bill_id,roll_call_id,date,chamber,description,yea,nay,nv,absent,total
1636377,1311676,2023-04-26,Assembly,"Do pass and be re-referred to the Committee on [Appropriations]",6,1,0,0,7
1636377,1327994,2023-05-18,Assembly,"Do pass as amended",12,3,0,1,16
1636377,1333609,2023-05-25,Assembly,"AB 1 McKinnor Assembly Third Reading",68,5,0,7,80
1636377,1348464,2023-06-28,Senate,"Do pass, but first be re-referred to the Committee on [Judiciary]",4,0,0,1,5
1636377,1350475,2023-07-11,Senate,"Do pass as amended, but first amend, and re-refer to the Committee on [Appropriations]",9,1,0,1,11
1636377,1352314,2023-08-28,Senate,"Placed on suspense file",7,0,0,0,7
1636377,1352628,2023-09-01,Senate,"Do pass",5,2,0,0,7
1636377,1353886,2023-09-12,Senate,"Assembly 3rd Reading AB1 McKinnor et al. By Durazo",30,3,0,7,40
1636377,1354155,2023-09-13,Assembly,"AB 1 McKinnor Concurrence in Senate Amendments",71,5,0,4,80
1636378,1313522,2023-04-26,Assembly,"Do pass as amended and be re-referred to the Committee on [Appropriations]",7,0,0,0,7
1636378,1322935,2023-05-10,Assembly,"Do pass. To Consent Calendar",14,0,0,2,16
1636378,1328666,2023-05-18,Assembly,"AB 10 Lowenthal Consent Calendar Second Day",74,0,0,6,80
1636378,1344198,2023-06-14,Senate,"Do pass as amended, but first amend, and re-refer to the Committee on [Appropriations]",7,0,0,0,7
1636378,1349474,2023-07-03,Senate,"Placed on suspense file",7,0,0,0,7
1636378,1352643,2023-09-01,Senate,"Do pass as amended",7,0,0,0,7
1636378,1354228,2023-09-13,Senate,"Special Consent AB10 Lowenthal et al",39,0,0,1,40
1636378,1354664,2023-09-14,Assembly,"AB 10 Lowenthal Concurrence in Senate Amendments",80,0,0,0,80
1636379,1276620,2023-03-15,Assembly,"Do pass as amended and be re-referred to the Committee on [Appropriations]",6,0,0,1,7
1636380,1298207,2023-04-11,Assembly,"Do pass",8,3,0,0,11
1636380,1330129,2023-05-22,Assembly,"AB 12 Haney Assembly Third Reading",53,14,0,13,80
1636380,1345691,2023-06-20,Senate,"Do pass",8,2,0,1,11
1636380,1353971,2023-09-12,Senate,"Assembly 3rd Reading AB12 Haney et al. Wiener",21,9,0,10,40
1636380,1354373,2023-09-13,Assembly,"AB 12 Haney Concurrence in Senate Amendments",50,18,0,12,80
1636381,1276660,2023-03-15,Assembly,"Do pass and be re-referred to the Committee on [Governmental Organization]",2,6,0,0,8
1636381,1276661,2023-03-15,Assembly,Reconsideration,3,1,0,4,8
1636383,1270448,2023-03-07,Assembly,"Do pass and be re-referred to the Committee on [Judiciary]",2,6,0,0,8
1636386,1251051,2023-02-14,Assembly,"Do pass and be re-referred to the Committee on [Appropriations]",2,5,0,1,8
1636387,1301005,2023-04-12,Assembly,"Do pass and be re-referred to the Committee on [Appropriations] with recommendation: To Consent Calendar",7,0,0,0,7
1636387,1328472,2023-05-18,Assembly,"Do pass",15,0,0,1,16
1636387,1333569,2023-05-25,Assembly,"AB 19 Joe Patterson Assembly Third Reading",78,0,0,2,80
1636387,1346265,2023-06-21,Senate,"Do pass as amended, but first amend, and re-refer to the Committee on [Appropriations] with the recommendation: To Consent Calendar",7,0,0,0,7
1636387,1349981,2023-07-10,Senate,"Placed on suspense file",6,0,0,1,7
1636388,1288270,2023-03-28,Assembly,"Do pass and be re-referred to the Committee on [Natural Resources]",8,0,0,1,9
1636388,1310271,2023-04-24,Assembly,"Do pass as amended and be re-referred to the Committee on [Appropriations]",10,0,0,1,11
1636388,1328789,2023-05-18,Assembly,"Do pass as amended",12,2,0,2,16
1636388,1333649,2023-05-25,Assembly,"AB 2 Ward Assembly Third Reading",66,4,0,10,80
1636388,1350483,2023-07-12,Senate,"Do pass, but first be re-referred to the Committee on [Appropriations]",5,0,0,2,7
1636388,1351357,2023-08-14,Senate,"Placed on suspense file",7,0,0,0,7
1636389,1275530,2023-03-14,Assembly,"Do pass as amended, and be re-referred to the Committee on [Human Services] with recommendation: To Consent Calendar",11,0,0,0,11
1636389,1304352,2023-04-18,Assembly,"Do pass and be re-referred to the Committee on [Appropriations] with recommendation: To Consent Calendar",7,0,0,1,8
1636389,1328475,2023-05-18,Assembly,"Do pass",15,0,0,1,16
1636389,1333752,2023-05-25,Assembly,"AB 20 Gipson Assembly Third Reading",78,0,0,2,80
1636389,1345668,2023-06-20,Senate,"Do pass, but first be re-referred to the Committee on [Human Services] with the recommendation: To Consent Calendar",11,0,0,0,11
1636389,1349566,2023-07-03,Senate,"Do pass, but first be re-referred to the Committee on [Appropriations]",5,0,0,0,5
1636389,1351481,2023-08-14,Senate,"Placed on suspense file",7,0,0,0,7
1636389,1352653,2023-09-01,Senate,"Do pass",7,0,0,0,7
1636389,1354027,2023-09-12,Senate,"Assembly 3rd Reading AB20 Gipson et al. By Wahab",38,0,0,2,40
1636389,1354222,2023-09-13,Assembly,"AB 20 Gipson Concurrence in Senate Amendments",80,0,0,0,80
1636390,1251030,2023-02-14,Assembly,"Do pass and be re-referred to the Committee on [Appropriations] with recommendation: To Consent Calendar",8,0,0,0,8
1636393,1298203,2023-04-11,Assembly,"Do pass as amended and be re-referred to the Committee on [Judiciary]",15,0,0,0,15
1636393,1310196,2023-04-25,Assembly,"Do pass as amended and be re-referred to the Committee on [Appropriations]",11,0,0,0,11
1636394,1311919,2023-04-25,Assembly,"Do pass and be re-referred to the Committee on [Appropriations]",12,0,0,0,12
1636394,1328699,2023-05-18,Assembly,"Do pass",15,0,0,1,16
1636394,1338075,2023-05-31,Assembly,"AB 25 McCarty Assembly Third Reading",79,0,0,1,80
1636394,1350495,2023-07-12,Senate,"Do pass, but first be re-referred to the Committee on [Appropriations]",7,0,0,0,7
1636394,1351284,2023-08-14,Senate,"Placed on suspense file",7,0,0,0,7
1636395,1317055,2023-05-01,Assembly,"Do pass and be re-referred to the Committee on [Appropriations]",11,0,0,0,11
1636396,1251025,2023-02-14,Assembly,"Do pass and be re-referred to the Committee on [Appropriations]",2,6,0,0,8
1636397,1299489,2023-04-11,Assembly,"Do pass and be re-referred to the Committee on [Revenue and Taxation]",6,2,0,0,8
1636397,1310234,2023-04-24,Assembly,"Do pass and be re-referred to the Committee on [Appropriations]",7,3,0,1,11
1636397,1328442,2023-05-18,Assembly,"Do pass as amended",11,4,0,1,16
1636397,1333613,2023-05-25,Assembly,"AB 28 Gabriel Assembly Third Reading",56,17,0,7,80
1636397,1346284,2023-06-21,Senate,"Do pass as amended, but first amend, and re-refer to the Committee on [Public Safety]",6,2,0,0,8
1636397,1350283,2023-07-11,Senate,"Do pass as amended, but first amend, and re-refer to the Committee on [Appropriations]",3,1,0,1,5
1636397,1351372,2023-08-14,Senate,"Placed on suspense file",7,0,0,0,7
1636397,1352926,2023-09-01,Senate,"Do pass as amended",5,2,0,0,7
1636397,1353471,2023-09-07,Senate,"Assembly 3rd Reading AB28 Gabriel et al. By Portantino",27,9,0,4,40
1636397,1353472,2023-09-07,Assembly,"AB 28 GABRIEL Concurrence in Senate Amendments",57,17,0,6,80
1636398,1251054,2023-02-14,Assembly,"Do pass as amended and be re-referred to the Committee on [Health]",8,0,0,0,8
1636398,1280702,2023-03-21,Assembly,"Do pass and be re-referred to the Committee on [Appropriations]",13,0,0,2,15
1636399,1310158,2023-04-24,Assembly,"Do pass as amended, and be re-referred to the Committee on [Appropriations] with recommendation: To Consent Calendar",11,0,0,0,11
1636399,1328127,2023-05-18,Assembly,"Do pass",15,0,0,1,16
1636399,1330067,2023-05-22,Assembly,"AB 3 Zbur Assembly Third Reading",76,0,0,4,80
1636399,1345649,2023-06-20,Senate,"Do pass as amended, but first amend, and re-refer to the Committee on [Natural Resources and Water]",18,0,0,0,18
1636399,1349914,2023-07-10,Senate,"Do pass as amended, but first amend, and re-refer to the Committee on [Appropriations]",10,0,0,1,11
1636399,1351486,2023-08-14,Senate,"Placed on suspense file",7,0,0,0,7
1636399,1352502,2023-09-01,Senate,"Do pass as amended",7,0,0,0,7
1636399,1354392,2023-09-13,Senate,"Special Consent AB3 Zbur et al. By Lim√≥n",39,0,0,1,40
1636399,1354558,2023-09-14,Assembly,"AB 3 Zbur Concurrence in Senate Amendments",79,1,0,0,80
1636400,1275587,2023-03-14,Assembly,"Do pass and be re-referred to the Committee on [Appropriations]",15,0,0,0,15
1636400,1328220,2023-05-18,Assembly,"Do pass",15,0,0,1,16
1636400,1330131,2023-05-22,Assembly,"AB 30 Ward Assembly Third Reading",76,0,0,4,80
1636400,1346949,2023-06-22,Senate,"Do pass, but first be re-referred to the Committee on [Appropriations] with the recommendation: To Consent Calendar",11,0,0,0,11
1636400,1350650,2023-07-13,Senate,"Consent Calendar AB30 Ward et al",37,0,0,3,40
1636400,1351290,2023-08-14,Assembly,"AB 30 Ward Concurrence in Senate Amendments",76,0,0,4,80
1636403,1280700,2023-03-21,Assembly,"Do pass and be re-referred to the Committee on [Public Safety]",14,0,0,1,15
1636403,1313424,2023-04-27,Assembly,"Do pass as amended and be re-referred to the Committee on [Appropriations]",8,0,0,0,8
1636403,1328192,2023-05-18,Assembly,"Do pass as amended",15,0,0,1,16
1636403,1333636,2023-05-25,Assembly,"AB 33 Bains Assembly Third Reading",78,0,0,2,80
1636403,1347843,2023-06-27,Senate,"Do pass, but first be re-referred to the Committee on [Appropriations] with the recommendation: To Consent Calendar",5,0,0,0,5
1636403,1351454,2023-08-14,Senate,"Placed on suspense file",7,0,0,0,7
1636403,1353061,2023-09-01,Senate,"Do pass as amended",7,0,0,0,7
1636403,1353819,2023-09-12,Senate,"Assembly 3rd Reading AB33 Bains et al. By Seyarto Urgency Clause",38,0,0,2,40
1636403,1354613,2023-09-14,Assembly,"AB 33 Bains Concurrence - Urgency Added",80,0,0,0,80
1636404,1305259,2023-04-19,Assembly,"Do pass and be re-referred to the Committee on [Local Government]",6,0,0,2,8
1636404,1313360,2023-04-26,Assembly,"Do pass and be re-referred to the Committee on [Appropriations]",6,1,0,1,8
1636404,1328735,2023-05-18,Assembly,"Do pass",11,4,0,1,16
1636404,1330056,2023-05-22,Assembly,"AB 34 Valencia Assembly Third Reading",61,15,0,4,80
1636404,1345683,2023-06-20,Senate,"Do pass as amended, but first amend, and re-refer to the Committee on [Governance and Finance]",6,0,0,1,7
1636404,1350694,2023-07-12,Senate,"Do pass, but first be re-referred to the Committee on [Appropriations]",6,2,0,0,8
1636404,1351841,2023-08-21,Senate,"Placed on suspense file",7,0,0,0,7
1636404,1352669,2023-09-01,Senate,"Do pass",5,2,0,0,7
1636404,1353263,2023-09-06,Senate,"Assembly 3rd Reading AB34 Valencia et al. By Umberg",31,7,0,2,40
1636404,1353264,2023-09-06,Senate,"Assembly 3rd Reading AB34 Valencia et al. By Umberg Motion To Reconsider",40,0,0,0,40
1636404,1354015,2023-09-12,Senate,"Assembly 3rd Reading AB34 Valencia et al. By Umberg",31,6,0,3,40
1636404,1354267,2023-09-13,Assembly,"AB 34 Valencia Concurrence in Senate Amendments",62,16,0,2,80
1636406,1298331,2023-04-11,Assembly,"Do pass and be re-referred to the Committee on [Public Safety]",8,1,0,2,11
1636406,1310369,2023-04-25,Assembly,"Do pass as amended and be re-referred to the Committee on [Appropriations]",7,1,0,0,8
1636407,1288235,2023-03-29,Assembly,"Do pass and be re-referred to the Committee on [Appropriations]",7,0,0,1,8
1636407,1311886,2023-04-26,Assembly,"Do pass",15,0,0,1,16
1636407,1328214,2023-05-18,Assembly,"AB 37 Bonta Assembly Third Reading",70,0,0,10,80
1636407,1349822,2023-07-05,Senate,"Do pass as amended, but first amend, and re-refer to the Committee on [Appropriations]",7,0,0,0,7
1636407,1354235,2023-09-13,Senate,"Assembly 3rd Reading AB37 Bonta et al. By Wiener",35,3,0,2,40
1636407,1354236,2023-09-13,Assembly,"AB 37 Bonta Concurrence in Senate Amendments",75,0,0,5,80
1636408,1286975,2023-03-28,Assembly,"Do pass as amended and be re-referred to the Committee on [Appropriations]",15,2,0,2,19
1636408,1328768,2023-05-18,Assembly,"Do pass as amended",11,3,0,2,16
1636408,1333617,2023-05-25,Assembly,"AB 38 Lee Assembly Third Reading",65,5,0,10,80
1636408,1347930,2023-06-27,Senate,"Do pass as amended, but first amend, and re-refer to the Committee on [Appropriations]",10,2,0,3,15
1636408,1351367,2023-08-14,Senate,"Placed on suspense file",7,0,0,0,7
1636409,1310400,2023-04-24,Assembly,"Do pass as amended and be re-referred to the Committee on [Appropriations]",11,0,0,1,12
1636409,1328255,2023-05-18,Assembly,"Do pass as amended",11,0,0,5,16
1636409,1333622,2023-05-25,Assembly,"AB 39 Grayson Assembly Third Reading",70,1,0,9,80
1636409,1349777,2023-07-05,Senate,"Do pass, but first be re-referred to the Committee on [Judiciary]",6,0,0,1,7
1636409,1350566,2023-07-11,Senate,"Do pass as amended, but first amend, and re-refer to the Committee on [Appropriations]",10,0,0,1,11
1636409,1351828,2023-08-21,Senate,"Placed on suspense file",7,0,0,0,7
1636409,1353073,2023-09-01,Senate,"Do pass as amended",5,2,0,0,7
1636409,1353738,2023-09-12,Senate,"Assembly 3rd Reading AB39 Grayson et al. By Lim√≥n",33,2,0,5,40
1636409,1354686,2023-09-14,Assembly,"AB 39 Grayson Concurrence in Senate Amendments",75,0,0,5,80
1636410,1298178,2023-04-11,Assembly,"Do pass and be re-referred to the Committee on [Appropriations]",13,1,0,1,15
1636410,1328235,2023-05-18,Assembly,"Do pass",12,3,0,1,16
1636410,1333567,2023-05-25,Assembly,"AB 4 Arambula Assembly Third Reading",64,9,0,7,80
1636410,1350616,2023-07-12,Senate,"Do pass as amended, but first amend, and re-refer to the Committee on [Appropriations]",9,1,0,2,12
1636410,1463914,2024-08-12,Senate,"Placed on suspense file",7,0,0,0,7
1636411,1285769,2023-03-27,Assembly,"Do pass and be re-referred to the Committee on [Health]",5,0,0,2,7
1636411,1304272,2023-04-18,Assembly,"Do pass as amended and be re-referred to the Committee on [Appropriations]",15,0,0,0,15
1636411,1328598,2023-05-18,Assembly,"Do pass as amended",12,0,0,4,16
1636411,1333694,2023-05-25,Assembly,"AB 40 Rodriguez Assembly Third Reading",73,0,0,7,80
1636411,1350632,2023-07-12,Senate,"Do pass, but first be re-referred to the Committee on [Appropriations]",10,0,0,2,12
1636411,1351350,2023-08-14,Senate,"Placed on suspense file",7,0,0,0,7
1636411,1352762,2023-09-01,Senate,"Do pass as amended",6,1,0,0,7
1636411,1353476,2023-09-07,Senate,"Assembly 3rd Reading AB40 Rodriguez et al",31,4,0,5,40
1636411,1353657,2023-09-11,Assembly,"AB 40 Rodriguez Concurrence in Senate Amendments",74,0,0,6,80
1636412,1305335,2023-04-19,Assembly,"Do pass as amended and be re-referred to the Committee on [Appropriations]",10,2,0,1,13
1636412,1328576,2023-05-18,Assembly,"Do pass as amended",11,3,0,2,16
1636412,1338177,2023-05-31,Assembly,"AB 41 Holden Assembly Third Reading",48,18,0,14,80
1636412,1350221,2023-07-10,Senate,"Do pass as amended, but first amend, and re-refer to the Committee on [Judiciary]",12,2,0,4,18
1636412,1351771,2023-08-21,Senate,"Placed on suspense file",7,0,0,0,7
1636412,1352795,2023-09-01,Senate,"Do pass as amended",5,0,0,2,7
1636412,1353442,2023-09-07,Senate,"Assembly 3rd Reading AB41 Holden et al. By Bradford",38,0,0,2,40
1636412,1353655,2023-09-11,Assembly,"AB 41 Holden Concurrence in Senate Amendments",73,1,0,6,80
1636413,1299373,2023-04-12,Assembly,"Do pass as amended and be re-referred to the Committee on [Local Government]",8,0,0,0,8
1636413,1313375,2023-04-26,Assembly,"Do pass and be re-referred to the Committee on [Appropriations]",8,0,0,0,8
1636413,1322857,2023-05-10,Assembly,"Do pass",15,0,0,1,16
1636413,1333551,2023-05-25,Assembly,"AB 42 Ramos Assembly Third Reading",78,0,0,2,80
1636413,1346274,2023-06-20,Senate,"Do pass, but first be re-referred to the Committee on [Governance and Finance]",11,0,0,0,11
1636413,1350635,2023-07-12,Senate,"Do pass, but first be re-referred to the Committee on [Appropriations]",8,0,0,0,8
1636413,1353247,2023-09-06,Senate,"Assembly 3rd Reading AB42 Ramos et al. By Blakespear",40,0,0,0,40
1636413,1353347,2023-09-07,Assembly,"AB 42 Ramos Concurrence in Senate Amendments",79,0,0,1,80
1636414,1285680,2023-03-27,Assembly,"Do pass as amended and be re-referred to the Committee on [Appropriations]",8,1,0,2,11
1636414,1328479,2023-05-18,Assembly,"Do pass",12,3,0,1,16
1636414,1333601,2023-05-25,Assembly,"AB 43 Holden Assembly Third Reading",56,17,0,7,80
1636414,1349574,2023-07-05,Senate,"Do pass as amended, but first amend, and re-refer to the Committee on [Appropriations]",5,2,0,0,7
1636414,1351831,2023-08-21,Senate,"Placed on suspense file",7,0,0,0,7
1636414,1352708,2023-09-01,Senate,"Do pass as amended",5,2,0,0,7
1636414,1354413,2023-09-13,Senate,"Assembly 3rd Reading AB43 Holden By Becker",28,8,0,4,40
1636414,1354414,2023-09-13,Assembly,"AB 43 Holden Concurrence in Senate Amendments",52,17,0,11,80
1636415,1286901,2023-03-28,Assembly,"Do pass as amended, and be re-referred to the Committee on [Appropriations] with recommendation: To Consent Calendar",8,0,0,0,8
1636415,1328366,2023-05-18,Assembly,"Do pass",15,0,0,1,16
1636415,1330034,2023-05-22,Assembly,"AB 44 Ramos Assembly Third Reading",77,0,0,3,80
1636415,1350266,2023-07-11,Senate,"Do pass as amended, but first amend, and re-refer to the Committee on [Appropriations]",4,0,0,1,5
1636415,1351449,2023-08-14,Senate,"Placed on suspense file",7,0,0,0,7
1636415,1353011,2023-09-01,Senate,"Do pass as amended",7,0,0,0,7
1636415,1354353,2023-09-13,Senate,"Special Consent AB44 Ramos",39,0,0,1,40
1636415,1354633,2023-09-14,Assembly,"AB 44 Ramos Concurrence in Senate Amendments",80,0,0,0,80
1636416,1274178,2023-03-13,Assembly,"Do pass and be re-referred to the Committee on [Appropriations]",8,0,0,3,11
1636416,1275563,2023-03-13,Assembly,"Do pass as amended and be re-referred to the Committee on [Appropriations]",8,0,0,3,11
1636416,1328003,2023-05-18,Assembly,"Do pass",11,4,0,1,16
1636416,1338015,2023-05-31,Assembly,"AB 45 Boerner Assembly Third Reading",61,10,0,9,80
1636416,1349490,2023-07-03,Senate,"Do pass, but first be re-referred to the Committee on [Appropriations]",7,1,0,3,11
1636416,1351296,2023-08-14,Senate,"Placed on suspense file",7,0,0,0,7
1636417,1317048,2023-05-01,Assembly,"Do pass and be re-referred to the Committee on [Appropriations]",11,0,0,0,11
1636417,1328777,2023-05-18,Assembly,"Do pass",15,0,0,1,16
1636417,1330039,2023-05-22,Assembly,"AB 46 Ramos Assembly Third Reading",77,0,0,3,80
1636417,1344227,2023-06-14,Senate,"Do pass, but first be re-referred to the Committee on [Military and Veterans Affairs]",7,0,0,1,8
1636417,1350170,2023-07-10,Senate,"Do pass as amended, but first amend, and re-refer to the Committee on [Appropriations]",5,0,0,0,5
1636417,1351418,2023-08-14,Senate,"Placed on suspense file",7,0,0,0,7
1636419,1276634,2023-03-14,Assembly,"Do pass as amended and be re-referred to the Committee on [Judiciary]",13,0,0,2,15
1636419,1286947,2023-03-28,Assembly,"Do pass and be re-referred to the Committee on [Appropriations] with recommendation: To Consent Calendar",9,0,0,2,11
1636419,1328597,2023-05-18,Assembly,"Do pass",15,0,0,1,16
1636419,1330064,2023-05-22,Assembly,"AB 48 Aguiar-Curry Assembly Third Reading",77,0,0,3,80
1636419,1344222,2023-06-14,Senate,"Do pass, but first be re-referred to the Committee on [Judiciary] with the recommendation: To Consent Calendar",12,0,0,0,12
1636419,1348382,2023-06-27,Senate,"Do pass, but first be re-referred to the Committee on [Appropriations] with the recommendation: To Consent Calendar",11,0,0,0,11
1636419,1349993,2023-07-10,Senate,"Placed on suspense file",6,0,0,1,7
1636419,1352619,2023-09-01,Senate,"Do pass as amended",7,0,0,0,7
1636419,1353899,2023-09-12,Senate,"Assembly 3rd Reading AB48 Aguiar-Curry et al. By Niello",38,0,0,2,40
1636419,1354266,2023-09-13,Assembly,"AB 48 Aguiar-Curry Concurrence in Senate Amendments",80,0,0,0,80
1636421,1313495,2023-04-26,Assembly,"Do pass as amended and be re-referred to the Committee on [Appropriations]",6,0,0,1,7
1636421,1328493,2023-05-18,Assembly,"Do pass",11,1,0,4,16
1636421,1330108,2023-05-22,Assembly,"AB 5 Zbur Assembly Third Reading",64,4,0,12,80
1636421,1350537,2023-07-12,Senate,"Do pass, but first be re-referred to the Committee on [Appropriations]",5,0,0,2,7
1636421,1351477,2023-08-14,Senate,"Placed on suspense file",7,0,0,0,7
1636421,1352983,2023-09-01,Senate,"Do pass as amended",5,2,0,0,7
1636421,1353478,2023-09-07,Senate,"Assembly 3rd Reading AB5 Zbur et al. By Menjivar",32,3,0,5,40
1636421,1353619,2023-09-11,Assembly,"AB 5 Zbur Concurrence in Senate Amendments",65,0,0,15,80
1636422,1313431,2023-04-26,Assembly,"Do pass as amended and be re-referred to the Committee on [Appropriations]",11,2,0,2,15
1636422,1328830,2023-05-18,Assembly,"Do pass as amended",11,2,0,3,16
1636422,1333710,2023-05-25,Assembly,"AB 50 Wood Assembly Third Reading",67,0,0,13,80
1636422,1349462,2023-07-03,Senate,"Do pass as amended, but first amend, and re-refer to the Committee on [Appropriations]",15,0,0,3,18
1636422,1351336,2023-08-14,Senate,"Placed on suspense file",7,0,0,0,7
1636422,1352771,2023-09-01,Senate,"Do pass as amended",7,0,0,0,7
1636422,1354699,2023-09-14,Senate,"Assembly 3rd Reading AB50 Wood et al. By Dodd",40,0,0,0,40
1636422,1354700,2023-09-14,Assembly,"AB 50 Wood Concurrence in Senate Amendments",74,0,0,6,80
1636423,1304349,2023-04-18,Assembly,"Do pass and be re-referred to the Committee on [Education]",7,0,0,1,8
1636423,1313396,2023-04-26,Assembly,"Do pass as amended and be re-referred to the Committee on [Appropriations]",7,0,0,0,7
1636423,1328064,2023-05-18,Assembly,"Do pass",15,0,0,1,16
1636423,1330157,2023-05-22,Assembly,"AB 51 Bonta Assembly Third Reading",77,0,0,3,80
1636423,1346268,2023-06-21,Senate,"Do pass, but first be re-referred to the Committee on [Human Services]",7,0,0,0,7
1636423,1350619,2023-07-13,Senate,"Do pass as amended, but first amend, and re-refer to the Committee on [Appropriations]",4,0,0,1,5
1636423,1351326,2023-08-14,Senate,"Placed on suspense file",7,0,0,0,7
1636423,1352578,2023-09-01,Senate,"Do pass as amended",7,0,0,0,7
1636423,1465867,2024-08-27,Senate,"Assembly 3rd Reading AB51 Bonta et al. By Ashby",40,0,0,0,40
1636423,1466875,2024-08-28,Assembly,"AB 51 Bonta Concurrence in Senate Amendments",77,0,0,2,79
1636424,1317032,2023-05-01,Assembly,"Do pass and be re-referred to the Committee on [Appropriations]",11,0,0,0,11
1636424,1328069,2023-05-18,Assembly,"Do pass",15,0,0,1,16
1636424,1330096,2023-05-22,Assembly,"AB 52 Grayson Assembly Third Reading",77,0,0,3,80
1636424,1344209,2023-06-14,Senate,"Do pass as amended, but first amend, and re-refer to the Committee on [Appropriations]",6,0,0,2,8
1636424,1347481,2023-06-26,Senate,"Placed on suspense file",6,0,0,1,7
1636424,1464025,2024-08-15,Senate,"Do pass as amended",7,0,0,0,7
1636424,1466342,2024-08-29,Assembly,"AB 52 Grayson Concurrence in Senate Amendments",76,0,0,3,79
1636424,1466898,2024-08-28,Senate,"Assembly 3rd Reading AB52 Grayson et al. By Caballero",39,0,0,1,40
1636426,1276604,2023-03-15,Assembly,"Do pass and be re-referred to the Committee on [Appropriations]",8,0,0,3,11
1636427,1310243,2023-04-25,Assembly,"Do pass as amended and be re-referred to the Committee on [Appropriations]",15,0,0,0,15
1636428,1251073,2023-02-14,Assembly,"Do pass and be re-referred to the Committee on [Appropriations]",8,0,0,0,8
1636428,1281891,2023-03-22,Assembly,"Do pass",15,0,0,1,16
1636428,1320358,2023-05-08,Assembly,"AB 56 Lackey Assembly Third Reading",72,0,0,8,80
1636428,1343774,2023-06-13,Senate,"Do pass, but first be re-referred to the Committee on [Appropriations]",5,0,0,0,5
1636428,1354159,2023-09-13,Senate,"Assembly 3rd Reading AB56 Lackey et al. By Ochoa Bogh",39,0,0,1,40
1636429,1285621,2023-03-27,Assembly,"Do pass and be re-referred to the Committee on [Natural Resources]",11,4,0,0,15
1636429,1310336,2023-04-24,Assembly,"Do pass and be re-referred to the Committee on [Appropriations]",8,2,0,1,11
1636429,1322896,2023-05-10,Assembly,"Do pass",12,3,0,1,16
1636429,1337208,2023-06-01,Assembly,"AB 6 Friedman Assembly Third Reading",45,19,0,16,80
1636430,1285651,2023-03-27,Assembly,"Do pass and be re-referred to the Committee on [Appropriations]",11,4,0,0,15
1636430,1328104,2023-05-18,Assembly,"Do pass",12,3,0,1,16
1636430,1333777,2023-05-25,Assembly,"AB 7 Friedman Assembly Third Reading Amendment Set #1",53,16,0,11,80
1636430,1338194,2023-05-31,Assembly,"AB 7 Friedman Assembly Third Reading",54,17,0,9,80
1636430,1350455,2023-07-11,Senate,"Do pass, but first be re-referred to the Committee on [Appropriations]",10,4,0,2,16
1636430,1352353,2023-08-28,Senate,"Placed on suspense file",7,0,0,0,7
1636430,1352662,2023-09-01,Senate,"Do pass as amended",5,0,0,2,7
1636431,1310217,2023-04-25,Assembly,"Do pass and be re-referred to the Committee on [Privacy and Consumer Protection]",5,1,0,1,7
1636431,1311865,2023-04-25,Assembly,"Do pass as amended and be re-referred to the Committee on [Appropriations]",8,2,0,1,11
1636431,1328180,2023-05-18,Assembly,"Do pass",11,3,0,2,16
1636431,1338145,2023-05-31,Assembly,"AB 8 Friedman Assembly Third Reading",48,11,0,21,80
1636431,1347483,2023-06-26,Senate,"Do pass, but first be re-referred to the Committee on [Judiciary]",11,0,0,2,13
1636431,1350540,2023-07-11,Senate,"Do pass, but first be re-referred to the Committee on [Appropriations]",7,0,0,4,11
1636431,1352320,2023-08-28,Senate,"Placed on suspense file",7,0,0,0,7
1636432,1310260,2023-04-24,Assembly,"Do pass and be re-referred to the Committee on [Appropriations]",8,3,0,0,11
1636432,1327995,2023-05-18,Assembly,"Do pass",11,4,0,1,16
1636433,1350565,2023-07-12,Assembly,"Be adopted as amended, and re-refer to the Committee on [Appropriations]",6,1,0,1,8
1636433,1352506,2023-09-01,Assembly,"Be adopted as amended",11,4,0,1,16
1636433,1353301,2023-09-06,Assembly,"ACA 1 Aguiar-Curry Assembly Third Reading",55,12,0,13,80
1636433,1354003,2023-09-11,Senate,"Be adopted, but first be re-referred to the Committee on [Appropriations]",5,2,0,0,7
1636433,1354004,2023-09-12,Senate,"Be adopted",5,2,0,0,7
1636433,1354504,2023-09-14,Senate,"Assembly 3rd Reading ACA1 Aguiar-Curry et al. By Wiener",29,10,0,1,40
1636436,1230245,2022-12-05,Assembly,"HR 2 RENDON Assembly Third Reading By REYES",61,16,0,2,79
1636437,1230246,2022-12-05,Assembly,"HR 3 RENDON Assembly Third Reading By REYES",77,0,0,2,79
1636438,1230247,2022-12-05,Assembly,"HR 4 RENDON Assembly Third Reading By REYES",77,0,0,2,79
1636439,1313387,2023-04-26,Senate,"Do pass as amended, but first amend, and re-refer to the Committee on [Appropriations] with the recommendation: To Consent Calendar",8,0,0,0,8
1636440,1281853,2023-03-22,Senate,"Do pass as amended, but first amend, and re-refer to the Committee on [Health] with the recommendation: To Consent Calendar",7,0,0,0,7
1636440,1301011,2023-04-12,Senate,"Do pass, but first be re-referred to the Committee on [Appropriations] with the recommendation: To Consent Calendar",11,0,0,1,12
1636440,1308793,2023-04-24,Senate,"Placed on suspense file",7,0,0,0,7
1636440,1328784,2023-05-18,Senate,"Do pass as amended",7,0,0,0,7
1636440,1335416,2023-05-30,Senate,"Special Consent SB10 Cortese et al",40,0,0,0,40
1636440,1348834,2023-06-28,Assembly,"Do pass as amended and be re-referred to the Committee on [Health]",7,0,0,0,7
1636440,1350256,2023-07-11,Assembly,"Do pass and be re-referred to the Committee on [Appropriations] with recommendation: To Consent Calendar",15,0,0,0,15
1636440,1352754,2023-09-01,Assembly,"Do pass as amended",11,0,0,5,16
1636440,1354245,2023-09-13,Assembly,"SB 10 Cortese Senate Third Reading By Low",80,0,0,0,80
1636440,1354860,2023-09-14,Senate,"Unfinished Business SB10 Cortese et al. Concurrence",40,0,0,0,40
1636441,1288293,2023-03-29,Senate,"Do pass as amended, but first amend, and re-refer to the Committee on [Health]",7,0,0,0,7
1636441,1313411,2023-04-26,Senate,"Do pass as amended, but first amend, and re-refer to the Committee on [Appropriations]",10,0,0,2,12
1636441,1324938,2023-05-15,Senate,"Placed on suspense file",7,0,0,0,7
1636441,1328158,2023-05-18,Senate,"Do pass as amended",7,0,0,0,7
1636441,1335580,2023-05-30,Senate,"Senate 3rd Reading SB11 Menjivar et al",40,0,0,0,40
1636441,1348461,2023-06-27,Assembly,"Do pass and be re-referred to the Committee on [Health]",11,0,0,1,12
1636441,1350320,2023-07-11,Assembly,"Do pass as amended and be re-referred to the Committee on [Appropriations]",15,0,0,0,15
1636442,1276632,2023-03-15,Senate,"Do pass, but first be re-referred to the Committee on [Appropriations]",5,2,0,0,7
1636442,1324979,2023-05-15,Senate,"Placed on suspense file",7,0,0,0,7
1636444,1310263,2023-04-25,Senate,"Do pass as amended, but first amend, and re-refer to the Committee on [Appropriations]",5,0,0,0,5
1636444,1320476,2023-05-08,Senate,"Placed on suspense file",7,0,0,0,7
1636444,1328313,2023-05-18,Senate,"Do pass",7,0,0,0,7
1636444,1333799,2023-05-25,Senate,"Special Consent SB14 Grove et al",40,0,0,0,40
1636444,1350263,2023-07-11,Assembly,"Do pass and be re-referred to the Committee on [Appropriations]",2,0,0,6,8
1636444,1350662,2023-07-13,Assembly,"Do pass and be re-referred to the Committee on [Appropriations]",6,0,0,2,8
1636444,1352618,2023-09-01,Assembly,"Do pass as amended",16,0,0,0,16
1636444,1353620,2023-09-11,Assembly,"SB 14 Grove Senate Third Reading By Blanca Rubio",80,0,0,0,80
1636444,1354163,2023-09-13,Senate,"Unfinished Business SB14 Grove et al. Concurrence",39,0,0,1,40
1636445,1288194,2023-03-29,Senate,"Do pass, but first be re-referred to the Committee on [Energy, Utilities and Communications] with the recommendation: To Consent Calendar",7,0,0,0,7
1636445,1310174,2023-04-24,Senate,"Do pass as amended, but first amend, and re-refer to the Committee on [Appropriations]",17,0,0,1,18
1636445,1325030,2023-05-15,Senate,"Placed on suspense file",7,0,0,0,7
1636445,1328552,2023-05-18,Senate,"Do pass",7,0,0,0,7
1636445,1333692,2023-05-25,Senate,"Special Consent SB15 Grove",40,0,0,0,40
1636445,1345187,2023-06-19,Assembly,"Do pass and be re-referred to the Committee on [Appropriations]",11,0,0,0,11
1636446,1288172,2023-03-28,Senate,"Do pass as amended",9,1,0,1,11
1636446,1302637,2023-04-17,Senate,"Placed on suspense file",6,0,0,1,7
1636446,1328314,2023-05-18,Senate,"Do pass as amended",5,2,0,0,7
1636446,1335576,2023-05-30,Senate,"Senate 3rd Reading SB16 Smallwood-Cuevas",32,7,0,1,40
1636446,1345659,2023-06-20,Assembly,"Do pass and be re-referred to the Committee on [Appropriations]",8,2,0,1,11
1636447,1310137,2023-04-24,Senate,"Do pass, but first be re-referred to the Committee on [Appropriations]",11,0,0,0,11
1636447,1320472,2023-05-08,Senate,"Placed on suspense file",7,0,0,0,7
1636447,1328592,2023-05-18,Senate,"Do pass",7,0,0,0,7
1636447,1332560,2023-05-24,Senate,"Senate 3rd Reading SB17 Caballero",40,0,0,0,40
1636447,1346290,2023-06-21,Assembly,"Do pass and be re-referred to the Committee on [Appropriations]",8,0,0,0,8
1636447,1352522,2023-09-01,Assembly,"Do pass",16,0,0,0,16
1636447,1354429,2023-09-13,Assembly,"SB 17 Caballero Senate Third Reading By Gabriel",80,0,0,0,80
1636448,1305521,2023-04-18,Senate,"Do pass, but first be re-referred to the Committee on [Governmental Organization]",10,0,0,1,11
1636448,1310311,2023-04-25,Senate,"Do pass, but first be re-referred to the Committee on [Appropriations]",15,0,0,0,15
1636448,1320488,2023-05-08,Senate,"Placed on suspense file",7,0,0,0,7
1636448,1328070,2023-05-18,Senate,"Do pass",7,0,0,0,7
1636448,1333697,2023-05-25,Senate,"Special Consent SB18 McGuire et al",40,0,0,0,40
1636448,1350397,2023-07-12,Assembly,"Do pass as amended and be re-referred to the Committee on [Appropriations]",8,0,0,0,8
1636448,1352616,2023-09-01,Assembly,"Do pass",16,0,0,0,16
1636448,1354154,2023-09-13,Assembly,"SB 18 McGuire Senate Third Reading By Wicks",80,0,0,0,80
1636448,1354864,2023-09-14,Senate,"Unfinished Business SB18 McGuire et al. Concurrence",40,0,0,0,40
1636449,1275585,2023-03-14,Senate,"Do pass, but first be re-referred to the Committee on [Appropriations]",4,0,0,1,5
1636449,1296896,2023-04-10,Senate,"Placed on suspense file",7,0,0,0,7
1636449,1328372,2023-05-18,Senate,"Do pass",7,0,0,0,7
1636449,1333599,2023-05-25,Senate,"Special Consent SB19 Seyarto et al",40,0,0,0,40
1636449,1345647,2023-06-20,Assembly,"Do pass as amended, and be re-referred to the Committee on [Public Safety] with recommendation: To Consent Calendar",14,0,0,1,15
1636449,1350139,2023-07-11,Assembly,"Do pass and be re-referred to the Committee on [Appropriations]",8,0,0,0,8
1636449,1352938,2023-09-01,Assembly,"Do pass as amended",15,0,0,1,16
1636449,1354227,2023-09-13,Assembly,"SB 19 Seyarto Senate Third Reading By Bains",79,0,0,1,80
1636449,1354820,2023-09-14,Senate,"Unfinished Business SB19 Seyarto et al. Concurrence",40,0,0,0,40
1636450,1288217,2023-03-28,Senate,"Do pass, but first be re-referred to the Committee on [Appropriations]",4,1,0,0,5
1636450,1296923,2023-04-10,Senate,"Placed on suspense file",7,0,0,0,7
1636450,1328679,2023-05-18,Senate,"Do pass",5,2,0,0,7
1636450,1333687,2023-05-25,Senate,"Senate 3rd Reading SB2 Portantino et al",29,9,0,2,40
1636450,1348335,2023-06-27,Assembly,"Do pass as amended and be re-referred to the Committee on [Appropriations]",6,2,0,0,8
1636450,1352575,2023-09-01,Assembly,"Do pass",11,5,0,0,16
1636450,1353570,2023-09-08,Assembly,"SB 2 Portantino Senate Third Reading By McCarty Amendment Set #1",57,17,0,6,80
1636450,1353626,2023-09-11,Assembly,"SB 2 Portantino Senate Third Reading By McCarty",54,23,0,3,80
1636450,1353724,2023-09-12,Senate,"Unfinished Business SB2 Portantino et al. Concurrence",28,8,0,4,40
1636451,1299402,2023-04-12,Senate,"Do pass as amended, but first amend, and re-refer to the Committee on [Housing]",8,0,0,0,8
1636451,1317041,2023-05-02,Senate,"Do pass",10,0,0,1,11
1636451,1330044,2023-05-22,Senate,"Senate 3rd Reading SB20 Rubio et al",36,0,0,4,40
1636451,1346230,2023-06-21,Assembly,"Do pass and be re-referred to the Committee on [Housing and Community Development] with recommendation: To Consent Calendar",8,0,0,0,8
1636451,1350492,2023-07-12,Assembly,"Do pass. To Consent Calendar",8,0,0,0,8
1636451,1351650,2023-08-17,Assembly,"SB 20 Rubio Consent Calendar Second Day Regular Session",75,0,0,5,80
1636452,1288222,2023-03-28,Senate,"Do pass, but first be re-referred to the Committee on [Appropriations]",10,0,0,1,11
1636452,1308849,2023-04-24,Senate,"Placed on suspense file",7,0,0,0,7
1636452,1328027,2023-05-18,Senate,"Do pass",7,0,0,0,7
1636452,1332606,2023-05-24,Senate,"Senate 3rd Reading SB21 Umberg Urgency Clause",39,0,0,1,40
1636452,1343714,2023-06-13,Assembly,"Do pass and be re-referred to the Committee on [Appropriations] with recommendation: To Consent Calendar",11,0,0,0,11
1636453,1280629,2023-03-21,Senate,"Do pass, but first be re-referred to the Committee on [Judiciary]",5,0,0,0,5
1636453,1288355,2023-03-28,Senate,"Do pass as amended, but first amend, and re-refer to the Committee on [Appropriations]",10,0,0,1,11
1636453,1315768,2023-05-01,Senate,"Placed on suspense file",6,0,0,1,7
1636453,1328783,2023-05-18,Senate,"Do pass",7,0,0,0,7
1636453,1332625,2023-05-24,Senate,"Senate 3rd Reading SB22 Umberg Urgency Clause",36,0,0,4,40
1636454,1298288,2023-04-11,Senate,"Do pass as amended, but first amend, and re-refer to the Committee on [Environmental Quality]",10,0,0,1,11
1636454,1311739,2023-04-26,Senate,"Do pass as amended, but first amend, and re-refer to the Committee on [Appropriations]",7,0,0,0,7
1636454,1325031,2023-05-15,Senate,"Placed on suspense file",7,0,0,0,7
1636455,1305485,2023-04-18,Senate,"Do pass, but first be re-referred to the Committee on [Rules]",6,1,0,0,7
1636455,1320363,2023-05-08,Senate,"Placed on suspense file",7,0,0,0,7
1636455,1328692,2023-05-18,Senate,"Do pass",5,2,0,0,7
1636455,1335431,2023-05-30,Senate,"Senate 3rd Reading SB24 Umberg et al",31,8,0,1,40
1636455,1349663,2023-07-05,Assembly,"Do pass and be re-referred to the Committee on [Appropriations]",6,1,0,1,8
1636456,1305479,2023-04-18,Senate,"Do pass",7,0,0,0,7
1636456,1315686,2023-05-01,Senate,"Senate 3rd Reading SB25 Skinner",37,0,0,3,40
1636456,1341003,2023-06-07,Assembly,"Do pass. To Consent Calendar",8,0,0,0,8
1636456,1344735,2023-06-15,Assembly,"SB 25 Skinner Consent Calendar Second Day Regular Session",74,0,0,6,80
1636457,1363966,2024-01-10,Senate,"Do pass as amended, but first amend, and re-refer to the Committee on [Appropriations]",11,0,0,1,12
1636457,1364754,2024-01-16,Senate,"Placed on suspense file",6,0,0,1,7
1636457,1366750,2024-01-18,Senate,"Do pass",6,0,0,1,7
1636457,1369579,2024-01-25,Senate,"Senate 3rd Reading SB26 Umberg et al",34,0,0,6,40
1636457,1458202,2024-06-18,Assembly,"Do pass and be re-referred to the Committee on [Appropriations]",16,0,0,0,16
1636457,1464407,2024-08-15,Assembly,"Do pass",14,0,0,1,15
1636457,1465983,2024-08-27,Assembly,"SB 26 Umberg Senate Third Reading By Mike Fong",75,0,0,4,79
1636457,1466923,2024-08-28,Senate,"Unfinished Business SB26 Umberg et al. Concurrence",39,0,0,1,40
1636458,1271503,2023-03-08,Senate,"Do pass as amended, but first amend, and re-refer to the Committee on [Judiciary]",4,0,0,1,5
1636458,1288225,2023-03-28,Senate,"Do pass, but first be re-referred to the Committee on [Rules]",8,1,0,2,11
1636458,1315683,2023-05-01,Senate,"Placed on suspense file",6,0,0,1,7
1636458,1328638,2023-05-18,Senate,"Do pass as amended",5,2,0,0,7
1636458,1335434,2023-05-30,Senate,"Senate 3rd Reading SB27 Durazo et al",29,7,0,4,40
1636458,1345611,2023-06-20,Assembly,"Do pass and be re-referred to the Committee on [Labor and Employment]",7,2,0,2,11
1636458,1348408,2023-06-28,Assembly,"Do pass and be re-referred to the Committee on [Appropriations]",5,0,0,2,7
1636458,1352804,2023-09-01,Assembly,"Do pass as amended",11,3,0,2,16
1636458,1353654,2023-09-11,Assembly,"SB 27 Durazo Senate Third Reading By Aguiar-Curry",61,14,0,5,80
1636458,1353916,2023-09-12,Senate,"Unfinished Business SB27 Durazo et al. Concurrence",28,8,0,4,40
1636459,1281874,2023-03-22,Senate,"Do pass, but first be re-referred to the Committee on [Governance and Finance]",7,0,0,0,7
1636459,1305307,2023-04-19,Senate,"Do pass, but first be re-referred to the Committee on [Appropriations]",6,1,0,1,8
1636459,1315659,2023-05-01,Senate,"Placed on suspense file",6,0,0,1,7
1636459,1328843,2023-05-18,Senate,"Do pass",5,2,0,0,7
1636459,1332653,2023-05-24,Senate,"Senate 3rd Reading SB28 Glazer",33,4,0,3,40
1636459,1348477,2023-06-27,Assembly,"Do pass and be re-referred to the Committee on [Education]",9,1,0,2,12
1636459,1350550,2023-07-12,Assembly,"Do pass and be re-referred to the Committee on [Appropriations]",4,2,0,1,7
1636460,1280622,2023-03-21,Senate,"Do pass, but first be re-referred to the Committee on [Appropriations] with the recommendation: To Consent Calendar",7,0,0,0,7
1636460,1296943,2023-04-10,Senate,"Placed on suspense file",7,0,0,0,7
1636460,1328152,2023-05-18,Senate,"Do pass",7,0,0,0,7
1636460,1333661,2023-05-25,Senate,"Special Consent SB29 Glazer et al. Urgency Clause",40,0,0,0,40
1636460,1346289,2023-06-21,Assembly,"Do pass as amended, and be re-referred to the Committee on [Appropriations] with recommendation: To Consent Calendar",8,0,0,0,8
1636460,1352980,2023-09-01,Assembly,"Do pass",16,0,0,0,16
1636460,1353310,2023-09-06,Assembly,"SB 29 Glazer Third Reading Urgency By Pellerin",79,0,0,1,80
1636460,1354678,2023-09-11,Senate,"Unfinished Business SB29 Glazer et al. Urgency Clause Concurrence",39,0,0,1,40
1636461,1280609,2023-03-21,Senate,"Do pass, but first be re-referred to the Committee on [Appropriations]",13,0,0,5,18
1636461,1302579,2023-04-17,Senate,"Placed on suspense file",6,0,0,1,7
1636461,1328811,2023-05-18,Senate,"Do pass as amended",5,1,0,1,7
1636461,1336336,2023-05-31,Senate,"Senate 3rd Reading SB3 Dodd et al",31,7,0,2,40
1636461,1346255,2023-06-20,Assembly,"Do pass and be re-referred to the Committee on [Appropriations]",7,2,0,0,9
1636461,1352730,2023-09-01,Assembly,"Do pass as amended",11,4,0,1,16
1636461,1353523,2023-09-07,Assembly,"SB 3 Dodd Senate Third Reading By Wilson",62,15,0,3,80
1636461,1354725,2023-09-11,Senate,"Unfinished Business SB3 Dodd et al. Concurrence",30,7,0,3,40
1636462,1311835,2023-04-25,Senate,"Do pass, but first be re-referred to the Committee on [Appropriations]",16,0,0,0,16
1636462,1330147,2023-05-22,Senate,"Senate 3rd Reading SB30 Umberg",40,0,0,0,40
1636462,1347807,2023-06-26,Assembly,"Do pass and be re-referred to the Committee on [Appropriations] with recommendation: To Consent Calendar",15,0,0,0,15
1636463,1288207,2023-03-28,Senate,"Do pass, but first be re-referred to the Committee on [Appropriations]",1,1,0,3,5
1636463,1288208,2023-03-28,Senate,"[First] hearing set for [03-29-2023]: Failed passage in Committee. Reconsideration granted",5,0,0,0,5
1636464,1305534,2023-04-19,Senate,"Do pass, but first be re-referred to the Committee on [Governance and Finance]",2,3,0,2,7
1636464,1305535,2023-04-19,Senate,"[First] hearing set for [04-19-2023]: Failed passage in Committee. Reconsideration granted",7,0,0,0,7
1636465,1288154,2023-03-29,Senate,"Do pass, but first be re-referred to the Committee on [Judiciary]",6,0,0,1,7
1636465,1299468,2023-04-11,Senate,"Do pass, but first be re-referred to the Committee on [Appropriations]",10,0,0,1,11
1636465,1323840,2023-05-11,Senate,"Senate 3rd Reading SB33 Glazer",39,0,0,1,40
1636465,1343143,2023-06-12,Assembly,"Do pass and be re-referred to the Committee on [Judiciary]",11,0,0,1,12
1636465,1345588,2023-06-20,Assembly,"Do pass as amended and be re-referred to the Committee on [Appropriations]",10,0,0,1,11
1636465,1351558,2023-08-16,Assembly,"Do pass",16,0,0,0,16
1636465,1354118,2023-09-13,Assembly,"SB 33 Glazer Senate Third Reading By Dixon",80,0,0,0,80
1636465,1354859,2023-09-14,Senate,"Unfinished Business SB33 Glazer Concurrence",40,0,0,0,40
1636466,1305453,2023-04-19,Senate,"Do pass, but first be re-referred to the Committee on [Appropriations]",6,2,0,0,8
1636466,1330116,2023-05-22,Senate,"Senate 3rd Reading SB34 Umberg et al",31,7,0,2,40
1636466,1350432,2023-07-12,Assembly,"Do pass and be re-referred to the Committee on [Appropriations]",6,2,0,0,8
1636466,1350433,2023-07-12,Assembly,"Do pass and be re-referred to the Committee on [Housing and Community Development]",6,2,0,0,8
1636466,1352102,2023-08-23,Assembly,"Do pass as amended",10,4,0,2,16
1636466,1353686,2023-09-11,Assembly,"SB 34 Umberg Senate Third Reading By Ting",62,18,0,0,80
1636466,1353952,2023-09-12,Senate,"Unfinished Business SB34 Umberg et al. Concurrence",31,7,0,2,40
1636467,1305451,2023-04-19,Senate,"Do pass, but first be re-referred to the Committee on [Appropriations] with the recommendation: To Consent Calendar",11,0,0,1,12
1636467,1318956,2023-05-04,Senate,"Consent Calendar SB35 Umberg",37,0,0,3,40
1636467,1350169,2023-07-11,Assembly,"Do pass as amended and be re-referred to the Committee on [Appropriations]",10,0,0,1,11
1636467,1352108,2023-08-23,Assembly,"Do pass. To Consent Calendar",15,0,0,1,16
1636467,1353144,2023-09-05,Assembly,"Do pass and be re-referred to the Committee on [Appropriations]",11,0,0,0,11
1636467,1353535,2023-09-07,Assembly,"Do pass as amended",16,0,0,0,16
1636467,1353921,2023-09-12,Assembly,"SB 35 Umberg Third Reading Urgency By Gipson",78,0,0,2,80
1636467,1354433,2023-09-13,Senate,"That the Assembly amendments be concurred in",9,0,0,2,11
1636467,1354626,2023-09-14,Senate,"Unfinished Business SB35 Umberg Urgency Clause Concurrence",40,0,0,0,40
1636468,1275522,2023-03-14,Senate,"Do pass, but first be re-referred to the Committee on [Judiciary]",4,0,0,1,5
1636468,1305217,2023-04-18,Senate,"Do pass, but first be re-referred to the Committee on [Appropriations]",8,2,0,1,11
1636468,1315732,2023-05-01,Senate,"Placed on suspense file",6,0,0,1,7
1636469,1281792,2023-03-21,Senate,"Do pass, but first be re-referred to the Committee on [Human Services]",10,0,0,1,11
1636469,1310203,2023-04-24,Senate,"Do pass, but first be re-referred to the Committee on [Appropriations]",5,0,0,0,5
1636469,1320445,2023-05-08,Senate,"Placed on suspense file",7,0,0,0,7
1636469,1366792,2024-01-18,Senate,"Do pass as amended",4,0,0,3,7
1636469,1371105,2024-01-29,Senate,"Senate 3rd Reading SB37 Caballero et al",36,0,0,4,40
1636469,1456949,2024-06-12,Assembly,"Do pass and be re-referred to the Committee on [Aging and Long-Term Care]",9,0,0,0,9
1636469,1458153,2024-06-18,Assembly,"Do pass and be re-referred to the Committee on [Appropriations]",6,0,0,1,7
1636469,1464564,2024-08-15,Assembly,"Do pass",13,1,0,1,15
1636469,1465606,2024-08-26,Assembly,"SB 37 Caballero Senate Third Reading By Bains",74,1,0,4,79
1636470,1296932,2023-04-10,Senate,"Do pass as amended, but first amend, and re-refer to the Committee on [Appropriations]",15,0,0,3,18
1636470,1315696,2023-05-01,Senate,"Placed on suspense file",6,0,0,1,7
1636470,1327929,2023-05-18,Senate,"Do pass",7,0,0,0,7
1636470,1333549,2023-05-25,Senate,"Special Consent SB38 Laird et al",40,0,0,0,40
1636470,1350524,2023-07-12,Assembly,"Do pass and be re-referred to the Committee on [Appropriations] with recommendation: To Consent Calendar",14,0,0,1,15
1636470,1352119,2023-08-23,Assembly,"Do pass. To Consent Calendar",15,0,0,1,16
1636470,1353242,2023-09-06,Assembly,"SB 38 Laird Senate Third Reading By Addis",77,0,0,3,80
1636470,1353528,2023-09-07,Senate,"Unfinished Business SB38 Laird et al. Concurrence",40,0,0,0,40
1636471,1286895,2023-03-28,Senate,"Do pass, but first be re-referred to the Committee on [Appropriations]",9,0,0,2,11
1636471,1313478,2023-04-27,Senate,"Senate 3rd Reading SB39 Laird et al",38,0,0,2,40
1636471,1343118,2023-06-12,Assembly,"Do pass and be re-referred to the Committee on [Appropriations] with recommendation: To Consent Calendar",10,0,0,1,11
1636471,1346239,2023-06-21,Assembly,"Do pass. To Consent Calendar",13,0,0,3,16
1636471,1347873,2023-06-27,Assembly,"SB 39 Laird Consent Calendar Second Day Regular Session",78,0,0,2,80
1636472,1281912,2023-03-21,Senate,"Do pass, but first be re-referred to the Committee on [Governance and Finance]",9,1,0,1,11
1636472,1313406,2023-04-26,Senate,"Do pass, but first be re-referred to the Committee on [Appropriations]",5,2,0,1,8
1636472,1325047,2023-05-15,Senate,"Placed on suspense file",7,0,0,0,7
1636472,1328580,2023-05-18,Senate,"Do pass as amended",6,1,0,0,7
1636472,1335402,2023-05-30,Senate,"Senate 3rd Reading SB4 Wiener et al",33,2,0,5,40
1636472,1348328,2023-06-28,Assembly,"Do pass as amended and be re-referred to the Committee on [Natural Resources]",6,0,0,2,8
1636472,1350784,2023-07-10,Assembly,"Do pass as amended and be re-referred to the Committee on [Appropriations]",9,1,0,1,11
1636472,1352928,2023-09-01,Assembly,"Do pass as amended",11,0,0,5,16
1636472,1353383,2023-09-07,Assembly,"SB 4 Wiener Senate Third Reading By McKinnor",73,1,0,6,80
1636472,1354750,2023-09-11,Senate,"Unfinished Business SB4 Wiener et al. Concurrence",32,2,0,6,40
1636473,1317044,2023-05-02,Senate,"Do pass and be ordered to the Consent Calendar",10,0,0,1,11
1636473,1323831,2023-05-11,Senate,"Consent Calendar SB40 Umberg",39,0,0,1,40
1636473,1350220,2023-07-11,Assembly,"Do pass as amended",8,3,0,0,11
1636473,1353723,2023-09-12,Assembly,"SB 40 Umberg Senate Third Reading By Maienschein",60,14,0,6,80
1636473,1354397,2023-09-13,Senate,"Unfinished Business SB40 Umberg Concurrence",31,8,0,1,40
1636474,1247344,2023-02-09,Senate,"Do pass, but first be re-referred to the Committee on [Judiciary]",5,0,0,0,5
1636474,1251052,2023-02-14,Senate,"Do pass, but first be re-referred to the Committee on [Appropriations]",10,0,0,1,11
1636474,1263005,2023-02-27,Senate,"Senate 3rd Reading SB41 Cortese Urgency Clause",37,0,0,3,40
1636474,1275557,2023-03-14,Assembly,"Do pass",6,0,0,1,7
1636474,1277633,2023-03-16,Assembly,"SB 41 Cortese Third Reading Urgency By Kalra",73,0,0,7,80
1636475,1317065,2023-05-02,Senate,"Do pass",10,0,0,1,11
1636475,1324936,2023-05-15,Senate,"Senate 3rd Reading SB42 Umberg",38,0,0,2,40
1636475,1462262,2024-07-02,Assembly,"Do pass as amended and be re-referred to the Committee on [Appropriations]",11,0,0,1,12
1636475,1464408,2024-08-15,Assembly,"Do pass as amended",11,0,0,4,15
1636475,1466308,2024-08-29,Assembly,"SB 42 Umberg Third Reading Urgency By Gipson",75,0,0,4,79
1636475,1467008,2024-08-31,Senate,"Unfinished Business SB42 Umberg Urgency Clause Concurrence",40,0,0,0,40
1636476,1288372,2023-03-29,Senate,"Do pass as amended, but first amend, and re-refer to the Committee on [Judiciary]",12,0,0,0,12
1636476,1311816,2023-04-25,Senate,"Do pass as amended, but first amend, and re-refer to the Committee on [Appropriations]",11,0,0,0,11
1636476,1320387,2023-05-08,Senate,"Placed on suspense file",7,0,0,0,7
1636476,1328825,2023-05-18,Senate,"Do pass",7,0,0,0,7
1636476,1334450,2023-05-26,Senate,"Senate 3rd Reading SB43 Eggman et al",37,0,0,3,40
1636476,1347841,2023-06-27,Assembly,"Do pass and be re-referred to the Committee on [Judiciary]",15,0,0,0,15
1636476,1350212,2023-07-11,Assembly,"Do pass as amended and be re-referred to the Committee on [Appropriations]",8,0,0,3,11
1636476,1352512,2023-09-01,Assembly,"Do pass as amended",11,0,0,5,16
1636476,1354823,2023-09-14,Senate,"Unfinished Business SB43 Eggman et al. Concurrence",40,0,0,0,40
1636476,1354824,2023-09-14,Assembly,"SB 43 Eggman Senate Third Reading By Maienschein",75,0,0,5,80
1636477,1288370,2023-03-28,Senate,"Do pass, but first be re-referred to the Committee on [Appropriations]",1,0,0,4,5
1636477,1288371,2023-03-28,Senate,"[First] hearing set for [03-29-2023]: Failed passage in Committee. Reconsideration granted",5,0,0,0,5
1636477,1310298,2023-04-25,Senate,"Do pass, but first be re-referred to the Committee on [Appropriations]",1,0,0,4,5
1636478,1281850,2023-03-22,Senate,"Do pass, but first be re-referred to the Committee on [Appropriations] with the recommendation: To Consent Calendar",11,0,0,1,12
1636478,1296961,2023-04-10,Senate,"Placed on suspense file",7,0,0,0,7
1636478,1328786,2023-05-18,Senate,"Do pass as amended",7,0,0,0,7
1636478,1335426,2023-05-30,Senate,"Special Consent SB45 Roth",40,0,0,0,40
1636478,1347937,2023-06-27,Assembly,"Do pass as amended, and be re-referred to the Committee on [Appropriations] with recommendation: To Consent Calendar",15,0,0,0,15
1636479,1275561,2023-03-14,Senate,"Do pass as amended, but first amend, and re-refer to the Committee on [Appropriations]",4,0,0,1,5
1636479,1302567,2023-04-17,Senate,"Placed on suspense file",6,0,0,1,7
1636479,1328622,2023-05-18,Senate,"Do pass as amended",7,0,0,0,7
1636479,1335505,2023-05-30,Senate,"Senate 3rd Reading SB46 Roth et al",40,0,0,0,40
1636479,1348374,2023-06-27,Assembly,"Do pass as amended, and be re-referred to the Committee on [Appropriations] with recommendation: To Consent Calendar",8,0,0,0,8
1636479,1352962,2023-09-01,Assembly,"Do pass",16,0,0,0,16
1636479,1353642,2023-09-11,Assembly,"SB 46 Roth Senate Third Reading By Cervantes",80,0,0,0,80
1636479,1353767,2023-09-12,Senate,"Unfinished Business SB46 Roth et al. Concurrence",38,0,0,2,40
1636481,1296996,2023-04-10,Senate,"Do pass as amended, but first amend, and re-refer to the Committee on [Environmental Quality]",12,3,0,3,18
1636481,1315646,2023-05-01,Senate,"Placed on suspense file",6,0,0,1,7
1636481,1328277,2023-05-18,Senate,"Do pass as amended",5,2,0,0,7
1636481,1332584,2023-05-24,Senate,"Senate 3rd Reading SB48 Becker",31,9,0,0,40
1636481,1348479,2023-06-28,Assembly,"Do pass as amended and be re-referred to the Committee on [Natural Resources]",10,3,0,2,15
1636481,1350774,2023-07-10,Assembly,"Do pass and be re-referred to the Committee on [Appropriations]",8,2,0,1,11
1636481,1352544,2023-09-01,Assembly,"Do pass as amended",11,4,0,1,16
1636481,1354425,2023-09-13,Assembly,"SB 48 Becker Senate Third Reading By Haney",57,17,0,6,80
1636481,1354790,2023-09-14,Senate,"Unfinished Business SB48 Becker Concurrence",31,9,0,0,40
1636482,1299401,2023-04-11,Senate,"Do pass, but first be re-referred to the Committee on [Governance and Finance]",16,0,0,0,16
1636482,1320459,2023-05-08,Senate,"Placed on suspense file",7,0,0,0,7
1636482,1327965,2023-05-18,Senate,"Do pass",7,0,0,0,7
1636482,1333818,2023-05-25,Senate,"Special Consent SB49 Becker",40,0,0,0,40
1636482,1348431,2023-06-28,Assembly,"Do pass as amended, and be re-referred to the Committee on [Revenue and Taxation] with recommendation: To Consent Calendar",14,0,0,1,15
1636482,1350288,2023-07-10,Assembly,"Do pass as amended and be re-referred to the Committee on [Appropriations]",10,0,0,1,11
1636482,1352720,2023-09-01,Assembly,"Do pass as amended",11,0,0,5,16
1636482,1354196,2023-09-13,Assembly,"SB 49 Becker Senate Third Reading By Connolly",79,0,0,1,80
1636482,1354821,2023-09-14,Senate,"Unfinished Business SB49 Becker Concurrence",40,0,0,0,40
1636483,1318023,2023-05-03,Senate,"Do pass, but first be re-referred to the Committee on [Appropriations]",2,2,0,4,8
1636483,1318024,2023-05-03,Senate,"[First] hearing set for [05-03-2023]: Failed passage in Committee. Reconsideration granted",7,0,0,1,8
1636484,1288184,2023-03-28,Senate,"Do pass as amended, but first amend, and re-refer to the Committee on [Appropriations]",4,1,0,0,5
1636484,1302670,2023-04-17,Senate,"Placed on suspense file",6,0,0,1,7
1636484,1328850,2023-05-18,Senate,"Do pass as amended",5,2,0,0,7
1636484,1335423,2023-05-30,Senate,"Senate 3rd Reading SB50 Bradford et al",22,11,0,7,40
1636484,1350124,2023-07-11,Assembly,"Do pass and be re-referred to the Committee on [Appropriations]",6,2,0,0,8
1636484,1352833,2023-09-01,Assembly,"Do pass as amended",10,5,0,1,16
1636485,1285682,2023-03-27,Senate,"Do pass, but first be re-referred to the Committee on [Appropriations]",11,0,0,2,13
1636485,1296926,2023-04-10,Senate,"Placed on suspense file",7,0,0,0,7
1636485,1328602,2023-05-18,Senate,"Do pass",5,2,0,0,7
1636485,1336360,2023-05-31,Senate,"Senate 3rd Reading SB51 Bradford Urgency Clause",34,3,0,3,40
1636485,1350321,2023-07-11,Assembly,"Do pass as amended and be re-referred to the Committee on [Appropriations]",17,0,0,2,19
1636485,1352564,2023-09-01,Assembly,"Do pass",12,1,0,3,16
1636485,1353661,2023-09-11,Assembly,"SB 51 Bradford Senate Third Reading By McCarty",70,4,0,6,80
1636485,1354189,2023-09-13,Senate,"Unfinished Business SB51 Bradford et al. Concurrence",35,3,0,2,40
1636486,1305417,2023-04-18,Senate,"Do pass, but first be re-referred to the Committee on [Governance and Finance]",4,1,0,2,7
1636486,1305418,2023-04-18,Senate,"[04-19-2023] set for [First] hearing: Reconsideration of favorable vote granted",7,0,0,0,7
1636486,1305419,2023-04-18,Senate,"Do pass, but first be re-referred to the Committee on [Governance and Finance]",6,0,0,1,7
1636486,1313359,2023-04-26,Senate,"Do pass, but first be re-referred to the Committee on [Appropriations]",6,2,0,0,8
1636486,1320391,2023-05-08,Senate,"Placed on suspense file",7,0,0,0,7
1636486,1328000,2023-05-18,Senate,"Do pass",5,2,0,0,7
1636486,1330086,2023-05-22,Senate,"Senate 3rd Reading SB52 Durazo et al",32,7,0,1,40
1636486,1349634,2023-07-05,Assembly,"Do pass as amended and be re-referred to the Committee on [Local Government]",6,1,0,1,8
1636486,1350447,2023-07-12,Assembly,"Do pass and be re-referred to the Committee on [Appropriations]",6,2,0,0,8
1636486,1352696,2023-09-01,Assembly,"Do pass as amended",11,4,0,1,16
1636486,1354230,2023-09-13,Assembly,"SB 52 Durazo Senate Third Reading By Bryan",58,15,0,7,80
1636486,1354861,2023-09-14,Senate,"Unfinished Business SB52 Durazo et al. Concurrence",32,8,0,0,40
1636487,1363763,2024-01-09,Senate,"Do pass, but first be re-referred to the Committee on [Appropriations]",4,1,0,0,5
1636487,1364804,2024-01-16,Senate,"Placed on suspense file",6,0,0,1,7
1636487,1366758,2024-01-18,Senate,"Do pass",4,2,0,1,7
1636487,1371092,2024-01-29,Senate,"Senate 3rd Reading SB53 Portantino",27,9,0,4,40
1636487,1456283,2024-06-11,Assembly,"Do pass and be re-referred to the Committee on [Appropriations]",6,2,0,0,8
1636487,1464037,2024-08-15,Assembly,"Do pass as amended",11,3,0,1,15
1636487,1465468,2024-08-22,Assembly,"SB 53 Portantino Senate Third Reading By McCarty Amendment Set #1",40,16,0,23,79
1636487,1465542,2024-08-26,Assembly,"SB 53 Portantino Senate Third Reading By McCarty",51,18,0,10,79
1636487,1465920,2024-08-27,Senate,"Unfinished Business SB53 Portantino et al. Concurrence",29,11,0,0,40
1636488,1286888,2023-03-28,Senate,"Do pass, but first be re-referred to the Committee on [Appropriations] with the recommendation: To Consent Calendar",14,0,0,1,15
1636488,1296949,2023-04-10,Senate,"Placed on suspense file",7,0,0,0,7
1636489,1305362,2023-04-18,Senate,"Do pass, but first be re-referred to the Committee on [Rules]",8,1,0,2,11
1636489,1313530,2023-04-26,Senate,"Do pass as amended, but first amend, and re-refer to the Committee on [Appropriations]",6,2,0,0,8
1636489,1325024,2023-05-15,Senate,"Placed on suspense file",7,0,0,0,7
1636489,1366781,2024-01-18,Senate,"Do pass as amended",4,0,0,3,7
1636489,1371101,2024-01-29,Senate,"Senate 3rd Reading SB7 Blakespear",32,0,0,8,40
1636489,1458552,2024-06-19,Assembly,"Do pass and be re-referred to the Committee on [Local Government]",7,1,0,1,9
1636489,1460532,2024-06-26,Assembly,"Do pass and be re-referred to the Committee on [Appropriations]",6,0,0,3,9
1636489,1463762,2024-08-07,Assembly,"Do pass",10,4,0,1,15
1636489,1465679,2024-08-26,Assembly,"SB 7 Blakespear Senate Third Reading By Ward",54,16,0,9,79
1636489,1466008,2024-08-27,Senate,"That the Assembly amendments be concurred in",8,2,0,0,10
1636489,1467022,2024-08-28,Senate,"Unfinished Business SB7 Blakespear Concurrence",31,8,0,1,40
1636491,1280675,2023-03-20,Senate,"Do pass, but first be re-referred to the Committee on [Judiciary]",5,0,0,0,5
1636491,1305225,2023-04-18,Senate,"Do pass as amended, but first amend, and re-refer to the Committee on [Appropriations] with the recommendation: To Consent Calendar",11,0,0,0,11
1636491,1315718,2023-05-01,Senate,"Placed on suspense file",6,0,0,1,7
1636491,1328380,2023-05-18,Senate,"Do pass as amended",7,0,0,0,7
1636491,1335459,2023-05-30,Senate,"Senate 3rd Reading SB9 Cortese et al",40,0,0,0,40
1636491,1345635,2023-06-20,Assembly,"Do pass and be re-referred to the Committee on [Judiciary]",8,0,0,0,8
1636491,1347869,2023-06-27,Assembly,"Do pass and be re-referred to the Committee on [Appropriations] with recommendation: To Consent Calendar",11,0,0,0,11
1636492,1230248,2022-12-05,Senate,"W/O REF. TO FILE SCR1 Atkins",31,8,0,0,39
1636492,1257654,2023-02-21,Assembly,"SCR 1 Atkins Senate Third Reading By Ramos",59,16,0,5,80
1636493,1230249,2022-12-05,Senate,"W/O REF. TO FILE SCR2 Umberg",39,0,0,0,39
1636494,1346975,2023-06-22,Senate,"Special Consent SCR3 Nguyen",39,0,0,1,40
1636494,1349979,2023-07-10,Assembly,"Be adopted. To Consent Calendar",13,0,0,0,13
1636494,1351385,2023-08-14,Assembly,"SCR 3 Nguyen Consent Calendar Second Day Regular Session",74,0,0,6,80
1636495,1352961,2023-09-01,Senate,"Special Consent SCR4 Nguyen",37,0,0,3,40
1636496,1325002,2023-05-15,Senate,"Senate 3rd Reading SCR5 Nguyen",38,0,0,2,40
1636496,1334472,2023-05-26,Assembly,"Be adopted. To Consent Calendar",12,0,0,1,13
1636496,1339980,2023-05-31,Assembly,"SCR 5 Nguyen Consent Calendar Second Day Regular Session",78,0,0,2,80
1636497,1283186,2023-03-23,Senate,"Senate 3rd Reading SCR6 Umberg et al",39,0,0,1,40
1636498,1271504,2023-03-08,Senate,"Be adopted and be ordered to the Consent Calendar",5,0,0,0,5
1636498,1311656,2023-04-26,Assembly,"Be adopted. To third reading",7,0,0,0,7
1636498,1324957,2023-05-15,Assembly,"SJR 1 Cortese Senate Third Reading By Addis",76,0,0,4,80
1636498,1334439,2023-05-26,Senate,"Special Consent SJR1 Cortese et al",37,0,0,3,40
1636507,1281987,2023-03-22,Senate,"Do pass, but first be re-referred to the Committee on [Appropriations]",13,2,0,3,18
1636507,1283420,2023-03-23,Senate,"Placed on suspense file",2,5,0,0,7
1636507,1283421,2023-03-23,Senate,"Do pass",5,2,0,0,7
1636507,1283422,2023-03-23,Senate,"Senate 2nd Reading SB2 Skinner",30,8,0,2,40
1636507,1285808,2023-03-27,Assembly,"Do pass",11,4,0,0,15
1636507,1285809,2023-03-27,Assembly,"SB 2 Skinner Senate Third Reading By IRWIN Amend By PATTERSON, JOE Set #1 Lay on the Table By REYES First Extraordinary Session",59,19,0,2,80
1636507,1285810,2023-03-27,Assembly,"SB 2 Skinner Senate Third Reading By IRWIN First Extraordinary Session",58,19,0,3,80
1636977,1274180,2023-03-13,Assembly,"Do pass and be re-referred to the Committee on [Appropriations]",10,0,0,1,11
1636977,1328635,2023-05-18,Assembly,"Do pass as amended",11,2,0,3,16
1636977,1338182,2023-05-31,Assembly,"AB 57 Kalra Assembly Third Reading",66,6,0,8,80
1636977,1347810,2023-06-27,Senate,"Do pass, but first be re-referred to the Committee on [Appropriations]",10,0,0,1,11
1636977,1349951,2023-07-10,Senate,"Placed on suspense file",6,0,0,1,7
1636977,1352635,2023-09-01,Senate,"Do pass",5,2,0,0,7
1636977,1353736,2023-09-12,Assembly,"AB 57 Kalra Concurrence in Senate Amendments",68,10,0,2,80
1636977,1354872,2023-09-11,Senate,"Assembly 3rd Reading AB57 Kalra et al. By Stern",36,3,0,1,40
1636978,1311929,2023-04-26,Assembly,"Do pass and be re-referred to the Committee on [Appropriations]",5,0,0,2,7
1636978,1322879,2023-05-10,Assembly,"Do pass",12,2,0,2,16
1636978,1330093,2023-05-22,Assembly,"AB 58 Kalra Assembly Third Reading",62,7,0,11,80
1636978,1350175,2023-07-11,Senate,"Do pass, but first be re-referred to the Committee on [Appropriations]",3,1,0,1,5
1636978,1354305,2023-09-13,Assembly,"With recommendation: That Senate amendments be concurred in",5,0,0,3,8
1636978,1354306,2023-09-13,Senate,"Assembly 3rd Reading AB58 Kalra By Cortese",30,8,0,2,40
1636978,1354307,2023-09-13,Assembly,"AB 58 Kalra Concurrence in Senate Amendments",62,11,0,7,80
1636979,1317045,2023-05-01,Assembly,"Do pass and be re-referred to the Committee on [Appropriations]",11,0,0,0,11
1636980,1304251,2023-04-18,Assembly,"Do pass and be re-referred to the Committee on [Appropriations] with recommendation: To Consent Calendar",8,0,0,0,8
1636980,1322951,2023-05-10,Assembly,"Do pass. To Consent Calendar",14,0,0,2,16
1636980,1328169,2023-05-18,Assembly,"AB 60 Bryan Consent Calendar Second Day Regular Session",74,0,0,6,80
1636980,1343789,2023-06-13,Senate,"Do pass, but first be re-referred to the Committee on [Appropriations] with the recommendation: To Consent Calendar",5,0,0,0,5
1636980,1347548,2023-06-26,Senate,"Placed on suspense file",6,0,0,1,7
1636980,1352611,2023-09-01,Senate,"Do pass",7,0,0,0,7
1636980,1353929,2023-09-12,Senate,"Special Consent AB60 Bryan By Rubio",39,0,0,1,40
1636981,1270447,2023-03-07,Assembly,"Do pass as amended and be re-referred to the Committee on [Appropriations]",6,1,0,1,8
1636981,1328050,2023-05-18,Assembly,"Do pass",11,4,0,1,16
1636982,1305492,2023-04-18,Assembly,"Do pass as amended and be re-referred to the Committee on [Appropriations]",14,0,0,1,15
1636983,1288237,2023-03-29,Assembly,"Do pass as amended and be re-referred to the Committee on [Appropriations]",8,0,0,0,8
1636983,1328866,2023-05-18,Assembly,"Do pass as amended",11,0,0,5,16
1636983,1333705,2023-05-25,Assembly,"AB 63 Cervantes Assembly Third Reading",75,0,0,5,80
1636983,1345617,2023-06-20,Senate,"Do pass, but first be re-referred to the Committee on [Appropriations]",7,0,0,0,7
1636983,1349522,2023-07-03,Senate,"Placed on suspense file",7,0,0,0,7
1636983,1352585,2023-09-01,Senate,"Do pass as amended",7,0,0,0,7
1636983,1354238,2023-09-13,Senate,"Special Consent AB63 Cervantes By Laird",39,0,0,1,40
1636983,1354758,2023-09-14,Assembly,"AB 63 Cervantes Concurrence in Senate Amendments",77,0,0,3,80
1636984,1308799,2023-04-24,Assembly,"Do pass and be re-referred to the Committee on [Appropriations] with recommendation: To Consent Calendar",15,0,0,0,15
1636985,1301982,2023-04-10,Assembly,"Do pass and be re-referred to the Committee on [Utilities and Energy]",3,7,0,1,11
1636986,1286959,2023-03-28,Assembly,"Do pass as amended and be re-referred to the Committee on [Appropriations]",15,0,0,0,15
1636987,1305392,2023-04-19,Senate,"Do pass, but first be re-referred to the Committee on [Judiciary]",5,1,0,1,7
1636987,1311646,2023-04-25,Senate,"Do pass as amended, but first amend, and re-refer to the Committee on [Appropriations]",8,2,0,1,11
1636987,1320401,2023-05-08,Senate,"Placed on suspense file",7,0,0,0,7
1636987,1328225,2023-05-18,Senate,"Do pass as amended",5,2,0,0,7
1636987,1333592,2023-05-25,Senate,"Senate 3rd Reading SB54 Skinner et al",32,6,0,2,40
1636987,1347541,2023-06-26,Assembly,"Do pass as amended and be re-referred to the Committee on [Judiciary]",8,1,0,3,12
1636987,1349660,2023-07-05,Assembly,"Do pass as amended and be re-referred to the Committee on [Appropriations]",8,2,0,1,11
1636987,1352606,2023-09-01,Assembly,"Do pass as amended",11,4,0,1,16
1636987,1353306,2023-09-06,Assembly,"SB 54 Skinner Senate Third Reading By Bryan",60,15,0,5,80
1636987,1353395,2023-09-07,Senate,"Unfinished Business SB54 Skinner et al. Concurrence",32,8,0,0,40
1636988,1299542,2023-04-11,Senate,"Do pass, but first be re-referred to the Committee on [Public Safety]",15,0,0,1,16
1636988,1310229,2023-04-25,Senate,"Do pass, but first be re-referred to the Committee on [Appropriations]",5,0,0,0,5
1636988,1330089,2023-05-22,Senate,"Senate 3rd Reading SB55 Umberg et al",39,0,0,1,40
1636988,1347902,2023-06-26,Assembly,"Do pass and be re-referred to the Committee on [Public Safety] with recommendation: To Consent Calendar",15,0,0,0,15
1636988,1351588,2023-08-16,Assembly,"Do pass. To Consent Calendar",15,0,0,1,16
1636988,1352235,2023-08-24,Assembly,"SB 55 Umberg Consent Calendar Second Day Regular Session",73,0,0,7,80
1636988,1353423,2023-09-07,Senate,"Special Consent SB55 Umberg et al",40,0,0,0,40
1637227,1251020,2023-02-14,Assembly,"Do pass and be re-referred to the Committee on [Judiciary] with recommendation: To Consent Calendar",8,0,0,0,8
1637227,1280633,2023-03-21,Assembly,"Do pass and be re-referred to the Committee on [Appropriations]",9,0,0,2,11
1637227,1328023,2023-05-18,Assembly,"Do pass",13,1,0,2,16
1637227,1338125,2023-05-31,Assembly,"AB 67 Muratsuchi Assembly Third Reading",68,7,0,5,80
1637227,1350156,2023-07-11,Senate,"Do pass, but first be re-referred to the Committee on [Appropriations]",4,0,0,1,5
1637227,1352351,2023-08-28,Senate,"Placed on suspense file",7,0,0,0,7
1637228,1363942,2024-01-10,Senate,"Do pass, but first be re-referred to the Committee on [Appropriations]",7,0,0,0,7
1637228,1367513,2024-01-22,Senate,"Senate 3rd Reading SB56 Skinner",39,0,0,1,40
1637228,1458200,2024-06-18,Assembly,"Do pass and be re-referred to the Committee on [Appropriations]",8,0,0,3,11
1637228,1463720,2024-08-07,Assembly,"Do pass. To Consent Calendar",14,0,0,1,15
1637228,1464057,2024-08-15,Assembly,"SB 56 Skinner Consent Calendar Second Day",75,0,0,4,79
1637228,1465448,2024-08-22,Senate,"Special Consent SB56 Skinner",33,0,0,7,40
1637229,1325018,2023-05-15,Senate,"Senate 3rd Reading SCR7 Nguyen",38,0,0,2,40
1637229,1334442,2023-05-26,Assembly,"Be adopted. To Consent Calendar",12,0,0,1,13
1637229,1340057,2023-05-31,Assembly,"SCR 7 Nguyen Consent Calendar Second Day Regular Session",78,0,0,2,80
1637230,1302647,2023-04-17,Senate,"Senate 3rd Reading SCR8 Nguyen et al",37,0,0,3,40
1637230,1318950,2023-05-04,Assembly,"Be adopted. To Consent Calendar",12,0,0,1,13
1637230,1323800,2023-05-11,Assembly,"SCR 8 Nguyen Consent Calendar Second Day Regular Session",66,0,0,14,80
1638405,1276654,2023-03-14,Assembly,"Do pass and be re-referred to the Committee on [Judiciary]",13,0,0,2,15
1638405,1280701,2023-03-21,Assembly,"Do pass and be re-referred to the Committee on [Appropriations]",11,0,0,0,11
1638405,1328454,2023-05-18,Assembly,"Do pass",15,0,0,1,16
1638405,1333681,2023-05-25,Assembly,"AB 70 Rodriguez Assembly Third Reading",78,0,0,2,80
1638405,1344223,2023-06-14,Senate,"Do pass, but first be re-referred to the Committee on [Judiciary] with the recommendation: To Consent Calendar",12,0,0,0,12
1638405,1348421,2023-06-27,Senate,"Do pass, but first be re-referred to the Committee on [Appropriations] with the recommendation: To Consent Calendar",11,0,0,0,11
1638405,1353210,2023-09-06,Senate,"Assembly 3rd Reading AB70 Rodriguez By Wilk",40,0,0,0,40
1638405,1353645,2023-09-11,Assembly,"AB 70 Rodriguez Concurrence in Senate Amendments",80,0,0,0,80
1638406,1301072,2023-04-12,Assembly,"Do pass as amended and be re-referred to the Committee on [Appropriations]",7,0,0,0,7
1638406,1318068,2023-05-03,Assembly,"Do pass. To Consent Calendar",16,0,0,0,16
1638406,1323853,2023-05-11,Assembly,"AB 71 Rodriguez Consent Calendar Second Day Regular Session",66,0,0,14,80
1638406,1346264,2023-06-21,Senate,"Do pass as amended, but first amend, and re-refer to the Committee on [Appropriations]",7,0,0,0,7
1638406,1349911,2023-07-10,Senate,"Placed on suspense file",6,0,0,1,7
1638548,1274194,2023-03-13,Assembly,"Do pass and be re-referred to the Committee on [Appropriations]",11,0,0,0,11
1638548,1281844,2023-03-22,Assembly,"Do pass",15,0,0,1,16
1638548,1296917,2023-04-10,Assembly,"AB 72 Boerner Horvath Assembly Third Reading",68,0,0,12,80
1638548,1344190,2023-06-14,Senate,"Do pass, but first be re-referred to the Committee on [Appropriations] with the recommendation: To Consent Calendar",7,0,0,0,7
1638548,1348887,2023-06-29,Senate,"Consent Calendar AB72 Boerner et al",39,0,0,1,40
1638548,1349534,2023-07-03,Assembly,"AB 72 Boerner Concurrence in Senate Amendments",67,0,0,13,80
1638549,1310266,2023-04-24,Assembly,"Do pass and be re-referred to the Committee on [Appropriations]",10,3,0,2,15
1638549,1326915,2023-05-17,Assembly,"Do pass",12,4,0,0,16
1638549,1338165,2023-05-31,Assembly,"AB 73 Boerner Assembly Third Reading",56,17,0,7,80
1638551,1231898,2023-01-13,Senate,"Senate 3rd Reading SR6 Grove",36,0,0,4,40
1638684,1264455,2023-02-28,Assembly,"Do pass and be re-referred to the Committee on [Appropriations]",2,6,0,0,8
1638685,1251050,2023-02-14,Assembly,"Do pass and be re-referred to the Committee on [Appropriations]",8,0,0,0,8
1638685,1328491,2023-05-18,Assembly,"Do pass",15,0,0,1,16
1638685,1338139,2023-05-31,Assembly,"AB 76 Davies Assembly Third Reading",80,0,0,0,80
1638685,1350249,2023-07-11,Senate,"Do pass, but first be re-referred to the Committee on [Appropriations] with the recommendation: To Consent Calendar",4,0,0,1,5
1638685,1351325,2023-08-14,Senate,"Placed on suspense file",7,0,0,0,7
1638686,1288307,2023-03-28,Assembly,"Do pass as amended and be re-referred to the Committee on [Appropriations]",14,0,0,1,15
1639062,1264458,2023-02-28,Assembly,"Do pass and be re-referred to the Committee on [Appropriations]",6,2,0,0,8
1639064,1301999,2023-04-10,Assembly,"Do pass as amended and be re-referred to the Committee on [Appropriations]",11,0,0,0,11
1639064,1328772,2023-05-18,Assembly,"Do pass",15,0,0,1,16
1639064,1333775,2023-05-25,Assembly,"AB 80 Addis Assembly Third Reading",78,0,0,2,80
1639064,1349985,2023-07-10,Senate,"Do pass, but first be re-referred to the Committee on [Appropriations]",8,0,0,3,11
1639064,1351453,2023-08-14,Senate,"Placed on suspense file",7,0,0,0,7
1639065,1286991,2023-03-28,Assembly,"Do pass",9,0,0,2,11
1639065,1306788,2023-04-20,Assembly,"AB 81 Ramos Assembly Third Reading",75,0,0,5,80
1639065,1350558,2023-07-11,Senate,"Do pass and be ordered to the Consent Calendar",11,0,0,0,11
1639065,1463941,2024-08-13,Senate,"That the measure be returned to Senate Floor for consideration. Ordered to third reading",9,0,0,2,11
1639065,1466001,2024-08-27,Senate,"Assembly 3rd Reading AB81 Ramos et al. By Lim√≥n Urgency Clause",38,0,0,2,40
1639065,1466692,2024-08-28,Assembly,"AB 81 Ramos Concurrence - Urgency Added",77,0,0,2,79
1639066,1363751,2024-01-09,Assembly,"Do pass and be re-referred to the Committee on [Judiciary]",13,0,0,3,16
1639066,1364117,2024-01-11,Assembly,"Do pass and be re-referred to the Committee on [Appropriations]",9,0,0,2,11
1639066,1366770,2024-01-18,Assembly,"Do pass",13,1,0,2,16
1639066,1371091,2024-01-29,Assembly,"AB 82 Weber Assembly Third Reading",63,2,0,15,80
1639066,1454243,2024-06-05,Senate,"Do pass, but first be re-referred to the Committee on [Judiciary]",9,0,0,2,11
1639066,1460785,2024-06-25,Senate,"Do pass, but first be re-referred to the Committee on [Appropriations]",10,0,0,1,11
1639066,1463559,2024-08-05,Senate,"Placed on suspense file",7,0,0,0,7
1639067,1241828,2023-02-02,Senate,"Special Consent ACR1 Wilson et al",36,0,0,4,40
1639202,1276663,2023-03-15,Assembly,"Do pass and be re-referred to the Committee on [Appropriations]",5,2,0,1,8
1639202,1328794,2023-05-18,Assembly,"Do pass",11,4,0,1,16
1639203,1288361,2023-03-29,Assembly,"Do pass and be re-referred to the Committee on [Revenue and Taxation]",8,0,0,0,8
1639203,1317033,2023-05-01,Assembly,"Do pass as amended and be re-referred to the Committee on [Appropriations]",11,0,0,0,11
1639203,1328157,2023-05-18,Assembly,"Do pass as amended",11,0,0,5,16
1639203,1333546,2023-05-25,Assembly,"AB 84 Ward Assembly Third Reading",73,0,0,7,80
1639203,1350664,2023-07-12,Senate,"Do pass as amended, but first amend, and re-refer to the Committee on [Appropriations]",8,0,0,0,8
1639203,1351394,2023-08-14,Senate,"Placed on suspense file",7,0,0,0,7
1639203,1352834,2023-09-01,Senate,"Do pass",7,0,0,0,7
1639203,1353986,2023-09-12,Senate,"Special Consent AB84 Ward By Skinner",39,0,0,1,40
1639203,1354292,2023-09-13,Assembly,"AB 84 Ward Concurrence in Senate Amendments",80,0,0,0,80
1639204,1310197,2023-04-25,Assembly,"Do pass and be re-referred to the Committee on [Appropriations]",12,0,0,3,15
1639204,1328579,2023-05-18,Assembly,"Do pass as amended",11,1,0,4,16
1639204,1333754,2023-05-25,Assembly,"AB 85 Weber Assembly Third Reading",61,0,0,19,80
1639204,1348818,2023-06-28,Senate,"Do pass as amended, but first amend, and re-refer to the Committee on [Appropriations]",10,0,0,2,12
1639204,1349930,2023-07-10,Senate,"Placed on suspense file",6,0,0,1,7
1639204,1353013,2023-09-01,Senate,"Do pass as amended",5,1,0,1,7
1639204,1354294,2023-09-13,Senate,"Assembly 3rd Reading AB85 Weber By Hurtado",30,7,0,3,40
1639204,1354671,2023-09-14,Assembly,"AB 85 Weber Concurrence in Senate Amendments",65,1,0,14,80
1639205,1232410,2023-01-17,Assembly,"Be adopted. To Consent Calendar",12,0,0,1,13
1639205,1233555,2023-01-19,Assembly,"ACR 2 Weber Consent Calendar Second Day",70,0,0,10,80
1639205,1247336,2023-02-09,Senate,"Special Consent ACR2 Weber et al",38,0,0,2,40
1639207,1280660,2023-03-21,Senate,"Do pass, but first be re-referred to the Committee on [Appropriations]",3,1,0,1,5
1639207,1332623,2023-05-24,Senate,"Senate 3rd Reading SB58 Wiener et al",21,16,0,3,40
1639207,1348436,2023-06-27,Assembly,"Do pass as amended and be re-referred to the Committee on [Health]",5,2,0,1,8
1639207,1350231,2023-07-11,Assembly,"Do pass as amended and be re-referred to the Committee on [Appropriations]",9,2,0,4,15
1639207,1353029,2023-09-01,Assembly,"Do pass as amended",9,3,0,4,16
1639207,1353214,2023-09-06,Assembly,"SB 58 Wiener Senate Third Reading By Wilson",43,15,0,22,80
1639207,1353441,2023-09-07,Senate,"Unfinished Business SB58 Wiener et al. Concurrence",21,14,0,5,40
1639479,1275544,2023-03-14,Senate,"Do pass, but first be re-referred to the Committee on [Health]",9,0,0,6,15
1639479,1288188,2023-03-29,Senate,"Do pass, but first be re-referred to the Committee on [Appropriations]",10,1,0,1,12
1639479,1302580,2023-04-17,Senate,"Placed on suspense file",6,0,0,1,7
1639479,1366771,2024-01-18,Senate,"Do pass as amended",4,0,0,3,7
1639479,1371102,2024-01-29,Senate,"Senate 3rd Reading SB59 Skinner et al",32,0,0,8,40
1639479,1458172,2024-06-17,Assembly,"Do pass and be re-referred to the Committee on [Utilities and Energy]",11,4,0,0,15
1639479,1462030,2024-07-01,Assembly,"Do pass as amended and be re-referred to the Committee on [Appropriations]",12,3,0,1,16
1639479,1464315,2024-08-15,Assembly,"Do pass as amended",11,3,0,1,15
1639479,1466549,2024-08-30,Assembly,"SB 59 Skinner Senate Third Reading By Irwin",58,14,0,7,79
1639479,1466936,2024-08-31,Senate,"Unfinished Business SB59 Skinner et al. Concurrence",30,9,0,1,40
1639796,1288258,2023-03-28,Senate,"Do pass, but first be re-referred to the Committee on [Appropriations]",10,0,0,1,11
1639796,1302682,2023-04-17,Senate,"Placed on suspense file",6,0,0,1,7
1639796,1328196,2023-05-18,Senate,"Do pass",7,0,0,0,7
1639796,1332617,2023-05-24,Senate,"Senate 3rd Reading SB60 Umberg",39,0,0,1,40
1639796,1343785,2023-06-13,Assembly,"Do pass and be re-referred to the Committee on [Judiciary]",10,0,0,1,11
1639796,1347875,2023-06-27,Assembly,"Do pass and be re-referred to the Committee on [Appropriations]",11,0,0,0,11
1639796,1352725,2023-09-01,Assembly,"Do pass",16,0,0,0,16
1639796,1353542,2023-09-07,Assembly,"SB 60 Umberg Senate Third Reading By Bauer-Kahan",79,0,0,1,80
1639796,1354665,2023-09-11,Senate,"Unfinished Business SB60 Umberg et al. Concurrence",39,0,0,1,40
1639797,1281838,2023-03-22,Senate,"Do pass, but first be re-referred to the Committee on [Appropriations] with the recommendation: To Consent Calendar",7,0,0,0,7
1639797,1296895,2023-04-10,Senate,"Placed on suspense file",7,0,0,0,7
1639797,1328289,2023-05-18,Senate,"Do pass as amended",7,0,0,0,7
1639797,1335539,2023-05-30,Senate,"Special Consent SB61 Dodd et al",40,0,0,0,40
1639797,1348308,2023-06-27,Assembly,"Do pass and be re-referred to the Committee on [Appropriations] with recommendation: To Consent Calendar",11,0,0,1,12
1642302,1233556,2023-01-19,Senate,"Senate 3rd Reading SCR9 Dodd",35,0,0,5,40
1642302,1241836,2023-02-02,Assembly,"Be adopted. To Consent Calendar",13,0,0,0,13
1642302,1247347,2023-02-09,Assembly,"SCR 9 Dodd Consent Calendar Second Day Regular Session",74,0,0,6,80
1643403,1305316,2023-04-19,Assembly,"Do pass as amended and be re-referred to the Committee on [Appropriations]",8,0,0,0,8
1643403,1328872,2023-05-18,Assembly,"Do pass",14,0,0,2,16
1643403,1337915,2023-05-31,Assembly,"AB 86 Jones-Sawyer Assembly Third Reading",79,0,0,1,80
1643403,1349614,2023-07-03,Senate,"Do pass, but first be re-referred to the Committee on [Housing]",4,0,0,1,5
1643403,1350178,2023-07-10,Senate,"Do pass, but first be re-referred to the Committee on [Appropriations]",10,0,0,1,11
1643403,1351440,2023-08-14,Senate,"Placed on suspense file",7,0,0,0,7
1643404,1283164,2023-03-22,Assembly,"Do pass as amended. To Consent Calendar",7,0,0,0,7
1643404,1296914,2023-04-10,Assembly,"AB 87 Quirk-Silva Consent Calendar Second Day",65,0,0,15,80
1643404,1341019,2023-06-07,Senate,"Do pass, but first be re-referred to the Committee on [Judiciary] with the recommendation: To Consent Calendar",7,0,0,0,7
1643404,1348318,2023-06-27,Senate,"Do pass and be ordered to the Consent Calendar",11,0,0,0,11
1643404,1349790,2023-07-06,Senate,"Consent Calendar AB87 Quirk-Silva",40,0,0,0,40
1643405,1251043,2023-02-14,Assembly,"Do pass and be re-referred to the Committee on [Appropriations]",8,0,0,0,8
1643405,1328906,2023-05-18,Assembly,"Do pass",15,0,0,1,16
1643405,1334445,2023-05-26,Assembly,"AB 88 Sanchez Assembly Third Reading",77,0,0,3,80
1643405,1347883,2023-06-27,Senate,"Do pass, but first be re-referred to the Committee on [Appropriations]",5,0,0,0,5
1643405,1354708,2023-09-14,Senate,"Assembly 3rd Reading AB88 Sanchez et al. By Alvarado-Gil",40,0,0,0,40
1643405,1354709,2023-09-14,Assembly,"AB 88 Sanchez Concurrence in Senate Amendments",79,0,0,1,80
1643406,1251037,2023-02-14,Assembly,"Do pass as amended and be re-referred to the Committee on [Appropriations]",6,0,0,2,8
1643406,1328095,2023-05-18,Assembly,"Do pass",15,0,0,1,16
1643406,1334470,2023-05-26,Assembly,"AB 89 Sanchez Assembly Third Reading",76,0,0,4,80
1643406,1345672,2023-06-20,Senate,"Do pass, but first be re-referred to the Committee on [Appropriations]",4,0,0,1,5
1643406,1349536,2023-07-03,Senate,"Placed on suspense file",7,0,0,0,7
1643407,1288395,2023-03-28,Senate,"Do pass, but first be re-referred to the Committee on [Appropriations]",1,2,0,2,5
1643407,1288396,2023-03-28,Senate,"[First] hearing set for [03-29-2023]: Failed passage in Committee. Reconsideration granted",5,0,0,0,5
1643408,1288389,2023-03-28,Senate,"Do pass, but first be re-referred to the Committee on [Appropriations]",5,0,0,0,5
1643408,1302642,2023-04-17,Senate,"Placed on suspense file",6,0,0,1,7
1643409,1288259,2023-03-28,Senate,"Do pass, but first be re-referred to the Committee on [Appropriations]",5,0,0,0,5
1643409,1296915,2023-04-10,Senate,"Placed on suspense file",7,0,0,0,7
1643410,1281806,2023-03-22,Senate,"Do pass, but first be re-referred to the Committee on [Appropriations] with the recommendation: To Consent Calendar",11,0,0,1,12
1643410,1296901,2023-04-10,Senate,"Placed on suspense file",7,0,0,0,7
1643411,1231897,2023-01-13,Senate,"Senate 3rd Reading SCR10 Min et al",36,0,0,4,40
1643411,1236692,2023-01-26,Assembly,"Be adopted. To Consent Calendar",13,0,0,0,13
1643411,1241826,2023-02-02,Assembly,"SCR 10 Min Consent Calendar Second Day Regular Session",73,0,0,7,80
1643412,1238203,2023-01-30,Senate,"Senate 3rd Reading SR7 Min et al",38,0,0,2,40
1644449,1280690,2023-03-21,Assembly,"Do pass and be re-referred to the Committee on [Appropriations]",13,0,0,2,15
1644449,1328490,2023-05-18,Assembly,"Do pass",15,0,0,1,16
1644449,1333685,2023-05-25,Assembly,"AB 90 Petrie-Norris Assembly Third Reading",78,0,0,2,80
1644450,1281924,2023-03-21,Assembly,"Do pass and be re-referred to the Committee on [Appropriations]",8,2,0,2,12
1644450,1328589,2023-05-18,Assembly,"Do pass",11,3,0,2,16
1644450,1338195,2023-05-31,Assembly,"AB 91 Alvarez Assembly Third Reading",65,8,0,7,80
1644450,1348441,2023-06-28,Senate,"Do pass as amended, but first amend, and re-refer to the Committee on [Appropriations]",6,0,0,1,7
1644450,1351444,2023-08-14,Senate,"Placed on suspense file",7,0,0,0,7
1644450,1353053,2023-09-01,Senate,"Do pass as amended",5,2,0,0,7
1644450,1353480,2023-09-07,Senate,"Assembly 3rd Reading AB91 Alvarez et al. By Padilla",33,6,0,1,40
1644450,1353673,2023-09-11,Assembly,"AB 91 Alvarez Concurrence in Senate Amendments",64,12,0,4,80
1644451,1264448,2023-02-28,Assembly,"Do pass as amended and be re-referred to the Committee on [Appropriations]",7,0,0,1,8
1644451,1328415,2023-05-18,Assembly,"Do pass",11,3,0,2,16
1644451,1330099,2023-05-22,Assembly,"AB 92 Connolly Assembly Third Reading",58,13,0,9,80
1644451,1345584,2023-06-20,Senate,"Do pass, but first be re-referred to the Committee on [Appropriations]",5,0,0,0,5
1644451,1349531,2023-07-03,Senate,"Placed on suspense file",7,0,0,0,7
1644451,1352624,2023-09-01,Senate,"Do pass as amended",5,2,0,0,7
1644451,1354229,2023-09-13,Senate,"Assembly 3rd Reading AB92 Connolly et al. By Umberg",30,7,0,3,40
1644451,1354738,2023-09-14,Assembly,"AB 92 Connolly Concurrence in Senate Amendments",62,12,0,6,80
1644452,1232408,2023-01-17,Assembly,"Be adopted. To third reading",12,0,0,1,13
1644454,1305237,2023-04-19,Senate,"Do pass as amended, but first amend, and re-refer to the Committee on [Public Safety]",11,0,0,1,12
1644454,1320408,2023-05-08,Senate,"Placed on suspense file",7,0,0,0,7
1644454,1328664,2023-05-18,Senate,"Do pass",7,0,0,0,7
1644454,1333615,2023-05-25,Senate,"Special Consent SB67 Seyarto",40,0,0,0,40
1644454,1348324,2023-06-27,Assembly,"Do pass and be re-referred to the Committee on [Health] with recommendation: To Consent Calendar",8,0,0,0,8
1644454,1350200,2023-07-11,Assembly,"Do pass and be re-referred to the Committee on [Appropriations] with recommendation: To Consent Calendar",15,0,0,0,15
1644454,1352897,2023-09-01,Assembly,"Do pass",16,0,0,0,16
1644454,1353636,2023-09-11,Assembly,"SB 67 Seyarto Senate Third Reading By Waldron",80,0,0,0,80
1644454,1354080,2023-09-13,Senate,"Unfinished Business SB67 Seyarto et al. Concurrence",39,0,0,1,40
1644455,1299451,2023-04-11,Senate,"Do pass, but first be re-referred to the Committee on [Appropriations] with the recommendation: To Consent Calendar",16,0,0,0,16
1644455,1308809,2023-04-24,Senate,"Do pass",7,0,0,0,7
1644455,1323801,2023-05-11,Senate,"Special Consent SB68 McGuire",39,0,0,1,40
1644455,1349649,2023-07-05,Assembly,"Do pass and be re-referred to the Committee on [Appropriations] with recommendation: To Consent Calendar",15,0,0,0,15
1644455,1351567,2023-08-16,Assembly,"Do pass. To Consent Calendar",15,0,0,1,16
1644455,1353246,2023-09-06,Assembly,"SB 68 McGuire Senate Third Reading By Connolly",79,0,0,1,80
1644455,1354201,2023-09-13,Senate,"Unfinished Business SB68 McGuire Concurrence",39,0,0,1,40
1644456,1276629,2023-03-15,Senate,"Do pass as amended, but first amend, and re-refer to the Committee on [Judiciary]",5,0,0,2,7
1644456,1299457,2023-04-11,Senate,"Do pass, but first be re-referred to the Committee on [Appropriations]",9,0,0,2,11
1644456,1308788,2023-04-24,Senate,"Placed on suspense file",7,0,0,0,7
1644456,1328024,2023-05-18,Senate,"Do pass as amended",5,1,0,1,7
1644456,1335533,2023-05-30,Senate,"Senate 3rd Reading SB69 Cortese et al",40,0,0,0,40
1644456,1350787,2023-07-10,Assembly,"Do pass as amended and be re-referred to the Committee on [Appropriations]",11,0,0,0,11
1644456,1352865,2023-09-01,Assembly,"Do pass",16,0,0,0,16
1644456,1353248,2023-09-06,Assembly,"SB 69 Cortese Senate Third Reading By Boerner",73,0,0,7,80
1644456,1353389,2023-09-07,Senate,"Unfinished Business SB69 Cortese et al. Concurrence",40,0,0,0,40
1644457,1352526,2023-09-01,Senate,"Special Consent SCR11 Nguyen",37,0,0,3,40
1644458,1231899,2023-01-13,Senate,"Senate 3rd Reading SCR12 Bradford et al",34,0,0,6,40
1644458,1260544,2023-02-23,Assembly,"Be adopted. To Consent Calendar",13,0,0,0,13
1644458,1267512,2023-03-02,Assembly,"SCR 12 Bradford Consent Calendar Second Day Regular Session",71,0,0,9,80
1649612,1283120,2023-03-23,Assembly,"AB 100 Ting Assembly Third Reading",60,14,0,6,80
1649612,1317078,2023-05-02,Senate,"Do pass",18,0,0,0,18
1649612,1318926,2023-05-04,Senate,"Assembly 3rd Reading AB100 Ting By Skinner",36,0,0,4,40
1649612,1318927,2023-05-04,Assembly,"AB 100 TING Concurrence in Senate Amendments",75,0,0,5,80
1649613,1283095,2023-03-23,Assembly,"AB 101 Ting Assembly Third Reading",60,14,0,6,80
1649613,1344216,2023-06-14,Senate,"Do pass",13,4,0,1,18
1649614,1283216,2023-03-23,Assembly,"AB 102 Ting Assembly Third Reading",60,14,0,6,80
1649614,1347805,2023-06-27,Senate,"Assembly 2nd Reading AB102 Ting By Skinner",32,6,0,2,40
1649614,1347806,2023-06-27,Assembly,"AB 102 TING Concurrence in Senate Amendments",62,14,0,4,80
1649614,1349435,2023-06-26,Senate,"Do pass",13,4,0,1,18
1649615,1283232,2023-03-23,Assembly,"AB 103 Ting Assembly Third Reading",60,14,0,6,80
1649615,1283233,2023-03-23,Assembly,"AB 103 Ting Assembly Third Reading",60,14,0,6,80
1649615,1347798,2023-06-27,Senate,"Assembly 2nd Reading AB103 Ting By Skinner",32,7,0,1,40
1649615,1347799,2023-06-27,Assembly,"AB 103 TING Concurrence in Senate Amendments",65,9,0,6,80
1649615,1349544,2023-06-26,Senate,"Do pass",13,4,0,1,18
1649616,1283080,2023-03-23,Assembly,"AB 104 Ting Assembly Third Reading",60,14,0,6,80
1649616,1352439,2023-08-30,Senate,"Do pass",13,5,0,0,18
1649617,1283111,2023-03-23,Assembly,"AB 105 Ting Assembly Third Reading",60,14,0,6,80
1649618,1283077,2023-03-23,Assembly,"AB 106 Ting Assembly Third Reading",60,14,0,6,80
1649618,1424941,2024-04-10,Senate,"Do pass",15,3,0,2,20
1649618,1425908,2024-04-11,Senate,"Assembly 3rd Reading AB106 Gabriel By Wiener",32,5,0,3,40
1649618,1425909,2024-04-11,Assembly,"AB 106 GABRIEL Concurrence in Senate Amendments",58,15,0,7,80
1649619,1283170,2023-03-23,Assembly,"AB 107 Ting Assembly Third Reading",60,14,0,6,80
1649619,1456868,2024-06-12,Senate,"Do pass",13,5,0,1,19
1649619,1457344,2024-06-13,Senate,"Assembly 2nd Reading AB107 Gabriel By Wiener",29,8,0,3,40
1649619,1457345,2024-06-13,Assembly,"AB 107 GABRIEL Concurrence in Senate Amendments",61,14,0,4,79
1649620,1283246,2023-03-23,Assembly,"AB 108 Ting Assembly Third Reading",60,14,0,6,80
1649620,1460448,2024-06-26,Senate,"Do pass",13,5,0,1,19
1649621,1283200,2023-03-23,Assembly,"AB 109 Ting Assembly Third Reading",60,14,0,6,80
1649621,1460563,2024-06-26,Senate,"Do pass",13,5,0,1,19
1649622,1283102,2023-03-23,Assembly,"AB 110 Budget Assembly Third Reading By TING",60,14,0,6,80
1649622,1317085,2023-05-02,Senate,"Do pass",18,0,0,0,18
1649622,1318929,2023-05-04,Senate,"Assembly 3rd Reading AB110 BUDGET (Ting) By Skinner",37,0,0,3,40
1649622,1318930,2023-05-04,Assembly,"AB 110 BUDGET Concurrence in Senate Amendments By TING",77,0,0,3,80
1649623,1283162,2023-03-23,Assembly,"AB 111 Budget Assembly Third Reading By TING",60,14,0,6,80
1649623,1317046,2023-05-02,Senate,"Do pass",18,0,0,0,18
1649623,1318932,2023-05-04,Senate,"Assembly 3rd Reading AB111 BUDGET (Ting) By Skinner",38,0,0,2,40
1649623,1318933,2023-05-04,Assembly,"AB 111 BUDGET Concurrence in Senate Amendments By TING",77,0,0,3,80
1649624,1283268,2023-03-23,Assembly,"AB 112 Budget Assembly Third Reading By TING",60,14,0,6,80
1649624,1317058,2023-05-02,Senate,"Do pass",18,0,0,0,18
1649624,1318974,2023-05-04,Senate,"Assembly 3rd Reading AB112 BUDGET (Ting) By Skinner",38,0,0,2,40
1649624,1318975,2023-05-04,Assembly,"AB 112 BUDGET Concurrence in Senate Amendments By TING",77,0,0,3,80
1649625,1283185,2023-03-23,Assembly,"AB 113 Budget Assembly Third Reading By TING",60,14,0,6,80
1649625,1317028,2023-05-02,Senate,"Do pass",13,5,0,0,18
1649625,1318984,2023-05-04,Senate,"Assembly 3rd Reading AB113 BUDGET (Ting) By Skinner",29,9,0,2,40
1649625,1318985,2023-05-04,Assembly,"AB 113 BUDGET Concurrence in Senate Amendments By TING",60,17,0,3,80
1649626,1283178,2023-03-23,Assembly,"AB 114 Budget Assembly Third Reading By TING",60,14,0,6,80
1649626,1349436,2023-06-26,Senate,"Do pass",14,0,0,4,18
1649627,1283082,2023-03-23,Assembly,"AB 115 Budget Assembly Third Reading By TING",60,14,0,6,80
1649627,1349432,2023-06-26,Senate,"Do pass",17,0,0,1,18
1649628,1283183,2023-03-23,Assembly,"AB 116 Budget Assembly Third Reading By TING",60,14,0,6,80
1649628,1347814,2023-06-27,Senate,"Assembly 2nd Reading AB116 BUDGET (Ting) By Skinner",34,4,0,2,40
1649628,1347815,2023-06-27,Assembly,"AB 116 BUDGET Concurrence in Senate Amendments By TING",76,1,0,3,80
1649628,1349426,2023-06-26,Senate,"Do pass",13,3,0,2,18
1649629,1283156,2023-03-23,Assembly,"AB 117 Budget Assembly Third Reading By TING",60,14,0,6,80
1649629,1349399,2023-06-26,Senate,"Do pass",17,0,0,1,18
1649630,1283076,2023-03-23,Assembly,"AB 118 Budget Assembly Third Reading By TING",60,14,0,6,80
1649630,1347860,2023-06-27,Senate,"Assembly 2nd Reading AB118 BUDGET (Ting) By Skinner",34,2,0,4,40
1649630,1347861,2023-06-27,Assembly,"AB 118 BUDGET Concurrence in Senate Amendments By TING",64,9,0,7,80
1649630,1349423,2023-06-26,Senate,"Do pass",13,1,0,4,18
1649631,1283096,2023-03-23,Assembly,"AB 119 Budget Assembly Third Reading By TING",60,14,0,6,80
1649631,1347943,2023-06-27,Senate,"Assembly 2nd Reading AB119 BUDGET (Ting) By Skinner Urgency Clause",35,0,0,5,40
1649631,1347944,2023-06-27,Assembly,"AB 119 BUDGET Concurrence - Urgency Added By TING",68,1,0,11,80
1649631,1349543,2023-06-26,Senate,"Do pass",14,0,0,4,18
1649632,1283119,2023-03-23,Assembly,"AB 120 Budget Assembly Third Reading By TING",60,14,0,6,80
1649632,1347855,2023-06-27,Senate,"Assembly 2nd Reading AB120 BUDGET (Ting) By Skinner",32,6,0,2,40
1649632,1347856,2023-06-27,Assembly,"AB 120 BUDGET Concurrence in Senate Amendments By TING",61,10,0,9,80
1649632,1349421,2023-06-26,Senate,"Do pass",13,3,0,2,18
1649633,1283104,2023-03-23,Assembly,"AB 121 Budget Assembly Third Reading By TING",60,14,0,6,80
1649633,1347800,2023-06-27,Senate,"Assembly 2nd Reading AB121 BUDGET (Ting) By Skinner",40,0,0,0,40
1649633,1347801,2023-06-27,Assembly,"AB 121 BUDGET Concurrence in Senate Amendments By TING",75,1,0,4,80
1649633,1349431,2023-06-26,Senate,"Do pass",17,0,0,1,18
1649634,1283195,2023-03-23,Assembly,"AB 122 Budget Assembly Third Reading By TING",60,14,0,6,80
1649634,1349427,2023-06-26,Senate,"Do pass",13,4,0,1,18
1649635,1283228,2023-03-23,Assembly,"AB 123 Budget Assembly Third Reading By TING",60,14,0,6,80
1649635,1349434,2023-06-26,Senate,"Do pass",13,0,0,5,18
1649636,1283237,2023-03-23,Assembly,"AB 124 Budget Assembly Third Reading By TING",60,14,0,6,80
1649636,1349428,2023-06-26,Senate,"Do pass",13,0,0,5,18
1649637,1283166,2023-03-23,Assembly,"AB 125 Budget Assembly Third Reading By TING",60,14,0,6,80
1649637,1349437,2023-06-26,Senate,"Do pass",13,2,0,3,18
1649638,1283121,2023-03-23,Assembly,"AB 126 Budget Assembly Third Reading By TING",60,14,0,6,80
1649638,1349422,2023-06-26,Senate,"Do pass",13,4,0,1,18
1649638,1354299,2023-09-13,Senate,"Do pass",10,5,0,3,18
1649638,1354639,2023-09-14,Senate,"Assembly 2nd Reading AB126 Reyes et al. Gonzalez Urgency Clause",30,8,0,2,40
1649638,1354640,2023-09-14,Assembly,"AB 126 REYES Concurrence - Urgency Added",61,12,0,7,80
1649639,1283109,2023-03-23,Assembly,"AB 127 Budget Assembly Third Reading By TING",60,14,0,6,80
1649639,1347896,2023-06-27,Senate,"Assembly 2nd Reading AB127 BUDGET (Ting) By Skinner",32,7,0,1,40
1649639,1347897,2023-06-27,Assembly,"AB 127 BUDGET Concurrence in Senate Amendments By TING",74,2,0,4,80
1649639,1349424,2023-06-26,Senate,"Do pass",13,2,0,3,18
1649640,1283112,2023-03-23,Assembly,"AB 128 Budget Assembly Third Reading By TING",60,14,0,6,80
1649640,1347922,2023-06-27,Senate,"Assembly 2nd Reading AB128 BUDGET (Ting) By Skinner",40,0,0,0,40
1649640,1347923,2023-06-27,Assembly,"AB 128 BUDGET Concurrence in Senate Amendments By TING",75,1,0,4,80
1649640,1349429,2023-06-26,Senate,"Do pass",17,0,0,1,18
1649641,1283099,2023-03-23,Assembly,"AB 129 Budget Assembly Third Reading By TING",60,14,0,6,80
1649641,1348855,2023-06-29,Senate,"Assembly 3rd Reading AB129 BUDGET (Ting) By Skinner",32,0,0,8,40
1649641,1349415,2023-06-26,Senate,"Do pass",13,0,0,5,18
1649641,1349416,2023-06-29,Assembly,"AB 129 BUDGET Concurrence in Senate Amendments By TING",68,0,0,12,80
1649642,1283263,2023-03-23,Assembly,"AB 130 Budget Assembly Third Reading By TING",60,14,0,6,80
1649642,1347820,2023-06-27,Senate,"Assembly 2nd Reading AB130 BUDGET (Ting) By Skinner",32,3,0,5,40
1649642,1347821,2023-06-27,Assembly,"AB 130 BUDGET Concurrence in Senate Amendments By TING",62,14,0,4,80
1649642,1349425,2023-06-26,Senate,"Do pass",13,0,0,5,18
1649643,1283212,2023-03-23,Assembly,"AB 131 Budget Assembly Third Reading By TING",60,14,0,6,80
1649643,1349398,2023-06-26,Senate,"Do pass",13,4,0,1,18
1649644,1283250,2023-03-23,Assembly,"AB 132 Budget Assembly Third Reading By TING",60,14,0,6,80
1649644,1349433,2023-06-26,Senate,"Do pass",14,0,0,4,18
1649645,1283090,2023-03-23,Assembly,"AB 133 Budget Assembly Third Reading By TING",60,14,0,6,80
1649645,1349412,2023-06-26,Senate,"Do pass",13,4,0,1,18
1649646,1283172,2023-03-23,Assembly,"AB 134 Budget Assembly Third Reading By TING",60,14,0,6,80
1649646,1347931,2023-06-27,Senate,"Assembly 2nd Reading AB134 BUDGET (Ting) By Skinner",32,8,0,0,40
1649646,1347932,2023-06-27,Assembly,"AB 134 BUDGET Concurrence in Senate Amendments By TING",59,17,0,4,80
1649646,1349420,2023-06-26,Senate,"Do pass",13,4,0,1,18
1649647,1283132,2023-03-23,Assembly,"AB 135 Budget Assembly Third Reading By TING",60,14,0,6,80
1649647,1352443,2023-08-30,Senate,"Do pass",13,5,0,0,18
1649648,1283086,2023-03-23,Assembly,"AB 136 Budget Assembly Third Reading By TING",60,14,0,6,80
1649648,1411346,2024-03-19,Senate,"Do pass",13,3,0,4,20
1649649,1283238,2023-03-23,Assembly,"AB 137 Budget Assembly Third Reading By TING",60,14,0,6,80
1649649,1352442,2023-08-30,Senate,"Do pass",13,5,0,0,18
1649650,1283124,2023-03-23,Assembly,"AB 138 Budget Assembly Third Reading By TING",60,14,0,6,80
1649650,1352441,2023-08-30,Senate,"Do pass",18,0,0,0,18
1649651,1283091,2023-03-23,Assembly,"AB 139 Budget Assembly Third Reading By TING",60,14,0,6,80
1649652,1283126,2023-03-23,Assembly,"AB 140 Budget Assembly Third Reading By TING",60,14,0,6,80
1649652,1352449,2023-08-30,Senate,"Do pass",13,3,0,2,18
1649653,1283194,2023-03-23,Assembly,"AB 141 Budget Assembly Third Reading By TING",60,14,0,6,80
1649653,1352440,2023-08-30,Senate,"Do pass",18,0,0,0,18
1649654,1283140,2023-03-23,Assembly,"AB 142 Budget Assembly Third Reading By TING",60,14,0,6,80
1649654,1352445,2023-08-30,Senate,"Do pass",15,0,0,3,18
1649655,1283089,2023-03-23,Assembly,"AB 143 Budget Assembly Third Reading By TING",60,14,0,6,80
1649655,1352448,2023-08-30,Senate,"Do pass",11,3,0,4,18
1649656,1283083,2023-03-23,Assembly,"AB 144 Budget Assembly Third Reading By TING",60,14,0,6,80
1649657,1283174,2023-03-23,Assembly,"AB 145 Budget Assembly Third Reading By TING",60,14,0,6,80
1649658,1283265,2023-03-23,Assembly,"AB 146 Budget Assembly Third Reading By TING",60,14,0,6,80
1649659,1283244,2023-03-23,Assembly,"AB 147 Budget Assembly Third Reading By TING",60,14,0,6,80
1649660,1283149,2023-03-23,Assembly,"AB 148 Budget Assembly Third Reading By TING",60,14,0,6,80
1649660,1352446,2023-08-30,Senate,"Do pass",13,3,0,2,18
1649661,1283150,2023-03-23,Assembly,"AB 149 Budget Assembly Third Reading By TING",60,14,0,6,80
1649662,1283193,2023-03-23,Assembly,"AB 150 Budget Assembly Third Reading By TING",60,14,0,6,80
1649663,1283088,2023-03-23,Assembly,"AB 151 Budget Assembly Third Reading By TING",60,14,0,6,80
1649663,1352447,2023-08-30,Senate,"Do pass",10,2,0,6,18
1649664,1283227,2023-03-23,Assembly,"AB 152 Budget Assembly Third Reading By TING",60,14,0,6,80
1649664,1352444,2023-08-30,Senate,"Do pass",18,0,0,0,18
1649665,1283154,2023-03-23,Assembly,"AB 153 Budget Assembly Third Reading By TING",60,14,0,6,80
1649665,1460693,2024-06-26,Senate,"Do pass",13,5,0,1,19
1649666,1283203,2023-03-23,Assembly,"AB 154 Budget Assembly Third Reading By TING",60,14,0,6,80
1649666,1456969,2024-06-12,Senate,"Do pass",13,5,0,1,19
1649667,1283137,2023-03-23,Assembly,"AB 155 Budget Assembly Third Reading By TING",60,14,0,6,80
1649667,1460697,2024-06-26,Senate,"Do pass",16,0,0,3,19
1649668,1283218,2023-03-23,Assembly,"AB 156 Budget Assembly Third Reading By TING",60,14,0,6,80
1649668,1460745,2024-06-26,Senate,"Do pass",13,5,0,1,19
1649669,1283215,2023-03-23,Assembly,"AB 157 Budget Assembly Third Reading By TING",60,14,0,6,80
1649669,1465538,2024-08-26,Senate,"Do pass",13,5,0,1,19
1649669,1466249,2024-08-29,Assembly,"AB 157 Gabriel Concurrence in Senate Amendments",59,14,0,6,79
1649669,1466740,2024-08-28,Senate,"Assembly 3rd Reading AB157 Gabriel By Wiener",31,9,0,0,40
1649670,1283240,2023-03-23,Assembly,"AB 158 Budget Assembly Third Reading By TING",60,14,0,6,80
1649670,1465610,2024-08-26,Senate,"Do pass",13,5,0,1,19
1649670,1466123,2024-08-29,Assembly,"AB 158 Gabriel Concurrence in Senate Amendments",59,16,0,4,79
1649670,1466682,2024-08-28,Senate,"Assembly 3rd Reading AB158 Gabriel By Wiener",31,9,0,0,40
1649671,1283159,2023-03-23,Assembly,"AB 159 Budget Assembly Third Reading By TING",60,14,0,6,80
1649671,1460612,2024-06-26,Senate,"Do pass",13,5,0,1,19
1649672,1283078,2023-03-23,Assembly,"AB 160 Budget Assembly Third Reading By TING",60,14,0,6,80
1649672,1460757,2024-06-26,Senate,"Do pass",13,5,0,1,19
1649672,1460758,2024-06-26,Senate,"Assembly 3rd Reading AB160 BUDGET (Gabriel) By Wiener",31,8,0,1,40
1649672,1460759,2024-06-26,Assembly,"AB 160 BUDGET Concurrence in Senate Amendments By GABRIEL",61,12,0,6,79
1649673,1283192,2023-03-23,Assembly,"AB 161 Budget Assembly Third Reading By TING",60,14,0,6,80
1649673,1460661,2024-06-26,Senate,"Do pass",18,0,0,1,19
1649673,1460662,2024-06-26,Senate,"Assembly 3rd Reading AB161 BUDGET (Gabriel) By Wiener",39,0,0,1,40
1649673,1460663,2024-06-26,Assembly,"AB 161 BUDGET Concurrence in Senate Amendments By GABRIEL",71,2,0,6,79
1649674,1283143,2023-03-23,Assembly,"AB 162 Budget Assembly Third Reading By TING",60,14,0,6,80
1649674,1460782,2024-06-26,Senate,"Do pass",13,5,0,1,19
1649674,1460783,2024-06-26,Senate,"Assembly 3rd Reading AB162 BUDGET (Gabriel) By Wiener",31,7,0,2,40
1649674,1460784,2024-06-26,Assembly,"AB 162 BUDGET Concurrence in Senate Amendments By GABRIEL",73,1,0,5,79
1649675,1283085,2023-03-23,Assembly,"AB 163 Budget Assembly Third Reading By TING",60,14,0,6,80
1649675,1460499,2024-06-26,Senate,"Do pass",13,5,0,1,19
1649676,1283207,2023-03-23,Assembly,"AB 164 Budget Assembly Third Reading By TING",60,14,0,6,80
1649676,1460469,2024-06-26,Senate,"Do pass",13,5,0,1,19
1649677,1283241,2023-03-23,Assembly,"AB 165 Budget Assembly Third Reading By TING",60,14,0,6,80
1649678,1283094,2023-03-23,Assembly,"AB 166 Budget Assembly Third Reading By TING",60,14,0,6,80
1649678,1460655,2024-06-26,Senate,"Do pass",13,4,0,2,19
1649678,1460656,2024-06-26,Senate,"Assembly 3rd Reading AB166 BUDGET (Gabriel) By Wiener",31,6,0,3,40
1649678,1460657,2024-06-26,Assembly,"AB 166 BUDGET Concurrence in Senate Amendments By GABRIEL",71,1,0,7,79
1649679,1283122,2023-03-23,Assembly,"AB 167 Budget Assembly Third Reading By TING",60,14,0,6,80
1649679,1456902,2024-06-12,Senate,"Do pass",13,5,0,1,19
1649680,1283223,2023-03-23,Assembly,"AB 168 Budget Assembly Third Reading By TING",60,14,0,6,80
1649680,1460431,2024-06-26,Senate,"Do pass",13,5,0,1,19
1649680,1460432,2024-06-26,Senate,"Assembly 3rd Reading AB168 BUDGET (Gabriel) By Wiener",31,8,0,1,40
1649680,1462107,2024-07-01,Assembly,"AB 168 Budget Concurrence in Senate Amendments By GABRIEL",67,1,0,11,79
1649681,1283152,2023-03-23,Assembly,"AB 169 Budget Assembly Third Reading By TING",60,14,0,6,80
1649681,1460519,2024-06-26,Senate,"Do pass",15,0,0,4,19
1649681,1460520,2024-06-26,Senate,"Assembly 3rd Reading AB169 BUDGET (Gabriel) By Wiener",32,0,0,8,40
1649681,1460521,2024-06-26,Assembly,"AB 169 BUDGET Concurrence in Senate Amendments By GABRIEL",73,1,0,5,79
1649682,1283155,2023-03-23,Assembly,"AB 170 Budget Assembly Third Reading By TING",60,14,0,6,80
1649682,1460779,2024-06-26,Senate,"Do pass",13,4,0,2,19
1649682,1460780,2024-06-26,Senate,"Assembly 3rd Reading AB170 BUDGET (Gabriel) By Wiener",31,8,0,1,40
1649682,1460781,2024-06-26,Assembly,"AB 170 BUDGET Concurrence in Senate Amendments By GABRIEL",73,1,0,5,79
1649683,1283147,2023-03-23,Assembly,"AB 171 Budget Assembly Third Reading By TING",60,14,0,6,80
1649683,1460733,2024-06-26,Senate,"Do pass",13,4,0,2,19
1649683,1460734,2024-06-26,Senate,"Assembly 3rd Reading AB171 BUDGET (Gabriel) By Wiener",31,7,0,2,40
1649683,1460735,2024-06-26,Assembly,"AB 171 BUDGET Concurrence in Senate Amendments By GABRIEL",61,11,0,7,79
1649684,1283108,2023-03-23,Assembly,"AB 172 Budget Assembly Third Reading By TING",60,14,0,6,80
1649685,1283113,2023-03-23,Assembly,"AB 173 Budget Assembly Third Reading By TING",60,14,0,6,80
1649685,1460501,2024-06-26,Senate,"Do pass",13,5,0,1,19
1649685,1460502,2024-06-26,Senate,"Assembly 3rd Reading AB173 BUDGET (Gabriel) By Wiener",31,8,0,1,40
1649685,1460503,2024-06-26,Assembly,"AB 173 BUDGET Concurrence in Senate Amendments By GABRIEL",60,13,0,6,79
1649686,1283260,2023-03-23,Assembly,"AB 174 Budget Assembly Third Reading By TING",60,14,0,6,80
1649686,1460539,2024-06-26,Senate,"Do pass",14,4,0,1,19
1649687,1283146,2023-03-23,Assembly,"AB 175 Budget Assembly Third Reading By TING",60,14,0,6,80
1649687,1460680,2024-06-26,Senate,"Do pass",13,4,0,2,19
1649688,1283100,2023-03-23,Assembly,"AB 176 Budget Assembly Third Reading By TING",60,14,0,6,80
1649688,1465603,2024-08-26,Senate,"Do pass",15,0,0,4,19
1649688,1466173,2024-08-29,Assembly,"AB 176 Budget Concurrence in Senate Amendments By GABRIEL",73,2,0,4,79
1649688,1467222,2024-08-28,Senate,"Assembly 3rd Reading AB176 BUDGET (Gabriel) By Wiener",39,0,0,1,40
1649689,1283176,2023-03-23,Assembly,"AB 177 Budget Assembly Third Reading By TING",60,14,0,6,80
1649689,1465616,2024-08-26,Senate,"Do pass",18,0,0,1,19
1649689,1466236,2024-08-29,Assembly,"AB 177 Budget Concurrence in Senate Amendments By GABRIEL",74,1,0,4,79
1649689,1467226,2024-08-28,Senate,"Assembly 3rd Reading AB177 BUDGET (Gabriel) By Wiener",40,0,0,0,40
1649690,1283125,2023-03-23,Assembly,"AB 178 Budget Assembly Third Reading By TING",60,14,0,6,80
1649690,1465583,2024-08-26,Senate,"Do pass",15,0,0,4,19
1649690,1466357,2024-08-29,Assembly,"AB 178 Budget Concurrence in Senate Amendments By GABRIEL",74,1,0,4,79
1649690,1467239,2024-08-28,Senate,"Assembly 3rd Reading AB178 BUDGET (Gabriel) By Wiener",34,0,0,6,40
1649691,1283219,2023-03-23,Assembly,"AB 179 Budget Assembly Third Reading By TING",60,14,0,6,80
1649691,1465713,2024-08-26,Senate,"Do pass",14,1,0,4,19
1649691,1466276,2024-08-29,Assembly,"AB 179 Budget Concurrence in Senate Amendments By GABRIEL",59,14,0,6,79
1649691,1467231,2024-08-28,Senate,"Assembly 3rd Reading AB179 BUDGET (Gabriel) By Wiener",35,1,0,4,40
1649692,1283224,2023-03-23,Assembly,"AB 180 Budget Assembly Third Reading By TING",60,14,0,6,80
1649692,1466132,2024-08-29,Senate,"Do pass",14,5,0,0,19
1649692,1467173,2024-08-31,Senate,"Assembly 3rd Reading AB180 Gabriel By Wiener",31,9,0,0,40
1649692,1467174,2024-08-31,Assembly,"AB 180 Gabriel Concurrence in Senate Amendments",60,17,0,2,79
1649693,1283107,2023-03-23,Assembly,"AB 181 Budget Assembly Third Reading By TING",60,14,0,6,80
1649693,1465775,2024-08-26,Senate,"Do pass",18,0,0,1,19
1649693,1466184,2024-08-29,Assembly,"AB 181 Budget Concurrence in Senate Amendments By GABRIEL",75,1,0,3,79
1649693,1467220,2024-08-28,Senate,"Assembly 3rd Reading AB181 BUDGET (Gabriel) By Wiener",40,0,0,0,40
1649694,1283251,2023-03-23,Assembly,"AB 182 Budget Assembly Third Reading By TING",60,14,0,6,80
1649695,1283123,2023-03-23,Assembly,"AB 183 Budget Assembly Third Reading By TING",60,14,0,6,80
1649696,1283264,2023-03-23,Assembly,"AB 184 Budget Assembly Third Reading By TING",60,14,0,6,80
1649697,1283255,2023-03-23,Assembly,"AB 185 Budget Assembly Third Reading By TING",60,14,0,6,80
1649698,1283087,2023-03-23,Assembly,"AB 186 Budget Assembly Third Reading By TING",60,14,0,6,80
1649699,1283225,2023-03-23,Assembly,"AB 187 Budget Assembly Third Reading By TING",60,14,0,6,80
1649700,1283138,2023-03-23,Assembly,"AB 188 Budget Assembly Third Reading By TING",60,14,0,6,80
1649701,1283163,2023-03-23,Assembly,"AB 189 Budget Assembly Third Reading By TING",60,14,0,6,80
1649702,1283254,2023-03-23,Assembly,"AB 190 Budget Assembly Third Reading By TING",60,14,0,6,80
1649703,1283098,2023-03-23,Assembly,"AB 191 Budget Assembly Third Reading By TING",60,14,0,6,80
1649704,1283266,2023-03-23,Assembly,"AB 192 Budget Assembly Third Reading By TING",60,14,0,6,80
1649705,1283243,2023-03-23,Assembly,"AB 193 Budget Assembly Third Reading By TING",60,14,0,6,80
1649706,1283177,2023-03-23,Assembly,"AB 194 Budget Assembly Third Reading By TING",60,14,0,6,80
1649707,1283196,2023-03-23,Assembly,"AB 195 Budget Assembly Third Reading By TING",60,14,0,6,80
1649708,1283157,2023-03-23,Assembly,"AB 196 Budget Assembly Third Reading By TING",60,14,0,6,80
1649709,1283127,2023-03-23,Assembly,"AB 197 Budget Assembly Third Reading By TING",60,14,0,6,80
1649710,1283145,2023-03-23,Assembly,"AB 198 Budget Assembly Third Reading By TING",60,14,0,6,80
1649711,1283115,2023-03-23,Assembly,"AB 199 Budget Assembly Third Reading By TING",60,14,0,6,80
1649712,1283252,2023-03-23,Assembly,"AB 200 Budget Assembly Third Reading By TING",60,14,0,6,80
1649713,1283169,2023-03-23,Assembly,"AB 201 Budget Assembly Third Reading By TING",60,14,0,6,80
1649714,1283175,2023-03-23,Assembly,"AB 202 Budget Assembly Third Reading By TING",60,14,0,6,80
1649715,1283214,2023-03-23,Assembly,"AB 203 Budget Assembly Third Reading By TING",60,14,0,6,80
1649716,1283093,2023-03-23,Assembly,"AB 204 Budget Assembly Third Reading By TING",60,14,0,6,80
1649717,1283234,2023-03-23,Assembly,"AB 205 Budget Assembly Third Reading By TING",60,14,0,6,80
1649718,1283230,2023-03-23,Assembly,"AB 206 Budget Assembly Third Reading By TING",60,14,0,6,80
1649719,1283187,2023-03-23,Assembly,"AB 207 Budget Assembly Third Reading By TING",60,14,0,6,80
1649720,1283081,2023-03-23,Assembly,"AB 208 Budget Assembly Third Reading By TING",60,14,0,6,80
1649721,1283236,2023-03-23,Assembly,"AB 209 Budget Assembly Third Reading By TING",60,14,0,6,80
1649722,1283103,2023-03-23,Assembly,"AB 210 Budget Assembly Third Reading By TING",60,14,0,6,80
1649723,1283171,2023-03-23,Assembly,"AB 211 Budget Assembly Third Reading By TING",60,14,0,6,80
1649724,1283167,2023-03-23,Assembly,"AB 212 Budget Assembly Third Reading By TING",60,14,0,6,80
1649725,1283211,2023-03-23,Assembly,"AB 213 Budget Assembly Third Reading By TING",60,14,0,6,80
1649726,1283245,2023-03-23,Assembly,"AB 214 Budget Assembly Third Reading By TING",60,14,0,6,80
1649727,1283179,2023-03-23,Assembly,"AB 215 Budget Assembly Third Reading By TING",60,14,0,6,80
1649728,1283239,2023-03-23,Assembly,"AB 216 Budget Assembly Third Reading By TING",60,14,0,6,80
1649729,1283197,2023-03-23,Assembly,"AB 217 Budget Assembly Third Reading By TING",60,14,0,6,80
1649730,1283160,2023-03-23,Assembly,"AB 218 Budget Assembly Third Reading By TING",60,14,0,6,80
1649730,1466261,2024-08-29,Senate,"Do pass",14,4,0,1,19
1649730,1467165,2024-08-31,Senate,"Assembly 3rd Reading AB218 BUDGET (Gabriel) By Wiener",30,9,0,1,40
1649730,1467166,2024-08-31,Assembly,"AB 218 BUDGET Concurrence in Senate Amendments By GABRIEL",58,17,0,4,79
1649731,1283134,2023-03-23,Assembly,"AB 219 Budget Assembly Third Reading By TING",60,14,0,6,80
1649732,1283117,2023-03-23,Assembly,"AB 220 Budget Assembly Third Reading By TING",60,14,0,6,80
1649733,1270442,2023-03-07,Assembly,"Do pass",6,1,0,1,8
1649733,1333693,2023-05-25,Assembly,"AB 93 Bryan Assembly Third Reading",36,21,0,23,80
1649733,1337195,2023-06-01,Assembly,"AB 93 Bryan Motion to Reconsider",53,17,0,10,80
1649733,1337196,2023-06-01,Assembly,"AB 93 Bryan Assembly Third Reading",35,22,0,23,80
1649734,1286992,2023-03-28,Assembly,"Do pass and be re-referred to the Committee on [Appropriations] with recommendation: To Consent Calendar",8,0,0,0,8
1649735,1313451,2023-04-26,Assembly,"Do pass as amended. To Consent Calendar",7,0,0,0,7
1649735,1320514,2023-05-08,Assembly,"AB 95 Hoover Consent Calendar Second Day Regular Session",71,0,0,9,80
1649735,1344220,2023-06-14,Senate,"Do pass",7,0,0,0,7
1649735,1353282,2023-09-06,Senate,"Assembly 3rd Reading AB95 Hoover et al. By Glazer",40,0,0,0,40
1649736,1281814,2023-03-22,Assembly,"Do pass",5,0,0,2,7
1649736,1320540,2023-05-08,Assembly,"AB 96 Kalra Assembly Third Reading",56,10,0,14,80
1649736,1344170,2023-06-14,Senate,"Do pass as amended",4,1,0,0,5
1649736,1354761,2023-09-14,Senate,"Assembly 3rd Reading AB96 Kalra By Gonzalez",31,8,0,1,40
1649736,1354762,2023-09-14,Assembly,"AB 96 KALRA Concurrence in Senate Amendments",63,12,0,5,80
1649737,1270437,2023-03-07,Assembly,"Do pass as amended and be re-referred to the Committee on [Appropriations]",8,0,0,0,8
1649737,1328674,2023-05-18,Assembly,"Do pass",15,0,0,1,16
1649737,1333773,2023-05-25,Assembly,"AB 97 Rodriguez Assembly Third Reading",77,0,0,3,80
1649737,1345680,2023-06-20,Senate,"Do pass, but first be re-referred to the Committee on [Appropriations] with the recommendation: To Consent Calendar",5,0,0,0,5
1649737,1349473,2023-07-03,Senate,"Placed on suspense file",7,0,0,0,7
1649737,1352845,2023-09-01,Senate,"Do pass as amended",6,0,0,1,7
1649737,1353236,2023-09-06,Senate,"Assembly 3rd Reading AB97 Rodriguez",39,0,0,1,40
1649737,1353684,2023-09-11,Assembly,"AB 97 Rodriguez Concurrence in Senate Amendments",80,0,0,0,80
1649738,1276600,2023-03-15,Assembly,"Do pass. To Consent Calendar",8,0,0,3,11
1649738,1283139,2023-03-23,Assembly,"AB 98 Aguiar-Curry Consent Calendar Second Day Regular Session",74,0,0,6,80
1649738,1346193,2023-06-21,Senate,"Do pass and be ordered to the Consent Calendar",8,0,0,0,8
1649738,1466192,2024-08-29,Senate,"Do pass, but first be re-referred to the Committee on [Appropriations]",4,2,0,1,7
1649738,1466523,2024-08-30,Senate,"Do pass",5,1,0,1,7
1649738,1467024,2024-08-31,Senate,"Assembly 3rd Reading AB98 Juan Carrillo et al. By Lim√≥n",22,16,0,2,40
1649738,1467025,2024-08-31,Assembly,"AB 98 Juan Carrillo Concurrence in Senate Amendments Move The Previous Question By AGUIAR-CURRY",45,16,0,18,79
1649738,1467026,2024-08-31,Assembly,"AB 98 Juan Carrillo Concurrence in Senate Amendments",46,17,0,16,79
1649739,1288252,2023-03-28,Assembly,"Do pass and be re-referred to the Committee on [Transportation]",7,2,0,0,9
1649739,1310177,2023-04-24,Assembly,"Do pass and be re-referred to the Committee on [Appropriations]",10,4,0,1,15
1649739,1328520,2023-05-18,Assembly,"Do pass",11,4,0,1,16
1649739,1330065,2023-05-22,Assembly,"AB 99 Connolly Assembly Third Reading",55,16,0,9,80
1649739,1348388,2023-06-27,Senate,"Do pass, but first be re-referred to the Committee on [Environmental Quality]",11,4,0,1,16
1649739,1350477,2023-07-12,Senate,"Do pass as amended, but first amend, and re-refer to the Committee on [Appropriations]",5,2,0,0,7
1649739,1351433,2023-08-14,Senate,"Placed on suspense file",7,0,0,0,7
1649739,1464436,2024-08-15,Senate,"Do pass as amended",5,2,0,0,7
1649739,1466224,2024-08-29,Assembly,"AB 99 Connolly Concurrence in Senate Amendments",52,16,0,11,79
1649739,1466795,2024-08-28,Senate,"Assembly 3rd Reading AB99 Connolly et al. By Stern",27,9,0,4,40
1649740,1232407,2023-01-17,Assembly,"Be adopted. To third reading",12,0,0,1,13
1649740,1267492,2023-03-02,Senate,"Special Consent ACR3 Haney et al",34,0,0,6,40
1649741,1301055,2023-04-12,Senate,"Do pass as amended, but first amend, and re-refer to the Committee on [Appropriations]",10,1,0,1,12
1649741,1315662,2023-05-01,Senate,"Placed on suspense file",6,0,0,1,7
1649741,1328847,2023-05-18,Senate,"Do pass",5,2,0,0,7
1649741,1332641,2023-05-24,Senate,"Senate 3rd Reading SB70 Wiener",31,9,0,0,40
1649741,1347834,2023-06-27,Assembly,"Do pass as amended and be re-referred to the Committee on [Appropriations]",12,3,0,0,15
1649742,1299398,2023-04-11,Senate,"Do pass, but first be re-referred to the Committee on [Public Safety]",9,0,0,2,11
1649742,1315668,2023-05-01,Senate,"Placed on suspense file",6,0,0,1,7
1649742,1328677,2023-05-18,Senate,"Do pass",6,0,0,1,7
1649742,1332613,2023-05-24,Senate,"Senate 3rd Reading SB71 Umberg",35,2,0,3,40
1649742,1332614,2023-05-24,Senate,"Senate 3rd Reading SB71 Umberg Reconsider",38,0,0,2,40
1649742,1332615,2023-05-24,Senate,"Senate 3rd Reading SB71 Umberg",34,2,0,4,40
1649742,1350131,2023-07-11,Assembly,"Do pass and be re-referred to the Committee on [Appropriations]",10,0,0,1,11
1649742,1352844,2023-09-01,Assembly,"Do pass",15,0,0,1,16
1649742,1353696,2023-09-11,Assembly,"SB 71 Umberg Senate Third Reading By Papan",78,0,0,2,80
1649742,1353941,2023-09-12,Senate,"Unfinished Business SB71 Umberg et al. Concurrence",38,0,0,2,40
1649743,1463945,2024-08-13,Senate,"Be adopted, but first be re-referred to the Committee on [Appropriations] with recommendation: To Consent Calendar",13,0,0,2,15
1649743,1465451,2024-08-22,Senate,"Consent Calendar 2nd SCR13 Roth",33,0,0,7,40
1649743,1466143,2024-08-29,Assembly,"Be adopted. To Consent Calendar",15,0,0,0,15
1649743,1466691,2024-08-31,Assembly,"SCR 13 Roth Consent Calendar Second Day",75,0,0,4,79
1649744,1232409,2023-01-17,Senate,"Be adopted as amended",9,1,0,1,11
1649744,1234458,2023-01-23,Senate,"Senate 3rd Reading SR9 Skinner et al",31,6,0,3,40
1652084,1275545,2023-03-14,Assembly,"Do pass as amended and be re-referred to the Committee on [Appropriations]",11,0,0,0,11
1652085,1275529,2023-03-14,Assembly,"Do pass",10,1,0,0,11
1652085,1283190,2023-03-23,Assembly,"AB 223 Ward Assembly Third Reading",63,0,0,17,80
1652085,1343700,2023-06-13,Senate,"Do pass",8,2,0,1,11
1652085,1353290,2023-09-06,Senate,"Assembly 3rd Reading AB223 Ward et al. By Padilla",32,6,0,2,40
1652085,1353494,2023-09-07,Assembly,"AB 223 Ward Concurrence in Senate Amendments",64,8,0,8,80
1652086,1271514,2023-03-08,Assembly,"Do pass and be re-referred to the Committee on [Appropriations] with recommendation: To Consent Calendar",22,0,0,0,22
1652086,1322887,2023-05-10,Assembly,"Do pass. To Consent Calendar",14,0,0,2,16
1652086,1328896,2023-05-18,Assembly,"AB 224 Aguiar-Curry Consent Calendar Second Day Regular Session",74,0,0,6,80
1652086,1343760,2023-06-13,Senate,"Do pass, but first be re-referred to the Committee on [Appropriations] with the recommendation: To Consent Calendar",14,0,0,1,15
1652086,1465897,2024-08-27,Senate,"Do pass, but first be re-referred to the Committee on [Appropriations]",5,0,0,0,5
1652086,1466054,2024-08-28,Senate,"Do pass",7,0,0,0,7
1652086,1466497,2024-08-30,Assembly,"With recommendation: That Senate amendments be concurred in",6,1,0,0,7
1652086,1466498,2024-08-30,Senate,"Assembly 3rd Reading AB224 Blanca Rubio et al. By Umberg",40,0,0,0,40
1652086,1467196,2024-08-31,Assembly,"AB 224 Blanca Rubio Concurrence in Senate Amendments",70,0,0,9,79
1655610,1286936,2023-03-28,Assembly,"Do pass and be re-referred to the Committee on [Appropriations] with recommendation: To Consent Calendar",18,0,0,1,19
1655610,1327934,2023-05-18,Assembly,"Do pass",15,0,0,1,16
1655610,1330055,2023-05-22,Assembly,"AB 225 Grayson Assembly Third Reading",77,0,0,3,80
1655610,1349957,2023-07-10,Senate,"Do pass, but first be re-referred to the Committee on [Appropriations]",13,0,0,0,13
1655610,1351265,2023-08-14,Senate,"Placed on suspense file",7,0,0,0,7
1655610,1353024,2023-09-01,Senate,"Do pass as amended",7,0,0,0,7
1655610,1354347,2023-09-13,Senate,"Special Consent AB225 Grayson By Caballero",39,0,0,1,40
1655610,1354724,2023-09-14,Assembly,"AB 225 Grayson Concurrence in Senate Amendments",80,0,0,0,80
1655611,1298221,2023-04-11,Assembly,"Do pass and be re-referred to the Committee on [Appropriations]",12,0,0,0,12
1655611,1328017,2023-05-18,Assembly,"Do pass",15,0,0,1,16
1655611,1330115,2023-05-22,Assembly,"AB 226 Ramos Assembly Third Reading",77,0,0,3,80
1655611,1344171,2023-06-14,Senate,"Do pass, but first be re-referred to the Committee on [Appropriations] with the recommendation: To Consent Calendar",7,0,0,0,7
1655611,1347538,2023-06-26,Senate,"Placed on suspense file",6,0,0,1,7
1655611,1352854,2023-09-01,Senate,"Do pass as amended",7,0,0,0,7
1655611,1354252,2023-09-13,Senate,"Special Consent AB226 Ramos et al",39,0,0,1,40
1655611,1354621,2023-09-14,Assembly,"AB 226 Ramos Concurrence in Senate Amendments",80,0,0,0,80
1655613,1280603,2023-03-21,Assembly,"Do pass and be re-referred to the Committee on [Appropriations]",14,0,0,1,15
1655614,1275552,2023-03-14,Assembly,"Do pass and be re-referred to the Committee on [Appropriations]",2,6,0,0,8
1655615,1283253,2023-03-22,Assembly,"Do pass as amended and be re-referred to the Committee on [Appropriations]",7,0,0,0,7
1655615,1328755,2023-05-18,Assembly,"Do pass",15,0,0,1,16
1655615,1330052,2023-05-22,Assembly,"AB 230 Reyes Assembly Third Reading",76,0,0,4,80
1655615,1344169,2023-06-14,Senate,"Do pass, but first be re-referred to the Committee on [Appropriations]",5,0,0,2,7
1655615,1347506,2023-06-26,Senate,"Placed on suspense file",6,0,0,1,7
1655615,1353091,2023-09-01,Senate,"Do pass as amended",5,0,0,2,7
1655615,1353885,2023-09-12,Assembly,"AB 230 Reyes Concurrence in Senate Amendments",77,0,0,3,80
1655615,1354863,2023-09-11,Senate,"Assembly 3rd Reading AB230 Reyes et al. By Skinner",32,0,0,8,40
1655616,1236697,2023-01-26,Assembly,"Be adopted. To Consent Calendar",13,0,0,0,13
1655616,1241822,2023-02-02,Assembly,"HR 7 Megan Dahle Consent Calendar Second Day",73,0,0,7,80
1655617,1241831,2023-02-02,Assembly,"Be adopted. To third reading",13,0,0,0,13
1655618,1299419,2023-04-11,Senate,"Do pass, but first be re-referred to the Committee on [Military and Veterans Affairs]",8,1,0,2,11
1655618,1308831,2023-04-24,Senate,"Do pass, but first be re-referred to the Committee on [Appropriations]",4,0,0,1,5
1655618,1315743,2023-05-01,Senate,"Placed on suspense file",6,0,0,1,7
1655618,1328228,2023-05-18,Senate,"Do pass as amended",6,0,0,1,7
1655618,1334475,2023-05-26,Senate,"Senate 3rd Reading SB73 Seyarto et al",36,0,0,4,40
1655618,1346278,2023-06-20,Assembly,"Do pass and be re-referred to the Committee on [Judiciary]",8,0,0,3,11
1655618,1460068,2024-06-25,Assembly,"Do pass and be re-referred to the Committee on [Appropriations] with recommendation: To Consent Calendar",11,0,0,1,12
1655619,1310270,2023-04-25,Senate,"Do pass as amended, but first amend, and re-refer to the Committee on [Appropriations]",15,0,0,0,15
1655619,1320507,2023-05-08,Senate,"Placed on suspense file",7,0,0,0,7
1655619,1328130,2023-05-18,Senate,"Do pass as amended",7,0,0,0,7
1655619,1335491,2023-05-30,Senate,"Special Consent SB74 Dodd et al. Urgency Clause",40,0,0,0,40
1655619,1351586,2023-08-16,Assembly,"Do pass as amended and be re-referred to the Committee on [Appropriations]",6,0,0,1,7
1655619,1352548,2023-09-01,Assembly,"Do pass",16,0,0,0,16
1655619,1460073,2024-06-24,Assembly,"Do pass and be re-referred to the Committee on [Appropriations] with recommendation: To Consent Calendar",8,0,0,0,8
1655620,1288160,2023-03-28,Senate,"Do pass, but first be re-referred to the Committee on [Appropriations] with the recommendation: To Consent Calendar",9,0,0,2,11
1655620,1296937,2023-04-10,Senate,"Placed on suspense file",7,0,0,0,7
1655620,1328233,2023-05-18,Senate,"Do pass",7,0,0,0,7
1655620,1333658,2023-05-25,Senate,"Special Consent SB75 Roth et al",40,0,0,0,40
1655620,1345609,2023-06-20,Assembly,"Do pass and be re-referred to the Committee on [Appropriations] with recommendation: To Consent Calendar",10,0,0,1,11
1655620,1352604,2023-09-01,Assembly,"Do pass",16,0,0,0,16
1655620,1353517,2023-09-07,Assembly,"SB 75 Roth Senate Third Reading By Cervantes",79,0,0,1,80
1655621,1310212,2023-04-25,Senate,"Do pass as amended, but first amend, and re-refer to the Committee on [Appropriations]",14,0,0,1,15
1655621,1320426,2023-05-08,Senate,"Placed on suspense file",7,0,0,0,7
1655621,1328716,2023-05-18,Senate,"Do pass",7,0,0,0,7
1655621,1333769,2023-05-25,Senate,"Special Consent SB76 Wiener et al",40,0,0,0,40
1655621,1350435,2023-07-12,Assembly,"Do pass as amended and be re-referred to the Committee on [Appropriations]",19,0,0,3,22
1655621,1352597,2023-09-01,Assembly,"Do pass as amended",11,0,0,5,16
1655621,1354358,2023-09-13,Assembly,"SB 76 Wiener Senate Third Reading By Haney",79,0,0,1,80
1655621,1354805,2023-09-14,Senate,"Unfinished Business SB76 Wiener et al. Concurrence",38,0,0,2,40
1657749,1279179,2023-03-20,Assembly,"Do pass",12,0,0,0,12
1657749,1306751,2023-04-20,Assembly,"AB 231 Chen Assembly Third Reading",76,0,0,4,80
1657749,1346180,2023-06-21,Senate,"Do pass, but first be re-referred to the Committee on [Judiciary] with the recommendation: To Consent Calendar",7,0,0,0,7
1657749,1349734,2023-07-06,Senate,"Do pass and be ordered to the Consent Calendar",11,0,0,0,11
1657749,1350687,2023-07-13,Senate,"Consent Calendar AB231 Chen",37,0,0,3,40
1657750,1286935,2023-03-28,Assembly,"Do pass and be re-referred to the Committee on [Appropriations] with recommendation: To Consent Calendar",18,0,0,1,19
1657750,1305462,2023-04-19,Assembly,"Do pass. To Consent Calendar",14,0,0,2,16
1657750,1313500,2023-04-27,Assembly,"AB 232 Aguiar-Curry Consent Calendar Second Day Regular Session",79,0,0,1,80
1657750,1338798,2023-06-05,Senate,"Do pass as amended, but first amend, and re-refer to the Committee on [Appropriations]",13,0,0,0,13
1657750,1351789,2023-08-21,Senate,"Do pass",7,0,0,0,7
1657750,1353174,2023-09-05,Senate,"Assembly 3rd Reading AB232 Aguiar-Curry By Ochoa Bogh",39,0,0,1,40
1657750,1353415,2023-09-07,Assembly,"AB 232 Aguiar-Curry Concurrence in Senate Amendments",79,0,0,1,80
1657751,1318025,2023-05-03,Assembly,"Do pass",8,0,0,0,8
1657751,1324944,2023-05-15,Assembly,"AB 233 Wilson Assembly Third Reading",69,3,0,8,80
1657751,1346313,2023-06-21,Senate,"Do pass as amended",6,1,0,1,8
1657753,1281872,2023-03-22,Assembly,"Do pass and be re-referred to the Committee on [Public Safety]",7,0,0,0,7
1657753,1304274,2023-04-18,Assembly,"Do pass and be re-referred to the Committee on [Appropriations] with recommendation: To Consent Calendar",8,0,0,0,8
1657754,1280620,2023-03-21,Senate,"Do pass as amended, but first amend, and re-refer to the Committee on [Appropriations]",6,0,0,1,7
1657754,1296908,2023-04-10,Senate,"Placed on suspense file",7,0,0,0,7
1657754,1328701,2023-05-18,Senate,"Do pass",6,0,0,1,7
1657754,1332645,2023-05-24,Senate,"Senate 3rd Reading SB77 Umberg",37,0,0,3,40
1657754,1349617,2023-07-05,Assembly,"Do pass as amended and be re-referred to the Committee on [Appropriations]",7,0,0,1,8
1657754,1353079,2023-09-01,Assembly,"Do pass as amended",11,0,0,5,16
1657754,1353541,2023-09-07,Assembly,"SB 77 Umberg Senate Third Reading By Lee",77,0,0,3,80
1657754,1354663,2023-09-11,Senate,"Unfinished Business SB77 Umberg et al. Concurrence",39,0,0,1,40
1657755,1288318,2023-03-28,Senate,"Do pass, but first be re-referred to the Committee on [Appropriations] with the recommendation: To Consent Calendar",5,0,0,0,5
1657755,1318983,2023-05-04,Senate,"Consent Calendar SB78 Glazer et al",37,0,0,3,40
1657755,1343750,2023-06-13,Assembly,"Do pass and be re-referred to the Committee on [Appropriations] with recommendation: To Consent Calendar",8,0,0,0,8
1657755,1352118,2023-08-23,Assembly,"Do pass. To Consent Calendar",15,0,0,1,16
1657755,1352482,2023-08-31,Assembly,"SB 78 Glazer Consent Calendar Second Day",79,0,0,1,80
1657755,1353354,2023-09-07,Senate,"Special Consent SB78 Glazer et al",40,0,0,0,40
1657757,1288209,2023-03-28,Senate,"Do pass, but first be re-referred to the Committee on [Appropriations] with the recommendation: To Consent Calendar",9,0,0,2,11
1657757,1301050,2023-04-13,Senate,"Consent Calendar SB80 Laird",36,0,0,4,40
1657757,1339946,2023-06-06,Assembly,"Do pass and be re-referred to the Committee on [Appropriations]",8,1,0,2,11
1657757,1346172,2023-06-21,Assembly,"Do pass",9,3,0,4,16
1657758,1310404,2023-04-25,Senate,"Do pass, but first be re-referred to the Committee on [Appropriations]",4,1,0,0,5
1657758,1320470,2023-05-08,Senate,"Placed on suspense file",7,0,0,0,7
1657758,1328164,2023-05-18,Senate,"Do pass as amended",5,2,0,0,7
1657758,1336346,2023-05-31,Senate,"Senate 3rd Reading SB81 Skinner et al",29,10,0,1,40
1657758,1348407,2023-06-27,Assembly,"Do pass and be re-referred to the Committee on [Appropriations]",6,2,0,0,8
1657758,1353019,2023-09-01,Assembly,"Do pass as amended",11,4,0,1,16
1657758,1353427,2023-09-07,Assembly,"SB 81 Skinner Senate Third Reading By Wicks Amendment Set #1",55,18,0,7,80
1657758,1354161,2023-09-13,Assembly,"SB 81 Skinner Senate Third Reading By Wicks",50,18,0,12,80
1657758,1354723,2023-09-14,Senate,"Unfinished Business SB81 Skinner et al. Concurrence",29,9,0,2,40
1659516,1276599,2023-03-14,Assembly,"Do pass as amended and be re-referred to the Committee on [Appropriations]",10,1,0,4,15
1659516,1366805,2024-01-18,Assembly,"Do pass as amended",12,2,0,2,16
1659516,1372095,2024-01-30,Assembly,"AB 236 Holden Assembly Third Reading",59,9,0,12,80
1659516,1460544,2024-06-26,Senate,"Do pass as amended, but first amend, and re-refer to the Committee on [Appropriations]",9,1,0,1,11
1659516,1463470,2024-08-05,Senate,"Placed on suspense file",7,0,0,0,7
1659517,1283208,2023-03-22,Assembly,"Do pass as amended and be re-referred to the Committee on [Appropriations]",5,0,0,2,7
1659518,1301059,2023-04-12,Assembly,"Do pass as amended, and be re-referred to the Committee on [Appropriations] with recommendation: To Consent Calendar",7,0,0,0,7
1659518,1328776,2023-05-18,Assembly,"Do pass",15,0,0,1,16
1659518,1333695,2023-05-25,Assembly,"AB 238 Muratsuchi Assembly Third Reading",78,0,0,2,80
1659518,1346266,2023-06-21,Senate,"Do pass, but first be re-referred to the Committee on [Appropriations]",7,0,0,0,7
1659518,1351846,2023-08-21,Senate,"Placed on suspense file",7,0,0,0,7
1659518,1352930,2023-09-01,Senate,"Do pass",7,0,0,0,7
1659519,1288314,2023-03-29,Assembly,"Do pass and be re-referred to the Committee on [Appropriations]",11,0,0,0,11
1659521,1304310,2023-04-17,Assembly,"Do pass and be re-referred to the Committee on [Natural Resources]",11,3,0,1,15
1659521,1310190,2023-04-24,Assembly,"Do pass and be re-referred to the Committee on [Appropriations]",8,3,0,0,11
1659521,1328616,2023-05-18,Assembly,"Do pass as amended",11,4,0,1,16
1659521,1347480,2023-06-26,Assembly,"AB 241 Reyes Third Reading Urgency Amendment Set #1",46,18,0,16,80
1659522,1276630,2023-03-14,Assembly,"Do pass and be re-referred to the Committee on [Appropriations]",13,0,0,2,15
1659522,1288256,2023-03-29,Assembly,"Do pass. To Consent Calendar",14,0,0,2,16
1659522,1302572,2023-04-17,Assembly,"AB 242 Wood Consent Calendar Second Day Regular Session",79,0,0,1,80
1659522,1338785,2023-06-05,Senate,"Do pass, but first be re-referred to the Committee on [Health]",13,0,0,0,13
1659522,1348829,2023-06-28,Senate,"Do pass, but first be re-referred to the Committee on [Appropriations]",12,0,0,0,12
1659522,1353114,2023-09-05,Senate,"Assembly 3rd Reading AB242 Wood By Roth",39,0,0,1,40
1659523,1288393,2023-03-29,Senate,"Do pass, but first be re-referred to the Committee on [Military and Veterans Affairs] with the recommendation: To Consent Calendar",8,0,0,0,8
1659523,1308824,2023-04-24,Senate,"Do pass, but first be re-referred to the Committee on [Appropriations] with the recommendation: To Consent Calendar",4,0,0,1,5
1659523,1318977,2023-05-04,Senate,"Consent Calendar SB82 Seyarto",37,0,0,3,40
1659523,1346260,2023-06-20,Assembly,"Do pass and be re-referred to the Committee on [Revenue and Taxation] with recommendation: To Consent Calendar",9,0,0,2,11
1659523,1350179,2023-07-10,Assembly,"Do pass and be re-referred to the Committee on [Appropriations]",10,0,0,1,11
1659523,1351579,2023-08-16,Assembly,"Do pass. To Consent Calendar",15,0,0,1,16
1659523,1353262,2023-09-06,Assembly,"SB 82 Seyarto Senate Third Reading By Hoover",79,0,0,1,80
1659523,1354583,2023-09-11,Senate,"Unfinished Business SB82 Seyarto Concurrence",39,0,0,1,40
1659524,1310358,2023-04-24,Senate,"Do pass as amended, but first amend, and re-refer to the Committee on [Appropriations]",17,0,0,1,18
1659524,1324945,2023-05-15,Senate,"Placed on suspense file",7,0,0,0,7
1659525,1299460,2023-04-11,Senate,"Do pass, but first be re-referred to the Committee on [Environmental Quality]",10,4,0,2,16
1659525,1311894,2023-04-26,Senate,"Do pass, but first be re-referred to the Committee on [Appropriations]",5,2,0,0,7
1659525,1320487,2023-05-08,Senate,"Placed on suspense file",7,0,0,0,7
1659525,1328559,2023-05-18,Senate,"Do pass as amended",4,2,0,1,7
1659526,1310394,2023-04-24,Senate,"Do pass, but first be re-referred to the Committee on [Appropriations]",5,0,0,0,5
1659526,1320432,2023-05-08,Senate,"Placed on suspense file",7,0,0,0,7
1659526,1366791,2024-01-18,Senate,"Do pass",4,2,0,1,7
1659526,1369556,2024-01-25,Senate,"Senate 3rd Reading SB85 Wiener et al",29,0,0,11,40
1659526,1456344,2024-06-11,Assembly,"Do pass as amended and be re-referred to the Committee on [Appropriations]",5,0,0,2,7
1659526,1464535,2024-08-15,Assembly,"Do pass as amended",11,0,0,4,15
1659526,1465684,2024-08-26,Assembly,"SB 85 Wiener Senate Third Reading By Pacheco",65,0,0,14,79
1659526,1465888,2024-08-27,Senate,"Unfinished Business SB85 Wiener et al. Concurrence",34,0,0,6,40
1664740,1275565,2023-03-14,Assembly,"Do pass and be re-referred to the Committee on [Appropriations] with recommendation: To Consent Calendar",11,0,0,0,11
1664740,1328694,2023-05-18,Assembly,"Do pass",15,0,0,1,16
1664740,1334454,2023-05-26,Assembly,"AB 243 Alanis Assembly Third Reading",77,0,0,3,80
1664740,1348433,2023-06-27,Senate,"Do pass, but first be re-referred to the Committee on [Appropriations] with the recommendation: To Consent Calendar",11,0,0,0,11
1664740,1351407,2023-08-14,Senate,"Placed on suspense file",7,0,0,0,7
1664740,1352899,2023-09-01,Senate,"Do pass",7,0,0,0,7
1664740,1354020,2023-09-12,Senate,"Special Consent AB243 Alanis et al. By Ochoa Bogh",39,0,0,1,40
1664740,1354519,2023-09-14,Assembly,"AB 243 Alanis Concurrence in Senate Amendments",80,0,0,0,80
1664742,1280667,2023-03-21,Assembly,"Do pass. To Consent Calendar",5,0,0,2,7
1664742,1285748,2023-03-27,Assembly,"AB 245 McKinnor Consent Calendar Second Day Regular Session",77,0,0,3,80
1664742,1340964,2023-06-07,Senate,"Do pass as amended, and be ordered to the Consent Calendar",7,0,0,0,7
1664742,1353271,2023-09-06,Senate,"Assembly 3rd Reading AB245 McKinnor By Hurtado",40,0,0,0,40
1664742,1353605,2023-09-11,Assembly,"AB 245 McKinnor Concurrence in Senate Amendments",80,0,0,0,80
1664743,1305505,2023-04-18,Assembly,"Do pass and be re-referred to the Committee on [Appropriations]",8,0,0,1,9
1664743,1318067,2023-05-03,Assembly,"Do pass",14,0,0,2,16
1664743,1324983,2023-05-15,Assembly,"AB 246 Papan Assembly Third Reading",70,0,0,10,80
1664743,1346143,2023-06-21,Senate,"Do pass, but first be re-referred to the Committee on [Judiciary]",5,0,0,2,7
1664743,1349769,2023-07-06,Senate,"Do pass as amended, but first amend, and re-refer to the Committee on [Appropriations]",10,0,0,1,11
1664743,1353273,2023-09-06,Senate,"Assembly 3rd Reading AB246 Papan et al. By Skinner",34,0,0,6,40
1664743,1353670,2023-09-11,Assembly,"AB 246 Papan Concurrence in Senate Amendments",71,0,0,9,80
1664744,1236687,2023-01-26,Assembly,"Be adopted. To third reading",13,0,0,0,13
1664744,1306730,2023-04-20,Senate,"Assembly 3rd Reading ACR4 Addis et al. By Ochoa Bogh",36,0,0,4,40
1664746,1275535,2023-03-14,Senate,"Do pass, but first be re-referred to the Committee on [Appropriations] with the recommendation: To Consent Calendar",4,0,0,1,5
1664746,1301085,2023-04-13,Senate,"Consent Calendar SB86 Seyarto",36,0,0,4,40
1664746,1343747,2023-06-13,Assembly,"Do pass and be re-referred to the Committee on [Appropriations] with recommendation: To Consent Calendar",8,0,0,0,8
1664746,1348337,2023-06-28,Assembly,"Do pass. To Consent Calendar",14,0,0,2,16
1664746,1349516,2023-07-03,Assembly,"SB 86 Seyarto Consent Calendar Second Day Regular Session",69,0,0,11,80
1664748,1299447,2023-04-12,Senate,"Do pass as amended, but first amend, and re-refer to the Committee on [Public Safety]",4,2,0,1,7
1664748,1310287,2023-04-25,Senate,"Do pass as amended, but first amend, and re-refer to the Committee on [Appropriations]",3,1,0,1,5
1664748,1320506,2023-05-08,Senate,"Placed on suspense file",7,0,0,0,7
1664748,1328765,2023-05-18,Senate,"Do pass",4,2,0,1,7
1664748,1335449,2023-05-30,Senate,"Senate 3rd Reading SB88 Skinner",29,9,0,2,40
1664748,1350219,2023-07-11,Assembly,"Do pass and be re-referred to the Committee on [Education]",6,2,0,0,8
1664748,1350560,2023-07-12,Assembly,"Do pass as amended and be re-referred to the Committee on [Appropriations]",5,2,0,0,7
1664748,1352941,2023-09-01,Assembly,"Do pass as amended",11,4,0,1,16
1664748,1353239,2023-09-06,Assembly,"SB 88 Skinner Senate Third Reading By McCarty",60,17,0,3,80
1664748,1353543,2023-09-07,Senate,"Unfinished Business SB88 Skinner et al. Concurrence",27,9,0,4,40
1664748,1353544,2023-09-07,Senate,"Unfinished Business SB88 Skinner et al. Concurrence Motion To Reconsider",40,0,0,0,40
1664748,1353545,2023-09-07,Senate,"Unfinished Business SB88 Skinner et al. Concurrence",31,9,0,0,40
1664749,1298236,2023-04-11,Senate,"Do pass as amended, but first amend, and re-refer to the Committee on [Appropriations]",5,0,0,0,5
1664749,1308822,2023-04-24,Senate,"Placed on suspense file",7,0,0,0,7
1664749,1327930,2023-05-18,Senate,"Do pass",7,0,0,0,7
1664749,1333678,2023-05-25,Senate,"Special Consent SB89 Ochoa Bogh et al",40,0,0,0,40
1664749,1350242,2023-07-11,Assembly,"Do pass and be re-referred to the Committee on [Appropriations]",3,0,0,5,8
1664749,1462468,2024-07-02,Assembly,"Do pass and be re-referred to the Committee on [Appropriations]",2,0,0,6,8
1664750,1313460,2023-04-26,Senate,"Do pass as amended, but first amend, and re-refer to the Committee on [Appropriations]",10,0,0,2,12
1664750,1320452,2023-05-08,Senate,"Placed on suspense file",7,0,0,0,7
1664750,1327954,2023-05-18,Senate,"Do pass",7,0,0,0,7
1664750,1330112,2023-05-22,Senate,"Senate 3rd Reading SB90 Wiener et al",40,0,0,0,40
1664750,1345685,2023-06-20,Assembly,"Do pass and be re-referred to the Committee on [Appropriations]",14,0,0,1,15
1664750,1351585,2023-08-16,Assembly,"Do pass",16,0,0,0,16
1664750,1353603,2023-09-11,Assembly,"SB 90 Wiener Senate Third Reading By Weber",79,0,0,1,80
1664750,1353961,2023-09-12,Senate,"Unfinished Business SB90 Wiener et al. Concurrence",39,0,0,1,40
1664751,1276598,2023-03-15,Senate,"Do pass, but first be re-referred to the Committee on [Housing] with the recommendation: To Consent Calendar",7,0,0,0,7
1664751,1305364,2023-04-18,Senate,"Do pass, but first be re-referred to the Committee on [Appropriations] with the recommendation: To Consent Calendar",10,0,0,1,11
1664751,1318971,2023-05-04,Senate,"Consent Calendar SB91 Umberg",37,0,0,3,40
1664751,1343110,2023-06-12,Assembly,"Do pass and be re-referred to the Committee on [Housing and Community Development] with recommendation: To Consent Calendar",10,0,0,1,11
1664751,1348463,2023-06-28,Assembly,"Do pass and be re-referred to the Committee on [Appropriations] with recommendation: To Consent Calendar",8,0,0,0,8
1664751,1350439,2023-07-12,Assembly,"Do pass. To Consent Calendar",15,0,0,1,16
1664751,1353140,2023-09-05,Assembly,"SB 91 Umberg Senate Third Reading By Lowenthal",76,0,0,4,80
1664751,1353868,2023-09-12,Assembly,"SB 91 Umberg Senate Third Reading By Lowenthal",77,0,0,3,80
1664751,1354296,2023-09-13,Senate,"Unfinished Business SB91 Umberg Concurrence",39,0,0,1,40
1664752,1243812,2023-02-06,Senate,"Senate 3rd Reading SCR14 Dodd",38,0,0,2,40
1664752,1247343,2023-02-09,Assembly,"Be adopted. To Consent Calendar",11,0,0,2,13
1664752,1255131,2023-02-17,Assembly,"SCR 14 Dodd Consent Calendar Second Day Regular Session",71,0,0,9,80
1664753,1236686,2023-01-26,Senate,"Senate 3rd Reading SR10 Nguyen et al",38,0,0,2,40
1667827,1300983,2023-04-12,Assembly,"Do pass and be re-referred to the Committee on [Higher Education]",7,0,0,0,7
1667827,1311714,2023-04-25,Assembly,"Do pass and be re-referred to the Committee on [Appropriations]",11,0,0,1,12
1667827,1328151,2023-05-18,Assembly,"Do pass as amended",12,0,0,4,16
1667827,1333713,2023-05-25,Assembly,"AB 247 Muratsuchi Assembly Third Reading",66,0,0,14,80
1667827,1344177,2023-06-14,Senate,"Do pass, but first be re-referred to the Committee on [Governance and Finance]",7,0,0,0,7
1667827,1350702,2023-07-12,Senate,"Do pass as amended, but first amend, and re-refer to the Committee on [Appropriations]",6,2,0,0,8
1667827,1351780,2023-08-21,Senate,"Placed on suspense file",7,0,0,0,7
1667827,1462076,2024-07-01,Senate,"Do pass",7,0,0,0,7
1667827,1462652,2024-07-03,Senate,"Assembly 3rd Reading AB247 Muratsuchi et al. By Newman Urgency Clause",34,3,0,3,40
1667827,1462653,2024-07-03,Assembly,"AB 247 MURATSUCHI Concurrence - Urgency Added",72,1,0,6,79
1667828,1275562,2023-03-14,Assembly,"Do pass. To Consent Calendar",8,0,0,0,8
1667828,1279191,2023-03-20,Assembly,"AB 248 Mathis Consent Calendar Second Day Regular Session",78,0,0,2,80
1667828,1345656,2023-06-19,Senate,"Do pass",5,0,0,0,5
1667828,1354034,2023-09-12,Assembly,"AB 248 Mathis Concurrence in Senate Amendments",80,0,0,0,80
1667828,1354508,2023-09-11,Senate,"Assembly 3rd Reading AB248 Mathis et al. By Lim√≥n",39,0,0,1,40
1667829,1278493,2023-03-14,Assembly,"Do pass and be re-referred to the Committee on [Education]",7,0,0,2,9
1667829,1289829,2023-03-29,Assembly,"Do pass as amended and be re-referred to the Committee on [Appropriations]",5,0,0,2,7
1667829,1328732,2023-05-18,Assembly,"Do pass as amended",11,0,0,5,16
1667829,1338186,2023-05-31,Assembly,"AB 249 Holden Assembly Third Reading",68,0,0,12,80
1667829,1349639,2023-07-05,Senate,"Do pass, but first be re-referred to the Committee on [Education]",6,0,0,1,7
1667829,1350394,2023-07-12,Senate,"Do pass, but first be re-referred to the Committee on [Appropriations]",7,0,0,0,7
1667829,1351821,2023-08-21,Senate,"Placed on suspense file",7,0,0,0,7
1667829,1352678,2023-09-01,Senate,"Do pass as amended",7,0,0,0,7
1667829,1354072,2023-09-13,Assembly,"AB 249 Holden Concurrence in Senate Amendments",71,1,0,8,80
1667829,1354737,2023-09-11,Senate,"Assembly 3rd Reading AB249 Holden et al. By Smallwood-Cuevas",35,3,0,2,40
1667830,1275556,2023-03-13,Assembly,"Do pass and be re-referred to the Committee on [Appropriations] with recommendation: To Consent Calendar",14,0,0,1,15
1667830,1328696,2023-05-18,Assembly,"Do pass",15,0,0,1,16
1667830,1330059,2023-05-22,Assembly,"AB 250 Rodriguez Assembly Third Reading",77,0,0,3,80
1667830,1343709,2023-06-13,Senate,"Do pass, but first be re-referred to the Committee on [Appropriations] with the recommendation: To Consent Calendar",16,0,0,0,16
1667830,1347528,2023-06-26,Senate,"Placed on suspense file",6,0,0,1,7
1667830,1352933,2023-09-01,Senate,"Do pass",7,0,0,0,7
1667830,1353759,2023-09-12,Senate,"Special Consent AB250 Rodriguez By Rubio",39,0,0,1,40
1667831,1280693,2023-03-20,Assembly,"Do pass and be re-referred to the Committee on [Appropriations]",11,3,0,1,15
1667831,1328051,2023-05-18,Assembly,"Do pass",11,4,0,1,16
1667831,1330158,2023-05-22,Assembly,"AB 251 Ward Assembly Third Reading",58,15,0,7,80
1667831,1343742,2023-06-13,Senate,"Do pass, but first be re-referred to the Committee on [Appropriations]",11,4,0,1,16
1667831,1347529,2023-06-26,Senate,"Placed on suspense file",6,0,0,1,7
1667831,1353030,2023-09-01,Senate,"Do pass as amended",5,2,0,0,7
1667831,1353540,2023-09-07,Senate,"Assembly 3rd Reading AB251 Ward et al. By Wiener",30,9,0,1,40
1667831,1353666,2023-09-11,Assembly,"AB 251 Ward Concurrence in Senate Amendments",58,19,0,3,80
1667832,1289793,2023-03-30,Assembly,"Be adopted. To Consent Calendar",11,0,0,2,13
1667832,1302582,2023-04-17,Assembly,"ACR 5 Ta Consent Calendar Second Day Regular Session",79,0,0,1,80
1667832,1318911,2023-05-04,Senate,"Special Consent ACR5 Ta et al",37,0,0,3,40
1667833,1285632,2023-03-27,Senate,"Senate 3rd Reading SB100 B. & F.R. (Skinner) Motions",29,8,0,3,40
1667834,1285670,2023-03-27,Senate,"Senate 3rd Reading SB101 B. & F.R. (Skinner)",29,8,0,3,40
1667834,1344706,2023-06-15,Senate,"Unfinished Business SB101 Skinner Concurrence",32,8,0,0,40
1667834,1344707,2023-06-15,Assembly,"SB 101 Skinner Senate Third Reading By Ting",61,14,0,5,80
1667835,1285579,2023-03-27,Senate,"Senate 3rd Reading SB102 B. & F.R. (Skinner)",29,8,0,3,40
1667836,1285719,2023-03-27,Senate,"Senate 3rd Reading SB103 B. & F.R. (Skinner)",29,8,0,3,40
1667837,1285770,2023-03-27,Senate,"Senate 3rd Reading SB104 B. & F.R. (Skinner)",29,8,0,3,40
1667837,1353558,2023-09-08,Assembly,"SB 104 Skinner Senate Third Reading By Ting",60,14,0,6,80
1667837,1354828,2023-09-11,Senate,"Unfinished Business SB104 Skinner Concurrence",31,8,0,1,40
1667838,1285645,2023-03-27,Senate,"Senate 3rd Reading SB105 B. & F.R. (Skinner)",29,8,0,3,40
1667838,1354205,2023-09-13,Assembly,"SB 105 Skinner Senate Third Reading By Ting",62,17,0,1,80
1667838,1354569,2023-09-14,Senate,"Unfinished Business SB105 Skinner Concurrence",32,8,0,0,40
1667839,1285663,2023-03-27,Senate,"Senate 3rd Reading SB106 B. & F.R. (Skinner)",29,8,0,3,40
1667840,1285751,2023-03-27,Senate,"Senate 3rd Reading SB107 B. & F.R. (Skinner)",29,8,0,3,40
1667841,1285609,2023-03-27,Senate,"Senate 3rd Reading SB108 B. & F.R. (Skinner)",29,8,0,3,40
1667841,1460576,2024-06-26,Senate,"Unfinished Business SB108 Wiener Concurrence",31,8,0,1,40
1667841,1460577,2024-06-26,Assembly,"SB 108 Wiener Senate Third Reading By Gabriel",60,14,0,5,79
1667842,1285582,2023-03-27,Senate,"Senate 3rd Reading SB109 B. & F.R. (Skinner)",29,8,0,3,40
1667842,1460581,2024-06-26,Senate,"Unfinished Business SB109 Wiener Concurrence",31,6,0,3,40
1667842,1460582,2024-06-26,Assembly,"SB 109 Wiener Senate Third Reading By Gabriel",60,14,0,5,79
1667843,1285722,2023-03-27,Senate,"Senate 3rd Reading SB110 B. & F.R. (Skinner)",29,8,0,3,40
1667844,1285608,2023-03-27,Senate,"Senate 3rd Reading SB111 B. & F.R. (Skinner)",29,8,0,3,40
1667845,1285725,2023-03-27,Senate,"Senate 3rd Reading SB112 B. & F.R. (Skinner)",29,8,0,3,40
1667846,1285664,2023-03-27,Senate,"Senate 3rd Reading SB113 B. & F.R. (Skinner)",29,8,0,3,40
1667847,1285737,2023-03-27,Senate,"Senate 3rd Reading SB114 B. & F.R. (Skinner)",29,8,0,3,40
1667847,1347916,2023-06-27,Senate,"Unfinished Business SB114 B. & F.R. (Skinner) Concurrence",36,0,0,4,40
1667847,1347917,2023-06-27,Assembly,"SB 114 Budget and Fiscal Review Senate Third Reading By TING",75,2,0,3,80
1667848,1285710,2023-03-27,Senate,"Senate 3rd Reading SB115 B. & F.R. (Skinner)",29,8,0,3,40
1667848,1347904,2023-06-27,Senate,"Unfinished Business SB115 B. & F.R. (Skinner) Concurrence",40,0,0,0,40
1667848,1347905,2023-06-27,Assembly,"SB 115 Budget and Fiscal Review Senate Third Reading By TING",77,2,0,1,80
1667849,1285646,2023-03-27,Senate,"Senate 3rd Reading SB116 B. & F.R. (Skinner)",29,8,0,3,40
1667850,1285581,2023-03-27,Senate,"Senate 3rd Reading SB117 B. & F.R. (Skinner)",29,8,0,3,40
1667850,1347790,2023-06-27,Senate,"Unfinished Business SB117 B. & F.R. (Skinner) Concurrence",40,0,0,0,40
1667850,1347791,2023-06-27,Assembly,"SB 117 Budget and Fiscal Review Senate Third Reading By TING",77,2,0,1,80
1667851,1285732,2023-03-27,Senate,"Senate 3rd Reading SB118 B. & F.R. (Skinner)",29,8,0,3,40
1667852,1285714,2023-03-27,Senate,"Senate 3rd Reading SB119 B. & F.R. (Skinner)",29,8,0,3,40
1667853,1285715,2023-03-27,Senate,"Senate 3rd Reading SB120 B. & F.R. (Skinner)",29,8,0,3,40
1667854,1285708,2023-03-27,Senate,"Senate 3rd Reading SB121 B. & F.R. (Skinner)",29,8,0,3,40
1667855,1285727,2023-03-27,Senate,"Senate 3rd Reading SB122 B. & F.R. (Skinner)",29,8,0,3,40
1667855,1347871,2023-06-27,Senate,"Unfinished Business SB122 B. & F.R. (Skinner) Concurrence",31,8,0,1,40
1667855,1347872,2023-06-27,Assembly,"SB 122 Budget and Fiscal Review Senate Third Reading By TING",61,17,0,2,80
1667856,1285746,2023-03-27,Senate,"Senate 3rd Reading SB123 B. & F.R. (Skinner)",29,8,0,3,40
1667856,1347926,2023-06-27,Senate,"Unfinished Business SB123 B. & F.R. (Skinner) Concurrence",32,0,0,8,40
1667856,1347927,2023-06-27,Assembly,"SB 123 Budget and Fiscal Review Senate Third Reading By TING",61,16,0,3,80
1667857,1285768,2023-03-27,Senate,"Senate 3rd Reading SB124 B. & F.R. (Skinner)",29,8,0,3,40
1667857,1349408,2023-06-29,Assembly,"SB 124 B. & F. R. Senate Third Reading By TING",57,14,0,9,80
1667857,1349593,2023-07-05,Senate,"Unfinished Business SB124 B. & F.R. (Skinner) Concurrence",29,2,0,9,40
1667858,1285756,2023-03-27,Senate,"Senate 3rd Reading SB125 B. & F.R. (Skinner)",29,8,0,3,40
1667858,1347852,2023-06-27,Senate,"Unfinished Business SB125 B. & F.R. (Skinner) Concurrence",32,7,0,1,40
1667858,1347853,2023-06-27,Assembly,"SB 125 Budget and Fiscal Review Senate Third Reading Amend By DAVIES Set #1 Motion to Lay on the Table By REYES",58,18,0,4,80
1667858,1347854,2023-06-27,Assembly,"SB 125 Budget and Fiscal Review Senate Third Reading By TING",61,17,0,2,80
1667859,1285604,2023-03-27,Senate,"Senate 3rd Reading SB126 B. & F.R. (Skinner)",29,8,0,3,40
1667860,1285666,2023-03-27,Senate,"Senate 3rd Reading SB127 B. & F.R. (Skinner)",29,8,0,3,40
1667861,1285601,2023-03-27,Senate,"Senate 3rd Reading SB128 B. & F.R. (Skinner)",29,8,0,3,40
1667862,1285750,2023-03-27,Senate,"Senate 3rd Reading SB129 B. & F.R. (Skinner)",29,8,0,3,40
1667863,1285726,2023-03-27,Senate,"Senate 3rd Reading SB130 B. & F.R. (Skinner)",29,8,0,3,40
1667864,1285590,2023-03-27,Senate,"Senate 3rd Reading SB131 B. & F.R. (Skinner)",29,8,0,3,40
1667864,1347938,2023-06-27,Senate,"Unfinished Business SB131 B. & F.R. (Skinner) Concurrence",32,8,0,0,40
1667864,1347939,2023-06-27,Assembly,"SB 131 Budget and Fiscal Review Senate Third Reading By TING",61,14,0,5,80
1667865,1285625,2023-03-27,Senate,"Senate 3rd Reading SB132 B. & F.R. (Skinner)",29,8,0,3,40
1667865,1347940,2023-06-27,Senate,"Unfinished Business SB132 B. & F.R. (Skinner) Concurrence",37,0,0,3,40
1667865,1347941,2023-06-27,Assembly,"SB 132 Budget and Fiscal Review Senate Third Reading By TING",70,5,0,5,80
1667866,1285676,2023-03-27,Senate,"Senate 3rd Reading SB133 B. & F.R. (Skinner)",29,8,0,3,40
1667866,1347910,2023-06-27,Senate,"Unfinished Business SB133 B. & F.R. (Skinner) Concurrence",32,8,0,0,40
1667866,1347911,2023-06-27,Assembly,"SB 133 Budget and Fiscal Review Senate Third Reading By TING",62,16,0,2,80
1667867,1285731,2023-03-27,Senate,"Senate 3rd Reading SB134 B. & F.R. (Skinner)",29,8,0,3,40
1667868,1285600,2023-03-27,Senate,"Senate 3rd Reading SB135 B. & F.R. (Skinner)",29,8,0,3,40
1667868,1353569,2023-09-08,Assembly,"SB 135 Budget and Fiscal Review Senate Third Reading By TING",58,16,0,6,80
1667868,1354786,2023-09-11,Senate,"Unfinished Business SB135 B. & F.R. (Skinner) Concurrence",31,8,0,1,40
1667869,1285718,2023-03-27,Senate,"Senate 3rd Reading SB136 B. & F.R. (Skinner)",29,8,0,3,40
1667869,1410539,2024-03-18,Assembly,"SB 136 Budget and Fiscal Review Third Reading Urgency By GABRIEL",58,11,0,11,80
1667869,1413839,2024-03-21,Senate,"Unfinished Business SB136 B. & F.R. (Wiener) Urgency Clause Concurrence",29,3,0,8,40
1667870,1285689,2023-03-27,Senate,"Senate 3rd Reading SB137 B. & F.R. (Skinner)",29,8,0,3,40
1667870,1353560,2023-09-08,Assembly,"SB 137 Budget and Fiscal Review Senate Third Reading By TING",61,13,0,6,80
1667870,1354848,2023-09-11,Senate,"Unfinished Business SB137 B. & F.R. (Skinner) Concurrence",31,8,0,1,40
1667871,1285650,2023-03-27,Senate,"Senate 3rd Reading SB138 B. & F.R. (Skinner)",29,8,0,3,40
1667871,1353574,2023-09-08,Assembly,"SB 138 Budget and Fiscal Review Senate Third Reading By TING",75,0,0,5,80
1667871,1354819,2023-09-11,Senate,"Unfinished Business SB138 B. & F.R. (Skinner) Concurrence",39,0,0,1,40
1667872,1285741,2023-03-27,Senate,"Senate 3rd Reading SB139 B. & F.R. (Skinner)",29,8,0,3,40
1667873,1285749,2023-03-27,Senate,"Senate 3rd Reading SB140 B. & F.R. (Skinner)",29,8,0,3,40
1667873,1353573,2023-09-08,Assembly,"SB 140 Budget and Fiscal Review Senate Third Reading By TING",61,10,0,9,80
1667873,1354840,2023-09-11,Senate,"Unfinished Business SB140 B. & F.R. (Skinner) Concurrence",31,8,0,1,40
1667874,1285763,2023-03-27,Senate,"Senate 3rd Reading SB141 B. & F.R. (Skinner)",29,8,0,3,40
1667874,1353572,2023-09-08,Assembly,"SB 141 Budget and Fiscal Review Senate Third Reading By TING",76,0,0,4,80
1667874,1354889,2023-09-11,Senate,"Unfinished Business SB141 B. & F.R. (Skinner) Concurrence",39,0,0,1,40
1667875,1285745,2023-03-27,Senate,"Senate 3rd Reading SB142 B. & F.R. (Skinner)",29,8,0,3,40
1667875,1353557,2023-09-08,Assembly,"SB 142 Budget and Fiscal Review Senate Third Reading By TING",61,7,0,12,80
1667875,1354586,2023-09-11,Senate,"Unfinished Business SB142 B. & F.R. (Skinner) Concurrence",37,0,0,3,40
1667876,1285639,2023-03-27,Senate,"Senate 3rd Reading SB143 B. & F.R. (Skinner)",29,8,0,3,40
1667876,1353566,2023-09-08,Assembly,"SB 143 Budget and Fiscal Review Senate Third Reading By TING",74,0,0,6,80
1667876,1354854,2023-09-11,Senate,"Unfinished Business SB143 B. & F.R. (Skinner) Concurrence",28,1,0,11,40
1667877,1285672,2023-03-27,Senate,"Senate 3rd Reading SB144 B. & F.R. (Skinner)",29,8,0,3,40
1667878,1285739,2023-03-27,Senate,"Senate 3rd Reading SB145 B. & F.R. (Skinner)",29,8,0,3,40
1667878,1348849,2023-06-29,Assembly,"Do pass",14,0,0,1,15
1667878,1349419,2023-06-29,Assembly,"SB 145 Newman Third Reading Urgency By RIVAS, L",73,0,0,7,80
1667878,1349576,2023-07-05,Senate,"Unfinished Business SB145 Newman et al. Urgency Clause Concurrence",38,0,0,2,40
1667879,1285635,2023-03-27,Senate,"Senate 3rd Reading SB146 B. & F.R. (Skinner)",29,8,0,3,40
1667879,1348840,2023-06-29,Assembly,"Do pass",15,0,0,0,15
1667879,1349407,2023-06-29,Assembly,"SB 146 Gonzalez Third Reading Urgency By RIVAS, L",74,0,0,6,80
1667879,1349644,2023-07-05,Senate,"Unfinished Business SB146 Gonzalez et al. Urgency Clause Concurrence",39,0,0,1,40
1667880,1285671,2023-03-27,Senate,"Senate 3rd Reading SB147 B. & F.R. (Skinner)",29,8,0,3,40
1667880,1348832,2023-06-29,Assembly,"Do pass",12,0,0,3,15
1667880,1349417,2023-06-29,Assembly,"SB 147 Ashby Third Reading Urgency By BAUER-KAHAN",72,0,0,8,80
1667880,1349559,2023-07-05,Senate,"Unfinished Business SB147 Ashby Urgency Clause Concurrence",33,5,0,2,40
1667881,1285764,2023-03-27,Senate,"Senate 3rd Reading SB148 B. & F.R. (Skinner)",29,8,0,3,40
1667881,1353562,2023-09-08,Assembly,"SB 148 Budget and Fiscal Review Senate Third Reading By TING",69,3,0,8,80
1667881,1354890,2023-09-11,Senate,"Unfinished Business SB148 B. & F.R. (Skinner) Concurrence",30,8,0,2,40
1667882,1285613,2023-03-27,Senate,"Senate 3rd Reading SB149 B. & F.R. (Skinner)",29,8,0,3,40
1667882,1348828,2023-06-29,Assembly,"Do pass",9,0,0,2,11
1667882,1349468,2023-07-03,Assembly,"SB 149 Caballero Third Reading Urgency Amend By DAVIES Set #1 Motion to Lay on the Table By REYES",56,13,0,11,80
1667882,1349469,2023-07-03,Assembly,"SB 149 Caballero Third Reading Urgency By BAUER-KAHAN",68,0,0,12,80
1667882,1349600,2023-07-05,Senate,"Unfinished Business SB149 Caballero et al. Urgency Clause Concurrence",39,0,0,1,40
1667883,1285602,2023-03-27,Senate,"Senate 3rd Reading SB150 B. & F.R. (Skinner)",29,8,0,3,40
1667883,1348875,2023-06-29,Assembly,"Do pass",12,2,0,1,15
1667883,1349409,2023-06-29,Assembly,"SB 150 Durazo Third Reading Urgency By RIVAS, L",61,11,0,8,80
1667883,1349579,2023-07-05,Senate,"Unfinished Business SB150 Durazo et al. Urgency Clause Concurrence",32,8,0,0,40
1667884,1285675,2023-03-27,Senate,"Senate 3rd Reading SB151 B. & F.R. (Skinner)",29,8,0,3,40
1667884,1353559,2023-09-08,Assembly,"SB 151 Budget and Fiscal Review Senate Third Reading By TING",75,0,0,5,80
1667884,1354719,2023-09-11,Senate,"Unfinished Business SB151 B. & F.R. (Skinner) Concurrence",31,5,0,4,40
1667885,1285629,2023-03-27,Senate,"Senate 3rd Reading SB152 B. & F.R. (Skinner)",29,8,0,3,40
1667885,1353571,2023-09-08,Assembly,"SB 152 Budget and Fiscal Review Senate Third Reading By TING",75,0,0,5,80
1667885,1354891,2023-09-11,Senate,"Unfinished Business SB152 B. & F.R. (Skinner) Concurrence",39,0,0,1,40
1667886,1285706,2023-03-27,Senate,"Senate 3rd Reading SB153 B. & F.R. (Skinner)",29,8,0,3,40
1667886,1460762,2024-06-26,Senate,"Unfinished Business SB153 B. & F.R. (Wiener) Concurrence",31,7,0,2,40
1667886,1460763,2024-06-26,Assembly,"SB 153 Budget and Fiscal Review Senate Third Reading By GABRIEL",63,11,0,5,79
1667887,1285738,2023-03-27,Senate,"Senate 3rd Reading SB154 B. & F.R. (Skinner)",29,8,0,3,40
1667887,1457346,2024-06-13,Senate,"Unfinished Business SB154 B. & F.R. (Wiener) Urgency Clause Concurrence",29,8,0,3,40
1667887,1457347,2024-06-13,Assembly,"SB 154 Budget and Fiscal Review Third Reading Urgency By GABRIEL",62,15,0,2,79
1667888,1285747,2023-03-27,Senate,"Senate 3rd Reading SB155 B. & F.R. (Skinner)",29,8,0,3,40
1667888,1460479,2024-06-26,Senate,"Unfinished Business SB155 B. & F.R. (Wiener) Concurrence",39,0,0,1,40
1667888,1460480,2024-06-26,Assembly,"SB 155 Budget and Fiscal Review Senate Third Reading By GABRIEL",74,1,0,4,79
1667889,1285626,2023-03-27,Senate,"Senate 3rd Reading SB156 B. & F.R. (Skinner)",29,8,0,3,40
1667889,1460699,2024-06-26,Senate,"Unfinished Business SB156 B. & F.R. (Wiener) Concurrence",31,7,0,2,40
1667889,1460700,2024-06-26,Assembly,"SB 156 Budget and Fiscal Review Senate Third Reading By GABRIEL",60,12,0,7,79
1667890,1285586,2023-03-27,Senate,"Senate 3rd Reading SB157 B. & F.R. (Skinner)",29,8,0,3,40
1667891,1285683,2023-03-27,Senate,"Senate 3rd Reading SB158 B. & F.R. (Skinner)",29,8,0,3,40
1667892,1285701,2023-03-27,Senate,"Senate 3rd Reading SB159 B. & F.R. (Skinner)",29,8,0,3,40
1667892,1461262,2024-06-27,Senate,"Unfinished Business SB159 B. & F.R. (Wiener) Concurrence",32,8,0,0,40
1667892,1461263,2024-06-27,Assembly,"SB 159 Budget and Fiscal Review Senate Third Reading By GABRIEL",59,10,0,10,79
1667893,1285686,2023-03-27,Senate,"Senate 3rd Reading SB160 B. & F.R. (Skinner)",29,8,0,3,40
1667894,1285591,2023-03-27,Senate,"Senate 3rd Reading SB161 B. & F.R. (Skinner)",29,8,0,3,40
1667895,1285620,2023-03-27,Senate,"Senate 3rd Reading SB162 B. & F.R. (Skinner)",29,8,0,3,40
1667896,1285589,2023-03-27,Senate,"Senate 3rd Reading SB163 B. & F.R. (Skinner)",29,8,0,3,40
1667896,1460702,2024-06-26,Senate,"Unfinished Business SB163 B. & F.R. (Wiener) Concurrence",31,6,0,3,40
1667896,1460703,2024-06-26,Assembly,"SB 163 Budget and Fiscal Review Senate Third Reading By GABRIEL",61,13,0,5,79
1667897,1285654,2023-03-27,Senate,"Senate 3rd Reading SB164 B. & F.R. (Skinner)",29,8,0,3,40
1667897,1460647,2024-06-26,Senate,"Unfinished Business SB164 B. & F.R. (Wiener) Concurrence",31,8,0,1,40
1667897,1460648,2024-06-26,Assembly,"SB 164 Budget and Fiscal Review Senate Third Reading By GABRIEL",60,14,0,5,79
1667898,1285771,2023-03-27,Senate,"Senate 3rd Reading SB165 B. & F.R. (Skinner)",29,8,0,3,40
1667899,1285765,2023-03-27,Senate,"Senate 3rd Reading SB166 B. & F.R. (Skinner)",29,8,0,3,40
1667900,1285679,2023-03-27,Senate,"Senate 3rd Reading SB167 B. & F.R. (Skinner)",29,8,0,3,40
1667900,1457309,2024-06-13,Senate,"Unfinished Business SB167 B. & F.R. (Wiener) Concurrence",29,8,0,3,40
1667900,1457310,2024-06-13,Assembly,"SB 167 Budget and Fiscal Review Senate Third Reading By GABRIEL",56,19,0,4,79
1667901,1285762,2023-03-27,Senate,"Senate 3rd Reading SB168 B. & F.R. (Skinner)",29,8,0,3,40
1667902,1285592,2023-03-27,Senate,"Senate 3rd Reading SB169 B. & F.R. (Skinner)",29,8,0,3,40
1667903,1285736,2023-03-27,Senate,"Senate 3rd Reading SB170 B. & F.R. (Skinner)",29,8,0,3,40
1667904,1285733,2023-03-27,Senate,"Senate 3rd Reading SB171 B. & F.R. (Skinner)",29,8,0,3,40
1667905,1285595,2023-03-27,Senate,"Senate 3rd Reading SB172 B. & F.R. (Skinner)",29,8,0,3,40
1667906,1285702,2023-03-27,Senate,"Senate 3rd Reading SB173 B. & F.R. (Skinner)",29,8,0,3,40
1667907,1285699,2023-03-27,Senate,"Senate 3rd Reading SB174 B. & F.R. (Skinner)",29,8,0,3,40
1667907,1460609,2024-06-26,Senate,"Unfinished Business SB174 B. & F.R. (Wiener) Concurrence",32,7,0,1,40
1667907,1460610,2024-06-26,Assembly,"SB 174 Budget and Fiscal Review Senate Third Reading By GABRIEL",59,7,0,13,79
1667908,1285623,2023-03-27,Senate,"Senate 3rd Reading SB175 B. & F.R. (Skinner)",29,8,0,3,40
1667908,1460550,2024-06-26,Senate,"Unfinished Business SB175 B. & F.R. (Wiener) Concurrence",30,7,0,3,40
1667908,1460551,2024-06-26,Assembly,"SB 175 Budget and Fiscal Review Senate Third Reading By GABRIEL",75,1,0,3,79
1667909,1285599,2023-03-27,Senate,"Senate 3rd Reading SB176 B. & F.R. (Skinner)",29,8,0,3,40
1667910,1285605,2023-03-27,Senate,"Senate 3rd Reading SB177 B. & F.R. (Skinner)",29,8,0,3,40
1667911,1285724,2023-03-27,Senate,"Senate 3rd Reading SB178 B. & F.R. (Skinner)",29,8,0,3,40
1667912,1285694,2023-03-27,Senate,"Senate 3rd Reading SB179 B. & F.R. (Skinner)",29,8,0,3,40
1667913,1285705,2023-03-27,Senate,"Senate 3rd Reading SB180 B. & F.R. (Skinner)",29,8,0,3,40
1667914,1285652,2023-03-27,Senate,"Senate 3rd Reading SB181 B. & F.R. (Skinner)",29,8,0,3,40
1667915,1285681,2023-03-27,Senate,"Senate 3rd Reading SB182 B. & F.R. (Skinner)",29,8,0,3,40
1667916,1285619,2023-03-27,Senate,"Senate 3rd Reading SB183 B. & F.R. (Skinner)",29,8,0,3,40
1667917,1285634,2023-03-27,Senate,"Senate 3rd Reading SB184 B. & F.R. (Skinner)",29,8,0,3,40
1667918,1285637,2023-03-27,Senate,"Senate 3rd Reading SB185 B. & F.R. (Skinner)",29,8,0,3,40
1667919,1285695,2023-03-27,Senate,"Senate 3rd Reading SB186 B. & F.R. (Skinner)",29,8,0,3,40
1667920,1285617,2023-03-27,Senate,"Senate 3rd Reading SB187 B. & F.R. (Skinner)",29,8,0,3,40
1667921,1285729,2023-03-27,Senate,"Senate 3rd Reading SB188 B. & F.R. (Skinner)",29,8,0,3,40
1667922,1285636,2023-03-27,Senate,"Senate 3rd Reading SB189 B. & F.R. (Skinner)",29,8,0,3,40
1667923,1285622,2023-03-27,Senate,"Senate 3rd Reading SB190 B. & F.R. (Skinner)",29,8,0,3,40
1667924,1285638,2023-03-27,Senate,"Senate 3rd Reading SB191 B. & F.R. (Skinner)",29,8,0,3,40
1667925,1285752,2023-03-27,Senate,"Senate 3rd Reading SB192 B. & F.R. (Skinner)",29,8,0,3,40
1667926,1285703,2023-03-27,Senate,"Senate 3rd Reading SB193 B. & F.R. (Skinner)",29,8,0,3,40
1667927,1285766,2023-03-27,Senate,"Senate 3rd Reading SB194 B. & F.R. (Skinner)",29,8,0,3,40
1667928,1285669,2023-03-27,Senate,"Senate 3rd Reading SB195 B. & F.R. (Skinner)",29,8,0,3,40
1667929,1285648,2023-03-27,Senate,"Senate 3rd Reading SB196 B. & F.R. (Skinner)",29,8,0,3,40
1667930,1285643,2023-03-27,Senate,"Senate 3rd Reading SB197 B. & F.R. (Skinner)",29,8,0,3,40
1667931,1285760,2023-03-27,Senate,"Senate 3rd Reading SB198 B. & F.R. (Skinner)",29,8,0,3,40
1667932,1285743,2023-03-27,Senate,"Senate 3rd Reading SB199 B. & F.R. (Skinner)",29,8,0,3,40
1667933,1285611,2023-03-27,Senate,"Senate 3rd Reading SB200 B. & F.R. (Skinner)",29,8,0,3,40
1667934,1285759,2023-03-27,Senate,"Senate 3rd Reading SB201 B. & F.R. (Skinner)",29,8,0,3,40
1667935,1285616,2023-03-27,Senate,"Senate 3rd Reading SB202 B. & F.R. (Skinner)",29,8,0,3,40
1667936,1285593,2023-03-27,Senate,"Senate 3rd Reading SB203 B. & F.R. (Skinner)",29,8,0,3,40
1667937,1285588,2023-03-27,Senate,"Senate 3rd Reading SB204 B. & F.R. (Skinner)",29,8,0,3,40
1667938,1285717,2023-03-27,Senate,"Senate 3rd Reading SB205 B. & F.R. (Skinner)",29,8,0,3,40
1667939,1285692,2023-03-27,Senate,"Senate 3rd Reading SB206 B. & F.R. (Skinner)",29,8,0,3,40
1667940,1285742,2023-03-27,Senate,"Senate 3rd Reading SB207 B. & F.R. (Skinner)",29,8,0,3,40
1667941,1285668,2023-03-27,Senate,"Senate 3rd Reading SB208 B. & F.R. (Skinner)",29,8,0,3,40
1667942,1285674,2023-03-27,Senate,"Senate 3rd Reading SB209 B. & F.R. (Skinner)",29,8,0,3,40
1667943,1285603,2023-03-27,Senate,"Senate 3rd Reading SB210 B. & F.R. (Skinner)",29,8,0,3,40
1667944,1285713,2023-03-27,Senate,"Senate 3rd Reading SB211 B. & F.R. (Skinner)",29,8,0,3,40
1667945,1285614,2023-03-27,Senate,"Senate 3rd Reading SB212 B. & F.R. (Skinner)",29,8,0,3,40
1667946,1285757,2023-03-27,Senate,"Senate 3rd Reading SB213 B. & F.R. (Skinner)",29,8,0,3,40
1667947,1285660,2023-03-27,Senate,"Senate 3rd Reading SB214 B. & F.R. (Skinner)",29,8,0,3,40
1667948,1285707,2023-03-27,Senate,"Senate 3rd Reading SB215 B. & F.R. (Skinner)",29,8,0,3,40
1667949,1285723,2023-03-27,Senate,"Senate 3rd Reading SB216 B. & F.R. (Skinner)",29,8,0,3,40
1667950,1285684,2023-03-27,Senate,"Senate 3rd Reading SB217 B. & F.R. (Skinner)",29,8,0,3,40
1667951,1285744,2023-03-27,Senate,"Senate 3rd Reading SB218 B. & F.R. (Skinner)",29,8,0,3,40
1667952,1285607,2023-03-27,Senate,"Senate 3rd Reading SB219 B. & F.R. (Skinner)",29,8,0,3,40
1667952,1466205,2024-08-29,Assembly,"Do pass",12,0,0,0,12
1667952,1466713,2024-08-31,Senate,"Unfinished Business SB219 Wiener et al. Concurrence",33,4,0,3,40
1667952,1466714,2024-08-31,Assembly,"SB 219 Wiener Senate Third Reading By Hart",77,0,0,2,79
1667954,1363755,2024-01-09,Senate,"Do pass, but first be re-referred to the Committee on [Appropriations]",5,0,0,0,5
1667954,1371082,2024-01-29,Senate,"Senate 3rd Reading SB92 Umberg",35,1,0,4,40
1667954,1453391,2024-06-04,Assembly,"Do pass and be re-referred to the Committee on [Appropriations]",6,0,0,2,8
1667954,1460084,2024-06-25,Assembly,"Do pass",11,0,0,1,12
1667954,1461214,2024-06-27,Senate,"Unfinished Business SB92 Umberg et al. Urgency Clause Concurrence",40,0,0,0,40
1667954,1461215,2024-06-27,Assembly,"SB 92 Umberg Third Reading Urgency By Kalra",76,0,0,3,79
1667956,1298200,2023-04-11,Senate,"Do pass, but first be re-referred to the Committee on [Appropriations]",4,1,0,0,5
1667956,1308791,2023-04-24,Senate,"Placed on suspense file",7,0,0,0,7
1667956,1328901,2023-05-18,Senate,"Do pass as amended",5,2,0,0,7
1667956,1332633,2023-05-24,Senate,"Senate 3rd Reading SB94 Cortese et al",22,12,0,6,40
1667956,1348344,2023-06-27,Assembly,"Do pass and be re-referred to the Committee on [Appropriations]",6,2,0,0,8
1667956,1352891,2023-09-01,Assembly,"Do pass as amended",10,5,0,1,16
1667957,1299452,2023-04-11,Senate,"Do pass as amended",9,1,0,1,11
1667957,1330143,2023-05-22,Senate,"Senate 3rd Reading SB95 Roth",39,1,0,0,40
1667957,1340062,2023-06-06,Assembly,"Do pass",8,0,0,3,11
1667957,1352455,2023-08-31,Assembly,"SB 95 Roth Senate Third Reading By Maienschein",72,1,0,7,80
1667958,1313513,2023-04-26,Senate,"Do pass as amended, but first amend, and re-refer to the Committee on [Appropriations]",6,0,0,2,8
1667958,1324954,2023-05-15,Senate,"Placed on suspense file",7,0,0,0,7
1667958,1328690,2023-05-18,Senate,"Do pass",7,0,0,0,7
1667958,1335482,2023-05-30,Senate,"Senate 3rd Reading SB96 Portantino",38,0,0,2,40
1667958,1350244,2023-07-10,Assembly,"Do pass and be re-referred to the Committee on [Appropriations]",10,0,0,1,11
1667958,1353054,2023-09-01,Assembly,"Do pass",16,0,0,0,16
1667958,1353405,2023-09-07,Assembly,"SB 96 Portantino Senate Third Reading By Holden",79,0,0,1,80
1667958,1354609,2023-09-11,Senate,"Unfinished Business SB96 Portantino Concurrence",38,0,0,2,40
1667959,1288168,2023-03-28,Senate,"Do pass, but first be re-referred to the Committee on [Appropriations]",5,0,0,0,5
1667959,1296930,2023-04-10,Senate,"Placed on suspense file",7,0,0,0,7
1667959,1328425,2023-05-18,Senate,"Do pass as amended",5,1,0,1,7
1667959,1332631,2023-05-24,Senate,"Senate 3rd Reading SB97 Wiener",37,0,0,3,40
1667959,1348466,2023-06-27,Assembly,"Do pass and be re-referred to the Committee on [Appropriations] with recommendation: To Consent Calendar",8,0,0,0,8
1667959,1352636,2023-09-01,Assembly,"Do pass as amended",11,0,0,5,16
1667959,1354185,2023-09-13,Assembly,"SB 97 Wiener Senate Third Reading By Holden",77,0,0,3,80
1667959,1354787,2023-09-14,Senate,"Unfinished Business SB97 Wiener Concurrence",40,0,0,0,40
1667960,1281804,2023-03-22,Senate,"Do pass, but first be re-referred to the Committee on [Appropriations]",6,1,0,0,7
1667960,1296987,2023-04-10,Senate,"Placed on suspense file",7,0,0,0,7
1667960,1328487,2023-05-18,Senate,"Do pass",6,1,0,0,7
1667960,1332602,2023-05-24,Senate,"Senate 3rd Reading SB98 Portantino",35,3,0,2,40
1667960,1456845,2024-06-12,Assembly,"Do pass as amended, and be re-referred to the Committee on [Appropriations] with recommendation: To Consent Calendar",7,0,0,0,7
1667960,1464208,2024-08-15,Assembly,"Do pass",14,0,0,1,15
1667960,1465750,2024-08-26,Assembly,"SB 98 Portantino Senate Third Reading By Addis",74,1,0,4,79
1667960,1465934,2024-08-27,Senate,"Unfinished Business SB98 Portantino Concurrence",40,0,0,0,40
1667961,1310268,2023-04-25,Senate,"Do pass, but first be re-referred to the Committee on [Appropriations]",5,0,0,0,5
1667961,1330109,2023-05-22,Senate,"Senate 3rd Reading SB99 Umberg",37,0,0,3,40
1667961,1462232,2024-07-02,Assembly,"Do pass and be re-referred to the Committee on [Appropriations]",3,1,0,4,8
1667961,1462233,2024-07-02,Assembly,Reconsideration,5,2,0,1,8
1667962,1236691,2023-01-26,Senate,"Senate 3rd Reading SCR15 Newman et al",38,0,0,2,40
1667962,1255137,2023-02-17,Assembly,"Be adopted. To Consent Calendar",12,0,0,1,13
1667962,1260561,2023-02-23,Assembly,"SCR 15 Newman Consent Calendar Second Day Regular Session",77,0,0,3,80
1667963,1238204,2023-01-30,Senate,"Senate 3rd Reading SR11 Alvarado-Gil et al",38,0,0,2,40
1671107,1305384,2023-04-18,Assembly,"Do pass and be re-referred to the Committee on [Appropriations]",8,3,0,1,12
1671107,1328517,2023-05-18,Assembly,"Do pass as amended",11,3,0,2,16
1671107,1337232,2023-06-01,Assembly,"AB 252 Holden Assembly Third Reading",42,15,0,23,80
1671109,1264451,2023-02-28,Assembly,"Do pass and be re-referred to the Committee on [Appropriations] with recommendation: To Consent Calendar",8,0,0,0,8
1671110,1276622,2023-03-14,Assembly,"Do pass and be re-referred to the Committee on [Privacy and Consumer Protection]",13,0,0,2,15
1671110,1311780,2023-04-25,Assembly,"Do pass and be re-referred to the Committee on [Appropriations]",10,0,0,1,11
1671110,1322864,2023-05-10,Assembly,"Do pass",15,0,0,1,16
1671110,1330088,2023-05-22,Assembly,"AB 254 Bauer-Kahan Assembly Third Reading",76,0,0,4,80
1671110,1343754,2023-06-13,Senate,"Do pass, but first be re-referred to the Committee on [Health]",9,0,0,2,11
1671110,1349804,2023-07-05,Senate,"Do pass, but first be re-referred to the Committee on [Appropriations]",11,1,0,0,12
1671110,1353285,2023-09-06,Senate,"Assembly 3rd Reading AB254 Bauer-Kahan et al. By Ashby",40,0,0,0,40
1671110,1353481,2023-09-07,Assembly,"AB 254 Bauer-Kahan Concurrence in Senate Amendments",77,0,0,3,80
1671111,1281835,2023-03-21,Assembly,"Do pass and be re-referred to the Committee on [Appropriations]",11,0,0,1,12
1671111,1328862,2023-05-18,Assembly,"Do pass",15,0,0,1,16
1671111,1333606,2023-05-25,Assembly,"AB 255 Alanis Assembly Third Reading",78,0,0,2,80
1671111,1346307,2023-06-21,Senate,"Do pass, but first be re-referred to the Committee on [Appropriations] with the recommendation: To Consent Calendar",7,0,0,0,7
1671111,1349466,2023-07-03,Senate,"Placed on suspense file",7,0,0,0,7
1671111,1352823,2023-09-01,Senate,"Do pass as amended",7,0,0,0,7
1671111,1354321,2023-09-13,Senate,"Special Consent AB255 Alanis et al. By Rubio",39,0,0,1,40
1671111,1354710,2023-09-14,Assembly,"AB 255 Alanis Concurrence in Senate Amendments",80,0,0,0,80
1671112,1310167,2023-04-24,Assembly,"Do pass and be re-referred to the Committee on [Appropriations]",15,0,0,0,15
1671112,1322866,2023-05-10,Assembly,"Do pass. To Consent Calendar",14,0,0,2,16
1671112,1328250,2023-05-18,Assembly,"AB 256 Dixon Consent Calendar Second Day Regular Session",74,0,0,6,80
1671112,1343704,2023-06-13,Senate,"Do pass, but first be re-referred to the Committee on [Appropriations] with the recommendation: To Consent Calendar",5,0,0,0,5
1671112,1353745,2023-09-12,Senate,"Assembly 3rd Reading AB256 Dixon By Rubio",38,0,0,2,40
1671112,1354409,2023-09-13,Assembly,"AB 256 Dixon Concurrence in Senate Amendments",80,0,0,0,80
1671113,1270455,2023-03-07,Assembly,"Do pass and be re-referred to the Committee on [Appropriations]",2,6,0,0,8
1671114,1310135,2023-04-25,Assembly,"Do pass as amended, and be re-referred to the Committee on [Appropriations] with recommendation: To Consent Calendar",7,0,0,0,7
1671114,1328121,2023-05-18,Assembly,"Do pass as amended",11,0,0,5,16
1671114,1333723,2023-05-25,Assembly,"AB 258 Reyes Assembly Third Reading",77,0,0,3,80
1671114,1343140,2023-06-12,Senate,"Do pass, but first be re-referred to the Committee on [Governmental Organization]",12,0,0,1,13
1671114,1350224,2023-07-11,Senate,"Do pass, but first be re-referred to the Committee on [Appropriations]",14,0,0,1,15
1671114,1351377,2023-08-14,Senate,"Placed on suspense file",7,0,0,0,7
1671114,1353038,2023-09-01,Senate,"Do pass as amended",7,0,0,0,7
1671114,1354160,2023-09-13,Senate,"Assembly 3rd Reading AB258 Reyes et al. By Alvarado-Gil",39,0,0,1,40
1671114,1354706,2023-09-14,Assembly,"AB 258 Reyes Concurrence in Senate Amendments",80,0,0,0,80
1671117,1305391,2023-04-18,Assembly,"Do pass and be re-referred to the Committee on [Appropriations]",9,0,0,3,12
1671118,1271508,2023-03-08,Assembly,"Do pass. To Consent Calendar",22,0,0,0,22
1671118,1277651,2023-03-16,Assembly,"AB 261 Kalra Consent Calendar Second Day Regular Session",73,0,0,7,80
1671118,1343796,2023-06-13,Senate,"Do pass",14,0,0,1,15
1671118,1353241,2023-09-06,Senate,"Assembly 3rd Reading AB261 Kalra By Laird",40,0,0,0,40
1671119,1310251,2023-04-25,Assembly,"Do pass and be re-referred to the Committee on [Appropriations]",8,0,0,0,8
1671119,1327947,2023-05-18,Assembly,"Do pass",15,0,0,1,16
1671119,1333706,2023-05-25,Assembly,"AB 262 Holden Assembly Third Reading",76,0,0,4,80
1671119,1349623,2023-07-03,Senate,"Do pass, but first be re-referred to the Committee on [Appropriations]",5,0,0,0,5
1671119,1351448,2023-08-14,Senate,"Placed on suspense file",7,0,0,0,7
1671119,1352654,2023-09-01,Senate,"Do pass as amended",5,2,0,0,7
1671119,1353208,2023-09-06,Senate,"Assembly 3rd Reading AB262 Holden By Alvarado-Gil",33,5,0,2,40
1671119,1465646,2024-08-26,Senate,"Assembly 3rd Reading AB262 Holden By Hurtado",33,6,0,1,40
1671119,1465965,2024-08-27,Assembly,"AB 262 Holden Concurrence in Senate Amendments",76,0,0,3,79
1671120,1298233,2023-04-11,Assembly,"Do pass and be re-referred to the Committee on [Appropriations]",10,1,0,1,12
1671121,1281837,2023-03-21,Assembly,"Do pass",12,0,0,0,12
1671121,1296916,2023-04-10,Assembly,"AB 264 Ting Assembly Third Reading",68,0,0,12,80
1671121,1340972,2023-06-07,Senate,"Do pass as amended",6,0,0,1,7
1671121,1353278,2023-09-06,Senate,"Assembly 3rd Reading AB264 Ting et al. By Min",35,0,0,5,40
1671121,1353443,2023-09-07,Assembly,"AB 264 Ting Concurrence in Senate Amendments",79,0,0,1,80
1671123,1310242,2023-04-24,Assembly,"Do pass and be re-referred to the Committee on [Appropriations]",11,0,0,0,11
1671123,1328109,2023-05-18,Assembly,"Do pass",15,0,0,1,16
1671123,1333616,2023-05-25,Assembly,"AB 265 Boerner Assembly Third Reading",77,0,0,3,80
1671123,1346325,2023-06-21,Senate,"Do pass, but first be re-referred to the Committee on [Appropriations] with the recommendation: To Consent Calendar",8,0,0,0,8
1671123,1349492,2023-07-03,Senate,"Placed on suspense file",7,0,0,0,7
1671123,1352889,2023-09-01,Senate,"Do pass",7,0,0,0,7
1671123,1353946,2023-09-12,Senate,"Special Consent AB265 Boerner By Ashby",39,0,0,1,40
1671125,1311766,2023-04-25,Assembly,"Do pass and be re-referred to the Committee on [Appropriations]",11,0,0,1,12
1671127,1236694,2023-01-26,Assembly,"Be adopted. To Consent Calendar",13,0,0,0,13
1671127,1241834,2023-02-02,Assembly,"HR 10 Muratsuchi Consent Calendar Second Day Regular Session",73,0,0,7,80
1671128,1318017,2023-05-03,Senate,"Do pass, but first be re-referred to the Committee on [Appropriations]",7,0,0,1,8
1671128,1324987,2023-05-15,Senate,"Placed on suspense file",7,0,0,0,7
1671131,1281890,2023-03-22,Senate,"Do pass, but first be re-referred to the Committee on [Appropriations] with the recommendation: To Consent Calendar",7,0,0,0,7
1671131,1296998,2023-04-10,Senate,"Placed on suspense file",7,0,0,0,7
1671131,1328320,2023-05-18,Senate,"Do pass",7,0,0,0,7
1671131,1333783,2023-05-25,Senate,"Special Consent SB223 Menjivar",40,0,0,0,40
1671131,1350491,2023-07-12,Assembly,"Do pass and be re-referred to the Committee on [Appropriations] with recommendation: To Consent Calendar",7,0,0,0,7
1671131,1351582,2023-08-16,Assembly,"Do pass. To Consent Calendar",15,0,0,1,16
1671131,1352228,2023-08-24,Assembly,"SB 223 Menjivar Consent Calendar Second Day Regular Session",73,0,0,7,80
1671132,1299361,2023-04-11,Senate,"Do pass as amended, but first amend, and re-refer to the Committee on [Agriculture]",6,2,0,3,11
1671132,1308853,2023-04-24,Senate,"Do pass, but first be re-referred to the Committee on [Appropriations]",3,0,0,1,4
1671132,1315775,2023-05-01,Senate,"Placed on suspense file",6,0,0,1,7
1671133,1281825,2023-03-21,Senate,"Do pass, but first be re-referred to the Committee on [Governmental Organization]",8,0,0,3,11
1671133,1298281,2023-04-11,Senate,"Do pass, but first be re-referred to the Committee on [Appropriations]",11,0,0,4,15
1671133,1308786,2023-04-24,Senate,"Placed on suspense file",7,0,0,0,7
1671133,1328141,2023-05-18,Senate,"Do pass",5,1,0,1,7
1671133,1332597,2023-05-24,Senate,"Senate 3rd Reading SB225 Caballero et al",33,4,0,3,40
1671133,1346165,2023-06-21,Assembly,"Do pass as amended and be re-referred to the Committee on [Accountability and Administrative Review]",6,1,0,1,8
1671133,1464224,2024-08-15,Assembly,"Do pass",11,2,0,2,15
1671134,1310371,2023-04-25,Senate,"Do pass, but first be re-referred to the Committee on [Appropriations]",5,0,0,0,5
1671134,1320368,2023-05-08,Senate,"Placed on suspense file",7,0,0,0,7
1671134,1328714,2023-05-18,Senate,"Do pass",7,0,0,0,7
1671134,1335390,2023-05-30,Senate,"Senate 3rd Reading SB226 Alvarado-Gil et al",36,0,0,4,40
1671134,1348412,2023-06-27,Assembly,"Do pass and be re-referred to the Committee on [Appropriations]",2,1,0,5,8
1671134,1462656,2024-07-02,Assembly,"Do pass as amended and be re-referred to the Committee on [Appropriations]",7,0,0,1,8
1671135,1271511,2023-03-08,Senate,"Do pass, but first be re-referred to the Committee on [Governance and Finance]",4,0,0,1,5
1671135,1305382,2023-04-19,Senate,"Do pass as amended, but first amend, and re-refer to the Committee on [Appropriations]",5,2,0,1,8
1671135,1315787,2023-05-01,Senate,"Placed on suspense file",6,0,0,1,7
1671135,1328655,2023-05-18,Senate,"Do pass",5,2,0,0,7
1671135,1335484,2023-05-30,Senate,"Senate 3rd Reading SB227 Durazo et al",30,7,0,3,40
1671135,1348455,2023-06-28,Assembly,"Do pass and be re-referred to the Committee on [Appropriations]",10,3,0,1,14
1671135,1464264,2024-08-15,Assembly,"Do pass as amended",11,3,0,1,15
1671135,1466138,2024-08-29,Senate,"Unfinished Business SB227 Durazo et al. Concurrence",30,9,0,1,40
1671135,1466710,2024-08-28,Assembly,"SB 227 Durazo Senate Third Reading By Juan Carrillo",59,15,0,5,79
1676715,1274179,2023-03-13,Assembly,"Do pass and be re-referred to the Committee on [Appropriations]",7,0,0,0,7
1676715,1305264,2023-04-19,Assembly,"Do pass. To Consent Calendar",14,0,0,2,16
1676715,1313388,2023-04-27,Assembly,"AB 267 Bauer-Kahan Consent Calendar Second Day Regular Session",79,0,0,1,80
1676715,1343710,2023-06-13,Senate,"Do pass, but first be re-referred to the Committee on [Appropriations]",14,0,0,1,15
1676715,1353317,2023-09-06,Senate,"Assembly 3rd Reading AB267 Bauer-Kahan By Glazer",40,0,0,0,40
1676715,1353440,2023-09-07,Assembly,"AB 267 Bauer-Kahan Concurrence in Senate Amendments",79,0,0,1,80
1676716,1264447,2023-02-28,Assembly,"Do pass and be re-referred to the Committee on [Appropriations]",6,2,0,0,8
1676716,1328506,2023-05-18,Assembly,"Do pass",11,4,0,1,16
1676716,1338018,2023-05-31,Assembly,"AB 268 Weber Assembly Third Reading",62,16,0,2,80
1676716,1350265,2023-07-11,Senate,"Do pass, but first be re-referred to the Committee on [Appropriations]",4,0,0,1,5
1676716,1351404,2023-08-14,Senate,"Placed on suspense file",7,0,0,0,7
1676716,1353009,2023-09-01,Senate,"Do pass",5,2,0,0,7
1676716,1354116,2023-09-13,Senate,"Assembly 3rd Reading AB268 Weber et al. By Atkins",29,3,0,8,40
1676716,1354117,2023-09-13,Assembly,"AB 268 Weber Concurrence in Senate Amendments",58,18,0,4,80
1676717,1251024,2023-02-14,Assembly,"Do pass and be re-referred to the Committee on [Health]",17,0,0,2,19
1676717,1252503,2023-02-15,Assembly,"Do pass",11,0,0,4,15
1676717,1255121,2023-02-17,Assembly,"AB 269 Berman Third Reading Urgency",69,0,0,11,80
1676717,1264449,2023-02-27,Senate,"Do pass, but first be re-referred to the Committee on [Appropriations]",10,0,0,3,13
1676717,1267520,2023-03-02,Senate,"Assembly 3rd Reading AB269 Berman By Lim√≥n Urgency Clause",34,0,0,6,40
1676718,1305283,2023-04-19,Assembly,"Do pass and be re-referred to the Committee on [Appropriations]",5,2,0,1,8
1676718,1327953,2023-05-18,Assembly,"Do pass",11,4,0,1,16
1676718,1338108,2023-05-31,Assembly,"AB 270 Lee Assembly Third Reading",59,18,0,3,80
1676718,1462285,2024-07-02,Senate,"Do pass as amended, but first amend, and re-refer to the Committee on [Appropriations]",6,1,0,0,7
1676718,1463380,2024-08-05,Senate,"Placed on suspense file",7,0,0,0,7
1676719,1264457,2023-02-28,Assembly,"Do pass. To Consent Calendar",8,0,0,0,8
1676719,1343708,2023-06-13,Senate,"Do pass, but first be re-referred to the Committee on [Human Services] with the recommendation: To Consent Calendar",5,0,0,0,5
1676719,1349640,2023-03-06,Assembly,"AB 271 Quirk-Silva Consent Calendar Second Day",79,0,0,1,80
1676719,1349641,2023-07-03,Senate,"Do pass and be ordered to the Consent Calendar",5,0,0,0,5
1676719,1350704,2023-07-13,Senate,"Consent Calendar AB271 Quirk-Silva et al",37,0,0,3,40
1676719,1351523,2023-08-14,Assembly,"AB 271 Quirk-Silva Concurrence in Senate Amendments",77,0,0,3,80
1676721,1275567,2023-03-14,Assembly,"Do pass as amended, and be re-referred to the Committee on [Appropriations] with recommendation: To Consent Calendar",11,0,0,0,11
1676721,1328621,2023-05-18,Assembly,"Do pass",15,0,0,1,16
1676721,1333552,2023-05-25,Assembly,"AB 273 Ramos Assembly Third Reading",78,0,0,2,80
1676721,1345555,2023-06-19,Senate,"Do pass, but first be re-referred to the Committee on [Judiciary]",5,0,0,0,5
1676721,1349740,2023-07-06,Senate,"Do pass as amended, but first amend, and re-refer to the Committee on [Appropriations] with the recommendation: To Consent Calendar",11,0,0,0,11
1676721,1351306,2023-08-14,Senate,"Placed on suspense file",7,0,0,0,7
1676721,1353034,2023-09-01,Senate,"Do pass as amended",7,0,0,0,7
1676721,1354346,2023-09-13,Senate,"Special Consent AB273 Ramos et al",39,0,0,1,40
1676721,1354637,2023-09-14,Assembly,"AB 273 Ramos Concurrence in Senate Amendments",80,0,0,0,80
1676722,1304301,2023-04-18,Assembly,"Do pass as amended and be re-referred to the Committee on [Appropriations]",7,0,0,1,8
1676722,1328033,2023-05-18,Assembly,"Do pass",15,0,0,1,16
1676722,1330051,2023-05-22,Assembly,"AB 274 Bryan Assembly Third Reading",77,0,0,3,80
1676722,1345651,2023-06-19,Senate,"Do pass, but first be re-referred to the Committee on [Governmental Organization] with the recommendation: To Consent Calendar",5,0,0,0,5
1676722,1347899,2023-06-27,Senate,"Do pass, but first be re-referred to the Committee on [Appropriations] with the recommendation: To Consent Calendar",15,0,0,0,15
1676722,1349987,2023-07-10,Senate,"Placed on suspense file",6,0,0,1,7
1676722,1353078,2023-09-01,Senate,"Do pass",7,0,0,0,7
1676722,1466284,2024-08-29,Assembly,"AB 274 Bryan Concurrence in Senate Amendments",76,0,0,3,79
1676722,1466862,2024-08-28,Senate,"Assembly 3rd Reading AB274 Bryan By Ashby",39,0,0,1,40
1676723,1283135,2023-03-22,Assembly,"Do pass",7,0,0,0,7
1676723,1296927,2023-04-10,Assembly,"AB 275 Ward Assembly Third Reading",67,0,0,13,80
1676723,1340968,2023-06-07,Senate,"Do pass and be ordered to the Consent Calendar",7,0,0,0,7
1676723,1353183,2023-09-05,Senate,"Assembly 3rd Reading AB275 Ward et al. By Glazer",39,0,0,1,40
1676723,1353360,2023-09-07,Assembly,"AB 275 Ward Concurrence in Senate Amendments",79,0,0,1,80
1676724,1285598,2023-03-27,Assembly,"Do pass and be re-referred to the Committee on [Appropriations]",14,0,0,1,15
1676725,1274192,2023-03-13,Assembly,"Do pass and be re-referred to the Committee on [Water, Parks, and Wildlife] with recommendation: To Consent Calendar",7,0,0,0,7
1676725,1305445,2023-04-18,Assembly,"Do pass and be re-referred to the Committee on [Appropriations] with recommendation: To Consent Calendar",15,0,0,0,15
1676725,1328838,2023-05-18,Assembly,"Do pass as amended",11,0,0,5,16
1676725,1337998,2023-05-31,Assembly,"AB 277 Rodriguez Assembly Third Reading",79,0,0,1,80
1676725,1346952,2023-06-22,Senate,"Do pass as amended, but first amend, and re-refer to the Committee on [Governmental Organization] with the recommendation: To Consent Calendar",11,0,0,0,11
1676725,1350183,2023-07-11,Senate,"Do pass, but first be re-referred to the Committee on [Appropriations] with the recommendation: To Consent Calendar",14,0,0,1,15
1676725,1351770,2023-08-21,Senate,"Placed on suspense file",7,0,0,0,7
1676726,1289779,2023-03-29,Assembly,"Do pass and be re-referred to the Committee on [Appropriations] with recommendation: To Consent Calendar",6,0,0,1,7
1676726,1328301,2023-05-18,Assembly,"Do pass",15,0,0,1,16
1676726,1330082,2023-05-22,Assembly,"AB 278 Reyes Assembly Third Reading",75,0,0,5,80
1676726,1344176,2023-06-14,Senate,"Do pass, but first be re-referred to the Committee on [Appropriations]",7,0,0,0,7
1676726,1347499,2023-06-26,Senate,"Placed on suspense file",6,0,0,1,7
1676726,1352879,2023-09-01,Senate,"Do pass as amended",5,2,0,0,7
1676726,1353370,2023-09-07,Senate,"Assembly 3rd Reading AB278 Reyes et al. By Lim√≥n",37,2,0,1,40
1676726,1353599,2023-09-11,Assembly,"AB 278 Reyes Concurrence in Senate Amendments",76,0,0,4,80
1676727,1241837,2023-02-02,Assembly,"Be adopted. To Consent Calendar",13,0,0,0,13
1676727,1247341,2023-02-09,Assembly,"ACR 6 Muratsuchi Consent Calendar Second Day",74,0,0,6,80
1676727,1267510,2023-03-02,Senate,"Special Consent ACR6 Muratsuchi et al",34,0,0,6,40
1676728,1310156,2023-04-24,Assembly,"Be adopted, and re-refer to the Committee on [Appropriations] with recommendation: To Consent Calendar",15,0,0,0,15
1676728,1333631,2023-05-25,Assembly,"ACR 7 Ramos Consent Calendar Second Day",76,0,0,4,80
1676728,1348428,2023-06-27,Senate,"Be adopted, but first be re-referred to the Committee on [Appropriations] with recommendation: To Consent Calendar",16,0,0,0,16
1676728,1350638,2023-07-13,Senate,"Consent Calendar ACR7 Ramos et al",37,0,0,3,40
1676729,1308782,2023-04-24,Senate,"Do pass, but first be re-referred to the Committee on [Appropriations] with the recommendation: To Consent Calendar",4,0,0,1,5
1676729,1320537,2023-05-08,Senate,"Placed on suspense file",7,0,0,0,7
1676729,1328527,2023-05-18,Senate,"Do pass",7,0,0,0,7
1676729,1333620,2023-05-25,Senate,"Special Consent SB228 Roth",40,0,0,0,40
1676729,1346246,2023-06-20,Assembly,"Do pass and be re-referred to the Committee on [Appropriations] with recommendation: To Consent Calendar",9,0,0,2,11
1676729,1353018,2023-09-01,Assembly,"Do pass",16,0,0,0,16
1676729,1353537,2023-09-07,Assembly,"SB 228 Roth Senate Third Reading By Schiavo",79,0,0,1,80
1676730,1305493,2023-04-19,Senate,"Do pass, but first be re-referred to the Committee on [Appropriations]",6,1,0,1,8
1676730,1330080,2023-05-22,Senate,"Senate 3rd Reading SB229 Umberg",31,6,0,3,40
1676730,1350530,2023-07-12,Assembly,"Do pass and be re-referred to the Committee on [Appropriations]",6,1,0,1,8
1676730,1350531,2023-07-12,Assembly,"Do pass and be re-referred to the Committee on [Housing and Community Development]",6,2,0,0,8
1676730,1352105,2023-08-23,Assembly,"Do pass as amended",10,4,0,2,16
1676730,1353595,2023-09-11,Assembly,"SB 229 Umberg Senate Third Reading By Ting",62,17,0,1,80
1676730,1353863,2023-09-12,Senate,"Unfinished Business SB229 Umberg Concurrence",31,7,0,2,40
1676731,1318033,2023-05-03,Senate,"Do pass as amended, but first amend, and re-refer to the Committee on [Appropriations]",4,2,0,2,8
1676731,1318034,2023-05-03,Senate,"[First] hearing set for [05-03-2023]: Failed passage in Committee. Reconsideration granted",7,0,0,1,8
1676731,1363949,2024-01-10,Senate,"Do pass as amended, but first amend, and re-refer to the Committee on [Appropriations]",5,3,0,0,8
1676731,1364818,2024-01-16,Senate,"Placed on suspense file",6,0,0,1,7
1676731,1366810,2024-01-18,Senate,"Do pass",5,1,0,1,7
1676731,1371100,2024-01-29,Senate,"Senate 3rd Reading SB230 Seyarto et al",28,4,0,8,40
1676732,1304449,2023-04-18,Senate,"Do pass as amended, but first amend, and re-refer to the Committee on [Appropriations]",9,0,0,2,11
1676732,1315716,2023-05-01,Senate,"Placed on suspense file",6,0,0,1,7
1676732,1328407,2023-05-18,Senate,"Do pass",7,0,0,0,7
1676732,1333547,2023-05-25,Senate,"Special Consent SB231 Hurtado",40,0,0,0,40
1676732,1350142,2023-07-11,Assembly,"Do pass as amended and be re-referred to the Committee on [Appropriations]",14,0,0,1,15
1679020,1278497,2023-03-14,Assembly,"Do pass",8,0,0,1,9
1679020,1296954,2023-04-10,Assembly,"AB 279 Blanca Rubio Assembly Third Reading",67,0,0,13,80
1679020,1340999,2023-06-07,Senate,"Do pass",6,0,0,1,7
1679020,1353138,2023-09-05,Senate,"Assembly 3rd Reading AB279 Blanca Rubio et al. By Rubio",38,0,0,2,40
1679021,1275589,2023-03-14,Assembly,"Do pass and be re-referred to the Committee on [Appropriations]",6,1,0,1,8
1679021,1328780,2023-05-18,Assembly,"Do pass as amended",11,4,0,1,16
1679021,1338135,2023-05-31,Assembly,"AB 280 Holden Assembly Third Reading",56,16,0,8,80
1679021,1350259,2023-07-11,Senate,"Do pass, but first be re-referred to the Committee on [Appropriations]",3,1,0,1,5
1679021,1351274,2023-08-14,Senate,"Placed on suspense file",7,0,0,0,7
1679021,1352827,2023-09-01,Senate,"Do pass as amended",5,2,0,0,7
1679021,1354232,2023-09-13,Senate,"Assembly 3rd Reading AB280 Holden et al. By Durazo",21,12,0,7,40
1679022,1281819,2023-03-22,Assembly,"Do pass and be re-referred to the Committee on [Housing and Community Development]",7,0,0,1,8
1679022,1299455,2023-04-12,Assembly,"Do pass as amended and be re-referred to the Committee on [Appropriations]",8,0,0,0,8
1679022,1311870,2023-04-26,Assembly,"Do pass. To Consent Calendar",16,0,0,0,16
1679022,1318942,2023-05-04,Assembly,"AB 281 Grayson Consent Calendar Second Day Regular Session",75,0,0,5,80
1679022,1346162,2023-06-21,Senate,"Do pass, but first be re-referred to the Committee on [Housing]",8,0,0,0,8
1679022,1350215,2023-07-10,Senate,"Do pass, but first be re-referred to the Committee on [Appropriations]",11,0,0,0,11
1679022,1353119,2023-09-05,Senate,"Assembly 3rd Reading AB281 Grayson et al. By Caballero",39,0,0,1,40
1679023,1286915,2023-03-28,Assembly,"Do pass and be re-referred to the Committee on [Appropriations] with recommendation: To Consent Calendar",18,0,0,1,19
1679023,1305244,2023-04-19,Assembly,"Do pass. To Consent Calendar",14,0,0,2,16
1679023,1313524,2023-04-27,Assembly,"AB 282 Aguiar-Curry Consent Calendar Second Day Regular Session",79,0,0,1,80
1679023,1349523,2023-07-03,Senate,"Do pass, but first be re-referred to the Committee on [Appropriations]",12,0,0,1,13
1679023,1353162,2023-09-05,Senate,"Assembly 3rd Reading AB282 Aguiar-Curry By Menjivar",39,0,0,1,40
1679023,1353524,2023-09-07,Assembly,"AB 282 Aguiar-Curry Concurrence in Senate Amendments",79,0,0,1,80
1679024,1276619,2023-03-14,Assembly,"Do pass. To Consent Calendar",13,0,0,2,15
1679024,1283101,2023-03-23,Assembly,"AB 283 Jim Patterson Consent Calendar Second Day",74,0,0,6,80
1679024,1341022,2023-06-07,Senate,"Do pass and be ordered to the Consent Calendar",12,0,0,0,12
1679026,1283182,2023-03-22,Assembly,"Do pass and be re-referred to the Committee on [Appropriations]",6,0,0,1,7
1679026,1305414,2023-04-19,Assembly,"Do pass",11,3,0,2,16
1679026,1320398,2023-05-08,Assembly,"AB 285 Luz Rivas Assembly Third Reading",59,2,0,19,80
1679026,1341004,2023-06-07,Senate,"Do pass, but first be re-referred to the Committee on [Appropriations]",7,0,0,0,7
1679026,1353764,2023-09-12,Senate,"Assembly 3rd Reading AB285 Luz Rivas et al. By Cortese",33,0,0,7,40
1679026,1354396,2023-09-13,Assembly,"AB 285 Luz Rivas Concurrence in Senate Amendments",67,4,0,9,80
1679027,1288384,2023-03-29,Assembly,"Do pass as amended and be re-referred to the Committee on [Appropriations]",10,0,0,3,13
1679027,1322888,2023-05-10,Assembly,"Do pass",12,0,0,4,16
1679027,1330043,2023-05-22,Assembly,"AB 286 Wood Assembly Third Reading",63,0,0,17,80
1679027,1345566,2023-06-20,Senate,"Do pass as amended, but first amend, and re-refer to the Committee on [Appropriations]",18,0,0,0,18
1679027,1351412,2023-08-14,Senate,"Placed on suspense file",7,0,0,0,7
1679027,1352935,2023-09-01,Senate,"Do pass",7,0,0,0,7
1679027,1353854,2023-09-12,Senate,"Special Consent AB286 Wood By Caballero",39,0,0,1,40
1679027,1354182,2023-09-13,Assembly,"AB 286 Wood Concurrence in Senate Amendments",74,0,0,6,80
1679028,1274177,2023-03-13,Assembly,"Do pass and be re-referred to the Committee on [Appropriations]",9,1,0,1,11
1679030,1304425,2023-04-18,Senate,"Do pass, but first be re-referred to the Committee on [Transportation]",12,1,0,5,18
1679030,1311918,2023-04-25,Senate,"Do pass as amended, but first amend, and re-refer to the Committee on [Appropriations]",11,3,0,2,16
1679030,1325032,2023-05-15,Senate,"Placed on suspense file",7,0,0,0,7
1679030,1328122,2023-05-18,Senate,"Do pass as amended",5,2,0,0,7
1679030,1335595,2023-05-30,Senate,"Senate 3rd Reading SB233 Skinner",29,9,0,2,40
1679030,1349665,2023-07-05,Assembly,"Do pass and be re-referred to the Committee on [Utilities and Energy]",9,4,0,2,15
1679030,1350465,2023-07-12,Assembly,"Do pass as amended and be re-referred to the Committee on [Appropriations]",10,4,0,1,15
1679030,1352518,2023-09-01,Assembly,"Do pass as amended",11,4,0,1,16
1679030,1435259,2024-04-25,Assembly,"SB 233 Skinner Senate Third Reading By Aguiar-Curry Amendment Set #1",60,12,0,8,80
1679030,1439734,2024-05-06,Assembly,"Do pass",13,2,0,3,18
1679030,1442527,2024-05-13,Assembly,"SB 233 Skinner Third Reading Urgency By Aguiar-Curry",61,13,0,6,80
1679030,1443478,2024-05-15,Senate,"That the Assembly amendments be concurred in",9,3,0,1,13
1679030,1450391,2024-05-21,Senate,"Unfinished Business SB233 Skinner et al. Urgency Clause Concurrence",31,8,0,1,40
1679031,1281934,2023-03-22,Senate,"Do pass, but first be re-referred to the Committee on [Health]",7,0,0,0,7
1679031,1301077,2023-04-12,Senate,"Do pass as amended, but first amend, and re-refer to the Committee on [Appropriations]",9,1,0,2,12
1679031,1315653,2023-05-01,Senate,"Placed on suspense file",6,0,0,1,7
1679031,1328379,2023-05-18,Senate,"Do pass as amended",7,0,0,0,7
1679031,1335419,2023-05-30,Senate,"Senate 3rd Reading SB234 Portantino et al",38,2,0,0,40
1679031,1348872,2023-06-28,Assembly,"Do pass and be re-referred to the Committee on [Health] with recommendation: To Consent Calendar",7,0,0,0,7
1679031,1350201,2023-07-11,Assembly,"Do pass as amended and be re-referred to the Committee on [Appropriations]",15,0,0,0,15
1679031,1352580,2023-09-01,Assembly,"Do pass",16,0,0,0,16
1679031,1353697,2023-09-11,Assembly,"SB 234 Portantino Senate Third Reading By Petrie-Norris",79,0,0,1,80
1679031,1353894,2023-09-12,Senate,"Unfinished Business SB234 Portantino et al. Concurrence",39,0,0,1,40
1679032,1305523,2023-04-18,Senate,"Do pass, but first be re-referred to the Committee on [Appropriations]",11,0,0,0,11
1679032,1325028,2023-05-15,Senate,"Senate 3rd Reading SB235 Umberg",38,0,0,2,40
1679032,1349577,2023-07-05,Assembly,"Do pass as amended, and be re-referred to the Committee on [Appropriations] with recommendation: To Consent Calendar",10,0,0,1,11
1679032,1351593,2023-08-16,Assembly,"Do pass. To Consent Calendar",15,0,0,1,16
1679032,1353486,2023-09-07,Assembly,"SB 235 Umberg Senate Third Reading By Papan",78,0,0,2,80
1679032,1354612,2023-09-11,Senate,"Unfinished Business SB235 Umberg Concurrence",39,0,0,1,40
1679033,1288356,2023-03-28,Senate,"Do pass as amended, but first amend, and re-refer to the Committee on [Appropriations]",5,0,0,0,5
1679033,1308864,2023-04-24,Senate,"Placed on suspense file",7,0,0,0,7
1679033,1328556,2023-05-18,Senate,"Do pass",7,0,0,0,7
1679033,1336328,2023-05-31,Senate,"Senate 3rd Reading SB236 Jones",40,0,0,0,40
1679033,1348346,2023-06-27,Assembly,"Do pass and be re-referred to the Committee on [Appropriations]",7,0,0,1,8
1679034,1304248,2023-04-18,Senate,"Do pass, but first be re-referred to the Committee on [Appropriations]",1,3,0,1,5
1679034,1304249,2023-04-18,Senate,"[First] hearing set for [04-18-2023]: Failed passage in Committee. Reconsideration granted",5,0,0,0,5
1679035,1301043,2023-04-12,Senate,"Do pass as amended, but first amend, and re-refer to the Committee on [Appropriations]",9,0,0,3,12
1679035,1308837,2023-04-24,Senate,"Placed on suspense file",7,0,0,0,7
1679035,1328908,2023-05-18,Senate,"Do pass as amended",5,2,0,0,7
1679035,1332588,2023-05-24,Senate,"Senate 3rd Reading SB238 Wiener et al",32,7,0,1,40
1679035,1347918,2023-06-27,Assembly,"Do pass and be re-referred to the Committee on [Appropriations]",12,3,0,0,15
1681528,1280626,2023-03-21,Assembly,"Do pass. To Consent Calendar",11,0,0,0,11
1681528,1285754,2023-03-27,Assembly,"AB 288 Maienschein Consent Calendar Second Day Regular Session",77,0,0,3,80
1681528,1343735,2023-06-13,Senate,"Do pass and be ordered to the Consent Calendar",10,0,0,1,11
1681528,1346957,2023-06-22,Senate,"Consent Calendar AB288 Maienschein et al",39,0,0,1,40
1681529,1276594,2023-03-14,Assembly,"Do pass and be re-referred to the Committee on [Appropriations] with recommendation: To Consent Calendar",13,0,0,2,15
1681529,1281898,2023-03-22,Assembly,"Do pass. To Consent Calendar",15,0,0,1,16
1681529,1289794,2023-03-30,Assembly,"AB 289 Holden Consent Calendar Second Day Regular Session",60,0,0,20,80
1681529,1340997,2023-06-07,Senate,"Do pass, but first be re-referred to the Committee on [Appropriations] with the recommendation: To Consent Calendar",12,0,0,0,12
1681529,1351441,2023-08-14,Senate,"Placed on suspense file",7,0,0,0,7
1681529,1352734,2023-09-01,Senate,"Do pass",6,0,0,1,7
1681529,1354563,2023-09-11,Senate,"Assembly 3rd Reading AB289 Holden By Wiener",39,0,0,1,40
1681532,1305390,2023-04-19,Assembly,"Do pass and be re-referred to the Committee on [Appropriations]",6,1,0,1,8
1681532,1328239,2023-05-18,Assembly,"Do pass as amended",11,4,0,1,16
1681532,1333788,2023-05-25,Assembly,"AB 292 Pellerin Assembly Third Reading",59,15,0,6,80
1681532,1345648,2023-06-20,Senate,"Do pass, but first be re-referred to the Committee on [Appropriations]",6,1,0,0,7
1681532,1353308,2023-09-06,Senate,"Assembly 3rd Reading AB292 Pellerin By Allen",32,8,0,0,40
1681532,1353426,2023-09-07,Assembly,"AB 292 Pellerin Concurrence in Senate Amendments",63,14,0,3,80
1681533,1275539,2023-03-14,Assembly,"Do pass and be re-referred to the Committee on [Appropriations]",14,0,0,1,15
1681534,1310145,2023-04-24,Assembly,"Do pass and be re-referred to the Committee on [Appropriations]",11,0,0,0,11
1681535,1304412,2023-04-17,Assembly,"Do pass and be re-referred to the Committee on [Appropriations] with recommendation: To Consent Calendar",15,0,0,0,15
1681535,1328571,2023-05-18,Assembly,"Do pass as amended",15,0,0,1,16
1681535,1338187,2023-05-31,Assembly,"AB 295 Vince Fong Assembly Third Reading",80,0,0,0,80
1681535,1456325,2024-06-11,Senate,"Do pass as amended, and be ordered to the Consent Calendar",11,0,0,0,11
1681535,1458813,2024-06-20,Senate,"Consent Calendar 2nd AB295 Lowenthal Urgency Clause",36,0,0,4,40
1681535,1460012,2024-06-25,Assembly,"With recommendation: That Senate amendments be concurred in",11,0,0,1,12
1681535,1461972,2024-07-01,Assembly,"AB 295 Lowenthal Concurrence - Urgency Added",73,0,0,6,79
1681536,1247338,2023-02-09,Assembly,"Be adopted. To third reading",11,0,0,2,13
1681537,1298222,2023-04-11,Senate,"Do pass, but first be re-referred to the Committee on [Housing]",14,0,0,1,15
1681537,1305315,2023-04-18,Senate,"Do pass as amended, but first amend, and re-refer to the Committee on [Appropriations]",10,0,0,1,11
1681537,1320463,2023-05-08,Senate,"Placed on suspense file",7,0,0,0,7
1681537,1328651,2023-05-18,Senate,"Do pass",7,0,0,0,7
1681537,1333623,2023-05-25,Senate,"Special Consent SB240 Ochoa Bogh et al",40,0,0,0,40
1681537,1346251,2023-06-21,Assembly,"Do pass and be re-referred to the Committee on [Housing and Community Development] with recommendation: To Consent Calendar",6,0,0,1,7
1681537,1350489,2023-07-12,Assembly,"Do pass and be re-referred to the Committee on [Appropriations] with recommendation: To Consent Calendar",8,0,0,0,8
1681537,1352755,2023-09-01,Assembly,"Do pass",16,0,0,0,16
1681537,1353683,2023-09-11,Assembly,"SB 240 Ochoa Bogh Senate Third Reading By Dixon",78,0,0,2,80
1681538,1275569,2023-03-14,Senate,"Do pass, but first be re-referred to the Committee on [Appropriations]",4,0,0,1,5
1681538,1296988,2023-04-10,Senate,"Placed on suspense file",7,0,0,0,7
1681538,1328357,2023-05-18,Senate,"Do pass as amended",5,2,0,0,7
1681538,1335468,2023-05-30,Senate,"Senate 3rd Reading SB241 Min",31,6,0,3,40
1681538,1348290,2023-06-27,Assembly,"Do pass as amended and be re-referred to the Committee on [Appropriations]",6,0,0,2,8
1681538,1353077,2023-09-01,Assembly,"Do pass",12,3,0,1,16
1681538,1353502,2023-09-07,Assembly,"SB 241 Min Senate Third Reading",60,13,0,7,80
1681538,1354668,2023-09-14,Senate,"Unfinished Business SB241 Min et al. Concurrence",29,10,0,1,40
1681538,1354669,2023-09-14,Assembly,"SB 241 Min Senate Third Reading By Gipson",61,14,0,5,80
1681539,1280604,2023-03-20,Senate,"Do pass, but first be re-referred to the Committee on [Appropriations]",5,0,0,0,5
1681539,1296934,2023-04-10,Senate,"Placed on suspense file",7,0,0,0,7
1681539,1328037,2023-05-18,Senate,"Do pass as amended",5,1,0,1,7
1681539,1334459,2023-05-26,Senate,"Senate 3rd Reading SB242 Skinner",35,0,0,5,40
1681539,1456397,2024-06-11,Assembly,"Do pass and be re-referred to the Committee on [Appropriations]",6,0,0,1,7
1681539,1464466,2024-08-15,Assembly,"Do pass as amended",11,0,0,4,15
1681539,1465600,2024-08-26,Assembly,"SB 242 Skinner Senate Third Reading By Quirk-Silva",76,0,0,3,79
1681539,1465903,2024-08-27,Senate,"Unfinished Business SB242 Skinner Concurrence",40,0,0,0,40
1681540,1318060,2023-05-03,Senate,"Do pass, but first be re-referred to the Committee on [Appropriations]",2,2,0,4,8
1681541,1299432,2023-04-11,Senate,"Do pass as amended, but first amend, and re-refer to the Committee on [Appropriations]",9,0,0,2,11
1681541,1308816,2023-04-24,Senate,"Placed on suspense file",7,0,0,0,7
1681541,1328731,2023-05-18,Senate,"Do pass as amended",6,1,0,0,7
1681541,1335445,2023-05-30,Senate,"Senate 3rd Reading SB244 Eggman et al",38,0,0,2,40
1681541,1347895,2023-06-27,Assembly,"Do pass and be re-referred to the Committee on [Judiciary]",7,0,0,4,11
1681541,1349567,2023-07-05,Assembly,"Do pass and be re-referred to the Committee on [Appropriations]",8,0,0,3,11
1681541,1353046,2023-09-01,Assembly,"Do pass as amended",12,1,0,3,16
1681541,1353747,2023-09-12,Assembly,"SB 244 Eggman Senate Third Reading By Wicks",65,1,0,14,80
1681541,1354427,2023-09-13,Senate,"Unfinished Business SB244 Eggman et al. Concurrence",39,0,0,1,40
1681542,1288294,2023-03-28,Senate,"Be adopted, but first be re-referred to the Committee on [Appropriations] with recommendation: To Consent Calendar",14,0,0,2,16
1681542,1301010,2023-04-13,Senate,"Consent Calendar SCR16 Roth et al",36,0,0,4,40
1681542,1349646,2023-07-05,Assembly,"Be adopted. To Consent Calendar",15,0,0,0,15
1681542,1351255,2023-08-14,Assembly,"SCR 16 Roth Consent Calendar Second Day Regular Session",74,0,0,6,80
1681543,1306789,2023-04-20,Senate,"Special Consent SR12 Allen",36,0,0,4,40
1683769,1285615,2023-03-27,Assembly,"Do pass and be re-referred to the Committee on [Communications and Conveyance] with recommendation: To Consent Calendar",7,0,0,0,7
1683769,1305405,2023-04-19,Assembly,"Do pass as amended, and be re-referred to the Committee on [Appropriations] with recommendation: To Consent Calendar",13,0,0,0,13
1683769,1327969,2023-05-18,Assembly,"Do pass as amended",11,0,0,5,16
1683769,1334473,2023-05-26,Assembly,"AB 296 Rodriguez Assembly Third Reading",77,0,0,3,80
1683769,1350197,2023-07-11,Senate,"Do pass, but first be re-referred to the Committee on [Appropriations] with the recommendation: To Consent Calendar",14,0,0,1,15
1683769,1351312,2023-08-14,Senate,"Placed on suspense file",7,0,0,0,7
1683770,1285704,2023-03-27,Assembly,"Do pass and be re-referred to the Committee on [Appropriations] with recommendation: To Consent Calendar",11,0,0,0,11
1683770,1328417,2023-05-18,Assembly,"Do pass",15,0,0,1,16
1683770,1337980,2023-05-31,Assembly,"AB 297 Vince Fong Assembly Third Reading",80,0,0,0,80
1683770,1347857,2023-06-27,Senate,"Do pass, but first be re-referred to the Committee on [Appropriations] with the recommendation: To Consent Calendar",11,0,0,0,11
1683770,1349932,2023-07-10,Senate,"Placed on suspense file",6,0,0,1,7
1683770,1353032,2023-09-01,Senate,"Do pass",7,0,0,0,7
1683770,1354573,2023-09-14,Senate,"Assembly 3rd Reading AB297 Vince Fong By Seyarto",40,0,0,0,40
1683770,1354574,2023-09-14,Assembly,"AB 297 Vince Fong Concurrence in Senate Amendments",80,0,0,0,80
1683771,1306775,2023-04-20,Assembly,"Do pass and be re-referred to the Committee on [Appropriations] with recommendation: To Consent Calendar",13,0,0,0,13
1683771,1318043,2023-05-03,Assembly,"Do pass. To Consent Calendar",16,0,0,0,16
1683771,1323819,2023-05-11,Assembly,"AB 298 Mathis Consent Calendar Second Day Regular Session",66,0,0,14,80
1683771,1343765,2023-06-13,Senate,"Do pass, but first be re-referred to the Committee on [Appropriations]",14,0,0,1,15
1683771,1353293,2023-09-06,Senate,"Assembly 3rd Reading AB298 Mathis et al. By Nguyen",40,0,0,0,40
1683772,1275533,2023-03-14,Assembly,"Do pass and be re-referred to the Committee on [Higher Education]",10,0,0,1,11
1683772,1305430,2023-04-18,Assembly,"Do pass and be re-referred to the Committee on [Appropriations]",9,0,0,3,12
1683772,1328079,2023-05-18,Assembly,"Do pass as amended",12,2,0,2,16
1683772,1338171,2023-05-31,Assembly,"AB 299 Holden Assembly Third Reading",63,4,0,13,80
1683772,1348474,2023-06-27,Senate,"Do pass as amended, but first amend, and re-refer to the Committee on [Education]",8,1,0,2,11
1683772,1349624,2023-07-05,Senate,"Do pass, but first be re-referred to the Committee on [Appropriations]",4,1,0,2,7
1683772,1351355,2023-08-14,Senate,"Placed on suspense file",7,0,0,0,7
1683772,1352805,2023-09-01,Senate,"Do pass as amended",5,2,0,0,7
1683772,1353771,2023-09-12,Assembly,"AB 299 Holden Concurrence in Senate Amendments",63,3,0,14,80
1683772,1354507,2023-09-11,Senate,"Assembly 3rd Reading AB299 Holden By Durazo",24,6,0,10,40
1683773,1275601,2023-03-14,Assembly,"Do pass as amended, and be re-referred to the Committee on [Appropriations] with recommendation: To Consent Calendar",11,0,0,0,11
1683774,1275579,2023-03-14,Assembly,"Do pass and be re-referred to the Committee on [Appropriations]",6,2,0,0,8
1683774,1311808,2023-04-26,Assembly,"Do pass",12,4,0,0,16
1683774,1320457,2023-05-08,Assembly,"AB 301 Bauer-Kahan Assembly Third Reading",54,17,0,9,80
1683774,1347866,2023-06-27,Senate,"Do pass",4,0,0,1,5
1683774,1353113,2023-09-05,Senate,"Assembly 3rd Reading AB301 Bauer-Kahan et al. By Blakespear",31,8,0,1,40
1683775,1280652,2023-03-21,Assembly,"Do pass as amended, and be re-referred to the Committee on [Appropriations] with recommendation: To Consent Calendar",11,0,0,0,11
1683775,1328482,2023-05-18,Assembly,"Do pass as amended",11,0,0,5,16
1683775,1335453,2023-05-30,Assembly,"AB 302 Ward Assembly Third Reading",79,0,0,1,80
1683775,1347870,2023-06-27,Senate,"Do pass, but first be re-referred to the Committee on [Judiciary]",15,0,0,0,15
1683775,1349831,2023-07-06,Senate,"Do pass, but first be re-referred to the Committee on [Appropriations] with the recommendation: To Consent Calendar",11,0,0,0,11
1683775,1351392,2023-08-14,Senate,"Placed on suspense file",7,0,0,0,7
1683775,1352950,2023-09-01,Senate,"Do pass as amended",7,0,0,0,7
1683775,1354399,2023-09-13,Senate,"Special Consent AB302 Ward et al. By Allen",39,0,0,1,40
1683775,1354748,2023-09-14,Assembly,"AB 302 Ward Concurrence in Senate Amendments",80,0,0,0,80
1683776,1264453,2023-02-28,Assembly,"Do pass as amended, and be re-referred to the Committee on [Appropriations] with recommendation: To Consent Calendar",8,0,0,0,8
1683776,1328555,2023-05-18,Assembly,"Do pass",15,0,0,1,16
1683776,1338055,2023-05-31,Assembly,"AB 303 Davies Assembly Third Reading",80,0,0,0,80
1683776,1350193,2023-07-11,Senate,"Do pass, but first be re-referred to the Committee on [Appropriations] with the recommendation: To Consent Calendar",4,0,0,1,5
1683776,1351688,2023-08-17,Senate,"Consent Calendar 2nd AB303 Davies",38,0,0,2,40
1683776,1352212,2023-08-24,Assembly,"AB 303 Davies Concurrence in Senate Amendments",76,0,0,4,80
1683777,1275551,2023-03-14,Assembly,"Do pass and be re-referred to the Committee on [Appropriations]",8,0,0,0,8
1683777,1328894,2023-05-18,Assembly,"Do pass as amended",11,0,0,5,16
1683777,1338081,2023-05-31,Assembly,"AB 304 Holden Assembly Third Reading",72,0,0,8,80
1683777,1350157,2023-07-11,Senate,"Do pass, but first be re-referred to the Committee on [Appropriations]",4,0,0,1,5
1683777,1351311,2023-08-14,Senate,"Placed on suspense file",7,0,0,0,7
1683777,1353041,2023-09-01,Senate,"Do pass as amended",6,0,0,1,7
1683777,1353781,2023-09-12,Senate,"Assembly 3rd Reading AB304 Holden et al. By Skinner",34,0,0,6,40
1683777,1354073,2023-09-13,Assembly,"AB 304 Holden Concurrence in Senate Amendments",76,0,0,4,80
1683778,1308826,2023-04-24,Assembly,"Do pass as amended and be re-referred to the Committee on [Appropriations]",13,1,0,1,15
1683778,1328637,2023-05-18,Assembly,"Do pass",13,1,0,2,16
1683778,1337988,2023-05-31,Assembly,"AB 305 Villapudua Assembly Third Reading",75,0,0,5,80
1683779,1310390,2023-04-25,Assembly,"Do pass and be re-referred to the Committee on [Appropriations] with recommendation: To Consent Calendar",7,0,0,0,7
1683780,1278553,2023-03-14,Assembly,"Do pass and be re-referred to the Committee on [Appropriations]",9,0,0,0,9
1683780,1288145,2023-03-29,Assembly,"Do pass. To Consent Calendar",14,0,0,2,16
1683780,1302654,2023-04-17,Assembly,"AB 307 Chen Consent Calendar Second Day Regular Session",79,0,0,1,80
1683780,1338783,2023-06-05,Senate,"Do pass, but first be re-referred to the Committee on [Appropriations] with the recommendation: To Consent Calendar",13,0,0,0,13
1683780,1348893,2023-06-29,Senate,"Consent Calendar AB307 Chen",39,0,0,1,40
1683781,1286885,2023-03-28,Assembly,"Do pass as amended and be re-referred to the Committee on [Appropriations]",15,0,0,0,15
1683782,1311889,2023-04-26,Assembly,"Do pass as amended and be re-referred to the Committee on [Appropriations]",5,2,0,1,8
1683782,1328672,2023-05-18,Assembly,"Do pass",11,4,0,1,16
1683782,1333570,2023-05-25,Assembly,"AB 309 Lee Assembly Third Reading",55,16,0,9,80
1683782,1346263,2023-06-20,Senate,"Do pass, but first be re-referred to the Committee on [Governance and Finance]",9,2,0,0,11
1683782,1350688,2023-07-12,Senate,"Do pass as amended, but first amend, and re-refer to the Committee on [Appropriations]",5,2,0,1,8
1683782,1351779,2023-08-21,Senate,"Placed on suspense file",7,0,0,0,7
1683782,1352785,2023-09-01,Senate,"Do pass as amended",5,2,0,0,7
1683782,1354605,2023-09-14,Senate,"Assembly 3rd Reading AB309 Lee et al. By Wiener",27,10,0,3,40
1683782,1354606,2023-09-14,Assembly,"AB 309 Lee Concurrence in Senate Amendments",56,16,0,8,80
1683783,1304353,2023-04-18,Assembly,"Do pass and be re-referred to the Committee on [Appropriations]",5,2,0,1,8
1683783,1328413,2023-05-18,Assembly,"Do pass",11,4,0,1,16
1683783,1338091,2023-05-31,Assembly,"AB 310 Arambula Assembly Third Reading",62,17,0,1,80
1683783,1462596,2024-07-03,Senate,"Do pass, but first be re-referred to the Committee on [Appropriations]",5,0,0,0,5
1683783,1465390,2024-08-20,Senate,"Assembly 3rd Reading AB310 Arambula By Ochoa Bogh",40,0,0,0,40
1683783,1465996,2024-08-27,Assembly,"With recommendation: That Senate amendments be concurred in",6,0,0,1,7
1683783,1466744,2024-08-28,Assembly,"AB 310 Arambula Concurrence in Senate Amendments",74,2,0,3,79
1683784,1304372,2023-04-18,Assembly,"Do pass and be re-referred to the Committee on [Appropriations]",5,2,0,1,8
1683784,1328455,2023-05-18,Assembly,"Do pass",11,4,0,1,16
1683784,1338192,2023-05-31,Assembly,"AB 311 Santiago Assembly Third Reading",64,15,0,1,80
1683784,1458315,2024-06-17,Senate,"Do pass, but first be re-referred to the Committee on [Appropriations]",3,0,0,2,5
1683784,1462023,2024-07-01,Senate,"Placed on suspense file",7,0,0,0,7
1683785,1299391,2023-04-12,Assembly,"Do pass and be re-referred to the Committee on [Judiciary]",8,0,0,0,8
1683785,1304351,2023-04-18,Assembly,"Do pass and be re-referred to the Committee on [Appropriations] with recommendation: To Consent Calendar",11,0,0,0,11
1683786,1264452,2023-02-28,Assembly,"Do pass and be re-referred to the Committee on [Appropriations] with recommendation: To Consent Calendar",8,0,0,0,8
1683787,1275564,2023-03-13,Assembly,"Do pass as amended and be re-referred to the Committee on [Appropriations]",11,0,0,0,11
1683787,1288327,2023-03-29,Assembly,"Do pass. To Consent Calendar",14,0,0,2,16
1683787,1302630,2023-04-17,Assembly,"AB 314 Jim Patterson Consent Calendar Second Day Regular Session",79,0,0,1,80
1683787,1340978,2023-06-07,Senate,"Do pass, but first be re-referred to the Committee on [Appropriations]",8,0,0,0,8
1683787,1354242,2023-09-13,Senate,"Assembly 3rd Reading AB314 Jim Patterson By Dahle",39,0,0,1,40
1683788,1280648,2023-03-21,Assembly,"Do pass and be re-referred to the Committee on [Appropriations]",8,3,0,0,11
1683789,1275528,2023-03-13,Assembly,"Do pass and be re-referred to the Committee on [Communications and Conveyance]",12,0,0,3,15
1683789,1305497,2023-04-19,Assembly,"Do pass as amended and be re-referred to the Committee on [Appropriations]",10,1,0,2,13
1683789,1328408,2023-05-18,Assembly,"Do pass",13,1,0,2,16
1683789,1338173,2023-05-31,Assembly,"AB 316 Aguiar-Curry Assembly Third Reading",69,4,0,7,80
1683789,1350410,2023-07-11,Senate,"Do pass, but first be re-referred to the Committee on [Appropriations]",14,0,0,2,16
1683789,1351837,2023-08-21,Senate,"Placed on suspense file",7,0,0,0,7
1683789,1352581,2023-09-01,Senate,"Do pass",7,0,0,0,7
1683789,1354866,2023-09-11,Senate,"Assembly 3rd Reading AB316 Aguiar-Curry et al. By Gonzalez",36,2,0,2,40
1683790,1280673,2023-03-21,Assembly,"Do pass and be re-referred to the Committee on [Appropriations]",14,0,0,1,15
1683790,1305226,2023-04-19,Assembly,"Do pass. To Consent Calendar",14,0,0,2,16
1683790,1313526,2023-04-27,Assembly,"AB 317 Weber Consent Calendar Second Day Regular Session",79,0,0,1,80
1683790,1340983,2023-06-07,Senate,"Do pass as amended, but first amend, and re-refer to the Committee on [Appropriations] with the recommendation: To Consent Calendar",12,0,0,0,12
1683790,1348851,2023-06-29,Senate,"Consent Calendar AB317 Weber",39,0,0,1,40
1683790,1354365,2023-09-13,Assembly,"AB 317 Weber Concurrence in Senate Amendments",79,0,0,1,80
1683791,1288224,2023-03-29,Assembly,"Do pass as amended and be re-referred to the Committee on [Appropriations]",6,2,0,0,8
1683791,1328209,2023-05-18,Assembly,"Do pass",11,4,0,1,16
1683791,1337957,2023-05-31,Assembly,"AB 318 Addis Assembly Third Reading",56,17,0,7,80
1683791,1346229,2023-06-20,Senate,"Do pass, but first be re-referred to the Committee on [Judiciary]",9,1,0,1,11
1683791,1349778,2023-07-06,Senate,"Do pass, but first be re-referred to the Committee on [Appropriations]",9,2,0,0,11
1683791,1351332,2023-08-14,Senate,"Placed on suspense file",7,0,0,0,7
1683791,1353095,2023-09-01,Senate,"Do pass",5,2,0,0,7
1683791,1354385,2023-09-13,Senate,"Assembly 3rd Reading AB318 Addis By Laird",29,7,0,4,40
1683791,1354386,2023-09-13,Assembly,"AB 318 Addis Concurrence in Senate Amendments",55,15,0,10,80
1683792,1288288,2023-03-29,Assembly,"Do pass as amended and be re-referred to the Committee on [Appropriations]",8,0,0,0,8
1683792,1327989,2023-05-18,Assembly,"Do pass as amended",11,0,0,5,16
1683792,1333805,2023-05-25,Assembly,"AB 319 Connolly Assembly Third Reading",75,0,0,5,80
1683792,1346163,2023-06-20,Senate,"Do pass, but first be re-referred to the Committee on [Appropriations]",11,0,0,0,11
1683792,1351529,2023-08-14,Senate,"Placed on suspense file",7,0,0,0,7
1683792,1352608,2023-09-01,Senate,"Do pass",7,0,0,0,7
1683792,1353520,2023-09-07,Senate,"Assembly 3rd Reading AB319 Connolly By Alvarado-Gil",40,0,0,0,40
1683793,1281887,2023-03-21,Assembly,"Do pass and be re-referred to the Committee on [Appropriations]",11,0,0,1,12
1683793,1305452,2023-04-19,Assembly,"Do pass. To Consent Calendar",14,0,0,2,16
1683793,1313463,2023-04-27,Assembly,"AB 320 Lee Consent Calendar Second Day Regular Session",79,0,0,1,80
1683794,1317057,2023-05-01,Assembly,"Do pass and be re-referred to the Committee on [Appropriations]",10,0,0,1,11
1683795,1247342,2023-02-09,Assembly,"Be adopted. To third reading",11,0,0,2,13
1683796,1280624,2023-03-20,Senate,"Do pass, but first be re-referred to the Committee on [Appropriations]",4,0,0,1,5
1683796,1296920,2023-04-10,Senate,"Placed on suspense file",7,0,0,0,7
1683796,1328706,2023-05-18,Senate,"Do pass",5,2,0,0,7
1683796,1332612,2023-05-24,Senate,"Senate 3rd Reading SB245 Hurtado et al",31,8,0,1,40
1683796,1456409,2024-06-11,Assembly,"Do pass as amended and be re-referred to the Committee on [Appropriations]",5,1,0,1,7
1683797,1280664,2023-03-20,Senate,"Do pass, but first be re-referred to the Committee on [Housing] with the recommendation: To Consent Calendar",5,0,0,0,5
1683797,1310254,2023-04-24,Senate,"Do pass, but first be re-referred to the Committee on [Appropriations] with the recommendation: To Consent Calendar",11,0,0,0,11
1683797,1320415,2023-05-08,Senate,"Placed on suspense file",7,0,0,0,7
1683797,1328373,2023-05-18,Senate,"Do pass",7,0,0,0,7
1683797,1333780,2023-05-25,Senate,"Special Consent SB246 Ochoa Bogh et al",40,0,0,0,40
1683797,1345592,2023-06-20,Assembly,"Do pass and be re-referred to the Committee on [Appropriations] with recommendation: To Consent Calendar",8,0,0,0,8
1683798,1310282,2023-04-25,Senate,"Do pass, but first be re-referred to the Committee on [Appropriations]",15,0,0,0,15
1683798,1335542,2023-05-30,Senate,"Senate 3rd Reading SB247 Wilk",40,0,0,0,40
1683798,1350399,2023-07-12,Assembly,"Do pass and be re-referred to the Committee on [Appropriations]",20,0,0,2,22
1683798,1352116,2023-08-23,Assembly,"Do pass. To Consent Calendar",15,0,0,1,16
1683798,1352463,2023-08-31,Assembly,"SB 247 Wilk Consent Calendar Second Day Regular Session",79,0,0,1,80
1683799,1305352,2023-04-18,Senate,"Do pass, but first be re-referred to the Committee on [Appropriations]",6,0,0,1,7
1683799,1315740,2023-05-01,Senate,"Placed on suspense file",6,0,0,1,7
1683799,1328647,2023-05-18,Senate,"Do pass as amended",5,2,0,0,7
1683799,1336372,2023-05-31,Senate,"Senate 3rd Reading SB248 Newman",33,6,0,1,40
1683799,1346170,2023-06-21,Assembly,"Do pass and be re-referred to the Committee on [Appropriations]",6,0,0,2,8
1683801,1310244,2023-04-25,Senate,"Do pass and be ordered to the Consent Calendar",5,0,0,0,5
1683801,1330062,2023-05-22,Senate,"Senate 3rd Reading SB250 Umberg",40,0,0,0,40
1683801,1343705,2023-06-13,Assembly,"Do pass as amended. To Consent Calendar",8,0,0,0,8
1683801,1346973,2023-06-22,Assembly,"SB 250 Umberg Consent Calendar Second Day Regular Session",71,0,0,9,80
1683801,1349780,2023-07-06,Senate,"Special Consent SB250 Umberg",40,0,0,0,40
1686420,1281832,2023-03-21,Assembly,"Do pass as amended and be re-referred to the Committee on [Military and Veterans Affairs]",12,0,0,0,12
1686420,1305246,2023-04-18,Assembly,"Do pass and be re-referred to the Committee on [Appropriations] with recommendation: To Consent Calendar",11,0,0,0,11
1686420,1328111,2023-05-18,Assembly,"Do pass",15,0,0,1,16
1686420,1338201,2023-05-31,Assembly,"AB 322 Mathis Assembly Third Reading",80,0,0,0,80
1686420,1348315,2023-06-28,Senate,"Do pass, but first be re-referred to the Committee on [Military and Veterans Affairs] with the recommendation: To Consent Calendar",7,0,0,0,7
1686420,1350150,2023-07-10,Senate,"Do pass, but first be re-referred to the Committee on [Appropriations] with the recommendation: To Consent Calendar",5,0,0,0,5
1686420,1351512,2023-08-14,Senate,"Placed on suspense file",7,0,0,0,7
1686420,1352948,2023-09-01,Senate,"Do pass",7,0,0,0,7
1686420,1353778,2023-09-12,Senate,"Special Consent AB322 Mathis et al. By Newman",39,0,0,1,40
1686421,1288257,2023-03-29,Assembly,"Do pass and be re-referred to the Committee on [Judiciary]",8,0,0,0,8
1686421,1298170,2023-04-11,Assembly,"Do pass as amended and be re-referred to the Committee on [Appropriations]",9,1,0,1,11
1686421,1327982,2023-05-18,Assembly,"Do pass as amended",11,1,0,4,16
1686421,1338168,2023-05-31,Assembly,"AB 323 Holden Assembly Third Reading",78,0,0,2,80
1686421,1346250,2023-06-20,Senate,"Do pass, but first be re-referred to the Committee on [Judiciary] with the recommendation: To Consent Calendar",11,0,0,0,11
1686421,1349753,2023-07-06,Senate,"Do pass, but first be re-referred to the Committee on [Appropriations]",11,0,0,0,11
1686421,1352355,2023-08-28,Senate,"Placed on suspense file",7,0,0,0,7
1686421,1352640,2023-09-01,Senate,"Do pass",7,0,0,0,7
1686421,1354416,2023-09-13,Assembly,"AB 323 Holden Concurrence in Senate Amendments",80,0,0,0,80
1686421,1354794,2023-09-11,Senate,"Assembly 3rd Reading AB323 Holden Wahab",39,0,0,1,40
1686422,1281875,2023-03-22,Assembly,"Do pass as amended and be re-referred to the Committee on [Natural Resources]",10,0,0,5,15
1686422,1310383,2023-04-24,Assembly,"Do pass and be re-referred to the Committee on [Appropriations]",6,0,0,5,11
1686423,1275584,2023-03-14,Assembly,"Do pass and be re-referred to the Committee on [Appropriations]",7,0,0,1,8
1686423,1328168,2023-05-18,Assembly,"Do pass",13,0,0,3,16
1686423,1330114,2023-05-22,Assembly,"AB 325 Reyes Assembly Third Reading",72,0,0,8,80
1686423,1345582,2023-06-19,Senate,"Do pass, but first be re-referred to the Committee on [Judiciary] with the recommendation: To Consent Calendar",5,0,0,0,5
1686423,1349808,2023-07-06,Senate,"Do pass, but first be re-referred to the Committee on [Appropriations] with the recommendation: To Consent Calendar",11,0,0,0,11
1686423,1351419,2023-08-14,Senate,"Placed on suspense file",7,0,0,0,7
1686425,1270450,2023-03-07,Assembly,"Do pass as amended, and be re-referred to the Committee on [Appropriations] with recommendation: To Consent Calendar",8,0,0,0,8
1686426,1270451,2023-03-07,Assembly,"Do pass and be re-referred to the Committee on [Appropriations]",2,6,0,0,8
1686426,1270452,2023-03-07,Assembly,Reconsideration,2,1,0,5,8
1686427,1281833,2023-03-21,Assembly,"Do pass",2,6,0,0,8
1686427,1363767,2024-01-09,Assembly,"Do pass",3,0,0,5,8
1686428,1270443,2023-03-07,Assembly,"Do pass and be re-referred to the Committee on [Appropriations] with recommendation: To Consent Calendar",8,0,0,0,8
1686429,1298230,2023-04-11,Assembly,"Do pass as amended and be re-referred to the Committee on [Judiciary]",8,3,0,0,11
1686429,1304370,2023-04-18,Assembly,"Do pass as amended and be re-referred to the Committee on [Appropriations]",8,3,0,0,11
1686430,1298316,2023-04-11,Assembly,"Do pass as amended, and be re-referred to the Committee on [Appropriations] with recommendation: To Consent Calendar",18,0,0,0,18
1686430,1318058,2023-05-03,Assembly,"Do pass. To Consent Calendar",16,0,0,0,16
1686430,1323859,2023-05-11,Assembly,"AB 332 Lee Consent Calendar Second Day Regular Session",66,0,0,14,80
1686430,1344178,2023-06-14,Senate,"Do pass as amended, but first amend, and re-refer to the Committee on [Appropriations] with the recommendation: To Consent Calendar",12,0,0,0,12
1686430,1347500,2023-06-26,Senate,"Placed on suspense file",6,0,0,1,7
1686432,1305475,2023-04-19,Assembly,"Do pass and be re-referred to the Committee on [Appropriations]",7,0,0,1,8
1686432,1318009,2023-05-03,Assembly,"Do pass. To Consent Calendar",16,0,0,0,16
1686432,1323843,2023-05-11,Assembly,"AB 334 Blanca Rubio Consent Calendar Second Day Regular Session",66,0,0,14,80
1686432,1340080,2023-06-06,Senate,"Do pass as amended, but first amend, and re-refer to the Committee on [Rules]",7,0,0,0,7
1686432,1349748,2023-07-06,Senate,"Do pass, but first be re-referred to the Committee on [Appropriations] with the recommendation: To Consent Calendar",11,0,0,0,11
1686432,1351704,2023-08-17,Senate,"Consent Calendar 2nd AB334 Blanca Rubio et al",38,0,0,2,40
1686432,1352341,2023-08-28,Assembly,"AB 334 Blanca Rubio Concurrence in Senate Amendments",75,0,0,5,80
1686433,1270440,2023-03-07,Assembly,"Do pass as amended and be re-referred to the Committee on [Appropriations]",8,0,0,0,8
1686434,1298303,2023-04-11,Assembly,"Do pass as amended and be re-referred to the Committee on [Appropriations]",18,0,0,0,18
1686434,1328399,2023-05-18,Assembly,"Do pass",15,0,0,1,16
1686434,1333800,2023-05-25,Assembly,"AB 336 Cervantes Assembly Third Reading",78,0,0,2,80
1686434,1343136,2023-06-12,Senate,"Do pass, but first be re-referred to the Committee on [Appropriations]",12,0,0,1,13
1686434,1347482,2023-06-26,Senate,"Placed on suspense file",6,0,0,1,7
1686434,1353035,2023-09-01,Senate,"Do pass",6,0,0,1,7
1686434,1353323,2023-09-06,Senate,"Assembly 3rd Reading AB336 Cervantes et al",38,1,0,1,40
1686435,1281906,2023-03-22,Assembly,"Do pass and be re-referred to the Committee on [Appropriations] with recommendation: To Consent Calendar",12,0,0,2,14
1686436,1281882,2023-03-22,Assembly,"Do pass and be re-referred to the Committee on [Appropriations]",6,0,0,1,7
1686436,1328798,2023-05-18,Assembly,"Do pass",11,3,0,2,16
1686436,1338174,2023-05-31,Assembly,"AB 338 Aguiar-Curry Assembly Third Reading",66,8,0,6,80
1686436,1350481,2023-07-12,Senate,"Do pass, but first be re-referred to the Committee on [Appropriations]",4,0,0,1,5
1686436,1351455,2023-08-14,Senate,"Placed on suspense file",7,0,0,0,7
1686436,1353047,2023-09-01,Senate,"Do pass",5,2,0,0,7
1686436,1353810,2023-09-12,Senate,"Assembly 3rd Reading AB338 Aguiar-Curry By Durazo",30,8,0,2,40
1686436,1354208,2023-09-13,Assembly,"AB 338 Aguiar-Curry Concurrence in Senate Amendments",65,8,0,7,80
1686437,1310355,2023-04-24,Assembly,"Do pass and be re-referred to the Committee on [Appropriations]",11,0,0,0,11
1686437,1328126,2023-05-18,Assembly,"Do pass",15,0,0,1,16
1686437,1333674,2023-05-25,Assembly,"AB 339 Irwin Assembly Third Reading",78,0,0,2,80
1686437,1346151,2023-06-21,Senate,"Do pass, but first be re-referred to the Committee on [Appropriations] with the recommendation: To Consent Calendar",8,0,0,0,8
1686437,1349517,2023-07-03,Senate,"Placed on suspense file",7,0,0,0,7
1686437,1353026,2023-09-01,Senate,"Do pass",7,0,0,0,7
1686437,1353973,2023-09-12,Senate,"Special Consent AB339 Irwin By Glazer",39,0,0,1,40
1686439,1271510,2023-03-08,Assembly,"Do pass and be re-referred to the Committee on [Appropriations]",21,1,0,0,22
1686439,1283217,2023-03-23,Assembly,"AB 341 Ramos Assembly Third Reading",68,1,0,11,80
1686439,1310150,2023-04-25,Senate,"Do pass, but first be re-referred to the Committee on [Appropriations]",11,0,0,4,15
1686439,1323829,2023-05-11,Senate,"Assembly 3rd Reading AB341 Ramos et al. By Dodd",32,0,0,8,40
1686439,1325009,2023-05-15,Assembly,"AB 341 Ramos Concurrence in Senate Amendments",72,1,0,7,80
1686440,1305356,2023-04-18,Senate,"Do pass, but first be re-referred to the Committee on [Appropriations]",2,0,0,5,7
1686440,1305357,2023-04-18,Senate,"[First] hearing set for [04-19-2023]: Failed passage in Committee. Reconsideration granted",7,0,0,0,7
1686440,1363744,2024-01-09,Senate,"Do pass, but first be re-referred to the Committee on [Elections and Constitutional Amendments]",5,0,0,0,5
1686440,1363745,2024-01-09,Senate,"Do pass and be ordered to the Consent Calendar",7,0,0,0,7
1686440,1364758,2024-01-16,Senate,"Consent Calendar 2nd SB251 Newman",36,0,0,4,40
1686440,1456892,2024-06-12,Assembly,"Do pass. To Consent Calendar",8,0,0,0,8
1686441,1301091,2023-04-12,Senate,"Do pass, but first be re-referred to the Committee on [Judiciary]",4,1,0,0,5
1686441,1305428,2023-04-18,Senate,"Do pass as amended, but first amend, and re-refer to the Committee on [Appropriations]",8,2,0,1,11
1686441,1315777,2023-05-01,Senate,"Placed on suspense file",6,0,0,1,7
1686441,1328524,2023-05-18,Senate,"Do pass as amended",4,2,0,1,7
1686441,1333810,2023-05-25,Senate,"Senate 3rd Reading SB252 Gonzalez et al",23,10,0,7,40
1686442,1276628,2023-03-15,Senate,"Do pass, but first be re-referred to the Committee on [Judiciary]",4,2,0,1,7
1686442,1305371,2023-04-18,Senate,"Do pass, but first be re-referred to the Committee on [Appropriations]",8,1,0,2,11
1686442,1315744,2023-05-01,Senate,"Placed on suspense file",6,0,0,1,7
1686442,1328867,2023-05-18,Senate,"Do pass as amended",5,2,0,0,7
1686442,1335502,2023-05-30,Senate,"Senate 3rd Reading SB253 Wiener et al",24,9,0,7,40
1686442,1350770,2023-07-10,Assembly,"Do pass as amended and be re-referred to the Committee on [Appropriations]",8,3,0,0,11
1686442,1352914,2023-09-01,Assembly,"Do pass as amended",11,4,0,1,16
1686442,1353679,2023-09-11,Assembly,"SB 253 Wiener Senate Third Reading By Ward",49,20,0,11,80
1686442,1353995,2023-09-12,Senate,"Unfinished Business SB253 Wiener et al. Concurrence",27,8,0,5,40
1686443,1288149,2023-03-28,Senate,"Do pass, but first be re-referred to the Committee on [Appropriations]",4,1,0,0,5
1686443,1302641,2023-04-17,Senate,"Placed on suspense file",6,0,0,1,7
1686443,1366808,2024-01-18,Senate,"Do pass as amended",4,2,0,1,7
1686443,1372124,2024-01-30,Senate,"Senate 3rd Reading SB254 Skinner",29,8,0,3,40
1686443,1453407,2024-06-04,Assembly,"Do pass and be re-referred to the Committee on [Appropriations]",7,0,0,1,8
1686443,1464392,2024-08-15,Assembly,"Do pass as amended",11,1,0,3,15
1686443,1466340,2024-08-29,Senate,"Unfinished Business SB254 Skinner Concurrence",30,10,0,0,40
1686443,1466843,2024-08-28,Assembly,"SB 254 Skinner Senate Third Reading By Wicks",72,0,0,7,79
1686444,1280631,2023-03-21,Senate,"Do pass, but first be re-referred to the Committee on [Appropriations]",5,0,0,0,5
1686444,1308820,2023-04-24,Senate,"Placed on suspense file",7,0,0,0,7
1686445,1298305,2023-04-11,Senate,"Do pass as amended, but first amend, and re-refer to the Committee on [Appropriations] with the recommendation: To Consent Calendar",11,0,0,0,11
1686445,1315730,2023-05-01,Senate,"Consent Calendar SB256 Dodd et al",37,0,0,3,40
1686445,1345614,2023-06-20,Assembly,"Do pass and be re-referred to the Committee on [Appropriations]",15,0,0,0,15
1686445,1350398,2023-07-12,Assembly,"Do pass. To Consent Calendar",15,0,0,1,16
1686445,1352344,2023-08-28,Assembly,"SB 256 Dodd Senate Third Reading By Aguiar-Curry",76,0,0,4,80
1686445,1353522,2023-09-07,Senate,"Special Consent SB256 Dodd et al",40,0,0,0,40
1686446,1288315,2023-03-29,Senate,"Do pass, but first be re-referred to the Committee on [Appropriations]",12,0,0,0,12
1686446,1296955,2023-04-10,Senate,"Placed on suspense file",7,0,0,0,7
1686446,1328770,2023-05-18,Senate,"Do pass",6,0,0,1,7
1686446,1334478,2023-05-26,Senate,"Senate 3rd Reading SB257 Portantino et al",35,0,0,5,40
1686446,1347900,2023-06-27,Assembly,"Do pass and be re-referred to the Committee on [Appropriations]",15,0,0,0,15
1686446,1352971,2023-09-01,Assembly,"Do pass",15,1,0,0,16
1686446,1353688,2023-09-11,Assembly,"SB 257 Portantino Senate Third Reading By Weber",79,0,0,1,80
1686446,1354026,2023-09-12,Senate,"Unfinished Business SB257 Portantino et al. Concurrence",39,0,0,1,40
1686447,1288198,2023-03-28,Senate,"Do pass, but first be re-referred to the Committee on [Appropriations] with the recommendation: To Consent Calendar",14,0,0,2,16
1686447,1296933,2023-04-10,Senate,"Placed on suspense file",7,0,0,0,7
1686447,1328147,2023-05-18,Senate,"Do pass",7,0,0,0,7
1686447,1333741,2023-05-25,Senate,"Special Consent SB258 Roth",40,0,0,0,40
1686447,1347822,2023-06-26,Assembly,"Do pass and be re-referred to the Committee on [Appropriations] with recommendation: To Consent Calendar",15,0,0,0,15
1686448,1275531,2023-03-14,Senate,"Do pass, but first be re-referred to the Committee on [Appropriations] with the recommendation: To Consent Calendar",13,0,0,2,15
1686448,1300981,2023-04-13,Senate,"Consent Calendar SB259 Seyarto et al",36,0,0,4,40
1686448,1340985,2023-06-07,Assembly,"Do pass as amended, and be re-referred to the Committee on [Appropriations] with recommendation: To Consent Calendar",7,0,0,0,7
1686448,1348327,2023-06-28,Assembly,"Do pass. To Consent Calendar",14,0,0,2,16
1686448,1349467,2023-07-03,Assembly,"SB 259 Seyarto Consent Calendar Second Day Regular Session",69,0,0,11,80
1686448,1351665,2023-08-17,Senate,"Special Consent SB259 Seyarto et al",38,0,0,2,40
1686449,1280682,2023-03-20,Senate,"Do pass, but first be re-referred to the Committee on [Governmental Organization]",4,0,0,1,5
1686449,1298213,2023-04-11,Senate,"Do pass, but first be re-referred to the Committee on [Appropriations]",11,1,0,3,15
1686449,1308887,2023-04-24,Senate,"Placed on suspense file",7,0,0,0,7
1686449,1328658,2023-05-18,Senate,"Do pass as amended",5,0,0,2,7
1686449,1335441,2023-05-30,Senate,"Senate 3rd Reading SB260 Menjivar et al",33,0,0,7,40
1686449,1345634,2023-06-20,Assembly,"Do pass and be re-referred to the Committee on [Appropriations]",8,0,0,0,8
1686450,1276611,2023-03-15,Senate,"Do pass, but first be re-referred to the Committee on [Judiciary]",4,2,0,1,7
1686450,1305498,2023-04-18,Senate,"Do pass, but first be re-referred to the Committee on [Appropriations]",9,1,0,1,11
1686450,1320451,2023-05-08,Senate,"Placed on suspense file",7,0,0,0,7
1686450,1328615,2023-05-18,Senate,"Do pass as amended",4,2,0,1,7
1686450,1335393,2023-05-30,Senate,"Senate 3rd Reading SB261 Stern et al",27,8,0,5,40
1686450,1350771,2023-07-10,Assembly,"Do pass as amended and be re-referred to the Committee on [Appropriations]",8,3,0,0,11
1686450,1352639,2023-09-01,Assembly,"Do pass as amended",11,4,0,1,16
1686450,1353877,2023-09-12,Assembly,"SB 261 Stern Senate Third Reading By Ting",47,17,0,16,80
1686450,1354087,2023-09-13,Senate,"Unfinished Business SB261 Stern et al. Concurrence",28,8,0,4,40
1686451,1280628,2023-03-20,Senate,"Do pass, but first be re-referred to the Committee on [Governance and Finance]",3,0,0,2,5
1686451,1305525,2023-04-19,Senate,"Do pass as amended, but first amend, and re-refer to the Committee on [Appropriations]",6,2,0,0,8
1686451,1315705,2023-05-01,Senate,"Placed on suspense file",6,0,0,1,7
1686452,1311896,2023-04-26,Senate,"Do pass as amended, but first amend, and re-refer to the Committee on [Appropriations]",4,0,0,3,7
1686452,1324955,2023-05-15,Senate,"Placed on suspense file",7,0,0,0,7
1686452,1328795,2023-05-18,Senate,"Do pass",6,0,0,1,7
1686452,1335396,2023-05-30,Senate,"Senate 3rd Reading SB263 Dodd",33,0,0,7,40
1686452,1348378,2023-06-28,Assembly,"Do pass and be re-referred to the Committee on [Appropriations]",13,0,0,1,14
1686452,1366824,2024-01-18,Assembly,"Do pass",15,0,0,1,16
1686452,1382150,2024-02-12,Assembly,"SB 263 Dodd Senate Third Reading By Calderon",70,0,0,10,80
1686452,1389456,2024-02-20,Senate,"Unfinished Business SB263 Dodd Motions Concurrence",37,0,0,3,40
1686453,1320490,2023-05-08,Senate,"Be adopted, but first be re-referred to the Committee on [Appropriations]",6,1,0,0,7
1686453,1352319,2023-08-28,Senate,"Placed on suspense file",7,0,0,0,7
1686453,1352655,2023-09-01,Senate,"Be adopted",5,2,0,0,7
1686453,1374189,2024-02-01,Senate,"Senate 3rd Reading SCA1 Newman et al",31,7,0,2,40
1686453,1460562,2024-06-26,Assembly,"Be adopted and re-referred to the Committee on [Appropriations]",6,2,0,0,8
1686453,1464498,2024-08-15,Assembly,"Be adopted as amended",11,3,0,1,15
1686453,1466438,2024-08-30,Assembly,"SCA 1 Newman Senate Third Reading By Bryan",59,17,0,3,79
1686453,1466966,2024-08-31,Senate,"Unfinished Business SCA1 Newman et al. Concurrence",32,8,0,0,40
1686454,1255136,2023-02-17,Senate,"Senate 3rd Reading SCR17 Dodd",33,0,0,7,40
1686454,1347954,2023-06-27,Assembly,"Be adopted. To third reading",9,0,0,2,11
1686455,1249645,2023-02-13,Senate,"Senate 3rd Reading SCR18 Menjivar et al",35,0,0,5,40
1686455,1255119,2023-02-17,Assembly,"Be adopted. To Consent Calendar",12,0,0,1,13
1686455,1260542,2023-02-23,Assembly,"SCR 18 Menjivar Consent Calendar Second Day Regular Session",77,0,0,3,80
1686456,1243817,2023-02-06,Senate,"Senate 3rd Reading SR13 Rubio et al",38,0,0,2,40
1689304,1286875,2023-03-28,Assembly,"Do pass as amended and be re-referred to the Committee on [Appropriations]",18,0,0,1,19
1689304,1305322,2023-04-19,Assembly,"Do pass. To Consent Calendar",14,0,0,2,16
1689304,1313404,2023-04-27,Assembly,"AB 342 Valencia Consent Calendar Second Day Regular Session",79,0,0,1,80
1689304,1338799,2023-06-05,Senate,"Do pass, but first be re-referred to the Committee on [Judiciary]",13,0,0,0,13
1689304,1345622,2023-06-20,Senate,"Do pass, but first be re-referred to the Committee on [Appropriations]",11,0,0,0,11
1689304,1353178,2023-09-05,Senate,"Assembly 3rd Reading AB342 Valencia et al. By Umberg",34,0,0,6,40
1689304,1353412,2023-09-07,Assembly,"AB 342 Valencia Concurrence in Senate Amendments",79,0,0,1,80
1689305,1278496,2023-03-14,Assembly,"Do pass and be re-referred to the Committee on [Appropriations] with recommendation: To Consent Calendar",9,0,0,0,9
1689306,1281840,2023-03-22,Assembly,"Do pass and be re-referred to the Committee on [Appropriations] with recommendation: To Consent Calendar",14,0,0,1,15
1689307,1286989,2023-03-28,Assembly,"Do pass and be re-referred to the Committee on [Appropriations]",15,0,0,0,15
1689307,1328317,2023-05-18,Assembly,"Do pass",15,0,0,1,16
1689307,1333815,2023-05-25,Assembly,"AB 345 Wilson Assembly Third Reading",78,0,0,2,80
1689307,1346995,2023-06-22,Senate,"Do pass as amended, but first amend, and re-refer to the Committee on [Appropriations]",11,0,0,0,11
1689307,1349958,2023-07-10,Senate,"Placed on suspense file",6,0,0,1,7
1689307,1352516,2023-09-01,Senate,"Do pass",7,0,0,0,7
1689307,1353978,2023-09-12,Senate,"Special Consent AB345 Wilson et al. By Dodd",39,0,0,1,40
1689307,1354356,2023-09-13,Assembly,"AB 345 Wilson Concurrence in Senate Amendments",79,0,0,1,80
1689308,1305519,2023-04-19,Assembly,"Do pass and be re-referred to the Committee on [Revenue and Taxation]",7,0,0,1,8
1689308,1310330,2023-04-24,Assembly,"Do pass and be re-referred to the Committee on [Appropriations]",10,0,0,1,11
1689308,1328216,2023-05-18,Assembly,"Do pass",13,0,0,3,16
1689308,1337917,2023-05-31,Assembly,"AB 346 Quirk-Silva Assembly Third Reading",77,0,0,3,80
1689308,1346222,2023-06-20,Senate,"Do pass, but first be re-referred to the Committee on [Governance and Finance]",10,0,0,1,11
1689308,1350689,2023-07-12,Senate,"Do pass as amended, but first amend, and re-refer to the Committee on [Appropriations]",6,0,0,2,8
1689308,1351281,2023-08-14,Senate,"Placed on suspense file",7,0,0,0,7
1689308,1353021,2023-09-01,Senate,"Do pass",6,0,0,1,7
1689308,1353806,2023-09-12,Senate,"Assembly 3rd Reading AB346 Quirk-Silva By Blakespear",36,0,0,4,40
1689308,1354082,2023-09-13,Assembly,"AB 346 Quirk-Silva Concurrence in Senate Amendments",79,0,0,1,80
1689309,1305439,2023-04-18,Assembly,"Do pass and be re-referred to the Committee on [Appropriations]",7,2,0,0,9
1689309,1328608,2023-05-18,Assembly,"Do pass as amended",11,3,0,2,16
1689309,1338064,2023-05-31,Assembly,"AB 347 Ting Assembly Third Reading",63,10,0,7,80
1689309,1350403,2023-07-12,Senate,"Do pass, but first be re-referred to the Committee on [Appropriations]",5,2,0,0,7
1689309,1352325,2023-08-28,Senate,"Placed on suspense file",7,0,0,0,7
1689309,1352656,2023-09-01,Senate,"Do pass as amended",5,2,0,0,7
1689309,1458410,2024-06-19,Senate,"Do pass as amended, but first amend, and re-refer to the Committee on [Health]",5,2,0,0,7
1689309,1462510,2024-07-03,Senate,"Do pass as amended, but first amend, and re-refer to the Committee on [Appropriations]",9,0,0,2,11
1689309,1463528,2024-08-05,Senate,"Placed on suspense file",7,0,0,0,7
1689309,1464286,2024-08-15,Senate,"Do pass as amended",5,2,0,0,7
1689309,1466175,2024-08-29,Assembly,"AB 347 Ting Concurrence in Senate Amendments",58,14,0,7,79
1689309,1466644,2024-08-28,Senate,"Assembly 3rd Reading AB347 Ting et al. By Stern",30,7,0,3,40
1689311,1276597,2023-03-15,Assembly,"Do pass and be re-referred to the Committee on [Appropriations]",7,0,0,0,7
1689311,1288365,2023-03-29,Assembly,"Do pass. To Consent Calendar",14,0,0,2,16
1689311,1302587,2023-04-17,Assembly,"AB 349 Ramos Consent Calendar Second Day Regular Session",79,0,0,1,80
1689311,1343775,2023-06-13,Senate,"Do pass, but first be re-referred to the Committee on [Appropriations]",12,0,0,3,15
1689311,1353122,2023-09-05,Senate,"Assembly 3rd Reading AB349 Ramos et al. By Archuleta",39,0,0,1,40
1689311,1353461,2023-09-07,Assembly,"AB 349 Ramos Concurrence in Senate Amendments",79,0,0,1,80
1689312,1275581,2023-03-13,Assembly,"Do pass and be re-referred to the Committee on [Natural Resources]",14,0,0,1,15
1689312,1322916,2023-05-10,Assembly,"Do pass. To Consent Calendar",14,0,0,2,16
1689312,1328682,2023-05-18,Assembly,"AB 350 Aguiar-Curry Consent Calendar Second Day Regular Session",74,0,0,6,80
1689312,1348379,2023-06-27,Senate,"Do pass, but first be re-referred to the Committee on [Environmental Quality] with the recommendation: To Consent Calendar",16,0,0,0,16
1689312,1350466,2023-07-12,Senate,"Do pass, but first be re-referred to the Committee on [Appropriations] with the recommendation: To Consent Calendar",7,0,0,0,7
1689312,1354251,2023-09-13,Senate,"Assembly 3rd Reading AB350 Aguiar-Curry et al. By Ashby",31,6,0,3,40
1689312,1354629,2023-09-14,Assembly,"AB 350 Aguiar-Curry Concurrence in Senate Amendments",74,0,0,6,80
1689313,1304311,2023-04-18,Assembly,"Do pass and be re-referred to the Committee on [Appropriations]",17,0,0,1,18
1689314,1298168,2023-04-11,Assembly,"Do pass and be re-referred to the Committee on [Privacy and Consumer Protection]",11,3,0,1,15
1689314,1311664,2023-04-25,Assembly,"Do pass and be re-referred to the Committee on [Appropriations]",8,2,0,1,11
1689314,1327936,2023-05-18,Assembly,"Do pass as amended",11,4,0,1,16
1689314,1338102,2023-05-31,Assembly,"AB 352 Bauer-Kahan Assembly Third Reading",64,12,0,4,80
1689314,1348481,2023-06-27,Senate,"Do pass, but first be re-referred to the Committee on [Health]",10,1,0,0,11
1689314,1350625,2023-07-12,Senate,"Do pass, but first be re-referred to the Committee on [Appropriations]",10,0,0,2,12
1689314,1354379,2023-09-13,Senate,"Assembly 3rd Reading AB352 Bauer-Kahan et al. By Atkins",32,7,0,1,40
1689314,1354616,2023-09-14,Assembly,"AB 352 Bauer-Kahan Concurrence in Senate Amendments",64,14,0,2,80
1689315,1270474,2023-03-07,Assembly,"Do pass and be re-referred to the Committee on [Appropriations] with recommendation: To Consent Calendar",8,0,0,0,8
1689315,1328007,2023-05-18,Assembly,"Do pass",15,0,0,1,16
1689315,1338020,2023-05-31,Assembly,"AB 353 Jones-Sawyer Assembly Third Reading",80,0,0,0,80
1689315,1350279,2023-07-11,Senate,"Do pass, but first be re-referred to the Committee on [Appropriations] with the recommendation: To Consent Calendar",4,0,0,1,5
1689315,1354165,2023-09-13,Senate,"Assembly 3rd Reading AB353 Jones-Sawyer By Ochoa Bogh",39,0,0,1,40
1689315,1354166,2023-09-13,Assembly,"AB 353 Jones-Sawyer Concurrence in Senate Amendments",79,0,0,1,80
1689316,1318090,2023-05-03,Assembly,"Do pass. To Consent Calendar",8,0,0,0,8
1689316,1323804,2023-05-11,Assembly,"AB 354 Stephanie Nguyen Consent Calendar Second Day Regular Session",66,0,0,14,80
1689316,1343779,2023-06-13,Senate,"Do pass and be ordered to the Consent Calendar",16,0,0,0,16
1689316,1346968,2023-06-22,Senate,"Consent Calendar AB354 Stephanie Nguyen",39,0,0,1,40
1689317,1270441,2023-03-07,Assembly,"Do pass as amended",8,0,0,0,8
1689317,1337977,2023-05-31,Assembly,"AB 355 Alanis Assembly Third Reading",79,0,0,1,80
1689317,1350316,2023-07-11,Senate,"Do pass",4,0,0,1,5
1689317,1353287,2023-09-06,Senate,"Assembly 3rd Reading AB355 Alanis By Alvarado-Gil",40,0,0,0,40
1689317,1353407,2023-09-07,Assembly,"AB 355 Alanis Concurrence in Senate Amendments",73,0,0,7,80
1689318,1302023,2023-04-10,Assembly,"Do pass as amended and be re-referred to the Committee on [Appropriations]",11,0,0,0,11
1689318,1311806,2023-04-26,Assembly,"Do pass. To Consent Calendar",16,0,0,0,16
1689318,1318919,2023-05-04,Assembly,"AB 356 Mathis Consent Calendar Second Day Regular Session",75,0,0,5,80
1689318,1340991,2023-06-07,Senate,"Do pass, but first be re-referred to the Committee on [Appropriations] with the recommendation: To Consent Calendar",7,0,0,0,7
1689318,1350703,2023-07-13,Senate,"Consent Calendar AB356 Mathis et al",37,0,0,3,40
1689319,1318013,2023-05-03,Senate,"Do pass as amended, but first amend, and re-refer to the Committee on [Appropriations] with the recommendation: To Consent Calendar",7,0,0,1,8
1689319,1327942,2023-05-18,Senate,"Consent Calendar SB264 Niello",38,0,0,2,40
1689319,1343778,2023-06-12,Assembly,"Do pass as amended and be re-referred to the Committee on [Appropriations]",11,0,0,0,11
1689319,1352723,2023-09-01,Assembly,"Do pass",16,0,0,0,16
1689319,1353616,2023-09-11,Assembly,"SB 264 Niello Senate Third Reading By Kalra",80,0,0,0,80
1689319,1354768,2023-09-14,Senate,"Unfinished Business SB264 Niello Concurrence",40,0,0,0,40
1689320,1275527,2023-03-14,Senate,"Do pass, but first be re-referred to the Committee on [Appropriations]",13,0,0,2,15
1689320,1296997,2023-04-10,Senate,"Placed on suspense file",7,0,0,0,7
1689320,1328251,2023-05-18,Senate,"Do pass as amended",7,0,0,0,7
1689320,1335607,2023-05-30,Senate,"Special Consent SB265 Hurtado et al",40,0,0,0,40
1689320,1349963,2023-07-10,Assembly,"Do pass and be re-referred to the Committee on [Appropriations] with recommendation: To Consent Calendar",6,0,0,1,7
1689321,1310168,2023-04-25,Senate,"Do pass, but first be re-referred to the Committee on [Appropriations] with the recommendation: To Consent Calendar",5,0,0,0,5
1689321,1320395,2023-05-08,Senate,"Placed on suspense file",7,0,0,0,7
1689322,1288165,2023-03-28,Senate,"Do pass, but first be re-referred to the Committee on [Appropriations]",8,1,0,2,11
1689322,1296979,2023-04-10,Senate,"Placed on suspense file",7,0,0,0,7
1689322,1328540,2023-05-18,Senate,"Do pass as amended",5,2,0,0,7
1689322,1336323,2023-05-31,Senate,"Senate 3rd Reading SB267 Eggman",31,3,0,6,40
1689322,1348334,2023-06-28,Assembly,"Do pass as amended and be re-referred to the Committee on [Judiciary]",6,1,0,1,8
1689322,1350122,2023-07-11,Assembly,"Do pass and be re-referred to the Committee on [Appropriations]",8,0,0,3,11
1689322,1352931,2023-09-01,Assembly,"Do pass",12,3,0,1,16
1689322,1353996,2023-09-12,Assembly,"SB 267 Eggman Senate Third Reading By Kalra",62,12,0,6,80
1689322,1354095,2023-09-13,Senate,"Unfinished Business SB267 Eggman et al. Concurrence",0,0,0,40,40
1689322,1354096,2023-09-13,Senate,"Unfinished Business SB267 Eggman et al. Concurrence",31,3,0,6,40
1689323,1304397,2023-04-18,Senate,"Do pass as amended, but first amend, and re-refer to the Committee on [Appropriations]",5,0,0,0,5
1689323,1320546,2023-05-08,Senate,"Placed on suspense file",7,0,0,0,7
1689323,1328034,2023-05-18,Senate,"Do pass",7,0,0,0,7
1689323,1333633,2023-05-25,Senate,"Special Consent SB268 Alvarado-Gil et al",40,0,0,0,40
1689323,1462582,2024-07-02,Assembly,"Do pass and be re-referred to the Committee on [Appropriations]",8,0,0,0,8
1689323,1464607,2024-08-15,Assembly,"Do pass",13,1,0,1,15
1689323,1465739,2024-08-26,Assembly,"SB 268 Alvarado-Gil Senate Third Reading By Alanis",74,0,0,5,79
1689323,1467149,2024-08-31,Senate,"Unfinished Business SB268 Alvarado-Gil et al. Concurrence",40,0,0,0,40
1689324,1275534,2023-03-14,Senate,"Do pass, but first be re-referred to the Committee on [Appropriations] with the recommendation: To Consent Calendar",13,0,0,2,15
1689324,1301047,2023-04-13,Senate,"Consent Calendar SB269 Laird",36,0,0,4,40
1689324,1344233,2023-06-14,Assembly,"Do pass as amended and be re-referred to the Committee on [Appropriations]",21,0,0,1,22
1689324,1350548,2023-07-12,Assembly,"Do pass. To Consent Calendar",15,0,0,1,16
1689324,1351702,2023-08-17,Assembly,"SB 269 Laird Consent Calendar Second Day Regular Session",75,0,0,5,80
1689324,1352262,2023-08-24,Senate,"Special Consent SB269 Laird",40,0,0,0,40
1689325,1311838,2023-04-26,Senate,"Do pass, but first be re-referred to the Committee on [Housing]",7,0,0,0,7
1689325,1320449,2023-05-08,Senate,"Placed on suspense file",7,0,0,0,7
1689326,1302657,2023-04-17,Senate,"Do pass, but first be re-referred to the Committee on [Judiciary]",13,0,0,0,13
1689326,1311857,2023-04-25,Senate,"Do pass, but first be re-referred to the Committee on [Appropriations]",11,0,0,0,11
1689326,1320504,2023-05-08,Senate,"Placed on suspense file",7,0,0,0,7
1689326,1328820,2023-05-18,Senate,"Do pass",6,1,0,0,7
1689326,1335389,2023-05-30,Senate,"Senate 3rd Reading SB271 Dodd et al",38,0,0,2,40
1689326,1347818,2023-06-27,Assembly,"Do pass and be re-referred to the Committee on [Judiciary] with recommendation: To Consent Calendar",11,0,0,0,11
1689326,1349587,2023-07-05,Assembly,"Do pass as amended, and be re-referred to the Committee on [Appropriations] with recommendation: To Consent Calendar",10,0,0,1,11
1689326,1353055,2023-09-01,Assembly,"Do pass as amended",11,0,0,5,16
1689326,1354083,2023-09-13,Assembly,"SB 271 Dodd Senate Third Reading By Connolly",79,0,0,1,80
1689326,1354830,2023-09-14,Senate,"Unfinished Business SB271 Dodd et al. Concurrence",40,0,0,0,40
1689327,1286957,2023-03-28,Senate,"Do pass, but first be re-referred to the Committee on [Governance and Finance]",9,0,0,2,11
1689327,1313402,2023-04-26,Senate,"Do pass, but first be re-referred to the Committee on [Appropriations]",6,0,0,2,8
1689327,1320380,2023-05-08,Senate,"Placed on suspense file",7,0,0,0,7
1689327,1328572,2023-05-18,Senate,"Do pass as amended",5,1,0,1,7
1689327,1332594,2023-05-24,Senate,"Senate 3rd Reading SB272 Laird",37,1,0,2,40
1689327,1345190,2023-06-19,Assembly,"Do pass and be re-referred to the Committee on [Appropriations]",10,1,0,0,11
1689327,1352896,2023-09-01,Assembly,"Do pass",13,1,0,2,16
1689327,1353594,2023-09-11,Assembly,"SB 272 Laird Senate Third Reading By Bennett",72,1,0,7,80
1689327,1353870,2023-09-12,Senate,"Unfinished Business SB272 Laird Concurrence",35,1,0,4,40
1689328,1315139,2023-04-25,Senate,"Do pass as amended, but first amend, and re-refer to the Committee on [Appropriations]",10,0,0,1,11
1689328,1325033,2023-05-15,Senate,"Senate 3rd Reading SB273 Wiener et al",38,0,0,2,40
1689328,1347540,2023-06-26,Assembly,"Do pass and be re-referred to the Committee on [Appropriations]",10,0,0,1,11
1689328,1352510,2023-09-01,Assembly,"Do pass as amended",11,0,0,5,16
1689328,1353439,2023-09-07,Assembly,"SB 273 Wiener Senate Third Reading By Haney",78,0,0,2,80
1689328,1354694,2023-09-11,Senate,"Unfinished Business SB273 Wiener et al. Concurrence",39,0,0,1,40
1691340,1275604,2023-03-14,Assembly,"Do pass as amended and be re-referred to the Committee on [Appropriations]",8,0,0,3,11
1691340,1327980,2023-05-18,Assembly,"Do pass",12,2,0,2,16
1691340,1338030,2023-05-31,Assembly,"AB 357 Maienschein Assembly Third Reading",68,2,0,10,80
1691340,1348313,2023-06-27,Senate,"Do pass, but first be re-referred to the Committee on [Appropriations]",11,0,0,0,11
1691340,1351439,2023-08-14,Senate,"Placed on suspense file",7,0,0,0,7
1691340,1352863,2023-09-01,Senate,"Do pass as amended",5,1,0,1,7
1691340,1353295,2023-09-06,Senate,"Assembly 3rd Reading AB357 Maienschein By Glazer",38,1,0,1,40
1691340,1353351,2023-09-07,Assembly,"AB 357 Maienschein Concurrence in Senate Amendments",69,2,0,9,80
1691341,1298198,2023-04-11,Assembly,"Do pass and be re-referred to the Committee on [Appropriations] with recommendation: To Consent Calendar",12,0,0,0,12
1691341,1311901,2023-04-26,Assembly,"Do pass. To Consent Calendar",16,0,0,0,16
1691341,1318952,2023-05-04,Assembly,"AB 358 Addis Consent Calendar Second Day Regular Session",75,0,0,5,80
1691341,1340957,2023-06-07,Senate,"Do pass, but first be re-referred to the Committee on [Appropriations] with the recommendation: To Consent Calendar",7,0,0,0,7
1691341,1348889,2023-06-29,Senate,"Consent Calendar AB358 Addis",39,0,0,1,40
1691342,1363779,2024-01-09,Assembly,"Do pass and be re-referred to the Committee on [Education]",10,0,0,1,11
1691342,1363938,2024-01-10,Assembly,"Do pass and be re-referred to the Committee on [Appropriations]",7,0,0,0,7
1691342,1366804,2024-01-18,Assembly,"Do pass as amended",12,0,0,4,16
1691342,1371107,2024-01-29,Assembly,"AB 359 Holden Assembly Third Reading",76,0,0,4,80
1691342,1451599,2024-05-29,Senate,"Do pass as amended, but first amend, and re-refer to the Committee on [Appropriations]",7,0,0,0,7
1691342,1455764,2024-06-10,Senate,"Placed on suspense file",7,0,0,0,7
1691342,1464642,2024-08-15,Senate,"Do pass",7,0,0,0,7
1691342,1466371,2024-08-29,Assembly,"AB 359 Holden Concurrence in Senate Amendments",76,0,0,3,79
1691342,1466891,2024-08-28,Senate,"Assembly 3rd Reading AB359 Holden et al. By Ochoa Bogh",39,0,0,1,40
1691343,1270471,2023-03-07,Assembly,"Do pass and be re-referred to the Committee on [Judiciary]",7,0,0,1,8
1691343,1280671,2023-03-21,Assembly,"Do pass as amended",10,0,0,1,11
1691343,1306743,2023-04-20,Assembly,"AB 360 Gipson Assembly Third Reading",75,0,0,5,80
1691343,1340061,2023-06-06,Senate,"Do pass, but first be re-referred to the Committee on [Judiciary]",5,0,0,0,5
1691343,1348420,2023-06-27,Senate,"Do pass, but first be re-referred to the Committee on [Appropriations] with the recommendation: To Consent Calendar",11,0,0,0,11
1691343,1349919,2023-07-10,Senate,"Placed on suspense file",6,0,0,1,7
1691343,1352531,2023-09-01,Senate,"Do pass",5,1,0,1,7
1691343,1353831,2023-09-12,Assembly,"AB 360 Gipson Concurrence in Senate Amendments",77,0,0,3,80
1691343,1354505,2023-09-11,Senate,"Assembly 3rd Reading AB360 Gipson et al. By Bradford",36,1,0,3,40
1691344,1304376,2023-04-17,Assembly,"Do pass and be re-referred to the Committee on [Privacy and Consumer Protection]",12,1,0,2,15
1691344,1311899,2023-04-25,Assembly,"Do pass as amended",7,1,0,3,11
1691344,1324977,2023-05-15,Assembly,"AB 361 Ward Assembly Third Reading",62,11,0,7,80
1691344,1343780,2023-06-13,Senate,"Do pass as amended, but first amend, and re-refer to the Committee on [Judiciary]",12,2,0,2,16
1691344,1348358,2023-06-27,Senate,"Do pass",10,1,0,0,11
1691344,1353182,2023-09-05,Senate,"Assembly 3rd Reading AB361 Ward By Blakespear",32,7,0,1,40
1691344,1353384,2023-09-07,Assembly,"AB 361 Ward Concurrence in Senate Amendments",63,13,0,4,80
1691346,1278494,2023-03-14,Assembly,"Do pass and be re-referred to the Committee on [Appropriations]",7,2,0,0,9
1691346,1328715,2023-05-18,Assembly,"Do pass",11,4,0,1,16
1691346,1338134,2023-05-31,Assembly,"AB 363 Bauer-Kahan Assembly Third Reading",57,16,0,7,80
1691346,1349632,2023-07-05,Senate,"Do pass as amended, but first amend, and re-refer to the Committee on [Appropriations]",5,2,0,0,7
1691346,1351513,2023-08-14,Senate,"Placed on suspense file",7,0,0,0,7
1691346,1352706,2023-09-01,Senate,"Do pass",5,2,0,0,7
1691346,1353979,2023-09-12,Assembly,"AB 363 Bauer-Kahan Concurrence in Senate Amendments",53,16,0,11,80
1691346,1354783,2023-09-11,Senate,"Assembly 3rd Reading AB363 Bauer-Kahan By Allen",27,10,0,3,40
1691347,1275574,2023-03-13,Assembly,"Do pass and be re-referred to the Committee on [Privacy and Consumer Protection]",15,0,0,0,15
1691347,1311737,2023-04-25,Assembly,"Do pass and be re-referred to the Committee on [Appropriations] with recommendation: To Consent Calendar",11,0,0,0,11
1691347,1328568,2023-05-18,Assembly,"Do pass",15,0,0,1,16
1691347,1338146,2023-05-31,Assembly,"AB 364 Bryan Assembly Third Reading",80,0,0,0,80
1691348,1280677,2023-03-21,Assembly,"Do pass and be re-referred to the Committee on [Appropriations] with recommendation: To Consent Calendar",14,0,0,1,15
1691348,1328378,2023-05-18,Assembly,"Do pass",15,0,0,1,16
1691348,1338112,2023-05-31,Assembly,"AB 365 Aguiar-Curry Assembly Third Reading",80,0,0,0,80
1691348,1346149,2023-06-21,Senate,"Do pass, but first be re-referred to the Committee on [Appropriations] with the recommendation: To Consent Calendar",12,0,0,0,12
1691349,1304379,2023-04-18,Assembly,"Do pass and be re-referred to the Committee on [Appropriations]",7,0,0,1,8
1691349,1328790,2023-05-18,Assembly,"Do pass as amended",11,0,0,5,16
1691349,1337916,2023-05-31,Assembly,"AB 366 Petrie-Norris Assembly Third Reading",80,0,0,0,80
1691349,1349561,2023-07-03,Senate,"Do pass, but first be re-referred to the Committee on [Labor, Public Employment and Retirement ]",5,0,0,0,5
1691349,1350534,2023-07-12,Senate,"Do pass, but first be re-referred to the Committee on [Appropriations] with the recommendation: To Consent Calendar",5,0,0,0,5
1691349,1351494,2023-08-14,Senate,"Placed on suspense file",7,0,0,0,7
1691349,1353000,2023-09-01,Senate,"Do pass as amended",7,0,0,0,7
1691349,1466450,2024-08-30,Senate,"Assembly 3rd Reading AB366 Petrie-Norris By Archuleta",40,0,0,0,40
1691349,1466972,2024-08-31,Assembly,"AB 366 Petrie-Norris Concurrence in Senate Amendments",77,0,0,2,79
1691350,1313389,2023-04-27,Assembly,"Do pass and be re-referred to the Committee on [Appropriations]",2,0,0,6,8
1691350,1313390,2023-04-27,Assembly,Reconsideration,8,0,0,0,8
1691351,1298298,2023-04-11,Assembly,"Do pass and be re-referred to the Committee on [Education]",12,0,0,0,12
1691351,1313430,2023-04-26,Assembly,"Do pass as amended, and be re-referred to the Committee on [Appropriations] with recommendation: To Consent Calendar",7,0,0,0,7
1691351,1322849,2023-05-10,Assembly,"Do pass. To Consent Calendar",14,0,0,2,16
1691351,1328036,2023-05-18,Assembly,"AB 368 Holden Consent Calendar Second Day Regular Session",74,0,0,6,80
1691351,1340955,2023-06-07,Senate,"Do pass, but first be re-referred to the Committee on [Appropriations] with the recommendation: To Consent Calendar",7,0,0,0,7
1691351,1353107,2023-09-05,Senate,"Assembly 3rd Reading AB368 Holden By Smallwood-Cuevas",39,0,0,1,40
1691351,1353108,2023-09-05,Senate,"Assembly 3rd Reading AB368 Holden By Smallwood-Cuevas Motion To Reconsider",39,0,0,1,40
1691351,1353865,2023-09-12,Assembly,"AB 368 Holden Concurrence in Senate Amendments",79,0,0,1,80
1691351,1354542,2023-09-11,Senate,"Assembly 3rd Reading AB368 Holden By Smallwood-Cuevas",39,0,0,1,40
1691352,1286908,2023-03-28,Assembly,"Do pass and be re-referred to the Committee on [Appropriations]",7,0,0,1,8
1691352,1328562,2023-05-18,Assembly,"Do pass as amended",11,0,0,5,16
1691352,1333670,2023-05-25,Assembly,"AB 369 Zbur Assembly Third Reading",76,0,0,4,80
1691352,1345561,2023-06-19,Senate,"Do pass, but first be re-referred to the Committee on [Appropriations]",5,0,0,0,5
1691352,1349483,2023-07-03,Senate,"Placed on suspense file",7,0,0,0,7
1691353,1289771,2023-03-29,Assembly,"Do pass as amended and be re-referred to the Committee on [Appropriations]",6,0,0,1,7
1691353,1305302,2023-04-19,Assembly,"Do pass. To Consent Calendar",14,0,0,2,16
1691353,1313405,2023-04-27,Assembly,"AB 370 Addis Consent Calendar Second Day Regular Session",79,0,0,1,80
1691353,1341002,2023-06-07,Senate,"Do pass as amended, but first amend, and re-refer to the Committee on [Appropriations]",7,0,0,0,7
1691353,1353251,2023-09-06,Senate,"Assembly 3rd Reading AB370 Addis By Lim√≥n",40,0,0,0,40
1691353,1353647,2023-09-11,Assembly,"AB 370 Addis Concurrence in Senate Amendments",80,0,0,0,80
1691354,1311773,2023-04-26,Assembly,"Do pass and be re-referred to the Committee on [Appropriations] with recommendation: To Consent Calendar",8,0,0,0,8
1691354,1328349,2023-05-18,Assembly,"Do pass",15,0,0,1,16
1691354,1337962,2023-05-31,Assembly,"AB 371 Garcia Assembly Third Reading",80,0,0,0,80
1691354,1350241,2023-07-10,Senate,"Do pass as amended, but first amend, and re-refer to the Committee on [Appropriations] with the recommendation: To Consent Calendar",11,0,0,0,11
1691354,1351493,2023-08-14,Senate,"Placed on suspense file",7,0,0,0,7
1691354,1352798,2023-09-01,Senate,"Do pass",7,0,0,0,7
1691354,1354257,2023-09-13,Senate,"Assembly 3rd Reading AB371 Garcia et al. By Jones",39,0,0,1,40
1691354,1354258,2023-09-13,Assembly,"AB 371 Garcia Concurrence in Senate Amendments",79,0,0,1,80
1691355,1304378,2023-04-18,Assembly,"Do pass and be re-referred to the Committee on [Appropriations]",7,0,0,1,8
1691355,1328222,2023-05-18,Assembly,"Do pass as amended",15,0,0,1,16
1691355,1333720,2023-05-25,Assembly,"AB 372 Stephanie Nguyen Assembly Third Reading",76,0,0,4,80
1691355,1345675,2023-06-19,Senate,"Do pass, but first be re-referred to the Committee on [Appropriations]",5,0,0,0,5
1691355,1349493,2023-07-03,Senate,"Placed on suspense file",7,0,0,0,7
1691355,1352894,2023-09-01,Senate,"Do pass",7,0,0,0,7
1691355,1353982,2023-09-12,Senate,"Assembly 3rd Reading AB372 Stephanie Nguyen et By Skinner",38,0,0,2,40
1691355,1354237,2023-09-13,Assembly,"AB 372 Stephanie Nguyen Concurrence in Senate Amendments",80,0,0,0,80
1691356,1289835,2023-03-29,Assembly,"Do pass as amended, and be re-referred to the Committee on [Human Services] with recommendation: To Consent Calendar",6,0,0,1,7
1691356,1310178,2023-04-25,Assembly,"Do pass. To Consent Calendar",8,0,0,0,8
1691356,1318980,2023-05-04,Assembly,"AB 373 Gipson Consent Calendar Second Day",75,0,0,5,80
1691356,1340963,2023-06-07,Senate,"Do pass, but first be re-referred to the Committee on [Human Services] with the recommendation: To Consent Calendar",7,0,0,0,7
1691356,1349563,2023-07-03,Senate,"Do pass as amended",5,0,0,0,5
1691356,1353801,2023-09-12,Senate,"Assembly 3rd Reading AB373 Gipson et al. By Wahab",38,0,0,2,40
1691356,1354111,2023-09-13,Assembly,"AB 373 Gipson Concurrence in Senate Amendments",80,0,0,0,80
1691357,1298163,2023-04-11,Assembly,"Do pass as amended and be re-referred to the Committee on [Governmental Organization]",15,2,0,1,18
1691357,1311825,2023-04-26,Assembly,"Do pass as amended and be re-referred to the Committee on [Appropriations]",17,4,0,1,22
1691357,1338004,2023-05-31,Assembly,"AB 374 Haney Assembly Third Reading",64,9,0,7,80
1691357,1347501,2023-06-26,Senate,"Do pass",11,1,0,1,13
1691357,1353434,2023-09-07,Senate,"Assembly 3rd Reading AB374 Haney By Caballero",34,3,0,3,40
1691357,1353698,2023-09-11,Assembly,"AB 374 Haney Concurrence in Senate Amendments",66,9,0,5,80
1691358,1363757,2024-01-09,Assembly,"Do pass. To Consent Calendar",10,0,0,0,10
1691358,1364232,2024-01-12,Assembly,"AB 375 Davies Consent Calendar Second Day",67,0,0,13,80
1691358,1453449,2024-06-04,Senate,"Do pass, but first be re-referred to the Committee on [Business, Professions and Economic Development] with the recommendation: To Consent Calendar",11,0,0,0,11
1691358,1457978,2024-06-17,Senate,"Do pass and be ordered to the Consent Calendar",12,0,0,1,13
1691358,1458768,2024-06-20,Senate,"Consent Calendar 2nd AB375 Davies",36,0,0,4,40
1691358,1461230,2024-06-27,Assembly,"AB 375 Davies Concurrence in Senate Amendments",73,0,0,6,79
1691359,1298306,2023-04-11,Assembly,"Do pass and be re-referred to the Committee on [Appropriations]",12,0,0,0,12
1691359,1328596,2023-05-18,Assembly,"Do pass",15,0,0,1,16
1691359,1337972,2023-05-31,Assembly,"AB 376 Villapudua Assembly Third Reading",80,0,0,0,80
1691359,1350385,2023-07-12,Senate,"Do pass as amended, but first amend, and re-refer to the Committee on [Appropriations]",6,0,0,1,7
1691359,1351295,2023-08-14,Senate,"Placed on suspense file",7,0,0,0,7
1691359,1353058,2023-09-01,Senate,"Do pass",7,0,0,0,7
1691359,1353998,2023-09-12,Assembly,"AB 376 Villapudua Concurrence in Senate Amendments",80,0,0,0,80
1691359,1354655,2023-09-11,Senate,"Assembly 3rd Reading AB376 Villapudua By Newman",39,0,0,1,40
1691360,1283153,2023-03-22,Assembly,"Do pass and be re-referred to the Committee on [Higher Education] with recommendation: To Consent Calendar",7,0,0,0,7
1691360,1311706,2023-04-25,Assembly,"Do pass and be re-referred to the Committee on [Appropriations] with recommendation: To Consent Calendar",12,0,0,0,12
1691360,1328237,2023-05-18,Assembly,"Do pass",15,0,0,1,16
1691360,1338067,2023-05-31,Assembly,"AB 377 Muratsuchi Assembly Third Reading",80,0,0,0,80
1691360,1350470,2023-07-12,Senate,"Do pass, but first be re-referred to the Committee on [Appropriations]",7,0,0,0,7
1691360,1351760,2023-08-21,Senate,"Placed on suspense file",7,0,0,0,7
1691361,1275540,2023-03-13,Assembly,"Do pass and be re-referred to the Committee on [Appropriations] with recommendation: To Consent Calendar",14,0,0,1,15
1691362,1247339,2023-02-09,Assembly,"Be adopted. To Consent Calendar",11,0,0,2,13
1691362,1255132,2023-02-17,Assembly,"ACR 10 Weber Consent Calendar Second Day",71,0,0,9,80
1691363,1241833,2023-02-02,Assembly,"Be adopted. To third reading",13,0,0,0,13
1691364,1305441,2023-04-19,Senate,"Do pass",7,0,0,0,7
1691364,1323864,2023-05-11,Senate,"Senate 3rd Reading SB274 Skinner",36,3,0,1,40
1691364,1350389,2023-07-12,Assembly,"Do pass as amended and be re-referred to the Committee on [Appropriations]",5,0,0,2,7
1691364,1352735,2023-09-01,Assembly,"Do pass",12,3,0,1,16
1691364,1353204,2023-09-06,Assembly,"SB 274 Skinner Senate Third Reading By Bonta",61,13,0,6,80
1691364,1353512,2023-09-07,Senate,"Unfinished Business SB274 Skinner et al. Concurrence",32,6,0,2,40
1691365,1304247,2023-04-18,Senate,"Do pass, but first be re-referred to the Committee on [Appropriations] with the recommendation: To Consent Calendar",10,0,0,1,11
1691365,1318987,2023-05-04,Senate,"Consent Calendar SB275 Grove",37,0,0,3,40
1691365,1343120,2023-06-12,Assembly,"Do pass and be re-referred to the Committee on [Appropriations] with recommendation: To Consent Calendar",10,0,0,1,11
1691365,1346194,2023-06-21,Assembly,"Do pass. To Consent Calendar",13,0,0,3,16
1691365,1347858,2023-06-27,Assembly,"SB 275 Grove Consent Calendar Second Day Regular Session",78,0,0,2,80
1691366,1311649,2023-04-26,Senate,"Do pass, but first be re-referred to the Committee on [Appropriations]",5,0,0,0,5
1691366,1320367,2023-05-08,Senate,"Placed on suspense file",7,0,0,0,7
1691367,1310393,2023-04-25,Senate,"Do pass, but first be re-referred to the Committee on [Appropriations]",14,0,0,1,15
1691367,1333593,2023-05-25,Senate,"Senate 3rd Reading SB277 Dodd",40,0,0,0,40
1691368,1305470,2023-04-19,Senate,"Do pass, but first be re-referred to the Committee on [Judiciary]",4,1,0,2,7
1691368,1317087,2023-05-02,Senate,"Do pass as amended",10,1,0,0,11
1691368,1330125,2023-05-22,Senate,"Senate 3rd Reading SB278 Dodd et al",33,5,0,2,40
1691368,1457966,2024-06-17,Assembly,"Do pass and be re-referred to the Committee on [Judiciary]",8,0,0,1,9
1691368,1460095,2024-06-25,Assembly,"Do pass as amended",9,2,0,1,12
1691368,1464639,2024-08-15,Assembly,"Do pass as amended",11,2,0,2,15
1691368,1465643,2024-08-26,Assembly,"SB 278 Dodd Senate Third Reading By Grayson",75,0,0,4,79
1691368,1466055,2024-08-28,Senate,"That the Assembly amendments be concurred in",5,0,0,2,7
1691368,1466346,2024-08-29,Senate,"Unfinished Business SB278 Dodd et al. Concurrence",33,1,0,6,40
1691369,1310250,2023-04-25,Senate,"Do pass, but first be re-referred to the Committee on [Appropriations]",15,0,0,0,15
1691369,1320496,2023-05-08,Senate,"Placed on suspense file",7,0,0,0,7
1691370,1288281,2023-03-28,Senate,"Do pass, but first be re-referred to the Committee on [Appropriations]",10,0,0,1,11
1691370,1308842,2023-04-24,Senate,"Senate 3rd Reading SB280 Laird",39,0,0,1,40
1691370,1343699,2023-06-13,Assembly,"Do pass as amended and be re-referred to the Committee on [Appropriations]",11,0,0,0,11
1691370,1348442,2023-06-28,Assembly,"Do pass. To Consent Calendar",14,0,0,2,16
1691370,1351259,2023-08-14,Assembly,"SB 280 Laird Senate Third Reading By Maienschein Amendment Set #1",73,0,0,7,80
1691370,1352318,2023-08-28,Assembly,"SB 280 Laird Senate Third Reading By Maienschein",76,0,0,4,80
1691370,1353322,2023-09-06,Senate,"Unfinished Business SB280 Laird Concurrence",40,0,0,0,40
1691371,1280601,2023-03-21,Senate,"Do pass, but first be re-referred to the Committee on [Appropriations]",5,0,0,0,5
1691371,1296977,2023-04-10,Senate,"Placed on suspense file",7,0,0,0,7
1691371,1328038,2023-05-18,Senate,"Do pass as amended",7,0,0,0,7
1691371,1335515,2023-05-30,Senate,"Special Consent SB281 McGuire et al",40,0,0,0,40
1691371,1348459,2023-06-27,Assembly,"Do pass as amended, and be re-referred to the Committee on [Appropriations] with recommendation: To Consent Calendar",8,0,0,0,8
1691371,1352644,2023-09-01,Assembly,"Do pass",16,0,0,0,16
1691371,1353757,2023-09-12,Assembly,"SB 281 McGuire Senate Third Reading By Wood",80,0,0,0,80
1691371,1354132,2023-09-13,Senate,"Unfinished Business SB281 McGuire et al. Concurrence",39,0,0,1,40
1691372,1288196,2023-03-29,Senate,"Do pass, but first be re-referred to the Committee on [Appropriations] with the recommendation: To Consent Calendar",12,0,0,0,12
1691372,1296899,2023-04-10,Senate,"Placed on suspense file",7,0,0,0,7
1691372,1328211,2023-05-18,Senate,"Do pass",7,0,0,0,7
1691372,1333719,2023-05-25,Senate,"Special Consent SB282 Eggman et al",40,0,0,0,40
1691372,1350140,2023-07-11,Assembly,"Do pass and be re-referred to the Committee on [Appropriations] with recommendation: To Consent Calendar",15,0,0,0,15
1691373,1281908,2023-03-22,Senate,"Do pass as amended, but first amend, and re-refer to the Committee on [Appropriations] with the recommendation: To Consent Calendar",7,0,0,0,7
1691373,1296951,2023-04-10,Senate,"Placed on suspense file",7,0,0,0,7
1691373,1328728,2023-05-18,Senate,"Do pass",7,0,0,0,7
1691373,1333550,2023-05-25,Senate,"Special Consent SB283 Ochoa Bogh",40,0,0,0,40
1691373,1350431,2023-07-12,Assembly,"Do pass as amended and be re-referred to the Committee on [Appropriations]",6,0,0,1,7
1691374,1285655,2023-03-27,Senate,"Do pass",7,0,0,6,13
1691374,1296952,2023-04-10,Senate,"Senate 3rd Reading SB284 Wiener",25,1,0,14,40
1691375,1302703,2023-04-17,Senate,"Do pass",12,1,0,0,13
1691375,1324964,2023-05-15,Senate,"Senate 3rd Reading SB285 Allen",33,3,0,4,40
1691375,1345688,2023-06-20,Assembly,"Do pass and be re-referred to the Committee on [Governmental Organization]",15,2,0,2,19
1691375,1462442,2024-07-02,Assembly,"Do pass as amended and be re-referred to the Committee on [Appropriations]",8,0,0,0,8
1691375,1463734,2024-08-07,Assembly,"Do pass. To Consent Calendar",14,0,0,1,15
1691375,1465661,2024-08-26,Assembly,"SB 285 Allen Senate Third Reading By McCarty",71,1,0,7,79
1691375,1466071,2024-08-28,Senate,"That the Assembly amendments be concurred in",5,0,0,0,5
1691375,1466095,2024-08-29,Senate,"Unfinished Business SB285 Allen Concurrence",39,0,0,1,40
1693891,1304391,2023-04-17,Assembly,"Do pass and be re-referred to the Committee on [Appropriations] with recommendation: To Consent Calendar",7,0,0,0,7
1693891,1318096,2023-05-03,Assembly,"Do pass. To Consent Calendar",16,0,0,0,16
1693891,1323805,2023-05-11,Assembly,"AB 379 Rodriguez Consent Calendar Second Day Regular Session",66,0,0,14,80
1693891,1349785,2023-07-05,Senate,"Do pass as amended, but first amend, and re-refer to the Committee on [Appropriations]",9,0,0,3,12
1693891,1351283,2023-08-14,Senate,"Placed on suspense file",7,0,0,0,7
1693892,1281815,2023-03-22,Assembly,"Do pass and be re-referred to the Committee on [Public Safety]",7,0,0,0,7
1693892,1304278,2023-04-18,Assembly,"Do pass and be re-referred to the Committee on [Appropriations]",8,0,0,0,8
1693892,1328583,2023-05-18,Assembly,"Do pass",15,0,0,1,16
1693892,1338001,2023-05-31,Assembly,"AB 380 Arambula Assembly Third Reading",80,0,0,0,80
1693892,1348343,2023-06-28,Senate,"Do pass, but first be re-referred to the Committee on [Public Safety] with the recommendation: To Consent Calendar",5,0,0,0,5
1693892,1350295,2023-07-11,Senate,"Do pass, but first be re-referred to the Committee on [Appropriations] with the recommendation: To Consent Calendar",4,0,0,1,5
1693892,1351331,2023-08-14,Senate,"Placed on suspense file",7,0,0,0,7
1693893,1313452,2023-04-26,Assembly,"Do pass as amended and be re-referred to the Committee on [Appropriations]",7,0,0,0,7
1693894,1304398,2023-04-17,Assembly,"Do pass and be re-referred to the Committee on [Appropriations] with recommendation: To Consent Calendar",15,0,0,0,15
1693894,1322906,2023-05-10,Assembly,"Do pass. To Consent Calendar",14,0,0,2,16
1693894,1328159,2023-05-18,Assembly,"AB 382 Cervantes Consent Calendar Second Day Regular Session",74,0,0,6,80
1693894,1343745,2023-06-13,Senate,"Do pass, but first be re-referred to the Committee on [Appropriations] with the recommendation: To Consent Calendar",16,0,0,0,16
1693894,1347496,2023-06-26,Senate,"Placed on suspense file",6,0,0,1,7
1693894,1353060,2023-09-01,Senate,"Do pass",7,0,0,0,7
1693895,1283128,2023-03-22,Assembly,"Do pass as amended and be re-referred to the Committee on [Appropriations]",7,0,0,0,7
1693895,1327975,2023-05-18,Assembly,"Do pass as amended",11,0,0,5,16
1693895,1333749,2023-05-25,Assembly,"AB 383 Zbur Assembly Third Reading",76,0,0,4,80
1693895,1348387,2023-06-28,Senate,"Do pass, but first be re-referred to the Committee on [Education] with the recommendation: To Consent Calendar",5,0,0,0,5
1693895,1349608,2023-07-05,Senate,"Do pass, but first be re-referred to the Committee on [Appropriations] with the recommendation: To Consent Calendar",7,0,0,0,7
1693895,1351480,2023-08-14,Senate,"Placed on suspense file",7,0,0,0,7
1693895,1352538,2023-09-01,Senate,"Do pass",7,0,0,0,7
1693896,1301027,2023-04-12,Assembly,"Do pass as amended, and be re-referred to the Committee on [Appropriations] with recommendation: To Consent Calendar",7,0,0,0,7
1693896,1328534,2023-05-18,Assembly,"Do pass",15,0,0,1,16
1693896,1338012,2023-05-31,Assembly,"AB 384 Calderon Assembly Third Reading",80,0,0,0,80
1693896,1348400,2023-06-28,Senate,"Do pass, but first be re-referred to the Committee on [Appropriations] with the recommendation: To Consent Calendar",7,0,0,0,7
1693896,1349901,2023-07-10,Senate,"Placed on suspense file",6,0,0,1,7
1693896,1352994,2023-09-01,Senate,"Do pass",7,0,0,0,7
1693896,1354017,2023-09-12,Senate,"Special Consent AB384 Calderon et al. By Gonzalez",39,0,0,1,40
1693897,1276606,2023-03-14,Assembly,"Do pass and be re-referred to the Committee on [Appropriations] with recommendation: To Consent Calendar",13,0,0,2,15
1693898,1280687,2023-03-21,Assembly,"Do pass and be re-referred to the Committee on [Appropriations]",11,0,0,0,11
1693898,1305240,2023-04-19,Assembly,"Do pass. To Consent Calendar",14,0,0,2,16
1693898,1315719,2023-05-01,Assembly,"AB 386 Stephanie Nguyen Assembly Third Reading",78,0,0,2,80
1693898,1343749,2023-06-13,Senate,"Do pass, but first be re-referred to the Committee on [Banking and Financial Institutions] with the recommendation: To Consent Calendar",5,0,0,0,5
1693898,1346161,2023-06-21,Senate,"Do pass, but first be re-referred to the Committee on [Appropriations] with the recommendation: To Consent Calendar",7,0,0,0,7
1693898,1349944,2023-07-10,Senate,"Placed on suspense file",6,0,0,1,7
1693898,1352703,2023-09-01,Senate,"Do pass",7,0,0,0,7
1693898,1353746,2023-09-12,Senate,"Special Consent AB386 Stephanie Nguyen By Caballero",39,0,0,1,40
1693899,1276627,2023-03-14,Assembly,"Do pass and be re-referred to the Committee on [Appropriations] with recommendation: To Consent Calendar",13,0,0,2,15
1693899,1288346,2023-03-29,Assembly,"Do pass. To Consent Calendar",14,0,0,2,16
1693899,1302678,2023-04-17,Assembly,"AB 387 Aguiar-Curry Consent Calendar Second Day Regular Session",79,0,0,1,80
1693899,1340969,2023-06-07,Senate,"Do pass, but first be re-referred to the Committee on [Appropriations] with the recommendation: To Consent Calendar",12,0,0,0,12
1693899,1347508,2023-06-26,Senate,"Placed on suspense file",6,0,0,1,7
1693900,1285631,2023-03-27,Assembly,"Do pass and be re-referred to the Committee on [Appropriations]",11,0,0,0,11
1693900,1328084,2023-05-18,Assembly,"Do pass as amended",11,0,0,5,16
1693900,1333737,2023-05-25,Assembly,"AB 388 Connolly Assembly Third Reading",76,0,0,4,80
1693900,1349528,2023-07-03,Senate,"Do pass as amended, but first amend, and re-refer to the Committee on [Appropriations] with the recommendation: To Consent Calendar",9,0,0,2,11
1693900,1351485,2023-08-14,Senate,"Placed on suspense file",7,0,0,0,7
1693901,1302577,2023-04-17,Assembly,"Do pass and be re-referred to the Committee on [Governmental Organization]",11,0,0,0,11
1693901,1311705,2023-04-26,Assembly,"Do pass as amended and be re-referred to the Committee on [Appropriations]",22,0,0,0,22
1693901,1322882,2023-05-10,Assembly,"Do pass. To Consent Calendar",14,0,0,2,16
1693901,1328125,2023-05-18,Assembly,"AB 389 Ramos Consent Calendar Second Day Regular Session",74,0,0,6,80
1693901,1346974,2023-06-22,Senate,"Do pass as amended, but first amend, and re-refer to the Committee on [Judiciary] with the recommendation: To Consent Calendar",11,0,0,0,11
1693901,1353606,2023-09-11,Senate,"Do pass as amended, but first amend, and re-refer to the Committee on [Appropriations]",5,0,0,2,7
1693901,1353842,2023-09-12,Senate,"Do pass",7,0,0,0,7
1693901,1354720,2023-09-14,Assembly,"With recommendation: That Senate amendments be concurred in",10,0,0,2,12
1693901,1354721,2023-09-14,Senate,"Assembly 3rd Reading AB389 Ramos et al. Ochoa Bogh",40,0,0,0,40
1693901,1354722,2023-09-14,Assembly,"AB 389 Ramos Concurrence in Senate Amendments",78,0,0,2,80
1693902,1270445,2023-03-07,Assembly,"Do pass and be re-referred to the Committee on [Appropriations] with recommendation: To Consent Calendar",8,0,0,0,8
1693903,1275571,2023-03-14,Assembly,"Do pass and be re-referred to the Committee on [Appropriations]",7,0,0,1,8
1693903,1327939,2023-05-18,Assembly,"Do pass",13,0,0,3,16
1693903,1338034,2023-05-31,Assembly,"AB 391 Jones-Sawyer Assembly Third Reading",78,0,0,2,80
1693903,1347889,2023-06-27,Senate,"Do pass, but first be re-referred to the Committee on [Appropriations] with the recommendation: To Consent Calendar",5,0,0,0,5
1693903,1349970,2023-07-10,Senate,"Placed on suspense file",6,0,0,1,7
1693903,1352517,2023-09-01,Senate,"Do pass as amended",7,0,0,0,7
1693903,1354297,2023-09-13,Senate,"Special Consent AB391 Jones-Sawyer By Wahab",39,0,0,1,40
1693903,1354715,2023-09-14,Assembly,"AB 391 Jones-Sawyer Concurrence in Senate Amendments",76,0,0,4,80
1693905,1275560,2023-03-14,Assembly,"Do pass and be re-referred to the Committee on [Education]",8,0,0,0,8
1693905,1289844,2023-03-29,Assembly,"Do pass and be re-referred to the Committee on [Appropriations] with recommendation: To Consent Calendar",6,0,0,1,7
1693905,1328879,2023-05-18,Assembly,"Do pass",15,0,0,1,16
1693905,1338029,2023-05-31,Assembly,"AB 393 Luz Rivas Assembly Third Reading",80,0,0,0,80
1693905,1349619,2023-07-03,Senate,"Do pass, but first be re-referred to the Committee on [Education] with the recommendation: To Consent Calendar",5,0,0,0,5
1693905,1350554,2023-07-12,Senate,"Do pass, but first be re-referred to the Committee on [Appropriations] with the recommendation: To Consent Calendar",7,0,0,0,7
1693905,1351261,2023-08-14,Senate,"Placed on suspense file",7,0,0,0,7
1693905,1352724,2023-09-01,Senate,"Do pass as amended",7,0,0,0,7
1693905,1353821,2023-09-12,Senate,"Assembly 3rd Reading AB393 Luz Rivas et al. By Lim√≥n",38,0,0,2,40
1693905,1354158,2023-09-13,Assembly,"AB 393 Luz Rivas Concurrence in Senate Amendments",80,0,0,0,80
1693907,1305487,2023-04-18,Assembly,"Do pass and be re-referred to the Committee on [Appropriations]",11,0,0,1,12
1693909,1274195,2023-03-13,Assembly,"Do pass and be re-referred to the Committee on [Appropriations]",4,5,0,2,11
1693909,1274196,2023-03-13,Assembly,Reconsideration,11,0,0,0,11
1693909,1363618,2024-01-08,Assembly,"Do pass and be re-referred to the Committee on [Appropriations]",3,6,0,2,11
1693910,1276631,2023-03-15,Assembly,"Do pass as amended",5,1,0,2,8
1693910,1288147,2023-03-29,Assembly,"Do pass",10,3,0,3,16
1693910,1306798,2023-04-20,Assembly,"AB 398 Pellerin Assembly Third Reading",60,14,0,6,80
1693910,1339986,2023-06-06,Senate,"Do pass, but first be re-referred to the Committee on [Appropriations]",6,1,0,0,7
1693910,1353297,2023-09-06,Senate,"Assembly 3rd Reading AB398 Pellerin By Newman",31,8,0,1,40
1693911,1270449,2023-03-07,Assembly,"Do pass and be re-referred to the Committee on [Appropriations] with recommendation: To Consent Calendar",8,0,0,0,8
1693911,1322847,2023-05-10,Assembly,"Do pass. To Consent Calendar",14,0,0,2,16
1693911,1328791,2023-05-18,Assembly,"AB 399 Ting Consent Calendar Second Day Regular Session",74,0,0,6,80
1693911,1350627,2023-07-12,Senate,"Do pass as amended",5,3,0,0,8
1693911,1352345,2023-08-28,Senate,"Placed on suspense file",7,0,0,0,7
1693911,1352774,2023-09-01,Senate,"Do pass as amended",5,2,0,0,7
1693911,1353288,2023-09-06,Senate,"Assembly 3rd Reading AB399 Boerner By Blakespear",23,10,0,7,40
1693911,1353926,2023-09-12,Assembly,"AB 399 Boerner Concurrence in Senate Amendments",47,8,0,25,80
1693912,1313523,2023-04-26,Assembly,"Do pass as amended and be re-referred to the Committee on [Appropriations]",8,0,0,0,8
1693912,1322894,2023-05-10,Assembly,"Do pass. To Consent Calendar",14,0,0,2,16
1693912,1328397,2023-05-18,Assembly,"AB 400 Blanca Rubio Consent Calendar Second Day Regular Session",74,0,0,6,80
1693912,1346314,2023-06-21,Senate,"Do pass, but first be re-referred to the Committee on [Appropriations] with the recommendation: To Consent Calendar",8,0,0,0,8
1693912,1350621,2023-07-13,Senate,"Consent Calendar AB400 Blanca Rubio",37,0,0,3,40
1693912,1352309,2023-08-28,Assembly,"AB 400 Blanca Rubio Concurrence in Senate Amendments",76,0,0,4,80
1693913,1286955,2023-03-28,Assembly,"Do pass and be re-referred to the Committee on [Appropriations] with recommendation: To Consent Calendar",15,0,0,0,15
1693914,1276592,2023-03-15,Assembly,"Do pass and be re-referred to the Committee on [Appropriations]",8,0,0,3,11
1693914,1327931,2023-05-18,Assembly,"Do pass as amended",11,0,0,5,16
1693914,1337898,2023-05-31,Assembly,"AB 402 Aguiar-Curry Assembly Third Reading",78,0,0,2,80
1693914,1349440,2023-07-03,Senate,"Do pass, but first be re-referred to the Committee on [Appropriations] with the recommendation: To Consent Calendar",3,0,0,1,4
1693914,1351792,2023-08-21,Senate,"Placed on suspense file",7,0,0,0,7
1693914,1352963,2023-09-01,Senate,"Do pass",7,0,0,0,7
1693914,1353756,2023-09-12,Senate,"Special Consent AB402 Aguiar-Curry By Dodd",39,0,0,1,40
1693914,1354180,2023-09-13,Assembly,"AB 402 Aguiar-Curry Concurrence in Senate Amendments",78,0,0,2,80
1693916,1276596,2023-03-15,Assembly,"Do pass and be re-referred to the Committee on [Appropriations]",8,0,0,3,11
1693916,1328863,2023-05-18,Assembly,"Do pass as amended",11,0,0,5,16
1693916,1333715,2023-05-25,Assembly,"AB 404 Connolly Assembly Third Reading",76,0,0,4,80
1693916,1345620,2023-06-19,Senate,"Do pass, but first be re-referred to the Committee on [Appropriations] with the recommendation: To Consent Calendar",4,0,0,0,4
1693916,1349438,2023-07-03,Senate,"Placed on suspense file",7,0,0,0,7
1693916,1352960,2023-09-01,Senate,"Do pass",7,0,0,0,7
1693916,1354007,2023-09-12,Senate,"Special Consent AB404 Connolly By Hurtado",39,0,0,1,40
1693917,1276603,2023-03-15,Assembly,"Do pass and be re-referred to the Committee on [Appropriations]",8,0,0,3,11
1693917,1328758,2023-05-18,Assembly,"Do pass as amended",11,0,0,5,16
1693917,1333683,2023-05-25,Assembly,"AB 405 Connolly Assembly Third Reading",76,0,0,4,80
1693917,1344186,2023-06-14,Senate,"Do pass, but first be re-referred to the Committee on [Appropriations] with the recommendation: To Consent Calendar",12,0,0,0,12
1693917,1347535,2023-06-26,Senate,"Placed on suspense file",6,0,0,1,7
1693918,1276615,2023-03-15,Assembly,"Do pass and be re-referred to the Committee on [Appropriations]",6,1,0,4,11
1693919,1278557,2023-03-14,Assembly,"Do pass. To Consent Calendar",9,0,0,0,9
1693919,1283189,2023-03-23,Assembly,"AB 407 Chen Consent Calendar Second Day Regular Session",74,0,0,6,80
1693919,1348398,2023-06-28,Senate,"Do pass, but first be re-referred to the Committee on [Rules] with the recommendation: To Consent Calendar",7,0,0,0,7
1693919,1351297,2023-08-14,Senate,"Placed on suspense file",7,0,0,0,7
1693919,1352871,2023-09-01,Senate,"Do pass",7,0,0,0,7
1693919,1353776,2023-09-12,Senate,"Special Consent AB407 Chen By Nguyen",39,0,0,1,40
1693919,1354387,2023-09-13,Assembly,"AB 407 Chen Concurrence in Senate Amendments",79,0,0,1,80
1693920,1288377,2023-03-29,Assembly,"Do pass and be re-referred to the Committee on [Natural Resources]",10,0,0,1,11
1693920,1301984,2023-04-10,Assembly,"Do pass as amended and be re-referred to the Committee on [Appropriations]",10,1,0,0,11
1693920,1328802,2023-05-18,Assembly,"Do pass",11,4,0,1,16
1693920,1338013,2023-05-31,Assembly,"AB 408 Wilson Third Reading Urgency",67,9,0,4,80
1693920,1349485,2023-07-03,Senate,"Do pass, but first be re-referred to the Committee on [Governance and Finance]",3,0,0,1,4
1693920,1350648,2023-07-12,Senate,"Do pass as amended, but first amend, and re-refer to the Committee on [Appropriations]",6,2,0,0,8
1693920,1351764,2023-08-21,Senate,"Placed on suspense file",7,0,0,0,7
1693922,1298187,2023-04-11,Assembly,"Do pass as amended. To Consent Calendar",10,0,0,1,11
1693922,1306772,2023-04-20,Assembly,"AB 410 Jones-Sawyer Consent Calendar Second Day Regular Session",76,0,0,4,80
1693922,1343712,2023-06-13,Senate,"Do pass and be ordered to the Consent Calendar",10,0,0,1,11
1693922,1346941,2023-06-22,Senate,"Consent Calendar AB410 Jones-Sawyer Urgency Clause",39,0,0,1,40
1693923,1305239,2023-04-18,Assembly,"Do pass and be re-referred to the Committee on [Appropriations]",14,0,0,1,15
1693924,1304241,2023-04-18,Assembly,"Do pass as amended and be re-referred to the Committee on [Appropriations]",15,0,0,0,15
1693924,1328660,2023-05-18,Assembly,"Do pass",15,0,0,1,16
1693924,1338059,2023-05-31,Assembly,"AB 412 Soria Third Reading Urgency",80,0,0,0,80
1693925,1280674,2023-03-20,Assembly,"Do pass as amended and be re-referred to the Committee on [Appropriations]",11,4,0,0,15
1693925,1322927,2023-05-10,Assembly,"Do pass",12,3,0,1,16
1693925,1330032,2023-05-22,Assembly,"AB 413 Lee Assembly Third Reading",53,16,0,11,80
1693925,1350509,2023-07-11,Senate,"Do pass as amended, but first amend, and re-refer to the Committee on [Appropriations]",13,2,0,1,16
1693925,1351806,2023-08-21,Senate,"Placed on suspense file",7,0,0,0,7
1693925,1352814,2023-09-01,Senate,"Do pass",5,2,0,0,7
1693925,1353922,2023-09-12,Senate,"Assembly 3rd Reading AB413 Lee By Blakespear",29,7,0,4,40
1693925,1354380,2023-09-13,Assembly,"AB 413 Lee Concurrence in Senate Amendments",57,18,0,5,80
1693926,1288297,2023-03-29,Assembly,"Do pass as amended and be re-referred to the Committee on [Appropriations]",11,0,0,2,13
1693926,1328573,2023-05-18,Assembly,"Do pass as amended",11,0,0,5,16
1693926,1333645,2023-05-25,Assembly,"AB 414 Reyes Assembly Third Reading",63,0,0,17,80
1693926,1345627,2023-06-20,Senate,"Do pass, but first be re-referred to the Committee on [Appropriations]",16,0,0,2,18
1693926,1353163,2023-09-05,Senate,"Assembly 3rd Reading AB414 Reyes et al. By Wilk",35,0,0,5,40
1693926,1353438,2023-09-07,Assembly,"AB 414 Reyes Concurrence in Senate Amendments",69,0,0,11,80
1693927,1274173,2023-03-13,Assembly,"Do pass and be re-referred to the Committee on [Communications and Conveyance] with recommendation: To Consent Calendar",7,0,0,0,7
1693927,1305401,2023-04-19,Assembly,"Do pass and be re-referred to the Committee on [Appropriations] with recommendation: To Consent Calendar",13,0,0,0,13
1693928,1271502,2023-03-08,Assembly,"Do pass and be re-referred to the Committee on [Appropriations]",21,0,0,1,22
1693928,1281925,2023-03-22,Assembly,"Do pass. To Consent Calendar",15,0,0,1,16
1693928,1289789,2023-03-30,Assembly,"AB 416 Muratsuchi Consent Calendar Second Day Regular Session",60,0,0,20,80
1693928,1343784,2023-06-13,Senate,"Do pass, but first be re-referred to the Committee on [Appropriations]",14,0,0,1,15
1693928,1353432,2023-09-07,Senate,"Assembly 3rd Reading AB416 Muratsuchi et al. By Durazo",39,0,0,1,40
1693929,1283242,2023-03-22,Assembly,"Do pass. To Consent Calendar",7,0,0,0,7
1693929,1289811,2023-03-30,Assembly,"AB 417 Bennett Consent Calendar Second Day Regular Session",60,0,0,20,80
1693929,1340984,2023-06-07,Senate,"Do pass and be ordered to the Consent Calendar",7,0,0,0,7
1693929,1353118,2023-09-05,Senate,"Assembly 3rd Reading AB417 Bennett et al. By Lim√≥n",39,0,0,1,40
1693929,1353411,2023-09-07,Assembly,"AB 417 Bennett Concurrence in Senate Amendments",78,0,0,2,80
1693930,1298208,2023-04-11,Assembly,"Do pass and be re-referred to the Committee on [Environmental Safety and Toxic Materials]",12,1,0,2,15
1693930,1305299,2023-04-18,Assembly,"Do pass and be re-referred to the Committee on [Appropriations]",7,1,0,1,9
1693930,1318044,2023-05-03,Assembly,"Do pass",12,3,0,1,16
1693930,1324959,2023-05-15,Assembly,"AB 418 Gabriel Assembly Third Reading",54,12,0,14,80
1693930,1348878,2023-06-28,Senate,"Do pass as amended, but first amend, and re-refer to the Committee on [Environmental Quality]",10,0,0,2,12
1693930,1350549,2023-07-12,Senate,"Do pass, but first be re-referred to the Committee on [Appropriations]",5,1,0,1,7
1693930,1353923,2023-09-12,Assembly,"AB 418 Gabriel Concurrence in Senate Amendments",65,6,0,9,80
1693930,1354687,2023-09-11,Senate,"Assembly 3rd Reading AB418 Gabriel et al. By Menjivar",33,3,0,4,40
1693931,1286958,2023-03-28,Assembly,"Do pass as amended and be re-referred to the Committee on [Appropriations]",10,0,0,1,11
1693932,1304419,2023-04-18,Assembly,"Do pass and be re-referred to the Committee on [Appropriations]",17,0,0,1,18
1693932,1328447,2023-05-18,Assembly,"Do pass",15,0,0,1,16
1693932,1338154,2023-05-31,Assembly,"AB 420 Aguiar-Curry Assembly Third Reading",79,0,0,1,80
1693932,1347502,2023-06-26,Senate,"Do pass, but first be re-referred to the Committee on [Rules]",11,1,0,1,13
1693932,1350661,2023-07-12,Senate,"Do pass, but first be re-referred to the Committee on [Appropriations]",10,1,0,1,12
1693932,1351800,2023-08-21,Senate,"Placed on suspense file",7,0,0,0,7
1693933,1305331,2023-04-19,Assembly,"Do pass and be re-referred to the Committee on [Appropriations]",5,2,0,1,8
1693933,1328160,2023-05-18,Assembly,"Do pass as amended",11,4,0,1,16
1693933,1338197,2023-05-31,Assembly,"AB 421 Bryan Assembly Third Reading",60,18,0,2,80
1693933,1349829,2023-07-05,Senate,"Do pass as amended, but first amend, and re-refer to the Committee on [Appropriations]",6,1,0,0,7
1693933,1353166,2023-09-05,Senate,"Assembly 3rd Reading AB421 Bryan et al. By Gonzalez Urgency Clause",30,9,0,1,40
1693933,1353167,2023-09-05,Assembly,"AB 421 BRYAN Concurrence - Urgency Added",55,17,0,8,80
1693935,1298248,2023-04-11,Senate,"Do pass, but first be re-referred to the Committee on [Energy, Utilities and Communications]",9,0,0,2,11
1693935,1310308,2023-04-24,Senate,"Do pass as amended, but first amend, and re-refer to the Committee on [Appropriations]",16,0,0,2,18
1693935,1324992,2023-05-15,Senate,"Placed on suspense file",7,0,0,0,7
1693935,1328812,2023-05-18,Senate,"Do pass as amended",7,0,0,0,7
1693935,1332595,2023-05-24,Senate,"Senate 3rd Reading SB286 McGuire et al",32,5,0,3,40
1693935,1347536,2023-06-26,Assembly,"Do pass as amended and be re-referred to the Committee on [Utilities and Energy]",11,0,0,0,11
1693935,1350442,2023-07-12,Assembly,"Do pass as amended and be re-referred to the Committee on [Appropriations]",14,0,0,1,15
1693935,1352543,2023-09-01,Assembly,"Do pass as amended",11,0,0,5,16
1693935,1354225,2023-09-13,Assembly,"SB 286 McGuire Senate Third Reading By Wood",76,0,0,4,80
1693935,1354862,2023-09-14,Senate,"Unfinished Business SB286 McGuire et al. Concurrence",32,8,0,0,40
1693936,1299418,2023-04-11,Senate,"Do pass as amended, but first amend, and re-refer to the Committee on [Appropriations]",8,0,0,3,11
1693936,1308832,2023-04-24,Senate,"Placed on suspense file",7,0,0,0,7
1693936,1328186,2023-05-18,Senate,"Do pass as amended",5,1,0,1,7
1693937,1298326,2023-04-11,Senate,"Do pass, but first be re-referred to the Committee on [Judiciary]",1,2,0,2,5
1693937,1298327,2023-04-11,Senate,"[First] hearing set for [04-11-2023]: Failed passage in Committee. Reconsideration granted",5,0,0,0,5
1693939,1298260,2023-04-11,Senate,"Do pass, but first be re-referred to the Committee on [Appropriations] with the recommendation: To Consent Calendar",5,0,0,0,5
1693939,1315666,2023-05-01,Senate,"Consent Calendar SB290 Min",37,0,0,3,40
1693939,1343772,2023-06-13,Assembly,"Do pass and be re-referred to the Committee on [Appropriations] with recommendation: To Consent Calendar",8,0,0,0,8
1693939,1346276,2023-06-21,Assembly,"Do pass. To Consent Calendar",13,0,0,3,16
1693939,1347795,2023-06-27,Assembly,"SB 290 Min Consent Calendar Second Day Regular Session",78,0,0,2,80
1693940,1299408,2023-04-12,Senate,"Do pass, but first be re-referred to the Committee on [Appropriations]",7,0,0,0,7
1693940,1308805,2023-04-24,Senate,"Placed on suspense file",7,0,0,0,7
1693940,1328813,2023-05-18,Senate,"Do pass as amended",5,1,0,1,7
1693940,1336329,2023-05-31,Senate,"Senate 3rd Reading SB291 Newman",37,0,0,3,40
1693940,1350404,2023-07-12,Assembly,"Do pass as amended, and be re-referred to the Committee on [Appropriations] with recommendation: To Consent Calendar",7,0,0,0,7
1693940,1353811,2023-09-12,Assembly,"SB 291 Newman Senate Third Reading By Muratsuchi",79,0,0,1,80
1693940,1354215,2023-09-13,Senate,"Unfinished Business SB291 Newman Concurrence",39,0,0,1,40
1693941,1305473,2023-04-19,Senate,"Do pass, but first be re-referred to the Committee on [Governance and Finance]",2,5,0,0,7
1693941,1305474,2023-04-19,Senate,"[Second] hearing set for [04-19-2023]: Failed passage in Committee. Reconsideration granted",7,0,0,0,7
1693941,1363961,2024-01-10,Senate,"Do pass, but first be re-referred to the Committee on [Governance and Finance]",2,4,0,1,7
1693942,1305292,2023-04-19,Senate,"Do pass as amended, but first amend, and re-refer to the Committee on [Appropriations]",7,0,0,0,7
1693942,1330097,2023-05-22,Senate,"Senate 3rd Reading SB293 Grove",40,0,0,0,40
1693942,1348824,2023-06-28,Assembly,"Do pass and be re-referred to the Committee on [Appropriations] with recommendation: To Consent Calendar",7,0,0,0,7
1693942,1351560,2023-08-16,Assembly,"Do pass. To Consent Calendar",15,0,0,1,16
1693942,1352211,2023-08-24,Assembly,"SB 293 Grove Consent Calendar Second Day Regular Session",73,0,0,7,80
1693943,1363941,2024-01-10,Senate,"Do pass as amended, but first amend, and re-refer to the Committee on [Appropriations]",9,2,0,1,12
1693943,1364811,2024-01-16,Senate,"Placed on suspense file",6,0,0,1,7
1693943,1366773,2024-01-18,Senate,"Do pass",4,2,0,1,7
1693943,1371098,2024-01-29,Senate,"Senate 3rd Reading SB294 Wiener",31,7,0,2,40
1693943,1453439,2024-06-04,Assembly,"Do pass and be re-referred to the Committee on [Appropriations]",12,3,0,1,16
1693944,1288366,2023-03-28,Senate,"Do pass, but first be re-referred to the Committee on [Appropriations]",13,0,0,3,16
1693944,1324982,2023-05-15,Senate,"Senate 3rd Reading SB295 Dodd",38,0,0,2,40
1693944,1462220,2024-07-01,Assembly,"Do pass and be re-referred to the Committee on [Appropriations]",13,0,0,2,15
1693944,1464393,2024-08-15,Assembly,"Do pass",12,0,0,3,15
1693944,1465718,2024-08-26,Assembly,"SB 295 Dodd Senate Third Reading By Grayson",69,0,0,10,79
1693944,1466064,2024-08-28,Senate,"That the Assembly amendments be concurred in",13,0,0,2,15
1693944,1466285,2024-08-29,Senate,"Unfinished Business SB295 Dodd et al. Concurrence",39,0,0,1,40
1693945,1288152,2023-03-28,Senate,"Do pass, but first be re-referred to the Committee on [Appropriations]",8,0,0,3,11
1693945,1296929,2023-04-10,Senate,"Placed on suspense file",7,0,0,0,7
1693945,1328804,2023-05-18,Senate,"Do pass as amended",6,0,0,1,7
1693945,1336366,2023-05-31,Senate,"Senate 3rd Reading SB296 Dodd et al",36,0,0,4,40
1693945,1347830,2023-06-27,Assembly,"Do pass and be re-referred to the Committee on [Judiciary]",9,0,0,2,11
1693945,1350262,2023-07-11,Assembly,"Do pass and be re-referred to the Committee on [Appropriations] with recommendation: To Consent Calendar",11,0,0,0,11
1693945,1352621,2023-09-01,Assembly,"Do pass",16,0,0,0,16
1693945,1353685,2023-09-11,Assembly,"SB 296 Dodd Senate Third Reading By Connolly",79,0,0,1,80
1693945,1353902,2023-09-12,Senate,"Unfinished Business SB296 Dodd et al. Concurrence",39,0,0,1,40
1693946,1280686,2023-03-21,Senate,"Do pass, but first be re-referred to the Committee on [Appropriations]",6,1,0,0,7
1693946,1325007,2023-05-15,Senate,"Senate 3rd Reading SB297 Allen",30,8,0,2,40
1693946,1340998,2023-06-07,Assembly,"Do pass as amended and be re-referred to the Committee on [Appropriations]",6,2,0,0,8
1693946,1348414,2023-06-28,Assembly,"Do pass",10,4,0,2,16
1693946,1353629,2023-09-11,Assembly,"SB 297 Allen Senate Third Reading By Pellerin",62,18,0,0,80
1693946,1353875,2023-09-12,Senate,"Unfinished Business SB297 Allen et al. Concurrence",31,8,0,1,40
1693948,1281800,2023-03-22,Senate,"Do pass as amended, but first amend, and re-refer to the Committee on [Appropriations]",11,0,0,1,12
1693948,1296973,2023-04-10,Senate,"Placed on suspense file",7,0,0,0,7
1693948,1328711,2023-05-18,Senate,"Do pass",5,1,0,1,7
1693948,1332660,2023-05-24,Senate,"Senate 3rd Reading SB299 Eggman et al",36,1,0,3,40
1693948,1460615,2024-06-26,Assembly,"Do pass as amended and be re-referred to the Committee on [Transportation]",6,0,0,2,8
1693948,1462284,2024-07-01,Assembly,"Do pass and be re-referred to the Committee on [Appropriations]",10,4,0,1,15
1693948,1464525,2024-08-15,Assembly,"Do pass as amended",11,3,0,1,15
1693948,1466144,2024-08-29,Senate,"That the Assembly amendments be concurred in",5,1,0,1,7
1693948,1466432,2024-08-30,Senate,"Unfinished Business SB299 Lim√≥n et al. Concurrence",29,9,0,2,40
1693948,1466948,2024-08-28,Assembly,"SB 299 Lim√≥n Senate Third Reading By Holden",56,12,0,11,79
1693949,1311893,2023-04-26,Senate,"Do pass as amended, but first amend, and re-refer to the Committee on [Appropriations]",5,0,0,0,5
1693949,1325017,2023-05-15,Senate,"Placed on suspense file",7,0,0,0,7
1693950,1276635,2023-03-15,Senate,"Do pass as amended, but first amend, and re-refer to the Committee on [Transportation] with the recommendation: To Consent Calendar",7,0,0,0,7
1693950,1299445,2023-04-11,Senate,"Do pass, but first be re-referred to the Committee on [Appropriations] with the recommendation: To Consent Calendar",16,0,0,0,16
1693950,1308807,2023-04-24,Senate,"Placed on suspense file",7,0,0,0,7
1693950,1328392,2023-05-18,Senate,"Do pass as amended",7,0,0,0,7
1693950,1335566,2023-05-30,Senate,"Special Consent SB301 Portantino et al",40,0,0,0,40
1693950,1347479,2023-06-26,Assembly,"Do pass and be re-referred to the Committee on [Appropriations] with recommendation: To Consent Calendar",11,0,0,0,11
1693950,1352830,2023-09-01,Assembly,"Do pass as amended",11,0,0,5,16
1693950,1445188,2024-05-20,Assembly,"SB 301 Portantino Senate Third Reading By Wilson",70,0,0,10,80
1693950,1450939,2024-05-28,Senate,"Unfinished Business SB301 Portantino et al. Concurrence",36,0,0,4,40
1693951,1288155,2023-03-29,Senate,"Do pass as amended, but first amend, and re-refer to the Committee on [Judiciary]",12,0,0,0,12
1693951,1305353,2023-04-18,Senate,"Do pass, but first be re-referred to the Committee on [Appropriations] with the recommendation: To Consent Calendar",11,0,0,0,11
1693951,1315763,2023-05-01,Senate,"Placed on suspense file",6,0,0,1,7
1693951,1328143,2023-05-18,Senate,"Do pass",7,0,0,0,7
1693951,1332630,2023-05-24,Senate,"Senate 3rd Reading SB302 Stern et al",39,0,0,1,40
1693951,1345682,2023-06-20,Assembly,"Do pass and be re-referred to the Committee on [Appropriations]",14,0,0,1,15
1693951,1352557,2023-09-01,Assembly,"Do pass",16,0,0,0,16
1693951,1354802,2023-09-14,Senate,"Unfinished Business SB302 Stern et al. Concurrence",40,0,0,0,40
1693951,1354803,2023-09-14,Assembly,"SB 302 Stern Senate Third Reading By Waldron",80,0,0,0,80
1693952,1305491,2023-04-19,Senate,"Do pass, but first be re-referred to the Committee on [Judiciary] with the recommendation: To Consent Calendar",7,0,0,0,7
1693952,1311655,2023-04-25,Senate,"Do pass as amended, but first amend, and re-refer to the Committee on [Appropriations] with the recommendation: To Consent Calendar",11,0,0,0,11
1693952,1320375,2023-05-08,Senate,"Placed on suspense file",7,0,0,0,7
1693952,1328261,2023-05-18,Senate,"Do pass",7,0,0,0,7
1693952,1333572,2023-05-25,Senate,"Special Consent SB303 Allen",40,0,0,0,40
1693952,1347503,2023-06-26,Assembly,"Do pass as amended and be re-referred to the Committee on [Judiciary]",11,0,0,0,11
1693952,1350253,2023-07-11,Assembly,"Do pass as amended, and be re-referred to the Committee on [Appropriations] with recommendation: To Consent Calendar",11,0,0,0,11
1693952,1352586,2023-09-01,Assembly,"Do pass",16,0,0,0,16
1693952,1353663,2023-09-11,Assembly,"SB 303 Allen Senate Third Reading By Boerner",80,0,0,0,80
1693952,1353975,2023-09-12,Senate,"Unfinished Business SB303 Allen Concurrence",39,0,0,1,40
1693953,1299403,2023-04-11,Senate,"Do pass, but first be re-referred to the Committee on [Appropriations] with the recommendation: To Consent Calendar",16,0,0,0,16
1693953,1315734,2023-05-01,Senate,"Consent Calendar SB304 Laird",37,0,0,3,40
1693953,1340960,2023-06-07,Assembly,"Do pass as amended and be re-referred to the Committee on [Appropriations]",8,0,0,0,8
1693953,1346257,2023-06-21,Assembly,"Do pass. To Consent Calendar",13,0,0,3,16
1693953,1347837,2023-06-27,Assembly,"SB 304 Laird Consent Calendar Second Day Regular Session",78,0,0,2,80
1693953,1349775,2023-07-06,Senate,"Special Consent SB304 Laird",40,0,0,0,40
1693954,1304346,2023-04-18,Senate,"Do pass as amended, but first amend, and re-refer to the Committee on [Appropriations]",17,0,0,1,18
1693954,1324972,2023-05-15,Senate,"Senate 3rd Reading SB305 Stern et al",38,0,0,2,40
1693954,1344180,2023-06-14,Assembly,"Do pass and be re-referred to the Committee on [Appropriations] with recommendation: To Consent Calendar",13,0,0,2,15
1693955,1296897,2023-04-10,Senate,"Do pass as amended, but first amend, and re-refer to the Committee on [Rules]",14,0,0,4,18
1693955,1315140,2023-04-25,Senate,"Do pass as amended, but first amend, and re-refer to the Committee on [Appropriations]",10,0,0,1,11
1693955,1320558,2023-05-08,Senate,"Placed on suspense file",7,0,0,0,7
1693955,1328546,2023-05-18,Senate,"Do pass as amended",7,0,0,0,7
1693955,1335560,2023-05-30,Senate,"Special Consent SB306 Caballero",40,0,0,0,40
1693955,1350782,2023-07-10,Assembly,"Do pass and be re-referred to the Committee on [Appropriations] with recommendation: To Consent Calendar",11,0,0,0,11
1693955,1352888,2023-09-01,Assembly,"Do pass as amended",11,0,0,5,16
1693955,1353869,2023-09-12,Assembly,"SB 306 Caballero Senate Third Reading By Pellerin",77,0,0,3,80
1693955,1354301,2023-09-13,Senate,"Unfinished Business SB306 Caballero By Lim√≥n Concurrence",39,0,0,1,40
1693956,1288192,2023-03-29,Senate,"Do pass, but first be re-referred to the Committee on [Human Services]",7,0,0,0,7
1693956,1310257,2023-04-24,Senate,"Do pass, but first be re-referred to the Committee on [Appropriations]",5,0,0,0,5
1693956,1320431,2023-05-08,Senate,"Placed on suspense file",7,0,0,0,7
1693956,1328787,2023-05-18,Senate,"Do pass",6,1,0,0,7
1693956,1330087,2023-05-22,Senate,"Senate 3rd Reading SB307 Ashby et al",39,1,0,0,40
1693957,1305455,2023-04-19,Senate,"Do pass, but first be re-referred to the Committee on [Appropriations]",5,2,0,0,7
1693957,1315650,2023-05-01,Senate,"Placed on suspense file",6,0,0,1,7
1693957,1328280,2023-05-18,Senate,"Do pass as amended",5,2,0,0,7
1693957,1333644,2023-05-25,Senate,"Senate 3rd Reading SB308 Becker",24,9,0,7,40
1693957,1462057,2024-07-01,Assembly,"Do pass as amended and be re-referred to the Committee on [Appropriations]",9,2,0,1,12
1697012,1275586,2023-03-14,Assembly,"Do pass and be re-referred to the Committee on [Appropriations] with recommendation: To Consent Calendar",8,0,0,0,8
1697013,1298210,2023-04-11,Assembly,"Do pass and be re-referred to the Committee on [Appropriations] with recommendation: To Consent Calendar",15,0,0,0,15
1697013,1328528,2023-05-18,Assembly,"Do pass",15,0,0,1,16
1697013,1337925,2023-05-31,Assembly,"AB 424 Bryan Assembly Third Reading",80,0,0,0,80
1697013,1348831,2023-06-28,Senate,"Do pass, but first be re-referred to the Committee on [Appropriations]",12,0,0,0,12
1697013,1349940,2023-07-10,Senate,"Placed on suspense file",6,0,0,1,7
1697013,1352682,2023-09-01,Senate,"Do pass",7,0,0,0,7
1697013,1353879,2023-09-12,Senate,"Assembly 3rd Reading AB424 Bryan et al. By Eggman",38,0,0,2,40
1697013,1354194,2023-09-13,Assembly,"AB 424 Bryan Concurrence in Senate Amendments",80,0,0,0,80
1697014,1288141,2023-03-28,Assembly,"Do pass as amended and be re-referred to the Committee on [Appropriations]",14,0,0,1,15
1697014,1328764,2023-05-18,Assembly,"Do pass",15,0,0,1,16
1697014,1338136,2023-05-31,Assembly,"AB 425 Alvarez Assembly Third Reading",80,0,0,0,80
1697014,1348827,2023-06-28,Senate,"Do pass, but first be re-referred to the Committee on [Appropriations] with the recommendation: To Consent Calendar",11,0,0,1,12
1697014,1349942,2023-07-10,Senate,"Placed on suspense file",6,0,0,1,7
1697014,1352528,2023-09-01,Senate,"Do pass as amended",7,0,0,0,7
1697014,1354359,2023-09-13,Senate,"Special Consent AB425 Alvarez et al. By Lim√≥n",39,0,0,1,40
1697014,1354579,2023-09-14,Assembly,"AB 425 Alvarez Concurrence in Senate Amendments",79,0,0,1,80
1697015,1288254,2023-03-29,Assembly,"Do pass and be re-referred to the Committee on [Appropriations] with recommendation: To Consent Calendar",8,0,0,0,8
1697015,1327996,2023-05-18,Assembly,"Do pass as amended",11,0,0,5,16
1697015,1333635,2023-05-25,Assembly,"AB 426 Jackson Assembly Third Reading",77,0,0,3,80
1697015,1349630,2023-07-03,Senate,"Do pass, but first be re-referred to the Committee on [Judiciary]",4,1,0,0,5
1697015,1350501,2023-07-11,Senate,"Do pass as amended, but first amend, and re-refer to the Committee on [Appropriations]",6,3,0,2,11
1697015,1351345,2023-08-14,Senate,"Placed on suspense file",7,0,0,0,7
1697015,1352772,2023-09-01,Senate,"Do pass as amended",5,2,0,0,7
1697015,1353850,2023-09-12,Assembly,"AB 426 Jackson Concurrence in Senate Amendments",77,1,0,2,80
1697015,1354682,2023-09-11,Senate,"Assembly 3rd Reading AB426 Jackson By Menjivar",30,7,0,3,40
1697016,1280683,2023-03-20,Assembly,"Do pass and be re-referred to the Committee on [Appropriations] with recommendation: To Consent Calendar",15,0,0,0,15
1697016,1318072,2023-05-03,Assembly,"Do pass. To Consent Calendar",16,0,0,0,16
1697016,1323874,2023-05-11,Assembly,"AB 427 Alvarez Consent Calendar Second Day Regular Session",66,0,0,14,80
1697016,1348389,2023-06-27,Senate,"Do pass and be ordered to the Consent Calendar",16,0,0,0,16
1697016,1349801,2023-07-06,Senate,"Consent Calendar AB427 Alvarez Urgency Clause",40,0,0,0,40
1697016,1352210,2023-08-24,Assembly,"AB 427 Alvarez Concurrence - Urgency Added",76,0,0,4,80
1697017,1304327,2023-04-18,Assembly,"Do pass as amended, and be re-referred to the Committee on [Appropriations] with recommendation: To Consent Calendar",8,0,0,0,8
1697019,1299413,2023-04-12,Assembly,"Do pass and be re-referred to the Committee on [Revenue and Taxation]",7,1,0,0,8
1697019,1310232,2023-04-24,Assembly,"Do pass and be re-referred to the Committee on [Appropriations]",11,0,0,0,11
1697019,1328693,2023-05-18,Assembly,"Do pass as amended",11,0,0,5,16
1697019,1333558,2023-05-25,Assembly,"AB 430 Bennett Assembly Third Reading",76,0,0,4,80
1697019,1346195,2023-06-20,Senate,"Do pass, but first be re-referred to the Committee on [Governance and Finance] with the recommendation: To Consent Calendar",11,0,0,0,11
1697019,1349766,2023-07-05,Senate,"Do pass as amended, but first amend, and re-refer to the Committee on [Appropriations] with the recommendation: To Consent Calendar",8,0,0,0,8
1697019,1351786,2023-08-21,Senate,"Placed on suspense file",7,0,0,0,7
1697021,1298262,2023-04-11,Assembly,"Do pass and be re-referred to the Committee on [Appropriations]",8,2,0,1,11
1697021,1328683,2023-05-18,Assembly,"Do pass",11,3,0,2,16
1697021,1338180,2023-05-31,Assembly,"AB 432 Mike Fong Assembly Third Reading",63,15,0,2,80
1697023,1288264,2023-03-29,Assembly,"Do pass and be re-referred to the Committee on [Local Government]",6,0,0,2,8
1697023,1307860,2023-04-19,Assembly,"Do pass and be re-referred to the Committee on [Appropriations]",6,0,0,1,7
1697023,1328118,2023-05-18,Assembly,"Do pass",11,1,0,4,16
1697023,1338163,2023-05-31,Assembly,"AB 434 Grayson Assembly Third Reading",61,1,0,18,80
1697023,1350301,2023-07-10,Senate,"Do pass as amended, but first amend, and re-refer to the Committee on [Appropriations]",9,2,0,0,11
1697023,1351475,2023-08-14,Senate,"Placed on suspense file",7,0,0,0,7
1697023,1352760,2023-09-01,Senate,"Do pass",5,2,0,0,7
1697023,1353981,2023-09-12,Senate,"Assembly 3rd Reading AB434 Grayson By Skinner",31,7,0,2,40
1697023,1354332,2023-09-13,Assembly,"AB 434 Grayson Concurrence in Senate Amendments",61,11,0,8,80
1697024,1286880,2023-03-28,Assembly,"Do pass as amended and be re-referred to the Committee on [Appropriations]",8,0,0,0,8
1697025,1275550,2023-03-13,Assembly,"Do pass and be re-referred to the Committee on [Local Government]",14,0,0,1,15
1697025,1281862,2023-03-22,Assembly,"Do pass and be re-referred to the Committee on [Appropriations]",8,0,0,0,8
1697025,1305374,2023-04-19,Assembly,"Do pass. To Consent Calendar",14,0,0,2,16
1697025,1313521,2023-04-27,Assembly,"AB 436 Alvarez Consent Calendar Second Day Regular Session",79,0,0,1,80
1697025,1343753,2023-06-13,Senate,"Do pass, but first be re-referred to the Committee on [Governance and Finance]",13,1,0,2,16
1697025,1350640,2023-07-12,Senate,"Do pass, but first be re-referred to the Committee on [Appropriations]",5,2,0,1,8
1697025,1354716,2023-09-14,Senate,"Assembly 3rd Reading AB436 Alvarez et al. By Durazo",30,3,0,7,40
1697025,1354717,2023-09-14,Assembly,"AB 436 Alvarez Concurrence in Senate Amendments",77,0,0,3,80
1697026,1305516,2023-04-19,Assembly,"Do pass and be re-referred to the Committee on [Appropriations]",4,0,0,3,7
1697026,1328248,2023-05-18,Assembly,"Do pass as amended",11,1,0,4,16
1697026,1333571,2023-05-25,Assembly,"AB 437 Jackson Assembly Third Reading",61,8,0,11,80
1697026,1350135,2023-07-11,Senate,"Do pass, but first be re-referred to the Committee on [Appropriations]",10,3,0,2,15
1697026,1351520,2023-08-14,Senate,"Placed on suspense file",7,0,0,0,7
1697026,1352813,2023-09-01,Senate,"Do pass as amended",5,2,0,0,7
1697027,1283129,2023-03-22,Assembly,"Do pass and be re-referred to the Committee on [Appropriations]",7,0,0,0,7
1697027,1328009,2023-05-18,Assembly,"Do pass",15,0,0,1,16
1697027,1337944,2023-05-31,Assembly,"AB 438 Blanca Rubio Assembly Third Reading",80,0,0,0,80
1697027,1349658,2023-07-05,Senate,"Do pass, but first be re-referred to the Committee on [Appropriations] with the recommendation: To Consent Calendar",7,0,0,0,7
1697027,1351501,2023-08-14,Senate,"Placed on suspense file",7,0,0,0,7
1697027,1352883,2023-09-01,Senate,"Do pass",7,0,0,0,7
1697027,1353953,2023-09-12,Senate,"Assembly 3rd Reading AB438 Blanca Rubio et al. By Portantino",30,0,0,10,40
1697027,1353954,2023-09-12,Senate,"Assembly 3rd Reading AB438 Blanca Rubio et al. By Portantino Motion To Reconsider",37,0,0,3,40
1697027,1465307,2024-08-19,Senate,"Assembly 3rd Reading AB438 Blanca Rubio et al. By Portantino",40,0,0,0,40
1697027,1465574,2024-08-26,Assembly,"AB 438 Blanca Rubio Concurrence in Senate Amendments",77,0,0,2,79
1697028,1283142,2023-03-22,Assembly,"Do pass as amended",6,0,0,1,7
1697028,1328601,2023-05-18,Assembly,"Do pass",15,0,0,1,16
1697028,1337945,2023-05-31,Assembly,"AB 439 Wendy Carrillo Assembly Third Reading",80,0,0,0,80
1697028,1350516,2023-07-12,Senate,"Do pass, but first be re-referred to the Committee on [Appropriations]",7,0,0,0,7
1697028,1351391,2023-08-14,Senate,"Placed on suspense file",7,0,0,0,7
1697028,1352732,2023-09-01,Senate,"Do pass",7,0,0,0,7
1697028,1353882,2023-09-12,Senate,"Special Consent AB439 Wendy Carrillo By Cortese",39,0,0,1,40
1697028,1354104,2023-09-13,Assembly,"AB 439 Wendy Carrillo Concurrence in Senate Amendments",80,0,0,0,80
1697029,1299348,2023-04-12,Assembly,"Do pass and be re-referred to the Committee on [Local Government]",7,0,0,1,8
1697029,1318027,2023-05-03,Assembly,"Do pass",6,2,0,0,8
1697029,1333790,2023-05-25,Assembly,"AB 440 Wicks Assembly Third Reading",62,13,0,5,80
1697029,1346288,2023-06-20,Senate,"Do pass",10,1,0,0,11
1697029,1462100,2024-07-01,Senate,"Do pass",6,1,0,0,7
1697029,1462592,2024-07-03,Senate,"Assembly 3rd Reading AB440 Pellerin et al. By Blakespear",31,8,0,1,40
1697029,1462593,2024-07-03,Assembly,"AB 440 PELLERIN Concurrence in Senate Amendments",59,6,0,14,79
1697031,1275610,2023-03-14,Assembly,"Do pass as amended, and be re-referred to the Committee on [Appropriations] with recommendation: To Consent Calendar",8,0,0,0,8
1697031,1328427,2023-05-18,Assembly,"Do pass",15,0,0,1,16
1697031,1338084,2023-05-31,Assembly,"AB 442 Villapudua Assembly Third Reading",79,0,0,1,80
1697031,1347824,2023-06-27,Senate,"Do pass, but first be re-referred to the Committee on [Appropriations] with the recommendation: To Consent Calendar",5,0,0,0,5
1697031,1351815,2023-08-21,Senate,"Placed on suspense file",7,0,0,0,7
1697032,1275578,2023-03-14,Assembly,"Do pass and be re-referred to the Committee on [Appropriations]",8,0,0,0,8
1697032,1328057,2023-05-18,Assembly,"Do pass",11,1,0,4,16
1697032,1338159,2023-05-31,Assembly,"AB 443 Jackson Assembly Third Reading",60,0,0,20,80
1697032,1350154,2023-07-11,Senate,"Do pass as amended, but first amend, and re-refer to the Committee on [Appropriations]",3,0,0,2,5
1697032,1351457,2023-08-14,Senate,"Placed on suspense file",7,0,0,0,7
1697032,1352766,2023-09-01,Senate,"Do pass as amended",5,2,0,0,7
1697032,1354074,2023-09-13,Senate,"Assembly 3rd Reading AB443 Jackson By Bradford",28,9,0,3,40
1697032,1354075,2023-09-13,Assembly,"AB 443 Jackson Concurrence in Senate Amendments",63,1,0,16,80
1697033,1305531,2023-04-18,Assembly,"Do pass and be re-referred to the Committee on [Appropriations] with recommendation: To Consent Calendar",11,0,0,0,11
1697033,1328173,2023-05-18,Assembly,"Do pass as amended",11,0,0,5,16
1697033,1333654,2023-05-25,Assembly,"AB 444 Addis Assembly Third Reading",74,0,0,6,80
1697033,1346305,2023-06-21,Senate,"Do pass as amended, but first amend, and re-refer to the Committee on [Appropriations] with the recommendation: To Consent Calendar",8,0,0,0,8
1697033,1349508,2023-07-03,Senate,"Placed on suspense file",7,0,0,0,7
1697035,1283262,2023-03-22,Assembly,"Do pass and be re-referred to the Committee on [Appropriations]",6,1,0,0,7
1697035,1305456,2023-04-19,Assembly,"Do pass",15,0,0,1,16
1697035,1313337,2023-04-27,Assembly,"AB 446 Quirk-Silva Assembly Third Reading",79,1,0,0,80
1697035,1340959,2023-06-07,Senate,"Do pass, but first be re-referred to the Committee on [Appropriations] with the recommendation: To Consent Calendar",7,0,0,0,7
1697035,1348823,2023-06-29,Senate,"Consent Calendar AB446 Quirk-Silva",39,0,0,1,40
1697035,1353945,2023-09-12,Senate,"Assembly 3rd Reading AB446 Quirk-Silva By Newman",38,0,0,2,40
1697035,1354197,2023-09-13,Assembly,"AB 446 Quirk-Silva Concurrence in Senate Amendments",79,0,0,1,80
1697036,1281852,2023-03-21,Assembly,"Do pass and be re-referred to the Committee on [Appropriations]",12,0,0,0,12
1697036,1328182,2023-05-18,Assembly,"Do pass as amended",11,0,0,5,16
1697036,1333801,2023-05-25,Assembly,"AB 447 Arambula Assembly Third Reading",76,0,0,4,80
1697036,1346181,2023-06-21,Senate,"Do pass, but first be re-referred to the Committee on [Appropriations]",7,0,0,0,7
1697036,1349510,2023-07-03,Senate,"Placed on suspense file",7,0,0,0,7
1697036,1352836,2023-09-01,Senate,"Do pass",7,0,0,0,7
1697036,1353766,2023-09-12,Senate,"Special Consent AB447 Arambula et al. By Lim√≥n",39,0,0,1,40
1697036,1354438,2023-09-13,Assembly,"AB 447 Arambula Concurrence in Senate Amendments",79,0,0,1,80
1697037,1275566,2023-03-14,Assembly,"Do pass and be re-referred to the Committee on [Judiciary]",8,0,0,0,8
1697037,1286907,2023-03-28,Assembly,"Do pass and be re-referred to the Committee on [Appropriations] with recommendation: To Consent Calendar",9,0,0,2,11
1697037,1328093,2023-05-18,Assembly,"Do pass",15,0,0,1,16
1697037,1337985,2023-05-31,Assembly,"AB 448 Juan Carrillo Assembly Third Reading",79,0,0,1,80
1697037,1349633,2023-07-03,Senate,"Do pass, but first be re-referred to the Committee on [Judiciary] with the recommendation: To Consent Calendar",5,0,0,0,5
1697037,1350425,2023-07-11,Senate,"Do pass as amended, but first amend, and re-refer to the Committee on [Appropriations] with the recommendation: To Consent Calendar",11,0,0,0,11
1697037,1351272,2023-08-14,Senate,"Placed on suspense file",7,0,0,0,7
1697037,1353048,2023-09-01,Senate,"Do pass",7,0,0,0,7
1697037,1353760,2023-09-12,Senate,"Assembly 3rd Reading AB448 Juan Carrillo et al. By Ashby",38,0,0,2,40
1697037,1354445,2023-09-13,Assembly,"AB 448 Juan Carrillo Concurrence in Senate Amendments",80,0,0,0,80
1697038,1275582,2023-03-14,Assembly,"Do pass and be re-referred to the Committee on [Appropriations]",8,0,0,0,8
1697038,1328704,2023-05-18,Assembly,"Do pass as amended",11,0,0,5,16
1697038,1333739,2023-05-25,Assembly,"AB 449 Ting Assembly Third Reading",75,0,0,5,80
1697038,1347935,2023-06-27,Senate,"Do pass, but first be re-referred to the Committee on [Appropriations]",5,0,0,0,5
1697038,1351468,2023-08-14,Senate,"Placed on suspense file",7,0,0,0,7
1697038,1353074,2023-09-01,Senate,"Do pass",7,0,0,0,7
1697038,1354744,2023-09-11,Senate,"Assembly 3rd Reading AB449 Ting et al. By Min",39,0,0,1,40
1697040,1281900,2023-03-22,Assembly,"Do pass and be re-referred to the Committee on [Appropriations] with recommendation: To Consent Calendar",12,0,0,2,14
1697040,1305507,2023-04-19,Assembly,"Do pass as amended. To Consent Calendar",14,0,0,2,16
1697040,1313493,2023-04-27,Assembly,"AB 451 Calderon Consent Calendar Second Day Regular Session",79,0,0,1,80
1697040,1348339,2023-06-28,Senate,"Do pass, but first be re-referred to the Committee on [Appropriations] with the recommendation: To Consent Calendar",7,0,0,0,7
1697040,1351673,2023-08-17,Senate,"Consent Calendar 2nd AB451 Calderon",38,0,0,2,40
1697041,1280621,2023-03-21,Assembly,"Do pass as amended and be re-referred to the Committee on [Appropriations]",11,0,0,0,11
1697041,1328240,2023-05-18,Assembly,"Do pass",15,0,0,1,16
1697041,1333740,2023-05-25,Assembly,"AB 452 Addis Assembly Third Reading",75,0,0,5,80
1697041,1348492,2023-06-27,Senate,"Do pass, but first be re-referred to the Committee on [Appropriations]",9,0,0,2,11
1697041,1351489,2023-08-14,Senate,"Placed on suspense file",7,0,0,0,7
1697041,1352683,2023-09-01,Senate,"Do pass",6,0,0,1,7
1697041,1353927,2023-09-12,Assembly,"AB 452 Addis Concurrence in Senate Amendments",79,1,0,0,80
1697041,1354796,2023-09-11,Senate,"Assembly 3rd Reading AB452 Addis et al. By Skinner",36,0,0,4,40
1697042,1276621,2023-03-15,Assembly,"Do pass and be re-referred to the Committee on [Local Government] with recommendation: To Consent Calendar",8,0,0,0,8
1697042,1288210,2023-03-29,Assembly,"Do pass and be re-referred to the Committee on [Appropriations] with recommendation: To Consent Calendar",8,0,0,0,8
1697042,1305258,2023-04-19,Assembly,"Do pass. To Consent Calendar",14,0,0,2,16
1697042,1313447,2023-04-27,Assembly,"AB 453 Cervantes Consent Calendar Second Day Regular Session",79,0,0,1,80
1697042,1458302,2024-06-18,Senate,"Do pass, but first be re-referred to the Committee on [Local Government] with the recommendation: To Consent Calendar",7,0,0,0,7
1697042,1460730,2024-06-26,Senate,"Do pass, but first be re-referred to the Committee on [Appropriations] with the recommendation: To Consent Calendar",7,0,0,0,7
1697042,1463888,2024-08-12,Senate,"Consent Calendar 2nd AB453 Cervantes",38,0,0,2,40
1697043,1276593,2023-03-15,Assembly,"Do pass as amended and be re-referred to the Committee on [Appropriations]",8,0,0,3,11
1697043,1288278,2023-03-29,Assembly,"Do pass. To Consent Calendar",14,0,0,2,16
1697043,1302662,2023-04-17,Assembly,"AB 454 Aguiar-Curry Consent Calendar Second Day Regular Session",79,0,0,1,80
1697043,1345587,2023-06-19,Senate,"Do pass, but first be re-referred to the Committee on [Appropriations]",3,0,0,1,4
1697043,1349768,2023-07-06,Senate,"Assembly 3rd Reading AB454 Aguiar-Curry By Dahle Urgency Clause",40,0,0,0,40
1697044,1286966,2023-03-28,Assembly,"Do pass as amended and be re-referred to the Committee on [Appropriations]",8,0,0,0,8
1697044,1328618,2023-05-18,Assembly,"Do pass",15,0,0,1,16
1697044,1338042,2023-05-31,Assembly,"AB 455 Quirk-Silva Assembly Third Reading",79,0,0,1,80
1697044,1347876,2023-06-27,Senate,"Do pass, but first be re-referred to the Committee on [Appropriations]",5,0,0,0,5
1697044,1351388,2023-08-14,Senate,"Placed on suspense file",7,0,0,0,7
1697044,1352496,2023-09-01,Senate,"Do pass as amended",7,0,0,0,7
1697044,1353838,2023-09-12,Senate,"Assembly 3rd Reading AB455 Quirk-Silva et al. By Archuleta",38,0,0,2,40
1697044,1354183,2023-09-13,Assembly,"AB 455 Quirk-Silva Concurrence in Senate Amendments",80,0,0,0,80
1697045,1281935,2023-03-21,Assembly,"Do pass and be re-referred to the Committee on [Appropriations]",9,0,0,3,12
1697045,1366785,2024-01-18,Assembly,"Do pass as amended",13,0,0,3,16
1697045,1371086,2024-01-29,Assembly,"AB 456 Maienschein Assembly Third Reading",75,0,0,5,80
1697045,1451606,2024-05-29,Senate,"Do pass as amended, but first amend, and re-refer to the Committee on [Appropriations] with the recommendation: To Consent Calendar",7,0,0,0,7
1697045,1455811,2024-06-10,Senate,"Placed on suspense file",7,0,0,0,7
1697046,1288205,2023-03-29,Assembly,"Do pass and be re-referred to the Committee on [Housing and Community Development]",8,0,0,0,8
1697046,1299368,2023-04-12,Assembly,"Do pass and be re-referred to the Committee on [Appropriations]",8,0,0,0,8
1697046,1306758,2023-04-20,Assembly,"AB 457 Joe Patterson Assembly Third Reading",77,0,0,3,80
1697046,1348348,2023-06-28,Senate,"Do pass as amended",8,0,0,0,8
1697046,1353769,2023-09-12,Senate,"Assembly 3rd Reading AB457 Joe Patterson By Blakespear",38,0,0,2,40
1697046,1454219,2024-06-05,Senate,"Do pass as amended, but first amend, and re-refer to the Committee on [Appropriations]",7,0,0,0,7
1697046,1462018,2024-07-01,Senate,"Placed on suspense file",7,0,0,0,7
1697046,1464118,2024-08-15,Senate,"Do pass",7,0,0,0,7
1697046,1466110,2024-08-29,Assembly,"With recommendation: That Senate amendments be concurred in",12,0,0,0,12
1697046,1466413,2024-08-30,Assembly,"AB 457 Aguiar-Curry Concurrence - Urgency Added",77,0,0,2,79
1697046,1466914,2024-08-28,Senate,"Assembly 3rd Reading AB457 Aguiar-Curry By Dodd Urgency Clause",39,0,0,1,40
1697047,1286965,2023-03-28,Assembly,"Do pass and be re-referred to the Committee on [Higher Education] with recommendation: To Consent Calendar",8,0,0,0,8
1697047,1311820,2023-04-25,Assembly,"Do pass",12,0,0,0,12
1697047,1320481,2023-05-08,Assembly,"AB 458 Jones-Sawyer Assembly Third Reading",70,0,0,10,80
1697047,1339978,2023-06-06,Senate,"Do pass and be ordered to the Consent Calendar",5,0,0,0,5
1697047,1348326,2023-06-28,Senate,"Do pass as amended, but first amend, and re-refer to the Committee on [Judiciary]",7,0,0,0,7
1697047,1350400,2023-07-11,Senate,"Do pass and be ordered to the Consent Calendar",11,0,0,0,11
1697047,1351648,2023-08-17,Senate,"Consent Calendar 2nd AB458 Jones-Sawyer",38,0,0,2,40
1697047,1352459,2023-08-31,Assembly,"With recommendation: That Senate amendments be concurred in",13,0,0,1,14
1697047,1353237,2023-09-06,Assembly,"AB 458 Jones-Sawyer Concurrence in Senate Amendments",79,0,0,1,80
1697048,1298310,2023-04-11,Assembly,"Do pass as amended and be re-referred to the Committee on [Appropriations]",15,0,0,0,15
1697048,1328394,2023-05-18,Assembly,"Do pass",15,0,0,1,16
1697048,1337946,2023-05-31,Assembly,"AB 459 Haney Assembly Third Reading",79,0,0,1,80
1697048,1459981,2024-06-25,Senate,"Do pass, but first be re-referred to the Committee on [Judiciary]",4,1,0,0,5
1697048,1462659,2024-07-02,Senate,"Do pass as amended, but first amend, and re-refer to the Committee on [Appropriations]",8,2,0,1,11
1697048,1463524,2024-08-05,Senate,"Placed on suspense file",7,0,0,0,7
1697049,1305463,2023-04-18,Assembly,"Do pass and be re-referred to the Committee on [Judiciary]",9,4,0,2,15
1697049,1310292,2023-04-25,Assembly,"Do pass as amended and be re-referred to the Committee on [Appropriations]",7,2,0,2,11
1697049,1327943,2023-05-18,Assembly,"Do pass as amended",11,4,0,1,16
1697049,1335437,2023-05-30,Assembly,"AB 460 Bauer-Kahan Assembly Third Reading",43,20,0,17,80
1697049,1456361,2024-06-11,Senate,"Do pass as amended, but first amend, and re-refer to the Committee on [Judiciary]",10,0,0,1,11
1697049,1460530,2024-06-25,Senate,"Do pass, but first be re-referred to the Committee on [Appropriations]",11,0,0,0,11
1697049,1463446,2024-08-05,Senate,"Placed on suspense file",7,0,0,0,7
1697049,1464134,2024-08-15,Senate,"Do pass as amended",6,1,0,0,7
1697049,1466361,2024-08-29,Senate,"Assembly 3rd Reading AB460 Bauer-Kahan et al. By Laird",38,2,0,0,40
1697049,1466595,2024-08-30,Assembly,"AB 460 Bauer-Kahan Concurrence in Senate Amendments",65,5,0,9,79
1697050,1281894,2023-03-21,Assembly,"Do pass and be re-referred to the Committee on [Appropriations]",12,0,0,0,12
1697050,1328247,2023-05-18,Assembly,"Do pass",15,0,0,1,16
1697050,1333765,2023-05-25,Assembly,"AB 461 Ramos Assembly Third Reading",78,0,0,2,80
1697050,1348336,2023-06-28,Senate,"Do pass, but first be re-referred to the Committee on [Health] with the recommendation: To Consent Calendar",7,0,0,0,7
1697050,1349824,2023-07-05,Senate,"Do pass, but first be re-referred to the Committee on [Appropriations] with the recommendation: To Consent Calendar",12,0,0,0,12
1697050,1351364,2023-08-14,Senate,"Placed on suspense file",7,0,0,0,7
1697050,1352530,2023-09-01,Senate,"Do pass as amended",7,0,0,0,7
1697050,1354289,2023-09-13,Senate,"Special Consent AB461 Ramos et al",39,0,0,1,40
1697050,1354756,2023-09-14,Assembly,"AB 461 Ramos Concurrence in Senate Amendments",80,0,0,0,80
1697051,1275594,2023-03-14,Assembly,"Do pass and be re-referred to the Committee on [Appropriations]",7,0,0,1,8
1697052,1281919,2023-03-22,Assembly,"Do pass and be re-referred to the Committee on [Appropriations]",14,0,0,1,15
1697053,1288282,2023-03-28,Assembly,"Do pass and be re-referred to the Committee on [Transportation]",10,0,0,5,15
1697053,1304344,2023-04-17,Assembly,"Do pass and be re-referred to the Committee on [Appropriations]",12,1,0,2,15
1697053,1328481,2023-05-18,Assembly,"Do pass as amended",12,3,0,1,16
1697053,1338176,2023-05-31,Assembly,"AB 464 Schiavo Assembly Third Reading",66,6,0,8,80
1697053,1348847,2023-06-28,Senate,"Do pass, but first be re-referred to the Committee on [Transportation]",10,0,0,2,12
1697053,1350541,2023-07-11,Senate,"Do pass as amended, but first amend, and re-refer to the Committee on [Appropriations]",12,0,0,4,16
1697053,1351374,2023-08-14,Senate,"Placed on suspense file",7,0,0,0,7
1697053,1352661,2023-09-01,Senate,"Do pass",5,2,0,0,7
1697053,1353325,2023-09-06,Senate,"Assembly 3rd Reading AB464 Schiavo et al",34,3,0,3,40
1697053,1353470,2023-09-07,Assembly,"AB 464 Schiavo Concurrence in Senate Amendments",66,5,0,9,80
1697055,1275524,2023-03-13,Assembly,"Do pass and be re-referred to the Committee on [Appropriations] with recommendation: To Consent Calendar",14,0,0,1,15
1697055,1305304,2023-04-19,Assembly,"Do pass. To Consent Calendar",14,0,0,2,16
1697055,1313422,2023-04-27,Assembly,"AB 466 Gipson Consent Calendar Second Day Regular Session",79,0,0,1,80
1697055,1343706,2023-06-13,Senate,"Do pass, but first be re-referred to the Committee on [Appropriations] with the recommendation: To Consent Calendar",16,0,0,0,16
1697055,1348892,2023-06-29,Senate,"Consent Calendar AB466 Gipson",39,0,0,1,40
1697056,1275573,2023-03-14,Assembly,"Do pass as amended",8,0,0,0,8
1697056,1313529,2023-04-27,Assembly,"AB 467 Gabriel Assembly Third Reading",80,0,0,0,80
1697056,1340040,2023-06-06,Senate,"Do pass as amended, and be ordered to the Consent Calendar",5,0,0,0,5
1697056,1343121,2023-06-12,Senate,"Consent Calendar AB467 Gabriel et al",35,0,0,5,40
1697056,1345188,2023-06-19,Assembly,"AB 467 Gabriel Concurrence in Senate Amendments",67,0,0,13,80
1697057,1305271,2023-04-19,Assembly,"Do pass and be re-referred to the Committee on [Appropriations]",8,0,0,0,8
1697057,1328197,2023-05-18,Assembly,"Do pass",15,0,0,1,16
1697057,1338044,2023-05-31,Assembly,"AB 468 Quirk-Silva Assembly Third Reading",78,0,0,2,80
1697057,1346225,2023-06-20,Senate,"Do pass, but first be re-referred to the Committee on [Judiciary]",11,0,0,0,11
1697057,1350429,2023-07-11,Senate,"Do pass, but first be re-referred to the Committee on [Appropriations]",11,0,0,0,11
1697057,1351328,2023-08-14,Senate,"Placed on suspense file",7,0,0,0,7
1697058,1288170,2023-03-29,Assembly,"Do pass and be re-referred to the Committee on [Judiciary]",7,0,0,0,7
1697058,1298183,2023-04-11,Assembly,"Do pass and be re-referred to the Committee on [Appropriations] with recommendation: To Consent Calendar",11,0,0,0,11
1697058,1328166,2023-05-18,Assembly,"Do pass",15,0,0,1,16
1697058,1333574,2023-05-25,Assembly,"AB 469 Vince Fong Assembly Third Reading",77,0,0,3,80
1697058,1345570,2023-06-20,Senate,"Do pass, but first be re-referred to the Committee on [Governmental Organization] with the recommendation: To Consent Calendar",11,0,0,0,11
1697058,1350119,2023-07-11,Senate,"Do pass, but first be re-referred to the Committee on [Appropriations]",14,0,0,1,15
1697058,1351387,2023-08-14,Senate,"Placed on suspense file",7,0,0,0,7
1697058,1352866,2023-09-01,Senate,"Do pass as amended",7,0,0,0,7
1697058,1354410,2023-09-13,Senate,"Assembly 3rd Reading AB469 Vince Fong et al. By Umberg",39,0,0,1,40
1697058,1354411,2023-09-13,Assembly,"AB 469 Vince Fong Concurrence in Senate Amendments",78,0,0,2,80
1697059,1286928,2023-03-28,Assembly,"Do pass and be re-referred to the Committee on [Appropriations] with recommendation: To Consent Calendar",18,0,0,1,19
1697059,1305232,2023-04-19,Assembly,"Do pass. To Consent Calendar",14,0,0,2,16
1697059,1313334,2023-04-27,Assembly,"AB 470 Valencia Consent Calendar Second Day Regular Session",79,0,0,1,80
1697059,1338787,2023-06-05,Senate,"Do pass, but first be re-referred to the Committee on [Appropriations]",13,0,0,0,13
1697059,1353180,2023-09-05,Senate,"Assembly 3rd Reading AB470 Valencia et al. By Gonzalez",39,0,0,1,40
1697060,1286943,2023-03-28,Assembly,"Do pass and be re-referred to the Committee on [Governmental Organization]",14,3,0,2,19
1697060,1311645,2023-04-26,Assembly,"Do pass as amended and be re-referred to the Committee on [Appropriations]",17,4,0,1,22
1697061,1281871,2023-03-22,Assembly,"Do pass and be re-referred to the Committee on [Higher Education]",6,0,0,1,7
1697061,1298294,2023-04-11,Assembly,"Do pass and be re-referred to the Committee on [Appropriations]",10,1,0,1,12
1697061,1328426,2023-05-18,Assembly,"Do pass as amended",11,3,0,2,16
1697061,1338100,2023-05-31,Assembly,"AB 472 Wicks Assembly Third Reading",66,8,0,6,80
1697061,1350392,2023-07-12,Senate,"Do pass",4,0,0,1,5
1697061,1351301,2023-08-14,Senate,"Placed on suspense file",7,0,0,0,7
1697061,1352588,2023-09-01,Senate,"Do pass",5,2,0,0,7
1697061,1353240,2023-09-06,Senate,"Assembly 3rd Reading AB472 Wicks et al. By Portantino",31,8,0,1,40
1697062,1275580,2023-03-14,Assembly,"Do pass as amended and be re-referred to the Committee on [Transportation]",10,0,0,1,11
1697062,1310215,2023-04-24,Assembly,"Do pass and be re-referred to the Committee on [Appropriations]",14,0,0,1,15
1697062,1328902,2023-05-18,Assembly,"Do pass",15,0,0,1,16
1697062,1330138,2023-05-22,Assembly,"AB 473 Aguiar-Curry Assembly Third Reading",74,0,0,6,80
1697062,1348429,2023-06-27,Senate,"Do pass as amended, but first amend, and re-refer to the Committee on [Judiciary]",13,1,0,2,16
1697062,1350464,2023-07-11,Senate,"Do pass as amended, but first amend, and re-refer to the Committee on [Appropriations]",10,0,0,1,11
1697062,1352959,2023-09-01,Senate,"Assembly 3rd Reading AB473 Aguiar-Curry et al. By Umberg",36,0,0,4,40
1697062,1353467,2023-09-07,Assembly,"AB 473 Aguiar-Curry Concurrence in Senate Amendments",76,0,0,4,80
1697063,1305423,2023-04-19,Assembly,"Be adopted and re-referred to the Committee on [Appropriations]",6,2,0,0,8
1697063,1328846,2023-05-18,Assembly,"Be adopted",11,4,0,1,16
1697064,1247345,2023-02-09,Assembly,"Be adopted. To Consent Calendar",11,0,0,2,13
1697064,1255133,2023-02-17,Assembly,"ACR 11 Wicks Consent Calendar Second Day Regular Session",71,0,0,9,80
1697065,1298228,2023-04-11,Senate,"Do pass, but first be re-referred to the Committee on [Appropriations]",5,0,0,0,5
1697065,1308794,2023-04-24,Senate,"Placed on suspense file",7,0,0,0,7
1697065,1328907,2023-05-18,Senate,"Do pass as amended",7,0,0,0,7
1697065,1335387,2023-05-30,Senate,"Special Consent SB309 Cortese et al",40,0,0,0,40
1697065,1348365,2023-06-27,Assembly,"Do pass and be re-referred to the Committee on [Appropriations] with recommendation: To Consent Calendar",8,0,0,0,8
1697065,1352973,2023-09-01,Assembly,"Do pass",16,0,0,0,16
1697065,1353782,2023-09-12,Assembly,"SB 309 Cortese Senate Third Reading By Reyes",80,0,0,0,80
1697065,1354441,2023-09-13,Senate,"Unfinished Business SB309 Cortese et al. Concurrence",39,0,0,1,40
1697066,1298290,2023-04-11,Senate,"Do pass as amended, but first amend, and re-refer to the Committee on [Judiciary]",11,0,0,0,11
1697066,1311791,2023-04-25,Senate,"Do pass, but first be re-referred to the Committee on [Appropriations]",11,0,0,0,11
1697066,1320425,2023-05-08,Senate,"Placed on suspense file",7,0,0,0,7
1697066,1328773,2023-05-18,Senate,"Do pass",7,0,0,0,7
1697066,1335411,2023-05-30,Senate,"Senate 3rd Reading SB310 Dodd",40,0,0,0,40
1697066,1347486,2023-06-26,Assembly,"Do pass as amended and be re-referred to the Committee on [Judiciary]",10,0,0,1,11
1697066,1349605,2023-07-05,Assembly,"Do pass and be re-referred to the Committee on [Appropriations]",10,0,0,1,11
1697066,1464499,2024-08-15,Assembly,"Do pass as amended",11,0,0,4,15
1697066,1465567,2024-08-26,Assembly,"SB 310 Dodd Senate Third Reading By Wood",77,0,0,2,79
1697066,1467068,2024-08-28,Senate,"Unfinished Business SB310 Dodd Concurrence",39,0,0,1,40
1697067,1281831,2023-03-22,Senate,"Do pass, but first be re-referred to the Committee on [Appropriations] with the recommendation: To Consent Calendar",11,0,0,1,12
1697067,1296963,2023-04-10,Senate,"Placed on suspense file",7,0,0,0,7
1697067,1328253,2023-05-18,Senate,"Do pass",7,0,0,0,7
1697067,1333544,2023-05-25,Senate,"Special Consent SB311 Eggman et al",40,0,0,0,40
1697067,1343738,2023-06-13,Assembly,"Do pass and be re-referred to the Committee on [Appropriations] with recommendation: To Consent Calendar",15,0,0,0,15
1697067,1353025,2023-09-01,Assembly,"Do pass",16,0,0,0,16
1697067,1353809,2023-09-12,Assembly,"SB 311 Eggman Senate Third Reading By Wood",80,0,0,0,80
1697067,1354423,2023-09-13,Senate,"Unfinished Business SB311 Eggman et al. Concurrence",39,0,0,1,40
1697068,1363939,2024-01-10,Senate,"Do pass, but first be re-referred to the Committee on [Appropriations]",7,0,0,0,7
1697068,1364803,2024-01-16,Senate,"Placed on suspense file",6,0,0,1,7
1697068,1366802,2024-01-18,Senate,"Do pass",6,0,0,1,7
1697068,1369541,2024-01-25,Senate,"Senate 3rd Reading SB312 Wiener et al",34,1,0,5,40
1697068,1461997,2024-07-01,Assembly,"Do pass as amended and be re-referred to the Committee on [Appropriations]",10,0,0,2,12
1697068,1464066,2024-08-15,Assembly,"Do pass",12,1,0,2,15
1697068,1465741,2024-08-26,Assembly,"SB 312 Wiener Senate Third Reading By Bryan",66,0,0,13,79
1697068,1466318,2024-08-29,Senate,"Unfinished Business SB312 Wiener et al. Concurrence",39,0,0,1,40
1697069,1298283,2023-04-11,Senate,"Do pass, but first be re-referred to the Committee on [Judiciary]",12,0,0,3,15
1697069,1305395,2023-04-18,Senate,"Do pass, but first be re-referred to the Committee on [Appropriations]",11,0,0,0,11
1697069,1315782,2023-05-01,Senate,"Placed on suspense file",6,0,0,1,7
1697070,1280615,2023-03-21,Senate,"Do pass, but first be re-referred to the Committee on [Governance and Finance]",6,0,0,1,7
1697070,1299384,2023-04-12,Senate,"Do pass as amended, but first amend, and re-refer to the Committee on [Appropriations]",6,2,0,0,8
1697070,1308819,2023-04-24,Senate,"Placed on suspense file",7,0,0,0,7
1697070,1328834,2023-05-18,Senate,"Do pass",5,2,0,0,7
1697070,1330111,2023-05-22,Senate,"Senate 3rd Reading SB314 Ashby",32,7,0,1,40
1697070,1346242,2023-06-21,Assembly,"Do pass and be re-referred to the Committee on [Local Government]",6,2,0,0,8
1697070,1350419,2023-07-12,Assembly,"Do pass and be re-referred to the Committee on [Appropriations]",6,1,0,1,8
1697070,1352758,2023-09-01,Assembly,"Do pass",12,4,0,0,16
1697070,1353625,2023-09-11,Assembly,"SB 314 Ashby Senate Third Reading By McCarty",62,18,0,0,80
1697070,1354050,2023-09-12,Senate,"Unfinished Business SB314 Ashby et al. Concurrence",31,7,0,2,40
1697071,1304401,2023-04-18,Senate,"Do pass as amended, but first amend, and re-refer to the Committee on [Appropriations]",10,0,0,1,11
1697071,1315784,2023-05-01,Senate,"Placed on suspense file",6,0,0,1,7
1697072,1288244,2023-03-28,Senate,"Do pass, but first be re-referred to the Committee on [Appropriations]",1,3,0,1,5
1697074,1304399,2023-04-17,Senate,"Do pass, but first be re-referred to the Committee on [Appropriations]",4,0,0,1,5
1697074,1315682,2023-05-01,Senate,"Placed on suspense file",6,0,0,1,7
1697074,1328364,2023-05-18,Senate,"Do pass",7,0,0,0,7
1697074,1333770,2023-05-25,Senate,"Special Consent SB318 Ochoa Bogh et al",40,0,0,0,40
1697074,1350310,2023-07-11,Assembly,"Do pass and be re-referred to the Committee on [Appropriations]",7,0,0,1,8
1697075,1310373,2023-04-24,Senate,"Do pass as amended, but first amend, and re-refer to the Committee on [Appropriations]",16,0,0,2,18
1697075,1325005,2023-05-15,Senate,"Placed on suspense file",7,0,0,0,7
1697075,1328800,2023-05-18,Senate,"Do pass",7,0,0,0,7
1697075,1333561,2023-05-25,Senate,"Special Consent SB319 McGuire",40,0,0,0,40
1697075,1350469,2023-07-12,Assembly,"Do pass and be re-referred to the Committee on [Appropriations] with recommendation: To Consent Calendar",14,0,0,1,15
1697075,1352634,2023-09-01,Assembly,"Do pass as amended",12,0,0,4,16
1697075,1354366,2023-09-13,Assembly,"SB 319 McGuire Senate Third Reading By Garcia",80,0,0,0,80
1697075,1354826,2023-09-14,Senate,"Unfinished Business SB319 McGuire Concurrence",40,0,0,0,40
1697077,1299400,2023-04-12,Senate,"Do pass, but first be re-referred to the Committee on [Appropriations]",7,0,0,0,7
1697077,1308797,2023-04-24,Senate,"Placed on suspense file",7,0,0,0,7
1697077,1328743,2023-05-18,Senate,"Do pass",6,1,0,0,7
1697077,1330126,2023-05-22,Senate,"Senate 3rd Reading SB321 Ashby et al",39,1,0,0,40
1697077,1348866,2023-06-28,Assembly,"Do pass as amended, and be re-referred to the Committee on [Appropriations] with recommendation: To Consent Calendar",7,0,0,0,7
1697077,1352565,2023-09-01,Assembly,"Do pass",16,0,0,0,16
1697077,1353234,2023-09-06,Assembly,"SB 321 Ashby Senate Third Reading By Bonta",79,0,0,1,80
1697077,1353527,2023-09-07,Senate,"Unfinished Business SB321 Ashby et al. Concurrence",39,1,0,0,40
1697078,1296971,2023-04-10,Senate,"Do pass as amended, but first amend, and re-refer to the Committee on [Labor, Public Employment and Retirement ]",11,3,0,4,18
1697078,1311902,2023-04-26,Senate,"Do pass, but first be re-referred to the Committee on [Appropriations]",4,1,0,0,5
1697078,1320525,2023-05-08,Senate,"Placed on suspense file",7,0,0,0,7
1697078,1328393,2023-05-18,Senate,"Do pass",5,2,0,0,7
1697078,1332603,2023-05-24,Senate,"Senate 3rd Reading SB322 Becker",32,7,0,1,40
1697078,1347819,2023-06-26,Assembly,"Do pass and be re-referred to the Committee on [Appropriations]",12,3,0,0,15
1697079,1288146,2023-03-29,Senate,"Do pass, but first be re-referred to the Committee on [Appropriations]",7,0,0,0,7
1697079,1296969,2023-04-10,Senate,"Placed on suspense file",7,0,0,0,7
1697079,1328657,2023-05-18,Senate,"Do pass",7,0,0,0,7
1697079,1333646,2023-05-25,Senate,"Special Consent SB323 Portantino et al",40,0,0,0,40
1697079,1350512,2023-07-12,Assembly,"Do pass as amended and be re-referred to the Committee on [Appropriations]",6,0,0,1,7
1697079,1353042,2023-09-01,Assembly,"Do pass as amended",11,0,0,5,16
1697079,1354420,2023-09-13,Assembly,"SB 323 Portantino Senate Third Reading By Pacheco",80,0,0,0,80
1697079,1354525,2023-09-14,Senate,"Unfinished Business SB323 Portantino et al. Concurrence",40,0,0,0,40
1697080,1300987,2023-04-12,Senate,"Do pass, but first be re-referred to the Committee on [Appropriations]",10,1,0,1,12
1697080,1308844,2023-04-24,Senate,"Placed on suspense file",7,0,0,0,7
1697080,1328700,2023-05-18,Senate,"Do pass",5,1,0,1,7
1697080,1332553,2023-05-24,Senate,"Senate 3rd Reading SB324 Lim√≥n",31,7,0,2,40
1697080,1347912,2023-06-27,Assembly,"Do pass and be re-referred to the Committee on [Appropriations]",12,2,0,1,15
1697081,1255129,2023-02-17,Senate,"Senate 3rd Reading SCR19 Alvarado-Gil et al",36,0,0,4,40
1697081,1267488,2023-03-02,Assembly,"Be adopted. To Consent Calendar",13,0,0,0,13
1697081,1272545,2023-03-09,Assembly,"SCR 19 Alvarado-Gil Consent Calendar Second Day Regular Session",75,0,0,5,80
1698880,1274187,2023-03-13,Assembly,"Do pass and be re-referred to the Committee on [Public Safety] with recommendation: To Consent Calendar",7,0,0,0,7
1698880,1313380,2023-04-27,Assembly,"Do pass and be re-referred to the Committee on [Appropriations]",8,0,0,0,8
1698880,1328501,2023-05-18,Assembly,"Do pass",15,0,0,1,16
1698880,1333757,2023-05-25,Assembly,"AB 474 Rodriguez Assembly Third Reading",78,0,0,2,80
1698880,1347915,2023-06-27,Senate,"Do pass, but first be re-referred to the Committee on [Governmental Organization]",5,0,0,0,5
1698880,1350159,2023-07-11,Senate,"Do pass, but first be re-referred to the Committee on [Appropriations]",14,0,0,1,15
1698880,1351507,2023-08-14,Senate,"Placed on suspense file",7,0,0,0,7
1698880,1352508,2023-09-01,Senate,"Do pass",7,0,0,0,7
1698880,1354510,2023-09-11,Senate,"Assembly 3rd Reading AB474 Rodriguez et al. By Umberg",38,1,0,1,40
1698882,1311671,2023-04-26,Assembly,"Do pass",21,0,0,1,22
1698882,1338166,2023-05-31,Assembly,"AB 476 Villapudua Assembly Third Reading",78,0,0,2,80
1698882,1350518,2023-07-11,Senate,"Do pass as amended",16,0,0,0,16
1698882,1353951,2023-09-12,Senate,"Assembly 3rd Reading AB476 Villapudua By Newman",38,0,0,2,40
1698882,1354341,2023-09-13,Assembly,"AB 476 Villapudua Concurrence in Senate Amendments",78,0,0,2,80
1698885,1275568,2023-03-14,Assembly,"Do pass as amended, and be re-referred to the Committee on [Appropriations] with recommendation: To Consent Calendar",8,0,0,0,8
1698885,1305349,2023-04-19,Assembly,"Do pass. To Consent Calendar",14,0,0,2,16
1698885,1313481,2023-04-27,Assembly,"AB 479 Blanca Rubio Consent Calendar Second Day Regular Session",79,0,0,1,80
1698885,1340081,2023-06-06,Senate,"Do pass, but first be re-referred to the Committee on [Appropriations] with the recommendation: To Consent Calendar",5,0,0,0,5
1698885,1348854,2023-06-29,Senate,"Consent Calendar AB479 Blanca Rubio Urgency Clause",39,0,0,1,40
1698886,1288179,2023-03-29,Assembly,"Do pass as amended and be re-referred to the Committee on [Housing and Community Development]",6,2,0,0,8
1698886,1311663,2023-04-26,Assembly,"Do pass and be re-referred to the Committee on [Appropriations]",6,1,0,1,8
1698886,1326933,2023-05-17,Assembly,"Do pass",12,4,0,0,16
1698886,1330078,2023-05-22,Assembly,"AB 480 Ting Assembly Third Reading",53,16,0,11,80
1698886,1348393,2023-06-28,Senate,"Do pass as amended, but first amend, and re-refer to the Committee on [Housing]",6,1,0,1,8
1698886,1350147,2023-07-10,Senate,"Do pass, but first be re-referred to the Committee on [Appropriations]",9,2,0,0,11
1698886,1352311,2023-08-28,Senate,"Placed on suspense file",7,0,0,0,7
1698886,1352691,2023-09-01,Senate,"Do pass",5,2,0,0,7
1698886,1354308,2023-09-13,Senate,"Assembly 3rd Reading AB480 Ting et al. By Umberg",31,8,0,1,40
1698886,1354647,2023-09-14,Assembly,"AB 480 Ting Concurrence in Senate Amendments",60,13,0,7,80
1698887,1310143,2023-04-25,Assembly,"Do pass and be re-referred to the Committee on [Appropriations]",15,0,0,3,18
1698887,1328775,2023-05-18,Assembly,"Do pass",15,0,0,1,16
1698887,1338123,2023-05-31,Assembly,"AB 481 Wendy Carrillo Assembly Third Reading",78,0,0,2,80
1698887,1349906,2023-07-10,Senate,"Do pass as amended, but first amend, and re-refer to the Committee on [Appropriations]",12,0,0,1,13
1698887,1351825,2023-08-21,Senate,"Placed on suspense file",7,0,0,0,7
1698889,1280637,2023-03-21,Assembly,"Do pass and be re-referred to the Committee on [Appropriations] with recommendation: To Consent Calendar",14,0,0,1,15
1698889,1328283,2023-05-18,Assembly,"Do pass",15,0,0,1,16
1698889,1338023,2023-05-31,Assembly,"AB 483 Muratsuchi Assembly Third Reading",80,0,0,0,80
1698889,1350713,2023-07-12,Senate,"Do pass as amended, but first amend, and re-refer to the Committee on [Appropriations]",11,0,0,1,12
1698889,1351462,2023-08-14,Senate,"Placed on suspense file",7,0,0,0,7
1698889,1352519,2023-09-01,Senate,"Do pass",7,0,0,0,7
1698889,1354103,2023-09-13,Senate,"Assembly 3rd Reading AB483 Muratsuchi et al. By Portantino",39,0,0,1,40
1698889,1354785,2023-09-14,Assembly,"AB 483 Muratsuchi Concurrence in Senate Amendments",80,0,0,0,80
1698890,1275532,2023-03-14,Assembly,"Do pass as amended and be re-referred to the Committee on [Appropriations]",8,0,0,0,8
1698892,1304390,2023-04-18,Assembly,"Do pass and be re-referred to the Committee on [Appropriations]",11,4,0,0,15
1698892,1328298,2023-05-18,Assembly,"Do pass",11,3,0,2,16
1698892,1338079,2023-05-31,Assembly,"AB 486 Kalra Assembly Third Reading",61,17,0,2,80
1698892,1348821,2023-06-28,Senate,"Do pass, but first be re-referred to the Committee on [Judiciary]",9,1,0,2,12
1698895,1281911,2023-03-22,Assembly,"Do pass and be re-referred to the Committee on [Appropriations] with recommendation: To Consent Calendar",12,0,0,2,14
1698895,1305500,2023-04-19,Assembly,"Do pass. To Consent Calendar",14,0,0,2,16
1698895,1313354,2023-04-27,Assembly,"AB 489 Calderon Consent Calendar Second Day Regular Session",79,0,0,1,80
1698895,1344175,2023-06-14,Senate,"Do pass, but first be re-referred to the Committee on [Appropriations] with the recommendation: To Consent Calendar",5,0,0,0,5
1698895,1348819,2023-06-29,Senate,"Consent Calendar AB489 Calderon",39,0,0,1,40
1698896,1280623,2023-03-20,Assembly,"Do pass and be re-referred to the Committee on [Appropriations] with recommendation: To Consent Calendar",15,0,0,0,15
1698896,1322856,2023-05-10,Assembly,"Do pass. To Consent Calendar",14,0,0,2,16
1698896,1328630,2023-05-18,Assembly,"AB 490 Vince Fong Consent Calendar Second Day Regular Session",74,0,0,6,80
1698896,1343720,2023-06-13,Senate,"Do pass, but first be re-referred to the Committee on [Appropriations] with the recommendation: To Consent Calendar",16,0,0,0,16
1698897,1304269,2023-04-17,Assembly,"Do pass and be re-referred to the Committee on [Appropriations] with recommendation: To Consent Calendar",11,0,0,0,11
1698897,1311796,2023-04-26,Assembly,"Do pass. To Consent Calendar",16,0,0,0,16
1698897,1318928,2023-05-04,Assembly,"AB 491 Wallis Consent Calendar Second Day Regular Session",75,0,0,5,80
1698897,1451575,2024-05-29,Senate,"Do pass as amended, but first amend, and re-refer to the Committee on [Judiciary]",7,0,0,0,7
1698898,1304309,2023-04-18,Assembly,"Do pass and be re-referred to the Committee on [Appropriations]",11,4,0,0,15
1698898,1328401,2023-05-18,Assembly,"Do pass",11,4,0,1,16
1698898,1338046,2023-05-31,Assembly,"AB 492 Pellerin Assembly Third Reading",64,16,0,0,80
1698900,1280656,2023-03-21,Assembly,"Do pass as amended and be re-referred to the Committee on [Appropriations]",11,0,0,4,15
1698900,1328431,2023-05-18,Assembly,"Do pass",12,2,0,2,16
1698900,1337969,2023-05-31,Assembly,"AB 494 Arambula Assembly Third Reading",66,9,0,5,80
1698900,1348830,2023-06-28,Senate,"Do pass, but first be re-referred to the Committee on [Appropriations]",10,1,0,1,12
1698900,1349982,2023-07-10,Senate,"Placed on suspense file",6,0,0,1,7
1698900,1352867,2023-09-01,Senate,"Do pass as amended",5,2,0,0,7
1698900,1353804,2023-09-12,Assembly,"AB 494 Arambula Concurrence in Senate Amendments",66,9,0,5,80
1698900,1354662,2023-09-11,Senate,"Assembly 3rd Reading AB494 Arambula By Smallwood-Cuevas",31,7,0,2,40
1698902,1278491,2023-03-14,Assembly,"Do pass",7,0,0,2,9
1698902,1283184,2023-03-23,Assembly,"AB 496 Friedman Assembly Third Reading",62,0,0,18,80
1698902,1340974,2023-06-07,Senate,"Do pass",6,0,0,1,7
1698902,1353221,2023-09-06,Senate,"Assembly 3rd Reading AB496 Friedman et al. By Skinner",38,0,0,2,40
1698903,1283116,2023-03-22,Assembly,"Do pass and be re-referred to the Committee on [Appropriations] with recommendation: To Consent Calendar",7,0,0,0,7
1698903,1305361,2023-04-19,Assembly,"Do pass. To Consent Calendar",14,0,0,2,16
1698903,1313403,2023-04-27,Assembly,"AB 497 Quirk-Silva Consent Calendar Second Day Regular Session",79,0,0,1,80
1698903,1340992,2023-06-07,Senate,"Do pass and be ordered to the Consent Calendar",7,0,0,0,7
1698903,1344725,2023-06-15,Senate,"Consent Calendar AB497 Quirk-Silva",40,0,0,0,40
1698904,1315713,2023-05-01,Assembly,"AB 498 Aguiar-Curry Third Reading Urgency",78,0,0,2,80
1698904,1323866,2023-05-11,Senate,"Assembly 3rd Reading AB498 Aguiar-Curry By Dodd Urgency Clause",39,0,0,1,40
1698905,1281915,2023-03-22,Assembly,"Do pass",8,0,0,0,8
1698905,1337227,2023-06-01,Assembly,"AB 499 Luz Rivas Assembly Third Reading",78,0,0,2,80
1698905,1348296,2023-06-27,Senate,"Do pass and be ordered to the Consent Calendar",16,0,0,0,16
1698905,1349735,2023-07-06,Senate,"Consent Calendar AB499 Luz Rivas",40,0,0,0,40
1698907,1310255,2023-04-24,Assembly,"Do pass and be re-referred to the Committee on [Appropriations]",4,11,0,0,15
1698907,1310256,2023-04-24,Assembly,Reconsideration,15,0,0,0,15
1698907,1363619,2024-01-08,Assembly,"Do pass and be re-referred to the Committee on [Appropriations]",4,10,0,1,15
1698908,1280678,2023-03-21,Assembly,"Do pass as amended",11,0,0,0,11
1698908,1296964,2023-04-10,Assembly,"AB 502 Lee Assembly Third Reading",68,0,0,12,80
1698908,1343741,2023-06-13,Senate,"Do pass, but first be re-referred to the Committee on [Business, Professions and Economic Development] with the recommendation: To Consent Calendar",10,0,0,1,11
1698908,1345185,2023-06-19,Senate,"Do pass",12,0,0,1,13
1698908,1352242,2023-08-24,Senate,"Special Consent AB502 Lee et al",40,0,0,0,40
1698909,1298165,2023-04-11,Assembly,"Do pass as amended and be re-referred to the Committee on [Appropriations]",15,0,0,0,15
1698910,1299355,2023-04-12,Assembly,"Do pass and be re-referred to the Committee on [Judiciary]",5,1,0,1,7
1698910,1304317,2023-04-18,Assembly,"Do pass and be re-referred to the Committee on [Appropriations]",8,3,0,0,11
1698910,1328474,2023-05-18,Assembly,"Do pass",11,4,0,1,16
1698910,1337974,2023-05-31,Assembly,"AB 504 Reyes Assembly Third Reading",63,13,0,4,80
1698910,1348363,2023-06-28,Senate,"Do pass, but first be re-referred to the Committee on [Judiciary]",4,1,0,0,5
1698910,1350473,2023-07-11,Senate,"Do pass as amended, but first amend, and re-refer to the Committee on [Appropriations]",9,2,0,0,11
1698910,1351302,2023-08-14,Senate,"Placed on suspense file",7,0,0,0,7
1698910,1352550,2023-09-01,Senate,"Do pass as amended",5,2,0,0,7
1698910,1353840,2023-09-12,Senate,"Assembly 3rd Reading AB504 Reyes et al. By Smallwood-Cuevas",27,8,0,5,40
1698910,1354121,2023-09-13,Assembly,"AB 504 Reyes Concurrence in Senate Amendments",62,13,0,5,80
1698911,1304358,2023-04-18,Assembly,"Do pass and be re-referred to the Committee on [Appropriations]",6,2,0,0,8
1698911,1328713,2023-05-18,Assembly,"Do pass",11,4,0,1,16
1698911,1333819,2023-05-25,Assembly,"AB 505 Ting Assembly Third Reading",58,15,0,7,80
1698911,1347950,2023-06-27,Senate,"Do pass, but first be re-referred to the Committee on [Appropriations]",4,1,0,0,5
1698911,1352348,2023-08-28,Senate,"Placed on suspense file",7,0,0,0,7
1698911,1352783,2023-09-01,Senate,"Do pass as amended",5,2,0,0,7
1698911,1354318,2023-09-13,Senate,"Assembly 3rd Reading AB505 Ting By Skinner",21,8,0,11,40
1698911,1354319,2023-09-13,Assembly,"AB 505 Ting Concurrence in Senate Amendments",55,17,0,8,80
1698912,1311809,2023-04-25,Assembly,"Do pass and be re-referred to the Committee on [Appropriations]",12,0,0,0,12
1698912,1328202,2023-05-18,Assembly,"Do pass",15,0,0,1,16
1698912,1338196,2023-05-31,Assembly,"AB 506 Mike Fong Assembly Third Reading",79,0,0,1,80
1698912,1350487,2023-07-12,Senate,"Do pass as amended, but first amend, and re-refer to the Committee on [Appropriations]",6,0,0,1,7
1698912,1351437,2023-08-14,Senate,"Placed on suspense file",7,0,0,0,7
1698913,1276624,2023-03-15,Assembly,"Do pass and be re-referred to the Committee on [Appropriations] with recommendation: To Consent Calendar",8,0,0,0,8
1698913,1288143,2023-03-29,Assembly,"Do pass. To Consent Calendar",14,0,0,2,16
1698913,1302602,2023-04-17,Assembly,"AB 507 Bryan Consent Calendar Second Day Regular Session",79,0,0,1,80
1698913,1340023,2023-06-06,Senate,"Do pass, but first be re-referred to the Committee on [Appropriations] with the recommendation: To Consent Calendar",7,0,0,0,7
1698913,1348867,2023-06-29,Senate,"Consent Calendar AB507 Bryan",39,0,0,1,40
1698914,1275549,2023-03-14,Assembly,"Do pass and be re-referred to the Committee on [Appropriations] with recommendation: To Consent Calendar",8,0,0,0,8
1698914,1328204,2023-05-18,Assembly,"Do pass",15,0,0,1,16
1698914,1338199,2023-05-31,Assembly,"AB 508 Petrie-Norris Assembly Third Reading",80,0,0,0,80
1698914,1350294,2023-07-11,Senate,"Do pass, but first be re-referred to the Committee on [Appropriations]",4,0,0,1,5
1698914,1353269,2023-09-06,Senate,"Assembly 3rd Reading AB508 Petrie-Norris et al. By Newman",40,0,0,0,40
1698915,1317042,2023-05-01,Assembly,"Do pass and be re-referred to the Committee on [Appropriations]",11,0,0,0,11
1698916,1304290,2023-04-18,Assembly,"Do pass and be re-referred to the Committee on [Appropriations] with recommendation: To Consent Calendar",7,0,0,1,8
1698917,1298324,2023-04-10,Assembly,"Do pass as amended and be re-referred to the Committee on [Appropriations]",10,0,0,1,11
1698917,1311782,2023-04-26,Assembly,"Do pass. To Consent Calendar",16,0,0,0,16
1698917,1318963,2023-05-04,Assembly,"AB 511 Dixon Consent Calendar Second Day Regular Session",75,0,0,5,80
1698917,1341028,2023-06-07,Senate,"Do pass as amended, but first amend, and re-refer to the Committee on [Appropriations] with the recommendation: To Consent Calendar",8,0,0,0,8
1698917,1348848,2023-06-29,Senate,"Consent Calendar AB511 Dixon et al",39,0,0,1,40
1698917,1352470,2023-08-31,Assembly,"AB 511 Dixon Concurrence in Senate Amendments",79,0,0,1,80
1698918,1276610,2023-03-14,Assembly,"Do pass as amended, and be re-referred to the Committee on [Appropriations] with recommendation: To Consent Calendar",13,0,0,2,15
1698919,1313441,2023-04-17,Assembly,"Do pass as amended and be re-referred to the Committee on [Appropriations]",7,0,0,0,7
1698919,1328226,2023-05-18,Assembly,"Do pass",15,0,0,1,16
1698919,1338058,2023-05-31,Assembly,"AB 513 Rodriguez Third Reading Urgency",80,0,0,0,80
1698919,1350318,2023-07-11,Senate,"Do pass, but first be re-referred to the Committee on [Appropriations]",14,0,0,1,15
1698919,1351253,2023-08-14,Senate,"Placed on suspense file",7,0,0,0,7
1698921,1305437,2023-04-19,Assembly,"Do pass as amended and be re-referred to the Committee on [Appropriations]",7,0,0,1,8
1698921,1328496,2023-05-18,Assembly,"Do pass",15,0,0,1,16
1698921,1330037,2023-05-22,Assembly,"AB 515 Ward Assembly Third Reading",76,0,0,4,80
1698921,1350146,2023-07-10,Senate,"Do pass, but first be re-referred to the Committee on [Appropriations] with the recommendation: To Consent Calendar",11,0,0,0,11
1698921,1351393,2023-08-14,Senate,"Placed on suspense file",7,0,0,0,7
1698922,1307880,2023-04-19,Assembly,"Do pass and be re-referred to the Committee on [Housing and Community Development]",7,0,0,0,7
1698922,1311875,2023-04-26,Assembly,"Do pass and be re-referred to the Committee on [Appropriations] with recommendation: To Consent Calendar",8,0,0,0,8
1698922,1326953,2023-05-17,Assembly,"Do pass. To Consent Calendar",15,0,0,1,16
1698922,1333774,2023-05-25,Assembly,"AB 516 Ramos Consent Calendar Second Day Regular Session",76,0,0,4,80
1698922,1344188,2023-06-14,Senate,"Do pass as amended, but first amend, and re-refer to the Committee on [Appropriations]",8,0,0,0,8
1698922,1353171,2023-09-05,Senate,"Assembly 3rd Reading AB516 Ramos By Alvarado-Gil",39,0,0,1,40
1698922,1353457,2023-09-07,Assembly,"AB 516 Ramos Concurrence in Senate Amendments",79,0,0,1,80
1698923,1310396,2023-04-25,Assembly,"Do pass and be re-referred to the Committee on [Appropriations] with recommendation: To Consent Calendar",15,0,0,0,15
1698923,1322883,2023-05-10,Assembly,"Do pass. To Consent Calendar",14,0,0,2,16
1698923,1328533,2023-05-18,Assembly,"AB 517 Soria Consent Calendar Second Day Regular Session",74,0,0,6,80
1698924,1299523,2023-04-12,Assembly,"Do pass and be re-referred to the Committee on [Appropriations]",10,0,0,4,14
1698924,1327928,2023-05-18,Assembly,"Do pass",12,1,0,3,16
1698924,1338161,2023-05-31,Assembly,"AB 518 Wicks Assembly Third Reading",64,0,0,16,80
1698924,1348487,2023-06-28,Senate,"Do pass, but first be re-referred to the Committee on [Appropriations]",5,0,0,0,5
1698924,1351263,2023-08-14,Senate,"Placed on suspense file",7,0,0,0,7
1698924,1352509,2023-09-01,Senate,"Do pass",5,2,0,0,7
1698924,1466023,2024-08-27,Senate,"Do pass, but first be re-referred to the Committee on [Appropriations]",5,0,0,0,5
1698924,1466069,2024-08-28,Senate,"Do pass",6,0,0,1,7
1698924,1466515,2024-08-30,Senate,"Assembly 3rd Reading AB518 Wicks et al. By Umberg",39,0,0,1,40
1698924,1467032,2024-08-31,Assembly,"AB 518 Wicks Concurrence in Senate Amendments",55,4,0,20,79
1698925,1311668,2023-04-26,Assembly,"Do pass and be re-referred to the Committee on [Appropriations] with recommendation: To Consent Calendar",8,0,0,0,8
1698925,1328422,2023-05-18,Assembly,"Do pass",15,0,0,1,16
1698925,1338103,2023-05-31,Assembly,"AB 519 Schiavo Assembly Third Reading",80,0,0,0,80
1698925,1350270,2023-07-10,Senate,"Do pass, but first be re-referred to the Committee on [Appropriations] with the recommendation: To Consent Calendar",11,0,0,0,11
1698925,1351785,2023-08-21,Senate,"Placed on suspense file",7,0,0,0,7
1698925,1352797,2023-09-01,Senate,"Do pass as amended",7,0,0,0,7
1698925,1354085,2023-09-13,Senate,"Special Consent AB519 Schiavo et al",39,0,0,1,40
1698925,1354670,2023-09-14,Assembly,"AB 519 Schiavo Concurrence in Senate Amendments",80,0,0,0,80
1698926,1311799,2023-04-26,Assembly,"Do pass and be re-referred to the Committee on [Appropriations]",7,0,0,0,7
1698926,1328590,2023-05-18,Assembly,"Do pass",13,2,0,1,16
1698926,1337229,2023-06-01,Assembly,"AB 520 Santiago Assembly Third Reading",66,13,0,1,80
1698926,1350504,2023-07-12,Senate,"Do pass, but first be re-referred to the Committee on [Appropriations]",5,0,0,0,5
1698926,1351383,2023-08-14,Senate,"Placed on suspense file",7,0,0,0,7
1698926,1352602,2023-09-01,Senate,"Do pass as amended",5,2,0,0,7
1698926,1354019,2023-09-12,Senate,"Assembly 3rd Reading AB520 Santiago By Becker",32,6,0,2,40
1698926,1354203,2023-09-13,Assembly,"AB 520 Santiago Concurrence in Senate Amendments",66,13,0,1,80
1698927,1311871,2023-04-26,Assembly,"Do pass and be re-referred to the Committee on [Appropriations]",7,0,0,0,7
1698927,1322907,2023-05-10,Assembly,"Do pass",15,0,0,1,16
1698927,1330113,2023-05-22,Assembly,"AB 521 Bauer-Kahan Assembly Third Reading",77,0,0,3,80
1698927,1346993,2023-06-22,Senate,"Do pass as amended, but first amend, and re-refer to the Committee on [Appropriations]",5,0,0,0,5
1698927,1349471,2023-07-03,Senate,"Do pass",5,0,0,2,7
1698927,1353884,2023-09-12,Senate,"Assembly 3rd Reading AB521 Bauer-Kahan et al. By Smallwood-Cuevas",34,0,0,6,40
1698927,1354325,2023-09-13,Assembly,"AB 521 Bauer-Kahan Concurrence in Senate Amendments",80,0,0,0,80
1698928,1280634,2023-03-21,Assembly,"Do pass and be re-referred to the Committee on [Public Safety] with recommendation: To Consent Calendar",11,0,0,0,11
1698928,1310259,2023-04-25,Assembly,"Do pass and be re-referred to the Committee on [Appropriations] with recommendation: To Consent Calendar",8,0,0,0,8
1698928,1328480,2023-05-18,Assembly,"Do pass",15,0,0,1,16
1698928,1338104,2023-05-31,Assembly,"AB 522 Kalra Assembly Third Reading",80,0,0,0,80
1698928,1348390,2023-06-27,Senate,"Do pass, but first be re-referred to the Committee on [Public Safety] with the recommendation: To Consent Calendar",11,0,0,0,11
1698928,1350275,2023-07-11,Senate,"Do pass, but first be re-referred to the Committee on [Appropriations] with the recommendation: To Consent Calendar",4,0,0,1,5
1698928,1351381,2023-08-14,Senate,"Placed on suspense file",7,0,0,0,7
1698930,1280608,2023-03-21,Assembly,"Do pass and be re-referred to the Committee on [Labor and Employment]",8,0,0,3,11
1698930,1299465,2023-04-12,Assembly,"Do pass and be re-referred to the Committee on [Appropriations]",5,2,0,0,7
1698930,1327987,2023-05-18,Assembly,"Do pass as amended",12,3,0,1,16
1698930,1337214,2023-06-01,Assembly,"AB 524 Wicks Assembly Third Reading",47,15,0,18,80
1698930,1348413,2023-06-27,Senate,"Do pass as amended, but first amend, and re-refer to the Committee on [Labor, Public Employment and Retirement ]",7,2,0,2,11
1698930,1350458,2023-07-12,Senate,"Do pass, but first be re-referred to the Committee on [Appropriations]",4,1,0,0,5
1698930,1351496,2023-08-14,Senate,"Placed on suspense file",7,0,0,0,7
1698930,1352990,2023-09-01,Senate,"Do pass",5,2,0,0,7
1698930,1353935,2023-09-12,Senate,"Assembly 3rd Reading AB524 Wicks By Eggman",26,8,0,6,40
1698930,1354534,2023-09-14,Assembly,"AB 524 Wicks Concurrence in Senate Amendments",49,17,0,14,80
1698931,1286902,2023-03-28,Assembly,"Do pass and be re-referred to the Committee on [Appropriations]",8,0,0,0,8
1698932,1247340,2023-02-09,Assembly,"Be adopted. To third reading",11,0,0,2,13
1698933,1304429,2023-04-18,Senate,"Do pass, but first be re-referred to the Committee on [Appropriations]",1,1,0,3,5
1698933,1304430,2023-04-18,Senate,"[First] hearing set for [04-18-2023]: Failed passage in Committee. Reconsideration granted",5,0,0,0,5
1698934,1313379,2023-04-26,Senate,"Do pass, but first be re-referred to the Committee on [Appropriations]",11,0,0,1,12
1698934,1320543,2023-05-08,Senate,"Placed on suspense file",7,0,0,0,7
1698934,1328198,2023-05-18,Senate,"Do pass",6,0,0,1,7
1698934,1332569,2023-05-24,Senate,"Senate 3rd Reading SB326 Eggman",39,0,0,1,40
1698934,1350155,2023-07-11,Assembly,"Amend, and re-refer to the Committee on [Health]",15,0,0,0,15
1698934,1351790,2023-08-22,Assembly,"Do pass and be re-referred to the Committee on [Housing and Community Development]",11,0,0,4,15
1698934,1352337,2023-08-28,Assembly,"Do pass and be re-referred to the Committee on [Appropriations]",6,0,0,2,8
1698934,1352910,2023-09-01,Assembly,"Do pass as amended",11,1,0,4,16
1698934,1353743,2023-09-12,Assembly,"SB 326 Eggman Third Reading Urgency By Wood",68,7,0,5,80
1698934,1354192,2023-09-13,Senate,"That the Assembly amendments be concurred in",12,0,0,0,12
1698934,1354791,2023-09-14,Senate,"Unfinished Business SB326 Eggman et al. Urgency Clause Concurrence",40,0,0,0,40
1698935,1311648,2023-04-26,Senate,"Do pass, but first be re-referred to the Committee on [Appropriations] with the recommendation: To Consent Calendar",5,0,0,0,5
1698935,1320527,2023-05-08,Senate,"Placed on suspense file",7,0,0,0,7
1698935,1328607,2023-05-18,Senate,"Do pass",7,0,0,0,7
1698935,1333660,2023-05-25,Senate,"Special Consent SB327 Laird",40,0,0,0,40
1698935,1350463,2023-07-12,Assembly,"Do pass and be re-referred to the Committee on [Appropriations] with recommendation: To Consent Calendar",7,0,0,0,7
1698935,1353002,2023-09-01,Assembly,"Do pass",16,0,0,0,16
1698935,1353224,2023-09-06,Assembly,"SB 327 Laird Senate Third Reading By McKinnor",79,0,0,1,80
1698936,1280670,2023-03-21,Senate,"Do pass as amended, but first amend, and re-refer to the Committee on [Education]",6,0,0,1,7
1698936,1299374,2023-04-12,Senate,"Do pass, but first be re-referred to the Committee on [Appropriations]",6,1,0,0,7
1698936,1308846,2023-04-24,Senate,"Placed on suspense file",7,0,0,0,7
1698936,1328541,2023-05-18,Senate,"Do pass as amended",5,2,0,0,7
1698936,1336356,2023-05-31,Senate,"Senate 3rd Reading SB328 Dodd et al",33,5,0,2,40
1698936,1349631,2023-07-05,Assembly,"Do pass and be re-referred to the Committee on [Appropriations]",6,1,0,1,8
1698937,1305275,2023-04-19,Senate,"Do pass as amended",8,0,0,0,8
1698937,1315789,2023-05-01,Senate,"Senate 3rd Reading SB329 Dodd et al",34,0,0,6,40
1698937,1341040,2023-06-07,Assembly,"Do pass",8,0,0,0,8
1698937,1343116,2023-06-12,Assembly,"SB 329 Dodd Senate Third Reading By WILSON",71,0,0,9,80
1698938,1306800,2023-04-19,Senate,"Do pass, but first be re-referred to the Committee on [Judiciary]",1,4,0,0,5
1698938,1306801,2023-04-19,Senate,"[First] hearing set for [04-20-2023]: Failed passage in Committee. Reconsideration granted",5,0,0,0,5
1698939,1311881,2023-04-25,Senate,"Do pass as amended, but first amend, and re-refer to the Committee on [Appropriations]",11,0,0,0,11
1698939,1320390,2023-05-08,Senate,"Placed on suspense file",7,0,0,0,7
1698939,1328286,2023-05-18,Senate,"Do pass",6,0,0,1,7
1698939,1332598,2023-05-24,Senate,"Senate 3rd Reading SB331 Rubio",38,0,0,2,40
1698939,1350314,2023-07-11,Assembly,"Do pass as amended and be re-referred to the Committee on [Appropriations]",11,0,0,0,11
1698939,1352500,2023-09-01,Assembly,"Do pass as amended",16,0,0,0,16
1698939,1354295,2023-09-13,Assembly,"SB 331 Rubio Senate Third Reading By Blanca Rubio",80,0,0,0,80
1698939,1354527,2023-09-14,Senate,"Unfinished Business SB331 Rubio et al. Concurrence",39,0,0,1,40
1698940,1301021,2023-04-12,Senate,"Do pass, but first be re-referred to the Committee on [Appropriations] with the recommendation: To Consent Calendar",5,0,0,0,5
1698940,1315771,2023-05-01,Senate,"Consent Calendar SB332 Cortese",37,0,0,3,40
1698940,1350666,2023-07-12,Assembly,"Do pass as amended and be re-referred to the Committee on [Appropriations]",7,0,0,0,7
1698940,1352122,2023-08-23,Assembly,"Do pass. To Consent Calendar",15,0,0,1,16
1698940,1353127,2023-09-05,Assembly,"SB 332 Cortese Third Reading Urgency By Haney",78,0,0,2,80
1698940,1353399,2023-09-07,Senate,"That the Assembly amendments be concurred in",5,0,0,0,5
1698940,1354673,2023-09-11,Senate,"Unfinished Business SB332 Cortese et al. Urgency Clause Concurrence",39,0,0,1,40
1698941,1288301,2023-03-29,Senate,"Do pass, but first be re-referred to the Committee on [Human Services]",7,0,0,0,7
1698941,1310221,2023-04-24,Senate,"Do pass, but first be re-referred to the Committee on [Appropriations]",5,0,0,0,5
1698941,1320483,2023-05-08,Senate,"Placed on suspense file",7,0,0,0,7
1698941,1328342,2023-05-18,Senate,"Do pass",5,2,0,0,7
1698941,1330152,2023-05-22,Senate,"Senate 3rd Reading SB333 Cortese et al",34,4,0,2,40
1698941,1339963,2023-06-06,Assembly,"Do pass and be re-referred to the Committee on [Education]",7,0,0,1,8
1698941,1456934,2024-06-12,Assembly,"Do pass and be re-referred to the Committee on [Appropriations]",6,0,0,1,7
1698942,1301020,2023-04-12,Senate,"Do pass, but first be re-referred to the Committee on [Appropriations]",4,1,0,0,5
1698942,1308867,2023-04-24,Senate,"Placed on suspense file",7,0,0,0,7
1698943,1300980,2023-04-12,Senate,"Do pass, but first be re-referred to the Committee on [Appropriations] with the recommendation: To Consent Calendar",5,0,0,0,5
1698943,1315684,2023-05-01,Senate,"Consent Calendar SB335 Cortese",37,0,0,3,40
1698943,1348289,2023-06-28,Assembly,"Do pass and be re-referred to the Committee on [Revenue and Taxation]",5,2,0,1,8
1698943,1350274,2023-07-10,Assembly,"Do pass as amended",6,3,0,2,11
1698943,1352340,2023-08-28,Assembly,"SB 335 Cortese Senate Third Reading By Bennett Amend By BENNETT Set #1",53,16,0,11,80
1698943,1353141,2023-09-05,Assembly,"SB 335 Cortese Senate Third Reading By Bennett",51,17,0,12,80
1698943,1353425,2023-09-07,Senate,"That the Assembly amendments be concurred in",6,2,0,0,8
1698943,1354557,2023-09-11,Senate,"Unfinished Business SB335 Cortese et al. Concurrence",28,8,0,4,40
1698944,1275548,2023-03-14,Senate,"Do pass, but first be re-referred to the Committee on [Appropriations]",13,0,0,2,15
1698944,1296956,2023-04-10,Senate,"Placed on suspense file",7,0,0,0,7
1698944,1328654,2023-05-18,Senate,"Do pass",7,0,0,0,7
1698944,1333753,2023-05-25,Senate,"Special Consent SB336 Umberg",40,0,0,0,40
1698944,1349580,2023-07-05,Assembly,"Do pass as amended and be re-referred to the Committee on [Appropriations]",6,0,0,1,7
1698944,1353083,2023-09-01,Assembly,"Do pass as amended",11,0,0,5,16
1698944,1465294,2024-08-19,Assembly,"SB 336 Umberg Senate Third Reading By Stephanie Nguyen",74,0,0,5,79
1698944,1466102,2024-08-29,Assembly,"SB 336 Umberg Senate Third Reading By Stephanie Nguyen",75,0,0,4,79
1698944,1466537,2024-08-30,Senate,"Unfinished Business SB336 Umberg Concurrence",40,0,0,0,40
1698945,1304283,2023-04-18,Senate,"Do pass as amended, but first amend, and re-refer to the Committee on [Appropriations]",7,2,0,2,11
1698945,1324989,2023-05-15,Senate,"Senate 3rd Reading SB337 Min et al",29,5,0,6,40
1698945,1343128,2023-06-12,Assembly,"Do pass and be re-referred to the Committee on [Appropriations]",8,0,0,3,11
1698945,1352513,2023-09-01,Assembly,"Do pass",13,3,0,0,16
1698945,1353672,2023-09-11,Assembly,"SB 337 Min Senate Third Reading By Kalra",69,7,0,4,80
1698947,1296990,2023-04-10,Senate,"Do pass, but first be re-referred to the Committee on [Health]",13,0,0,0,13
1698947,1313395,2023-04-26,Senate,"Do pass, but first be re-referred to the Committee on [Appropriations]",10,0,0,2,12
1698947,1320388,2023-05-08,Senate,"Placed on suspense file",7,0,0,0,7
1698947,1328495,2023-05-18,Senate,"Do pass",7,0,0,0,7
1698947,1330058,2023-05-22,Senate,"Senate 3rd Reading SB339 Wiener et al",40,0,0,0,40
1698947,1347946,2023-06-27,Assembly,"Do pass as amended and be re-referred to the Committee on [Business and Professions]",13,0,0,2,15
1698947,1350305,2023-07-11,Assembly,"Do pass and be re-referred to the Committee on [Appropriations]",17,0,0,2,19
1698947,1352770,2023-09-01,Assembly,"Do pass as amended",11,0,0,5,16
1698947,1363617,2024-01-08,Assembly,"SB 339 Wiener Senate Third Reading By Low Amendment Set #1",59,0,0,21,80
1698947,1366763,2024-01-18,Assembly,"SB 339 Wiener Third Reading Urgency By Low",68,0,0,12,80
1698947,1367511,2024-01-22,Senate,"Unfinished Business SB339 Wiener et al. Urgency Clause Concurrence",39,0,0,1,40
1698948,1288251,2023-03-29,Senate,"Do pass, but first be re-referred to the Committee on [Public Safety]",12,0,0,0,12
1698948,1310265,2023-04-25,Senate,"Do pass, but first be re-referred to the Committee on [Appropriations]",5,0,0,0,5
1698948,1320462,2023-05-08,Senate,"Placed on suspense file",7,0,0,0,7
1698948,1328558,2023-05-18,Senate,"Do pass",7,0,0,0,7
1698948,1333647,2023-05-25,Senate,"Special Consent SB340 Eggman et al",40,0,0,0,40
1698949,1281802,2023-03-21,Senate,"Do pass, but first be re-referred to the Committee on [Appropriations]",10,0,0,1,11
1698949,1330105,2023-05-22,Senate,"Senate 3rd Reading SB341 Becker",40,0,0,0,40
1698949,1340993,2023-06-07,Assembly,"Do pass and be re-referred to the Committee on [Appropriations]",8,0,0,0,8
1698949,1348468,2023-06-28,Assembly,"Do pass. To Consent Calendar",14,0,0,2,16
1698949,1353990,2023-09-12,Assembly,"SB 341 Becker Senate Third Reading By Ward",77,0,0,3,80
1698949,1354374,2023-09-13,Senate,"Unfinished Business SB341 Becker Concurrence",39,0,0,1,40
1698950,1288335,2023-03-29,Senate,"Do pass, but first be re-referred to the Committee on [Appropriations]",3,1,0,3,7
1698950,1288336,2023-03-29,Senate,"[First] hearing set for [03-29-2023]: Failed passage in Committee. Reconsideration granted",7,0,0,0,7
1698950,1311701,2023-04-26,Senate,"Do pass, but first be re-referred to the Committee on [Appropriations]",3,2,0,2,7
1698951,1288266,2023-03-28,Senate,"Do pass, but first be re-referred to the Committee on [Human Services]",10,0,0,1,11
1698951,1310408,2023-04-24,Senate,"Do pass, but first be re-referred to the Committee on [Appropriations]",5,0,0,0,5
1698951,1320446,2023-05-08,Senate,"Placed on suspense file",7,0,0,0,7
1698951,1328195,2023-05-18,Senate,"Do pass as amended",7,0,0,0,7
1698951,1332593,2023-05-24,Senate,"Senate 3rd Reading SB343 Skinner",40,0,0,0,40
1698951,1343773,2023-06-13,Assembly,"Do pass and be re-referred to the Committee on [Human Services]",11,0,0,0,11
1698951,1350267,2023-07-11,Assembly,"Do pass and be re-referred to the Committee on [Appropriations]",7,0,0,1,8
1698951,1353085,2023-09-01,Assembly,"Do pass",16,0,0,0,16
1698951,1353249,2023-09-06,Assembly,"SB 343 Skinner Senate Third Reading By Maienschein",79,0,0,1,80
1698951,1353466,2023-09-07,Senate,"Unfinished Business SB343 Skinner Concurrence",40,0,0,0,40
1698952,1288308,2023-03-29,Senate,"Do pass as amended, but first amend, and re-refer to the Committee on [Judiciary] with the recommendation: To Consent Calendar",12,0,0,0,12
1698952,1305512,2023-04-18,Senate,"Do pass as amended, but first amend, and re-refer to the Committee on [Appropriations] with the recommendation: To Consent Calendar",11,0,0,0,11
1698952,1315706,2023-05-01,Senate,"Placed on suspense file",6,0,0,1,7
1698952,1328262,2023-05-18,Senate,"Do pass",7,0,0,0,7
1698952,1333786,2023-05-25,Senate,"Special Consent SB344 Rubio",40,0,0,0,40
1698952,1347846,2023-06-27,Assembly,"Do pass and be re-referred to the Committee on [Appropriations] with recommendation: To Consent Calendar",15,0,0,0,15
1698952,1352869,2023-09-01,Assembly,"Do pass as amended",11,0,0,5,16
1698952,1353789,2023-09-12,Assembly,"SB 344 Rubio Senate Third Reading By Weber",79,0,0,1,80
1698952,1354088,2023-09-13,Senate,"Unfinished Business SB344 Rubio Concurrence",39,0,0,1,40
1698953,1304380,2023-04-18,Senate,"Do pass, but first be re-referred to the Committee on [Judiciary]",4,0,0,1,5
1698953,1311734,2023-04-25,Senate,"Do pass as amended, but first amend, and re-refer to the Committee on [Appropriations]",8,2,0,1,11
1698953,1320512,2023-05-08,Senate,"Placed on suspense file",7,0,0,0,7
1698953,1328687,2023-05-18,Senate,"Do pass as amended",5,2,0,0,7
1698953,1336365,2023-05-31,Senate,"Senate 3rd Reading SB345 Skinner et al",32,8,0,0,40
1698953,1349601,2023-07-05,Assembly,"Do pass and be re-referred to the Committee on [Public Safety]",8,2,0,1,11
1698953,1350240,2023-07-11,Assembly,"Do pass and be re-referred to the Committee on [Appropriations]",6,1,0,1,8
1698953,1352969,2023-09-01,Assembly,"Do pass as amended",11,4,0,1,16
1698953,1353227,2023-09-06,Assembly,"SB 345 Skinner Senate Third Reading By Wilson",62,15,0,3,80
1698953,1353462,2023-09-07,Senate,"Unfinished Business SB345 Skinner et al. Concurrence",32,8,0,0,40
1698954,1310389,2023-04-25,Senate,"Do pass, but first be re-referred to the Committee on [Appropriations] with the recommendation: To Consent Calendar",15,0,0,0,15
1698954,1323828,2023-05-11,Senate,"Consent Calendar SB346 Ochoa Bogh",39,0,0,1,40
1698955,1363956,2024-01-10,Senate,"Do pass, but first be re-referred to the Committee on [Appropriations]",7,0,0,0,7
1698955,1367506,2024-01-22,Senate,"Senate 3rd Reading SB347 Newman",39,0,0,1,40
1698955,1460772,2024-06-26,Assembly,"Do pass as amended",8,0,0,1,9
1698955,1464488,2024-08-15,Assembly,"SB 347 Newman Senate Third Reading By Juan Carrillo",75,0,0,4,79
1698955,1465932,2024-08-27,Senate,"That the Assembly amendments be concurred in",5,0,0,2,7
1698955,1466112,2024-08-29,Senate,"Unfinished Business SB347 Newman Concurrence",40,0,0,0,40
1698956,1320535,2023-05-08,Senate,"Senate 3rd Reading SCR20 Umberg et al",36,0,0,4,40
1698956,1328849,2023-05-18,Assembly,"Be adopted. To Consent Calendar",12,0,0,1,13
1698956,1333779,2023-05-25,Assembly,"SCR 20 Umberg Consent Calendar Second Day Regular Session",76,0,0,4,80
1698957,1255135,2023-02-17,Senate,"Senate 3rd Reading SR14 Becker",36,0,0,4,40
1700968,1274198,2023-03-13,Assembly,"Do pass and be re-referred to the Committee on [Appropriations]",11,0,0,0,11
1700968,1328848,2023-05-18,Assembly,"Do pass",15,0,0,1,16
1700968,1338028,2023-05-31,Assembly,"AB 527 Calderon Assembly Third Reading",79,0,0,1,80
1700968,1347929,2023-06-27,Senate,"Do pass as amended, but first amend, and re-refer to the Committee on [Appropriations]",11,0,0,0,11
1700968,1349903,2023-07-10,Senate,"Placed on suspense file",6,0,0,1,7
1700969,1310341,2023-04-25,Assembly,"Do pass and be re-referred to the Committee on [Appropriations] with recommendation: To Consent Calendar",16,0,0,2,18
1700969,1328458,2023-05-18,Assembly,"Do pass",15,0,0,1,16
1700969,1338191,2023-05-31,Assembly,"AB 528 Irwin Assembly Third Reading",79,0,0,1,80
1700969,1349904,2023-07-10,Senate,"Do pass, but first be re-referred to the Committee on [Appropriations]",10,0,0,3,13
1700969,1351782,2023-08-21,Senate,"Placed on suspense file",7,0,0,0,7
1700970,1288241,2023-03-29,Assembly,"Do pass as amended and be re-referred to the Committee on [Local Government]",8,0,0,0,8
1700970,1307866,2023-04-19,Assembly,"Do pass and be re-referred to the Committee on [Appropriations] with recommendation: To Consent Calendar",7,0,0,0,7
1700970,1328218,2023-05-18,Assembly,"Do pass",15,0,0,1,16
1700970,1338087,2023-05-31,Assembly,"AB 529 Gabriel Assembly Third Reading",79,0,0,1,80
1700970,1350196,2023-07-10,Senate,"Do pass, but first be re-referred to the Committee on [Appropriations]",11,0,0,0,11
1700970,1351466,2023-08-14,Senate,"Placed on suspense file",7,0,0,0,7
1700970,1352702,2023-09-01,Senate,"Do pass",7,0,0,0,7
1700970,1354142,2023-09-13,Senate,"Assembly 3rd Reading AB529 Gabriel et al. By Blakespear",39,0,0,1,40
1700970,1354757,2023-09-14,Assembly,"AB 529 Gabriel Concurrence in Senate Amendments",80,0,0,0,80
1700972,1288243,2023-03-29,Assembly,"Do pass and be re-referred to the Committee on [Military and Veterans Affairs]",8,0,0,0,8
1700972,1305509,2023-04-18,Assembly,"Do pass and be re-referred to the Committee on [Appropriations] with recommendation: To Consent Calendar",11,0,0,0,11
1700972,1328897,2023-05-18,Assembly,"Do pass",15,0,0,1,16
1700972,1335559,2023-05-30,Assembly,"AB 531 Irwin Assembly Third Reading",80,0,0,0,80
1700972,1350191,2023-07-10,Senate,"Do pass, but first be re-referred to the Committee on [Governance and Finance]",10,1,0,0,11
1700972,1350697,2023-07-12,Senate,"Do pass, but first be re-referred to the Committee on [Appropriations]",6,2,0,0,8
1700972,1352354,2023-08-28,Senate,"Placed on suspense file",7,0,0,0,7
1700972,1352843,2023-09-01,Senate,"Do pass",5,2,0,0,7
1700972,1354617,2023-09-14,Assembly,"With recommendation: That Senate amendments be concurred in",6,2,0,0,8
1700972,1354618,2023-09-14,Senate,"Assembly 3rd Reading AB531 Irwin et al. By Eggman",35,2,0,3,40
1700972,1354619,2023-09-14,Assembly,"AB 531 Irwin Concurrence in Senate Amendments",66,8,0,6,80
1700975,1280645,2023-03-21,Assembly,"Do pass. To Consent Calendar",11,0,0,0,11
1700975,1289831,2023-03-30,Assembly,"AB 534 McCarty Consent Calendar Second Day Regular Session",60,0,0,20,80
1700975,1345595,2023-06-20,Senate,"Do pass",11,0,0,0,11
1700975,1353173,2023-09-05,Senate,"Assembly 3rd Reading AB534 McCarty et al. By Ashby",39,0,0,1,40
1700976,1289800,2023-03-29,Assembly,"Do pass as amended, and be re-referred to the Committee on [Appropriations] with recommendation: To Consent Calendar",6,0,0,1,7
1700976,1328058,2023-05-18,Assembly,"Do pass",15,0,0,1,16
1700976,1337989,2023-05-31,Assembly,"AB 535 Irwin Assembly Third Reading",80,0,0,0,80
1700976,1346271,2023-06-21,Senate,"Do pass, but first be re-referred to the Committee on [Appropriations]",7,0,0,0,7
1700976,1349541,2023-07-03,Senate,"Placed on suspense file",7,0,0,0,7
1700976,1353036,2023-09-01,Senate,"Do pass",7,0,0,0,7
1700976,1466029,2024-08-27,Senate,"Do pass, but first be re-referred to the Committee on [Appropriations]",10,0,0,0,10
1700976,1466065,2024-08-28,Senate,"Do pass",7,0,0,0,7
1700976,1466545,2024-08-30,Senate,"Assembly 3rd Reading AB535 Schiavo et al. By Archuleta Urgency Clause",39,0,0,1,40
1700976,1467066,2024-08-31,Assembly,"AB 535 Schiavo Concurrence - Urgency Added",77,0,0,2,79
1700977,1274197,2023-03-13,Assembly,"Do pass. To Consent Calendar",11,0,0,0,11
1700977,1279209,2023-03-20,Assembly,"AB 536 Wilson Consent Calendar Second Day",78,0,0,2,80
1700977,1341031,2023-06-07,Senate,"Do pass and be ordered to the Consent Calendar",7,0,0,0,7
1700977,1344712,2023-06-15,Senate,"Consent Calendar AB536 Wilson et al",40,0,0,0,40
1700978,1298216,2023-04-11,Assembly,"Do pass as amended and be re-referred to the Committee on [Judiciary]",13,3,0,2,18
1700978,1304393,2023-04-18,Assembly,"Do pass as amended and be re-referred to the Committee on [Appropriations]",8,1,0,2,11
1700978,1328184,2023-05-18,Assembly,"Do pass as amended",11,3,0,2,16
1700978,1334440,2023-05-26,Assembly,"AB 537 Berman Assembly Third Reading",53,8,0,19,80
1700978,1348491,2023-06-27,Senate,"Do pass as amended, but first amend, and re-refer to the Committee on [Appropriations]",9,1,0,1,11
1700978,1351352,2023-08-14,Senate,"Placed on suspense file",7,0,0,0,7
1700978,1353082,2023-09-01,Senate,"Do pass as amended",5,2,0,0,7
1700978,1353835,2023-09-12,Senate,"Assembly 3rd Reading AB537 Berman et al. By Glazer",30,8,0,2,40
1700978,1354176,2023-09-13,Assembly,"AB 537 Berman Concurrence in Senate Amendments",62,4,0,14,80
1700979,1313344,2023-04-26,Assembly,"Do pass as amended and be re-referred to the Committee on [Appropriations]",12,0,0,3,15
1700982,1278559,2023-03-14,Assembly,"Do pass and be re-referred to the Committee on [Appropriations] with recommendation: To Consent Calendar",9,0,0,0,9
1700982,1305248,2023-04-19,Assembly,"Do pass. To Consent Calendar",14,0,0,2,16
1700982,1313497,2023-04-27,Assembly,"AB 541 Wood Consent Calendar Second Day Regular Session",79,0,0,1,80
1700982,1340976,2023-06-07,Senate,"Do pass as amended, but first amend, and re-refer to the Committee on [Appropriations]",7,0,0,0,7
1700982,1354033,2023-09-12,Senate,"Assembly 3rd Reading AB541 Wood By Dahle",38,0,0,2,40
1700982,1354110,2023-09-13,Assembly,"AB 541 Wood Concurrence in Senate Amendments",80,0,0,0,80
1700983,1275542,2023-03-14,Assembly,"Do pass as amended",11,0,0,0,11
1700983,1315709,2023-05-01,Assembly,"AB 542 Juan Carrillo Assembly Third Reading",78,0,0,2,80
1700983,1343788,2023-06-13,Senate,"Do pass as amended",9,0,0,2,11
1700983,1353311,2023-09-06,Senate,"Assembly 3rd Reading AB542 Juan Carrillo By Umberg",40,0,0,0,40
1700983,1353640,2023-09-11,Assembly,"AB 542 Juan Carrillo Concurrence in Senate Amendments",79,0,0,1,80
1700984,1317051,2023-05-01,Assembly,"Do pass and be re-referred to the Committee on [Appropriations]",11,0,0,0,11
1700984,1328028,2023-05-18,Assembly,"Do pass",15,0,0,1,16
1700984,1333820,2023-05-25,Assembly,"AB 543 Gipson Assembly Third Reading",73,0,0,7,80
1700984,1346226,2023-06-21,Senate,"Do pass, but first be re-referred to the Committee on [Appropriations]",4,2,0,2,8
1700984,1346227,2023-06-21,Senate,"[First] hearing set for [06-21-2023]: Failed passage in Committee. Reconsideration granted",8,0,0,0,8
1700984,1349770,2023-07-05,Senate,"Do pass, but first be re-referred to the Committee on [Appropriations]",6,1,0,1,8
1700984,1351304,2023-08-14,Senate,"Placed on suspense file",7,0,0,0,7
1700984,1352737,2023-09-01,Senate,"Do pass",7,0,0,0,7
1700984,1354730,2023-09-11,Senate,"Assembly 3rd Reading AB543 Gipson Glazer",28,5,0,7,40
1700985,1305293,2023-04-19,Assembly,"Do pass and be re-referred to the Committee on [Appropriations]",6,2,0,0,8
1700985,1366779,2024-01-18,Assembly,"Do pass as amended",12,3,0,1,16
1700985,1371110,2024-01-29,Assembly,"AB 544 Bryan Assembly Third Reading",53,14,0,13,80
1700985,1458176,2024-06-18,Senate,"Do pass as amended, but first amend, and re-refer to the Committee on [Public Safety]",6,1,0,0,7
1700985,1462210,2024-07-02,Senate,"Do pass, but first be re-referred to the Committee on [Appropriations]",4,1,0,0,5
1700985,1463897,2024-08-12,Senate,"Placed on suspense file",7,0,0,0,7
1700985,1464237,2024-08-15,Senate,"Do pass",5,2,0,0,7
1700985,1466516,2024-08-30,Senate,"Assembly 3rd Reading AB544 Bryan et al. By Glazer",30,10,0,0,40
1700985,1466987,2024-08-31,Assembly,"AB 544 Bryan Concurrence in Senate Amendments",56,15,0,8,79
1700986,1276608,2023-03-15,Assembly,"Do pass and be re-referred to the Committee on [Appropriations]",5,0,0,3,8
1700986,1328371,2023-05-18,Assembly,"Do pass",13,2,0,1,16
1700986,1338183,2023-05-31,Assembly,"AB 545 Pellerin Assembly Third Reading",67,6,0,7,80
1700986,1345585,2023-06-20,Senate,"Do pass, but first be re-referred to the Committee on [Appropriations]",6,0,0,1,7
1700986,1349453,2023-07-03,Senate,"Placed on suspense file",7,0,0,0,7
1700986,1353087,2023-09-01,Senate,"Do pass",5,2,0,0,7
1700986,1353203,2023-09-06,Senate,"Assembly 3rd Reading AB545 Pellerin",33,3,0,4,40
1700987,1281807,2023-03-22,Assembly,"Do pass and be re-referred to the Committee on [Appropriations] with recommendation: To Consent Calendar",20,0,0,2,22
1700987,1326938,2023-05-17,Assembly,"Do pass. To Consent Calendar",15,0,0,1,16
1700987,1333699,2023-05-25,Assembly,"AB 546 Villapudua Consent Calendar Second Day Regular Session",76,0,0,4,80
1700987,1347925,2023-06-27,Senate,"Do pass, but first be re-referred to the Committee on [Appropriations] with the recommendation: To Consent Calendar",15,0,0,0,15
1700987,1353453,2023-09-07,Senate,"Assembly 3rd Reading AB546 Villapudua By Wilk",40,0,0,0,40
1700987,1353693,2023-09-11,Assembly,"AB 546 Villapudua Concurrence in Senate Amendments",80,0,0,0,80
1700989,1299390,2023-04-12,Assembly,"Do pass as amended and be re-referred to the Committee on [Appropriations]",6,0,0,2,8
1700989,1328435,2023-05-18,Assembly,"Do pass",11,3,0,2,16
1700989,1337961,2023-05-31,Assembly,"AB 548 Boerner Assembly Third Reading",57,17,0,6,80
1700989,1346249,2023-06-20,Senate,"Do pass as amended, but first amend, and re-refer to the Committee on [Appropriations]",9,1,0,1,11
1700989,1349518,2023-07-03,Senate,"Placed on suspense file",7,0,0,0,7
1700989,1352773,2023-09-01,Senate,"Do pass as amended",5,2,0,0,7
1700989,1353867,2023-09-12,Assembly,"AB 548 Boerner Concurrence in Senate Amendments",59,16,0,5,80
1700989,1354641,2023-09-11,Senate,"Assembly 3rd Reading AB548 Boerner et al. By Blakespear",30,9,0,1,40
1700990,1280610,2023-03-21,Assembly,"Do pass and be re-referred to the Committee on [Appropriations]",8,1,0,2,11
1700991,1305345,2023-04-19,Assembly,"Do pass and be re-referred to the Committee on [Appropriations] with recommendation: To Consent Calendar",8,0,0,0,8
1700992,1304254,2023-04-18,Assembly,"Do pass and be re-referred to the Committee on [Health]",7,0,0,1,8
1700992,1310161,2023-04-25,Assembly,"Do pass as amended, and be re-referred to the Committee on [Appropriations] with recommendation: To Consent Calendar",15,0,0,0,15
1700992,1326942,2023-05-17,Assembly,"Do pass. To Consent Calendar",15,0,0,1,16
1700992,1333802,2023-05-25,Assembly,"AB 551 Bennett Consent Calendar Second Day Regular Session",76,0,0,4,80
1700992,1346184,2023-06-21,Senate,"Do pass, but first be re-referred to the Committee on [Human Services] with the recommendation: To Consent Calendar",12,0,0,0,12
1700992,1349569,2023-07-03,Senate,"Do pass, but first be re-referred to the Committee on [Appropriations] with the recommendation: To Consent Calendar",5,0,0,0,5
1700992,1462299,2024-07-02,Senate,"Do pass as amended, but first amend, and re-refer to the Committee on [Appropriations]",18,0,0,0,18
1700992,1463501,2024-08-05,Senate,"Placed on suspense file",7,0,0,0,7
1700992,1464156,2024-08-15,Senate,"Do pass as amended",7,0,0,0,7
1700992,1466483,2024-08-30,Senate,"Assembly 3rd Reading AB551 Bennett By Becker",40,0,0,0,40
1700992,1467054,2024-08-31,Assembly,"AB 551 Bennett Concurrence in Senate Amendments",75,0,0,4,79
1700993,1276612,2023-03-15,Assembly,"Do pass and be re-referred to the Committee on [Appropriations]",8,0,0,3,11
1700993,1328727,2023-05-18,Assembly,"Do pass as amended",15,0,0,1,16
1700993,1337911,2023-05-31,Assembly,"AB 552 Bennett Assembly Third Reading",80,0,0,0,80
1700993,1349445,2023-07-03,Senate,"Do pass, but first be re-referred to the Committee on [Natural Resources and Water]",3,0,0,1,4
1700993,1349977,2023-07-10,Senate,"Do pass as amended, but first amend, and re-refer to the Committee on [Appropriations]",7,3,0,1,11
1700993,1351775,2023-08-21,Senate,"Placed on suspense file",7,0,0,0,7
1700993,1352861,2023-09-01,Senate,"Do pass",5,2,0,0,7
1700993,1353924,2023-09-12,Senate,"Assembly 3rd Reading AB552 Bennett et al. By Becker",34,3,0,3,40
1700993,1354261,2023-09-13,Assembly,"AB 552 Bennett Concurrence in Senate Amendments",71,0,0,9,80
1700994,1299469,2023-04-12,Assembly,"Do pass and be re-referred to the Committee on [Appropriations] with recommendation: To Consent Calendar",19,0,0,3,22
1700994,1328020,2023-05-18,Assembly,"Do pass",15,0,0,1,16
1700994,1337955,2023-05-31,Assembly,"AB 553 Ramos Assembly Third Reading",80,0,0,0,80
1700994,1350281,2023-07-11,Senate,"Do pass, but first be re-referred to the Committee on [Appropriations] with the recommendation: To Consent Calendar",14,0,0,1,15
1700994,1351519,2023-08-14,Senate,"Placed on suspense file",7,0,0,0,7
1700994,1352802,2023-09-01,Senate,"Do pass as amended",7,0,0,0,7
1700994,1354368,2023-09-13,Senate,"Special Consent AB553 Ramos et al",39,0,0,1,40
1700994,1354711,2023-09-14,Assembly,"AB 553 Ramos Concurrence in Senate Amendments",80,0,0,0,80
1700995,1275559,2023-03-14,Assembly,"Do pass as amended and be re-referred to the Committee on [Banking and Finance]",11,0,0,0,11
1700995,1310395,2023-04-24,Assembly,"Do pass",9,0,0,3,12
1700996,1286941,2023-03-28,Assembly,"Do pass as amended and be re-referred to the Committee on [Education]",8,0,0,0,8
1700996,1313329,2023-04-26,Assembly,"Do pass as amended and be re-referred to the Committee on [Appropriations]",7,0,0,0,7
1700996,1328310,2023-05-18,Assembly,"Do pass",15,0,0,1,16
1700996,1338160,2023-05-31,Assembly,"AB 555 Juan Carrillo Assembly Third Reading",80,0,0,0,80
1700996,1349643,2023-07-05,Senate,"Do pass as amended, but first amend, and re-refer to the Committee on [Appropriations]",7,0,0,0,7
1700996,1351427,2023-08-14,Senate,"Placed on suspense file",7,0,0,0,7
1700997,1310291,2023-04-24,Assembly,"Do pass as amended and be re-referred to the Committee on [Appropriations]",11,0,0,0,11
1700997,1328801,2023-05-18,Assembly,"Do pass",15,0,0,1,16
1700997,1338062,2023-05-31,Assembly,"AB 556 Gallagher Third Reading Urgency",80,0,0,0,80
1700997,1346252,2023-06-21,Senate,"Do pass, but first be re-referred to the Committee on [Appropriations] with the recommendation: To Consent Calendar",8,0,0,0,8
1700997,1349488,2023-07-03,Senate,"Placed on suspense file",7,0,0,0,7
1700997,1352499,2023-09-01,Senate,"Do pass",7,0,0,0,7
1700997,1353737,2023-09-12,Senate,"Special Consent AB556 Gallagher By Dahle Urgency Clause",39,0,0,1,40
1700998,1313408,2023-04-26,Assembly,"Do pass",8,0,0,0,8
1700998,1324941,2023-05-15,Assembly,"AB 557 Hart Assembly Third Reading",78,0,0,2,80
1700998,1341021,2023-06-07,Senate,"Do pass, but first be re-referred to the Committee on [Judiciary]",8,0,0,0,8
1700998,1348330,2023-06-27,Senate,"Do pass",11,0,0,0,11
1700998,1353385,2023-09-07,Senate,"Assembly 3rd Reading AB557 Hart et al. By Ashby",40,0,0,0,40
1700998,1353590,2023-09-11,Assembly,"AB 557 Hart Concurrence in Senate Amendments",79,0,0,1,80
1701000,1280611,2023-03-20,Assembly,"Do pass and be re-referred to the Committee on [Appropriations]",11,0,0,0,11
1701000,1288177,2023-03-29,Assembly,"Do pass. To Consent Calendar",14,0,0,2,16
1701000,1302648,2023-04-17,Assembly,"AB 559 Boerner Horvath Consent Calendar Second Day Regular Session",79,0,0,1,80
1701000,1341000,2023-06-07,Senate,"Do pass, but first be re-referred to the Committee on [Appropriations] with the recommendation: To Consent Calendar",8,0,0,0,8
1701000,1348845,2023-06-29,Senate,"Consent Calendar AB559 Boerner et al",39,0,0,1,40
1701001,1286977,2023-03-28,Assembly,"Do pass and be re-referred to the Committee on [Judiciary]",9,4,0,2,15
1701001,1298276,2023-04-11,Assembly,"Do pass as amended and be re-referred to the Committee on [Appropriations]",7,2,0,2,11
1701001,1327992,2023-05-18,Assembly,"Do pass as amended",11,4,0,1,16
1701001,1338200,2023-05-31,Assembly,"AB 560 Bennett Assembly Third Reading",48,19,0,13,80
1701001,1346947,2023-06-22,Senate,"Do pass, but first be re-referred to the Committee on [Judiciary]",6,3,0,2,11
1701001,1350476,2023-07-11,Senate,"Do pass, but first be re-referred to the Committee on [Appropriations]",8,2,0,1,11
1701001,1351396,2023-08-14,Senate,"Placed on suspense file",7,0,0,0,7
1701002,1275525,2023-03-14,Assembly,"Do pass as amended, and be re-referred to the Committee on [Public Safety] with recommendation: To Consent Calendar",11,0,0,0,11
1701003,1281873,2023-03-22,Assembly,"Do pass and be re-referred to the Committee on [Appropriations]",8,0,0,0,8
1701003,1305314,2023-04-19,Assembly,"Do pass. To Consent Calendar",14,0,0,2,16
1701003,1313318,2023-04-27,Assembly,"AB 562 Wendy Carrillo Consent Calendar Second Day Regular Session",79,0,0,1,80
1701003,1344208,2023-06-14,Senate,"Do pass, but first be re-referred to the Committee on [Appropriations] with the recommendation: To Consent Calendar",8,0,0,0,8
1701003,1348896,2023-06-29,Senate,"Consent Calendar AB562 Wendy Carrillo",39,0,0,1,40
1701005,1298225,2023-04-11,Assembly,"Do pass and be re-referred to the Committee on [Appropriations] with recommendation: To Consent Calendar",15,0,0,0,15
1701005,1328074,2023-05-18,Assembly,"Do pass",15,0,0,1,16
1701005,1337912,2023-05-31,Assembly,"AB 564 Villapudua Assembly Third Reading",80,0,0,0,80
1701006,1288150,2023-03-28,Assembly,"Do pass. To Consent Calendar",9,0,0,0,9
1701006,1302603,2023-04-17,Assembly,"AB 565 Lee Consent Calendar Second Day Regular Session",79,0,0,1,80
1701007,1308851,2023-04-24,Assembly,"Do pass as amended and be re-referred to the Committee on [Appropriations]",11,3,0,1,15
1701008,1286896,2023-03-28,Assembly,"Do pass as amended, and be re-referred to the Committee on [Appropriations] with recommendation: To Consent Calendar",8,0,0,0,8
1701008,1327971,2023-05-18,Assembly,"Do pass",15,0,0,1,16
1701008,1333760,2023-05-25,Assembly,"AB 567 Ting Assembly Third Reading",76,0,0,4,80
1701008,1345625,2023-06-20,Senate,"Do pass, but first be re-referred to the Committee on [Appropriations]",5,0,0,0,5
1701008,1349504,2023-07-03,Senate,"Placed on suspense file",7,0,0,0,7
1701008,1352912,2023-09-01,Senate,"Do pass as amended",6,0,0,1,7
1701008,1353334,2023-09-06,Senate,"Assembly 3rd Reading AB567 Ting et al. By Durazo",40,0,0,0,40
1701008,1353430,2023-09-07,Assembly,"AB 567 Ting Concurrence in Senate Amendments",79,0,0,1,80
1701010,1288204,2023-03-28,Assembly,"Do pass and be re-referred to the Committee on [Higher Education]",11,0,0,0,11
1701010,1311751,2023-04-25,Assembly,"Do pass and be re-referred to the Committee on [Appropriations] with recommendation: To Consent Calendar",12,0,0,0,12
1701010,1328831,2023-05-18,Assembly,"Do pass",15,0,0,1,16
1701010,1337965,2023-05-31,Assembly,"AB 569 Garcia Assembly Third Reading",80,0,0,0,80
1701010,1348295,2023-06-28,Senate,"Do pass, but first be re-referred to the Committee on [Appropriations] with the recommendation: To Consent Calendar",7,0,0,0,7
1701010,1350652,2023-07-13,Senate,"Consent Calendar AB569 Garcia",37,0,0,3,40
1701011,1274186,2023-03-13,Assembly,"Do pass and be re-referred to the Committee on [Appropriations] with recommendation: To Consent Calendar",7,0,0,0,7
1701011,1305343,2023-04-19,Assembly,"Do pass as amended. To Consent Calendar",14,0,0,2,16
1701011,1313364,2023-04-27,Assembly,"AB 570 Gallagher Consent Calendar Second Day Regular Session",79,0,0,1,80
1701011,1343723,2023-06-13,Senate,"Do pass, but first be re-referred to the Committee on [Appropriations]",14,0,0,1,15
1701011,1353364,2023-09-07,Senate,"Assembly 3rd Reading AB570 Gallagher By Niello",40,0,0,0,40
1701012,1299448,2023-04-12,Assembly,"Do pass and be re-referred to the Committee on [Judiciary]",10,2,0,2,14
1701012,1304388,2023-04-18,Assembly,"Do pass and be re-referred to the Committee on [Appropriations]",8,3,0,0,11
1701012,1328005,2023-05-18,Assembly,"Do pass",11,4,0,1,16
1701012,1337994,2023-05-31,Assembly,"AB 571 Petrie-Norris Assembly Third Reading",63,14,0,3,80
1701012,1348395,2023-06-28,Senate,"Do pass as amended, but first amend, and re-refer to the Committee on [Judiciary]",4,2,0,1,7
1701012,1350532,2023-07-11,Senate,"Do pass, but first be re-referred to the Committee on [Appropriations]",9,2,0,0,11
1701012,1351809,2023-08-21,Senate,"Placed on suspense file",7,0,0,0,7
1701012,1352722,2023-09-01,Senate,"Do pass as amended",5,2,0,0,7
1701012,1353962,2023-09-12,Senate,"Assembly 3rd Reading AB571 Petrie-Norris et al. By Becker",31,7,0,2,40
1701012,1354130,2023-09-13,Assembly,"AB 571 Petrie-Norris Concurrence in Senate Amendments",64,14,0,2,80
1701013,1311794,2023-04-26,Assembly,"Do pass",5,1,0,2,8
1701013,1337200,2023-06-01,Assembly,"AB 572 Haney Assembly Third Reading",55,18,0,7,80
1701013,1346135,2023-06-20,Senate,"Do pass, but first be re-referred to the Committee on [Judiciary]",7,2,0,2,11
1701013,1349760,2023-07-06,Senate,"Do pass as amended",9,2,0,0,11
1701013,1354370,2023-09-13,Senate,"Assembly 3rd Reading AB572 Haney et al. By Skinner",30,8,0,2,40
1701013,1354371,2023-09-13,Assembly,"AB 572 Haney Concurrence in Senate Amendments",59,14,0,7,80
1701014,1301994,2023-04-10,Assembly,"Do pass and be re-referred to the Committee on [Appropriations] with recommendation: To Consent Calendar",11,0,0,0,11
1701014,1328477,2023-05-18,Assembly,"Do pass as amended",11,0,0,5,16
1701014,1337913,2023-05-31,Assembly,"AB 573 Garcia Assembly Third Reading",80,0,0,0,80
1701014,1350457,2023-07-12,Senate,"Do pass as amended, but first amend, and re-refer to the Committee on [Appropriations] with the recommendation: To Consent Calendar",7,0,0,0,7
1701014,1351398,2023-08-14,Senate,"Placed on suspense file",7,0,0,0,7
1701015,1299456,2023-04-11,Assembly,"Do pass and be re-referred to the Committee on [Appropriations]",7,0,0,1,8
1701015,1328067,2023-05-18,Assembly,"Do pass",11,2,0,3,16
1701015,1338110,2023-05-31,Assembly,"AB 574 Jones-Sawyer Assembly Third Reading",58,13,0,9,80
1701015,1350134,2023-07-11,Senate,"Do pass, but first be re-referred to the Committee on [Appropriations]",3,0,0,2,5
1701015,1351338,2023-08-14,Senate,"Placed on suspense file",7,0,0,0,7
1701015,1352673,2023-09-01,Senate,"Do pass as amended",5,2,0,0,7
1701015,1354178,2023-09-13,Senate,"Assembly 3rd Reading AB574 Jones-Sawyer By Ashby",27,9,0,4,40
1701015,1354179,2023-09-13,Assembly,"AB 574 Jones-Sawyer Concurrence in Senate Amendments",59,16,0,5,80
1701016,1299509,2023-04-12,Assembly,"Do pass and be re-referred to the Committee on [Appropriations]",13,0,0,1,14
1701016,1328080,2023-05-18,Assembly,"Do pass",15,0,0,1,16
1701016,1338144,2023-05-31,Assembly,"AB 575 Papan Assembly Third Reading",79,0,0,1,80
1701016,1348458,2023-06-28,Senate,"Do pass as amended, but first amend, and re-refer to the Committee on [Appropriations]",5,0,0,0,5
1701016,1351761,2023-08-21,Senate,"Placed on suspense file",7,0,0,0,7
1701016,1352523,2023-09-01,Senate,"Do pass as amended",7,0,0,0,7
1701016,1353965,2023-09-12,Senate,"Assembly 3rd Reading AB575 Papan et al. By Ashby",38,0,0,2,40
1701016,1354128,2023-09-13,Assembly,"AB 575 Papan Concurrence in Senate Amendments",80,0,0,0,80
1701017,1298284,2023-04-11,Assembly,"Do pass and be re-referred to the Committee on [Appropriations]",10,4,0,1,15
1701017,1328910,2023-05-18,Assembly,"Do pass",11,4,0,1,16
1701017,1338193,2023-05-31,Assembly,"AB 576 Weber Assembly Third Reading",62,16,0,2,80
1701017,1348860,2023-06-28,Senate,"Do pass, but first be re-referred to the Committee on [Appropriations]",10,0,0,2,12
1701017,1349912,2023-07-10,Senate,"Placed on suspense file",6,0,0,1,7
1701017,1352803,2023-09-01,Senate,"Do pass",5,2,0,0,7
1701017,1354554,2023-09-11,Senate,"Assembly 3rd Reading AB576 Weber et al. By Ashby",30,8,0,2,40
1701019,1288303,2023-03-29,Assembly,"Do pass and be re-referred to the Committee on [Appropriations] with recommendation: To Consent Calendar",8,0,0,0,8
1701019,1328522,2023-05-18,Assembly,"Do pass as amended",11,0,0,5,16
1701019,1337976,2023-05-31,Assembly,"AB 578 Berman Assembly Third Reading",80,0,0,0,80
1701019,1350322,2023-07-10,Senate,"Do pass, but first be re-referred to the Committee on [Appropriations] with the recommendation: To Consent Calendar",11,0,0,0,11
1701019,1351783,2023-08-21,Senate,"Placed on suspense file",7,0,0,0,7
1701020,1289776,2023-03-29,Assembly,"Do pass and be re-referred to the Committee on [Appropriations]",5,2,0,0,7
1701020,1328066,2023-05-18,Assembly,"Do pass",11,3,0,2,16
1701020,1337986,2023-05-31,Assembly,"AB 579 Ting Assembly Third Reading",61,14,0,5,80
1701020,1348430,2023-06-28,Senate,"Do pass as amended, but first amend, and re-refer to the Committee on [Appropriations]",6,1,0,0,7
1701020,1351473,2023-08-14,Senate,"Placed on suspense file",7,0,0,0,7
1701020,1352768,2023-09-01,Senate,"Do pass",5,2,0,0,7
1701020,1353873,2023-09-12,Assembly,"AB 579 Ting Concurrence in Senate Amendments",63,11,0,6,80
1701020,1354509,2023-09-11,Senate,"Assembly 3rd Reading AB579 Ting By Newman",31,8,0,1,40
1701021,1288373,2023-03-29,Senate,"Do pass, but first be re-referred to the Committee on [Human Services]",7,0,0,0,7
1701021,1304385,2023-04-17,Senate,"Do pass, but first be re-referred to the Committee on [Appropriations]",4,0,0,1,5
1701021,1315783,2023-05-01,Senate,"Placed on suspense file",6,0,0,1,7
1701021,1328089,2023-05-18,Senate,"Do pass as amended",7,0,0,0,7
1701021,1335593,2023-05-30,Senate,"Special Consent SB348 Skinner et al",40,0,0,0,40
1701021,1348879,2023-06-28,Assembly,"Do pass as amended and be re-referred to the Committee on [Human Services]",7,0,0,0,7
1701021,1350315,2023-07-11,Assembly,"Do pass and be re-referred to the Committee on [Appropriations] with recommendation: To Consent Calendar",7,0,0,1,8
1701021,1352536,2023-09-01,Assembly,"Do pass as amended",11,0,0,5,16
1701021,1353252,2023-09-06,Assembly,"SB 348 Skinner Senate Third Reading By Blanca Rubio",79,0,0,1,80
1701021,1353421,2023-09-07,Senate,"Unfinished Business SB348 Skinner et al. Concurrence",40,0,0,0,40
1701022,1288339,2023-03-28,Senate,"Do pass as amended, but first amend, and re-refer to the Committee on [Appropriations]",5,0,0,0,5
1701022,1302665,2023-04-17,Senate,"Placed on suspense file",6,0,0,1,7
1701022,1328053,2023-05-18,Senate,"Do pass as amended",7,0,0,0,7
1701022,1336345,2023-05-31,Senate,"Senate 3rd Reading SB349 Roth",38,1,0,1,40
1701023,1299394,2023-04-12,Senate,"Do pass, but first be re-referred to the Committee on [Appropriations] with the recommendation: To Consent Calendar",7,0,0,0,7
1701023,1308852,2023-04-24,Senate,"Placed on suspense file",7,0,0,0,7
1701023,1328212,2023-05-18,Senate,"Do pass as amended",7,0,0,0,7
1701023,1335492,2023-05-30,Senate,"Special Consent SB350 Ashby et al",40,0,0,0,40
1701023,1348877,2023-06-28,Assembly,"Do pass as amended and be re-referred to the Committee on [Appropriations]",7,0,0,0,7
1701023,1352796,2023-09-01,Assembly,"Do pass",16,0,0,0,16
1701023,1353621,2023-09-11,Assembly,"SB 350 Ashby Senate Third Reading By Aguiar-Curry",80,0,0,0,80
1701023,1354030,2023-09-12,Senate,"Unfinished Business SB350 Ashby et al. Concurrence",39,0,0,1,40
1701025,1300988,2023-04-12,Senate,"Do pass, but first be re-referred to the Committee on [Housing]",4,1,0,0,5
1701025,1310312,2023-04-24,Senate,"Do pass, but first be re-referred to the Committee on [Appropriations]",10,1,0,0,11
1701025,1320471,2023-05-08,Senate,"Placed on suspense file",7,0,0,0,7
1701026,1288337,2023-03-29,Senate,"Do pass as amended, but first amend, and re-refer to the Committee on [Appropriations]",5,0,0,2,7
1701026,1302680,2023-04-17,Senate,"Placed on suspense file",6,0,0,1,7
1701026,1328299,2023-05-18,Senate,"Do pass",5,1,0,1,7
1701026,1336340,2023-05-31,Senate,"Senate 3rd Reading SB353 Dodd et al. Urgency Clause",32,8,0,0,40
1701026,1350780,2023-07-10,Assembly,"Do pass and be re-referred to the Committee on [Appropriations]",11,0,0,0,11
1701026,1352545,2023-09-01,Assembly,"Do pass",13,3,0,0,16
1701026,1354850,2023-09-14,Senate,"Unfinished Business SB353 Dodd et al. Urgency Clause Concurrence",32,8,0,0,40
1701026,1354851,2023-09-14,Assembly,"SB 353 Dodd Third Reading Urgency By Kalra",67,6,0,7,80
1701027,1311847,2023-04-26,Senate,"Do pass, but first be re-referred to the Committee on [Appropriations] with the recommendation: To Consent Calendar",7,0,0,0,7
1701027,1320519,2023-05-08,Senate,"Placed on suspense file",7,0,0,0,7
1701027,1328819,2023-05-18,Senate,"Do pass as amended",7,0,0,0,7
1701027,1335466,2023-05-30,Senate,"Special Consent SB354 Ochoa Bogh",40,0,0,0,40
1701027,1348820,2023-06-28,Assembly,"Do pass and be re-referred to the Committee on [Appropriations] with recommendation: To Consent Calendar",7,0,0,0,7
1701027,1352571,2023-09-01,Assembly,"Do pass as amended",15,0,0,1,16
1701027,1353378,2023-09-07,Assembly,"SB 354 Ochoa Bogh Senate Third Reading By Gallagher",79,0,0,1,80
1701027,1354207,2023-09-13,Senate,"Unfinished Business SB354 Ochoa Bogh Concurrence",39,0,0,1,40
1701028,1310199,2023-04-24,Senate,"Do pass as amended, but first amend, and re-refer to the Committee on [Appropriations]",14,2,0,2,18
1701028,1324934,2023-05-15,Senate,"Placed on suspense file",7,0,0,0,7
1701028,1328619,2023-05-18,Senate,"Do pass as amended",5,2,0,0,7
1701028,1332657,2023-05-24,Senate,"Senate 3rd Reading SB355 Eggman",32,7,0,1,40
1701028,1348317,2023-06-28,Assembly,"Do pass and be re-referred to the Committee on [Appropriations]",13,0,0,2,15
1701028,1351592,2023-08-16,Assembly,"Do pass",14,1,0,1,16
1701028,1353658,2023-09-11,Assembly,"SB 355 Eggman Senate Third Reading By Soria",73,0,0,7,80
1701028,1353848,2023-09-12,Senate,"Unfinished Business SB355 Eggman et al. Concurrence",31,8,0,1,40
1701029,1305214,2023-04-18,Senate,"Do pass as amended, but first amend, and re-refer to the Committee on [Appropriations]",10,0,0,1,11
1701029,1315751,2023-05-01,Senate,"Placed on suspense file",6,0,0,1,7
1701030,1299431,2023-04-11,Senate,"Do pass, but first be re-referred to the Committee on [Judiciary]",15,0,0,1,16
1701030,1311928,2023-04-25,Senate,"Do pass as amended, but first amend, and re-refer to the Committee on [Appropriations]",11,0,0,0,11
1701030,1324933,2023-05-15,Senate,"Placed on suspense file",7,0,0,0,7
1701030,1328428,2023-05-18,Senate,"Do pass",7,0,0,0,7
1701030,1332577,2023-05-24,Senate,"Senate 3rd Reading SB357 Portantino et al",39,0,0,1,40
1701030,1347797,2023-06-26,Assembly,"Do pass and be re-referred to the Committee on [Judiciary]",15,0,0,0,15
1701030,1349657,2023-07-05,Assembly,"Do pass and be re-referred to the Committee on [Appropriations]",9,0,0,2,11
1701030,1352498,2023-09-01,Assembly,"Do pass",14,0,0,2,16
1701030,1463834,2024-08-12,Assembly,"SB 357 Portantino Senate Third Reading By Davies",68,0,0,11,79
1701030,1465434,2024-08-22,Senate,"Special Consent SB357 Portantino et al",33,0,0,7,40
1701032,1304326,2023-04-18,Senate,"Do pass, but first be re-referred to the Committee on [Appropriations] with the recommendation: To Consent Calendar",5,0,0,0,5
1701032,1318918,2023-05-04,Senate,"Consent Calendar SB359 Umberg",37,0,0,3,40
1701032,1348456,2023-06-27,Assembly,"Do pass and be re-referred to the Committee on [Appropriations]",2,3,0,3,8
1701032,1462267,2024-07-01,Assembly,"Do pass and be re-referred to the Committee on [Appropriations]",15,0,0,0,15
1701033,1298232,2023-04-11,Senate,"Do pass as amended",11,0,0,0,11
1701033,1320377,2023-05-08,Senate,"Senate 3rd Reading SB360 Blakespear",36,0,0,4,40
1701033,1343117,2023-06-12,Assembly,"Do pass as amended. To Consent Calendar",10,0,0,1,11
1701033,1346936,2023-06-22,Assembly,"SB 360 Blakespear Consent Calendar Second Day",71,0,0,9,80
1701033,1349771,2023-07-06,Senate,"Special Consent SB360 Blakespear",40,0,0,0,40
1701034,1286929,2023-03-28,Senate,"Do pass as amended, but first amend, and re-refer to the Committee on [Appropriations]",10,0,0,1,11
1701034,1302571,2023-04-17,Senate,"Placed on suspense file",6,0,0,1,7
1701035,1311877,2023-04-25,Senate,"Do pass as amended, but first amend, and re-refer to the Committee on [Appropriations]",9,2,0,0,11
1701035,1320417,2023-05-08,Senate,"Placed on suspense file",7,0,0,0,7
1701035,1328242,2023-05-18,Senate,"Do pass as amended",5,2,0,0,7
1701035,1336379,2023-05-31,Senate,"Senate 3rd Reading SB362 Becker et al",32,8,0,0,40
1701035,1347844,2023-06-27,Assembly,"Do pass as amended and be re-referred to the Committee on [Judiciary]",7,0,0,4,11
1701035,1352707,2023-09-01,Assembly,"Do pass as amended",10,3,0,3,16
1701035,1354372,2023-09-13,Assembly,"SB 362 Becker Senate Third Reading By Gabriel",52,14,0,14,80
1701035,1354831,2023-09-14,Senate,"Unfinished Business SB362 Becker et al. Concurrence",31,9,0,0,40
1701036,1281860,2023-03-22,Senate,"Do pass, but first be re-referred to the Committee on [Judiciary]",11,0,0,1,12
1701036,1299528,2023-04-11,Senate,"Do pass, but first be re-referred to the Committee on [Appropriations]",10,0,0,1,11
1701036,1308859,2023-04-24,Senate,"Placed on suspense file",7,0,0,0,7
1701036,1328909,2023-05-18,Senate,"Do pass as amended",7,0,0,0,7
1701036,1332644,2023-05-24,Senate,"Senate 3rd Reading SB363 Eggman et al",40,0,0,0,40
1701036,1343734,2023-06-13,Assembly,"Do pass and be re-referred to the Committee on [Appropriations] with recommendation: To Consent Calendar",15,0,0,0,15
1701038,1299453,2023-04-11,Senate,"Do pass, but first be re-referred to the Committee on [Appropriations]",8,2,0,1,11
1701038,1308823,2023-04-24,Senate,"Placed on suspense file",7,0,0,0,7
1701038,1328045,2023-05-18,Senate,"Do pass as amended",5,2,0,0,7
1701038,1332555,2023-05-24,Senate,"Senate 3rd Reading SB365 Wiener et al",30,9,0,1,40
1701038,1343692,2023-06-13,Assembly,"Do pass and be re-referred to the Committee on [Appropriations]",8,3,0,0,11
1701038,1353039,2023-09-01,Assembly,"Do pass",11,4,0,1,16
1701038,1353391,2023-09-07,Assembly,"SB 365 Wiener Senate Third Reading By Papan",47,22,0,11,80
1701039,1315138,2023-04-25,Senate,"Do pass as amended, but first amend, and re-refer to the Committee on [Appropriations]",11,0,0,0,11
1701039,1320379,2023-05-08,Senate,"Placed on suspense file",7,0,0,0,7
1701039,1328229,2023-05-18,Senate,"Do pass as amended",7,0,0,0,7
1701039,1336378,2023-05-31,Senate,"Senate 3rd Reading SB366 Caballero et al",40,0,0,0,40
1701039,1459957,2024-06-25,Assembly,"Do pass as amended and be re-referred to the Committee on [Appropriations]",13,0,0,2,15
1701039,1464515,2024-08-15,Assembly,"Do pass as amended",11,0,0,4,15
1701039,1465655,2024-08-26,Assembly,"SB 366 Caballero Senate Third Reading By Blanca Rubio",68,0,0,11,79
1701039,1466101,2024-08-29,Senate,"Unfinished Business SB366 Caballero et al. Concurrence",40,0,0,0,40
1701040,1276613,2023-03-15,Senate,"Do pass as amended, but first amend, and re-refer to the Committee on [Governance and Finance] with the recommendation: To Consent Calendar",7,0,0,0,7
1701040,1296922,2023-04-10,Senate,"Placed on suspense file",7,0,0,0,7
1701040,1328146,2023-05-18,Senate,"Do pass",7,0,0,0,7
1701040,1333559,2023-05-25,Senate,"Special Consent SB367 Seyarto",40,0,0,0,40
1701040,1347544,2023-06-26,Assembly,"Do pass as amended, and be re-referred to the Committee on [Appropriations] with recommendation: To Consent Calendar",11,0,0,0,11
1701041,1288386,2023-03-28,Senate,"Do pass as amended, but first amend, and re-refer to the Committee on [Appropriations]",4,0,0,1,5
1701041,1302586,2023-04-17,Senate,"Placed on suspense file",6,0,0,1,7
1701041,1328633,2023-05-18,Senate,"Do pass",5,2,0,0,7
1701041,1332586,2023-05-24,Senate,"Senate 3rd Reading SB368 Portantino et al",30,8,0,2,40
1701041,1348471,2023-06-27,Assembly,"Do pass as amended and be re-referred to the Committee on [Appropriations]",6,1,0,1,8
1701041,1352864,2023-09-01,Assembly,"Do pass",12,4,0,0,16
1701041,1353596,2023-09-11,Assembly,"SB 368 Portantino Senate Third Reading By Bauer-Kahan",62,15,0,3,80
1701041,1353847,2023-09-12,Senate,"Unfinished Business SB368 Portantino et al. Concurrence",29,10,0,1,40
1701042,1276602,2023-03-15,Senate,"Be adopted as amended",7,0,0,0,7
1701042,1313373,2023-04-27,Senate,"Senate 3rd Reading SCR21 Archuleta et al",38,0,0,2,40
1701042,1349651,2023-07-05,Assembly,"Be adopted. To Consent Calendar",15,0,0,0,15
1701042,1351262,2023-08-14,Assembly,"SCR 21 Archuleta Consent Calendar Second Day Regular Session",74,0,0,6,80
1701043,1263010,2023-02-27,Senate,"Senate 3rd Reading SCR22 Newman",37,0,0,3,40
1701043,1280703,2023-03-21,Assembly,"Be adopted as amended. To Consent Calendar",6,0,0,1,7
1701043,1285630,2023-03-27,Assembly,"SCR 22 Newman Consent Calendar Second Day Regular Session",77,0,0,3,80
1701043,1301048,2023-04-13,Senate,"Special Consent SCR22 Newman",36,0,0,4,40
1701044,1289792,2023-03-30,Senate,"Senate 3rd Reading SCR23 Newman",36,0,0,4,40
1701044,1323872,2023-05-11,Assembly,"Be adopted. To Consent Calendar",10,0,0,3,13
1701044,1328217,2023-05-18,Assembly,"SCR 23 Newman Consent Calendar Second Day Regular Session",74,0,0,6,80
1701045,1274184,2023-03-13,Senate,"Senate 3rd Reading SCR24 Bradford et al",37,0,0,3,40
1701045,1350151,2023-07-11,Assembly,"Be adopted as amended. To Consent Calendar",7,0,0,0,7
1701045,1351413,2023-08-14,Assembly,"SCR 24 Bradford Consent Calendar Second Day Regular Session",74,0,0,6,80
1701045,1352239,2023-08-24,Senate,"Special Consent SCR24 Bradford et al",40,0,0,0,40
1702700,1299414,2023-04-12,Assembly,"Do pass as amended, and be re-referred to the Committee on [Appropriations] with recommendation: To Consent Calendar",15,0,0,0,15
1702701,1304315,2023-04-18,Assembly,"Do pass and be re-referred to the Committee on [Appropriations] with recommendation: To Consent Calendar",8,0,0,0,8
1702701,1328852,2023-05-18,Assembly,"Do pass as amended",11,0,0,5,16
1702701,1337914,2023-05-31,Assembly,"AB 581 Wendy Carrillo Assembly Third Reading",79,0,0,1,80
1702701,1350223,2023-07-11,Senate,"Do pass, but first be re-referred to the Committee on [Appropriations] with the recommendation: To Consent Calendar",4,0,0,1,5
1702701,1353721,2023-09-12,Assembly,"AB 581 Wendy Carrillo Concurrence in Senate Amendments",77,0,0,3,80
1702701,1354533,2023-09-11,Senate,"Assembly 3rd Reading AB581 Wendy Carrillo By Bradford",39,0,0,1,40
1702702,1317095,2023-05-01,Assembly,"Do pass and be re-referred to the Committee on [Appropriations]",11,0,0,0,11
1702703,1298204,2023-04-11,Assembly,"Do pass as amended and be re-referred to the Committee on [Appropriations]",12,3,0,0,15
1702704,1274185,2023-03-13,Assembly,"Do pass and be re-referred to the Committee on [Appropriations] with recommendation: To Consent Calendar",11,0,0,0,11
1702704,1281916,2023-03-22,Assembly,"Do pass. To Consent Calendar",15,0,0,1,16
1702704,1289788,2023-03-30,Assembly,"AB 584 Hart Consent Calendar Second Day Regular Session",60,0,0,20,80
1702704,1346953,2023-06-22,Senate,"Do pass, but first be re-referred to the Committee on [Appropriations] with the recommendation: To Consent Calendar",11,0,0,0,11
1702704,1350701,2023-07-13,Senate,"Consent Calendar AB584 Hart",37,0,0,3,40
1702705,1302000,2023-04-10,Assembly,"Do pass and be re-referred to the Committee on [Appropriations] with recommendation: To Consent Calendar",11,0,0,0,11
1702705,1328566,2023-05-18,Assembly,"Do pass as amended",11,0,0,5,16
1702705,1338099,2023-05-31,Assembly,"AB 585 Robert Rivas Third Reading Urgency",80,0,0,0,80
1702705,1349622,2023-07-05,Senate,"Do pass, but first be re-referred to the Committee on [Appropriations] with the recommendation: To Consent Calendar",7,0,0,0,7
1702705,1351525,2023-08-14,Senate,"Placed on suspense file",7,0,0,0,7
1702705,1353003,2023-09-01,Senate,"Do pass as amended",7,0,0,0,7
1702705,1354338,2023-09-13,Senate,"Special Consent AB585 Robert Rivas et al. By Stern Urgency Clause",39,0,0,1,40
1702705,1354712,2023-09-14,Assembly,"AB 585 Robert Rivas Concurrence in Senate Amendments",79,0,0,1,80
1702706,1298223,2023-04-11,Assembly,"Do pass and be re-referred to the Committee on [Appropriations]",11,1,0,3,15
1702707,1281866,2023-03-22,Assembly,"Do pass and be re-referred to the Committee on [Appropriations]",7,0,0,0,7
1702707,1305389,2023-04-19,Assembly,"Do pass",15,0,0,1,16
1702707,1308857,2023-04-24,Assembly,"AB 587 Robert Rivas Assembly Third Reading",72,0,0,8,80
1702707,1344185,2023-06-14,Senate,"Do pass, but first be re-referred to the Committee on [Appropriations]",5,0,0,0,5
1702707,1352227,2023-08-24,Senate,"Assembly 3rd Reading AB587 Robert Rivas By Smallwood-Cuevas",33,0,0,7,40
1702707,1352471,2023-08-31,Assembly,"AB 587 Robert Rivas Concurrence in Senate Amendments",77,0,0,3,80
1702708,1281810,2023-03-22,Assembly,"Do pass. To Consent Calendar",7,0,0,1,8
1702708,1289822,2023-03-30,Assembly,"AB 588 Robert Rivas Consent Calendar Second Day Regular Session",60,0,0,20,80
1702708,1344193,2023-06-14,Senate,"Do pass and be ordered to the Consent Calendar",8,0,0,0,8
1702708,1346969,2023-06-22,Senate,"Consent Calendar AB588 Robert Rivas et al. By Laird",39,0,0,1,40
1702709,1305396,2023-04-19,Assembly,"Do pass and be re-referred to the Committee on [Human Services]",6,0,0,2,8
1702709,1310377,2023-04-25,Assembly,"Do pass as amended and be re-referred to the Committee on [Appropriations]",7,0,0,1,8
1702709,1328877,2023-05-18,Assembly,"Do pass as amended",13,0,0,3,16
1702709,1338178,2023-05-31,Assembly,"AB 589 Boerner Assembly Third Reading",71,0,0,9,80
1702709,1346261,2023-06-20,Senate,"Do pass, but first be re-referred to the Committee on [Human Services]",9,0,0,2,11
1702709,1349668,2023-07-03,Senate,"Do pass, but first be re-referred to the Committee on [Appropriations]",5,0,0,0,5
1702709,1351327,2023-08-14,Senate,"Placed on suspense file",7,0,0,0,7
1702709,1352925,2023-09-01,Senate,"Do pass",5,0,0,2,7
1702709,1353511,2023-09-07,Senate,"Assembly 3rd Reading AB589 Boerner et al. By Wiener",38,0,0,2,40
1702709,1353689,2023-09-11,Assembly,"AB 589 Boerner Concurrence in Senate Amendments",71,0,0,9,80
1702710,1288363,2023-03-29,Assembly,"Do pass and be re-referred to the Committee on [Appropriations]",7,0,0,0,7
1702710,1328362,2023-05-18,Assembly,"Do pass",15,0,0,1,16
1702710,1337997,2023-05-31,Assembly,"AB 590 Hart Assembly Third Reading",80,0,0,0,80
1702710,1350198,2023-07-11,Senate,"Do pass, but first be re-referred to the Committee on [Appropriations]",14,0,0,1,15
1702710,1351807,2023-08-21,Senate,"Placed on suspense file",7,0,0,0,7
1702710,1352825,2023-09-01,Senate,"Do pass as amended",7,0,0,0,7
1702710,1353943,2023-09-12,Senate,"Assembly 3rd Reading AB590 Hart et al. By Lim√≥n",38,0,0,2,40
1702710,1354141,2023-09-13,Assembly,"AB 590 Hart Concurrence in Senate Amendments",80,0,0,0,80
1702711,1280607,2023-03-20,Assembly,"Do pass and be re-referred to the Committee on [Appropriations]",15,0,0,0,15
1702711,1315767,2023-05-01,Assembly,"AB 591 Gabriel Assembly Third Reading",78,0,0,2,80
1702712,1318076,2023-05-03,Assembly,"Do pass",8,0,0,0,8
1702712,1324984,2023-05-15,Assembly,"AB 592 Wilson Assembly Third Reading",75,0,0,5,80
1702712,1346198,2023-06-21,Senate,"Do pass",8,0,0,0,8
1702712,1353181,2023-09-05,Senate,"Assembly 3rd Reading AB592 Wilson By Glazer",39,0,0,1,40
1702712,1353369,2023-09-07,Assembly,"AB 592 Wilson Concurrence in Senate Amendments",77,0,0,3,80
1702713,1301980,2023-04-10,Assembly,"Do pass as amended and be re-referred to the Committee on [Appropriations]",8,0,0,3,11
1702713,1328245,2023-05-18,Assembly,"Do pass",11,3,0,2,16
1702713,1338060,2023-05-31,Assembly,"AB 593 Haney Assembly Third Reading",60,15,0,5,80
1702713,1350302,2023-07-10,Senate,"Do pass as amended, but first amend, and re-refer to the Committee on [Appropriations]",14,3,0,1,18
1702713,1351399,2023-08-14,Senate,"Placed on suspense file",7,0,0,0,7
1702714,1299343,2023-04-12,Assembly,"Do pass and be re-referred to the Committee on [Judiciary]",5,2,0,0,7
1702714,1304347,2023-04-18,Assembly,"Do pass and be re-referred to the Committee on [Appropriations]",8,3,0,0,11
1702714,1327977,2023-05-18,Assembly,"Do pass as amended",11,4,0,1,16
1702714,1333722,2023-05-25,Assembly,"AB 594 Maienschein Assembly Third Reading",52,17,0,11,80
1702714,1348485,2023-06-28,Senate,"Do pass, but first be re-referred to the Committee on [Judiciary]",4,1,0,0,5
1702714,1350395,2023-07-11,Senate,"Do pass, but first be re-referred to the Committee on [Appropriations]",9,2,0,0,11
1702714,1351527,2023-08-14,Senate,"Placed on suspense file",7,0,0,0,7
1702714,1352991,2023-09-01,Senate,"Do pass",5,2,0,0,7
1702714,1354052,2023-09-12,Senate,"Assembly 3rd Reading AB594 Maienschein et al. By Cortese",30,8,0,2,40
1702714,1354198,2023-09-13,Assembly,"AB 594 Maienschein Concurrence in Senate Amendments",54,18,0,8,80
1702715,1298180,2023-04-11,Assembly,"Do pass as amended and be re-referred to the Committee on [Appropriations]",16,0,0,2,18
1702716,1286882,2023-03-28,Assembly,"Do pass and be re-referred to the Committee on [Education]",8,0,0,0,8
1702716,1313417,2023-04-26,Assembly,"Do pass as amended and be re-referred to the Committee on [Appropriations]",7,0,0,0,7
1702716,1328595,2023-05-18,Assembly,"Do pass",15,0,0,1,16
1702716,1330140,2023-05-22,Assembly,"AB 596 Reyes Assembly Third Reading",75,0,0,5,80
1702716,1345690,2023-06-19,Senate,"Do pass, but first be re-referred to the Committee on [Education]",5,0,0,0,5
1702716,1349594,2023-07-05,Senate,"Do pass, but first be re-referred to the Committee on [Appropriations]",7,0,0,0,7
1702716,1351435,2023-08-14,Senate,"Placed on suspense file",7,0,0,0,7
1702718,1300995,2023-04-12,Assembly,"Do pass as amended and be re-referred to the Committee on [Appropriations]",5,2,0,0,7
1702718,1328060,2023-05-18,Assembly,"Do pass",11,4,0,1,16
1702718,1338095,2023-05-31,Assembly,"AB 598 Wicks Assembly Third Reading",64,16,0,0,80
1702718,1460009,2024-06-24,Senate,"Do pass, but first be re-referred to the Committee on [Local Government] with the recommendation: To Consent Calendar",10,0,0,0,10
1702718,1462663,2024-07-03,Senate,"Do pass and be ordered to the Consent Calendar",7,0,0,0,7
1702718,1466170,2024-08-29,Senate,"Assembly 3rd Reading AB598 Wicks By Dodd",40,0,0,0,40
1702718,1466445,2024-08-30,Assembly,"With recommendation: That Senate amendments be concurred in",7,0,0,2,9
1702718,1466949,2024-08-31,Assembly,"AB 598 Wicks Concurrence in Senate Amendments",67,2,0,10,79
1702719,1283130,2023-03-22,Assembly,"Do pass as amended and be re-referred to the Committee on [Appropriations]",7,0,0,0,7
1702719,1328712,2023-05-18,Assembly,"Do pass",15,0,0,1,16
1702719,1335548,2023-05-30,Assembly,"AB 599 Ward Assembly Third Reading",78,0,0,2,80
1702719,1349606,2023-07-05,Senate,"Do pass, but first be re-referred to the Committee on [Appropriations]",5,0,0,2,7
1702719,1351492,2023-08-14,Senate,"Placed on suspense file",7,0,0,0,7
1702720,1275576,2023-03-14,Assembly,"Do pass and be re-referred to the Committee on [Appropriations]",6,2,0,0,8
1702720,1328281,2023-05-18,Assembly,"Do pass",12,3,0,1,16
1702720,1338132,2023-05-31,Assembly,"AB 600 Ting Assembly Third Reading",48,17,0,15,80
1702720,1347892,2023-06-27,Senate,"Do pass, but first be re-referred to the Committee on [Appropriations]",4,1,0,0,5
1702720,1351361,2023-08-14,Senate,"Placed on suspense file",7,0,0,0,7
1702720,1353005,2023-09-01,Senate,"Do pass as amended",5,2,0,0,7
1702720,1354280,2023-09-13,Senate,"Assembly 3rd Reading AB600 Ting et al. By Bradford",28,10,0,2,40
1702720,1354281,2023-09-13,Assembly,"AB 600 Ting Concurrence in Senate Amendments",50,17,0,13,80
1702722,1304250,2023-04-18,Assembly,"Do pass and be re-referred to the Committee on [Appropriations] with recommendation: To Consent Calendar",17,0,0,1,18
1702722,1328656,2023-05-18,Assembly,"Do pass",15,0,0,1,16
1702722,1337918,2023-05-31,Assembly,"AB 602 Pellerin Assembly Third Reading",80,0,0,0,80
1702723,1305261,2023-04-18,Assembly,"Do pass and be re-referred to the Committee on [Appropriations]",11,0,0,1,12
1702723,1328006,2023-05-18,Assembly,"Do pass",15,0,0,1,16
1702723,1337935,2023-05-31,Assembly,"AB 603 Cervantes Assembly Third Reading",77,0,0,3,80
1702723,1348331,2023-06-28,Senate,"Do pass, but first be re-referred to the Committee on [Appropriations]",7,0,0,0,7
1702723,1354704,2023-09-11,Senate,"Assembly 3rd Reading AB603 Cervantes By Smallwood-Cuevas",39,0,0,1,40
1702724,1288298,2023-03-29,Assembly,"Do pass and be re-referred to the Committee on [Appropriations]",6,2,0,0,8
1702724,1305268,2023-04-19,Assembly,"Do pass",11,4,0,1,16
1702724,1308804,2023-04-24,Assembly,"AB 604 Lee Assembly Third Reading",49,13,0,18,80
1702724,1345586,2023-06-20,Senate,"Do pass, but first be re-referred to the Committee on [Energy, Utilities and Communications]",9,2,0,0,11
1702724,1350186,2023-07-10,Senate,"Do pass as amended, but first amend, and re-refer to the Committee on [Appropriations]",15,2,0,1,18
1702724,1353292,2023-09-06,Senate,"Assembly 3rd Reading AB604 Lee By Dodd",30,7,0,3,40
1702724,1353436,2023-09-07,Assembly,"AB 604 Lee Concurrence in Senate Amendments",54,14,0,12,80
1702725,1275538,2023-03-14,Assembly,"Do pass and be re-referred to the Committee on [Agriculture]",8,0,0,0,8
1702725,1288383,2023-03-29,Assembly,"Do pass and be re-referred to the Committee on [Appropriations] with recommendation: To Consent Calendar",11,0,0,0,11
1702726,1286909,2023-03-28,Assembly,"Do pass and be re-referred to the Committee on [Appropriations]",15,0,0,0,15
1702726,1305337,2023-04-19,Assembly,"Do pass. To Consent Calendar",14,0,0,2,16
1702726,1313503,2023-04-27,Assembly,"AB 606 Mathis Consent Calendar Second Day Regular Session",79,0,0,1,80
1702726,1346987,2023-06-22,Senate,"Do pass as amended, but first amend, and re-refer to the Committee on [Appropriations] with the recommendation: To Consent Calendar",11,0,0,0,11
1702726,1349921,2023-07-10,Senate,"Placed on suspense file",6,0,0,1,7
1702726,1352541,2023-09-01,Senate,"Do pass",7,0,0,0,7
1702726,1353890,2023-09-12,Senate,"Special Consent AB606 Mathis et al. By Dodd",39,0,0,1,40
1702726,1354555,2023-09-14,Assembly,"AB 606 Mathis Concurrence in Senate Amendments",80,0,0,0,80
1702727,1281817,2023-03-21,Assembly,"Do pass and be re-referred to the Committee on [Appropriations]",11,0,0,1,12
1702727,1328437,2023-05-18,Assembly,"Do pass as amended",11,0,0,5,16
1702727,1338162,2023-05-31,Assembly,"AB 607 Kalra Assembly Third Reading",80,0,0,0,80
1702727,1349581,2023-07-05,Senate,"Do pass, but first be re-referred to the Committee on [Appropriations]",6,0,0,1,7
1702727,1351813,2023-08-21,Senate,"Placed on suspense file",7,0,0,0,7
1702727,1352642,2023-09-01,Senate,"Do pass",7,0,0,0,7
1702727,1353846,2023-09-12,Senate,"Assembly 3rd Reading AB607 Kalra et al. By Newman",38,0,0,2,40
1702727,1354298,2023-09-13,Assembly,"AB 607 Kalra Concurrence in Senate Amendments",80,0,0,0,80
1702728,1298220,2023-04-11,Assembly,"Do pass as amended and be re-referred to the Committee on [Appropriations]",15,0,0,0,15
1702728,1328161,2023-05-18,Assembly,"Do pass",15,0,0,1,16
1702728,1338181,2023-05-31,Assembly,"AB 608 Schiavo Assembly Third Reading",80,0,0,0,80
1702728,1349789,2023-07-05,Senate,"Do pass, but first be re-referred to the Committee on [Governmental Organization] with the recommendation: To Consent Calendar",12,0,0,0,12
1702728,1350144,2023-07-11,Senate,"Do pass as amended, but first amend, and re-refer to the Committee on [Appropriations] with the recommendation: To Consent Calendar",14,0,0,1,15
1702728,1351465,2023-08-14,Senate,"Placed on suspense file",7,0,0,0,7
1702728,1352527,2023-09-01,Senate,"Do pass",7,0,0,0,7
1702728,1353332,2023-09-06,Senate,"Assembly 3rd Reading AB608 Schiavo et al. By Eggman",40,0,0,0,40
1702728,1353368,2023-09-07,Assembly,"AB 608 Schiavo Concurrence in Senate Amendments",79,0,0,1,80
1702729,1274174,2023-03-13,Assembly,"Do pass and be re-referred to the Committee on [Appropriations] with recommendation: To Consent Calendar",7,0,0,0,7
1702729,1328640,2023-05-18,Assembly,"Do pass",15,0,0,1,16
1702729,1338109,2023-05-31,Assembly,"AB 609 Papan Assembly Third Reading",80,0,0,0,80
1702729,1347894,2023-06-27,Senate,"Do pass, but first be re-referred to the Committee on [Governmental Organization] with the recommendation: To Consent Calendar",11,0,0,0,11
1702729,1350208,2023-07-11,Senate,"Do pass as amended, but first amend, and re-refer to the Committee on [Appropriations]",14,0,0,1,15
1702729,1351317,2023-08-14,Senate,"Placed on suspense file",7,0,0,0,7
1702730,1275577,2023-03-13,Assembly,"Do pass and be re-referred to the Committee on [Appropriations]",14,0,0,1,15
1702730,1328043,2023-05-18,Assembly,"Do pass as amended",11,0,0,5,16
1702730,1335400,2023-05-30,Assembly,"AB 610 Holden Assembly Third Reading",80,0,0,0,80
1702730,1350471,2023-07-11,Senate,"Do pass, but first be re-referred to the Committee on [Appropriations] with the recommendation: To Consent Calendar",16,0,0,0,16
1702730,1351765,2023-08-21,Senate,"Placed on suspense file",7,0,0,0,7
1702730,1352648,2023-09-01,Senate,"Do pass",7,0,0,0,7
1702730,1390965,2024-02-21,Senate,"Do pass, but first be re-referred to the Committee on [Appropriations]",5,0,0,0,5
1702730,1395243,2024-02-26,Senate,"Do pass",6,0,0,1,7
1702730,1400024,2024-02-29,Senate,"Assembly 3rd Reading AB610 Holden By Lim√≥n Urgency Clause",31,4,0,5,40
1702730,1410532,2024-03-18,Assembly,"AB 610 Holden Concurrence - Urgency Added",57,5,0,18,80
1702731,1283188,2023-03-22,Assembly,"Do pass as amended and be re-referred to the Committee on [Appropriations]",7,0,0,0,7
1702731,1305310,2023-04-19,Assembly,"Do pass. To Consent Calendar",14,0,0,2,16
1702731,1313532,2023-04-27,Assembly,"AB 611 Weber Consent Calendar Second Day Regular Session",79,0,0,1,80
1702731,1340961,2023-06-07,Senate,"Do pass, but first be re-referred to the Committee on [Appropriations] with the recommendation: To Consent Calendar",7,0,0,0,7
1702731,1348865,2023-06-29,Senate,"Consent Calendar AB611 Weber",39,0,0,1,40
1702732,1280643,2023-03-20,Assembly,"Do pass and be re-referred to the Committee on [Water, Parks, and Wildlife] with recommendation: To Consent Calendar",15,0,0,0,15
1702732,1305297,2023-04-18,Assembly,"Do pass and be re-referred to the Committee on [Appropriations] with recommendation: To Consent Calendar",15,0,0,0,15
1702733,1305351,2023-04-18,Assembly,"Do pass as amended, and be re-referred to the Committee on [Appropriations] with recommendation: To Consent Calendar",15,0,0,0,15
1702734,1310344,2023-04-25,Assembly,"Do pass and be re-referred to the Committee on [Appropriations] with recommendation: To Consent Calendar",15,0,0,0,15
1702734,1322875,2023-05-10,Assembly,"Do pass. To Consent Calendar",14,0,0,2,16
1702734,1328581,2023-05-18,Assembly,"AB 614 Wood Consent Calendar Second Day Regular Session",74,0,0,6,80
1702734,1350645,2023-07-12,Senate,"Do pass, but first be re-referred to the Committee on [Appropriations] with the recommendation: To Consent Calendar",11,0,0,1,12
1702734,1351668,2023-08-17,Senate,"Consent Calendar 2nd AB614 Wood",38,0,0,2,40
1702735,1275546,2023-03-14,Assembly,"Do pass and be re-referred to the Committee on [Appropriations] with recommendation: To Consent Calendar",11,0,0,0,11
1702735,1328822,2023-05-18,Assembly,"Do pass",15,0,0,1,16
1702735,1337953,2023-05-31,Assembly,"AB 615 Maienschein Assembly Third Reading",80,0,0,0,80
1702735,1348422,2023-06-27,Senate,"Do pass, but first be re-referred to the Committee on [Appropriations] with the recommendation: To Consent Calendar",11,0,0,0,11
1702735,1351410,2023-08-14,Senate,"Placed on suspense file",7,0,0,0,7
1702736,1298273,2023-04-11,Assembly,"Do pass and be re-referred to the Committee on [Appropriations]",10,4,0,1,15
1702736,1328221,2023-05-18,Assembly,"Do pass",11,4,0,1,16
1702736,1338090,2023-05-31,Assembly,"AB 616 Rodriguez Assembly Third Reading",53,17,0,10,80
1702736,1349776,2023-07-05,Senate,"Do pass, but first be re-referred to the Committee on [Judiciary]",9,1,0,2,12
1702736,1350567,2023-07-11,Senate,"Do pass, but first be re-referred to the Committee on [Appropriations]",9,1,0,1,11
1702736,1351483,2023-08-14,Senate,"Placed on suspense file",7,0,0,0,7
1702736,1352555,2023-09-01,Senate,"Do pass",5,2,0,0,7
1702736,1354001,2023-09-12,Assembly,"AB 616 Rodriguez Concurrence in Senate Amendments",54,17,0,9,80
1702736,1354623,2023-09-11,Senate,"Assembly 3rd Reading AB616 Rodriguez et al. By Stern",23,9,0,8,40
1702738,1286945,2023-03-28,Assembly,"Do pass and be re-referred to the Committee on [Appropriations] with recommendation: To Consent Calendar",15,0,0,0,15
1702738,1328087,2023-05-18,Assembly,"Do pass as amended",11,0,0,5,16
1702738,1338002,2023-05-31,Assembly,"AB 618 Bauer-Kahan Assembly Third Reading",79,0,0,1,80
1702738,1349521,2023-07-03,Senate,"Do pass as amended, but first amend, and re-refer to the Committee on [Appropriations]",9,0,0,2,11
1702738,1351510,2023-08-14,Senate,"Placed on suspense file",7,0,0,0,7
1702738,1352716,2023-09-01,Senate,"Do pass as amended",5,0,0,2,7
1702738,1354031,2023-09-12,Senate,"Assembly 3rd Reading AB618 Bauer-Kahan et al. By Lim√≥n",38,0,0,2,40
1702738,1354334,2023-09-13,Assembly,"AB 618 Bauer-Kahan Concurrence in Senate Amendments",80,0,0,0,80
1702739,1285767,2023-03-27,Assembly,"Do pass and be re-referred to the Committee on [Appropriations]",7,0,0,0,7
1702739,1328604,2023-05-18,Assembly,"Do pass as amended",15,0,0,1,16
1702739,1333795,2023-05-25,Assembly,"AB 619 Vince Fong Assembly Third Reading",77,0,0,3,80
1702739,1350248,2023-07-11,Senate,"Do pass, but first be re-referred to the Committee on [Appropriations] with the recommendation: To Consent Calendar",14,0,0,1,15
1702739,1351264,2023-08-14,Senate,"Placed on suspense file",7,0,0,0,7
1702740,1310147,2023-04-25,Assembly,"Do pass as amended and be re-referred to the Committee on [Appropriations]",14,1,0,0,15
1702740,1328208,2023-05-18,Assembly,"Do pass",13,2,0,1,16
1702740,1338184,2023-05-31,Assembly,"AB 620 Connolly Assembly Third Reading",73,0,0,7,80
1702740,1348850,2023-06-28,Senate,"Do pass, but first be re-referred to the Committee on [Appropriations]",11,0,0,1,12
1702740,1349924,2023-07-10,Senate,"Placed on suspense file",6,0,0,1,7
1702740,1352665,2023-09-01,Senate,"Do pass as amended",5,1,0,1,7
1702740,1353492,2023-09-07,Senate,"Assembly 3rd Reading AB620 Connolly et al. By Lim√≥n",32,0,0,8,40
1702740,1353493,2023-09-07,Senate,"Assembly 3rd Reading AB620 Connolly et al. By Lim√≥n Motion To Reconsider",40,0,0,0,40
1702740,1354253,2023-09-13,Senate,"Assembly 3rd Reading AB620 Connolly et al. By Lim√≥n",35,0,0,5,40
1702740,1354539,2023-09-14,Assembly,"AB 620 Connolly Concurrence in Senate Amendments",72,0,0,8,80
1702741,1281907,2023-03-22,Assembly,"Do pass and be re-referred to the Committee on [Appropriations]",12,0,0,2,14
1702741,1328531,2023-05-18,Assembly,"Do pass",15,0,0,1,16
1702741,1337924,2023-05-31,Assembly,"AB 621 Irwin Assembly Third Reading",80,0,0,0,80
1702741,1348418,2023-06-28,Senate,"Do pass, but first be re-referred to the Committee on [Appropriations] with the recommendation: To Consent Calendar",5,0,0,0,5
1702741,1349943,2023-07-10,Senate,"Placed on suspense file",6,0,0,1,7
1702741,1352670,2023-09-01,Senate,"Do pass as amended",7,0,0,0,7
1702741,1353802,2023-09-12,Senate,"Assembly 3rd Reading AB621 Irwin et al. By Portantino",38,0,0,2,40
1702741,1354391,2023-09-13,Assembly,"AB 621 Irwin Concurrence in Senate Amendments",80,0,0,0,80
1702743,1304335,2023-04-18,Assembly,"Do pass and be re-referred to the Committee on [Appropriations] with recommendation: To Consent Calendar",17,0,0,1,18
1702743,1322858,2023-05-10,Assembly,"Do pass. To Consent Calendar",14,0,0,2,16
1702743,1327922,2023-05-18,Assembly,"AB 623 Chen Consent Calendar Second Day Regular Session",74,0,0,6,80
1702743,1343138,2023-06-12,Senate,"Do pass, but first be re-referred to the Committee on [Appropriations]",11,0,0,2,13
1702743,1353452,2023-09-07,Senate,"Assembly 3rd Reading AB623 Chen By Newman",40,0,0,0,40
1702744,1281876,2023-03-21,Assembly,"Do pass and be re-referred to the Committee on [Appropriations]",11,0,0,1,12
1702744,1328614,2023-05-18,Assembly,"Do pass as amended",11,0,0,5,16
1702744,1335558,2023-05-30,Assembly,"AB 624 Grayson Assembly Third Reading",80,0,0,0,80
1702744,1346321,2023-06-21,Senate,"Do pass, but first be re-referred to the Committee on [Rules]",7,0,0,0,7
1702744,1349666,2023-07-03,Senate,"Do pass, but first be re-referred to the Committee on [Appropriations] with the recommendation: To Consent Calendar",5,0,0,0,5
1702744,1351257,2023-08-14,Senate,"Placed on suspense file",7,0,0,0,7
1702744,1353070,2023-09-01,Senate,"Do pass as amended",7,0,0,0,7
1702744,1354293,2023-09-13,Senate,"Special Consent AB624 Grayson By Newman",39,0,0,1,40
1702744,1354650,2023-09-14,Assembly,"AB 624 Grayson Concurrence in Senate Amendments",80,0,0,0,80
1702745,1281865,2023-03-22,Assembly,"Do pass as amended and be re-referred to the Committee on [Natural Resources]",13,0,0,2,15
1702745,1301979,2023-04-10,Assembly,"Do pass as amended and be re-referred to the Committee on [Appropriations]",10,0,0,1,11
1702746,1276617,2023-03-15,Assembly,"Do pass as amended and be re-referred to the Committee on [Appropriations]",6,0,0,2,8
1702746,1328047,2023-05-18,Assembly,"Do pass",12,3,0,1,16
1702746,1338039,2023-05-31,Assembly,"AB 626 Pellerin Assembly Third Reading",69,2,0,9,80
1702746,1345631,2023-06-20,Senate,"Do pass, but first be re-referred to the Committee on [Appropriations]",6,1,0,0,7
1702746,1349525,2023-07-03,Senate,"Placed on suspense file",7,0,0,0,7
1702746,1352913,2023-09-01,Senate,"Do pass",5,2,0,0,7
1702746,1353484,2023-09-07,Senate,"Assembly 3rd Reading AB626 Pellerin By Laird",36,4,0,0,40
1702747,1363611,2024-01-08,Assembly,"Do pass as amended and be re-referred to the Committee on [Appropriations]",14,0,0,1,15
1702747,1366786,2024-01-18,Assembly,"Do pass as amended",12,0,0,4,16
1702747,1371113,2024-01-29,Assembly,"AB 627 Jackson Assembly Third Reading",67,1,0,12,80
1702748,1310329,2023-04-25,Assembly,"Do pass and be re-referred to the Committee on [Appropriations] with recommendation: To Consent Calendar",7,0,0,0,7
1702748,1322851,2023-05-10,Assembly,"Do pass. To Consent Calendar",14,0,0,2,16
1702748,1328806,2023-05-18,Assembly,"AB 628 Wilson Consent Calendar Second Day Regular Session",74,0,0,6,80
1702748,1343109,2023-06-12,Senate,"Do pass, but first be re-referred to the Committee on [Appropriations] with the recommendation: To Consent Calendar",12,0,0,1,13
1702748,1460030,2024-06-25,Senate,"Do pass, but first be re-referred to the Committee on [Appropriations]",4,1,0,0,5
1702748,1460775,2024-06-26,Senate,"Do pass",5,1,0,1,7
1702748,1461225,2024-06-27,Senate,"Assembly 3rd Reading AB628 Wilson By Bradford",33,2,0,5,40
1702748,1461226,2024-06-27,Assembly,"AB 628 WILSON Concurrence in Senate Amendments",67,0,0,12,79
1702749,1317035,2023-05-01,Assembly,"Do pass and be re-referred to the Committee on [Appropriations]",11,0,0,0,11
1702750,1285656,2023-03-27,Assembly,"Do pass and be re-referred to the Committee on [Appropriations]",15,0,0,0,15
1702750,1322871,2023-05-10,Assembly,"Do pass. To Consent Calendar",14,0,0,2,16
1702750,1328188,2023-05-18,Assembly,"AB 630 Ramos Consent Calendar Second Day Regular Session",74,0,0,6,80
1702750,1348286,2023-06-27,Senate,"Do pass, but first be re-referred to the Committee on [Judiciary] with the recommendation: To Consent Calendar",16,0,0,0,16
1702750,1349755,2023-07-06,Senate,"Do pass, but first be re-referred to the Committee on [Appropriations] with the recommendation: To Consent Calendar",11,0,0,0,11
1702750,1351682,2023-08-17,Senate,"Consent Calendar 2nd AB630 Ramos et al",38,0,0,2,40
1702751,1302569,2023-04-17,Assembly,"Do pass and be re-referred to the Committee on [Judiciary]",8,3,0,0,11
1702751,1310354,2023-04-25,Assembly,"Do pass as amended and be re-referred to the Committee on [Appropriations]",8,3,0,0,11
1702751,1328723,2023-05-18,Assembly,"Do pass",11,4,0,1,16
1702751,1338158,2023-05-31,Assembly,"AB 631 Hart Assembly Third Reading",50,19,0,11,80
1702751,1347877,2023-06-27,Senate,"Do pass, but first be re-referred to the Committee on [Public Safety]",7,3,0,1,11
1702751,1351298,2023-08-14,Senate,"Placed on suspense file",7,0,0,0,7
1702751,1352811,2023-09-01,Senate,"Do pass as amended",4,2,0,1,7
1702751,1353825,2023-09-12,Senate,"Assembly 3rd Reading AB631 Hart et al. By Allen",29,9,0,2,40
1702751,1354343,2023-09-13,Assembly,"AB 631 Hart Concurrence in Senate Amendments",53,19,0,8,80
1702752,1280672,2023-03-21,Assembly,"Do pass and be re-referred to the Committee on [Appropriations]",14,0,0,1,15
1702752,1305488,2023-04-19,Assembly,"Do pass. To Consent Calendar",14,0,0,2,16
1702752,1313399,2023-04-27,Assembly,"AB 632 Gipson Consent Calendar Second Day Regular Session",79,0,0,1,80
1702752,1344237,2023-06-14,Senate,"Do pass as amended, but first amend, and re-refer to the Committee on [Appropriations]",12,0,0,0,12
1702752,1347532,2023-06-26,Senate,"Placed on suspense file",6,0,0,1,7
1702752,1352848,2023-09-01,Senate,"Do pass",6,0,0,1,7
1702752,1353244,2023-09-06,Senate,"Assembly 3rd Reading AB632 Gipson By Bradford",39,0,0,1,40
1702752,1353547,2023-09-07,Assembly,"AB 632 Gipson Concurrence in Senate Amendments",76,0,0,4,80
1702753,1286953,2023-03-28,Assembly,"Do pass and be re-referred to the Committee on [Appropriations] with recommendation: To Consent Calendar",18,0,0,1,19
1702753,1328436,2023-05-18,Assembly,"Do pass",15,0,0,1,16
1702753,1338008,2023-05-31,Assembly,"AB 633 Jim Patterson Assembly Third Reading",80,0,0,0,80
1702753,1345201,2023-06-19,Senate,"Do pass, but first be re-referred to the Committee on [Appropriations]",12,0,0,1,13
1702753,1349936,2023-07-10,Senate,"Placed on suspense file",6,0,0,1,7
1702753,1352567,2023-09-01,Senate,"Do pass",7,0,0,0,7
1702753,1353994,2023-09-12,Senate,"Special Consent AB633 Jim Patterson By Nguyen",39,0,0,1,40
1702753,1354401,2023-09-13,Assembly,"With recommendation: That Senate amendments be concurred in",19,0,0,0,19
1702753,1354553,2023-09-14,Assembly,"AB 633 Jim Patterson Concurrence in Senate Amendments",80,0,0,0,80
1702754,1281902,2023-03-21,Assembly,"Do pass and be re-referred to the Committee on [Appropriations]",10,0,0,2,12
1702754,1328232,2023-05-18,Assembly,"Do pass",15,0,0,1,16
1702754,1330060,2023-05-22,Assembly,"AB 634 Ward Assembly Third Reading",76,0,0,4,80
1702754,1340970,2023-06-07,Senate,"Do pass, but first be re-referred to the Committee on [Appropriations] with the recommendation: To Consent Calendar",7,0,0,0,7
1702754,1347505,2023-06-26,Senate,"Placed on suspense file",6,0,0,1,7
1702754,1353088,2023-09-01,Senate,"Do pass as amended",7,0,0,0,7
1702754,1354243,2023-09-13,Senate,"Special Consent AB634 Ward By Smallwood-Cuevas",39,0,0,1,40
1702754,1354540,2023-09-14,Assembly,"AB 634 Ward Concurrence in Senate Amendments",80,0,0,0,80
1702756,1299479,2023-04-12,Assembly,"Do pass and be re-referred to the Committee on [Appropriations]",5,0,0,2,7
1702756,1311720,2023-04-26,Assembly,"Do pass",12,2,0,2,16
1702756,1328316,2023-05-18,Assembly,"AB 636 Kalra Assembly Third Reading",59,5,0,16,80
1702756,1350559,2023-07-12,Senate,"Do pass, but first be re-referred to the Committee on [Appropriations]",4,0,0,1,5
1702756,1353150,2023-09-05,Senate,"Assembly 3rd Reading AB636 Kalra By Durazo",31,7,0,2,40
1702757,1363615,2024-01-08,Assembly,"Do pass and be re-referred to the Committee on [Appropriations]",14,0,0,1,15
1702757,1366753,2024-01-18,Assembly,"Do pass",15,0,0,1,16
1702757,1369562,2024-01-25,Assembly,"AB 637 Jackson Assembly Third Reading",70,0,0,10,80
1702757,1454229,2024-06-05,Senate,"Do pass, but first be re-referred to the Committee on [Transportation] with the recommendation: To Consent Calendar",7,0,0,0,7
1702757,1460496,2024-06-25,Senate,"Do pass, but first be re-referred to the Committee on [Appropriations]",14,0,0,1,15
1702757,1463639,2024-08-05,Senate,"Placed on suspense file",7,0,0,0,7
1702757,1464622,2024-08-15,Senate,"Do pass as amended",7,0,0,0,7
1702757,1466280,2024-08-29,Assembly,"AB 637 Jackson Concurrence in Senate Amendments",66,1,0,12,79
1702757,1466814,2024-08-28,Senate,"Assembly 3rd Reading AB637 Jackson By Newman",35,3,0,2,40
1702758,1305511,2023-04-18,Assembly,"Do pass as amended and be re-referred to the Committee on [Appropriations]",11,0,0,1,12
1702759,1275554,2023-03-13,Assembly,"Do pass and be re-referred to the Committee on [Appropriations]",10,1,0,4,15
1702760,1283114,2023-03-22,Assembly,"Do pass as amended and be re-referred to the Committee on [Labor and Employment]",7,0,0,0,7
1702761,1304304,2023-04-17,Assembly,"Do pass and be re-referred to the Committee on [Appropriations]",15,0,0,0,15
1702761,1328001,2023-05-18,Assembly,"Do pass",15,0,0,1,16
1702761,1333596,2023-05-25,Assembly,"AB 641 Vince Fong Assembly Third Reading",77,0,0,3,80
1702761,1350499,2023-07-11,Senate,"Do pass as amended, but first amend, and re-refer to the Committee on [Appropriations]",16,0,0,0,16
1702761,1353433,2023-09-07,Senate,"Assembly 3rd Reading AB641 Vince Fong et al. By Archuleta",40,0,0,0,40
1702761,1353671,2023-09-11,Assembly,"AB 641 Vince Fong Concurrence in Senate Amendments",80,0,0,0,80
1702762,1299434,2023-04-11,Assembly,"Do pass and be re-referred to the Committee on [Privacy and Consumer Protection]",6,0,0,2,8
1702762,1311832,2023-04-25,Assembly,"Do pass as amended and be re-referred to the Committee on [Appropriations]",9,0,0,2,11
1702763,1313480,2023-04-26,Assembly,"Do pass as amended and be re-referred to the Committee on [Appropriations]",14,0,0,1,15
1702765,1304414,2023-04-17,Assembly,"Do pass and be re-referred to the Committee on [Privacy and Consumer Protection]",12,0,0,3,15
1702765,1311746,2023-04-25,Assembly,"Do pass as amended and be re-referred to the Committee on [Appropriations]",8,1,0,2,11
1702765,1328681,2023-05-18,Assembly,"Do pass",11,3,0,2,16
1702765,1338068,2023-05-31,Assembly,"AB 645 Friedman Assembly Third Reading",58,7,0,15,80
1702765,1348320,2023-06-27,Senate,"Do pass as amended, but first amend, and re-refer to the Committee on [Judiciary]",10,5,0,1,16
1702765,1350381,2023-07-11,Senate,"Do pass as amended, but first amend, and re-refer to the Committee on [Appropriations]",10,1,0,0,11
1702765,1352332,2023-08-28,Senate,"Placed on suspense file",7,0,0,0,7
1702765,1352629,2023-09-01,Senate,"Do pass",4,2,0,1,7
1702765,1353808,2023-09-12,Senate,"Assembly 3rd Reading AB645 Friedman et al. By Wiener",29,6,0,5,40
1702765,1354369,2023-09-13,Assembly,"AB 645 Friedman Concurrence in Senate Amendments",62,9,0,9,80
1702767,1281861,2023-03-22,Assembly,"Do pass and be re-referred to the Committee on [Judiciary]",5,2,0,0,7
1702767,1286889,2023-03-28,Assembly,"Do pass as amended and be re-referred to the Committee on [Appropriations]",7,3,0,1,11
1702767,1328351,2023-05-18,Assembly,"Do pass as amended",11,4,0,1,16
1702767,1335408,2023-05-30,Assembly,"AB 647 Holden Assembly Third Reading",58,16,0,6,80
1702767,1346992,2023-06-22,Senate,"Do pass as amended, but first amend, and re-refer to the Committee on [Judiciary]",4,1,0,0,5
1702767,1350522,2023-07-11,Senate,"Do pass as amended, but first amend, and re-refer to the Committee on [Appropriations]",8,2,0,1,11
1702767,1351503,2023-08-14,Senate,"Placed on suspense file",7,0,0,0,7
1702767,1352949,2023-09-01,Senate,"Do pass as amended",5,2,0,0,7
1702767,1354630,2023-09-14,Senate,"Assembly 3rd Reading AB647 Holden By Smallwood-Cuevas",27,11,0,2,40
1702767,1354631,2023-09-14,Assembly,"AB 647 HOLDEN Concurrence in Senate Amendments",60,15,0,5,80
1702768,1305443,2023-04-19,Assembly,"Do pass as amended",8,0,0,0,8
1702768,1320439,2023-05-08,Assembly,"AB 648 Valencia Assembly Third Reading",72,0,0,8,80
1702768,1340036,2023-06-06,Senate,"Do pass, but first be re-referred to the Committee on [Judiciary]",11,0,0,0,11
1702768,1345637,2023-06-20,Senate,"Do pass",11,0,0,0,11
1702768,1353155,2023-09-05,Senate,"Assembly 3rd Reading AB648 Valencia et al. By Min",39,0,0,1,40
1702769,1304277,2023-04-18,Assembly,"Do pass and be re-referred to the Committee on [Appropriations]",7,0,0,1,8
1702769,1327958,2023-05-18,Assembly,"Do pass as amended",11,0,0,5,16
1702769,1333663,2023-05-25,Assembly,"AB 649 Wilson Assembly Third Reading",77,0,0,3,80
1702769,1345598,2023-06-19,Senate,"Do pass, but first be re-referred to the Committee on [Appropriations] with the recommendation: To Consent Calendar",5,0,0,0,5
1702769,1349486,2023-07-03,Senate,"Placed on suspense file",7,0,0,0,7
1702772,1278495,2023-03-14,Assembly,"Do pass and be re-referred to the Committee on [Appropriations]",7,2,0,0,9
1702772,1328890,2023-05-18,Assembly,"Do pass",11,4,0,1,16
1702772,1338116,2023-05-31,Assembly,"AB 652 Lee Assembly Third Reading",57,17,0,6,80
1702772,1349613,2023-07-05,Senate,"Do pass, but first be re-referred to the Committee on [Appropriations]",4,3,0,0,7
1702772,1352335,2023-08-28,Senate,"Placed on suspense file",7,0,0,0,7
1702772,1352947,2023-09-01,Senate,"Do pass",5,2,0,0,7
1702772,1354310,2023-09-13,Senate,"Assembly 3rd Reading AB652 Lee et al. By Laird",29,10,0,1,40
1702772,1354311,2023-09-13,Assembly,"AB 652 Lee Concurrence in Senate Amendments",55,16,0,9,80
1702773,1311726,2023-04-26,Assembly,"Do pass as amended and be re-referred to the Committee on [Appropriations]",8,0,0,0,8
1702773,1327978,2023-05-18,Assembly,"Do pass",15,0,0,1,16
1702773,1333684,2023-05-25,Assembly,"AB 653 Reyes Assembly Third Reading",76,0,0,4,80
1702773,1350163,2023-07-10,Senate,"Do pass, but first be re-referred to the Committee on [Appropriations]",10,0,0,1,11
1702773,1463868,2024-08-12,Senate,"Placed on suspense file",7,0,0,0,7
1702773,1464372,2024-08-15,Senate,"Do pass as amended",4,1,0,2,7
1702773,1466338,2024-08-29,Assembly,"AB 653 Reyes Concurrence in Senate Amendments",74,0,0,5,79
1702773,1466831,2024-08-28,Senate,"Assembly 3rd Reading AB653 Reyes et al. By Skinner",32,1,0,7,40
1702775,1286927,2023-03-28,Assembly,"Do pass and be re-referred to the Committee on [Appropriations] with recommendation: To Consent Calendar",15,0,0,0,15
1702775,1305459,2023-04-19,Assembly,"Do pass. To Consent Calendar",14,0,0,2,16
1702775,1313474,2023-04-27,Assembly,"AB 655 Petrie-Norris Consent Calendar Second Day Regular Session",79,0,0,1,80
1702775,1346934,2023-06-22,Senate,"Do pass, but first be re-referred to the Committee on [Appropriations] with the recommendation: To Consent Calendar",11,0,0,0,11
1702775,1350675,2023-07-13,Senate,"Consent Calendar AB655 Petrie-Norris",37,0,0,3,40
1702776,1311711,2023-04-25,Assembly,"Do pass and be re-referred to the Committee on [Appropriations]",12,0,0,0,12
1702776,1328063,2023-05-18,Assembly,"Do pass",15,0,0,1,16
1702776,1337231,2023-06-01,Assembly,"AB 656 McCarty Assembly Third Reading",79,0,0,1,80
1702776,1350486,2023-07-12,Senate,"Do pass as amended, but first amend, and re-refer to the Committee on [Appropriations]",7,0,0,0,7
1702776,1351293,2023-08-14,Senate,"Placed on suspense file",7,0,0,0,7
1702776,1352694,2023-09-01,Senate,"Do pass",7,0,0,0,7
1702776,1353817,2023-09-12,Assembly,"AB 656 McCarty Concurrence in Senate Amendments",80,0,0,0,80
1702776,1354807,2023-09-11,Senate,"Assembly 3rd Reading AB656 McCarty et al. By Lim√≥n",39,0,0,1,40
1702778,1299369,2023-04-12,Assembly,"Do pass as amended and be re-referred to the Committee on [Appropriations]",7,0,0,0,7
1702778,1311686,2023-04-26,Assembly,"Do pass. To Consent Calendar",16,0,0,0,16
1702778,1318941,2023-05-04,Assembly,"AB 658 Mike Fong Consent Calendar Second Day Regular Session",75,0,0,5,80
1702778,1344230,2023-06-14,Senate,"Do pass, but first be re-referred to the Committee on [Appropriations]",5,0,0,0,5
1702778,1353928,2023-09-12,Assembly,"AB 658 Mike Fong Concurrence in Senate Amendments",80,0,0,0,80
1702778,1354535,2023-09-11,Senate,"Assembly 3rd Reading AB658 Mike Fong By Rubio",39,0,0,1,40
1702779,1304318,2023-04-18,Assembly,"Do pass and be re-referred to the Committee on [Appropriations]",10,4,0,1,15
1702779,1326966,2023-05-17,Assembly,"Do pass",11,4,0,1,16
1702779,1337990,2023-05-31,Assembly,"AB 659 Aguiar-Curry Assembly Third Reading",59,14,0,7,80
1702779,1348858,2023-06-28,Senate,"Do pass as amended, but first amend, and re-refer to the Committee on [Education]",10,1,0,1,12
1702779,1350525,2023-07-12,Senate,"Do pass, but first be re-referred to the Committee on [Appropriations]",5,2,0,0,7
1702779,1351811,2023-08-21,Senate,"Placed on suspense file",7,0,0,0,7
1702779,1352775,2023-09-01,Senate,"Do pass",5,2,0,0,7
1702779,1353917,2023-09-12,Senate,"Assembly 3rd Reading AB659 Aguiar-Curry et al. By Wiener",32,6,0,2,40
1702779,1354223,2023-09-13,Assembly,"AB 659 Aguiar-Curry Concurrence in Senate Amendments",60,13,0,7,80
1702780,1276616,2023-03-15,Assembly,"Do pass and be re-referred to the Committee on [Health]",7,0,0,4,11
1702780,1310216,2023-04-25,Assembly,"Do pass as amended and be re-referred to the Committee on [Appropriations]",11,3,0,1,15
1702780,1328762,2023-05-18,Assembly,"Do pass as amended",11,4,0,1,16
1702780,1335489,2023-05-30,Assembly,"AB 660 Irwin Assembly Third Reading",63,16,0,1,80
1702780,1346141,2023-06-21,Senate,"Do pass as amended, but first amend, and re-refer to the Committee on [Agriculture]",9,0,0,3,12
1702780,1458335,2024-06-18,Senate,"Do pass, but first be re-referred to the Committee on [Appropriations]",5,0,0,0,5
1702780,1461951,2024-07-01,Senate,"Placed on suspense file",7,0,0,0,7
1702780,1464040,2024-08-15,Senate,"Do pass as amended",5,1,0,1,7
1702780,1465814,2024-08-27,Senate,"Assembly 3rd Reading AB660 Irwin et al. By Allen",34,1,0,5,40
1702780,1466877,2024-08-28,Assembly,"AB 660 Irwin Concurrence in Senate Amendments",61,14,0,4,79
1702781,1363944,2024-01-10,Assembly,"Do pass. To Consent Calendar",8,0,0,0,8
1702781,1364772,2024-01-16,Assembly,"AB 661 Joe Patterson Consent Calendar Second Day",70,0,0,10,80
1702781,1453452,2024-06-04,Senate,"Do pass and be ordered to the Consent Calendar",11,0,0,0,11
1702781,1455788,2024-06-10,Senate,"Consent Calendar 2nd AB661 Joe Patterson",37,0,0,3,40
1702781,1457365,2024-06-13,Assembly,"AB 661 Joe Patterson Concurrence in Senate Amendments",73,0,0,6,79
1702782,1288260,2023-03-29,Assembly,"Do pass and be re-referred to the Committee on [Appropriations] with recommendation: To Consent Calendar",13,0,0,0,13
1702782,1328523,2023-05-18,Assembly,"Do pass",15,0,0,1,16
1702782,1338137,2023-05-31,Assembly,"AB 662 Boerner Assembly Third Reading",80,0,0,0,80
1702782,1350209,2023-07-10,Senate,"Do pass as amended, but first amend, and re-refer to the Committee on [Appropriations]",12,1,0,5,18
1702782,1351289,2023-08-14,Senate,"Placed on suspense file",7,0,0,0,7
1702783,1298202,2023-04-11,Assembly,"Do pass as amended and be re-referred to the Committee on [Appropriations]",18,0,0,0,18
1702783,1311915,2023-04-26,Assembly,"Do pass. To Consent Calendar",16,0,0,0,16
1702783,1328678,2023-05-18,Assembly,"AB 663 Haney Assembly Third Reading",74,0,0,6,80
1702783,1343134,2023-06-12,Senate,"Do pass, but first be re-referred to the Committee on [Appropriations]",12,0,0,1,13
1702783,1353129,2023-09-05,Senate,"Assembly 3rd Reading AB663 Haney By Becker",39,0,0,1,40
1702783,1354101,2023-09-13,Assembly,"With recommendation: That Senate amendments be concurred in",19,0,0,0,19
1702783,1354747,2023-09-14,Assembly,"AB 663 Haney Concurrence in Senate Amendments",80,0,0,0,80
1702784,1278551,2023-03-14,Assembly,"Do pass and be re-referred to the Committee on [Appropriations]",7,0,0,2,9
1702784,1305328,2023-04-19,Assembly,"Do pass",12,0,0,4,16
1702784,1308789,2023-04-24,Assembly,"AB 664 Lee Assembly Third Reading",63,2,0,15,80
1702784,1340996,2023-06-07,Senate,"Do pass, but first be re-referred to the Committee on [Appropriations]",4,2,0,1,7
1702784,1347504,2023-06-26,Senate,"Placed on suspense file",6,0,0,1,7
1702784,1352633,2023-09-01,Senate,"Do pass",5,2,0,0,7
1702784,1353812,2023-09-12,Senate,"Assembly 3rd Reading AB664 Lee By Gonzalez",29,8,0,3,40
1702784,1354079,2023-09-13,Assembly,"AB 664 Lee Concurrence in Senate Amendments",63,6,0,11,80
1702785,1267499,2023-03-02,Assembly,"Be adopted. To Consent Calendar",13,0,0,0,13
1702785,1272550,2023-03-09,Assembly,"ACR 12 Stephanie Nguyen Consent Calendar Second Day",75,0,0,5,80
1702785,1289827,2023-03-30,Senate,"Special Consent ACR12 Stephanie Nguyen et",35,0,0,5,40
1702786,1286906,2023-03-28,Assembly,"Be adopted as amended",10,0,0,1,11
1702786,1289801,2023-03-30,Assembly,"AJR 1 Holden Assembly Third Reading",65,0,0,15,80
1702786,1343737,2023-06-13,Senate,"Be adopted. Ordered to third reading",10,0,0,1,11
1702786,1349975,2023-07-10,Senate,"Assembly 3rd Reading AJR1 Holden et al. By Portantino",39,0,0,1,40
1702787,1299357,2023-04-12,Senate,"Do pass, but first be re-referred to the Committee on [Appropriations] with the recommendation: To Consent Calendar",7,0,0,0,7
1702787,1308785,2023-04-24,Senate,"Placed on suspense file",7,0,0,0,7
1702787,1328224,2023-05-18,Senate,"Do pass",7,0,0,0,7
1702787,1333806,2023-05-25,Senate,"Special Consent SB369 Nguyen et al",40,0,0,0,40
1702787,1348881,2023-06-28,Assembly,"Do pass and be re-referred to the Committee on [Appropriations] with recommendation: To Consent Calendar",7,0,0,0,7
1702787,1353089,2023-09-01,Assembly,"Do pass as amended",15,0,0,1,16
1702787,1354360,2023-09-13,Assembly,"SB 369 Nguyen Senate Third Reading By Lowenthal",80,0,0,0,80
1702787,1354800,2023-09-14,Senate,"Unfinished Business SB369 Nguyen et al. Concurrence",40,0,0,0,40
1702788,1299409,2023-04-12,Senate,"Do pass, but first be re-referred to the Committee on [Appropriations] with the recommendation: To Consent Calendar",8,0,0,0,8
1702788,1308882,2023-04-24,Senate,"Placed on suspense file",7,0,0,0,7
1702788,1328796,2023-05-18,Senate,"Do pass",7,0,0,0,7
1702788,1333794,2023-05-25,Senate,"Special Consent SB370 McGuire et al. Urgency Clause",40,0,0,0,40
1702788,1460717,2024-06-26,Assembly,"Do pass and be re-referred to the Committee on [Appropriations]",14,0,0,1,15
1702788,1463719,2024-08-07,Assembly,"Do pass. To Consent Calendar",14,0,0,1,15
1702789,1298174,2023-04-11,Senate,"Do pass as amended, and be ordered to the Consent Calendar",11,0,0,0,11
1702789,1302578,2023-04-17,Senate,"Consent Calendar SB371 Ochoa Bogh",37,0,0,3,40
1702789,1345671,2023-06-20,Assembly,"Do pass",15,0,0,0,15
1702789,1351697,2023-08-17,Assembly,"SB 371 Ochoa Bogh Senate Third Reading By Reyes",76,0,0,4,80
1702790,1285697,2023-03-27,Senate,"Do pass, but first be re-referred to the Committee on [Judiciary]",8,2,0,3,13
1702790,1305381,2023-04-18,Senate,"Do pass as amended, but first amend, and re-refer to the Committee on [Appropriations]",9,0,0,2,11
1702790,1315693,2023-05-01,Senate,"Placed on suspense file",6,0,0,1,7
1702790,1328463,2023-05-18,Senate,"Do pass",5,2,0,0,7
1702790,1330031,2023-05-22,Senate,"Senate 3rd Reading SB372 Menjivar et al",33,4,0,3,40
1702790,1345605,2023-06-20,Assembly,"Do pass and be re-referred to the Committee on [Judiciary]",13,0,0,6,19
1702790,1347839,2023-06-27,Assembly,"Do pass as amended and be re-referred to the Committee on [Appropriations]",8,1,0,2,11
1702790,1351562,2023-08-16,Assembly,"Do pass",12,4,0,0,16
1702790,1353193,2023-09-05,Assembly,"SB 372 Menjivar Senate Third Reading By Zbur",63,5,0,12,80
1702790,1353245,2023-09-06,Senate,"Unfinished Business SB372 Menjivar et al. Concurrence",36,4,0,0,40
1702791,1296924,2023-04-10,Senate,"Do pass as amended, but first amend, and re-refer to the Committee on [Judiciary]",13,0,0,0,13
1702791,1305427,2023-04-18,Senate,"Do pass as amended, but first amend, and re-refer to the Committee on [Appropriations]",11,0,0,0,11
1702791,1320403,2023-05-08,Senate,"Senate 3rd Reading SB373 Menjivar",36,0,0,4,40
1702791,1345629,2023-06-20,Assembly,"Do pass as amended and be re-referred to the Committee on [Appropriations]",19,0,0,0,19
1702791,1351590,2023-08-16,Assembly,"Do pass. To Consent Calendar",15,0,0,1,16
1702791,1353880,2023-09-12,Assembly,"SB 373 Menjivar Senate Third Reading By Jackson",80,0,0,0,80
1702791,1354137,2023-09-13,Senate,"Unfinished Business SB373 Menjivar Concurrence",39,0,0,1,40
1702792,1288347,2023-03-28,Senate,"Do pass, but first be re-referred to the Committee on [Appropriations] with the recommendation: To Consent Calendar",14,0,0,2,16
1702792,1306767,2023-04-20,Senate,"Consent Calendar SB374 Ashby et al",36,0,0,4,40
1702792,1347842,2023-06-26,Assembly,"Do pass and be re-referred to the Committee on [Appropriations] with recommendation: To Consent Calendar",15,0,0,0,15
1702792,1351565,2023-08-16,Assembly,"Do pass. To Consent Calendar",15,0,0,1,16
1702792,1352218,2023-08-24,Assembly,"SB 374 Ashby Consent Calendar Second Day Regular Session",73,0,0,7,80
1702792,1352856,2023-09-01,Senate,"Special Consent SB374 Ashby et al",37,0,0,3,40
1702793,1311724,2023-04-26,Senate,"Do pass, but first be re-referred to the Committee on [Appropriations]",3,1,0,1,5
1702793,1320477,2023-05-08,Senate,"Placed on suspense file",7,0,0,0,7
1702794,1304417,2023-04-18,Senate,"Do pass as amended, but first amend, and re-refer to the Committee on [Appropriations]",5,0,0,0,5
1702794,1330130,2023-05-22,Senate,"Senate 3rd Reading SB376 Rubio et al",40,0,0,0,40
1702794,1343719,2023-06-13,Assembly,"Do pass and be re-referred to the Committee on [Appropriations] with recommendation: To Consent Calendar",8,0,0,0,8
1702794,1346295,2023-06-21,Assembly,"Do pass. To Consent Calendar",13,0,0,3,16
1702794,1347813,2023-06-27,Assembly,"SB 376 Rubio Consent Calendar Second Day Regular Session",78,0,0,2,80
1702794,1349830,2023-07-06,Senate,"Special Consent SB376 Rubio et al",40,0,0,0,40
1702795,1288201,2023-03-28,Senate,"Do pass, but first be re-referred to the Committee on [Appropriations]",4,1,0,0,5
1702795,1296957,2023-04-10,Senate,"Placed on suspense file",7,0,0,0,7
1702795,1328305,2023-05-18,Senate,"Do pass as amended",5,2,0,0,7
1702795,1336369,2023-05-31,Senate,"Senate 3rd Reading SB377 Skinner",27,8,0,5,40
1702795,1348380,2023-06-27,Assembly,"Do pass and be re-referred to the Committee on [Appropriations]",6,2,0,0,8
1702797,1363739,2024-01-09,Senate,"Do pass, but first be re-referred to the Committee on [Appropriations]",5,0,0,0,5
1702797,1371093,2024-01-29,Senate,"Senate 3rd Reading SB379 Umberg",39,0,0,1,40
1702797,1453400,2024-06-04,Assembly,"Do pass and be re-referred to the Committee on [Appropriations] with recommendation: To Consent Calendar",7,0,0,1,8
1702797,1464643,2024-08-15,Assembly,"Do pass as amended",11,0,0,4,15
1702797,1466383,2024-08-30,Senate,"Special Consent SB379 Umberg",40,0,0,0,40
1702797,1466912,2024-08-28,Assembly,"SB 379 Umberg Senate Third Reading By Bryan",77,0,0,2,79
1702798,1304288,2023-04-17,Senate,"Do pass, but first be re-referred to the Committee on [Education]",4,0,0,1,5
1702798,1311879,2023-04-26,Senate,"Do pass, but first be re-referred to the Committee on [Appropriations]",7,0,0,0,7
1702798,1320480,2023-05-08,Senate,"Placed on suspense file",7,0,0,0,7
1702798,1328841,2023-05-18,Senate,"Do pass",6,1,0,0,7
1702798,1332573,2023-05-24,Senate,"Senate 3rd Reading SB380 Lim√≥n et al",39,0,0,1,40
1702798,1345655,2023-06-20,Assembly,"Do pass and be re-referred to the Committee on [Education]",8,0,0,0,8
1702798,1350382,2023-07-12,Assembly,"Do pass and be re-referred to the Committee on [Appropriations]",7,0,0,0,7
1702798,1460716,2024-06-26,Assembly,"Do pass and be re-referred to the Committee on [Appropriations] with recommendation: To Consent Calendar",7,0,0,0,7
1702799,1288202,2023-03-28,Senate,"Do pass, but first be re-referred to the Committee on [Appropriations]",14,0,0,2,16
1702799,1302695,2023-04-17,Senate,"Do pass",6,0,0,1,7
1702799,1313309,2023-04-27,Senate,"Senate 3rd Reading SB381 Min",38,0,0,2,40
1702799,1349558,2023-07-05,Assembly,"Do pass and be re-referred to the Committee on [Appropriations] with recommendation: To Consent Calendar",15,0,0,0,15
1702799,1352876,2023-09-01,Assembly,"Do pass",16,0,0,0,16
1702799,1353937,2023-09-12,Assembly,"SB 381 Min Senate Third Reading By Davies",80,0,0,0,80
1702799,1354322,2023-09-13,Senate,"Unfinished Business SB381 Min et al. Concurrence",39,0,0,1,40
1702800,1311872,2023-04-26,Senate,"Do pass, but first be re-referred to the Committee on [Appropriations]",3,2,0,0,5
1702800,1320374,2023-05-08,Senate,"Placed on suspense file",7,0,0,0,7
1702800,1364120,2024-01-11,Senate,"Do pass and be ordered to the Consent Calendar",10,0,0,1,11
1702800,1366799,2024-01-18,Senate,"Consent Calendar 2nd SB382 Becker",37,0,0,3,40
1702800,1456371,2024-06-11,Assembly,"Do pass. To Consent Calendar",12,0,0,0,12
1702800,1458820,2024-06-20,Assembly,"SB 382 Becker Consent Calendar Second Day Regular Session",67,0,0,12,79
1702800,1465305,2024-08-19,Senate,"Unfinished Business SB382 Becker Concurrence",40,0,0,0,40
1702801,1296911,2023-04-10,Senate,"Do pass as amended",7,0,0,0,7
1702801,1306736,2023-04-20,Senate,"Senate 3rd Reading SB383 Portantino Urgency Clause",36,0,0,4,40
1702801,1326963,2023-05-17,Assembly,"Do pass",16,0,0,0,16
1702801,1341944,2023-06-08,Assembly,"SB 383 Portantino Third Reading Urgency By Holden",67,0,0,13,80
1702802,1308803,2023-04-24,Senate,"Do pass, but first be re-referred to the Committee on [Appropriations]",12,0,0,1,13
1702802,1324998,2023-05-15,Senate,"Senate 3rd Reading SB384 Bradford",38,0,0,2,40
1702802,1347817,2023-06-27,Assembly,"Do pass and be re-referred to the Committee on [Appropriations] with recommendation: To Consent Calendar",18,0,0,1,19
1702802,1352622,2023-09-01,Assembly,"Do pass",16,0,0,0,16
1702802,1353638,2023-09-11,Assembly,"SB 384 Bradford Senate Third Reading By Wendy Carrillo",78,0,0,2,80
1702803,1296912,2023-04-10,Senate,"Do pass, but first be re-referred to the Committee on [Judiciary]",10,3,0,0,13
1702803,1305373,2023-04-18,Senate,"Do pass, but first be re-referred to the Committee on [Appropriations]",9,2,0,0,11
1702803,1320399,2023-05-08,Senate,"Senate 3rd Reading SB385 Atkins",28,8,0,4,40
1702803,1345603,2023-06-20,Assembly,"Do pass and be re-referred to the Committee on [Judiciary]",13,4,0,2,19
1702803,1347888,2023-06-27,Assembly,"Do pass and be re-referred to the Committee on [Appropriations]",8,2,0,1,11
1702803,1351564,2023-08-16,Assembly,"Do pass",12,4,0,0,16
1702803,1352207,2023-08-24,Assembly,"SB 385 Atkins Senate Third Reading By Stephanie Nguyen",58,15,0,7,80
1702804,1305272,2023-04-18,Senate,"Do pass, but first be re-referred to the Committee on [Appropriations]",6,1,0,0,7
1702804,1330132,2023-05-22,Senate,"Senate 3rd Reading SB386 Newman",32,8,0,0,40
1702804,1346153,2023-06-21,Assembly,"Do pass and be re-referred to the Committee on [Appropriations]",6,1,0,1,8
1702804,1351572,2023-08-16,Assembly,"Do pass",12,4,0,0,16
1702804,1354349,2023-09-13,Assembly,"SB 386 Newman Senate Third Reading By Pellerin",62,17,0,1,80
1702804,1354814,2023-09-14,Senate,"Unfinished Business SB386 Newman Concurrence",32,8,0,0,40
1702805,1298271,2023-04-11,Senate,"Do pass as amended, but first amend, and re-refer to the Committee on [Appropriations]",14,0,0,1,15
1702805,1320566,2023-05-08,Senate,"Senate 3rd Reading SB387 Dodd et al",35,0,0,5,40
1702805,1341012,2023-06-07,Assembly,"Do pass as amended and be re-referred to the Committee on [Appropriations]",7,0,0,0,7
1702805,1352540,2023-09-01,Assembly,"Do pass as amended",11,0,0,5,16
1702805,1354190,2023-09-13,Assembly,"SB 387 Dodd Senate Third Reading By Wood",80,0,0,0,80
1702805,1354853,2023-09-14,Senate,"Unfinished Business SB387 Dodd et al. Concurrence",40,0,0,0,40
1702806,1299342,2023-04-12,Senate,"Do pass, but first be re-referred to the Committee on [Governmental Organization]",8,0,0,0,8
1702806,1310144,2023-04-25,Senate,"Do pass, but first be re-referred to the Committee on [Appropriations]",15,0,0,0,15
1702806,1320389,2023-05-08,Senate,"Placed on suspense file",7,0,0,0,7
1702806,1328257,2023-05-18,Senate,"Do pass",7,0,0,0,7
1702806,1333712,2023-05-25,Senate,"Special Consent SB388 Archuleta",40,0,0,0,40
1702806,1348462,2023-06-26,Assembly,"Do pass and be re-referred to the Committee on [Appropriations]",10,0,0,1,11
1702806,1352100,2023-08-23,Assembly,"Do pass. To Consent Calendar",15,0,0,1,16
1702806,1352467,2023-08-31,Assembly,"SB 388 Archuleta Consent Calendar Second Day Regular Session",79,0,0,1,80
1702807,1315141,2023-04-25,Senate,"Do pass as amended, but first amend, and re-refer to the Committee on [Appropriations]",6,3,0,2,11
1702807,1320509,2023-05-08,Senate,"Placed on suspense file",7,0,0,0,7
1702807,1328554,2023-05-18,Senate,"Do pass",5,2,0,0,7
1702807,1335545,2023-05-30,Senate,"Senate 3rd Reading SB389 Allen",23,11,0,6,40
1702807,1350255,2023-07-11,Assembly,"Do pass and be re-referred to the Committee on [Appropriations]",9,3,0,3,15
1702807,1351553,2023-08-16,Assembly,"Do pass",11,4,0,1,16
1702807,1353121,2023-09-05,Assembly,"SB 389 Allen Senate Third Reading By Bauer-Kahan",58,17,0,5,80
1702807,1353857,2023-09-12,Senate,"Unfinished Business SB389 Allen et al. Concurrence",30,8,0,2,40
1702808,1305236,2023-04-19,Senate,"Do pass, but first be re-referred to the Committee on [Judiciary]",5,0,0,2,7
1702808,1311647,2023-04-25,Senate,"Do pass, but first be re-referred to the Committee on [Appropriations]",10,0,0,1,11
1702808,1330029,2023-05-22,Senate,"Senate 3rd Reading SB390 Lim√≥n",33,0,0,7,40
1702808,1345194,2023-06-19,Assembly,"Do pass and be re-referred to the Committee on [Judiciary]",9,0,0,2,11
1702808,1349599,2023-07-05,Assembly,"Do pass and be re-referred to the Committee on [Appropriations]",8,0,0,3,11
1702808,1352791,2023-09-01,Assembly,"Do pass",13,0,0,3,16
1702808,1354210,2023-09-13,Assembly,"SB 390 Lim√≥n Senate Third Reading By Gabriel",67,0,0,13,80
1702809,1306733,2023-04-19,Senate,"Do pass, but first be re-referred to the Committee on [Appropriations] with the recommendation: To Consent Calendar",5,0,0,0,5
1702809,1315655,2023-05-01,Senate,"Placed on suspense file",6,0,0,1,7
1702809,1328584,2023-05-18,Senate,"Do pass",7,0,0,0,7
1702809,1333814,2023-05-25,Senate,"Special Consent SB391 Blakespear",40,0,0,0,40
1702809,1348425,2023-06-28,Assembly,"Do pass and be re-referred to the Committee on [Appropriations]",13,0,0,1,14
1702809,1352547,2023-09-01,Assembly,"Do pass",16,0,0,0,16
1702809,1353950,2023-09-12,Assembly,"SB 391 Blakespear Senate Third Reading By Grayson",80,0,0,0,80
1702809,1354240,2023-09-13,Senate,"Unfinished Business SB391 Blakespear Concurrence",39,0,0,1,40
1702810,1275537,2023-03-14,Senate,"Do pass, but first be re-referred to the Committee on [Appropriations]",13,0,0,2,15
1702810,1320402,2023-05-08,Senate,"Senate 3rd Reading SB392 Bradford et al",36,0,0,4,40
1702810,1344192,2023-06-14,Assembly,"Do pass and be re-referred to the Committee on [Appropriations]",21,0,0,1,22
1702810,1348475,2023-06-28,Assembly,"Do pass. To Consent Calendar",14,0,0,2,16
1702810,1353892,2023-09-12,Assembly,"SB 392 Bradford Senate Third Reading By Santiago",80,0,0,0,80
1702810,1354148,2023-09-13,Senate,"Unfinished Business SB392 Bradford et al. Concurrence",39,0,0,1,40
1702811,1276633,2023-03-15,Senate,"Do pass as amended, but first amend, and re-refer to the Committee on [Judiciary]",6,0,0,1,7
1702811,1317067,2023-05-02,Senate,"Do pass as amended",8,0,0,3,11
1702811,1324943,2023-05-15,Senate,"Senate 3rd Reading SB393 Glazer et al",32,0,0,8,40
1702811,1462290,2024-07-02,Assembly,"Do pass",11,0,0,1,12
1702811,1465591,2024-08-26,Assembly,"SB 393 Glazer Senate Third Reading By Bauer-Kahan",77,0,0,2,79
1702811,1466066,2024-08-28,Senate,"That the Assembly amendments be concurred in",11,0,0,0,11
1702811,1466514,2024-08-30,Senate,"Special Consent SB393 Glazer et al",40,0,0,0,40
1702812,1304284,2023-04-18,Senate,"Do pass, but first be re-referred to the Committee on [Education]",16,0,0,2,18
1702812,1311932,2023-04-26,Senate,"Do pass as amended, but first amend, and re-refer to the Committee on [Appropriations]",7,0,0,0,7
1702812,1325054,2023-05-15,Senate,"Placed on suspense file",7,0,0,0,7
1702812,1328295,2023-05-18,Senate,"Do pass",7,0,0,0,7
1702812,1330054,2023-05-22,Senate,"Senate 3rd Reading SB394 Gonzalez et al",40,0,0,0,40
1702812,1345193,2023-06-19,Assembly,"Do pass and be re-referred to the Committee on [Education]",11,0,0,0,11
1702812,1348841,2023-06-28,Assembly,"Do pass as amended and be re-referred to the Committee on [Appropriations]",7,0,0,0,7
1702812,1352817,2023-09-01,Assembly,"Do pass as amended",11,0,0,5,16
1702812,1354025,2023-09-12,Assembly,"SB 394 Gonzalez Senate Third Reading By Calderon",76,1,0,3,80
1702812,1354108,2023-09-13,Senate,"Unfinished Business SB394 Gonzalez et al. Concurrence",39,0,0,1,40
1702813,1305323,2023-04-18,Senate,"Do pass, but first be re-referred to the Committee on [Housing]",8,2,0,1,11
1702813,1315674,2023-05-01,Senate,"Placed on suspense file",6,0,0,1,7
1702817,1301035,2023-04-12,Senate,"Do pass, but first be re-referred to the Committee on [Judiciary]",4,1,0,0,5
1702817,1311933,2023-04-25,Senate,"Do pass as amended, but first amend, and re-refer to the Committee on [Appropriations]",9,2,0,0,11
1702817,1324978,2023-05-15,Senate,"Placed on suspense file",7,0,0,0,7
1702817,1328702,2023-05-18,Senate,"Do pass",5,2,0,0,7
1702817,1333701,2023-05-25,Senate,"Senate 3rd Reading SB399 Wahab et al",26,7,0,7,40
1702817,1348360,2023-06-28,Assembly,"Do pass and be re-referred to the Committee on [Judiciary]",5,1,0,1,7
1702817,1350165,2023-07-11,Assembly,"Do pass and be re-referred to the Committee on [Appropriations]",7,3,0,1,11
1702817,1464353,2024-08-15,Assembly,"Do pass as amended",10,3,0,2,15
1702817,1466499,2024-08-30,Assembly,"SB 399 Wahab Senate Third Reading By Haney",51,17,0,11,79
1702817,1466998,2024-08-31,Senate,"Unfinished Business SB399 Wahab et al. Concurrence",31,9,0,0,40
1702818,1298250,2023-04-11,Senate,"Do pass as amended",4,0,0,1,5
1702818,1325025,2023-05-15,Senate,"Senate 3rd Reading SB400 Wahab",33,0,0,7,40
1702818,1343733,2023-06-13,Assembly,"Do pass as amended",7,0,0,1,8
1702818,1353296,2023-09-06,Assembly,"SB 400 Wahab Senate Third Reading By Ortega",72,0,0,8,80
1702818,1353475,2023-09-07,Senate,"Unfinished Business SB400 Wahab Concurrence",40,0,0,0,40
1702818,1380146,2024-02-08,Assembly,"SB 400 Wahab Senate Third Reading By Ortega",67,0,0,13,80
1702818,1392728,2024-02-22,Senate,"Unfinished Business SB400 Wahab Concurrence",39,0,0,1,40
1702819,1288263,2023-03-29,Senate,"Do pass, but first be re-referred to the Committee on [Appropriations]",5,0,0,2,7
1702819,1302691,2023-04-17,Senate,"Placed on suspense file",6,0,0,1,7
1702819,1328913,2023-05-18,Senate,"Do pass",5,1,0,1,7
1702819,1332621,2023-05-24,Senate,"Senate 3rd Reading SB401 Lim√≥n et al",32,6,0,2,40
1702819,1349973,2023-07-10,Assembly,"Do pass as amended and be re-referred to the Committee on [Appropriations]",8,3,0,1,12
1702819,1353063,2023-09-01,Assembly,"Do pass as amended",11,4,0,1,16
1702819,1354395,2023-09-13,Assembly,"SB 401 Lim√≥n Senate Third Reading By Bauer-Kahan",57,17,0,6,80
1702819,1354822,2023-09-14,Senate,"Unfinished Business SB401 Lim√≥n et al. Concurrence",32,7,0,1,40
1702820,1363952,2024-01-10,Senate,"Do pass, but first be re-referred to the Committee on [Judiciary]",9,1,0,2,12
1702820,1364116,2024-01-11,Senate,"Do pass as amended",10,0,0,1,11
1702820,1371088,2024-01-29,Senate,"Senate 3rd Reading SB402 Wahab",37,1,0,2,40
1702820,1458256,2024-06-18,Assembly,"Do pass as amended and be re-referred to the Committee on [Judiciary]",16,0,0,0,16
1702820,1462295,2024-07-02,Assembly,"Do pass as amended and be re-referred to the Committee on [Appropriations]",10,0,0,2,12
1702821,1311657,2023-04-25,Senate,"Do pass, but first be re-referred to the Committee on [Appropriations]",11,0,0,0,11
1702821,1323784,2023-05-11,Senate,"Senate 3rd Reading SB403 Wahab et al",34,1,0,5,40
1702821,1349661,2023-07-05,Assembly,"Do pass as amended and be re-referred to the Committee on [Appropriations]",9,0,0,2,11
1702821,1351574,2023-08-16,Assembly,"Do pass",13,1,0,2,16
1702821,1352308,2023-08-28,Assembly,"SB 403 Wahab Senate Third Reading By Connolly",55,3,0,22,80
1702821,1353137,2023-09-05,Senate,"Unfinished Business SB403 Wahab et al. Motions Concurrence",31,5,0,4,40
1702822,1310279,2023-04-25,Senate,"Do pass, but first be re-referred to the Committee on [Appropriations]",5,0,0,0,5
1702822,1320555,2023-05-08,Senate,"Placed on suspense file",7,0,0,0,7
1702822,1328586,2023-05-18,Senate,"Do pass as amended",7,0,0,0,7
1702822,1332581,2023-05-24,Senate,"Senate 3rd Reading SB404 Wahab",40,0,0,0,40
1702822,1348353,2023-06-27,Assembly,"Do pass as amended and be re-referred to the Committee on [Appropriations]",8,0,0,0,8
1702823,1310284,2023-04-24,Senate,"Do pass as amended, but first amend, and re-refer to the Committee on [Appropriations]",11,0,0,0,11
1702823,1324935,2023-05-15,Senate,"Placed on suspense file",7,0,0,0,7
1702824,1276605,2023-03-15,Senate,"Do pass, but first be re-referred to the Committee on [Housing] with the recommendation: To Consent Calendar",7,0,0,0,7
1702824,1317025,2023-05-02,Senate,"Do pass and be ordered to the Consent Calendar",10,0,0,1,11
1702824,1320413,2023-05-08,Senate,"Consent Calendar SB406 Cortese",36,0,0,4,40
1702824,1343113,2023-06-12,Assembly,"Do pass as amended and be re-referred to the Committee on [Housing and Community Development]",10,0,0,1,11
1702824,1348443,2023-06-28,Assembly,"Do pass. To Consent Calendar",8,0,0,0,8
1702824,1349765,2023-07-06,Assembly,"SB 406 Cortese Consent Calendar Second Day Regular Session",70,0,0,10,80
1702824,1351675,2023-08-17,Senate,"Special Consent SB406 Cortese et al",38,0,0,2,40
1702825,1304409,2023-04-17,Senate,"Do pass, but first be re-referred to the Committee on [Judiciary]",3,0,0,2,5
1702825,1311684,2023-04-25,Senate,"Do pass as amended, but first amend, and re-refer to the Committee on [Appropriations]",8,2,0,1,11
1702825,1320553,2023-05-08,Senate,"Placed on suspense file",7,0,0,0,7
1702825,1328626,2023-05-18,Senate,"Do pass",5,2,0,0,7
1702825,1332608,2023-05-24,Senate,"Senate 3rd Reading SB407 Wiener et al",31,5,0,4,40
1702825,1345606,2023-06-20,Assembly,"Do pass and be re-referred to the Committee on [Appropriations]",6,2,0,0,8
1702825,1352641,2023-09-01,Assembly,"Do pass as amended",11,4,0,1,16
1702825,1354098,2023-09-13,Assembly,"SB 407 Wiener Senate Third Reading By Ward",61,14,0,5,80
1702825,1354846,2023-09-14,Senate,"Unfinished Business SB407 Wiener et al. Concurrence",32,8,0,0,40
1702826,1304441,2023-04-17,Senate,"Do pass, but first be re-referred to the Committee on [Health]",4,0,0,1,5
1702826,1304442,2023-04-17,Senate,"[04-18-2023] set for [First] hearing: Reconsideration of favorable vote granted",4,0,0,1,5
1702826,1304443,2023-04-17,Senate,"Do pass, but first be re-referred to the Committee on [Health]",3,0,0,2,5
1702826,1313392,2023-04-26,Senate,"Do pass as amended, but first amend, and re-refer to the Committee on [Appropriations]",10,0,0,2,12
1702826,1325042,2023-05-15,Senate,"Placed on suspense file",7,0,0,0,7
1702826,1328338,2023-05-18,Senate,"Do pass as amended",6,0,0,1,7
1702826,1332622,2023-05-24,Senate,"Senate 3rd Reading SB408 Ashby",40,0,0,0,40
1702826,1345596,2023-06-20,Assembly,"Do pass and be re-referred to the Committee on [Health]",8,0,0,0,8
1702826,1350185,2023-07-11,Assembly,"Do pass as amended and be re-referred to the Committee on [Appropriations]",15,0,0,0,15
1702827,1305227,2023-04-18,Senate,"Do pass, but first be re-referred to the Committee on [Appropriations]",6,0,0,1,7
1702827,1320551,2023-05-08,Senate,"Placed on suspense file",7,0,0,0,7
1702827,1328688,2023-05-18,Senate,"Do pass",7,0,0,0,7
1702827,1335531,2023-05-30,Senate,"Senate 3rd Reading SB409 Newman",39,0,0,1,40
1702827,1346217,2023-06-21,Assembly,"Do pass as amended and be re-referred to the Committee on [Appropriations]",7,0,0,1,8
1702828,1304396,2023-04-18,Senate,"Do pass as amended, but first amend, and re-refer to the Committee on [Appropriations]",17,0,0,1,18
1702828,1325041,2023-05-15,Senate,"Placed on suspense file",7,0,0,0,7
1702828,1328532,2023-05-18,Senate,"Do pass as amended",5,0,0,2,7
1702828,1332607,2023-05-24,Senate,"Senate 3rd Reading SB410 Becker",32,8,0,0,40
1702828,1350444,2023-07-12,Assembly,"Do pass as amended and be re-referred to the Committee on [Appropriations]",11,0,0,4,15
1702828,1353016,2023-09-01,Assembly,"Do pass as amended",11,3,0,2,16
1702828,1354869,2023-09-14,Senate,"Unfinished Business SB410 Becker Concurrence",32,8,0,0,40
1702828,1354870,2023-09-14,Assembly,"SB 410 Becker Senate Third Reading By Connolly",70,1,0,9,80
1702829,1305278,2023-04-19,Senate,"Do pass as amended, but first amend, and re-refer to the Committee on [Judiciary]",6,2,0,0,8
1702829,1317092,2023-05-02,Senate,"Do pass",9,1,0,1,11
1702829,1324974,2023-05-15,Senate,"Senate 3rd Reading SB411 Portantino et al. Urgency Clause",30,5,0,5,40
1702829,1350546,2023-07-12,Assembly,"Do pass as amended",7,0,0,1,8
1702829,1352213,2023-08-24,Assembly,"SB 411 Portantino Third Reading Urgency By Luz Rivas",59,12,0,9,80
1702829,1353330,2023-09-06,Senate,"Unfinished Business SB411 Portantino et al. Urgency Clause Concurrence",32,6,0,2,40
1702830,1280654,2023-03-21,Senate,"Do pass, but first be re-referred to the Committee on [Appropriations]",5,0,0,0,5
1702830,1315790,2023-05-01,Senate,"Senate 3rd Reading SB412 Archuleta",37,0,0,3,40
1702830,1343782,2023-06-13,Assembly,"Do pass and be re-referred to the Committee on [Appropriations]",8,0,0,0,8
1702830,1348384,2023-06-28,Assembly,"Do pass. To Consent Calendar",14,0,0,2,16
1702830,1353958,2023-09-12,Assembly,"SB 412 Archuleta Senate Third Reading By Ramos",80,0,0,0,80
1702831,1288343,2023-03-29,Senate,"Do pass and be ordered to the Consent Calendar",7,0,0,0,7
1702831,1301023,2023-04-13,Senate,"Consent Calendar SB413 Bradford",36,0,0,4,40
1702831,1350407,2023-07-12,Assembly,"Do pass as amended. To Consent Calendar",7,0,0,0,7
1702831,1352241,2023-08-24,Assembly,"SB 413 Bradford Consent Calendar Second Day Regular Session",73,0,0,7,80
1702831,1352807,2023-09-01,Senate,"Special Consent SB413 Bradford",37,0,0,3,40
1702832,1288171,2023-03-29,Senate,"Do pass as amended, but first amend, and re-refer to the Committee on [Environmental Quality]",7,0,0,1,8
1702832,1311713,2023-04-26,Senate,"Do pass as amended, but first amend, and re-refer to the Committee on [Appropriations]",6,0,0,1,7
1702832,1324948,2023-05-15,Senate,"Placed on suspense file",7,0,0,0,7
1702832,1328807,2023-05-18,Senate,"Do pass as amended",7,0,0,0,7
1702832,1332566,2023-05-24,Senate,"Senate 3rd Reading SB414 Allen",40,0,0,0,40
1702832,1345197,2023-06-19,Assembly,"Do pass and be re-referred to the Committee on [Appropriations]",11,0,0,0,11
1702833,1305387,2023-04-19,Senate,"Do pass, but first be re-referred to the Committee on [Appropriations]",5,1,0,1,7
1702833,1315772,2023-05-01,Senate,"Placed on suspense file",6,0,0,1,7
1702834,1286951,2023-03-28,Senate,"Do pass, but first be re-referred to the Committee on [Environmental Quality]",12,0,0,3,15
1702834,1302588,2023-04-17,Senate,"Placed on suspense file",6,0,0,1,7
1702834,1328737,2023-05-18,Senate,"Do pass as amended",5,0,0,2,7
1702834,1332638,2023-05-24,Senate,"Senate 3rd Reading SB416 Laird et al",36,0,0,4,40
1702834,1346298,2023-06-21,Assembly,"Do pass and be re-referred to the Committee on [Appropriations]",6,0,0,1,7
1702834,1352981,2023-09-01,Assembly,"Do pass",14,2,0,0,16
1702834,1353608,2023-09-11,Assembly,"SB 416 Laird Senate Third Reading By Friedman",68,4,0,8,80
1702834,1354046,2023-09-12,Senate,"Unfinished Business SB416 Laird et al. Concurrence",35,0,0,5,40
1702835,1304292,2023-04-18,Senate,"Do pass",5,0,0,0,5
1702835,1323792,2023-05-11,Senate,"Senate 3rd Reading SB417 Blakespear",32,4,0,4,40
1702835,1343744,2023-06-13,Assembly,"Do pass",7,0,0,1,8
1702835,1351287,2023-08-14,Assembly,"SB 417 Blakespear Senate Third Reading By Irwin",63,0,0,17,80
1702835,1353209,2023-09-06,Senate,"Unfinished Business SB417 Blakespear et al. Concurrence",32,5,0,3,40
1702836,1296984,2023-04-10,Senate,"Do pass, but first be re-referred to the Committee on [Public Safety]",12,0,0,1,13
1702836,1310348,2023-04-25,Senate,"Do pass, but first be re-referred to the Committee on [Appropriations] with the recommendation: To Consent Calendar",5,0,0,0,5
1702836,1320489,2023-05-08,Senate,"Placed on suspense file",7,0,0,0,7
1702836,1328369,2023-05-18,Senate,"Do pass as amended",6,0,0,1,7
1702836,1336343,2023-05-31,Senate,"Senate 3rd Reading SB418 Padilla",38,0,0,2,40
1702836,1350161,2023-07-11,Assembly,"Do pass as amended and be re-referred to the Committee on [Appropriations]",7,0,0,0,7
1702836,1350162,2023-07-11,Assembly,"Amendments (Committee's)",7,0,0,0,7
1702837,1318056,2023-05-03,Senate,"Do pass as amended, but first amend, and re-refer to the Committee on [Appropriations]",7,0,0,1,8
1702837,1325011,2023-05-15,Senate,"Placed on suspense file",7,0,0,0,7
1702837,1328461,2023-05-18,Senate,"Do pass",7,0,0,0,7
1702837,1333608,2023-05-25,Senate,"Special Consent SB419 Roth et al",40,0,0,0,40
1702837,1350233,2023-07-10,Assembly,"Do pass and be re-referred to the Committee on [Appropriations]",10,0,0,1,11
1702837,1352806,2023-09-01,Assembly,"Do pass",16,0,0,0,16
1702837,1353813,2023-09-12,Assembly,"SB 419 Roth Senate Third Reading By Muratsuchi",80,0,0,0,80
1702837,1354248,2023-09-13,Senate,"Unfinished Business SB419 Roth et al. Concurrence",39,0,0,1,40
1702838,1288277,2023-03-29,Senate,"Do pass as amended, but first amend, and re-refer to the Committee on [Energy, Utilities and Communications] with the recommendation: To Consent Calendar",7,0,0,0,7
1702838,1310253,2023-04-24,Senate,"Do pass as amended, but first amend, and re-refer to the Committee on [Appropriations]",17,0,0,1,18
1702838,1325006,2023-05-15,Senate,"Placed on suspense file",7,0,0,0,7
1702838,1328384,2023-05-18,Senate,"Do pass as amended",7,0,0,0,7
1702838,1335385,2023-05-30,Senate,"Special Consent SB420 Becker",40,0,0,0,40
1702838,1350408,2023-07-12,Assembly,"Do pass and be re-referred to the Committee on [Appropriations]",13,0,0,2,15
1702838,1350775,2023-07-10,Assembly,"Do pass and be re-referred to the Committee on [Utilities and Energy]",11,0,0,0,11
1702838,1352103,2023-08-23,Assembly,"Do pass. To Consent Calendar",15,0,0,1,16
1702838,1353609,2023-09-11,Assembly,"SB 420 Becker Senate Third Reading By Muratsuchi",78,1,0,1,80
1702838,1354276,2023-09-13,Senate,"That the Assembly amendments be concurred in",15,0,0,3,18
1702838,1354511,2023-09-14,Senate,"Unfinished Business SB420 Becker et al. Concurrence",40,0,0,0,40
1705789,1286898,2023-03-28,Assembly,"Do pass",7,2,0,2,11
1705789,1296904,2023-04-10,Assembly,"AB 665 Wendy Carrillo Assembly Third Reading",55,9,0,16,80
1705789,1345589,2023-06-20,Senate,"Do pass",9,2,0,0,11
1705789,1353220,2023-09-06,Senate,"Assembly 3rd Reading AB665 Wendy Carrillo et al",31,8,0,1,40
1705789,1353529,2023-09-07,Assembly,"AB 665 Wendy Carrillo Concurrence in Senate Amendments",60,16,0,4,80
1705791,1363738,2024-01-09,Assembly,"Do pass and be re-referred to the Committee on [Appropriations]",7,0,0,1,8
1705791,1366800,2024-01-18,Assembly,"Do pass",13,0,0,3,16
1705791,1369545,2024-01-25,Assembly,"AB 667 Maienschein Assembly Third Reading",61,1,0,18,80
1705795,1299389,2023-04-12,Assembly,"Do pass as amended and be re-referred to the Committee on [Appropriations]",7,0,0,1,8
1705795,1327951,2023-05-18,Assembly,"Do pass",12,2,0,2,16
1705795,1335458,2023-05-30,Assembly,"AB 671 Ward Assembly Third Reading",77,1,0,2,80
1705795,1350292,2023-07-10,Senate,"Do pass, but first be re-referred to the Committee on [Appropriations]",11,0,0,0,11
1705795,1351447,2023-08-14,Senate,"Placed on suspense file",7,0,0,0,7
1705795,1352942,2023-09-01,Senate,"Do pass",7,0,0,0,7
1705795,1354329,2023-09-13,Senate,"Assembly 3rd Reading AB671 Ward et al. By Rubio",39,0,0,1,40
1705795,1354714,2023-09-14,Assembly,"AB 671 Ward Concurrence in Senate Amendments",79,0,0,1,80
1705796,1300986,2023-04-12,Assembly,"Do pass as amended and be re-referred to the Committee on [Appropriations]",7,0,0,0,7
1705796,1328510,2023-05-18,Assembly,"Do pass",15,0,0,1,16
1705796,1337984,2023-05-31,Assembly,"AB 672 Jackson Assembly Third Reading",80,0,0,0,80
1705796,1460641,2024-06-25,Senate,"Do pass, but first be re-referred to the Committee on [Appropriations] with the recommendation: To Consent Calendar",11,0,0,0,11
1705796,1463832,2024-08-12,Senate,"Consent Calendar 2nd AB672 Jackson",38,0,0,2,40
1705796,1465263,2024-08-19,Assembly,"With recommendation: That Senate amendments be concurred in",9,0,0,3,12
1705796,1465493,2024-08-22,Assembly,"AB 672 Jackson Concurrence in Senate Amendments",61,0,0,18,79
1705797,1280641,2023-03-20,Assembly,"Do pass and be re-referred to the Committee on [Natural Resources]",15,0,0,0,15
1705797,1301978,2023-04-10,Assembly,"Do pass and be re-referred to the Committee on [Appropriations]",10,0,0,1,11
1705799,1313317,2023-04-27,Assembly,"Do pass as amended and be re-referred to the Committee on [Appropriations]",5,0,0,3,8
1705800,1317056,2023-05-02,Assembly,"Do pass as amended",10,4,0,1,15
1705800,1330069,2023-05-22,Assembly,"AB 676 Bennett Assembly Third Reading",54,17,0,9,80
1705800,1349952,2023-07-10,Senate,"Do pass as amended",6,3,0,2,11
1705800,1353521,2023-09-07,Senate,"Assembly 3rd Reading AB676 Bennett By Padilla",26,11,0,3,40
1705800,1353631,2023-09-11,Assembly,"AB 676 Bennett Concurrence in Senate Amendments",59,14,0,7,80
1705802,1281822,2023-03-22,Assembly,"Do pass as amended and be re-referred to the Committee on [Natural Resources]",12,0,0,3,15
1705802,1310160,2023-04-24,Assembly,"Do pass and be re-referred to the Committee on [Appropriations]",9,0,0,2,11
1705802,1322859,2023-05-10,Assembly,"Do pass",12,3,0,1,16
1705802,1330075,2023-05-22,Assembly,"AB 678 Alvarez Assembly Third Reading",61,9,0,10,80
1705802,1349476,2023-07-03,Senate,"Do pass as amended, but first amend, and re-refer to the Committee on [Appropriations]",11,2,0,5,18
1705802,1354106,2023-09-13,Senate,"Assembly 3rd Reading AB678 Alvarez By Bradford",33,0,0,7,40
1705802,1354107,2023-09-13,Assembly,"AB 678 Alvarez Concurrence in Senate Amendments",62,8,0,10,80
1705803,1286954,2023-03-28,Assembly,"Do pass and be re-referred to the Committee on [Education]",7,0,0,1,8
1705803,1313355,2023-04-26,Assembly,"Do pass as amended, and be re-referred to the Committee on [Appropriations] with recommendation: To Consent Calendar",7,0,0,0,7
1705804,1298181,2023-04-11,Assembly,"Do pass and be re-referred to the Committee on [Appropriations]",9,1,0,2,12
1705806,1288167,2023-03-28,Assembly,"Do pass and be re-referred to the Committee on [Appropriations] with recommendation: To Consent Calendar",9,0,0,0,9
1705806,1305440,2023-04-19,Assembly,"Do pass. To Consent Calendar",14,0,0,2,16
1705806,1313363,2023-04-27,Assembly,"AB 682 Mathis Consent Calendar Second Day Regular Session",79,0,0,1,80
1705806,1340988,2023-06-07,Senate,"Do pass, but first be re-referred to the Committee on [Natural Resources and Water] with the recommendation: To Consent Calendar",7,0,0,0,7
1705806,1346965,2023-06-22,Senate,"Do pass, but first be re-referred to the Committee on [Appropriations]",9,0,0,2,11
1705806,1354220,2023-09-13,Senate,"Assembly 3rd Reading AB682 Mathis By Lim√≥n",39,0,0,1,40
1705808,1305234,2023-04-18,Assembly,"Do pass and be re-referred to the Committee on [Appropriations] with recommendation: To Consent Calendar",11,0,0,0,11
1705809,1281858,2023-03-22,Assembly,"Do pass and be re-referred to the Committee on [Appropriations]",7,0,0,0,7
1705811,1304423,2023-04-18,Assembly,"Do pass and be re-referred to the Committee on [Appropriations]",17,0,0,1,18
1705811,1328670,2023-05-18,Assembly,"Do pass",15,0,0,1,16
1705811,1338172,2023-05-31,Assembly,"AB 687 Hart Assembly Third Reading",80,0,0,0,80
1705811,1347493,2023-06-26,Senate,"Do pass, but first be re-referred to the Committee on [Appropriations]",12,0,0,1,13
1705811,1351839,2023-08-21,Senate,"Placed on suspense file",7,0,0,0,7
1705813,1311859,2023-04-25,Assembly,"Do pass and be re-referred to the Committee on [Appropriations]",11,0,0,1,12
1705813,1328344,2023-05-18,Assembly,"Do pass",12,0,0,4,16
1705813,1337922,2023-05-31,Assembly,"AB 689 Wendy Carrillo Assembly Third Reading",75,3,0,2,80
1705813,1349602,2023-07-05,Senate,"Do pass as amended, but first amend, and re-refer to the Committee on [Appropriations]",6,0,0,1,7
1705813,1351458,2023-08-14,Senate,"Placed on suspense file",7,0,0,0,7
1705814,1280662,2023-03-21,Assembly,"Do pass and be re-referred to the Committee on [Appropriations] with recommendation: To Consent Calendar",11,0,0,0,11
1705814,1305413,2023-04-19,Assembly,"Do pass. To Consent Calendar",14,0,0,2,16
1705814,1313486,2023-04-27,Assembly,"AB 690 Chen Consent Calendar Second Day Regular Session",79,0,0,1,80
1705814,1343702,2023-06-13,Senate,"Do pass, but first be re-referred to the Committee on [Appropriations] with the recommendation: To Consent Calendar",10,0,0,1,11
1705814,1347547,2023-06-26,Senate,"Do pass",6,0,0,1,7
1705814,1354005,2023-09-12,Senate,"Assembly 3rd Reading AB690 Chen By Wilk",38,0,0,2,40
1705815,1299481,2023-04-12,Assembly,"Do pass and be re-referred to the Committee on [Appropriations] with recommendation: To Consent Calendar",15,0,0,0,15
1705815,1318031,2023-05-03,Assembly,"Do pass. To Consent Calendar",16,0,0,0,16
1705815,1323844,2023-05-11,Assembly,"AB 691 Ting Consent Calendar Second Day Regular Session",66,0,0,14,80
1705815,1459328,2024-06-24,Senate,"Do pass, but first be re-referred to the Committee on [Appropriations]",13,4,0,1,18
1705815,1463569,2024-08-05,Senate,"Placed on suspense file",7,0,0,0,7
1705816,1285597,2023-03-27,Assembly,"Do pass and be re-referred to the Committee on [Appropriations]",9,0,0,2,11
1705818,1283229,2023-03-22,Assembly,"Do pass as amended and be re-referred to the Committee on [Appropriations]",7,0,0,0,7
1705818,1328134,2023-05-18,Assembly,"Do pass",15,0,0,1,16
1705818,1333756,2023-05-25,Assembly,"AB 694 Gipson Assembly Third Reading",75,0,0,5,80
1705818,1344172,2023-06-14,Senate,"Do pass, but first be re-referred to the Committee on [Labor, Public Employment and Retirement ] with the recommendation: To Consent Calendar",7,0,0,0,7
1705818,1346938,2023-06-22,Senate,"Do pass as amended, but first amend, and re-refer to the Committee on [Appropriations] with the recommendation: To Consent Calendar",5,0,0,0,5
1705818,1349989,2023-07-10,Senate,"Placed on suspense file",6,0,0,1,7
1705819,1310241,2023-04-25,Assembly,"Do pass as amended and be re-referred to the Committee on [Appropriations]",7,0,0,1,8
1705819,1328278,2023-05-18,Assembly,"Do pass as amended",14,1,0,1,16
1705819,1335601,2023-05-30,Assembly,"AB 695 Pacheco Assembly Third Reading",72,1,0,7,80
1705819,1345667,2023-06-20,Senate,"Do pass, but first be re-referred to the Committee on [Appropriations]",3,0,0,2,5
1705819,1349480,2023-07-03,Senate,"Placed on suspense file",7,0,0,0,7
1705819,1353004,2023-09-01,Senate,"Do pass",6,0,0,1,7
1705819,1354412,2023-09-13,Senate,"Assembly 3rd Reading AB695 Pacheco By Umberg",30,6,0,4,40
1705819,1354590,2023-09-14,Assembly,"AB 695 Pacheco Concurrence in Senate Amendments",75,0,0,5,80
1705820,1305274,2023-04-19,Assembly,"Do pass as amended, and be re-referred to the Committee on [Appropriations] with recommendation: To Consent Calendar",6,0,0,1,7
1705820,1328639,2023-05-18,Assembly,"Do pass as amended",11,0,0,5,16
1705820,1335536,2023-05-30,Assembly,"AB 696 Lowenthal Assembly Third Reading",80,0,0,0,80
1705820,1350286,2023-07-11,Senate,"Do pass, but first be re-referred to the Committee on [Appropriations] with the recommendation: To Consent Calendar",14,0,0,1,15
1705820,1351258,2023-08-14,Senate,"Placed on suspense file",7,0,0,0,7
1705821,1281917,2023-03-21,Assembly,"Do pass and be re-referred to the Committee on [Appropriations] with recommendation: To Consent Calendar",8,0,0,0,8
1705823,1281848,2023-03-22,Assembly,"Do pass and be re-referred to the Committee on [Appropriations]",12,0,0,2,14
1705823,1305450,2023-04-19,Assembly,"Do pass. To Consent Calendar",14,0,0,2,16
1705823,1313461,2023-04-27,Assembly,"AB 699 Weber Consent Calendar Second Day Regular Session",79,0,0,1,80
1705823,1344225,2023-06-14,Senate,"Do pass, but first be re-referred to the Committee on [Appropriations]",5,0,0,0,5
1705823,1353957,2023-09-12,Assembly,"AB 699 Weber Concurrence in Senate Amendments",80,0,0,0,80
1705823,1354788,2023-09-11,Senate,"Assembly 3rd Reading AB699 Weber et al. By Blakespear",39,0,0,1,40
1705824,1288248,2023-03-28,Assembly,"Do pass and be re-referred to the Committee on [Appropriations] with recommendation: To Consent Calendar",14,0,0,1,15
1705824,1328039,2023-05-18,Assembly,"Do pass",15,0,0,1,16
1705824,1338101,2023-05-31,Assembly,"AB 700 Grayson Assembly Third Reading",80,0,0,0,80
1705824,1349621,2023-07-05,Senate,"Do pass, but first be re-referred to the Committee on [Appropriations] with the recommendation: To Consent Calendar",7,0,0,0,7
1705824,1351530,2023-08-14,Senate,"Placed on suspense file",7,0,0,0,7
1705824,1352507,2023-09-01,Senate,"Do pass as amended",7,0,0,0,7
1705824,1354304,2023-09-13,Senate,"Special Consent AB700 Grayson et al",39,0,0,1,40
1705824,1354736,2023-09-14,Assembly,"AB 700 Grayson Concurrence in Senate Amendments",80,0,0,0,80
1705825,1281883,2023-03-21,Assembly,"Do pass and be re-referred to the Committee on [Appropriations]",4,0,0,4,8
1705825,1313507,2023-04-27,Assembly,"Do pass and be re-referred to the Committee on [Appropriations]",6,0,0,2,8
1705825,1328814,2023-05-18,Assembly,"Do pass",14,0,0,2,16
1705825,1333742,2023-05-25,Assembly,"AB 701 Villapudua Assembly Third Reading",72,0,0,8,80
1705825,1347808,2023-06-27,Senate,"Do pass, but first be re-referred to the Committee on [Appropriations]",5,0,0,0,5
1705825,1351506,2023-08-14,Senate,"Placed on suspense file",7,0,0,0,7
1705825,1352849,2023-09-01,Senate,"Do pass as amended",7,0,0,0,7
1705825,1353729,2023-09-12,Senate,"Assembly 3rd Reading AB701 Villapudua et al. By Dodd",38,0,0,2,40
1705825,1354376,2023-09-13,Assembly,"AB 701 Villapudua Concurrence in Senate Amendments",78,0,0,2,80
1705828,1285693,2023-03-27,Assembly,"Do pass as amended and be re-referred to the Committee on [Appropriations]",10,1,0,0,11
1705829,1280692,2023-03-20,Assembly,"Do pass and be re-referred to the Committee on [Appropriations] with recommendation: To Consent Calendar",15,0,0,0,15
1705829,1288322,2023-03-29,Assembly,"Do pass. To Consent Calendar",14,0,0,2,16
1705829,1302633,2023-04-17,Assembly,"AB 705 Lowenthal Consent Calendar Second Day Regular Session",79,0,0,1,80
1705829,1343730,2023-06-13,Senate,"Do pass, but first be re-referred to the Committee on [Appropriations] with the recommendation: To Consent Calendar",16,0,0,0,16
1705829,1348868,2023-06-29,Senate,"Consent Calendar AB705 Lowenthal",39,0,0,1,40
1705830,1285690,2023-03-27,Assembly,"Do pass and be re-referred to the Committee on [Appropriations] with recommendation: To Consent Calendar",11,0,0,0,11
1705830,1305480,2023-04-19,Assembly,"Do pass. To Consent Calendar",14,0,0,2,16
1705830,1330057,2023-05-22,Assembly,"AB 706 Luz Rivas Assembly Third Reading",77,0,0,3,80
1705830,1346978,2023-06-22,Senate,"Do pass, but first be re-referred to the Committee on [Appropriations] with the recommendation: To Consent Calendar",11,0,0,0,11
1705830,1350692,2023-07-13,Senate,"Consent Calendar AB706 Luz Rivas",37,0,0,3,40
1705833,1299381,2023-04-11,Assembly,"Do pass. To Consent Calendar",8,0,0,0,8
1705833,1306728,2023-04-20,Assembly,"AB 709 McKinnor Consent Calendar Second Day Regular Session",76,0,0,4,80
1705833,1343707,2023-06-13,Senate,"Do pass as amended, but first amend, and re-refer to the Committee on [Appropriations]",5,0,0,0,5
1705833,1354421,2023-09-13,Assembly,"With recommendation: That Senate amendments be concurred in",7,0,0,1,8
1705833,1354422,2023-09-13,Assembly,"AB 709 McKinnor Concurrence in Senate Amendments",79,0,0,1,80
1705833,1354777,2023-09-11,Senate,"Assembly 3rd Reading AB709 McKinnor et al. By Skinner",39,0,0,1,40
1705834,1310349,2023-04-25,Assembly,"Do pass as amended and be re-referred to the Committee on [Appropriations]",11,4,0,0,15
1705836,1304324,2023-04-18,Assembly,"Do pass and be re-referred to the Committee on [Appropriations]",7,0,0,1,8
1705836,1318037,2023-05-03,Assembly,"Do pass. To Consent Calendar",16,0,0,0,16
1705836,1323822,2023-05-11,Assembly,"AB 712 Wendy Carrillo Consent Calendar Second Day Regular Session",66,0,0,14,80
1705836,1345554,2023-06-19,Senate,"Do pass, but first be re-referred to the Committee on [Appropriations] with the recommendation: To Consent Calendar",5,0,0,0,5
1705836,1350654,2023-07-13,Senate,"Consent Calendar AB712 Wendy Carrillo",37,0,0,3,40
1705838,1289813,2023-03-29,Assembly,"Do pass as amended and be re-referred to the Committee on [Appropriations]",7,0,0,0,7
1705838,1328106,2023-05-18,Assembly,"Do pass as amended",11,0,0,5,16
1705838,1335588,2023-05-30,Assembly,"AB 714 McCarty Assembly Third Reading",80,0,0,0,80
1705838,1350494,2023-07-12,Senate,"Do pass, but first be re-referred to the Committee on [Appropriations]",7,0,0,0,7
1705838,1351300,2023-08-14,Senate,"Placed on suspense file",7,0,0,0,7
1705838,1352846,2023-09-01,Senate,"Do pass as amended",7,0,0,0,7
1705838,1353750,2023-09-12,Senate,"Assembly 3rd Reading AB714 McCarty et al. By Durazo",38,0,0,2,40
1705838,1354439,2023-09-13,Assembly,"AB 714 McCarty Concurrence in Senate Amendments",76,0,0,4,80
1705839,1283105,2023-03-22,Assembly,"Do pass and be re-referred to the Committee on [Appropriations] with recommendation: To Consent Calendar",7,0,0,0,7
1705839,1328368,2023-05-18,Assembly,"Do pass as amended",15,0,0,1,16
1705839,1338000,2023-05-31,Assembly,"AB 715 Megan Dahle Assembly Third Reading",80,0,0,0,80
1705839,1348427,2023-06-28,Senate,"Do pass, but first be re-referred to the Committee on [Appropriations] with the recommendation: To Consent Calendar",7,0,0,0,7
1705839,1349968,2023-07-10,Senate,"Placed on suspense file",6,0,0,1,7
1705840,1304374,2023-04-17,Assembly,"Do pass as amended and be re-referred to the Committee on [Health]",6,0,0,1,7
1705840,1310335,2023-04-25,Assembly,"Do pass as amended and be re-referred to the Committee on [Appropriations]",14,0,0,1,15
1705840,1328885,2023-05-18,Assembly,"Do pass",14,0,0,2,16
1705840,1335569,2023-05-30,Assembly,"AB 716 Boerner Assembly Third Reading",80,0,0,0,80
1705840,1349731,2023-07-05,Senate,"Do pass as amended, but first amend, and re-refer to the Committee on [Appropriations]",11,0,0,1,12
1705840,1351450,2023-08-14,Senate,"Placed on suspense file",7,0,0,0,7
1705840,1352488,2023-09-01,Senate,"Do pass",7,0,0,0,7
1705840,1353833,2023-09-12,Assembly,"AB 716 Boerner Concurrence in Senate Amendments",80,0,0,0,80
1705840,1354559,2023-09-11,Senate,"Assembly 3rd Reading AB716 Boerner et al. By Menjivar",39,0,0,1,40
1705841,1310236,2023-04-25,Assembly,"Do pass and be re-referred to the Committee on [Appropriations] with recommendation: To Consent Calendar",11,0,0,0,11
1705841,1322855,2023-05-10,Assembly,"Do pass. To Consent Calendar",14,0,0,2,16
1705841,1328032,2023-05-18,Assembly,"AB 717 Villapudua Consent Calendar Second Day Regular Session",74,0,0,6,80
1705841,1345640,2023-06-20,Senate,"Do pass, but first be re-referred to the Committee on [Appropriations] with the recommendation: To Consent Calendar",11,0,0,0,11
1705842,1288269,2023-03-28,Assembly,"Do pass and be re-referred to the Committee on [Appropriations]",11,0,0,0,11
1705842,1327976,2023-05-18,Assembly,"Do pass",15,0,0,1,16
1705842,1335506,2023-05-30,Assembly,"AB 718 Ta Assembly Third Reading",80,0,0,0,80
1705842,1350291,2023-07-10,Senate,"Do pass, but first be re-referred to the Committee on [Appropriations] with the recommendation: To Consent Calendar",4,0,0,1,5
1705842,1351397,2023-08-14,Senate,"Placed on suspense file",7,0,0,0,7
1705842,1353007,2023-09-01,Senate,"Do pass as amended",7,0,0,0,7
1705842,1466331,2024-08-29,Senate,"Assembly 3rd Reading AB718 Ta et al. By Seyarto",40,0,0,0,40
1705842,1466500,2024-08-30,Assembly,"AB 718 Ta Concurrence in Senate Amendments",77,0,0,2,79
1705843,1298254,2023-04-11,Assembly,"Do pass and be re-referred to the Committee on [Appropriations]",11,0,0,4,15
1705843,1328191,2023-05-18,Assembly,"Do pass",11,1,0,4,16
1705843,1335518,2023-05-30,Assembly,"AB 719 Boerner Assembly Third Reading",65,0,0,15,80
1705843,1349758,2023-07-05,Senate,"Do pass as amended, but first amend, and re-refer to the Committee on [Appropriations]",12,0,0,0,12
1705843,1351491,2023-08-14,Senate,"Placed on suspense file",7,0,0,0,7
1705843,1353068,2023-09-01,Senate,"Do pass",7,0,0,0,7
1705843,1353966,2023-09-12,Assembly,"AB 719 Boerner Concurrence in Senate Amendments",77,0,0,3,80
1705843,1354531,2023-09-11,Senate,"Assembly 3rd Reading AB719 Boerner By Lim√≥n",39,0,0,1,40
1705844,1305367,2023-04-18,Assembly,"Do pass and be re-referred to the Committee on [Appropriations] with recommendation: To Consent Calendar",15,0,0,0,15
1705844,1328593,2023-05-18,Assembly,"Do pass",15,0,0,1,16
1705844,1333543,2023-05-25,Assembly,"AB 720 Addis Assembly Third Reading",76,0,0,4,80
1705844,1346979,2023-06-22,Senate,"Do pass, but first be re-referred to the Committee on [Appropriations]",9,0,0,2,11
1705844,1349489,2023-07-03,Senate,"Placed on suspense file",7,0,0,0,7
1705845,1283148,2023-03-22,Assembly,"Do pass as amended and be re-referred to the Committee on [Appropriations]",7,0,0,0,7
1705845,1305447,2023-04-19,Assembly,"Do pass. To Consent Calendar",14,0,0,2,16
1705845,1315801,2023-05-01,Assembly,"AB 721 Valencia Assembly Third Reading",77,0,0,3,80
1705845,1350484,2023-07-12,Senate,"Do pass as amended, but first amend, and re-refer to the Committee on [Appropriations]",6,0,0,1,7
1705845,1353133,2023-09-05,Senate,"Assembly 3rd Reading AB721 Valencia et al. By Glazer",39,0,0,1,40
1705845,1353519,2023-09-07,Assembly,"AB 721 Valencia Concurrence in Senate Amendments",76,0,0,4,80
1705846,1288284,2023-03-29,Assembly,"Do pass",7,1,0,0,8
1705846,1320442,2023-05-08,Assembly,"AB 722 Bonta Assembly Third Reading",60,0,0,20,80
1705846,1346154,2023-06-21,Senate,"Do pass, but first be re-referred to the Committee on [Health]",7,0,0,1,8
1705846,1350665,2023-07-12,Senate,"Do pass",10,0,0,2,12
1705846,1353312,2023-09-06,Senate,"Assembly 3rd Reading AB722 Bonta et al. By Wahab",36,3,0,1,40
1705847,1283092,2023-03-22,Assembly,"Do pass and be re-referred to the Committee on [Appropriations] with recommendation: To Consent Calendar",7,0,0,0,7
1705847,1305289,2023-04-19,Assembly,"Do pass. To Consent Calendar",14,0,0,2,16
1705847,1313468,2023-04-27,Assembly,"AB 723 Quirk-Silva Consent Calendar Second Day Regular Session",79,0,0,1,80
1705847,1341009,2023-06-07,Senate,"Do pass, but first be re-referred to the Committee on [Human Services] with the recommendation: To Consent Calendar",7,0,0,0,7
1705847,1349654,2023-07-03,Senate,"Do pass, but first be re-referred to the Committee on [Appropriations]",5,0,0,0,5
1705847,1351431,2023-08-14,Senate,"Placed on suspense file",7,0,0,0,7
1705847,1352918,2023-09-01,Senate,"Do pass",7,0,0,0,7
1705847,1353829,2023-09-12,Assembly,"AB 723 Quirk-Silva Concurrence in Senate Amendments",80,0,0,0,80
1705847,1354763,2023-09-11,Senate,"Assembly 3rd Reading AB723 Quirk-Silva et al. By Ochoa Bogh",39,0,0,1,40
1705848,1281856,2023-03-21,Assembly,"Do pass and be re-referred to the Committee on [Appropriations] with recommendation: To Consent Calendar",8,0,0,0,8
1705848,1305306,2023-04-19,Assembly,"Do pass. To Consent Calendar",14,0,0,2,16
1705848,1313324,2023-04-27,Assembly,"AB 724 Vince Fong Consent Calendar Second Day Regular Session",79,0,0,1,80
1705848,1340044,2023-06-06,Senate,"Do pass as amended, but first amend, and re-refer to the Committee on [Appropriations] with the recommendation: To Consent Calendar",5,0,0,0,5
1705848,1348843,2023-06-29,Senate,"Consent Calendar AB724 Vince Fong By Ochoa Bogh",39,0,0,1,40
1705848,1353280,2023-09-06,Senate,"Assembly 3rd Reading AB724 Vince Fong By Ochoa Bogh",40,0,0,0,40
1705848,1353388,2023-09-07,Assembly,"AB 724 Vince Fong Concurrence in Senate Amendments",78,0,0,2,80
1705849,1281824,2023-03-21,Assembly,"Do pass and be re-referred to the Committee on [Appropriations]",7,1,0,0,8
1705849,1328781,2023-05-18,Assembly,"Do pass",11,3,0,2,16
1705849,1335470,2023-05-30,Assembly,"AB 725 Lowenthal Assembly Third Reading",63,11,0,6,80
1705849,1345621,2023-06-20,Senate,"Do pass, but first be re-referred to the Committee on [Appropriations]",4,1,0,0,5
1705849,1349527,2023-07-03,Senate,"Placed on suspense file",7,0,0,0,7
1705849,1352857,2023-09-01,Senate,"Do pass as amended",5,2,0,0,7
1705849,1353939,2023-09-12,Senate,"Assembly 3rd Reading AB725 Lowenthal By Blakespear",30,7,0,3,40
1705849,1354331,2023-09-13,Assembly,"AB 725 Lowenthal Concurrence in Senate Amendments",62,13,0,5,80
1705851,1305366,2023-04-18,Assembly,"Do pass and be re-referred to the Committee on [Appropriations]",7,2,0,0,9
1705851,1318081,2023-05-03,Assembly,"Do pass",12,4,0,0,16
1705851,1324962,2023-05-15,Assembly,"AB 727 Weber Assembly Third Reading",62,2,0,16,80
1705851,1346235,2023-06-21,Senate,"Do pass as amended, but first amend, and re-refer to the Committee on [Judiciary]",5,0,0,2,7
1705851,1349798,2023-07-06,Senate,"Do pass as amended, but first amend, and re-refer to the Committee on [Appropriations]",8,1,0,2,11
1705851,1353852,2023-09-12,Senate,"Assembly 3rd Reading AB727 Weber By Laird",31,5,0,4,40
1705851,1354199,2023-09-13,Assembly,"AB 727 Weber Concurrence in Senate Amendments",65,11,0,4,80
1705856,1310210,2023-04-25,Assembly,"Do pass as amended and be re-referred to the Committee on [Appropriations]",8,0,0,0,8
1705856,1328443,2023-05-18,Assembly,"Do pass",14,0,0,2,16
1705856,1335519,2023-05-30,Assembly,"AB 732 Mike Fong Assembly Third Reading",78,0,0,2,80
1705856,1347903,2023-06-27,Senate,"Do pass as amended, but first amend, and re-refer to the Committee on [Appropriations]",5,0,0,0,5
1705856,1351359,2023-08-14,Senate,"Placed on suspense file",7,0,0,0,7
1705856,1352718,2023-09-01,Senate,"Do pass",7,0,0,0,7
1705856,1353772,2023-09-12,Senate,"Assembly 3rd Reading AB732 Mike Fong et al. By Blakespear",38,0,0,2,40
1705856,1354437,2023-09-13,Assembly,"AB 732 Mike Fong Concurrence in Senate Amendments",78,0,0,2,80
1705857,1310303,2023-04-25,Assembly,"Do pass as amended and be re-referred to the Committee on [Appropriations]",6,1,0,1,8
1705857,1322852,2023-05-10,Assembly,"Do pass",12,3,0,1,16
1705857,1337902,2023-05-31,Assembly,"AB 733 Mike Fong Assembly Third Reading",55,18,0,7,80
1705857,1347898,2023-06-27,Senate,"Do pass as amended, but first amend, and re-refer to the Committee on [Governance and Finance]",4,1,0,0,5
1705857,1350695,2023-07-12,Senate,"Do pass, but first be re-referred to the Committee on [Appropriations]",6,2,0,0,8
1705857,1351321,2023-08-14,Senate,"Placed on suspense file",7,0,0,0,7
1705857,1352566,2023-09-01,Senate,"Do pass as amended",5,2,0,0,7
1705857,1353878,2023-09-12,Senate,"Assembly 3rd Reading AB733 Mike Fong et al. By Becker",24,9,0,7,40
1705857,1354430,2023-09-13,Assembly,"AB 733 Mike Fong Concurrence in Senate Amendments",55,18,0,7,80
1705858,1363955,2024-01-10,Assembly,"Do pass as amended",5,2,0,0,7
1705859,1311874,2023-04-26,Assembly,"Do pass and be re-referred to the Committee on [Appropriations]",7,0,0,0,7
1705864,1280653,2023-03-21,Assembly,"Do pass and be re-referred to the Committee on [Accountability and Administrative Review]",11,0,0,0,11
1705866,1281834,2023-03-21,Assembly,"Do pass and be re-referred to the Committee on [Appropriations]",6,2,0,0,8
1705866,1328470,2023-05-18,Assembly,"Do pass as amended",11,4,0,1,16
1705867,1304433,2023-04-18,Assembly,"Do pass as amended and be re-referred to the Committee on [Appropriations]",11,0,0,0,11
1705868,1280605,2023-03-20,Assembly,"Do pass and be re-referred to the Committee on [Appropriations] with recommendation: To Consent Calendar",15,0,0,0,15
1705868,1328774,2023-05-18,Assembly,"Do pass as amended",11,0,0,5,16
1705868,1335512,2023-05-30,Assembly,"AB 744 Juan Carrillo Assembly Third Reading",79,0,0,1,80
1705868,1350514,2023-07-11,Senate,"Do pass, but first be re-referred to the Committee on [Appropriations] with the recommendation: To Consent Calendar",16,0,0,0,16
1705868,1351495,2023-08-14,Senate,"Placed on suspense file",7,0,0,0,7
1705868,1352625,2023-09-01,Senate,"Do pass as amended",7,0,0,0,7
1705868,1354187,2023-09-13,Senate,"Special Consent AB744 Juan Carrillo et al. By Cortese",39,0,0,1,40
1705868,1354726,2023-09-14,Assembly,"AB 744 Juan Carrillo Concurrence in Senate Amendments",80,0,0,0,80
1705869,1288136,2023-03-29,Assembly,"Do pass and be re-referred to the Committee on [Appropriations]",7,0,0,1,8
1705870,1298255,2023-04-11,Assembly,"Do pass and be re-referred to the Committee on [Appropriations]",12,0,0,0,12
1705870,1328668,2023-05-18,Assembly,"Do pass as amended",11,0,0,5,16
1705870,1335481,2023-05-30,Assembly,"AB 746 Sanchez Assembly Third Reading",79,0,0,1,80
1705870,1346254,2023-06-21,Senate,"Do pass, but first be re-referred to the Committee on [Appropriations] with the recommendation: To Consent Calendar",7,0,0,0,7
1705870,1349456,2023-07-03,Senate,"Placed on suspense file",7,0,0,0,7
1705870,1352650,2023-09-01,Senate,"Do pass",7,0,0,0,7
1705870,1354018,2023-09-12,Senate,"Special Consent AB746 Sanchez By Ochoa Bogh",39,0,0,1,40
1705871,1299476,2023-04-12,Assembly,"Do pass and be re-referred to the Committee on [Judiciary]",5,2,0,0,7
1705871,1310307,2023-04-25,Assembly,"Do pass as amended and be re-referred to the Committee on [Appropriations]",7,3,0,1,11
1705871,1328788,2023-05-18,Assembly,"Do pass as amended",11,4,0,1,16
1705872,1301989,2023-04-10,Assembly,"Do pass and be re-referred to the Committee on [Judiciary] with recommendation: To Consent Calendar",11,0,0,0,11
1705872,1310388,2023-04-25,Assembly,"Do pass and be re-referred to the Committee on [Appropriations] with recommendation: To Consent Calendar",11,0,0,0,11
1705872,1328040,2023-05-18,Assembly,"Do pass",15,0,0,1,16
1705872,1335418,2023-05-30,Assembly,"AB 748 Villapudua Assembly Third Reading",80,0,0,0,80
1705872,1346937,2023-06-22,Senate,"Do pass, but first be re-referred to the Committee on [Judiciary]",9,0,0,2,11
1705872,1349795,2023-07-06,Senate,"Do pass, but first be re-referred to the Committee on [Appropriations]",11,0,0,0,11
1705872,1351479,2023-08-14,Senate,"Placed on suspense file",7,0,0,0,7
1705872,1352711,2023-09-01,Senate,"Do pass",7,0,0,0,7
1705872,1354810,2023-09-11,Senate,"Assembly 3rd Reading AB748 Villapudua et al. By Dodd",39,0,0,1,40
1705873,1280627,2023-03-21,Assembly,"Do pass and be re-referred to the Committee on [Accountability and Administrative Review] with recommendation: To Consent Calendar",11,0,0,0,11
1705873,1305291,2023-04-19,Assembly,"Do pass as amended, and be re-referred to the Committee on [Appropriations] with recommendation: To Consent Calendar",6,0,0,1,7
1705873,1328360,2023-05-18,Assembly,"Do pass",15,0,0,1,16
1705873,1335497,2023-05-30,Assembly,"AB 749 Irwin Assembly Third Reading",80,0,0,0,80
1705873,1350166,2023-07-11,Senate,"Do pass, but first be re-referred to the Committee on [Appropriations]",14,0,0,1,15
1705873,1351844,2023-08-21,Senate,"Placed on suspense file",7,0,0,0,7
1705874,1299521,2023-04-11,Assembly,"Do pass. To Consent Calendar",8,0,0,0,8
1705874,1306764,2023-04-20,Assembly,"AB 750 Rodriguez Consent Calendar Second Day Regular Session",76,0,0,4,80
1705874,1340054,2023-06-06,Senate,"Do pass and be ordered to the Consent Calendar",5,0,0,0,5
1705874,1343127,2023-06-12,Senate,"Consent Calendar AB750 Rodriguez",35,0,0,5,40
1705875,1281845,2023-03-21,Assembly,"Do pass. To Consent Calendar",8,0,0,0,8
1705875,1289777,2023-03-30,Assembly,"AB 751 Schiavo Consent Calendar Second Day Regular Session",60,0,0,20,80
1705875,1340005,2023-06-06,Senate,"Do pass and be ordered to the Consent Calendar",5,0,0,0,5
1705875,1343111,2023-06-12,Senate,"Consent Calendar AB751 Schiavo",35,0,0,5,40
1705876,1280646,2023-03-20,Assembly,"Do pass and be re-referred to the Committee on [Appropriations] with recommendation: To Consent Calendar",15,0,0,0,15
1705876,1328550,2023-05-18,Assembly,"Do pass",15,0,0,1,16
1705876,1335517,2023-05-30,Assembly,"AB 752 Blanca Rubio Assembly Third Reading",80,0,0,0,80
1705876,1348375,2023-06-27,Senate,"Do pass, but first be re-referred to the Committee on [Appropriations]",16,0,0,0,16
1705876,1351424,2023-08-14,Senate,"Placed on suspense file",7,0,0,0,7
1705876,1352956,2023-09-01,Senate,"Do pass",7,0,0,0,7
1705876,1353898,2023-09-12,Assembly,"AB 752 Blanca Rubio Concurrence in Senate Amendments",80,0,0,0,80
1705876,1354707,2023-09-11,Senate,"Assembly 3rd Reading AB752 Blanca Rubio et al. By Dodd",39,0,0,1,40
1705877,1288206,2023-03-28,Assembly,"Do pass and be re-referred to the Committee on [Appropriations]",9,0,0,0,9
1705877,1328404,2023-05-18,Assembly,"Do pass",15,0,0,1,16
1705877,1335472,2023-05-30,Assembly,"AB 753 Papan Assembly Third Reading",78,0,0,2,80
1705877,1350568,2023-07-12,Senate,"Do pass as amended, but first amend, and re-refer to the Committee on [Appropriations]",6,1,0,0,7
1705877,1351826,2023-08-21,Senate,"Placed on suspense file",7,0,0,0,7
1705877,1352630,2023-09-01,Senate,"Do pass",5,2,0,0,7
1705877,1353792,2023-09-12,Assembly,"AB 753 Papan Concurrence in Senate Amendments",79,0,0,1,80
1705877,1354755,2023-09-11,Senate,"Assembly 3rd Reading AB753 Papan et al. By Stern",32,6,0,2,40
1705878,1308812,2023-04-24,Assembly,"Do pass as amended and be re-referred to the Committee on [Appropriations]",10,4,0,1,15
1705878,1322880,2023-05-10,Assembly,"Do pass",12,3,0,1,16
1705878,1328707,2023-05-18,Assembly,"AB 754 Papan Assembly Third Reading Amendment Set #1",58,15,0,7,80
1705878,1338142,2023-05-31,Assembly,"AB 754 Papan Assembly Third Reading",59,18,0,3,80
1705878,1349986,2023-07-10,Senate,"Do pass, but first be re-referred to the Committee on [Appropriations]",7,3,0,1,11
1705878,1351803,2023-08-21,Senate,"Placed on suspense file",7,0,0,0,7
1705879,1308840,2023-04-24,Assembly,"Do pass and be re-referred to the Committee on [Appropriations]",11,4,0,0,15
1705879,1322922,2023-05-10,Assembly,"Do pass",12,3,0,1,16
1705879,1338204,2023-05-31,Assembly,"AB 755 Papan Assembly Third Reading",58,17,0,5,80
1705879,1349933,2023-07-10,Senate,"Do pass as amended, but first amend, and re-refer to the Committee on [Appropriations]",7,3,0,1,11
1705879,1353940,2023-09-12,Assembly,"AB 755 Papan Concurrence in Senate Amendments",60,18,0,2,80
1705879,1354601,2023-09-11,Senate,"Assembly 3rd Reading AB755 Papan By Ashby",28,10,0,2,40
1705880,1285640,2023-03-27,Assembly,"Do pass and be re-referred to the Committee on [Environmental Safety and Toxic Materials]",11,1,0,3,15
1705880,1305542,2023-04-18,Assembly,"Do pass and be re-referred to the Committee on [Appropriations]",7,0,0,2,9
1705882,1281888,2023-03-21,Assembly,"Do pass and be re-referred to the Committee on [Appropriations]",2,6,0,0,8
1705882,1281889,2023-03-21,Assembly,Reconsideration,7,0,0,1,8
1705882,1363759,2024-01-09,Assembly,"Do pass and be re-referred to the Committee on [Appropriations]",4,0,0,4,8
1705883,1288368,2023-03-29,Assembly,"Do pass as amended",8,0,0,0,8
1705883,1306802,2023-04-20,Assembly,"AB 759 Grayson Assembly Third Reading",77,0,0,3,80
1705883,1340995,2023-06-07,Senate,"Do pass and be ordered to the Consent Calendar",8,0,0,0,8
1705883,1344711,2023-06-15,Senate,"Consent Calendar AB759 Grayson et al",40,0,0,0,40
1705884,1298270,2023-04-11,Assembly,"Do pass and be re-referred to the Committee on [Appropriations]",10,0,0,2,12
1705884,1311819,2023-04-26,Assembly,"Do pass",13,1,0,2,16
1705884,1320422,2023-05-08,Assembly,"AB 760 Wilson Assembly Third Reading",58,0,0,22,80
1705884,1340989,2023-06-07,Senate,"Do pass, but first be re-referred to the Committee on [Judiciary]",5,0,0,2,7
1705884,1345666,2023-06-20,Senate,"Do pass, but first be re-referred to the Committee on [Appropriations]",9,0,0,2,11
1705884,1354378,2023-09-13,Senate,"Assembly 3rd Reading AB760 Wilson et al. By Padilla",31,1,0,8,40
1705884,1354589,2023-09-14,Assembly,"AB 760 Wilson Concurrence in Senate Amendments",69,0,0,11,80
1705885,1280613,2023-03-20,Assembly,"Do pass and be re-referred to the Committee on [Appropriations] with recommendation: To Consent Calendar",15,0,0,0,15
1705885,1328113,2023-05-18,Assembly,"Do pass",15,0,0,1,16
1705885,1335462,2023-05-30,Assembly,"AB 761 Friedman Assembly Third Reading",79,0,0,1,80
1705885,1451600,2024-05-29,Senate,"Do pass",7,0,0,0,7
1705885,1465383,2024-08-20,Senate,"Assembly 3rd Reading AB761 Friedman et al. By Allen",40,0,0,0,40
1705885,1466056,2024-08-28,Assembly,"With recommendation: That Senate amendments be concurred in",9,0,0,0,9
1705885,1466288,2024-08-29,Assembly,"AB 761 Friedman Concurrence in Senate Amendments",76,0,0,3,79
1705886,1310360,2023-04-25,Assembly,"Do pass and be re-referred to the Committee on [Appropriations] with recommendation: To Consent Calendar",8,0,0,0,8
1705886,1328112,2023-05-18,Assembly,"Do pass",15,0,0,1,16
1705886,1338027,2023-05-31,Assembly,"AB 762 Wicks Assembly Third Reading",80,0,0,0,80
1705886,1350280,2023-07-11,Senate,"Do pass, but first be re-referred to the Committee on [Appropriations] with the recommendation: To Consent Calendar",4,0,0,1,5
1705886,1351278,2023-08-14,Senate,"Placed on suspense file",7,0,0,0,7
1705886,1352988,2023-09-01,Senate,"Do pass",7,0,0,0,7
1705886,1353748,2023-09-12,Senate,"Special Consent AB762 Wicks By Wiener",39,0,0,1,40
1705888,1305522,2023-04-19,Assembly,"Do pass and be re-referred to the Committee on [Local Government]",5,1,0,2,8
1705888,1313492,2023-04-26,Assembly,"Do pass and be re-referred to the Committee on [Appropriations]",6,2,0,0,8
1705888,1328318,2023-05-18,Assembly,"Do pass as amended",11,4,0,1,16
1705888,1335608,2023-05-30,Assembly,"AB 764 Bryan Assembly Third Reading",62,17,0,1,80
1705888,1349818,2023-07-05,Senate,"Do pass, but first be re-referred to the Committee on [Governance and Finance]",6,1,0,0,7
1705888,1350708,2023-07-12,Senate,"Do pass as amended, but first amend, and re-refer to the Committee on [Appropriations]",6,2,0,0,8
1705888,1351442,2023-08-14,Senate,"Placed on suspense file",7,0,0,0,7
1705888,1352964,2023-09-01,Senate,"Do pass as amended",5,2,0,0,7
1705888,1353784,2023-09-12,Senate,"Assembly 3rd Reading AB764 Bryan et al. By Durazo",30,7,0,3,40
1705888,1354077,2023-09-13,Assembly,"AB 764 Bryan Concurrence in Senate Amendments",62,18,0,0,80
1705889,1298185,2023-04-11,Assembly,"Do pass as amended and be re-referred to the Committee on [Appropriations]",16,0,0,2,18
1705890,1298247,2023-04-11,Assembly,"Do pass as amended and be re-referred to the Committee on [Appropriations]",17,0,0,1,18
1705891,1298325,2023-04-11,Assembly,"Do pass and be re-referred to the Committee on [Appropriations]",15,0,0,0,15
1705891,1328488,2023-05-18,Assembly,"Do pass",15,0,0,1,16
1705891,1333691,2023-05-25,Assembly,"AB 767 Gipson Assembly Third Reading",76,0,0,4,80
1705891,1346272,2023-06-21,Senate,"Do pass as amended, but first amend, and re-refer to the Committee on [Appropriations]",11,0,0,1,12
1705891,1349481,2023-07-03,Senate,"Placed on suspense file",7,0,0,0,7
1705891,1352627,2023-09-01,Senate,"Do pass as amended",6,0,0,1,7
1705891,1353243,2023-09-06,Senate,"Assembly 3rd Reading AB767 Gipson By Menjivar",38,0,0,2,40
1705891,1353526,2023-09-07,Assembly,"AB 767 Gipson Concurrence in Senate Amendments",76,0,0,4,80
1705894,1310398,2023-04-25,Assembly,"Do pass as amended and be re-referred to the Committee on [Appropriations]",5,2,0,1,8
1705896,1310352,2023-04-25,Assembly,"Do pass and be re-referred to the Committee on [Appropriations] with recommendation: To Consent Calendar",8,0,0,0,8
1705896,1363775,2024-01-09,Assembly,"Do pass",6,0,0,1,7
1705896,1366765,2024-01-18,Assembly,"AB 772 Jackson Assembly Third Reading",68,0,0,12,80
1705896,1458182,2024-06-17,Senate,"Do pass as amended",5,0,0,0,5
1705896,1465769,2024-08-26,Senate,"Assembly 3rd Reading AB772 Jackson By Lim√≥n",40,0,0,0,40
1705896,1465809,2024-08-27,Assembly,"AB 772 Jackson Concurrence in Senate Amendments",77,0,0,2,79
1705897,1288216,2023-03-29,Assembly,"Do pass and be re-referred to the Committee on [Appropriations]",8,0,0,0,8
1705897,1311853,2023-04-26,Assembly,"Do pass",14,1,0,1,16
1705897,1320550,2023-05-08,Assembly,"AB 773 Pellerin Assembly Third Reading",70,0,0,10,80
1705897,1340050,2023-06-06,Senate,"Do pass, but first be re-referred to the Committee on [Appropriations]",7,0,0,0,7
1705897,1353190,2023-09-05,Senate,"Assembly 3rd Reading AB773 Pellerin et al. By Lim√≥n Urgency Clause",39,0,0,1,40
1705897,1353515,2023-09-07,Assembly,"AB 773 Pellerin Concurrence - Urgency Added",76,0,0,4,80
1705898,1305533,2023-04-19,Assembly,"Do pass and be re-referred to the Committee on [Appropriations] with recommendation: To Consent Calendar",11,0,0,0,11
1705899,1281896,2023-03-22,Assembly,"Do pass and be re-referred to the Committee on [Appropriations]",6,0,0,1,7
1705899,1328508,2023-05-18,Assembly,"Do pass",11,3,0,2,16
1705899,1335573,2023-05-30,Assembly,"AB 775 Arambula Assembly Third Reading",67,7,0,6,80
1705899,1346971,2023-06-22,Senate,"Do pass, but first be re-referred to the Committee on [Appropriations]",4,1,0,0,5
1705899,1349458,2023-07-03,Senate,"Placed on suspense file",7,0,0,0,7
1705900,1280618,2023-03-20,Assembly,"Do pass and be re-referred to the Committee on [Appropriations] with recommendation: To Consent Calendar",15,0,0,0,15
1705900,1328451,2023-05-18,Assembly,"Do pass as amended",11,0,0,5,16
1705900,1335467,2023-05-30,Assembly,"AB 776 Holden Assembly Third Reading",80,0,0,0,80
1705900,1348437,2023-06-27,Senate,"Do pass, but first be re-referred to the Committee on [Appropriations] with the recommendation: To Consent Calendar",16,0,0,0,16
1705900,1349983,2023-07-10,Senate,"Placed on suspense file",6,0,0,1,7
1705900,1352605,2023-09-01,Senate,"Do pass",7,0,0,0,7
1705900,1354400,2023-09-13,Assembly,"AB 776 Holden Concurrence in Senate Amendments",80,0,0,0,80
1705900,1354653,2023-09-11,Senate,"Assembly 3rd Reading AB776 Holden et al. By Rubio",39,0,0,1,40
1705901,1288173,2023-03-28,Assembly,"Do pass and be re-referred to the Committee on [Appropriations] with recommendation: To Consent Calendar",9,0,0,0,9
1705901,1305394,2023-04-19,Assembly,"Do pass. To Consent Calendar",14,0,0,2,16
1705901,1313466,2023-04-27,Assembly,"AB 777 Cervantes Consent Calendar Second Day Regular Session",79,0,0,1,80
1705901,1346191,2023-06-21,Senate,"Do pass, but first be re-referred to the Committee on [Appropriations] with the recommendation: To Consent Calendar",7,0,0,0,7
1705901,1350698,2023-07-13,Senate,"Consent Calendar AB777 Cervantes et al",37,0,0,3,40
1705901,1352251,2023-08-24,Assembly,"AB 777 Cervantes Concurrence in Senate Amendments",76,0,0,4,80
1705903,1286937,2023-03-28,Assembly,"Do pass and be re-referred to the Committee on [Judiciary]",11,3,0,1,15
1705903,1298277,2023-04-11,Assembly,"Do pass and be re-referred to the Committee on [Appropriations]",8,3,0,0,11
1705903,1328203,2023-05-18,Assembly,"Do pass",11,3,0,2,16
1705903,1338054,2023-05-31,Assembly,"AB 779 Wilson Assembly Third Reading",59,17,0,4,80
1705903,1347891,2023-06-27,Senate,"Do pass as amended, but first amend, and re-refer to the Committee on [Judiciary]",7,3,0,1,11
1705903,1350521,2023-07-11,Senate,"Do pass, but first be re-referred to the Committee on [Appropriations]",8,3,0,0,11
1705903,1351794,2023-08-21,Senate,"Placed on suspense file",7,0,0,0,7
1705903,1353049,2023-09-01,Senate,"Do pass",5,2,0,0,7
1705903,1353858,2023-09-12,Senate,"Assembly 3rd Reading AB779 Wilson By Laird",28,8,0,4,40
1705903,1354256,2023-09-13,Assembly,"AB 779 Wilson Concurrence in Senate Amendments",59,16,0,5,80
1705905,1285658,2023-03-27,Assembly,"Do pass and be re-referred to the Committee on [Appropriations] with recommendation: To Consent Calendar",7,0,0,0,7
1705905,1328610,2023-05-18,Assembly,"Do pass as amended",11,0,0,5,16
1705905,1335436,2023-05-30,Assembly,"AB 781 Maienschein Assembly Third Reading",80,0,0,0,80
1705905,1347933,2023-06-27,Senate,"Do pass, but first be re-referred to the Committee on [Appropriations]",15,0,0,0,15
1705905,1351516,2023-08-14,Senate,"Placed on suspense file",7,0,0,0,7
1705905,1352549,2023-09-01,Senate,"Do pass",7,0,0,0,7
1705905,1353976,2023-09-12,Senate,"Special Consent AB781 Maienschein By Glazer",39,0,0,1,40
1705905,1354151,2023-09-13,Assembly,"AB 781 Maienschein Concurrence in Senate Amendments",79,0,0,1,80
1705906,1281929,2023-03-22,Assembly,"Do pass. To Consent Calendar",20,0,0,2,22
1705906,1289796,2023-03-30,Assembly,"AB 782 Lackey Consent Calendar Second Day Regular Session",60,0,0,20,80
1705906,1343736,2023-06-13,Senate,"Do pass and be ordered to the Consent Calendar",14,0,0,1,15
1705906,1349939,2023-07-10,Senate,"Do pass, but first be re-referred to the Committee on [Appropriations]",13,0,0,0,13
1705906,1353302,2023-09-06,Senate,"Assembly 3rd Reading AB782 McKinnor et al. By Eggman",40,0,0,0,40
1705906,1354265,2023-09-13,Assembly,"With recommendation: That Senate amendments be concurred in",19,0,0,0,19
1705906,1354767,2023-09-14,Assembly,"AB 782 McKinnor Concurrence in Senate Amendments",79,0,0,1,80
1705907,1286996,2023-03-28,Assembly,"Do pass and be re-referred to the Committee on [Appropriations]",14,3,0,2,19
1705907,1305411,2023-04-19,Assembly,"Do pass",11,4,0,1,16
1705907,1308854,2023-04-24,Assembly,"AB 783 Ting Assembly Third Reading",64,9,0,7,80
1705907,1346157,2023-06-21,Senate,"Do pass as amended, but first amend, and re-refer to the Committee on [Appropriations]",6,2,0,0,8
1705907,1353139,2023-09-05,Senate,"Assembly 3rd Reading AB783 Ting et al. By Menjivar",31,7,0,2,40
1705907,1353363,2023-09-07,Assembly,"AB 783 Ting Concurrence in Senate Amendments",67,10,0,3,80
1705909,1302583,2023-04-17,Assembly,"Do pass as amended and be re-referred to the Committee on [Housing and Community Development]",9,0,0,2,11
1705909,1311698,2023-04-26,Assembly,"Do pass as amended and be re-referred to the Committee on [Appropriations]",8,0,0,0,8
1705909,1322905,2023-05-10,Assembly,"Do pass. To Consent Calendar",14,0,0,2,16
1705909,1328859,2023-05-18,Assembly,"AB 785 Santiago Consent Calendar Second Day Regular Session",74,0,0,6,80
1705909,1346159,2023-06-21,Senate,"Do pass, but first be re-referred to the Committee on [Housing]",7,0,0,0,7
1705909,1350296,2023-07-10,Senate,"Do pass as amended, but first amend, and re-refer to the Committee on [Appropriations]",11,0,0,0,11
1705909,1354285,2023-09-13,Senate,"Assembly 3rd Reading AB785 Santiago By Durazo",38,0,0,2,40
1705909,1354286,2023-09-13,Assembly,"AB 785 Santiago Concurrence in Senate Amendments",71,0,0,9,80
1705911,1283209,2023-03-22,Assembly,"Do pass as amended and be re-referred to the Committee on [Appropriations]",7,0,0,0,7
1705911,1328684,2023-05-18,Assembly,"Do pass",15,0,0,1,16
1705911,1335600,2023-05-30,Assembly,"AB 787 Gabriel Assembly Third Reading",79,0,0,1,80
1705911,1346185,2023-06-21,Senate,"Do pass, but first be re-referred to the Committee on [Appropriations]",7,0,0,0,7
1705911,1349487,2023-07-03,Senate,"Placed on suspense file",7,0,0,0,7
1705912,1285647,2023-03-27,Assembly,"Do pass and be re-referred to the Committee on [Appropriations] with recommendation: To Consent Calendar",11,0,0,0,11
1705912,1328015,2023-05-18,Assembly,"Do pass",15,0,0,1,16
1705912,1337941,2023-05-31,Assembly,"AB 788 Petrie-Norris Assembly Third Reading",80,0,0,0,80
1705912,1349917,2023-07-10,Senate,"Do pass as amended, but first amend, and re-refer to the Committee on [Appropriations] with the recommendation: To Consent Calendar",10,0,0,1,11
1705912,1351279,2023-08-14,Senate,"Placed on suspense file",7,0,0,0,7
1705913,1305503,2023-04-18,Assembly,"Do pass as amended and be re-referred to the Committee on [Appropriations]",12,0,0,0,12
1705913,1328767,2023-05-18,Assembly,"Do pass as amended",11,0,0,5,16
1705913,1335598,2023-05-30,Assembly,"AB 789 Berman Assembly Third Reading",80,0,0,0,80
1705913,1346256,2023-06-21,Senate,"Do pass as amended, but first amend, and re-refer to the Committee on [Appropriations]",7,0,0,0,7
1705913,1349972,2023-07-10,Senate,"Placed on suspense file",6,0,0,1,7
1705913,1352885,2023-09-01,Senate,"Do pass as amended",7,0,0,0,7
1705913,1354139,2023-09-13,Senate,"Special Consent AB789 Berman et al. By Skinner",39,0,0,1,40
1705913,1354742,2023-09-14,Assembly,"AB 789 Berman Concurrence in Senate Amendments",80,0,0,0,80
1705915,1310201,2023-04-25,Assembly,"Do pass as amended and be re-referred to the Committee on [Appropriations]",8,0,0,0,8
1705915,1322878,2023-05-10,Assembly,"Do pass. To Consent Calendar",14,0,0,2,16
1705915,1328539,2023-05-18,Assembly,"AB 791 Ramos Consent Calendar Second Day Regular Session",74,0,0,6,80
1705915,1343726,2023-06-13,Senate,"Do pass, but first be re-referred to the Committee on [Appropriations]",5,0,0,0,5
1705915,1353231,2023-09-06,Senate,"Assembly 3rd Reading AB791 Ramos By Roth",40,0,0,0,40
1705917,1299404,2023-04-11,Assembly,"Do pass and be re-referred to the Committee on [Judiciary]",7,0,0,1,8
1705917,1304273,2023-04-18,Assembly,"Do pass as amended and be re-referred to the Committee on [Appropriations]",8,0,0,3,11
1705917,1327983,2023-05-18,Assembly,"Do pass",12,2,0,2,16
1705917,1337192,2023-06-01,Assembly,"AB 793 Bonta Assembly Third Reading",54,15,0,11,80
1705917,1347942,2023-06-27,Senate,"Do pass, but first be re-referred to the Committee on [Judiciary]",4,1,0,0,5
1705920,1298268,2023-04-11,Assembly,"Do pass and be re-referred to the Committee on [Business and Professions]",5,0,0,2,7
1705920,1310237,2023-04-25,Assembly,"Do pass as amended and be re-referred to the Committee on [Appropriations]",13,0,0,5,18
1705920,1328021,2023-05-18,Assembly,"Do pass as amended",11,0,0,5,16
1705920,1338124,2023-05-31,Assembly,"AB 796 Weber Assembly Third Reading",71,1,0,8,80
1705920,1459353,2024-06-24,Senate,"Do pass as amended, but first amend, and re-refer to the Committee on [Public Safety]",12,0,0,1,13
1705920,1465344,2024-08-20,Senate,"Assembly 3rd Reading AB796 Weber By Stern",40,0,0,0,40
1705920,1465749,2024-08-26,Assembly,"AB 796 Weber Concurrence in Senate Amendments",74,0,0,5,79
1705921,1363735,2024-01-09,Assembly,"Do pass and be re-referred to the Committee on [Appropriations]",5,2,0,1,8
1705922,1299461,2023-04-11,Assembly,"Do pass as amended, and be re-referred to the Committee on [Health] with recommendation: To Consent Calendar",8,0,0,0,8
1705922,1310391,2023-04-25,Assembly,"Do pass and be re-referred to the Committee on [Appropriations] with recommendation: To Consent Calendar",15,0,0,0,15
1705922,1328629,2023-05-18,Assembly,"Do pass as amended",11,1,0,4,16
1705922,1335394,2023-05-30,Assembly,"AB 798 Weber Assembly Third Reading",80,0,0,0,80
1705922,1345602,2023-06-20,Senate,"Do pass, but first be re-referred to the Committee on [Appropriations] with the recommendation: To Consent Calendar",5,0,0,0,5
1705922,1349509,2023-07-03,Senate,"Placed on suspense file",7,0,0,0,7
1705923,1311710,2023-04-26,Assembly,"Do pass and be re-referred to the Committee on [Appropriations]",7,0,0,1,8
1705923,1328086,2023-05-18,Assembly,"Do pass",14,0,0,2,16
1705923,1335429,2023-05-30,Assembly,"AB 799 Luz Rivas Assembly Third Reading",80,0,0,0,80
1705923,1345590,2023-06-19,Senate,"Do pass, but first be re-referred to the Committee on [Housing]",5,0,0,0,5
1705923,1350205,2023-07-10,Senate,"Do pass, but first be re-referred to the Committee on [Appropriations]",10,0,0,1,11
1705923,1351363,2023-08-14,Senate,"Placed on suspense file",7,0,0,0,7
1705923,1352953,2023-09-01,Senate,"Do pass as amended",7,0,0,0,7
1705923,1459980,2024-06-24,Senate,"Do pass, but first be re-referred to the Committee on [Human Services]",10,0,0,0,10
1705923,1462211,2024-07-01,Senate,"Do pass, but first be re-referred to the Committee on [Appropriations]",5,0,0,0,5
1705923,1463861,2024-08-12,Senate,"Placed on suspense file",7,0,0,0,7
1705923,1464071,2024-08-15,Senate,"Do pass as amended",7,0,0,0,7
1705923,1465865,2024-08-27,Senate,"Assembly 3rd Reading AB799 Luz Rivas et al. By Padilla",40,0,0,0,40
1705923,1466781,2024-08-28,Assembly,"AB 799 Luz Rivas Concurrence in Senate Amendments",76,0,0,3,79
1705924,1301063,2023-04-12,Assembly,"Do pass and be re-referred to the Committee on [Labor and Employment]",5,2,0,0,7
1705924,1311822,2023-04-26,Assembly,"Do pass and be re-referred to the Committee on [Appropriations]",7,0,0,0,7
1705924,1328828,2023-05-18,Assembly,"Do pass as amended",12,2,0,2,16
1705924,1333669,2023-05-25,Assembly,"AB 800 Ortega Assembly Third Reading",64,5,0,11,80
1705924,1350393,2023-07-12,Senate,"Do pass, but first be re-referred to the Committee on [Appropriations]",4,0,0,3,7
1705924,1351798,2023-08-21,Senate,"Placed on suspense file",7,0,0,0,7
1705924,1352782,2023-09-01,Senate,"Do pass",5,2,0,0,7
1705924,1353856,2023-09-12,Assembly,"AB 800 Ortega Concurrence in Senate Amendments",67,8,0,5,80
1705924,1354858,2023-09-11,Senate,"Assembly 3rd Reading AB800 Ortega et al. By Smallwood-Cuevas",29,7,0,4,40
1705925,1280599,2023-03-21,Assembly,"Do pass as amended, and be re-referred to the Committee on [Education] with recommendation: To Consent Calendar",11,0,0,0,11
1705925,1363957,2024-01-10,Assembly,"Do pass as amended",7,0,0,0,7
1705925,1366828,2024-01-18,Assembly,"AB 801 Joe Patterson Assembly Third Reading",67,0,0,13,80
1705925,1454264,2024-06-05,Senate,"Do pass, but first be re-referred to the Committee on [Judiciary] with the recommendation: To Consent Calendar",7,0,0,0,7
1705925,1456296,2024-06-11,Senate,"Do pass as amended, and be ordered to the Consent Calendar",11,0,0,0,11
1705925,1466181,2024-08-29,Assembly,"AB 801 Joe Patterson Concurrence in Senate Amendments",76,0,0,3,79
1705925,1466720,2024-08-28,Senate,"Assembly 3rd Reading AB801 Joe Patterson By Niello",39,0,0,1,40
1705926,1289815,2023-03-29,Assembly,"Do pass as amended and be re-referred to the Committee on [Appropriations]",6,0,0,1,7
1705929,1288212,2023-03-28,Assembly,"Do pass and be re-referred to the Committee on [Appropriations]",9,0,0,0,9
1705929,1366769,2024-01-18,Assembly,"Do pass as amended",12,0,0,4,16
1705929,1372099,2024-01-30,Assembly,"AB 805 Arambula Third Reading Urgency",76,0,0,4,80
1705929,1454190,2024-06-05,Senate,"Do pass as amended, but first amend, and re-refer to the Committee on [Appropriations]",7,0,0,0,7
1705929,1459341,2024-06-24,Senate,"Placed on suspense file",6,0,0,1,7
1705929,1464416,2024-08-15,Senate,"Do pass",7,0,0,0,7
1705929,1465767,2024-08-26,Senate,"Assembly 3rd Reading AB805 Arambula et al. By Laird Urgency Clause",40,0,0,0,40
1705929,1465940,2024-08-27,Assembly,"AB 805 Arambula Concurrence in Senate Amendments",76,0,0,3,79
1705930,1281798,2023-03-21,Assembly,"Do pass",8,0,0,0,8
1705930,1296940,2023-04-10,Assembly,"AB 806 Maienschein Assembly Third Reading",68,0,0,12,80
1705930,1339973,2023-06-06,Senate,"Do pass as amended",5,0,0,0,5
1705930,1353142,2023-09-05,Senate,"Assembly 3rd Reading AB806 Maienschein By Blakespear",39,0,0,1,40
1705930,1353362,2023-09-07,Assembly,"AB 806 Maienschein Concurrence in Senate Amendments",77,2,0,1,80
1705931,1281903,2023-03-21,Assembly,"Do pass and be re-referred to the Committee on [Appropriations]",6,1,0,1,8
1705932,1299470,2023-04-11,Assembly,"Do pass and be re-referred to the Committee on [Appropriations]",2,1,0,5,8
1705933,1286938,2023-03-28,Assembly,"Do pass and be re-referred to the Committee on [Appropriations]",15,0,0,0,15
1705933,1328388,2023-05-18,Assembly,"Do pass",14,1,0,1,16
1705933,1335407,2023-05-30,Assembly,"AB 809 Bennett Assembly Third Reading",78,0,0,2,80
1705933,1349907,2023-07-10,Senate,"Do pass, but first be re-referred to the Committee on [Appropriations]",10,0,0,1,11
1705933,1351252,2023-08-14,Senate,"Placed on suspense file",7,0,0,0,7
1705933,1352710,2023-09-01,Senate,"Do pass as amended",7,0,0,0,7
1705933,1354186,2023-09-13,Senate,"Special Consent AB809 Bennett By Min",39,0,0,1,40
1705933,1354624,2023-09-14,Assembly,"AB 809 Bennett Concurrence in Senate Amendments",79,0,0,1,80
1705934,1363761,2024-01-09,Assembly,"Do pass and be re-referred to the Committee on [Appropriations]",10,0,0,1,11
1705934,1366803,2024-01-18,Assembly,"Do pass",15,0,0,1,16
1705934,1371081,2024-01-29,Assembly,"AB 810 Friedman Assembly Third Reading",76,0,0,4,80
1705934,1451605,2024-05-29,Senate,"Do pass, but first be re-referred to the Committee on [Judiciary] with the recommendation: To Consent Calendar",7,0,0,0,7
1705934,1458157,2024-06-18,Senate,"Do pass, but first be re-referred to the Committee on [Appropriations]",10,0,0,1,11
1705934,1463353,2024-08-05,Senate,"Placed on suspense file",7,0,0,0,7
1705934,1464078,2024-08-15,Senate,"Do pass",7,0,0,0,7
1705934,1466304,2024-08-29,Assembly,"AB 810 Friedman Concurrence in Senate Amendments",76,0,0,3,79
1705934,1466836,2024-08-28,Senate,"Assembly 3rd Reading AB810 Friedman By Ochoa Bogh",39,0,0,1,40
1705935,1305537,2023-04-18,Assembly,"Do pass and be re-referred to the Committee on [Appropriations]",9,1,0,2,12
1705935,1327959,2023-05-18,Assembly,"Do pass",13,1,0,2,16
1705935,1335478,2023-05-30,Assembly,"AB 811 Mike Fong Assembly Third Reading",74,2,0,4,80
1705935,1350503,2023-07-12,Senate,"Do pass as amended, but first amend, and re-refer to the Committee on [Appropriations]",6,0,0,1,7
1705935,1351456,2023-08-14,Senate,"Placed on suspense file",7,0,0,0,7
1705935,1352748,2023-09-01,Senate,"Do pass as amended",5,2,0,0,7
1705935,1353223,2023-09-06,Senate,"Assembly 3rd Reading AB811 Mike Fong By Cortese",35,3,0,2,40
1705935,1353539,2023-09-07,Assembly,"AB 811 Mike Fong Concurrence in Senate Amendments",75,0,0,5,80
1705936,1305482,2023-04-19,Assembly,"Do pass and be re-referred to the Committee on [Arts, Entertainment, Sports, and Tourism]",6,2,0,0,8
1705936,1310214,2023-04-25,Assembly,"Do pass",5,1,0,1,7
1705936,1324980,2023-05-15,Assembly,"AB 812 Boerner Assembly Third Reading",64,6,0,10,80
1705936,1339962,2023-06-06,Senate,"Do pass as amended",11,0,0,0,11
1705936,1354145,2023-09-13,Senate,"Assembly 3rd Reading AB812 Boerner et al. By Rubio",33,5,0,2,40
1705936,1354789,2023-09-14,Assembly,"AB 812 Boerner Concurrence in Senate Amendments",64,10,0,6,80
1705937,1285633,2023-03-27,Assembly,"Do pass and be re-referred to the Committee on [Appropriations] with recommendation: To Consent Calendar",7,0,0,0,7
1705938,1310179,2023-04-25,Assembly,"Do pass as amended and be re-referred to the Committee on [Appropriations]",14,1,0,3,18
1705938,1328503,2023-05-18,Assembly,"Do pass",12,3,0,1,16
1705938,1338122,2023-05-31,Assembly,"AB 814 Lowenthal Assembly Third Reading",66,2,0,12,80
1705939,1304287,2023-04-18,Assembly,"Do pass as amended and be re-referred to the Committee on [Appropriations]",12,0,0,3,15
1705939,1328132,2023-05-18,Assembly,"Do pass",12,2,0,2,16
1705939,1335417,2023-05-30,Assembly,"AB 815 Wood Assembly Third Reading",64,5,0,11,80
1705939,1462642,2024-07-03,Senate,"Do pass as amended, but first amend, and re-refer to the Committee on [Appropriations]",9,1,0,1,11
1705939,1463526,2024-08-05,Senate,"Placed on suspense file",7,0,0,0,7
1705940,1286995,2023-03-28,Assembly,"Do pass",7,0,0,4,11
1705940,1324990,2023-05-15,Assembly,"AB 816 Haney Assembly Third Reading",62,0,0,18,80
1705940,1345600,2023-06-20,Senate,"Do pass",9,2,0,0,11
1705940,1354002,2023-09-12,Assembly,"AB 816 Haney Concurrence in Senate Amendments",64,6,0,10,80
1705940,1354875,2023-09-11,Senate,"Assembly 3rd Reading AB816 Haney By Wiener",30,9,0,1,40
1705941,1363947,2024-01-10,Assembly,"Do pass as amended",8,0,0,1,9
1705941,1369550,2024-01-25,Assembly,"AB 817 Pacheco Assembly Third Reading",54,8,0,18,80
1705941,1454267,2024-06-05,Senate,"Do pass, but first be re-referred to the Committee on [Judiciary]",0,4,0,3,7
1705941,1454268,2024-06-05,Senate,"[Second] hearing set for [06-05-2024]: Failed passage in Committee. Reconsideration granted",7,0,0,0,7
1705942,1286931,2023-03-28,Assembly,"Do pass as amended and be re-referred to the Committee on [Public Safety]",10,0,0,1,11
1705942,1310374,2023-04-25,Assembly,"Do pass and be re-referred to the Committee on [Appropriations] with recommendation: To Consent Calendar",8,0,0,0,8
1705942,1328311,2023-05-18,Assembly,"Do pass",15,0,0,1,16
1705942,1335386,2023-05-30,Assembly,"AB 818 Petrie-Norris Assembly Third Reading",80,0,0,0,80
1705942,1345670,2023-06-20,Senate,"Do pass, but first be re-referred to the Committee on [Public Safety] with the recommendation: To Consent Calendar",11,0,0,0,11
1705942,1350284,2023-07-11,Senate,"Do pass, but first be re-referred to the Committee on [Appropriations] with the recommendation: To Consent Calendar",4,0,0,1,5
1705942,1351303,2023-08-14,Senate,"Placed on suspense file",7,0,0,0,7
1705942,1352998,2023-09-01,Senate,"Do pass as amended",7,0,0,0,7
1705942,1353993,2023-09-12,Senate,"Assembly 3rd Reading AB818 Petrie-Norris By Portantino",38,0,0,2,40
1705942,1354344,2023-09-13,Assembly,"AB 818 Petrie-Norris Concurrence in Senate Amendments",80,0,0,0,80
1705943,1281829,2023-03-21,Assembly,"Do pass and be re-referred to the Committee on [Appropriations]",7,1,0,0,8
1705943,1311826,2023-04-26,Assembly,"Do pass",12,4,0,0,16
1705943,1324939,2023-05-15,Assembly,"AB 819 Bryan Assembly Third Reading",62,12,0,6,80
1705943,1343697,2023-06-13,Senate,"Do pass, but first be re-referred to the Committee on [Appropriations]",5,0,0,0,5
1705943,1353299,2023-09-06,Senate,"Assembly 3rd Reading AB819 Bryan By Wahab",29,8,0,3,40
1705944,1298322,2023-04-11,Assembly,"Do pass as amended and be re-referred to the Committee on [Appropriations]",8,0,0,0,8
1705944,1318088,2023-05-03,Assembly,"Do pass. To Consent Calendar",16,0,0,0,16
1705944,1323862,2023-05-11,Assembly,"AB 820 Reyes Consent Calendar Second Day Regular Session",66,0,0,14,80
1705944,1345599,2023-06-19,Senate,"Do pass, but first be re-referred to the Committee on [Health] with the recommendation: To Consent Calendar",5,0,0,0,5
1705944,1350659,2023-07-12,Senate,"Do pass, but first be re-referred to the Committee on [Appropriations] with the recommendation: To Consent Calendar",11,0,0,1,12
1705944,1351445,2023-08-14,Senate,"Placed on suspense file",7,0,0,0,7
1705945,1307863,2023-04-19,Assembly,"Do pass and be re-referred to the Committee on [Housing and Community Development]",7,0,0,0,7
1705945,1311700,2023-04-26,Assembly,"Do pass as amended and be re-referred to the Committee on [Appropriations]",7,0,0,1,8
1705945,1328391,2023-05-18,Assembly,"Do pass",15,0,0,1,16
1705945,1335514,2023-05-30,Assembly,"AB 821 Grayson Assembly Third Reading",79,1,0,0,80
1705945,1346275,2023-06-21,Senate,"Do pass as amended, but first amend, and re-refer to the Committee on [Judiciary]",7,0,0,1,8
1705945,1349754,2023-07-06,Senate,"Do pass, but first be re-referred to the Committee on [Appropriations]",11,0,0,0,11
1705945,1351827,2023-08-21,Senate,"Placed on suspense file",7,0,0,0,7
1705945,1353052,2023-09-01,Senate,"Do pass",6,0,0,1,7
1705945,1353253,2023-09-06,Senate,"Assembly 3rd Reading AB821 Grayson",38,0,0,2,40
1705945,1353357,2023-09-07,Assembly,"AB 821 Grayson Concurrence in Senate Amendments",78,0,0,2,80
1705947,1280696,2023-03-20,Assembly,"Do pass and be re-referred to the Committee on [Appropriations]",15,0,0,0,15
1705948,1280661,2023-03-20,Assembly,"Do pass and be re-referred to the Committee on [Appropriations]",11,1,0,3,15
1705948,1328206,2023-05-18,Assembly,"Do pass",11,3,0,2,16
1705948,1335448,2023-05-30,Assembly,"AB 824 Calderon Assembly Third Reading",63,9,0,8,80
1705948,1348457,2023-06-27,Senate,"Do pass, but first be re-referred to the Committee on [Appropriations]",12,3,0,1,16
1705948,1351307,2023-08-14,Senate,"Placed on suspense file",7,0,0,0,7
1705949,1280635,2023-03-20,Assembly,"Do pass and be re-referred to the Committee on [Appropriations]",11,4,0,0,15
1705949,1322892,2023-05-10,Assembly,"Do pass",12,3,0,1,16
1705949,1333625,2023-05-25,Assembly,"AB 825 Bryan Assembly Third Reading",61,14,0,5,80
1705949,1350506,2023-07-11,Senate,"Do pass as amended, but first amend, and re-refer to the Committee on [Appropriations]",12,4,0,0,16
1705949,1353836,2023-09-12,Senate,"Assembly 3rd Reading AB825 Bryan By Portantino",30,7,0,3,40
1705949,1354168,2023-09-13,Assembly,"AB 825 Bryan Concurrence in Senate Amendments",58,15,0,7,80
1705950,1286891,2023-03-28,Assembly,"Do pass and be re-referred to the Committee on [Appropriations] with recommendation: To Consent Calendar",18,0,0,1,19
1705950,1305393,2023-04-19,Assembly,"Do pass. To Consent Calendar",14,0,0,2,16
1705950,1313345,2023-04-27,Assembly,"AB 826 Chen Consent Calendar Second Day Regular Session",79,0,0,1,80
1705950,1345180,2023-06-19,Senate,"Do pass, but first be re-referred to the Committee on [Appropriations] with the recommendation: To Consent Calendar",12,0,0,1,13
1705950,1350684,2023-07-13,Senate,"Consent Calendar AB826 Chen",37,0,0,3,40
1705951,1298211,2023-04-11,Assembly,"Do pass and be re-referred to the Committee on [Appropriations] with recommendation: To Consent Calendar",15,0,0,0,15
1705952,1363762,2024-01-09,Assembly,"Do pass as amended and be re-referred to the Committee on [Appropriations]",8,2,0,5,15
1705952,1366776,2024-01-18,Assembly,"Do pass",11,3,0,2,16
1705952,1371122,2024-01-29,Assembly,"AB 828 Connolly Assembly Third Reading",47,15,0,18,80
1705952,1460103,2024-06-25,Senate,"Do pass as amended, but first amend, and re-refer to the Committee on [Appropriations]",7,4,0,0,11
1705952,1465786,2024-08-27,Senate,"Assembly 3rd Reading AB828 Connolly By Cortese",29,10,0,1,40
1705952,1466756,2024-08-28,Assembly,"AB 828 Connolly Concurrence in Senate Amendments",53,17,0,9,79
1705953,1304418,2023-04-18,Assembly,"Do pass and be re-referred to the Committee on [Appropriations]",7,0,0,1,8
1705953,1328733,2023-05-18,Assembly,"Do pass",15,0,0,1,16
1705953,1335495,2023-05-30,Assembly,"AB 829 Waldron Assembly Third Reading",80,0,0,0,80
1705953,1345639,2023-06-20,Senate,"Do pass, but first be re-referred to the Committee on [Appropriations]",5,0,0,0,5
1705953,1349441,2023-07-03,Senate,"Placed on suspense file",7,0,0,0,7
1705953,1352946,2023-09-01,Senate,"Do pass as amended",7,0,0,0,7
1705953,1354597,2023-09-14,Senate,"Assembly 3rd Reading AB829 Waldron By Rubio",40,0,0,0,40
1705953,1354598,2023-09-14,Assembly,"AB 829 Waldron Concurrence in Senate Amendments",79,0,0,1,80
1705954,1305399,2023-04-18,Assembly,"Do pass as amended and be re-referred to the Committee on [Appropriations]",14,0,0,1,15
1705954,1328018,2023-05-18,Assembly,"Do pass as amended",11,0,0,5,16
1705954,1338141,2023-05-31,Assembly,"AB 830 Soria Assembly Third Reading",80,0,0,0,80
1705954,1349961,2023-07-10,Senate,"Do pass, but first be re-referred to the Committee on [Appropriations]",10,0,0,1,11
1705954,1351835,2023-08-21,Senate,"Placed on suspense file",7,0,0,0,7
1705956,1285606,2023-03-27,Assembly,"Do pass and be re-referred to the Committee on [Appropriations]",11,3,0,1,15
1705956,1311912,2023-04-26,Assembly,"Do pass",12,4,0,0,16
1705956,1330046,2023-05-22,Assembly,"AB 832 Cervantes Assembly Third Reading",61,15,0,4,80
1705956,1343724,2023-06-13,Senate,"Do pass, but first be re-referred to the Committee on [Appropriations]",12,4,0,0,16
1705956,1465980,2024-08-27,Senate,"Assembly 3rd Reading AB832 Cervantes By Cortese",31,9,0,0,40
1705957,1255127,2023-02-17,Assembly,"Be adopted. To Consent Calendar",12,0,0,1,13
1705957,1260545,2023-02-23,Assembly,"ACR 13 Stephanie Nguyen Consent Calendar Second Day",77,0,0,3,80
1705958,1313457,2023-04-27,Assembly,"Be adopted. To Consent Calendar",13,0,0,0,13
1705958,1318920,2023-05-04,Assembly,"ACR 14 Luz Rivas Consent Calendar Second Day Regular Session",75,0,0,5,80
1705958,1334441,2023-05-26,Senate,"Special Consent ACR14 Luz Rivas et al",37,0,0,3,40
1705959,1288328,2023-03-29,Senate,"Do pass, but first be re-referred to the Committee on [Appropriations] with the recommendation: To Consent Calendar",12,0,0,0,12
1705959,1300997,2023-04-13,Senate,"Consent Calendar SB421 Lim√≥n",36,0,0,4,40
1705959,1343701,2023-06-13,Assembly,"Do pass and be re-referred to the Committee on [Appropriations] with recommendation: To Consent Calendar",15,0,0,0,15
1705959,1346212,2023-06-21,Assembly,"Do pass. To Consent Calendar",13,0,0,3,16
1705959,1351660,2023-08-17,Assembly,"SB 421 Lim√≥n Senate Third Reading By Pellerin Amendment Set #1",74,0,0,6,80
1705959,1352202,2023-08-24,Assembly,"SB 421 Lim√≥n Senate Third Reading By Pellerin",75,0,0,5,80
1705959,1352603,2023-09-01,Senate,"Special Consent SB421 Lim√≥n et al",37,0,0,3,40
1705960,1305354,2023-04-19,Senate,"Do pass, but first be re-referred to the Committee on [Labor, Public Employment and Retirement ]",7,0,0,0,7
1705960,1311864,2023-04-26,Senate,"Do pass, but first be re-referred to the Committee on [Appropriations] with the recommendation: To Consent Calendar",5,0,0,0,5
1705960,1320384,2023-05-08,Senate,"Placed on suspense file",7,0,0,0,7
1705960,1328288,2023-05-18,Senate,"Do pass",6,0,0,1,7
1705960,1332616,2023-05-24,Senate,"Senate 3rd Reading SB422 Portantino",38,0,0,2,40
1705960,1347490,2023-06-26,Assembly,"Do pass and be re-referred to the Committee on [Labor and Employment] with recommendation: To Consent Calendar",11,0,0,0,11
1705960,1350705,2023-07-12,Assembly,"Do pass and be re-referred to the Committee on [Appropriations] with recommendation: To Consent Calendar",7,0,0,0,7
1705960,1353067,2023-09-01,Assembly,"Do pass",16,0,0,0,16
1705960,1466425,2024-08-30,Assembly,"Do pass",14,0,0,1,15
1705960,1466983,2024-08-31,Senate,"Unfinished Business SB422 Portantino Concurrence",38,0,0,2,40
1705960,1466984,2024-08-31,Assembly,"SB 422 Portantino Senate Third Reading By Zbur",76,0,0,3,79
1705961,1281918,2023-03-21,Senate,"Do pass, but first be re-referred to the Committee on [Governance and Finance]",9,1,0,1,11
1705961,1313426,2023-04-26,Senate,"Do pass, but first be re-referred to the Committee on [Appropriations]",5,2,0,1,8
1705961,1324971,2023-05-15,Senate,"Placed on suspense file",7,0,0,0,7
1705961,1328270,2023-05-18,Senate,"Do pass as amended",5,0,0,2,7
1705961,1336335,2023-05-31,Senate,"Senate 3rd Reading SB423 Wiener et al",29,5,0,6,40
1705961,1348396,2023-06-28,Assembly,"Do pass as amended and be re-referred to the Committee on [Natural Resources]",7,1,0,0,8
1705961,1350783,2023-07-10,Assembly,"Do pass as amended and be re-referred to the Committee on [Appropriations]",7,0,0,4,11
1705961,1352837,2023-09-01,Assembly,"Do pass as amended",12,3,0,1,16
1705961,1353456,2023-09-07,Assembly,"SB 423 Wiener Senate Third Reading By Wicks",61,8,0,11,80
1705961,1354520,2023-09-11,Senate,"Unfinished Business SB423 Wiener et al. Concurrence",27,7,0,6,40
1705962,1301004,2023-04-12,Senate,"Do pass as amended, but first amend, and re-refer to the Committee on [Appropriations]",11,0,0,1,12
1705962,1315757,2023-05-01,Senate,"Placed on suspense file",6,0,0,1,7
1705962,1328785,2023-05-18,Senate,"Do pass as amended",7,0,0,0,7
1705962,1336377,2023-05-31,Senate,"Senate 3rd Reading SB424 Durazo et al",40,0,0,0,40
1705962,1460731,2024-06-26,Assembly,"Do pass as amended and be re-referred to the Committee on [Appropriations]",8,2,0,1,11
1705963,1288261,2023-03-29,Senate,"Do pass, but first be re-referred to the Committee on [Transportation]",6,0,0,1,7
1705963,1311947,2023-04-25,Senate,"Do pass as amended, but first amend, and re-refer to the Committee on [Appropriations]",15,0,0,1,16
1705963,1324949,2023-05-15,Senate,"Placed on suspense file",7,0,0,0,7
1705963,1328609,2023-05-18,Senate,"Do pass",6,1,0,0,7
1705963,1332575,2023-05-24,Senate,"Senate 3rd Reading SB425 Newman",38,1,0,1,40
1705963,1347825,2023-06-26,Assembly,"Do pass and be re-referred to the Committee on [Natural Resources]",14,0,0,1,15
1705963,1350777,2023-07-10,Assembly,"Do pass and be re-referred to the Committee on [Appropriations]",10,1,0,0,11
1705964,1311833,2023-04-26,Senate,"Do pass, but first be re-referred to the Committee on [Appropriations]",4,2,0,1,7
1705964,1336338,2023-05-31,Senate,"Senate 3rd Reading SB426 Niello et al",18,8,0,14,40
1705964,1336339,2023-05-31,Senate,"Senate 3rd Reading SB426 Niello et al. Reconsider",39,0,0,1,40
1705965,1313458,2023-04-26,Senate,"Do pass, but first be re-referred to the Committee on [Appropriations]",10,0,0,2,12
1705965,1320475,2023-05-08,Senate,"Placed on suspense file",7,0,0,0,7
1705965,1328835,2023-05-18,Senate,"Do pass",5,1,0,1,7
1705965,1332656,2023-05-24,Senate,"Senate 3rd Reading SB427 Portantino",33,1,0,6,40
1705965,1350125,2023-07-11,Assembly,"Do pass as amended and be re-referred to the Committee on [Appropriations]",12,0,0,3,15
1705965,1352658,2023-09-01,Assembly,"Do pass",13,1,0,2,16
1705965,1425932,2024-04-11,Assembly,"SB 427 Portantino Senate Third Reading By Zbur",62,0,0,18,80
1705966,1288175,2023-03-28,Senate,"Do pass as amended, but first amend, and re-refer to the Committee on [Appropriations] with the recommendation: To Consent Calendar",9,0,0,2,11
1705966,1308872,2023-04-24,Senate,"Placed on suspense file",7,0,0,0,7
1705966,1328864,2023-05-18,Senate,"Do pass as amended",7,0,0,0,7
1705966,1335579,2023-05-30,Senate,"Special Consent SB428 Blakespear",40,0,0,0,40
1705966,1347879,2023-06-27,Assembly,"Do pass. To Consent Calendar",11,0,0,0,11
1705966,1349513,2023-07-03,Assembly,"SB 428 Blakespear Consent Calendar Second Day",69,0,0,11,80
1705966,1353096,2023-09-01,Assembly,"SB 428 Blakespear Senate Third Reading By Boerner",70,0,0,10,80
1705966,1354676,2023-09-14,Senate,"Unfinished Business SB428 Blakespear Concurrence",40,0,0,0,40
1705966,1354677,2023-09-14,Assembly,"SB 428 Blakespear Senate Third Reading By Boerner",80,0,0,0,80
1705967,1296935,2023-04-10,Senate,"Do pass, but first be re-referred to the Committee on [Appropriations]",14,0,0,4,18
1705967,1332635,2023-05-24,Senate,"Senate 3rd Reading SB429 Bradford",38,0,0,2,40
1705967,1349659,2023-07-05,Assembly,"Do pass as amended and be re-referred to the Committee on [Appropriations]",12,0,0,1,13
1705967,1352880,2023-09-01,Assembly,"Do pass",14,1,0,1,16
1705967,1353910,2023-09-12,Assembly,"SB 429 Bradford Senate Third Reading By Boerner",48,1,0,31,80
1705967,1354403,2023-09-13,Senate,"That the Assembly amendments be concurred in",11,0,0,7,18
1705967,1354735,2023-09-14,Senate,"Unfinished Business SB429 Bradford Concurrence",28,2,0,10,40
1705968,1298206,2023-04-11,Senate,"Do pass, but first be re-referred to the Committee on [Appropriations]",15,0,0,0,15
1705968,1320383,2023-05-08,Senate,"Senate 3rd Reading SB430 Dodd",36,0,0,4,40
1705968,1344202,2023-06-14,Assembly,"Do pass as amended and be re-referred to the Committee on [Appropriations]",16,0,0,6,22
1705969,1310306,2023-04-24,Senate,"Do pass, but first be re-referred to the Committee on [Appropriations] with the recommendation: To Consent Calendar",5,0,0,0,5
1705969,1320386,2023-05-08,Senate,"Placed on suspense file",7,0,0,0,7
1705970,1311920,2023-04-26,Senate,"Do pass as amended, but first amend, and re-refer to the Committee on [Appropriations] with the recommendation: To Consent Calendar",5,0,0,0,5
1705970,1328561,2023-05-18,Senate,"Consent Calendar SB432 Cortese",38,0,0,2,40
1705970,1348319,2023-06-28,Assembly,"Do pass and be re-referred to the Committee on [Appropriations] with recommendation: To Consent Calendar",7,0,0,0,7
1705970,1350386,2023-07-12,Assembly,"Do pass. To Consent Calendar",15,0,0,1,16
1705970,1352483,2023-08-31,Assembly,"SB 432 Cortese Senate Third Reading By Haney",77,0,0,3,80
1705970,1353367,2023-09-07,Senate,"Special Consent SB432 Cortese",40,0,0,0,40
1705971,1301075,2023-04-12,Senate,"Do pass, but first be re-referred to the Committee on [Education]",4,1,0,0,5
1705971,1305481,2023-04-19,Senate,"Do pass, but first be re-referred to the Committee on [Appropriations]",4,2,0,1,7
1705971,1315776,2023-05-01,Senate,"Placed on suspense file",6,0,0,1,7
1705971,1327925,2023-05-18,Senate,"Do pass as amended",5,2,0,0,7
1705971,1332561,2023-05-24,Senate,"Senate 3rd Reading SB433 Cortese",28,11,0,1,40
1705971,1344219,2023-06-14,Assembly,"Do pass and be re-referred to the Committee on [Higher Education]",5,1,0,1,7
1705971,1348469,2023-06-27,Assembly,"Do pass as amended and be re-referred to the Committee on [Appropriations]",8,3,0,1,12
1705971,1352982,2023-09-01,Assembly,"Do pass",11,4,0,1,16
1705971,1353692,2023-09-11,Assembly,"SB 433 Cortese Senate Third Reading By McKinnor",61,17,0,2,80
1705971,1353768,2023-09-12,Senate,"Unfinished Business SB433 Cortese Concurrence",28,10,0,2,40
1705972,1288245,2023-03-28,Senate,"Do pass, but first be re-referred to the Committee on [Appropriations] with the recommendation: To Consent Calendar",14,0,0,2,16
1705972,1302645,2023-04-17,Senate,"Placed on suspense file",6,0,0,1,7
1705972,1328128,2023-05-18,Senate,"Do pass",7,0,0,0,7
1705972,1333792,2023-05-25,Senate,"Special Consent SB434 Min et al",40,0,0,0,40
1705972,1349583,2023-07-05,Assembly,"Do pass and be re-referred to the Committee on [Appropriations] with recommendation: To Consent Calendar",15,0,0,0,15
1705972,1352747,2023-09-01,Assembly,"Do pass",16,0,0,0,16
1705972,1353682,2023-09-11,Assembly,"SB 434 Min Senate Third Reading By Low",80,0,0,0,80
1705972,1353968,2023-09-12,Senate,"Unfinished Business SB434 Min et al. Concurrence",39,0,0,1,40
1705973,1286872,2023-03-28,Senate,"Do pass, but first be re-referred to the Committee on [Judiciary]",10,0,0,5,15
1705973,1299364,2023-04-11,Senate,"Do pass, but first be re-referred to the Committee on [Appropriations]",8,0,0,3,11
1705973,1308850,2023-04-24,Senate,"Placed on suspense file",7,0,0,0,7
1705973,1328759,2023-05-18,Senate,"Do pass as amended",5,0,0,2,7
1705973,1332574,2023-05-24,Senate,"Senate 3rd Reading SB435 Gonzalez et al",35,0,0,5,40
1705973,1350202,2023-07-11,Assembly,"Do pass and be re-referred to the Committee on [Appropriations]",7,0,0,1,8
1705973,1352666,2023-09-01,Assembly,"Do pass as amended",11,0,0,5,16
1705973,1353463,2023-09-07,Assembly,"SB 435 Gonzalez Senate Third Reading By Arambula",79,0,0,1,80
1705973,1354602,2023-09-11,Senate,"Unfinished Business SB435 Gonzalez et al. Concurrence",34,0,0,6,40
1705974,1298259,2023-04-11,Senate,"Do pass, but first be re-referred to the Committee on [Appropriations] with the recommendation: To Consent Calendar",15,0,0,0,15
1705974,1308801,2023-04-24,Senate,"Placed on suspense file",7,0,0,0,7
1705975,1280694,2023-03-21,Senate,"Do pass, but first be re-referred to the Committee on [Appropriations] with the recommendation: To Consent Calendar",7,0,0,0,7
1705975,1301082,2023-04-13,Senate,"Consent Calendar SB437 Dodd",36,0,0,4,40
1705975,1341017,2023-06-07,Assembly,"Do pass and be re-referred to the Committee on [Appropriations] with recommendation: To Consent Calendar",8,0,0,0,8
1705975,1346238,2023-06-21,Assembly,"Do pass. To Consent Calendar",13,0,0,3,16
1705975,1347804,2023-06-27,Assembly,"SB 437 Dodd Consent Calendar Second Day Regular Session",78,0,0,2,80
1705976,1286948,2023-03-28,Senate,"Do pass as amended, but first amend, and re-refer to the Committee on [Environmental Quality]",9,0,0,2,11
1705976,1305359,2023-04-19,Senate,"Do pass, but first be re-referred to the Committee on [Appropriations]",6,0,0,1,7
1705976,1325048,2023-05-15,Senate,"Senate 3rd Reading SB438 Caballero et al",38,0,0,2,40
1705977,1317037,2023-05-02,Senate,"Do pass and be ordered to the Consent Calendar",10,0,0,1,11
1705977,1323875,2023-05-11,Senate,"Consent Calendar SB439 Skinner",39,0,0,1,40
1705977,1339972,2023-06-06,Assembly,"Do pass. To Consent Calendar",11,0,0,0,11
1705977,1353400,2023-09-07,Assembly,"SB 439 Skinner Senate Third Reading By Grayson",78,0,0,2,80
1705977,1354548,2023-09-11,Senate,"Unfinished Business SB439 Skinner Concurrence",39,0,0,1,40
1705978,1305520,2023-04-18,Senate,"Do pass, but first be re-referred to the Committee on [Governance and Finance]",8,2,0,1,11
1705978,1313330,2023-04-26,Senate,"Do pass as amended, but first amend, and re-refer to the Committee on [Appropriations]",5,2,0,1,8
1705978,1324963,2023-05-15,Senate,"Placed on suspense file",7,0,0,0,7
1705978,1328805,2023-05-18,Senate,"Do pass as amended",5,2,0,0,7
1705978,1336367,2023-05-31,Senate,"Senate 3rd Reading SB440 Skinner et al",30,8,0,2,40
1705978,1348369,2023-06-28,Assembly,"Do pass as amended and be re-referred to the Committee on [Local Government]",6,2,0,0,8
1705978,1350401,2023-07-12,Assembly,"Do pass and be re-referred to the Committee on [Appropriations]",6,1,0,1,8
1705978,1464565,2024-08-15,Assembly,"Do pass as amended",11,3,0,1,15
1705978,1466629,2024-08-31,Senate,"Unfinished Business SB440 Skinner et al. Concurrence",30,9,0,1,40
1705978,1466630,2024-08-31,Assembly,"SB 440 Skinner Senate Third Reading By Ting",53,15,0,11,79
1705979,1288162,2023-03-28,Senate,"Do pass, but first be re-referred to the Committee on [Appropriations]",5,0,0,0,5
1705979,1302596,2023-04-17,Senate,"Placed on suspense file",6,0,0,1,7
1705979,1328398,2023-05-18,Senate,"Do pass as amended",5,2,0,0,7
1705979,1336353,2023-05-31,Senate,"Senate 3rd Reading SB441 Bradford",31,4,0,5,40
1705979,1350121,2023-07-11,Assembly,"Do pass and be re-referred to the Committee on [Appropriations]",6,2,0,0,8
1705979,1352596,2023-09-01,Assembly,"Do pass as amended",11,3,0,2,16
1705980,1280617,2023-03-21,Senate,"Do pass, but first be re-referred to the Committee on [Appropriations]",5,0,0,0,5
1705980,1296968,2023-04-10,Senate,"Placed on suspense file",7,0,0,0,7
1705980,1328547,2023-05-18,Senate,"Do pass as amended",7,0,0,0,7
1705980,1335473,2023-05-30,Senate,"Special Consent SB442 Lim√≥n et al",40,0,0,0,40
1705980,1453442,2024-06-04,Assembly,"Do pass and be re-referred to the Committee on [Appropriations] with recommendation: To Consent Calendar",7,0,0,1,8
1705980,1464325,2024-08-15,Assembly,"Do pass",14,0,0,1,15
1705980,1466004,2024-08-27,Assembly,"SB 442 Lim√≥n Senate Third Reading By Bennett",77,0,0,2,79
1705982,1281805,2023-03-22,Senate,"Do pass as amended, but first amend, and re-refer to the Committee on [Appropriations] with the recommendation: To Consent Calendar",7,0,0,0,7
1705982,1296983,2023-04-10,Senate,"Placed on suspense file",7,0,0,0,7
1705982,1328387,2023-05-18,Senate,"Do pass",7,0,0,0,7
1705982,1333655,2023-05-25,Senate,"Special Consent SB444 Newman",40,0,0,0,40
1705982,1348452,2023-06-27,Assembly,"Do pass as amended and be re-referred to the Committee on [Appropriations]",11,0,0,1,12
1705982,1352591,2023-09-01,Assembly,"Do pass as amended",11,0,0,5,16
1705982,1354119,2023-09-13,Assembly,"SB 444 Newman Senate Third Reading By Arambula",80,0,0,0,80
1705982,1354849,2023-09-14,Senate,"Unfinished Business SB444 Newman Concurrence",40,0,0,0,40
1705983,1281821,2023-03-22,Senate,"Do pass as amended, but first amend, and re-refer to the Committee on [Appropriations]",7,0,0,0,7
1705983,1296898,2023-04-10,Senate,"Placed on suspense file",7,0,0,0,7
1705983,1328382,2023-05-18,Senate,"Do pass as amended",7,0,0,0,7
1705983,1336352,2023-05-31,Senate,"Senate 3rd Reading SB445 Portantino et al",40,0,0,0,40
1705983,1348853,2023-06-28,Assembly,"Do pass and be re-referred to the Committee on [Appropriations] with recommendation: To Consent Calendar",7,0,0,0,7
1705983,1352709,2023-09-01,Assembly,"Do pass",16,0,0,0,16
1705983,1460464,2024-06-26,Assembly,"Do pass as amended, and be re-referred to the Committee on [Appropriations] with recommendation: To Consent Calendar",7,0,0,0,7
1705983,1464141,2024-08-15,Assembly,"Do pass as amended",11,0,0,4,15
1705983,1465668,2024-08-26,Assembly,"SB 445 Portantino Senate Third Reading By Blanca Rubio",76,0,0,3,79
1705983,1466209,2024-08-29,Senate,"Unfinished Business SB445 Portantino et al. Concurrence",40,0,0,0,40
1705984,1288239,2023-03-29,Senate,"Do pass, but first be re-referred to the Committee on [Judiciary] with the recommendation: To Consent Calendar",7,0,0,0,7
1705984,1299486,2023-04-11,Senate,"Do pass, but first be re-referred to the Committee on [Appropriations] with the recommendation: To Consent Calendar",10,0,0,1,11
1705984,1315738,2023-05-01,Senate,"Consent Calendar SB446 Wilk",37,0,0,3,40
1705984,1343124,2023-06-12,Assembly,"Do pass and be re-referred to the Committee on [Judiciary] with recommendation: To Consent Calendar",12,0,0,0,12
1705984,1345660,2023-06-20,Assembly,"Do pass and be re-referred to the Committee on [Appropriations] with recommendation: To Consent Calendar",10,0,0,1,11
1705984,1350564,2023-07-12,Assembly,"Do pass. To Consent Calendar",15,0,0,1,16
1705984,1351710,2023-08-17,Assembly,"SB 446 Wilk Consent Calendar Second Day Regular Session",75,0,0,5,80
1705985,1302592,2023-04-17,Senate,"Do pass, but first be re-referred to the Committee on [Appropriations]",10,3,0,0,13
1705985,1315694,2023-05-01,Senate,"Placed on suspense file",6,0,0,1,7
1705985,1328883,2023-05-18,Senate,"Do pass",5,2,0,0,7
1705985,1332578,2023-05-24,Senate,"Senate 3rd Reading SB447 Atkins",31,8,0,1,40
1705985,1350423,2023-07-11,Assembly,"Do pass as amended and be re-referred to the Committee on [Appropriations]",6,1,0,0,7
1705985,1350424,2023-07-11,Assembly,"Amendments (Committee's)",6,1,0,0,7
1705985,1353065,2023-09-01,Assembly,"Do pass as amended",11,4,0,1,16
1705985,1353668,2023-09-11,Assembly,"SB 447 Atkins Third Reading Urgency By Zbur",64,12,0,4,80
1705985,1354037,2023-09-12,Senate,"Unfinished Business SB447 Atkins Urgency Clause Concurrence",31,6,0,3,40
1705986,1298312,2023-04-11,Senate,"Do pass, but first be re-referred to the Committee on [Appropriations] with the recommendation: To Consent Calendar",5,0,0,0,5
1705986,1315707,2023-05-01,Senate,"Consent Calendar SB448 Becker",37,0,0,3,40
1705986,1343762,2023-06-13,Assembly,"Do pass and be re-referred to the Committee on [Appropriations] with recommendation: To Consent Calendar",8,0,0,0,8
1705986,1346146,2023-06-21,Assembly,"Do pass. To Consent Calendar",13,0,0,3,16
1705986,1353872,2023-09-12,Assembly,"SB 448 Becker Senate Third Reading By Santiago",80,0,0,0,80
1705986,1354169,2023-09-13,Senate,"Unfinished Business SB448 Becker et al. Concurrence",39,0,0,1,40
1705987,1304242,2023-04-18,Senate,"Do pass, but first be re-referred to the Committee on [Appropriations]",5,0,0,0,5
1705987,1336359,2023-05-31,Senate,"Senate 3rd Reading SB449 Bradford",40,0,0,0,40
1705987,1350120,2023-07-11,Assembly,"Do pass and be re-referred to the Committee on [Appropriations]",8,0,0,0,8
1705987,1351573,2023-08-16,Assembly,"Do pass. To Consent Calendar",15,0,0,1,16
1705987,1353589,2023-09-11,Assembly,"SB 449 Bradford Senate Third Reading By Ting",77,0,0,3,80
1705987,1354094,2023-09-13,Senate,"Unfinished Business SB449 Bradford Concurrence",39,0,0,1,40
1705988,1305267,2023-04-18,Senate,"Do pass, but first be re-referred to the Committee on [Rules]",9,1,0,1,11
1705988,1313369,2023-04-26,Senate,"Do pass, but first be re-referred to the Committee on [Appropriations]",5,2,0,1,8
1705988,1325034,2023-05-15,Senate,"Placed on suspense file",7,0,0,0,7
1705988,1328348,2023-05-18,Senate,"Do pass",5,2,0,0,7
1705988,1332640,2023-05-24,Senate,"Senate 3rd Reading SB450 Atkins",30,7,0,3,40
1705988,1346262,2023-06-21,Assembly,"Do pass and be re-referred to the Committee on [Local Government]",7,1,0,0,8
1705988,1348426,2023-06-28,Assembly,"Do pass and be re-referred to the Committee on [Appropriations]",5,2,0,1,8
1705988,1352534,2023-09-01,Assembly,"Do pass as amended",12,2,0,2,16
1705988,1466350,2024-08-29,Senate,"Unfinished Business SB450 Atkins Concurrence",29,9,0,2,40
1705988,1466807,2024-08-28,Assembly,"SB 450 Atkins Senate Third Reading By Wicks",54,8,0,17,79
1705990,1304395,2023-04-18,Senate,"Do pass as amended, but first amend, and re-refer to the Committee on [Appropriations]",4,0,0,1,5
1705990,1315651,2023-05-01,Senate,"Placed on suspense file",6,0,0,1,7
1705990,1328117,2023-05-18,Senate,"Do pass as amended",5,2,0,0,7
1705990,1332610,2023-05-24,Senate,"Senate 3rd Reading SB452 Blakespear et al",29,10,0,1,40
1705990,1348292,2023-06-27,Assembly,"Do pass and be re-referred to the Committee on [Appropriations]",6,2,0,0,8
1705990,1352539,2023-09-01,Assembly,"Do pass as amended",11,4,0,1,16
1705990,1354090,2023-09-13,Assembly,"SB 452 Blakespear Senate Third Reading By Maienschein",55,18,0,7,80
1705990,1354852,2023-09-14,Senate,"Unfinished Business SB452 Blakespear et al. Concurrence",30,9,0,1,40
1705991,1298264,2023-04-11,Senate,"Do pass, but first be re-referred to the Committee on [Appropriations]",1,1,0,3,5
1705991,1298265,2023-04-11,Senate,"[Second] hearing set for [04-11-2023]: Failed passage in Committee. Reconsideration granted",5,0,0,0,5
1705992,1318089,2023-05-03,Senate,"Do pass, but first be re-referred to the Committee on [Appropriations] with the recommendation: To Consent Calendar",7,0,0,1,8
1705992,1325038,2023-05-15,Senate,"Placed on suspense file",7,0,0,0,7
1705993,1305415,2023-04-19,Senate,"Do pass, but first be re-referred to the Committee on [Judiciary]",7,0,0,0,7
1705993,1317039,2023-05-02,Senate,"Do pass and be ordered to the Consent Calendar",10,0,0,1,11
1705993,1336334,2023-05-31,Senate,"Senate 3rd Reading SB455 McGuire",40,0,0,0,40
1705993,1347507,2023-06-26,Assembly,"Do pass as amended and be re-referred to the Committee on [Judiciary]",10,0,0,2,12
1705993,1349629,2023-07-05,Assembly,"Do pass. To Consent Calendar",10,0,0,1,11
1705993,1352356,2023-08-28,Assembly,"SB 455 McGuire Senate Third Reading By Grayson",75,0,0,5,80
1705993,1353376,2023-09-07,Senate,"Special Consent SB455 McGuire",40,0,0,0,40
1705994,1281854,2023-03-21,Senate,"Do pass, but first be re-referred to the Committee on [Human Services]",10,0,0,1,11
1705994,1310276,2023-04-24,Senate,"Do pass, but first be re-referred to the Committee on [Appropriations] with the recommendation: To Consent Calendar",5,0,0,0,5
1705994,1320370,2023-05-08,Senate,"Placed on suspense file",7,0,0,0,7
1705994,1328486,2023-05-18,Senate,"Do pass",7,0,0,0,7
1705994,1333764,2023-05-25,Senate,"Special Consent SB456 Menjivar et al",40,0,0,0,40
1705994,1348373,2023-06-28,Assembly,"Do pass as amended and be re-referred to the Committee on [Human Services]",8,0,0,0,8
1705994,1350236,2023-07-11,Assembly,"Do pass and be re-referred to the Committee on [Appropriations] with recommendation: To Consent Calendar",7,0,0,1,8
1705995,1288352,2023-03-28,Senate,"Do pass",10,0,0,1,11
1705995,1308787,2023-04-24,Senate,"Senate 3rd Reading SB457 Menjivar et al",39,0,0,1,40
1705995,1340082,2023-06-06,Assembly,"Do pass",9,0,0,2,11
1705995,1351666,2023-08-17,Assembly,"SB 457 Menjivar Senate Third Reading By Papan",73,0,0,7,80
1705997,1311834,2023-04-25,Senate,"Do pass as amended, but first amend, and re-refer to the Committee on [Public Safety] with the recommendation: To Consent Calendar",11,0,0,0,11
1705997,1328746,2023-05-18,Senate,"Consent Calendar SB459 Rubio et al",38,0,0,2,40
1705997,1345608,2023-06-20,Assembly,"Do pass as amended, and be re-referred to the Committee on [Appropriations] with recommendation: To Consent Calendar",10,0,0,1,11
1705997,1350508,2023-07-12,Assembly,"Do pass. To Consent Calendar",15,0,0,1,16
1705997,1353454,2023-09-07,Assembly,"SB 459 Rubio Senate Third Reading By Gabriel",79,0,0,1,80
1705997,1354571,2023-09-11,Senate,"Unfinished Business SB459 Rubio et al. Concurrence",39,0,0,1,40
1705999,1301052,2023-04-12,Senate,"Do pass, but first be re-referred to the Committee on [Judiciary]",5,0,0,0,5
1705999,1330040,2023-05-22,Senate,"Senate 3rd Reading SB461 Wahab et al",40,0,0,0,40
1705999,1348349,2023-06-28,Assembly,"Do pass as amended and be re-referred to the Committee on [Appropriations]",7,0,0,0,7
1705999,1350544,2023-07-12,Assembly,"Do pass. To Consent Calendar",15,0,0,1,16
1705999,1351708,2023-08-17,Assembly,"SB 461 Wahab Consent Calendar Second Day Regular Session",75,0,0,5,80
1705999,1353238,2023-09-06,Assembly,"SB 461 Wahab Senate Third Reading By Gabriel",79,0,0,1,80
1705999,1353497,2023-09-07,Senate,"Unfinished Business SB461 Wahab et al. Concurrence",40,0,0,0,40
1706000,1280691,2023-03-20,Senate,"Do pass, but first be re-referred to the Committee on [Judiciary] with the recommendation: To Consent Calendar",5,0,0,0,5
1706000,1299340,2023-04-11,Senate,"Do pass and be ordered to the Consent Calendar",10,0,0,1,11
1706000,1306735,2023-04-20,Senate,"Consent Calendar SB462 Wahab et al",36,0,0,4,40
1706000,1340086,2023-06-06,Assembly,"Do pass and be re-referred to the Committee on [Privacy and Consumer Protection] with recommendation: To Consent Calendar",8,0,0,0,8
1706000,1347851,2023-06-27,Assembly,"Do pass. To Consent Calendar",11,0,0,0,11
1706000,1349444,2023-07-03,Assembly,"SB 462 Wahab Consent Calendar Second Day Regular Session",69,0,0,11,80
1706001,1299417,2023-04-11,Senate,"Do pass, but first be re-referred to the Committee on [Appropriations] with the recommendation: To Consent Calendar",10,0,0,1,11
1706001,1315701,2023-05-01,Senate,"Consent Calendar SB463 Wahab et al",37,0,0,3,40
1706001,1340027,2023-06-06,Assembly,"Do pass and be re-referred to the Committee on [Human Services]",9,2,0,0,11
1706001,1350182,2023-07-11,Assembly,"Do pass and be re-referred to the Committee on [Appropriations]",5,2,0,1,8
1706001,1351561,2023-08-16,Assembly,"Do pass",13,3,0,0,16
1706001,1353134,2023-09-05,Assembly,"SB 463 Wahab Senate Third Reading By Gipson",60,12,0,8,80
1706001,1353229,2023-09-06,Senate,"Unfinished Business SB463 Wahab et al. Concurrence",40,0,0,0,40
1706002,1310356,2023-04-25,Senate,"Do pass, but first be re-referred to the Committee on [Appropriations] with the recommendation: To Consent Calendar",5,0,0,0,5
1706002,1320371,2023-05-08,Senate,"Placed on suspense file",7,0,0,0,7
1706002,1328341,2023-05-18,Senate,"Do pass",7,0,0,0,7
1706002,1333671,2023-05-25,Senate,"Special Consent SB464 Wahab et al",40,0,0,0,40
1706002,1348338,2023-06-27,Assembly,"Do pass as amended, and be re-referred to the Committee on [Appropriations] with recommendation: To Consent Calendar",8,0,0,0,8
1706002,1353040,2023-09-01,Assembly,"Do pass as amended",11,0,0,5,16
1706002,1353490,2023-09-07,Assembly,"SB 464 Wahab Senate Third Reading",79,0,0,1,80
1706002,1354667,2023-09-11,Senate,"Unfinished Business SB464 Wahab et al. Concurrence",39,0,0,1,40
1706003,1310182,2023-04-24,Senate,"Do pass, but first be re-referred to the Committee on [Appropriations] with the recommendation: To Consent Calendar",5,0,0,0,5
1706003,1323871,2023-05-11,Senate,"Consent Calendar SB465 Wahab et al",39,0,0,1,40
1706003,1339989,2023-06-06,Assembly,"Do pass as amended and be re-referred to the Committee on [Appropriations]",7,0,0,1,8
1706003,1352660,2023-09-01,Assembly,"Do pass",15,0,0,1,16
1706003,1353651,2023-09-11,Assembly,"SB 465 Wahab Senate Third Reading By Jackson",79,0,0,1,80
1706003,1353862,2023-09-12,Senate,"Unfinished Business SB465 Wahab et al. Concurrence",39,0,0,1,40
1706004,1305350,2023-04-18,Senate,"Do pass",7,1,0,3,11
1706004,1335510,2023-05-30,Senate,"Senate 3rd Reading SB466 Wahab",15,16,0,9,40
1706004,1335511,2023-05-30,Senate,"Senate 3rd Reading SB466 Wahab Reconsider",40,0,0,0,40
1706005,1281841,2023-03-22,Senate,"Do pass",7,0,0,0,7
1706005,1308795,2023-04-24,Senate,"Senate 3rd Reading SB467 Portantino",39,0,0,1,40
1706005,1343693,2023-06-13,Assembly,"Do pass",9,0,0,3,12
1706005,1347498,2023-06-26,Assembly,"SB 467 Portantino Senate Third Reading By Mike Fong",68,0,0,12,80
1706007,1305546,2023-04-18,Senate,"Do pass, but first be re-referred to the Committee on [Appropriations]",10,0,0,1,11
1706007,1323790,2023-05-11,Senate,"Senate 3rd Reading SB469 Allen et al",39,0,0,1,40
1706007,1340990,2023-06-07,Assembly,"Do pass as amended and be re-referred to the Committee on [Appropriations]",8,0,0,0,8
1706007,1350390,2023-07-12,Assembly,"Do pass. To Consent Calendar",15,0,0,1,16
1706007,1351681,2023-08-17,Assembly,"SB 469 Allen Consent Calendar Second Day Regular Session",75,0,0,5,80
1706007,1352254,2023-08-24,Senate,"Special Consent SB469 Allen et al",40,0,0,0,40
1706008,1315142,2023-04-25,Senate,"Do pass as amended, but first amend, and re-refer to the Committee on [Appropriations] with the recommendation: To Consent Calendar",10,0,0,1,11
1706008,1320438,2023-05-08,Senate,"Placed on suspense file",7,0,0,0,7
1706008,1328400,2023-05-18,Senate,"Do pass",7,0,0,0,7
1706008,1333807,2023-05-25,Senate,"Special Consent SB470 Alvarado-Gil",40,0,0,0,40
1706008,1350172,2023-07-11,Assembly,"Do pass as amended and be re-referred to the Committee on [Appropriations]",14,0,0,1,15
1706008,1352721,2023-09-01,Assembly,"Do pass as amended",11,0,0,5,16
1706008,1353500,2023-09-07,Assembly,"SB 470 Alvarado-Gil Senate Third Reading By Megan Dahle",79,0,0,1,80
1706008,1354610,2023-09-11,Senate,"Unfinished Business SB470 Alvarado-Gil Concurrence",39,0,0,1,40
1706009,1318085,2023-05-03,Senate,"Do pass, but first be re-referred to the Committee on [Appropriations]",7,0,0,1,8
1706009,1325015,2023-05-15,Senate,"Placed on suspense file",7,0,0,0,7
1706010,1281863,2023-03-22,Senate,"Do pass as amended, but first amend, and re-refer to the Committee on [Health] with the recommendation: To Consent Calendar",7,0,0,0,7
1706010,1301062,2023-04-12,Senate,"Do pass as amended, but first amend, and re-refer to the Committee on [Appropriations]",11,0,0,1,12
1706010,1315685,2023-05-01,Senate,"Placed on suspense file",6,0,0,1,7
1706011,1299502,2023-04-11,Senate,"Do pass, but first be re-referred to the Committee on [Appropriations]",14,0,0,2,16
1706011,1308784,2023-04-24,Senate,"Placed on suspense file",7,0,0,0,7
1706012,1288316,2023-03-28,Senate,"Do pass, but first be re-referred to the Committee on [Appropriations]",5,0,0,0,5
1706012,1302576,2023-04-17,Senate,"Placed on suspense file",6,0,0,1,7
1706012,1328502,2023-05-18,Senate,"Do pass as amended",5,2,0,0,7
1706012,1332571,2023-05-24,Senate,"Senate 3rd Reading SB474 Becker et al",34,5,0,1,40
1706012,1348391,2023-06-27,Assembly,"Do pass and be re-referred to the Committee on [Appropriations]",8,0,0,0,8
1706012,1352579,2023-09-01,Assembly,"Do pass as amended",11,1,0,4,16
1706012,1354125,2023-09-13,Assembly,"SB 474 Becker Senate Third Reading By Bryan",77,1,0,2,80
1706012,1354847,2023-09-14,Senate,"Unfinished Business SB474 Becker et al. Concurrence",35,5,0,0,40
1706013,1299423,2023-04-11,Senate,"Be adopted, but first be re-referred to the Committee on [Appropriations] with recommendation: To Consent Calendar",16,0,0,0,16
1706013,1315649,2023-05-01,Senate,"Consent Calendar SCR25 Seyarto et al",37,0,0,3,40
1706013,1349637,2023-07-05,Assembly,"Be adopted. To Consent Calendar",15,0,0,0,15
1706013,1351294,2023-08-14,Assembly,"SCR 25 Seyarto Consent Calendar Second Day Regular Session",74,0,0,6,80
1706013,1352219,2023-08-24,Senate,"Special Consent SCR25 Seyarto et al",40,0,0,0,40
1706014,1352838,2023-09-01,Senate,"Special Consent SCR26 Nguyen",37,0,0,3,40
1706015,1313485,2023-04-27,Senate,"Senate 3rd Reading SCR27 Ochoa Bogh et al",38,0,0,2,40
1706015,1323785,2023-05-11,Assembly,"Be adopted. To Consent Calendar",10,0,0,3,13
1706015,1328352,2023-05-18,Assembly,"SCR 27 Ochoa Bogh Consent Calendar Second Day Regular Session",74,0,0,6,80
1707480,1305436,2023-04-18,Assembly,"Do pass as amended and be re-referred to the Committee on [Appropriations]",14,0,0,1,15
1707480,1328636,2023-05-18,Assembly,"Do pass",15,0,0,1,16
1707480,1335438,2023-05-30,Assembly,"AB 833 Luz Rivas Assembly Third Reading",80,0,0,0,80
1707481,1286976,2023-03-28,Assembly,"Do pass as amended and be re-referred to the Committee on [Appropriations]",18,0,0,1,19
1707481,1305303,2023-04-19,Assembly,"Do pass. To Consent Calendar",14,0,0,2,16
1707481,1313483,2023-04-27,Assembly,"AB 834 Irwin Consent Calendar Second Day Regular Session",79,0,0,1,80
1707481,1349514,2023-07-03,Senate,"Do pass, but first be re-referred to the Committee on [Appropriations] with the recommendation: To Consent Calendar",12,0,0,1,13
1707481,1351661,2023-08-17,Senate,"Consent Calendar 2nd AB834 Irwin",38,0,0,2,40
1707481,1352216,2023-08-24,Assembly,"AB 834 Irwin Concurrence in Senate Amendments",75,0,0,5,80
1707482,1304260,2023-04-17,Assembly,"Do pass as amended and be re-referred to the Committee on [Appropriations]",7,0,0,0,7
1707482,1328857,2023-05-18,Assembly,"Do pass as amended",11,0,0,5,16
1707482,1335433,2023-05-30,Assembly,"AB 835 Lee Assembly Third Reading",80,0,0,0,80
1707482,1347792,2023-06-27,Senate,"Do pass as amended, but first amend, and re-refer to the Committee on [Appropriations]",15,0,0,0,15
1707482,1353123,2023-09-05,Senate,"Assembly 3rd Reading AB835 Lee et al. By Wiener",39,0,0,1,40
1707482,1353396,2023-09-07,Assembly,"AB 835 Lee Concurrence in Senate Amendments",79,0,0,1,80
1707484,1288246,2023-03-29,Assembly,"Do pass as amended and be re-referred to the Committee on [Housing and Community Development]",8,0,0,0,8
1707484,1311745,2023-04-26,Assembly,"Do pass as amended",7,0,0,1,8
1707484,1328884,2023-05-18,Assembly,"Do pass",15,0,0,1,16
1707484,1335537,2023-05-30,Assembly,"AB 837 Alvarez Assembly Third Reading",80,0,0,0,80
1707485,1288247,2023-03-28,Assembly,"Do pass and be re-referred to the Committee on [Appropriations]",9,0,0,0,9
1707486,1288311,2023-03-28,Assembly,"Do pass as amended and be re-referred to the Committee on [Appropriations]",14,0,0,1,15
1707486,1305526,2023-04-19,Assembly,"Do pass. To Consent Calendar",14,0,0,2,16
1707486,1313528,2023-04-27,Assembly,"AB 839 Addis Consent Calendar Second Day Regular Session",79,0,0,1,80
1707486,1341041,2023-06-07,Senate,"Do pass, but first be re-referred to the Committee on [Human Services]",12,0,0,0,12
1707486,1349645,2023-07-03,Senate,"Do pass, but first be re-referred to the Committee on [Appropriations]",5,0,0,0,5
1707486,1353153,2023-09-05,Senate,"Assembly 3rd Reading AB839 Addis By Alvarado-Gil",39,0,0,1,40
1707486,1353474,2023-09-07,Assembly,"AB 839 Addis Concurrence in Senate Amendments",79,0,0,1,80
1707487,1299345,2023-04-12,Assembly,"Do pass and be re-referred to the Committee on [Appropriations]",18,0,0,4,22
1707487,1328116,2023-05-18,Assembly,"Do pass",15,0,0,1,16
1707487,1335523,2023-05-30,Assembly,"AB 840 Addis Assembly Third Reading",77,0,0,3,80
1707487,1350199,2023-07-11,Senate,"Do pass, but first be re-referred to the Committee on [Appropriations]",14,0,0,1,15
1707487,1353165,2023-09-05,Senate,"Assembly 3rd Reading AB840 Addis et al. By Newman",39,0,0,1,40
1707487,1353381,2023-09-07,Assembly,"AB 840 Addis Concurrence in Senate Amendments",77,0,0,3,80
1707488,1299428,2023-04-12,Assembly,"Do pass as amended and be re-referred to the Committee on [Natural Resources]",15,0,0,0,15
1707488,1310326,2023-04-24,Assembly,"Do pass and be re-referred to the Committee on [Appropriations] with recommendation: To Consent Calendar",11,0,0,0,11
1707488,1328538,2023-05-18,Assembly,"Do pass as amended",11,0,0,5,16
1707488,1335452,2023-05-30,Assembly,"AB 841 Berman Assembly Third Reading",79,0,0,1,80
1707488,1349530,2023-07-03,Senate,"Do pass as amended, but first amend, and re-refer to the Committee on [Environmental Quality]",13,2,0,3,18
1707488,1351832,2023-08-21,Senate,"Placed on suspense file",7,0,0,0,7
1707490,1304316,2023-04-18,Assembly,"Do pass and be re-referred to the Committee on [Appropriations] with recommendation: To Consent Calendar",7,0,0,1,8
1707490,1328101,2023-05-18,Assembly,"Do pass",15,0,0,1,16
1707490,1335508,2023-05-30,Assembly,"AB 843 Juan Carrillo Assembly Third Reading",80,0,0,0,80
1707490,1345591,2023-06-19,Senate,"Do pass, but first be re-referred to the Committee on [Appropriations] with the recommendation: To Consent Calendar",5,0,0,0,5
1707490,1349533,2023-07-03,Senate,"Placed on suspense file",7,0,0,0,7
1707490,1352900,2023-09-01,Senate,"Do pass",7,0,0,0,7
1707490,1353774,2023-09-12,Assembly,"AB 843 Juan Carrillo Concurrence in Senate Amendments",80,0,0,0,80
1707490,1354514,2023-09-11,Senate,"Assembly 3rd Reading AB843 Juan Carrillo By Lim√≥n",39,0,0,1,40
1707491,1280695,2023-03-20,Assembly,"Do pass and be re-referred to the Committee on [Insurance] with recommendation: To Consent Calendar",15,0,0,0,15
1707491,1299392,2023-04-12,Assembly,"Do pass as amended and be re-referred to the Committee on [Appropriations]",13,0,0,1,14
1707491,1311689,2023-04-26,Assembly,"Do pass. To Consent Calendar",16,0,0,0,16
1707491,1318906,2023-05-04,Assembly,"AB 844 Gipson Consent Calendar Second Day Regular Session",75,0,0,5,80
1707491,1348486,2023-06-28,Senate,"Do pass as amended, but first amend, and re-refer to the Committee on [Judiciary]",7,0,0,0,7
1707491,1350533,2023-07-11,Senate,"Do pass, but first be re-referred to the Committee on [Appropriations] with the recommendation: To Consent Calendar",11,0,0,0,11
1707491,1351797,2023-08-21,Senate,"Do pass",7,0,0,0,7
1707491,1353207,2023-09-06,Senate,"Assembly 3rd Reading AB844 Gipson",40,0,0,0,40
1707491,1353506,2023-09-07,Assembly,"AB 844 Gipson Concurrence in Senate Amendments",76,0,0,4,80
1707492,1298167,2023-04-11,Assembly,"Do pass as amended and be re-referred to the Committee on [Health]",8,0,0,0,8
1707492,1304342,2023-04-18,Assembly,"Do pass and be re-referred to the Committee on [Appropriations] with recommendation: To Consent Calendar",15,0,0,0,15
1707493,1311856,2023-04-26,Assembly,"Do pass",6,2,0,0,8
1707493,1372122,2024-01-30,Assembly,"AB 846 Bonta Assembly Third Reading",59,6,0,15,80
1707493,1459943,2024-06-24,Senate,"Do pass as amended, but first amend, and re-refer to the Committee on [Judiciary]",6,2,0,2,10
1707493,1462520,2024-07-02,Senate,"Do pass, but first be re-referred to the Committee on [Appropriations]",8,2,0,1,11
1707493,1463564,2024-08-05,Senate,"Placed on suspense file",7,0,0,0,7
1707493,1464493,2024-08-15,Senate,"Do pass as amended",5,2,0,0,7
1707493,1466131,2024-08-29,Senate,"Assembly 3rd Reading AB846 Bonta By Wahab",26,10,0,4,40
1707493,1466494,2024-08-30,Assembly,"With recommendation: That Senate amendments be concurred in",7,2,0,0,9
1707493,1467004,2024-08-31,Assembly,"AB 846 Bonta Concurrence in Senate Amendments",57,10,0,12,79
1707494,1304295,2023-04-18,Assembly,"Do pass as amended and be re-referred to the Committee on [Appropriations]",15,0,0,0,15
1707494,1328136,2023-05-18,Assembly,"Do pass",15,0,0,1,16
1707494,1335493,2023-05-30,Assembly,"AB 847 Luz Rivas Assembly Third Reading",80,0,0,0,80
1707494,1349783,2023-07-05,Senate,"Do pass as amended, but first amend, and re-refer to the Committee on [Appropriations] with the recommendation: To Consent Calendar",12,0,0,0,12
1707494,1351691,2023-08-17,Senate,"Consent Calendar 2nd AB847 Luz Rivas",38,0,0,2,40
1707494,1354426,2023-09-13,Senate,"Assembly 3rd Reading AB847 Luz Rivas By Portantino",39,0,0,1,40
1707494,1354556,2023-09-14,Assembly,"AB 847 Luz Rivas Concurrence in Senate Amendments",80,0,0,0,80
1707496,1285700,2023-03-27,Assembly,"Do pass as amended and be re-referred to the Committee on [Appropriations]",8,3,0,0,11
1707496,1328766,2023-05-18,Assembly,"Do pass",11,4,0,1,16
1707496,1335509,2023-05-30,Assembly,"AB 849 Garcia Assembly Third Reading",60,18,0,2,80
1707496,1349590,2023-07-05,Senate,"Do pass, but first be re-referred to the Committee on [Appropriations]",5,2,0,0,7
1707496,1351299,2023-08-14,Senate,"Placed on suspense file",7,0,0,0,7
1707499,1286970,2023-03-28,Assembly,"Do pass",6,0,0,2,8
1707499,1324997,2023-05-15,Assembly,"AB 852 Jones-Sawyer Assembly Third Reading",58,13,0,9,80
1707499,1458324,2024-06-18,Senate,"Do pass as amended",5,0,0,0,5
1707499,1465742,2024-08-26,Senate,"Assembly 3rd Reading AB852 Jones-Sawyer et al. By Seyarto Urgency Clause",40,0,0,0,40
1707499,1466556,2024-08-30,Assembly,"With recommendation: That Senate amendments be concurred in",8,0,0,0,8
1707499,1466557,2024-08-30,Assembly,"AB 852 Jones-Sawyer Concurrence - Urgency Added",69,0,0,10,79
1707500,1286932,2023-03-28,Assembly,"Do pass as amended and be re-referred to the Committee on [Appropriations]",7,2,0,2,11
1707500,1328875,2023-05-18,Assembly,"Do pass",11,4,0,1,16
1707500,1335582,2023-05-30,Assembly,"AB 853 Maienschein Assembly Third Reading",62,16,0,2,80
1707500,1350388,2023-07-11,Senate,"Do pass as amended, but first amend, and re-refer to the Committee on [Appropriations]",10,1,0,0,11
1707500,1351342,2023-08-14,Senate,"Placed on suspense file",7,0,0,0,7
1707500,1352877,2023-09-01,Senate,"Do pass",5,2,0,0,7
1707500,1353258,2023-09-06,Senate,"Assembly 3rd Reading AB853 Maienschein By Becker",32,8,0,0,40
1707500,1353259,2023-09-06,Senate,"Assembly 3rd Reading AB853 Maienschein By Becker Motion To Reconsider",40,0,0,0,40
1707500,1353260,2023-09-06,Senate,"Assembly 3rd Reading AB853 Maienschein By Becker",33,7,0,0,40
1707500,1353469,2023-09-07,Assembly,"AB 853 Maienschein Concurrence in Senate Amendments",60,14,0,6,80
1707501,1352343,2023-08-28,Assembly,"AB 854 Ramos Third Reading Urgency",74,0,0,6,80
1707501,1353313,2023-09-06,Senate,"Assembly 3rd Reading AB854 Ramos et al. By Dodd Urgency Clause",38,0,0,2,40
1707502,1281901,2023-03-21,Assembly,"Do pass and be re-referred to the Committee on [Revenue and Taxation]",6,2,0,0,8
1707504,1304336,2023-04-18,Assembly,"Do pass and be re-referred to the Committee on [Appropriations]",7,0,0,1,8
1707504,1326917,2023-05-17,Assembly,"Do pass. To Consent Calendar",15,0,0,1,16
1707504,1333725,2023-05-25,Assembly,"AB 857 Ortega Consent Calendar Second Day Regular Session",76,0,0,4,80
1707504,1345618,2023-06-20,Senate,"Do pass as amended, but first amend, and re-refer to the Committee on [Human Services] with the recommendation: To Consent Calendar",5,0,0,0,5
1707504,1349620,2023-07-03,Senate,"Do pass, but first be re-referred to the Committee on [Appropriations] with the recommendation: To Consent Calendar",5,0,0,0,5
1707504,1351706,2023-08-17,Senate,"Consent Calendar 2nd AB857 Ortega",38,0,0,2,40
1707504,1352201,2023-08-24,Assembly,"AB 857 Ortega Concurrence in Senate Amendments",76,0,0,4,80
1707506,1305285,2023-04-18,Assembly,"Do pass and be re-referred to the Committee on [Appropriations]",12,0,0,3,15
1707506,1322877,2023-05-10,Assembly,"Do pass. To Consent Calendar",14,0,0,2,16
1707506,1328236,2023-05-18,Assembly,"AB 859 Gallagher Consent Calendar Second Day Regular Session",74,0,0,6,80
1707506,1349450,2023-07-03,Senate,"Do pass as amended, but first amend, and re-refer to the Committee on [Appropriations] with the recommendation: To Consent Calendar",9,0,0,2,11
1707506,1354170,2023-09-13,Senate,"Assembly 3rd Reading AB859 Gallagher et al. By Cortese",39,0,0,1,40
1707506,1354171,2023-09-13,Assembly,"AB 859 Gallagher Concurrence in Senate Amendments",76,0,0,4,80
1707507,1288285,2023-03-29,Assembly,"Do pass and be re-referred to the Committee on [Appropriations]",7,0,0,0,7
1707507,1328434,2023-05-18,Assembly,"Do pass as amended",11,0,0,5,16
1707507,1335574,2023-05-30,Assembly,"AB 860 Valencia Assembly Third Reading",79,0,0,1,80
1707507,1347921,2023-06-27,Senate,"Do pass, but first be re-referred to the Committee on [Appropriations] with the recommendation: To Consent Calendar",15,0,0,0,15
1707507,1351277,2023-08-14,Senate,"Placed on suspense file",7,0,0,0,7
1707508,1305468,2023-04-18,Assembly,"Do pass and be re-referred to the Committee on [Appropriations] with recommendation: To Consent Calendar",9,0,0,0,9
1707508,1328793,2023-05-18,Assembly,"Do pass as amended",11,0,0,5,16
1707508,1337189,2023-06-01,Assembly,"AB 861 Santiago Assembly Third Reading",79,0,0,1,80
1707509,1281811,2023-03-21,Assembly,"Do pass and be re-referred to the Committee on [Appropriations]",8,0,0,0,8
1707509,1328545,2023-05-18,Assembly,"Do pass",11,0,0,5,16
1707509,1335532,2023-05-30,Assembly,"AB 862 Bauer-Kahan Assembly Third Reading",67,0,0,13,80
1707509,1350309,2023-07-11,Senate,"Do pass, but first be re-referred to the Committee on [Appropriations]",3,1,0,1,5
1707509,1351521,2023-08-14,Senate,"Placed on suspense file",7,0,0,0,7
1707510,1285696,2023-03-27,Assembly,"Do pass as amended and be re-referred to the Committee on [Appropriations]",8,0,0,3,11
1707510,1328548,2023-05-18,Assembly,"Do pass",11,3,0,2,16
1707510,1335521,2023-05-30,Assembly,"AB 863 Aguiar-Curry Assembly Third Reading",63,8,0,9,80
1707510,1349585,2023-07-05,Senate,"Do pass as amended, but first amend, and re-refer to the Committee on [Appropriations]",5,1,0,1,7
1707510,1458453,2024-06-19,Senate,"Do pass as amended, but first amend, and re-refer to the Committee on [Judiciary]",5,2,0,0,7
1707510,1462498,2024-07-02,Senate,"Do pass, but first be re-referred to the Committee on [Appropriations]",9,2,0,0,11
1707510,1463909,2024-08-12,Senate,"Placed on suspense file",7,0,0,0,7
1707510,1464510,2024-08-15,Senate,"Do pass as amended",5,0,0,2,7
1707510,1467152,2024-08-31,Senate,"Assembly 3rd Reading AB863 Aguiar-Curry et al. By Laird",24,9,0,7,40
1707510,1467153,2024-08-31,Assembly,"AB 863 Aguiar-Curry Concurrence in Senate Amendments",55,9,0,15,79
1707512,1305355,2023-04-19,Assembly,"Do pass and be re-referred to the Committee on [Appropriations]",8,0,0,3,11
1707513,1286926,2023-03-28,Assembly,"Do pass and be re-referred to the Committee on [Appropriations]",7,0,0,1,8
1707513,1328708,2023-05-18,Assembly,"Do pass as amended",11,0,0,5,16
1707513,1335590,2023-05-30,Assembly,"AB 866 Blanca Rubio Assembly Third Reading",80,0,0,0,80
1707513,1345573,2023-06-19,Senate,"Do pass, but first be re-referred to the Committee on [Appropriations] with the recommendation: To Consent Calendar",5,0,0,0,5
1707513,1349457,2023-07-03,Senate,"Placed on suspense file",7,0,0,0,7
1707513,1453381,2024-06-03,Senate,"Do pass, but first be re-referred to the Committee on [Judiciary]",3,1,0,1,5
1707513,1458323,2024-06-18,Senate,"Do pass",10,0,0,1,11
1707513,1465398,2024-08-21,Senate,"Assembly 3rd Reading AB866 Blanca Rubio By Ashby",26,6,0,8,40
1707513,1466490,2024-08-30,Assembly,"With recommendation: That Senate amendments be concurred in",5,1,0,1,7
1707513,1466938,2024-08-31,Assembly,"AB 866 Blanca Rubio Concurrence in Senate Amendments",71,0,0,8,79
1707514,1286912,2023-03-28,Assembly,"Do pass and be re-referred to the Committee on [Judiciary]",8,0,0,0,8
1707514,1298226,2023-04-11,Assembly,"Do pass and be re-referred to the Committee on [Appropriations] with recommendation: To Consent Calendar",11,0,0,0,11
1707514,1328744,2023-05-18,Assembly,"Do pass",15,0,0,1,16
1707514,1335421,2023-05-30,Assembly,"AB 867 Friedman Assembly Third Reading",80,0,0,0,80
1707514,1345645,2023-06-19,Senate,"Do pass, but first be re-referred to the Committee on [Judiciary]",5,0,0,0,5
1707514,1348293,2023-06-27,Senate,"Do pass, but first be re-referred to the Committee on [Appropriations] with the recommendation: To Consent Calendar",11,0,0,0,11
1707514,1349953,2023-07-10,Senate,"Placed on suspense file",6,0,0,1,7
1707514,1352664,2023-09-01,Senate,"Do pass as amended",7,0,0,0,7
1707514,1354283,2023-09-13,Senate,"Special Consent AB867 Friedman By Wahab",39,0,0,1,40
1707514,1354615,2023-09-14,Assembly,"AB 867 Friedman Concurrence in Senate Amendments",80,0,0,0,80
1707515,1288230,2023-03-29,Assembly,"Do pass as amended and be re-referred to the Committee on [Appropriations]",6,2,0,0,8
1707515,1328271,2023-05-18,Assembly,"Do pass",11,4,0,1,16
1707515,1337937,2023-05-31,Assembly,"AB 868 Wilson Assembly Third Reading",58,17,0,5,80
1707515,1349752,2023-07-05,Senate,"Do pass, but first be re-referred to the Committee on [Judiciary]",6,1,0,0,7
1707515,1350414,2023-07-11,Senate,"Do pass, but first be re-referred to the Committee on [Appropriations]",10,1,0,0,11
1707515,1351793,2023-08-21,Senate,"Placed on suspense file",7,0,0,0,7
1707516,1280640,2023-03-21,Assembly,"Do pass and be re-referred to the Committee on [Appropriations]",14,0,0,1,15
1707516,1328176,2023-05-18,Assembly,"Do pass",15,0,0,1,16
1707516,1335568,2023-05-30,Assembly,"AB 869 Wood Assembly Third Reading",80,0,0,0,80
1707516,1460684,2024-06-26,Senate,"Do pass as amended, but first amend, and re-refer to the Committee on [Appropriations] with the recommendation: To Consent Calendar",11,0,0,0,11
1707516,1463472,2024-08-05,Senate,"Placed on suspense file",7,0,0,0,7
1707516,1464421,2024-08-15,Senate,"Do pass as amended",6,0,0,1,7
1707516,1466145,2024-08-29,Assembly,"AB 869 Wood Concurrence in Senate Amendments",76,0,0,3,79
1707516,1466728,2024-08-28,Senate,"Assembly 3rd Reading AB869 Wood et al. By Roth",38,0,0,2,40
1707517,1304411,2023-04-18,Assembly,"Do pass and be re-referred to the Committee on [Appropriations]",7,0,0,1,8
1707518,1299351,2023-04-12,Assembly,"Do pass and be re-referred to the Committee on [Appropriations]",7,0,0,0,7
1707518,1328381,2023-05-18,Assembly,"Do pass as amended",12,2,0,2,16
1707518,1335398,2023-05-30,Assembly,"AB 871 Haney Assembly Third Reading",67,8,0,5,80
1707518,1348300,2023-06-28,Senate,"Do pass as amended, but first amend, and re-refer to the Committee on [Appropriations]",4,1,0,0,5
1707518,1351531,2023-08-14,Senate,"Placed on suspense file",7,0,0,0,7
1707518,1352689,2023-09-01,Senate,"Do pass as amended",5,2,0,0,7
1707518,1465847,2024-08-27,Senate,"Assembly 3rd Reading AB871 Haney By Cortese",25,10,0,5,40
1707518,1466750,2024-08-28,Assembly,"AB 871 Haney Concurrence in Senate Amendments",66,7,0,6,79
1707519,1289814,2023-03-29,Assembly,"Do pass and be re-referred to the Committee on [Appropriations] with recommendation: To Consent Calendar",6,0,0,1,7
1707519,1305388,2023-04-19,Assembly,"Do pass. To Consent Calendar",14,0,0,2,16
1707519,1313416,2023-04-27,Assembly,"AB 872 Education Consent Calendar Second Day Regular Session",79,0,0,1,80
1707519,1340965,2023-06-07,Senate,"Do pass, but first be re-referred to the Committee on [Human Services] with the recommendation: To Consent Calendar",7,0,0,0,7
1707519,1349603,2023-07-03,Senate,"Do pass, but first be re-referred to the Committee on [Appropriations] with the recommendation: To Consent Calendar",5,0,0,0,5
1707519,1352209,2023-08-24,Senate,"Consent Calendar 2nd AB872 ED. (Muratsuchi)",40,0,0,0,40
1707519,1353800,2023-09-12,Senate,"Assembly 3rd Reading AB872 ED. (Muratsuchi) By Newman",38,0,0,2,40
1707519,1354097,2023-09-13,Assembly,"AB 872 Education Concurrence in Senate Amendments By MURATSUCHI",80,0,0,0,80
1707520,1301064,2023-04-12,Assembly,"Do pass as amended, and be re-referred to the Committee on [Appropriations] with recommendation: To Consent Calendar",7,0,0,0,7
1707520,1318008,2023-05-03,Assembly,"Do pass. To Consent Calendar",16,0,0,0,16
1707520,1323893,2023-05-11,Assembly,"AB 873 Berman Consent Calendar Second Day Regular Session",66,0,0,14,80
1707520,1346306,2023-06-21,Senate,"Do pass, but first be re-referred to the Committee on [Appropriations]",7,0,0,0,7
1707520,1353445,2023-09-07,Senate,"Assembly 3rd Reading AB873 Berman By Lim√≥n",35,2,0,3,40
1707522,1280699,2023-03-21,Assembly,"Do pass and be re-referred to the Committee on [Appropriations] with recommendation: To Consent Calendar",11,0,0,0,11
1707522,1328094,2023-05-18,Assembly,"Do pass",15,0,0,1,16
1707522,1335605,2023-05-30,Assembly,"AB 875 Gabriel Assembly Third Reading",77,0,0,3,80
1707522,1348424,2023-06-27,Senate,"Do pass, but first be re-referred to the Committee on [Appropriations]",11,0,0,0,11
1707522,1351370,2023-08-14,Senate,"Placed on suspense file",7,0,0,0,7
1707522,1352693,2023-09-01,Senate,"Do pass as amended",7,0,0,0,7
1707522,1354040,2023-09-12,Assembly,"AB 875 Gabriel Concurrence in Senate Amendments",77,0,0,3,80
1707522,1354522,2023-09-11,Senate,"Assembly 3rd Reading AB875 Gabriel By Durazo",39,0,0,1,40
1707523,1298295,2023-04-11,Assembly,"Do pass and be re-referred to the Committee on [Appropriations] with recommendation: To Consent Calendar",11,0,0,0,11
1707523,1322893,2023-05-10,Assembly,"Do pass. To Consent Calendar",14,0,0,2,16
1707523,1328612,2023-05-18,Assembly,"AB 876 Robert Rivas Consent Calendar Second Day Regular Session",74,0,0,6,80
1707523,1348361,2023-06-27,Senate,"Do pass as amended, but first amend, and re-refer to the Committee on [Human Services] with the recommendation: To Consent Calendar",11,0,0,0,11
1707523,1349635,2023-07-03,Senate,"Do pass, but first be re-referred to the Committee on [Appropriations] with the recommendation: To Consent Calendar",5,0,0,0,5
1707523,1353291,2023-09-06,Senate,"Do pass, but first be re-referred to the Committee on [Appropriations]",11,0,0,0,11
1707523,1354028,2023-09-12,Senate,"Do pass",7,0,0,0,7
1707523,1354029,2023-09-12,Senate,"Assembly 3rd Reading AB876 Robert Rivas et al. By Laird Urgency Clause",39,0,0,1,40
1707523,1354487,2023-09-14,Assembly,"With recommendation: That Senate amendments be concurred in",11,0,0,0,11
1707523,1354595,2023-09-14,Assembly,"AB 876 Robert Rivas Concurrence - Urgency Added",80,0,0,0,80
1707524,1317047,2023-05-01,Assembly,"Do pass and be re-referred to the Committee on [Appropriations]",11,0,0,0,11
1707525,1286971,2023-03-28,Assembly,"Do pass. To Consent Calendar",18,0,0,1,19
1707525,1296900,2023-04-10,Assembly,"AB 878 Pellerin Consent Calendar Second Day Regular Session",65,0,0,15,80
1707525,1338794,2023-06-05,Senate,"Do pass and be ordered to the Consent Calendar",13,0,0,0,13
1707525,1341927,2023-06-08,Senate,"Consent Calendar AB878 Pellerin",39,0,0,1,40
1707526,1310405,2023-04-25,Assembly,"Do pass and be re-referred to the Committee on [Appropriations] with recommendation: To Consent Calendar",7,0,0,0,7
1707528,1281799,2023-03-21,Assembly,"Do pass and be re-referred to the Committee on [Appropriations]",7,1,0,0,8
1707528,1328829,2023-05-18,Assembly,"Do pass as amended",11,3,0,2,16
1707528,1335551,2023-05-30,Assembly,"AB 881 Ting Assembly Third Reading",67,7,0,6,80
1707528,1345616,2023-06-20,Senate,"Do pass, but first be re-referred to the Committee on [Appropriations]",5,0,0,0,5
1707528,1349497,2023-07-03,Senate,"Placed on suspense file",7,0,0,0,7
1707528,1352932,2023-09-01,Senate,"Do pass as amended",6,0,0,1,7
1707528,1353272,2023-09-06,Senate,"Assembly 3rd Reading AB881 Ting By Wahab",40,0,0,0,40
1707528,1353489,2023-09-07,Assembly,"AB 881 Ting Concurrence in Senate Amendments",73,3,0,4,80
1707529,1285618,2023-03-27,Assembly,"Do pass as amended and be re-referred to the Committee on [Appropriations]",11,0,0,0,11
1707529,1328717,2023-05-18,Assembly,"Do pass",15,0,0,1,16
1707529,1337899,2023-05-31,Assembly,"AB 882 Davies Assembly Third Reading",80,0,0,0,80
1707529,1349941,2023-07-10,Senate,"Do pass, but first be re-referred to the Committee on [Appropriations] with the recommendation: To Consent Calendar",10,0,0,1,11
1707529,1351288,2023-08-14,Senate,"Placed on suspense file",7,0,0,0,7
1707529,1352535,2023-09-01,Senate,"Do pass",7,0,0,0,7
1707529,1354016,2023-09-12,Senate,"Special Consent AB882 Davies By Newman",39,0,0,1,40
1707530,1286919,2023-03-28,Assembly,"Do pass and be re-referred to the Committee on [Appropriations] with recommendation: To Consent Calendar",18,0,0,1,19
1707530,1328673,2023-05-18,Assembly,"Do pass as amended",15,0,0,1,16
1707530,1335447,2023-05-30,Assembly,"AB 883 Mathis Assembly Third Reading",80,0,0,0,80
1707530,1343129,2023-06-12,Senate,"Do pass, but first be re-referred to the Committee on [Military and Veterans Affairs]",12,0,0,1,13
1707530,1350250,2023-07-10,Senate,"Do pass, but first be re-referred to the Committee on [Appropriations] with the recommendation: To Consent Calendar",5,0,0,0,5
1707530,1351380,2023-08-14,Senate,"Placed on suspense file",7,0,0,0,7
1707530,1352915,2023-09-01,Senate,"Do pass",7,0,0,0,7
1707530,1353895,2023-09-12,Senate,"Special Consent AB883 Mathis et al",39,0,0,1,40
1707531,1288231,2023-03-29,Assembly,"Do pass and be re-referred to the Committee on [Appropriations]",7,0,0,1,8
1707531,1366813,2024-01-18,Assembly,"Do pass as amended",12,0,0,4,16
1707531,1371084,2024-01-29,Assembly,"AB 884 Low Assembly Third Reading",65,0,0,15,80
1707531,1462311,2024-07-02,Senate,"Do pass, but first be re-referred to the Committee on [Appropriations]",7,0,0,0,7
1707531,1463594,2024-08-05,Senate,"Placed on suspense file",7,0,0,0,7
1707531,1464614,2024-08-15,Senate,"Do pass as amended",7,0,0,0,7
1707531,1466125,2024-08-29,Assembly,"AB 884 Low Concurrence in Senate Amendments",72,0,0,7,79
1707531,1466671,2024-08-28,Senate,"Assembly 3rd Reading AB884 Low et al. By Wahab",38,1,0,1,40
1707533,1311930,2023-04-25,Assembly,"Do pass and be re-referred to the Committee on [Judiciary]",9,0,0,2,11
1707533,1317104,2023-05-02,Assembly,"Do pass",10,0,0,1,11
1707533,1337222,2023-06-01,Assembly,"AB 886 Wicks Assembly Third Reading",55,6,0,19,80
1707533,1460561,2024-06-25,Senate,"Do pass as amended, but first amend, and re-refer to the Committee on [Appropriations]",9,2,0,0,11
1707533,1463676,2024-08-05,Senate,"Placed on suspense file",7,0,0,0,7
1707533,1464603,2024-08-15,Senate,"Do pass",4,2,0,1,7
1707533,1464604,2024-08-15,Senate,"[08-15-2024] set for [First] hearing: Reconsideration of favorable vote granted",6,0,0,1,7
1707533,1464605,2024-08-15,Senate,"Do pass, but first be re-referred to the Committee on [Rules]",4,2,0,1,7
1707535,1311828,2023-04-25,Assembly,"Do pass and be re-referred to the Committee on [Appropriations]",11,0,0,1,12
1707535,1328263,2023-05-18,Assembly,"Do pass",14,0,0,2,16
1707535,1335428,2023-05-30,Assembly,"AB 888 Cervantes Assembly Third Reading",77,0,0,3,80
1707535,1348302,2023-06-28,Senate,"Do pass, but first be re-referred to the Committee on [Appropriations]",7,0,0,0,7
1707535,1349926,2023-07-10,Senate,"Placed on suspense file",6,0,0,1,7
1707536,1300990,2023-04-12,Assembly,"Do pass and be re-referred to the Committee on [Appropriations] with recommendation: To Consent Calendar",7,0,0,0,7
1707536,1328747,2023-05-18,Assembly,"Do pass",15,0,0,1,16
1707536,1333714,2023-05-25,Assembly,"AB 889 Joe Patterson Assembly Third Reading",78,0,0,2,80
1707536,1346301,2023-06-21,Senate,"Do pass, but first be re-referred to the Committee on [Appropriations] with the recommendation: To Consent Calendar",7,0,0,0,7
1707536,1350669,2023-07-13,Senate,"Consent Calendar AB889 Joe Patterson et al",37,0,0,3,40
1707537,1281913,2023-03-21,Assembly,"Do pass and be re-referred to the Committee on [Appropriations]",8,0,0,0,8
1707537,1328107,2023-05-18,Assembly,"Do pass",15,0,0,1,16
1707537,1333632,2023-05-25,Assembly,"AB 890 Joe Patterson Assembly Third Reading",78,0,0,2,80
1707537,1347864,2023-06-27,Senate,"Do pass as amended, but first amend, and re-refer to the Committee on [Appropriations]",5,0,0,0,5
1707537,1351526,2023-08-14,Senate,"Placed on suspense file",7,0,0,0,7
1707537,1352808,2023-09-01,Senate,"Do pass as amended",7,0,0,0,7
1707537,1354013,2023-09-12,Senate,"Assembly 3rd Reading AB890 Joe Patterson et al. By Alvarado-Gil",38,0,0,2,40
1707537,1354188,2023-09-13,Assembly,"AB 890 Joe Patterson Concurrence in Senate Amendments",80,0,0,0,80
1707538,1301983,2023-04-10,Assembly,"Do pass as amended and be re-referred to the Committee on [Appropriations]",8,3,0,0,11
1707539,1281855,2023-03-22,Assembly,"Do pass and be re-referred to the Committee on [Local Government]",6,1,0,0,7
1707539,1307869,2023-04-19,Assembly,"Do pass and be re-referred to the Committee on [Appropriations]",6,0,0,1,7
1707539,1328421,2023-05-18,Assembly,"Do pass",12,1,0,3,16
1707539,1335555,2023-05-30,Assembly,"AB 892 Bains Assembly Third Reading",65,4,0,11,80
1707539,1348399,2023-06-28,Senate,"Do pass, but first be re-referred to the Committee on [Labor, Public Employment and Retirement ]",6,0,0,2,8
1707539,1350387,2023-07-12,Senate,"Do pass, but first be re-referred to the Committee on [Appropriations]",5,0,0,0,5
1707539,1351366,2023-08-14,Senate,"Placed on suspense file",7,0,0,0,7
1707539,1352916,2023-09-01,Senate,"Do pass",5,2,0,0,7
1707539,1465938,2024-08-27,Senate,"That the measure be returned to Senate Floor for consideration. Ordered to third reading",4,1,0,2,7
1707539,1466458,2024-08-30,Assembly,"With recommendation: That Senate amendments be concurred in",8,0,0,1,9
1707539,1467178,2024-08-28,Senate,"Assembly 3rd Reading AB892 Bains By Cortese",31,8,0,1,40
1707539,1467179,2024-08-31,Assembly,"AB 892 Bains Concurrence in Senate Amendments",62,0,0,17,79
1707540,1298218,2023-04-11,Assembly,"Do pass as amended and be re-referred to the Committee on [Appropriations]",9,0,0,2,11
1707540,1326929,2023-05-17,Assembly,"Do pass",14,0,0,2,16
1707540,1335494,2023-05-30,Assembly,"AB 893 Papan Assembly Third Reading",60,0,0,20,80
1707540,1348291,2023-06-27,Senate,"Do pass, but first be re-referred to the Committee on [Business, Professions and Economic Development]",11,0,0,0,11
1707540,1349482,2023-07-03,Senate,"Do pass as amended, but first amend, and re-refer to the Committee on [Appropriations]",12,0,0,1,13
1707540,1353250,2023-09-06,Senate,"Assembly 3rd Reading AB893 Papan By Umberg",35,0,0,5,40
1707540,1353567,2023-09-08,Assembly,"AB 893 Papan Concurrence in Senate Amendments",62,0,0,18,80
1707541,1307862,2023-04-19,Assembly,"Do pass and be re-referred to the Committee on [Housing and Community Development]",5,2,0,0,7
1707541,1311709,2023-04-26,Assembly,"Do pass and be re-referred to the Committee on [Appropriations]",6,0,0,2,8
1707541,1326941,2023-05-17,Assembly,"Do pass",12,3,0,1,16
1707541,1330084,2023-05-22,Assembly,"AB 894 Friedman Assembly Third Reading",62,10,0,8,80
1707541,1346133,2023-06-21,Senate,"Do pass as amended, but first amend, and re-refer to the Committee on [Housing]",7,0,0,1,8
1707541,1350311,2023-07-10,Senate,"Do pass, but first be re-referred to the Committee on [Appropriations]",9,2,0,0,11
1707541,1352352,2023-08-28,Senate,"Placed on suspense file",7,0,0,0,7
1707541,1352779,2023-09-01,Senate,"Do pass as amended",5,2,0,0,7
1707541,1353851,2023-09-12,Senate,"Assembly 3rd Reading AB894 Friedman et al. By Blakespear",31,7,0,2,40
1707541,1354177,2023-09-13,Assembly,"AB 894 Friedman Concurrence in Senate Amendments",64,11,0,5,80
1707543,1305457,2023-04-18,Assembly,"Do pass and be re-referred to the Committee on [Appropriations]",14,0,0,1,15
1707544,1283158,2023-03-22,Assembly,"Do pass and be re-referred to the Committee on [Appropriations]",5,0,0,2,7
1707544,1328665,2023-05-18,Assembly,"Do pass as amended",11,2,0,3,16
1707544,1335479,2023-05-30,Assembly,"AB 897 McCarty Assembly Third Reading",63,8,0,9,80
1707544,1346270,2023-06-21,Senate,"Do pass, but first be re-referred to the Committee on [Appropriations]",4,0,0,3,7
1707544,1349460,2023-07-03,Senate,"Placed on suspense file",7,0,0,0,7
1707544,1353051,2023-09-01,Senate,"Do pass",5,2,0,0,7
1707544,1354718,2023-09-11,Senate,"Assembly 3rd Reading AB897 McCarty et al. By Cortese",29,10,0,1,40
1707545,1281877,2023-03-21,Assembly,"Do pass and be re-referred to the Committee on [Appropriations]",7,0,0,1,8
1707545,1328279,2023-05-18,Assembly,"Do pass",15,0,0,1,16
1707545,1337909,2023-05-31,Assembly,"AB 898 Lackey Assembly Third Reading",78,0,0,2,80
1707545,1350269,2023-07-11,Senate,"Do pass, but first be re-referred to the Committee on [Appropriations]",3,0,0,2,5
1707545,1351329,2023-08-14,Senate,"Placed on suspense file",7,0,0,0,7
1707546,1288190,2023-03-28,Assembly,"Do pass and be re-referred to the Committee on [Environmental Safety and Toxic Materials]",11,1,0,3,15
1707546,1305383,2023-04-18,Assembly,"Do pass and be re-referred to the Committee on [Appropriations]",8,0,0,1,9
1707546,1328567,2023-05-18,Assembly,"Do pass",14,0,0,2,16
1707546,1338040,2023-05-31,Assembly,"AB 899 Muratsuchi Assembly Third Reading",53,0,0,27,80
1707546,1348871,2023-06-28,Senate,"Do pass as amended, but first amend, and re-refer to the Committee on [Environmental Quality]",7,0,0,5,12
1707546,1350402,2023-07-12,Senate,"Do pass as amended, but first amend, and re-refer to the Committee on [Appropriations]",4,1,0,2,7
1707546,1351285,2023-08-14,Senate,"Placed on suspense file",7,0,0,0,7
1707546,1353071,2023-09-01,Senate,"Do pass",5,1,0,1,7
1707546,1353989,2023-09-12,Senate,"Assembly 3rd Reading AB899 Muratsuchi et al. By Skinner",34,2,0,4,40
1707546,1354342,2023-09-13,Assembly,"AB 899 Muratsuchi Concurrence in Senate Amendments",77,0,0,3,80
1707547,1305250,2023-04-18,Assembly,"Do pass and be re-referred to the Committee on [Appropriations]",14,0,0,1,15
1707548,1307858,2023-04-19,Assembly,"Do pass and be re-referred to the Committee on [Housing and Community Development]",5,1,0,1,7
1707548,1311916,2023-04-26,Assembly,"Do pass as amended and be re-referred to the Committee on [Appropriations]",6,2,0,0,8
1707549,1310180,2023-04-24,Assembly,"Do pass and be re-referred to the Committee on [Appropriations] with recommendation: To Consent Calendar",15,0,0,0,15
1707549,1322910,2023-05-10,Assembly,"Do pass. To Consent Calendar",14,0,0,2,16
1707549,1328817,2023-05-18,Assembly,"AB 902 Rodriguez Consent Calendar Second Day Regular Session",74,0,0,6,80
1707549,1348354,2023-06-27,Senate,"Do pass, but first be re-referred to the Committee on [Appropriations] with the recommendation: To Consent Calendar",16,0,0,0,16
1707549,1350653,2023-07-13,Senate,"Consent Calendar AB902 Rodriguez",37,0,0,3,40
1707551,1298308,2023-04-11,Assembly,"Do pass and be re-referred to the Committee on [Appropriations]",12,0,0,3,15
1707551,1328705,2023-05-18,Assembly,"Do pass",11,1,0,4,16
1707551,1335395,2023-05-30,Assembly,"AB 904 Calderon Assembly Third Reading",67,2,0,11,80
1707551,1346142,2023-06-21,Senate,"Do pass as amended, but first amend, and re-refer to the Committee on [Appropriations]",11,0,0,1,12
1707551,1349532,2023-07-03,Senate,"Placed on suspense file",7,0,0,0,7
1707551,1352778,2023-09-01,Senate,"Do pass",5,2,0,0,7
1707551,1354041,2023-09-12,Senate,"Assembly 3rd Reading AB904 Calderon et al. By Rubio",34,2,0,4,40
1707551,1354290,2023-09-13,Assembly,"AB 904 Calderon Concurrence in Senate Amendments",69,0,0,11,80
1707554,1310159,2023-04-25,Assembly,"Do pass and be re-referred to the Committee on [Appropriations]",11,0,0,4,15
1707554,1328098,2023-05-18,Assembly,"Do pass",12,1,0,3,16
1707554,1338170,2023-05-31,Assembly,"AB 907 Lowenthal Assembly Third Reading",69,0,0,11,80
1707554,1348836,2023-06-28,Senate,"Do pass as amended, but first amend, and re-refer to the Committee on [Appropriations]",11,0,0,1,12
1707554,1349929,2023-07-10,Senate,"Placed on suspense file",6,0,0,1,7
1707554,1352859,2023-09-01,Senate,"Do pass",5,0,0,2,7
1707554,1353839,2023-09-12,Senate,"Assembly 3rd Reading AB907 Lowenthal By Gonzalez",33,0,0,7,40
1707554,1354355,2023-09-13,Assembly,"AB 907 Lowenthal Concurrence in Senate Amendments",69,0,0,11,80
1707555,1313455,2023-04-26,Assembly,"Do pass as amended, and be re-referred to the Committee on [Appropriations] with recommendation: To Consent Calendar",7,0,0,0,7
1707555,1328903,2023-05-18,Assembly,"Do pass",15,0,0,1,16
1707555,1335564,2023-05-30,Assembly,"AB 908 MURATSUCHI Third Reading Urgency By O'DONNELL",80,0,0,0,80
1707555,1350405,2023-07-12,Senate,"Do pass, but first be re-referred to the Committee on [Appropriations] with the recommendation: To Consent Calendar",7,0,0,0,7
1707555,1351784,2023-08-21,Senate,"Placed on suspense file",7,0,0,0,7
1707555,1352974,2023-09-01,Senate,"Do pass",7,0,0,0,7
1707555,1353956,2023-09-12,Senate,"Special Consent AB908 ED. (Muratsuchi) Urgency Clause",39,0,0,1,40
1707555,1354216,2023-09-13,Assembly,"AB 908 Education Concurrence in Senate Amendments By MURATSUCHI",79,0,0,1,80
1707556,1285667,2023-03-27,Assembly,"Do pass as amended and be re-referred to the Committee on [Appropriations]",11,0,0,0,11
1707557,1307859,2023-04-19,Assembly,"Do pass and be re-referred to the Committee on [Appropriations]",7,0,0,0,7
1707557,1318052,2023-05-03,Assembly,"Do pass. To Consent Calendar",16,0,0,0,16
1707557,1323888,2023-05-11,Assembly,"AB 910 Wilson Consent Calendar Second Day Regular Session",66,0,0,14,80
1707557,1346300,2023-06-21,Senate,"Do pass, but first be re-referred to the Committee on [Elections and Constitutional Amendments]",7,0,0,1,8
1707557,1349759,2023-07-05,Senate,"Do pass, but first be re-referred to the Committee on [Appropriations]",7,0,0,0,7
1707557,1353972,2023-09-12,Assembly,"AB 910 Wilson Concurrence in Senate Amendments",80,0,0,0,80
1707557,1354868,2023-09-11,Senate,"Assembly 3rd Reading AB910 Wilson By Niello",39,0,0,1,40
1707558,1299520,2023-04-12,Assembly,"Do pass as amended and be re-referred to the Committee on [Judiciary]",7,1,0,0,8
1707558,1304280,2023-04-18,Assembly,"Do pass and be re-referred to the Committee on [Appropriations]",8,3,0,0,11
1707558,1326923,2023-05-17,Assembly,"Do pass as amended",12,4,0,0,16
1707558,1337967,2023-05-31,Assembly,"AB 911 Schiavo Assembly Third Reading",64,14,0,2,80
1707558,1348362,2023-06-27,Senate,"Do pass, but first be re-referred to the Committee on [Housing]",10,1,0,0,11
1707558,1350118,2023-07-10,Senate,"Do pass, but first be re-referred to the Committee on [Appropriations]",10,1,0,0,11
1707558,1353735,2023-09-12,Assembly,"AB 911 Schiavo Concurrence in Senate Amendments",64,13,0,3,80
1707558,1354541,2023-09-11,Senate,"Assembly 3rd Reading AB911 Schiavo By Blakespear",33,6,0,1,40
1707559,1281930,2023-03-21,Assembly,"Do pass as amended and be re-referred to the Committee on [Education]",7,0,0,1,8
1707559,1301040,2023-04-12,Assembly,"Do pass as amended and be re-referred to the Committee on [Appropriations]",6,0,0,1,7
1707559,1328473,2023-05-18,Assembly,"Do pass as amended",12,0,0,4,16
1707559,1335553,2023-05-30,Assembly,"AB 912 Jones-Sawyer Assembly Third Reading",77,0,0,3,80
1707559,1345654,2023-06-20,Senate,"Do pass, but first be re-referred to the Committee on [Health]",5,0,0,0,5
1707559,1350712,2023-07-12,Senate,"Do pass, but first be re-referred to the Committee on [Appropriations]",11,0,0,1,12
1707559,1351509,2023-08-14,Senate,"Placed on suspense file",7,0,0,0,7
1707559,1352561,2023-09-01,Senate,"Do pass as amended",7,0,0,0,7
1707559,1353824,2023-09-12,Assembly,"AB 912 Jones-Sawyer Concurrence in Senate Amendments",78,0,0,2,80
1707559,1354799,2023-09-11,Senate,"Assembly 3rd Reading AB912 Jones-Sawyer et al. By Skinner",39,0,0,1,40
1707561,1310132,2023-04-24,Assembly,"Do pass and be re-referred to the Committee on [Utilities and Energy]",10,0,0,1,11
1707561,1313343,2023-04-26,Assembly,"Do pass as amended and be re-referred to the Committee on [Appropriations]",13,0,0,2,15
1707561,1328008,2023-05-18,Assembly,"Do pass",15,0,0,1,16
1707561,1335455,2023-05-30,Assembly,"AB 914 Friedman Assembly Third Reading",79,0,0,1,80
1707561,1349571,2023-07-05,Senate,"Do pass, but first be re-referred to the Committee on [Energy, Utilities and Communications] with the recommendation: To Consent Calendar",7,0,0,0,7
1707561,1350271,2023-07-10,Senate,"Do pass as amended, but first amend, and re-refer to the Committee on [Appropriations]",18,0,0,0,18
1707561,1351777,2023-08-21,Senate,"Placed on suspense file",7,0,0,0,7
1707562,1300999,2023-04-12,Assembly,"Do pass as amended and be re-referred to the Committee on [Health]",7,0,0,0,7
1707562,1310186,2023-04-25,Assembly,"Do pass as amended, and be re-referred to the Committee on [Appropriations] with recommendation: To Consent Calendar",15,0,0,0,15
1707562,1328446,2023-05-18,Assembly,"Do pass",15,0,0,1,16
1707562,1333637,2023-05-25,Assembly,"AB 915 Arambula Assembly Third Reading",78,0,0,2,80
1707562,1348445,2023-06-28,Senate,"Do pass, but first be re-referred to the Committee on [Health]",7,0,0,0,7
1707562,1349751,2023-07-05,Senate,"Do pass as amended, but first amend, and re-refer to the Committee on [Appropriations] with the recommendation: To Consent Calendar",12,0,0,0,12
1707562,1351422,2023-08-14,Senate,"Placed on suspense file",7,0,0,0,7
1707564,1311804,2023-04-26,Assembly,"Do pass and be re-referred to the Committee on [Appropriations]",14,0,0,0,14
1707564,1322914,2023-05-10,Assembly,"Do pass",15,0,0,1,16
1707564,1330121,2023-05-22,Assembly,"AB 917 Ortega Assembly Third Reading",77,0,0,3,80
1707564,1348449,2023-06-28,Senate,"Do pass as amended, but first amend, and re-refer to the Committee on [Appropriations]",7,0,0,0,7
1707564,1353318,2023-09-06,Senate,"Assembly 3rd Reading AB917 Ortega et al. By Rubio",40,0,0,0,40
1707564,1353504,2023-09-07,Assembly,"AB 917 Ortega Concurrence in Senate Amendments",79,0,0,1,80
1707565,1313376,2023-04-26,Assembly,"Do pass as amended and be re-referred to the Committee on [Appropriations]",8,0,0,0,8
1707565,1326920,2023-05-17,Assembly,"Do pass",16,0,0,0,16
1707565,1330139,2023-05-22,Assembly,"AB 918 Garcia Assembly Third Reading",77,0,0,3,80
1707565,1350631,2023-07-12,Senate,"Do pass as amended, but first amend, and re-refer to the Committee on [Appropriations]",8,0,0,0,8
1707565,1351348,2023-08-14,Senate,"Placed on suspense file",7,0,0,0,7
1707565,1352632,2023-09-01,Senate,"Do pass as amended",7,0,0,0,7
1707565,1354773,2023-09-14,Senate,"Assembly 3rd Reading AB918 Garcia et al. By Padilla Urgency Clause",40,0,0,0,40
1707565,1354774,2023-09-14,Assembly,"AB 918 Garcia Concurrence - Urgency Added",78,0,0,2,80
1707567,1286905,2023-03-28,Assembly,"Do pass and be re-referred to the Committee on [Appropriations]",7,2,0,2,11
1707568,1310322,2023-04-25,Assembly,"Do pass and be re-referred to the Committee on [Appropriations]",13,0,0,2,15
1707569,1310192,2023-04-25,Assembly,"Do pass and be re-referred to the Committee on [Appropriations]",5,2,0,1,8
1707569,1366759,2024-01-18,Assembly,"Do pass as amended",12,3,0,1,16
1707569,1372108,2024-01-30,Assembly,"AB 922 Wicks Assembly Third Reading",61,10,0,9,80
1707569,1453408,2024-06-03,Senate,"Do pass, but first be re-referred to the Committee on [Appropriations]",2,1,0,2,5
1707569,1453409,2024-06-03,Senate,"[First] hearing set for [06-04-2024]: Failed passage in Committee. Reconsideration granted",4,0,0,1,5
1707569,1462294,2024-07-01,Senate,"Do pass, but first be re-referred to the Committee on [Appropriations]",3,0,0,2,5
1707569,1463469,2024-08-05,Senate,"Placed on suspense file",7,0,0,0,7
1707569,1464216,2024-08-15,Senate,"Do pass",4,2,0,1,7
1707569,1466634,2024-08-31,Senate,"Assembly 3rd Reading AB922 Wicks By Wahab",30,8,0,2,40
1707570,1308817,2023-04-24,Assembly,"Do pass and be re-referred to the Committee on [Appropriations] with recommendation: To Consent Calendar",15,0,0,0,15
1707570,1328868,2023-05-18,Assembly,"Do pass as amended",11,0,0,5,16
1707570,1338050,2023-05-31,Assembly,"AB 923 Bauer-Kahan Assembly Third Reading",80,0,0,0,80
1707570,1349938,2023-07-10,Senate,"Do pass as amended, but first amend, and re-refer to the Committee on [Appropriations] with the recommendation: To Consent Calendar",10,0,0,1,11
1707570,1351395,2023-08-14,Senate,"Placed on suspense file",7,0,0,0,7
1707571,1304340,2023-04-18,Assembly,"Do pass as amended and be re-referred to the Committee on [Appropriations]",11,0,0,0,11
1707571,1322918,2023-05-10,Assembly,"Do pass. To Consent Calendar",14,0,0,2,16
1707571,1328124,2023-05-18,Assembly,"AB 924 Gabriel Consent Calendar Second Day Regular Session",74,0,0,6,80
1707572,1285612,2023-03-27,Assembly,"Do pass and be re-referred to the Committee on [Appropriations] with recommendation: To Consent Calendar",15,0,0,0,15
1707572,1311659,2023-04-26,Assembly,"Do pass. To Consent Calendar",16,0,0,0,16
1707572,1318966,2023-05-04,Assembly,"AB 925 Ta Consent Calendar Second Day Regular Session",75,0,0,5,80
1707572,1343771,2023-06-13,Senate,"Do pass, but first be re-referred to the Committee on [Appropriations] with the recommendation: To Consent Calendar",5,0,0,0,5
1707572,1348842,2023-06-29,Senate,"Consent Calendar AB925 Ta By Seyarto",39,0,0,1,40
1707573,1299505,2023-04-12,Assembly,"Do pass as amended and be re-referred to the Committee on [Revenue and Taxation]",8,0,0,0,8
1707573,1317040,2023-05-01,Assembly,"Do pass as amended and be re-referred to the Committee on [Appropriations]",11,0,0,0,11
1707575,1286884,2023-03-28,Assembly,"Do pass and be re-referred to the Committee on [Appropriations] with recommendation: To Consent Calendar",8,0,0,0,8
1707575,1305238,2023-04-19,Assembly,"Do pass. To Consent Calendar",14,0,0,2,16
1707575,1313420,2023-04-27,Assembly,"AB 928 Reyes Consent Calendar Second Day Regular Session",79,0,0,1,80
1707575,1349610,2023-07-03,Senate,"Do pass, but first be re-referred to the Committee on [Appropriations] with the recommendation: To Consent Calendar",5,0,0,0,5
1707575,1351652,2023-08-17,Senate,"Consent Calendar 2nd AB928 Rendon et al",38,0,0,2,40
1707575,1352246,2023-08-24,Assembly,"AB 928 Rendon Concurrence in Senate Amendments",76,0,0,4,80
1707577,1307878,2023-04-19,Assembly,"Do pass and be re-referred to the Committee on [Jobs, Economic Development, and the Economy]",5,2,0,0,7
1707577,1310368,2023-04-25,Assembly,"Do pass as amended and be re-referred to the Committee on [Appropriations]",4,0,0,3,7
1707577,1366774,2024-01-18,Assembly,"Do pass as amended",12,3,0,1,16
1707577,1371131,2024-01-29,Assembly,"AB 930 Friedman Assembly Third Reading",52,16,0,12,80
1707577,1456301,2024-06-11,Senate,"Do pass as amended, but first amend, and re-refer to the Committee on [Housing]",5,2,0,0,7
1707577,1462633,2024-07-02,Senate,"Do pass, but first be re-referred to the Committee on [Appropriations]",7,2,0,1,10
1707577,1463545,2024-08-05,Senate,"Placed on suspense file",7,0,0,0,7
1707578,1298252,2023-04-11,Assembly,"Do pass and be re-referred to the Committee on [Appropriations]",12,0,0,3,15
1707578,1311776,2023-04-26,Assembly,"Do pass",12,2,0,2,16
1707578,1315661,2023-05-01,Assembly,"AB 931 Irwin Assembly Third Reading",62,1,0,17,80
1707578,1344207,2023-06-14,Senate,"Do pass as amended, but first amend, and re-refer to the Committee on [Appropriations]",10,0,0,2,12
1707578,1347487,2023-06-26,Senate,"Placed on suspense file",6,0,0,1,7
1707578,1353012,2023-09-01,Senate,"Do pass as amended",6,0,0,1,7
1707578,1353348,2023-09-07,Senate,"Assembly 3rd Reading AB931 Irwin By Lim√≥n",39,0,0,1,40
1707578,1353628,2023-09-11,Assembly,"AB 931 Irwin Concurrence in Senate Amendments",74,0,0,6,80
1707579,1299490,2023-04-12,Assembly,"Do pass and be re-referred to the Committee on [Appropriations] with recommendation: To Consent Calendar",8,0,0,0,8
1707579,1328771,2023-05-18,Assembly,"Do pass as amended",11,0,0,5,16
1707579,1335522,2023-05-30,Assembly,"AB 932 Ting Assembly Third Reading",80,0,0,0,80
1707579,1346283,2023-06-20,Senate,"Do pass, but first be re-referred to the Committee on [Appropriations] with the recommendation: To Consent Calendar",11,0,0,0,11
1707579,1351674,2023-08-17,Senate,"Consent Calendar 2nd AB932 Ting",38,0,0,2,40
1707580,1280666,2023-03-21,Assembly,"Do pass as amended",8,0,0,3,11
1707580,1306773,2023-04-20,Assembly,"AB 933 Aguiar-Curry Assembly Third Reading",60,2,0,18,80
1707580,1343758,2023-06-13,Senate,"Do pass",8,1,0,2,11
1707580,1353286,2023-09-06,Senate,"Assembly 3rd Reading AB933 Aguiar-Curry et al. By Rubio",32,5,0,3,40
1707580,1353618,2023-09-11,Assembly,"AB 933 Aguiar-Curry Concurrence in Senate Amendments",64,0,0,16,80
1707581,1313448,2023-04-26,Assembly,"Do pass as amended, and be re-referred to the Committee on [Appropriations] with recommendation: To Consent Calendar",7,0,0,0,7
1707581,1328374,2023-05-18,Assembly,"Do pass",15,0,0,1,16
1707581,1335528,2023-05-30,Assembly,"AB 934 Muratsuchi Assembly Third Reading",80,0,0,0,80
1707581,1344221,2023-06-14,Senate,"Do pass, but first be re-referred to the Committee on [Appropriations] with the recommendation: To Consent Calendar",7,0,0,0,7
1707581,1347510,2023-06-26,Senate,"Placed on suspense file",6,0,0,1,7
1707581,1352695,2023-09-01,Senate,"Do pass",7,0,0,0,7
1707581,1354150,2023-09-13,Senate,"Assembly 3rd Reading AB934 Muratsuchi By Newman",39,0,0,1,40
1707581,1354588,2023-09-14,Assembly,"AB 934 Muratsuchi Concurrence in Senate Amendments",80,0,0,0,80
1707582,1298172,2023-04-11,Assembly,"Do pass as amended and be re-referred to the Committee on [Governmental Organization]",10,4,0,1,15
1707582,1311841,2023-04-26,Assembly,"Do pass and be re-referred to the Committee on [Appropriations]",16,4,0,2,22
1707582,1328631,2023-05-18,Assembly,"Do pass as amended",11,4,0,1,16
1707582,1335474,2023-05-30,Assembly,"AB 935 Connolly Assembly Third Reading",61,14,0,5,80
1707582,1346174,2023-06-21,Senate,"Do pass, but first be re-referred to the Committee on [Governance and Finance]",10,0,0,2,12
1707582,1349793,2023-07-05,Senate,"Do pass, but first be re-referred to the Committee on [Appropriations]",6,2,0,0,8
1707582,1351360,2023-08-14,Senate,"Placed on suspense file",7,0,0,0,7
1707582,1352688,2023-09-01,Senate,"Do pass",5,2,0,0,7
1707582,1353933,2023-09-12,Senate,"Assembly 3rd Reading AB935 Connolly et al. By Rubio",30,6,0,4,40
1707582,1354277,2023-09-13,Assembly,"AB 935 Connolly Concurrence in Senate Amendments",62,14,0,4,80
1707583,1304282,2023-04-18,Assembly,"Do pass and be re-referred to the Committee on [Appropriations] with recommendation: To Consent Calendar",17,0,0,1,18
1707583,1322934,2023-05-10,Assembly,"Do pass as amended. To Consent Calendar",14,0,0,2,16
1707583,1328105,2023-05-18,Assembly,"AB 936 Wood Consent Calendar Second Day Regular Session",74,0,0,6,80
1707583,1343112,2023-06-12,Senate,"Do pass, but first be re-referred to the Committee on [Appropriations]",12,0,0,1,13
1707583,1353186,2023-09-05,Senate,"Assembly 3rd Reading AB936 Wood By Alvarado-Gil Urgency Clause",39,0,0,1,40
1707584,1298237,2023-04-11,Assembly,"Do pass as amended and be re-referred to the Committee on [Human Services]",11,0,0,0,11
1707584,1310309,2023-04-25,Assembly,"Do pass and be re-referred to the Committee on [Appropriations]",8,0,0,0,8
1707584,1328511,2023-05-18,Assembly,"Do pass",14,0,0,2,16
1707584,1335403,2023-05-30,Assembly,"AB 937 McKinnor Assembly Third Reading",80,0,0,0,80
1707584,1348355,2023-06-27,Senate,"Do pass, but first be re-referred to the Committee on [Human Services] with the recommendation: To Consent Calendar",11,0,0,0,11
1707584,1349586,2023-07-03,Senate,"Do pass, but first be re-referred to the Committee on [Appropriations]",5,0,0,0,5
1707584,1352333,2023-08-28,Senate,"Placed on suspense file",7,0,0,0,7
1707584,1352851,2023-09-01,Senate,"Do pass",7,0,0,0,7
1707584,1353889,2023-09-12,Senate,"Assembly 3rd Reading AB937 McKinnor et al. By Smallwood-Cuevas",38,0,0,2,40
1707584,1354314,2023-09-13,Assembly,"AB 937 McKinnor Concurrence in Senate Amendments",80,0,0,0,80
1707585,1313410,2023-04-26,Assembly,"Do pass as amended and be re-referred to the Committee on [Appropriations]",6,0,0,1,7
1707585,1328858,2023-05-18,Assembly,"Do pass",13,0,0,3,16
1707585,1337253,2023-06-01,Assembly,"AB 938 Muratsuchi Assembly Third Reading",77,0,0,3,80
1707585,1349669,2023-07-05,Senate,"Do pass, but first be re-referred to the Committee on [Labor, Public Employment and Retirement ]",5,0,0,2,7
1707585,1350445,2023-07-12,Senate,"Do pass as amended, but first amend, and re-refer to the Committee on [Appropriations]",4,0,0,1,5
1707585,1351822,2023-08-21,Senate,"Placed on suspense file",7,0,0,0,7
1707585,1352839,2023-09-01,Senate,"Do pass as amended",6,0,0,1,7
1707585,1465991,2024-08-27,Senate,"Assembly 3rd Reading AB938 Muratsuchi et al. By Newman",40,0,0,0,40
1707585,1466678,2024-08-28,Assembly,"AB 938 Muratsuchi Concurrence in Senate Amendments",76,0,0,3,79
1707586,1318026,2023-05-03,Assembly,"Do pass",8,0,0,0,8
1707586,1324961,2023-05-15,Assembly,"AB 939 Pellerin Assembly Third Reading",78,0,0,2,80
1707586,1340979,2023-06-07,Senate,"Do pass",7,0,0,1,8
1707586,1351709,2023-08-17,Senate,"Assembly 3rd Reading AB939 Pellerin By Becker",38,0,0,2,40
1707586,1352223,2023-08-24,Assembly,"AB 939 Pellerin Concurrence in Senate Amendments",75,0,0,5,80
1707588,1363770,2024-01-09,Assembly,"Do pass and be re-referred to the Committee on [Appropriations]",11,0,0,5,16
1707588,1366784,2024-01-18,Assembly,"Do pass",11,0,0,5,16
1707588,1372097,2024-01-30,Assembly,"AB 941 Waldron Assembly Third Reading",58,0,0,22,80
1707590,1281809,2023-03-21,Assembly,"Do pass and be re-referred to the Committee on [Appropriations] with recommendation: To Consent Calendar",8,0,0,0,8
1707590,1328823,2023-05-18,Assembly,"Do pass",15,0,0,1,16
1707590,1335561,2023-05-30,Assembly,"AB 943 Kalra Assembly Third Reading",80,0,0,0,80
1707590,1347884,2023-06-27,Senate,"Do pass, but first be re-referred to the Committee on [Appropriations] with the recommendation: To Consent Calendar",5,0,0,0,5
1707590,1351497,2023-08-14,Senate,"Placed on suspense file",7,0,0,0,7
1707590,1352610,2023-09-01,Senate,"Do pass",7,0,0,0,7
1707590,1353849,2023-09-12,Senate,"Assembly 3rd Reading AB943 Kalra By Min",38,0,0,2,40
1707590,1354367,2023-09-13,Assembly,"AB 943 Kalra Concurrence in Senate Amendments",80,0,0,0,80
1707591,1304266,2023-04-17,Assembly,"Do pass as amended and be re-referred to the Committee on [Appropriations]",7,0,0,0,7
1707592,1299500,2023-04-11,Assembly,"Do pass and be re-referred to the Committee on [Appropriations] with recommendation: To Consent Calendar",8,0,0,0,8
1707592,1328600,2023-05-18,Assembly,"Do pass",15,0,0,1,16
1707592,1333729,2023-05-25,Assembly,"AB 945 Reyes Assembly Third Reading",77,0,0,3,80
1707592,1347928,2023-06-27,Senate,"Do pass as amended, but first amend, and re-refer to the Committee on [Appropriations] with the recommendation: To Consent Calendar",5,0,0,0,5
1707592,1351446,2023-08-14,Senate,"Placed on suspense file",7,0,0,0,7
1707592,1352858,2023-09-01,Senate,"Do pass as amended",7,0,0,0,7
1707592,1354218,2023-09-13,Senate,"Assembly 3rd Reading AB945 Reyes By Becker",39,0,0,1,40
1707592,1354674,2023-09-14,Assembly,"AB 945 Reyes Concurrence in Senate Amendments",80,0,0,0,80
1707593,1304400,2023-04-17,Assembly,"Do pass and be re-referred to the Committee on [Appropriations] with recommendation: To Consent Calendar",7,0,0,0,7
1707593,1318083,2023-05-03,Assembly,"Do pass. To Consent Calendar",16,0,0,0,16
1707593,1323820,2023-05-11,Assembly,"AB 946 Stephanie Nguyen Consent Calendar Second Day Regular Session",66,0,0,14,80
1707593,1343690,2023-06-13,Senate,"Do pass, but first be re-referred to the Committee on [Appropriations] with the recommendation: To Consent Calendar",5,0,0,0,5
1707593,1348839,2023-06-29,Senate,"Consent Calendar AB946 Stephanie Nguyen",39,0,0,1,40
1707594,1311818,2023-04-25,Assembly,"Do pass and be re-referred to the Committee on [Appropriations] with recommendation: To Consent Calendar",11,0,0,0,11
1707594,1322936,2023-05-10,Assembly,"Do pass",14,0,0,2,16
1707594,1330079,2023-05-22,Assembly,"AB 947 Gabriel Assembly Third Reading",76,0,0,4,80
1707594,1345663,2023-06-20,Senate,"Do pass, but first be re-referred to the Committee on [Appropriations]",11,0,0,0,11
1707594,1353175,2023-09-05,Senate,"Assembly 3rd Reading AB947 Gabriel et al. By Caballero",39,0,0,1,40
1707595,1280596,2023-03-21,Assembly,"Do pass and be re-referred to the Committee on [Appropriations]",13,0,0,2,15
1707595,1305514,2023-04-19,Assembly,"Do pass. To Consent Calendar",14,0,0,2,16
1707595,1313325,2023-04-27,Assembly,"AB 948 Berman Consent Calendar Second Day Regular Session",79,0,0,1,80
1707595,1341015,2023-06-07,Senate,"Do pass as amended, but first amend, and re-refer to the Committee on [Appropriations]",12,0,0,0,12
1707595,1347484,2023-06-26,Senate,"Do pass",6,0,0,1,7
1707595,1353154,2023-09-05,Senate,"Assembly 3rd Reading AB948 Berman et al. By Wiener",39,0,0,1,40
1707595,1353420,2023-09-07,Assembly,"AB 948 Berman Concurrence in Senate Amendments",79,0,0,1,80
1707597,1310224,2023-04-25,Assembly,"Do pass as amended, and be re-referred to the Committee on [Appropriations] with recommendation: To Consent Calendar",11,0,0,0,11
1707599,1280668,2023-03-21,Assembly,"Do pass and be re-referred to the Committee on [Appropriations]",13,0,0,2,15
1707599,1305249,2023-04-19,Assembly,"Do pass",15,0,0,1,16
1707599,1315725,2023-05-01,Assembly,"AB 952 Wood Assembly Third Reading",74,0,0,6,80
1707599,1344232,2023-06-14,Senate,"Do pass, but first be re-referred to the Committee on [Appropriations] with the recommendation: To Consent Calendar",12,0,0,0,12
1707599,1348864,2023-06-29,Senate,"Consent Calendar AB952 Wood",39,0,0,1,40
1707599,1350641,2023-07-13,Assembly,"AB 952 Wood Concurrence in Senate Amendments",72,0,0,8,80
1707600,1286881,2023-03-28,Assembly,"Do pass as amended and be re-referred to the Committee on [Natural Resources]",15,0,0,0,15
1707600,1302575,2023-04-17,Assembly,"Do pass as amended and be re-referred to the Committee on [Appropriations]",11,0,0,0,11
1707600,1327973,2023-05-18,Assembly,"Do pass as amended",15,0,0,1,16
1707600,1335446,2023-05-30,Assembly,"AB 953 Connolly Assembly Third Reading",80,0,0,0,80
1707600,1349909,2023-07-10,Senate,"Do pass as amended, but first amend, and re-refer to the Committee on [Appropriations] with the recommendation: To Consent Calendar",10,0,0,1,11
1707600,1351320,2023-08-14,Senate,"Placed on suspense file",7,0,0,0,7
1707601,1280616,2023-03-21,Assembly,"Do pass as amended and be re-referred to the Committee on [Human Services]",8,0,0,3,11
1707601,1304341,2023-04-18,Assembly,"Do pass",5,0,0,3,8
1707601,1308908,2023-04-24,Assembly,"AB 954 Bryan Assembly Third Reading",63,2,0,15,80
1707601,1345578,2023-06-20,Senate,"Do pass as amended, but first amend, and re-refer to the Committee on [Human Services]",9,0,0,2,11
1707601,1349652,2023-07-03,Senate,"Do pass",5,0,0,0,5
1707601,1353112,2023-09-05,Senate,"Assembly 3rd Reading AB954 Bryan By Menjivar",35,0,0,5,40
1707601,1353505,2023-09-07,Assembly,"AB 954 Bryan Concurrence in Senate Amendments",63,0,0,17,80
1707602,1313462,2023-04-27,Assembly,"Bill measure be retained in committee, and subject matter be referred to Rules Committee for assignment to the proper committee",8,0,0,0,8
1707603,1288382,2023-03-29,Assembly,"Do pass and be re-referred to the Committee on [Appropriations]",7,0,0,0,7
1707603,1311741,2023-04-26,Assembly,"Do pass. To Consent Calendar",16,0,0,0,16
1707603,1318958,2023-05-04,Assembly,"AB 956 Alvarez Consent Calendar Second Day Regular Session",75,0,0,5,80
1707603,1343711,2023-06-13,Senate,"Do pass, but first be re-referred to the Committee on [Appropriations] with the recommendation: To Consent Calendar",5,0,0,0,5
1707603,1348815,2023-06-29,Senate,"Consent Calendar AB956 Alvarez",39,0,0,1,40
1707603,1349807,2023-07-06,Assembly,"AB 956 Alvarez Concurrence in Senate Amendments",69,0,0,11,80
1707604,1280632,2023-03-21,Assembly,"Do pass",8,3,0,0,11
1707604,1289809,2023-03-30,Assembly,"AB 957 Wilson Assembly Third Reading",51,13,0,16,80
1707604,1343786,2023-06-13,Senate,"Do pass",8,2,0,1,11
1707604,1353315,2023-09-06,Senate,"Assembly 3rd Reading AB957 Wilson et al. By Umberg",30,9,0,1,40
1707604,1353568,2023-09-08,Assembly,"AB 957 Wilson Concurrence in Senate Amendments",61,16,0,3,80
1707605,1281904,2023-03-21,Assembly,"Do pass and be re-referred to the Committee on [Appropriations]",7,0,0,1,8
1707605,1328181,2023-05-18,Assembly,"Do pass as amended",11,4,0,1,16
1707605,1335562,2023-05-30,Assembly,"AB 958 Santiago Assembly Third Reading",52,15,0,13,80
1707605,1347794,2023-06-27,Senate,"Do pass, but first be re-referred to the Committee on [Appropriations]",4,1,0,0,5
1707605,1351409,2023-08-14,Senate,"Placed on suspense file",7,0,0,0,7
1707606,1280679,2023-03-21,Assembly,"Do pass and be re-referred to the Committee on [Appropriations] with recommendation: To Consent Calendar",11,0,0,0,11
1707606,1328521,2023-05-18,Assembly,"Do pass",15,0,0,1,16
1707606,1335476,2023-05-30,Assembly,"AB 959 McCarty Third Reading Urgency",80,0,0,0,80
1707606,1345571,2023-06-20,Senate,"Do pass, but first be re-referred to the Committee on [Appropriations] with the recommendation: To Consent Calendar",11,0,0,0,11
1707606,1349515,2023-07-03,Senate,"Placed on suspense file",7,0,0,0,7
1707607,1363937,2024-01-10,Assembly,"Do pass as amended and be re-referred to the Committee on [Appropriations]",6,0,0,1,7
1707607,1366780,2024-01-18,Assembly,"AB 960 Mathis Assembly Third Reading",66,0,0,14,80
1707607,1454237,2024-06-05,Senate,"Do pass as amended, but first amend, and re-refer to the Committee on [Judiciary]",6,0,0,1,7
1707607,1460691,2024-06-25,Senate,"Do pass as amended, and be ordered to the Consent Calendar",11,0,0,0,11
1707607,1462636,2024-07-03,Senate,"Consent Calendar 2nd AB960 Mathis",39,0,0,1,40
1707607,1463899,2024-08-12,Assembly,"AB 960 Mathis Concurrence in Senate Amendments",72,0,0,7,79
1707609,1280651,2023-03-20,Assembly,"Do pass and be re-referred to the Committee on [Appropriations] with recommendation: To Consent Calendar",15,0,0,0,15
1707609,1328201,2023-05-18,Assembly,"Do pass as amended",15,0,0,1,16
1707609,1335570,2023-05-30,Assembly,"AB 962 Vince Fong Assembly Third Reading",80,0,0,0,80
1707609,1350563,2023-07-11,Senate,"Do pass as amended, but first amend, and re-refer to the Committee on [Appropriations] with the recommendation: To Consent Calendar",16,0,0,0,16
1707609,1351801,2023-08-21,Senate,"Do pass",7,0,0,0,7
1707609,1353168,2023-09-05,Senate,"Assembly 3rd Reading AB962 Vince Fong et al. By Glazer",39,0,0,1,40
1707609,1353375,2023-09-07,Assembly,"AB 962 Vince Fong Concurrence in Senate Amendments",79,0,0,1,80
1707610,1286956,2023-03-28,Assembly,"Do pass as amended and be re-referred to the Committee on [Jobs, Economic Development, and the Economy]",7,0,0,1,8
1707610,1310338,2023-04-25,Assembly,"Do pass as amended and be re-referred to the Committee on [Appropriations]",7,0,0,0,7
1707611,1305290,2023-04-19,Assembly,"Do pass and be re-referred to the Committee on [Appropriations] with recommendation: To Consent Calendar",6,0,0,1,7
1707612,1305247,2023-04-19,Assembly,"Do pass as amended and be re-referred to the Committee on [Local Government]",13,0,0,0,13
1707612,1313437,2023-04-26,Assembly,"Do pass as amended and be re-referred to the Committee on [Appropriations]",8,0,0,0,8
1707612,1326924,2023-05-17,Assembly,"Do pass",16,0,0,0,16
1707612,1330041,2023-05-22,Assembly,"AB 965 Juan Carrillo Assembly Third Reading",76,0,0,4,80
1707612,1345674,2023-06-20,Senate,"Do pass, but first be re-referred to the Committee on [Governance and Finance]",17,0,0,1,18
1707612,1350618,2023-07-12,Senate,"Do pass, but first be re-referred to the Committee on [Appropriations]",8,0,0,0,8
1707612,1353215,2023-09-06,Senate,"Assembly 3rd Reading AB965 Juan Carrillo By Dodd",40,0,0,0,40
1707612,1353600,2023-09-11,Assembly,"AB 965 Juan Carrillo Concurrence in Senate Amendments",80,0,0,0,80
1707613,1305438,2023-04-18,Assembly,"Do pass and be re-referred to the Committee on [Appropriations] with recommendation: To Consent Calendar",15,0,0,0,15
1707613,1328645,2023-05-18,Assembly,"Do pass",15,0,0,1,16
1707613,1337905,2023-05-31,Assembly,"AB 966 Davies Assembly Third Reading",80,0,0,0,80
1707613,1349461,2023-07-03,Senate,"Do pass as amended, but first amend, and re-refer to the Committee on [Appropriations] with the recommendation: To Consent Calendar",9,0,0,2,11
1707613,1351280,2023-08-14,Senate,"Placed on suspense file",7,0,0,0,7
1707613,1352759,2023-09-01,Senate,"Do pass",7,0,0,0,7
1707613,1353871,2023-09-12,Senate,"Special Consent AB966 Davies By Newman",39,0,0,1,40
1707613,1354241,2023-09-13,Assembly,"AB 966 Davies Concurrence in Senate Amendments",79,0,0,1,80
1707615,1286969,2023-03-28,Assembly,"Do pass as amended",9,0,0,2,11
1707615,1306808,2023-04-20,Assembly,"AB 968 Grayson Assembly Third Reading",73,0,0,7,80
1707615,1345579,2023-06-20,Senate,"Do pass as amended, and be ordered to the Consent Calendar",11,0,0,0,11
1707615,1348880,2023-06-29,Senate,"Consent Calendar AB968 Grayson et al",39,0,0,1,40
1707615,1349511,2023-07-03,Assembly,"AB 968 Grayson Concurrence in Senate Amendments",66,0,0,14,80
1707616,1305305,2023-04-19,Assembly,"Do pass",6,1,0,1,8
1707616,1313510,2023-04-27,Assembly,"AB 969 Pellerin Assembly Third Reading",62,9,0,9,80
1707616,1345567,2023-06-20,Senate,"Do pass, but first be re-referred to the Committee on [Appropriations]",6,1,0,0,7
1707616,1348368,2023-06-28,Senate,"Do pass as amended, but first amend, and re-refer to the Committee on [Appropriations]",6,2,0,0,8
1707616,1353135,2023-09-05,Senate,"Assembly 3rd Reading AB969 Pellerin et al. By Glazer Urgency Clause",31,6,0,3,40
1707616,1353431,2023-09-07,Assembly,"With recommendation: That Senate amendments be concurred in",6,2,0,0,8
1707616,1353563,2023-09-08,Assembly,"AB 969 Pellerin Concurrence - Urgency Added",62,14,0,4,80
1707617,1281857,2023-03-22,Assembly,"Do pass and be re-referred to the Committee on [Appropriations]",12,0,0,2,14
1707617,1328515,2023-05-18,Assembly,"Do pass as amended",11,0,0,5,16
1707617,1335587,2023-05-30,Assembly,"AB 970 Luz Rivas Assembly Third Reading",75,0,0,5,80
1707617,1348341,2023-06-28,Senate,"Do pass, but first be re-referred to the Committee on [Governance and Finance]",7,0,0,0,7
1707617,1350667,2023-07-12,Senate,"Do pass, but first be re-referred to the Committee on [Appropriations]",8,0,0,0,8
1707617,1351796,2023-08-21,Senate,"Placed on suspense file",7,0,0,0,7
1707617,1352970,2023-09-01,Senate,"Do pass as amended",7,0,0,0,7
1707617,1353832,2023-09-12,Assembly,"AB 970 Luz Rivas Concurrence in Senate Amendments",73,0,0,7,80
1707617,1354728,2023-09-11,Senate,"Assembly 3rd Reading AB970 Luz Rivas et al. By Allen",39,0,0,1,40
1707618,1304270,2023-04-17,Assembly,"Do pass. To Consent Calendar",15,0,0,0,15
1707618,1308883,2023-04-24,Assembly,"AB 971 Lee Consent Calendar Second Day",77,0,0,3,80
1707618,1343696,2023-06-13,Senate,"Do pass and be ordered to the Consent Calendar",16,0,0,0,16
1707618,1346951,2023-06-22,Senate,"Consent Calendar AB971 Lee",39,0,0,1,40
1707618,1353126,2023-09-05,Senate,"Assembly 3rd Reading AB971 Lee By Becker",39,0,0,1,40
1707618,1353536,2023-09-07,Assembly,"AB 971 Lee Concurrence in Senate Amendments",79,0,0,1,80
1707619,1313539,2023-04-26,Assembly,"Do pass and be re-referred to the Committee on [Appropriations]",8,0,0,0,8
1707619,1328356,2023-05-18,Assembly,"Do pass as amended",11,0,0,5,16
1707619,1335422,2023-05-30,Assembly,"AB 972 Maienschein Assembly Third Reading",80,0,0,0,80
1707619,1348490,2023-06-28,Senate,"Do pass as amended, but first amend, and re-refer to the Committee on [Appropriations]",8,0,0,0,8
1707619,1349991,2023-07-10,Senate,"Placed on suspense file",6,0,0,1,7
1707621,1288161,2023-03-28,Assembly,"Do pass and be re-referred to the Committee on [Appropriations]",12,0,0,3,15
1707623,1288376,2023-03-29,Assembly,"Do pass and be re-referred to the Committee on [Local Government]",7,0,0,1,8
1707623,1307870,2023-04-19,Assembly,"Do pass",6,0,0,1,7
1707623,1338097,2023-05-31,Assembly,"AB 976 Ting Assembly Third Reading",62,0,0,18,80
1707623,1346293,2023-06-20,Senate,"Do pass, but first be re-referred to the Committee on [Governance and Finance]",8,2,0,1,11
1707623,1349827,2023-07-05,Senate,"Do pass",5,2,0,1,8
1707623,1353218,2023-09-06,Senate,"Assembly 3rd Reading AB976 Ting et al. By Skinner",22,9,0,9,40
1707623,1353664,2023-09-11,Assembly,"AB 976 Ting Concurrence in Senate Amendments",60,3,0,17,80
1707624,1363752,2024-01-09,Assembly,"Do pass as amended and be re-referred to the Committee on [Appropriations]",8,0,0,0,8
1707624,1366751,2024-01-18,Assembly,"Do pass",15,0,0,1,16
1707624,1371089,2024-01-29,Assembly,"AB 977 Rodriguez Assembly Third Reading",68,0,0,12,80
1707624,1453460,2024-06-04,Senate,"Do pass, but first be re-referred to the Committee on [Appropriations]",3,1,0,1,5
1707624,1462000,2024-07-01,Senate,"Placed on suspense file",7,0,0,0,7
1707624,1464101,2024-08-15,Senate,"Do pass",7,0,0,0,7
1707624,1465977,2024-08-27,Senate,"Assembly 3rd Reading AB977 Rodriguez et al. By Ashby",39,0,0,1,40
1707624,1466215,2024-08-29,Assembly,"AB 977 Rodriguez Concurrence in Senate Amendments",72,0,0,7,79
1707625,1343721,2023-06-13,Assembly,"Be adopted and re-referred to the Committee on [Appropriations]",9,1,0,1,11
1707625,1346234,2023-06-21,Assembly,"Be adopted",11,0,0,5,16
1707625,1347545,2023-06-26,Assembly,"ACA 5 Low Assembly Third Reading",67,0,0,13,80
1707625,1348478,2023-06-27,Senate,"Be adopted, but first be re-referred to the Committee on [Elections and Constitutional Amendments]",11,0,0,0,11
1707625,1349774,2023-07-05,Senate,"Be adopted, but first be re-referred to the Committee on [Appropriations]",6,0,0,1,7
1707625,1349978,2023-07-10,Senate,"Be adopted",5,0,0,2,7
1707625,1350709,2023-07-13,Senate,"Assembly 3rd Reading ACA5 Low et al. By Wiener",31,0,0,9,40
1707626,1260541,2023-02-23,Assembly,"Be adopted. To third reading",13,0,0,0,13
1707627,1283180,2023-03-22,Assembly,"Be adopted. To Consent Calendar",7,0,0,0,7
1707627,1289775,2023-03-30,Assembly,"ACR 16 Mike Fong Consent Calendar Second Day Regular Session",60,0,0,20,80
1707627,1351502,2023-08-14,Senate,"Assembly 3rd Reading ACR16 Mike Fong et al. By Smallwood-Cuevas",37,0,0,3,40
1707628,1260543,2023-02-23,Assembly,"Be adopted. To third reading",13,0,0,0,13
1707629,1313377,2023-04-26,Senate,"Do pass, but first be re-referred to the Committee on [Appropriations]",8,0,0,0,8
1707629,1330146,2023-05-22,Senate,"Senate 3rd Reading SB475 Min",40,0,0,0,40
1707629,1348372,2023-06-28,Assembly,"Do pass and be re-referred to the Committee on [Appropriations] with recommendation: To Consent Calendar",8,0,0,0,8
1707629,1351587,2023-08-16,Assembly,"Do pass. To Consent Calendar",15,0,0,1,16
1707629,1352253,2023-08-24,Assembly,"SB 475 Min Consent Calendar Second Day Regular Session",73,0,0,7,80
1707629,1352671,2023-09-01,Senate,"Special Consent SB475 Min et al",37,0,0,3,40
1707630,1281910,2023-03-22,Senate,"Do pass, but first be re-referred to the Committee on [Appropriations]",9,2,0,1,12
1707630,1296903,2023-04-10,Senate,"Placed on suspense file",7,0,0,0,7
1707630,1328055,2023-05-18,Senate,"Do pass",5,2,0,0,7
1707630,1335477,2023-05-30,Senate,"Senate 3rd Reading SB476 Lim√≥n et al",30,9,0,1,40
1707630,1345558,2023-06-20,Assembly,"Do pass and be re-referred to the Committee on [Appropriations]",10,3,0,2,15
1707630,1352637,2023-09-01,Assembly,"Do pass",12,4,0,0,16
1707630,1353739,2023-09-12,Assembly,"SB 476 Lim√≥n Senate Third Reading By Friedman",56,18,0,6,80
1707630,1354354,2023-09-13,Senate,"Unfinished Business SB476 Lim√≥n et al. Concurrence",30,8,0,2,40
1707631,1317069,2023-05-02,Senate,"Do pass and be ordered to the Consent Calendar",10,0,0,1,11
1707631,1320394,2023-05-08,Senate,"Consent Calendar SB477 HOUSING (Wiener)",36,0,0,4,40
1707631,1346269,2023-06-21,Assembly,"Do pass as amended. To Consent Calendar",8,0,0,0,8
1707631,1349430,2023-06-29,Assembly,"SB 477 Housing Consent Calendar Second Day",74,0,0,6,80
1707631,1349965,2023-07-10,Senate,"Unfinished Business SB477 HOUSING (Wiener) Urgency Clause Concurrence",37,0,0,3,40
1707631,1405813,2024-03-07,Assembly,"SB 477 Housing Third Reading Urgency By WARD Amendment Set #1",70,0,0,10,80
1707631,1407459,2024-03-11,Assembly,"SB 477 Housing Third Reading Urgency By WARD",66,0,0,14,80
1707631,1409568,2024-03-14,Senate,"Unfinished Business SB477 HOUSING (Skinner) Urgency Clause Concurrence",40,0,0,0,40
1707632,1311757,2023-04-25,Senate,"Do pass, but first be re-referred to the Committee on [Appropriations]",9,1,0,1,11
1707632,1320531,2023-05-08,Senate,"Placed on suspense file",7,0,0,0,7
1707632,1328328,2023-05-18,Senate,"Do pass as amended",4,2,0,1,7
1707632,1336333,2023-05-31,Senate,"Senate 3rd Reading SB478 Dodd et al",31,3,0,6,40
1707632,1347934,2023-06-27,Assembly,"Do pass and be re-referred to the Committee on [Privacy and Consumer Protection]",8,3,0,0,11
1707632,1350214,2023-07-11,Assembly,"Do pass as amended",8,2,0,1,11
1707632,1353591,2023-09-11,Assembly,"SB 478 Dodd Senate Third Reading By Bauer-Kahan",60,14,0,6,80
1707632,1353795,2023-09-12,Senate,"Unfinished Business SB478 Dodd et al. Concurrence",30,8,0,2,40
1707633,1306716,2023-04-19,Senate,"Do pass and be ordered to the Consent Calendar",5,0,0,0,5
1707633,1315712,2023-05-01,Senate,"Consent Calendar SB479 Padilla",37,0,0,3,40
1707633,1348480,2023-06-28,Assembly,"Do pass. To Consent Calendar",13,0,0,1,14
1707633,1405815,2024-03-07,Assembly,"SB 479 Durazo Third Reading Urgency By McKinnor",66,0,0,14,80
1707633,1407460,2024-03-11,Senate,"That the Assembly amendments be concurred in",10,0,0,1,11
1707633,1409569,2024-03-14,Senate,"Unfinished Business SB479 Durazo Urgency Clause Concurrence",40,0,0,0,40
1707634,1311836,2023-04-26,Senate,"Do pass as amended, but first amend, and re-refer to the Committee on [Appropriations]",7,0,0,0,7
1707634,1325014,2023-05-15,Senate,"Placed on suspense file",7,0,0,0,7
1707634,1366796,2024-01-18,Senate,"Do pass",6,0,0,1,7
1707634,1371116,2024-01-29,Senate,"Senate 3rd Reading SB480 Portantino",37,1,0,2,40
1707634,1460616,2024-06-26,Assembly,"Do pass and be re-referred to the Committee on [Labor and Employment] with recommendation: To Consent Calendar",7,0,0,0,7
1707634,1462301,2024-07-02,Assembly,"Do pass and be re-referred to the Committee on [Appropriations] with recommendation: To Consent Calendar",7,0,0,0,7
1707636,1305242,2023-04-18,Senate,"Do pass, but first be re-referred to the Committee on [Appropriations]",10,0,0,1,11
1707636,1315640,2023-05-01,Senate,"Placed on suspense file",6,0,0,1,7
1707636,1328611,2023-05-18,Senate,"Do pass",7,0,0,0,7
1707636,1333587,2023-05-25,Senate,"Special Consent SB482 Blakespear",40,0,0,0,40
1707636,1348377,2023-06-28,Assembly,"Do pass as amended and be re-referred to the Committee on [Appropriations]",8,0,0,0,8
1707636,1352659,2023-09-01,Assembly,"Do pass as amended",11,0,0,5,16
1707636,1354231,2023-09-13,Assembly,"SB 482 Blakespear Senate Third Reading By Blanca Rubio",80,0,0,0,80
1707636,1354518,2023-09-14,Senate,"Unfinished Business SB482 Blakespear Concurrence",40,0,0,0,40
1707637,1363958,2024-01-10,Senate,"Do pass, but first be re-referred to the Committee on [Appropriations]",7,0,0,0,7
1707637,1364784,2024-01-16,Senate,"Placed on suspense file",6,0,0,1,7
1707637,1366789,2024-01-18,Senate,"Do pass",6,0,0,1,7
1707637,1371094,2024-01-29,Senate,"Senate 3rd Reading SB483 Cortese",39,0,0,1,40
1707637,1456916,2024-06-12,Assembly,"Do pass",7,0,0,0,7
1707637,1465780,2024-08-27,Assembly,"SB 483 Cortese Senate Third Reading By Aguiar-Curry",75,0,0,4,79
1707637,1467073,2024-08-28,Senate,"Unfinished Business SB483 Cortese et al. Concurrence",39,0,0,1,40
1707638,1288148,2023-03-29,Senate,"Do pass as amended, but first amend, and re-refer to the Committee on [Appropriations] with the recommendation: To Consent Calendar",7,0,0,0,7
1707638,1302658,2023-04-17,Senate,"Placed on suspense file",6,0,0,1,7
1707638,1328719,2023-05-18,Senate,"Do pass",7,0,0,0,7
1707638,1333704,2023-05-25,Senate,"Special Consent SB484 Newman",40,0,0,0,40
1707638,1347543,2023-06-26,Assembly,"Do pass as amended and be re-referred to the Committee on [Appropriations]",10,0,0,2,12
1707639,1288223,2023-03-29,Senate,"Do pass as amended, but first amend, and re-refer to the Committee on [Rules]",5,0,0,2,7
1707639,1308920,2023-04-24,Senate,"Do pass as amended, but first amend, and re-refer to the Committee on [Appropriations]",4,0,0,0,4
1707639,1324999,2023-05-15,Senate,"Placed on suspense file",7,0,0,0,7
1707639,1328507,2023-05-18,Senate,"Do pass",6,0,0,1,7
1707639,1335603,2023-05-30,Senate,"Senate 3rd Reading SB485 Becker",38,0,0,2,40
1707639,1349584,2023-07-05,Assembly,"Do pass and be re-referred to the Committee on [Public Safety]",6,0,0,2,8
1707639,1350133,2023-07-11,Assembly,"Do pass as amended and be re-referred to the Committee on [Appropriations]",6,1,0,1,8
1707639,1352560,2023-09-01,Assembly,"Do pass as amended",11,3,0,2,16
1707639,1353893,2023-09-12,Assembly,"SB 485 Becker Senate Third Reading By Pellerin",63,10,0,7,80
1707639,1354313,2023-09-13,Senate,"That the Assembly amendments be concurred in",5,1,0,1,7
1707639,1354675,2023-09-14,Senate,"Unfinished Business SB485 Becker Concurrence",33,7,0,0,40
1707640,1281846,2023-03-22,Senate,"Do pass",7,0,0,0,7
1707640,1308855,2023-04-24,Senate,"Senate 3rd Reading SB486 Hurtado",39,0,0,1,40
1707640,1343787,2023-06-13,Assembly,"Do pass and be re-referred to the Committee on [Education]",5,0,0,2,7
1707640,1350454,2023-07-12,Assembly,"Do pass as amended",4,2,0,1,7
1707640,1353416,2023-09-07,Assembly,"SB 486 Hurtado Senate Third Reading By Bains",60,9,0,11,80
1707640,1353779,2023-09-12,Senate,"Unfinished Business SB486 Hurtado Concurrence",28,9,0,3,40
1707641,1288220,2023-03-28,Senate,"Do pass, but first be re-referred to the Committee on [Rules]",8,2,0,1,11
1707641,1305489,2023-04-19,Senate,"Do pass as amended, but first amend, and re-refer to the Committee on [Appropriations]",9,2,0,1,12
1707641,1315721,2023-05-01,Senate,"Placed on suspense file",6,0,0,1,7
1707641,1328269,2023-05-18,Senate,"Do pass",5,2,0,0,7
1707641,1332624,2023-05-24,Senate,"Senate 3rd Reading SB487 Atkins et al",31,8,0,1,40
1707641,1347924,2023-06-27,Assembly,"Do pass and be re-referred to the Committee on [Judiciary]",11,4,0,0,15
1707641,1350225,2023-07-11,Assembly,"Do pass and be re-referred to the Committee on [Appropriations]",8,3,0,0,11
1707641,1352607,2023-09-01,Assembly,"Do pass as amended",11,4,0,1,16
1707641,1353419,2023-09-07,Assembly,"SB 487 Atkins Senate Third Reading By Bauer-Kahan",64,15,0,1,80
1707641,1354695,2023-09-11,Senate,"Unfinished Business SB487 Atkins et al. Concurrence",31,8,0,1,40
1707642,1310138,2023-04-24,Senate,"Do pass, but first be re-referred to the Committee on [Appropriations]",7,2,0,9,18
1707642,1310139,2023-04-24,Senate,"[First] hearing set for [04-25-2023]: Failed passage in Committee. Reconsideration granted",17,0,0,1,18
1707644,1288186,2023-03-28,Senate,"Do pass, but first be re-referred to the Committee on [Appropriations]",9,0,0,2,11
1707644,1296989,2023-04-10,Senate,"Placed on suspense file",7,0,0,0,7
1707644,1328088,2023-05-18,Senate,"Do pass",5,1,0,1,7
1707644,1335425,2023-05-30,Senate,"Senate 3rd Reading SB490 Bradford Urgency Clause",32,2,0,6,40
1707645,1310226,2023-04-24,Senate,"Do pass, but first be re-referred to the Committee on [Appropriations]",5,0,0,0,5
1707645,1320494,2023-05-08,Senate,"Placed on suspense file",7,0,0,0,7
1707645,1328085,2023-05-18,Senate,"Do pass",7,0,0,0,7
1707645,1333767,2023-05-25,Senate,"Special Consent SB491 Durazo et al",40,0,0,0,40
1707645,1350232,2023-07-11,Assembly,"Do pass and be re-referred to the Committee on [Appropriations]",7,0,0,1,8
1707646,1280606,2023-03-21,Senate,"Do pass, but first be re-referred to the Committee on [Appropriations]",4,0,0,1,5
1707646,1296945,2023-04-10,Senate,"Placed on suspense file",7,0,0,0,7
1707647,1280676,2023-03-21,Senate,"Do pass, but first be re-referred to the Committee on [Environmental Quality]",17,0,0,1,18
1707647,1305442,2023-04-19,Senate,"Do pass as amended, but first amend, and re-refer to the Committee on [Appropriations] with the recommendation: To Consent Calendar",7,0,0,0,7
1707647,1315720,2023-05-01,Senate,"Placed on suspense file",6,0,0,1,7
1707647,1328695,2023-05-18,Senate,"Do pass",7,0,0,0,7
1707647,1334474,2023-05-26,Senate,"Senate 3rd Reading SB493 Min",36,0,0,4,40
1707647,1349616,2023-07-05,Assembly,"Do pass and be re-referred to the Committee on [Utilities and Energy] with recommendation: To Consent Calendar",15,0,0,0,15
1707647,1350527,2023-07-12,Assembly,"Do pass and be re-referred to the Committee on [Appropriations] with recommendation: To Consent Calendar",14,0,0,1,15
1707647,1352835,2023-09-01,Assembly,"Do pass",16,0,0,0,16
1707647,1353662,2023-09-11,Assembly,"SB 493 Min Senate Third Reading By Alvarez",80,0,0,0,80
1707647,1353803,2023-09-12,Senate,"Unfinished Business SB493 Min et al. Concurrence",39,0,0,1,40
1707648,1305262,2023-04-19,Senate,"Do pass",6,1,0,0,7
1707648,1324947,2023-05-15,Senate,"Senate 3rd Reading SB494 Newman",32,6,0,2,40
1707648,1348833,2023-06-28,Assembly,"Do pass as amended",6,0,0,1,7
1707648,1353754,2023-09-12,Assembly,"SB 494 Newman Senate Third Reading By Mike Fong",65,14,0,1,80
1707648,1354389,2023-09-13,Senate,"Unfinished Business SB494 Newman Concurrence",32,7,0,1,40
1707649,1298289,2023-04-11,Senate,"Do pass, but first be re-referred to the Committee on [Appropriations]",13,0,0,2,15
1707649,1308810,2023-04-24,Senate,"Placed on suspense file",7,0,0,0,7
1707649,1328889,2023-05-18,Senate,"Do pass as amended",7,0,0,0,7
1707649,1336375,2023-05-31,Senate,"Senate 3rd Reading SB495 Dodd",34,2,0,4,40
1707649,1458818,2024-06-19,Assembly,"Do pass and be re-referred to the Committee on [Appropriations]",16,1,0,5,22
1707650,1305400,2023-04-19,Senate,"Do pass as amended, but first amend, and re-refer to the Committee on [Appropriations]",11,0,0,1,12
1707650,1320491,2023-05-08,Senate,"Placed on suspense file",7,0,0,0,7
1707650,1328365,2023-05-18,Senate,"Do pass",6,0,0,1,7
1707650,1332585,2023-05-24,Senate,"Senate 3rd Reading SB496 Lim√≥n et al",40,0,0,0,40
1707650,1350228,2023-07-11,Assembly,"Do pass as amended and be re-referred to the Committee on [Appropriations]",15,0,0,0,15
1707650,1352638,2023-09-01,Assembly,"Do pass as amended",11,0,0,5,16
1707650,1354339,2023-09-13,Assembly,"SB 496 Lim√≥n Senate Third Reading By Waldron",79,0,0,1,80
1707650,1354825,2023-09-14,Senate,"Unfinished Business SB496 Lim√≥n et al. Concurrence",40,0,0,0,40
1707651,1300991,2023-04-12,Senate,"Do pass, but first be re-referred to the Committee on [Judiciary]",4,1,0,0,5
1707651,1311687,2023-04-25,Senate,"Do pass as amended, but first amend, and re-refer to the Committee on [Appropriations]",8,2,0,1,11
1707651,1320407,2023-05-08,Senate,"Placed on suspense file",7,0,0,0,7
1707651,1328676,2023-05-18,Senate,"Do pass",5,2,0,0,7
1707651,1335498,2023-05-30,Senate,"Senate 3rd Reading SB497 Smallwood-Cuevas",29,10,0,1,40
1707651,1345636,2023-06-20,Assembly,"Do pass and be re-referred to the Committee on [Labor and Employment]",7,2,0,2,11
1707651,1350639,2023-07-12,Assembly,"Do pass and be re-referred to the Committee on [Appropriations]",5,2,0,0,7
1707651,1352107,2023-08-23,Assembly,"Do pass",10,4,0,2,16
1707651,1353424,2023-09-07,Assembly,"SB 497 Smallwood-Cuevas Senate Third Reading By Kalra",52,17,0,11,80
1707652,1310213,2023-04-25,Senate,"Do pass, but first be re-referred to the Committee on [Appropriations]",14,0,0,1,15
1707652,1325055,2023-05-15,Senate,"Senate 3rd Reading SB498 Gonzalez",38,0,0,2,40
1707652,1344182,2023-06-14,Assembly,"Do pass and be re-referred to the Committee on [Appropriations]",20,0,0,2,22
1707652,1352514,2023-09-01,Assembly,"Do pass",16,0,0,0,16
1707652,1353451,2023-09-07,Assembly,"SB 498 Gonzalez Senate Third Reading By Gipson",79,0,0,1,80
1707653,1281796,2023-03-22,Senate,"Do pass as amended, but first amend, and re-refer to the Committee on [Human Services]",7,0,0,0,7
1707653,1310290,2023-04-24,Senate,"Do pass as amended, but first amend, and re-refer to the Committee on [Appropriations]",5,0,0,0,5
1707653,1325008,2023-05-15,Senate,"Placed on suspense file",7,0,0,0,7
1707653,1328569,2023-05-18,Senate,"Do pass as amended",5,2,0,0,7
1707653,1336332,2023-05-31,Senate,"Senate 3rd Reading SB499 Menjivar et al",32,4,0,4,40
1707653,1350136,2023-07-11,Assembly,"Do pass and be re-referred to the Committee on [Education]",5,0,0,3,8
1707653,1350413,2023-07-12,Assembly,"Do pass and be re-referred to the Committee on [Appropriations]",4,1,0,2,7
1707654,1315144,2023-04-25,Senate,"Do pass as amended, but first amend, and re-refer to the Committee on [Appropriations]",9,0,0,2,11
1707654,1320410,2023-05-08,Senate,"Placed on suspense file",7,0,0,0,7
1707654,1327957,2023-05-18,Senate,"Do pass",6,0,0,1,7
1707654,1332601,2023-05-24,Senate,"Senate 3rd Reading SB500 McGuire",38,0,0,2,40
1707654,1350243,2023-07-11,Assembly,"Do pass and be re-referred to the Committee on [Appropriations] with recommendation: To Consent Calendar",14,0,0,1,15
1707654,1352924,2023-09-01,Assembly,"Do pass as amended",11,0,0,5,16
1707654,1354226,2023-09-13,Assembly,"SB 500 McGuire Senate Third Reading By Addis",76,0,0,4,80
1707654,1354871,2023-09-14,Senate,"Unfinished Business SB500 McGuire Concurrence",40,0,0,0,40
1707655,1304404,2023-04-18,Senate,"Do pass, but first be re-referred to the Committee on [Environmental Quality]",17,0,0,1,18
1707655,1315769,2023-05-01,Senate,"Placed on suspense file",6,0,0,1,7
1707656,1301028,2023-04-12,Senate,"Do pass as amended, but first amend, and re-refer to the Committee on [Appropriations] with the recommendation: To Consent Calendar",11,0,0,1,12
1707656,1308830,2023-04-24,Senate,"Placed on suspense file",7,0,0,0,7
1707656,1328238,2023-05-18,Senate,"Do pass",7,0,0,0,7
1707656,1333728,2023-05-25,Senate,"Special Consent SB502 Allen",40,0,0,0,40
1707656,1347827,2023-06-27,Assembly,"Do pass as amended and be re-referred to the Committee on [Appropriations]",15,0,0,0,15
1707656,1352684,2023-09-01,Assembly,"Do pass",16,0,0,0,16
1707656,1353637,2023-09-11,Assembly,"SB 502 Allen Senate Third Reading By Wood",80,0,0,0,80
1707656,1354012,2023-09-12,Senate,"Unfinished Business SB502 Allen et al. Concurrence",39,0,0,1,40
1707658,1304432,2023-04-18,Senate,"Do pass as amended, but first amend, and re-refer to the Committee on [Appropriations] with the recommendation: To Consent Calendar",10,0,0,1,11
1707658,1318960,2023-05-04,Senate,"Consent Calendar SB504 Dodd",37,0,0,3,40
1707658,1455789,2024-06-10,Assembly,"Do pass and be re-referred to the Committee on [Appropriations] with recommendation: To Consent Calendar",10,0,0,1,11
1707658,1464540,2024-08-15,Assembly,"Do pass",14,0,0,1,15
1707658,1466560,2024-08-30,Senate,"Special Consent SB504 Dodd",40,0,0,0,40
1707658,1466991,2024-08-28,Assembly,"SB 504 Dodd Senate Third Reading By Friedman",77,0,0,2,79
1707659,1299415,2023-04-12,Senate,"Do pass, but first be re-referred to the Committee on [Appropriations]",7,0,0,0,7
1707659,1320362,2023-05-08,Senate,"Senate 3rd Reading SB505 Rubio",36,0,0,4,40
1707659,1348415,2023-06-28,Assembly,"Do pass and be re-referred to the Committee on [Appropriations] with recommendation: To Consent Calendar",13,0,0,1,14
1707659,1351566,2023-08-16,Assembly,"Do pass. To Consent Calendar",15,0,0,1,16
1707659,1352259,2023-08-24,Assembly,"SB 505 Rubio Consent Calendar Second Day Regular Session",73,0,0,7,80
1707660,1296948,2023-04-10,Senate,"Do pass as amended, but first amend, and re-refer to the Committee on [Transportation]",15,0,0,3,18
1707660,1311662,2023-04-25,Senate,"Do pass, but first be re-referred to the Committee on [Appropriations] with the recommendation: To Consent Calendar",16,0,0,0,16
1707660,1320529,2023-05-08,Senate,"Placed on suspense file",7,0,0,0,7
1707660,1328703,2023-05-18,Senate,"Do pass",7,0,0,0,7
1707660,1333619,2023-05-25,Senate,"Special Consent SB506 Laird",40,0,0,0,40
1707660,1348494,2023-06-28,Assembly,"Do pass and be re-referred to the Committee on [Appropriations] with recommendation: To Consent Calendar",14,0,0,1,15
1707660,1352826,2023-09-01,Assembly,"Do pass",16,0,0,0,16
1707660,1353274,2023-09-06,Assembly,"SB 506 Laird Senate Third Reading By Boerner",78,0,0,2,80
1707661,1280658,2023-03-21,Senate,"Do pass, but first be re-referred to the Committee on [Transportation]",17,0,0,1,18
1707661,1311887,2023-04-25,Senate,"Do pass, but first be re-referred to the Committee on [Appropriations] with the recommendation: To Consent Calendar",16,0,0,0,16
1707661,1320378,2023-05-08,Senate,"Placed on suspense file",7,0,0,0,7
1707662,1296962,2023-04-10,Senate,"Do pass, but first be re-referred to the Committee on [Environmental Quality]",12,0,0,1,13
1707662,1311658,2023-04-26,Senate,"Do pass as amended, but first amend, and re-refer to the Committee on [Appropriations]",5,0,0,2,7
1707662,1333766,2023-05-25,Senate,"Senate 3rd Reading SB508 Laird",36,0,0,4,40
1707662,1345623,2023-06-20,Assembly,"Do pass and be re-referred to the Committee on [Natural Resources]",19,0,0,0,19
1707662,1350772,2023-07-10,Assembly,"Do pass as amended and be re-referred to the Committee on [Appropriations]",8,0,0,3,11
1707663,1305478,2023-04-19,Senate,"Do pass as amended, but first amend, and re-refer to the Committee on [Appropriations]",7,0,0,0,7
1707663,1315765,2023-05-01,Senate,"Placed on suspense file",6,0,0,1,7
1707663,1328419,2023-05-18,Senate,"Do pass",7,0,0,0,7
1707663,1332568,2023-05-24,Senate,"Senate 3rd Reading SB509 Portantino et al",40,0,0,0,40
1707663,1350562,2023-07-12,Assembly,"Do pass as amended and be re-referred to the Committee on [Appropriations]",6,0,0,1,7
1707663,1352503,2023-09-01,Assembly,"Do pass",16,0,0,0,16
1707663,1353598,2023-09-11,Assembly,"SB 509 Portantino Senate Third Reading By Muratsuchi",78,0,0,2,80
1707663,1354102,2023-09-13,Senate,"Unfinished Business SB509 Portantino et al. Concurrence",39,0,0,1,40
1707664,1301045,2023-04-12,Senate,"Do pass, but first be re-referred to the Committee on [Appropriations] with the recommendation: To Consent Calendar",5,0,0,0,5
1707664,1315699,2023-05-01,Senate,"Consent Calendar SB510 Laird",37,0,0,3,40
1707664,1344197,2023-06-14,Assembly,"Do pass and be re-referred to the Committee on [Appropriations]",7,0,0,0,7
1707664,1348444,2023-06-28,Assembly,"Do pass. To Consent Calendar",14,0,0,2,16
1707664,1349526,2023-07-03,Assembly,"SB 510 Laird Consent Calendar Second Day Regular Session",69,0,0,11,80
1707665,1305277,2023-04-19,Senate,"Do pass as amended, but first amend, and re-refer to the Committee on [Appropriations]",7,0,0,0,7
1707665,1315695,2023-05-01,Senate,"Placed on suspense file",6,0,0,1,7
1707665,1328029,2023-05-18,Senate,"Do pass",6,0,0,1,7
1707665,1332580,2023-05-24,Senate,"Senate 3rd Reading SB511 Blakespear",38,0,0,2,40
1707665,1345191,2023-06-19,Assembly,"Do pass and be re-referred to the Committee on [Appropriations] with recommendation: To Consent Calendar",11,0,0,0,11
1707666,1318019,2023-05-03,Senate,"Do pass as amended, but first amend, and re-refer to the Committee on [Appropriations]",4,0,0,4,8
1707666,1318020,2023-05-03,Senate,"[First] hearing set for [05-03-2023]: Failed passage in Committee. Reconsideration granted",7,0,0,1,8
1707666,1322891,2023-05-10,Senate,"Do pass, but first be re-referred to the Committee on [Appropriations]",6,0,0,2,8
1707666,1325012,2023-05-15,Senate,"Placed on suspense file",7,0,0,0,7
1707666,1328842,2023-05-18,Senate,"Do pass",7,0,0,0,7
1707666,1335565,2023-05-30,Senate,"Senate 3rd Reading SB512 Bradford",33,1,0,6,40
1707667,1288360,2023-03-28,Senate,"Do pass, but first be re-referred to the Committee on [Appropriations]",5,0,0,0,5
1707667,1296906,2023-04-10,Senate,"Placed on suspense file",7,0,0,0,7
1707668,1280655,2023-03-21,Senate,"Do pass, but first be re-referred to the Committee on [Appropriations] with the recommendation: To Consent Calendar",5,0,0,0,5
1707668,1296965,2023-04-10,Senate,"Placed on suspense file",7,0,0,0,7
1707668,1327981,2023-05-18,Senate,"Do pass",7,0,0,0,7
1707668,1333590,2023-05-25,Senate,"Special Consent SB514 Archuleta",40,0,0,0,40
1707668,1350168,2023-07-11,Assembly,"Do pass and be re-referred to the Committee on [Appropriations] with recommendation: To Consent Calendar",8,0,0,0,8
1707668,1352978,2023-09-01,Assembly,"Do pass",16,0,0,0,16
1707668,1353930,2023-09-12,Assembly,"SB 514 Archuleta Senate Third Reading By Rodriguez",80,0,0,0,80
1707669,1281870,2023-03-22,Senate,"Do pass, but first be re-referred to the Committee on [Appropriations] with the recommendation: To Consent Calendar",7,0,0,0,7
1707669,1301071,2023-04-13,Senate,"Consent Calendar SB515 Stern et al",36,0,0,4,40
1707669,1348837,2023-06-28,Assembly,"Do pass as amended and be re-referred to the Committee on [Appropriations]",7,0,0,0,7
1707669,1351554,2023-08-16,Assembly,"Do pass. To Consent Calendar",15,0,0,1,16
1707669,1353728,2023-09-12,Assembly,"SB 515 Stern Senate Third Reading By Schiavo",80,0,0,0,80
1707669,1354362,2023-09-13,Senate,"Unfinished Business SB515 Stern et al. Concurrence",39,0,0,1,40
1707670,1305402,2023-04-19,Senate,"Do pass, but first be re-referred to the Committee on [Public Safety]",6,2,0,0,8
1707670,1310269,2023-04-25,Senate,"Do pass as amended, but first amend, and re-refer to the Committee on [Appropriations]",4,1,0,0,5
1707670,1320405,2023-05-08,Senate,"Placed on suspense file",7,0,0,0,7
1707670,1328205,2023-05-18,Senate,"Do pass as amended",5,2,0,0,7
1707670,1332618,2023-05-24,Senate,"Senate 3rd Reading SB516 Skinner",32,8,0,0,40
1707670,1348287,2023-06-26,Assembly,"Do pass as amended and be re-referred to the Committee on [Appropriations]",8,0,0,3,11
1707670,1353043,2023-09-01,Assembly,"Do pass as amended",12,2,0,2,16
1707670,1353509,2023-09-07,Assembly,"SB 516 Skinner Senate Third Reading By Bonta Amend By BONTA Set #1",60,15,0,5,80
1707670,1464617,2024-08-15,Assembly,"Do pass as amended",12,0,0,3,15
1707671,1302591,2023-04-17,Senate,"Do pass, but first be re-referred to the Committee on [Transportation]",13,0,0,0,13
1707671,1311880,2023-04-25,Senate,"Do pass, but first be re-referred to the Committee on [Appropriations] with the recommendation: To Consent Calendar",16,0,0,0,16
1707671,1320366,2023-05-08,Senate,"Placed on suspense file",7,0,0,0,7
1707671,1328625,2023-05-18,Senate,"Do pass",7,0,0,0,7
1707671,1333562,2023-05-25,Senate,"Special Consent SB517 Gonzalez et al",40,0,0,0,40
1707672,1305309,2023-04-18,Senate,"Do pass, but first be re-referred to the Committee on [Appropriations]",7,0,0,0,7
1707672,1315773,2023-05-01,Senate,"Placed on suspense file",6,0,0,1,7
1707672,1328634,2023-05-18,Senate,"Do pass",7,0,0,0,7
1707672,1333675,2023-05-25,Senate,"Special Consent SB518 Wilk",40,0,0,0,40
1707673,1310392,2023-04-25,Senate,"Do pass, but first be re-referred to the Committee on [Governance and Finance]",4,0,0,1,5
1707673,1313499,2023-04-26,Senate,"Do pass, but first be re-referred to the Committee on [Appropriations]",6,0,0,2,8
1707673,1320464,2023-05-08,Senate,"Placed on suspense file",7,0,0,0,7
1707673,1328403,2023-05-18,Senate,"Do pass",5,0,0,2,7
1707673,1333652,2023-05-25,Senate,"Senate 3rd Reading SB519 Atkins et al",32,0,0,8,40
1707673,1350282,2023-07-11,Assembly,"Do pass as amended and be re-referred to the Committee on [Appropriations]",6,2,0,0,8
1707673,1352780,2023-09-01,Assembly,"Do pass",12,4,0,0,16
1707673,1353859,2023-09-12,Assembly,"SB 519 Atkins Senate Third Reading By Weber",57,17,0,6,80
1707673,1354405,2023-09-13,Senate,"Unfinished Business SB519 Atkins et al. Concurrence",31,4,0,5,40
1707674,1318093,2023-05-03,Senate,"Do pass, but first be re-referred to the Committee on [Appropriations] with the recommendation: To Consent Calendar",7,0,0,1,8
1707674,1324931,2023-05-15,Senate,"Placed on suspense file",7,0,0,0,7
1707674,1328748,2023-05-18,Senate,"Do pass",7,0,0,0,7
1707674,1333598,2023-05-25,Senate,"Special Consent SB520 Seyarto",40,0,0,0,40
1707674,1350153,2023-07-10,Assembly,"Do pass and be re-referred to the Committee on [Appropriations]",10,0,0,1,11
1707674,1353015,2023-09-01,Assembly,"Do pass as amended",15,0,0,1,16
1707674,1354162,2023-09-13,Assembly,"SB 520 Seyarto Senate Third Reading By Vince Fong",78,0,0,2,80
1707674,1354843,2023-09-14,Senate,"Unfinished Business SB520 Seyarto Concurrence",40,0,0,0,40
1707675,1304289,2023-04-17,Senate,"Do pass, but first be re-referred to the Committee on [Judiciary]",4,0,0,1,5
1707675,1311821,2023-04-25,Senate,"Do pass, but first be re-referred to the Committee on [Appropriations]",10,0,0,1,11
1707675,1320468,2023-05-08,Senate,"Placed on suspense file",7,0,0,0,7
1707675,1328769,2023-05-18,Senate,"Do pass",7,0,0,0,7
1707675,1333690,2023-05-25,Senate,"Special Consent SB521 Smallwood-Cuevas et",40,0,0,0,40
1707675,1350298,2023-07-11,Assembly,"Do pass and be re-referred to the Committee on [Appropriations] with recommendation: To Consent Calendar",7,0,0,1,8
1707675,1352890,2023-09-01,Assembly,"Do pass",16,0,0,0,16
1707675,1353660,2023-09-11,Assembly,"SB 521 Smallwood-Cuevas Senate Third Reading By Jackson",80,0,0,0,80
1707675,1353837,2023-09-12,Senate,"Unfinished Business SB521 Smallwood-Cuevas et Concurrence",39,0,0,1,40
1707676,1299344,2023-04-11,Senate,"Do pass as amended, and be ordered to the Consent Calendar",10,0,0,1,11
1707676,1306766,2023-04-20,Senate,"Consent Calendar SB522 Niello",36,0,0,4,40
1707676,1343703,2023-06-13,Assembly,"Do pass. To Consent Calendar",11,0,0,0,11
1707676,1345189,2023-06-19,Assembly,"SB 522 Niello Consent Calendar Second Day",73,0,0,7,80
1707678,1302638,2023-04-17,Senate,"Do pass, but first be re-referred to the Committee on [Health]",10,2,0,1,13
1707678,1313514,2023-04-26,Senate,"Do pass as amended, but first amend, and re-refer to the Committee on [Appropriations]",9,0,0,3,12
1707678,1325004,2023-05-15,Senate,"Placed on suspense file",7,0,0,0,7
1707679,1301060,2023-04-12,Senate,"Do pass as amended, but first amend, and re-refer to the Committee on [Appropriations]",4,1,0,0,5
1707679,1315664,2023-05-01,Senate,"Placed on suspense file",6,0,0,1,7
1707679,1328138,2023-05-18,Senate,"Do pass",4,2,0,1,7
1707679,1336368,2023-05-31,Senate,"Senate 3rd Reading SB525 Durazo et al",21,11,0,8,40
1707679,1350620,2023-07-12,Assembly,"Do pass and be re-referred to the Committee on [Appropriations]",5,2,0,0,7
1707679,1352757,2023-09-01,Assembly,"Do pass",11,4,0,1,16
1707679,1354815,2023-09-14,Senate,"Unfinished Business SB525 Durazo et al. Concurrence",31,9,0,0,40
1707679,1354816,2023-09-14,Assembly,"SB 525 Durazo Senate Third Reading By Haney",63,13,0,4,80
1707680,1311654,2023-04-26,Senate,"Do pass as amended, but first amend, and re-refer to the Committee on [Appropriations]",5,0,0,0,5
1707680,1320516,2023-05-08,Senate,"Placed on suspense file",7,0,0,0,7
1707681,1310275,2023-04-24,Senate,"Do pass as amended, but first amend, and re-refer to the Committee on [Appropriations]",14,3,0,1,18
1707681,1325000,2023-05-15,Senate,"Placed on suspense file",7,0,0,0,7
1707682,1299395,2023-04-12,Senate,"Do pass, but first be re-referred to the Committee on [Appropriations] with the recommendation: To Consent Calendar",7,0,0,0,7
1707682,1315756,2023-05-01,Senate,"Consent Calendar SB528 Rubio",37,0,0,3,40
1707683,1296942,2023-04-10,Senate,"Do pass as amended, but first amend, and re-refer to the Committee on [Transportation]",15,0,0,3,18
1707683,1311787,2023-04-25,Senate,"Do pass, but first be re-referred to the Committee on [Appropriations]",14,0,0,2,16
1707683,1320521,2023-05-08,Senate,"Placed on suspense file",7,0,0,0,7
1707684,1298297,2023-04-11,Senate,"Do pass, but first be re-referred to the Committee on [Appropriations] with the recommendation: To Consent Calendar",5,0,0,0,5
1707684,1315678,2023-05-01,Senate,"Placed on suspense file",6,0,0,1,7
1707685,1281797,2023-03-22,Senate,"Do pass, but first be re-referred to the Committee on [Banking and Financial Institutions] with the recommendation: To Consent Calendar",7,0,0,0,7
1707685,1305243,2023-04-19,Senate,"Do pass, but first be re-referred to the Committee on [Appropriations]",7,0,0,0,7
1707685,1330074,2023-05-22,Senate,"Senate 3rd Reading SB531 Ochoa Bogh",40,0,0,0,40
1707685,1350449,2023-07-12,Assembly,"Do pass as amended, and be re-referred to the Committee on [Appropriations] with recommendation: To Consent Calendar",7,0,0,0,7
1707685,1352584,2023-09-01,Assembly,"Do pass",16,0,0,0,16
1707685,1353644,2023-09-11,Assembly,"SB 531 Ochoa Bogh Third Reading Urgency By Megan Dahle",78,0,0,2,80
1707685,1354270,2023-09-13,Senate,"That the Assembly amendments be concurred in",4,0,0,3,7
1707685,1354560,2023-09-14,Senate,"Unfinished Business SB531 Ochoa Bogh Urgency Clause Concurrence",40,0,0,0,40
1707686,1299363,2023-04-12,Senate,"Do pass as amended, but first amend, and re-refer to the Committee on [Elections and Constitutional Amendments]",5,1,0,2,8
1707686,1305332,2023-04-18,Senate,"Do pass as amended, but first amend, and re-refer to the Committee on [Appropriations]",6,1,0,0,7
1707686,1320552,2023-05-08,Senate,"Placed on suspense file",7,0,0,0,7
1707686,1328438,2023-05-18,Senate,"Do pass as amended",5,2,0,0,7
1707686,1336327,2023-05-31,Senate,"Senate 3rd Reading SB532 Wiener et al",34,3,0,3,40
1707686,1349596,2023-07-05,Assembly,"Do pass and be re-referred to the Committee on [Appropriations]",10,4,0,1,15
1707686,1462248,2024-07-01,Assembly,"Do pass and be re-referred to the Committee on [Privacy and Consumer Protection]",12,3,0,0,15
1707686,1462655,2024-07-02,Assembly,"Do pass as amended",11,0,0,0,11
1707686,1465584,2024-08-26,Assembly,"SB 532 Wiener Senate Third Reading By Ting",65,6,0,8,79
1707686,1466067,2024-08-28,Senate,"That the Assembly amendments be concurred in",11,0,0,4,15
1707686,1466142,2024-08-29,Senate,"Unfinished Business SB532 Wiener Concurrence",34,5,0,1,40
1707687,1318012,2023-05-03,Senate,"Do pass as amended, but first amend, and re-refer to the Committee on [Appropriations]",7,0,0,1,8
1707687,1364750,2024-01-16,Senate,"Placed on suspense file",6,0,0,1,7
1707688,1311860,2023-04-26,Senate,"Do pass as amended, but first amend, and re-refer to the Committee on [Appropriations]",4,0,0,1,5
1707688,1324994,2023-05-15,Senate,"Placed on suspense file",7,0,0,0,7
1707688,1328260,2023-05-18,Senate,"Do pass as amended",5,2,0,0,7
1707688,1332626,2023-05-24,Senate,"Senate 3rd Reading SB534 Padilla",32,6,0,2,40
1707688,1344215,2023-06-14,Assembly,"Do pass and be re-referred to the Committee on [Appropriations]",6,0,0,1,7
1707690,1363753,2024-01-09,Senate,"Do pass, but first be re-referred to the Committee on [Environmental Quality] with the recommendation: To Consent Calendar",15,0,0,0,15
1707690,1367517,2024-01-22,Senate,"Senate 3rd Reading SB536 Rubio",39,0,0,1,40
1707690,1462303,2024-07-02,Assembly,"Do pass and be re-referred to the Committee on [Appropriations] with recommendation: To Consent Calendar",21,0,0,1,22
1707690,1464048,2024-08-15,Assembly,"Do pass",14,0,0,1,15
1707690,1465774,2024-08-26,Assembly,"SB 536 Rubio Senate Third Reading By Rodriguez",76,0,0,3,79
1707690,1466053,2024-08-28,Senate,"That the Assembly amendments be concurred in",14,0,0,1,15
1707690,1466424,2024-08-30,Senate,"Special Consent SB536 Rubio et al",40,0,0,0,40
1707691,1305346,2023-04-19,Senate,"Do pass as amended, but first amend, and re-refer to the Committee on [Judiciary]",6,2,0,0,8
1707691,1317083,2023-05-02,Senate,"Do pass",9,2,0,0,11
1707691,1335503,2023-05-30,Senate,"Senate 3rd Reading SB537 Becker Urgency Clause",32,8,0,0,40
1707691,1350443,2023-07-12,Assembly,"Do pass as amended",6,1,0,1,8
1707691,1463957,2024-08-14,Assembly,"Do pass",18,0,0,4,22
1707691,1466094,2024-08-29,Senate,"That the Assembly amendments be concurred in",13,0,0,2,15
1707691,1466456,2024-08-30,Senate,"Unfinished Business SB537 Becker et al. Concurrence",40,0,0,0,40
1707691,1467000,2024-08-28,Assembly,"SB 537 Becker Senate Third Reading By Calderon",77,0,0,2,79
1707692,1311718,2023-04-25,Senate,"Do pass, but first be re-referred to the Committee on [Appropriations]",12,3,0,1,16
1707692,1330110,2023-05-22,Senate,"Senate 3rd Reading SB538 Portantino",31,5,0,4,40
1707692,1349597,2023-07-05,Assembly,"Do pass and be re-referred to the Committee on [Appropriations]",13,0,0,2,15
1707692,1352903,2023-09-01,Assembly,"Do pass",12,3,0,1,16
1707692,1353352,2023-09-07,Assembly,"SB 538 Portantino Senate Third Reading By Bryan",66,6,0,8,80
1707693,1286952,2023-03-28,Senate,"Do pass as amended, but first amend, and re-refer to the Committee on [Appropriations] with the recommendation: To Consent Calendar",10,0,0,1,11
1707693,1302643,2023-04-17,Senate,"Placed on suspense file",6,0,0,1,7
1707693,1328620,2023-05-18,Senate,"Do pass",7,0,0,0,7
1707693,1333602,2023-05-25,Senate,"Special Consent SB539 Stern",40,0,0,0,40
1707693,1347497,2023-06-26,Assembly,"Do pass and be re-referred to the Committee on [Appropriations] with recommendation: To Consent Calendar",11,0,0,0,11
1707693,1353020,2023-09-01,Assembly,"Do pass",16,0,0,0,16
1707693,1354184,2023-09-13,Assembly,"SB 539 Stern Senate Third Reading By Friedman",79,0,0,1,80
1707693,1354739,2023-09-14,Senate,"Unfinished Business SB539 Stern Concurrence",40,0,0,0,40
1707694,1296894,2023-04-10,Senate,"Do pass, but first be re-referred to the Committee on [Appropriations]",13,0,0,0,13
1707694,1308815,2023-04-24,Senate,"Placed on suspense file",7,0,0,0,7
1707694,1328469,2023-05-18,Senate,"Do pass",7,0,0,0,7
1707694,1333597,2023-05-25,Senate,"Special Consent SB540 Laird",40,0,0,0,40
1707694,1347953,2023-06-27,Assembly,"Do pass as amended and be re-referred to the Committee on [Appropriations]",18,0,0,1,19
1707694,1352944,2023-09-01,Assembly,"Do pass",16,0,0,0,16
1707694,1353261,2023-09-06,Assembly,"SB 540 Laird Senate Third Reading By Berman",79,0,0,1,80
1707694,1353397,2023-09-07,Senate,"Unfinished Business SB540 Laird Concurrence",40,0,0,0,40
1707695,1288369,2023-03-29,Senate,"Do pass as amended, but first amend, and re-refer to the Committee on [Health]",5,2,0,0,7
1707695,1301066,2023-04-12,Senate,"Do pass, but first be re-referred to the Committee on [Appropriations]",10,1,0,1,12
1707695,1308866,2023-04-24,Senate,"Placed on suspense file",7,0,0,0,7
1707695,1328175,2023-05-18,Senate,"Do pass as amended",5,2,0,0,7
1707695,1336383,2023-05-31,Senate,"Senate 3rd Reading SB541 Menjivar et al",31,8,0,1,40
1707695,1336384,2023-05-31,Senate,"Senate 3rd Reading SB541 Menjivar et al. Reconsider",40,0,0,0,40
1707695,1336385,2023-05-31,Senate,"Senate 3rd Reading SB541 Menjivar et al",31,9,0,0,40
1707695,1348885,2023-06-28,Assembly,"Do pass as amended and be re-referred to the Committee on [Health]",5,1,0,1,7
1707695,1350227,2023-07-11,Assembly,"Do pass and be re-referred to the Committee on [Appropriations]",12,3,0,0,15
1707695,1352520,2023-09-01,Assembly,"Do pass as amended",11,4,0,1,16
1707695,1353444,2023-09-07,Assembly,"SB 541 Menjivar Senate Third Reading By Wilson",65,11,0,4,80
1707695,1354627,2023-09-11,Senate,"Unfinished Business SB541 Menjivar et al. Concurrence",30,9,0,1,40
1707696,1350615,2023-07-13,Senate,"Senate 3rd Reading SCR28 Seyarto et al",37,0,0,3,40
1707696,1351524,2023-08-14,Assembly,"Be adopted. To Consent Calendar",12,0,0,1,13
1707696,1351705,2023-08-17,Assembly,"SCR 28 Seyarto Consent Calendar Second Day Regular Session",75,0,0,5,80
1707697,1315679,2023-05-01,Senate,"Senate 3rd Reading SR15 Seyarto Motions",37,0,0,3,40
1709700,1302604,2023-04-17,Assembly,"Do pass and be re-referred to the Committee on [Local Government]",8,3,0,0,11
1709700,1313371,2023-04-26,Assembly,"Do pass as amended and be re-referred to the Committee on [Appropriations]",2,1,0,5,8
1709700,1313372,2023-04-26,Assembly,Reconsideration,8,0,0,0,8
1709701,1298243,2023-04-11,Assembly,"Do pass as amended and be re-referred to the Committee on [Appropriations]",11,2,0,2,15
1709701,1328324,2023-05-18,Assembly,"Do pass",11,4,0,1,16
1709701,1338080,2023-05-31,Assembly,"AB 1001 Haney Assembly Third Reading",61,14,0,5,80
1709702,1310189,2023-04-24,Assembly,"Do pass and be re-referred to the Committee on [Appropriations]",10,0,0,1,11
1709702,1328726,2023-05-18,Assembly,"Do pass",13,0,0,3,16
1709702,1335443,2023-05-30,Assembly,"AB 1002 Irwin Assembly Third Reading",79,0,0,1,80
1709702,1348410,2023-06-28,Senate,"Do pass, but first be re-referred to the Committee on [Appropriations] with the recommendation: To Consent Calendar",8,0,0,0,8
1709702,1349969,2023-07-10,Senate,"Placed on suspense file",6,0,0,1,7
1709702,1352612,2023-09-01,Senate,"Do pass as amended",5,0,0,2,7
1709702,1353855,2023-09-12,Senate,"Assembly 3rd Reading AB1002 Irwin et al. By Blakespear",36,0,0,4,40
1709702,1354084,2023-09-13,Assembly,"AB 1002 Irwin Concurrence in Senate Amendments",78,0,0,2,80
1709704,1305458,2023-04-19,Assembly,"Do pass as amended and be re-referred to the Committee on [Appropriations]",8,0,0,0,8
1709705,1310205,2023-04-25,Assembly,"Do pass and be re-referred to the Committee on [Appropriations]",7,0,0,1,8
1709705,1328844,2023-05-18,Assembly,"Do pass as amended",12,0,0,4,16
1709705,1335496,2023-05-30,Assembly,"AB 1005 Alvarez Assembly Third Reading",80,0,0,0,80
1709705,1345626,2023-06-19,Senate,"Do pass, but first be re-referred to the Committee on [Health]",5,0,0,0,5
1709705,1349813,2023-07-05,Senate,"Do pass, but first be re-referred to the Committee on [Appropriations] with the recommendation: To Consent Calendar",12,0,0,0,12
1709705,1351337,2023-08-14,Senate,"Placed on suspense file",7,0,0,0,7
1709705,1464205,2024-08-15,Senate,"Do pass",7,0,0,0,7
1709705,1466002,2024-08-27,Senate,"Assembly 3rd Reading AB1005 Alvarez By Lim√≥n",40,0,0,0,40
1709705,1466708,2024-08-28,Assembly,"AB 1005 Alvarez Concurrence in Senate Amendments",77,0,0,2,79
1709706,1311900,2023-04-25,Assembly,"Do pass as amended and be re-referred to the Committee on [Appropriations]",7,0,0,1,8
1709706,1328282,2023-05-18,Assembly,"Do pass",15,0,0,1,16
1709706,1335597,2023-05-30,Assembly,"AB 1006 McKinnor Assembly Third Reading",80,0,0,0,80
1709706,1345681,2023-06-19,Senate,"Do pass, but first be re-referred to the Committee on [Appropriations]",5,0,0,0,5
1709706,1349491,2023-07-03,Senate,"Placed on suspense file",7,0,0,0,7
1709707,1281823,2023-03-22,Assembly,"Do pass and be re-referred to the Committee on [Appropriations]",5,2,0,0,7
1709707,1328259,2023-05-18,Assembly,"Do pass",11,4,0,1,16
1709707,1338057,2023-05-31,Assembly,"AB 1007 Ortega Assembly Third Reading",61,16,0,3,80
1709707,1348476,2023-06-28,Senate,"Do pass as amended, but first amend, and re-refer to the Committee on [Appropriations]",4,0,0,1,5
1709707,1349935,2023-07-10,Senate,"Placed on suspense file",6,0,0,1,7
1709707,1352553,2023-09-01,Senate,"Do pass",5,2,0,0,7
1709707,1353820,2023-09-12,Senate,"Assembly 3rd Reading AB1007 Ortega By Laird",28,8,0,4,40
1709707,1354268,2023-09-13,Assembly,"AB 1007 Ortega Concurrence in Senate Amendments",62,16,0,2,80
1709708,1308814,2023-04-24,Assembly,"Do pass and be re-referred to the Committee on [Appropriations]",11,0,0,4,15
1709708,1328667,2023-05-18,Assembly,"Do pass",11,3,0,2,16
1709708,1338140,2023-05-31,Assembly,"AB 1008 Bauer-Kahan Assembly Third Reading",61,15,0,4,80
1709708,1462556,2024-07-02,Senate,"Do pass as amended, but first amend, and re-refer to the Committee on [Appropriations]",9,2,0,0,11
1709708,1466443,2024-08-30,Senate,"Assembly 3rd Reading AB1008 Bauer-Kahan By Umberg",29,9,0,2,40
1709708,1466977,2024-08-31,Assembly,"AB 1008 Bauer-Kahan Concurrence in Senate Amendments",55,15,0,9,79
1709711,1311729,2023-04-25,Assembly,"Do pass as amended and be re-referred to the Committee on [Appropriations]",11,0,0,0,11
1709711,1326922,2023-05-17,Assembly,"Do pass",15,0,0,1,16
1709711,1330038,2023-05-22,Assembly,"AB 1011 Weber Assembly Third Reading",74,0,0,6,80
1709711,1348392,2023-06-27,Senate,"Do pass as amended, but first amend, and re-refer to the Committee on [Appropriations]",11,0,0,0,11
1709711,1351842,2023-08-21,Senate,"Placed on suspense file",7,0,0,0,7
1709712,1310246,2023-04-24,Assembly,"Do pass as amended and be re-referred to the Committee on [Appropriations]",12,0,0,3,15
1709713,1299388,2023-04-12,Assembly,"Do pass as amended and be re-referred to the Committee on [Appropriations]",19,0,0,3,22
1709713,1318053,2023-05-03,Assembly,"Do pass",16,0,0,0,16
1709713,1330100,2023-05-22,Assembly,"AB 1013 Lowenthal Assembly Third Reading",76,0,0,4,80
1709713,1347832,2023-06-27,Senate,"Do pass as amended, but first amend, and re-refer to the Committee on [Judiciary]",15,0,0,0,15
1709713,1349787,2023-07-06,Senate,"Do pass, but first be re-referred to the Committee on [Appropriations] with the recommendation: To Consent Calendar",11,0,0,0,11
1709713,1351703,2023-08-17,Senate,"Consent Calendar 2nd AB1013 Lowenthal et al",38,0,0,2,40
1709713,1353084,2023-09-01,Assembly,"AB 1013 Lowenthal Concurrence in Senate Amendments",74,0,0,6,80
1709715,1304343,2023-04-18,Assembly,"Do pass and be re-referred to the Committee on [Appropriations]",7,0,0,1,8
1709715,1328449,2023-05-18,Assembly,"Do pass as amended",11,0,0,5,16
1709715,1335525,2023-05-30,Assembly,"AB 1015 Calderon Assembly Third Reading",80,0,0,0,80
1709715,1345581,2023-06-19,Senate,"Do pass, but first be re-referred to the Committee on [Appropriations]",5,0,0,0,5
1709715,1349447,2023-07-03,Senate,"Placed on suspense file",7,0,0,0,7
1709715,1352847,2023-09-01,Senate,"Do pass as amended",5,0,0,2,7
1709715,1353482,2023-09-07,Senate,"Assembly 3rd Reading AB1015 Calderon et al. By Lim√≥n",40,0,0,0,40
1709715,1353483,2023-09-07,Senate,"Assembly 3rd Reading AB1015 Calderon et al. By Lim√≥n Motion To Reconsider",40,0,0,0,40
1709715,1354217,2023-09-13,Senate,"Assembly 3rd Reading AB1015 Calderon et al. By Lim√≥n",39,0,0,1,40
1709715,1354578,2023-09-14,Assembly,"AB 1015 Calderon Concurrence in Senate Amendments",80,0,0,0,80
1709716,1288182,2023-03-29,Assembly,"Do pass and be re-referred to the Committee on [Privacy and Consumer Protection]",11,0,0,0,11
1709716,1311938,2023-04-25,Assembly,"Do pass and be re-referred to the Committee on [Appropriations]",10,0,0,1,11
1709716,1328119,2023-05-18,Assembly,"Do pass",14,0,0,2,16
1709716,1335487,2023-05-30,Assembly,"AB 1016 Jones-Sawyer Assembly Third Reading",72,0,0,8,80
1709716,1346248,2023-06-21,Senate,"Do pass as amended, but first amend, and re-refer to the Committee on [Agriculture]",6,0,0,1,7
1709716,1349463,2023-07-03,Senate,"Do pass, but first be re-referred to the Committee on [Appropriations]",3,0,0,1,4
1709716,1351416,2023-08-14,Senate,"Placed on suspense file",7,0,0,0,7
1709716,1353001,2023-09-01,Senate,"Do pass",7,0,0,0,7
1709716,1353327,2023-09-06,Senate,"Assembly 3rd Reading AB1016 Jones-Sawyer et al. By Caballero",40,0,0,0,40
1709716,1353615,2023-09-11,Assembly,"AB 1016 Jones-Sawyer Concurrence in Senate Amendments",75,0,0,5,80
1709717,1280625,2023-03-20,Assembly,"Do pass and be re-referred to the Committee on [Appropriations] with recommendation: To Consent Calendar",15,0,0,0,15
1709717,1305410,2023-04-19,Assembly,"Do pass. To Consent Calendar",14,0,0,2,16
1709717,1313353,2023-04-27,Assembly,"AB 1017 Friedman Consent Calendar Second Day Regular Session",79,0,0,1,80
1709717,1343691,2023-06-13,Senate,"Do pass, but first be re-referred to the Committee on [Appropriations] with the recommendation: To Consent Calendar",16,0,0,0,16
1709720,1299382,2023-04-12,Assembly,"Do pass",7,0,0,0,7
1709720,1306729,2023-04-20,Assembly,"AB 1020 Grayson Assembly Third Reading",76,0,0,4,80
1709720,1344210,2023-06-14,Senate,"Do pass",5,0,0,0,5
1709720,1353211,2023-09-06,Senate,"Assembly 3rd Reading AB1020 Grayson By Laird",40,0,0,0,40
1709720,1353465,2023-09-07,Assembly,"AB 1020 Grayson Concurrence in Senate Amendments",79,0,0,1,80
1709721,1298286,2023-04-11,Assembly,"Do pass as amended and be re-referred to the Committee on [Appropriations]",13,1,0,4,18
1709721,1311653,2023-04-26,Assembly,"Do pass",13,0,0,3,16
1709721,1324937,2023-05-15,Assembly,"AB 1021 Wicks Assembly Third Reading",69,1,0,10,80
1709721,1343126,2023-06-12,Senate,"Do pass, but first be re-referred to the Committee on [Public Safety]",9,0,0,4,13
1709721,1345676,2023-06-20,Senate,"Do pass, but first be re-referred to the Committee on [Appropriations]",5,0,0,0,5
1709721,1353147,2023-09-05,Senate,"Assembly 3rd Reading AB1021 Wicks et al. By Ashby",35,2,0,3,40
1709721,1353503,2023-09-07,Assembly,"AB 1021 Wicks Concurrence in Senate Amendments",69,0,0,11,80
1709723,1304424,2023-04-17,Assembly,"Do pass and be re-referred to the Committee on [Education] with recommendation: To Consent Calendar",7,0,0,0,7
1709723,1313425,2023-04-26,Assembly,"Do pass and be re-referred to the Committee on [Appropriations] with recommendation: To Consent Calendar",7,0,0,0,7
1709723,1322928,2023-05-10,Assembly,"Do pass. To Consent Calendar",14,0,0,2,16
1709723,1328193,2023-05-18,Assembly,"AB 1023 Papan Consent Calendar Second Day Regular Session",74,0,0,6,80
1709723,1347823,2023-06-27,Senate,"Do pass, but first be re-referred to the Committee on [Appropriations]",15,0,0,0,15
1709723,1353305,2023-09-06,Senate,"Assembly 3rd Reading AB1023 Papan By Smallwood-Cuevas",40,0,0,0,40
1709724,1305213,2023-04-18,Assembly,"Do pass and be re-referred to the Committee on [Appropriations] with recommendation: To Consent Calendar",15,0,0,0,15
1709724,1328011,2023-05-18,Assembly,"Do pass as amended",11,0,0,5,16
1709724,1335526,2023-05-30,Assembly,"AB 1024 Aguiar-Curry Assembly Third Reading",79,0,0,1,80
1709724,1347885,2023-06-27,Senate,"Do pass, but first be re-referred to the Committee on [Appropriations] with the recommendation: To Consent Calendar",11,0,0,0,11
1709724,1351817,2023-08-21,Senate,"Placed on suspense file",7,0,0,0,7
1709725,1288219,2023-03-29,Assembly,"Do pass and be re-referred to the Committee on [Appropriations]",8,0,0,0,8
1709725,1328516,2023-05-18,Assembly,"Do pass",15,0,0,1,16
1709725,1337987,2023-05-31,Assembly,"AB 1025 Dixon Assembly Third Reading",79,0,0,1,80
1709725,1348309,2023-06-28,Senate,"Do pass, but first be re-referred to the Committee on [Judiciary] with the recommendation: To Consent Calendar",8,0,0,0,8
1709725,1349742,2023-07-06,Senate,"Do pass, but first be re-referred to the Committee on [Appropriations] with the recommendation: To Consent Calendar",11,0,0,0,11
1709725,1351273,2023-08-14,Senate,"Placed on suspense file",7,0,0,0,7
1709725,1352908,2023-09-01,Senate,"Do pass",7,0,0,0,7
1709725,1353906,2023-09-12,Senate,"Special Consent AB1025 Dixon",39,0,0,1,40
1709727,1298274,2023-04-11,Assembly,"Do pass and be re-referred to the Committee on [Privacy and Consumer Protection]",9,0,0,2,11
1709727,1311797,2023-04-25,Assembly,"Do pass as amended and be re-referred to the Committee on [Appropriations]",11,0,0,0,11
1709727,1322899,2023-05-10,Assembly,"Do pass",15,0,0,1,16
1709727,1330073,2023-05-22,Assembly,"AB 1027 Petrie-Norris Assembly Third Reading",77,0,0,3,80
1709727,1349737,2023-07-06,Senate,"Do pass, but first be re-referred to the Committee on [Public Safety]",11,0,0,0,11
1709727,1350290,2023-07-11,Senate,"Do pass as amended, but first amend, and re-refer to the Committee on [Appropriations]",4,0,0,1,5
1709727,1353145,2023-09-05,Senate,"Assembly 3rd Reading AB1027 Petrie-Norris By Umberg",37,0,0,3,40
1709727,1353611,2023-09-11,Assembly,"AB 1027 Petrie-Norris Concurrence in Senate Amendments",80,0,0,0,80
1709728,1286904,2023-03-28,Assembly,"Do pass and be re-referred to the Committee on [Appropriations]",6,2,0,0,8
1709728,1305464,2023-04-19,Assembly,"Do pass",10,4,0,2,16
1709728,1338149,2023-05-31,Assembly,"AB 1028 McKinnor Assembly Third Reading",45,17,0,18,80
1709728,1350299,2023-07-11,Senate,"Do pass, but first be re-referred to the Committee on [Appropriations]",3,1,0,1,5
1709728,1352339,2023-08-28,Senate,"Placed on suspense file",7,0,0,0,7
1709729,1298175,2023-04-11,Assembly,"Do pass as amended. To Consent Calendar",11,0,0,0,11
1709729,1306715,2023-04-20,Assembly,"AB 1029 Pellerin Consent Calendar Second Day",76,0,0,4,80
1709729,1350551,2023-07-11,Senate,"Do pass and be ordered to the Consent Calendar",11,0,0,0,11
1709729,1351658,2023-08-17,Senate,"Consent Calendar 2nd AB1029 Pellerin",38,0,0,2,40
1709729,1352225,2023-08-24,Assembly,"AB 1029 Pellerin Concurrence in Senate Amendments",76,0,0,4,80
1709732,1299376,2023-04-12,Assembly,"Do pass and be re-referred to the Committee on [Appropriations]",5,2,0,0,7
1709732,1328358,2023-05-18,Assembly,"Do pass",11,4,0,1,16
1709732,1335554,2023-05-30,Assembly,"AB 1032 Pacheco Assembly Third Reading",61,16,0,3,80
1709732,1350555,2023-07-11,Senate,"Do pass as amended, but first amend, and re-refer to the Committee on [Appropriations]",9,2,0,0,11
1709732,1351400,2023-08-14,Senate,"Placed on suspense file",7,0,0,0,7
1709732,1352739,2023-09-01,Senate,"Do pass as amended",5,2,0,0,7
1709732,1354382,2023-09-13,Senate,"Assembly 3rd Reading AB1032 Pacheco et al. By Umberg",31,8,0,1,40
1709732,1354751,2023-09-14,Assembly,"AB 1032 Pacheco Concurrence in Senate Amendments",65,15,0,0,80
1709733,1305386,2023-04-19,Assembly,"Do pass as amended and be re-referred to the Committee on [Local Government]",6,1,0,1,8
1709733,1313433,2023-04-26,Assembly,"Do pass as amended and be re-referred to the Committee on [Appropriations]",5,2,0,1,8
1709733,1326964,2023-05-17,Assembly,"Do pass",12,4,0,0,16
1709733,1338185,2023-05-31,Assembly,"AB 1033 Ting Assembly Third Reading",50,16,0,14,80
1709733,1346156,2023-06-20,Senate,"Do pass, but first be re-referred to the Committee on [Governance and Finance]",8,1,0,2,11
1709733,1349756,2023-07-05,Senate,"Do pass, but first be re-referred to the Committee on [Appropriations]",5,2,0,1,8
1709733,1353191,2023-09-05,Senate,"Assembly 3rd Reading AB1033 Ting By Blakespear",21,14,0,5,40
1709733,1353678,2023-09-11,Assembly,"AB 1033 Ting Concurrence in Senate Amendments",49,17,0,14,80
1709734,1286981,2023-03-28,Assembly,"Do pass and be re-referred to the Committee on [Privacy and Consumer Protection]",6,2,0,0,8
1709734,1311937,2023-04-25,Assembly,"Do pass as amended",7,2,0,2,11
1709734,1325016,2023-05-15,Assembly,"AB 1034 Wilson Assembly Third Reading",41,17,0,22,80
1709734,1345607,2023-06-20,Senate,"Do pass",4,1,0,0,5
1709734,1466028,2024-08-27,Senate,"Do pass, but first be re-referred to the Committee on [Appropriations]",5,0,0,0,5
1709734,1466068,2024-08-28,Senate,"Do pass",5,2,0,0,7
1709734,1466403,2024-08-30,Assembly,"With recommendation: That Senate amendments be concurred in",7,0,0,0,7
1709734,1466404,2024-08-30,Senate,"Assembly 3rd Reading AB1034 Grayson et al. By Cortese",32,7,0,1,40
1709734,1466955,2024-08-31,Assembly,"AB 1034 Grayson Concurrence in Senate Amendments",77,0,0,2,79
1709737,1305504,2023-04-19,Assembly,"Do pass and be re-referred to the Committee on [Appropriations]",6,2,0,0,8
1709737,1322911,2023-05-10,Assembly,"Do pass",12,3,0,1,16
1709737,1330050,2023-05-22,Assembly,"AB 1037 Berman Assembly Third Reading",61,16,0,3,80
1709737,1345686,2023-06-20,Senate,"Do pass, but first be re-referred to the Committee on [Appropriations]",6,1,0,0,7
1709737,1353903,2023-09-12,Assembly,"AB 1037 Berman Concurrence in Senate Amendments",62,18,0,0,80
1709737,1354575,2023-09-11,Senate,"Assembly 3rd Reading AB1037 Berman et al. By Newman",31,8,0,1,40
1709738,1286903,2023-03-28,Assembly,"Do pass and be re-referred to the Committee on [Education] with recommendation: To Consent Calendar",8,0,0,0,8
1709738,1313488,2023-04-26,Assembly,"Do pass and be re-referred to the Committee on [Appropriations] with recommendation: To Consent Calendar",7,0,0,0,7
1709738,1326960,2023-05-17,Assembly,"Do pass. To Consent Calendar",15,0,0,1,16
1709738,1333804,2023-05-25,Assembly,"AB 1038 Reyes Consent Calendar Second Day Regular Session",76,0,0,4,80
1709738,1349609,2023-07-03,Senate,"Do pass, but first be re-referred to the Committee on [Education] with the recommendation: To Consent Calendar",5,0,0,0,5
1709738,1350547,2023-07-12,Senate,"Do pass as amended, but first amend, and re-refer to the Committee on [Appropriations]",7,0,0,0,7
1709738,1351346,2023-08-14,Senate,"Placed on suspense file",7,0,0,0,7
1709738,1352573,2023-09-01,Senate,"Do pass",7,0,0,0,7
1709738,1465388,2024-08-20,Senate,"Do pass, but first be re-referred to the Committee on [Appropriations]",12,0,0,3,15
1709738,1466462,2024-08-30,Assembly,"With recommendation: That Senate amendments be concurred in",9,0,0,0,9
1709738,1466463,2024-08-30,Assembly,"AB 1038 Mike Fong Concurrence - Urgency Added",73,0,0,6,79
1709738,1467018,2024-08-28,Senate,"Assembly 3rd Reading AB1038 Mike Fong et al. By Portantino Urgency Clause",34,1,0,5,40
1709739,1363750,2024-01-09,Assembly,"Do pass and be re-referred to the Committee on [Appropriations]",8,0,0,0,8
1709742,1305318,2023-04-18,Assembly,"Do pass and be re-referred to the Committee on [Appropriations]",7,2,0,0,9
1709742,1328241,2023-05-18,Assembly,"Do pass",11,4,0,1,16
1709742,1335594,2023-05-30,Assembly,"AB 1042 Bauer-Kahan Assembly Third Reading",53,19,0,8,80
1709742,1348298,2023-06-28,Senate,"Do pass, but first be re-referred to the Committee on [Agriculture]",4,2,0,1,7
1709742,1458236,2024-06-18,Senate,"Do pass as amended, but first amend, and re-refer to the Committee on [Environmental Quality]",3,0,0,2,5
1709742,1462644,2024-07-03,Senate,"Do pass as amended, but first amend, and re-refer to the Committee on [Appropriations]",4,0,0,3,7
1709742,1467138,2024-08-31,Senate,"Assembly 3rd Reading AB1042 Bauer-Kahan et al. By Allen",32,8,0,0,40
1709742,1467139,2024-08-31,Assembly,"AB 1042 Bauer-Kahan Concurrence in Senate Amendments",50,17,0,12,79
1709743,1286887,2023-03-28,Assembly,"Do pass as amended. To Consent Calendar",9,0,0,2,11
1709743,1302673,2023-04-17,Assembly,"AB 1043 Essayli Consent Calendar Second Day",79,0,0,1,80
1709743,1348297,2023-06-27,Senate,"Do pass and be ordered to the Consent Calendar",11,0,0,0,11
1709743,1349805,2023-07-06,Senate,"Consent Calendar AB1043 Essayli",40,0,0,0,40
1709743,1353969,2023-09-12,Senate,"Assembly 3rd Reading AB1043 Essayli By Wilk",32,3,0,5,40
1709743,1354779,2023-09-14,Assembly,"AB 1043 Essayli Concurrence in Senate Amendments",22,15,0,43,80
1709744,1310185,2023-04-25,Assembly,"Do pass and be re-referred to the Committee on [Appropriations]",7,0,0,0,7
1709745,1288325,2023-03-28,Assembly,"Do pass and be re-referred to the Committee on [Appropriations]",9,0,0,0,9
1709746,1313362,2023-04-26,Assembly,"Do pass and be re-referred to the Committee on [Appropriations] with recommendation: To Consent Calendar",8,0,0,0,8
1709746,1326945,2023-05-17,Assembly,"Do pass. To Consent Calendar",15,0,0,1,16
1709746,1333664,2023-05-25,Assembly,"AB 1046 Lowenthal Consent Calendar Second Day Regular Session",76,0,0,4,80
1709746,1344181,2023-06-14,Senate,"Do pass as amended, but first amend, and re-refer to the Committee on [Appropriations] with the recommendation: To Consent Calendar",8,0,0,0,8
1709746,1348817,2023-06-29,Senate,"Consent Calendar AB1046 Lowenthal",39,0,0,1,40
1709746,1353592,2023-09-11,Assembly,"AB 1046 Lowenthal Concurrence in Senate Amendments",80,0,0,0,80
1709747,1363737,2024-01-09,Assembly,"Do pass and be re-referred to the Committee on [Appropriations]",6,1,0,1,8
1709748,1310283,2023-04-25,Assembly,"Do pass as amended and be re-referred to the Committee on [Appropriations]",14,0,0,1,15
1709748,1328457,2023-05-18,Assembly,"Do pass",15,0,0,1,16
1709748,1338119,2023-05-31,Assembly,"AB 1048 Wicks Assembly Third Reading",75,0,0,5,80
1709748,1348825,2023-06-28,Senate,"Do pass as amended, but first amend, and re-refer to the Committee on [Appropriations]",12,0,0,0,12
1709748,1349988,2023-07-10,Senate,"Placed on suspense file",6,0,0,1,7
1709748,1352987,2023-09-01,Senate,"Do pass",5,0,0,2,7
1709748,1354259,2023-09-13,Senate,"Assembly 3rd Reading AB1048 Wicks By Wiener",34,0,0,6,40
1709748,1354693,2023-09-14,Assembly,"AB 1048 Wicks Concurrence in Senate Amendments",78,0,0,2,80
1709750,1281895,2023-03-22,Assembly,"Do pass and be re-referred to the Committee on [Appropriations] with recommendation: To Consent Calendar",7,0,0,0,7
1709751,1300993,2023-04-12,Assembly,"Do pass as amended and be re-referred to the Committee on [Appropriations]",7,0,0,0,7
1709752,1318065,2023-05-03,Assembly,"Do pass as amended",6,2,0,0,8
1709752,1337900,2023-05-31,Assembly,"AB 1052 McCarty Assembly Third Reading",58,17,0,5,80
1709752,1349828,2023-07-05,Senate,"Do pass, but first be re-referred to the Committee on [Transportation]",6,2,0,0,8
1709752,1350502,2023-07-11,Senate,"Do pass",12,4,0,0,16
1709752,1353265,2023-09-06,Senate,"Assembly 3rd Reading AB1052 McCarty By Ashby",31,9,0,0,40
1709753,1288312,2023-03-29,Assembly,"Do pass as amended and be re-referred to the Committee on [Appropriations]",8,0,0,0,8
1709753,1328689,2023-05-18,Assembly,"Do pass",15,0,0,1,16
1709753,1335444,2023-05-30,Assembly,"AB 1053 Gabriel Assembly Third Reading",80,0,0,0,80
1709753,1350300,2023-07-10,Senate,"Do pass, but first be re-referred to the Committee on [Appropriations] with the recommendation: To Consent Calendar",11,0,0,0,11
1709753,1351429,2023-08-14,Senate,"Placed on suspense file",7,0,0,0,7
1709753,1464529,2024-08-15,Senate,"Do pass",7,0,0,0,7
1709753,1465883,2024-08-27,Senate,"Assembly 3rd Reading AB1053 Gabriel et al. By Skinner",40,0,0,0,40
1709753,1466731,2024-08-28,Assembly,"AB 1053 Gabriel Concurrence in Senate Amendments",77,0,0,2,79
1709754,1313459,2023-04-26,Assembly,"Do pass as amended and be re-referred to the Committee on [Appropriations]",7,0,0,0,7
1709754,1328736,2023-05-18,Assembly,"Do pass",15,0,0,1,16
1709754,1335440,2023-05-30,Assembly,"AB 1054 Berman Assembly Third Reading",80,0,0,0,80
1709754,1350482,2023-07-12,Senate,"Do pass, but first be re-referred to the Committee on [Appropriations]",7,0,0,0,7
1709754,1351432,2023-08-14,Senate,"Placed on suspense file",7,0,0,0,7
1709756,1305319,2023-04-18,Assembly,"Do pass and be re-referred to the Committee on [Appropriations] with recommendation: To Consent Calendar",15,0,0,0,15
1709757,1304359,2023-04-18,Assembly,"Do pass as amended and be re-referred to the Committee on [Appropriations]",15,0,0,0,15
1709757,1327964,2023-05-18,Assembly,"Do pass",15,0,0,1,16
1709757,1335527,2023-05-30,Assembly,"AB 1057 Weber Assembly Third Reading",80,0,0,0,80
1709757,1346150,2023-06-21,Senate,"Do pass as amended, but first amend, and re-refer to the Committee on [Appropriations] with the recommendation: To Consent Calendar",12,0,0,0,12
1709757,1349449,2023-07-03,Senate,"Placed on suspense file",7,0,0,0,7
1709757,1352663,2023-09-01,Senate,"Do pass as amended",7,0,0,0,7
1709757,1353904,2023-09-12,Senate,"Assembly 3rd Reading AB1057 Weber et al. By Eggman",38,0,0,2,40
1709757,1354136,2023-09-13,Assembly,"AB 1057 Weber Concurrence in Senate Amendments",80,0,0,0,80
1709758,1313310,2023-04-27,Assembly,"Do pass and be re-referred to the Committee on [Appropriations]",2,6,0,0,8
1709758,1313311,2023-04-27,Assembly,Reconsideration,8,0,0,0,8
1709759,1305269,2023-04-18,Assembly,"Do pass and be re-referred to the Committee on [Appropriations]",7,1,0,1,9
1709759,1328691,2023-05-18,Assembly,"Do pass",11,4,0,1,16
1709759,1335581,2023-05-30,Assembly,"AB 1059 Friedman Assembly Third Reading",64,14,0,2,80
1709759,1348448,2023-06-28,Senate,"Do pass, but first be re-referred to the Committee on [Business, Professions and Economic Development]",6,0,0,1,7
1709759,1349955,2023-07-10,Senate,"Do pass, but first be re-referred to the Committee on [Appropriations]",10,0,0,3,13
1709759,1351830,2023-08-21,Senate,"Placed on suspense file",7,0,0,0,7
1709759,1352736,2023-09-01,Senate,"Do pass as amended",5,2,0,0,7
1709759,1353390,2023-09-07,Senate,"Assembly 3rd Reading AB1059 Friedman By Dahle",35,3,0,2,40
1709759,1353687,2023-09-11,Assembly,"AB 1059 Friedman Concurrence in Senate Amendments",67,0,0,13,80
1709760,1310280,2023-04-25,Assembly,"Do pass and be re-referred to the Committee on [Appropriations]",15,0,0,0,15
1709760,1328323,2023-05-18,Assembly,"Do pass",15,0,0,1,16
1709760,1333668,2023-05-25,Assembly,"AB 1060 Ortega Assembly Third Reading",77,0,0,3,80
1709760,1348870,2023-06-28,Senate,"Do pass, but first be re-referred to the Committee on [Appropriations]",12,0,0,0,12
1709760,1349974,2023-07-10,Senate,"Placed on suspense file",6,0,0,1,7
1709760,1352532,2023-09-01,Senate,"Do pass as amended",6,0,0,1,7
1709760,1353983,2023-09-12,Senate,"Assembly 3rd Reading AB1060 Ortega et al. By Wahab",38,0,0,2,40
1709760,1354209,2023-09-13,Assembly,"AB 1060 Ortega Concurrence in Senate Amendments",80,0,0,0,80
1709761,1288391,2023-03-29,Assembly,"Do pass and be re-referred to the Committee on [Appropriations] with recommendation: To Consent Calendar",13,0,0,0,13
1709761,1328734,2023-05-18,Assembly,"Do pass",15,0,0,1,16
1709761,1335599,2023-05-30,Assembly,"AB 1061 Boerner Assembly Third Reading",79,0,0,1,80
1709761,1350211,2023-07-10,Senate,"Do pass",14,2,0,2,18
1709761,1353324,2023-09-06,Senate,"Assembly 3rd Reading AB1061 Rendon et al. By Lim√≥n",31,8,0,1,40
1709761,1353624,2023-09-11,Assembly,"With recommendation: That Senate amendments be concurred in",13,0,0,2,15
1709761,1354051,2023-09-12,Assembly,"AB 1061 Rendon Concurrence in Senate Amendments",70,8,0,2,80
1709763,1310248,2023-04-25,Assembly,"Do pass as amended and be re-referred to the Committee on [Appropriations]",12,3,0,0,15
1709763,1328648,2023-05-18,Assembly,"Do pass",11,4,0,1,16
1709763,1335486,2023-05-30,Assembly,"AB 1063 Gabriel Assembly Third Reading",64,15,0,1,80
1709763,1350685,2023-07-12,Senate,"Do pass as amended, but first amend, and re-refer to the Committee on [Appropriations]",9,1,0,2,12
1709763,1351333,2023-08-14,Senate,"Placed on suspense file",7,0,0,0,7
1709763,1352829,2023-09-01,Senate,"Do pass as amended",5,2,0,0,7
1709763,1354122,2023-09-13,Assembly,"AB 1063 Gabriel Concurrence in Senate Amendments",64,14,0,2,80
1709763,1354856,2023-09-11,Senate,"Assembly 3rd Reading AB1063 Gabriel By Ashby",28,9,0,3,40
1709764,1281847,2023-03-21,Assembly,"Do pass as amended and be re-referred to the Committee on [Appropriations]",8,0,0,0,8
1709765,1288187,2023-03-29,Assembly,"Do pass and be re-referred to the Committee on [Appropriations]",12,0,0,1,13
1709765,1328163,2023-05-18,Assembly,"Do pass as amended",15,0,0,1,16
1709765,1335454,2023-05-30,Assembly,"AB 1065 Jim Patterson Assembly Third Reading",75,0,0,5,80
1709765,1345560,2023-06-20,Senate,"Do pass, but first be re-referred to the Committee on [Appropriations]",13,0,0,5,18
1709765,1349540,2023-07-03,Senate,"Placed on suspense file",7,0,0,0,7
1709765,1352821,2023-09-01,Senate,"Do pass",7,0,0,0,7
1709765,1354684,2023-09-14,Senate,"Assembly 3rd Reading AB1065 Jim Patterson By Dodd",31,6,0,3,40
1709765,1354685,2023-09-14,Assembly,"AB 1065 Jim Patterson Concurrence in Senate Amendments",76,0,0,4,80
1709766,1317064,2023-05-01,Assembly,"Do pass and be re-referred to the Committee on [Appropriations]",11,0,0,0,11
1709767,1286924,2023-03-28,Assembly,"Do pass and be re-referred to the Committee on [Appropriations]",5,0,0,3,8
1709768,1281867,2023-03-22,Assembly,"Do pass as amended and be re-referred to the Committee on [Appropriations]",13,0,0,2,15
1709768,1305224,2023-04-19,Assembly,"Do pass. To Consent Calendar",14,0,0,2,16
1709768,1320548,2023-05-08,Assembly,"AB 1068 Valencia Assembly Third Reading",66,0,0,14,80
1709768,1349537,2023-07-03,Senate,"Do pass as amended, but first amend, and re-refer to the Committee on [Appropriations]",12,1,0,5,18
1709768,1354214,2023-09-13,Senate,"Assembly 3rd Reading AB1068 Valencia By Padilla",32,3,0,5,40
1709768,1354584,2023-09-14,Assembly,"AB 1068 Valencia Concurrence in Senate Amendments",77,0,0,3,80
1709770,1298272,2023-04-11,Assembly,"Do pass as amended and be re-referred to the Committee on [Appropriations]",18,0,0,0,18
1709770,1311682,2023-04-26,Assembly,"Do pass. To Consent Calendar",16,0,0,0,16
1709770,1318917,2023-05-04,Assembly,"AB 1070 Low Consent Calendar Second Day Regular Session",75,0,0,5,80
1709770,1338780,2023-06-05,Senate,"Do pass, but first be re-referred to the Committee on [Appropriations]",10,0,0,3,13
1709770,1353277,2023-09-06,Senate,"Assembly 3rd Reading AB1070 Low By Roth",40,0,0,0,40
1709770,1354120,2023-09-13,Assembly,"With recommendation: That Senate amendments be concurred in",19,0,0,0,19
1709770,1354746,2023-09-14,Assembly,"AB 1070 Low Concurrence in Senate Amendments",78,0,0,2,80
1709771,1301033,2023-04-12,Assembly,"Do pass as amended, and be re-referred to the Committee on [Appropriations] with recommendation: To Consent Calendar",7,0,0,0,7
1709771,1318095,2023-05-03,Assembly,"Do pass. To Consent Calendar",16,0,0,0,16
1709771,1323795,2023-05-11,Assembly,"AB 1071 Hoover Consent Calendar Second Day Regular Session",66,0,0,14,80
1709771,1341023,2023-06-07,Senate,"Do pass, but first be re-referred to the Committee on [Appropriations] with the recommendation: To Consent Calendar",7,0,0,0,7
1709771,1348886,2023-06-29,Senate,"Consent Calendar AB1071 Hoover",39,0,0,1,40
1709772,1308869,2023-04-24,Assembly,"Do pass as amended and be re-referred to the Committee on [Appropriations]",10,1,0,4,15
1709774,1311744,2023-04-26,Assembly,"Do pass and be re-referred to the Committee on [Appropriations] with recommendation: To Consent Calendar",22,0,0,0,22
1709774,1326943,2023-05-17,Assembly,"Do pass. To Consent Calendar",15,0,0,1,16
1709774,1333787,2023-05-25,Assembly,"AB 1074 Alanis Consent Calendar Second Day Regular Session",76,0,0,4,80
1709774,1347829,2023-06-27,Senate,"Do pass, but first be re-referred to the Committee on [Appropriations] with the recommendation: To Consent Calendar",15,0,0,0,15
1709774,1351692,2023-08-17,Senate,"Consent Calendar 2nd AB1074 Alanis",38,0,0,2,40
1709774,1354330,2023-09-13,Senate,"Assembly 3rd Reading AB1074 Alanis et al. By Dodd",39,0,0,1,40
1709774,1354489,2023-09-14,Assembly,"With recommendation: That Senate amendments be concurred in",18,0,0,4,22
1709774,1354572,2023-09-14,Assembly,"AB 1074 Alanis Concurrence in Senate Amendments",80,0,0,0,80
1709776,1311907,2023-04-26,Assembly,"Do pass and be re-referred to the Committee on [Appropriations]",7,0,0,0,7
1709776,1328019,2023-05-18,Assembly,"Do pass",15,0,0,1,16
1709776,1335490,2023-05-30,Assembly,"AB 1076 Bauer-Kahan Assembly Third Reading",80,0,0,0,80
1709776,1349821,2023-07-06,Senate,"Do pass as amended, but first amend, and re-refer to the Committee on [Appropriations] with the recommendation: To Consent Calendar",11,0,0,0,11
1709776,1351517,2023-08-14,Senate,"Placed on suspense file",7,0,0,0,7
1709776,1352951,2023-09-01,Senate,"Do pass",7,0,0,0,7
1709776,1353987,2023-09-12,Senate,"Special Consent AB1076 Bauer-Kahan By Durazo",39,0,0,1,40
1709776,1354246,2023-09-13,Assembly,"AB 1076 Bauer-Kahan Concurrence in Senate Amendments",80,0,0,0,80
1709778,1313400,2023-04-26,Assembly,"Do pass as amended and be re-referred to the Committee on [Appropriations]",5,2,0,0,7
1709778,1328725,2023-05-18,Assembly,"Do pass",11,4,0,1,16
1709778,1335488,2023-05-30,Assembly,"AB 1078 Jackson Assembly Third Reading",62,16,0,2,80
1709778,1349656,2023-07-05,Senate,"Do pass as amended, but first amend, and re-refer to the Committee on [Appropriations]",5,2,0,0,7
1709778,1351840,2023-08-21,Senate,"Placed on suspense file",7,0,0,0,7
1709778,1352786,2023-09-01,Senate,"Do pass as amended",5,2,0,0,7
1709778,1353532,2023-09-07,Senate,"Assembly 3rd Reading AB1078 Jackson et al. By Gonzalez Urgency Clause",31,9,0,0,40
1709778,1353533,2023-09-07,Assembly,"AB 1078 JACKSON Concurrence - Urgency Added",61,17,0,2,80
1709779,1288272,2023-03-28,Assembly,"Do pass as amended and be re-referred to the Committee on [Judiciary]",13,0,0,2,15
1709779,1298307,2023-04-11,Assembly,"Do pass and be re-referred to the Committee on [Appropriations]",9,1,0,1,11
1709779,1328675,2023-05-18,Assembly,"Do pass",14,0,0,2,16
1709779,1335463,2023-05-30,Assembly,"AB 1079 Jackson Assembly Third Reading",75,0,0,5,80
1709779,1346199,2023-06-21,Senate,"Do pass as amended, but first amend, and re-refer to the Committee on [Judiciary]",10,0,0,2,12
1709779,1349764,2023-07-06,Senate,"Do pass, but first be re-referred to the Committee on [Appropriations]",10,0,0,1,11
1709779,1351275,2023-08-14,Senate,"Placed on suspense file",7,0,0,0,7
1709779,1352940,2023-09-01,Senate,"Do pass as amended",6,0,0,1,7
1709779,1353254,2023-09-06,Senate,"Assembly 3rd Reading AB1079 Jackson et al. By Min",35,0,0,5,40
1709779,1353607,2023-09-11,Assembly,"AB 1079 Jackson Concurrence in Senate Amendments",76,0,0,4,80
1709780,1281818,2023-03-21,Assembly,"Do pass as amended, and be re-referred to the Committee on [Appropriations] with recommendation: To Consent Calendar",8,0,0,0,8
1709780,1305360,2023-04-19,Assembly,"Do pass. To Consent Calendar",14,0,0,2,16
1709780,1313456,2023-04-27,Assembly,"AB 1080 Ta Consent Calendar Second Day Regular Session",79,0,0,1,80
1709780,1339974,2023-06-06,Senate,"Do pass, but first be re-referred to the Committee on [Appropriations] with the recommendation: To Consent Calendar",5,0,0,0,5
1709780,1348869,2023-06-29,Senate,"Consent Calendar AB1080 Ta et al. By Umberg",39,0,0,1,40
1709782,1285685,2023-03-27,Assembly,"Do pass and be re-referred to the Committee on [Appropriations]",11,2,0,2,15
1709782,1328307,2023-05-18,Assembly,"Do pass as amended",11,4,0,1,16
1709782,1337993,2023-05-31,Assembly,"AB 1082 Kalra Assembly Third Reading",47,14,0,19,80
1709782,1348405,2023-06-27,Senate,"Do pass as amended, but first amend, and re-refer to the Committee on [Public Safety]",10,3,0,3,16
1709782,1350229,2023-07-11,Senate,"Do pass, but first be re-referred to the Committee on [Appropriations]",3,1,0,1,5
1709782,1352331,2023-08-28,Senate,"Placed on suspense file",7,0,0,0,7
1709782,1464503,2024-08-15,Senate,"Do pass as amended",5,2,0,0,7
1709784,1304384,2023-04-18,Assembly,"Do pass and be re-referred to the Committee on [Appropriations]",7,0,0,1,8
1709785,1280602,2023-03-21,Assembly,"Do pass as amended and be re-referred to the Committee on [Appropriations]",11,0,0,4,15
1709785,1328056,2023-05-18,Assembly,"Do pass",11,3,0,2,16
1709785,1335586,2023-05-30,Assembly,"AB 1085 Maienschein Assembly Third Reading",63,12,0,5,80
1709785,1344211,2023-06-14,Senate,"Do pass as amended, but first amend, and re-refer to the Committee on [Appropriations]",10,0,0,2,12
1709785,1347512,2023-06-26,Senate,"Placed on suspense file",6,0,0,1,7
1709785,1352892,2023-09-01,Senate,"Do pass as amended",5,2,0,0,7
1709785,1353790,2023-09-12,Senate,"Assembly 3rd Reading AB1085 Maienschein By Wiener",30,7,0,3,40
1709785,1354105,2023-09-13,Assembly,"AB 1085 Maienschein Concurrence in Senate Amendments",63,13,0,4,80
1709788,1281868,2023-03-22,Assembly,"Do pass and be re-referred to the Committee on [Appropriations]",20,0,0,2,22
1709788,1328652,2023-05-18,Assembly,"Do pass",15,0,0,1,16
1709788,1335456,2023-05-30,Assembly,"AB 1088 Blanca Rubio Assembly Third Reading",80,0,0,0,80
1709788,1347828,2023-06-27,Senate,"Do pass, but first be re-referred to the Committee on [Appropriations]",15,0,0,0,15
1709788,1353267,2023-09-06,Senate,"Assembly 3rd Reading AB1088 Blanca Rubio By Alvarado-Gil",40,0,0,0,40
1709789,1286978,2023-03-28,Assembly,"Do pass as amended and be re-referred to the Committee on [Judiciary]",7,1,0,0,8
1709789,1304294,2023-04-18,Assembly,"Do pass as amended and be re-referred to the Committee on [Appropriations]",8,0,0,3,11
1709789,1328210,2023-05-18,Assembly,"Do pass",11,2,0,3,16
1709789,1335591,2023-05-30,Assembly,"AB 1089 Gipson Assembly Third Reading",64,8,0,8,80
1709789,1347901,2023-06-27,Senate,"Do pass, but first be re-referred to the Committee on [Judiciary]",4,1,0,0,5
1709789,1350391,2023-07-11,Senate,"Do pass, but first be re-referred to the Committee on [Appropriations]",10,1,0,0,11
1709789,1351353,2023-08-14,Senate,"Placed on suspense file",7,0,0,0,7
1709789,1352563,2023-09-01,Senate,"Do pass as amended",5,2,0,0,7
1709789,1353316,2023-09-06,Senate,"Assembly 3rd Reading AB1089 Gipson et al. By Min",32,6,0,2,40
1709789,1353387,2023-09-07,Assembly,"AB 1089 Gipson Concurrence in Senate Amendments",61,9,0,10,80
1709790,1299487,2023-04-11,Assembly,"Do pass as amended and be re-referred to the Committee on [Local Government]",6,2,0,0,8
1709792,1288262,2023-03-28,Assembly,"Do pass as amended and be re-referred to the Committee on [Appropriations]",10,4,0,1,15
1709792,1328489,2023-05-18,Assembly,"Do pass",11,4,0,1,16
1709792,1335420,2023-05-30,Assembly,"AB 1092 Wood Assembly Third Reading",62,18,0,0,80
1709792,1349796,2023-07-05,Senate,"Do pass, but first be re-referred to the Committee on [Judiciary]",9,2,0,1,12
1709792,1350526,2023-07-11,Senate,"Do pass, but first be re-referred to the Committee on [Appropriations]",9,2,0,0,11
1709792,1351426,2023-08-14,Senate,"Placed on suspense file",7,0,0,0,7
1709793,1310340,2023-04-24,Assembly,"Do pass and be re-referred to the Committee on [Appropriations]",11,0,0,0,11
1709793,1328587,2023-05-18,Assembly,"Do pass",15,0,0,1,16
1709793,1335547,2023-05-30,Assembly,"AB 1093 Jim Patterson Assembly Third Reading",80,0,0,0,80
1709793,1350715,2023-07-12,Senate,"Do pass as amended, but first amend, and re-refer to the Committee on [Appropriations] with the recommendation: To Consent Calendar",8,0,0,0,8
1709793,1351369,2023-08-14,Senate,"Placed on suspense file",7,0,0,0,7
1709796,1311781,2023-04-25,Assembly,"Do pass",12,0,0,0,12
1709796,1320557,2023-05-08,Assembly,"AB 1096 Mike Fong Assembly Third Reading",70,0,0,10,80
1709796,1350523,2023-07-12,Senate,"Do pass, but first be re-referred to the Committee on [Appropriations]",6,0,0,1,7
1709796,1351305,2023-08-14,Senate,"Placed on suspense file",7,0,0,0,7
1709796,1352882,2023-09-01,Senate,"Do pass",7,0,0,0,7
1709796,1353815,2023-09-12,Assembly,"AB 1096 Mike Fong Concurrence in Senate Amendments",79,0,0,1,80
1709796,1354745,2023-09-11,Senate,"Assembly 3rd Reading AB1096 Mike Fong By Rubio",39,0,0,1,40
1709797,1310228,2023-04-24,Assembly,"Do pass and be re-referred to the Committee on [Appropriations]",11,0,0,0,11
1709797,1326948,2023-05-17,Assembly,"Do pass. To Consent Calendar",15,0,0,1,16
1709797,1333653,2023-05-25,Assembly,"AB 1097 Luz Rivas Consent Calendar Second Day Regular Session",76,0,0,4,80
1709797,1349773,2023-07-05,Senate,"Do pass, but first be re-referred to the Committee on [Appropriations] with the recommendation: To Consent Calendar",8,0,0,0,8
1709797,1351425,2023-08-14,Senate,"Placed on suspense file",7,0,0,0,7
1709797,1353075,2023-09-01,Senate,"Do pass",7,0,0,0,7
1709797,1354036,2023-09-12,Senate,"Special Consent AB1097 Luz Rivas",39,0,0,1,40
1709801,1299442,2023-04-12,Assembly,"Do pass as amended and be re-referred to the Committee on [Appropriations]",8,0,0,0,8
1709802,1288163,2023-03-29,Assembly,"Do pass and be re-referred to the Committee on [Privacy and Consumer Protection] with recommendation: To Consent Calendar",13,0,0,0,13
1709804,1286897,2023-03-28,Assembly,"Do pass",6,0,0,2,8
1709804,1320482,2023-05-08,Assembly,"AB 1104 Bonta Assembly Third Reading",54,15,0,11,80
1709804,1350258,2023-07-11,Senate,"Do pass, but first be re-referred to the Committee on [Appropriations]",3,0,0,2,5
1709804,1353192,2023-09-05,Senate,"Assembly 3rd Reading AB1104 Bonta By Durazo",28,9,0,3,40
1709804,1353404,2023-09-07,Assembly,"AB 1104 Bonta Concurrence in Senate Amendments",61,14,0,5,80
1709806,1289845,2023-03-29,Assembly,"Do pass as amended, and be re-referred to the Committee on [Appropriations] with recommendation: To Consent Calendar",6,0,0,1,7
1709806,1327974,2023-05-18,Assembly,"Do pass",15,0,0,1,16
1709806,1338083,2023-05-31,Assembly,"AB 1106 Soria Assembly Third Reading",79,0,0,1,80
1709806,1346292,2023-06-21,Senate,"Do pass as amended, but first amend, and re-refer to the Committee on [Appropriations]",6,0,0,1,7
1709806,1349902,2023-07-10,Senate,"Placed on suspense file",6,0,0,1,7
1709809,1310293,2023-04-25,Assembly,"Do pass as amended",15,0,0,0,15
1709809,1328537,2023-05-18,Assembly,"AB 1109 Connolly Assembly Third Reading",75,0,0,5,80
1709809,1345176,2023-06-19,Senate,"Do pass",12,0,0,1,13
1709809,1352491,2023-09-01,Senate,"Assembly 3rd Reading AB1109 Connolly et al. By Ashby",37,0,0,3,40
1709809,1353479,2023-09-07,Assembly,"AB 1109 Connolly Concurrence in Senate Amendments",79,0,0,1,80
1709810,1288191,2023-03-28,Assembly,"Do pass as amended, and be re-referred to the Committee on [Appropriations] with recommendation: To Consent Calendar",14,0,0,1,15
1709810,1328376,2023-05-18,Assembly,"Do pass",15,0,0,1,16
1709810,1335583,2023-05-30,Assembly,"AB 1110 Arambula Assembly Third Reading",79,0,0,1,80
1709810,1349772,2023-07-05,Senate,"Do pass as amended, but first amend, and re-refer to the Committee on [Appropriations] with the recommendation: To Consent Calendar",12,0,0,0,12
1709810,1351356,2023-08-14,Senate,"Placed on suspense file",7,0,0,0,7
1709811,1298245,2023-04-11,Assembly,"Do pass as amended and be re-referred to the Committee on [Appropriations]",16,0,0,2,18
1709811,1327935,2023-05-18,Assembly,"Do pass",15,0,0,1,16
1709811,1335450,2023-05-30,Assembly,"AB 1111 Pellerin Assembly Third Reading",74,1,0,5,80
1709811,1347491,2023-06-26,Senate,"Do pass, but first be re-referred to the Committee on [Appropriations]",8,1,0,4,13
1709811,1351341,2023-08-14,Senate,"Placed on suspense file",7,0,0,0,7
1709811,1464180,2024-08-15,Senate,"Do pass as amended",4,0,0,3,7
1709811,1465868,2024-08-27,Senate,"Assembly 3rd Reading AB1111 Pellerin et al. By Eggman",27,5,0,8,40
1709811,1466689,2024-08-28,Assembly,"AB 1111 Pellerin Concurrence in Senate Amendments",69,2,0,8,79
1709812,1304307,2023-04-18,Assembly,"Do pass and be re-referred to the Committee on [Appropriations] with recommendation: To Consent Calendar",7,0,0,1,8
1709812,1328467,2023-05-18,Assembly,"Do pass",15,0,0,1,16
1709812,1338202,2023-05-31,Assembly,"AB 1112 McKinnor Assembly Third Reading",79,0,0,1,80
1709812,1349568,2023-07-03,Senate,"Do pass, but first be re-referred to the Committee on [Appropriations] with the recommendation: To Consent Calendar",5,0,0,0,5
1709812,1352336,2023-08-28,Senate,"Placed on suspense file",7,0,0,0,7
1709812,1353014,2023-09-01,Senate,"Do pass as amended",7,0,0,0,7
1709812,1354271,2023-09-13,Senate,"Special Consent AB1112 McKinnor By Alvarado-Gil",39,0,0,1,40
1709812,1354543,2023-09-14,Assembly,"AB 1112 McKinnor Concurrence in Senate Amendments",80,0,0,0,80
1709813,1313316,2023-04-26,Assembly,"Do pass and be re-referred to the Committee on [Appropriations]",7,0,0,0,7
1709813,1328275,2023-05-18,Assembly,"Do pass",15,0,0,1,16
1709813,1335544,2023-05-30,Assembly,"AB 1113 McCarty Assembly Third Reading",80,0,0,0,80
1709813,1350528,2023-07-12,Senate,"Do pass, but first be re-referred to the Committee on [Appropriations]",7,0,0,0,7
1709813,1351452,2023-08-14,Senate,"Placed on suspense file",7,0,0,0,7
1709813,1352939,2023-09-01,Senate,"Do pass as amended",7,0,0,0,7
1709813,1466608,2024-08-31,Senate,"Assembly 3rd Reading AB1113 McCarty et al. By Lim√≥n",40,0,0,0,40
1709813,1466609,2024-08-31,Assembly,"AB 1113 McCarty Concurrence in Senate Amendments",74,0,0,5,79
1709814,1281899,2023-03-22,Assembly,"Do pass as amended and be re-referred to the Committee on [Housing and Community Development]",8,0,0,0,8
1709814,1299393,2023-04-12,Assembly,"Do pass as amended and be re-referred to the Committee on [Appropriations]",8,0,0,0,8
1709814,1311695,2023-04-26,Assembly,"Do pass. To Consent Calendar",16,0,0,0,16
1709814,1318955,2023-05-04,Assembly,"AB 1114 Haney Consent Calendar Second Day Regular Session",75,0,0,5,80
1709814,1346168,2023-06-21,Senate,"Do pass, but first be re-referred to the Committee on [Housing]",8,0,0,0,8
1709814,1350176,2023-07-10,Senate,"Do pass, but first be re-referred to the Committee on [Appropriations] with the recommendation: To Consent Calendar",11,0,0,0,11
1709814,1353176,2023-09-05,Senate,"Assembly 3rd Reading AB1114 Haney By Wiener",39,0,0,1,40
1709815,1288313,2023-03-28,Assembly,"Do pass and be re-referred to the Committee on [Appropriations]",7,0,0,2,9
1709815,1328882,2023-05-18,Assembly,"Do pass",12,2,0,2,16
1709815,1338169,2023-05-31,Assembly,"AB 1115 Papan Assembly Third Reading",67,0,0,13,80
1709815,1349647,2023-07-05,Senate,"Do pass, but first be re-referred to the Committee on [Appropriations]",5,0,0,2,7
1709815,1351386,2023-08-14,Senate,"Placed on suspense file",7,0,0,0,7
1709815,1352593,2023-09-01,Senate,"Do pass",5,0,0,2,7
1709815,1354044,2023-09-12,Senate,"Assembly 3rd Reading AB1115 Papan By Becker",32,0,0,8,40
1709815,1354309,2023-09-13,Assembly,"AB 1115 Papan Concurrence in Senate Amendments",68,0,0,12,80
1709816,1279197,2023-03-20,Assembly,"Do pass and be re-referred to the Committee on [Appropriations]",12,0,0,0,12
1709816,1305508,2023-04-19,Assembly,"Do pass. To Consent Calendar",14,0,0,2,16
1709816,1313446,2023-04-27,Assembly,"AB 1116 Grayson Consent Calendar Second Day Regular Session",79,0,0,1,80
1709816,1346196,2023-06-21,Senate,"Do pass as amended, but first amend, and re-refer to the Committee on [Appropriations]",7,0,0,0,7
1709816,1353213,2023-09-06,Senate,"Assembly 3rd Reading AB1116 Grayson By Min",40,0,0,0,40
1709816,1353448,2023-09-07,Assembly,"AB 1116 Grayson Concurrence in Senate Amendments",79,0,0,1,80
1709817,1288195,2023-03-28,Assembly,"Do pass and be re-referred to the Committee on [Appropriations]",14,0,0,1,15
1709817,1328244,2023-05-18,Assembly,"Do pass",15,0,0,1,16
1709817,1335469,2023-05-30,Assembly,"AB 1117 Irwin Assembly Third Reading",80,0,0,0,80
1709818,1286950,2023-03-28,Assembly,"Do pass. To Consent Calendar",8,0,0,0,8
1709818,1296995,2023-04-10,Assembly,"AB 1118 Kalra Consent Calendar Second Day Regular Session",65,0,0,15,80
1709818,1340058,2023-06-06,Senate,"Do pass",5,0,0,0,5
1709818,1353132,2023-09-05,Senate,"Assembly 3rd Reading AB1118 Kalra By Bradford",37,0,0,3,40
1709818,1353403,2023-09-07,Assembly,"AB 1118 Kalra Concurrence in Senate Amendments",76,0,0,4,80
1709819,1286962,2023-03-28,Assembly,"Do pass as amended and be re-referred to the Committee on [Appropriations]",7,2,0,2,11
1709819,1311660,2023-04-26,Assembly,"Do pass",12,4,0,0,16
1709819,1335609,2023-05-30,Assembly,"AB 1119 Wicks Assembly Third Reading Amendment Set #1",57,18,0,5,80
1709819,1337234,2023-06-01,Assembly,"AB 1119 Wicks Assembly Third Reading",53,18,0,9,80
1709819,1350380,2023-07-11,Senate,"Do pass, but first be re-referred to the Committee on [Appropriations]",8,2,0,1,11
1709819,1354014,2023-09-12,Assembly,"AB 1119 Wicks Concurrence in Senate Amendments",58,18,0,4,80
1709819,1354703,2023-09-11,Senate,"Assembly 3rd Reading AB1119 Wicks By Becker",30,9,0,1,40
1709821,1281808,2023-03-22,Assembly,"Do pass and be re-referred to the Committee on [Appropriations] with recommendation: To Consent Calendar",7,0,0,0,7
1709821,1327984,2023-05-18,Assembly,"Do pass",15,0,0,1,16
1709821,1335475,2023-05-30,Assembly,"AB 1121 Haney Assembly Third Reading",79,0,0,1,80
1709821,1346983,2023-06-22,Senate,"Do pass, but first be re-referred to the Committee on [Appropriations] with the recommendation: To Consent Calendar",5,0,0,0,5
1709821,1349501,2023-07-03,Senate,"Placed on suspense file",7,0,0,0,7
1709821,1352690,2023-09-01,Senate,"Do pass as amended",7,0,0,0,7
1709821,1354221,2023-09-13,Senate,"Special Consent AB1121 Haney By Cortese",39,0,0,1,40
1709821,1354532,2023-09-14,Assembly,"AB 1121 Haney Concurrence in Senate Amendments",80,0,0,0,80
1709822,1304356,2023-04-18,Assembly,"Do pass as amended and be re-referred to the Committee on [Appropriations]",15,0,0,0,15
1709822,1328049,2023-05-18,Assembly,"Do pass",15,0,0,1,16
1709822,1333811,2023-05-25,Assembly,"AB 1122 Bains Assembly Third Reading",77,0,0,3,80
1709822,1349733,2023-07-05,Senate,"Do pass, but first be re-referred to the Committee on [Appropriations] with the recommendation: To Consent Calendar",12,0,0,0,12
1709822,1351324,2023-08-14,Senate,"Placed on suspense file",7,0,0,0,7
1709822,1352554,2023-09-01,Senate,"Do pass",7,0,0,0,7
1709822,1353796,2023-09-12,Senate,"Special Consent AB1122 Bains By Alvarado-Gil",39,0,0,1,40
1709822,1456363,2024-06-11,Senate,"Do pass, but first be re-referred to the Committee on [Environmental Quality]",14,0,0,1,15
1709822,1462641,2024-07-03,Senate,"Do pass as amended, but first amend, and re-refer to the Committee on [Appropriations]",7,0,0,0,7
1709822,1463453,2024-08-05,Senate,"Placed on suspense file",7,0,0,0,7
1709822,1464595,2024-08-15,Senate,"Do pass",7,0,0,0,7
1709822,1465608,2024-08-26,Senate,"Assembly 3rd Reading AB1122 Bains et al. By Archuleta",39,1,0,0,40
1709822,1466364,2024-08-29,Assembly,"With recommendation: That Senate amendments be concurred in",13,0,0,2,15
1709822,1466475,2024-08-30,Assembly,"AB 1122 Bains Concurrence in Senate Amendments",69,0,0,10,79
1709823,1298285,2023-04-11,Assembly,"Do pass and be re-referred to the Committee on [Appropriations]",9,2,0,1,12
1709823,1328075,2023-05-18,Assembly,"Do pass",11,3,0,2,16
1709823,1335571,2023-05-30,Assembly,"AB 1123 Addis Assembly Third Reading",62,8,0,10,80
1709823,1346988,2023-06-22,Senate,"Do pass, but first be re-referred to the Committee on [Education]",4,1,0,0,5
1709823,1348438,2023-06-28,Senate,"Do pass, but first be re-referred to the Committee on [Appropriations]",4,2,0,1,7
1709823,1349948,2023-07-10,Senate,"Placed on suspense file",6,0,0,1,7
1709823,1352997,2023-09-01,Senate,"Do pass",5,2,0,0,7
1709823,1354658,2023-09-11,Senate,"Assembly 3rd Reading AB1123 Addis et al. By Durazo",29,8,0,3,40
1709824,1304298,2023-04-18,Assembly,"Do pass as amended and be re-referred to the Committee on [Appropriations]",15,0,0,0,15
1709825,1289836,2023-03-27,Assembly,"Do pass and be re-referred to the Committee on [Public Safety] with recommendation: To Consent Calendar",15,0,0,0,15
1709825,1310410,2023-04-25,Assembly,"Do pass. To Consent Calendar",8,0,0,0,8
1709825,1315692,2023-05-01,Assembly,"AB 1125 Hart Consent Calendar Second Day Regular Session",78,0,0,2,80
1709825,1340069,2023-06-06,Senate,"Do pass and be ordered to the Consent Calendar",5,0,0,0,5
1709825,1353379,2023-09-07,Senate,"Assembly 3rd Reading AB1125 Hart By Lim√≥n",40,0,0,0,40
1709825,1353665,2023-09-11,Assembly,"AB 1125 Hart Concurrence in Senate Amendments",79,0,0,1,80
1709826,1298296,2023-04-11,Assembly,"Do pass. To Consent Calendar",18,0,0,0,18
1709826,1302660,2023-04-17,Assembly,"AB 1126 Lackey Consent Calendar Second Day Regular Session",79,0,0,1,80
1709826,1349950,2023-07-10,Senate,"Do pass as amended",13,0,0,0,13
1709826,1353931,2023-09-12,Assembly,"AB 1126 Lackey Concurrence in Senate Amendments",80,0,0,0,80
1709826,1354806,2023-09-11,Senate,"Assembly 3rd Reading AB1126 Lackey et al. By Archuleta",39,0,0,1,40
1709827,1283131,2023-03-22,Assembly,"Do pass and be re-referred to the Committee on [Appropriations] with recommendation: To Consent Calendar",7,0,0,0,7
1709827,1328570,2023-05-18,Assembly,"Do pass",15,0,0,1,16
1709827,1333796,2023-05-25,Assembly,"AB 1127 Reyes Assembly Third Reading",77,0,0,3,80
1709827,1346322,2023-06-21,Senate,"Do pass, but first be re-referred to the Committee on [Appropriations] with the recommendation: To Consent Calendar",7,0,0,0,7
1709827,1349442,2023-07-03,Senate,"Placed on suspense file",7,0,0,0,7
1709827,1352884,2023-09-01,Senate,"Do pass as amended",7,0,0,0,7
1709827,1354327,2023-09-13,Senate,"Special Consent AB1127 Reyes et al. By Ashby",39,0,0,1,40
1709827,1354660,2023-09-14,Assembly,"AB 1127 Reyes Concurrence in Senate Amendments",80,0,0,0,80
1709828,1310273,2023-04-24,Assembly,"Do pass and be re-referred to the Committee on [Appropriations]",10,0,0,1,11
1709830,1310155,2023-04-25,Assembly,"Do pass. To Consent Calendar",16,0,0,2,18
1709830,1318900,2023-05-04,Assembly,"AB 1130 Berman Consent Calendar Second Day Regular Session",75,0,0,5,80
1709830,1338790,2023-06-05,Senate,"Do pass and be ordered to the Consent Calendar",13,0,0,0,13
1709830,1341931,2023-06-08,Senate,"Consent Calendar AB1130 Berman",39,0,0,1,40
1709831,1310375,2023-04-25,Assembly,"Do pass and be re-referred to the Committee on [Appropriations] with recommendation: To Consent Calendar",15,0,0,0,15
1709832,1288380,2023-03-29,Assembly,"Do pass and be re-referred to the Committee on [Appropriations]",8,0,0,0,8
1709832,1305368,2023-04-19,Assembly,"Do pass. To Consent Calendar",14,0,0,2,16
1709832,1313335,2023-04-27,Assembly,"AB 1132 Friedman Consent Calendar Second Day Regular Session",79,0,0,1,80
1709832,1341042,2023-06-07,Senate,"Do pass, but first be re-referred to the Committee on [Appropriations]",7,0,0,1,8
1709832,1353268,2023-09-06,Senate,"Assembly 3rd Reading AB1132 Friedman et al. By Becker",40,0,0,0,40
1709833,1299370,2023-04-11,Assembly,"Do pass as amended and be re-referred to the Committee on [Appropriations]",6,2,0,0,8
1709833,1328886,2023-05-18,Assembly,"Do pass",11,4,0,1,16
1709833,1335578,2023-05-30,Assembly,"AB 1133 Schiavo Assembly Third Reading",55,18,0,7,80
1709833,1350181,2023-07-11,Senate,"Do pass, but first be re-referred to the Committee on [Appropriations]",3,1,0,1,5
1709833,1351347,2023-08-14,Senate,"Placed on suspense file",7,0,0,0,7
1709835,1364113,2024-01-10,Assembly,"Do pass and be re-referred to the Committee on [Appropriations]",10,1,0,0,11
1709835,1366778,2024-01-18,Assembly,"Do pass",14,1,0,1,16
1709835,1371123,2024-01-29,Assembly,"AB 1135 Lowenthal Assembly Third Reading",61,1,0,18,80
1709835,1460087,2024-06-25,Senate,"Do pass, but first be re-referred to the Committee on [Appropriations]",11,2,0,3,16
1709835,1463621,2024-08-05,Senate,"Placed on suspense file",7,0,0,0,7
1709836,1286930,2023-03-28,Assembly,"Do pass as amended and be re-referred to the Committee on [Arts, Entertainment, Sports, and Tourism]",17,0,0,2,19
1709836,1298314,2023-04-11,Assembly,"Do pass and be re-referred to the Committee on [Appropriations]",6,0,0,1,7
1709836,1311858,2023-04-26,Assembly,"Do pass",15,0,0,1,16
1709836,1337959,2023-05-31,Assembly,"AB 1136 Haney Assembly Third Reading",74,0,0,6,80
1709836,1349984,2023-07-10,Senate,"Do pass, but first be re-referred to the Committee on [Labor, Public Employment and Retirement ]",13,0,0,0,13
1709836,1350472,2023-07-12,Senate,"Do pass, but first be re-referred to the Committee on [Appropriations]",5,0,0,0,5
1709836,1351351,2023-08-14,Senate,"Placed on suspense file",7,0,0,0,7
1709836,1352600,2023-09-01,Senate,"Do pass as amended",5,0,0,2,7
1709836,1353955,2023-09-12,Assembly,"AB 1136 Haney Concurrence in Senate Amendments",76,0,0,4,80
1709836,1354513,2023-09-11,Senate,"Assembly 3rd Reading AB1136 Haney et al. By Archuleta",34,0,0,6,40
1709837,1281881,2023-03-22,Assembly,"Do pass and be re-referred to the Committee on [Appropriations]",6,0,0,1,7
1709837,1328476,2023-05-18,Assembly,"Do pass",11,3,0,2,16
1709837,1335504,2023-05-30,Assembly,"AB 1137 Jones-Sawyer Assembly Third Reading",67,8,0,5,80
1709837,1462484,2024-07-03,Senate,"Do pass as amended, but first amend, and re-refer to the Committee on [Appropriations]",5,0,0,0,5
1709837,1463404,2024-08-05,Senate,"Placed on suspense file",7,0,0,0,7
1709837,1464108,2024-08-15,Senate,"Do pass",5,2,0,0,7
1709837,1465354,2024-08-20,Senate,"Assembly 3rd Reading AB1137 Jones-Sawyer By Laird",32,7,0,1,40
1709837,1465822,2024-08-27,Assembly,"AB 1137 Jones-Sawyer Concurrence in Senate Amendments",66,7,0,6,79
1709838,1298219,2023-04-11,Assembly,"Do pass as amended and be re-referred to the Committee on [Appropriations]",12,0,0,0,12
1709838,1328339,2023-05-18,Assembly,"Do pass as amended",11,0,0,5,16
1709838,1335546,2023-05-30,Assembly,"AB 1138 Weber Assembly Third Reading",80,0,0,0,80
1709838,1346304,2023-06-21,Senate,"Do pass, but first be re-referred to the Committee on [Appropriations]",7,0,0,0,7
1709838,1349479,2023-07-03,Senate,"Placed on suspense file",7,0,0,0,7
1709838,1353081,2023-09-01,Senate,"Do pass as amended",7,0,0,0,7
1709838,1354023,2023-09-12,Senate,"Assembly 3rd Reading AB1138 Weber et al. By Lim√≥n",38,0,0,2,40
1709838,1354394,2023-09-13,Assembly,"AB 1138 Weber Concurrence in Senate Amendments",80,0,0,0,80
1709839,1317091,2023-05-02,Assembly,"Do pass. To Consent Calendar",11,0,0,0,11
1709839,1320392,2023-05-08,Assembly,"AB 1139 Garcia Consent Calendar Second Day Regular Session",71,0,0,9,80
1709839,1345564,2023-06-20,Senate,"Do pass and be ordered to the Consent Calendar",11,0,0,0,11
1709839,1348835,2023-06-29,Senate,"Consent Calendar AB1139 Garcia et al",39,0,0,1,40
1709839,1351654,2023-08-17,Assembly,"AB 1139 Garcia Concurrence in Senate Amendments",76,0,0,4,80
1709840,1311895,2023-04-26,Assembly,"Do pass and be re-referred to the Committee on [Appropriations] with recommendation: To Consent Calendar",14,0,0,0,14
1709840,1326919,2023-05-17,Assembly,"Do pass. To Consent Calendar",15,0,0,1,16
1709840,1333677,2023-05-25,Assembly,"AB 1140 Insurance Consent Calendar Second Day Regular Session",76,0,0,4,80
1709840,1348473,2023-06-28,Senate,"Do pass, but first be re-referred to the Committee on [Labor, Public Employment and Retirement ] with the recommendation: To Consent Calendar",7,0,0,0,7
1709840,1350406,2023-07-12,Senate,"Do pass, but first be re-referred to the Committee on [Appropriations] with the recommendation: To Consent Calendar",5,0,0,0,5
1709840,1352220,2023-08-24,Senate,"Consent Calendar 2nd AB1140 INS. (Calderon)",40,0,0,0,40
1709840,1352316,2023-08-28,Assembly,"AB 1140 Insurance Concurrence in Senate Amendments By CALDERON",72,0,0,8,80
1709841,1288193,2023-03-29,Assembly,"Do pass and be re-referred to the Committee on [Emergency Management] with recommendation: To Consent Calendar",11,0,0,0,11
1709841,1304427,2023-04-17,Assembly,"Do pass and be re-referred to the Committee on [Appropriations] with recommendation: To Consent Calendar",7,0,0,0,7
1709841,1318039,2023-05-03,Assembly,"Do pass. To Consent Calendar",16,0,0,0,16
1709841,1323813,2023-05-11,Assembly,"AB 1141 Megan Dahle Consent Calendar Second Day Regular Session",66,0,0,14,80
1709842,1363742,2024-01-09,Assembly,"Do pass and be re-referred to the Committee on [Appropriations]",9,0,0,2,11
1709842,1366755,2024-01-18,Assembly,"Do pass",14,0,0,2,16
1709842,1369548,2024-01-25,Assembly,"AB 1142 Mike Fong Assembly Third Reading",68,0,0,12,80
1709842,1462561,2024-07-03,Senate,"Do pass, but first be re-referred to the Committee on [Governmental Organization]",7,0,0,0,7
1709842,1465267,2024-08-19,Senate,"Assembly 3rd Reading AB1142 Mike Fong By Wilk",40,0,0,0,40
1709842,1465673,2024-08-26,Assembly,"AB 1142 Mike Fong Concurrence in Senate Amendments",77,0,0,2,79
1709845,1311752,2023-04-25,Assembly,"Do pass and be re-referred to the Committee on [Appropriations]",7,0,0,1,8
1709845,1328591,2023-05-18,Assembly,"Do pass",15,0,0,1,16
1709845,1335520,2023-05-30,Assembly,"AB 979 Alvarez Assembly Third Reading",80,0,0,0,80
1709845,1346213,2023-06-21,Senate,"Do pass, but first be re-referred to the Committee on [Human Services] with the recommendation: To Consent Calendar",12,0,0,0,12
1709845,1349582,2023-07-03,Senate,"Do pass, but first be re-referred to the Committee on [Appropriations] with the recommendation: To Consent Calendar",5,0,0,0,5
1709845,1352204,2023-08-24,Senate,"Consent Calendar 2nd AB979 Alvarez",40,0,0,0,40
1709845,1352330,2023-08-28,Assembly,"AB 979 Alvarez Concurrence in Senate Amendments",75,0,0,5,80
1709846,1285761,2023-03-27,Assembly,"Do pass and be re-referred to the Committee on [Appropriations] with recommendation: To Consent Calendar",15,0,0,0,15
1709847,1285716,2023-03-27,Assembly,"Do pass and be re-referred to the Committee on [Appropriations] with recommendation: To Consent Calendar",15,0,0,0,15
1709848,1281813,2023-03-22,Assembly,"Do pass as amended and be re-referred to the Committee on [Appropriations]",14,0,0,1,15
1709850,1313531,2023-04-26,Assembly,"Do pass as amended, and be re-referred to the Committee on [Appropriations] with recommendation: To Consent Calendar",7,0,0,0,7
1709850,1328874,2023-05-18,Assembly,"Do pass",15,0,0,1,16
1709851,1310136,2023-04-24,Assembly,"Do pass and be re-referred to the Committee on [Appropriations]",8,3,0,0,11
1709851,1328803,2023-05-18,Assembly,"Do pass as amended",11,4,0,1,16
1709851,1337934,2023-05-31,Assembly,"AB 985 Arambula Assembly Third Reading",45,21,0,14,80
1709851,1349627,2023-07-05,Senate,"Do pass as amended, but first amend, and re-refer to the Committee on [Appropriations]",5,2,0,0,7
1709851,1351824,2023-08-21,Senate,"Placed on suspense file",7,0,0,0,7
1709851,1352668,2023-09-01,Senate,"Do pass",5,2,0,0,7
1709851,1353896,2023-09-12,Senate,"Assembly 3rd Reading AB985 Arambula et al. By Laird",28,8,0,4,40
1709851,1354431,2023-09-13,Assembly,"AB 985 Arambula Concurrence in Senate Amendments",38,21,0,21,80
1709854,1288296,2023-03-29,Assembly,"Do pass as amended. To Consent Calendar",13,0,0,0,13
1709854,1302649,2023-04-17,Assembly,"AB 988 Mathis Consent Calendar Second Day Regular Session",79,0,0,1,80
1709854,1343767,2023-06-13,Senate,"Do pass and be ordered to the Consent Calendar",14,0,0,1,15
1709854,1345196,2023-06-19,Senate,"Consent Calendar AB988 Mathis et al",39,0,0,1,40
1709854,1354593,2023-09-14,Senate,"Assembly 3rd Reading AB988 Mathis et al. By Ochoa Bogh",40,0,0,0,40
1709854,1354594,2023-09-14,Assembly,"AB 988 Mathis Concurrence in Senate Amendments",80,0,0,0,80
1709856,1305380,2023-04-18,Assembly,"Do pass and be re-referred to the Committee on [Appropriations] with recommendation: To Consent Calendar",9,0,0,0,9
1709856,1366790,2024-01-18,Assembly,"Do pass",15,0,0,1,16
1709856,1371117,2024-01-29,Assembly,"AB 990 Grayson Assembly Third Reading",75,0,0,5,80
1709856,1454235,2024-06-05,Senate,"Do pass, but first be re-referred to the Committee on [Appropriations]",7,0,0,0,7
1709856,1458005,2024-06-17,Senate,"Placed on suspense file",7,0,0,0,7
1709857,1310304,2023-04-25,Assembly,"Do pass and be re-referred to the Committee on [Appropriations]",7,0,0,1,8
1709859,1286871,2023-03-28,Assembly,"Do pass and be re-referred to the Committee on [Appropriations]",18,0,0,1,19
1709859,1305527,2023-04-19,Assembly,"Do pass. To Consent Calendar",14,0,0,2,16
1709859,1313438,2023-04-27,Assembly,"AB 993 Blanca Rubio Consent Calendar Second Day Regular Session",79,0,0,1,80
1709859,1338781,2023-06-05,Senate,"Do pass, but first be re-referred to the Committee on [Appropriations]",13,0,0,0,13
1709859,1353170,2023-09-05,Senate,"Assembly 3rd Reading AB993 Blanca Rubio By Glazer",39,0,0,1,40
1709860,1281828,2023-03-21,Assembly,"Do pass and be re-referred to the Committee on [Privacy and Consumer Protection]",5,2,0,1,8
1709860,1311861,2023-04-25,Assembly,"Do pass as amended and be re-referred to the Committee on [Appropriations]",8,3,0,0,11
1709860,1322930,2023-05-10,Assembly,"Do pass",12,3,0,1,16
1709860,1333576,2023-05-25,Assembly,"AB 994 Jackson Assembly Third Reading",48,17,0,15,80
1709860,1345658,2023-06-20,Senate,"Do pass, but first be re-referred to the Committee on [Judiciary]",4,1,0,0,5
1709860,1349802,2023-07-06,Senate,"Do pass, but first be re-referred to the Committee on [Appropriations]",7,2,0,2,11
1709860,1353120,2023-09-05,Senate,"Assembly 3rd Reading AB994 Jackson et al. By Wiener",26,11,0,3,40
1709860,1353447,2023-09-07,Assembly,"AB 994 Jackson Concurrence in Senate Amendments",52,20,0,8,80
1709862,1310387,2023-04-25,Assembly,"Do pass and be re-referred to the Committee on [Appropriations]",16,0,0,2,18
1709862,1326925,2023-05-17,Assembly,"Do pass",16,0,0,0,16
1709862,1333727,2023-05-25,Assembly,"AB 996 Low Assembly Third Reading",78,0,0,2,80
1709862,1345192,2023-06-19,Senate,"Do pass, but first be re-referred to the Committee on [Appropriations]",11,0,0,2,13
1709862,1462369,2024-07-02,Senate,"Do pass as amended, but first amend, and re-refer to the Committee on [Appropriations]",7,0,0,0,7
1709862,1463400,2024-08-05,Senate,"Placed on suspense file",7,0,0,0,7
1709863,1281923,2023-03-21,Assembly,"Do pass and be re-referred to the Committee on [Appropriations] with recommendation: To Consent Calendar",8,0,0,0,8
1709863,1328628,2023-05-18,Assembly,"Do pass as amended",11,0,0,5,16
1709863,1335563,2023-05-30,Assembly,"AB 997 Gipson Assembly Third Reading",80,0,0,0,80
1709863,1345638,2023-06-20,Senate,"Do pass, but first be re-referred to the Committee on [Appropriations] with the recommendation: To Consent Calendar",5,0,0,0,5
1709863,1349535,2023-07-03,Senate,"Placed on suspense file",7,0,0,0,7
1709864,1285687,2023-03-27,Assembly,"Do pass and be re-referred to the Committee on [Utilities and Energy] with recommendation: To Consent Calendar",11,0,0,0,11
1709864,1299443,2023-04-12,Assembly,"Do pass as amended, and be re-referred to the Committee on [Appropriations] with recommendation: To Consent Calendar",15,0,0,0,15
1709864,1328659,2023-05-18,Assembly,"Do pass",15,0,0,1,16
1709864,1335399,2023-05-30,Assembly,"AB 998 Connolly Assembly Third Reading",80,0,0,0,80
1709864,1345594,2023-06-20,Senate,"Do pass as amended, but first amend, and re-refer to the Committee on [Appropriations]",18,0,0,0,18
1709864,1349920,2023-07-10,Senate,"Placed on suspense file",6,0,0,1,7
1709866,1323899,2023-05-11,Assembly,"Be adopted. To Consent Calendar",10,0,0,3,13
1709866,1328499,2023-05-18,Assembly,"ACR 17 Ramos Consent Calendar Second Day Regular Session",74,0,0,6,80
1709866,1353006,2023-09-01,Senate,"Assembly 3rd Reading ACR17 Ramos et al. By Gonzalez",37,0,0,3,40
1709866,1353161,2023-09-05,Assembly,"ACR 17 Ramos Concurrence in Senate Amendments",79,0,0,1,80
1709867,1288174,2023-03-29,Senate,"Do pass as amended, but first amend, and re-refer to the Committee on [Appropriations] with the recommendation: To Consent Calendar",8,0,0,0,8
1709867,1302610,2023-04-17,Senate,"Placed on suspense file",6,0,0,1,7
1709867,1328254,2023-05-18,Senate,"Do pass",7,0,0,0,7
1709867,1333545,2023-05-25,Senate,"Special Consent SB542 Dahle et al. Urgency Clause",40,0,0,0,40
1709867,1350238,2023-07-10,Assembly,"Do pass as amended and be re-referred to the Committee on [Appropriations]",10,0,0,1,11
1709867,1462253,2024-07-01,Assembly,"Do pass as amended and be re-referred to the Committee on [Appropriations]",6,0,0,1,7
1709867,1464142,2024-08-15,Assembly,"Do pass",14,0,0,1,15
1709867,1465657,2024-08-26,Assembly,"SB 542 Dahle Third Reading Urgency By Gallagher",77,0,0,2,79
1709867,1467095,2024-08-28,Senate,"Special Consent SB542 Dahle et al. Urgency Clause",39,0,0,1,40
1709869,1298323,2023-04-11,Senate,"Do pass, but first be re-referred to the Committee on [Judiciary]",13,1,0,1,15
1709869,1311733,2023-04-25,Senate,"Do pass as amended, but first amend, and re-refer to the Committee on [Appropriations]",9,0,0,2,11
1709869,1324981,2023-05-15,Senate,"Senate 3rd Reading SB544 Laird",26,3,0,11,40
1709869,1350453,2023-07-12,Assembly,"Do pass as amended and be re-referred to the Committee on [Appropriations]",12,2,0,8,22
1709869,1352937,2023-09-01,Assembly,"Do pass",14,0,0,2,16
1709869,1354377,2023-09-13,Assembly,"SB 544 Laird Senate Third Reading By Berman",50,15,0,15,80
1709869,1354611,2023-09-14,Senate,"Unfinished Business SB544 Laird Concurrence",30,5,0,5,40
1709870,1298196,2023-04-11,Senate,"Do pass, but first be re-referred to the Committee on [Appropriations]",5,0,0,0,5
1709870,1330098,2023-05-22,Senate,"Senate 3rd Reading SB545 Rubio et al",37,0,0,3,40
1709870,1343725,2023-06-13,Assembly,"Do pass as amended and be re-referred to the Committee on [Appropriations]",7,0,0,1,8
1709870,1348364,2023-06-28,Assembly,"Do pass",10,0,0,6,16
1709870,1352312,2023-08-28,Assembly,"SB 545 Rubio Senate Third Reading By Bryan Amend By BRYAN Set #1",62,2,0,16,80
1709870,1353656,2023-09-11,Assembly,"SB 545 Rubio Senate Third Reading By Bryan",64,4,0,12,80
1709870,1353843,2023-09-12,Senate,"Unfinished Business SB545 Rubio et al. Concurrence",39,0,0,1,40
1709871,1363953,2024-01-10,Senate,"Do pass, but first be re-referred to the Committee on [Appropriations]",5,2,0,1,8
1709871,1364821,2024-01-16,Senate,"Placed on suspense file",6,0,0,1,7
1709872,1304246,2023-04-18,Senate,"Do pass, but first be re-referred to the Committee on [Housing]",3,0,0,1,4
1709872,1310164,2023-04-24,Senate,"Do pass, but first be re-referred to the Committee on [Appropriations] with the recommendation: To Consent Calendar",11,0,0,0,11
1709872,1323835,2023-05-11,Senate,"Consent Calendar SB547 Blakespear",39,0,0,1,40
1709873,1306762,2023-04-19,Senate,"Do pass as amended, but first amend, and re-refer to the Committee on [Appropriations] with the recommendation: To Consent Calendar",5,0,0,0,5
1709873,1315676,2023-05-01,Senate,"Placed on suspense file",6,0,0,1,7
1709873,1328605,2023-05-18,Senate,"Do pass",7,0,0,0,7
1709873,1333600,2023-05-25,Senate,"Special Consent SB548 Niello",40,0,0,0,40
1709873,1348440,2023-06-28,Assembly,"Do pass as amended and be re-referred to the Committee on [Appropriations]",7,0,0,0,7
1709873,1352680,2023-09-01,Assembly,"Do pass",16,0,0,0,16
1709873,1353691,2023-09-11,Assembly,"SB 548 Niello Senate Third Reading By Joe Patterson",80,0,0,0,80
1709873,1354415,2023-09-13,Senate,"Unfinished Business SB548 Niello Concurrence",39,0,0,1,40
1709874,1305276,2023-04-19,Senate,"Do pass, but first be re-referred to the Committee on [Appropriations] with the recommendation: To Consent Calendar",7,0,0,0,7
1709874,1318965,2023-05-04,Senate,"Consent Calendar SB549 Newman",37,0,0,3,40
1709874,1349636,2023-07-05,Assembly,"Do pass as amended and be re-referred to the Committee on [Rules]",6,0,0,5,11
1709874,1462320,2024-07-02,Assembly,"Do pass and be re-referred to the Committee on [Appropriations]",15,1,0,6,22
1709874,1464621,2024-08-15,Assembly,"Do pass as amended",14,0,0,1,15
1709874,1466273,2024-08-29,Assembly,"SB 549 Newman Senate Third Reading By Aguiar-Curry",62,0,0,17,79
1709874,1467077,2024-08-31,Senate,"Unfinished Business SB549 Newman et al. Concurrence",32,2,0,6,40
1709875,1286946,2023-03-28,Senate,"Do pass, but first be re-referred to the Committee on [Appropriations] with the recommendation: To Consent Calendar",10,0,0,1,11
1709875,1296909,2023-04-10,Senate,"Placed on suspense file",7,0,0,0,7
1709876,1313336,2023-04-26,Senate,"Do pass as amended, but first amend, and re-refer to the Committee on [Appropriations]",11,0,0,1,12
1709876,1320526,2023-05-08,Senate,"Placed on suspense file",7,0,0,0,7
1709876,1328395,2023-05-18,Senate,"Do pass",7,0,0,0,7
1709876,1332646,2023-05-24,Senate,"Senate 3rd Reading SB551 Portantino et al",40,0,0,0,40
1709876,1343761,2023-06-13,Assembly,"Do pass as amended and be re-referred to the Committee on [Appropriations]",15,0,0,0,15
1709876,1352742,2023-09-01,Assembly,"Do pass",16,0,0,0,16
1709876,1411405,2024-03-19,Assembly,"Do pass as amended and be re-referred to the Committee on [Appropriations]",11,0,0,0,11
1709876,1464309,2024-08-15,Assembly,"Do pass",14,0,0,1,15
1709876,1465762,2024-08-26,Assembly,"SB 551 Portantino Third Reading Urgency By Irwin",77,0,0,2,79
1709876,1466063,2024-08-28,Senate,"That the Assembly amendments be concurred in",5,0,0,2,7
1709876,1466558,2024-08-30,Senate,"Special Consent SB551 Portantino Urgency Clause",40,0,0,0,40
1709877,1363614,2024-01-08,Senate,"Do pass, but first be re-referred to the Committee on [Housing]",12,0,0,1,13
1709877,1363740,2024-01-09,Senate,"Do pass, but first be re-referred to the Committee on [Appropriations]",10,0,0,0,10
1709877,1367503,2024-01-22,Senate,"Senate 3rd Reading SB552 Newman",39,0,0,1,40
1709877,1456280,2024-06-11,Assembly,"Do pass and be re-referred to the Committee on [Housing and Community Development]",17,0,0,1,18
1709877,1460498,2024-06-26,Assembly,"Do pass and be re-referred to the Committee on [Appropriations] with recommendation: To Consent Calendar",9,0,0,0,9
1709877,1463752,2024-08-07,Assembly,"Do pass. To Consent Calendar",14,0,0,1,15
1709877,1464386,2024-08-15,Assembly,"SB 552 Newman Consent Calendar Second Day Regular Session",75,0,0,4,79
1709877,1466503,2024-08-30,Assembly,"SB 552 Newman Senate Third Reading By Bains",77,0,0,2,79
1709877,1466993,2024-08-31,Senate,"Unfinished Business SB552 Newman et al. Concurrence",40,0,0,0,40
1709878,1301053,2023-04-12,Senate,"Do pass as amended, but first amend, and re-refer to the Committee on [Rules]",5,0,0,0,5
1709878,1311810,2023-04-25,Senate,"Do pass, but first be re-referred to the Committee on [Appropriations]",10,1,0,0,11
1709878,1320365,2023-05-08,Senate,"Placed on suspense file",7,0,0,0,7
1709878,1328179,2023-05-18,Senate,"Do pass",5,2,0,0,7
1709878,1336344,2023-05-31,Senate,"Senate 3rd Reading SB553 Cortese",29,8,0,3,40
1709878,1348403,2023-06-28,Assembly,"Do pass and be re-referred to the Committee on [Judiciary]",5,2,0,0,7
1709878,1349604,2023-07-05,Assembly,"Do pass as amended and be re-referred to the Committee on [Appropriations]",8,2,0,1,11
1709878,1352972,2023-09-01,Assembly,"Do pass as amended",10,4,0,2,16
1709878,1353632,2023-09-11,Assembly,"SB 553 Cortese Senate Third Reading By Ortega",55,17,0,8,80
1709878,1354011,2023-09-12,Senate,"Unfinished Business SB553 Cortese et al. Concurrence",29,8,0,3,40
1709879,1364118,2024-01-11,Senate,"Do pass, but first be re-referred to the Committee on [Appropriations]",9,1,0,1,11
1709879,1371124,2024-01-29,Senate,"Senate 3rd Reading SB554 Cortese",32,6,0,2,40
1709879,1453384,2024-06-04,Assembly,"Do pass",8,0,0,4,12
1709879,1465303,2024-08-19,Assembly,"SB 554 Cortese Senate Third Reading By Blanca Rubio",65,1,0,13,79
1709880,1310331,2023-04-24,Senate,"Do pass, but first be re-referred to the Committee on [Appropriations]",9,1,0,1,11
1709880,1320456,2023-05-08,Senate,"Placed on suspense file",7,0,0,0,7
1709880,1328292,2023-05-18,Senate,"Do pass",5,2,0,0,7
1709880,1336392,2023-05-31,Senate,"Senate 3rd Reading SB555 Wahab",31,8,0,1,40
1709880,1348352,2023-06-28,Assembly,"Do pass and be re-referred to the Committee on [Appropriations]",6,2,0,0,8
1709880,1354740,2023-09-14,Senate,"Unfinished Business SB555 Wahab Concurrence",30,9,0,1,40
1709880,1354741,2023-09-14,Assembly,"SB 555 Wahab Senate Third Reading By Haney",54,16,0,10,80
1709881,1311764,2023-04-25,Senate,"Do pass as amended, but first amend, and re-refer to the Committee on [Appropriations]",8,2,0,1,11
1709881,1325010,2023-05-15,Senate,"Placed on suspense file",7,0,0,0,7
1709882,1286879,2023-03-28,Senate,"Do pass, but first be re-referred to the Committee on [Appropriations] with the recommendation: To Consent Calendar",14,0,0,1,15
1709882,1296950,2023-04-10,Senate,"Placed on suspense file",7,0,0,0,7
1709882,1327956,2023-05-18,Senate,"Do pass as amended",7,0,0,0,7
1709882,1335404,2023-05-30,Senate,"Special Consent SB557 Lim√≥n",40,0,0,0,40
1709882,1346282,2023-06-21,Assembly,"Do pass and be re-referred to the Committee on [Appropriations] with recommendation: To Consent Calendar",6,0,0,1,7
1709882,1352620,2023-09-01,Assembly,"Do pass",16,0,0,0,16
1709882,1353915,2023-09-12,Assembly,"SB 557 Lim√≥n Senate Third Reading By Hart",80,0,0,0,80
1709883,1298275,2023-04-11,Senate,"Do pass as amended, but first amend, and re-refer to the Committee on [Judiciary]",5,0,0,0,5
1709883,1305270,2023-04-18,Senate,"Do pass, but first be re-referred to the Committee on [Appropriations] with the recommendation: To Consent Calendar",11,0,0,0,11
1709883,1315704,2023-05-01,Senate,"Placed on suspense file",6,0,0,1,7
1709883,1328565,2023-05-18,Senate,"Do pass",7,0,0,0,7
1709883,1333733,2023-05-25,Senate,"Special Consent SB558 Rubio",40,0,0,0,40
1709883,1349650,2023-07-05,Assembly,"Do pass as amended, and be re-referred to the Committee on [Appropriations] with recommendation: To Consent Calendar",10,0,0,1,11
1709883,1352551,2023-09-01,Assembly,"Do pass",16,0,0,0,16
1709883,1353659,2023-09-11,Assembly,"SB 558 Rubio Senate Third Reading By Addis",80,0,0,0,80
1709883,1353814,2023-09-12,Senate,"Unfinished Business SB558 Rubio Concurrence",39,0,0,1,40
1709884,1363754,2024-01-09,Senate,"Do pass as amended, but first amend, and re-refer to the Committee on [Appropriations]",7,3,0,1,11
1709884,1364815,2024-01-16,Senate,"Placed on suspense file",6,0,0,1,7
1709885,1305256,2023-04-19,Senate,"Do pass, but first be re-referred to the Committee on [Judiciary]",5,0,0,2,7
1709885,1311758,2023-04-25,Senate,"Do pass, but first be re-referred to the Committee on [Appropriations]",10,0,0,1,11
1709885,1320404,2023-05-08,Senate,"Placed on suspense file",7,0,0,0,7
1709888,1313491,2023-04-26,Senate,"Do pass as amended, but first amend, and re-refer to the Committee on [Appropriations]",8,0,0,0,8
1709888,1324929,2023-05-15,Senate,"Placed on suspense file",7,0,0,0,7
1709889,1299435,2023-04-11,Senate,"Do pass",9,0,0,2,11
1709889,1324968,2023-05-15,Senate,"Senate 3rd Reading SB564 Laird",37,0,0,3,40
1709889,1339977,2023-06-06,Assembly,"Do pass",10,0,0,1,11
1709889,1345195,2023-06-19,Assembly,"SB 564 Laird Senate Third Reading By Maienschein",70,0,0,10,80
1709890,1313442,2023-04-26,Senate,"Do pass, but first be re-referred to the Committee on [Appropriations]",6,1,0,1,8
1709890,1320542,2023-05-08,Senate,"Placed on suspense file",7,0,0,0,7
1709890,1328450,2023-05-18,Senate,"Do pass",5,2,0,0,7
1709890,1332647,2023-05-24,Senate,"Senate 3rd Reading SB565 Caballero et al",32,6,0,2,40
1709890,1348305,2023-06-26,Assembly,"Do pass as amended and be re-referred to the Committee on [Appropriations]",6,2,0,3,11
1709890,1352909,2023-09-01,Assembly,"Do pass as amended",11,4,0,1,16
1709890,1354269,2023-09-13,Assembly,"SB 565 Caballero Senate Third Reading By Irwin",62,15,0,3,80
1709890,1354526,2023-09-14,Senate,"Unfinished Business SB565 Caballero et al. Concurrence",32,8,0,0,40
1709891,1299405,2023-04-12,Senate,"Do pass, but first be re-referred to the Committee on [Appropriations] with the recommendation: To Consent Calendar",8,0,0,0,8
1709891,1315660,2023-05-01,Senate,"Consent Calendar SB566 Jones",37,0,0,3,40
1709891,1341024,2023-06-07,Assembly,"Do pass and be re-referred to the Committee on [Appropriations] with recommendation: To Consent Calendar",8,0,0,0,8
1709891,1346192,2023-06-21,Assembly,"Do pass. To Consent Calendar",13,0,0,3,16
1709891,1347881,2023-06-27,Assembly,"SB 566 Jones Consent Calendar Second Day Regular Session",78,0,0,2,80
1709891,1349781,2023-07-06,Senate,"Special Consent SB566 Jones",40,0,0,0,40
1709892,1311814,2023-04-25,Senate,"Do pass as amended, but first amend, and re-refer to the Committee on [Appropriations]",9,2,0,0,11
1709892,1324986,2023-05-15,Senate,"Placed on suspense file",7,0,0,0,7
1709892,1328054,2023-05-18,Senate,"Do pass as amended",5,2,0,0,7
1709892,1336325,2023-05-31,Senate,"Senate 3rd Reading SB567 Durazo et al",21,12,0,7,40
1709892,1348416,2023-06-28,Assembly,"Do pass as amended and be re-referred to the Committee on [Judiciary]",6,2,0,0,8
1709892,1350278,2023-07-11,Assembly,"Do pass as amended and be re-referred to the Committee on [Appropriations]",8,3,0,0,11
1709892,1352613,2023-09-01,Assembly,"Do pass",11,4,0,1,16
1709892,1354651,2023-09-14,Senate,"W/O REF. TO FILE SB567 Durazo",24,9,0,7,40
1709892,1354652,2023-09-14,Assembly,"SB 567 Durazo Senate Third Reading By McKinnor",55,16,0,9,80
1709893,1305517,2023-04-19,Senate,"Do pass, but first be re-referred to the Committee on [Appropriations]",6,1,0,0,7
1709893,1320364,2023-05-08,Senate,"Do pass",5,1,0,1,7
1709893,1332643,2023-05-24,Senate,"Senate 3rd Reading SB568 Newman",33,6,0,1,40
1709893,1346243,2023-06-20,Assembly,"Do pass and be re-referred to the Committee on [Natural Resources]",8,0,0,1,9
1709893,1350778,2023-07-10,Assembly,"Do pass and be re-referred to the Committee on [Appropriations]",11,0,0,0,11
1709893,1351589,2023-08-16,Assembly,"Do pass",14,1,0,1,16
1709893,1352465,2023-08-31,Assembly,"SB 568 Newman Senate Third Reading By Irwin",69,5,0,6,80
1709893,1354607,2023-09-11,Senate,"Unfinished Business SB568 Newman Concurrence",38,0,0,2,40
1709894,1299503,2023-04-12,Senate,"Do pass, but first be re-referred to the Committee on [Appropriations]",8,0,0,0,8
1709894,1308875,2023-04-24,Senate,"Placed on suspense file",7,0,0,0,7
1709894,1328810,2023-05-18,Senate,"Do pass",7,0,0,0,7
1709894,1333594,2023-05-25,Senate,"Special Consent SB569 Glazer et al",40,0,0,0,40
1709894,1349628,2023-07-05,Assembly,"Do pass and be re-referred to the Committee on [Appropriations]",7,0,0,1,8
1709895,1288183,2023-03-29,Senate,"Do pass as amended, but first amend, and re-refer to the Committee on [Appropriations]",12,0,0,0,12
1709895,1302611,2023-04-17,Senate,"Placed on suspense file",6,0,0,1,7
1709895,1328390,2023-05-18,Senate,"Do pass",7,0,0,0,7
1709895,1333579,2023-05-25,Senate,"Special Consent SB570 Becker et al",40,0,0,0,40
1709895,1350307,2023-07-11,Assembly,"Do pass as amended and be re-referred to the Committee on [Appropriations]",13,0,0,2,15
1709896,1363760,2024-01-09,Senate,"Do pass as amended, but first amend, and re-refer to the Committee on [Appropriations]",9,0,0,2,11
1709896,1364773,2024-01-16,Senate,"Placed on suspense file",6,0,0,1,7
1709896,1366814,2024-01-18,Senate,"Do pass",5,0,0,2,7
1709896,1371132,2024-01-29,Senate,"Senate 3rd Reading SB571 Allen et al",31,0,0,9,40
1709896,1462006,2024-07-01,Assembly,"Do pass as amended and be re-referred to the Committee on [Appropriations]",12,0,0,0,12
1709896,1464381,2024-08-15,Assembly,"Do pass as amended",11,0,0,4,15
1709896,1466415,2024-08-30,Senate,"Special Consent SB571 Allen et al",40,0,0,0,40
1709896,1466945,2024-08-28,Assembly,"SB 571 Allen Senate Third Reading By Friedman",77,0,0,2,79
1709897,1304306,2023-04-18,Senate,"Do pass as amended, but first amend, and re-refer to the Committee on [Appropriations]",17,0,0,1,18
1709897,1330042,2023-05-22,Senate,"Senate 3rd Reading SB572 Stern et al",40,0,0,0,40
1709897,1350497,2023-07-12,Assembly,"Do pass and be re-referred to the Committee on [Appropriations] with recommendation: To Consent Calendar",14,0,0,1,15
1709897,1352704,2023-09-01,Assembly,"Do pass as amended",11,0,0,5,16
1709897,1466060,2024-08-28,Assembly,"Do pass",21,0,0,1,22
1709897,1466849,2024-08-31,Senate,"Unfinished Business SB572 Smallwood-Cuevas et al. Concurrence",35,0,0,5,40
1709897,1466850,2024-08-31,Assembly,"SB 572 Smallwood-Cuevas Senate Third Reading By Bryan",76,0,0,3,79
1709898,1305416,2023-04-18,Senate,"Do pass as amended, but first amend, and re-refer to the Committee on [Appropriations]",4,0,0,3,7
1709900,1364111,2024-01-11,Senate,"Do pass, but first be re-referred to the Committee on [Appropriations]",9,0,0,2,11
1709900,1364827,2024-01-16,Senate,"Placed on suspense file",6,0,0,1,7
1709900,1366787,2024-01-18,Senate,"Do pass",5,0,0,2,7
1709900,1371128,2024-01-29,Senate,"Senate 3rd Reading SB575 Wahab",38,0,0,2,40
1709900,1453436,2024-06-04,Assembly,"Do pass and be re-referred to the Committee on [Appropriations] with recommendation: To Consent Calendar",8,0,0,4,12
1709900,1464159,2024-08-15,Assembly,"Do pass",14,0,0,1,15
1709900,1466325,2024-08-29,Senate,"Unfinished Business SB575 Wahab et al. Concurrence",40,0,0,0,40
1709900,1466792,2024-08-28,Assembly,"SB 575 Wahab Senate Third Reading By Kalra",77,0,0,2,79
1709902,1286934,2023-03-28,Senate,"Do pass, but first be re-referred to the Committee on [Appropriations] with the recommendation: To Consent Calendar",14,0,0,1,15
1709902,1296972,2023-04-10,Senate,"Placed on suspense file",7,0,0,0,7
1709902,1328738,2023-05-18,Senate,"Do pass",7,0,0,0,7
1709902,1333747,2023-05-25,Senate,"Special Consent SB577 Hurtado",40,0,0,0,40
1709902,1349947,2023-07-10,Assembly,"Do pass and be re-referred to the Committee on [Appropriations] with recommendation: To Consent Calendar",6,0,0,1,7
1709902,1352515,2023-09-01,Assembly,"Do pass as amended",11,0,0,5,16
1709902,1460441,2024-06-26,Assembly,"Do pass and be re-referred to the Committee on [Appropriations] with recommendation: To Consent Calendar",15,0,0,0,15
1709902,1463711,2024-08-07,Assembly,"Do pass. To Consent Calendar",14,0,0,1,15
1709902,1464284,2024-08-15,Assembly,"SB 577 Hurtado Consent Calendar Second Day Regular Session",75,0,0,4,79
1709902,1466139,2024-08-29,Senate,"Unfinished Business SB577 Hurtado et al. Concurrence",40,0,0,0,40
1709903,1299512,2023-04-11,Senate,"Do pass as amended, but first amend, and re-refer to the Committee on [Human Services] with the recommendation: To Consent Calendar",10,0,0,1,11
1709903,1310397,2023-04-24,Senate,"Do pass, but first be re-referred to the Committee on [Appropriations] with the recommendation: To Consent Calendar",5,0,0,0,5
1709903,1320448,2023-05-08,Senate,"Placed on suspense file",7,0,0,0,7
1709903,1328411,2023-05-18,Senate,"Do pass",7,0,0,0,7
1709903,1333563,2023-05-25,Senate,"Special Consent SB578 Ashby et al",40,0,0,0,40
1709903,1345652,2023-06-20,Assembly,"Do pass and be re-referred to the Committee on [Human Services] with recommendation: To Consent Calendar",10,0,0,1,11
1709903,1350303,2023-07-11,Assembly,"Do pass as amended and be re-referred to the Committee on [Appropriations]",7,0,0,1,8
1709903,1352713,2023-09-01,Assembly,"Do pass as amended",15,0,0,1,16
1709903,1354272,2023-09-13,Assembly,"SB 578 Ashby Senate Third Reading By Reyes",77,0,0,3,80
1709903,1354523,2023-09-14,Senate,"Unfinished Business SB578 Ashby et al. Concurrence",40,0,0,0,40
1709904,1304319,2023-04-18,Senate,"Do pass, but first be re-referred to the Committee on [Appropriations]",10,0,0,1,11
1709904,1323833,2023-05-11,Senate,"Senate 3rd Reading SB579 Umberg",39,0,0,1,40
1709904,1345644,2023-06-20,Assembly,"Do pass and be re-referred to the Committee on [Appropriations] with recommendation: To Consent Calendar",15,0,0,0,15
1709904,1351570,2023-08-16,Assembly,"Do pass. To Consent Calendar",15,0,0,1,16
1709904,1352198,2023-08-24,Assembly,"SB 579 Umberg Consent Calendar Second Day Regular Session",73,0,0,7,80
1709906,1311940,2023-04-25,Senate,"Do pass as amended, but first amend, and re-refer to the Committee on [Appropriations]",10,0,0,1,11
1709906,1320385,2023-05-08,Senate,"Placed on suspense file",7,0,0,0,7
1709907,1301008,2023-04-12,Senate,"Do pass as amended, but first amend, and re-refer to the Committee on [Judiciary]",11,0,0,1,12
1709907,1311892,2023-04-25,Senate,"Do pass, but first be re-referred to the Committee on [Appropriations]",11,0,0,0,11
1709907,1320474,2023-05-08,Senate,"Placed on suspense file",7,0,0,0,7
1709907,1328876,2023-05-18,Senate,"Do pass",7,0,0,0,7
1709907,1332651,2023-05-24,Senate,"Senate 3rd Reading SB582 Becker",39,0,0,1,40
1709907,1347845,2023-06-27,Assembly,"Do pass as amended and be re-referred to the Committee on [Appropriations]",15,0,0,0,15
1709907,1352687,2023-09-01,Assembly,"Do pass as amended",11,0,0,5,16
1709907,1353513,2023-09-07,Assembly,"SB 582 Becker Senate Third Reading Amendment Set #1",61,16,0,3,80
1709907,1353853,2023-09-12,Assembly,"SB 582 Becker Senate Third Reading By Boerner",78,0,0,2,80
1709907,1354191,2023-09-13,Senate,"That the Assembly amendments be concurred in",10,0,0,2,12
1709907,1354855,2023-09-14,Senate,"Unfinished Business SB582 Becker Concurrence",40,0,0,0,40
1709908,1304257,2023-04-18,Senate,"Do pass, but first be re-referred to the Committee on [Appropriations]",10,0,0,1,11
1709908,1315723,2023-05-01,Senate,"Placed on suspense file",6,0,0,1,7
1709908,1328553,2023-05-18,Senate,"Do pass as amended",7,0,0,0,7
1709908,1336376,2023-05-31,Senate,"Senate 3rd Reading SB583 Padilla et al",39,0,0,1,40
1709908,1347489,2023-06-26,Assembly,"Do pass as amended and be re-referred to the Committee on [Appropriations]",10,0,0,1,11
1709908,1352679,2023-09-01,Assembly,"Do pass as amended",12,0,0,4,16
1709908,1353473,2023-09-07,Assembly,"SB 583 Padilla Senate Third Reading",68,0,0,12,80
1709908,1466327,2024-08-29,Assembly,"SB 583 Padilla Senate Third Reading By Garcia",66,0,0,13,79
1709908,1466597,2024-08-30,Senate,"Unfinished Business SB583 Padilla et al. Concurrence",40,0,0,0,40
1709909,1305398,2023-04-18,Senate,"Do pass, but first be re-referred to the Committee on [Governance and Finance]",8,2,0,1,11
1709909,1313494,2023-04-26,Senate,"Do pass as amended, but first amend, and re-refer to the Committee on [Appropriations]",5,2,0,1,8
1709909,1324928,2023-05-15,Senate,"Placed on suspense file",7,0,0,0,7
1709909,1328453,2023-05-18,Senate,"Do pass as amended",5,2,0,0,7
1709909,1336389,2023-05-31,Senate,"Senate 3rd Reading SB584 Lim√≥n et al. Urgency Clause",27,11,0,2,40
1709910,1317088,2023-05-02,Senate,"Do pass",8,0,0,3,11
1709910,1335383,2023-05-30,Senate,"Senate 3rd Reading SB585 Niello",29,7,0,4,40
1709911,1286998,2023-03-28,Senate,"Do pass as amended, but first amend, and re-refer to the Committee on [Governance and Finance]",9,0,0,2,11
1709911,1305265,2023-04-19,Senate,"Do pass as amended, but first amend, and re-refer to the Committee on [Appropriations]",8,0,0,0,8
1709911,1330048,2023-05-22,Senate,"Senate 3rd Reading SB586 Eggman",40,0,0,0,40
1709911,1345664,2023-06-20,Assembly,"Do pass and be re-referred to the Committee on [Appropriations]",15,0,0,0,15
1709911,1352968,2023-09-01,Assembly,"Do pass as amended",11,0,0,5,16
1709911,1425931,2024-04-11,Assembly,"SB 586 Eggman Third Reading Urgency By Aguiar-Curry",73,0,0,7,80
1709911,1431032,2024-04-18,Senate,"Special Consent SB586 Eggman et al. Urgency Clause",39,0,0,1,40
1709913,1318004,2023-05-03,Senate,"Do pass, but first be re-referred to the Committee on [Appropriations]",7,0,0,1,8
1709913,1325003,2023-05-15,Senate,"Placed on suspense file",7,0,0,0,7
1709913,1328044,2023-05-18,Senate,"Do pass",7,0,0,0,7
1709913,1334462,2023-05-26,Senate,"Senate 3rd Reading SB588 Allen",37,0,0,3,40
1709914,1310195,2023-04-24,Senate,"Do pass, but first be re-referred to the Committee on [Appropriations] with the recommendation: To Consent Calendar",5,0,0,0,5
1709914,1320382,2023-05-08,Senate,"Placed on suspense file",7,0,0,0,7
1709914,1328432,2023-05-18,Senate,"Do pass as amended",7,0,0,0,7
1709914,1335540,2023-05-30,Senate,"Special Consent SB589 Alvarado-Gil et al",40,0,0,0,40
1709914,1350319,2023-07-11,Assembly,"Do pass and be re-referred to the Committee on [Appropriations]",7,0,0,1,8
1709916,1298278,2023-04-11,Senate,"Do pass, but first be re-referred to the Committee on [Judiciary] with the recommendation: To Consent Calendar",15,0,0,0,15
1709916,1305363,2023-04-18,Senate,"Do pass, but first be re-referred to the Committee on [Appropriations] with the recommendation: To Consent Calendar",11,0,0,0,11
1709916,1315747,2023-05-01,Senate,"Placed on suspense file",6,0,0,1,7
1709917,1306731,2023-04-19,Senate,"Do pass, but first be re-referred to the Committee on [Judiciary]",1,3,0,1,5
1709917,1306732,2023-04-19,Senate,"[Second] hearing set for [04-20-2023]: Failed passage in Committee. Reconsideration granted",5,0,0,0,5
1709918,1288178,2023-03-29,Senate,"Do pass, but first be re-referred to the Committee on [Housing]",7,0,0,1,8
1709918,1317050,2023-05-02,Senate,"Do pass, but first be re-referred to the Committee on [Appropriations]",10,0,0,1,11
1709918,1323851,2023-05-11,Senate,"Senate 3rd Reading SB593 Wiener et al",35,2,0,3,40
1709918,1346267,2023-06-21,Assembly,"Do pass and be re-referred to the Committee on [Housing and Community Development]",7,1,0,0,8
1709918,1348316,2023-06-28,Assembly,"Do pass as amended",6,0,0,2,8
1709918,1353617,2023-09-11,Assembly,"SB 593 Wiener Senate Third Reading By Ting",61,13,0,6,80
1709918,1354053,2023-09-12,Senate,"Unfinished Business SB593 Wiener et al. Concurrence",34,0,0,6,40
1709919,1305465,2023-04-19,Senate,"Do pass, but first be re-referred to the Committee on [Judiciary]",5,2,0,0,7
1709919,1311721,2023-04-25,Senate,"Do pass as amended, but first amend, and re-refer to the Committee on [Appropriations]",8,2,0,1,11
1709919,1320440,2023-05-08,Senate,"Placed on suspense file",7,0,0,0,7
1709920,1281812,2023-03-22,Senate,"Do pass, but first be re-referred to the Committee on [Judiciary] with the recommendation: To Consent Calendar",11,0,0,1,12
1709920,1299440,2023-04-11,Senate,"Do pass as amended, but first amend, and re-refer to the Committee on [Appropriations]",10,0,0,1,11
1709920,1330102,2023-05-22,Senate,"Senate 3rd Reading SB595 Roth",40,0,0,0,40
1709920,1347836,2023-06-27,Assembly,"Do pass as amended and be re-referred to the Committee on [Health]",11,0,0,0,11
1709920,1350177,2023-07-11,Assembly,"Do pass and be re-referred to the Committee on [Appropriations] with recommendation: To Consent Calendar",15,0,0,0,15
1709920,1351568,2023-08-16,Assembly,"Do pass. To Consent Calendar",15,0,0,1,16
1709920,1352264,2023-08-24,Assembly,"SB 595 Roth Consent Calendar Second Day Regular Session",73,0,0,7,80
1709920,1352975,2023-09-01,Senate,"Special Consent SB595 Roth",37,0,0,3,40
1709921,1299444,2023-04-12,Senate,"Do pass, but first be re-referred to the Committee on [Public Safety]",5,0,0,2,7
1709921,1310366,2023-04-25,Senate,"Do pass, but first be re-referred to the Committee on [Appropriations]",4,1,0,0,5
1709921,1320503,2023-05-08,Senate,"Placed on suspense file",7,0,0,0,7
1709921,1328891,2023-05-18,Senate,"Do pass",5,2,0,0,7
1709921,1332600,2023-05-24,Senate,"Senate 3rd Reading SB596 Portantino",30,8,0,2,40
1709921,1348891,2023-06-28,Assembly,"Do pass and be re-referred to the Committee on [Public Safety]",6,0,0,1,7
1709921,1350254,2023-07-11,Assembly,"Do pass and be re-referred to the Committee on [Appropriations]",6,0,0,2,8
1709921,1352789,2023-09-01,Assembly,"Do pass",12,3,0,1,16
1709921,1353627,2023-09-11,Assembly,"SB 596 Portantino Senate Third Reading By Zbur",65,8,0,7,80
1709921,1353719,2023-09-12,Senate,"Unfinished Business SB596 Portantino Concurrence",30,8,0,2,40
1709922,1305515,2023-04-18,Senate,"Do pass, but first be re-referred to the Committee on [Appropriations]",8,2,0,1,11
1709922,1315717,2023-05-01,Senate,"Placed on suspense file",6,0,0,1,7
1709922,1328460,2023-05-18,Senate,"Do pass",5,2,0,0,7
1709922,1332627,2023-05-24,Senate,"Senate 3rd Reading SB597 Glazer",29,9,0,2,40
1709922,1346296,2023-06-21,Assembly,"Do pass as amended and be re-referred to the Committee on [Appropriations]",6,0,0,2,8
1709922,1464447,2024-08-15,Assembly,"Do pass as amended",11,2,0,2,15
1709922,1466317,2024-08-29,Senate,"Unfinished Business SB597 Glazer et al. Concurrence",39,1,0,0,40
1709922,1466827,2024-08-28,Assembly,"SB 597 Glazer Senate Third Reading By Boerner",60,13,0,6,79
1709923,1300979,2023-04-12,Senate,"Do pass as amended, but first amend, and re-refer to the Committee on [Appropriations]",10,0,0,2,12
1709923,1308868,2023-04-24,Senate,"Placed on suspense file",7,0,0,0,7
1709923,1328650,2023-05-18,Senate,"Do pass",5,2,0,0,7
1709923,1332557,2023-05-24,Senate,"Senate 3rd Reading SB598 Skinner et al",33,2,0,5,40
1709923,1350306,2023-07-11,Assembly,"Do pass as amended and be re-referred to the Committee on [Appropriations]",11,0,0,4,15
1709924,1305434,2023-04-18,Senate,"Do pass, but first be re-referred to the Committee on [Appropriations]",11,0,0,0,11
1709924,1320453,2023-05-08,Senate,"Placed on suspense file",7,0,0,0,7
1709924,1328304,2023-05-18,Senate,"Do pass as amended",7,0,0,0,7
1709924,1336341,2023-05-31,Senate,"Senate 3rd Reading SB599 Caballero et al",40,0,0,0,40
1709924,1345630,2023-06-20,Assembly,"Do pass and be re-referred to the Committee on [Appropriations] with recommendation: To Consent Calendar",10,0,0,1,11
1709924,1351578,2023-08-16,Assembly,"Do pass. To Consent Calendar",15,0,0,1,16
1709924,1352853,2023-09-01,Assembly,"SB 599 Caballero Senate Third Reading By Petrie-Norris",60,3,0,17,80
1709924,1353401,2023-09-07,Senate,"Unfinished Business SB599 Caballero et al. Concurrence",40,0,0,0,40
1709925,1304402,2023-04-17,Senate,"Do pass, but first be re-referred to the Committee on [Appropriations]",4,0,0,1,5
1709925,1315688,2023-05-01,Senate,"Placed on suspense file",6,0,0,1,7
1709925,1328065,2023-05-18,Senate,"Do pass",5,1,0,1,7
1709925,1334476,2023-05-26,Senate,"Senate 3rd Reading SB600 Menjivar",34,0,0,6,40
1709926,1302620,2023-04-17,Senate,"Do pass, but first be re-referred to the Committee on [Public Safety]",13,0,0,0,13
1709926,1310297,2023-04-25,Senate,"Do pass, but first be re-referred to the Committee on [Appropriations]",5,0,0,0,5
1709926,1320497,2023-05-08,Senate,"Placed on suspense file",7,0,0,0,7
1709926,1328004,2023-05-18,Senate,"Do pass as amended",5,0,0,2,7
1709926,1332567,2023-05-24,Senate,"Senate 3rd Reading SB601 McGuire",40,0,0,0,40
1709926,1345576,2023-06-20,Assembly,"Do pass and be re-referred to the Committee on [Public Safety] with recommendation: To Consent Calendar",19,0,0,0,19
1709926,1350222,2023-07-11,Assembly,"Do pass as amended, and be re-referred to the Committee on [Appropriations] with recommendation: To Consent Calendar",8,0,0,0,8
1709926,1352677,2023-09-01,Assembly,"Do pass",16,0,0,0,16
1709926,1353763,2023-09-12,Assembly,"SB 601 McGuire Senate Third Reading By Berman",80,0,0,0,80
1709926,1354734,2023-09-14,Senate,"Unfinished Business SB601 McGuire Concurrence",40,0,0,0,40
1709927,1298304,2023-04-11,Senate,"Do pass and be ordered to the Consent Calendar",5,0,0,0,5
1709927,1302570,2023-04-17,Senate,"Consent Calendar SB602 Archuleta et al",37,0,0,3,40
1709927,1348453,2023-06-27,Assembly,"Do pass",7,0,0,1,8
1709927,1352484,2023-08-31,Assembly,"SB 602 Archuleta Senate Third Reading By Rendon",76,0,0,4,80
1709927,1353450,2023-09-07,Senate,"Special Consent SB602 Archuleta et al",40,0,0,0,40
1709928,1310372,2023-04-25,Senate,"Do pass as amended",5,0,0,0,5
1709928,1323826,2023-05-11,Senate,"Special Consent SB603 Rubio",39,0,0,1,40
1709928,1348451,2023-06-27,Assembly,"Do pass",8,0,0,0,8
1709928,1352733,2023-09-01,Assembly,"SB 603 Rubio Senate Third Reading By Bonta",73,0,0,7,80
1709928,1353284,2023-09-06,Senate,"Unfinished Business SB603 Rubio Concurrence",39,0,0,1,40
1709930,1304276,2023-04-18,Senate,"Do pass, but first be re-referred to the Committee on [Natural Resources and Water]",15,0,0,3,18
1709930,1315148,2023-04-25,Senate,"Do pass as amended, but first amend, and re-refer to the Committee on [Appropriations]",10,0,0,1,11
1709930,1320528,2023-05-08,Senate,"Placed on suspense file",7,0,0,0,7
1709930,1327993,2023-05-18,Senate,"Do pass",7,0,0,0,7
1709930,1333763,2023-05-25,Senate,"Special Consent SB605 Padilla et al",40,0,0,0,40
1709930,1348304,2023-06-28,Assembly,"Do pass as amended, and be re-referred to the Committee on [Appropriations] with recommendation: To Consent Calendar",14,0,0,1,15
1709930,1352787,2023-09-01,Assembly,"Do pass as amended",11,0,0,5,16
1709930,1354811,2023-09-14,Senate,"Unfinished Business SB605 Padilla et al. Concurrence",40,0,0,0,40
1709930,1354812,2023-09-14,Assembly,"SB 605 Padilla Senate Third Reading By Muratsuchi",80,0,0,0,80
1709931,1299522,2023-04-11,Senate,"Do pass, but first be re-referred to the Committee on [Appropriations] with the recommendation: To Consent Calendar",16,0,0,0,16
1709931,1308888,2023-04-24,Senate,"Placed on suspense file",7,0,0,0,7
1709931,1328030,2023-05-18,Senate,"Do pass",7,0,0,0,7
1709931,1333703,2023-05-25,Senate,"Special Consent SB606 Alvarado-Gil",40,0,0,0,40
1709931,1347849,2023-06-26,Assembly,"Do pass and be re-referred to the Committee on [Appropriations] with recommendation: To Consent Calendar",15,0,0,0,15
1709931,1352901,2023-09-01,Assembly,"Do pass",16,0,0,0,16
1709931,1353646,2023-09-11,Assembly,"SB 606 Alvarado-Gil Senate Third Reading By Bains",80,0,0,0,80
1709931,1353944,2023-09-12,Senate,"Unfinished Business SB606 Alvarado-Gil Concurrence",39,0,0,1,40
1709932,1363616,2024-01-08,Senate,"Do pass, but first be re-referred to the Committee on [Appropriations]",12,0,0,1,13
1709932,1367505,2024-01-22,Senate,"Senate 3rd Reading SB607 Portantino",39,0,0,1,40
1709932,1456340,2024-06-11,Assembly,"Do pass and be re-referred to the Committee on [Appropriations]",12,1,0,5,18
1709932,1462258,2024-07-02,Assembly,"Do pass",11,0,0,4,15
1709932,1465828,2024-08-27,Assembly,"SB 607 Portantino Senate Third Reading By Low",49,3,0,27,79
1709933,1280636,2023-03-20,Senate,"Do pass, but first be re-referred to the Committee on [Transportation]",5,0,0,0,5
1709933,1299501,2023-04-11,Senate,"Do pass, but first be re-referred to the Committee on [Appropriations]",14,0,0,2,16
1709933,1308861,2023-04-24,Senate,"Placed on suspense file",7,0,0,0,7
1709934,1281801,2023-03-22,Senate,"Do pass, but first be re-referred to the Committee on [Appropriations] with the recommendation: To Consent Calendar",7,0,0,0,7
1709934,1300992,2023-04-13,Senate,"Consent Calendar SB609 Caballero",36,0,0,4,40
1709934,1348826,2023-06-28,Assembly,"Do pass as amended, and be re-referred to the Committee on [Appropriations] with recommendation: To Consent Calendar",7,0,0,0,7
1709934,1351581,2023-08-16,Assembly,"Do pass. To Consent Calendar",15,0,0,1,16
1709934,1353072,2023-09-01,Assembly,"SB 609 Caballero Senate Third Reading By Soria",71,0,0,9,80
1709934,1354697,2023-09-11,Senate,"Unfinished Business SB609 Caballero Concurrence",39,0,0,1,40
1709935,1280659,2023-03-21,Senate,"Do pass, but first be re-referred to the Committee on [Appropriations]",17,0,0,1,18
1709935,1320518,2023-05-08,Senate,"Senate 3rd Reading SB610 Laird",36,0,0,4,40
1709935,1462115,2024-07-01,Assembly,"Do pass as amended and be re-referred to the Committee on [Appropriations]",9,0,0,3,12
1709936,1317066,2023-05-02,Senate,"Do pass as amended",10,1,0,0,11
1709936,1336370,2023-05-31,Senate,"Senate 3rd Reading SB611 Menjivar",32,3,0,5,40
1709936,1462247,2024-07-02,Assembly,"Do pass",10,1,0,1,12
1709936,1466013,2024-08-27,Assembly,"SB 611 Menjivar Senate Third Reading By Haney",63,7,0,9,79
1709936,1467067,2024-08-28,Senate,"Unfinished Business SB611 Menjivar Concurrence",31,6,0,3,40
1709937,1296960,2023-04-10,Senate,"Do pass as amended",13,0,0,0,13
1709937,1335577,2023-05-30,Senate,"Senate 3rd Reading SB612 Ochoa Bogh",40,0,0,0,40
1709937,1347833,2023-06-27,Assembly,"Do pass as amended",18,0,0,1,19
1709937,1352233,2023-08-24,Assembly,"SB 612 Ochoa Bogh Senate Third Reading By Bains",76,0,0,4,80
1709937,1352995,2023-09-01,Senate,"Special Consent SB612 Ochoa Bogh et al",37,0,0,3,40
1709938,1288364,2023-03-29,Senate,"Do pass as amended, but first amend, and re-refer to the Committee on [Appropriations] with the recommendation: To Consent Calendar",7,0,0,0,7
1709938,1315669,2023-05-01,Senate,"Placed on suspense file",6,0,0,1,7
1709938,1328272,2023-05-18,Senate,"Do pass",7,0,0,0,7
1709938,1333581,2023-05-25,Senate,"Special Consent SB613 Seyarto",40,0,0,0,40
1709938,1347511,2023-06-26,Assembly,"Do pass as amended, and be re-referred to the Committee on [Appropriations] with recommendation: To Consent Calendar",11,0,0,0,11
1709938,1352615,2023-09-01,Assembly,"Do pass",16,0,0,0,16
1709938,1353612,2023-09-11,Assembly,"SB 613 Seyarto Senate Third Reading By Sanchez",80,0,0,0,80
1709938,1354839,2023-09-14,Senate,"Unfinished Business SB613 Seyarto Concurrence",39,1,0,0,40
1709940,1288306,2023-03-29,Senate,"Do pass, but first be re-referred to the Committee on [Transportation]",7,0,0,0,7
1709940,1311815,2023-04-25,Senate,"Do pass, but first be re-referred to the Committee on [Appropriations]",16,0,0,0,16
1709940,1320467,2023-05-08,Senate,"Placed on suspense file",7,0,0,0,7
1709940,1328189,2023-05-18,Senate,"Do pass",7,0,0,0,7
1709940,1333784,2023-05-25,Senate,"Special Consent SB615 Allen et al",40,0,0,0,40
1709940,1460488,2024-06-25,Assembly,"Do pass and be re-referred to the Committee on [Natural Resources]",6,1,0,0,7
1709940,1461974,2024-07-01,Assembly,"Do pass as amended and be re-referred to the Committee on [Appropriations]",10,1,0,1,12
1709940,1464090,2024-08-15,Assembly,"Do pass as amended",11,3,0,1,15
1709940,1467114,2024-08-31,Senate,"Unfinished Business SB615 Allen et al. Concurrence",33,1,0,6,40
1709940,1467115,2024-08-31,Assembly,"SB 615 Allen Senate Third Reading By Aguiar-Curry",62,5,0,12,79
1709941,1306724,2023-04-19,Senate,"Do pass as amended, but first amend, and re-refer to the Committee on [Appropriations]",4,1,0,0,5
1709941,1320437,2023-05-08,Senate,"Placed on suspense file",7,0,0,0,7
1709941,1328899,2023-05-18,Senate,"Do pass",5,2,0,0,7
1709941,1336374,2023-05-31,Senate,"Senate 3rd Reading SB616 Gonzalez et al",27,9,0,4,40
1709941,1348472,2023-06-28,Assembly,"Do pass and be re-referred to the Committee on [Appropriations]",5,1,0,1,7
1709941,1352923,2023-09-01,Assembly,"Do pass as amended",11,3,0,2,16
1709941,1354032,2023-09-12,Assembly,"SB 616 Gonzalez Senate Third Reading By Haney",52,18,0,10,80
1709941,1354348,2023-09-13,Senate,"Unfinished Business SB616 Gonzalez et al. Concurrence",27,9,0,4,40
1709942,1299352,2023-04-11,Senate,"Do pass, but first be re-referred to the Committee on [Appropriations] with the recommendation: To Consent Calendar",16,0,0,0,16
1709942,1315722,2023-05-01,Senate,"Consent Calendar SB617 Newman",37,0,0,3,40
1709942,1346233,2023-06-21,Assembly,"Do pass as amended and be re-referred to the Committee on [Appropriations]",8,0,0,0,8
1709942,1351556,2023-08-16,Assembly,"Do pass. To Consent Calendar",15,0,0,1,16
1709942,1352197,2023-08-24,Assembly,"SB 617 Newman Consent Calendar Second Day Regular Session",73,0,0,7,80
1709942,1353022,2023-09-01,Senate,"Special Consent SB617 Newman",37,0,0,3,40
1709943,1305298,2023-04-18,Senate,"Do pass, but first be re-referred to the Committee on [Human Services]",11,0,0,0,11
1709943,1310345,2023-04-24,Senate,"Do pass, but first be re-referred to the Committee on [Appropriations]",4,0,0,1,5
1709943,1324940,2023-05-15,Senate,"Placed on suspense file",7,0,0,0,7
1709944,1310272,2023-04-24,Senate,"Do pass as amended, but first amend, and re-refer to the Committee on [Appropriations]",16,0,0,2,18
1709944,1324967,2023-05-15,Senate,"Placed on suspense file",7,0,0,0,7
1709944,1328582,2023-05-18,Senate,"Do pass",7,0,0,0,7
1709944,1335524,2023-05-30,Senate,"Senate 3rd Reading SB619 Padilla et al",37,0,0,3,40
1709944,1350451,2023-07-12,Assembly,"Do pass as amended, and be re-referred to the Committee on [Appropriations] with recommendation: To Consent Calendar",14,0,0,1,15
1709944,1350773,2023-07-10,Assembly,"Do pass and be re-referred to the Committee on [Utilities and Energy]",11,0,0,0,11
1709944,1352576,2023-09-01,Assembly,"Do pass as amended",11,0,0,5,16
1709944,1353485,2023-09-07,Assembly,"SB 619 Padilla Senate Third Reading By Muratsuchi",78,0,0,2,80
1709944,1353834,2023-09-12,Senate,"That the Assembly amendments be concurred in",14,0,0,4,18
1709944,1354424,2023-09-13,Senate,"Unfinished Business SB619 Padilla et al. Concurrence",39,0,0,1,40
1709945,1305426,2023-04-18,Senate,"Do pass as amended, but first amend, and re-refer to the Committee on [Appropriations]",10,0,0,1,11
1709945,1315779,2023-05-01,Senate,"Placed on suspense file",6,0,0,1,7
1709945,1328818,2023-05-18,Senate,"Do pass",7,0,0,0,7
1709945,1333560,2023-05-25,Senate,"Special Consent SB620 McGuire et al",40,0,0,0,40
1709945,1350545,2023-07-12,Assembly,"Do pass as amended and be re-referred to the Committee on [Appropriations]",8,0,0,0,8
1709945,1464092,2024-08-15,Assembly,"Do pass as amended",11,0,0,4,15
1709945,1466062,2024-08-28,Assembly,"Do pass",6,0,0,1,7
1709946,1313467,2023-04-26,Senate,"Do pass as amended, but first amend, and re-refer to the Committee on [Appropriations]",11,0,0,1,12
1709946,1325020,2023-05-15,Senate,"Do pass",7,0,0,0,7
1709946,1332690,2023-05-24,Senate,"Senate 3rd Reading SB621 Caballero",40,0,0,0,40
1709946,1345568,2023-06-20,Assembly,"Do pass and be re-referred to the Committee on [Appropriations]",14,0,0,1,15
1709946,1352110,2023-08-23,Assembly,"Do pass. To Consent Calendar",15,0,0,1,16
1709946,1352460,2023-08-31,Assembly,"SB 621 Caballero Consent Calendar Second Day Regular Session",79,0,0,1,80
1709947,1308873,2023-04-24,Senate,"Do pass, but first be re-referred to the Committee on [Appropriations]",12,0,0,1,13
1709947,1332611,2023-05-24,Senate,"Senate 3rd Reading SB622 Allen",37,0,0,3,40
1709947,1347868,2023-06-27,Assembly,"Do pass and be re-referred to the Committee on [Appropriations]",18,0,0,1,19
1709947,1351552,2023-08-16,Assembly,"Do pass. To Consent Calendar",15,0,0,1,16
1709947,1352200,2023-08-24,Assembly,"SB 622 Allen Consent Calendar Second Day Regular Session",73,0,0,7,80
1709947,1353205,2023-09-06,Senate,"Unfinished Business SB622 Allen et al. Concurrence",40,0,0,0,40
1709948,1301078,2023-04-12,Senate,"Do pass, but first be re-referred to the Committee on [Appropriations]",5,0,0,0,5
1709948,1308806,2023-04-24,Senate,"Placed on suspense file",7,0,0,0,7
1709948,1328445,2023-05-18,Senate,"Do pass",5,1,0,1,7
1709948,1330154,2023-05-22,Senate,"Senate 3rd Reading SB623 Laird et al",35,0,0,5,40
1709948,1348329,2023-06-28,Assembly,"Do pass and be re-referred to the Committee on [Appropriations]",13,0,0,1,14
1709948,1352954,2023-09-01,Assembly,"Do pass",15,0,0,1,16
1709948,1353597,2023-09-11,Assembly,"SB 623 Laird Senate Third Reading By Wood",79,0,0,1,80
1709948,1353881,2023-09-12,Senate,"Unfinished Business SB623 Laird et al. Concurrence",39,0,0,1,40
1709949,1272544,2023-03-09,Senate,"Senate 3rd Reading SCR29 Ashby et al",37,0,0,3,40
1709949,1283261,2023-03-23,Assembly,"Be adopted. To Consent Calendar",13,0,0,0,13
1709949,1289825,2023-03-30,Assembly,"SCR 29 Ashby Consent Calendar Second Day Regular Session",60,0,0,20,80
1709950,1263018,2023-02-27,Senate,"Senate 3rd Reading SR16 Dodd et al",36,0,0,4,40
1709951,1274189,2023-03-13,Senate,"Senate 3rd Reading SR17 Archuleta",37,0,0,3,40
1711890,1299492,2023-04-12,Assembly,"Do pass and be re-referred to the Committee on [Appropriations]",13,0,0,1,14
1711890,1327941,2023-05-18,Assembly,"Do pass",14,0,0,2,16
1711890,1333698,2023-05-25,Assembly,"AB 1145 Maienschein Assembly Third Reading",76,0,0,4,80
1711890,1348370,2023-06-28,Senate,"Do pass, but first be re-referred to the Committee on [Appropriations]",5,0,0,0,5
1711890,1349990,2023-07-10,Senate,"Placed on suspense file",6,0,0,1,7
1711890,1352927,2023-09-01,Senate,"Do pass",5,0,0,2,7
1711890,1354649,2023-09-11,Senate,"Assembly 3rd Reading AB1145 Maienschein By Laird",33,3,0,4,40
1711892,1298191,2023-04-11,Assembly,"Do pass and be re-referred to the Committee on [Human Services] with recommendation: To Consent Calendar",11,0,0,0,11
1711892,1304339,2023-04-18,Assembly,"Do pass and be re-referred to the Committee on [Appropriations]",7,0,0,1,8
1711892,1328718,2023-05-18,Assembly,"Do pass as amended",11,0,0,5,16
1711892,1338150,2023-05-31,Assembly,"AB 1147 Addis Assembly Third Reading",80,0,0,0,80
1711892,1349565,2023-07-03,Senate,"Do pass, but first be re-referred to the Committee on [Judiciary]",5,0,0,0,5
1711892,1350478,2023-07-11,Senate,"Do pass as amended, but first amend, and re-refer to the Committee on [Appropriations]",11,0,0,0,11
1711892,1351430,2023-08-14,Senate,"Placed on suspense file",7,0,0,0,7
1711892,1352697,2023-09-01,Senate,"Do pass as amended",7,0,0,0,7
1711892,1466571,2024-08-30,Senate,"Assembly 3rd Reading AB1147 Addis et al. By Menjivar",40,0,0,0,40
1711892,1467069,2024-08-31,Assembly,"AB 1147 Addis Concurrence in Senate Amendments",77,0,0,2,79
1711893,1317105,2023-05-02,Assembly,"Do pass as amended",7,3,0,1,11
1711893,1328284,2023-05-18,Assembly,"Do pass as amended",12,3,0,1,16
1711893,1337920,2023-05-31,Assembly,"AB 1148 Bonta Assembly Third Reading",57,10,0,13,80
1711893,1348394,2023-06-27,Senate,"Do pass as amended, but first amend, and re-refer to the Committee on [Human Services]",9,2,0,0,11
1711893,1350660,2023-07-13,Senate,"Do pass, but first be re-referred to the Committee on [Appropriations]",3,0,0,2,5
1711893,1351286,2023-08-14,Senate,"Placed on suspense file",7,0,0,0,7
1711893,1352492,2023-09-01,Senate,"Do pass",5,2,0,0,7
1711893,1354211,2023-09-13,Senate,"Assembly 3rd Reading AB1148 Bonta By Ashby",28,7,0,5,40
1711893,1354212,2023-09-13,Assembly,"AB 1148 Bonta Concurrence in Senate Amendments",56,14,0,10,80
1711894,1286892,2023-03-28,Assembly,"Do pass and be re-referred to the Committee on [Appropriations] with recommendation: To Consent Calendar",8,0,0,0,8
1711895,1286944,2023-03-28,Assembly,"Do pass and be re-referred to the Committee on [Appropriations]",15,0,0,0,15
1711895,1328068,2023-05-18,Assembly,"Do pass",15,0,0,1,16
1711895,1333798,2023-05-25,Assembly,"AB 1150 Water, Parks, and Wildli Assembly Third Reading",77,0,0,3,80
1711895,1346967,2023-06-22,Senate,"Do pass as amended, but first amend, and re-refer to the Committee on [Appropriations] with the recommendation: To Consent Calendar",11,0,0,0,11
1711895,1349994,2023-07-10,Senate,"Placed on suspense file",6,0,0,1,7
1711895,1352756,2023-09-01,Senate,"Do pass",7,0,0,0,7
1711895,1354284,2023-09-13,Senate,"Assembly 3rd Reading AB1150 W., P., & W. (Bauer-Kahan) By Min",39,0,0,1,40
1711895,1354625,2023-09-14,Assembly,"AB 1150 Water, Parks, and Wildli Concurrence in Senate Amendments By BAUER-KAHAN",80,0,0,0,80
1711896,1305444,2023-04-18,Assembly,"Do pass. To Consent Calendar",12,0,0,0,12
1711896,1313386,2023-04-27,Assembly,"AB 1151 McKinnor Consent Calendar Second Day Regular Session",79,0,0,1,80
1711896,1340962,2023-06-07,Senate,"Do pass and be ordered to the Consent Calendar",7,0,0,0,7
1711896,1344713,2023-06-15,Senate,"Consent Calendar AB1151 McKinnor",40,0,0,0,40
1711896,1346935,2023-06-22,Assembly,"AB 1151 McKinnor Concurrence in Senate Amendments",72,0,0,8,80
1711899,1286984,2023-03-28,Assembly,"Do pass and be re-referred to the Committee on [Judiciary]",7,0,0,1,8
1711899,1304261,2023-04-18,Assembly,"Do pass as amended, and be re-referred to the Committee on [Appropriations] with recommendation: To Consent Calendar",11,0,0,0,11
1711902,1310194,2023-04-25,Assembly,"Do pass and be re-referred to the Committee on [Appropriations]",12,0,0,3,15
1711902,1328144,2023-05-18,Assembly,"Do pass",12,1,0,3,16
1711902,1338094,2023-05-31,Assembly,"AB 1157 Ortega Assembly Third Reading",65,0,0,15,80
1711902,1350651,2023-07-12,Senate,"Do pass as amended, but first amend, and re-refer to the Committee on [Appropriations]",9,0,0,3,12
1711902,1351532,2023-08-14,Senate,"Placed on suspense file",7,0,0,0,7
1711904,1302004,2023-04-10,Assembly,"Do pass as amended and be re-referred to the Committee on [Appropriations]",11,0,0,0,11
1711904,1328671,2023-05-18,Assembly,"Do pass",15,0,0,1,16
1711904,1335480,2023-05-30,Assembly,"AB 1159 Aguiar-Curry Assembly Third Reading",80,0,0,0,80
1711904,1348283,2023-06-28,Senate,"Do pass as amended, but first amend, and re-refer to the Committee on [Natural Resources and Water]",7,0,0,0,7
1711904,1349925,2023-07-10,Senate,"Do pass, but first be re-referred to the Committee on [Appropriations] with the recommendation: To Consent Calendar",10,0,0,1,11
1711904,1352248,2023-08-24,Senate,"Consent Calendar 2nd AB1159 Aguiar-Curry",40,0,0,0,40
1711904,1352346,2023-08-28,Assembly,"AB 1159 Aguiar-Curry Concurrence in Senate Amendments",76,0,0,4,80
1711905,1363771,2024-01-09,Assembly,"Do pass as amended and be re-referred to the Committee on [Appropriations]",8,2,0,1,11
1711905,1366782,2024-01-18,Assembly,"Do pass as amended",12,3,0,1,16
1711905,1371103,2024-01-29,Assembly,"AB 1160 Pacheco Assembly Third Reading",61,8,0,11,80
1711905,1451604,2024-05-29,Senate,"Do pass, but first be re-referred to the Committee on [Judiciary]",5,1,0,1,7
1711905,1462513,2024-07-02,Senate,"Do pass as amended, but first amend, and re-refer to the Committee on [Appropriations]",8,0,0,3,11
1711905,1463454,2024-08-05,Senate,"Placed on suspense file",7,0,0,0,7
1711908,1305408,2023-04-19,Assembly,"Do pass and be re-referred to the Committee on [Appropriations]",4,0,0,3,7
1711908,1328623,2023-05-18,Assembly,"Do pass as amended",11,2,0,3,16
1711908,1337241,2023-06-01,Assembly,"AB 1163 Luz Rivas Assembly Third Reading",64,0,0,16,80
1711908,1347936,2023-06-27,Senate,"Do pass as amended, but first amend, and re-refer to the Committee on [Judiciary]",10,0,0,5,15
1711908,1350450,2023-07-11,Senate,"Do pass, but first be re-referred to the Committee on [Appropriations]",9,0,0,2,11
1711908,1351820,2023-08-21,Senate,"Placed on suspense file",7,0,0,0,7
1711908,1352738,2023-09-01,Senate,"Do pass as amended",5,0,0,2,7
1711908,1353780,2023-09-12,Senate,"Assembly 3rd Reading AB1163 Luz Rivas et al. By Padilla",31,0,0,9,40
1711908,1354444,2023-09-13,Assembly,"AB 1163 Luz Rivas Concurrence in Senate Amendments",64,3,0,13,80
1711909,1304322,2023-04-18,Assembly,"Do pass and be re-referred to the Committee on [Appropriations]",11,0,0,4,15
1711910,1313419,2023-04-26,Assembly,"Do pass. To Consent Calendar",7,0,0,0,7
1711910,1318910,2023-05-04,Assembly,"AB 1165 McCarty Consent Calendar Second Day Regular Session",75,0,0,5,80
1711910,1341026,2023-06-07,Senate,"Do pass and be ordered to the Consent Calendar",7,0,0,0,7
1711910,1344718,2023-06-15,Senate,"Consent Calendar AB1165 McCarty et al",40,0,0,0,40
1711911,1286874,2023-03-28,Assembly,"Do pass. To Consent Calendar",9,0,0,2,11
1711911,1296958,2023-04-10,Assembly,"AB 1166 Bains Consent Calendar Second Day Regular Session",65,0,0,15,80
1711911,1345565,2023-06-20,Senate,"Do pass and be ordered to the Consent Calendar",11,0,0,0,11
1711911,1348822,2023-06-29,Senate,"Consent Calendar AB1166 Bains",39,0,0,1,40
1711912,1285662,2023-03-27,Assembly,"Do pass and be re-referred to the Committee on [Appropriations]",8,3,0,0,11
1711912,1328273,2023-05-18,Assembly,"Do pass",11,4,0,1,16
1711912,1333717,2023-05-25,Assembly,"AB 1167 Wendy Carrillo Assembly Third Reading",49,16,0,15,80
1711912,1349448,2023-07-03,Senate,"Do pass, but first be re-referred to the Committee on [Appropriations]",6,2,0,3,11
1711912,1351819,2023-08-21,Senate,"Placed on suspense file",7,0,0,0,7
1711912,1352895,2023-09-01,Senate,"Do pass as amended",4,2,0,1,7
1711912,1354328,2023-09-13,Senate,"Assembly 3rd Reading AB1167 Wendy Carrillo et al By Laird",21,11,0,8,40
1711912,1354528,2023-09-14,Assembly,"AB 1167 Wendy Carrillo Concurrence in Senate Amendments",43,18,0,19,80
1711913,1298195,2023-04-11,Assembly,"Do pass as amended and be re-referred to the Committee on [Emergency Management]",12,1,0,2,15
1711913,1311829,2023-04-26,Assembly,"Amendments (Committee's)",6,1,0,0,7
1711913,1311830,2023-04-26,Assembly,"Do pass as amended and be re-referred to the Committee on [Appropriations]",6,1,0,0,7
1711913,1328504,2023-05-18,Assembly,"Do pass",12,2,0,2,16
1711913,1335430,2023-05-30,Assembly,"AB 1168 Bennett Assembly Third Reading",72,2,0,6,80
1711913,1348816,2023-06-28,Senate,"Do pass as amended, but first amend, and re-refer to the Committee on [Governance and Finance]",10,0,0,2,12
1711913,1350623,2023-07-12,Senate,"Do pass as amended, but first amend, and re-refer to the Committee on [Appropriations]",7,0,0,1,8
1711913,1351487,2023-08-14,Senate,"Placed on suspense file",7,0,0,0,7
1711913,1353062,2023-09-01,Senate,"Do pass",7,0,0,0,7
1711913,1465665,2024-08-26,Senate,"Assembly 3rd Reading AB1168 Bennett By Lim√≥n",33,2,0,5,40
1711913,1465846,2024-08-27,Assembly,"AB 1168 Bennett Concurrence in Senate Amendments",69,0,0,10,79
1711915,1363936,2024-01-10,Assembly,"Do pass and be re-referred to the Committee on [Appropriations]",7,0,0,1,8
1711915,1366788,2024-01-18,Assembly,"Do pass",15,0,0,1,16
1711915,1371112,2024-01-29,Assembly,"AB 1170 Valencia Assembly Third Reading",77,0,0,3,80
1711915,1453405,2024-06-04,Senate,"Do pass as amended, but first amend, and re-refer to the Committee on [Judiciary]",7,0,0,0,7
1711915,1460619,2024-06-25,Senate,"Do pass, but first be re-referred to the Committee on [Appropriations] with the recommendation: To Consent Calendar",11,0,0,0,11
1711915,1463879,2024-08-12,Senate,"Consent Calendar 2nd AB1170 Valencia",38,0,0,2,40
1711915,1465264,2024-08-19,Assembly,"AB 1170 Valencia Concurrence in Senate Amendments",76,0,0,3,79
1711916,1298321,2023-04-11,Assembly,"Do pass and be re-referred to the Committee on [Judiciary]",15,2,0,1,18
1711916,1317038,2023-05-02,Assembly,"Do pass as amended",10,0,0,1,11
1711916,1324996,2023-05-15,Assembly,"AB 1171 Blanca Rubio Assembly Third Reading",69,0,0,11,80
1711916,1349446,2023-07-03,Senate,"Do pass, but first be re-referred to the Committee on [Judiciary]",11,0,0,2,13
1711916,1350552,2023-07-11,Senate,"Do pass, but first be re-referred to the Committee on [Appropriations]",11,0,0,0,11
1711916,1351843,2023-08-21,Senate,"Placed on suspense file",7,0,0,0,7
1711916,1352893,2023-09-01,Senate,"Do pass",7,0,0,0,7
1711916,1353963,2023-09-12,Assembly,"AB 1171 Blanca Rubio Concurrence in Senate Amendments",74,5,0,1,80
1711916,1354865,2023-09-11,Senate,"Assembly 3rd Reading AB1171 Blanca Rubio et al. By Becker",39,0,0,1,40
1711917,1285712,2023-03-27,Assembly,"Do pass and be re-referred to the Committee on [Utilities and Energy] with recommendation: To Consent Calendar",11,0,0,0,11
1711917,1299472,2023-04-12,Assembly,"Do pass as amended, and be re-referred to the Committee on [Appropriations] with recommendation: To Consent Calendar",15,0,0,0,15
1711917,1328551,2023-05-18,Assembly,"Do pass",15,0,0,1,16
1711917,1333603,2023-05-25,Assembly,"AB 1172 Calderon Assembly Third Reading",77,0,0,3,80
1711917,1345624,2023-06-20,Senate,"Do pass as amended, but first amend, and re-refer to the Committee on [Appropriations]",16,0,0,2,18
1711917,1349966,2023-07-10,Senate,"Placed on suspense file",6,0,0,1,7
1711917,1352631,2023-09-01,Senate,"Do pass as amended",7,0,0,0,7
1711917,1354109,2023-09-13,Senate,"Special Consent AB1172 Calderon By Newman",39,0,0,1,40
1711917,1354538,2023-09-14,Assembly,"AB 1172 Calderon Concurrence in Senate Amendments",80,0,0,0,80
1711918,1283084,2023-03-22,Assembly,"Do pass as amended, and be re-referred to the Committee on [Higher Education] with recommendation: To Consent Calendar",7,0,0,0,7
1711918,1311913,2023-04-25,Assembly,"Do pass. To Consent Calendar",12,0,0,0,12
1711918,1318967,2023-05-04,Assembly,"AB 1173 Ta Consent Calendar Second Day Regular Session",75,0,0,5,80
1711918,1340980,2023-06-07,Senate,"Do pass and be ordered to the Consent Calendar",7,0,0,0,7
1711918,1344714,2023-06-15,Senate,"Consent Calendar AB1173 Ta et al. By Wilk",40,0,0,0,40
1711919,1281897,2023-03-22,Assembly,"Do pass. To Consent Calendar",20,0,0,2,22
1711919,1289790,2023-03-30,Assembly,"AB 1174 Joe Patterson Consent Calendar Second Day Regular Session",60,0,0,20,80
1711920,1311708,2023-04-26,Assembly,"Do pass as amended and be re-referred to the Committee on [Appropriations]",22,0,0,0,22
1711920,1328892,2023-05-18,Assembly,"Do pass as amended",11,0,0,5,16
1711920,1335442,2023-05-30,Assembly,"AB 1175 Quirk-Silva Assembly Third Reading",78,0,0,2,80
1711920,1348383,2023-06-27,Senate,"Do pass as amended, but first amend, and re-refer to the Committee on [Appropriations]",16,0,0,0,16
1711920,1351467,2023-08-14,Senate,"Placed on suspense file",7,0,0,0,7
1711920,1352824,2023-09-01,Senate,"Do pass as amended",7,0,0,0,7
1711920,1354390,2023-09-13,Senate,"Special Consent AB1175 Quirk-Silva et al. By Nguyen",39,0,0,1,40
1711920,1354634,2023-09-14,Assembly,"AB 1175 Quirk-Silva Concurrence in Senate Amendments",79,0,0,1,80
1711921,1313470,2023-04-26,Assembly,"Do pass as amended and be re-referred to the Committee on [Appropriations]",6,2,0,0,8
1711921,1326965,2023-05-17,Assembly,"Do pass",12,4,0,0,16
1711921,1337971,2023-05-31,Assembly,"AB 1176 Zbur Assembly Third Reading",70,5,0,5,80
1711921,1454215,2024-06-05,Senate,"Do pass, but first be re-referred to the Committee on [Energy, Utilities and Communications]",5,2,0,0,7
1711922,1286916,2023-03-28,Assembly,"Do pass and be re-referred to the Committee on [Appropriations] with recommendation: To Consent Calendar",8,0,0,0,8
1711923,1289795,2023-03-29,Assembly,"Do pass as amended and be re-referred to the Committee on [Appropriations]",6,0,0,1,7
1711923,1328530,2023-05-18,Assembly,"Do pass as amended",11,1,0,4,16
1711923,1335432,2023-05-30,Assembly,"AB 1178 Luz Rivas Assembly Third Reading",72,1,0,7,80
1711923,1348499,2023-06-28,Senate,"Do pass, but first be re-referred to the Committee on [Appropriations]",6,0,0,1,7
1711923,1349992,2023-07-10,Senate,"Placed on suspense file",6,0,0,1,7
1711924,1286878,2023-03-28,Assembly,"Do pass as amended. To Consent Calendar",9,0,0,2,11
1711924,1302597,2023-04-17,Assembly,"AB 1179 Pacheco Consent Calendar Second Day Regular Session",79,0,0,1,80
1711924,1343794,2023-06-13,Senate,"Do pass and be ordered to the Consent Calendar",10,0,0,1,11
1711924,1346939,2023-06-22,Senate,"Consent Calendar AB1179 Pacheco",39,0,0,1,40
1711925,1304299,2023-04-18,Assembly,"Do pass as amended and be re-referred to the Committee on [Appropriations]",15,0,0,0,15
1711926,1313484,2023-04-26,Assembly,"Do pass as amended, and be re-referred to the Committee on [Appropriations] with recommendation: To Consent Calendar",15,0,0,0,15
1711927,1310379,2023-04-25,Assembly,"Do pass and be re-referred to the Committee on [Appropriations] with recommendation: To Consent Calendar",7,0,0,0,7
1711927,1327927,2023-05-18,Assembly,"Do pass",15,0,0,1,16
1711927,1335575,2023-05-30,Assembly,"AB 1182 Petrie-Norris Assembly Third Reading",80,0,0,0,80
1711927,1347530,2023-06-26,Senate,"Do pass, but first be re-referred to the Committee on [Appropriations]",10,3,0,0,13
1711927,1351267,2023-08-14,Senate,"Placed on suspense file",7,0,0,0,7
1711930,1304367,2023-04-17,Assembly,"Do pass and be re-referred to the Committee on [Appropriations] with recommendation: To Consent Calendar",7,0,0,0,7
1711930,1328154,2023-05-18,Assembly,"Do pass as amended",11,0,0,5,16
1711930,1335457,2023-05-30,Assembly,"AB 1185 Gabriel Assembly Third Reading",79,0,0,1,80
1711930,1347882,2023-06-27,Senate,"Do pass, but first be re-referred to the Committee on [Appropriations]",15,0,0,0,15
1711930,1351408,2023-08-14,Senate,"Placed on suspense file",7,0,0,0,7
1711930,1352698,2023-09-01,Senate,"Do pass as amended",7,0,0,0,7
1711930,1353742,2023-09-12,Senate,"Assembly 3rd Reading AB1185 Gabriel et al. By Wiener",38,0,0,2,40
1711930,1354249,2023-09-13,Assembly,"AB 1185 Gabriel Concurrence in Senate Amendments",80,0,0,0,80
1711931,1286910,2023-03-28,Assembly,"Do pass and be re-referred to the Committee on [Appropriations]",7,0,0,1,8
1711931,1328078,2023-05-18,Assembly,"Do pass",11,4,0,1,16
1711931,1333573,2023-05-25,Assembly,"AB 1186 Bonta Assembly Third Reading",57,13,0,10,80
1711931,1347886,2023-06-27,Senate,"Do pass, but first be re-referred to the Committee on [Appropriations]",4,0,0,1,5
1711931,1351378,2023-08-14,Senate,"Placed on suspense file",7,0,0,0,7
1711931,1352681,2023-09-01,Senate,"Do pass",5,2,0,0,7
1711931,1462304,2024-07-02,Senate,"Do pass, but first be re-referred to the Committee on [Appropriations]",4,1,0,0,5
1711931,1462597,2024-07-02,Senate,"Pursuant to Senate Rule 29.10, that the measure be re-referred to the Committee on Appropriations pursuant to Joint Rule 10.5",4,1,0,0,5
1711931,1463566,2024-08-05,Senate,"Placed on suspense file",7,0,0,0,7
1711931,1464133,2024-08-15,Senate,"Do pass",5,2,0,0,7
1711931,1465697,2024-08-26,Senate,"Assembly 3rd Reading AB1186 Bonta et al. By Skinner",31,9,0,0,40
1711931,1465999,2024-08-27,Assembly,"AB 1186 Bonta Concurrence in Senate Amendments",61,13,0,5,79
1711932,1304268,2023-04-18,Assembly,"Do pass and be re-referred to the Committee on [Appropriations]",6,0,0,2,8
1711932,1322873,2023-05-10,Assembly,"Do pass",12,0,0,4,16
1711932,1333731,2023-05-25,Assembly,"AB 1187 Quirk-Silva Assembly Third Reading",65,0,0,15,80
1711932,1345632,2023-06-20,Senate,"Do pass, but first be re-referred to the Committee on [Appropriations]",4,0,0,1,5
1711932,1353131,2023-09-05,Senate,"Assembly 3rd Reading AB1187 Quirk-Silva By Menjivar",33,0,0,7,40
1711933,1310153,2023-04-24,Assembly,"Do pass and be re-referred to the Committee on [Appropriations] with recommendation: To Consent Calendar",15,0,0,0,15
1711935,1305494,2023-04-18,Assembly,"Do pass and be re-referred to the Committee on [Appropriations]",12,0,0,0,12
1711937,1313349,2023-04-26,Assembly,"Do pass as amended and be re-referred to the Committee on [Appropriations]",5,2,0,0,7
1711937,1328276,2023-05-18,Assembly,"Do pass",12,2,0,2,16
1711937,1337251,2023-06-01,Assembly,"AB 1192 McCarty Assembly Third Reading",50,16,0,14,80
1711937,1350446,2023-07-12,Senate,"Do pass as amended, but first amend, and re-refer to the Committee on [Appropriations]",5,2,0,0,7
1711937,1351816,2023-08-21,Senate,"Placed on suspense file",7,0,0,0,7
1711939,1311732,2023-04-25,Assembly,"Do pass and be re-referred to the Committee on [Appropriations]",8,1,0,2,11
1711939,1322872,2023-05-10,Assembly,"Do pass",12,2,0,2,16
1711939,1330028,2023-05-22,Assembly,"AB 1194 Wendy Carrillo Assembly Third Reading",64,8,0,8,80
1711939,1345552,2023-06-20,Senate,"Do pass, but first be re-referred to the Committee on [Appropriations]",10,0,0,1,11
1711939,1353720,2023-09-12,Senate,"Assembly 3rd Reading AB1194 Wendy Carrillo et al By Menjivar",31,5,0,4,40
1711939,1354428,2023-09-13,Assembly,"AB 1194 Wendy Carrillo Concurrence in Senate Amendments",65,12,0,3,80
1711940,1285594,2023-03-27,Assembly,"Do pass as amended and be re-referred to the Committee on [Appropriations]",8,1,0,2,11
1711942,1305484,2023-04-19,Assembly,"Do pass and be re-referred to the Committee on [Appropriations]",11,0,0,0,11
1711942,1328465,2023-05-18,Assembly,"Do pass as amended",12,1,0,3,16
1711942,1335552,2023-05-30,Assembly,"AB 1197 Hart Assembly Third Reading",66,2,0,12,80
1711942,1346948,2023-06-22,Senate,"Do pass as amended, but first amend, and re-refer to the Committee on [Agriculture]",9,0,0,2,11
1711942,1349524,2023-07-03,Senate,"Do pass, but first be re-referred to the Committee on [Appropriations]",3,0,0,1,4
1711942,1351522,2023-08-14,Senate,"Placed on suspense file",7,0,0,0,7
1711943,1299439,2023-04-12,Assembly,"Do pass as amended and be re-referred to the Committee on [Jobs, Economic Development, and the Economy]",15,0,0,0,15
1711943,1310249,2023-04-25,Assembly,"Do pass and be re-referred to the Committee on [Appropriations]",7,0,0,0,7
1711943,1328722,2023-05-18,Assembly,"Do pass",15,0,0,1,16
1711943,1333568,2023-05-25,Assembly,"AB 1198 Grayson Assembly Third Reading",77,0,0,3,80
1711943,1343131,2023-06-12,Senate,"Do pass, but first be re-referred to the Committee on [Energy, Utilities and Communications]",12,0,0,1,13
1711943,1350145,2023-07-10,Senate,"Do pass, but first be re-referred to the Committee on [Appropriations]",18,0,0,0,18
1711943,1463854,2024-08-12,Senate,"Placed on suspense file",7,0,0,0,7
1711947,1280650,2023-03-21,Assembly,"Do pass as amended and be re-referred to the Committee on [Appropriations]",14,0,0,1,15
1711947,1328644,2023-05-18,Assembly,"Do pass",15,0,0,1,16
1711947,1338032,2023-05-31,Assembly,"AB 1202 Lackey Assembly Third Reading",79,0,0,1,80
1711947,1350686,2023-07-12,Senate,"Do pass as amended, but first amend, and re-refer to the Committee on [Appropriations] with the recommendation: To Consent Calendar",11,0,0,1,12
1711947,1351401,2023-08-14,Senate,"Placed on suspense file",7,0,0,0,7
1711947,1352714,2023-09-01,Senate,"Do pass",7,0,0,0,7
1711947,1353984,2023-09-12,Senate,"Special Consent AB1202 Lackey et al",39,0,0,1,40
1711947,1354340,2023-09-13,Assembly,"AB 1202 Lackey Concurrence in Senate Amendments",78,0,0,2,80
1711948,1317054,2023-05-01,Assembly,"Do pass and be re-referred to the Committee on [Appropriations]",11,0,0,0,11
1711948,1328162,2023-05-18,Assembly,"Do pass",15,0,0,1,16
1711948,1333651,2023-05-25,Assembly,"AB 1203 Bains Assembly Third Reading",77,0,0,3,80
1711948,1346253,2023-06-21,Senate,"Do pass, but first be re-referred to the Committee on [Appropriations]",7,0,0,1,8
1711948,1349503,2023-07-03,Senate,"Placed on suspense file",7,0,0,0,7
1711948,1352676,2023-09-01,Senate,"Do pass",7,0,0,0,7
1711948,1353816,2023-09-12,Assembly,"AB 1203 Bains Concurrence in Senate Amendments",80,0,0,0,80
1711948,1354576,2023-09-11,Senate,"Assembly 3rd Reading AB1203 Bains et al. By Ashby",39,0,0,1,40
1711949,1310209,2023-04-25,Assembly,"Do pass as amended and be re-referred to the Committee on [Appropriations]",15,1,0,2,18
1711949,1322863,2023-05-10,Assembly,"Do pass",13,1,0,2,16
1711949,1330156,2023-05-22,Assembly,"AB 1204 Holden Assembly Third Reading",71,2,0,7,80
1711949,1345181,2023-06-19,Senate,"Do pass, but first be re-referred to the Committee on [Labor, Public Employment and Retirement ]",9,1,0,3,13
1711949,1350436,2023-07-12,Senate,"Do pass, but first be re-referred to the Committee on [Appropriations]",5,0,0,0,5
1711949,1353109,2023-09-05,Senate,"Assembly 3rd Reading AB1204 Holden By Cortese",32,1,0,7,40
1711950,1317072,2023-05-02,Assembly,"Do pass as amended",11,4,0,0,15
1711950,1330155,2023-05-22,Assembly,"AB 1205 Bauer-Kahan Assembly Third Reading",46,17,0,17,80
1711950,1349976,2023-07-10,Senate,"Do pass as amended",6,3,0,2,11
1711950,1351772,2023-08-21,Senate,"Placed on suspense file",7,0,0,0,7
1711950,1352870,2023-09-01,Senate,"Do pass",5,2,0,0,7
1711950,1466100,2024-08-29,Senate,"Do pass, but first be re-referred to the Committee on [Appropriations]",5,0,0,2,7
1711950,1466401,2024-08-30,Senate,"Do pass",7,0,0,0,7
1711950,1466967,2024-08-31,Senate,"Assembly 3rd Reading AB1205 Bauer-Kahan et al",40,0,0,0,40
1711950,1466968,2024-08-31,Assembly,"AB 1205 Bauer-Kahan Concurrence in Senate Amendments",68,3,0,8,79
1711951,1288158,2023-03-29,Assembly,"Do pass and be re-referred to the Committee on [Privacy and Consumer Protection]",7,0,0,1,8
1711951,1311722,2023-04-25,Assembly,"Do pass as amended and be re-referred to the Committee on [Appropriations]",9,1,0,1,11
1711952,1304392,2023-04-18,Assembly,"Do pass as amended and be re-referred to the Committee on [Appropriations]",13,0,0,5,18
1711952,1327949,2023-05-18,Assembly,"Do pass",12,0,0,4,16
1711952,1333682,2023-05-25,Assembly,"AB 1207 Irwin Assembly Third Reading",61,0,0,19,80
1711952,1349484,2023-07-03,Senate,"Do pass as amended, but first amend, and re-refer to the Committee on [Appropriations]",8,2,0,3,13
1711952,1351787,2023-08-21,Senate,"Placed on suspense file",7,0,0,0,7
1711952,1353031,2023-09-01,Senate,"Do pass as amended",5,1,0,1,7
1711952,1354690,2023-09-14,Senate,"Assembly 3rd Reading AB1207 Irwin et al. By Ashby",23,10,0,7,40
1711952,1354691,2023-09-14,Assembly,"AB 1207 Irwin Concurrence in Senate Amendments",63,0,0,17,80
1711953,1280684,2023-03-21,Assembly,"Do pass as amended and be re-referred to the Committee on [Appropriations]",13,0,0,2,15
1711954,1310346,2023-04-25,Assembly,"Do pass as amended and be re-referred to the Committee on [Appropriations]",7,0,0,1,8
1711955,1304258,2023-04-18,Assembly,"Do pass and be re-referred to the Committee on [Judiciary]",15,0,0,0,15
1711955,1310363,2023-04-25,Assembly,"Do pass and be re-referred to the Committee on [Appropriations] with recommendation: To Consent Calendar",11,0,0,0,11
1711955,1326934,2023-05-17,Assembly,"Do pass. To Consent Calendar",15,0,0,1,16
1711955,1333612,2023-05-25,Assembly,"AB 1210 Kalra Consent Calendar Second Day Regular Session",76,0,0,4,80
1711955,1345177,2023-06-19,Senate,"Do pass, but first be re-referred to the Committee on [Judiciary]",12,0,0,1,13
1711955,1349767,2023-07-06,Senate,"Do pass as amended, but first amend, and re-refer to the Committee on [Appropriations] with the recommendation: To Consent Calendar",11,0,0,0,11
1711955,1354024,2023-09-12,Assembly,"AB 1210 Kalra Concurrence in Senate Amendments",80,0,0,0,80
1711955,1354661,2023-09-11,Senate,"Assembly 3rd Reading AB1210 Kalra By Ashby",39,0,0,1,40
1711956,1288381,2023-03-28,Assembly,"Do pass and be re-referred to the Committee on [Appropriations] with recommendation: To Consent Calendar",9,0,0,0,9
1711956,1305330,2023-04-19,Assembly,"Do pass. To Consent Calendar",14,0,0,2,16
1711956,1313326,2023-04-27,Assembly,"AB 1211 Mathis Consent Calendar Second Day Regular Session",79,0,0,1,80
1711957,1305435,2023-04-18,Assembly,"Do pass and be re-referred to the Committee on [Appropriations] with recommendation: To Consent Calendar",15,0,0,0,15
1711958,1311925,2023-04-26,Assembly,"Do pass and be re-referred to the Committee on [Appropriations]",11,1,0,2,14
1711958,1322854,2023-05-10,Assembly,"Do pass",12,2,0,2,16
1711958,1333604,2023-05-25,Assembly,"AB 1213 Ortega Assembly Third Reading",62,8,0,10,80
1711958,1346958,2023-06-22,Senate,"Do pass, but first be re-referred to the Committee on [Appropriations]",4,0,0,1,5
1711958,1349519,2023-07-03,Senate,"Placed on suspense file",7,0,0,0,7
1711958,1353059,2023-09-01,Senate,"Do pass as amended",5,2,0,0,7
1711958,1354042,2023-09-12,Assembly,"AB 1213 Ortega Concurrence in Senate Amendments",63,13,0,4,80
1711958,1354827,2023-09-11,Senate,"Assembly 3rd Reading AB1213 Ortega By Cortese",30,9,0,1,40
1711959,1299350,2023-04-11,Assembly,"Do pass and be re-referred to the Committee on [Appropriations]",8,0,0,0,8
1711959,1318097,2023-05-03,Assembly,"Do pass. To Consent Calendar",16,0,0,0,16
1711959,1330133,2023-05-22,Assembly,"AB 1214 Maienschein Assembly Third Reading",77,0,0,3,80
1711959,1345613,2023-06-20,Senate,"Do pass, but first be re-referred to the Committee on [Judiciary]",5,0,0,0,5
1711960,1288144,2023-03-29,Assembly,"Do pass as amended and be re-referred to the Committee on [Appropriations]",8,0,0,0,8
1711960,1328026,2023-05-18,Assembly,"Do pass as amended",11,0,0,5,16
1711960,1338071,2023-05-31,Assembly,"AB 1215 Wendy Carrillo Assembly Third Reading",80,0,0,0,80
1711960,1346240,2023-06-20,Senate,"Do pass, but first be re-referred to the Committee on [Appropriations]",10,0,0,1,11
1711960,1349477,2023-07-03,Senate,"Placed on suspense file",7,0,0,0,7
1711960,1352726,2023-09-01,Senate,"Do pass",7,0,0,0,7
1711960,1354091,2023-09-13,Senate,"Assembly 3rd Reading AB1215 Wendy Carrillo By Newman",39,0,0,1,40
1711960,1354092,2023-09-13,Assembly,"AB 1215 Wendy Carrillo Concurrence in Senate Amendments",78,0,0,2,80
1711961,1310357,2023-04-24,Assembly,"Do pass as amended and be re-referred to the Committee on [Appropriations]",8,3,0,0,11
1711961,1322848,2023-05-10,Assembly,"Do pass",12,3,0,1,16
1711961,1328402,2023-05-18,Assembly,"AB 1216 Muratsuchi Assembly Third Reading",59,15,0,6,80
1711961,1346273,2023-06-21,Senate,"Do pass, but first be re-referred to the Committee on [Appropriations]",5,2,0,0,7
1711961,1353228,2023-09-06,Senate,"Assembly 3rd Reading AB1216 Muratsuchi et al. By Allen",31,9,0,0,40
1711961,1353458,2023-09-07,Assembly,"AB 1216 Muratsuchi Concurrence in Senate Amendments",62,16,0,2,80
1711962,1299362,2023-04-12,Assembly,"Do pass as amended and be re-referred to the Committee on [Health]",19,0,0,3,22
1711962,1310261,2023-04-25,Assembly,"Do pass as amended and be re-referred to the Committee on [Appropriations]",15,0,0,0,15
1711962,1322886,2023-05-10,Assembly,"Do pass. To Consent Calendar",14,0,0,2,16
1711962,1328557,2023-05-18,Assembly,"AB 1217 Gabriel Consent Calendar Second Day Regular Session",74,0,0,6,80
1711962,1347831,2023-06-27,Senate,"Do pass, but first be re-referred to the Committee on [Health]",15,0,0,0,15
1711962,1350637,2023-07-12,Senate,"Do pass as amended, but first amend, and re-refer to the Committee on [Appropriations]",11,0,0,1,12
1711962,1353110,2023-09-05,Senate,"Assembly 3rd Reading AB1217 Gabriel et al. By Ashby",39,0,0,1,40
1711962,1353530,2023-09-07,Assembly,"AB 1217 Gabriel Concurrence in Senate Amendments",79,0,0,1,80
1711963,1299438,2023-04-12,Assembly,"Do pass as amended and be re-referred to the Committee on [Local Government]",7,1,0,0,8
1711963,1313357,2023-04-26,Assembly,"Do pass and be re-referred to the Committee on [Appropriations]",8,0,0,0,8
1711963,1322937,2023-05-10,Assembly,"Do pass",15,0,0,1,16
1711963,1333803,2023-05-25,Assembly,"AB 1218 Lowenthal Assembly Third Reading",77,0,0,3,80
1711963,1348470,2023-06-28,Senate,"Do pass, but first be re-referred to the Committee on [Housing]",5,0,0,3,8
1711963,1350313,2023-07-10,Senate,"Do pass, but first be re-referred to the Committee on [Appropriations]",9,0,0,2,11
1711963,1353793,2023-09-12,Senate,"Assembly 3rd Reading AB1218 Lowenthal By Skinner",38,0,0,2,40
1711963,1354086,2023-09-13,Assembly,"AB 1218 Lowenthal Concurrence in Senate Amendments",80,0,0,0,80
1711964,1288273,2023-03-29,Assembly,"Do pass as amended, and be re-referred to the Committee on [Appropriations] with recommendation: To Consent Calendar",8,0,0,0,8
1711964,1311707,2023-04-26,Assembly,"Do pass. To Consent Calendar",16,0,0,0,16
1711964,1318916,2023-05-04,Assembly,"AB 1219 Berman Consent Calendar Second Day Regular Session",75,0,0,5,80
1711964,1340059,2023-06-06,Senate,"Do pass as amended, but first amend, and re-refer to the Committee on [Appropriations]",7,0,0,0,7
1711964,1353321,2023-09-06,Senate,"Assembly 3rd Reading AB1219 Berman By Stern",40,0,0,0,40
1711964,1353622,2023-09-11,Assembly,"AB 1219 Berman Concurrence in Senate Amendments",80,0,0,0,80
1711969,1311802,2023-04-26,Assembly,"Do pass and be re-referred to the Committee on [Appropriations]",7,0,0,0,7
1711971,1286890,2023-03-28,Assembly,"Do pass and be re-referred to the Committee on [Appropriations] with recommendation: To Consent Calendar",8,0,0,0,8
1711971,1311884,2023-04-26,Assembly,"Do pass. To Consent Calendar",16,0,0,0,16
1711971,1328092,2023-05-18,Assembly,"AB 1226 Haney Assembly Third Reading",70,0,0,10,80
1711971,1343715,2023-06-13,Senate,"Do pass, but first be re-referred to the Committee on [Appropriations] with the recommendation: To Consent Calendar",5,0,0,0,5
1711971,1348859,2023-06-29,Senate,"Consent Calendar AB1226 Haney et al",39,0,0,1,40
1711972,1305252,2023-04-19,Assembly,"Do pass as amended",5,0,0,3,8
1711972,1315735,2023-05-01,Assembly,"AB 1227 Low Assembly Third Reading",67,0,0,13,80
1711972,1349738,2023-07-05,Senate,"Do pass",6,0,0,1,7
1711972,1353152,2023-09-05,Senate,"Assembly 3rd Reading AB1227 Low et al. By Cortese",31,7,0,2,40
1711972,1353422,2023-09-07,Assembly,"AB 1227 Low Concurrence in Senate Amendments",69,0,0,11,80
1711973,1299358,2023-04-12,Assembly,"Do pass and be re-referred to the Committee on [Judiciary]",5,2,0,0,7
1711973,1310188,2023-04-25,Assembly,"Do pass and be re-referred to the Committee on [Appropriations]",6,3,0,2,11
1711973,1328757,2023-05-18,Assembly,"Do pass",11,4,0,1,16
1711973,1338010,2023-05-31,Assembly,"AB 1228 Holden Assembly Third Reading",42,22,0,16,80
1711973,1348434,2023-06-28,Senate,"Do pass, but first be re-referred to the Committee on [Judiciary]",4,1,0,0,5
1711973,1353761,2023-09-12,Senate,"Do pass, but first be re-referred to the Committee on [Appropriations]",4,1,0,0,5
1711973,1353762,2023-09-12,Senate,"Do pass",5,2,0,0,7
1711973,1354780,2023-09-14,Assembly,"With recommendation: That Senate amendments be concurred in",5,0,0,2,7
1711973,1354781,2023-09-14,Senate,"Assembly 3rd Reading AB1228 Holden By Lim√≥n",32,8,0,0,40
1711973,1354782,2023-09-14,Assembly,"AB 1228 Holden Concurrence in Senate Amendments",53,17,0,10,80
1711974,1310187,2023-04-24,Assembly,"Do pass and be re-referred to the Committee on [Judiciary]",10,1,0,1,12
1711976,1305385,2023-04-19,Assembly,"Do pass as amended and be re-referred to the Committee on [Appropriations]",13,0,0,0,13
1711977,1305467,2023-04-19,Assembly,"Do pass and be re-referred to the Committee on [Appropriations]",8,0,0,3,11
1711978,1288399,2023-03-28,Assembly,"Do pass and be re-referred to the Committee on [Appropriations] with recommendation: To Consent Calendar",14,0,0,1,15
1711978,1305510,2023-04-19,Assembly,"Do pass. To Consent Calendar",14,0,0,2,16
1711978,1313398,2023-04-27,Assembly,"AB 1233 Waldron Consent Calendar Second Day Regular Session",79,0,0,1,80
1711978,1341029,2023-06-07,Senate,"Do pass, but first be re-referred to the Committee on [Appropriations] with the recommendation: To Consent Calendar",12,0,0,0,12
1711978,1347534,2023-06-26,Senate,"Placed on suspense file",6,0,0,1,7
1711978,1352828,2023-09-01,Senate,"Do pass",7,0,0,0,7
1711978,1353907,2023-09-12,Senate,"Special Consent AB1233 Waldron",39,0,0,1,40
1711982,1305501,2023-04-18,Assembly,"Do pass and be re-referred to the Committee on [Appropriations]",12,0,0,0,12
1711983,1288227,2023-03-28,Assembly,"Do pass and be re-referred to the Committee on [Appropriations]",9,0,0,0,9
1711983,1328821,2023-05-18,Assembly,"Do pass",15,0,0,1,16
1711983,1333782,2023-05-25,Assembly,"AB 1238 Ward Assembly Third Reading",75,0,0,5,80
1711984,1304263,2023-04-18,Assembly,"Do pass and be re-referred to the Committee on [Appropriations] with recommendation: To Consent Calendar",15,0,0,0,15
1711984,1326932,2023-05-17,Assembly,"Do pass. To Consent Calendar",15,0,0,1,16
1711984,1333688,2023-05-25,Assembly,"AB 1239 Calderon Consent Calendar Second Day Regular Session",76,0,0,4,80
1711984,1348856,2023-06-28,Senate,"Do pass, but first be re-referred to the Committee on [Public Safety] with the recommendation: To Consent Calendar",11,0,0,1,12
1711984,1350289,2023-07-11,Senate,"Do pass, but first be re-referred to the Committee on [Appropriations] with the recommendation: To Consent Calendar",4,0,0,1,5
1711984,1354683,2023-09-11,Senate,"Assembly 3rd Reading AB1239 Calderon By Menjivar",39,0,0,1,40
1711984,1460555,2024-06-26,Senate,"Do pass, but first be re-referred to the Committee on [Appropriations] with the recommendation: To Consent Calendar",5,0,0,0,5
1711984,1463844,2024-08-12,Senate,"Consent Calendar 2nd AB1239 Calderon",38,0,0,2,40
1711984,1466466,2024-08-30,Assembly,"With recommendation: That Senate amendments be concurred in",14,0,0,1,15
1711984,1466467,2024-08-30,Assembly,"AB 1239 Calderon Concurrence in Senate Amendments",76,0,0,3,79
1711986,1288181,2023-03-28,Assembly,"Do pass and be re-referred to the Committee on [Appropriations]",14,0,0,1,15
1711986,1305513,2023-04-19,Assembly,"Do pass. To Consent Calendar",14,0,0,2,16
1711986,1313429,2023-04-27,Assembly,"AB 1241 Weber Consent Calendar Second Day Regular Session",79,0,0,1,80
1711986,1340973,2023-06-07,Senate,"Do pass, but first be re-referred to the Committee on [Appropriations] with the recommendation: To Consent Calendar",12,0,0,0,12
1711986,1348863,2023-06-29,Senate,"Consent Calendar AB1241 Weber",39,0,0,1,40
1711986,1352206,2023-08-24,Assembly,"AB 1241 Weber Concurrence in Senate Amendments",76,0,0,4,80
1711989,1304334,2023-04-18,Assembly,"Do pass and be re-referred to the Committee on [Appropriations]",16,0,0,2,18
1711989,1328377,2023-05-18,Assembly,"Do pass",14,0,0,2,16
1711989,1333761,2023-05-25,Assembly,"AB 1244 Holden Assembly Third Reading",72,0,0,8,80
1711989,1345182,2023-06-19,Senate,"Do pass as amended, but first amend, and re-refer to the Committee on [Appropriations]",10,0,0,3,13
1711989,1351459,2023-08-14,Senate,"Placed on suspense file",7,0,0,0,7
1711989,1352701,2023-09-01,Senate,"Do pass as amended",5,2,0,0,7
1711989,1353331,2023-09-06,Senate,"Assembly 3rd Reading AB1244 Holden",32,2,0,6,40
1711989,1353518,2023-09-07,Assembly,"AB 1244 Holden Concurrence in Senate Amendments",74,0,0,6,80
1711990,1298194,2023-04-11,Assembly,"Do pass and be re-referred to the Committee on [Appropriations]",12,0,0,0,12
1711991,1299480,2023-04-12,Assembly,"Do pass and be re-referred to the Committee on [Appropriations]",7,0,0,0,7
1711991,1318006,2023-05-03,Assembly,"Do pass. To Consent Calendar",16,0,0,0,16
1711991,1323891,2023-05-11,Assembly,"AB 1246 Stephanie Nguyen Consent Calendar Second Day Regular Session",66,0,0,14,80
1711991,1346964,2023-06-22,Senate,"Do pass, but first be re-referred to the Committee on [Appropriations] with the recommendation: To Consent Calendar",5,0,0,0,5
1711991,1349502,2023-07-03,Senate,"Placed on suspense file",7,0,0,0,7
1711991,1352792,2023-09-01,Senate,"Do pass as amended",7,0,0,0,7
1711991,1465282,2024-08-19,Senate,"Assembly 3rd Reading AB1246 Stephanie Nguyen By Ashby",40,0,0,0,40
1711991,1465783,2024-08-27,Assembly,"AB 1246 Stephanie Nguyen Concurrence in Senate Amendments",77,0,0,2,79
1711992,1310191,2023-04-24,Assembly,"Do pass and be re-referred to the Committee on [Appropriations]",11,0,0,1,12
1711993,1305223,2023-04-19,Assembly,"Do pass and be re-referred to the Committee on [Local Government]",5,1,0,2,8
1711993,1313331,2023-04-26,Assembly,"Do pass and be re-referred to the Committee on [Appropriations]",6,2,0,0,8
1711993,1328140,2023-05-18,Assembly,"Do pass as amended",11,4,0,1,16
1711993,1335439,2023-05-30,Assembly,"AB 1248 Bryan Assembly Third Reading",61,17,0,2,80
1711993,1349745,2023-07-05,Senate,"Do pass, but first be re-referred to the Committee on [Governance and Finance]",6,1,0,0,7
1711993,1350630,2023-07-12,Senate,"Do pass, but first be re-referred to the Committee on [Appropriations]",5,2,0,1,8
1711993,1351763,2023-08-21,Senate,"Placed on suspense file",7,0,0,0,7
1711993,1352810,2023-09-01,Senate,"Do pass as amended",5,2,0,0,7
1711993,1353755,2023-09-12,Senate,"Assembly 3rd Reading AB1248 Bryan et al. By Allen",30,7,0,3,40
1711993,1354432,2023-09-13,Assembly,"AB 1248 Bryan Concurrence in Senate Amendments",62,16,0,2,80
1711995,1304345,2023-04-17,Assembly,"Do pass and be re-referred to the Committee on [Appropriations] with recommendation: To Consent Calendar",15,0,0,0,15
1711995,1328861,2023-05-18,Assembly,"Do pass",15,0,0,1,16
1711995,1333735,2023-05-25,Assembly,"AB 1250 Friedman Assembly Third Reading",76,0,0,4,80
1711995,1350428,2023-07-11,Senate,"Do pass as amended, but first amend, and re-refer to the Committee on [Appropriations]",12,4,0,0,16
1711995,1351791,2023-08-21,Senate,"Placed on suspense file",7,0,0,0,7
1711996,1300984,2023-04-12,Assembly,"Do pass as amended and be re-referred to the Committee on [Appropriations]",6,0,0,1,7
1711996,1327968,2023-05-18,Assembly,"Do pass",15,0,0,1,16
1711996,1333629,2023-05-25,Assembly,"AB 1251 Luz Rivas Assembly Third Reading",77,0,0,3,80
1711996,1344194,2023-06-14,Senate,"Do pass, but first be re-referred to the Committee on [Appropriations] with the recommendation: To Consent Calendar",7,0,0,0,7
1711996,1347533,2023-06-26,Senate,"Placed on suspense file",6,0,0,1,7
1711996,1352614,2023-09-01,Senate,"Do pass",7,0,0,0,7
1711996,1353948,2023-09-12,Senate,"Special Consent AB1251 Luz Rivas et al. By Becker",39,0,0,1,40
1711997,1304253,2023-04-18,Assembly,"Do pass as amended and be re-referred to the Committee on [Appropriations]",6,0,0,2,8
1711997,1366794,2024-01-18,Assembly,"Do pass",12,0,0,4,16
1711997,1369559,2024-01-25,Assembly,"AB 1252 Wicks Assembly Third Reading",56,6,0,18,80
1711997,1460054,2024-06-25,Senate,"Do pass, but first be re-referred to the Committee on [Appropriations]",4,1,0,0,5
1711997,1463441,2024-08-05,Senate,"Placed on suspense file",7,0,0,0,7
1711997,1464213,2024-08-15,Senate,"Do pass",4,2,0,1,7
1711997,1466745,2024-08-31,Senate,"Assembly 3rd Reading AB1252 Wicks et al. By Blakespear",31,8,0,1,40
1711997,1466746,2024-08-31,Assembly,"AB 1252 Wicks Concurrence in Senate Amendments",57,10,0,12,79
1711998,1317096,2023-05-02,Assembly,"Do pass as amended",10,0,0,1,11
1711998,1338021,2023-05-31,Assembly,"AB 1253 Maienschein Assembly Third Reading",72,0,0,8,80
1711998,1350237,2023-07-11,Senate,"Do pass",4,0,0,1,5
1711998,1353270,2023-09-06,Senate,"Assembly 3rd Reading AB1253 Maienschein By Laird",40,0,0,0,40
1711999,1299495,2023-04-12,Assembly,"Do pass and be re-referred to the Committee on [Appropriations]",7,0,0,0,7
1711999,1328484,2023-05-18,Assembly,"Do pass",15,0,0,1,16
1711999,1333641,2023-05-25,Assembly,"AB 1254 Flora Assembly Third Reading",77,0,0,3,80
1711999,1346976,2023-06-22,Senate,"Do pass, but first be re-referred to the Committee on [Appropriations]",5,0,0,0,5
1711999,1349452,2023-07-03,Senate,"Placed on suspense file",7,0,0,0,7
1711999,1464323,2024-08-15,Senate,"Do pass",7,0,0,0,7
1712001,1307875,2023-04-19,Assembly,"Do pass and be re-referred to the Committee on [Revenue and Taxation]",5,2,0,0,7
1712001,1317030,2023-05-01,Assembly,"Do pass",8,2,0,1,11
1712001,1324985,2023-05-15,Assembly,"AB 1256 Wood Assembly Third Reading",55,14,0,11,80
1712001,1341032,2023-06-07,Senate,"Do pass",6,1,0,1,8
1712001,1354357,2023-09-13,Senate,"Assembly 3rd Reading AB1256 Wood By McGuire",30,9,0,1,40
1712002,1310262,2023-04-25,Assembly,"Do pass and be re-referred to the Committee on [Appropriations] with recommendation: To Consent Calendar",16,0,0,2,18
1712002,1328560,2023-05-18,Assembly,"Do pass",15,0,0,1,16
1712002,1333591,2023-05-25,Assembly,"AB 1257 Business and Professions Assembly Third Reading By BERMAN",77,0,0,3,80
1712002,1349927,2023-07-10,Senate,"Do pass, but first be re-referred to the Committee on [Appropriations]",13,0,0,0,13
1712002,1351488,2023-08-14,Senate,"Placed on suspense file",7,0,0,0,7
1712002,1352907,2023-09-01,Senate,"Do pass as amended",7,0,0,0,7
1712002,1354100,2023-09-13,Senate,"Special Consent AB1257 Berman et al. By Roth",39,0,0,1,40
1712002,1354608,2023-09-14,Assembly,"AB 1257 Berman Concurrence in Senate Amendments",80,0,0,0,80
1712003,1310154,2023-04-25,Assembly,"Do pass. To Consent Calendar",7,0,0,0,7
1712003,1315749,2023-05-01,Assembly,"AB 1258 Boerner Consent Calendar Second Day Regular Session",78,0,0,2,80
1712004,1318062,2023-05-03,Assembly,"Do pass as amended",7,1,0,0,8
1712004,1337947,2023-05-31,Assembly,"AB 1259 Soria Assembly Third Reading",63,11,0,6,80
1712004,1346160,2023-06-21,Senate,"Do pass",6,1,0,1,8
1712004,1353827,2023-09-12,Assembly,"AB 1259 Soria Concurrence in Senate Amendments",62,11,0,7,80
1712004,1354696,2023-09-11,Senate,"Assembly 3rd Reading AB1259 Soria et al. Glazer",30,8,0,2,40
1712005,1299466,2023-04-11,Assembly,"Do pass and be re-referred to the Committee on [Appropriations]",2,6,0,0,8
1712005,1363777,2024-01-09,Assembly,"Do pass as amended and be re-referred to the Committee on [Appropriations]",8,0,0,0,8
1712005,1366761,2024-01-18,Assembly,"Do pass",15,0,0,1,16
1712005,1369542,2024-01-25,Assembly,"AB 1260 Joe Patterson Assembly Third Reading",64,0,0,16,80
1712006,1299488,2023-04-11,Assembly,"Do pass and be re-referred to the Committee on [Appropriations]",8,0,0,0,8
1712006,1318092,2023-05-03,Assembly,"Do pass. To Consent Calendar",16,0,0,0,16
1712006,1323873,2023-05-11,Assembly,"AB 1261 Santiago Consent Calendar Second Day Regular Session",66,0,0,14,80
1712006,1347859,2023-06-27,Senate,"Do pass, but first be re-referred to the Committee on [Appropriations]",5,0,0,0,5
1712006,1351464,2023-08-14,Senate,"Placed on suspense file",7,0,0,0,7
1712006,1352790,2023-09-01,Senate,"Do pass",7,0,0,0,7
1712006,1353959,2023-09-12,Senate,"Special Consent AB1261 Santiago et al. By Rubio",39,0,0,1,40
1712006,1354337,2023-09-13,Assembly,"AB 1261 Santiago Concurrence in Senate Amendments",79,0,0,1,80
1712007,1310324,2023-04-25,Assembly,"Do pass and be re-referred to the Committee on [Appropriations] with recommendation: To Consent Calendar",16,0,0,2,18
1712007,1328900,2023-05-18,Assembly,"Do pass",15,0,0,1,16
1712007,1333759,2023-05-25,Assembly,"AB 1262 Business and Professions Assembly Third Reading By BERMAN",77,0,0,3,80
1712007,1347531,2023-06-26,Senate,"Do pass, but first be re-referred to the Committee on [Judiciary]",13,0,0,0,13
1712007,1351310,2023-08-14,Senate,"Placed on suspense file",7,0,0,0,7
1712007,1352744,2023-09-01,Senate,"Do pass as amended",7,0,0,0,7
1712007,1354202,2023-09-13,Senate,"Special Consent AB1262 Berman et al. By Roth",39,0,0,1,40
1712007,1354591,2023-09-14,Assembly,"AB 1262 Berman Concurrence in Senate Amendments",80,0,0,0,80
1712008,1310169,2023-04-25,Assembly,"Do pass and be re-referred to the Committee on [Appropriations] with recommendation: To Consent Calendar",16,0,0,2,18
1712008,1328680,2023-05-18,Assembly,"Do pass as amended",15,0,0,1,16
1712008,1335606,2023-05-30,Assembly,"AB 1263 Business and Professions Assembly Third Reading By BERMAN",79,0,0,1,80
1712008,1349918,2023-07-10,Senate,"Do pass as amended, but first amend, and re-refer to the Committee on [Appropriations]",12,0,0,1,13
1712008,1351251,2023-08-14,Senate,"Placed on suspense file",7,0,0,0,7
1712008,1352765,2023-09-01,Senate,"Do pass",7,0,0,0,7
1712008,1353751,2023-09-12,Senate,"Assembly 3rd Reading AB1263 Berman et al. By Roth",37,0,0,3,40
1712008,1354234,2023-09-13,Assembly,"AB 1263 Berman Concurrence in Senate Amendments",80,0,0,0,80
1712009,1310252,2023-04-25,Assembly,"Do pass and be re-referred to the Committee on [Appropriations] with recommendation: To Consent Calendar",16,0,0,2,18
1712009,1328529,2023-05-18,Assembly,"Do pass",15,0,0,1,16
1712009,1333689,2023-05-25,Assembly,"AB 1264 Business and Professions Assembly Third Reading By BERMAN",77,0,0,3,80
1712009,1349928,2023-07-10,Senate,"Do pass, but first be re-referred to the Committee on [Appropriations]",12,0,0,1,13
1712009,1351436,2023-08-14,Senate,"Placed on suspense file",7,0,0,0,7
1712009,1352820,2023-09-01,Senate,"Do pass",7,0,0,0,7
1712009,1353920,2023-09-12,Assembly,"AB 1264 Berman Concurrence in Senate Amendments",80,0,0,0,80
1712009,1354845,2023-09-11,Senate,"Assembly 3rd Reading AB1264 Berman et al. By Roth",39,0,0,1,40
1712010,1304281,2023-04-17,Assembly,"Do pass and be re-referred to the Committee on [Natural Resources]",4,10,0,1,15
1712011,1286997,2023-03-28,Assembly,"Do pass and be re-referred to the Committee on [Appropriations]",6,2,0,0,8
1712011,1322938,2023-05-10,Assembly,"Do pass",12,3,0,1,16
1712011,1333648,2023-05-25,Assembly,"AB 1266 Kalra Assembly Third Reading",50,19,0,11,80
1712011,1347908,2023-06-27,Senate,"Do pass, but first be re-referred to the Committee on [Appropriations]",4,1,0,0,5
1712011,1351414,2023-08-14,Senate,"Placed on suspense file",7,0,0,0,7
1712012,1285587,2023-03-27,Assembly,"Do pass and be re-referred to the Committee on [Natural Resources]",15,0,0,0,15
1712012,1301981,2023-04-10,Assembly,"Do pass and be re-referred to the Committee on [Appropriations]",11,0,0,0,11
1712013,1298231,2023-04-10,Assembly,"Do pass and be re-referred to the Committee on [Appropriations]",10,0,0,1,11
1712013,1311845,2023-04-26,Assembly,"Do pass. To Consent Calendar",16,0,0,0,16
1712013,1318903,2023-05-04,Assembly,"AB 1268 Irwin Consent Calendar Second Day Regular Session",75,0,0,5,80
1712013,1344173,2023-06-14,Senate,"Do pass, but first be re-referred to the Committee on [Appropriations]",8,0,0,0,8
1712013,1353124,2023-09-05,Senate,"Assembly 3rd Reading AB1268 Irwin By Blakespear",39,0,0,1,40
1712013,1353408,2023-09-07,Assembly,"AB 1268 Irwin Concurrence in Senate Amendments",79,0,0,1,80
1712015,1313366,2023-04-26,Assembly,"Do pass and be re-referred to the Committee on [Appropriations] with recommendation: To Consent Calendar",8,0,0,0,8
1712015,1326927,2023-05-17,Assembly,"Do pass. To Consent Calendar",15,0,0,1,16
1712015,1333736,2023-05-25,Assembly,"AB 1270 Dixon Consent Calendar Second Day Regular Session",76,0,0,4,80
1712015,1346145,2023-06-21,Senate,"Do pass, but first be re-referred to the Committee on [Appropriations]",8,0,0,0,8
1712015,1354596,2023-09-11,Senate,"Assembly 3rd Reading AB1270 Dixon By Newman",39,1,0,0,40
1712016,1311697,2023-04-26,Assembly,"Do pass and be re-referred to the Committee on [Appropriations]",22,0,0,0,22
1712016,1322865,2023-05-10,Assembly,"Do pass. To Consent Calendar",14,0,0,2,16
1712016,1328386,2023-05-18,Assembly,"AB 1271 Gipson Consent Calendar Second Day Regular Session",74,0,0,6,80
1712016,1347816,2023-06-27,Senate,"Do pass, but first be re-referred to the Committee on [Appropriations] with the recommendation: To Consent Calendar",15,0,0,0,15
1712016,1351696,2023-08-17,Senate,"Consent Calendar 2nd AB1271 Gipson",38,0,0,2,40
1712016,1353773,2023-09-12,Assembly,"AB 1271 Gipson Concurrence in Senate Amendments",80,0,0,0,80
1712016,1354620,2023-09-11,Senate,"Assembly 3rd Reading AB1271 Gipson By Roth",39,0,0,1,40
1712017,1286985,2023-03-28,Assembly,"Do pass and be re-referred to the Committee on [Appropriations]",12,2,0,1,15
1712017,1328808,2023-05-18,Assembly,"Do pass",11,4,0,1,16
1712017,1335464,2023-05-30,Assembly,"AB 1272 Wood Assembly Third Reading",64,12,0,4,80
1712017,1346956,2023-06-22,Senate,"Do pass as amended, but first amend, and re-refer to the Committee on [Appropriations]",8,0,0,3,11
1712017,1349922,2023-07-10,Senate,"Placed on suspense file",6,0,0,1,7
1712017,1352728,2023-09-01,Senate,"Do pass as amended",5,2,0,0,7
1712017,1353826,2023-09-12,Assembly,"AB 1272 Wood Concurrence in Senate Amendments",63,12,0,5,80
1712017,1354729,2023-09-11,Senate,"Assembly 3rd Reading AB1272 Wood By Laird",29,9,0,2,40
1712018,1281816,2023-03-22,Assembly,"Do pass and be re-referred to the Committee on [Appropriations]",6,0,0,1,7
1712018,1328331,2023-05-18,Assembly,"Do pass as amended",11,3,0,2,16
1712018,1333665,2023-05-25,Assembly,"AB 1273 Bonta Assembly Third Reading",62,10,0,8,80
1712018,1346972,2023-06-22,Senate,"Do pass, but first be re-referred to the Committee on [Appropriations]",4,0,0,1,5
1712018,1349512,2023-07-03,Senate,"Placed on suspense file",7,0,0,0,7
1712018,1352945,2023-09-01,Senate,"Do pass as amended",5,2,0,0,7
1712018,1353891,2023-09-12,Assembly,"AB 1273 Bonta Concurrence in Senate Amendments",65,12,0,3,80
1712018,1354632,2023-09-11,Senate,"Assembly 3rd Reading AB1273 Bonta et al. By Smallwood-Cuevas",31,8,0,1,40
1712019,1363769,2024-01-09,Assembly,"Do pass and be re-referred to the Committee on [Appropriations] with recommendation: To Consent Calendar",6,0,0,1,7
1712019,1366754,2024-01-18,Assembly,"Do pass. To Consent Calendar",15,0,0,1,16
1712019,1369555,2024-01-25,Assembly,"AB 1274 Connolly Consent Calendar Second Day",69,0,0,11,80
1712020,1305483,2023-04-18,Assembly,"Do pass and be re-referred to the Committee on [Local Government]",9,0,0,3,12
1712020,1318091,2023-05-03,Assembly,"Do pass",6,2,0,0,8
1712020,1328865,2023-05-18,Assembly,"AB 1275 Arambula Assembly Third Reading",57,6,0,17,80
1712020,1346164,2023-06-21,Senate,"Do pass, but first be re-referred to the Committee on [Governance and Finance]",5,0,0,2,7
1712021,1298267,2023-04-11,Assembly,"Do pass and be re-referred to the Committee on [Privacy and Consumer Protection] with recommendation: To Consent Calendar",15,0,0,0,15
1712021,1311910,2023-04-25,Assembly,"Do pass as amended, and be re-referred to the Committee on [Appropriations] with recommendation: To Consent Calendar",11,0,0,0,11
1712023,1311795,2023-04-26,Assembly,"Do pass and be re-referred to the Committee on [Appropriations]",14,0,0,0,14
1712024,1285665,2023-03-27,Assembly,"Do pass and be re-referred to the Committee on [Appropriations] with recommendation: To Consent Calendar",11,0,0,0,11
1712024,1305229,2023-04-19,Assembly,"Do pass. To Consent Calendar",14,0,0,2,16
1712024,1313361,2023-04-27,Assembly,"AB 1279 Mike Fong Consent Calendar Second Day Regular Session",79,0,0,1,80
1712024,1346940,2023-06-22,Senate,"Do pass as amended, but first amend, and re-refer to the Committee on [Appropriations] with the recommendation: To Consent Calendar",11,0,0,0,11
1712024,1350693,2023-07-13,Senate,"Consent Calendar AB1279 Mike Fong et al",37,0,0,3,40
1712024,1351656,2023-08-17,Assembly,"AB 1279 Mike Fong Concurrence in Senate Amendments",76,0,0,4,80
1712025,1286923,2023-03-28,Assembly,"Do pass. To Consent Calendar",9,0,0,2,11
1712025,1296982,2023-04-10,Assembly,"AB 1280 Maienschein Consent Calendar Second Day Regular Session",65,0,0,15,80
1712025,1345619,2023-06-20,Senate,"Do pass and be ordered to the Consent Calendar",11,0,0,0,11
1712025,1348838,2023-06-29,Senate,"Consent Calendar AB1280 Maienschein",39,0,0,1,40
1712027,1304285,2023-04-18,Assembly,"Do pass as amended, and be re-referred to the Committee on [Privacy and Consumer Protection] with recommendation: To Consent Calendar",15,0,0,0,15
1712027,1311651,2023-04-25,Assembly,"Do pass and be re-referred to the Committee on [Appropriations] with recommendation: To Consent Calendar",11,0,0,0,11
1712027,1328300,2023-05-18,Assembly,"Do pass",15,0,0,1,16
1712027,1333768,2023-05-25,Assembly,"AB 1282 Lowenthal Assembly Third Reading",77,0,0,3,80
1712027,1346280,2023-06-21,Senate,"Do pass, but first be re-referred to the Committee on [Judiciary] with the recommendation: To Consent Calendar",12,0,0,0,12
1712027,1349812,2023-07-06,Senate,"Do pass, but first be re-referred to the Committee on [Appropriations] with the recommendation: To Consent Calendar",11,0,0,0,11
1712027,1351406,2023-08-14,Senate,"Placed on suspense file",7,0,0,0,7
1712027,1352675,2023-09-01,Senate,"Do pass as amended",7,0,0,0,7
1712027,1465848,2024-08-27,Senate,"Assembly 3rd Reading AB1282 Lowenthal et al. By Wiener",40,0,0,0,40
1712027,1466787,2024-08-28,Assembly,"AB 1282 Lowenthal Concurrence in Senate Amendments",77,0,0,2,79
1712028,1313434,2023-04-26,Assembly,"Do pass as amended and be re-referred to the Committee on [Appropriations]",7,0,0,0,7
1712028,1322885,2023-05-10,Assembly,"Do pass. To Consent Calendar",14,0,0,2,16
1712028,1328423,2023-05-18,Assembly,"AB 1283 Chen Consent Calendar Second Day Regular Session",74,0,0,6,80
1712028,1346326,2023-06-21,Senate,"Do pass as amended, but first amend, and re-refer to the Committee on [Health]",7,0,0,0,7
1712028,1350700,2023-07-12,Senate,"Do pass, but first be re-referred to the Committee on [Appropriations]",11,0,0,1,12
1712028,1353828,2023-09-12,Assembly,"AB 1283 Chen Concurrence in Senate Amendments",80,0,0,0,80
1712028,1354628,2023-09-11,Senate,"Assembly 3rd Reading AB1283 Chen et al. By Grove",39,0,0,1,40
1712029,1301992,2023-04-10,Assembly,"Do pass and be re-referred to the Committee on [Appropriations] with recommendation: To Consent Calendar",11,0,0,0,11
1712029,1366777,2024-01-18,Assembly,"Do pass as amended",12,0,0,4,16
1712029,1371130,2024-01-29,Assembly,"AB 1284 Ramos Assembly Third Reading",77,0,0,3,80
1712029,1456335,2024-06-11,Senate,"Do pass as amended, but first amend, and re-refer to the Committee on [Appropriations]",11,0,0,0,11
1712029,1461984,2024-07-01,Senate,"Placed on suspense file",7,0,0,0,7
1712029,1464331,2024-08-15,Senate,"Do pass",7,0,0,0,7
1712029,1465776,2024-08-26,Senate,"Assembly 3rd Reading AB1284 Ramos et al. By Laird",40,0,0,0,40
1712029,1465838,2024-08-27,Assembly,"AB 1284 Ramos Concurrence in Senate Amendments",76,0,0,3,79
1712030,1311760,2023-04-26,Assembly,"Do pass as amended and be re-referred to the Committee on [Appropriations]",6,0,0,2,8
1712030,1326952,2023-05-17,Assembly,"Do pass. To Consent Calendar",15,0,0,1,16
1712030,1333778,2023-05-25,Assembly,"AB 1285 Wicks Consent Calendar Second Day Regular Session",76,0,0,4,80
1712030,1345601,2023-06-19,Senate,"Do pass, but first be re-referred to the Committee on [Housing]",5,0,0,0,5
1712030,1350158,2023-07-10,Senate,"Do pass, but first be re-referred to the Committee on [Appropriations] with the recommendation: To Consent Calendar",11,0,0,0,11
1712030,1351651,2023-08-17,Senate,"Consent Calendar 2nd AB1285 Wicks",38,0,0,2,40
1712030,1353281,2023-09-06,Senate,"Assembly 3rd Reading AB1285 Wicks By Wiener",40,0,0,0,40
1712030,1353674,2023-09-11,Assembly,"AB 1285 Wicks Concurrence in Senate Amendments",79,0,0,1,80
1712031,1304328,2023-04-18,Assembly,"Do pass as amended and be re-referred to the Committee on [Appropriations]",11,1,0,6,18
1712031,1318086,2023-05-03,Assembly,"Do pass",12,2,0,2,16
1712031,1337194,2023-06-01,Assembly,"AB 1286 Haney Assembly Third Reading",57,10,0,13,80
1712031,1349496,2023-07-03,Senate,"Do pass, but first be re-referred to the Committee on [Judiciary]",8,3,0,2,13
1712031,1350519,2023-07-11,Senate,"Do pass as amended, but first amend, and re-refer to the Committee on [Appropriations]",9,2,0,0,11
1712031,1354129,2023-09-13,Senate,"Assembly 3rd Reading AB1286 Haney et al. By Smallwood-Cuevas",30,9,0,1,40
1712031,1354636,2023-09-14,Assembly,"AB 1286 Haney Concurrence in Senate Amendments",59,8,0,13,80
1712032,1299498,2023-04-12,Assembly,"Do pass as amended and be re-referred to the Committee on [Natural Resources]",8,0,0,0,8
1712032,1310351,2023-04-24,Assembly,"Do pass as amended and be re-referred to the Committee on [Appropriations]",10,0,0,1,11
1712032,1326955,2023-05-17,Assembly,"Do pass. To Consent Calendar",15,0,0,1,16
1712032,1338061,2023-05-31,Assembly,"AB 1287 Alvarez Assembly Third Reading",72,1,0,7,80
1712032,1346247,2023-06-20,Senate,"Do pass, but first be re-referred to the Committee on [Governance and Finance]",9,1,0,1,11
1712032,1349803,2023-07-05,Senate,"Do pass as amended, but first amend, and re-refer to the Committee on [Appropriations]",5,1,0,2,8
1712032,1353783,2023-09-12,Senate,"Assembly 3rd Reading AB1287 Alvarez By Padilla",31,4,0,5,40
1712032,1354323,2023-09-13,Assembly,"AB 1287 Alvarez Concurrence in Senate Amendments",76,1,0,3,80
1712033,1310165,2023-04-25,Assembly,"Do pass and be re-referred to the Committee on [Appropriations]",14,1,0,0,15
1712033,1322897,2023-05-10,Assembly,"Do pass",14,1,0,1,16
1712033,1328424,2023-05-18,Assembly,"AB 1288 Reyes Assembly Third Reading",68,1,0,11,80
1712033,1350714,2023-07-12,Senate,"Do pass as amended, but first amend, and re-refer to the Committee on [Appropriations]",10,0,0,2,12
1712033,1351358,2023-08-14,Senate,"Do pass",5,0,0,2,7
1712033,1353160,2023-09-05,Senate,"Assembly 3rd Reading AB1288 Rendon et al. By Wiener",37,0,0,3,40
1712033,1353546,2023-09-07,Assembly,"AB 1288 Rendon Concurrence in Senate Amendments",76,1,0,3,80
1712034,1305273,2023-04-19,Assembly,"Do pass and be re-referred to the Committee on [Appropriations] with recommendation: To Consent Calendar",11,0,0,0,11
1712035,1302568,2023-04-17,Assembly,"Do pass and be re-referred to the Committee on [Appropriations]",8,3,0,0,11
1712035,1318018,2023-05-03,Assembly,"Do pass",12,4,0,0,16
1712036,1299463,2023-04-11,Assembly,"Do pass and be re-referred to the Committee on [Transportation] with recommendation: To Consent Calendar",8,0,0,0,8
1712036,1322926,2023-05-10,Assembly,"Do pass. To Consent Calendar",14,0,0,2,16
1712036,1327960,2023-05-18,Assembly,"AB 1291 McCarty Consent Calendar Second Day Regular Session",74,0,0,6,80
1712036,1345641,2023-06-20,Senate,"Do pass, but first be re-referred to the Committee on [Governance and Finance] with the recommendation: To Consent Calendar",5,0,0,0,5
1712036,1349741,2023-07-05,Senate,"Do pass as amended, but first amend, and re-refer to the Committee on [Appropriations]",8,0,0,0,8
1712036,1351812,2023-08-21,Senate,"Placed on suspense file",7,0,0,0,7
1712036,1352652,2023-09-01,Senate,"Do pass",7,0,0,0,7
1712036,1354009,2023-09-12,Senate,"Do pass, but first be re-referred to the Committee on [Appropriations]",5,0,0,2,7
1712036,1354010,2023-09-12,Senate,"Do pass",7,0,0,0,7
1712036,1354580,2023-09-14,Senate,"Assembly 3rd Reading AB1291 McCarty By Newman",40,0,0,0,40
1712036,1354581,2023-09-14,Assembly,"AB 1291 McCARTY Concurrence in Senate Amendments",77,0,0,3,80
1712037,1310384,2023-04-25,Assembly,"Do pass as amended and be re-referred to the Committee on [Appropriations]",13,0,0,5,18
1712038,1313323,2023-04-26,Assembly,"Do pass as amended, and be re-referred to the Committee on [Appropriations] with recommendation: To Consent Calendar",15,0,0,0,15
1712038,1326930,2023-05-17,Assembly,"Do pass. To Consent Calendar",15,0,0,1,16
1712038,1333673,2023-05-25,Assembly,"AB 1293 Irwin Consent Calendar Second Day Regular Session",76,0,0,4,80
1712038,1349472,2023-07-03,Senate,"Do pass as amended, but first amend, and re-refer to the Committee on [Appropriations]",15,0,0,3,18
1712038,1351774,2023-08-21,Senate,"Placed on suspense file",7,0,0,0,7
1712039,1299515,2023-04-12,Assembly,"Do pass and be re-referred to the Committee on [Appropriations]",19,0,0,3,22
1712039,1311927,2023-04-26,Assembly,"Do pass. To Consent Calendar",16,0,0,0,16
1712039,1318923,2023-05-04,Assembly,"AB 1294 Boerner Consent Calendar Second Day Regular Session",75,0,0,5,80
1712039,1343743,2023-06-13,Senate,"Do pass, but first be re-referred to the Committee on [Appropriations]",14,0,0,1,15
1712039,1353206,2023-09-06,Senate,"Assembly 3rd Reading AB1294 Boerner et al. By Hurtado",40,0,0,0,40
1712039,1353633,2023-09-11,Assembly,"AB 1294 Boerner Concurrence in Senate Amendments",79,0,0,1,80
1712040,1305327,2023-04-19,Assembly,"Do pass as amended and be re-referred to the Committee on [Appropriations]",8,0,0,0,8
1712041,1310350,2023-04-24,Assembly,"Do pass and be re-referred to the Committee on [Appropriations] with recommendation: To Consent Calendar",11,0,0,1,12
1712041,1322931,2023-05-10,Assembly,"Do pass. To Consent Calendar",14,0,0,2,16
1712041,1328082,2023-05-18,Assembly,"AB 1296 Grayson Consent Calendar Second Day Regular Session",74,0,0,6,80
1712041,1459964,2024-06-25,Senate,"Do pass, but first be re-referred to the Committee on [Environmental Quality]",14,0,0,2,16
1712041,1462604,2024-07-03,Senate,"Do pass, but first be re-referred to the Committee on [Appropriations]",7,0,0,0,7
1712041,1463461,2024-08-05,Senate,"Placed on suspense file",7,0,0,0,7
1712041,1464031,2024-08-15,Senate,"Do pass",6,1,0,0,7
1712041,1465418,2024-08-21,Senate,"Assembly 3rd Reading AB1296 Grayson et al. By Dodd",31,0,0,9,40
1712041,1466178,2024-08-29,Assembly,"With recommendation: That Senate amendments be concurred in",13,0,0,2,15
1712041,1466455,2024-08-30,Assembly,"AB 1296 Grayson Concurrence in Senate Amendments",69,1,0,9,79
1712042,1288228,2023-03-29,Assembly,"Do pass and be re-referred to the Committee on [Appropriations]",6,1,0,1,8
1712042,1328002,2023-05-18,Assembly,"Do pass",11,4,0,1,16
1712042,1333672,2023-05-25,Assembly,"AB 1297 Quirk-Silva Assembly Third Reading",62,6,0,12,80
1712042,1348489,2023-06-28,Senate,"Do pass, but first be re-referred to the Committee on [Appropriations]",6,2,0,0,8
1712042,1349954,2023-07-10,Senate,"Placed on suspense file",6,0,0,1,7
1712044,1363940,2024-01-10,Assembly,"Do pass as amended and be re-referred to the Committee on [Appropriations]",5,2,0,0,7
1712044,1366823,2024-01-18,Assembly,"Do pass as amended",11,3,0,2,16
1712047,1304375,2023-04-18,Assembly,"Do pass and be re-referred to the Committee on [Health]",8,0,0,3,11
1712048,1304403,2023-04-17,Assembly,"Do pass and be re-referred to the Committee on [Appropriations] with recommendation: To Consent Calendar",7,0,0,0,7
1712049,1311775,2023-04-25,Assembly,"Do pass",10,0,0,1,11
1712049,1320545,2023-05-08,Assembly,"AB 1304 Papan Assembly Third Reading",66,0,0,14,80
1712049,1343135,2023-06-12,Senate,"Do pass, but first be re-referred to the Committee on [Appropriations]",11,0,0,2,13
1712049,1353117,2023-09-05,Senate,"Assembly 3rd Reading AB1304 Papan By Cortese",38,0,0,2,40
1712049,1353449,2023-09-07,Assembly,"AB 1304 Papan Concurrence in Senate Amendments",73,0,0,7,80
1712050,1301990,2023-04-10,Assembly,"Do pass and be re-referred to the Committee on [Judiciary]",8,1,0,2,11
1712050,1310285,2023-04-25,Assembly,"Do pass and be re-referred to the Committee on [Appropriations]",8,2,0,1,11
1712050,1328315,2023-05-18,Assembly,"Do pass",11,4,0,1,16
1712050,1335409,2023-05-30,Assembly,"AB 1305 Gabriel Assembly Third Reading",61,17,0,2,80
1712050,1348294,2023-06-28,Senate,"Do pass as amended, but first amend, and re-refer to the Committee on [Judiciary]",5,2,0,0,7
1712050,1350409,2023-07-11,Senate,"Do pass, but first be re-referred to the Committee on [Appropriations]",9,2,0,0,11
1712050,1353749,2023-09-12,Senate,"Assembly 3rd Reading AB1305 Gabriel et al. By Lim√≥n",28,8,0,4,40
1712050,1354435,2023-09-13,Assembly,"AB 1305 Gabriel Concurrence in Senate Amendments",59,18,0,3,80
1712051,1299483,2023-04-11,Assembly,"Do pass as amended and be re-referred to the Committee on [Judiciary]",6,0,0,2,8
1712051,1304279,2023-04-18,Assembly,"Do pass and be re-referred to the Committee on [Appropriations]",8,3,0,0,11
1712051,1328485,2023-05-18,Assembly,"Do pass",11,4,0,1,16
1712051,1335465,2023-05-30,Assembly,"AB 1306 Wendy Carrillo Assembly Third Reading",54,18,0,8,80
1712051,1347914,2023-06-27,Senate,"Do pass, but first be re-referred to the Committee on [Appropriations]",4,0,0,1,5
1712051,1351256,2023-08-14,Senate,"Placed on suspense file",7,0,0,0,7
1712051,1352672,2023-09-01,Senate,"Do pass",5,2,0,0,7
1712051,1354836,2023-09-11,Senate,"Assembly 3rd Reading AB1306 Wendy Carrillo et al By Wiener",29,9,0,2,40
1712052,1301985,2023-04-10,Assembly,"Do pass and be re-referred to the Committee on [Appropriations] with recommendation: To Consent Calendar",11,0,0,0,11
1712052,1311849,2023-04-26,Assembly,"Do pass. To Consent Calendar",16,0,0,0,16
1712052,1330081,2023-05-22,Assembly,"AB 1307 Wicks Third Reading Urgency",77,0,0,3,80
1712052,1346167,2023-06-21,Senate,"Do pass, but first be re-referred to the Committee on [Housing] with the recommendation: To Consent Calendar",7,0,0,0,7
1712052,1350149,2023-07-10,Senate,"Do pass, but first be re-referred to the Committee on [Appropriations] with the recommendation: To Consent Calendar",11,0,0,0,11
1712052,1351679,2023-08-17,Senate,"Consent Calendar 2nd AB1307 Wicks et al. By Wiener Urgency Clause",38,0,0,2,40
1712052,1352315,2023-08-28,Assembly,"AB 1307 Wicks Concurrence in Senate Amendments",76,0,0,4,80
1712053,1288362,2023-03-29,Assembly,"Do pass as amended and be re-referred to the Committee on [Housing and Community Development]",7,1,0,0,8
1712053,1305342,2023-04-19,Assembly,"Do pass and be re-referred to the Committee on [Appropriations]",6,1,0,1,8
1712053,1318063,2023-05-03,Assembly,"Do pass",14,2,0,0,16
1712053,1333748,2023-05-25,Assembly,"AB 1308 Quirk-Silva Assembly Third Reading",71,3,0,6,80
1712053,1346281,2023-06-21,Senate,"Do pass, but first be re-referred to the Committee on [Housing]",6,2,0,0,8
1712053,1350188,2023-07-10,Senate,"Do pass, but first be re-referred to the Committee on [Appropriations]",10,1,0,0,11
1712053,1353158,2023-09-05,Senate,"Assembly 3rd Reading AB1308 Quirk-Silva et al. By Wiener",29,5,0,6,40
1712054,1311854,2023-04-25,Assembly,"Do pass as amended and be re-referred to the Committee on [Appropriations]",7,0,0,1,8
1712054,1326956,2023-05-17,Assembly,"Do pass. To Consent Calendar",15,0,0,1,16
1712054,1333744,2023-05-25,Assembly,"AB 1309 Reyes Consent Calendar Second Day Regular Session",76,0,0,4,80
1712054,1346228,2023-06-21,Senate,"Do pass, but first be re-referred to the Committee on [Appropriations] with the recommendation: To Consent Calendar",12,0,0,0,12
1712054,1353125,2023-09-05,Senate,"Assembly 3rd Reading AB1309 Reyes et al. By Durazo",39,0,0,1,40
1712054,1353392,2023-09-07,Assembly,"AB 1309 Reyes Concurrence in Senate Amendments",79,0,0,1,80
1712055,1286942,2023-03-28,Assembly,"Do pass as amended and be re-referred to the Committee on [Appropriations]",6,2,0,0,8
1712055,1328207,2023-05-18,Assembly,"Do pass as amended",11,4,0,1,16
1712055,1338072,2023-05-31,Assembly,"AB 1310 McKinnor Assembly Third Reading Amend By ESSAYLI Set #1 Motion to Lay on the Table By REYES",61,18,0,1,80
1712055,1338073,2023-05-31,Assembly,"AB 1310 McKinnor Assembly Third Reading",41,19,0,20,80
1712055,1350273,2023-07-11,Senate,"Do pass as amended, but first amend, and re-refer to the Committee on [Appropriations]",3,1,0,1,5
1712055,1352327,2023-08-28,Senate,"Placed on suspense file",7,0,0,0,7
1712056,1311850,2023-04-25,Assembly,"Do pass and be re-referred to the Committee on [Appropriations] with recommendation: To Consent Calendar",12,0,0,0,12
1712056,1328110,2023-05-18,Assembly,"Do pass",15,0,0,1,16
1712056,1338033,2023-05-31,Assembly,"AB 1311 Soria Assembly Third Reading",79,0,0,1,80
1712056,1349592,2023-07-05,Senate,"Do pass and be ordered to the Consent Calendar",7,0,0,0,7
1712056,1350614,2023-07-13,Senate,"Consent Calendar AB1311 Soria",37,0,0,3,40
1712057,1279207,2023-03-20,Assembly,"Do pass. To Consent Calendar",12,0,0,0,12
1712057,1285740,2023-03-27,Assembly,"AB 1312 Banking and Finance Consent Calendar Second Day By GRAYSON",77,0,0,3,80
1712057,1346189,2023-06-21,Senate,"Do pass and be ordered to the Consent Calendar",7,0,0,0,7
1712057,1348861,2023-06-29,Senate,"Consent Calendar AB1312 B. & F. (Grayson)",39,0,0,1,40
1712058,1311851,2023-04-25,Assembly,"Do pass as amended and be re-referred to the Committee on [Appropriations]",7,0,0,1,8
1712058,1328148,2023-05-18,Assembly,"Do pass",15,0,0,1,16
1712058,1333686,2023-05-25,Assembly,"AB 1313 Ortega Assembly Third Reading",77,0,0,3,80
1712058,1345679,2023-06-19,Senate,"Do pass, but first be re-referred to the Committee on [Appropriations]",5,0,0,0,5
1712058,1349464,2023-07-03,Senate,"Placed on suspense file",7,0,0,0,7
1712061,1363741,2024-01-09,Assembly,"Do pass and be re-referred to the Committee on [Appropriations]",16,0,0,0,16
1712061,1366815,2024-01-18,Assembly,"Do pass. To Consent Calendar",15,0,0,1,16
1712061,1369561,2024-01-25,Assembly,"AB 1316 Irwin Consent Calendar Second Day Regular Session",69,0,0,11,80
1712061,1456900,2024-06-12,Senate,"Do pass as amended, but first amend, and re-refer to the Committee on [Appropriations]",10,0,0,1,11
1712061,1465703,2024-08-26,Senate,"Assembly 3rd Reading AB1316 Irwin et al. By Eggman",40,0,0,0,40
1712061,1465922,2024-08-27,Assembly,"AB 1316 Irwin Concurrence in Senate Amendments",77,0,0,2,79
1712062,1310222,2023-04-25,Assembly,"Do pass",8,3,0,0,11
1712062,1337999,2023-05-31,Assembly,"AB 1317 Wendy Carrillo Assembly Third Reading",54,18,0,8,80
1712062,1349786,2023-07-06,Senate,"Do pass",8,2,0,1,11
1712062,1354642,2023-09-14,Senate,"Assembly 3rd Reading AB1317 Wendy Carrillo et al By Durazo",27,12,0,1,40
1712062,1354643,2023-09-14,Assembly,"AB 1317 Wendy Carrillo Concurrence in Senate Amendments",56,18,0,6,80
1712063,1302672,2023-04-17,Assembly,"Do pass and be re-referred to the Committee on [Local Government]",11,0,0,0,11
1712063,1313516,2023-04-26,Assembly,"Do pass and be re-referred to the Committee on [Appropriations] with recommendation: To Consent Calendar",8,0,0,0,8
1712063,1322915,2023-05-10,Assembly,"Do pass. To Consent Calendar",14,0,0,2,16
1712063,1328174,2023-05-18,Assembly,"AB 1318 Luz Rivas Consent Calendar Second Day Regular Session",74,0,0,6,80
1712064,1288253,2023-03-29,Assembly,"Do pass and be re-referred to the Committee on [Natural Resources]",6,2,0,0,8
1712064,1310406,2023-04-24,Assembly,"Do pass and be re-referred to the Committee on [Appropriations]",8,3,0,0,11
1712064,1326918,2023-05-17,Assembly,"Do pass",12,4,0,0,16
1712064,1333732,2023-05-25,Assembly,"AB 1319 Wicks Assembly Third Reading",58,17,0,5,80
1712064,1346236,2023-06-20,Senate,"Do pass, but first be re-referred to the Committee on [Governance and Finance]",8,2,0,1,11
1712064,1350647,2023-07-12,Senate,"Do pass as amended, but first amend, and re-refer to the Committee on [Appropriations]",6,2,0,0,8
1712064,1353148,2023-09-05,Senate,"Assembly 3rd Reading AB1319 Wicks et al. By Cortese",31,8,0,1,40
1712064,1353460,2023-09-07,Assembly,"AB 1319 Wicks Concurrence in Senate Amendments",59,17,0,4,80
1712065,1304389,2023-04-17,Assembly,"Do pass and be re-referred to the Committee on [Appropriations] with recommendation: To Consent Calendar",15,0,0,0,15
1712065,1326962,2023-05-17,Assembly,"Do pass. To Consent Calendar",15,0,0,1,16
1712065,1333835,2023-05-25,Assembly,"AB 1320 Hoover Consent Calendar Second Day Regular Session",76,0,0,4,80
1712065,1348439,2023-06-27,Senate,"Do pass, but first be re-referred to the Committee on [Appropriations] with the recommendation: To Consent Calendar",16,0,0,0,16
1712065,1350636,2023-07-13,Senate,"Consent Calendar AB1320 Hoover",37,0,0,3,40
1712066,1304436,2023-04-18,Assembly,"Do pass and be re-referred to the Committee on [Appropriations] with recommendation: To Consent Calendar",7,0,0,1,8
1712066,1328042,2023-05-18,Assembly,"Do pass",14,0,0,2,16
1712066,1333553,2023-05-25,Assembly,"AB 1321 Bonta Assembly Third Reading",76,0,0,4,80
1712066,1345669,2023-06-19,Senate,"Do pass, but first be re-referred to the Committee on [Appropriations] with the recommendation: To Consent Calendar",5,0,0,0,5
1712066,1349470,2023-07-03,Senate,"Placed on suspense file",7,0,0,0,7
1712067,1288388,2023-03-28,Assembly,"Do pass and be re-referred to the Committee on [Water, Parks, and Wildlife]",7,0,0,2,9
1712067,1308808,2023-04-24,Assembly,"Do pass as amended and be re-referred to the Committee on [Appropriations]",11,2,0,2,15
1712067,1328385,2023-05-18,Assembly,"Do pass",12,3,0,1,16
1712067,1335460,2023-05-30,Assembly,"AB 1322 Friedman Assembly Third Reading",57,12,0,11,80
1712067,1348423,2023-06-28,Senate,"Do pass as amended, but first amend, and re-refer to the Committee on [Natural Resources and Water]",4,2,0,1,7
1712067,1349960,2023-07-10,Senate,"Do pass as amended, but first amend, and re-refer to the Committee on [Appropriations]",6,3,0,2,11
1712067,1351836,2023-08-21,Senate,"Placed on suspense file",7,0,0,0,7
1712067,1352852,2023-09-01,Senate,"Do pass as amended",5,2,0,0,7
1712067,1353410,2023-09-07,Senate,"Assembly 3rd Reading AB1322 Friedman et al. By Allen",28,11,0,1,40
1712067,1353639,2023-09-11,Assembly,"AB 1322 Friedman Concurrence in Senate Amendments",57,17,0,6,80
1712069,1280681,2023-03-21,Assembly,"Do pass and be re-referred to the Committee on [Human Services]",8,2,0,1,11
1712069,1304325,2023-04-18,Assembly,"Do pass and be re-referred to the Committee on [Appropriations]",5,1,0,2,8
1712069,1328264,2023-05-18,Assembly,"Do pass",12,3,0,1,16
1712069,1333578,2023-05-25,Assembly,"AB 1324 Bryan Assembly Third Reading",62,13,0,5,80
1712069,1348446,2023-06-27,Senate,"Do pass, but first be re-referred to the Committee on [Human Services]",9,2,0,0,11
1712069,1350699,2023-07-13,Senate,"Do pass, but first be re-referred to the Committee on [Appropriations]",3,0,0,2,5
1712069,1351778,2023-08-21,Senate,"Placed on suspense file",7,0,0,0,7
1712070,1310277,2023-04-25,Assembly,"Do pass and be re-referred to the Committee on [Appropriations] with recommendation: To Consent Calendar",15,0,0,0,15
1712070,1330117,2023-05-22,Assembly,"AB 1325 Waldron Assembly Third Reading",77,0,0,3,80
1712070,1344187,2023-06-14,Senate,"Do pass as amended, and be ordered to the Consent Calendar",12,0,0,0,12
1712070,1346966,2023-06-22,Senate,"Consent Calendar AB1325 Waldron et al. Urgency Clause",39,0,0,1,40
1712070,1349539,2023-07-03,Assembly,"AB 1325 Waldron Concurrence - Urgency Added",67,0,0,13,80
1712071,1301070,2023-04-12,Assembly,"Do pass and be re-referred to the Committee on [Appropriations] with recommendation: To Consent Calendar",7,0,0,0,7
1712071,1311783,2023-04-26,Assembly,"Do pass. To Consent Calendar",16,0,0,0,16
1712071,1318957,2023-05-04,Assembly,"AB 1326 Megan Dahle Consent Calendar Second Day Regular Session",75,0,0,5,80
1712071,1340958,2023-06-07,Senate,"Do pass, but first be re-referred to the Committee on [Appropriations] with the recommendation: To Consent Calendar",7,0,0,0,7
1712071,1348862,2023-06-29,Senate,"Consent Calendar AB1326 Megan Dahle",39,0,0,1,40
1712072,1280689,2023-03-21,Assembly,"Do pass as amended, and be re-referred to the Committee on [Education] with recommendation: To Consent Calendar",5,0,0,2,7
1712072,1313348,2023-04-26,Assembly,"Do pass as amended. To Consent Calendar",7,0,0,0,7
1712072,1327932,2023-05-18,Assembly,"Do pass",15,0,0,1,16
1712072,1333589,2023-05-25,Assembly,"AB 1327 Weber Assembly Third Reading",76,0,0,4,80
1712072,1348501,2023-06-28,Senate,"Do pass as amended, but first amend, and re-refer to the Committee on [Judiciary] with the recommendation: To Consent Calendar",7,0,0,0,7
1712072,1350556,2023-07-11,Senate,"Do pass as amended, but first amend, and re-refer to the Committee on [Appropriations] with the recommendation: To Consent Calendar",11,0,0,0,11
1712072,1351368,2023-08-14,Senate,"Placed on suspense file",7,0,0,0,7
1712072,1352999,2023-09-01,Senate,"Do pass",7,0,0,0,7
1712072,1353949,2023-09-12,Senate,"Special Consent AB1327 Weber et al. By Min",39,0,0,1,40
1712072,1354364,2023-09-13,Assembly,"AB 1327 Weber Concurrence in Senate Amendments",80,0,0,0,80
1712073,1310362,2023-04-25,Assembly,"Do pass and be re-referred to the Committee on [Appropriations]",16,0,0,2,18
1712073,1322868,2023-05-10,Assembly,"Do pass. To Consent Calendar",14,0,0,2,16
1712073,1328563,2023-05-18,Assembly,"AB 1328 Gipson Consent Calendar Second Day Regular Session",74,0,0,6,80
1712074,1304286,2023-04-18,Assembly,"Do pass and be re-referred to the Committee on [Appropriations] with recommendation: To Consent Calendar",8,0,0,0,8
1712074,1326949,2023-05-17,Assembly,"Do pass. To Consent Calendar",15,0,0,1,16
1712074,1333657,2023-05-25,Assembly,"AB 1329 Maienschein Consent Calendar Second Day Regular Session",76,0,0,4,80
1712074,1347878,2023-06-27,Senate,"Do pass, but first be re-referred to the Committee on [Appropriations] with the recommendation: To Consent Calendar",5,0,0,0,5
1712074,1351476,2023-08-14,Senate,"Placed on suspense file",7,0,0,0,7
1712074,1352842,2023-09-01,Senate,"Do pass",7,0,0,0,7
1712074,1354038,2023-09-12,Senate,"Special Consent AB1329 Maienschein By Atkins",39,0,0,1,40
1712076,1310359,2023-04-25,Assembly,"Do pass and be re-referred to the Committee on [Appropriations]",15,0,0,0,15
1712076,1322860,2023-05-10,Assembly,"Do pass. To Consent Calendar",14,0,0,2,16
1712076,1328291,2023-05-18,Assembly,"AB 1331 Wood Consent Calendar Second Day Regular Session",74,0,0,6,80
1712076,1350642,2023-07-12,Senate,"Do pass as amended, but first amend, and re-refer to the Committee on [Appropriations]",10,0,0,2,12
1712076,1351469,2023-08-14,Senate,"Placed on suspense file",7,0,0,0,7
1712077,1305282,2023-04-19,Assembly,"Do pass and be re-referred to the Committee on [Local Government]",7,0,0,1,8
1712077,1313443,2023-04-26,Assembly,"Do pass and be re-referred to the Committee on [Appropriations]",8,0,0,0,8
1712077,1322869,2023-05-10,Assembly,"Do pass",14,0,0,2,16
1712077,1327940,2023-05-18,Assembly,"AB 1332 Juan Carrillo Assembly Third Reading",71,0,0,9,80
1712077,1339999,2023-06-06,Senate,"Do pass, but first be re-referred to the Committee on [Governance and Finance]",11,0,0,0,11
1712077,1349819,2023-07-05,Senate,"Do pass as amended, but first amend, and re-refer to the Committee on [Appropriations]",8,0,0,0,8
1712077,1353255,2023-09-06,Senate,"Assembly 3rd Reading AB1332 Juan Carrillo et al. By Wiener",39,0,0,1,40
1712077,1353630,2023-09-11,Assembly,"AB 1332 Juan Carrillo Concurrence in Senate Amendments",75,0,0,5,80
1712078,1364114,2024-01-11,Assembly,"Do pass",8,0,0,3,11
1712078,1366762,2024-01-18,Assembly,"AB 1333 Ward Assembly Third Reading",48,1,0,31,80
1712079,1305230,2023-04-19,Assembly,"Do pass as amended and be re-referred to the Committee on [Appropriations]",8,0,0,0,8
1712079,1328230,2023-05-18,Assembly,"Do pass",15,0,0,1,16
1712079,1333611,2023-05-25,Assembly,"AB 1334 Pellerin Assembly Third Reading",76,0,0,4,80
1712079,1346214,2023-06-20,Senate,"Do pass, but first be re-referred to the Committee on [Governance and Finance] with the recommendation: To Consent Calendar",11,0,0,0,11
1712079,1348500,2023-06-28,Senate,"Do pass, but first be re-referred to the Committee on [Appropriations] with the recommendation: To Consent Calendar",8,0,0,0,8
1712079,1349980,2023-07-10,Senate,"Placed on suspense file",6,0,0,1,7
1712080,1285644,2023-03-27,Assembly,"Do pass and be re-referred to the Committee on [Appropriations]",11,3,0,1,15
1712080,1305431,2023-04-19,Assembly,"Do pass",11,4,0,1,16
1712080,1328406,2023-05-18,Assembly,"AB 1335 Zbur Assembly Third Reading",60,10,0,10,80
1712080,1346190,2023-06-20,Senate,"Do pass as amended, but first amend, and re-refer to the Committee on [Transportation]",8,2,0,1,11
1712080,1350420,2023-07-11,Senate,"Do pass, but first be re-referred to the Committee on [Appropriations]",11,2,0,3,16
1712082,1305420,2023-04-18,Assembly,"Do pass as amended and be re-referred to the Committee on [Judiciary]",9,4,0,2,15
1712082,1328165,2023-05-18,Assembly,"Do pass as amended",11,4,0,1,16
1712082,1335589,2023-05-30,Assembly,"AB 1337 Wicks Assembly Third Reading",45,20,0,15,80
1712083,1304364,2023-04-18,Assembly,"Do pass as amended and be re-referred to the Committee on [Appropriations]",13,0,0,2,15
1712084,1298263,2023-04-11,Assembly,"Do pass as amended and be re-referred to the Committee on [Appropriations]",11,0,0,0,11
1712085,1283249,2023-03-22,Assembly,"Do pass and be re-referred to the Committee on [Appropriations] with recommendation: To Consent Calendar",7,0,0,0,7
1712085,1328321,2023-05-18,Assembly,"Do pass",15,0,0,1,16
1712085,1333711,2023-05-25,Assembly,"AB 1340 Garcia Assembly Third Reading",76,0,0,4,80
1712085,1350570,2023-07-12,Senate,"Do pass, but first be re-referred to the Committee on [Appropriations] with the recommendation: To Consent Calendar",7,0,0,0,7
1712085,1351434,2023-08-14,Senate,"Placed on suspense file",7,0,0,0,7
1712085,1353027,2023-09-01,Senate,"Do pass",7,0,0,0,7
1712085,1354113,2023-09-13,Senate,"Assembly 3rd Reading AB1340 Garcia et al. By Newman",39,0,0,1,40
1712085,1354638,2023-09-14,Assembly,"AB 1340 Garcia Concurrence in Senate Amendments",80,0,0,0,80
1712086,1286883,2023-03-28,Assembly,"Do pass as amended, and be re-referred to the Committee on [Appropriations] with recommendation: To Consent Calendar",18,0,0,1,19
1712086,1305220,2023-04-19,Assembly,"Do pass. To Consent Calendar",14,0,0,2,16
1712086,1313423,2023-04-27,Assembly,"AB 1341 Berman Consent Calendar Second Day Regular Session",79,0,0,1,80
1712086,1338782,2023-06-05,Senate,"Do pass, but first be re-referred to the Committee on [Appropriations]",13,0,0,0,13
1712086,1353156,2023-09-05,Senate,"Assembly 3rd Reading AB1341 Berman By Laird Urgency Clause",39,0,0,1,40
1712086,1353508,2023-09-07,Assembly,"AB 1341 Berman Concurrence in Senate Amendments",79,0,0,1,80
1712087,1298189,2023-04-11,Assembly,"Do pass and be re-referred to the Committee on [Appropriations] with recommendation: To Consent Calendar",12,0,0,0,12
1712087,1311921,2023-04-26,Assembly,"Do pass. To Consent Calendar",16,0,0,0,16
1712087,1318948,2023-05-04,Assembly,"AB 1342 Megan Dahle Consent Calendar Second Day Regular Session",75,0,0,5,80
1712087,1341030,2023-06-07,Senate,"Do pass, but first be re-referred to the Committee on [Appropriations] with the recommendation: To Consent Calendar",7,0,0,0,7
1712087,1348844,2023-06-29,Senate,"Consent Calendar AB1342 Megan Dahle",39,0,0,1,40
1712089,1286968,2023-03-28,Assembly,"Do pass as amended and be re-referred to the Committee on [Judiciary]",6,0,0,2,8
1712089,1298229,2023-04-11,Assembly,"Do pass and be re-referred to the Committee on [Appropriations]",8,0,0,3,11
1712090,1304382,2023-04-18,Assembly,"Do pass and be re-referred to the Committee on [Appropriations]",10,0,0,1,11
1712090,1322908,2023-05-10,Assembly,"Do pass",13,0,0,3,16
1712090,1328375,2023-05-18,Assembly,"AB 1345 Hart Assembly Third Reading",64,1,0,15,80
1712090,1348280,2023-06-27,Senate,"Do pass as amended, but first amend, and re-refer to the Committee on [Appropriations]",9,0,0,2,11
1712090,1351389,2023-08-14,Senate,"Placed on suspense file",7,0,0,0,7
1712090,1352886,2023-09-01,Senate,"Do pass as amended",5,2,0,0,7
1712090,1353730,2023-09-12,Assembly,"AB 1345 Hart Concurrence in Senate Amendments",72,0,0,8,80
1712090,1354770,2023-09-11,Senate,"Assembly 3rd Reading AB1345 Hart et al. By Rubio",30,6,0,4,40
1712092,1285728,2023-03-27,Assembly,"Do pass and be re-referred to the Committee on [Privacy and Consumer Protection]",8,2,0,1,11
1712092,1311743,2023-04-25,Assembly,"Do pass as amended and be re-referred to the Committee on [Appropriations]",8,2,0,1,11
1712092,1328412,2023-05-18,Assembly,"Do pass",11,4,0,1,16
1712092,1335592,2023-05-30,Assembly,"AB 1347 Ting Assembly Third Reading",49,17,0,14,80
1712092,1348371,2023-06-27,Senate,"Do pass as amended, but first amend, and re-refer to the Committee on [Environmental Quality]",9,0,0,2,11
1712092,1350505,2023-07-12,Senate,"Do pass as amended, but first amend, and re-refer to the Committee on [Appropriations]",4,2,0,1,7
1712092,1351799,2023-08-21,Senate,"Placed on suspense file",7,0,0,0,7
1712093,1305406,2023-04-19,Assembly,"Do pass and be re-referred to the Committee on [Appropriations] with recommendation: To Consent Calendar",6,0,0,1,7
1712093,1328632,2023-05-18,Assembly,"Do pass as amended",15,0,0,1,16
1712093,1337921,2023-05-31,Assembly,"AB 1348 Grayson Assembly Third Reading",80,0,0,0,80
1712093,1350252,2023-07-11,Senate,"Do pass, but first be re-referred to the Committee on [Appropriations] with the recommendation: To Consent Calendar",14,0,0,1,15
1712093,1351788,2023-08-21,Senate,"Placed on suspense file",7,0,0,0,7
1712094,1304243,2023-04-17,Assembly,"Do pass as amended, and be re-referred to the Committee on [Utilities and Energy] with recommendation: To Consent Calendar",15,0,0,0,15
1712094,1313428,2023-04-26,Assembly,"Do pass as amended. To Consent Calendar",15,0,0,0,15
1712094,1320461,2023-05-08,Assembly,"AB 1349 Irwin Consent Calendar Second Day",71,0,0,9,80
1712094,1343722,2023-06-13,Senate,"Do pass, but first be re-referred to the Committee on [Energy, Utilities and Communications]",11,0,0,5,16
1712095,1305294,2023-04-18,Assembly,"Do pass and be re-referred to the Committee on [Appropriations] with recommendation: To Consent Calendar",11,0,0,0,11
1712095,1328135,2023-05-18,Assembly,"Do pass",15,0,0,1,16
1712095,1333643,2023-05-25,Assembly,"AB 1350 Soria Assembly Third Reading",76,0,0,4,80
1712095,1350192,2023-07-10,Senate,"Do pass, but first be re-referred to the Committee on [Appropriations] with the recommendation: To Consent Calendar",5,0,0,0,5
1712095,1351271,2023-08-14,Senate,"Placed on suspense file",7,0,0,0,7
1712095,1352831,2023-09-01,Senate,"Do pass",7,0,0,0,7
1712095,1353925,2023-09-12,Senate,"Special Consent AB1350 Soria",39,0,0,1,40
1712095,1354291,2023-09-13,Assembly,"AB 1350 Soria Concurrence in Senate Amendments",78,0,0,2,80
1712096,1286972,2023-03-28,Assembly,"Do pass and be re-referred to the Committee on [Appropriations] with recommendation: To Consent Calendar",8,0,0,0,8
1712097,1286973,2023-03-28,Assembly,"Do pass and be re-referred to the Committee on [Education]",7,0,0,1,8
1712097,1301061,2023-04-12,Assembly,"Do pass and be re-referred to the Committee on [Appropriations]",7,0,0,0,7
1712097,1328642,2023-05-18,Assembly,"Do pass as amended",11,0,0,5,16
1712097,1333588,2023-05-25,Assembly,"AB 1352 Bonta Third Reading Urgency",75,0,0,5,80
1712097,1344203,2023-06-14,Senate,"Do pass, but first be re-referred to the Committee on [Human Services] with the recommendation: To Consent Calendar",7,0,0,0,7
1712099,1301042,2023-04-12,Assembly,"Do pass and be re-referred to the Committee on [Appropriations]",7,0,0,0,7
1712099,1311759,2023-04-26,Assembly,"Do pass. To Consent Calendar",16,0,0,0,16
1712099,1318976,2023-05-04,Assembly,"AB 1354 Mike Fong Consent Calendar Second Day Regular Session",75,0,0,5,80
1712099,1344213,2023-06-14,Senate,"Do pass, but first be re-referred to the Committee on [Appropriations]",7,0,0,0,7
1712099,1351657,2023-08-17,Senate,"Assembly 3rd Reading AB1354 Mike Fong et al. By Min",38,0,0,2,40
1712100,1311800,2023-04-26,Assembly,"Be adopted and re-referred to the Committee on [Appropriations]",6,0,0,1,7
1712100,1327955,2023-05-18,Assembly,"Be adopted",11,3,0,2,16
1712100,1338188,2023-05-31,Assembly,"ACA 6 Haney Assembly Third Reading",67,7,0,6,80
1712100,1348307,2023-06-28,Senate,"Be adopted, but first be re-referred to the Committee on [Elections and Constitutional Amendments]",5,0,0,0,5
1712100,1353680,2023-09-11,Senate,"Be adopted, but first be re-referred to the Committee on [Appropriations]",3,1,0,3,7
1712100,1353681,2023-09-11,Senate,"[First] hearing set for [09-11-2023]: Failed passage in Committee. Reconsideration granted",7,0,0,0,7
1712100,1456376,2024-06-11,Senate,"Be adopted, but first be re-referred to the Committee on [Appropriations]",2,1,0,4,7
1712101,1339992,2023-06-06,Assembly,"Be adopted and re-referred to the Committee on [Judiciary]",6,2,0,0,8
1712101,1343695,2023-06-13,Assembly,"Be adopted as amended, and re-refer to the Committee on [Appropriations]",8,3,0,0,11
1712101,1352574,2023-09-01,Assembly,"Be adopted",12,4,0,0,16
1712101,1353911,2023-09-12,Assembly,"ACA 7 Jackson Assembly Third Reading",62,18,0,0,80
1712102,1301083,2023-04-13,Assembly,"Be adopted. To third reading",13,0,0,0,13
1712103,1304267,2023-04-18,Senate,"Do pass, but first be re-referred to the Committee on [Appropriations] with the recommendation: To Consent Calendar",3,0,0,1,4
1712103,1318962,2023-05-04,Senate,"Consent Calendar SB624 Alvarado-Gil",37,0,0,3,40
1712103,1346244,2023-06-21,Assembly,"Do pass as amended and be re-referred to the Committee on [Appropriations]",10,0,0,1,11
1712104,1301036,2023-04-12,Senate,"Do pass as amended, but first amend, and re-refer to the Committee on [Judiciary]",6,1,0,5,12
1712104,1301037,2023-04-12,Senate,"[First] hearing set for [04-13-2023]: Failed passage in Committee. Reconsideration granted",11,0,0,1,12
1712104,1305536,2023-04-19,Senate,"Do pass as amended, but first amend, and re-refer to the Committee on [Judiciary]",7,1,0,4,12
1712104,1364109,2024-01-11,Senate,"Do pass, but first be re-referred to the Committee on [Appropriations]",8,0,0,3,11
1712104,1364830,2024-01-16,Senate,"Placed on suspense file",6,0,0,1,7
1712105,1306759,2023-04-19,Senate,"Do pass, but first be re-referred to the Committee on [Appropriations]",5,0,0,0,5
1712105,1330047,2023-05-22,Senate,"Senate 3rd Reading SB626 Rubio et al",33,5,0,2,40
1712105,1344199,2023-06-14,Assembly,"Do pass and be re-referred to the Committee on [Appropriations]",5,0,0,2,7
1712105,1350468,2023-07-12,Assembly,"Do pass",12,0,0,4,16
1712105,1352199,2023-08-24,Assembly,"SB 626 Rubio Senate Third Reading By Connolly",64,1,0,15,80
1712106,1301076,2023-04-12,Senate,"Do pass as amended, but first amend, and re-refer to the Committee on [Judiciary]",4,1,0,0,5
1712106,1311917,2023-04-25,Senate,"Do pass as amended, but first amend, and re-refer to the Committee on [Appropriations]",7,2,0,2,11
1712106,1320541,2023-05-08,Senate,"Placed on suspense file",7,0,0,0,7
1712106,1328854,2023-05-18,Senate,"Do pass",5,2,0,0,7
1712106,1335549,2023-05-30,Senate,"Senate 3rd Reading SB627 Smallwood-Cuevas et",28,10,0,2,40
1712106,1348332,2023-06-28,Assembly,"Do pass and be re-referred to the Committee on [Judiciary]",5,1,0,1,7
1712106,1350141,2023-07-11,Assembly,"Do pass as amended and be re-referred to the Committee on [Appropriations]",7,3,0,1,11
1712106,1352645,2023-09-01,Assembly,"Do pass as amended",11,4,0,1,16
1712106,1354275,2023-09-13,Assembly,"SB 627 Smallwood-Cuevas Senate Third Reading By Ortega",47,16,0,17,80
1712106,1354515,2023-09-14,Senate,"Unfinished Business SB627 Smallwood-Cuevas et Concurrence",29,10,0,1,40
1712107,1304265,2023-04-17,Senate,"Do pass, but first be re-referred to the Committee on [Appropriations]",4,0,0,1,5
1712107,1315781,2023-05-01,Senate,"Placed on suspense file",6,0,0,1,7
1712107,1327972,2023-05-18,Senate,"Do pass",5,1,0,1,7
1712107,1332628,2023-05-24,Senate,"Senate 3rd Reading SB628 Hurtado",35,2,0,3,40
1712107,1350312,2023-07-11,Assembly,"Do pass and be re-referred to the Committee on [Appropriations]",5,0,0,3,8
1712107,1353050,2023-09-01,Assembly,"Do pass as amended",12,1,0,3,16
1712107,1354164,2023-09-13,Assembly,"SB 628 Hurtado Senate Third Reading By Wilson",71,0,0,9,80
1712107,1354842,2023-09-14,Senate,"Unfinished Business SB628 Hurtado Concurrence",36,3,0,1,40
1712108,1311716,2023-04-26,Senate,"Do pass, but first be re-referred to the Committee on [Appropriations]",7,0,0,0,7
1712108,1320373,2023-05-08,Senate,"Placed on suspense file",7,0,0,0,7
1712109,1296938,2023-04-10,Senate,"Do pass, but first be re-referred to the Committee on [Judiciary]",12,0,0,1,13
1712109,1311842,2023-04-25,Senate,"Do pass, but first be re-referred to the Committee on [Appropriations] with the recommendation: To Consent Calendar",11,0,0,0,11
1712109,1323863,2023-05-11,Senate,"Consent Calendar SB630 Dodd",39,0,0,1,40
1712109,1345557,2023-06-20,Assembly,"Do pass and be re-referred to the Committee on [Judiciary] with recommendation: To Consent Calendar",19,0,0,0,19
1712109,1347826,2023-06-27,Assembly,"Do pass and be re-referred to the Committee on [Appropriations] with recommendation: To Consent Calendar",11,0,0,0,11
1712109,1350535,2023-07-12,Assembly,"Do pass. To Consent Calendar",15,0,0,1,16
1712109,1351684,2023-08-17,Assembly,"SB 630 Dodd Consent Calendar Second Day Regular Session",75,0,0,5,80
1712110,1301065,2023-04-12,Senate,"Do pass, but first be re-referred to the Committee on [Appropriations]",4,0,0,1,5
1712110,1308818,2023-04-24,Senate,"Placed on suspense file",7,0,0,0,7
1712110,1328013,2023-05-18,Senate,"Do pass as amended",5,2,0,0,7
1712110,1332564,2023-05-24,Senate,"Senate 3rd Reading SB631 Cortese",31,8,0,1,40
1712110,1348483,2023-06-28,Assembly,"Do pass and be re-referred to the Committee on [Appropriations]",10,1,0,3,14
1712111,1305296,2023-04-18,Senate,"Do pass, but first be re-referred to the Committee on [Appropriations]",7,0,0,0,7
1712111,1315703,2023-05-01,Senate,"Placed on suspense file",6,0,0,1,7
1712111,1327990,2023-05-18,Senate,"Do pass as amended",7,0,0,0,7
1712111,1335388,2023-05-30,Senate,"Special Consent SB632 Caballero",40,0,0,0,40
1712111,1349570,2023-07-05,Assembly,"Do pass as amended and be re-referred to the Committee on [Appropriations]",7,0,0,1,8
1712111,1352109,2023-08-23,Assembly,"Do pass. To Consent Calendar",15,0,0,1,16
1712111,1459965,2024-06-25,Assembly,"Do pass and be re-referred to the Committee on [Transportation]",13,0,0,2,15
1712111,1462228,2024-07-01,Assembly,"Do pass and be re-referred to the Committee on [Appropriations] with recommendation: To Consent Calendar",15,0,0,0,15
1712111,1464406,2024-08-15,Assembly,"Do pass",14,0,0,1,15
1712111,1465765,2024-08-26,Assembly,"SB 632 Caballero Senate Third Reading By Lackey",75,0,0,4,79
1712111,1466070,2024-08-28,Senate,"That the Assembly amendments be concurred in",10,0,0,1,11
1712111,1466469,2024-08-30,Senate,"Special Consent SB632 Caballero et al",40,0,0,0,40
1712112,1299437,2023-04-12,Senate,"Do pass as amended, but first amend, and re-refer to the Committee on [Appropriations]",6,0,0,1,7
1712112,1325023,2023-05-15,Senate,"Senate 3rd Reading SB633 Gonzalez",32,5,0,3,40
1712112,1343727,2023-06-13,Assembly,"Do pass and be re-referred to the Committee on [Appropriations]",9,2,0,1,12
1712112,1352745,2023-09-01,Assembly,"Do pass",12,4,0,0,16
1712112,1353501,2023-09-07,Assembly,"SB 633 Gonzalez Senate Third Reading By Bonta",65,11,0,4,80
1712113,1305280,2023-04-18,Senate,"Do pass, but first be re-referred to the Committee on [Governance and Finance]",8,1,0,2,11
1712113,1313341,2023-04-26,Senate,"Do pass as amended, but first amend, and re-refer to the Committee on [Appropriations]",5,2,0,1,8
1712113,1325022,2023-05-15,Senate,"Placed on suspense file",7,0,0,0,7
1712114,1288326,2023-03-29,Senate,"Do pass, but first be re-referred to the Committee on [Human Services]",7,0,0,0,7
1712114,1310281,2023-04-24,Senate,"Do pass, but first be re-referred to the Committee on [Appropriations]",5,0,0,0,5
1712114,1320523,2023-05-08,Senate,"Placed on suspense file",7,0,0,0,7
1712114,1328041,2023-05-18,Senate,"Do pass as amended",7,0,0,0,7
1712114,1335585,2023-05-30,Senate,"Special Consent SB635 Menjivar",40,0,0,0,40
1712114,1350264,2023-07-11,Assembly,"Do pass as amended and be re-referred to the Committee on [Appropriations]",15,0,0,0,15
1712114,1352966,2023-09-01,Assembly,"Do pass",16,0,0,0,16
1712114,1353604,2023-09-11,Assembly,"SB 635 Menjivar Senate Third Reading By Arambula",78,0,0,2,80
1712114,1354361,2023-09-13,Senate,"That the Assembly amendments be concurred in",12,0,0,0,12
1712114,1354795,2023-09-14,Senate,"Unfinished Business SB635 Menjivar et al. Concurrence",40,0,0,0,40
1712115,1306803,2023-04-19,Senate,"Do pass, but first be re-referred to the Committee on [Appropriations]",4,1,0,0,5
1712115,1330083,2023-05-22,Senate,"Senate 3rd Reading SB636 Cortese",30,8,0,2,40
1712115,1348310,2023-06-28,Assembly,"Do pass and be re-referred to the Committee on [Appropriations]",10,3,0,1,14
1712115,1351575,2023-08-16,Assembly,"Do pass",12,3,0,1,16
1712115,1466204,2024-08-29,Assembly,"SB 636 Cortese Senate Third Reading By Ward",54,13,0,12,79
1712115,1466570,2024-08-30,Senate,"Unfinished Business SB636 Cortese Concurrence",31,9,0,0,40
1712117,1286949,2023-03-28,Senate,"Do pass, but first be re-referred to the Committee on [Governance and Finance]",9,0,0,2,11
1712117,1305336,2023-04-19,Senate,"Do pass, but first be re-referred to the Committee on [Appropriations]",7,1,0,0,8
1712117,1315770,2023-05-01,Senate,"Placed on suspense file",6,0,0,1,7
1712117,1328076,2023-05-18,Senate,"Do pass as amended",5,2,0,0,7
1712117,1336350,2023-05-31,Senate,"Senate 3rd Reading SB638 Eggman et al",36,2,0,2,40
1712118,1301084,2023-04-12,Senate,"Do pass and be ordered to the Consent Calendar",11,0,0,1,12
1712118,1306792,2023-04-20,Senate,"Consent Calendar SB639 Lim√≥n",36,0,0,4,40
1712118,1343755,2023-06-13,Assembly,"Do pass as amended. To Consent Calendar",15,0,0,0,15
1712118,1346982,2023-06-22,Assembly,"SB 639 Lim√≥n Consent Calendar Second Day Regular Session",71,0,0,9,80
1712118,1352359,2023-08-28,Assembly,"SB 639 Lim√≥n Senate Third Reading By Alvarez",76,0,0,4,80
1712118,1354254,2023-09-13,Assembly,"Do pass",13,0,0,3,16
1712118,1354255,2023-09-13,Assembly,"SB 639 Lim√≥n Senate Third Reading By Alvarez",78,0,0,2,80
1712118,1460007,2024-06-25,Assembly,"Do pass as amended and be re-referred to the Committee on [Appropriations]",18,0,0,0,18
1712118,1463710,2024-08-07,Assembly,"Do pass. To Consent Calendar",14,0,0,1,15
1712118,1465558,2024-08-26,Assembly,"SB 639 Lim√≥n Senate Third Reading By Alvarez",77,0,0,2,79
1712118,1466052,2024-08-28,Senate,"That the Assembly amendments be concurred in",8,0,0,4,12
1712118,1466146,2024-08-29,Senate,"Unfinished Business SB639 Lim√≥n et al. Concurrence",34,3,0,3,40
1712119,1288387,2023-03-29,Senate,"Do pass, but first be re-referred to the Committee on [Labor, Public Employment and Retirement ]",4,2,0,1,7
1712119,1306714,2023-04-19,Senate,"Do pass, but first be re-referred to the Committee on [Appropriations]",4,1,0,0,5
1712119,1315697,2023-05-01,Senate,"Placed on suspense file",6,0,0,1,7
1712119,1327945,2023-05-18,Senate,"Do pass as amended",5,2,0,0,7
1712119,1336331,2023-05-31,Senate,"Senate 3rd Reading SB640 Portantino et al",28,10,0,2,40
1712119,1348301,2023-06-27,Assembly,"Do pass and be re-referred to the Committee on [Labor and Employment]",8,3,0,1,12
1712119,1350707,2023-07-12,Assembly,"Do pass and be re-referred to the Committee on [Appropriations]",6,0,0,1,7
1712119,1352784,2023-09-01,Assembly,"Do pass",12,3,0,1,16
1712119,1353649,2023-09-11,Assembly,"SB 640 Portantino Senate Third Reading By Kalra",58,12,0,10,80
1712120,1313465,2023-04-26,Senate,"Do pass as amended, but first amend, and re-refer to the Committee on [Appropriations] with the recommendation: To Consent Calendar",11,0,0,1,12
1712120,1320524,2023-05-08,Senate,"Placed on suspense file",7,0,0,0,7
1712120,1328577,2023-05-18,Senate,"Do pass",7,0,0,0,7
1712120,1333808,2023-05-25,Senate,"Special Consent SB641 Roth et al",40,0,0,0,40
1712120,1345559,2023-06-20,Assembly,"Do pass and be re-referred to the Committee on [Appropriations] with recommendation: To Consent Calendar",14,0,0,1,15
1712120,1352752,2023-09-01,Assembly,"Do pass as amended",11,0,0,5,16
1712120,1354262,2023-09-13,Assembly,"SB 641 Roth Senate Third Reading By Haney",76,0,0,4,80
1712120,1354809,2023-09-14,Senate,"Unfinished Business SB641 Roth et al. Concurrence",40,0,0,0,40
1712121,1288283,2023-03-29,Senate,"Do pass, but first be re-referred to the Committee on [Judiciary]",5,0,0,2,7
1712121,1299482,2023-04-11,Senate,"Do pass",10,0,0,1,11
1712121,1323810,2023-05-11,Senate,"Senate 3rd Reading SB642 Cortese",35,3,0,2,40
1712121,1346158,2023-06-20,Assembly,"Do pass and be re-referred to the Committee on [Judiciary]",8,0,0,1,9
1712121,1347920,2023-06-27,Assembly,"Do pass",9,1,0,1,11
1712121,1350673,2023-07-13,Assembly,"SB 642 Cortese Senate Third Reading By Cervantes",63,1,0,16,80
1712121,1351680,2023-08-17,Senate,"Unfinished Business SB642 Cortese et al. Concurrence",32,5,0,3,40
1712122,1299441,2023-04-12,Senate,"Do pass as amended, but first amend, and re-refer to the Committee on [Public Safety]",6,1,0,0,7
1712122,1315731,2023-05-01,Senate,"Placed on suspense file",6,0,0,1,7
1712122,1328745,2023-05-18,Senate,"Do pass",6,0,0,1,7
1712122,1335483,2023-05-30,Senate,"Senate 3rd Reading SB643 Wilk",35,0,0,5,40
1712123,1299349,2023-04-11,Senate,"Do pass as amended, but first amend, and re-refer to the Committee on [Appropriations]",9,0,0,2,11
1712123,1308838,2023-04-24,Senate,"Placed on suspense file",7,0,0,0,7
1712123,1328641,2023-05-18,Senate,"Do pass",5,2,0,0,7
1712123,1332565,2023-05-24,Senate,"Senate 3rd Reading SB644 Glazer et al",33,6,0,1,40
1712123,1343768,2023-06-13,Assembly,"Do pass as amended and be re-referred to the Committee on [Judiciary]",7,0,0,4,11
1712123,1347951,2023-06-27,Assembly,"Do pass and be re-referred to the Committee on [Appropriations]",9,1,0,1,11
1712123,1352979,2023-09-01,Assembly,"Do pass",13,2,0,1,16
1712123,1353525,2023-09-07,Assembly,"SB 644 Glazer Senate Third Reading By Berman",73,0,0,7,80
1712123,1354585,2023-09-11,Senate,"Unfinished Business SB644 Glazer et al. Concurrence",39,0,0,1,40
1712125,1311905,2023-04-25,Senate,"Do pass as amended, but first amend, and re-refer to the Committee on [Appropriations]",11,0,0,0,11
1712125,1320412,2023-05-08,Senate,"Placed on suspense file",7,0,0,0,7
1712125,1328274,2023-05-18,Senate,"Do pass",6,0,0,1,7
1712125,1330124,2023-05-22,Senate,"Senate 3rd Reading SB646 Cortese",39,0,0,1,40
1712125,1345572,2023-06-20,Assembly,"Do pass as amended and be re-referred to the Committee on [Appropriations]",10,0,0,1,11
1712127,1288394,2023-03-29,Senate,"Do pass, but first be re-referred to the Committee on [Appropriations] with the recommendation: To Consent Calendar",7,0,0,0,7
1712127,1296944,2023-04-10,Senate,"Placed on suspense file",7,0,0,0,7
1712127,1327991,2023-05-18,Senate,"Do pass",7,0,0,0,7
1712127,1333580,2023-05-25,Senate,"Special Consent SB648 Dahle",40,0,0,0,40
1712127,1348883,2023-06-28,Assembly,"Do pass as amended, and be re-referred to the Committee on [Appropriations] with recommendation: To Consent Calendar",7,0,0,0,7
1712127,1352919,2023-09-01,Assembly,"Do pass",16,0,0,0,16
1712127,1353495,2023-09-07,Assembly,"SB 648 Dahle Third Reading Urgency By Megan Dahle",79,0,0,1,80
1712127,1354604,2023-09-11,Senate,"Unfinished Business SB648 Dahle Urgency Clause Concurrence",39,0,0,1,40
1712129,1286873,2023-03-28,Senate,"Do pass, but first be re-referred to the Committee on [Appropriations]",13,0,0,2,15
1712129,1296918,2023-04-10,Senate,"Placed on suspense file",7,0,0,0,7
1712129,1327970,2023-05-18,Senate,"Do pass",7,0,0,0,7
1712129,1333595,2023-05-25,Senate,"Special Consent SB650 Dodd et al",40,0,0,0,40
1712129,1350490,2023-07-12,Assembly,"Do pass and be re-referred to the Committee on [Appropriations]",20,0,0,2,22
1712129,1352957,2023-09-01,Assembly,"Do pass",16,0,0,0,16
1712129,1353417,2023-09-07,Assembly,"SB 650 Dodd Senate Third Reading By Low",79,0,0,1,80
1712130,1298192,2023-04-11,Senate,"Do pass as amended, but first amend, and re-refer to the Committee on [Environmental Quality]",9,0,0,2,11
1712130,1311908,2023-04-26,Senate,"Do pass as amended, but first amend, and re-refer to the Committee on [Appropriations]",7,0,0,0,7
1712130,1320428,2023-05-08,Senate,"Placed on suspense file",7,0,0,0,7
1712130,1327963,2023-05-18,Senate,"Do pass",6,1,0,0,7
1712130,1332620,2023-05-24,Senate,"Senate 3rd Reading SB651 Grove et al",37,0,0,3,40
1712130,1345563,2023-06-20,Assembly,"Do pass as amended and be re-referred to the Committee on [Natural Resources]",11,0,0,4,15
1712131,1299511,2023-04-11,Senate,"Do pass as amended, but first amend, and re-refer to the Committee on [Public Safety] with the recommendation: To Consent Calendar",10,0,0,1,11
1712131,1320517,2023-05-08,Senate,"Senate 3rd Reading SB652 Umberg",36,0,0,4,40
1712131,1339953,2023-06-06,Assembly,"Do pass as amended. To Consent Calendar",11,0,0,0,11
1712131,1344733,2023-06-15,Assembly,"SB 652 Umberg Consent Calendar Second Day Regular Session",74,0,0,6,80
1712131,1346954,2023-06-22,Senate,"Special Consent SB652 Umberg",39,0,0,1,40
1712133,1299493,2023-04-12,Senate,"Do pass as amended",8,0,0,0,8
1712133,1308886,2023-04-24,Senate,"Senate 3rd Reading SB654 Jones",39,0,0,1,40
1712133,1348409,2023-06-28,Assembly,"Do pass",8,0,0,0,8
1712133,1351699,2023-08-17,Assembly,"SB 654 Jones Senate Third Reading By Boerner",75,0,0,5,80
1712134,1298166,2023-04-11,Senate,"Do pass, but first be re-referred to the Committee on [Appropriations]",4,0,0,1,5
1712134,1315702,2023-05-01,Senate,"Placed on suspense file",6,0,0,1,7
1712136,1304387,2023-04-17,Senate,"Do pass, but first be re-referred to the Committee on [Housing]",4,0,0,1,5
1712136,1310206,2023-04-24,Senate,"Do pass, but first be re-referred to the Committee on [Appropriations]",11,0,0,0,11
1712136,1320549,2023-05-08,Senate,"Placed on suspense file",7,0,0,0,7
1712136,1328512,2023-05-18,Senate,"Do pass",7,0,0,0,7
1712136,1333618,2023-05-25,Senate,"Special Consent SB657 Caballero",40,0,0,0,40
1712136,1346178,2023-06-21,Assembly,"Do pass and be re-referred to the Committee on [Aging and Long-Term Care] with recommendation: To Consent Calendar",8,0,0,0,8
1712136,1350226,2023-07-11,Assembly,"Do pass as amended and be re-referred to the Committee on [Appropriations]",6,0,0,2,8
1712136,1353093,2023-09-01,Assembly,"Do pass",16,0,0,0,16
1712136,1353437,2023-09-07,Assembly,"SB 657 Caballero Senate Third Reading By Bains",79,0,0,1,80
1712136,1354537,2023-09-11,Senate,"Unfinished Business SB657 Caballero et al. Concurrence",39,0,0,1,40
1712137,1280598,2023-03-21,Senate,"Do pass, but first be re-referred to the Committee on [Judiciary]",7,0,0,0,7
1712137,1299497,2023-04-11,Senate,"Do pass as amended, but first amend, and re-refer to the Committee on [Appropriations]",9,0,0,2,11
1712137,1336342,2023-05-31,Senate,"Senate 3rd Reading SB658 McGuire",40,0,0,0,40
1712137,1349588,2023-07-05,Assembly,"Do pass and be re-referred to the Committee on [Appropriations]",6,0,0,2,8
1712137,1352114,2023-08-23,Assembly,"Do pass. To Consent Calendar",15,0,0,1,16
1712137,1352457,2023-08-31,Assembly,"SB 658 McGuire Consent Calendar Second Day Regular Session",79,0,0,1,80
1712137,1353507,2023-09-07,Senate,"Special Consent SB658 McGuire",40,0,0,0,40
1712138,1298311,2023-04-11,Senate,"Do pass as amended, but first amend, and re-refer to the Committee on [Rules]",10,0,0,1,11
1712138,1311715,2023-04-26,Senate,"Do pass, but first be re-referred to the Committee on [Appropriations] with the recommendation: To Consent Calendar",7,0,0,0,7
1712138,1320430,2023-05-08,Senate,"Placed on suspense file",7,0,0,0,7
1712138,1328345,2023-05-18,Senate,"Do pass as amended",7,0,0,0,7
1712138,1335401,2023-05-30,Senate,"Special Consent SB659 Ashby",40,0,0,0,40
1712138,1350206,2023-07-11,Assembly,"Do pass as amended and be re-referred to the Committee on [Appropriations]",14,0,0,1,15
1712138,1352525,2023-09-01,Assembly,"Do pass as amended",11,0,0,5,16
1712138,1353435,2023-09-07,Assembly,"SB 659 Ashby Senate Third Reading By Bauer-Kahan",77,0,0,3,80
1712138,1354754,2023-09-11,Senate,"Unfinished Business SB659 Ashby et al. Concurrence",39,0,0,1,40
1712139,1306805,2023-04-19,Senate,"Do pass, but first be re-referred to the Committee on [Appropriations]",5,0,0,0,5
1712139,1315760,2023-05-01,Senate,"Placed on suspense file",6,0,0,1,7
1712140,1305422,2023-04-19,Senate,"Do pass as amended, but first amend, and re-refer to the Committee on [Appropriations]",7,0,0,0,7
1712140,1315672,2023-05-01,Senate,"Placed on suspense file",6,0,0,1,7
1712140,1328526,2023-05-18,Senate,"Do pass",7,0,0,0,7
1712140,1332590,2023-05-24,Senate,"Senate 3rd Reading SB661 Bradford",39,0,0,1,40
1712140,1343791,2023-06-13,Assembly,"Do pass and be re-referred to the Committee on [Appropriations]",11,0,0,1,12
1712140,1352592,2023-09-01,Assembly,"Do pass as amended",11,0,0,5,16
1712140,1354419,2023-09-13,Assembly,"SB 661 Bradford Senate Third Reading By Valencia",77,0,0,3,80
1712140,1354506,2023-09-14,Senate,"Unfinished Business SB661 Bradford Concurrence",40,0,0,0,40
1712141,1305432,2023-04-18,Senate,"Do pass, but first be re-referred to the Committee on [Business, Professions and Economic Development]",8,0,0,3,11
1712141,1308874,2023-04-24,Senate,"Do pass as amended, but first amend, and re-refer to the Committee on [Appropriations]",11,0,0,2,13
1712141,1320538,2023-05-08,Senate,"Placed on suspense file",7,0,0,0,7
1712142,1304245,2023-04-18,Senate,"Do pass, but first be re-referred to the Committee on [Environmental Quality]",17,0,0,1,18
1712142,1311763,2023-04-26,Senate,"Do pass as amended, but first amend, and re-refer to the Committee on [Appropriations]",7,0,0,0,7
1712142,1320441,2023-05-08,Senate,"Placed on suspense file",7,0,0,0,7
1712142,1328430,2023-05-18,Senate,"Do pass as amended",7,0,0,0,7
1712143,1310320,2023-04-24,Senate,"Do pass as amended, but first amend, and re-refer to the Committee on [Appropriations]",16,0,0,2,18
1712143,1330119,2023-05-22,Senate,"Senate 3rd Reading SB664 Stern",40,0,0,0,40
1712143,1350422,2023-07-12,Assembly,"Do pass and be re-referred to the Committee on [Appropriations] with recommendation: To Consent Calendar",14,0,0,1,15
1712143,1353056,2023-09-01,Assembly,"Do pass",16,0,0,0,16
1712143,1353565,2023-09-08,Assembly,"SB 664 Stern Senate Third Reading Amend By SCHIAVO Set #1",63,0,0,17,80
1712143,1353791,2023-09-12,Assembly,"SB 664 Stern Senate Third Reading By Schiavo",80,0,0,0,80
1712143,1354076,2023-09-13,Senate,"Unfinished Business SB664 Stern Concurrence",39,0,0,1,40
1712144,1288287,2023-03-29,Senate,"Do pass, but first be re-referred to the Committee on [Appropriations]",5,0,0,2,7
1712144,1302608,2023-04-17,Senate,"Placed on suspense file",6,0,0,1,7
1712144,1328296,2023-05-18,Senate,"Do pass as amended",6,1,0,0,7
1712144,1332563,2023-05-24,Senate,"Senate 3rd Reading SB665 Allen",39,0,0,1,40
1712144,1345200,2023-06-19,Assembly,"Do pass as amended and be re-referred to the Committee on [Appropriations]",11,0,0,0,11
1712144,1353028,2023-09-01,Assembly,"Do pass as amended",11,0,0,5,16
1712144,1354206,2023-09-13,Assembly,"SB 665 Allen Senate Third Reading By Connolly",74,0,0,6,80
1712144,1354867,2023-09-14,Senate,"Unfinished Business SB665 Allen Concurrence",39,0,0,1,40
1712145,1305539,2023-04-19,Senate,"Do pass, but first be re-referred to the Committee on [Rules] with the recommendation: To Consent Calendar",7,0,0,0,7
1712145,1317053,2023-05-02,Senate,"Do pass and be ordered to the Consent Calendar",10,0,0,1,11
1712145,1323857,2023-05-11,Senate,"Consent Calendar SB666 Min",39,0,0,1,40
1712145,1343146,2023-06-12,Assembly,"Do pass as amended and be re-referred to the Committee on [Judiciary]",12,0,0,0,12
1712145,1347809,2023-06-27,Assembly,"Do pass and be re-referred to the Committee on [Appropriations]",11,0,0,0,11
1712145,1352546,2023-09-01,Assembly,"Do pass",16,0,0,0,16
1712145,1353669,2023-09-11,Assembly,"SB 666 Min Senate Third Reading By Grayson",80,0,0,0,80
1712145,1354021,2023-09-12,Senate,"Unfinished Business SB666 Min Concurrence",39,0,0,1,40
1712146,1302640,2023-04-17,Senate,"Do pass as amended, but first amend, and re-refer to the Committee on [Appropriations]",12,0,0,1,13
1712146,1336388,2023-05-31,Senate,"Senate 3rd Reading SB667 Dodd",40,0,0,0,40
1712146,1347848,2023-06-27,Assembly,"Do pass and be re-referred to the Committee on [Appropriations]",18,0,0,1,19
1712146,1350507,2023-07-12,Assembly,"Do pass. To Consent Calendar",15,0,0,1,16
1712146,1353938,2023-09-12,Assembly,"SB 667 Dodd Senate Third Reading By Schiavo",79,0,0,1,80
1712146,1354093,2023-09-13,Senate,"Unfinished Business SB667 Dodd et al. Concurrence",39,0,0,1,40
1712147,1286917,2023-03-28,Senate,"Do pass, but first be re-referred to the Committee on [Appropriations] with the recommendation: To Consent Calendar",10,0,0,1,11
1712147,1301007,2023-04-13,Senate,"Consent Calendar SB668 Dodd",36,0,0,4,40
1712147,1340039,2023-06-06,Assembly,"Do pass and be re-referred to the Committee on [Appropriations]",14,0,0,1,15
1712147,1351580,2023-08-16,Assembly,"Do pass. To Consent Calendar",15,0,0,1,16
1712147,1352203,2023-08-24,Assembly,"SB 668 Dodd Consent Calendar Second Day Regular Session",73,0,0,7,80
1712148,1308858,2023-04-24,Senate,"Do pass as amended, but first amend, and re-refer to the Committee on [Appropriations]",13,0,0,0,13
1712148,1324993,2023-05-15,Senate,"Senate 3rd Reading SB669 Cortese",38,0,0,2,40
1712148,1345569,2023-06-20,Assembly,"Do pass as amended and be re-referred to the Committee on [Appropriations]",18,0,0,1,19
1712148,1351571,2023-08-16,Assembly,"Do pass. To Consent Calendar",15,0,0,1,16
1712148,1352226,2023-08-24,Assembly,"SB 669 Cortese Consent Calendar Second Day Regular Session",73,0,0,7,80
1712148,1353066,2023-09-01,Senate,"Special Consent SB669 Cortese et al",37,0,0,3,40
1712149,1311922,2023-04-26,Senate,"Do pass as amended, but first amend, and re-refer to the Committee on [Appropriations]",5,1,0,1,7
1712149,1320397,2023-05-08,Senate,"Placed on suspense file",7,0,0,0,7
1712150,1299449,2023-04-12,Senate,"Do pass as amended, but first amend, and re-refer to the Committee on [Public Safety]",6,0,0,1,7
1712150,1315733,2023-05-01,Senate,"Placed on suspense file",6,0,0,1,7
1712150,1328061,2023-05-18,Senate,"Do pass",7,0,0,0,7
1712150,1333696,2023-05-25,Senate,"Special Consent SB671 Portantino",40,0,0,0,40
1712150,1350416,2023-07-12,Assembly,"Do pass and be re-referred to the Committee on [Appropriations] with recommendation: To Consent Calendar",7,0,0,0,7
1712150,1353090,2023-09-01,Assembly,"Do pass",16,0,0,0,16
1712150,1354250,2023-09-13,Assembly,"SB 671 Portantino Senate Third Reading By Blanca Rubio",79,0,0,1,80
1712150,1354681,2023-09-14,Senate,"Unfinished Business SB671 Portantino Concurrence",40,0,0,0,40
1712151,1311891,2023-04-25,Senate,"Do pass, but first be re-referred to the Committee on [Appropriations] with the recommendation: To Consent Calendar",16,0,0,0,16
1712151,1324958,2023-05-15,Senate,"Placed on suspense file",7,0,0,0,7
1712151,1328720,2023-05-18,Senate,"Do pass",7,0,0,0,7
1712151,1333734,2023-05-25,Senate,"Special Consent SB672 McGuire",40,0,0,0,40
1712152,1304275,2023-04-18,Senate,"Do pass, but first be re-referred to the Committee on [Appropriations]",5,0,0,0,5
1712152,1332679,2023-05-24,Senate,"Senate 3rd Reading SB673 Bradford et al",39,0,0,1,40
1712152,1349949,2023-07-10,Assembly,"Do pass and be re-referred to the Committee on [Appropriations]",6,0,0,1,7
1712152,1353008,2023-09-01,Assembly,"Do pass as amended",11,0,0,5,16
1712152,1354434,2023-09-13,Assembly,"SB 673 Bradford Senate Third Reading By Gipson",76,0,0,4,80
1712152,1354835,2023-09-14,Senate,"Unfinished Business SB673 Bradford et al. Concurrence",40,0,0,0,40
1712153,1288238,2023-03-29,Senate,"Do pass as amended, but first amend, and re-refer to the Committee on [Judiciary]",4,2,0,1,7
1712153,1305471,2023-04-18,Senate,"Do pass, but first be re-referred to the Committee on [Appropriations]",10,1,0,0,11
1712153,1330120,2023-05-22,Senate,"Senate 3rd Reading SB674 Gonzalez et al",31,6,0,3,40
1712153,1347509,2023-06-26,Assembly,"Do pass and be re-referred to the Committee on [Judiciary]",7,2,0,2,11
1712153,1350234,2023-07-11,Assembly,"Do pass as amended and be re-referred to the Committee on [Appropriations]",8,3,0,0,11
1712153,1352104,2023-08-23,Assembly,"Do pass",11,4,0,1,16
1712153,1462059,2024-07-01,Assembly,"SB 674 Gonzalez Senate Third Reading By Zbur",47,15,0,17,79
1712153,1463822,2024-08-08,Senate,"Unfinished Business SB674 Gonzalez et al. Concurrence",28,8,0,4,40
1712154,1298234,2023-04-11,Senate,"Do pass as amended, but first amend, and re-refer to the Committee on [Appropriations] with the recommendation: To Consent Calendar",11,0,0,0,11
1712154,1315755,2023-05-01,Senate,"Placed on suspense file",6,0,0,1,7
1712154,1328498,2023-05-18,Senate,"Do pass as amended",7,0,0,0,7
1712154,1335397,2023-05-30,Senate,"Special Consent SB675 Lim√≥n",40,0,0,0,40
1712154,1345198,2023-06-19,Assembly,"Do pass as amended, and be re-referred to the Committee on [Appropriations] with recommendation: To Consent Calendar",11,0,0,0,11
1712154,1352887,2023-09-01,Assembly,"Do pass",15,0,0,1,16
1712154,1461983,2024-07-01,Assembly,"SB 675 Lim√≥n Senate Third Reading By Wicks",72,0,0,7,79
1712154,1467147,2024-08-31,Senate,"Unfinished Business SB675 Lim√≥n et al. Concurrence",38,0,0,2,40
1712154,1467148,2024-08-31,Assembly,"SB 675 Lim√≥n Senate Third Reading By Wicks",76,0,0,3,79
1712155,1313475,2023-04-26,Senate,"Do pass",6,1,0,1,8
1712155,1332642,2023-05-24,Senate,"Senate 3rd Reading SB676 Allen",33,5,0,2,40
1712155,1350529,2023-07-12,Assembly,"Do pass",8,0,0,0,8
1712155,1353992,2023-09-12,Assembly,"SB 676 Allen Senate Third Reading By Schiavo",66,10,0,4,80
1712156,1311793,2023-04-25,Senate,"Do pass, but first be re-referred to the Committee on [Appropriations] with the recommendation: To Consent Calendar",16,0,0,0,16
1712156,1323861,2023-05-11,Senate,"Consent Calendar SB677 Blakespear",39,0,0,1,40
1712156,1347838,2023-06-26,Assembly,"Do pass and be re-referred to the Committee on [Appropriations] with recommendation: To Consent Calendar",15,0,0,0,15
1712156,1352587,2023-09-01,Assembly,"Do pass",16,0,0,0,16
1712156,1353643,2023-09-11,Assembly,"SB 677 Blakespear Senate Third Reading By Dixon",80,0,0,0,80
1712157,1305472,2023-04-18,Senate,"Do pass, but first be re-referred to the Committee on [Appropriations]",7,0,0,0,7
1712157,1323860,2023-05-11,Senate,"Senate 3rd Reading SB678 Umberg",38,0,0,2,40
1712157,1341016,2023-06-07,Assembly,"Do pass as amended, and be re-referred to the Committee on [Appropriations] with recommendation: To Consent Calendar",8,0,0,0,8
1712157,1348345,2023-06-28,Assembly,"Do pass. To Consent Calendar",14,0,0,2,16
1712157,1349506,2023-07-03,Assembly,"SB 678 Umberg Consent Calendar Second Day Regular Session",69,0,0,11,80
1712157,1351646,2023-08-17,Senate,"Special Consent SB678 Umberg",38,0,0,2,40
1712159,1311803,2023-04-25,Senate,"Do pass as amended, but first amend, and re-refer to the Committee on [Appropriations]",8,1,0,2,11
1712159,1330061,2023-05-22,Senate,"Senate 3rd Reading SB680 Skinner",31,6,0,3,40
1712159,1347887,2023-06-27,Assembly,"Do pass and be re-referred to the Committee on [Privacy and Consumer Protection]",8,0,0,3,11
1712159,1350261,2023-07-11,Assembly,"Do pass as amended and be re-referred to the Committee on [Appropriations]",10,0,0,1,11
1712160,1280614,2023-03-21,Senate,"Do pass as amended, but first amend, and re-refer to the Committee on [Appropriations]",6,1,0,0,7
1712160,1335556,2023-05-30,Senate,"Senate 3rd Reading SB681 Allen",32,8,0,0,40
1712160,1346147,2023-06-21,Assembly,"Do pass and be re-referred to the Committee on [Appropriations]",6,1,0,1,8
1712160,1351555,2023-08-16,Assembly,"Do pass",12,4,0,0,16
1712160,1354273,2023-09-13,Assembly,"SB 681 Allen Senate Third Reading By Friedman",61,18,0,1,80
1712160,1354692,2023-09-14,Senate,"Unfinished Business SB681 Allen et al. Concurrence",32,8,0,0,40
1712161,1288169,2023-03-29,Senate,"Do pass as amended, but first amend, and re-refer to the Committee on [Transportation]",5,2,0,0,7
1712161,1311837,2023-04-25,Senate,"Do pass as amended, but first amend, and re-refer to the Committee on [Appropriations]",12,4,0,0,16
1712161,1324969,2023-05-15,Senate,"Placed on suspense file",7,0,0,0,7
1712162,1299450,2023-04-11,Senate,"Do pass as amended, but first amend, and re-refer to the Committee on [Appropriations]",9,0,0,2,11
1712162,1308880,2023-04-24,Senate,"Placed on suspense file",7,0,0,0,7
1712162,1328012,2023-05-18,Senate,"Do pass",7,0,0,0,7
1712162,1332655,2023-05-24,Senate,"Senate 3rd Reading SB683 Glazer et al",40,0,0,0,40
1712162,1345597,2023-06-20,Assembly,"Do pass and be re-referred to the Committee on [Judiciary]",11,0,0,8,19
1712162,1347945,2023-06-27,Assembly,"Do pass as amended and be re-referred to the Committee on [Appropriations]",8,3,0,0,11
1712162,1352841,2023-09-01,Assembly,"Do pass",12,2,0,2,16
1712163,1299375,2023-04-12,Senate,"Do pass, but first be re-referred to the Committee on [Rules]",5,0,0,3,8
1712163,1310402,2023-04-24,Senate,"Do pass, but first be re-referred to the Committee on [Appropriations]",9,0,0,2,11
1712163,1332551,2023-05-24,Senate,"Senate 3rd Reading SB684 Caballero",34,0,0,6,40
1712163,1346186,2023-06-21,Assembly,"Do pass and be re-referred to the Committee on [Local Government]",8,0,0,0,8
1712163,1350434,2023-07-12,Assembly,"Do pass as amended and be re-referred to the Committee on [Appropriations]",8,0,0,0,8
1712163,1352800,2023-09-01,Assembly,"Do pass as amended",11,0,0,5,16
1712163,1354797,2023-09-14,Senate,"Unfinished Business SB684 Caballero et al. Concurrence",37,0,0,3,40
1712163,1354798,2023-09-14,Assembly,"SB 684 Caballero Senate Third Reading By Boerner",79,0,0,1,80
1712164,1311866,2023-04-26,Senate,"Do pass, but first be re-referred to the Committee on [Appropriations]",2,0,0,3,5
1712164,1311867,2023-04-26,Senate,"[First] hearing set for [04-26-2023]: Failed passage in Committee. Reconsideration granted",5,0,0,0,5
1712165,1311882,2023-04-26,Senate,"Do pass, but first be re-referred to the Committee on [Appropriations]",4,1,0,0,5
1712165,1320510,2023-05-08,Senate,"Placed on suspense file",7,0,0,0,7
1712165,1327952,2023-05-18,Senate,"Do pass",5,2,0,0,7
1712165,1334451,2023-05-26,Senate,"Senate 3rd Reading SB686 Durazo et al",24,8,0,8,40
1712165,1348356,2023-06-28,Assembly,"Do pass and be re-referred to the Committee on [Appropriations]",7,0,0,0,7
1712165,1353064,2023-09-01,Assembly,"Do pass as amended",11,4,0,1,16
1712165,1354402,2023-09-13,Assembly,"SB 686 Durazo Senate Third Reading By Wendy Carrillo",65,2,0,13,80
1712165,1354833,2023-09-14,Senate,"Unfinished Business SB686 Durazo et al. Concurrence",27,8,0,5,40
1712166,1298238,2023-04-11,Senate,"Do pass as amended, but first amend, and re-refer to the Committee on [Environmental Quality]",8,1,0,2,11
1712166,1311692,2023-04-26,Senate,"Do pass, but first be re-referred to the Committee on [Appropriations]",4,1,0,2,7
1712166,1320532,2023-05-08,Senate,"Placed on suspense file",7,0,0,0,7
1712167,1296939,2023-04-10,Senate,"Do pass, but first be re-referred to the Committee on [Agriculture]",15,0,0,3,18
1712167,1315774,2023-05-01,Senate,"Placed on suspense file",6,0,0,1,7
1712167,1328178,2023-05-18,Senate,"Do pass",7,0,0,0,7
1712167,1333813,2023-05-25,Senate,"Special Consent SB688 Padilla",40,0,0,0,40
1712167,1348386,2023-06-28,Assembly,"Do pass as amended and be re-referred to the Committee on [Appropriations]",14,0,0,1,15
1712168,1363764,2024-01-09,Senate,"Do pass, but first be re-referred to the Committee on [Transportation]",8,3,0,0,11
1712168,1363765,2024-01-09,Senate,"Do pass",11,3,0,1,15
1712168,1371106,2024-01-29,Senate,"Senate 3rd Reading SB689 Blakespear",31,8,0,1,40
1712168,1455815,2024-06-10,Assembly,"Do pass and be re-referred to the Committee on [Transportation]",10,0,0,1,11
1712168,1462305,2024-07-01,Assembly,"Do pass and be re-referred to the Committee on [Appropriations]",15,0,0,0,15
1712168,1463763,2024-08-07,Assembly,"Do pass",11,3,0,1,15
1712168,1465300,2024-08-19,Assembly,"SB 689 Blakespear Senate Third Reading By Alvarez",63,8,0,8,79
1712168,1465474,2024-08-22,Senate,"Unfinished Business SB689 Blakespear Concurrence",25,7,0,8,40
1712169,1310140,2023-04-25,Senate,"Do pass, but first be re-referred to the Committee on [Appropriations]",5,0,0,0,5
1712169,1320393,2023-05-08,Senate,"Placed on suspense file",7,0,0,0,7
1712169,1328014,2023-05-18,Senate,"Do pass",6,0,0,1,7
1712169,1332549,2023-05-24,Senate,"Senate 3rd Reading SB690 Rubio",39,0,0,1,40
1712169,1350247,2023-07-11,Assembly,"Do pass and be re-referred to the Committee on [Appropriations]",8,0,0,0,8
1712169,1464589,2024-08-15,Assembly,"Do pass as amended",14,0,0,1,15
1712169,1467150,2024-08-31,Senate,"Unfinished Business SB690 Rubio Concurrence",40,0,0,0,40
1712169,1467151,2024-08-31,Assembly,"SB 690 Rubio Senate Third Reading By Blanca Rubio",77,0,0,2,79
1712170,1288295,2023-03-29,Senate,"Do pass, but first be re-referred to the Committee on [Appropriations]",7,0,0,0,7
1712170,1296921,2023-04-10,Senate,"Placed on suspense file",7,0,0,0,7
1712170,1363948,2024-01-10,Senate,"Do pass, but first be re-referred to the Committee on [Appropriations]",5,2,0,0,7
1712170,1364809,2024-01-16,Senate,"Placed on suspense file",6,0,0,1,7
1712170,1366809,2024-01-18,Senate,"Do pass",4,2,0,1,7
1712170,1371109,2024-01-29,Senate,"Senate 3rd Reading SB691 Portantino",31,7,0,2,40
1712170,1460769,2024-06-26,Assembly,"Do pass as amended and be re-referred to the Committee on [Appropriations]",6,0,0,1,7
1712170,1463755,2024-08-07,Assembly,"Do pass as amended",10,2,0,3,15
1712170,1465261,2024-08-19,Assembly,"SB 691 Portantino Senate Third Reading By McCarty",58,5,0,16,79
1712170,1465563,2024-08-26,Senate,"That the Assembly amendments be concurred in",5,1,0,1,7
1712170,1465796,2024-08-27,Senate,"Unfinished Business SB691 Portantino Concurrence",31,9,0,0,40
1712171,1288342,2023-03-29,Senate,"Do pass",8,0,0,0,8
1712171,1323845,2023-05-11,Senate,"Special Consent SB692 Dahle",39,0,0,1,40
1712171,1348435,2023-06-28,Assembly,"Do pass",8,0,0,0,8
1712171,1353455,2023-09-07,Assembly,"SB 692 Dahle Senate Third Reading By Megan Dahle",79,0,0,1,80
1712173,1305263,2023-04-19,Senate,"Do pass, but first be re-referred to the Committee on [Appropriations] with the recommendation: To Consent Calendar",11,0,0,1,12
1712173,1315748,2023-05-01,Senate,"Placed on suspense file",6,0,0,1,7
1712173,1328887,2023-05-18,Senate,"Do pass",7,0,0,0,7
1712173,1333781,2023-05-25,Senate,"Special Consent SB694 Eggman",40,0,0,0,40
1712173,1345612,2023-06-20,Assembly,"Do pass and be re-referred to the Committee on [Appropriations] with recommendation: To Consent Calendar",14,0,0,1,15
1712173,1352493,2023-09-01,Assembly,"Do pass as amended",11,0,0,5,16
1712173,1353775,2023-09-12,Assembly,"SB 694 Eggman Senate Third Reading By Weber",78,0,0,2,80
1712173,1354442,2023-09-13,Senate,"Unfinished Business SB694 Eggman Concurrence",39,0,0,1,40
1712174,1288176,2023-03-28,Senate,"Do pass, but first be re-referred to the Committee on [Appropriations] with the recommendation: To Consent Calendar",14,0,0,2,16
1712174,1302609,2023-04-17,Senate,"Placed on suspense file",6,0,0,1,7
1712174,1328418,2023-05-18,Senate,"Do pass as amended",7,0,0,0,7
1712174,1335535,2023-05-30,Senate,"Special Consent SB695 Gonzalez et al",40,0,0,0,40
1712174,1349611,2023-07-05,Assembly,"Do pass and be re-referred to the Committee on [Appropriations] with recommendation: To Consent Calendar",15,0,0,0,15
1712174,1352556,2023-09-01,Assembly,"Do pass as amended",11,0,0,5,16
1712174,1354140,2023-09-13,Assembly,"SB 695 Gonzalez Senate Third Reading By Friedman",77,0,0,3,80
1712174,1354857,2023-09-14,Senate,"Unfinished Business SB695 Gonzalez et al. Concurrence",40,0,0,0,40
1712175,1311831,2023-04-25,Senate,"Do pass as amended, but first amend, and re-refer to the Committee on [Appropriations]",11,0,0,0,11
1712175,1324930,2023-05-15,Senate,"Placed on suspense file",7,0,0,0,7
1712175,1328518,2023-05-18,Senate,"Do pass",5,1,0,1,7
1712175,1335604,2023-05-30,Senate,"Senate 3rd Reading SB696 Portantino et al",34,0,0,6,40
1712175,1347862,2023-06-27,Assembly,"Do pass and be re-referred to the Committee on [Appropriations]",11,0,0,0,11
1712175,1352822,2023-09-01,Assembly,"Do pass as amended",11,0,0,5,16
1712175,1353488,2023-09-07,Assembly,"SB 696 Portantino Senate Third Reading By Low",78,0,0,2,80
1712175,1354702,2023-09-11,Senate,"Unfinished Business SB696 Portantino et al. Concurrence",39,0,0,1,40
1712176,1306726,2023-04-19,Senate,"Do pass, but first be re-referred to the Committee on [Appropriations]",4,0,0,1,5
1712176,1315698,2023-05-01,Senate,"Placed on suspense file",6,0,0,1,7
1712176,1328751,2023-05-18,Senate,"Do pass",6,1,0,0,7
1712176,1334463,2023-05-26,Senate,"Senate 3rd Reading SB697 Hurtado",32,2,0,6,40
1712176,1462326,2024-07-02,Assembly,"Do pass as amended and be re-referred to the Committee on [Appropriations]",8,2,0,2,12
1712177,1306768,2023-04-19,Senate,"Do pass as amended, and be ordered to the Consent Calendar",5,0,0,0,5
1712177,1315711,2023-05-01,Senate,"Consent Calendar SB698 Wilk et al",37,0,0,3,40
1712177,1344214,2023-06-14,Assembly,"Do pass. To Consent Calendar",7,0,0,0,7
1712177,1350629,2023-07-13,Assembly,"SB 698 Wilk Senate Third Reading By Luz Rivas",72,0,0,8,80
1712178,1305502,2023-04-18,Senate,"Do pass, but first be re-referred to the Committee on [Appropriations]",11,0,0,0,11
1712178,1315758,2023-05-01,Senate,"Placed on suspense file",6,0,0,1,7
1712178,1328346,2023-05-18,Senate,"Do pass as amended",7,0,0,0,7
1712178,1335507,2023-05-30,Senate,"Special Consent SB699 Caballero",40,0,0,0,40
1712178,1348406,2023-06-28,Assembly,"Do pass and be re-referred to the Committee on [Judiciary]",7,0,0,0,7
1712178,1349578,2023-07-05,Assembly,"Do pass. To Consent Calendar",10,0,0,1,11
1712178,1351269,2023-08-14,Assembly,"SB 699 Caballero Consent Calendar Second Day Regular Session",74,0,0,6,80
1712179,1299527,2023-04-11,Senate,"Do pass as amended, but first amend, and re-refer to the Committee on [Labor, Public Employment and Retirement ]",7,2,0,2,11
1712179,1311840,2023-04-26,Senate,"Do pass, but first be re-referred to the Committee on [Appropriations]",3,0,0,2,5
1712179,1320502,2023-05-08,Senate,"Placed on suspense file",7,0,0,0,7
1712179,1328361,2023-05-18,Senate,"Do pass",5,2,0,0,7
1712179,1335392,2023-05-30,Senate,"Senate 3rd Reading SB700 Bradford",29,9,0,2,40
1712179,1348284,2023-06-28,Assembly,"Do pass and be re-referred to the Committee on [Judiciary]",7,0,0,0,7
1712179,1349573,2023-07-05,Assembly,"Do pass and be re-referred to the Committee on [Appropriations]",8,2,0,1,11
1712179,1352490,2023-09-01,Assembly,"Do pass as amended",12,3,0,1,16
1712179,1354133,2023-09-13,Assembly,"SB 700 Bradford Senate Third Reading By Kalra",59,8,0,13,80
1712179,1354804,2023-09-14,Senate,"Unfinished Business SB700 Bradford Concurrence",30,8,0,2,40
1712180,1318049,2023-05-03,Senate,"Do pass",5,0,0,3,8
1712180,1330137,2023-05-22,Senate,"Senate 3rd Reading SB701 Hurtado",37,2,0,1,40
1712180,1346137,2023-06-21,Assembly,"Do pass",10,0,0,1,11
1712180,1352480,2023-08-31,Assembly,"SB 701 Hurtado Senate Third Reading By Irwin",73,0,0,7,80
1712181,1298279,2023-04-11,Senate,"Do pass, but first be re-referred to the Committee on [Judiciary]",15,0,0,0,15
1712181,1305334,2023-04-18,Senate,"Do pass, but first be re-referred to the Committee on [Appropriations]",11,0,0,0,11
1712181,1325021,2023-05-15,Senate,"Senate 3rd Reading SB702 Lim√≥n",38,0,0,2,40
1712181,1341038,2023-06-07,Assembly,"Do pass and be re-referred to the Committee on [Appropriations]",7,0,0,0,7
1712181,1352816,2023-09-01,Assembly,"Do pass",12,0,0,4,16
1712181,1353623,2023-09-11,Assembly,"SB 702 Lim√≥n Senate Third Reading By Wendy Carrillo",78,0,0,2,80
1712181,1354054,2023-09-12,Senate,"Unfinished Business SB702 Lim√≥n et al. Concurrence",39,0,0,1,40
1712182,1311935,2023-04-26,Senate,"Do pass, but first be re-referred to the Committee on [Appropriations]",1,4,0,0,5
1712183,1315146,2023-04-25,Senate,"Do pass, but first be re-referred to the Committee on [Appropriations]",7,2,0,2,11
1712183,1320479,2023-05-08,Senate,"Placed on suspense file",7,0,0,0,7
1712183,1328200,2023-05-18,Senate,"Do pass",5,2,0,0,7
1712183,1335557,2023-05-30,Senate,"Senate 3rd Reading SB704 Min",31,8,0,1,40
1712183,1350776,2023-07-10,Assembly,"Do pass and be re-referred to the Committee on [Appropriations]",9,0,0,2,11
1712183,1352120,2023-08-23,Assembly,"Do pass",13,2,0,1,16
1712183,1353635,2023-09-11,Assembly,"SB 704 Min Senate Third Reading By Pellerin",68,5,0,7,80
1712183,1353797,2023-09-12,Senate,"Unfinished Business SB704 Min Concurrence",32,6,0,2,40
1712183,1353798,2023-09-12,Senate,"Unfinished Business SB704 Min Concurrence Motion To Reconsider",39,0,0,1,40
1712183,1353799,2023-09-12,Senate,"Unfinished Business SB704 Min Concurrence",30,8,0,2,40
1712184,1296975,2023-04-10,Senate,"Do pass as amended, but first amend, and re-refer to the Committee on [Appropriations]",15,0,0,3,18
1712184,1315739,2023-05-01,Senate,"Placed on suspense file",6,0,0,1,7
1712185,1288351,2023-03-29,Senate,"Do pass as amended, but first amend, and re-refer to the Committee on [Appropriations]",8,0,0,0,8
1712185,1313370,2023-04-27,Senate,"Senate 3rd Reading SB706 Caballero et al",38,0,0,2,40
1712185,1346148,2023-06-21,Assembly,"Do pass as amended and be re-referred to the Committee on [Appropriations]",8,0,0,0,8
1712185,1351557,2023-08-16,Assembly,"Do pass. To Consent Calendar",15,0,0,1,16
1712185,1352224,2023-08-24,Assembly,"SB 706 Caballero Consent Calendar Second Day Regular Session",73,0,0,7,80
1712185,1352781,2023-09-01,Senate,"Special Consent SB706 Caballero et al",37,0,0,3,40
1712186,1288240,2023-03-29,Senate,"Do pass as amended, but first amend, and re-refer to the Committee on [Judiciary]",5,2,0,0,7
1712186,1311756,2023-04-25,Senate,"Do pass, but first be re-referred to the Committee on [Appropriations]",9,0,0,2,11
1712186,1320469,2023-05-08,Senate,"Placed on suspense file",7,0,0,0,7
1712186,1328853,2023-05-18,Senate,"Do pass as amended",5,2,0,0,7
1712186,1336361,2023-05-31,Senate,"Senate 3rd Reading SB707 Newman et al",32,8,0,0,40
1712186,1461949,2024-07-01,Assembly,"Do pass as amended and be re-referred to the Committee on [Appropriations]",9,3,0,0,12
1712186,1464172,2024-08-15,Assembly,"Do pass as amended",11,3,0,1,15
1712186,1466200,2024-08-29,Senate,"That the Assembly amendments be concurred in",4,2,0,1,7
1712186,1466396,2024-08-30,Senate,"Unfinished Business SB707 Newman et al. Concurrence",32,8,0,0,40
1712186,1467015,2024-08-28,Assembly,"SB 707 Newman Senate Third Reading By Bauer-Kahan",61,11,0,7,79
1712187,1286939,2023-03-28,Senate,"Do pass as amended, but first amend, and re-refer to the Committee on [Transportation]",10,0,0,1,11
1712187,1311772,2023-04-25,Senate,"Do pass, but first be re-referred to the Committee on [Appropriations] with the recommendation: To Consent Calendar",16,0,0,0,16
1712187,1323852,2023-05-11,Senate,"Consent Calendar SB708 Jones",39,0,0,1,40
1712187,1456351,2024-06-11,Assembly,"Do pass and be re-referred to the Committee on [Transportation]",12,0,0,3,15
1712187,1462307,2024-07-01,Assembly,"Do pass and be re-referred to the Committee on [Appropriations] with recommendation: To Consent Calendar",15,0,0,0,15
1712187,1463707,2024-08-07,Assembly,"Do pass",14,0,0,1,15
1712187,1465490,2024-08-22,Assembly,"SB 708 Jones Senate Third Reading By Garcia",59,0,0,20,79
1712187,1466932,2024-08-28,Senate,"Special Consent SB708 Jones",39,0,0,1,40
1712188,1305288,2023-04-19,Senate,"Do pass, but first be re-referred to the Committee on [Appropriations]",5,2,0,0,7
1712188,1315663,2023-05-01,Senate,"Placed on suspense file",6,0,0,1,7
1712189,1311923,2023-04-25,Senate,"Do pass, but first be re-referred to the Committee on [Appropriations]",12,1,0,3,16
1712189,1320536,2023-05-08,Senate,"Placed on suspense file",7,0,0,0,7
1712189,1328059,2023-05-18,Senate,"Do pass as amended",5,1,0,1,7
1712189,1336391,2023-05-31,Senate,"Senate 3rd Reading SB710 Durazo",32,3,0,5,40
1712189,1349638,2023-07-05,Assembly,"Do pass and be re-referred to the Committee on [Appropriations]",15,0,0,0,15
1712189,1352537,2023-09-01,Assembly,"Do pass",16,0,0,0,16
1712189,1353538,2023-09-07,Assembly,"SB 710 Durazo Senate Third Reading By Mike Fong",78,0,0,2,80
1712189,1354603,2023-09-11,Senate,"Unfinished Business SB710 Durazo Concurrence",30,2,0,8,40
1712190,1305348,2023-04-19,Senate,"Do pass as amended, but first amend, and re-refer to the Committee on [Appropriations]",6,0,0,1,7
1712190,1320522,2023-05-08,Senate,"Placed on suspense file",7,0,0,0,7
1712190,1328383,2023-05-18,Senate,"Do pass",7,0,0,0,7
1712190,1333582,2023-05-25,Senate,"Special Consent SB711 Caballero et al",40,0,0,0,40
1712190,1343763,2023-06-13,Assembly,"Do pass and be re-referred to the Committee on [Appropriations] with recommendation: To Consent Calendar",11,0,0,1,12
1712191,1288305,2023-03-28,Senate,"Do pass as amended",9,1,0,1,11
1712191,1334453,2023-05-26,Senate,"Senate 3rd Reading SB712 Portantino",29,3,0,8,40
1712191,1347793,2023-06-27,Assembly,"Do pass. To Consent Calendar",11,0,0,0,11
1712191,1353202,2023-09-06,Assembly,"SB 712 Portantino Senate Third Reading By Boerner",73,0,0,7,80
1712191,1353428,2023-09-07,Senate,"Unfinished Business SB712 Portantino Concurrence",33,3,0,4,40
1712192,1310401,2023-04-24,Senate,"Do pass, but first be re-referred to the Committee on [Governance and Finance]",9,0,0,2,11
1712192,1318064,2023-05-03,Senate,"Do pass",5,0,0,3,8
1712192,1330134,2023-05-22,Senate,"Senate 3rd Reading SB713 Padilla",33,0,0,7,40
1712192,1340971,2023-06-07,Assembly,"Do pass and be re-referred to the Committee on [Local Government]",7,0,0,1,8
1712192,1346188,2023-06-21,Assembly,"Do pass",6,0,0,2,8
1712192,1353861,2023-09-12,Assembly,"SB 713 Padilla Senate Third Reading By Alvarez",75,1,0,4,80
1712192,1354193,2023-09-13,Senate,"Unfinished Business SB713 Padilla et al. Concurrence",33,0,0,7,40
1712194,1299510,2023-04-12,Senate,"Do pass, but first be re-referred to the Committee on [Appropriations]",7,0,0,0,7
1712194,1308890,2023-04-24,Senate,"Placed on suspense file",7,0,0,0,7
1712195,1301079,2023-04-12,Senate,"Do pass, but first be re-referred to the Committee on [Judiciary] with the recommendation: To Consent Calendar",5,0,0,0,5
1712195,1305429,2023-04-18,Senate,"Do pass, but first be re-referred to the Committee on [Appropriations] with the recommendation: To Consent Calendar",11,0,0,0,11
1712195,1315691,2023-05-01,Senate,"Placed on suspense file",6,0,0,1,7
1712195,1328760,2023-05-18,Senate,"Do pass",7,0,0,0,7
1712195,1333548,2023-05-25,Senate,"Special Consent SB716 Alvarado-Gil",40,0,0,0,40
1712195,1348465,2023-06-28,Assembly,"Do pass and be re-referred to the Committee on [Judiciary]",7,0,0,0,7
1712195,1349560,2023-07-05,Assembly,"Do pass and be re-referred to the Committee on [Appropriations]",10,0,0,1,11
1712195,1352623,2023-09-01,Assembly,"Do pass",16,0,0,0,16
1712195,1354350,2023-09-13,Assembly,"SB 716 Alvarado-Gil Senate Third Reading By Lackey",80,0,0,0,80
1712196,1305233,2023-04-19,Senate,"Do pass, but first be re-referred to the Committee on [Appropriations]",11,0,0,1,12
1712196,1315766,2023-05-01,Senate,"Placed on suspense file",6,0,0,1,7
1712196,1327948,2023-05-18,Senate,"Do pass",7,0,0,0,7
1712196,1333565,2023-05-25,Senate,"Senate 3rd Reading SB717 Stern",40,0,0,0,40
1712196,1350304,2023-07-11,Assembly,"Do pass and be re-referred to the Committee on [Appropriations]",15,0,0,0,15
1712196,1352875,2023-09-01,Assembly,"Do pass as amended",13,2,0,1,16
1712196,1354418,2023-09-13,Assembly,"SB 717 Stern Senate Third Reading By Luz Rivas",77,0,0,3,80
1712196,1354801,2023-09-14,Senate,"Unfinished Business SB717 Stern Concurrence",40,0,0,0,40
1712197,1280698,2023-03-21,Senate,"Do pass as amended, but first amend, and re-refer to the Committee on [Appropriations]",7,0,0,0,7
1712197,1296910,2023-04-10,Senate,"Placed on suspense file",7,0,0,0,7
1712197,1328131,2023-05-18,Senate,"Do pass",7,0,0,0,7
1712197,1333797,2023-05-25,Senate,"Special Consent SB718 Wilk",40,0,0,0,40
1712197,1346215,2023-06-21,Assembly,"Do pass and be re-referred to the Committee on [Appropriations]",2,0,0,6,8
1712197,1346216,2023-06-21,Assembly,Reconsideration,8,0,0,0,8
1712198,1298215,2023-04-11,Senate,"Do pass, but first be re-referred to the Committee on [Appropriations]",4,1,0,0,5
1712198,1308792,2023-04-24,Senate,"Placed on suspense file",7,0,0,0,7
1712198,1366757,2024-01-18,Senate,"Do pass as amended",4,2,0,1,7
1712198,1372106,2024-01-30,Senate,"Senate 3rd Reading SB719 Becker",17,12,0,11,40
1712199,1299383,2023-04-11,Senate,"Do pass, but first be re-referred to the Committee on [Rules]",11,4,0,1,16
1712199,1311883,2023-04-26,Senate,"Do pass as amended, but first amend, and re-refer to the Committee on [Appropriations]",5,2,0,0,7
1712199,1324991,2023-05-15,Senate,"Placed on suspense file",7,0,0,0,7
1712199,1328840,2023-05-18,Senate,"Do pass",4,2,0,1,7
1712199,1335513,2023-05-30,Senate,"Senate 3rd Reading SB720 Stern",30,8,0,2,40
1712199,1347919,2023-06-26,Assembly,"Do pass and be re-referred to the Committee on [Natural Resources]",7,4,0,4,15
1712199,1349625,2023-07-05,Assembly,Reconsideration,9,0,0,6,15
1712199,1349626,2023-07-05,Assembly,"Do pass as amended and be re-referred to the Committee on [Natural Resources]",10,4,0,1,15
1712199,1461960,2024-07-01,Assembly,"Do pass as amended, and be re-referred to the Committee on [Appropriations] with recommendation: To Consent Calendar",15,0,0,1,16
1712199,1464038,2024-08-15,Assembly,"Do pass as amended",11,0,0,4,15
1712200,1298209,2023-04-11,Senate,"Do pass, but first be re-referred to the Committee on [Judiciary]",14,1,0,0,15
1712200,1305339,2023-04-18,Senate,"Do pass, but first be re-referred to the Committee on [Appropriations]",11,0,0,0,11
1712200,1315700,2023-05-01,Senate,"Placed on suspense file",6,0,0,1,7
1712200,1328137,2023-05-18,Senate,"Do pass",6,1,0,0,7
1712200,1332637,2023-05-24,Senate,"Senate 3rd Reading SB721 Becker",38,0,0,2,40
1712200,1458543,2024-06-19,Assembly,"Do pass and be re-referred to the Committee on [Local Government]",8,0,0,1,9
1712200,1460459,2024-06-26,Assembly,"Do pass as amended and be re-referred to the Committee on [Appropriations]",6,0,0,3,9
1712201,1304244,2023-04-17,Senate,"Do pass, but first be re-referred to the Committee on [Judiciary] with the recommendation: To Consent Calendar",4,0,0,1,5
1712201,1311779,2023-04-25,Senate,"Do pass, but first be re-referred to the Committee on [Appropriations] with the recommendation: To Consent Calendar",11,0,0,0,11
1712201,1320418,2023-05-08,Senate,"Placed on suspense file",7,0,0,0,7
1712201,1328035,2023-05-18,Senate,"Do pass",7,0,0,0,7
1712201,1333676,2023-05-25,Senate,"Special Consent SB722 Ochoa Bogh",40,0,0,0,40
1712201,1345577,2023-06-20,Assembly,"Do pass as amended and be re-referred to the Committee on [Judiciary]",8,0,0,0,8
1712201,1353069,2023-09-01,Assembly,"Do pass as amended",11,0,0,5,16
1712201,1353366,2023-09-07,Assembly,"SB 722 Ochoa Bogh Senate Third Reading",77,0,0,3,80
1712201,1354837,2023-09-14,Senate,"Unfinished Business SB722 Ochoa Bogh Concurrence",38,0,0,2,40
1712202,1311914,2023-04-26,Senate,"Do pass, but first be re-referred to the Committee on [Appropriations]",4,1,0,0,5
1712202,1330141,2023-05-22,Senate,"Senate 3rd Reading SB723 Durazo",28,9,0,3,40
1712202,1344218,2023-06-14,Assembly,"Do pass and be re-referred to the Committee on [Appropriations]",5,2,0,0,7
1712202,1352743,2023-09-01,Assembly,"Do pass",11,4,0,1,16
1712202,1354149,2023-09-13,Assembly,"SB 723 Durazo Senate Third Reading By Kalra",58,18,0,4,80
1712202,1354749,2023-09-14,Senate,"Unfinished Business SB723 Durazo et al. Concurrence",31,9,0,0,40
1712203,1280665,2023-03-21,Senate,"Do pass, but first be re-referred to the Committee on [Appropriations]",6,0,0,1,7
1712203,1296980,2023-04-10,Senate,"Placed on suspense file",7,0,0,0,7
1712203,1328031,2023-05-18,Senate,"Do pass",5,1,0,1,7
1712203,1332572,2023-05-24,Senate,"Senate 3rd Reading SB724 Glazer et al",32,0,0,8,40
1712203,1349595,2023-07-05,Assembly,"Do pass and be re-referred to the Committee on [Appropriations]",6,0,0,2,8
1712204,1306785,2023-04-19,Senate,"Do pass",5,0,0,0,5
1712204,1336387,2023-05-31,Senate,"Senate 3rd Reading SB725 Smallwood-Cuevas",33,6,0,1,40
1712204,1350674,2023-07-12,Assembly,"Do pass",5,2,0,0,7
1712204,1354529,2023-09-14,Senate,"Unfinished Business SB725 Smallwood-Cuevas Concurrence",31,8,0,1,40
1712204,1354530,2023-09-14,Assembly,"SB 725 Smallwood-Cuevas Senate Third Reading By Holden",59,15,0,6,80
1712205,1299459,2023-04-12,Senate,"Do pass as amended, but first amend, and re-refer to the Committee on [Military and Veterans Affairs]",8,0,0,0,8
1712205,1308796,2023-04-24,Senate,"Do pass, but first be re-referred to the Committee on [Appropriations] with the recommendation: To Consent Calendar",4,0,0,1,5
1712205,1315654,2023-05-01,Senate,"Placed on suspense file",6,0,0,1,7
1712205,1328856,2023-05-18,Senate,"Do pass",7,0,0,0,7
1712205,1333667,2023-05-25,Senate,"Special Consent SB726 Archuleta et al",40,0,0,0,40
1712205,1346177,2023-06-20,Assembly,"Do pass and be re-referred to the Committee on [Revenue and Taxation] with recommendation: To Consent Calendar",9,0,0,2,11
1712206,1320455,2023-05-08,Senate,"Be adopted, but first be re-referred to the Committee on [Appropriations]",4,1,0,2,7
1712206,1352324,2023-08-28,Senate,"Placed on suspense file",7,0,0,0,7
1712206,1352577,2023-09-01,Senate,"Be adopted",5,2,0,0,7
1712207,1263009,2023-02-27,Senate,"Senate 3rd Reading SCR30 Smallwood-Cuevas et",36,0,0,4,40
1712207,1283144,2023-03-23,Assembly,"Be adopted. To Consent Calendar",13,0,0,0,13
1712207,1289773,2023-03-30,Assembly,"SCR 30 Smallwood-Cuevas Consent Calendar Second Day Regular Session",60,0,0,20,80
1714273,1311774,2023-04-26,Assembly,"Do pass as amended and be re-referred to the Committee on [Appropriations]",14,0,0,0,14
1714273,1322881,2023-05-10,Assembly,"Do pass. To Consent Calendar",14,0,0,2,16
1714273,1328258,2023-05-18,Assembly,"AB 1355 Valencia Consent Calendar Second Day Regular Session",74,0,0,6,80
1714273,1344226,2023-06-14,Senate,"Do pass, but first be re-referred to the Committee on [Appropriations] with the recommendation: To Consent Calendar",5,0,0,0,5
1714273,1353275,2023-09-06,Senate,"Assembly 3rd Reading AB1355 Valencia et al. By Umberg",40,0,0,0,40
1714273,1353276,2023-09-06,Senate,"Assembly 3rd Reading AB1355 Valencia et al. By Umberg Motion To Reconsider",40,0,0,0,40
1714273,1353960,2023-09-12,Assembly,"AB 1355 Valencia Concurrence in Senate Amendments",80,0,0,0,80
1714273,1354701,2023-09-11,Senate,"Assembly 3rd Reading AB1355 Valencia et al. By Umberg",39,0,0,1,40
1714274,1299436,2023-04-12,Assembly,"Do pass and be re-referred to the Committee on [Judiciary]",5,0,0,2,7
1714274,1310333,2023-04-25,Assembly,"Do pass as amended and be re-referred to the Committee on [Appropriations]",8,2,0,1,11
1714274,1328367,2023-05-18,Assembly,"Do pass",11,4,0,1,16
1714274,1338156,2023-05-31,Assembly,"AB 1356 Haney Assembly Third Reading",60,14,0,6,80
1714274,1346961,2023-06-22,Senate,"Do pass, but first be re-referred to the Committee on [Judiciary]",4,0,0,1,5
1714274,1350542,2023-07-11,Senate,"Do pass as amended, but first amend, and re-refer to the Committee on [Appropriations]",9,1,0,1,11
1714274,1351282,2023-08-14,Senate,"Placed on suspense file",7,0,0,0,7
1714274,1352746,2023-09-01,Senate,"Do pass as amended",5,2,0,0,7
1714274,1353912,2023-09-12,Assembly,"AB 1356 Haney Concurrence in Senate Amendments",62,15,0,3,80
1714274,1354512,2023-09-11,Senate,"Assembly 3rd Reading AB1356 Haney et al. By Smallwood-Cuevas",29,9,0,2,40
1714275,1289810,2023-03-29,Assembly,"Do pass and be re-referred to the Committee on [Appropriations] with recommendation: To Consent Calendar",6,0,0,1,7
1714276,1313515,2023-04-26,Assembly,"Do pass and be re-referred to the Committee on [Appropriations]",13,0,0,2,15
1714277,1311767,2023-04-26,Assembly,"Do pass and be re-referred to the Committee on [Appropriations]",5,1,0,1,7
1714277,1328574,2023-05-18,Assembly,"Do pass",11,4,0,1,16
1714277,1335405,2023-05-30,Assembly,"AB 1359 Schiavo Assembly Third Reading",60,16,0,4,80
1714277,1346945,2023-06-22,Senate,"Do pass as amended, but first amend, and re-refer to the Committee on [Judiciary]",4,0,0,1,5
1714277,1350460,2023-07-11,Senate,"Do pass, but first be re-referred to the Committee on [Appropriations]",9,1,0,1,11
1714277,1351276,2023-08-14,Senate,"Placed on suspense file",7,0,0,0,7
1714277,1352657,2023-09-01,Senate,"Do pass",5,2,0,0,7
1714277,1456328,2024-06-11,Senate,"Do pass, but first be re-referred to the Committee on [Environmental Quality]",11,0,0,0,11
1714277,1462695,2024-07-03,Senate,"Do pass, but first be re-referred to the Committee on [Appropriations]",7,0,0,0,7
1714277,1465864,2024-08-27,Senate,"Assembly 3rd Reading AB1359 Papan et al. By Padilla Urgency Clause",40,0,0,0,40
1714277,1466090,2024-08-29,Assembly,"With recommendation: That Senate amendments be concurred in",12,0,0,0,12
1714277,1466559,2024-08-30,Assembly,"AB 1359 Papan Concurrence - Urgency Added",77,0,0,2,79
1714278,1299429,2023-04-11,Assembly,"Do pass and be re-referred to the Committee on [Health]",7,0,0,1,8
1714278,1304321,2023-04-18,Assembly,"Do pass as amended and be re-referred to the Committee on [Appropriations]",15,0,0,0,15
1714278,1328519,2023-05-18,Assembly,"Do pass",15,0,0,1,16
1714278,1333662,2023-05-25,Assembly,"AB 1360 McCarty Assembly Third Reading",72,0,0,8,80
1714278,1345575,2023-06-20,Senate,"Do pass, but first be re-referred to the Committee on [Health]",5,0,0,0,5
1714278,1350644,2023-07-12,Senate,"Do pass, but first be re-referred to the Committee on [Appropriations]",11,0,0,1,12
1714278,1351808,2023-08-21,Senate,"Placed on suspense file",7,0,0,0,7
1714278,1352984,2023-09-01,Senate,"Do pass as amended",5,0,0,2,7
1714278,1353785,2023-09-12,Senate,"Assembly 3rd Reading AB1360 McCarty et al. By Dodd",35,0,0,5,40
1714278,1354287,2023-09-13,Assembly,"AB 1360 McCarty Concurrence in Senate Amendments",78,0,0,2,80
1714279,1304312,2023-04-17,Assembly,"Do pass and be re-referred to the Committee on [Appropriations]",11,0,0,0,11
1714279,1328083,2023-05-18,Assembly,"Do pass as amended",15,0,0,1,16
1714279,1338069,2023-05-31,Assembly,"AB 1361 Hoover Assembly Third Reading",80,0,0,0,80
1714279,1348350,2023-06-28,Senate,"Do pass, but first be re-referred to the Committee on [Military and Veterans Affairs] with the recommendation: To Consent Calendar",8,0,0,0,8
1714279,1350323,2023-07-10,Senate,"Do pass and be ordered to the Consent Calendar",5,0,0,0,5
1714279,1351322,2023-08-14,Senate,"Consent Calendar 2nd AB1361 Hoover",38,0,0,2,40
1714279,1351323,2023-08-14,Senate,"Consent Calendar 2nd AB1361 Hoover Motion To Reconsider",37,0,0,3,40
1714279,1353289,2023-09-06,Senate,"Assembly 3rd Reading AB1361 Hoover et al. By Seyarto",40,0,0,0,40
1714279,1353650,2023-09-11,Assembly,"AB 1361 Hoover Concurrence in Senate Amendments",80,0,0,0,80
1714284,1310176,2023-04-25,Assembly,"Do pass and be re-referred to the Committee on [Appropriations] with recommendation: To Consent Calendar",11,0,0,0,11
1714284,1322901,2023-05-10,Assembly,"Do pass. To Consent Calendar",14,0,0,2,16
1714284,1328729,2023-05-18,Assembly,"AB 1366 Maienschein Consent Calendar Second Day Regular Session",74,0,0,6,80
1714284,1348347,2023-06-27,Senate,"Do pass, but first be re-referred to the Committee on [Appropriations] with the recommendation: To Consent Calendar",11,0,0,0,11
1714284,1351500,2023-08-14,Senate,"Do pass",7,0,0,0,7
1714284,1353744,2023-09-12,Assembly,"AB 1366 Maienschein Concurrence in Senate Amendments",80,0,0,0,80
1714284,1354635,2023-09-11,Senate,"Assembly 3rd Reading AB1366 Maienschein By Padilla",39,0,0,1,40
1714286,1286983,2023-03-28,Assembly,"Do pass and be re-referred to the Committee on [Appropriations]",8,0,0,0,8
1714287,1298171,2023-04-11,Assembly,"Do pass and be re-referred to the Committee on [Appropriations]",18,0,0,0,18
1714287,1311731,2023-04-26,Assembly,"Do pass. To Consent Calendar",16,0,0,0,16
1714287,1318938,2023-05-04,Assembly,"AB 1369 Bauer-Kahan Consent Calendar Second Day Regular Session",75,0,0,5,80
1714287,1347549,2023-06-26,Senate,"Do pass, but first be re-referred to the Committee on [Appropriations]",10,1,0,2,13
1714287,1353329,2023-09-06,Senate,"Assembly 3rd Reading AB1369 Bauer-Kahan By Roth",36,0,0,4,40
1714287,1353349,2023-09-07,Assembly,"AB 1369 Bauer-Kahan Concurrence in Senate Amendments",75,0,0,5,80
1714288,1298176,2023-04-11,Assembly,"Do pass and be re-referred to the Committee on [Labor and Employment] with recommendation: To Consent Calendar",12,0,0,0,12
1714288,1311742,2023-04-26,Assembly,"Do pass and be re-referred to the Committee on [Appropriations] with recommendation: To Consent Calendar",7,0,0,0,7
1714288,1328881,2023-05-18,Assembly,"Do pass",15,0,0,1,16
1714288,1335543,2023-05-30,Assembly,"AB 1370 Ta Assembly Third Reading",80,0,0,0,80
1714288,1346287,2023-06-21,Senate,"Do pass, but first be re-referred to the Committee on [Appropriations] with the recommendation: To Consent Calendar",7,0,0,0,7
1714288,1349451,2023-07-03,Senate,"Placed on suspense file",7,0,0,0,7
1714289,1304313,2023-04-18,Assembly,"Do pass as amended. To Consent Calendar",8,0,0,0,8
1714289,1313342,2023-04-27,Assembly,"AB 1371 Low Consent Calendar Second Day Regular Session",79,0,0,1,80
1714289,1343766,2023-06-13,Senate,"Do pass, but first be re-referred to the Committee on [Appropriations] with the recommendation: To Consent Calendar",5,0,0,0,5
1714289,1353116,2023-09-05,Senate,"Assembly 3rd Reading AB1371 Low By Grove",39,0,0,1,40
1714291,1313501,2023-04-26,Assembly,"Do pass and be re-referred to the Committee on [Appropriations]",8,2,0,5,15
1714291,1328046,2023-05-18,Assembly,"Do pass as amended",11,4,0,1,16
1714291,1334471,2023-05-26,Assembly,"AB 1373 Garcia Third Reading Urgency",57,17,0,6,80
1714291,1353226,2023-09-06,Senate,"Do pass as amended, but first amend, and re-refer to the Committee on [Appropriations]",14,3,0,1,18
1714291,1353786,2023-09-12,Senate,"Do pass",5,2,0,0,7
1714291,1354644,2023-09-14,Senate,"Assembly 3rd Reading AB1373 Garcia et al. By Becker Urgency Clause",29,10,0,1,40
1714291,1354645,2023-09-14,Assembly,"AB 1373 Garcia Concurrence in Senate Amendments",62,16,0,2,80
1714294,1317027,2023-05-02,Assembly,"Do pass as amended. To Consent Calendar",11,0,0,0,11
1714294,1323842,2023-05-11,Assembly,"AB 1376 Juan Carrillo Consent Calendar Second Day",66,0,0,14,80
1714294,1346258,2023-06-21,Senate,"Do pass as amended, but first amend, and re-refer to the Committee on [Judiciary] with the recommendation: To Consent Calendar",12,0,0,0,12
1714294,1349732,2023-07-06,Senate,"Do pass, but first be re-referred to the Committee on [Appropriations] with the recommendation: To Consent Calendar",11,0,0,0,11
1714294,1351474,2023-08-14,Senate,"Placed on suspense file",7,0,0,0,7
1714294,1352717,2023-09-01,Senate,"Do pass",7,0,0,0,7
1714294,1354039,2023-09-12,Senate,"Special Consent AB1376 Juan Carrillo By Menjivar",39,0,0,1,40
1714294,1354174,2023-09-13,Assembly,"AB 1376 Juan Carrillo Concurrence in Senate Amendments",80,0,0,0,80
1714295,1299475,2023-04-12,Assembly,"Do pass as amended and be re-referred to the Committee on [Appropriations]",8,0,0,0,8
1714295,1322884,2023-05-10,Assembly,"Do pass. To Consent Calendar",14,0,0,2,16
1714295,1328396,2023-05-18,Assembly,"AB 1377 Friedman Consent Calendar Second Day Regular Session",74,0,0,6,80
1714295,1345643,2023-06-19,Senate,"Do pass, but first be re-referred to the Committee on [Housing]",5,0,0,0,5
1714295,1350207,2023-07-10,Senate,"Do pass, but first be re-referred to the Committee on [Appropriations]",11,0,0,0,11
1714295,1353794,2023-09-12,Assembly,"AB 1377 Friedman Concurrence in Senate Amendments",80,0,0,0,80
1714295,1354679,2023-09-11,Senate,"Assembly 3rd Reading AB1377 Friedman et al. By Smallwood-Cuevas",39,0,0,1,40
1714296,1299474,2023-04-11,Assembly,"Do pass and be re-referred to the Committee on [Appropriations]",2,0,0,6,8
1714298,1304377,2023-04-18,Assembly,"Do pass and be re-referred to the Committee on [Appropriations]",7,0,0,1,8
1714299,1281914,2023-03-22,Assembly,"Do pass and be re-referred to the Committee on [Appropriations]",5,0,0,2,7
1714299,1328575,2023-05-18,Assembly,"Do pass as amended",11,2,0,3,16
1714299,1338130,2023-05-31,Assembly,"AB 1381 Weber Assembly Third Reading",61,15,0,4,80
1714300,1298280,2023-04-11,Assembly,"Do pass and be re-referred to the Committee on [Appropriations]",7,0,0,0,7
1714300,1328285,2023-05-18,Assembly,"Do pass",15,0,0,1,16
1714300,1335412,2023-05-30,Assembly,"AB 1382 Quirk-Silva Assembly Third Reading",79,0,0,1,80
1714300,1350184,2023-07-11,Senate,"Do pass, but first be re-referred to the Committee on [Appropriations]",13,0,0,2,15
1714300,1351766,2023-08-21,Senate,"Placed on suspense file",7,0,0,0,7
1714303,1318005,2023-05-03,Assembly,"Do pass",5,2,0,1,8
1714303,1328077,2023-05-18,Assembly,"AB 1385 Garcia Assembly Third Reading",54,10,0,16,80
1714303,1348321,2023-06-27,Senate,"Do pass, but first be re-referred to the Committee on [Governance and Finance]",14,1,0,1,16
1714303,1349746,2023-07-05,Senate,"Do pass",6,2,0,0,8
1714303,1353307,2023-09-06,Senate,"Assembly 3rd Reading AB1385 Garcia By Padilla",32,6,0,2,40
1714304,1288348,2023-03-29,Assembly,"Do pass and be re-referred to the Committee on [Military and Veterans Affairs] with recommendation: To Consent Calendar",8,0,0,0,8
1714304,1305476,2023-04-18,Assembly,"Do pass and be re-referred to the Committee on [Appropriations]",11,0,0,0,11
1714304,1328081,2023-05-18,Assembly,"Do pass",15,0,0,1,16
1714304,1335413,2023-05-30,Assembly,"AB 1386 Gabriel Assembly Third Reading",80,0,0,0,80
1714304,1346299,2023-06-20,Senate,"Do pass, but first be re-referred to the Committee on [Military and Veterans Affairs] with the recommendation: To Consent Calendar",11,0,0,0,11
1714304,1350268,2023-07-10,Senate,"Do pass, but first be re-referred to the Committee on [Appropriations] with the recommendation: To Consent Calendar",5,0,0,0,5
1714304,1351334,2023-08-14,Senate,"Placed on suspense file",7,0,0,0,7
1714304,1352595,2023-09-01,Senate,"Do pass as amended",5,0,0,2,7
1714304,1353901,2023-09-12,Senate,"Assembly 3rd Reading AB1386 Gabriel et al. By Roth",34,0,0,6,40
1714304,1354375,2023-09-13,Assembly,"AB 1386 Gabriel Concurrence in Senate Amendments",80,0,0,0,80
1714305,1304365,2023-04-18,Assembly,"Do pass and be re-referred to the Committee on [Appropriations]",6,1,0,1,8
1714307,1281843,2023-03-22,Assembly,"Do pass and be re-referred to the Committee on [Appropriations] with recommendation: To Consent Calendar",12,0,0,2,14
1714307,1305404,2023-04-19,Assembly,"Do pass. To Consent Calendar",14,0,0,2,16
1714307,1313489,2023-04-27,Assembly,"AB 1389 Wendy Carrillo Consent Calendar Second Day Regular Session",79,0,0,1,80
1714307,1344217,2023-06-14,Senate,"Do pass, but first be re-referred to the Committee on [Appropriations] with the recommendation: To Consent Calendar",5,0,0,0,5
1714307,1348814,2023-06-29,Senate,"Consent Calendar AB1389 Wendy Carrillo",39,0,0,1,40
1714307,1353464,2023-09-07,Assembly,"AB 1389 Wendy Carrillo Concurrence in Senate Amendments",79,0,0,1,80
1714308,1311673,2023-04-25,Assembly,"Do pass as amended and be re-referred to the Committee on [Appropriations]",9,2,0,1,12
1714310,1298266,2023-04-11,Assembly,"Do pass and be re-referred to the Committee on [Appropriations]",10,1,0,4,15
1714310,1328199,2023-05-18,Assembly,"Do pass",12,3,0,1,16
1714310,1333610,2023-05-25,Assembly,"AB 1392 Rodriguez Assembly Third Reading",60,10,0,10,80
1714310,1349816,2023-07-05,Senate,"Do pass, but first be re-referred to the Committee on [Appropriations]",10,2,0,0,12
1714310,1351335,2023-08-14,Senate,"Placed on suspense file",7,0,0,0,7
1714310,1352594,2023-09-01,Senate,"Do pass as amended",5,2,0,0,7
1714310,1353913,2023-09-12,Senate,"Assembly 3rd Reading AB1392 Rodriguez By Hurtado",29,7,0,4,40
1714310,1354333,2023-09-13,Assembly,"AB 1392 Rodriguez Concurrence in Senate Amendments",64,11,0,5,80
1714311,1311681,2023-04-25,Assembly,"Do pass and be re-referred to the Committee on [Appropriations]",9,1,0,2,12
1714311,1328249,2023-05-18,Assembly,"Do pass as amended",11,2,0,3,16
1714311,1338082,2023-05-31,Assembly,"AB 1393 Calderon Assembly Third Reading",62,1,0,17,80
1714311,1350485,2023-07-12,Senate,"Do pass, but first be re-referred to the Committee on [Appropriations]",6,0,0,1,7
1714311,1351319,2023-08-14,Senate,"Placed on suspense file",7,0,0,0,7
1714312,1298320,2023-04-11,Assembly,"Do pass and be re-referred to the Committee on [Judiciary]",8,0,0,3,11
1714312,1317068,2023-05-02,Assembly,"Do pass",10,0,0,1,11
1714312,1338155,2023-05-31,Assembly,"AB 1394 Wicks Assembly Third Reading",77,0,0,3,80
1714312,1350383,2023-07-11,Senate,"Do pass as amended, but first amend, and re-refer to the Committee on [Appropriations]",11,0,0,0,11
1714312,1351498,2023-08-14,Senate,"Placed on suspense file",7,0,0,0,7
1714312,1352777,2023-09-01,Senate,"Do pass",7,0,0,0,7
1714312,1353888,2023-09-12,Senate,"Assembly 3rd Reading AB1394 Wicks et al. By Ashby",38,0,0,2,40
1714312,1354233,2023-09-13,Assembly,"AB 1394 Wicks Concurrence in Senate Amendments",77,0,0,3,80
1714313,1286914,2023-03-28,Assembly,"Do pass and be re-referred to the Committee on [Appropriations]",17,0,0,2,19
1714313,1305300,2023-04-19,Assembly,"Do pass",15,0,0,1,16
1714313,1313393,2023-04-27,Assembly,"AB 1395 Garcia Third Reading Urgency",80,0,0,0,80
1714313,1338778,2023-06-05,Senate,"Do pass, but first be re-referred to the Committee on [Appropriations]",13,0,0,0,13
1714313,1353326,2023-09-06,Senate,"Assembly 3rd Reading AB1395 Garcia et al. By Archuleta Urgency Clause",40,0,0,0,40
1714314,1310181,2023-04-25,Assembly,"Do pass and be re-referred to the Committee on [Appropriations]",16,0,0,2,18
1714317,1304300,2023-04-18,Assembly,"Do pass as amended and be re-referred to the Committee on [Appropriations]",16,0,0,2,18
1714317,1322898,2023-05-10,Assembly,"Do pass",15,0,0,1,16
1714317,1338088,2023-05-31,Assembly,"AB 1399 Friedman Assembly Third Reading",76,0,0,4,80
1714317,1349908,2023-07-10,Senate,"Do pass as amended, but first amend, and re-refer to the Committee on [Appropriations]",11,0,0,2,13
1714317,1351823,2023-08-21,Senate,"Placed on suspense file",7,0,0,0,7
1714317,1352955,2023-09-01,Senate,"Do pass as amended",7,0,0,0,7
1714317,1353864,2023-09-12,Assembly,"AB 1399 Friedman Concurrence in Senate Amendments",79,0,0,1,80
1714317,1354521,2023-09-11,Senate,"Assembly 3rd Reading AB1399 Friedman et al. By Archuleta",36,3,0,1,40
1714318,1305317,2023-04-18,Assembly,"Do pass and be re-referred to the Committee on [Revenue and Taxation]",11,0,0,1,12
1714318,1310361,2023-04-24,Assembly,"Do pass and be re-referred to the Committee on [Appropriations]",11,0,0,0,11
1714318,1328617,2023-05-18,Assembly,"Do pass",14,0,0,2,16
1714318,1333584,2023-05-25,Assembly,"AB 1400 Bryan Assembly Third Reading",76,0,0,4,80
1714318,1348460,2023-06-28,Senate,"Do pass as amended, but first amend, and re-refer to the Committee on [Governance and Finance]",7,0,0,0,7
1714318,1350655,2023-07-12,Senate,"Do pass, but first be re-referred to the Committee on [Appropriations] with the recommendation: To Consent Calendar",8,0,0,0,8
1714318,1351421,2023-08-14,Senate,"Placed on suspense file",7,0,0,0,7
1714318,1352626,2023-09-01,Senate,"Do pass",6,0,0,1,7
1714318,1353932,2023-09-12,Assembly,"AB 1400 Bryan Concurrence in Senate Amendments",79,0,0,1,80
1714318,1354654,2023-09-11,Senate,"Assembly 3rd Reading AB1400 Bryan By Smallwood-Cuevas",37,0,0,3,40
1714320,1310163,2023-04-25,Assembly,"Do pass and be re-referred to the Committee on [Appropriations] with recommendation: To Consent Calendar",8,0,0,0,8
1714320,1328183,2023-05-18,Assembly,"Do pass",15,0,0,1,16
1714320,1333640,2023-05-25,Assembly,"AB 1402 Megan Dahle Assembly Third Reading",77,0,0,3,80
1714320,1347835,2023-06-27,Senate,"Do pass, but first be re-referred to the Committee on [Appropriations] with the recommendation: To Consent Calendar",5,0,0,0,5
1714320,1351759,2023-08-21,Senate,"Placed on suspense file",7,0,0,0,7
1714320,1352917,2023-09-01,Senate,"Do pass",7,0,0,0,7
1714320,1353947,2023-09-12,Senate,"Special Consent AB1402 Megan Dahle By Dahle",39,0,0,1,40
1714321,1299377,2023-04-12,Assembly,"Do pass and be re-referred to the Committee on [Environmental Safety and Toxic Materials]",16,0,0,6,22
1714321,1305241,2023-04-18,Assembly,"Do pass and be re-referred to the Committee on [Appropriations]",8,0,0,1,9
1714321,1328627,2023-05-18,Assembly,"Do pass",15,0,0,1,16
1714321,1333745,2023-05-25,Assembly,"AB 1403 Garcia Assembly Third Reading",73,0,0,7,80
1714321,1347906,2023-06-27,Senate,"Do pass, but first be re-referred to the Committee on [Environmental Quality]",14,0,0,1,15
1714321,1350569,2023-07-12,Senate,"Do pass, but first be re-referred to the Committee on [Appropriations]",7,0,0,0,7
1714321,1351818,2023-08-21,Senate,"Placed on suspense file",7,0,0,0,7
1714321,1352568,2023-09-01,Senate,"Do pass as amended",7,0,0,0,7
1714321,1354089,2023-09-13,Senate,"Special Consent AB1403 Garcia By Archuleta",39,0,0,1,40
1714321,1354577,2023-09-14,Assembly,"AB 1403 Garcia Concurrence in Senate Amendments",78,0,0,2,80
1714322,1310204,2023-04-25,Assembly,"Do pass as amended, and be re-referred to the Committee on [Appropriations] with recommendation: To Consent Calendar",11,0,0,0,11
1714322,1322870,2023-05-10,Assembly,"Do pass. To Consent Calendar",14,0,0,2,16
1714322,1327946,2023-05-18,Assembly,"AB 1404 Wendy Carrillo Consent Calendar Second Day Regular Session",74,0,0,6,80
1714322,1350459,2023-07-11,Senate,"Do pass as amended, but first amend, and re-refer to the Committee on [Appropriations] with the recommendation: To Consent Calendar",11,0,0,0,11
1714322,1354300,2023-09-13,Senate,"Assembly 3rd Reading AB1404 Wendy Carrillo By Laird",39,0,0,1,40
1714322,1354666,2023-09-14,Assembly,"AB 1404 Wendy Carrillo Concurrence in Senate Amendments",80,0,0,0,80
1714324,1304366,2023-04-18,Assembly,"Do pass as amended and be re-referred to the Committee on [Appropriations]",7,0,0,1,8
1714324,1328194,2023-05-18,Assembly,"Do pass",12,1,0,3,16
1714324,1333771,2023-05-25,Assembly,"AB 1406 McCarty Assembly Third Reading",65,2,0,13,80
1714324,1345665,2023-06-20,Senate,"Do pass as amended, but first amend, and re-refer to the Committee on [Appropriations]",4,0,0,1,5
1714324,1351805,2023-08-21,Senate,"Placed on suspense file",7,0,0,0,7
1714324,1352489,2023-09-01,Senate,"Do pass",5,2,0,0,7
1714324,1353413,2023-09-07,Senate,"Assembly 3rd Reading AB1406 McCarty et al. By Portantino",29,8,0,3,40
1714324,1353690,2023-09-11,Assembly,"AB 1406 McCarty Concurrence in Senate Amendments",67,9,0,4,80
1714325,1305376,2023-04-18,Assembly,"Do pass and be re-referred to the Committee on [Appropriations]",14,0,0,1,15
1714325,1327988,2023-05-18,Assembly,"Do pass",15,0,0,1,16
1714325,1333791,2023-05-25,Assembly,"AB 1407 Addis Assembly Third Reading",77,0,0,3,80
1714325,1349910,2023-07-10,Senate,"Do pass as amended, but first amend, and re-refer to the Committee on [Appropriations]",10,0,0,1,11
1714325,1351514,2023-08-14,Senate,"Placed on suspense file",7,0,0,0,7
1714325,1353057,2023-09-01,Senate,"Do pass",7,0,0,0,7
1714326,1363943,2024-01-10,Assembly,"Do pass as amended and be re-referred to the Committee on [Appropriations]",5,0,0,2,7
1714330,1299433,2023-04-11,Assembly,"Do pass and be re-referred to the Committee on [Appropriations]",6,0,0,2,8
1714330,1326936,2023-05-17,Assembly,"Do pass",13,0,0,3,16
1714330,1330135,2023-05-22,Assembly,"AB 1412 Hart Assembly Third Reading",66,4,0,10,80
1714330,1343746,2023-06-13,Senate,"Do pass, but first be re-referred to the Committee on [Appropriations]",4,1,0,0,5
1714330,1353900,2023-09-12,Assembly,"AB 1412 Hart Concurrence in Senate Amendments",66,3,0,11,80
1714330,1354698,2023-09-11,Senate,"Assembly 3rd Reading AB1412 Hart et al. By Wahab",30,9,0,1,40
1714331,1311788,2023-04-26,Assembly,"Do pass and be re-referred to the Committee on [Appropriations]",8,0,0,0,8
1714331,1328721,2023-05-18,Assembly,"Do pass",15,0,0,1,16
1714331,1335461,2023-05-30,Assembly,"AB 1413 Ting Assembly Third Reading",80,0,0,0,80
1714331,1345574,2023-06-19,Senate,"Do pass, but first be re-referred to the Committee on [Housing]",5,0,0,0,5
1714331,1350276,2023-07-10,Senate,"Do pass, but first be re-referred to the Committee on [Appropriations]",11,0,0,0,11
1714331,1460044,2024-06-24,Senate,"Do pass, but first be re-referred to the Committee on [Local Government] with the recommendation: To Consent Calendar",10,0,0,0,10
1714331,1462495,2024-07-03,Senate,"Do pass as amended, but first amend, and re-refer to the Committee on [Appropriations] with the recommendation: To Consent Calendar",7,0,0,0,7
1714331,1465869,2024-08-27,Senate,"Assembly 3rd Reading AB1413 Ting By Durazo",40,0,0,0,40
1714331,1466429,2024-08-30,Assembly,"With recommendation: That Senate amendments be concurred in",9,0,0,0,9
1714331,1466430,2024-08-30,Assembly,"AB 1413 Ting Concurrence in Senate Amendments",74,0,0,5,79
1714332,1298159,2023-04-11,Assembly,"Do pass as amended and be re-referred to the Committee on [Banking and Finance]",8,3,0,0,11
1714332,1310382,2023-04-24,Assembly,"Do pass as amended",9,1,0,2,12
1714332,1338151,2023-05-31,Assembly,"AB 1414 Kalra Assembly Third Reading",53,18,0,9,80
1714332,1349826,2023-07-06,Senate,"Do pass as amended",9,2,0,0,11
1714332,1353909,2023-09-12,Senate,"Assembly 3rd Reading AB1414 Kalra By Umberg",30,7,0,3,40
1714332,1354219,2023-09-13,Assembly,"AB 1414 Kalra Concurrence in Senate Amendments",56,18,0,6,80
1714333,1311717,2023-04-26,Assembly,"Do pass and be re-referred to the Committee on [Appropriations]",22,0,0,0,22
1714333,1328792,2023-05-18,Assembly,"Do pass",15,0,0,1,16
1714333,1337952,2023-05-31,Assembly,"AB 1415 Santiago Assembly Third Reading",78,0,0,2,80
1714333,1350536,2023-07-11,Senate,"Do pass as amended, but first amend, and re-refer to the Committee on [Appropriations]",15,0,0,1,16
1714333,1351382,2023-08-14,Senate,"Placed on suspense file",7,0,0,0,7
1714333,1352794,2023-09-01,Senate,"Do pass",7,0,0,0,7
1714333,1353845,2023-09-12,Senate,"Assembly 3rd Reading AB1415 Santiago By Allen",38,0,0,2,40
1714333,1354127,2023-09-13,Assembly,"AB 1415 Santiago Concurrence in Senate Amendments",79,0,0,1,80
1714335,1311878,2023-04-25,Assembly,"Do pass and be re-referred to the Committee on [Appropriations]",7,0,0,1,8
1714335,1326970,2023-05-17,Assembly,"Do pass. To Consent Calendar",15,0,0,1,16
1714335,1333642,2023-05-25,Assembly,"AB 1417 Wood Consent Calendar Second Day Regular Session",76,0,0,4,80
1714335,1345646,2023-06-20,Senate,"Do pass, but first be re-referred to the Committee on [Human Services] with the recommendation: To Consent Calendar",5,0,0,0,5
1714335,1349662,2023-07-03,Senate,"Do pass, but first be re-referred to the Committee on [Appropriations] with the recommendation: To Consent Calendar",5,0,0,0,5
1714335,1351814,2023-08-21,Senate,"Placed on suspense file",7,0,0,0,7
1714335,1352920,2023-09-01,Senate,"Do pass as amended",7,0,0,0,7
1714335,1354126,2023-09-13,Senate,"Special Consent AB1417 Wood",39,0,0,1,40
1714335,1354743,2023-09-14,Assembly,"AB 1417 Wood Concurrence in Senate Amendments",79,0,0,1,80
1714336,1298186,2023-04-11,Assembly,"Do pass as amended and be re-referred to the Committee on [Appropriations]",10,0,0,1,11
1714336,1328860,2023-05-18,Assembly,"Do pass",14,0,0,2,16
1714336,1333624,2023-05-25,Assembly,"AB 1418 McKinnor Assembly Third Reading",72,0,0,8,80
1714336,1349811,2023-07-06,Senate,"Do pass, but first be re-referred to the Committee on [Appropriations]",10,0,0,1,11
1714336,1352329,2023-08-28,Senate,"Placed on suspense file",7,0,0,0,7
1714336,1352712,2023-09-01,Senate,"Do pass as amended",7,0,0,0,7
1714336,1354114,2023-09-13,Senate,"Assembly 3rd Reading AB1418 McKinnor et al. By Laird",39,0,0,1,40
1714336,1354115,2023-09-13,Assembly,"AB 1418 McKinnor Concurrence in Senate Amendments",75,0,0,5,80
1714338,1310173,2023-04-25,Assembly,"Do pass as amended and be re-referred to the Committee on [Appropriations]",8,0,0,0,8
1714338,1328010,2023-05-18,Assembly,"Do pass",15,0,0,1,16
1714338,1333721,2023-05-25,Assembly,"AB 1420 Berman Assembly Third Reading",75,0,0,5,80
1714338,1347840,2023-06-27,Senate,"Do pass, but first be re-referred to the Committee on [Appropriations]",5,0,0,0,5
1714338,1351769,2023-08-21,Senate,"Placed on suspense file",7,0,0,0,7
1714338,1352674,2023-09-01,Senate,"Do pass",5,2,0,0,7
1714338,1354764,2023-09-14,Senate,"Assembly 3rd Reading AB1420 Berman By Blakespear",33,5,0,2,40
1714338,1354765,2023-09-14,Assembly,"AB 1420 Berman Concurrence in Senate Amendments",75,0,0,5,80
1714339,1298188,2023-04-11,Assembly,"Do pass and be re-referred to the Committee on [Appropriations]",7,0,0,0,7
1714341,1305365,2023-04-18,Assembly,"Do pass and be re-referred to the Committee on [Appropriations]",7,2,0,0,9
1714341,1328114,2023-05-18,Assembly,"Do pass",11,4,0,1,16
1714341,1333630,2023-05-25,Assembly,"AB 1423 Schiavo Assembly Third Reading",64,9,0,7,80
1714341,1348432,2023-06-28,Senate,"Do pass as amended, but first amend, and re-refer to the Committee on [Governance and Finance]",6,0,0,1,7
1714341,1350657,2023-07-12,Senate,"Do pass, but first be re-referred to the Committee on [Appropriations]",7,0,0,1,8
1714341,1351762,2023-08-21,Senate,"Placed on suspense file",7,0,0,0,7
1714341,1352815,2023-09-01,Senate,"Do pass as amended",5,1,0,1,7
1714341,1353876,2023-09-12,Assembly,"AB 1423 Schiavo Concurrence in Senate Amendments",64,9,0,7,80
1714341,1354784,2023-09-11,Senate,"Assembly 3rd Reading AB1423 Schiavo By Allen",35,2,0,3,40
1714350,1304329,2023-04-18,Assembly,"Do pass and be re-referred to the Committee on [Appropriations]",11,4,0,0,15
1714350,1322850,2023-05-10,Assembly,"Do pass",12,3,0,1,16
1714350,1328294,2023-05-18,Assembly,"AB 1432 Wendy Carrillo Assembly Third Reading",61,13,0,6,80
1714350,1346140,2023-06-21,Senate,"Do pass, but first be re-referred to the Committee on [Appropriations]",10,2,0,0,12
1714350,1353266,2023-09-06,Senate,"Assembly 3rd Reading AB1432 Wendy Carrillo By Menjivar",32,8,0,0,40
1714350,1353531,2023-09-07,Assembly,"AB 1432 Wendy Carrillo Concurrence in Senate Amendments",64,15,0,1,80
1714351,1301014,2023-04-12,Assembly,"Do pass as amended, and be re-referred to the Committee on [Appropriations] with recommendation: To Consent Calendar",7,0,0,0,7
1714351,1318014,2023-05-03,Assembly,"Do pass. To Consent Calendar",16,0,0,0,16
1714351,1323796,2023-05-11,Assembly,"AB 1433 Mike Fong Consent Calendar Second Day Regular Session",66,0,0,14,80
1714351,1350384,2023-07-12,Senate,"Do pass, but first be re-referred to the Committee on [Appropriations]",7,0,0,0,7
1714351,1351478,2023-08-14,Senate,"Placed on suspense file",7,0,0,0,7
1714351,1352868,2023-09-01,Senate,"Do pass as amended",7,0,0,0,7
1714351,1354204,2023-09-13,Senate,"Special Consent AB1433 Rendon et al. By Gonzalez",39,0,0,1,40
1714351,1354490,2023-09-14,Assembly,"With recommendation: That Senate amendments be concurred in",6,0,0,1,7
1714351,1354582,2023-09-14,Assembly,"AB 1433 Rendon Concurrence in Senate Amendments",80,0,0,0,80
1714352,1299485,2023-04-12,Assembly,"Do pass and be re-referred to the Committee on [Appropriations] with recommendation: To Consent Calendar",15,0,0,0,15
1714353,1304330,2023-04-17,Assembly,"Do pass and be re-referred to the Committee on [Appropriations] with recommendation: To Consent Calendar",15,0,0,0,15
1714353,1328319,2023-05-18,Assembly,"Do pass",15,0,0,1,16
1714353,1337991,2023-05-31,Assembly,"AB 1435 Lackey Assembly Third Reading",77,0,0,3,80
1714353,1350218,2023-07-11,Senate,"Do pass, but first be re-referred to the Committee on [Appropriations] with the recommendation: To Consent Calendar",4,0,0,1,5
1714353,1351804,2023-08-21,Senate,"Placed on suspense file",7,0,0,0,7
1714353,1352552,2023-09-01,Senate,"Do pass",7,0,0,0,7
1714353,1353765,2023-09-12,Senate,"Special Consent AB1435 Lackey",39,0,0,1,40
1714353,1354195,2023-09-13,Assembly,"AB 1435 Lackey Concurrence in Senate Amendments",78,0,0,2,80
1714355,1298201,2023-04-11,Assembly,"Do pass as amended and be re-referred to the Committee on [Appropriations]",15,0,0,0,15
1714355,1328585,2023-05-18,Assembly,"Do pass",15,0,0,1,16
1714355,1333730,2023-05-25,Assembly,"AB 1437 Irwin Assembly Third Reading",75,0,0,5,80
1714355,1346241,2023-06-21,Senate,"Do pass, but first be re-referred to the Committee on [Appropriations] with the recommendation: To Consent Calendar",12,0,0,0,12
1714355,1349459,2023-07-03,Senate,"Placed on suspense file",7,0,0,0,7
1714355,1352749,2023-09-01,Senate,"Do pass",7,0,0,0,7
1714355,1353934,2023-09-12,Senate,"Special Consent AB1437 Irwin et al. By Eggman",39,0,0,1,40
1714357,1298299,2023-04-10,Assembly,"Do pass and be re-referred to the Committee on [Housing and Community Development]",9,0,0,2,11
1714357,1311848,2023-04-26,Assembly,"Do pass as amended and be re-referred to the Committee on [Appropriations]",6,0,0,2,8
1714357,1328492,2023-05-18,Assembly,"Do pass",12,0,0,4,16
1714357,1333607,2023-05-25,Assembly,"AB 1439 Garcia Assembly Third Reading",65,1,0,14,80
1714357,1346179,2023-06-20,Senate,"Do pass, but first be re-referred to the Committee on [Appropriations]",10,0,0,1,11
1714357,1349520,2023-07-03,Senate,"Placed on suspense file",7,0,0,0,7
1714357,1352906,2023-09-01,Senate,"Do pass as amended",7,0,0,0,7
1714357,1353980,2023-09-12,Assembly,"AB 1439 Garcia Concurrence in Senate Amendments",70,0,0,10,80
1714357,1354659,2023-09-11,Senate,"Assembly 3rd Reading AB1439 Garcia et al. By Dodd",35,0,0,5,40
1714363,1313308,2023-04-26,Assembly,"Do pass as amended and be re-referred to the Committee on [Appropriations]",7,0,0,0,7
1714363,1330123,2023-05-22,Assembly,"AB 1445 Arambula Assembly Third Reading",77,0,0,3,80
1714363,1344167,2023-06-14,Senate,"Do pass as amended",7,0,0,0,7
1714363,1352495,2023-09-01,Senate,"Assembly 3rd Reading AB1445 Arambula By Newman",37,0,0,3,40
1714363,1353169,2023-09-05,Assembly,"AB 1445 Arambula Concurrence in Senate Amendments",77,0,0,3,80
1714365,1310332,2023-04-24,Assembly,"Do pass and be re-referred to the Committee on [Appropriations]",15,0,0,0,15
1714365,1326944,2023-05-17,Assembly,"Do pass. To Consent Calendar",15,0,0,1,16
1714365,1333605,2023-05-25,Assembly,"AB 1447 Flora Consent Calendar Second Day Regular Session",76,0,0,4,80
1714365,1350441,2023-07-11,Senate,"Do pass, but first be re-referred to the Committee on [Appropriations]",14,0,0,2,16
1714366,1298205,2023-04-11,Assembly,"Do pass as amended and be re-referred to the Committee on [Judiciary]",18,0,0,0,18
1714366,1317034,2023-05-02,Assembly,"Do pass as amended",11,0,0,0,11
1714366,1328873,2023-05-18,Assembly,"Do pass",15,0,0,1,16
1714366,1337249,2023-06-01,Assembly,"AB 1448 Wallis Assembly Third Reading",78,0,0,2,80
1714366,1349962,2023-07-10,Senate,"Do pass, but first be re-referred to the Committee on [Judiciary]",13,0,0,0,13
1714366,1350396,2023-07-11,Senate,"Do pass, but first be re-referred to the Committee on [Appropriations]",11,0,0,0,11
1714366,1351847,2023-08-21,Senate,"Placed on suspense file",7,0,0,0,7
1714366,1353044,2023-09-01,Senate,"Do pass",7,0,0,0,7
1714366,1353787,2023-09-12,Senate,"Special Consent AB1448 Wallis By Alvarado-Gil",39,0,0,1,40
1714366,1354443,2023-09-13,Assembly,"AB 1448 Wallis Concurrence in Senate Amendments",80,0,0,0,80
1714367,1302655,2023-04-17,Assembly,"Do pass as amended and be re-referred to the Committee on [Housing and Community Development]",8,1,0,2,11
1714367,1311924,2023-04-26,Assembly,"Do pass as amended and be re-referred to the Committee on [Appropriations]",7,1,0,0,8
1714367,1322940,2023-05-10,Assembly,"Do pass",12,3,0,1,16
1714367,1328845,2023-05-18,Assembly,"AB 1449 Alvarez Assembly Third Reading",54,13,0,13,80
1714367,1346138,2023-06-21,Senate,"Do pass, but first be re-referred to the Committee on [Housing]",6,0,0,1,7
1714367,1350129,2023-07-10,Senate,"Do pass, but first be re-referred to the Committee on [Appropriations]",9,0,0,2,11
1714367,1353429,2023-09-07,Senate,"Assembly 3rd Reading AB1449 Alvarez et al. By Wiener",32,2,0,6,40
1714369,1310296,2023-04-25,Assembly,"Do pass as amended and be re-referred to the Committee on [Appropriations]",12,0,0,3,15
1714369,1328750,2023-05-18,Assembly,"Do pass as amended",12,2,0,2,16
1714369,1338113,2023-05-31,Assembly,"AB 1451 Jackson Assembly Third Reading",67,0,0,13,80
1714369,1350668,2023-07-12,Senate,"Do pass as amended, but first amend, and re-refer to the Committee on [Appropriations]",10,0,0,2,12
1714369,1351340,2023-08-14,Senate,"Placed on suspense file",7,0,0,0,7
1714369,1352996,2023-09-01,Senate,"Do pass",5,0,0,2,7
1714369,1353491,2023-09-07,Senate,"Assembly 3rd Reading AB1451 Jackson By Wiener",33,0,0,7,40
1714369,1353695,2023-09-11,Assembly,"AB 1451 Jackson Concurrence in Senate Amendments",67,2,0,11,80
1714370,1306757,2023-04-20,Assembly,"Do pass and be re-referred to the Committee on [Appropriations] with recommendation: To Consent Calendar",13,0,0,0,13
1714370,1318029,2023-05-03,Assembly,"Do pass. To Consent Calendar",16,0,0,0,16
1714370,1323797,2023-05-11,Assembly,"AB 1452 Mathis Consent Calendar Second Day Regular Session",66,0,0,14,80
1714370,1343740,2023-06-13,Senate,"Do pass, but first be re-referred to the Committee on [Appropriations]",14,0,0,1,15
1714370,1354733,2023-09-11,Senate,"Assembly 3rd Reading AB1452 Mathis et al. By Seyarto",39,0,0,1,40
1714375,1304362,2023-04-18,Assembly,"Do pass. To Consent Calendar",7,0,0,1,8
1714375,1313476,2023-04-27,Assembly,"AB 1457 Ortega Consent Calendar Second Day",79,0,0,1,80
1714375,1345562,2023-06-19,Senate,"Do pass",4,0,0,1,5
1714375,1353164,2023-09-05,Senate,"Assembly 3rd Reading AB1457 Ortega et al. By Skinner",39,0,0,1,40
1714376,1299526,2023-04-12,Assembly,"Do pass as amended and be re-referred to the Committee on [Judiciary]",8,0,0,0,8
1714376,1317094,2023-05-02,Assembly,"Do pass as amended",11,0,0,0,11
1714376,1337939,2023-05-31,Assembly,"AB 1458 Ta Assembly Third Reading",75,1,0,4,80
1714376,1346155,2023-06-20,Senate,"Do pass, but first be re-referred to the Committee on [Judiciary]",10,0,0,1,11
1714376,1350539,2023-07-11,Senate,"Do pass as amended",11,0,0,0,11
1714376,1353159,2023-09-05,Senate,"Assembly 3rd Reading AB1458 Ta By Umberg",39,0,0,1,40
1714376,1353610,2023-09-11,Assembly,"AB 1458 Ta Concurrence in Senate Amendments",78,1,0,1,80
1714377,1306783,2023-04-20,Assembly,"Do pass and be re-referred to the Committee on [Appropriations] with recommendation: To Consent Calendar",13,0,0,0,13
1714377,1318057,2023-05-03,Assembly,"Do pass. To Consent Calendar",16,0,0,0,16
1714377,1323818,2023-05-11,Assembly,"AB 1459 Ramos Consent Calendar Second Day Regular Session",66,0,0,14,80
1714377,1343776,2023-06-13,Senate,"Do pass, but first be re-referred to the Committee on [Appropriations]",14,0,0,1,15
1714377,1353143,2023-09-05,Senate,"Assembly 3rd Reading AB1459 Ramos et al. By Laird",39,0,0,1,40
1714377,1353380,2023-09-07,Assembly,"AB 1459 Ramos Concurrence in Senate Amendments",79,0,0,1,80
1714379,1288290,2023-03-29,Assembly,"Do pass and be re-referred to the Committee on [Appropriations] with recommendation: To Consent Calendar",13,0,0,0,13
1714380,1280600,2023-03-21,Assembly,"Do pass and be re-referred to the Committee on [Military and Veterans Affairs] with recommendation: To Consent Calendar",14,0,0,1,15
1714380,1305231,2023-04-18,Assembly,"Do pass and be re-referred to the Committee on [Appropriations] with recommendation: To Consent Calendar",11,0,0,0,11
1714380,1328459,2023-05-18,Assembly,"Do pass",15,0,0,1,16
1714380,1333554,2023-05-25,Assembly,"AB 1462 Jim Patterson Assembly Third Reading",75,0,0,5,80
1714380,1344196,2023-06-14,Senate,"Do pass, but first be re-referred to the Committee on [Military and Veterans Affairs] with the recommendation: To Consent Calendar",12,0,0,0,12
1714380,1350204,2023-07-10,Senate,"Do pass, but first be re-referred to the Committee on [Appropriations] with the recommendation: To Consent Calendar",5,0,0,0,5
1714380,1351344,2023-08-14,Senate,"Placed on suspense file",7,0,0,0,7
1714380,1352582,2023-09-01,Senate,"Do pass",7,0,0,0,7
1714380,1353758,2023-09-12,Senate,"Assembly 3rd Reading AB1462 Jim Patterson et al. By Rubio",38,0,0,2,40
1714380,1354224,2023-09-13,Assembly,"AB 1462 Jim Patterson Concurrence in Senate Amendments",80,0,0,0,80
1714381,1285657,2023-03-27,Assembly,"Do pass and be re-referred to the Committee on [Privacy and Consumer Protection]",10,4,0,1,15
1714381,1311869,2023-04-25,Assembly,"Do pass as amended and be re-referred to the Committee on [Appropriations]",8,2,0,1,11
1714381,1328588,2023-05-18,Assembly,"Do pass",11,4,0,1,16
1714381,1337193,2023-06-01,Assembly,"AB 1463 Lowenthal Assembly Third Reading",48,15,0,17,80
1714381,1350417,2023-07-11,Senate,"Do pass as amended, but first amend, and re-refer to the Committee on [Appropriations]",5,2,0,4,11
1714381,1350418,2023-07-11,Senate,"[First] hearing set for [07-12-2023]: Failed passage in Committee. Reconsideration granted",11,0,0,0,11
1714382,1304421,2023-04-17,Assembly,"Do pass and be re-referred to the Committee on [Appropriations]",15,0,0,0,15
1714383,1302666,2023-04-17,Assembly,"Do pass and be re-referred to the Committee on [Judiciary]",8,3,0,0,11
1714383,1310157,2023-04-25,Assembly,"Do pass and be re-referred to the Committee on [Appropriations]",8,2,0,1,11
1714383,1322890,2023-05-10,Assembly,"Do pass",12,3,0,1,16
1714383,1337187,2023-06-01,Assembly,"AB 1465 Wicks Assembly Third Reading",51,15,0,14,80
1714383,1349642,2023-07-05,Senate,"Do pass, but first be re-referred to the Committee on [Judiciary]",5,2,0,0,7
1714383,1350557,2023-07-11,Senate,"Do pass as amended, but first amend, and re-refer to the Committee on [Appropriations]",10,1,0,0,11
1714383,1467140,2024-08-31,Senate,"Assembly 3rd Reading AB1465 Wicks By Skinner",27,10,0,3,40
1714383,1467141,2024-08-31,Assembly,"AB 1465 Wicks Concurrence in Senate Amendments Motion to Suspend the Rules By AGUIAR-CURRY",51,17,0,11,79
1714383,1467142,2024-08-31,Assembly,"AB 1465 Wicks Concurrence in Senate Amendments Move The Previous Question By BAUER-KAHAN",50,15,0,14,79
1714383,1467143,2024-08-31,Assembly,"AB 1465 Wicks Concurrence in Senate Amendments Appeal the Decision of the Speaker By ESSAYLI",52,15,0,12,79
1714383,1467144,2024-08-31,Assembly,"AB 1465 Wicks Concurrence in Senate Amendments",49,15,0,15,79
1714384,1283168,2023-03-22,Assembly,"Do pass and be re-referred to the Committee on [Appropriations]",7,0,0,0,7
1714384,1328123,2023-05-18,Assembly,"Do pass",15,0,0,1,16
1714384,1333758,2023-05-25,Assembly,"AB 1466 Weber Assembly Third Reading",76,0,0,4,80
1714384,1346175,2023-06-21,Senate,"Do pass, but first be re-referred to the Committee on [Appropriations] with the recommendation: To Consent Calendar",7,0,0,0,7
1714384,1349499,2023-07-03,Senate,"Placed on suspense file",7,0,0,0,7
1714384,1352881,2023-09-01,Senate,"Do pass",7,0,0,0,7
1714384,1353734,2023-09-12,Senate,"Special Consent AB1466 Weber",39,0,0,1,40
1714385,1280685,2023-03-21,Assembly,"Do pass as amended. To Consent Calendar",5,0,0,2,7
1714385,1289787,2023-03-30,Assembly,"AB 1467 Alanis Consent Calendar Second Day",60,0,0,20,80
1714385,1341011,2023-06-07,Senate,"Do pass and be ordered to the Consent Calendar",12,0,0,0,12
1714385,1344734,2023-06-15,Senate,"Consent Calendar AB1467 Alanis",40,0,0,0,40
1714387,1311798,2023-04-26,Assembly,"Do pass",8,0,0,0,8
1714387,1320447,2023-05-08,Assembly,"AB 1469 Kalra Assembly Third Reading",72,0,0,8,80
1714387,1349739,2023-07-05,Senate,"Do pass as amended",8,0,0,0,8
1714387,1354134,2023-09-13,Senate,"Assembly 3rd Reading AB1469 Kalra et al. By Becker",39,0,0,1,40
1714387,1354135,2023-09-13,Assembly,"AB 1469 Kalra Concurrence in Senate Amendments",79,0,0,1,80
1714388,1310367,2023-04-25,Assembly,"Do pass as amended and be re-referred to the Committee on [Appropriations]",15,0,0,0,15
1714388,1328139,2023-05-18,Assembly,"Do pass",15,0,0,1,16
1714388,1337185,2023-06-01,Assembly,"AB 1470 Quirk-Silva Assembly Third Reading",79,0,0,1,80
1714388,1348895,2023-06-28,Senate,"Do pass as amended, but first amend, and re-refer to the Committee on [Appropriations]",11,0,0,1,12
1714388,1349956,2023-07-10,Senate,"Placed on suspense file",6,0,0,1,7
1714388,1353033,2023-09-01,Senate,"Do pass",7,0,0,0,7
1714388,1354006,2023-09-12,Senate,"Assembly 3rd Reading AB1470 Quirk-Silva By Eggman",37,0,0,3,40
1714388,1464126,2024-08-15,Assembly,"AB 1470 Quirk-Silva Concurrence in Senate Amendments",75,0,0,4,79
1714389,1304363,2023-04-18,Assembly,"Do pass as amended and be re-referred to the Committee on [Appropriations]",14,0,0,1,15
1714389,1328405,2023-05-18,Assembly,"Do pass",15,0,0,1,16
1714389,1333751,2023-05-25,Assembly,"AB 1471 Pellerin Third Reading Urgency",76,0,0,4,80
1714389,1349800,2023-07-05,Senate,"Do pass, but first be re-referred to the Committee on [Appropriations] with the recommendation: To Consent Calendar",12,0,0,0,12
1714389,1351515,2023-08-14,Senate,"Placed on suspense file",7,0,0,0,7
1714389,1352860,2023-09-01,Senate,"Do pass",7,0,0,0,7
1714389,1354008,2023-09-12,Senate,"Special Consent AB1471 Pellerin By Cortese Urgency Clause",39,0,0,1,40
1714389,1354263,2023-09-13,Assembly,"AB 1471 Pellerin Concurrence in Senate Amendments",79,0,0,1,80
1714390,1311777,2023-04-26,Assembly,"Do pass",7,0,0,1,8
1714390,1320434,2023-05-08,Assembly,"AB 1472 Alvarez Assembly Third Reading",72,0,0,8,80
1714390,1350437,2023-07-11,Senate,"Do pass, but first be re-referred to the Committee on [Appropriations]",2,6,0,3,11
1714390,1350438,2023-07-11,Senate,"[Final] hearing set for [07-12-2023]: Failed passage in Committee. Reconsideration granted",11,0,0,0,11
1714390,1462657,2024-07-02,Senate,"Do pass, but first be re-referred to the Committee on [Appropriations]",9,1,0,1,11
1714390,1463675,2024-08-05,Senate,"Placed on suspense file",7,0,0,0,7
1714390,1464395,2024-08-15,Senate,"Do pass",5,2,0,0,7
1714390,1466374,2024-08-29,Senate,"Assembly 3rd Reading AB1472 Alvarez et al. By Padilla",33,6,0,1,40
1714390,1466509,2024-08-30,Assembly,"AB 1472 Alvarez Concurrence in Senate Amendments",70,0,0,9,79
1714391,1313509,2023-04-26,Assembly,"Do pass as amended, and be re-referred to the Committee on [Appropriations] with recommendation: To Consent Calendar",7,0,0,0,7
1714391,1328243,2023-05-18,Assembly,"Do pass",15,0,0,1,16
1714391,1333789,2023-05-25,Assembly,"AB 1473 Maienschein Assembly Third Reading",76,1,0,3,80
1714391,1346316,2023-06-21,Senate,"Do pass, but first be re-referred to the Committee on [Appropriations]",7,0,0,0,7
1714391,1349542,2023-07-03,Senate,"Placed on suspense file",7,0,0,0,7
1714392,1299499,2023-04-12,Assembly,"Do pass and be re-referred to the Committee on [Appropriations] with recommendation: To Consent Calendar",8,0,0,0,8
1714392,1311852,2023-04-26,Assembly,"Do pass. To Consent Calendar",16,0,0,0,16
1714392,1318914,2023-05-04,Assembly,"AB 1474 Reyes Consent Calendar Second Day Regular Session",75,0,0,5,80
1714392,1340068,2023-06-06,Senate,"Do pass, but first be re-referred to the Committee on [Appropriations] with the recommendation: To Consent Calendar",11,0,0,0,11
1714392,1353722,2023-09-12,Assembly,"AB 1474 Reyes Concurrence in Senate Amendments",80,0,0,0,80
1714392,1354759,2023-09-11,Senate,"Assembly 3rd Reading AB1474 Reyes et al. By Menjivar",39,0,0,1,40
1714393,1304431,2023-04-17,Assembly,"Do pass and be re-referred to the Committee on [Appropriations] with recommendation: To Consent Calendar",15,0,0,0,15
1714394,1307877,2023-04-19,Assembly,"Do pass and be re-referred to the Committee on [Housing and Community Development]",6,1,0,0,7
1714394,1311855,2023-04-26,Assembly,"Do pass and be re-referred to the Committee on [Appropriations]",6,2,0,0,8
1714395,1280688,2023-03-21,Assembly,"Do pass as amended and be re-referred to the Committee on [Appropriations]",14,0,0,1,15
1714396,1310274,2023-04-25,Assembly,"Do pass and be re-referred to the Committee on [Appropriations] with recommendation: To Consent Calendar",15,0,0,0,15
1714396,1328514,2023-05-18,Assembly,"Do pass as amended",11,0,0,5,16
1714396,1337906,2023-05-31,Assembly,"AB 1478 Cervantes Assembly Third Reading",79,0,0,1,80
1714396,1350682,2023-07-12,Senate,"Do pass, but first be re-referred to the Committee on [Appropriations] with the recommendation: To Consent Calendar",11,0,0,1,12
1714396,1351420,2023-08-14,Senate,"Placed on suspense file",7,0,0,0,7
1714396,1353023,2023-09-01,Senate,"Do pass",7,0,0,0,7
1714396,1353788,2023-09-12,Senate,"Special Consent AB1478 Cervantes By Lim√≥n",39,0,0,1,40
1714397,1313469,2023-04-26,Assembly,"Do pass and be re-referred to the Committee on [Appropriations] with recommendation: To Consent Calendar",7,0,0,0,7
1714397,1328542,2023-05-18,Assembly,"Do pass",15,0,0,1,16
1714397,1333750,2023-05-25,Assembly,"AB 1479 Garcia Assembly Third Reading",77,0,0,3,80
1714397,1348303,2023-06-28,Senate,"Do pass as amended, but first amend, and re-refer to the Committee on [Appropriations] with the recommendation: To Consent Calendar",7,0,0,0,7
1714397,1351463,2023-08-14,Senate,"Placed on suspense file",7,0,0,0,7
1714397,1353094,2023-09-01,Senate,"Do pass",7,0,0,0,7
1714397,1353997,2023-09-12,Senate,"Special Consent AB1479 Garcia By Eggman",39,0,0,1,40
1714397,1354282,2023-09-13,Assembly,"AB 1479 Garcia Concurrence in Senate Amendments",80,0,0,0,80
1714399,1310399,2023-04-25,Assembly,"Do pass and be re-referred to the Committee on [Appropriations]",13,0,0,2,15
1714399,1328709,2023-05-18,Assembly,"Do pass",12,0,0,4,16
1714399,1333638,2023-05-25,Assembly,"AB 1481 Boerner Assembly Third Reading",66,1,0,13,80
1714399,1350690,2023-07-12,Senate,"Do pass as amended, but first amend, and re-refer to the Committee on [Appropriations]",10,0,0,2,12
1714399,1353883,2023-09-12,Assembly,"AB 1481 Boerner Concurrence in Senate Amendments",68,2,0,10,80
1714399,1354838,2023-09-11,Senate,"Assembly 3rd Reading AB1481 Boerner et al. By Skinner",31,3,0,6,40
1714400,1313520,2023-04-26,Assembly,"Do pass as amended and be re-referred to the Committee on [Appropriations]",10,2,0,3,15
1714401,1304439,2023-04-18,Assembly,"Do pass as amended and be re-referred to the Committee on [Appropriations]",5,1,0,2,8
1714401,1322874,2023-05-10,Assembly,"Do pass",12,3,0,1,16
1714401,1330128,2023-05-22,Assembly,"AB 1483 Valencia Assembly Third Reading",62,14,0,4,80
1714401,1343713,2023-06-13,Senate,"Do pass, but first be re-referred to the Committee on [Appropriations]",4,0,0,1,5
1714401,1347537,2023-06-26,Senate,"Placed on suspense file",6,0,0,1,7
1714401,1352533,2023-09-01,Senate,"Do pass as amended",5,2,0,0,7
1714401,1353346,2023-09-07,Senate,"Assembly 3rd Reading AB1483 Valencia et al. By Bradford",29,9,0,2,40
1714401,1353593,2023-09-11,Assembly,"AB 1483 Valencia Concurrence in Senate Amendments",62,16,0,2,80
1714402,1299517,2023-04-12,Assembly,"Do pass and be re-referred to the Committee on [Appropriations]",5,2,0,0,7
1714402,1328389,2023-05-18,Assembly,"Do pass as amended",11,3,0,2,16
1714402,1338143,2023-05-31,Assembly,"AB 1484 Zbur Assembly Third Reading",62,16,0,2,80
1714402,1350498,2023-07-12,Senate,"Do pass, but first be re-referred to the Committee on [Appropriations]",4,1,0,0,5
1714402,1351518,2023-08-14,Senate,"Placed on suspense file",7,0,0,0,7
1714402,1352753,2023-09-01,Senate,"Do pass as amended",5,2,0,0,7
1714402,1354156,2023-09-13,Senate,"Assembly 3rd Reading AB1484 Zbur et al. By Smallwood-Cuevas",26,11,0,3,40
1714402,1354157,2023-09-13,Assembly,"AB 1484 Zbur Concurrence in Senate Amendments",59,15,0,6,80
1714403,1299516,2023-04-12,Assembly,"Do pass and be re-referred to the Committee on [Judiciary]",6,1,0,1,8
1714403,1304428,2023-04-18,Assembly,"Do pass and be re-referred to the Committee on [Appropriations]",8,3,0,0,11
1714403,1322904,2023-05-10,Assembly,"Do pass",12,3,0,1,16
1714403,1337191,2023-06-01,Assembly,"AB 1485 Haney Assembly Third Reading",56,16,0,8,80
1714403,1346176,2023-06-20,Senate,"Do pass, but first be re-referred to the Committee on [Judiciary]",9,2,0,0,11
1714403,1349784,2023-07-06,Senate,"Do pass, but first be re-referred to the Committee on [Appropriations]",9,2,0,0,11
1714403,1353818,2023-09-12,Senate,"Assembly 3rd Reading AB1485 Haney et al. By Wiener",30,7,0,3,40
1714403,1354398,2023-09-13,Assembly,"AB 1485 Haney Concurrence in Senate Amendments",56,16,0,8,80
1714404,1304259,2023-04-18,Assembly,"Do pass",5,2,0,1,8
1714404,1324953,2023-05-15,Assembly,"AB 1486 Jones-Sawyer Assembly Third Reading",45,18,0,17,80
1714404,1345628,2023-06-20,Senate,"Do pass",4,1,0,0,5
1714405,1298282,2023-04-11,Assembly,"Do pass as amended and be re-referred to the Committee on [Appropriations]",12,0,0,3,15
1714405,1328219,2023-05-18,Assembly,"Do pass",11,3,0,2,16
1714405,1337211,2023-06-01,Assembly,"AB 1487 Santiago Assembly Third Reading",66,0,0,14,80
1714405,1346136,2023-06-21,Senate,"Do pass, but first be re-referred to the Committee on [Appropriations]",10,0,0,2,12
1714405,1349500,2023-07-03,Senate,"Placed on suspense file",7,0,0,0,7
1714405,1352649,2023-09-01,Senate,"Do pass as amended",5,0,0,2,7
1714405,1353230,2023-09-06,Senate,"Assembly 3rd Reading AB1487 Santiago et al. By Menjivar",32,1,0,7,40
1714405,1353677,2023-09-11,Assembly,"AB 1487 Santiago Concurrence in Senate Amendments",65,4,0,11,80
1714407,1310339,2023-04-24,Assembly,"Do pass as amended and be re-referred to the Committee on [Appropriations]",10,0,0,1,11
1714407,1328306,2023-05-18,Assembly,"Do pass",14,0,0,2,16
1714407,1333743,2023-05-25,Assembly,"AB 1489 Wood Assembly Third Reading",66,0,0,14,80
1714407,1348351,2023-06-28,Senate,"Do pass, but first be re-referred to the Committee on [Appropriations]",7,0,0,0,7
1714407,1351451,2023-08-14,Senate,"Placed on suspense file",7,0,0,0,7
1714407,1352700,2023-09-01,Senate,"Do pass",7,0,0,0,7
1714407,1353999,2023-09-12,Senate,"Special Consent AB1489 Wood",39,0,0,1,40
1714408,1305219,2023-04-19,Assembly,"Do pass and be re-referred to the Committee on [Local Government]",6,1,0,1,8
1714408,1313327,2023-04-26,Assembly,"Do pass as amended and be re-referred to the Committee on [Appropriations]",7,1,0,0,8
1714408,1328120,2023-05-18,Assembly,"Do pass",14,1,0,1,16
1714408,1333772,2023-05-25,Assembly,"AB 1490 Lee Assembly Third Reading",72,1,0,7,80
1714408,1346231,2023-06-20,Senate,"Do pass, but first be re-referred to the Committee on [Governance and Finance]",10,1,0,0,11
1714408,1349799,2023-07-05,Senate,"Do pass as amended, but first amend, and re-refer to the Committee on [Appropriations]",5,2,0,1,8
1714408,1351438,2023-08-14,Senate,"Placed on suspense file",7,0,0,0,7
1714408,1352651,2023-09-01,Senate,"Do pass",5,2,0,0,7
1714408,1353905,2023-09-12,Senate,"Assembly 3rd Reading AB1490 Lee et al. By Umberg",29,7,0,4,40
1714408,1354302,2023-09-13,Assembly,"AB 1490 Lee Concurrence in Senate Amendments",77,0,0,3,80
1714414,1301087,2023-04-12,Assembly,"Do pass as amended, and be re-referred to the Committee on [Appropriations] with recommendation: To Consent Calendar",7,0,0,0,7
1714415,1310200,2023-04-25,Assembly,"Do pass and be re-referred to the Committee on [Appropriations]",6,1,0,1,8
1714416,1310170,2023-04-24,Assembly,"Do pass as amended and be re-referred to the Committee on [Appropriations]",10,0,0,1,11
1714417,1311679,2023-04-26,Assembly,"Do pass and be re-referred to the Committee on [Appropriations]",6,0,0,2,8
1714418,1310364,2023-04-24,Assembly,"Do pass as amended and be re-referred to the Committee on [Appropriations]",11,0,0,0,11
1714418,1328536,2023-05-18,Assembly,"Do pass",15,0,0,1,16
1714418,1337203,2023-06-01,Assembly,"AB 1500 Irwin Third Reading Urgency",79,0,0,1,80
1714418,1348366,2023-06-28,Senate,"Do pass, but first be re-referred to the Committee on [Appropriations] with the recommendation: To Consent Calendar",8,0,0,0,8
1714418,1349934,2023-07-10,Senate,"Placed on suspense file",6,0,0,1,7
1714418,1352667,2023-09-01,Senate,"Do pass",7,0,0,0,7
1714418,1354022,2023-09-12,Senate,"Special Consent AB1500 Irwin et al. Urgency Clause",39,0,0,1,40
1714421,1289804,2023-03-29,Assembly,"Do pass and be re-referred to the Committee on [Appropriations] with recommendation: To Consent Calendar",6,0,0,1,7
1714421,1328756,2023-05-18,Assembly,"Do pass",15,0,0,1,16
1714421,1337216,2023-06-01,Assembly,"AB 1503 Lee Assembly Third Reading",79,0,0,1,80
1714421,1346294,2023-06-21,Senate,"Do pass, but first be re-referred to the Committee on [Appropriations] with the recommendation: To Consent Calendar",7,0,0,0,7
1714421,1349495,2023-07-03,Senate,"Placed on suspense file",7,0,0,0,7
1714421,1352583,2023-09-01,Senate,"Do pass",7,0,0,0,7
1714421,1353741,2023-09-12,Senate,"Assembly 3rd Reading AB1503 Lee et al. By Ashby",38,0,0,2,40
1714421,1354440,2023-09-13,Assembly,"AB 1503 Lee Concurrence in Senate Amendments",78,1,0,1,80
1714422,1307857,2023-04-19,Assembly,"Do pass and be re-referred to the Committee on [Transportation]",5,2,0,0,7
1714422,1310146,2023-04-24,Assembly,"Do pass and be re-referred to the Committee on [Appropriations]",11,4,0,0,15
1714423,1304420,2023-04-17,Assembly,"Do pass and be re-referred to the Committee on [Appropriations]",7,0,0,0,7
1714423,1328837,2023-05-18,Assembly,"Do pass as amended",11,0,0,5,16
1714423,1337901,2023-05-31,Assembly,"AB 1505 Rodriguez Third Reading Urgency",80,0,0,0,80
1714423,1350123,2023-07-11,Senate,"Do pass, but first be re-referred to the Committee on [Appropriations] with the recommendation: To Consent Calendar",14,0,0,1,15
1714423,1456944,2024-06-12,Senate,"Do pass, but first be re-referred to the Committee on [Judiciary]",7,0,0,0,7
1714423,1460485,2024-06-25,Senate,"Do pass and be ordered to the Consent Calendar",11,0,0,0,11
1714423,1465729,2024-08-26,Senate,"Assembly 3rd Reading AB1505 Rodriguez By Portantino",40,0,0,0,40
1714423,1466540,2024-08-30,Assembly,"With recommendation: That Senate amendments be concurred in",14,0,0,1,15
1714423,1466541,2024-08-30,Assembly,"AB 1505 Rodriguez Concurrence in Senate Amendments",74,0,0,5,79
1714424,1304297,2023-04-18,Assembly,"Do pass as amended",7,0,0,1,8
1714424,1313498,2023-04-27,Assembly,"AB 1506 Quirk-Silva Assembly Third Reading",79,0,0,1,80
1714424,1345687,2023-06-19,Senate,"Do pass as amended, but first amend, and re-refer to the Committee on [Judiciary]",5,0,0,0,5
1714424,1348285,2023-06-27,Senate,"Do pass and be ordered to the Consent Calendar",11,0,0,0,11
1714424,1349820,2023-07-06,Senate,"Consent Calendar AB1506 Quirk-Silva",40,0,0,0,40
1714424,1350634,2023-07-13,Assembly,"AB 1506 Quirk-Silva Concurrence in Senate Amendments",71,0,0,9,80
1714426,1305358,2023-04-19,Assembly,"Do pass and be re-referred to the Committee on [Appropriations] with recommendation: To Consent Calendar",8,0,0,0,8
1714426,1328452,2023-05-18,Assembly,"Do pass",15,0,0,1,16
1714426,1337246,2023-06-01,Assembly,"AB 1508 Ramos Assembly Third Reading",79,0,0,1,80
1714426,1346297,2023-06-20,Senate,"Do pass, but first be re-referred to the Committee on [Appropriations] with the recommendation: To Consent Calendar",11,0,0,0,11
1714426,1349475,2023-07-03,Senate,"Placed on suspense file",7,0,0,0,7
1714426,1352685,2023-09-01,Senate,"Do pass",7,0,0,0,7
1714426,1354000,2023-09-12,Senate,"Special Consent AB1508 Ramos",39,0,0,1,40
1714427,1313473,2023-04-26,Assembly,"Do pass as amended, and be re-referred to the Committee on [Appropriations] with recommendation: To Consent Calendar",7,0,0,0,7
1714428,1301073,2023-04-12,Assembly,"Do pass. To Consent Calendar",7,0,0,0,7
1714428,1306727,2023-04-20,Assembly,"AB 1510 Jones-Sawyer Consent Calendar Second Day Regular Session",76,0,0,4,80
1714428,1349823,2023-07-05,Senate,"Do pass as amended, but first amend, and re-refer to the Committee on [Governance and Finance]",10,1,0,1,12
1714428,1461982,2024-07-01,Senate,"Placed on suspense file",7,0,0,0,7
1714429,1310231,2023-04-25,Assembly,"Do pass and be re-referred to the Committee on [Appropriations]",7,0,0,0,7
1714429,1328246,2023-05-18,Assembly,"Do pass",15,0,0,1,16
1714429,1337239,2023-06-01,Assembly,"AB 1511 Santiago Assembly Third Reading",78,0,0,2,80
1714429,1459941,2024-06-25,Senate,"Do pass as amended, but first amend, and re-refer to the Committee on [Appropriations]",11,0,0,5,16
1714429,1463510,2024-08-05,Senate,"Placed on suspense file",7,0,0,0,7
1714429,1464260,2024-08-15,Senate,"Do pass",5,0,0,2,7
1714429,1466333,2024-08-29,Assembly,"AB 1511 Santiago Concurrence in Senate Amendments",75,0,0,4,79
1714429,1467244,2024-08-28,Senate,"Assembly 3rd Reading AB1511 Santiago et al. By Rubio",39,0,0,1,40
1714430,1310148,2023-04-25,Assembly,"Do pass and be re-referred to the Committee on [Appropriations]",7,0,0,1,8
1714430,1328433,2023-05-18,Assembly,"Do pass",15,0,0,1,16
1714430,1337219,2023-06-01,Assembly,"AB 1512 Bryan Assembly Third Reading",79,0,0,1,80
1714430,1350691,2023-07-13,Senate,"Do pass, but first be re-referred to the Committee on [Appropriations] with the recommendation: To Consent Calendar",4,0,0,1,5
1714430,1351423,2023-08-14,Senate,"Placed on suspense file",7,0,0,0,7
1714430,1352497,2023-09-01,Senate,"Do pass as amended",7,0,0,0,7
1714430,1353974,2023-09-12,Senate,"Assembly 3rd Reading AB1512 Bryan et al. By Ochoa Bogh",37,0,0,3,40
1714430,1354131,2023-09-13,Assembly,"AB 1512 Bryan Concurrence in Senate Amendments",80,0,0,0,80
1714431,1313464,2023-04-26,Assembly,"Do pass as amended and be re-referred to the Committee on [Appropriations]",12,0,0,3,15
1714432,1304296,2023-04-18,Assembly,"Do pass and be re-referred to the Committee on [Appropriations]",7,0,0,1,8
1714434,1311730,2023-04-26,Assembly,"Do pass and be re-referred to the Committee on [Appropriations]",5,0,0,2,7
1714434,1328133,2023-05-18,Assembly,"Do pass",11,4,0,1,16
1714434,1371114,2024-01-29,Assembly,"AB 1516 Kalra Assembly Third Reading",61,10,0,9,80
1714434,1454186,2024-06-05,Senate,"Do pass, but first be re-referred to the Committee on [Appropriations]",4,1,0,0,5
1714434,1458010,2024-06-17,Senate,"Placed on suspense file",7,0,0,0,7
1714435,1313435,2023-04-26,Assembly,"Do pass as amended, and be re-referred to the Committee on [Appropriations] with recommendation: To Consent Calendar",7,0,0,0,7
1714435,1328102,2023-05-18,Assembly,"Do pass",15,0,0,1,16
1714435,1337201,2023-06-01,Assembly,"AB 1517 Gallagher Assembly Third Reading",78,0,0,2,80
1714435,1348495,2023-06-28,Senate,"Do pass, but first be re-referred to the Committee on [Appropriations] with the recommendation: To Consent Calendar",7,0,0,0,7
1714435,1349995,2023-07-10,Senate,"Placed on suspense file",6,0,0,1,7
1714435,1352818,2023-09-01,Senate,"Do pass as amended",7,0,0,0,7
1714435,1354324,2023-09-13,Senate,"Special Consent AB1517 Gallagher et al. By Ochoa Bogh",39,0,0,1,40
1714435,1354813,2023-09-14,Assembly,"AB 1517 Gallagher Concurrence in Senate Amendments",80,0,0,0,80
1714436,1310233,2023-04-25,Assembly,"Do pass and be re-referred to the Committee on [Appropriations]",16,0,0,2,18
1714437,1304262,2023-04-17,Assembly,"Do pass and be re-referred to the Committee on [Public Safety]",15,0,0,0,15
1714437,1310198,2023-04-25,Assembly,"Do pass and be re-referred to the Committee on [Appropriations] with recommendation: To Consent Calendar",8,0,0,0,8
1714437,1328466,2023-05-18,Assembly,"Do pass",15,0,0,1,16
1714437,1337252,2023-06-01,Assembly,"AB 1519 Bains Assembly Third Reading",79,0,0,1,80
1714437,1348381,2023-06-27,Senate,"Do pass, but first be re-referred to the Committee on [Public Safety] with the recommendation: To Consent Calendar",16,0,0,0,16
1714437,1350194,2023-07-11,Senate,"Do pass, but first be re-referred to the Committee on [Appropriations]",4,0,0,1,5
1714437,1351365,2023-08-14,Senate,"Placed on suspense file",7,0,0,0,7
1714437,1352872,2023-09-01,Senate,"Do pass as amended",7,0,0,0,7
1714437,1354363,2023-09-13,Senate,"Special Consent AB1519 Bains et al. By Umberg",39,0,0,1,40
1714437,1354587,2023-09-14,Assembly,"AB 1519 Bains Concurrence in Senate Amendments",80,0,0,0,80
1714438,1301024,2023-04-12,Assembly,"Do pass as amended and be re-referred to the Committee on [Appropriations]",7,0,0,0,7
1714440,1310207,2023-04-25,Assembly,"Do pass and be re-referred to the Committee on [Appropriations]",6,0,0,2,8
1714442,1305257,2023-04-18,Assembly,"Do pass and be re-referred to the Committee on [Appropriations]",11,0,0,1,12
1714442,1328827,2023-05-18,Assembly,"Do pass",15,0,0,1,16
1714442,1337202,2023-06-01,Assembly,"AB 1524 Lowenthal Assembly Third Reading",77,0,0,3,80
1714442,1348467,2023-06-28,Senate,"Do pass, but first be re-referred to the Committee on [Appropriations] with the recommendation: To Consent Calendar",7,0,0,0,7
1714442,1349967,2023-07-10,Senate,"Placed on suspense file",6,0,0,1,7
1714442,1352647,2023-09-01,Senate,"Do pass as amended",7,0,0,0,7
1714442,1465709,2024-08-26,Senate,"Assembly 3rd Reading AB1524 Lowenthal et al. By Menjivar",40,0,0,0,40
1714442,1466025,2024-08-27,Assembly,"AB 1524 Lowenthal Concurrence in Senate Amendments",77,0,0,2,79
1714443,1310183,2023-04-24,Assembly,"Do pass and be re-referred to the Committee on [Appropriations]",10,4,0,1,15
1714444,1310325,2023-04-24,Assembly,"Do pass and be re-referred to the Committee on [Appropriations] with recommendation: To Consent Calendar",11,0,0,0,11
1714444,1322889,2023-05-10,Assembly,"Do pass. To Consent Calendar",14,0,0,2,16
1714444,1328156,2023-05-18,Assembly,"AB 1526 Natural Resources Consent Calendar Second Day Regular Session",74,0,0,6,80
1714444,1346944,2023-06-22,Senate,"Do pass as amended, but first amend, and re-refer to the Committee on [Environmental Quality] with the recommendation: To Consent Calendar",11,0,0,0,11
1714444,1350474,2023-07-12,Senate,"Do pass, but first be re-referred to the Committee on [Appropriations] with the recommendation: To Consent Calendar",7,0,0,0,7
1714444,1351314,2023-08-14,Senate,"Placed on suspense file",7,0,0,0,7
1714444,1352590,2023-09-01,Senate,"Do pass",7,0,0,0,7
1714444,1354406,2023-09-13,Senate,"Assembly 3rd Reading AB1526 NAT. RES. (Rivas, L.) By Allen",0,0,0,40,40
1714444,1354407,2023-09-13,Senate,"Assembly 3rd Reading AB1526 NAT. RES. (Rivas, L.) By Allen",39,0,0,1,40
1714444,1354408,2023-09-13,Assembly,"AB 1526 NAT. RES. Concurrence in Senate Amendments By RIVAS, L",78,0,0,2,80
1714446,1311691,2023-04-26,Assembly,"Do pass. To Consent Calendar",8,0,0,0,8
1714446,1318961,2023-05-04,Assembly,"AB 1528 Gipson Consent Calendar Second Day Regular Session",75,0,0,5,80
1714446,1340020,2023-06-06,Senate,"Do pass, but first be re-referred to the Committee on [Governance and Finance] with the recommendation: To Consent Calendar",11,0,0,0,11
1714446,1349810,2023-07-05,Senate,"Do pass as amended, and be ordered to the Consent Calendar",8,0,0,0,8
1714446,1351379,2023-08-14,Senate,"Placed on suspense file",7,0,0,0,7
1714446,1352572,2023-09-01,Senate,"Do pass",7,0,0,0,7
1714446,1353731,2023-09-12,Senate,"Special Consent AB1528 Gipson By Smallwood-Cuevas",39,0,0,1,40
1714446,1354436,2023-09-13,Assembly,"AB 1528 Gipson Concurrence in Senate Amendments",80,0,0,0,80
1714447,1299491,2023-04-12,Assembly,"Do pass as amended and be re-referred to the Committee on [Transportation]",13,0,0,2,15
1714451,1313365,2023-04-26,Assembly,"Do pass as amended and be re-referred to the Committee on [Appropriations]",13,0,0,2,15
1714451,1327051,2023-05-17,Assembly,"Do pass",15,0,0,1,16
1714451,1337223,2023-06-01,Assembly,"AB 1533 Utilities and Energy Third Reading Urgency By GARCIA",71,0,0,9,80
1714451,1462278,2024-07-02,Senate,"Do pass as amended, but first amend, and re-refer to the Committee on [Appropriations] with the recommendation: To Consent Calendar",18,0,0,0,18
1714451,1464097,2024-08-15,Senate,"Consent Calendar 2nd AB1533 U. & E. (Petrie-Norris)",37,0,0,3,40
1714451,1466487,2024-08-30,Assembly,"With recommendation: That Senate amendments be concurred in",16,0,0,0,16
1714451,1467053,2024-08-31,Assembly,"AB 1533 Utilities and Energy Concurrence in Senate Amendments By PETRIE-NORRIS",77,0,0,2,79
1714452,1301996,2023-04-10,Assembly,"Do pass and be re-referred to the Committee on [Appropriations]",11,0,0,0,11
1714454,1286870,2023-03-28,Assembly,"Do pass and be re-referred to the Committee on [Appropriations]",6,1,0,1,8
1714454,1328888,2023-05-18,Assembly,"Do pass",11,4,0,1,16
1714454,1338105,2023-05-31,Assembly,"AB 1536 Juan Carrillo Assembly Third Reading",65,5,0,10,80
1714454,1349572,2023-07-03,Senate,"Do pass, but first be re-referred to the Committee on [Appropriations]",5,0,0,0,5
1714454,1351460,2023-08-14,Senate,"Placed on suspense file",7,0,0,0,7
1714454,1352809,2023-09-01,Senate,"Do pass as amended",5,2,0,0,7
1714454,1354123,2023-09-13,Senate,"Assembly 3rd Reading AB1536 Juan Carrillo et al. By Durazo",32,2,0,6,40
1714454,1354124,2023-09-13,Assembly,"AB 1536 Juan Carrillo Concurrence in Senate Amendments",64,7,0,9,80
1714455,1304413,2023-04-18,Assembly,"Do pass and be re-referred to the Committee on [Appropriations]",13,0,0,2,15
1714455,1328293,2023-05-18,Assembly,"Do pass",11,1,0,4,16
1714455,1338164,2023-05-31,Assembly,"AB 1537 Wood Assembly Third Reading",64,2,0,14,80
1714455,1350711,2023-07-12,Senate,"Do pass, but first be re-referred to the Committee on [Appropriations]",10,0,0,2,12
1714455,1351308,2023-08-14,Senate,"Placed on suspense file",7,0,0,0,7
1714455,1353086,2023-09-01,Senate,"Do pass",6,1,0,0,7
1714456,1299387,2023-04-12,Assembly,"Do pass as amended and be re-referred to the Committee on [Natural Resources]",12,2,0,1,15
1714457,1305518,2023-04-19,Assembly,"Do pass and be re-referred to the Committee on [Appropriations]",7,0,0,1,8
1714457,1318075,2023-05-03,Assembly,"Do pass. To Consent Calendar",16,0,0,0,16
1714457,1323807,2023-05-11,Assembly,"AB 1539 Berman Consent Calendar Second Day Regular Session",66,0,0,14,80
1714457,1340083,2023-06-06,Senate,"Do pass, but first be re-referred to the Committee on [Public Safety]",7,0,0,0,7
1714457,1350272,2023-07-11,Senate,"Do pass, but first be re-referred to the Committee on [Appropriations]",4,0,0,1,5
1714457,1351362,2023-08-14,Senate,"Placed on suspense file",7,0,0,0,7
1714457,1352569,2023-09-01,Senate,"Do pass",7,0,0,0,7
1714457,1353753,2023-09-12,Senate,"Special Consent AB1539 Berman et al. By Umberg",39,0,0,1,40
1714458,1305308,2023-04-18,Assembly,"Do pass and be re-referred to the Committee on [Appropriations]",8,1,0,3,12
1714458,1327966,2023-05-18,Assembly,"Do pass",11,2,0,3,16
1714458,1338147,2023-05-31,Assembly,"AB 1540 Mike Fong Assembly Third Reading",67,1,0,12,80
1714458,1350480,2023-07-12,Senate,"Do pass, but first be re-referred to the Committee on [Appropriations]",7,0,0,0,7
1714458,1351405,2023-08-14,Senate,"Placed on suspense file",7,0,0,0,7
1714458,1352504,2023-09-01,Senate,"Do pass",5,0,0,2,7
1714458,1353477,2023-09-07,Senate,"Assembly 3rd Reading AB1540 Mike Fong By Durazo",40,0,0,0,40
1714458,1353770,2023-09-12,Assembly,"AB 1540 Mike Fong Concurrence in Senate Amendments",70,1,0,9,80
1714459,1305469,2023-04-18,Assembly,"Do pass and be re-referred to the Committee on [Appropriations] with recommendation: To Consent Calendar",12,0,0,0,12
1714459,1318055,2023-05-03,Assembly,"Do pass. To Consent Calendar",16,0,0,0,16
1714459,1323856,2023-05-11,Assembly,"AB 1541 Mike Fong Consent Calendar Second Day Regular Session",66,0,0,14,80
1714459,1341005,2023-06-07,Senate,"Do pass, but first be re-referred to the Committee on [Appropriations] with the recommendation: To Consent Calendar",7,0,0,0,7
1714459,1348857,2023-06-29,Senate,"Consent Calendar AB1541 Mike Fong",39,0,0,1,40
1714460,1305266,2023-04-18,Assembly,"Do pass and be re-referred to the Committee on [Appropriations] with recommendation: To Consent Calendar",12,0,0,0,12
1714460,1318021,2023-05-03,Assembly,"Do pass. To Consent Calendar",16,0,0,0,16
1714460,1323806,2023-05-11,Assembly,"AB 1542 Mike Fong Consent Calendar Second Day Regular Session",66,0,0,14,80
1714461,1305286,2023-04-18,Assembly,"Do pass and be re-referred to the Committee on [Appropriations]",10,0,0,2,12
1714461,1328613,2023-05-18,Assembly,"Do pass",15,0,0,1,16
1714461,1337936,2023-05-31,Assembly,"AB 1543 Mike Fong Assembly Third Reading",79,0,0,1,80
1714461,1346166,2023-06-21,Senate,"Do pass as amended, but first amend, and re-refer to the Committee on [Appropriations] with the recommendation: To Consent Calendar",7,0,0,0,7
1714461,1349946,2023-07-10,Senate,"Placed on suspense file",6,0,0,1,7
1714462,1299464,2023-04-11,Assembly,"Do pass and be re-referred to the Committee on [Privacy and Consumer Protection]",5,0,0,3,8
1714462,1311939,2023-04-25,Assembly,"Do pass and be re-referred to the Committee on [Appropriations]",11,0,0,0,11
1714462,1328741,2023-05-18,Assembly,"Do pass as amended",15,0,0,1,16
1714462,1337238,2023-06-01,Assembly,"AB 1544 Lackey Assembly Third Reading",71,0,0,9,80
1714464,1298315,2023-04-11,Assembly,"Do pass and be re-referred to the Committee on [Judiciary]",8,3,0,0,11
1714464,1304293,2023-04-18,Assembly,"Do pass and be re-referred to the Committee on [Appropriations]",8,3,0,0,11
1714464,1318082,2023-05-03,Assembly,"Do pass",12,4,0,0,16
1714464,1328662,2023-05-18,Assembly,"AB 1546 Gabriel Assembly Third Reading",59,15,0,6,80
1714464,1345633,2023-06-20,Senate,"Do pass, but first be re-referred to the Committee on [Appropriations]",9,2,0,0,11
1714464,1351833,2023-08-21,Senate,"Placed on suspense file",7,0,0,0,7
1714465,1304360,2023-04-18,Assembly,"Do pass and be re-referred to the Committee on [Appropriations]",11,0,0,0,11
1714466,1302631,2023-04-17,Assembly,"Do pass as amended and be re-referred to the Committee on [Appropriations]",11,0,0,0,11
1714466,1328606,2023-05-18,Assembly,"Do pass",15,0,0,1,16
1714466,1337940,2023-05-31,Assembly,"AB 1548 Hart Assembly Third Reading",80,0,0,0,80
1714466,1349598,2023-07-05,Senate,"Do pass, but first be re-referred to the Committee on [Appropriations] with the recommendation: To Consent Calendar",7,0,0,0,7
1714466,1351309,2023-08-14,Senate,"Placed on suspense file",7,0,0,0,7
1714466,1352599,2023-09-01,Senate,"Do pass",7,0,0,0,7
1714466,1353725,2023-09-12,Senate,"Special Consent AB1548 Hart By Menjivar",39,0,0,1,40
1714467,1310353,2023-04-25,Assembly,"Do pass as amended and be re-referred to the Committee on [Appropriations]",15,0,0,0,15
1714468,1299484,2023-04-12,Assembly,"Do pass as amended and be re-referred to the Committee on [Natural Resources]",11,4,0,0,15
1714468,1310202,2023-04-24,Assembly,"Do pass and be re-referred to the Committee on [Appropriations]",8,3,0,0,11
1714468,1328185,2023-05-18,Assembly,"Do pass as amended",11,4,0,1,16
1714468,1366797,2024-01-18,Assembly,"AB 1550 Bennett Assembly Third Reading Amendment Set #1",36,15,0,29,80
1714469,1304406,2023-04-18,Assembly,"Do pass and be re-referred to the Committee on [Appropriations]",7,0,0,1,8
1714473,1289778,2023-03-29,Assembly,"Do pass as amended and be re-referred to the Committee on [Appropriations]",6,0,0,1,7
1714473,1305499,2023-04-19,Assembly,"Do pass. To Consent Calendar",14,0,0,2,16
1714473,1313496,2023-04-27,Assembly,"AB 1555 Quirk-Silva Consent Calendar Second Day Regular Session",79,0,0,1,80
1714473,1341010,2023-06-07,Senate,"Do pass, but first be re-referred to the Committee on [Appropriations] with the recommendation: To Consent Calendar",7,0,0,0,7
1714473,1348876,2023-06-29,Senate,"Consent Calendar AB1555 Quirk-Silva",39,0,0,1,40
1714475,1298214,2023-04-11,Assembly,"Do pass as amended, and be re-referred to the Committee on [Appropriations] with recommendation: To Consent Calendar",18,0,0,0,18
1714475,1311823,2023-04-26,Assembly,"Do pass. To Consent Calendar",16,0,0,0,16
1714475,1318907,2023-05-04,Assembly,"AB 1557 Flora Consent Calendar Second Day Regular Session",75,0,0,5,80
1714475,1338796,2023-06-05,Senate,"Do pass, but first be re-referred to the Committee on [Appropriations] with the recommendation: To Consent Calendar",13,0,0,0,13
1714475,1348888,2023-06-29,Senate,"Consent Calendar AB1557 Flora et al. Urgency Clause",39,0,0,1,40
1714475,1351683,2023-08-17,Assembly,"AB 1557 Flora Concurrence in Senate Amendments",75,0,0,5,80
1714477,1288300,2023-03-29,Assembly,"Do pass as amended, and be re-referred to the Committee on [Public Safety] with recommendation: To Consent Calendar",8,0,0,0,8
1714477,1310337,2023-04-25,Assembly,"Do pass as amended, and be re-referred to the Committee on [Appropriations] with recommendation: To Consent Calendar",8,0,0,0,8
1714477,1328363,2023-05-18,Assembly,"Do pass",15,0,0,1,16
1714477,1338041,2023-05-31,Assembly,"AB 1559 Jackson Assembly Third Reading",80,0,0,0,80
1714477,1345593,2023-06-20,Senate,"Do pass, but first be re-referred to the Committee on [Public Safety] with the recommendation: To Consent Calendar",7,0,0,0,7
1714477,1350210,2023-07-11,Senate,"Do pass, but first be re-referred to the Committee on [Appropriations] with the recommendation: To Consent Calendar",4,0,0,1,5
1714477,1351384,2023-08-14,Senate,"Placed on suspense file",7,0,0,0,7
1714478,1310227,2023-04-25,Assembly,"Do pass and be re-referred to the Committee on [Appropriations] with recommendation: To Consent Calendar",16,0,0,2,18
1714478,1322876,2023-05-10,Assembly,"Do pass. To Consent Calendar",14,0,0,2,16
1714478,1328097,2023-05-18,Assembly,"AB 1560 Flora Consent Calendar Second Day Regular Session",74,0,0,6,80
1714478,1343115,2023-06-12,Senate,"Do pass, but first be re-referred to the Committee on [Appropriations]",12,0,0,1,13
1714478,1353157,2023-09-05,Senate,"Assembly 3rd Reading AB1560 Flora By Alvarado-Gil",39,0,0,1,40
1714480,1310133,2023-04-25,Assembly,"Do pass and be re-referred to the Committee on [Appropriations] with recommendation: To Consent Calendar",7,0,0,0,7
1714481,1286963,2023-03-28,Assembly,"Do pass and be re-referred to the Committee on [Appropriations]",8,4,0,3,15
1714481,1328354,2023-05-18,Assembly,"Do pass",12,3,0,1,16
1714481,1333679,2023-05-25,Assembly,"AB 1563 Bennett Assembly Third Reading",45,20,0,15,80
1714481,1346994,2023-06-22,Senate,"Do pass, but first be re-referred to the Committee on [Governance and Finance]",7,4,0,0,11
1714482,1298197,2023-04-11,Assembly,"Do pass and be re-referred to the Committee on [Appropriations] with recommendation: To Consent Calendar",18,0,0,0,18
1714483,1304252,2023-04-18,Assembly,"Do pass and be re-referred to the Committee on [Appropriations]",17,0,0,1,18
1714483,1327967,2023-05-18,Assembly,"Do pass",15,0,0,1,16
1714483,1338025,2023-05-31,Assembly,"AB 1565 Jones-Sawyer Assembly Third Reading",74,0,0,6,80
1714483,1349964,2023-07-10,Senate,"Do pass, but first be re-referred to the Committee on [Appropriations]",11,0,0,2,13
1714483,1351845,2023-08-21,Senate,"Placed on suspense file",7,0,0,0,7
1714484,1288385,2023-03-28,Assembly,"Do pass and be re-referred to the Committee on [Appropriations] with recommendation: To Consent Calendar",11,0,0,0,11
1714484,1305377,2023-04-19,Assembly,"Do pass. To Consent Calendar",14,0,0,2,16
1714484,1313314,2023-04-27,Assembly,"AB 1566 Soria Consent Calendar Second Day Regular Session",79,0,0,1,80
1714484,1350174,2023-07-10,Senate,"Do pass, but first be re-referred to the Committee on [Appropriations] with the recommendation: To Consent Calendar",5,0,0,0,5
1714484,1352261,2023-08-24,Senate,"Consent Calendar 2nd AB1566 Soria et al",40,0,0,0,40
1714484,1352338,2023-08-28,Assembly,"AB 1566 Soria Concurrence in Senate Amendments",75,0,0,5,80
1714485,1305407,2023-04-18,Assembly,"Do pass and be re-referred to the Committee on [Natural Resources]",10,2,0,3,15
1714485,1310230,2023-04-24,Assembly,"Do pass as amended and be re-referred to the Committee on [Appropriations]",8,1,0,2,11
1714485,1327944,2023-05-18,Assembly,"Do pass",11,3,0,2,16
1714485,1338076,2023-05-31,Assembly,"AB 1567 Garcia Assembly Third Reading",63,0,0,17,80
1714486,1304408,2023-04-18,Assembly,"Do pass and be re-referred to the Committee on [Appropriations]",7,0,0,1,8
1714486,1328464,2023-05-18,Assembly,"Do pass",15,0,0,1,16
1714486,1337942,2023-05-31,Assembly,"AB 1568 Wood Assembly Third Reading",80,0,0,0,80
1714486,1349664,2023-07-03,Senate,"Do pass, but first be re-referred to the Committee on [Appropriations]",5,0,0,0,5
1714486,1351292,2023-08-14,Senate,"Placed on suspense file",7,0,0,0,7
1714487,1299458,2023-04-12,Assembly,"Do pass and be re-referred to the Committee on [Appropriations] with recommendation: To Consent Calendar",15,0,0,0,15
1714487,1328698,2023-05-18,Assembly,"Do pass as amended",11,0,0,5,16
1714487,1337964,2023-05-31,Assembly,"AB 1569 Garcia Assembly Third Reading",78,0,0,2,80
1714487,1350216,2023-07-10,Senate,"Do pass, but first be re-referred to the Committee on [Appropriations]",16,0,0,2,18
1714487,1351330,2023-08-14,Senate,"Placed on suspense file",7,0,0,0,7
1714488,1363758,2024-01-09,Assembly,"Do pass and be re-referred to the Committee on [Appropriations]",11,3,0,4,18
1714490,1305421,2023-04-18,Assembly,"Do pass as amended and be re-referred to the Committee on [Appropriations]",9,3,0,3,15
1714490,1328833,2023-05-18,Assembly,"Do pass as amended",11,3,0,2,16
1714490,1338157,2023-05-31,Assembly,"AB 1572 Friedman Assembly Third Reading",55,18,0,7,80
1714490,1349505,2023-07-03,Senate,"Do pass as amended, but first amend, and re-refer to the Committee on [Appropriations]",7,2,0,2,11
1714490,1352347,2023-08-28,Senate,"Placed on suspense file",7,0,0,0,7
1714490,1352558,2023-09-01,Senate,"Do pass",5,2,0,0,7
1714490,1354047,2023-09-12,Assembly,"AB 1572 Friedman Concurrence in Senate Amendments",55,18,0,7,80
1714490,1354592,2023-09-11,Senate,"Assembly 3rd Reading AB1572 Friedman et al. By Stern",29,10,0,1,40
1714491,1305412,2023-04-18,Assembly,"Do pass and be re-referred to the Committee on [Appropriations]",9,4,0,2,15
1714491,1328025,2023-05-18,Assembly,"Do pass as amended",11,4,0,1,16
1714491,1338077,2023-05-31,Assembly,"AB 1573 Friedman Assembly Third Reading",56,18,0,6,80
1714491,1349507,2023-07-03,Senate,"Do pass as amended, but first amend, and re-refer to the Committee on [Appropriations]",7,1,0,3,11
1714491,1352349,2023-08-28,Senate,"Placed on suspense file",7,0,0,0,7
1714491,1352763,2023-09-01,Senate,"Do pass as amended",5,2,0,0,7
1714493,1363768,2024-01-09,Assembly,"Do pass and be re-referred to the Committee on [Appropriations]",10,0,0,1,11
1714493,1366756,2024-01-18,Assembly,"Do pass as amended",12,0,0,4,16
1714493,1371104,2024-01-29,Assembly,"AB 1575 Irwin Assembly Third Reading",77,0,0,3,80
1714493,1451561,2024-05-29,Senate,"Do pass, but first be re-referred to the Committee on [Judiciary] with the recommendation: To Consent Calendar",7,0,0,0,7
1714493,1458320,2024-06-18,Senate,"Do pass, but first be re-referred to the Committee on [Appropriations] with the recommendation: To Consent Calendar",10,0,0,1,11
1714493,1463358,2024-08-05,Senate,"Placed on suspense file",7,0,0,0,7
1714493,1464314,2024-08-15,Senate,"Do pass",7,0,0,0,7
1714493,1466258,2024-08-29,Assembly,"AB 1575 Irwin Concurrence in Senate Amendments",76,0,0,3,79
1714493,1466885,2024-08-28,Senate,"Assembly 3rd Reading AB1575 Irwin By Ashby",39,0,0,1,40
1714494,1317031,2023-05-01,Assembly,"Do pass and be re-referred to the Committee on [Appropriations]",11,0,0,0,11
1714495,1310258,2023-04-25,Assembly,"Do pass as amended and be re-referred to the Committee on [Appropriations]",14,0,0,1,15
1714495,1328100,2023-05-18,Assembly,"Do pass",12,2,0,2,16
1714495,1338014,2023-05-31,Assembly,"AB 1577 Low Assembly Third Reading",67,0,0,13,80
1714495,1462555,2024-07-03,Senate,"Do pass, but first be re-referred to the Committee on [Appropriations]",9,2,0,0,11
1714495,1463499,2024-08-05,Senate,"Placed on suspense file",7,0,0,0,7
1714495,1464077,2024-08-15,Senate,"Do pass",5,2,0,0,7
1714495,1466305,2024-08-29,Assembly,"AB 1577 Low Concurrence in Senate Amendments",63,6,0,10,79
1714495,1466790,2024-08-28,Senate,"Assembly 3rd Reading AB1577 Low By Roth",31,8,0,1,40
1714496,1311765,2023-04-26,Assembly,"Do pass and be re-referred to the Committee on [Appropriations] with recommendation: To Consent Calendar",14,0,0,0,14
1714496,1322909,2023-05-10,Assembly,"Do pass. To Consent Calendar",14,0,0,2,16
1714496,1328091,2023-05-18,Assembly,"AB 1578 Valencia Consent Calendar Second Day Regular Session",74,0,0,6,80
1714496,1348497,2023-06-28,Senate,"Do pass, but first be re-referred to the Committee on [Appropriations]",7,0,0,0,7
1714496,1353279,2023-09-06,Senate,"Assembly 3rd Reading AB1578 Valencia By Rubio",40,0,0,0,40
1714497,1305344,2023-04-19,Assembly,"Do pass as amended and be re-referred to the Committee on [Appropriations]",6,0,0,1,7
1714498,1285755,2023-03-27,Assembly,"Do pass and be re-referred to the Committee on [Utilities and Energy] with recommendation: To Consent Calendar",15,0,0,0,15
1714498,1313351,2023-04-26,Assembly,"Do pass as amended, and be re-referred to the Committee on [Appropriations] with recommendation: To Consent Calendar",15,0,0,0,15
1714499,1305333,2023-04-18,Assembly,"Do pass and be re-referred to the Committee on [Appropriations]",14,0,0,1,15
1714499,1328340,2023-05-18,Assembly,"Do pass",15,0,0,1,16
1714499,1338203,2023-05-31,Assembly,"AB 1581 Kalra Assembly Third Reading",80,0,0,0,80
1714499,1460099,2024-06-25,Senate,"Do pass as amended, but first amend, and re-refer to the Committee on [Appropriations]",10,0,0,1,11
1714499,1463655,2024-08-05,Senate,"Placed on suspense file",7,0,0,0,7
1714499,1464177,2024-08-15,Senate,"Do pass as amended",7,0,0,0,7
1714499,1466169,2024-08-29,Assembly,"With recommendation: That Senate amendments be concurred in",12,0,0,3,15
1714499,1466555,2024-08-30,Assembly,"AB 1581 Kalra Concurrence in Senate Amendments",77,0,0,2,79
1714499,1467082,2024-08-28,Senate,"Assembly 3rd Reading AB1581 Kalra et al. By Min",39,0,0,1,40
1714500,1299416,2023-04-11,Assembly,"Do pass and be re-referred to the Committee on [Appropriations]",2,0,0,6,8
1714501,1305284,2023-04-19,Assembly,"Do pass and be re-referred to the Committee on [Appropriations] with recommendation: To Consent Calendar",11,0,0,0,11
1714501,1318077,2023-05-03,Assembly,"Do pass. To Consent Calendar",16,0,0,0,16
1714501,1323789,2023-05-11,Assembly,"AB 1583 Agriculture Consent Calendar Second Day Regular Session",66,0,0,14,80
1714501,1345650,2023-06-19,Senate,"Do pass, but first be re-referred to the Committee on [Appropriations] with the recommendation: To Consent Calendar",4,0,0,0,4
1714501,1350680,2023-07-13,Senate,"Consent Calendar AB1583 AGRI. (Soria)",37,0,0,3,40
1714502,1304302,2023-04-18,Assembly,"Do pass as amended and be re-referred to the Committee on [Appropriations]",6,2,0,0,8
1714502,1328231,2023-05-18,Assembly,"Do pass",11,4,0,1,16
1714502,1337996,2023-05-31,Assembly,"AB 1584 Weber Assembly Third Reading",50,18,0,12,80
1714502,1350128,2023-07-11,Senate,"Do pass, but first be re-referred to the Committee on [Appropriations]",3,1,0,1,5
1714502,1351838,2023-08-21,Senate,"Placed on suspense file",7,0,0,0,7
1714503,1286899,2023-03-28,Assembly,"Do pass and be re-referred to the Committee on [Appropriations]",10,0,0,1,11
1714505,1311723,2023-04-26,Assembly,"Do pass and be re-referred to the Committee on [Appropriations] with recommendation: To Consent Calendar",8,0,0,0,8
1714505,1328268,2023-05-18,Assembly,"Do pass",15,0,0,1,16
1714505,1333702,2023-05-25,Assembly,"AB 1587 Ting Assembly Third Reading",76,0,0,4,80
1714505,1349814,2023-07-05,Senate,"Do pass, but first be re-referred to the Committee on [Judiciary]",5,2,0,0,7
1714505,1350561,2023-07-11,Senate,"Do pass as amended, but first amend, and re-refer to the Committee on [Appropriations]",9,2,0,0,11
1714505,1354172,2023-09-13,Assembly,"With recommendation: That Senate amendments be concurred in",7,2,0,3,12
1714505,1354173,2023-09-13,Assembly,"AB 1587 Ting Concurrence in Senate Amendments",60,15,0,5,80
1714505,1354689,2023-09-11,Senate,"Assembly 3rd Reading AB1587 Ting et al. By Lim√≥n",30,9,0,1,40
1714506,1364107,2024-01-10,Assembly,"Do pass as amended and be re-referred to the Committee on [Appropriations]",7,3,0,1,11
1714506,1366820,2024-01-18,Assembly,"Do pass",12,3,0,1,16
1714506,1367507,2024-01-22,Assembly,"AB 1588 Wilson Assembly Second Reading Amendment Set #1",49,10,0,21,80
1714506,1371099,2024-01-29,Assembly,"AB 1588 Wilson Assembly Third Reading",51,14,0,15,80
1714506,1462306,2024-07-02,Senate,"Do pass as amended, but first amend, and re-refer to the Committee on [Appropriations]",14,4,0,0,18
1714506,1463532,2024-08-05,Senate,"Placed on suspense file",7,0,0,0,7
1714508,1302595,2023-04-17,Assembly,"Do pass as amended and be re-referred to the Committee on [Judiciary]",3,1,0,7,11
1714511,1299477,2023-04-12,Assembly,"Do pass and be re-referred to the Committee on [Appropriations]",7,0,0,0,7
1714511,1328297,2023-05-18,Assembly,"Do pass",15,0,0,1,16
1714511,1337979,2023-05-31,Assembly,"AB 1593 Garcia Assembly Third Reading",79,0,0,1,80
1714511,1350510,2023-07-12,Senate,"Do pass, but first be re-referred to the Committee on [Appropriations]",4,1,0,0,5
1714511,1351415,2023-08-14,Senate,"Placed on suspense file",7,0,0,0,7
1714511,1352559,2023-09-01,Senate,"Do pass",5,2,0,0,7
1714511,1354564,2023-09-11,Senate,"Assembly 3rd Reading AB1593 Garcia et al. By Padilla",32,4,0,4,40
1714512,1310299,2023-04-24,Assembly,"Do pass and be re-referred to the Committee on [Appropriations] with recommendation: To Consent Calendar",15,0,0,0,15
1714512,1328177,2023-05-18,Assembly,"Do pass as amended",11,0,0,5,16
1714512,1337927,2023-05-31,Assembly,"AB 1594 Garcia Assembly Third Reading",80,0,0,0,80
1714512,1349648,2023-07-05,Senate,"Do pass, but first be re-referred to the Committee on [Transportation] with the recommendation: To Consent Calendar",7,0,0,0,7
1714512,1350462,2023-07-11,Senate,"Do pass as amended, but first amend, and re-refer to the Committee on [Appropriations] with the recommendation: To Consent Calendar",16,0,0,0,16
1714512,1351339,2023-08-14,Senate,"Placed on suspense file",7,0,0,0,7
1714512,1352761,2023-09-01,Senate,"Do pass as amended",7,0,0,0,7
1714512,1354383,2023-09-13,Senate,"Assembly 3rd Reading AB1594 Garcia et al. By Bradford",34,1,0,5,40
1714512,1354384,2023-09-13,Assembly,"AB 1594 Garcia Concurrence in Senate Amendments",78,0,0,2,80
1714513,1305321,2023-04-19,Assembly,"Do pass and be re-referred to the Committee on [Appropriations]",6,2,0,0,8
1714513,1328778,2023-05-18,Assembly,"Do pass",11,4,0,1,16
1714515,1305379,2023-04-18,Assembly,"Do pass and be re-referred to the Committee on [Judiciary] with recommendation: To Consent Calendar",9,0,0,0,9
1714515,1310288,2023-04-25,Assembly,"Do pass and be re-referred to the Committee on [Appropriations] with recommendation: To Consent Calendar",11,0,0,0,11
1714515,1328649,2023-05-18,Assembly,"Do pass as amended",11,0,0,5,16
1714515,1338009,2023-05-31,Assembly,"AB 1597 Alvarez Assembly Third Reading",79,0,0,1,80
1714515,1458394,2024-06-19,Senate,"Do pass, but first be re-referred to the Committee on [Judiciary] with the recommendation: To Consent Calendar",7,0,0,0,7
1714515,1462548,2024-07-02,Senate,"Do pass as amended, but first amend, and re-refer to the Committee on [Appropriations]",11,0,0,0,11
1714515,1463674,2024-08-05,Senate,"Placed on suspense file",7,0,0,0,7
1714516,1304291,2023-04-18,Assembly,"Do pass and be re-referred to the Committee on [Appropriations]",6,2,0,0,8
1714516,1326958,2023-05-17,Assembly,"Do pass",12,4,0,0,16
1714516,1330142,2023-05-22,Assembly,"AB 1598 Berman Assembly Third Reading",63,13,0,4,80
1714516,1343777,2023-06-13,Senate,"Do pass, but first be re-referred to the Committee on [Appropriations]",4,0,0,1,5
1714516,1353844,2023-09-12,Assembly,"AB 1598 Berman Concurrence in Senate Amendments",65,12,0,3,80
1714516,1354656,2023-09-11,Senate,"Assembly 3rd Reading AB1598 Berman et al. By Rubio",30,5,0,5,40
1714521,1305245,2023-04-19,Assembly,"Do pass and be re-referred to the Committee on [Appropriations]",11,0,0,0,11
1714521,1328505,2023-05-18,Assembly,"Do pass",15,0,0,1,16
1714521,1337943,2023-05-31,Assembly,"AB 1603 Alvarez Assembly Third Reading",80,0,0,0,80
1714521,1349443,2023-07-03,Senate,"Do pass, but first be re-referred to the Committee on [Appropriations] with the recommendation: To Consent Calendar",3,0,0,1,4
1714521,1351402,2023-08-14,Senate,"Placed on suspense file",7,0,0,0,7
1714522,1313490,2023-04-26,Assembly,"Do pass as amended and be re-referred to the Committee on [Appropriations]",5,2,0,0,7
1714522,1328603,2023-05-18,Assembly,"Do pass",11,4,0,1,16
1714522,1337188,2023-06-01,Assembly,"AB 1604 Bonta Assembly Third Reading",51,18,0,11,80
1714522,1350538,2023-07-12,Senate,"Do pass as amended, but first amend, and re-refer to the Committee on [Appropriations]",4,2,0,1,7
1714522,1351461,2023-08-14,Senate,"Placed on suspense file",7,0,0,0,7
1714522,1353010,2023-09-01,Senate,"Do pass as amended",5,2,0,0,7
1714522,1354081,2023-09-13,Senate,"Assembly 3rd Reading AB1604 Bonta By Newman",26,10,0,4,40
1714522,1354648,2023-09-14,Assembly,"AB 1604 Bonta Concurrence in Senate Amendments",46,18,0,16,80
1714523,1300985,2023-04-12,Assembly,"Do pass as amended and be re-referred to the Committee on [Appropriations]",5,1,0,1,7
1714523,1328543,2023-05-18,Assembly,"Do pass",15,0,0,1,16
1714523,1338205,2023-05-31,Assembly,"AB 1605 Gallagher Assembly Third Reading",78,1,0,1,80
1714523,1346286,2023-06-21,Senate,"Do pass, but first be re-referred to the Committee on [Military and Veterans Affairs] with the recommendation: To Consent Calendar",7,0,0,0,7
1714523,1350127,2023-07-10,Senate,"Do pass, but first be re-referred to the Committee on [Appropriations] with the recommendation: To Consent Calendar",5,0,0,0,5
1714523,1351663,2023-08-17,Senate,"Consent Calendar 2nd AB1605 Gallagher et al",38,0,0,2,40
1714524,1310247,2023-04-24,Assembly,"Do pass as amended and be re-referred to the Committee on [Appropriations]",15,0,0,0,15
1714524,1328287,2023-05-18,Assembly,"Do pass",15,0,0,1,16
1714524,1337932,2023-05-31,Assembly,"AB 1606 Gipson Assembly Third Reading",80,0,0,0,80
1714524,1350488,2023-07-11,Senate,"Do pass, but first be re-referred to the Committee on [Appropriations] with the recommendation: To Consent Calendar",16,0,0,0,16
1714524,1351428,2023-08-14,Senate,"Placed on suspense file",7,0,0,0,7
1714524,1352986,2023-09-01,Senate,"Do pass",7,0,0,0,7
1714524,1353936,2023-09-12,Assembly,"AB 1606 Gipson Concurrence in Senate Amendments",80,0,0,0,80
1714524,1354622,2023-09-11,Senate,"Assembly 3rd Reading AB1606 Gipson By Lim√≥n",39,0,0,1,40
1714525,1305311,2023-04-19,Assembly,"Do pass as amended and be re-referred to the Committee on [Local Government]",8,0,0,0,8
1714525,1313414,2023-04-26,Assembly,"Do pass and be re-referred to the Committee on [Appropriations]",8,0,0,0,8
1714525,1327985,2023-05-18,Assembly,"Do pass",15,0,0,1,16
1714525,1337929,2023-05-31,Assembly,"AB 1607 Wendy Carrillo Assembly Third Reading",80,0,0,0,80
1714525,1346200,2023-06-20,Senate,"Do pass, but first be re-referred to the Committee on [Governance and Finance]",9,0,0,2,11
1714525,1350678,2023-07-12,Senate,"Do pass",6,0,0,2,8
1714525,1353320,2023-09-06,Senate,"Assembly 3rd Reading AB1607 Wendy Carrillo By Gonzalez",31,9,0,0,40
1714525,1353355,2023-09-07,Assembly,"AB 1607 Wendy Carrillo Concurrence in Senate Amendments",71,5,0,4,80
1714527,1310342,2023-04-24,Assembly,"Do pass and be re-referred to the Committee on [Appropriations]",10,3,0,2,15
1714528,1304437,2023-04-18,Assembly,"Do pass and be re-referred to the Committee on [Appropriations] with recommendation: To Consent Calendar",17,0,0,1,18
1714528,1328739,2023-05-18,Assembly,"Do pass",15,0,0,1,16
1714528,1338019,2023-05-31,Assembly,"AB 1610 Jones-Sawyer Assembly Third Reading",80,0,0,0,80
1714528,1459391,2024-06-24,Senate,"Do pass, but first be re-referred to the Committee on [Appropriations]",12,0,0,1,13
1714528,1463563,2024-08-05,Senate,"Placed on suspense file",7,0,0,0,7
1714529,1305301,2023-04-18,Assembly,"Do pass and be re-referred to the Committee on [Appropriations] with recommendation: To Consent Calendar",15,0,0,0,15
1714529,1322862,2023-05-10,Assembly,"Do pass. To Consent Calendar",14,0,0,2,16
1714529,1328509,2023-05-18,Assembly,"AB 1611 Lowenthal Consent Calendar Second Day Regular Session",74,0,0,6,80
1714529,1346950,2023-06-22,Senate,"Do pass, but first be re-referred to the Committee on [Appropriations] with the recommendation: To Consent Calendar",11,0,0,0,11
1714529,1350633,2023-07-13,Senate,"Consent Calendar AB1611 Lowenthal",37,0,0,3,40
1714530,1304355,2023-04-18,Assembly,"Do pass and be re-referred to the Committee on [Appropriations] with recommendation: To Consent Calendar",15,0,0,0,15
1714530,1322902,2023-05-10,Assembly,"Do pass. To Consent Calendar",14,0,0,2,16
1714530,1328483,2023-05-18,Assembly,"AB 1612 Pacheco Consent Calendar Second Day Regular Session",74,0,0,6,80
1714530,1350622,2023-07-12,Senate,"Do pass, but first be re-referred to the Committee on [Appropriations] with the recommendation: To Consent Calendar",11,0,0,1,12
1714530,1353177,2023-09-05,Senate,"Assembly 3rd Reading AB1612 Pacheco et al. By Lim√≥n",39,0,0,1,40
1714530,1353634,2023-09-11,Assembly,"AB 1612 Pacheco Concurrence in Senate Amendments",80,0,0,0,80
1714532,1310286,2023-04-24,Assembly,"Do pass as amended and be re-referred to the Committee on [Appropriations]",11,4,0,0,15
1714532,1328355,2023-05-18,Assembly,"Do pass",11,4,0,1,16
1714532,1338179,2023-05-31,Assembly,"AB 1614 Gabriel Assembly Third Reading",59,18,0,3,80
1714532,1349494,2023-07-03,Senate,"Do pass, but first be re-referred to the Committee on [Transportation]",12,1,0,5,18
1714532,1350456,2023-07-11,Senate,"Do pass as amended, but first amend, and re-refer to the Committee on [Appropriations]",12,3,0,1,16
1714532,1351260,2023-08-14,Senate,"Placed on suspense file",7,0,0,0,7
1714532,1352769,2023-09-01,Senate,"Do pass as amended",5,2,0,0,7
1714532,1353977,2023-09-12,Assembly,"AB 1614 Gabriel Concurrence in Senate Amendments",61,17,0,2,80
1714532,1354760,2023-09-11,Senate,"Assembly 3rd Reading AB1614 Gabriel et al. By Stern",30,9,0,1,40
1714534,1298249,2023-04-11,Assembly,"Do pass and be re-referred to the Committee on [Appropriations] with recommendation: To Consent Calendar",18,0,0,0,18
1714534,1328730,2023-05-18,Assembly,"Do pass",15,0,0,1,16
1714534,1338011,2023-05-31,Assembly,"AB 1616 Lackey Assembly Third Reading",79,0,0,1,80
1714534,1347539,2023-06-26,Senate,"Do pass, but first be re-referred to the Committee on [Public Safety]",9,2,0,2,13
1714538,1305538,2023-04-19,Assembly,"Do pass as amended",6,1,0,1,8
1714538,1338133,2023-05-31,Assembly,"AB 1620 Zbur Assembly Third Reading",56,18,0,6,80
1714538,1350493,2023-07-11,Senate,"Do pass",10,1,0,0,11
1714538,1353212,2023-09-06,Senate,"Assembly 3rd Reading AB1620 Zbur et al. By Allen",29,8,0,3,40
1714538,1353667,2023-09-11,Assembly,"AB 1620 Zbur Concurrence in Senate Amendments",58,17,0,5,80
1714541,1313307,2023-04-26,Assembly,"Do pass as amended and be re-referred to the Committee on [Appropriations]",12,0,0,3,15
1714544,1299514,2023-04-12,Assembly,"Do pass as amended, and be re-referred to the Committee on [Transportation] with recommendation: To Consent Calendar",15,0,0,0,15
1714544,1310305,2023-04-24,Assembly,"Do pass and be re-referred to the Committee on [Appropriations] with recommendation: To Consent Calendar",15,0,0,0,15
1714545,1288221,2023-03-28,Assembly,"Do pass and be re-referred to the Committee on [Appropriations] with recommendation: To Consent Calendar",9,0,0,0,9
1714545,1305279,2023-04-19,Assembly,"Do pass. To Consent Calendar",14,0,0,2,16
1714545,1313472,2023-04-27,Assembly,"AB 1627 Lee Consent Calendar Second Day Regular Session",79,0,0,1,80
1714545,1341034,2023-06-07,Senate,"Do pass, but first be re-referred to the Committee on [Appropriations]",6,0,0,1,7
1714545,1351672,2023-08-17,Senate,"Assembly 3rd Reading AB1627 Lee By Dahle",38,0,0,2,40
1714545,1352256,2023-08-24,Assembly,"AB 1627 Lee Concurrence in Senate Amendments",74,0,0,6,80
1714546,1288189,2023-03-28,Assembly,"Do pass and be re-referred to the Committee on [Appropriations]",7,2,0,0,9
1714546,1328071,2023-05-18,Assembly,"Do pass",11,4,0,1,16
1714546,1338153,2023-05-31,Assembly,"AB 1628 McKinnor Assembly Third Reading",63,14,0,3,80
1714546,1350511,2023-07-12,Senate,"Do pass as amended, but first amend, and re-refer to the Committee on [Appropriations]",5,2,0,0,7
1714546,1352334,2023-08-28,Senate,"Placed on suspense file",7,0,0,0,7
1714546,1352750,2023-09-01,Senate,"Do pass as amended",5,2,0,0,7
1714546,1353732,2023-09-12,Senate,"Assembly 3rd Reading AB1628 McKinnor et al. By Allen",28,8,0,4,40
1714546,1354393,2023-09-13,Assembly,"AB 1628 McKinnor Concurrence in Senate Amendments",63,15,0,2,80
1714549,1305495,2023-04-18,Assembly,"Do pass and be re-referred to the Committee on [Appropriations]",8,3,0,4,15
1714549,1322923,2023-05-10,Assembly,"Do pass",12,3,0,1,16
1714549,1335541,2023-05-30,Assembly,"AB 1631 Schiavo Assembly Third Reading",49,17,0,14,80
1714549,1349945,2023-07-10,Senate,"Do pass, but first be re-referred to the Committee on [Appropriations]",7,0,0,4,11
1714549,1353219,2023-09-06,Senate,"Assembly 3rd Reading AB1631 Schiavo et al. By Wilk",30,2,0,8,40
1714551,1299365,2023-04-12,Assembly,"Do pass as amended and be re-referred to the Committee on [Natural Resources]",8,0,0,0,8
1714551,1310225,2023-04-24,Assembly,"Do pass as amended and be re-referred to the Committee on [Appropriations]",8,0,0,3,11
1714551,1328468,2023-05-18,Assembly,"Do pass",15,0,0,1,16
1714551,1337970,2023-05-31,Assembly,"AB 1633 Ting Assembly Third Reading",70,1,0,9,80
1714551,1346171,2023-06-20,Senate,"Do pass, but first be re-referred to the Committee on [Environmental Quality]",11,0,0,0,11
1714551,1350467,2023-07-12,Senate,"Do pass as amended, but first amend, and re-refer to the Committee on [Appropriations]",7,0,0,0,7
1714551,1351375,2023-08-14,Senate,"Placed on suspense file",7,0,0,0,7
1714551,1352562,2023-09-01,Senate,"Do pass as amended",7,0,0,0,7
1714551,1354152,2023-09-13,Senate,"Assembly 3rd Reading AB1633 Ting et al. By Wiener",21,3,0,16,40
1714551,1354153,2023-09-13,Assembly,"AB 1633 TING Concurrence in Senate Amendments",67,2,0,11,80
1714553,1363950,2024-01-10,Assembly,"Do pass and be re-referred to the Committee on [Appropriations]",8,0,0,0,8
1714553,1366806,2024-01-18,Assembly,"Do pass as amended",12,2,0,2,16
1714553,1371125,2024-01-29,Assembly,"AB 1635 Ward Assembly Third Reading",70,0,0,10,80
1714553,1459970,2024-06-25,Senate,"Do pass as amended, but first amend, and re-refer to the Committee on [Appropriations]",12,2,0,2,16
1714553,1463641,2024-08-05,Senate,"Placed on suspense file",7,0,0,0,7
1714553,1464467,2024-08-15,Senate,"Do pass",4,2,0,1,7
1714555,1307867,2023-04-19,Assembly,"Do pass and be re-referred to the Committee on [Privacy and Consumer Protection]",5,0,0,2,7
1714555,1311936,2023-04-25,Assembly,"Do pass as amended and be re-referred to the Committee on [Appropriations]",9,0,0,2,11
1714555,1328782,2023-05-18,Assembly,"Do pass as amended",12,2,0,2,16
1714555,1338121,2023-05-31,Assembly,"AB 1637 Irwin Assembly Third Reading",56,4,0,20,80
1714555,1348281,2023-06-28,Senate,"Do pass as amended, but first amend, and re-refer to the Committee on [Appropriations]",5,2,0,1,8
1714555,1349971,2023-07-10,Senate,"Placed on suspense file",6,0,0,1,7
1714555,1352985,2023-09-01,Senate,"Do pass",5,2,0,0,7
1714555,1353822,2023-09-12,Senate,"Assembly 3rd Reading AB1637 Irwin By Blakespear",24,8,0,8,40
1714555,1354381,2023-09-13,Assembly,"AB 1637 Irwin Concurrence in Senate Amendments",60,12,0,8,80
1714556,1304422,2023-04-17,Assembly,"Do pass and be re-referred to the Committee on [Appropriations] with recommendation: To Consent Calendar",7,0,0,0,7
1714556,1328290,2023-05-18,Assembly,"Do pass",15,0,0,1,16
1714556,1338175,2023-05-31,Assembly,"AB 1638 Mike Fong Assembly Third Reading",80,0,0,0,80
1714556,1350710,2023-07-12,Senate,"Do pass as amended, but first amend, and re-refer to the Committee on [Appropriations]",8,0,0,0,8
1714556,1351470,2023-08-14,Senate,"Placed on suspense file",7,0,0,0,7
1714556,1353080,2023-09-01,Senate,"Do pass as amended",7,0,0,0,7
1714556,1353333,2023-09-06,Senate,"Assembly 3rd Reading AB1638 Mike Fong",40,0,0,0,40
1714556,1353382,2023-09-07,Assembly,"AB 1638 Mike Fong Concurrence in Senate Amendments",76,0,0,4,80
1714560,1301049,2023-04-12,Assembly,"Do pass and be re-referred to the Committee on [Appropriations] with recommendation: To Consent Calendar",7,0,0,0,7
1714560,1328669,2023-05-18,Assembly,"Do pass",15,0,0,1,16
1714560,1337931,2023-05-31,Assembly,"AB 1642 Gipson Assembly Third Reading",80,0,0,0,80
1714560,1348488,2023-06-28,Senate,"Do pass, but first be re-referred to the Committee on [Natural Resources and Water] with the recommendation: To Consent Calendar",7,0,0,0,7
1714560,1349937,2023-07-10,Senate,"Do pass as amended, but first amend, and re-refer to the Committee on [Appropriations] with the recommendation: To Consent Calendar",10,0,0,1,11
1714560,1351371,2023-08-14,Senate,"Placed on suspense file",7,0,0,0,7
1714561,1299462,2023-04-11,Assembly,"Do pass and be re-referred to the Committee on [Appropriations]",7,0,0,1,8
1714561,1318059,2023-05-03,Assembly,"Do pass",12,4,0,0,16
1714561,1320493,2023-05-08,Assembly,"AB 1643 Bauer-Kahan Assembly Third Reading",56,8,0,16,80
1714561,1340000,2023-06-06,Senate,"Do pass, but first be re-referred to the Committee on [Appropriations]",5,0,0,0,5
1714561,1353130,2023-09-05,Senate,"Assembly 3rd Reading AB1643 Bauer-Kahan et al. By Menjivar",31,8,0,1,40
1714562,1310211,2023-04-25,Assembly,"Do pass as amended and be re-referred to the Committee on [Appropriations]",12,0,0,3,15
1714563,1310380,2023-04-25,Assembly,"Do pass as amended and be re-referred to the Committee on [Appropriations]",12,0,0,3,15
1714563,1328624,2023-05-18,Assembly,"Do pass",11,2,0,3,16
1714563,1338138,2023-05-31,Assembly,"AB 1645 Zbur Assembly Third Reading",64,10,0,6,80
1714563,1350643,2023-07-12,Senate,"Do pass as amended, but first amend, and re-refer to the Committee on [Appropriations]",10,1,0,1,12
1714563,1351511,2023-08-14,Senate,"Placed on suspense file",7,0,0,0,7
1714563,1352934,2023-09-01,Senate,"Do pass",5,2,0,0,7
1714563,1354045,2023-09-12,Senate,"Assembly 3rd Reading AB1645 Zbur By Eggman",31,7,0,2,40
1714563,1354288,2023-09-13,Assembly,"AB 1645 Zbur Concurrence in Senate Amendments",64,8,0,8,80
1714564,1310238,2023-04-25,Assembly,"Do pass as amended and be re-referred to the Committee on [Appropriations]",13,3,0,2,18
1714564,1322900,2023-05-10,Assembly,"Do pass",12,3,0,1,16
1714564,1328266,2023-05-18,Assembly,"AB 1646 Stephanie Nguyen Assembly Third Reading",61,13,0,6,80
1714564,1345202,2023-06-19,Senate,"Do pass, but first be re-referred to the Committee on [Appropriations]",9,3,0,1,13
1714564,1353991,2023-09-12,Senate,"Assembly 3rd Reading AB1646 Stephanie Nguyen et By Atkins",31,7,0,2,40
1714564,1354181,2023-09-13,Assembly,"AB 1646 Stephanie Nguyen Concurrence in Senate Amendments",64,15,0,1,80
1714565,1288304,2023-03-28,Assembly,"Do pass and be re-referred to the Committee on [Public Safety]",11,0,0,0,11
1714565,1310378,2023-04-25,Assembly,"Do pass as amended, and be re-referred to the Committee on [Appropriations] with recommendation: To Consent Calendar",8,0,0,0,8
1714565,1328663,2023-05-18,Assembly,"Do pass",15,0,0,1,16
1714565,1333718,2023-05-25,Assembly,"AB 1647 Soria Assembly Third Reading",75,0,0,5,80
1714567,1281927,2023-03-22,Assembly,"Do pass",7,0,0,1,8
1714567,1306793,2023-04-20,Assembly,"AB 1649 Kalra Assembly Third Reading",77,0,0,3,80
1714567,1341001,2023-06-07,Senate,"Do pass",7,0,0,1,8
1714567,1353111,2023-09-05,Senate,"Assembly 3rd Reading AB1649 Kalra By Cortese",39,0,0,1,40
1714568,1317043,2023-05-02,Assembly,"Do pass as amended. To Consent Calendar",11,0,0,0,11
1714568,1323786,2023-05-11,Assembly,"AB 1650 Jim Patterson Consent Calendar Second Day Regular Session",66,0,0,14,80
1714568,1348404,2023-06-27,Senate,"Do pass as amended, and be ordered to the Consent Calendar",11,0,0,0,11
1714568,1354417,2023-09-13,Senate,"Assembly 3rd Reading AB1650 Jim Patterson By Jones",39,0,0,1,40
1714568,1354524,2023-09-14,Assembly,"AB 1650 Jim Patterson Concurrence in Senate Amendments",80,0,0,0,80
1714569,1301026,2023-04-12,Assembly,"Do pass and be re-referred to the Committee on [Appropriations] with recommendation: To Consent Calendar",7,0,0,0,7
1714569,1311839,2023-04-26,Assembly,"Do pass. To Consent Calendar",16,0,0,0,16
1714569,1318988,2023-05-04,Assembly,"AB 1651 Sanchez Consent Calendar Second Day Regular Session",75,0,0,5,80
1714569,1344200,2023-06-14,Senate,"Do pass, but first be re-referred to the Committee on [Appropriations]",7,0,0,0,7
1714569,1347546,2023-06-26,Senate,"Placed on suspense file",6,0,0,1,7
1714569,1352589,2023-09-01,Senate,"Do pass",7,0,0,0,7
1714569,1353805,2023-09-12,Senate,"Special Consent AB1651 Sanchez et al. By Archuleta",39,0,0,1,40
1714571,1289828,2023-03-29,Assembly,"Do pass as amended, and be re-referred to the Committee on [Appropriations] with recommendation: To Consent Calendar",6,0,0,1,7
1714571,1328549,2023-05-18,Assembly,"Do pass",15,0,0,1,16
1714571,1338118,2023-05-31,Assembly,"AB 1653 Sanchez Assembly Third Reading",80,0,0,0,80
1714571,1348323,2023-06-28,Senate,"Do pass, but first be re-referred to the Committee on [Appropriations] with the recommendation: To Consent Calendar",7,0,0,0,7
1714571,1351471,2023-08-14,Senate,"Placed on suspense file",7,0,0,0,7
1714571,1352943,2023-09-01,Senate,"Do pass",7,0,0,0,7
1714571,1354316,2023-09-13,Senate,"Assembly 3rd Reading AB1653 Sanchez By Hurtado",39,0,0,1,40
1714571,1354769,2023-09-14,Assembly,"AB 1653 Sanchez Concurrence in Senate Amendments",80,0,0,0,80
1714575,1311931,2023-04-26,Assembly,"Do pass and be re-referred to the Committee on [Appropriations]",6,1,0,1,8
1714575,1328022,2023-05-18,Assembly,"Do pass",11,3,0,2,16
1714575,1338016,2023-05-31,Assembly,"AB 1657 Wicks Third Reading Urgency",61,13,0,6,80
1714575,1346219,2023-06-20,Senate,"Do pass, but first be re-referred to the Committee on [Governance and Finance]",9,2,0,0,11
1714575,1350671,2023-07-12,Senate,"Do pass, but first be re-referred to the Committee on [Appropriations]",6,2,0,0,8
1714575,1351403,2023-08-14,Senate,"Placed on suspense file",7,0,0,0,7
1714576,1299524,2023-04-12,Assembly,"Do pass and be re-referred to the Committee on [Appropriations] with recommendation: To Consent Calendar",19,0,0,3,22
1714576,1326916,2023-05-17,Assembly,"Do pass. To Consent Calendar",15,0,0,1,16
1714576,1333666,2023-05-25,Assembly,"AB 1658 Santiago Consent Calendar Second Day Regular Session",76,0,0,4,80
1714576,1347796,2023-06-27,Senate,"Do pass, but first be re-referred to the Committee on [Appropriations] with the recommendation: To Consent Calendar",15,0,0,0,15
1714576,1353188,2023-09-05,Senate,"Assembly 3rd Reading AB1658 Santiago et al. By Dodd Urgency Clause",39,0,0,1,40
1714576,1353641,2023-09-11,Assembly,"AB 1658 Santiago Concurrence - Urgency Added",80,0,0,0,80
1714577,1298287,2023-04-11,Assembly,"Do pass as amended and be re-referred to the Committee on [Judiciary]",10,0,0,1,11
1714577,1304323,2023-04-18,Assembly,"Do pass and be re-referred to the Committee on [Appropriations] with recommendation: To Consent Calendar",11,0,0,0,11
1714577,1328878,2023-05-18,Assembly,"Do pass",15,0,0,1,16
1714577,1337910,2023-05-31,Assembly,"AB 1659 Gabriel Assembly Third Reading",78,0,0,2,80
1714577,1349538,2023-07-03,Senate,"Do pass, but first be re-referred to the Committee on [Judiciary]",9,2,0,2,13
1714577,1350496,2023-07-11,Senate,"Do pass, but first be re-referred to the Committee on [Appropriations]",10,1,0,0,11
1714577,1351834,2023-08-21,Senate,"Placed on suspense file",7,0,0,0,7
1714582,1299399,2023-04-12,Assembly,"Do pass and be re-referred to the Committee on [Appropriations]",15,0,0,0,15
1714583,1305235,2023-04-18,Assembly,"Do pass and be re-referred to the Committee on [Appropriations] with recommendation: To Consent Calendar",11,0,0,0,11
1714583,1318069,2023-05-03,Assembly,"Do pass. To Consent Calendar",16,0,0,0,16
1714583,1323887,2023-05-11,Assembly,"AB 1665 Soria Consent Calendar Second Day Regular Session",66,0,0,14,80
1714583,1350126,2023-07-10,Senate,"Do pass, but first be re-referred to the Committee on [Appropriations]",5,0,0,0,5
1714585,1311909,2023-04-25,Assembly,"Do pass and be re-referred to the Committee on [Appropriations] with recommendation: To Consent Calendar",11,0,0,0,11
1714586,1281905,2023-03-22,Assembly,"Do pass and be re-referred to the Committee on [Appropriations]",20,0,0,2,22
1714586,1305506,2023-04-19,Assembly,"Do pass. To Consent Calendar",14,0,0,2,16
1714586,1313367,2023-04-27,Assembly,"AB 1668 Joe Patterson Consent Calendar Second Day Regular Session",79,0,0,1,80
1714586,1343781,2023-06-13,Senate,"Do pass, but first be re-referred to the Committee on [Appropriations]",14,0,0,1,15
1714586,1353151,2023-09-05,Senate,"Assembly 3rd Reading AB1668 Joe Patterson et al. By Niello",39,0,0,1,40
1714586,1353414,2023-09-07,Assembly,"AB 1668 Joe Patterson Concurrence in Senate Amendments",79,0,0,1,80
1714587,1298212,2023-04-11,Assembly,"Do pass and be re-referred to the Committee on [Jobs, Economic Development, and the Economy]",7,0,0,0,7
1714587,1310220,2023-04-25,Assembly,"Do pass and be re-referred to the Committee on [Appropriations] with recommendation: To Consent Calendar",7,0,0,0,7
1714588,1310289,2023-04-25,Assembly,"Do pass and be re-referred to the Committee on [Appropriations]",11,0,0,4,15
1714590,1299412,2023-04-12,Assembly,"Do pass and be re-referred to the Committee on [Appropriations]",6,0,0,1,7
1714590,1328370,2023-05-18,Assembly,"Do pass",13,1,0,2,16
1714590,1338098,2023-05-31,Assembly,"AB 1672 Haney Assembly Third Reading",67,6,0,7,80
1714591,1311674,2023-04-26,Assembly,"Do pass and be re-referred to the Committee on [Appropriations]",22,0,0,0,22
1714591,1328322,2023-05-18,Assembly,"Do pass",15,0,0,1,16
1714591,1337954,2023-05-31,Assembly,"AB 1673 Pacheco Assembly Third Reading",79,0,0,1,80
1714591,1348325,2023-06-27,Senate,"Do pass, but first be re-referred to the Committee on [Appropriations] with the recommendation: To Consent Calendar",16,0,0,0,16
1714591,1350676,2023-07-13,Senate,"Consent Calendar AB1673 Pacheco et al",37,0,0,3,40
1714591,1353887,2023-09-12,Assembly,"AB 1673 Pacheco Concurrence in Senate Amendments",79,0,0,1,80
1714591,1354646,2023-09-11,Senate,"Assembly 3rd Reading AB1673 Pacheco et al. By Rubio",39,0,0,1,40
1714593,1304320,2023-04-18,Assembly,"Do pass and be re-referred to the Committee on [Appropriations] with recommendation: To Consent Calendar",7,0,0,1,8
1714595,1311738,2023-04-26,Assembly,"Do pass and be re-referred to the Committee on [Appropriations]",5,1,0,1,7
1714595,1328564,2023-05-18,Assembly,"Do pass",11,4,0,1,16
1714595,1338129,2023-05-31,Assembly,"AB 1677 McKinnor Assembly Third Reading",65,12,0,3,80
1714595,1348496,2023-06-28,Senate,"Do pass, but first be re-referred to the Committee on [Appropriations]",4,1,0,0,5
1714595,1349913,2023-07-10,Senate,"Placed on suspense file",6,0,0,1,7
1714595,1352832,2023-09-01,Senate,"Do pass",5,2,0,0,7
1714595,1353406,2023-09-07,Senate,"Assembly 3rd Reading AB1677 McKinnor et al. By Durazo",32,8,0,0,40
1714595,1353830,2023-09-12,Assembly,"AB 1677 McKinnor Concurrence in Senate Amendments",65,5,0,10,80
1714597,1281849,2023-03-22,Assembly,"Do pass. To Consent Calendar",20,0,0,2,22
1714597,1289839,2023-03-30,Assembly,"AB 1679 Santiago Consent Calendar Second Day Regular Session",60,0,0,20,80
1714597,1350626,2023-07-12,Senate,"Do pass as amended",6,2,0,0,8
1714597,1353298,2023-09-06,Senate,"Assembly 3rd Reading AB1679 Santiago By Smallwood-Cuevas",30,9,0,1,40
1714597,1353740,2023-09-12,Assembly,"With recommendation: That Senate amendments be concurred in",5,1,0,2,8
1714597,1354404,2023-09-13,Assembly,"AB 1679 Santiago Concurrence in Senate Amendments",53,18,0,9,80
1714602,1318079,2023-05-03,Assembly,"Do pass",8,0,0,0,8
1714602,1320554,2023-05-08,Assembly,"AB 1684 Maienschein Assembly Third Reading",71,0,0,9,80
1714602,1344183,2023-06-14,Senate,"Do pass as amended, but first amend, and re-refer to the Committee on [Judiciary]",8,0,0,0,8
1714602,1350440,2023-07-11,Senate,"Do pass as amended",11,0,0,0,11
1714602,1353823,2023-09-12,Assembly,"AB 1684 Maienschein Concurrence in Senate Amendments",79,0,0,1,80
1714602,1354876,2023-09-11,Senate,"Assembly 3rd Reading AB1684 Maienschein By Umberg",39,0,0,1,40
1714604,1301986,2023-04-10,Assembly,"Do pass and be re-referred to the Committee on [Appropriations]",11,0,0,0,11
1714604,1311728,2023-04-26,Assembly,"Do pass. To Consent Calendar",16,0,0,0,16
1714604,1318981,2023-05-04,Assembly,"AB 1686 Grayson Consent Calendar Second Day Regular Session",75,0,0,5,80
1714604,1346977,2023-06-22,Senate,"Do pass as amended, but first amend, and re-refer to the Committee on [Appropriations] with the recommendation: To Consent Calendar",11,0,0,0,11
1714604,1350663,2023-07-13,Senate,"Consent Calendar AB1686 Grayson",37,0,0,3,40
1714604,1351484,2023-08-14,Assembly,"AB 1686 Grayson Concurrence in Senate Amendments",78,0,0,2,80
1714606,1305251,2023-04-19,Assembly,"Do pass and be re-referred to the Committee on [Appropriations]",7,0,0,1,8
1714606,1328599,2023-05-18,Assembly,"Do pass",15,0,0,1,16
1714606,1337973,2023-05-31,Assembly,"AB 1688 Sanchez Assembly Third Reading",80,0,0,0,80
1714606,1349797,2023-07-05,Senate,"Do pass, but first be re-referred to the Committee on [Appropriations]",7,0,0,0,7
1714606,1351268,2023-08-14,Senate,"Placed on suspense file",7,0,0,0,7
1714611,1363749,2024-01-09,Assembly,"Do pass and be re-referred to the Committee on [Appropriations]",7,0,0,0,7
1714613,1301017,2023-04-12,Assembly,"Do pass as amended and be re-referred to the Committee on [Higher Education]",7,0,0,0,7
1714613,1311934,2023-04-25,Assembly,"Do pass and be re-referred to the Committee on [Appropriations]",12,0,0,0,12
1714613,1328350,2023-05-18,Assembly,"Do pass",15,0,0,1,16
1714613,1338152,2023-05-31,Assembly,"AB 1695 Gipson Assembly Third Reading",80,0,0,0,80
1714613,1348493,2023-06-28,Senate,"Do pass as amended, but first amend, and re-refer to the Committee on [Appropriations]",7,0,0,0,7
1714613,1351482,2023-08-14,Senate,"Placed on suspense file",7,0,0,0,7
1714613,1352727,2023-09-01,Senate,"Do pass",7,0,0,0,7
1714613,1353777,2023-09-12,Senate,"Special Consent AB1695 Gipson",39,0,0,1,40
1714614,1288255,2023-03-28,Assembly,"Do pass and be re-referred to the Committee on [Appropriations]",14,0,0,1,15
1714614,1311890,2023-04-26,Assembly,"Do pass. To Consent Calendar",16,0,0,0,16
1714614,1318972,2023-05-04,Assembly,"AB 1696 Sanchez Consent Calendar Second Day Regular Session",75,0,0,5,80
1714614,1344184,2023-06-14,Senate,"Do pass, but first be re-referred to the Committee on [Appropriations] with the recommendation: To Consent Calendar",12,0,0,0,12
1714614,1348852,2023-06-29,Senate,"Consent Calendar AB1696 Sanchez",39,0,0,1,40
1714615,1311843,2023-04-25,Assembly,"Do pass as amended. To Consent Calendar",11,0,0,0,11
1714615,1318904,2023-05-04,Assembly,"AB 1697 Schiavo Consent Calendar Second Day Regular Session",75,0,0,5,80
1714615,1349743,2023-07-06,Senate,"Do pass as amended, and be ordered to the Consent Calendar",11,0,0,0,11
1714615,1353294,2023-09-06,Senate,"Assembly 3rd Reading AB1697 Schiavo By Stern",40,0,0,0,40
1714615,1353499,2023-09-07,Assembly,"AB 1697 Schiavo Concurrence in Senate Amendments",79,0,0,1,80
1714617,1299513,2023-04-12,Assembly,"Do pass and be re-referred to the Committee on [Higher Education]",5,2,0,0,7
1714617,1311813,2023-04-25,Assembly,"Do pass and be re-referred to the Committee on [Appropriations]",9,2,0,1,12
1714617,1328914,2023-05-18,Assembly,"Do pass as amended",11,4,0,1,16
1714617,1337960,2023-05-31,Assembly,"AB 1699 McCarty Assembly Third Reading",60,15,0,5,80
1714617,1350553,2023-07-12,Senate,"Do pass",4,1,0,0,5
1714617,1351417,2023-08-14,Senate,"Placed on suspense file",7,0,0,0,7
1714617,1353017,2023-09-01,Senate,"Do pass as amended",5,2,0,0,7
1714617,1354351,2023-09-13,Senate,"Assembly 3rd Reading AB1699 McCarty et al. By Cortese",25,10,0,5,40
1714617,1354352,2023-09-13,Assembly,"AB 1699 McCarty Concurrence in Senate Amendments",58,18,0,4,80
1714619,1298241,2023-04-11,Assembly,"Do pass and be re-referred to the Committee on [Appropriations] with recommendation: To Consent Calendar",15,0,0,0,15
1714619,1306717,2023-04-20,Assembly,"AB 1701 Weber Assembly Third Reading",76,0,0,4,80
1714619,1340994,2023-06-07,Senate,"Do pass as amended",12,0,0,0,12
1714619,1351701,2023-08-17,Senate,"Assembly 3rd Reading AB1701 Weber et al. By Gonzalez",38,0,0,2,40
1714619,1352205,2023-08-24,Assembly,"AB 1701 Weber Concurrence in Senate Amendments",76,0,0,4,80
1714621,1298319,2023-04-11,Assembly,"Do pass as amended and be re-referred to the Committee on [Appropriations]",18,0,0,0,18
1714621,1328643,2023-05-18,Assembly,"Do pass",15,0,0,1,16
1714621,1337956,2023-05-31,Assembly,"AB 1703 Wendy Carrillo Assembly Third Reading",78,0,0,2,80
1714621,1347492,2023-06-26,Senate,"Do pass, but first be re-referred to the Committee on [Appropriations]",13,0,0,0,13
1714621,1353225,2023-09-06,Senate,"Assembly 3rd Reading AB1703 Wendy Carrillo et al",40,0,0,0,40
1714622,1281851,2023-03-22,Assembly,"Do pass and be re-referred to the Committee on [Appropriations] with recommendation: To Consent Calendar",20,0,0,2,22
1714622,1305326,2023-04-19,Assembly,"Do pass. To Consent Calendar",14,0,0,2,16
1714622,1313322,2023-04-27,Assembly,"AB 1704 Santiago Consent Calendar Second Day Regular Session",79,0,0,1,80
1714622,1343793,2023-06-13,Senate,"Do pass, but first be re-referred to the Committee on [Appropriations] with the recommendation: To Consent Calendar",14,0,0,1,15
1714622,1353908,2023-09-12,Senate,"Assembly 3rd Reading AB1704 Santiago By Dodd Urgency Clause",38,0,0,2,40
1714622,1354561,2023-09-14,Assembly,"AB 1704 Santiago Concurrence - Urgency Added",80,0,0,0,80
1714623,1301993,2023-04-10,Assembly,"Do pass and be re-referred to the Committee on [Appropriations]",8,3,0,0,11
1714624,1301988,2023-04-10,Assembly,"Do pass and be re-referred to the Committee on [Appropriations] with recommendation: To Consent Calendar",11,0,0,0,11
1714624,1311678,2023-04-26,Assembly,"Do pass. To Consent Calendar",16,0,0,0,16
1714624,1318921,2023-05-04,Assembly,"AB 1706 Bonta Consent Calendar Second Day Regular Session",75,0,0,5,80
1714624,1346959,2023-06-22,Senate,"Do pass, but first be re-referred to the Committee on [Appropriations] with the recommendation: To Consent Calendar",11,0,0,0,11
1714624,1350628,2023-07-13,Senate,"Consent Calendar AB1706 Bonta et al",37,0,0,3,40
1714625,1298169,2023-04-11,Assembly,"Do pass as amended and be re-referred to the Committee on [Judiciary]",14,2,0,2,18
1714625,1304405,2023-04-18,Assembly,"Do pass and be re-referred to the Committee on [Appropriations]",8,2,0,1,11
1714625,1322895,2023-05-10,Assembly,"Do pass",12,2,0,2,16
1714625,1330153,2023-05-22,Assembly,"AB 1707 Pacheco Assembly Third Reading",62,12,0,6,80
1714625,1345178,2023-06-19,Senate,"Do pass, but first be re-referred to the Committee on [Judiciary]",9,1,0,3,13
1714625,1349763,2023-07-06,Senate,"Do pass as amended, but first amend, and re-refer to the Committee on [Appropriations]",9,1,0,1,11
1714625,1353172,2023-09-05,Senate,"Assembly 3rd Reading AB1707 Pacheco et al. By Ashby",31,8,0,1,40
1714625,1353602,2023-09-11,Assembly,"AB 1707 Pacheco Concurrence in Senate Amendments",64,13,0,3,80
1714626,1304415,2023-04-18,Assembly,"Do pass and be re-referred to the Committee on [Appropriations]",2,2,0,4,8
1714628,1313350,2023-04-26,Assembly,"Do pass as amended and be re-referred to the Committee on [Appropriations]",10,0,0,5,15
1714629,1304308,2023-04-17,Assembly,"Do pass and be re-referred to the Committee on [Natural Resources] with recommendation: To Consent Calendar",15,0,0,0,15
1714629,1310134,2023-04-24,Assembly,"Do pass and be re-referred to the Committee on [Appropriations] with recommendation: To Consent Calendar",11,0,0,0,11
1714630,1311827,2023-04-25,Assembly,"Do pass as amended, and be re-referred to the Committee on [Appropriations] with recommendation: To Consent Calendar",11,0,0,0,11
1714630,1328265,2023-05-18,Assembly,"Do pass",15,0,0,1,16
1714630,1338120,2023-05-31,Assembly,"AB 1712 Irwin Assembly Third Reading",80,0,0,0,80
1714631,1305375,2023-04-19,Assembly,"Do pass as amended, and be re-referred to the Committee on [Appropriations] with recommendation: To Consent Calendar",6,0,0,1,7
1714631,1328303,2023-05-18,Assembly,"Do pass as amended",11,0,0,5,16
1714631,1337951,2023-05-31,Assembly,"AB 1713 Gipson Assembly Third Reading",78,0,0,2,80
1714631,1349749,2023-07-05,Senate,"Do pass as amended, but first amend, and re-refer to the Committee on [Appropriations]",6,2,0,0,8
1714631,1352342,2023-08-28,Senate,"Placed on suspense file",7,0,0,0,7
1714634,1305409,2023-04-18,Assembly,"Do pass and be re-referred to the Committee on [Appropriations]",9,0,0,0,9
1714634,1318078,2023-05-03,Assembly,"Do pass. To Consent Calendar",16,0,0,0,16
1714634,1323834,2023-05-11,Assembly,"AB 1716 Environmental Safety and Toxic Materials Consent Calendar Second Day Regular Session",66,0,0,14,80
1714634,1346182,2023-06-21,Senate,"Do pass, but first be re-referred to the Committee on [Appropriations]",7,0,0,0,7
1714634,1353328,2023-09-06,Senate,"Assembly 3rd Reading AB1716 E.S. & T.M. (Lee) By Allen",39,0,0,1,40
1714634,1353418,2023-09-07,Assembly,"AB 1716 Environmental Safety and Concurrence in Senate Amendments By LEE",75,0,0,5,80
1714638,1317084,2023-05-02,Assembly,"Do pass. To Consent Calendar",11,0,0,0,11
1714638,1320486,2023-05-08,Assembly,"AB 1720 Bauer-Kahan Consent Calendar Second Day Regular Session",71,0,0,9,80
1714638,1349747,2023-07-05,Senate,"Do pass, but first be re-referred to the Committee on [Judiciary]",10,2,0,0,12
1714638,1350543,2023-07-11,Senate,"Do pass, but first be re-referred to the Committee on [Appropriations]",9,2,0,0,11
1714638,1351291,2023-08-14,Senate,"Placed on suspense file",7,0,0,0,7
1714638,1352601,2023-09-01,Senate,"Do pass as amended",5,2,0,0,7
1714638,1354278,2023-09-13,Assembly,"With recommendation: That Senate amendments be concurred in",8,2,0,5,15
1714638,1354279,2023-09-13,Senate,"Assembly 3rd Reading AB1720 Bauer-Kahan et al. By Skinner",31,8,0,1,40
1714638,1354771,2023-09-14,Assembly,"AB 1720 Bauer-Kahan Concurrence in Senate Amendments",62,17,0,1,80
1714640,1289852,2023-03-29,Assembly,"Do pass as amended and be re-referred to the Committee on [Appropriations]",5,0,0,2,7
1714640,1328448,2023-05-18,Assembly,"Do pass as amended",15,0,0,1,16
1714640,1338052,2023-05-31,Assembly,"AB 1722 Megan Dahle Assembly Third Reading",68,0,0,12,80
1714640,1348340,2023-06-28,Senate,"Do pass as amended, but first amend, and re-refer to the Committee on [Appropriations]",7,0,0,0,7
1714640,1351528,2023-08-14,Senate,"Placed on suspense file",7,0,0,0,7
1714640,1352767,2023-09-01,Senate,"Do pass",7,0,0,0,7
1714640,1353866,2023-09-12,Senate,"Special Consent AB1722 Megan Dahle",39,0,0,1,40
1714640,1354672,2023-09-14,Assembly,"AB 1722 Megan Dahle Concurrence in Senate Amendments",79,0,0,1,80
1714641,1304383,2023-04-18,Assembly,"Do pass and be re-referred to the Committee on [Appropriations]",7,0,0,1,8
1714641,1328832,2023-05-18,Assembly,"Do pass as amended",13,0,0,3,16
1714641,1337904,2023-05-31,Assembly,"AB 1723 Waldron Assembly Third Reading",79,0,0,1,80
1714641,1350160,2023-07-11,Senate,"Do pass, but first be re-referred to the Committee on [Appropriations] with the recommendation: To Consent Calendar",4,0,0,1,5
1714641,1351802,2023-08-21,Senate,"Placed on suspense file",7,0,0,0,7
1714643,1363756,2024-01-09,Assembly,"Do pass and be re-referred to the Committee on [Appropriations] with recommendation: To Consent Calendar",8,0,0,0,8
1714643,1366760,2024-01-18,Assembly,"Do pass. To Consent Calendar",15,0,0,1,16
1714643,1369551,2024-01-25,Assembly,"AB 1725 McCarty Consent Calendar Second Day Regular Session",69,0,0,11,80
1714643,1453417,2024-06-04,Senate,"Do pass as amended, but first amend, and re-refer to the Committee on [Appropriations]",4,0,0,1,5
1714643,1458006,2024-06-17,Senate,"Placed on suspense file",7,0,0,0,7
1714644,1299356,2023-04-11,Assembly,"Do pass as amended",6,2,0,0,8
1714644,1337210,2023-06-01,Assembly,"AB 1726 Kalra Assembly Third Reading",45,17,0,18,80
1714644,1350277,2023-07-11,Senate,"Do pass",3,1,0,1,5
1714644,1353967,2023-09-12,Senate,"Assembly 3rd Reading AB1726 Kalra By Skinner",29,7,0,4,40
1714644,1354274,2023-09-13,Assembly,"AB 1726 Kalra Concurrence in Senate Amendments",50,17,0,13,80
1714649,1298242,2023-04-11,Assembly,"Do pass. To Consent Calendar",18,0,0,0,18
1714649,1302607,2023-04-17,Assembly,"AB 1731 Santiago Consent Calendar Second Day Regular Session",79,0,0,1,80
1714649,1338814,2023-06-05,Senate,"Do pass and be ordered to the Consent Calendar",13,0,0,0,13
1714649,1351695,2023-08-17,Senate,"Assembly 3rd Reading AB1731 Santiago By Roth",38,0,0,2,40
1714651,1305253,2023-04-19,Assembly,"Do pass and be re-referred to the Committee on [Appropriations] with recommendation: To Consent Calendar",11,0,0,0,11
1714652,1305255,2023-04-19,Assembly,"Do pass as amended and be re-referred to the Committee on [Local Government]",7,0,0,1,8
1714652,1313352,2023-04-26,Assembly,"Do pass and be re-referred to the Committee on [Appropriations]",8,0,0,0,8
1714652,1328353,2023-05-18,Assembly,"Do pass",15,0,0,1,16
1714652,1337928,2023-05-31,Assembly,"AB 1734 Jones-Sawyer Assembly Third Reading",79,0,0,1,80
1714652,1349791,2023-07-05,Senate,"Do pass, but first be re-referred to the Committee on [Housing]",8,0,0,0,8
1714652,1350187,2023-07-10,Senate,"Do pass as amended, but first amend, and re-refer to the Committee on [Appropriations]",11,0,0,0,11
1714652,1351795,2023-08-21,Senate,"Placed on suspense file",7,0,0,0,7
1714652,1352764,2023-09-01,Senate,"Do pass",7,0,0,0,7
1714652,1354599,2023-09-14,Senate,"Assembly 3rd Reading AB1734 Jones-Sawyer By Durazo",40,0,0,0,40
1714652,1354600,2023-09-14,Assembly,"AB 1734 Jones-Sawyer Concurrence in Senate Amendments",71,3,0,6,80
1714653,1310334,2023-04-24,Assembly,"Do pass. To Consent Calendar",15,0,0,0,15
1714653,1315656,2023-05-01,Assembly,"AB 1735 Low Consent Calendar Second Day",78,0,0,2,80
1714653,1343770,2023-06-13,Senate,"Do pass and be ordered to the Consent Calendar",16,0,0,0,16
1714653,1346955,2023-06-22,Senate,"Consent Calendar AB1735 Low",39,0,0,1,40
1714654,1318061,2023-05-03,Assembly,"Do pass. To Consent Calendar",8,0,0,0,8
1714654,1323839,2023-05-11,Assembly,"AB 1736 Juan Carrillo Consent Calendar Second Day Regular Session",66,0,0,14,80
1714654,1341013,2023-06-07,Senate,"Do pass",7,0,0,1,8
1714654,1353136,2023-09-05,Senate,"Assembly 3rd Reading AB1736 Juan Carrillo By Bradford",25,3,0,12,40
1714656,1304337,2023-04-17,Assembly,"Do pass and be re-referred to the Committee on [Housing and Community Development] with recommendation: To Consent Calendar",15,0,0,0,15
1714656,1311876,2023-04-26,Assembly,"Do pass and be re-referred to the Committee on [Appropriations] with recommendation: To Consent Calendar",8,0,0,0,8
1714656,1328871,2023-05-18,Assembly,"Do pass",15,0,0,1,16
1714656,1338131,2023-05-31,Assembly,"AB 1738 Wendy Carrillo Assembly Third Reading",79,0,0,1,80
1714656,1350479,2023-07-11,Senate,"Do pass, but first be re-referred to the Committee on [Appropriations] with the recommendation: To Consent Calendar",16,0,0,0,16
1714656,1351776,2023-08-21,Senate,"Placed on suspense file",7,0,0,0,7
1714656,1352898,2023-09-01,Senate,"Do pass",7,0,0,0,7
1714656,1466171,2024-08-29,Assembly,"AB 1738 Wendy Carrillo Concurrence in Senate Amendments",76,0,0,3,79
1714656,1466732,2024-08-28,Senate,"Assembly 3rd Reading AB1738 Wendy Carrillo et al By Min",39,0,0,1,40
1714657,1299508,2023-04-11,Assembly,"Do pass and be re-referred to the Committee on [Appropriations]",6,0,0,2,8
1714658,1280697,2023-03-21,Assembly,"Do pass as amended, and be re-referred to the Committee on [Appropriations] with recommendation: To Consent Calendar",11,0,0,0,11
1714658,1311926,2023-04-26,Assembly,"Do pass. To Consent Calendar",16,0,0,0,16
1714658,1318953,2023-05-04,Assembly,"AB 1740 Sanchez Consent Calendar Second Day Regular Session",75,0,0,5,80
1714658,1343795,2023-06-13,Senate,"Do pass, but first be re-referred to the Committee on [Appropriations] with the recommendation: To Consent Calendar",10,0,0,1,11
1714658,1348884,2023-06-29,Senate,"Consent Calendar AB1740 Sanchez et al",39,0,0,1,40
1714659,1310278,2023-04-25,Assembly,"Do pass as amended and be re-referred to the Committee on [Appropriations]",13,2,0,3,18
1714659,1326959,2023-05-17,Assembly,"Do pass",15,0,0,1,16
1714659,1337966,2023-05-31,Assembly,"AB 1741 Waldron Assembly Third Reading",70,0,0,10,80
1714659,1345184,2023-06-19,Senate,"Do pass, but first be re-referred to the Committee on [Appropriations]",10,0,0,3,13
1714659,1354546,2023-09-14,Senate,"Assembly 3rd Reading AB1741 Waldron By Glazer",36,1,0,3,40
1714659,1354547,2023-09-14,Assembly,"AB 1741 Waldron Concurrence in Senate Amendments",74,0,0,6,80
1714661,1304426,2023-04-17,Assembly,"Do pass and be re-referred to the Committee on [Natural Resources]",15,0,0,0,15
1714661,1310166,2023-04-24,Assembly,"Do pass as amended and be re-referred to the Committee on [Appropriations]",11,0,0,0,11
1714663,1298309,2023-04-11,Assembly,"Do pass and be re-referred to the Committee on [Appropriations] with recommendation: To Consent Calendar",12,0,0,0,12
1714663,1328142,2023-05-18,Assembly,"Do pass",15,0,0,1,16
1714663,1333762,2023-05-25,Assembly,"AB 1745 Soria Assembly Third Reading",75,0,0,5,80
1714663,1344205,2023-06-14,Senate,"Do pass, but first be re-referred to the Committee on [Military and Veterans Affairs] with the recommendation: To Consent Calendar",7,0,0,0,7
1714663,1350143,2023-07-10,Senate,"Do pass, but first be re-referred to the Committee on [Appropriations]",4,0,0,1,5
1714663,1351472,2023-08-14,Senate,"Placed on suspense file",7,0,0,0,7
1714663,1352965,2023-09-01,Senate,"Do pass",7,0,0,0,7
1714663,1353733,2023-09-12,Senate,"Assembly 3rd Reading AB1745 Soria By Eggman",38,0,0,2,40
1714664,1299471,2023-04-11,Assembly,"Do pass and be re-referred to the Committee on [Appropriations]",2,0,0,6,8
1714666,1313527,2023-04-26,Assembly,"Do pass as amended and be re-referred to the Committee on [Appropriations]",8,0,0,0,8
1714667,1311789,2023-04-25,Assembly,"Do pass and be re-referred to the Committee on [Appropriations]",12,0,0,0,12
1714667,1328149,2023-05-18,Assembly,"Do pass as amended",11,0,0,5,16
1714667,1338007,2023-05-31,Assembly,"AB 1749 McCarty Assembly Third Reading",80,0,0,0,80
1714667,1348314,2023-06-28,Senate,"Do pass, but first be re-referred to the Committee on [Appropriations]",7,0,0,0,7
1714667,1351829,2023-08-21,Senate,"Placed on suspense file",7,0,0,0,7
1714670,1310323,2023-04-25,Assembly,"Be adopted and re-referred to the Committee on [Appropriations]",7,0,0,1,8
1714670,1328439,2023-05-18,Assembly,"Be adopted",11,2,0,3,16
1714670,1354138,2023-09-13,Assembly,"ACA 8 Wilson Assembly Third Reading",68,4,0,8,80
1714670,1456320,2024-06-11,Senate,"Be adopted, but first be re-referred to the Committee on [Elections and Constitutional Amendments]",4,1,0,0,5
1714670,1458220,2024-06-18,Senate,"Be adopted as amended, but first amend, and re-refer to the Committee on [Appropriations]",6,0,0,1,7
1714670,1460764,2024-06-26,Senate,"Be adopted",5,1,0,1,7
1714670,1461269,2024-06-27,Senate,"Assembly 3rd Reading ACA8 Wilson et al. By Bradford",33,3,0,4,40
1714670,1461270,2024-06-27,Assembly,"ACA 8 WILSON Concurrence in Senate Amendments",68,0,0,11,79
1714671,1283226,2023-03-22,Assembly,"Be adopted. To Consent Calendar",7,0,0,0,7
1714671,1289832,2023-03-30,Assembly,"ACR 18 Mike Fong Consent Calendar Second Day Regular Session",60,0,0,20,80
1714671,1341039,2023-06-07,Senate,"Be adopted and be ordered to the Consent Calendar",7,0,0,0,7
1714671,1344732,2023-06-15,Senate,"Consent Calendar ACR18 Mike Fong et al",40,0,0,0,40
1714673,1267522,2023-03-02,Assembly,"Be adopted. To Consent Calendar",13,0,0,0,13
1714673,1272568,2023-03-09,Assembly,"ACR 20 Rodriguez Consent Calendar Second Day Regular Session",75,0,0,5,80
1714673,1289842,2023-03-30,Senate,"Special Consent ACR20 Rodriguez et al",35,0,0,5,40
1714674,1267524,2023-03-02,Assembly,"Be adopted. To Consent Calendar",13,0,0,0,13
1714674,1272556,2023-03-09,Assembly,"ACR 21 Weber Consent Calendar Second Day Regular Session",75,0,0,5,80
1714674,1289784,2023-03-30,Senate,"Special Consent ACR21 Weber et al",35,0,0,5,40
1714675,1272557,2023-03-09,Assembly,"Be adopted. To third reading",13,0,0,0,13
1714675,1306748,2023-04-20,Senate,"Special Consent ACR22 Essayli et al",36,0,0,4,40
1714676,1313319,2023-04-27,Assembly,"Be adopted. To Consent Calendar",13,0,0,0,13
1714676,1318954,2023-05-04,Assembly,"HR 15 Villapudua Consent Calendar Second Day Regular Session",75,0,0,5,80
1714677,1260548,2023-02-23,Assembly,"Be adopted. To Consent Calendar",13,0,0,0,13
1714677,1267491,2023-03-02,Assembly,"HR 16 Maienschein Consent Calendar Second Day",71,0,0,9,80
1714678,1317063,2023-05-02,Senate,"Do pass",11,0,0,0,11
1714678,1325027,2023-05-15,Senate,"Senate 3rd Reading SB727 Lim√≥n",38,0,0,2,40
1714678,1343790,2023-06-13,Assembly,"Do pass as amended. To Consent Calendar",11,0,0,0,11
1714678,1353942,2023-09-12,Assembly,"SB 727 Lim√≥n Senate Third Reading By Ortega",80,0,0,0,80
1714678,1354317,2023-09-13,Senate,"Unfinished Business SB727 Lim√≥n et al. Concurrence",39,0,0,1,40
1714679,1311805,2023-04-26,Senate,"Do pass as amended",5,2,0,0,7
1714679,1330145,2023-05-22,Senate,"Senate 3rd Reading SB728 Lim√≥n",31,9,0,0,40
1714679,1345183,2023-06-19,Assembly,"Do pass as amended",8,3,0,0,11
1714679,1350515,2023-07-12,Assembly,"Do pass",10,4,0,2,16
1714679,1353841,2023-09-12,Assembly,"SB 728 Lim√≥n Senate Third Reading By Luz Rivas",53,18,0,9,80
1714679,1354312,2023-09-13,Senate,"Unfinished Business SB728 Lim√≥n Concurrence",30,9,0,1,40
1714680,1313358,2023-04-26,Senate,"Do pass as amended, but first amend, and re-refer to the Committee on [Appropriations]",11,0,0,1,12
1714680,1320458,2023-05-08,Senate,"Placed on suspense file",7,0,0,0,7
1714680,1328347,2023-05-18,Senate,"Do pass as amended",5,2,0,0,7
1714680,1332556,2023-05-24,Senate,"Senate 3rd Reading SB729 Menjivar et al",31,3,0,6,40
1714680,1350189,2023-07-11,Assembly,"Do pass as amended and be re-referred to the Committee on [Appropriations]",10,1,0,4,15
1714680,1464228,2024-08-15,Assembly,"Do pass",11,3,0,1,15
1714680,1466195,2024-08-29,Senate,"Unfinished Business SB729 Menjivar et al. Concurrence",31,8,0,1,40
1714680,1466712,2024-08-28,Assembly,"SB 729 Menjivar Senate Third Reading By Wicks",62,1,0,16,79
1714681,1304361,2023-04-17,Senate,"Do pass, but first be re-referred to the Committee on [Appropriations]",4,0,0,1,5
1714681,1315708,2023-05-01,Senate,"Placed on suspense file",6,0,0,1,7
1714682,1305260,2023-04-18,Senate,"Do pass as amended, but first amend, and re-refer to the Committee on [Appropriations] with the recommendation: To Consent Calendar",11,0,0,0,11
1714682,1315759,2023-05-01,Senate,"Placed on suspense file",6,0,0,1,7
1714682,1328312,2023-05-18,Senate,"Do pass",7,0,0,0,7
1714682,1333738,2023-05-25,Senate,"Special Consent SB731 Ashby",40,0,0,0,40
1714682,1344201,2023-06-14,Assembly,"Do pass and be re-referred to the Committee on [Judiciary]",7,0,0,0,7
1714682,1347867,2023-06-27,Assembly,"Do pass and be re-referred to the Committee on [Appropriations]",9,1,0,1,11
1714682,1352494,2023-09-01,Assembly,"Do pass as amended",13,2,0,1,16
1714682,1353257,2023-09-06,Assembly,"SB 731 Ashby Senate Third Reading By Kalra",74,0,0,6,80
1714682,1353496,2023-09-07,Senate,"Unfinished Business SB731 Ashby et al. Concurrence",40,0,0,0,40
1714683,1310328,2023-04-25,Senate,"Do pass",14,1,0,0,15
1714683,1320423,2023-05-08,Senate,"Senate 3rd Reading SB732 Menjivar",36,0,0,4,40
1714683,1340012,2023-06-06,Assembly,"Do pass",14,0,0,1,15
1714683,1351678,2023-08-17,Assembly,"SB 732 Menjivar Senate Third Reading By Aguiar-Curry",75,0,0,5,80
1714683,1353304,2023-09-06,Senate,"Unfinished Business SB732 Menjivar et al. Concurrence",40,0,0,0,40
1714684,1304368,2023-04-18,Senate,"Do pass, but first be re-referred to the Committee on [Appropriations]",1,3,0,1,5
1714684,1304369,2023-04-18,Senate,"[First] hearing set for [04-18-2023]: Failed passage in Committee. Reconsideration granted",5,0,0,0,5
1714684,1363743,2024-01-09,Senate,"Do pass, but first be re-referred to the Committee on [Appropriations]",3,0,0,2,5
1714684,1364744,2024-01-16,Senate,"Placed on suspense file",6,0,0,1,7
1714684,1366812,2024-01-18,Senate,"Do pass",6,0,0,1,7
1714684,1371108,2024-01-29,Senate,"Senate 3rd Reading SB733 Glazer",30,1,0,9,40
1714684,1453420,2024-06-04,Assembly,"Do pass and be re-referred to the Committee on [Appropriations]",6,0,0,2,8
1714685,1318070,2023-05-03,Senate,"Do pass, but first be re-referred to the Committee on [Appropriations]",7,0,0,1,8
1714685,1324995,2023-05-15,Senate,"Placed on suspense file",7,0,0,0,7
1714685,1328594,2023-05-18,Senate,"Do pass",7,0,0,0,7
1714685,1333585,2023-05-25,Senate,"Special Consent SB734 Rubio",40,0,0,0,40
1714685,1350285,2023-07-10,Assembly,"Do pass and be re-referred to the Committee on [Appropriations]",10,0,0,1,11
1714685,1352729,2023-09-01,Assembly,"Do pass",16,0,0,0,16
1714685,1353232,2023-09-06,Assembly,"SB 734 Rubio Senate Third Reading By Pacheco",79,0,0,1,80
1714686,1306781,2023-04-19,Senate,"Do pass as amended, but first amend, and re-refer to the Committee on [Judiciary]",5,0,0,0,5
1714686,1320556,2023-05-08,Senate,"Placed on suspense file",7,0,0,0,7
1714686,1328494,2023-05-18,Senate,"Do pass as amended",5,2,0,0,7
1714686,1332592,2023-05-24,Senate,"Senate 3rd Reading SB735 Cortese et al",33,4,0,3,40
1714686,1460654,2024-06-26,Assembly,"Do pass as amended and be re-referred to the Committee on [Appropriations]",7,1,0,1,9
1714687,1299467,2023-04-12,Senate,"Do pass, but first be re-referred to the Committee on [Housing] with the recommendation: To Consent Calendar",8,0,0,0,8
1714687,1310218,2023-04-24,Senate,"Do pass and be ordered to the Consent Calendar",11,0,0,0,11
1714687,1315677,2023-05-01,Senate,"Consent Calendar SB736 McGuire",37,0,0,3,40
1714687,1345186,2023-06-19,Assembly,"SB 736 McGuire Third Reading Urgency By Aguiar-Curry",73,0,0,7,80
1714687,1346942,2023-06-22,Senate,"Unfinished Business SB736 McGuire et al. Urgency Clause Concurrence",38,0,0,2,40
1714690,1311824,2023-04-26,Senate,"Do pass as amended, but first amend, and re-refer to the Committee on [Appropriations]",5,1,0,1,7
1714690,1336381,2023-05-31,Senate,"Senate 3rd Reading SB739 Alvarado-Gil",28,0,0,12,40
1714690,1454217,2024-06-05,Assembly,"Do pass as amended",9,0,0,0,9
1714690,1459405,2024-06-24,Assembly,"SB 739 Ashby Third Reading Urgency By Stephanie Nguyen",76,0,0,3,79
1714690,1462627,2024-07-03,Senate,"That the Assembly amendments be concurred in",7,0,0,0,7
1714690,1465257,2024-08-19,Senate,"Unfinished Business SB739 Ashby Urgency Clause Concurrence",40,0,0,0,40
1714691,1311754,2023-04-26,Senate,"Do pass, but first be re-referred to the Committee on [Appropriations]",7,0,0,0,7
1714691,1324942,2023-05-15,Senate,"Placed on suspense file",7,0,0,0,7
1714691,1327933,2023-05-18,Senate,"Do pass",6,0,0,1,7
1714691,1330118,2023-05-22,Senate,"Senate 3rd Reading SB740 Cortese et al",36,2,0,2,40
1714691,1350681,2023-07-12,Assembly,"Do pass and be re-referred to the Committee on [Appropriations]",6,0,0,1,7
1714691,1352101,2023-08-23,Assembly,"Do pass",15,0,0,1,16
1714691,1352474,2023-08-31,Assembly,"SB 740 Cortese Senate Third Reading By Kalra",76,1,0,3,80
1714692,1299519,2023-04-11,Senate,"Do pass",9,1,0,1,11
1714692,1333555,2023-05-25,Senate,"Senate 3rd Reading SB741 Min",32,4,0,4,40
1714692,1333556,2023-05-25,Senate,"Senate 3rd Reading SB741 Min Reconsider",39,0,0,1,40
1714692,1333557,2023-05-25,Senate,"Senate 3rd Reading SB741 Min",34,2,0,4,40
1714692,1345580,2023-06-20,Assembly,"Do pass as amended",8,1,0,2,11
1714692,1354516,2023-09-14,Senate,"Unfinished Business SB741 Min et al. Concurrence",33,6,0,1,40
1714692,1354517,2023-09-14,Assembly,"SB 741 Min Senate Third Reading By Papan",61,0,0,19,80
1714694,1299473,2023-04-12,Senate,"Do pass, but first be re-referred to the Committee on [Appropriations] with the recommendation: To Consent Calendar",7,0,0,0,7
1714694,1315673,2023-05-01,Senate,"Consent Calendar SB743 Nguyen",37,0,0,3,40
1714694,1348397,2023-06-28,Assembly,"Do pass and be re-referred to the Committee on [Appropriations] with recommendation: To Consent Calendar",13,0,0,1,14
1714694,1351577,2023-08-16,Assembly,"Do pass. To Consent Calendar",15,0,0,1,16
1714694,1353128,2023-09-05,Assembly,"SB 743 Nguyen Senate Third Reading By Chen",77,0,0,3,80
1714694,1353217,2023-09-06,Senate,"Unfinished Business SB743 Nguyen Concurrence",40,0,0,0,40
1714696,1305218,2023-04-18,Senate,"Do pass as amended, but first amend, and re-refer to the Committee on [Appropriations]",8,1,0,2,11
1714696,1315710,2023-05-01,Senate,"Placed on suspense file",6,0,0,1,7
1714696,1328895,2023-05-18,Senate,"Do pass",5,1,0,1,7
1714696,1330045,2023-05-22,Senate,"Senate 3rd Reading SB745 Cortese et al",31,9,0,0,40
1714696,1346259,2023-06-20,Assembly,"Do pass and be re-referred to the Committee on [Housing and Community Development]",6,1,0,2,9
1714696,1350513,2023-07-12,Assembly,"Do pass as amended and be re-referred to the Committee on [Appropriations]",6,2,0,0,8
1714696,1352952,2023-09-01,Assembly,"Do pass",13,3,0,0,16
1714696,1353614,2023-09-11,Assembly,"SB 745 Cortese Senate Third Reading By Wendy Carrillo",62,11,0,7,80
1714696,1353985,2023-09-12,Senate,"Unfinished Business SB745 Cortese et al. Concurrence",30,8,0,2,40
1714697,1310175,2023-04-24,Senate,"Do pass, but first be re-referred to the Committee on [Appropriations]",17,0,0,1,18
1714697,1330107,2023-05-22,Senate,"Senate 3rd Reading SB746 Eggman",40,0,0,0,40
1714697,1344179,2023-06-14,Assembly,"Do pass as amended, and be re-referred to the Committee on [Appropriations] with recommendation: To Consent Calendar",13,0,0,2,15
1714697,1352117,2023-08-23,Assembly,"Do pass. To Consent Calendar",15,0,0,1,16
1714697,1352478,2023-08-31,Assembly,"SB 746 Eggman Consent Calendar Second Day Regular Session",79,0,0,1,80
1714697,1353374,2023-09-07,Senate,"Special Consent SB746 Eggman et al",40,0,0,0,40
1714698,1299446,2023-04-12,Senate,"Do pass as amended, but first amend, and re-refer to the Committee on [Rules]",8,0,0,0,8
1714698,1310235,2023-04-24,Senate,"Do pass as amended, but first amend, and re-refer to the Committee on [Appropriations]",11,0,0,0,11
1714698,1324927,2023-05-15,Senate,"Placed on suspense file",7,0,0,0,7
1714698,1328062,2023-05-18,Senate,"Do pass as amended",7,0,0,0,7
1714698,1336386,2023-05-31,Senate,"Senate 3rd Reading SB747 Caballero et al",38,0,0,2,40
1714698,1348312,2023-06-28,Assembly,"Do pass as amended and be re-referred to the Committee on [Housing and Community Development]",8,0,0,0,8
1714698,1350427,2023-07-12,Assembly,"Do pass as amended and be re-referred to the Committee on [Appropriations]",8,0,0,0,8
1714698,1353037,2023-09-01,Assembly,"Do pass",16,0,0,0,16
1714698,1354336,2023-09-13,Assembly,"SB 747 Caballero Senate Third Reading By Ting",80,0,0,0,80
1714698,1354727,2023-09-14,Senate,"Unfinished Business SB747 Caballero et al. Concurrence",40,0,0,0,40
1714699,1305222,2023-04-18,Senate,"Do pass, but first be re-referred to the Committee on [Appropriations] with the recommendation: To Consent Calendar",11,0,0,0,11
1714699,1318982,2023-05-04,Senate,"Consent Calendar SB748 Roth",37,0,0,3,40
1714699,1340067,2023-06-06,Assembly,"Do pass and be re-referred to the Committee on [Appropriations] with recommendation: To Consent Calendar",11,0,0,0,11
1714699,1346144,2023-06-21,Assembly,"Do pass. To Consent Calendar",13,0,0,3,16
1714699,1347874,2023-06-27,Assembly,"SB 748 Roth Consent Calendar Second Day Regular Session",78,0,0,2,80
1714700,1298300,2023-04-11,Senate,"Do pass, but first be re-referred to the Committee on [Appropriations]",4,1,0,0,5
1714700,1308847,2023-04-24,Senate,"Placed on suspense file",7,0,0,0,7
1714700,1328187,2023-05-18,Senate,"Do pass",5,2,0,0,7
1714700,1335596,2023-05-30,Senate,"Senate 3rd Reading SB749 Smallwood-Cuevas Urgency Clause",28,11,0,1,40
1714700,1350171,2023-07-11,Assembly,"Do pass and be re-referred to the Committee on [Appropriations]",6,0,0,2,8
1714700,1351559,2023-08-16,Assembly,"Do pass",11,4,0,1,16
1714700,1354873,2023-09-14,Assembly,"SB 749 Smallwood-Cuevas Third Reading Urgency By Ting",54,18,0,8,80
1714702,1318003,2023-05-03,Senate,"Do pass as amended",5,2,0,1,8
1714702,1335516,2023-05-30,Senate,"Senate 3rd Reading SB751 Padilla",30,9,0,1,40
1714702,1350779,2023-07-10,Assembly,"Do pass and be re-referred to the Committee on [Appropriations]",8,3,0,0,11
1714702,1352855,2023-09-01,Assembly,"Do pass as amended",11,4,0,1,16
1714702,1354112,2023-09-13,Assembly,"SB 751 Padilla Senate Third Reading By Alvarez",48,17,0,15,80
1714702,1354562,2023-09-14,Senate,"Unfinished Business SB751 Padilla Concurrence",28,10,0,2,40
1714704,1298217,2023-04-11,Senate,"Do pass, but first be re-referred to the Committee on [Natural Resources and Water]",5,0,0,0,5
1714704,1315143,2023-04-25,Senate,"Do pass, but first be re-referred to the Committee on [Appropriations]",10,0,0,1,11
1714704,1320421,2023-05-08,Senate,"Placed on suspense file",7,0,0,0,7
1714704,1328172,2023-05-18,Senate,"Do pass as amended",7,0,0,0,7
1714704,1336357,2023-05-31,Senate,"Senate 3rd Reading SB753 Caballero et al",40,0,0,0,40
1714704,1348450,2023-06-27,Assembly,"Do pass as amended and be re-referred to the Committee on [Water, Parks, and Wildlife]",8,0,0,0,8
1714704,1352874,2023-09-01,Assembly,"Do pass",16,0,0,0,16
1714704,1354043,2023-09-12,Assembly,"SB 753 Caballero Senate Third Reading By Megan Dahle",76,0,0,4,80
1714704,1354167,2023-09-13,Senate,"Unfinished Business SB753 Caballero et al. By Stern Concurrence",39,0,0,1,40
1714705,1296928,2023-04-10,Senate,"Do pass as amended, but first amend, and re-refer to the Committee on [Appropriations]",15,0,0,3,18
1714705,1320478,2023-05-08,Senate,"Placed on suspense file",7,0,0,0,7
1714706,1310142,2023-04-24,Senate,"Do pass as amended, but first amend, and re-refer to the Committee on [Appropriations]",17,0,0,1,18
1714706,1324970,2023-05-15,Senate,"Placed on suspense file",7,0,0,0,7
1714706,1328869,2023-05-18,Senate,"Do pass",7,0,0,0,7
1714706,1333639,2023-05-25,Senate,"Special Consent SB755 Becker",40,0,0,0,40
1714706,1348482,2023-06-28,Assembly,"Do pass and be re-referred to the Committee on [Natural Resources] with recommendation: To Consent Calendar",14,0,0,1,15
1714706,1350786,2023-07-10,Assembly,"Do pass as amended, and be re-referred to the Committee on [Appropriations] with recommendation: To Consent Calendar",11,0,0,0,11
1714707,1298251,2023-04-11,Senate,"Do pass, but first be re-referred to the Committee on [Judiciary]",11,0,0,0,11
1714707,1305530,2023-04-18,Senate,"Do pass as amended, but first amend, and re-refer to the Committee on [Appropriations]",11,0,0,0,11
1714707,1330127,2023-05-22,Senate,"Senate 3rd Reading SB756 Laird",40,0,0,0,40
1714707,1345657,2023-06-20,Assembly,"Do pass and be re-referred to the Committee on [Judiciary]",15,0,0,0,15
1714707,1347850,2023-06-27,Assembly,"Do pass and be re-referred to the Committee on [Appropriations] with recommendation: To Consent Calendar",11,0,0,0,11
1714707,1350461,2023-07-12,Assembly,"Do pass. To Consent Calendar",15,0,0,1,16
1714707,1351698,2023-08-17,Assembly,"SB 756 Laird Consent Calendar Second Day Regular Session",75,0,0,5,80
1714708,1296981,2023-04-10,Senate,"Do pass as amended, but first amend, and re-refer to the Committee on [Transportation]",12,3,0,3,18
1714708,1315754,2023-05-01,Senate,"Placed on suspense file",6,0,0,1,7
1714708,1328256,2023-05-18,Senate,"Do pass",5,2,0,0,7
1714708,1335584,2023-05-30,Senate,"Senate 3rd Reading SB757 Archuleta",29,8,0,3,40
1714708,1349564,2023-07-05,Assembly,"Do pass and be re-referred to the Committee on [Appropriations]",9,2,0,2,13
1714708,1352731,2023-09-01,Assembly,"Do pass as amended",11,4,0,1,16
1714708,1353534,2023-09-07,Assembly,"SB 757 Archuleta Senate Third Reading By Santiago Amendment Set #1",61,16,0,3,80
1714708,1354551,2023-09-14,Senate,"Unfinished Business SB757 Archuleta Concurrence",30,8,0,2,40
1714708,1354552,2023-09-14,Assembly,"SB 757 Archuleta Senate Third Reading By Santiago",63,16,0,1,80
1714709,1298239,2023-04-11,Senate,"Do pass, but first be re-referred to the Committee on [Appropriations]",4,0,0,1,5
1714709,1315729,2023-05-01,Senate,"Placed on suspense file",6,0,0,1,7
1714709,1328090,2023-05-18,Senate,"Do pass",5,1,0,1,7
1714709,1332576,2023-05-24,Senate,"Senate 3rd Reading SB758 Umberg",30,6,0,4,40
1714709,1453471,2024-06-04,Assembly,"Do pass as amended and be re-referred to the Committee on [Appropriations]",7,0,0,1,8
1714709,1464615,2024-08-15,Assembly,"Do pass as amended",12,0,0,3,15
1714709,1465573,2024-08-26,Assembly,"SB 758 Umberg Senate Third Reading By Grayson",71,0,0,8,79
1714709,1467074,2024-08-28,Senate,"Unfinished Business SB758 Umberg et al. Concurrence",31,8,0,1,40
1714711,1299385,2023-04-12,Senate,"Do pass as amended, but first amend, and re-refer to the Committee on [Appropriations]",6,0,0,1,7
1714711,1315724,2023-05-01,Senate,"Placed on suspense file",6,0,0,1,7
1714711,1328302,2023-05-18,Senate,"Do pass as amended",5,1,0,1,7
1714711,1336330,2023-05-31,Senate,"Senate 3rd Reading SB760 Newman et al",33,6,0,1,40
1714711,1350448,2023-07-12,Assembly,"Do pass as amended and be re-referred to the Committee on [Appropriations]",4,0,0,3,7
1714711,1352705,2023-09-01,Assembly,"Do pass",12,2,0,2,16
1714711,1353510,2023-09-07,Assembly,"SB 760 Newman Senate Third Reading By Zbur",65,6,0,9,80
1714711,1354614,2023-09-11,Senate,"Unfinished Business SB760 Newman et al. Concurrence",32,7,0,1,40
1714712,1311846,2023-04-25,Senate,"Do pass as amended, but first amend, and re-refer to the Committee on [Appropriations]",8,2,0,1,11
1714712,1325026,2023-05-15,Senate,"Placed on suspense file",7,0,0,0,7
1714713,1310245,2023-04-25,Senate,"Do pass, but first be re-referred to the Committee on [Appropriations] with the recommendation: To Consent Calendar",5,0,0,0,5
1714713,1323870,2023-05-11,Senate,"Consent Calendar SB762 Becker",39,0,0,1,40
1714713,1343783,2023-06-13,Assembly,"Do pass as amended, and be re-referred to the Committee on [Appropriations] with recommendation: To Consent Calendar",8,0,0,0,8
1714713,1348288,2023-06-28,Assembly,"Do pass. To Consent Calendar",14,0,0,2,16
1714714,1298235,2023-04-11,Senate,"Do pass, but first be re-referred to the Committee on [Appropriations]",4,1,0,0,5
1714714,1315647,2023-05-01,Senate,"Placed on suspense file",6,0,0,1,7
1714715,1364119,2024-01-11,Senate,"Do pass, but first be re-referred to the Committee on [Appropriations]",8,1,0,2,11
1714715,1364823,2024-01-16,Senate,"Placed on suspense file",6,0,0,1,7
1714715,1366775,2024-01-18,Senate,"Do pass",5,0,0,2,7
1714715,1371085,2024-01-29,Senate,"Senate 3rd Reading SB764 Padilla et al",34,0,0,6,40
1714715,1458294,2024-06-18,Assembly,"Do pass as amended and be re-referred to the Committee on [Judiciary]",11,0,0,0,11
1714715,1460056,2024-06-25,Assembly,"Do pass and be re-referred to the Committee on [Appropriations]",11,0,0,1,12
1714715,1464235,2024-08-15,Assembly,"Do pass",14,0,0,1,15
1714715,1465715,2024-08-26,Assembly,"SB 764 Padilla Senate Third Reading By McKinnor",77,0,0,2,79
1714715,1466180,2024-08-29,Senate,"Unfinished Business SB764 Padilla et al. Concurrence",38,0,0,2,40
1714716,1305370,2023-04-19,Senate,"Do pass, but first be re-referred to the Committee on [Labor, Public Employment and Retirement ]",7,0,0,0,7
1714716,1311761,2023-04-26,Senate,"Do pass as amended, but first amend, and re-refer to the Committee on [Appropriations]",5,0,0,0,5
1714716,1325052,2023-05-15,Senate,"Placed on suspense file",7,0,0,0,7
1714716,1328048,2023-05-18,Senate,"Do pass",7,0,0,0,7
1714716,1332583,2023-05-24,Senate,"Senate 3rd Reading SB765 Portantino",39,0,0,1,40
1714716,1348846,2023-06-28,Assembly,"Do pass as amended and be re-referred to the Committee on [Public Employment and Retirement]",6,0,0,1,7
1714716,1352115,2023-08-23,Assembly,"Do pass and be re-referred to the Committee on [Appropriations]",6,0,0,1,7
1714716,1352840,2023-09-01,Assembly,"Do pass",16,0,0,0,16
1714716,1353314,2023-09-06,Assembly,"SB 765 Portantino Senate Third Reading By Addis",79,0,0,1,80
1714716,1353350,2023-09-07,Senate,"Unfinished Business SB765 Portantino et al. Concurrence",40,0,0,0,40
1714717,1308813,2023-04-24,Senate,"Do pass, but first be re-referred to the Committee on [Appropriations]",13,0,0,0,13
1714717,1320427,2023-05-08,Senate,"Placed on suspense file",7,0,0,0,7
1714718,1311888,2023-04-26,Senate,"Do pass, but first be re-referred to the Committee on [Appropriations]",6,1,0,0,7
1714718,1320444,2023-05-08,Senate,"Placed on suspense file",7,0,0,0,7
1714719,1363945,2024-01-10,Senate,"Do pass, but first be re-referred to the Committee on [Housing]",6,1,0,0,7
1714719,1364789,2024-01-16,Senate,"Placed on suspense file",6,0,0,1,7
1714719,1366795,2024-01-18,Senate,"Do pass",4,2,0,1,7
1714719,1371127,2024-01-29,Senate,"Senate 3rd Reading SB768 Caballero",34,4,0,2,40
1714719,1455777,2024-06-10,Assembly,"Do pass and be re-referred to the Committee on [Appropriations]",10,0,0,1,11
1714719,1464524,2024-08-15,Assembly,"Do pass as amended",11,2,0,2,15
1714719,1465581,2024-08-26,Assembly,"SB 768 Caballero Senate Third Reading By Wood",72,0,0,7,79
1714719,1465817,2024-08-27,Senate,"Unfinished Business SB768 Caballero et al. Concurrence",34,4,0,2,40
1714720,1305228,2023-04-19,Senate,"Do pass as amended, but first amend, and re-refer to the Committee on [Appropriations]",7,1,0,0,8
1714720,1315746,2023-05-01,Senate,"Placed on suspense file",6,0,0,1,7
1714720,1328429,2023-05-18,Senate,"Do pass",6,1,0,0,7
1714720,1330085,2023-05-22,Senate,"Senate 3rd Reading SB769 Gonzalez",37,2,0,1,40
1714720,1346197,2023-06-21,Assembly,"Do pass as amended and be re-referred to the Committee on [Appropriations]",6,1,0,1,8
1714721,1305281,2023-04-19,Senate,"Do pass as amended, but first amend, and re-refer to the Committee on [Appropriations]",7,2,0,3,12
1714721,1315667,2023-05-01,Senate,"Placed on suspense file",6,0,0,1,7
1714721,1328444,2023-05-18,Senate,"Do pass",5,2,0,0,7
1714721,1335550,2023-05-30,Senate,"Senate 3rd Reading SB770 Wiener et al",30,9,0,1,40
1714721,1347948,2023-06-27,Assembly,"Do pass and be re-referred to the Committee on [Appropriations]",10,4,0,1,15
1714721,1352801,2023-09-01,Assembly,"Do pass as amended",9,4,0,3,16
1714721,1354345,2023-09-13,Assembly,"SB 770 Wiener Senate Third Reading By Schiavo",47,18,0,15,80
1714721,1354772,2023-09-14,Senate,"Unfinished Business SB770 Wiener et al. Concurrence",29,9,0,2,40
1714722,1310267,2023-04-25,Senate,"Do pass and be ordered to the Consent Calendar",15,0,0,0,15
1714722,1315726,2023-05-01,Senate,"Consent Calendar SB771 G.O. (Dodd)",37,0,0,3,40
1714722,1344204,2023-06-14,Assembly,"Do pass. To Consent Calendar",21,0,0,1,22
1714722,1353601,2023-09-11,Assembly,"SB 771 Dodd Third Reading Urgency By Ramos",80,0,0,0,80
1714722,1353897,2023-09-12,Senate,"Unfinished Business SB771 Dodd et al. Urgency Clause Concurrence",39,0,0,1,40
1714723,1298184,2023-04-11,Senate,"Do pass as amended, but first amend, and re-refer to the Committee on [Appropriations] with the recommendation: To Consent Calendar",11,0,0,0,11
1714723,1320436,2023-05-08,Senate,"Placed on suspense file",7,0,0,0,7
1714724,1304394,2023-04-17,Senate,"Do pass, but first be re-referred to the Committee on [Appropriations] with the recommendation: To Consent Calendar",4,0,0,1,5
1714724,1315675,2023-05-01,Senate,"Placed on suspense file",6,0,0,1,7
1714724,1328096,2023-05-18,Senate,"Do pass",7,0,0,0,7
1714724,1333812,2023-05-25,Senate,"Special Consent SB773 Glazer",40,0,0,0,40
1714724,1350173,2023-07-11,Assembly,"Do pass and be re-referred to the Committee on [Appropriations]",7,0,0,1,8
1714724,1352904,2023-09-01,Assembly,"Do pass as amended",11,0,0,5,16
1714724,1353309,2023-09-06,Assembly,"SB 773 Glazer Senate Third Reading By Jackson",79,0,0,1,80
1714724,1354657,2023-09-11,Senate,"Unfinished Business SB773 Glazer Concurrence",39,0,0,1,40
1714726,1288398,2023-03-28,Senate,"Do pass, but first be re-referred to the Committee on [Appropriations]",14,0,0,2,16
1714726,1296925,2023-04-10,Senate,"Do pass",7,0,0,0,7
1714726,1330122,2023-05-22,Senate,"Senate 3rd Reading SB775 Padilla",40,0,0,0,40
1714726,1349591,2023-07-05,Assembly,"Do pass and be re-referred to the Committee on [Appropriations] with recommendation: To Consent Calendar",15,0,0,0,15
1714726,1351576,2023-08-16,Assembly,"Do pass. To Consent Calendar",15,0,0,1,16
1714726,1352236,2023-08-24,Assembly,"SB 775 Padilla Consent Calendar Second Day Regular Session",73,0,0,7,80
1714726,1354570,2023-09-11,Senate,"Unfinished Business SB775 Padilla Concurrence",39,0,0,1,40
1714728,1288142,2023-03-29,Senate,"Do pass, but first be re-referred to the Committee on [Appropriations]",5,0,0,2,7
1714728,1302632,2023-04-17,Senate,"Placed on suspense file",6,0,0,1,7
1714728,1328016,2023-05-18,Senate,"Do pass as amended",4,1,0,2,7
1714728,1332654,2023-05-24,Senate,"Senate 3rd Reading SB777 Allen",36,2,0,2,40
1714728,1350785,2023-07-10,Assembly,"Do pass as amended and be re-referred to the Committee on [Appropriations]",9,0,0,2,11
1714728,1352976,2023-09-01,Assembly,"Do pass as amended",11,2,0,3,16
1714728,1354775,2023-09-14,Senate,"Unfinished Business SB777 Allen Concurrence",36,2,0,2,40
1714728,1354776,2023-09-14,Assembly,"SB 777 Allen Senate Third Reading By Friedman",60,16,0,4,80
1714729,1296966,2023-04-10,Senate,"Do pass as amended, but first amend, and re-refer to the Committee on [Governance and Finance]",12,0,0,1,13
1714729,1313356,2023-04-26,Senate,"Do pass as amended, but first amend, and re-refer to the Committee on [Appropriations] with the recommendation: To Consent Calendar",8,0,0,0,8
1714729,1320400,2023-05-08,Senate,"Placed on suspense file",7,0,0,0,7
1714729,1328471,2023-05-18,Senate,"Do pass",7,0,0,0,7
1714729,1333755,2023-05-25,Senate,"Special Consent SB778 Ochoa Bogh",40,0,0,0,40
1714729,1462039,2024-07-01,Assembly,"Do pass as amended, and be re-referred to the Committee on [Appropriations] with recommendation: To Consent Calendar",15,0,0,1,16
1714729,1464576,2024-08-15,Assembly,"Do pass as amended",11,0,0,4,15
1714729,1465640,2024-08-26,Assembly,"SB 778 Ochoa Bogh Senate Third Reading By Chen",77,0,0,2,79
1714729,1467017,2024-08-28,Senate,"Special Consent SB778 Ochoa Bogh",39,0,0,1,40
1714730,1301009,2023-04-12,Senate,"Do pass as amended, but first amend, and re-refer to the Committee on [Judiciary]",9,2,0,1,12
1714730,1315785,2023-05-01,Senate,"Placed on suspense file",6,0,0,1,7
1714730,1328685,2023-05-18,Senate,"Do pass",5,2,0,0,7
1714730,1336371,2023-05-31,Senate,"Senate 3rd Reading SB779 Stern et al",26,8,0,6,40
1714730,1350287,2023-07-11,Assembly,"Do pass as amended and be re-referred to the Committee on [Appropriations]",11,4,0,0,15
1714730,1352715,2023-09-01,Assembly,"Do pass",11,3,0,2,16
1714730,1353561,2023-09-08,Assembly,"SB 779 Stern Senate Third Reading By Ortega Amendment Set #1",57,16,0,7,80
1714730,1354260,2023-09-13,Assembly,"SB 779 Stern Senate Third Reading By Ortega",48,17,0,15,80
1714730,1354874,2023-09-14,Senate,"Unfinished Business SB779 Stern et al. Concurrence",24,10,0,6,40
1714731,1304407,2023-04-18,Senate,"Do pass, but first be re-referred to the Committee on [Appropriations] with the recommendation: To Consent Calendar",3,0,0,1,4
1714731,1318973,2023-05-04,Senate,"Consent Calendar SB780 Alvarado-Gil",37,0,0,3,40
1714731,1346139,2023-06-21,Assembly,"Do pass and be re-referred to the Committee on [Appropriations] with recommendation: To Consent Calendar",10,0,0,1,11
1714731,1350517,2023-07-12,Assembly,"Do pass. To Consent Calendar",15,0,0,1,16
1714731,1351700,2023-08-17,Assembly,"SB 780 Alvarado-Gil Consent Calendar Second Day Regular Session",75,0,0,5,80
1714731,1354536,2023-09-11,Senate,"Unfinished Business SB780 Alvarado-Gil Concurrence",38,0,0,2,40
1714732,1288153,2023-03-29,Senate,"Do pass as amended, but first amend, and re-refer to the Committee on [Energy, Utilities and Communications]",5,2,0,0,7
1714732,1310184,2023-04-24,Senate,"Do pass as amended, but first amend, and re-refer to the Committee on [Appropriations]",14,2,0,2,18
1714732,1324950,2023-05-15,Senate,"Placed on suspense file",7,0,0,0,7
1714732,1328824,2023-05-18,Senate,"Do pass",5,2,0,0,7
1714732,1335567,2023-05-30,Senate,"Senate 3rd Reading SB781 Stern",29,5,0,6,40
1714732,1347542,2023-06-26,Assembly,"Do pass as amended and be re-referred to the Committee on [Utilities and Energy]",8,3,0,0,11
1714732,1350411,2023-07-12,Assembly,"Do pass and be re-referred to the Committee on [Appropriations]",10,0,0,5,15
1714733,1363746,2024-01-09,Senate,"Do pass, but first be re-referred to the Committee on [Judiciary]",15,0,0,0,15
1714733,1364115,2024-01-11,Senate,"Do pass, but first be re-referred to the Committee on [Appropriations] with the recommendation: To Consent Calendar",10,0,0,1,11
1714733,1364832,2024-01-16,Senate,"Placed on suspense file",6,0,0,1,7
1714733,1366766,2024-01-18,Senate,"Do pass",6,0,0,1,7
1714733,1371115,2024-01-29,Senate,"Senate 3rd Reading SB782 Lim√≥n",39,0,0,1,40
1714733,1454257,2024-06-05,Assembly,"Do pass and be re-referred to the Committee on [Judiciary] with recommendation: To Consent Calendar",19,0,0,3,22
1714733,1456358,2024-06-11,Assembly,"Do pass and be re-referred to the Committee on [Appropriations] with recommendation: To Consent Calendar",12,0,0,0,12
1714733,1464492,2024-08-15,Assembly,"Do pass as amended",11,0,0,4,15
1714733,1465653,2024-08-26,Assembly,"SB 782 Lim√≥n Senate Third Reading By Wendy Carrillo",76,0,0,3,79
1714733,1467202,2024-08-28,Senate,"Unfinished Business SB782 Lim√≥n et al. Concurrence",36,0,0,4,40
1714734,1298199,2023-04-10,Senate,"Do pass, but first be re-referred to the Committee on [Health] with the recommendation: To Consent Calendar",4,0,0,1,5
1714734,1313487,2023-04-26,Senate,"Do pass as amended, but first amend, and re-refer to the Committee on [Appropriations] with the recommendation: To Consent Calendar",11,0,0,1,12
1714734,1320416,2023-05-08,Senate,"Placed on suspense file",7,0,0,0,7
1714734,1328809,2023-05-18,Senate,"Do pass as amended",7,0,0,0,7
1714734,1336364,2023-05-31,Senate,"Senate 3rd Reading SB783 Archuleta et al",40,0,0,0,40
1714735,1302594,2023-04-17,Senate,"Do pass, but first be re-referred to the Committee on [Health]",12,0,0,1,13
1714735,1313479,2023-04-26,Senate,"Do pass, but first be re-referred to the Committee on [Appropriations]",10,0,0,2,12
1714735,1364741,2024-01-16,Senate,"Placed on suspense file",6,0,0,1,7
1714736,1302653,2023-04-17,Senate,"Do pass, but first be re-referred to the Committee on [Judiciary]",9,1,0,3,13
1714736,1311868,2023-04-25,Senate,"Do pass as amended, but first amend, and re-refer to the Committee on [Appropriations]",8,0,0,3,11
1714736,1324973,2023-05-15,Senate,"Placed on suspense file",7,0,0,0,7
1714736,1327998,2023-05-18,Senate,"Do pass",5,1,0,1,7
1714736,1335410,2023-05-30,Senate,"Senate 3rd Reading SB785 Caballero et al",34,0,0,6,40
1714736,1350130,2023-07-11,Assembly,"Do pass and be re-referred to the Committee on [Privacy and Consumer Protection]",5,0,0,2,7
1714736,1462439,2024-07-02,Assembly,"Do pass as amended and be re-referred to the Committee on [Appropriations]",9,0,0,2,11
1714736,1464351,2024-08-15,Assembly,"Do pass as amended",11,0,0,4,15
1714737,1305221,2023-04-19,Senate,"Do pass as amended",9,0,0,3,12
1714737,1330095,2023-05-22,Senate,"Senate 3rd Reading SB786 Portantino",35,0,0,5,40
1714737,1350213,2023-07-11,Assembly,"Do pass",15,0,0,0,15
1714737,1352208,2023-08-24,Assembly,"SB 786 Portantino Senate Third Reading By Zbur",76,0,0,4,80
1714737,1353256,2023-09-06,Senate,"Unfinished Business SB786 Portantino Concurrence",40,0,0,0,40
1714738,1286921,2023-03-28,Senate,"Do pass, but first be re-referred to the Committee on [Appropriations]",13,0,0,2,15
1714738,1330144,2023-05-22,Senate,"Senate 3rd Reading SB787 Dahle",40,0,0,0,40
1714738,1344224,2023-06-14,Assembly,"Do pass and be re-referred to the Committee on [Appropriations]",21,0,0,1,22
1714738,1348454,2023-06-28,Assembly,"Do pass. To Consent Calendar",14,0,0,2,16
1714738,1349498,2023-07-03,Assembly,"SB 787 Dahle Consent Calendar Second Day Regular Session",69,0,0,11,80
1714739,1286961,2023-03-28,Senate,"Do pass, but first be re-referred to the Committee on [Appropriations] with the recommendation: To Consent Calendar",14,0,0,1,15
1714739,1301001,2023-04-13,Senate,"Consent Calendar SB788 Ashby et al",36,0,0,4,40
1714739,1344206,2023-06-14,Assembly,"Do pass and be re-referred to the Committee on [Appropriations]",18,0,0,4,22
1714739,1348359,2023-06-28,Assembly,"Do pass. To Consent Calendar",14,0,0,2,16
1714739,1349439,2023-07-03,Assembly,"SB 788 Ashby Consent Calendar Second Day Regular Session",69,0,0,11,80
1714740,1305403,2023-04-18,Senate,"Do pass, but first be re-referred to the Committee on [Appropriations]",6,0,0,1,7
1714740,1323812,2023-05-11,Senate,"Senate 3rd Reading SB789 Allen et al",39,0,0,1,40
1714740,1341047,2023-06-07,Assembly,"Do pass as amended, and be re-referred to the Committee on [Appropriations] with recommendation: To Consent Calendar",8,0,0,0,8
1714740,1346303,2023-06-21,Assembly,"Do pass. To Consent Calendar",13,0,0,3,16
1714740,1351664,2023-08-17,Assembly,"SB 789 Allen Senate Third Reading By Low Amendment Set #1",70,0,0,10,80
1714740,1352475,2023-08-31,Assembly,"SB 789 Allen Senate Third Reading By Low",73,0,0,7,80
1714740,1353233,2023-09-06,Senate,"Unfinished Business SB789 Allen et al. Concurrence",34,0,0,6,40
1714740,1353807,2023-09-12,Assembly,"SB 789 Allen Senate Third Reading By Aguiar-Curry",59,14,0,7,80
1714740,1354147,2023-09-13,Senate,"Unfinished Business SB789 Allen et al. Concurrence",32,7,0,1,40
1714741,1299494,2023-04-11,Senate,"Do pass, but first be re-referred to the Committee on [Appropriations] with the recommendation: To Consent Calendar",10,0,0,1,11
1714741,1315670,2023-05-01,Senate,"Consent Calendar SB790 Padilla",37,0,0,3,40
1714741,1340043,2023-06-06,Assembly,"Do pass and be re-referred to the Committee on [Appropriations] with recommendation: To Consent Calendar",11,0,0,0,11
1714741,1346152,2023-06-21,Assembly,"Do pass. To Consent Calendar",13,0,0,3,16
1714741,1347909,2023-06-27,Assembly,"SB 790 Padilla Consent Calendar Second Day Regular Session",78,0,0,2,80
1714742,1299396,2023-04-12,Senate,"Do pass, but first be re-referred to the Committee on [Judiciary]",7,0,0,0,7
1714742,1305486,2023-04-18,Senate,"Do pass, but first be re-referred to the Committee on [Appropriations]",11,0,0,0,11
1714742,1315762,2023-05-01,Senate,"Placed on suspense file",6,0,0,1,7
1714742,1328150,2023-05-18,Senate,"Do pass",7,0,0,0,7
1714742,1335530,2023-05-30,Senate,"Senate 3rd Reading SB791 McGuire",40,0,0,0,40
1714742,1348376,2023-06-27,Assembly,"Do pass and be re-referred to the Committee on [Appropriations]",11,0,0,1,12
1714742,1352936,2023-09-01,Assembly,"Do pass",16,0,0,0,16
1714742,1354320,2023-09-13,Assembly,"SB 791 McGuire Senate Third Reading By Weber",80,0,0,0,80
1714742,1354731,2023-09-14,Senate,"Unfinished Business SB791 McGuire Concurrence",40,0,0,0,40
1714743,1310219,2023-04-25,Senate,"Do pass, but first be re-referred to the Committee on [Appropriations] with the recommendation: To Consent Calendar",15,0,0,0,15
1714743,1323890,2023-05-11,Senate,"Consent Calendar SB792 Smallwood-Cuevas",39,0,0,1,40
1714744,1299506,2023-04-12,Senate,"Do pass, but first be re-referred to the Committee on [Judiciary]",7,0,0,0,7
1714744,1311771,2023-04-25,Senate,"Do pass, but first be re-referred to the Committee on [Appropriations] with the recommendation: To Consent Calendar",11,0,0,0,11
1714744,1323811,2023-05-11,Senate,"Consent Calendar SB793 Glazer",39,0,0,1,40
1714744,1343716,2023-06-13,Assembly,"Do pass and be re-referred to the Committee on [Insurance] with recommendation: To Consent Calendar",10,0,0,1,11
1714744,1348299,2023-06-28,Assembly,"Do pass and be re-referred to the Committee on [Appropriations] with recommendation: To Consent Calendar",13,0,0,1,14
1714744,1351584,2023-08-16,Assembly,"Do pass. To Consent Calendar",15,0,0,1,16
1714744,1352247,2023-08-24,Assembly,"SB 793 Glazer Consent Calendar Second Day Regular Session",73,0,0,7,80
1714745,1288374,2023-03-29,Senate,"Do pass, but first be re-referred to the Committee on [Judiciary]",3,3,0,1,7
1714745,1288375,2023-03-29,Senate,"[First] hearing set for [03-29-2023]: Failed passage in Committee. Reconsideration granted",7,0,0,0,7
1714746,1304305,2023-04-18,Senate,"Do pass, but first be re-referred to the Committee on [Rules]",13,4,0,1,18
1714746,1311906,2023-04-25,Senate,"Do pass as amended, but first amend, and re-refer to the Committee on [Appropriations]",8,2,0,1,11
1714746,1320450,2023-05-08,Senate,"Placed on suspense file",7,0,0,0,7
1714746,1328761,2023-05-18,Senate,"Do pass",5,2,0,0,7
1714746,1335500,2023-05-30,Senate,"Senate 3rd Reading SB795 Stern et al",32,8,0,0,40
1714746,1348385,2023-06-28,Assembly,"Do pass and be re-referred to the Committee on [Judiciary]",12,1,0,2,15
1714746,1350297,2023-07-11,Assembly,"Do pass as amended and be re-referred to the Committee on [Appropriations]",9,2,0,0,11
1714747,1310162,2023-04-25,Senate,"Do pass as amended, but first amend, and re-refer to the Committee on [Appropriations]",5,0,0,0,5
1714747,1320534,2023-05-08,Senate,"Placed on suspense file",7,0,0,0,7
1714747,1328167,2023-05-18,Senate,"Do pass",7,0,0,0,7
1714747,1333628,2023-05-25,Senate,"Special Consent SB796 Alvarado-Gil et al",40,0,0,0,40
1714747,1453379,2024-06-04,Assembly,"Do pass and be re-referred to the Committee on [Appropriations]",7,0,0,1,8
1714748,1288334,2023-03-29,Senate,"Do pass as amended, but first amend, and re-refer to the Committee on [Appropriations]",6,1,0,1,8
1714748,1302574,2023-04-17,Senate,"Placed on suspense file",6,0,0,1,7
1714748,1328073,2023-05-18,Senate,"Do pass",5,1,0,1,7
1714748,1335471,2023-05-30,Senate,"Senate 3rd Reading SB797 Padilla et al",35,0,0,5,40
1714748,1348333,2023-06-26,Assembly,"Do pass and be re-referred to the Committee on [Appropriations]",8,0,0,3,11
1714748,1352911,2023-09-01,Assembly,"Do pass as amended",12,1,0,3,16
1714748,1353914,2023-09-12,Assembly,"SB 797 Padilla Senate Third Reading By Garcia",74,0,0,6,80
1714748,1354326,2023-09-13,Senate,"Unfinished Business SB797 Padilla et al. Concurrence",33,0,0,7,40
1714749,1288151,2023-03-29,Senate,"Do pass, but first be re-referred to the Committee on [Elections and Constitutional Amendments]",8,0,0,0,8
1714749,1305295,2023-04-18,Senate,"Do pass and be ordered to the Consent Calendar",7,0,0,0,7
1714749,1315764,2023-05-01,Senate,"Consent Calendar SB798 Glazer et al",37,0,0,3,40
1714749,1341018,2023-06-07,Assembly,"Do pass. To Consent Calendar",8,0,0,0,8
1714749,1353222,2023-09-06,Assembly,"SB 798 Glazer Senate Third Reading By Pellerin",79,0,0,1,80
1714750,1304410,2023-04-18,Senate,"Do pass, but first be re-referred to the Committee on [Appropriations] with the recommendation: To Consent Calendar",5,0,0,0,5
1714750,1315752,2023-05-01,Senate,"Placed on suspense file",6,0,0,1,7
1714750,1328129,2023-05-18,Senate,"Do pass",7,0,0,0,7
1714750,1333726,2023-05-25,Senate,"Special Consent SB799 Durazo",40,0,0,0,40
1714750,1352476,2023-08-31,Assembly,"Do pass and be re-referred to the Committee on [Appropriations]",11,2,0,1,14
1714750,1353409,2023-09-07,Assembly,"Do pass",12,4,0,0,16
1714750,1353694,2023-09-11,Assembly,"SB 799 Portantino Senate Third Reading By Holden",59,18,0,3,80
1714750,1354315,2023-09-13,Senate,"That the Assembly amendments be concurred in",4,1,0,0,5
1714750,1354766,2023-09-14,Senate,"Unfinished Business SB799 Portantino et al. Concurrence",27,12,0,1,40
1714751,1311725,2023-04-25,Senate,"Do pass as amended, but first amend, and re-refer to the Committee on [Appropriations]",15,0,0,1,16
1714751,1325001,2023-05-15,Senate,"Placed on suspense file",7,0,0,0,7
1714751,1328816,2023-05-18,Senate,"Do pass",7,0,0,0,7
1714751,1333746,2023-05-25,Senate,"Special Consent SB800 Caballero",40,0,0,0,40
1714751,1347789,2023-06-26,Assembly,"Do pass and be re-referred to the Committee on [Appropriations] with recommendation: To Consent Calendar",15,0,0,0,15
1714751,1352929,2023-09-01,Assembly,"Do pass as amended",11,0,0,5,16
1714751,1354549,2023-09-14,Senate,"Unfinished Business SB800 Caballero et al. Concurrence",40,0,0,0,40
1714751,1354550,2023-09-14,Assembly,"SB 800 Caballero Senate Third Reading By Valencia",79,0,0,1,80
1714752,1317079,2023-05-02,Senate,"Do pass and be ordered to the Consent Calendar",10,0,0,1,11
1714752,1323858,2023-05-11,Senate,"Consent Calendar SB801 Allen",39,0,0,1,40
1714752,1339985,2023-06-06,Assembly,"Do pass as amended. To Consent Calendar",11,0,0,0,11
1714752,1344730,2023-06-15,Assembly,"SB 801 Allen Consent Calendar Second Day Regular Session",74,0,0,6,80
1714752,1352245,2023-08-24,Assembly,"SB 801 Allen Senate Third Reading By Maienschein Amendment Set #1",72,0,0,8,80
1714752,1352326,2023-08-28,Assembly,"SB 801 Allen Senate Third Reading By Maienschein",76,0,0,4,80
1714752,1353516,2023-09-07,Senate,"Special Consent SB801 Allen",40,0,0,0,40
1714753,1285653,2023-03-27,Senate,"Do pass, but first be re-referred to the Committee on [Appropriations] with the recommendation: To Consent Calendar",12,0,0,1,13
1714753,1300973,2023-04-13,Senate,"Consent Calendar SB802 Roth",36,0,0,4,40
1714754,1298182,2023-04-11,Senate,"Do pass, but first be re-referred to the Committee on [Appropriations] with the recommendation: To Consent Calendar",15,0,0,0,15
1714754,1308881,2023-04-24,Senate,"Placed on suspense file",7,0,0,0,7
1714754,1328416,2023-05-18,Senate,"Do pass as amended",7,0,0,0,7
1714754,1335424,2023-05-30,Senate,"Special Consent SB803 Becker",40,0,0,0,40
1714754,1350415,2023-07-12,Assembly,"Do pass and be re-referred to the Committee on [Appropriations]",5,0,0,2,7
1714754,1353092,2023-09-01,Assembly,"Do pass as amended",11,3,0,2,16
1714755,1304255,2023-04-18,Senate,"Do pass",2,2,0,1,5
1714755,1304256,2023-04-18,Senate,"[First] hearing set for [04-18-2023]: Failed passage in Committee. Reconsideration granted",5,0,0,0,5
1714755,1363772,2024-01-09,Senate,"Do pass",3,0,0,2,5
1714755,1371087,2024-01-29,Senate,"Senate 3rd Reading SB804 Dahle",32,2,0,6,40
1714755,1462500,2024-07-02,Assembly,"Do pass",5,0,0,3,8
1714755,1465476,2024-08-22,Assembly,"SB 804 Dahle Senate Third Reading By Alanis",46,7,0,26,79
1714756,1305466,2023-04-19,Senate,"Do pass as amended, but first amend, and re-refer to the Committee on [Human Services]",11,0,0,1,12
1714756,1310240,2023-04-24,Senate,"Do pass, but first be re-referred to the Committee on [Appropriations]",5,0,0,0,5
1714756,1320511,2023-05-08,Senate,"Placed on suspense file",7,0,0,0,7
1714756,1328414,2023-05-18,Senate,"Do pass",7,0,0,0,7
1714756,1333817,2023-05-25,Senate,"Special Consent SB805 Portantino",40,0,0,0,40
1714756,1347865,2023-06-27,Assembly,"Do pass and be re-referred to the Committee on [Human Services]",15,0,0,0,15
1714756,1350230,2023-07-11,Assembly,"Do pass and be re-referred to the Committee on [Appropriations]",7,0,0,1,8
1714756,1352529,2023-09-01,Assembly,"Do pass",15,0,0,1,16
1714756,1353675,2023-09-11,Assembly,"SB 805 Portantino Senate Third Reading By Bains",78,1,0,1,80
1714756,1354035,2023-09-12,Senate,"Unfinished Business SB805 Portantino Concurrence",39,0,0,1,40
1714757,1311704,2023-04-25,Senate,"Do pass as amended, but first amend, and re-refer to the Committee on [Appropriations]",11,0,0,0,11
1714757,1333566,2023-05-25,Senate,"Senate 3rd Reading SB806 Archuleta",40,0,0,0,40
1714757,1349562,2023-07-05,Assembly,"Do pass as amended and be re-referred to the Committee on [Appropriations]",13,2,0,0,15
1714757,1352113,2023-08-23,Assembly,"Do pass",11,4,0,1,16
1714757,1354388,2023-09-13,Assembly,"SB 806 Archuleta Senate Third Reading By Calderon",65,12,0,3,80
1714757,1354705,2023-09-14,Senate,"Unfinished Business SB806 Archuleta Concurrence",40,0,0,0,40
1714758,1311862,2023-04-25,Senate,"Do pass, but first be re-referred to the Committee on [Appropriations] with the recommendation: To Consent Calendar",11,0,0,0,11
1714758,1335427,2023-05-30,Senate,"Senate 3rd Reading SB807 Ochoa Bogh",40,0,0,0,40
1714759,1288215,2023-03-29,Senate,"Do pass as amended, but first amend, and re-refer to the Committee on [Judiciary]",6,0,0,1,7
1714759,1311790,2023-04-25,Senate,"Do pass as amended, but first amend, and re-refer to the Committee on [Appropriations] with the recommendation: To Consent Calendar",11,0,0,0,11
1714759,1320547,2023-05-08,Senate,"Placed on suspense file",7,0,0,0,7
1714759,1328153,2023-05-18,Senate,"Do pass",7,0,0,0,7
1714759,1333575,2023-05-25,Senate,"Special Consent SB808 Dodd",40,0,0,0,40
1714759,1348357,2023-06-27,Assembly,"Do pass and be re-referred to the Committee on [Appropriations]",11,0,0,1,12
1714759,1351551,2023-08-16,Assembly,"Do pass. To Consent Calendar",15,0,0,1,16
1714759,1352243,2023-08-24,Assembly,"SB 808 Dodd Consent Calendar Second Day Regular Session",73,0,0,7,80
1714759,1353076,2023-09-01,Senate,"Special Consent SB808 Dodd",37,0,0,3,40
1714760,1311904,2023-04-25,Senate,"Do pass as amended, but first amend, and re-refer to the Committee on [Appropriations]",8,2,0,1,11
1714760,1320559,2023-05-08,Senate,"Placed on suspense file",7,0,0,0,7
1714762,1288367,2023-03-29,Senate,"Do pass, but first be re-referred to the Committee on [Judiciary]",7,0,0,0,7
1714762,1311863,2023-04-25,Senate,"Do pass, but first be re-referred to the Committee on [Appropriations]",7,0,0,4,11
1714762,1320492,2023-05-08,Senate,"Placed on suspense file",7,0,0,0,7
1714762,1328456,2023-05-18,Senate,"Do pass",7,0,0,0,7
1714762,1336380,2023-05-31,Senate,"Senate 3rd Reading SB811 Jones et al",34,1,0,5,40
1714763,1308828,2023-04-24,Senate,"Do pass as amended, but first amend, and re-refer to the Committee on [Appropriations]",13,0,0,0,13
1714763,1332570,2023-05-24,Senate,"Senate 3rd Reading SB812 Roth et al",39,0,0,1,40
1714763,1350257,2023-07-11,Assembly,"Do pass and be re-referred to the Committee on [Appropriations]",19,0,0,0,19
1714763,1351591,2023-08-16,Assembly,"Do pass. To Consent Calendar",15,0,0,1,16
1714763,1352214,2023-08-24,Assembly,"SB 812 Roth Consent Calendar Second Day Regular Session",73,0,0,7,80
1714764,1308834,2023-04-24,Senate,"Do pass as amended, but first amend, and re-refer to the Committee on [Appropriations]",13,0,0,0,13
1714764,1320424,2023-05-08,Senate,"Placed on suspense file",7,0,0,0,7
1714764,1328513,2023-05-18,Senate,"Do pass",7,0,0,0,7
1714764,1333656,2023-05-25,Senate,"Special Consent SB813 Roth et al",40,0,0,0,40
1714764,1350235,2023-07-11,Assembly,"Do pass and be re-referred to the Committee on [Appropriations] with recommendation: To Consent Calendar",19,0,0,0,19
1714764,1352989,2023-09-01,Assembly,"Do pass",16,0,0,0,16
1714764,1353676,2023-09-11,Assembly,"SB 813 Roth Senate Third Reading By Berman",79,0,0,1,80
1714765,1308781,2023-04-24,Senate,"Do pass as amended, but first amend, and re-refer to the Committee on [Appropriations]",13,0,0,0,13
1714765,1320411,2023-05-08,Senate,"Placed on suspense file",7,0,0,0,7
1714765,1328697,2023-05-18,Senate,"Do pass as amended",7,0,0,0,7
1714765,1335415,2023-05-30,Senate,"Special Consent SB814 Roth et al",40,0,0,0,40
1714765,1350260,2023-07-11,Assembly,"Do pass and be re-referred to the Committee on [Appropriations]",19,0,0,0,19
1714765,1352692,2023-09-01,Assembly,"Do pass",16,0,0,0,16
1714765,1354247,2023-09-13,Assembly,"SB 814 Roth Senate Third Reading By Berman",80,0,0,0,80
1714765,1354844,2023-09-14,Senate,"Unfinished Business SB814 Roth et al. Concurrence",40,0,0,0,40
1714766,1308802,2023-04-24,Senate,"Do pass as amended",10,1,0,2,13
1714766,1325046,2023-05-15,Senate,"Placed on suspense file",7,0,0,0,7
1714766,1328171,2023-05-18,Senate,"Do pass",5,0,0,2,7
1714766,1336324,2023-05-31,Senate,"Senate 3rd Reading SB815 Roth et al",32,1,0,7,40
1714766,1350152,2023-07-11,Assembly,"Do pass as amended and be re-referred to the Committee on [Appropriations]",10,5,0,4,19
1714766,1352505,2023-09-01,Assembly,"Do pass as amended",11,3,0,2,16
1714766,1354544,2023-09-14,Senate,"Unfinished Business SB815 Roth et al. Concurrence",35,1,0,4,40
1714766,1354545,2023-09-14,Assembly,"SB 815 Roth Senate Third Reading By Berman",55,15,0,10,80
1714767,1308870,2023-04-24,Senate,"Do pass, but first be re-referred to the Committee on [Appropriations]",12,0,0,1,13
1714767,1332582,2023-05-24,Senate,"Senate 3rd Reading SB816 Roth",39,0,0,1,40
1714767,1350138,2023-07-11,Assembly,"Do pass as amended and be re-referred to the Committee on [Appropriations]",13,2,0,4,19
1714767,1352799,2023-09-01,Assembly,"Do pass",11,3,0,2,16
1714767,1353726,2023-09-12,Assembly,"SB 816 Roth Senate Third Reading By Berman",59,11,0,10,80
1714767,1354303,2023-09-13,Senate,"That the Assembly amendments be concurred in",8,3,0,2,13
1714767,1354713,2023-09-14,Senate,"Unfinished Business SB816 Roth Concurrence",31,9,0,0,40
1714768,1285596,2023-03-27,Senate,"Do pass, but first be re-referred to the Committee on [Appropriations]",12,0,0,1,13
1714768,1332548,2023-05-24,Senate,"Senate 3rd Reading SB817 Roth",39,0,0,1,40
1714768,1350190,2023-07-11,Assembly,"Do pass and be re-referred to the Committee on [Appropriations]",17,0,0,2,19
1714769,1285753,2023-03-27,Senate,"Do pass and be ordered to the Consent Calendar",12,0,0,1,13
1714769,1289818,2023-03-30,Senate,"Consent Calendar SB818 Roth",35,0,0,5,40
1714770,1305529,2023-04-19,Senate,"Do pass as amended, but first amend, and re-refer to the Committee on [Appropriations] with the recommendation: To Consent Calendar",11,0,0,1,12
1714770,1318913,2023-05-04,Senate,"Consent Calendar SB819 Eggman",37,0,0,3,40
1714770,1350167,2023-07-11,Assembly,"Do pass and be re-referred to the Committee on [Appropriations] with recommendation: To Consent Calendar",15,0,0,0,15
1714770,1351594,2023-08-16,Assembly,"Do pass. To Consent Calendar",15,0,0,1,16
1714770,1466510,2024-08-30,Assembly,"SB 819 Eggman Senate Third Reading By Flora",77,0,0,2,79
1714770,1467181,2024-08-31,Senate,"Unfinished Business SB819 Eggman Concurrence",40,0,0,0,40
1714771,1302675,2023-04-17,Senate,"Do pass, but first be re-referred to the Committee on [Public Safety]",11,0,0,2,13
1714771,1310381,2023-04-25,Senate,"Do pass as amended, but first amend, and re-refer to the Committee on [Appropriations]",5,0,0,0,5
1714771,1324946,2023-05-15,Senate,"Placed on suspense file",7,0,0,0,7
1714771,1366801,2024-01-18,Senate,"Do pass",6,0,0,1,7
1714771,1371120,2024-01-29,Senate,"Senate 3rd Reading SB820 Alvarado-Gil",36,0,0,4,40
1714771,1456337,2024-06-11,Assembly,"Do pass and be re-referred to the Committee on [Public Safety]",17,0,0,1,18
1714771,1462464,2024-07-02,Assembly,"Do pass and be re-referred to the Committee on [Appropriations]",6,0,0,2,8
1714772,1305461,2023-04-18,Senate,"Do pass and be ordered to the Consent Calendar",7,0,0,0,7
1714772,1315658,2023-05-01,Senate,"Consent Calendar SB821 Glazer",37,0,0,3,40
1714773,1301018,2023-04-12,Senate,"Do pass as amended, but first amend, and re-refer to the Committee on [Governmental Organization]",4,1,0,0,5
1714773,1310317,2023-04-25,Senate,"Do pass as amended, but first amend, and re-refer to the Committee on [Appropriations]",8,5,0,2,15
1714773,1320435,2023-05-08,Senate,"Placed on suspense file",7,0,0,0,7
1714773,1328898,2023-05-18,Senate,"Do pass as amended",5,2,0,0,7
1714773,1336373,2023-05-31,Senate,"Senate 3rd Reading SB822 Durazo et al",31,8,0,1,40
1714773,1348401,2023-06-28,Assembly,"Do pass and be re-referred to the Committee on [Jobs, Economic Development, and the Economy]",7,0,0,0,7
1714773,1350164,2023-07-11,Assembly,"Do pass and be re-referred to the Committee on [Appropriations]",6,1,0,0,7
1714773,1352905,2023-09-01,Assembly,"Do pass as amended",11,2,0,3,16
1714773,1353564,2023-09-08,Assembly,"SB 822 Durazo Senate Third Reading By Schiavo Amendment Set #1",60,12,0,8,80
1714773,1354752,2023-09-14,Senate,"Unfinished Business SB822 Durazo et al. Concurrence",31,8,0,1,40
1714773,1354753,2023-09-14,Assembly,"SB 822 Durazo Senate Third Reading By Schiavo",68,9,0,3,80
1714774,1310370,2023-04-24,Senate,"Do pass as amended, but first amend, and re-refer to the Committee on [Appropriations]",15,1,0,2,18
1714774,1324966,2023-05-15,Senate,"Placed on suspense file",7,0,0,0,7
1714775,1304381,2023-04-17,Senate,"Do pass, but first be re-referred to the Committee on [Judiciary]",4,0,0,1,5
1714775,1311903,2023-04-25,Senate,"Do pass, but first be re-referred to the Committee on [Appropriations] with the recommendation: To Consent Calendar",11,0,0,0,11
1714775,1320466,2023-05-08,Senate,"Placed on suspense file",7,0,0,0,7
1714775,1328359,2023-05-18,Senate,"Do pass",7,0,0,0,7
1714775,1330092,2023-05-22,Senate,"Senate 3rd Reading SB824 Ashby et al",40,0,0,0,40
1714775,1339969,2023-06-06,Assembly,"Do pass and be re-referred to the Committee on [Judiciary] with recommendation: To Consent Calendar",8,0,0,0,8
1714775,1343694,2023-06-13,Assembly,"Do pass and be re-referred to the Committee on [Appropriations]",10,0,0,1,11
1714776,1299507,2023-04-12,Senate,"Do pass and be ordered to the Consent Calendar",8,0,0,0,8
1714776,1306719,2023-04-20,Senate,"Consent Calendar SB825 Lim√≥n",36,0,0,4,40
1714776,1341020,2023-06-07,Assembly,"Do pass. To Consent Calendar",8,0,0,0,8
1714776,1352257,2023-08-24,Assembly,"SB 825 Lim√≥n Senate Third Reading By Hart",74,0,0,6,80
1714778,1299378,2023-04-11,Senate,"Do pass, but first be re-referred to the Committee on [Judiciary]",7,1,0,8,16
1714778,1299379,2023-04-11,Senate,"[First] hearing set for [04-12-2023]: Failed passage in Committee. Reconsideration granted",16,0,0,0,16
1714778,1363766,2024-01-09,Senate,"Do pass, but first be re-referred to the Committee on [Judiciary]",15,0,0,0,15
1714778,1364110,2024-01-11,Senate,"Do pass, but first be re-referred to the Committee on [Appropriations]",10,0,0,1,11
1714778,1371083,2024-01-29,Senate,"Senate 3rd Reading SB827 Glazer",39,0,0,1,40
1714778,1458219,2024-06-17,Assembly,"Do pass and be re-referred to the Committee on [Judiciary]",15,0,0,0,15
1714778,1462313,2024-07-02,Assembly,"Do pass as amended",11,0,0,1,12
1714779,1310343,2023-04-25,Senate,"Do pass, but first be re-referred to the Committee on [Appropriations] with the recommendation: To Consent Calendar",5,0,0,0,5
1714779,1323809,2023-05-11,Senate,"Consent Calendar SB828 Smallwood-Cuevas",39,0,0,1,40
1714779,1445179,2024-05-20,Assembly,"SB 828 Smallwood-Cuevas Senate Second Reading By HANEY Amendment Set #1",53,15,0,12,80
1714779,1448794,2024-05-22,Assembly,"Do pass",7,0,0,0,7
1714779,1449571,2024-05-23,Assembly,"SB 828 Durazo Third Reading Urgency By HANEY",61,7,0,12,80
1714779,1451584,2024-05-29,Senate,"That the Assembly amendments be concurred in",4,0,0,1,5
1714779,1452235,2024-05-30,Senate,"Unfinished Business SB828 Durazo Urgency Clause Concurrence",31,1,0,8,40
1714780,1302598,2023-04-17,Senate,"Do pass, but first be re-referred to the Committee on [Judiciary]",11,0,0,2,13
1714780,1311650,2023-04-25,Senate,"Do pass, but first be re-referred to the Committee on [Appropriations]",9,0,0,2,11
1714780,1320376,2023-05-08,Senate,"Placed on suspense file",7,0,0,0,7
1714780,1328851,2023-05-18,Senate,"Do pass",6,0,0,1,7
1714780,1336358,2023-05-31,Senate,"Senate 3rd Reading SB829 Wilk et al",40,0,0,0,40
1714781,1311898,2023-04-26,Senate,"Do pass, but first be re-referred to the Committee on [Appropriations]",4,1,0,0,5
1714781,1320433,2023-05-08,Senate,"Placed on suspense file",7,0,0,0,7
1714781,1328880,2023-05-18,Senate,"Do pass",5,2,0,0,7
1714781,1336382,2023-05-31,Senate,"Senate 3rd Reading SB830 Smallwood-Cuevas et",30,9,0,1,40
1714781,1348484,2023-06-28,Assembly,"Do pass and be re-referred to the Committee on [Appropriations]",7,0,0,0,7
1714781,1352812,2023-09-01,Assembly,"Do pass as amended",12,3,0,1,16
1714782,1304264,2023-04-17,Senate,"Do pass, but first be re-referred to the Committee on [Public Safety]",4,0,0,1,5
1714782,1310141,2023-04-25,Senate,"Do pass, but first be re-referred to the Committee on [Appropriations]",5,0,0,0,5
1714782,1320520,2023-05-08,Senate,"Placed on suspense file",7,0,0,0,7
1714782,1327986,2023-05-18,Senate,"Do pass",5,2,0,0,7
1714782,1335534,2023-05-30,Senate,"Senate 3rd Reading SB831 Caballero",34,2,0,4,40
1714782,1350180,2023-07-11,Assembly,"Do pass and be re-referred to the Committee on [Appropriations]",6,0,0,2,8
1714782,1352992,2023-09-01,Assembly,"Do pass as amended",12,2,0,2,16
1714782,1354792,2023-09-14,Senate,"Unfinished Business SB831 Caballero Concurrence",34,5,0,1,40
1714782,1354793,2023-09-14,Assembly,"SB 831 Caballero Senate Third Reading By Garcia",65,11,0,4,80
1714783,1298317,2023-04-11,Senate,"Do pass, but first be re-referred to the Committee on [Appropriations]",1,2,0,2,5
1714783,1298318,2023-04-11,Senate,"[First] hearing set for [04-11-2023]: Failed passage in Committee. Reconsideration granted",5,0,0,0,5
1714784,1308798,2023-04-24,Senate,"Do pass, but first be re-referred to the Committee on [Appropriations]",12,0,0,1,13
1714784,1320505,2023-05-08,Senate,"Placed on suspense file",7,0,0,0,7
1714784,1328544,2023-05-18,Senate,"Do pass",6,0,0,1,7
1714784,1335451,2023-05-30,Senate,"Senate 3rd Reading SB833 McGuire",37,1,0,2,40
1714784,1347788,2023-06-27,Assembly,"Do pass and be re-referred to the Committee on [Appropriations] with recommendation: To Consent Calendar",18,0,0,1,19
1714784,1351563,2023-08-16,Assembly,"Do pass. To Consent Calendar",15,0,0,1,16
1714784,1352244,2023-08-24,Assembly,"SB 833 McGuire Consent Calendar Second Day Regular Session",73,0,0,7,80
1714784,1354335,2023-09-13,Senate,"Unfinished Business SB833 McGuire Concurrence",38,0,0,2,40
1714785,1305324,2023-04-18,Senate,"Do pass, but first be re-referred to the Committee on [Governance and Finance]",8,2,0,1,11
1714785,1313502,2023-04-26,Senate,"Do pass as amended, but first amend, and re-refer to the Committee on [Appropriations]",6,2,0,0,8
1714785,1325013,2023-05-15,Senate,"Placed on suspense file",7,0,0,0,7
1714785,1328108,2023-05-18,Senate,"Do pass",5,2,0,0,7
1714785,1335414,2023-05-30,Senate,"Senate 3rd Reading SB834 Portantino Urgency Clause",28,9,0,3,40
1714786,1315147,2023-04-25,Senate,"Do pass, but first be re-referred to the Committee on [Appropriations] with the recommendation: To Consent Calendar",10,0,0,1,11
1714786,1323894,2023-05-11,Senate,"Consent Calendar SB835 Smallwood-Cuevas",39,0,0,1,40
1714786,1343114,2023-06-12,Assembly,"Do pass and be re-referred to the Committee on [Appropriations] with recommendation: To Consent Calendar",10,0,0,1,11
1714786,1346173,2023-06-21,Assembly,"Do pass. To Consent Calendar",13,0,0,3,16
1714786,1347880,2023-06-27,Assembly,"SB 835 Smallwood-Cuevas Consent Calendar Second Day Regular Session",78,0,0,2,80
1714787,1315145,2023-04-25,Senate,"Do pass as amended",10,0,0,1,11
1714787,1323867,2023-05-11,Senate,"Special Consent SB836 Dahle",39,0,0,1,40
1714787,1350203,2023-07-11,Assembly,"Do pass as amended",12,0,0,3,15
1714787,1353359,2023-09-07,Assembly,"SB 836 Dahle Senate Third Reading By Megan Dahle",72,2,0,6,80
1714787,1353988,2023-09-12,Senate,"Unfinished Business SB836 Dahle Concurrence",38,0,0,2,40
1714788,1310327,2023-04-24,Senate,"Do pass as amended, but first amend, and re-refer to the Committee on [Appropriations]",17,0,0,1,18
1714788,1325037,2023-05-15,Senate,"Senate 3rd Reading SB837 Archuleta",38,0,0,2,40
1714788,1348322,2023-06-28,Assembly,"Do pass and be re-referred to the Committee on [Appropriations]",13,0,0,2,15
1714788,1352111,2023-08-23,Assembly,"Do pass. To Consent Calendar",15,0,0,1,16
1714788,1352464,2023-08-31,Assembly,"SB 837 Archuleta Consent Calendar Second Day Regular Session",79,0,0,1,80
1714789,1288164,2023-03-28,Senate,"Do pass, but first be re-referred to the Committee on [Appropriations]",5,0,0,0,5
1714789,1296947,2023-04-10,Senate,"Placed on suspense file",7,0,0,0,7
1714792,1298256,2023-04-11,Senate,"Do pass as amended, but first amend, and re-refer to the Committee on [Appropriations] with the recommendation: To Consent Calendar",11,0,0,0,11
1714792,1308790,2023-04-24,Senate,"Placed on suspense file",7,0,0,0,7
1714793,1304357,2023-04-17,Senate,"Do pass, but first be re-referred to the Committee on [Housing] with the recommendation: To Consent Calendar",4,0,0,1,5
1714793,1310365,2023-04-24,Senate,"Do pass, but first be re-referred to the Committee on [Appropriations] with the recommendation: To Consent Calendar",11,0,0,0,11
1714793,1320508,2023-05-08,Senate,"Placed on suspense file",7,0,0,0,7
1714793,1328441,2023-05-18,Senate,"Do pass",7,0,0,0,7
1714793,1333614,2023-05-25,Senate,"Special Consent SB842 Jones Urgency Clause",40,0,0,0,40
1714793,1345653,2023-06-20,Assembly,"Do pass and be re-referred to the Committee on [Appropriations] with recommendation: To Consent Calendar",8,0,0,0,8
1714793,1352873,2023-09-01,Assembly,"Do pass",16,0,0,0,16
1714793,1353653,2023-09-11,Assembly,"Do pass and be re-referred to the Committee on [Appropriations]",14,0,0,1,15
1714793,1354143,2023-09-13,Assembly,"Do pass. To Consent Calendar",13,0,0,3,16
1714793,1354144,2023-09-13,Assembly,"SB 842 Bradford Senate Third Reading By Garcia",76,0,0,4,80
1714793,1354680,2023-09-14,Senate,"Unfinished Business SB842 Bradford Concurrence",26,6,0,8,40
1714794,1304386,2023-04-18,Senate,"Do pass, but first be re-referred to the Committee on [Appropriations]",5,0,0,0,5
1714794,1315778,2023-05-01,Senate,"Placed on suspense file",6,0,0,1,7
1714795,1310149,2023-04-25,Senate,"Do pass, but first be re-referred to the Committee on [Appropriations] with the recommendation: To Consent Calendar",15,0,0,0,15
1714795,1323788,2023-05-11,Senate,"Consent Calendar SB844 Jones",39,0,0,1,40
1714795,1350421,2023-07-12,Assembly,"Do pass and be re-referred to the Committee on [Appropriations] with recommendation: To Consent Calendar",20,0,0,2,22
1714795,1352112,2023-08-23,Assembly,"Do pass. To Consent Calendar",15,0,0,1,16
1714795,1353648,2023-09-11,Assembly,"SB 844 Jones Third Reading Urgency By Villapudua",80,0,0,0,80
1714795,1354834,2023-09-14,Senate,"Unfinished Business SB844 Jones Urgency Clause Concurrence",39,0,0,1,40
1714797,1280630,2023-03-21,Senate,"Do pass, but first be re-referred to the Committee on [Transportation]",6,1,0,0,7
1714797,1311844,2023-04-25,Senate,"Do pass, but first be re-referred to the Committee on [Appropriations]",12,3,0,1,16
1714797,1320396,2023-05-08,Senate,"Placed on suspense file",7,0,0,0,7
1714798,1311817,2023-04-25,Senate,"Do pass, but first be re-referred to the Committee on [Appropriations]",9,0,0,7,16
1714798,1336349,2023-05-31,Senate,"Senate 3rd Reading SB847 Dahle",21,8,0,11,40
1714798,1349653,2023-07-05,Assembly,"Do pass and be re-referred to the Committee on [Appropriations]",15,0,0,0,15
1714798,1352850,2023-09-01,Assembly,"Do pass",16,0,0,0,16
1714798,1354244,2023-09-13,Assembly,"SB 847 Dahle Senate Third Reading By Megan Dahle",74,0,0,6,80
1714798,1354688,2023-09-14,Senate,"Unfinished Business SB847 Dahle Concurrence",31,5,0,4,40
1714799,1306804,2023-04-19,Senate,"Do pass, but first be re-referred to the Committee on [Judiciary]",5,0,0,0,5
1714799,1311755,2023-04-25,Senate,"Do pass, but first be re-referred to the Committee on [Appropriations]",9,1,0,1,11
1714799,1320369,2023-05-08,Senate,"Placed on suspense file",7,0,0,0,7
1714799,1328797,2023-05-18,Senate,"Do pass as amended",5,2,0,0,7
1714799,1332552,2023-05-24,Senate,"Senate 3rd Reading SB848 Rubio et al",35,3,0,2,40
1714799,1344228,2023-06-14,Assembly,"Do pass and be re-referred to the Committee on [Judiciary]",7,0,0,0,7
1714799,1347907,2023-06-27,Assembly,"Do pass as amended and be re-referred to the Committee on [Appropriations]",8,0,0,3,11
1714799,1352751,2023-09-01,Assembly,"Do pass",13,2,0,1,16
1714799,1354099,2023-09-13,Assembly,"SB 848 Rubio Senate Third Reading By Quirk-Silva",78,0,0,2,80
1714799,1354732,2023-09-14,Senate,"Unfinished Business SB848 Rubio et al. Concurrence",34,0,0,6,40
1714801,1363747,2024-01-09,Senate,"Do pass, but first be re-referred to the Committee on [Appropriations]",5,0,0,0,5
1714801,1364763,2024-01-16,Senate,"Placed on suspense file",6,0,0,1,7
1714802,1310223,2023-04-24,Senate,"Do pass as amended, but first amend, and re-refer to the Committee on [Appropriations]",16,0,0,2,18
1714802,1324951,2023-05-15,Senate,"Placed on suspense file",7,0,0,0,7
1714803,1310151,2023-04-25,Senate,"Do pass",5,0,0,0,5
1714803,1323836,2023-05-11,Senate,"Senate 3rd Reading SB852 Rubio",39,0,0,1,40
1714803,1343748,2023-06-13,Assembly,"Do pass",8,0,0,0,8
1714803,1352958,2023-09-01,Assembly,"SB 852 Rubio Senate Third Reading By Santiago",67,0,0,13,80
1714803,1353216,2023-09-06,Senate,"Unfinished Business SB852 Rubio Concurrence",39,0,0,1,40
1714805,1288267,2023-03-29,Senate,"Do pass as amended, but first amend, and re-refer to the Committee on [Appropriations]",5,2,0,0,7
1714807,1299353,2023-04-12,Senate,"Do pass, but first be re-referred to the Committee on [Appropriations]",7,0,0,0,7
1714807,1308825,2023-04-24,Senate,"Placed on suspense file",7,0,0,0,7
1714807,1328420,2023-05-18,Senate,"Do pass",7,0,0,0,7
1714807,1333564,2023-05-25,Senate,"Special Consent SB856 Glazer",40,0,0,0,40
1714807,1348367,2023-06-27,Assembly,"Do pass and be re-referred to the Committee on [Appropriations]",11,0,0,1,12
1714808,1299454,2023-04-12,Senate,"Do pass, but first be re-referred to the Committee on [Appropriations]",7,0,0,0,7
1714808,1324976,2023-05-15,Senate,"Senate 3rd Reading SB857 Laird",35,0,0,5,40
1714808,1350520,2023-07-12,Assembly,"Do pass and be re-referred to the Committee on [Appropriations]",5,0,0,2,7
1714808,1352776,2023-09-01,Assembly,"Do pass",12,1,0,3,16
1714808,1354200,2023-09-13,Assembly,"SB 857 Laird Senate Third Reading By Zbur",66,0,0,14,80
1714808,1354832,2023-09-14,Senate,"Unfinished Business SB857 Laird et al. Concurrence",36,0,0,4,40
1714809,1305446,2023-04-18,Senate,"Do pass, but first be re-referred to the Committee on [Appropriations]",7,0,0,0,7
1714809,1315689,2023-05-01,Senate,"Placed on suspense file",6,0,0,1,7
1714811,1296907,2023-04-10,Senate,"Do pass, but first be re-referred to the Committee on [Appropriations] with the recommendation: To Consent Calendar",15,0,0,3,18
1714811,1308833,2023-04-24,Senate,"Placed on suspense file",7,0,0,0,7
1714812,1288249,2023-03-29,Senate,"Do pass as amended, but first amend, and re-refer to the Committee on [Judiciary]",7,0,0,0,7
1714812,1305490,2023-04-18,Senate,"Do pass as amended, but first amend, and re-refer to the Committee on [Appropriations]",10,0,0,1,11
1714812,1315680,2023-05-01,Senate,"Placed on suspense file",6,0,0,1,7
1714813,1304354,2023-04-18,Senate,"Do pass, but first be re-referred to the Committee on [Appropriations]",3,0,0,1,4
1714813,1323798,2023-05-11,Senate,"Senate 3rd Reading SB862 Laird",39,0,0,1,40
1714813,1348447,2023-06-28,Assembly,"Do pass as amended and be re-referred to the Committee on [Revenue and Taxation]",5,2,0,1,8
1714813,1350245,2023-07-10,Assembly,"Do pass",6,3,0,2,11
1714813,1351254,2023-08-14,Assembly,"SB 862 Laird Senate Third Reading By Pellerin",52,16,0,12,80
1714813,1352438,2023-08-30,Senate,"That the Assembly amendments be concurred in",6,1,0,1,8
1714813,1353283,2023-09-06,Senate,"Unfinished Business SB862 Laird Concurrence",30,8,0,2,40
1714814,1363748,2024-01-09,Senate,"Do pass",6,1,0,0,7
1714814,1372115,2024-01-30,Senate,"Senate 3rd Reading SB863 Allen",30,7,0,3,40
1714814,1460535,2024-06-26,Assembly,"Do pass",6,2,0,0,8
1714814,1463779,2024-08-08,Assembly,"SB 863 Allen Senate Third Reading By Low",55,16,0,8,79
1714814,1465359,2024-08-20,Senate,"Unfinished Business SB863 Allen Concurrence",31,9,0,0,40
1714815,1300996,2023-04-12,Senate,"Do pass, but first be re-referred to the Committee on [Appropriations]",5,0,0,0,5
1714815,1308865,2023-04-24,Senate,"Placed on suspense file",7,0,0,0,7
1714815,1328234,2023-05-18,Senate,"Do pass",5,2,0,0,7
1714815,1333809,2023-05-25,Senate,"Senate 3rd Reading SB864 Smallwood-Cuevas",33,7,0,0,40
1714815,1350670,2023-07-12,Assembly,"Do pass and be re-referred to the Committee on [Appropriations]",5,2,0,0,7
1714818,1286933,2023-03-28,Senate,"Do pass, but first be re-referred to the Committee on [Governance and Finance]",8,0,0,3,11
1714818,1313374,2023-04-26,Senate,"Do pass, but first be re-referred to the Committee on [Appropriations]",6,1,0,1,8
1714818,1320454,2023-05-08,Senate,"Placed on suspense file",7,0,0,0,7
1714818,1328826,2023-05-18,Senate,"Do pass as amended",5,1,0,1,7
1714818,1336362,2023-05-31,Senate,"Senate 3rd Reading SB867 Allen et al",33,5,0,2,40
1714818,1345604,2023-06-20,Assembly,"Do pass as amended and be re-referred to the Committee on [Natural Resources]",11,2,0,2,15
1714818,1462579,2024-07-03,Senate,"W/O REF. TO FILE SB867 Allen",33,6,0,1,40
1714818,1462580,2024-07-03,Assembly,"SB 867 Allen Third Reading Urgency By Garcia",66,6,0,7,79
1714819,1288166,2023-03-29,Senate,"Do pass, but first be re-referred to the Committee on [Rules]",7,0,0,0,7
1714819,1305329,2023-04-18,Senate,"Do pass, but first be re-referred to the Committee on [Appropriations] with the recommendation: To Consent Calendar",11,0,0,0,11
1714819,1315665,2023-05-01,Senate,"Placed on suspense file",6,0,0,1,7
1714819,1328763,2023-05-18,Senate,"Do pass",7,0,0,0,7
1714819,1333785,2023-05-25,Senate,"Special Consent SB868 Wilk et al",40,0,0,0,40
1714819,1348890,2023-06-28,Assembly,"Do pass and be re-referred to the Committee on [Judiciary] with recommendation: To Consent Calendar",7,0,0,0,7
1714819,1350246,2023-07-11,Assembly,"Do pass as amended, and be re-referred to the Committee on [Appropriations] with recommendation: To Consent Calendar",11,0,0,0,11
1714820,1363959,2024-01-10,Senate,"Do pass, but first be re-referred to the Committee on [Judiciary]",6,0,0,1,7
1714820,1364112,2024-01-11,Senate,"Do pass, but first be re-referred to the Committee on [Appropriations]",10,0,0,1,11
1714820,1364790,2024-01-16,Senate,"Placed on suspense file",6,0,0,1,7
1714821,1313432,2023-04-26,Senate,"Do pass, but first be re-referred to the Committee on [Appropriations]",11,0,0,1,12
1714821,1320500,2023-05-08,Senate,"Placed on suspense file",7,0,0,0,7
1714822,1318080,2023-05-03,Senate,"Do pass, but first be re-referred to the Committee on [Appropriations]",7,0,0,1,8
1714822,1352740,2023-09-01,Senate,"Placed on suspense file",7,0,0,0,7
1714822,1352741,2023-09-01,Senate,"Do pass as amended",7,0,0,0,7
1714822,1353964,2023-09-12,Senate,"Senate 3rd Reading SB871 Archuleta",39,0,0,1,40
1714823,1311897,2023-04-26,Senate,"Do pass, but first be re-referred to the Committee on [Appropriations]",7,0,0,0,7
1714823,1320515,2023-05-08,Senate,"Placed on suspense file",7,0,0,0,7
1714823,1328252,2023-05-18,Senate,"Do pass",7,0,0,0,7
1714823,1333716,2023-05-25,Senate,"Special Consent SB872 Min",40,0,0,0,40
1714823,1348874,2023-06-28,Assembly,"Do pass and be re-referred to the Committee on [Appropriations] with recommendation: To Consent Calendar",7,0,0,0,7
1714823,1352788,2023-09-01,Assembly,"Do pass",16,0,0,0,16
1714823,1354146,2023-09-13,Assembly,"SB 872 Min Senate Third Reading By McCarty",80,0,0,0,80
1714823,1354778,2023-09-14,Senate,"Unfinished Business SB872 Min Concurrence",40,0,0,0,40
1714824,1305528,2023-04-19,Senate,"Do pass, but first be re-referred to the Committee on [Appropriations]",8,1,0,3,12
1714824,1315671,2023-05-01,Senate,"Placed on suspense file",6,0,0,1,7
1714824,1328749,2023-05-18,Senate,"Do pass",5,2,0,0,7
1714824,1336363,2023-05-31,Senate,"Senate 3rd Reading SB873 Bradford",28,2,0,10,40
1714824,1350217,2023-07-11,Assembly,"Do pass and be re-referred to the Committee on [Appropriations]",13,1,0,1,15
1714826,1363623,2024-01-08,Senate,"Do pass, but first be re-referred to the Committee on [Judiciary]",3,0,0,2,5
1714826,1364108,2024-01-11,Senate,"Do pass, but first be re-referred to the Committee on [Appropriations]",10,0,0,1,11
1714826,1364805,2024-01-16,Senate,"Placed on suspense file",6,0,0,1,7
1714826,1366752,2024-01-18,Senate,"Do pass",6,0,0,1,7
1714826,1371090,2024-01-29,Senate,"Senate 3rd Reading SB875 Glazer",32,0,0,8,40
1714829,1288323,2023-03-29,Senate,"Do pass and be ordered to the Consent Calendar",8,0,0,0,8
1714829,1301025,2023-04-13,Senate,"Consent Calendar SB878 GOV. & F. (Caballero) Urgency Clause",36,0,0,4,40
1714829,1340953,2023-06-07,Assembly,"Do pass. To Consent Calendar",8,0,0,0,8
1714829,1344719,2023-06-15,Assembly,"SB 878 Governance and Finance Consent Calendar Second Day Regular Session",74,0,0,6,80
1714830,1288392,2023-03-29,Senate,"Do pass and be ordered to the Consent Calendar",8,0,0,0,8
1714830,1301016,2023-04-13,Senate,"Consent Calendar SB879 GOV. & F. (Caballero) Urgency Clause",36,0,0,4,40
1714830,1341008,2023-06-07,Assembly,"Do pass. To Consent Calendar",8,0,0,0,8
1714830,1344710,2023-06-15,Assembly,"SB 879 Governance and Finance Consent Calendar Second Day Regular Session",74,0,0,6,80
1714831,1288271,2023-03-29,Senate,"Do pass and be ordered to the Consent Calendar",8,0,0,0,8
1714831,1301058,2023-04-13,Senate,"Consent Calendar SB880 GOV. & F. (Caballero)",36,0,0,4,40
1714831,1340977,2023-06-07,Assembly,"Do pass. To Consent Calendar",8,0,0,0,8
1714831,1344705,2023-06-15,Assembly,"SB 880 Governance and Finance Consent Calendar Second Day Regular Session",74,0,0,6,80
1714832,1306760,2023-04-19,Senate,"Do pass, but first be re-referred to the Committee on [Judiciary]",1,3,0,1,5
1714832,1306761,2023-04-19,Senate,"[First] hearing set for [04-20-2023]: Failed passage in Committee. Reconsideration granted",5,0,0,0,5
1714833,1320372,2023-05-08,Senate,"Be adopted, but first be re-referred to the Committee on [Appropriations]",7,0,0,0,7
1714833,1352313,2023-08-28,Senate,"Placed on suspense file",7,0,0,0,7
1714834,1311778,2023-04-25,Senate,"Be adopted, but first be re-referred to the Committee on [Appropriations] with recommendation: To Consent Calendar",16,0,0,0,16
1714834,1323815,2023-05-11,Senate,"Consent Calendar SCR31 Laird et al",39,0,0,1,40
1714834,1349607,2023-07-05,Assembly,"Be adopted. To Consent Calendar",15,0,0,0,15
1714834,1351504,2023-08-14,Assembly,"SCR 31 Laird Consent Calendar Second Day Regular Session",74,0,0,6,80
1714835,1267518,2023-03-02,Senate,"Senate 3rd Reading SCR32 Wilk",34,0,0,6,40
1714835,1283079,2023-03-23,Assembly,"Be adopted. To Consent Calendar",13,0,0,0,13
1714835,1289821,2023-03-30,Assembly,"SCR 32 Wilk Consent Calendar Second Day Regular Session",60,0,0,20,80
1714836,1305378,2023-04-19,Senate,"Be adopted. Ordered to third reading",5,2,0,0,7
1714836,1325019,2023-05-15,Senate,"Senate 3rd Reading SJR2 Gonzalez et al",28,7,0,5,40
1714836,1350781,2023-07-10,Assembly,"Be adopted. To third reading",8,3,0,0,11
1714836,1352921,2023-09-01,Assembly,"SJR 2 Gonzalez Senate Third Reading By Kalra",50,14,0,16,80
1717506,1305477,2023-04-19,Assembly,"Do pass. To Consent Calendar",11,0,0,0,11
1717506,1313471,2023-04-27,Assembly,"AB 1752 Agriculture Consent Calendar Second Day Regular Session",79,0,0,1,80
1717506,1345583,2023-06-19,Senate,"Do pass and be ordered to the Consent Calendar",4,0,0,0,4
1717506,1347494,2023-06-26,Senate,"Consent Calendar AB1752 AGRI. (Rivas, R.)",37,0,0,3,40
1717506,1353187,2023-09-05,Senate,"Assembly 3rd Reading AB1752 AGRI. (Soria) By Eggman",39,0,0,1,40
1717506,1353353,2023-09-07,Assembly,"AB 1752 Agriculture Concurrence in Senate Amendments By SORIA",79,0,0,1,80
1717507,1267498,2023-03-02,Assembly,"Be adopted. To Consent Calendar",13,0,0,0,13
1717507,1272558,2023-03-09,Assembly,"ACR 23 Weber Consent Calendar Second Day Regular Session",75,0,0,5,80
1717507,1289808,2023-03-30,Senate,"Special Consent ACR23 Weber et al",35,0,0,5,40
1717508,1283235,2023-03-23,Assembly,"Be adopted. To Consent Calendar",13,0,0,0,13
1717508,1289819,2023-03-30,Assembly,"SCR 33 Dodd Consent Calendar Second Day Regular Session",60,0,0,20,80
1719011,1267515,2023-03-02,Senate,"Senate 3rd Reading SR18 Newman",34,0,0,6,40
1720059,1305425,2023-04-19,Senate,"Do pass and be ordered to the Consent Calendar",8,0,0,0,8
1720059,1315753,2023-05-01,Senate,"Consent Calendar SB882 GOV. & F. (Caballero)",37,0,0,3,40
1720059,1350452,2023-07-12,Assembly,"Do pass. To Consent Calendar",8,0,0,0,8
1720059,1351647,2023-08-17,Assembly,"SB 882 Governance and Finance Consent Calendar Second Day Regular Session",75,0,0,5,80
1720059,1352221,2023-08-24,Senate,"Special Consent SB882 GOV. & F. (Caballero)",40,0,0,0,40
1722015,1267489,2023-03-02,Assembly,"Be adopted. To third reading",13,0,0,0,13
1722015,1289768,2023-03-30,Senate,"Special Consent ACR24 Ortega et al",35,0,0,5,40
1722016,1272565,2023-03-09,Assembly,"Be adopted. To third reading",13,0,0,0,13
1723184,1306718,2023-04-20,Assembly,"Be adopted. To third reading",13,0,0,0,13
1723184,1334449,2023-05-26,Senate,"Special Consent ACR25 Ramos et al",37,0,0,3,40
1723185,1272564,2023-03-09,Assembly,"Be adopted. To third reading",13,0,0,0,13
1723185,1301029,2023-04-13,Senate,"Special Consent ACR26 Joe Patterson et al",36,0,0,4,40
1723186,1306723,2023-04-20,Senate,"Senate 3rd Reading SCR34 Ashby et al",36,0,0,4,40
1723186,1318944,2023-05-04,Assembly,"Be adopted. To Consent Calendar",12,0,0,1,13
1723186,1323889,2023-05-11,Assembly,"SCR 34 Ashby Consent Calendar Second Day Regular Session",66,0,0,14,80
1723187,1288218,2023-03-29,Senate,"Be adopted. Ordered to third reading",8,0,0,0,8
1723187,1301057,2023-04-13,Senate,"Special Consent SJR3 Roth et al",36,0,0,4,40
1723187,1340986,2023-06-07,Assembly,"Be adopted. To Consent Calendar",8,0,0,0,8
1723187,1343122,2023-06-12,Assembly,"SJR 3 Roth Consent Calendar Second Day",76,0,0,4,80
1724787,1272546,2023-03-09,Assembly,"Be adopted. To third reading",13,0,0,0,13
1724787,1289812,2023-03-30,Senate,"Special Consent ACR27 Gallagher et al",35,0,0,5,40
1724788,1277647,2023-03-16,Assembly,"Be adopted. To Consent Calendar",11,0,0,2,13
1724788,1283222,2023-03-23,Assembly,"ACR 28 Reyes Consent Calendar Second Day Regular Session",74,0,0,6,80
1724788,1306786,2023-04-20,Senate,"Special Consent ACR28 Reyes et al",36,0,0,4,40
1724789,1272578,2023-03-09,Assembly,"Be adopted. To third reading",13,0,0,0,13
1724790,1283201,2023-03-23,Senate,"Senate 3rd Reading SR19 Wilk",39,0,0,1,40
1726104,1307874,2023-04-19,Assembly,"Do pass. To Consent Calendar",7,0,0,0,7
1726104,1313407,2023-04-27,Assembly,"AB 1753 Local Government Consent Calendar Second Day Regular Session",79,0,0,1,80
1726104,1341033,2023-06-07,Senate,"Do pass and be ordered to the Consent Calendar",8,0,0,0,8
1726104,1344716,2023-06-15,Senate,"Consent Calendar AB1753 L. GOV. (Aguiar-Curry)",40,0,0,0,40
1726105,1298269,2023-04-11,Assembly,"Do pass. To Consent Calendar",11,0,0,0,11
1726105,1302644,2023-04-17,Assembly,"AB 1754 Judiciary Consent Calendar Second Day Regular Session",79,0,0,1,80
1726105,1349809,2023-07-06,Senate,"Do pass and be ordered to the Consent Calendar",11,0,0,0,11
1726105,1350677,2023-07-13,Senate,"Consent Calendar AB1754 JUD. (Maienschein)",37,0,0,3,40
1726106,1304373,2023-04-18,Assembly,"Do pass and be re-referred to the Committee on [Appropriations] with recommendation: To Consent Calendar",11,0,0,0,11
1726106,1328497,2023-05-18,Assembly,"Do pass as amended",15,0,0,1,16
1726106,1338128,2023-05-31,Assembly,"AB 1755 JUD. Assembly Third Reading By MAIENSCHEIN",79,0,0,1,80
1726106,1348419,2023-06-27,Senate,"Do pass, but first be re-referred to the Committee on [Human Services]",11,0,0,0,11
1726106,1349575,2023-07-03,Senate,"Do pass, but first be re-referred to the Committee on [Appropriations]",5,0,0,0,5
1726106,1351810,2023-08-21,Senate,"Placed on suspense file",7,0,0,0,7
1726106,1352609,2023-09-01,Senate,"Do pass",7,0,0,0,7
1726106,1465551,2024-08-26,Senate,"Do pass",9,1,0,1,11
1726106,1466337,2024-08-29,Senate,"Assembly 3rd Reading AB1755 Kalra et al. By Umberg",31,4,0,5,40
1726106,1466406,2024-08-30,Assembly,"With recommendation: That Senate amendments be concurred in",9,1,0,2,12
1726106,1466952,2024-08-31,Assembly,"AB 1755 Kalra Concurrence in Senate Amendments",55,4,0,20,79
1726107,1298246,2023-04-11,Assembly,"Do pass as amended and be re-referred to the Committee on [Appropriations]",11,0,0,0,11
1726107,1328661,2023-05-18,Assembly,"Do pass",15,0,0,1,16
1726107,1337235,2023-06-01,Assembly,"AB 1756 Judiciary Assembly Third Reading By MAIENSCHEIN",79,0,0,1,80
1726107,1349757,2023-07-06,Senate,"Do pass as amended, but first amend, and re-refer to the Committee on [Appropriations] with the recommendation: To Consent Calendar",11,0,0,0,11
1726107,1351768,2023-08-21,Senate,"Placed on suspense file",7,0,0,0,7
1726107,1352699,2023-09-01,Senate,"Do pass as amended",7,0,0,0,7
1726107,1353752,2023-09-12,Assembly,"AB 1756 Judiciary Concurrence in Senate Amendments By MAIENSCHEIN",79,0,0,1,80
1726107,1354808,2023-09-11,Senate,"Assembly 3rd Reading AB1756 JUD. (Maienschein) By Umberg",39,0,0,1,40
1726108,1298291,2023-04-11,Assembly,"Do pass. To Consent Calendar",11,0,0,0,11
1726108,1302629,2023-04-17,Assembly,"AB 1757 Judiciary Consent Calendar Second Day Regular Session",79,0,0,1,80
1726108,1350500,2023-07-11,Senate,"Do pass as amended, but first amend, and re-refer to the Committee on [Appropriations]",9,1,0,1,11
1726108,1459367,2024-06-24,Senate,"Placed on suspense file",6,0,0,1,7
1726109,1298313,2023-04-11,Assembly,"Do pass and be re-referred to the Committee on [Appropriations] with recommendation: To Consent Calendar",11,0,0,0,11
1726109,1328535,2023-05-18,Assembly,"Do pass",15,0,0,1,16
1726109,1337215,2023-06-01,Assembly,"AB 1758 Judiciary Assembly Third Reading By MAIENSCHEIN",79,0,0,1,80
1726109,1348306,2023-06-27,Senate,"Do pass, but first be re-referred to the Committee on [Appropriations]",11,0,0,0,11
1726109,1351773,2023-08-21,Senate,"Placed on suspense file",7,0,0,0,7
1726110,1313445,2023-04-27,Assembly,"Be adopted. To third reading",13,0,0,0,13
1726110,1334446,2023-05-26,Senate,"Special Consent ACR29 Quirk-Silva et al",37,0,0,3,40
1726111,1272561,2023-03-09,Assembly,"Be adopted. To Consent Calendar",13,0,0,0,13
1726111,1277631,2023-03-16,Assembly,"ACR 30 Wilson Consent Calendar Second Day",73,0,0,7,80
1726111,1301056,2023-04-13,Senate,"Special Consent ACR30 Wilson et al",36,0,0,4,40
1726112,1277645,2023-03-16,Assembly,"Be adopted. To third reading",11,0,0,2,13
1726112,1283133,2023-03-23,Assembly,"ACR 31 Pacheco Assembly Third Reading",77,0,0,3,80
1726112,1306721,2023-04-20,Senate,"Special Consent ACR31 Pacheco",36,0,0,4,40
1726113,1277652,2023-03-16,Assembly,"Be adopted. To third reading",11,0,0,2,13
1726113,1306713,2023-04-20,Senate,"Special Consent ACR32 McCarty et al",36,0,0,4,40
1726114,1272574,2023-03-09,Assembly,"Be adopted. To Consent Calendar",13,0,0,0,13
1726114,1277632,2023-03-16,Assembly,"ACR 33 Robert Rivas Consent Calendar Second Day Regular Session",73,0,0,7,80
1726114,1301034,2023-04-13,Senate,"Special Consent ACR33 Robert Rivas et al",36,0,0,4,40
1726115,1289843,2023-03-30,Assembly,"Be adopted. To third reading",11,0,0,2,13
1726115,1323881,2023-05-11,Senate,"Special Consent ACR34 Chen et al",39,0,0,1,40
1726116,1289786,2023-03-30,Senate,"Senate 3rd Reading SR20 Padilla et al",36,0,0,4,40
1728398,1341045,2023-06-07,Assembly,"Be adopted and re-referred to the Committee on [Appropriations]",6,2,0,0,8
1728398,1444619,2024-05-16,Assembly,"Be adopted",11,4,0,0,15
1728398,1459392,2024-06-24,Assembly,"ACA 10 Aguiar-Curry Assembly Third Reading",54,8,0,17,79
1728398,1460546,2024-06-26,Senate,"Be adopted",5,2,0,0,7
1728398,1460547,2024-06-26,Senate,"Be adopted, but first be re-referred to the Committee on [Appropriations]",5,2,0,0,7
1728398,1461248,2024-06-27,Senate,"Assembly 3rd Reading ACA10 Aguiar-Curry et al. By Glazer",31,8,0,1,40
1728399,1277637,2023-03-16,Assembly,"Be adopted. To Consent Calendar",11,0,0,2,13
1728399,1283206,2023-03-23,Assembly,"ACR 35 Calderon Consent Calendar Second Day Regular Session",74,0,0,6,80
1728399,1306742,2023-04-20,Senate,"Special Consent ACR35 Calderon et al",36,0,0,4,40
1728400,1322952,2023-05-10,Senate,"Be adopted, but first be re-referred to the Committee on [Elections and Constitutional Amendments]",3,4,0,1,8
1728400,1322953,2023-05-10,Senate,"[Second] hearing set for [05-10-2023]: Failed passage in Committee. Reconsideration granted",8,0,0,0,8
1728401,1279186,2023-03-20,Senate,"Senate 3rd Reading SR21 Skinner",38,0,0,2,40
1729720,1313401,2023-04-27,Assembly,"Be adopted. To third reading",13,0,0,0,13
1729721,1310300,2023-04-25,Senate,"Do pass, but first be re-referred to the Committee on [Appropriations] with the recommendation: To Consent Calendar",5,0,0,0,5
1729721,1328215,2023-05-18,Senate,"Consent Calendar SB883 PUB. S. (Wahab)",38,0,0,2,40
1729721,1350308,2023-07-11,Assembly,"Do pass and be re-referred to the Committee on [Appropriations] with recommendation: To Consent Calendar",8,0,0,0,8
1729721,1351569,2023-08-16,Assembly,"Do pass. To Consent Calendar",15,0,0,1,16
1729721,1352234,2023-08-24,Assembly,"SB 883 Public Safety Consent Calendar Second Day Regular Session",72,0,0,8,80
1729721,1352617,2023-09-01,Senate,"Special Consent SB883 PUB. S. (Wahab)",37,0,0,3,40
1731368,1305424,2023-04-19,Assembly,"Do pass as amended, and be re-referred to the Committee on [Appropriations] with recommendation: To Consent Calendar",6,0,0,1,7
1731368,1326969,2023-05-17,Assembly,"Do pass. To Consent Calendar",15,0,0,1,16
1731368,1333586,2023-05-25,Assembly,"AB 1759 Accountability and Administrative Review Consent Calendar Second Day Regular Session",76,0,0,4,80
1731368,1347812,2023-06-27,Senate,"Do pass, but first be re-referred to the Committee on [Appropriations] with the recommendation: To Consent Calendar",15,0,0,0,15
1731368,1351669,2023-08-17,Senate,"Consent Calendar 2nd AB1759 A. & A.R. (Petrie-Norris) By Dodd",38,0,0,2,40
1731369,1305254,2023-04-18,Assembly,"Do pass and be re-referred to the Committee on [Appropriations] with recommendation: To Consent Calendar",15,0,0,0,15
1731369,1322917,2023-05-10,Assembly,"Do pass. To Consent Calendar",14,0,0,2,16
1731369,1328724,2023-05-18,Assembly,"AB 1760 Water, Parks, and Wildlife Consent Calendar Second Day Regular Session",74,0,0,6,80
1731369,1347863,2023-06-27,Senate,"Do pass, but first be re-referred to the Committee on [Appropriations] with the recommendation: To Consent Calendar",11,0,0,0,11
1731369,1350656,2023-07-13,Senate,"Consent Calendar AB1760 W., P., & W. (Bauer-Kahan)",37,0,0,3,40
1731370,1305341,2023-04-19,Assembly,"Do pass. To Consent Calendar",8,0,0,0,8
1731370,1313512,2023-04-27,Assembly,"AB 1761 Elections Consent Calendar Second Day Regular Session",79,0,0,1,80
1731370,1340035,2023-06-06,Senate,"Do pass, but first be re-referred to the Committee on [Appropriations] with the recommendation: To Consent Calendar",7,0,0,0,7
1731370,1348894,2023-06-29,Senate,"Consent Calendar AB1761 ELECTIONS (Bryan)",39,0,0,1,40
1731370,1351316,2023-08-14,Assembly,"AB 1761 Elections Concurrence in Senate Amendments By PELLERIN",76,0,0,4,80
1731372,1313378,2023-04-27,Assembly,"Be adopted. To third reading",13,0,0,0,13
1731372,1334456,2023-05-26,Senate,"Special Consent ACR36 Connolly et al",37,0,0,3,40
1731373,1277640,2023-03-16,Assembly,"Be adopted. To third reading",11,0,0,2,13
1731373,1353365,2023-09-07,Senate,"Assembly 3rd Reading ACR37 Jackson et al. By Smallwood-Cuevas",40,0,0,0,40
1731374,1305448,2023-04-19,Senate,"Be adopted, but first be re-referred to the Committee on [Elections and Constitutional Amendments]",2,5,0,0,7
1731374,1305449,2023-04-19,Senate,"[Second] hearing set for [04-19-2023]: Failed passage in Committee. Reconsideration granted",7,0,0,0,7
1731374,1363946,2024-01-10,Senate,"Be adopted, but first be re-referred to the Committee on [Appropriations]",2,4,0,1,7
1731375,1283110,2023-03-23,Senate,"Senate 3rd Reading SCR35 Newman",39,0,0,1,40
1731375,1289807,2023-03-30,Assembly,"Be adopted. To Consent Calendar",11,0,0,2,13
1731375,1302636,2023-04-17,Assembly,"SCR 35 Newman Consent Calendar Second Day Regular Session",79,0,0,1,80
1731376,1289765,2023-03-30,Senate,"Senate 3rd Reading SCR36 Portantino et al",36,0,0,4,40
1731376,1313413,2023-04-27,Assembly,"Be adopted. To Consent Calendar",13,0,0,0,13
1731376,1318949,2023-05-04,Assembly,"SCR 36 Portantino Consent Calendar Second Day Regular Session",75,0,0,5,80
1731377,1283231,2023-03-23,Senate,"Senate 3rd Reading SCR37 Wahab et al",39,0,0,1,40
1731377,1323821,2023-05-11,Assembly,"Be adopted. To Consent Calendar",10,0,0,3,13
1731377,1328836,2023-05-18,Assembly,"SCR 37 Wahab Consent Calendar Second Day Regular Session",74,0,0,6,80
1731378,1283191,2023-03-23,Senate,"Senate 3rd Reading SCR38 Wahab et al",39,0,0,1,40
1731378,1323832,2023-05-11,Assembly,"Be adopted. To Consent Calendar",10,0,0,3,13
1731378,1328653,2023-05-18,Assembly,"SCR 38 Wahab Consent Calendar Second Day Regular Session",74,0,0,6,80
1732851,1310301,2023-04-24,Assembly,"Be adopted, and re-refer to the Committee on [Appropriations] with recommendation: To Consent Calendar",15,0,0,0,15
1732851,1326926,2023-05-17,Assembly,"Be adopted. To Consent Calendar",15,0,0,1,16
1732852,1310302,2023-04-25,Senate,"Do pass, but first be re-referred to the Committee on [Appropriations] with the recommendation: To Consent Calendar",15,0,0,0,15
1732852,1323814,2023-05-11,Senate,"Consent Calendar SB884 G.O. (Dodd)",39,0,0,1,40
1732852,1344166,2023-06-14,Assembly,"Do pass and be re-referred to the Committee on [Appropriations] with recommendation: To Consent Calendar",21,0,0,1,22
1732852,1348311,2023-06-28,Assembly,"Do pass. To Consent Calendar",14,0,0,2,16
1732852,1349465,2023-07-03,Assembly,"SB 884 Governmental Organization Consent Calendar Second Day Regular Session",69,0,0,11,80
1732853,1320429,2023-05-08,Senate,"Senate 3rd Reading SCR39 Umberg et al",36,0,0,4,40
1732853,1341942,2023-06-08,Assembly,"Be adopted. To Consent Calendar",12,0,0,1,13
1732853,1344723,2023-06-15,Assembly,"SCR 39 Umberg Consent Calendar Second Day Regular Session",74,0,0,6,80
1738921,1305369,2023-04-19,Assembly,"Do pass. To Consent Calendar",8,0,0,0,8
1738921,1313508,2023-04-27,Assembly,"AB 1762 Elections Consent Calendar Second Day Regular Session",79,0,0,1,80
1738921,1345642,2023-06-20,Senate,"Do pass and be ordered to the Consent Calendar",7,0,0,0,7
1738921,1353319,2023-09-06,Senate,"Assembly 3rd Reading AB1762 ELECTIONS (Pellerin) By Glazer",40,0,0,0,40
1738921,1353402,2023-09-07,Assembly,"AB 1762 Elections Concurrence in Senate Amendments By PELLERIN",79,0,0,1,80
1738922,1305524,2023-04-19,Assembly,"Do pass and be re-referred to the Committee on [Appropriations] with recommendation: To Consent Calendar",11,0,0,0,11
1738922,1328815,2023-05-18,Assembly,"Do pass",15,0,0,1,16
1738922,1337205,2023-06-01,Assembly,"AB 1763 Agriculture Assembly Third Reading By RIVAS, R",79,0,0,1,80
1738922,1349455,2023-07-03,Senate,"Do pass, but first be re-referred to the Committee on [Appropriations] with the recommendation: To Consent Calendar",3,0,0,1,4
1738922,1352250,2023-08-24,Senate,"Consent Calendar 2nd AB1763 AGRI. (Soria)",40,0,0,0,40
1738922,1352322,2023-08-28,Assembly,"AB 1763 Agriculture Concurrence in Senate Amendments By SORIA",76,0,0,4,80
1738923,1318909,2023-05-04,Assembly,"Be adopted. To Consent Calendar",12,0,0,1,13
1738923,1323787,2023-05-11,Assembly,"ACR 39 Bains Consent Calendar Second Day Regular Session",66,0,0,14,80
1738923,1337244,2023-06-01,Senate,"Special Consent ACR39 Bains et al",40,0,0,0,40
1738924,1289798,2023-03-30,Assembly,"Be adopted. To third reading",11,0,0,2,13
1738925,1289806,2023-03-30,Senate,"Senate 3rd Reading SCR40 Menjivar et al",36,0,0,4,40
1738925,1306747,2023-04-20,Assembly,"Be adopted. To Consent Calendar",13,0,0,0,13
1738925,1313427,2023-04-27,Assembly,"SCR 40 Menjivar Consent Calendar Second Day Regular Session",79,0,0,1,80
1740926,1306774,2023-04-19,Senate,"Do pass, but first be re-referred to the Committee on [Public Safety] with the recommendation: To Consent Calendar",5,0,0,0,5
1740926,1310152,2023-04-25,Senate,"Do pass, but first be re-referred to the Committee on [Appropriations] with the recommendation: To Consent Calendar",5,0,0,0,5
1740926,1323803,2023-05-11,Senate,"Consent Calendar SB885 L., P.E. & R. (Cortese)",39,0,0,1,40
1740926,1344165,2023-06-14,Assembly,"Do pass and be re-referred to the Committee on [Appropriations] with recommendation: To Consent Calendar",7,0,0,0,7
1740926,1348411,2023-06-28,Assembly,"Do pass. To Consent Calendar",14,0,0,2,16
1740926,1349529,2023-07-03,Assembly,"SB 885 Labor, Public Employment and Retirement Consent Calendar Second Day Regular Session",69,0,0,11,80
1740926,1351677,2023-08-17,Senate,"Special Consent SB885 L., P.E. & R. (Cortese)",38,0,0,2,40
1740927,1311786,2023-04-26,Senate,"Do pass, but first be re-referred to the Committee on [Appropriations] with the recommendation: To Consent Calendar",7,0,0,0,7
1740927,1323898,2023-05-11,Senate,"Consent Calendar SB886 ED. (Newman)",39,0,0,1,40
1740927,1343759,2023-06-13,Assembly,"Do pass and be re-referred to the Committee on [Appropriations] with recommendation: To Consent Calendar",11,0,0,1,12
1740927,1350426,2023-07-12,Assembly,"Do pass. To Consent Calendar",15,0,0,1,16
1740927,1351694,2023-08-17,Assembly,"SB 886 Education Consent Calendar Second Day Regular Session",75,0,0,5,80
1740927,1352260,2023-08-24,Senate,"Special Consent SB886 ED. (Newman)",40,0,0,0,40
1740928,1308835,2023-04-24,Senate,"Do pass, but first be re-referred to the Committee on [Appropriations] with the recommendation: To Consent Calendar",13,0,0,0,13
1740928,1323802,2023-05-11,Senate,"Consent Calendar SB887 B., P. & E.D. (Roth)",39,0,0,1,40
1740928,1350239,2023-07-11,Assembly,"Do pass and be re-referred to the Committee on [Appropriations] with recommendation: To Consent Calendar",19,0,0,0,19
1740928,1351583,2023-08-16,Assembly,"Do pass. To Consent Calendar",15,0,0,1,16
1740928,1353613,2023-09-11,Assembly,"SB 887 Business, Professions and Senate Third Reading By BERMAN",80,0,0,0,80
1740928,1354048,2023-09-12,Senate,"Unfinished Business SB887 B., P. & E.D. (Roth) Concurrence",38,0,0,2,40
1740929,1283256,2023-03-23,Senate,"Senate 3rd Reading SCR41 Rubio et al",39,0,0,1,40
1742860,1283071,2023-03-23,Assembly,"Be adopted. To Consent Calendar",13,0,0,0,13
1742860,1289780,2023-03-30,Assembly,"ACR 40 Maienschein Consent Calendar Second Day Regular Session",60,0,0,20,80
1742860,1313511,2023-04-27,Senate,"Special Consent ACR40 Maienschein et al",38,0,0,2,40
1742862,1283248,2023-03-23,Assembly,"Be adopted. To Consent Calendar",13,0,0,0,13
1742862,1289785,2023-03-30,Assembly,"HR 22 Gabriel Consent Calendar Second Day Regular Session",60,0,0,20,80
1742863,1305460,2023-04-18,Senate,"Do pass, but first be re-referred to the Committee on [Judiciary] with the recommendation: To Consent Calendar",7,0,0,0,7
1742863,1311911,2023-04-25,Senate,"Do pass, but first be re-referred to the Committee on [Appropriations] with the recommendation: To Consent Calendar",11,0,0,0,11
1742863,1320414,2023-05-08,Senate,"Placed on suspense file",7,0,0,0,7
1743497,1311719,2023-04-26,Assembly,"Do pass and be re-referred to the Committee on [Appropriations] with recommendation: To Consent Calendar",8,0,0,0,8
1743497,1322903,2023-05-10,Assembly,"Do pass. To Consent Calendar",14,0,0,2,16
1743497,1328267,2023-05-18,Assembly,"AB 1764 Housing and Community Development Consent Calendar Second Day Regular Session",74,0,0,6,80
1743497,1346237,2023-06-20,Senate,"Do pass, but first be re-referred to the Committee on [Judiciary] with the recommendation: To Consent Calendar",11,0,0,0,11
1743497,1349794,2023-07-06,Senate,"Do pass, but first be re-referred to the Committee on [Appropriations] with the recommendation: To Consent Calendar",11,0,0,0,11
1743497,1351671,2023-08-17,Senate,"Consent Calendar 2nd AB1764 H. & C.D. (Wicks)",38,0,0,2,40
1743497,1354175,2023-09-13,Senate,"Assembly 3rd Reading AB1764 H. & C.D. (Wicks) By Wiener",39,0,0,1,40
1743497,1354565,2023-09-14,Assembly,"AB 1764 Housing and Community De Concurrence in Senate Amendments By WICKS",80,0,0,0,80
1743498,1310193,2023-04-24,Assembly,"Do pass and be re-referred to the Committee on [Appropriations]",11,0,0,0,11
1743498,1328072,2023-05-18,Assembly,"Do pass",15,0,0,1,16
1743498,1337254,2023-06-01,Assembly,"AB 1765 Revenue and Taxation Assembly Third Reading By IRWIN",79,0,0,1,80
1743498,1350658,2023-07-12,Senate,"Do pass, but first be re-referred to the Committee on [Appropriations] with the recommendation: To Consent Calendar",8,0,0,0,8
1743498,1353235,2023-09-06,Senate,"Assembly 3rd Reading AB1765 REV. & TAX. (Irwin) By Skinner",40,0,0,0,40
1743498,1353356,2023-09-07,Assembly,"AB 1765 Revenue and Taxation Concurrence in Senate Amendments By IRWIN",75,0,0,5,80
1743499,1320513,2023-05-08,Senate,"Senate 3rd Reading SCR42 Ochoa Bogh et al",36,0,0,4,40
1743499,1323855,2023-05-11,Assembly,"Be adopted. To Consent Calendar",10,0,0,3,13
1743499,1328646,2023-05-18,Assembly,"SCR 42 Ochoa Bogh Consent Calendar Second Day Regular Session",74,0,0,6,80
1743500,1308871,2023-04-24,Senate,"Be adopted and be ordered to the Consent Calendar",4,0,0,1,5
1743500,1315728,2023-05-01,Senate,"Consent Calendar SJR4 Ochoa Bogh et al",37,0,0,3,40
1743500,1346279,2023-06-20,Assembly,"Be adopted. To Consent Calendar",9,0,0,2,11
1743500,1347495,2023-06-26,Assembly,"SJR 4 Ochoa Bogh Consent Calendar Second Day",72,0,0,8,80
1744551,1311807,2023-04-26,Assembly,"Do pass and be re-referred to the Committee on [Appropriations] with recommendation: To Consent Calendar",7,0,0,0,7
1744551,1326947,2023-05-17,Assembly,"Do pass. To Consent Calendar",15,0,0,1,16
1744551,1333650,2023-05-25,Assembly,"AB 1766 Labor and Employment Consent Calendar Second Day Regular Session",76,0,0,4,80
1744551,1346980,2023-06-22,Senate,"Do pass, but first be re-referred to the Committee on [Appropriations] with the recommendation: To Consent Calendar",5,0,0,0,5
1744551,1350706,2023-07-13,Senate,"Consent Calendar AB1766 L. & E. (Kalra)",37,0,0,3,40
1744552,1311740,2023-04-26,Assembly,"Do pass. To Consent Calendar",7,0,0,0,7
1744552,1318970,2023-05-04,Assembly,"AB 1767 Labor and Employment Consent Calendar Second Day Regular Session",75,0,0,5,80
1744553,1289817,2023-03-30,Assembly,"Be adopted. To third reading",11,0,0,2,13
1744553,1318925,2023-05-04,Senate,"Special Consent ACR41 Lackey et al",37,0,0,3,40
1744554,1283247,2023-03-23,Assembly,"Be adopted. To third reading",13,0,0,0,13
1744554,1313415,2023-04-27,Senate,"Special Consent ACR42 Addis et al",38,0,0,2,40
1744555,1283221,2023-03-23,Assembly,"Be adopted. To third reading",13,0,0,0,13
1744556,1302646,2023-04-17,Senate,"Senate 3rd Reading SCR43 Wiener et al",37,0,0,3,40
1744556,1318937,2023-05-04,Assembly,"Be adopted. To Consent Calendar",12,0,0,1,13
1744556,1323865,2023-05-11,Assembly,"SCR 43 Wiener Consent Calendar Second Day Regular Session",66,0,0,14,80
1745243,1300989,2023-04-13,Assembly,"Be adopted. To third reading",13,0,0,0,13
1745243,1318912,2023-05-04,Senate,"Special Consent ACR43 Gabriel et al",37,0,0,3,40
1745245,1283257,2023-03-23,Assembly,"Be adopted. To third reading",13,0,0,0,13
1745246,1313339,2023-04-26,Senate,"Do pass, but first be re-referred to the Committee on [Appropriations] with the recommendation: To Consent Calendar",8,0,0,0,8
1745246,1323895,2023-05-11,Senate,"Consent Calendar SB889 GOV. & F. (Caballero)",39,0,0,1,40
1745246,1350317,2023-07-10,Assembly,"Do pass and be re-referred to the Committee on [Appropriations] with recommendation: To Consent Calendar",10,0,0,1,11
1745246,1352977,2023-09-01,Assembly,"Do pass as amended",11,0,0,5,16
1745246,1354817,2023-09-14,Senate,"Unfinished Business SB889 GOV. & F. (Caballero) Concurrence",40,0,0,0,40
1745246,1354818,2023-09-14,Assembly,"SB 889 Governance and Finance Senate Third Reading By IRWIN",80,0,0,0,80
1745247,1313347,2023-04-26,Senate,"Do pass, but first be re-referred to the Committee on [Appropriations] with the recommendation: To Consent Calendar",8,0,0,0,8
1745247,1323869,2023-05-11,Senate,"Consent Calendar SB890 GOV. & F. (Caballero)",39,0,0,1,40
1745247,1348282,2023-06-26,Assembly,"Do pass and be re-referred to the Committee on [Appropriations] with recommendation: To Consent Calendar",11,0,0,0,11
1745247,1352106,2023-08-23,Assembly,"Do pass. To Consent Calendar",15,0,0,1,16
1745247,1353652,2023-09-11,Assembly,"SB 890 Governance and Finance Senate Third Reading By IRWIN",80,0,0,0,80
1745247,1354829,2023-09-14,Senate,"Unfinished Business SB890 GOV. & F. (Caballero) Concurrence",40,0,0,0,40
1745248,1308884,2023-04-24,Senate,"Senate 3rd Reading SCR44 Caballero et al",39,0,0,1,40
1745248,1327961,2023-05-18,Assembly,"Be adopted. To Consent Calendar",12,0,0,1,13
1745248,1333634,2023-05-25,Assembly,"SCR 44 Caballero Consent Calendar Second Day Regular Session",76,0,0,4,80
1745994,1311727,2023-04-26,Assembly,"Do pass. To Consent Calendar",22,0,0,0,22
1745994,1318902,2023-05-04,Assembly,"AB 1768 Governmental Organization Consent Calendar Second Day Regular Session",75,0,0,5,80
1745994,1350148,2023-07-11,Senate,"Do pass and be ordered to the Consent Calendar",14,0,0,1,15
1745994,1460061,2024-06-25,Senate,"That the measure be returned to Senate Floor for consideration. Ordered to third reading",14,0,0,2,16
1745994,1465849,2024-08-27,Senate,"Assembly 3rd Reading AB1768 G.O. (Blanca Rubio) By Dodd",40,0,0,0,40
1745994,1467213,2024-08-28,Assembly,"AB 1768 G.O. Concurrence in Senate Amendments By RUBIO",77,0,0,2,79
1745995,1311768,2023-04-26,Assembly,"Do pass and be re-referred to the Committee on [Appropriations] with recommendation: To Consent Calendar",22,0,0,0,22
1745995,1328325,2023-05-18,Assembly,"Do pass",15,0,0,1,16
1745995,1337225,2023-06-01,Assembly,"AB 1769 G.O. Assembly Third Reading By FRAZIER",78,0,0,2,80
1745995,1350137,2023-07-11,Senate,"Do pass, but first be re-referred to the Committee on [Appropriations] with the recommendation: To Consent Calendar",14,0,0,1,15
1745996,1311753,2023-04-26,Assembly,"Do pass. To Consent Calendar",7,0,0,0,7
1745996,1318908,2023-05-04,Assembly,"AB 1770 E.M. Consent Calendar Second Day Regular Session",75,0,0,5,80
1745996,1350251,2023-07-11,Senate,"Do pass, but first be re-referred to the Committee on [Appropriations] with the recommendation: To Consent Calendar",14,0,0,1,15
1745996,1351767,2023-08-21,Senate,"Placed on suspense file",7,0,0,0,7
1745996,1352521,2023-09-01,Senate,"Do pass as amended",7,0,0,0,7
1745996,1354264,2023-09-13,Senate,"Special Consent AB1770 E.M. (Rodriguez)",39,0,0,1,40
1745996,1463427,2024-08-05,Senate,"Assembly 3rd Reading AB1770 E.M. (Rodriguez) By Dodd",40,0,0,0,40
1745996,1465265,2024-08-19,Assembly,"AB 1770 Emergency Management Concurrence in Senate Amendments By RODRIGUEZ",76,0,0,3,79
1745997,1289766,2023-03-30,Assembly,"Be adopted. To third reading",11,0,0,2,13
1745997,1313504,2023-04-27,Senate,"Special Consent ACR45 Ta et al. By Umberg",38,0,0,2,40
1745998,1289838,2023-03-30,Assembly,"Be adopted. To third reading",11,0,0,2,13
1745998,1296970,2023-04-10,Assembly,"AJR 2 Bains Assembly Third Reading",66,0,0,14,80
1745998,1348342,2023-06-27,Senate,"Be adopted and be ordered to the Consent Calendar",11,0,0,0,11
1745998,1349736,2023-07-06,Senate,"Consent Calendar AJR2 Bains et al",40,0,0,0,40
1745998,1350624,2023-07-13,Assembly,"AJR 2 Bains Concurrence in Senate Amendments",73,0,0,7,80
1745999,1283136,2023-03-23,Assembly,"Be adopted. To third reading",13,0,0,0,13
1746000,1296991,2023-04-10,Senate,"Senate 3rd Reading SCR45 Blakespear et al",35,0,0,5,40
1746000,1318901,2023-05-04,Assembly,"Be adopted. To Consent Calendar",12,0,0,1,13
1746000,1323868,2023-05-11,Assembly,"SCR 45 Blakespear Consent Calendar Second Day Regular Session",66,0,0,14,80
1746865,1289783,2023-03-30,Assembly,"Be adopted. To Consent Calendar",11,0,0,2,13
1746865,1302593,2023-04-17,Assembly,"ACR 46 Pellerin Consent Calendar Second Day Regular Session",79,0,0,1,80
1746865,1318959,2023-05-04,Senate,"Special Consent ACR46 Pellerin et al",37,0,0,3,40
1746866,1311750,2023-04-25,Senate,"Do pass and be ordered to the Consent Calendar",16,0,0,0,16
1746866,1318945,2023-05-04,Senate,"Consent Calendar SB891 TRANS. (Gonzalez)",37,0,0,3,40
1746866,1347890,2023-06-26,Assembly,"Do pass and be re-referred to the Committee on [Appropriations] with recommendation: To Consent Calendar",15,0,0,0,15
1746866,1352099,2023-08-23,Assembly,"Do pass. To Consent Calendar",15,0,0,1,16
1746866,1352479,2023-08-31,Assembly,"SB 891 Transportation Consent Calendar Second Day Regular Session",79,0,0,1,80
1746866,1353361,2023-09-07,Senate,"Special Consent SB891 TRANS. (Gonzalez)",40,0,0,0,40
1746867,1318038,2023-05-03,Senate,"Be adopted, but first be re-referred to the Committee on [Elections and Constitutional Amendments]",7,0,0,1,8
1746867,1320443,2023-05-08,Senate,"Be adopted, but first be re-referred to the Committee on [Appropriations] with recommendation: To Consent Calendar",7,0,0,0,7
1746867,1352321,2023-08-28,Senate,"Placed on suspense file",7,0,0,0,7
1746867,1352902,2023-09-01,Senate,"Be adopted",7,0,0,0,7
1746867,1353860,2023-09-12,Senate,"Senate 3rd Reading SCA6 Archuleta",39,0,0,1,40
1748380,1323816,2023-05-11,Assembly,"Be adopted. To third reading",10,0,0,3,13
1748380,1341940,2023-06-08,Senate,"Special Consent ACR47 McCarty et al",39,0,0,1,40
1748381,1341027,2023-06-07,Assembly,"Be adopted as amended",8,0,0,0,8
1748381,1345179,2023-06-19,Assembly,"AJR 3 Grayson Assembly Third Reading",69,0,0,11,80
1748381,1350132,2023-07-10,Senate,"Be adopted and be ordered to the Consent Calendar",11,0,0,0,11
1748381,1351490,2023-08-14,Senate,"Consent Calendar 2nd AJR3 Grayson et al",38,0,0,2,40
1749144,1300998,2023-04-13,Assembly,"Be adopted. To third reading",13,0,0,0,13
1749144,1323838,2023-05-11,Senate,"Special Consent ACR48 Mathis et al",39,0,0,1,40
1749145,1301006,2023-04-13,Assembly,"Be adopted. To third reading",13,0,0,0,13
1749146,1310172,2023-04-25,Senate,"Be adopted, but first be re-referred to the Committee on [Appropriations]",10,2,0,3,15
1749146,1328099,2023-05-18,Senate,"Senate 3rd Reading SCR47 Glazer et al",30,7,0,3,40
1749146,1346169,2023-06-21,Assembly,"Be adopted and re-referred to the Committee on [Appropriations]",4,2,0,1,7
1749146,1350430,2023-07-12,Assembly,"Be adopted. To third reading",11,3,0,2,16
1749146,1351662,2023-08-17,Assembly,"SCR 47 Glazer Senate Third Reading By Aguiar-Curry",60,11,0,9,80
1749811,1289803,2023-03-30,Assembly,"Be adopted. To third reading",11,0,0,2,13
1749811,1313394,2023-04-27,Senate,"Special Consent ACR49 Berman et al. By Glazer",38,0,0,2,40
1751298,1328904,2023-05-18,Assembly,"Be adopted. To third reading",12,0,0,1,13
1751298,1346991,2023-06-22,Senate,"Special Consent ACR50 Luz Rivas et al",39,0,0,1,40
1751299,1301069,2023-04-13,Assembly,"Be adopted. To third reading",13,0,0,0,13
1751299,1323850,2023-05-11,Senate,"Special Consent ACR51 Hart et al",39,0,0,1,40
1751300,1301000,2023-04-13,Assembly,"Be adopted. To third reading",13,0,0,0,13
1751300,1327950,2023-05-18,Senate,"Special Consent ACR52 Jones-Sawyer et al",38,0,0,2,40
1751301,1306787,2023-04-20,Senate,"Senate 3rd Reading SCR48 Smallwood-Cuevas et",36,0,0,4,40
1751301,1334448,2023-05-26,Assembly,"Be adopted. To Consent Calendar",12,0,0,1,13
1751301,1337888,2023-05-31,Assembly,"SCR 48 Smallwood-Cuevas Consent Calendar Second Day Regular Session",78,0,0,2,80
1751302,1302671,2023-04-17,Senate,"Senate 3rd Reading SR23 Gonzalez et al",37,0,0,3,40
1751303,1315652,2023-05-01,Senate,"Senate 3rd Reading SR24 Gonzalez et al",37,0,0,3,40
1754450,1306725,2023-04-20,Assembly,"Be adopted. To third reading",13,0,0,0,13
1754450,1337243,2023-06-01,Senate,"Special Consent ACR53 Weber et al",40,0,0,0,40
1754451,1301039,2023-04-13,Assembly,"Be adopted. To Consent Calendar",13,0,0,0,13
1754451,1306734,2023-04-20,Assembly,"ACR 54 Pacheco Consent Calendar Second Day Regular Session",76,0,0,4,80
1754451,1323854,2023-05-11,Senate,"Special Consent ACR54 Pacheco et al",39,0,0,1,40
1754452,1306776,2023-04-20,Assembly,"Be adopted. To third reading",13,0,0,0,13
1754452,1328686,2023-05-18,Senate,"Special Consent ACR55 Irwin et al",38,0,0,2,40
1754453,1323830,2023-05-11,Assembly,"Be adopted. To third reading",10,0,0,3,13
1754453,1341951,2023-06-08,Senate,"Special Consent ACR56 Rodriguez et al",39,0,0,1,40
1754454,1300994,2023-04-13,Assembly,"Be adopted. To third reading",13,0,0,0,13
1754455,1323791,2023-05-11,Assembly,"Be adopted. To third reading",10,0,0,3,13
1754456,1320409,2023-05-08,Senate,"Senate 3rd Reading SCR49 Laird",36,0,0,4,40
1754456,1328308,2023-05-18,Assembly,"Be adopted. To Consent Calendar",12,0,0,1,13
1754456,1333583,2023-05-25,Assembly,"SCR 49 Laird Consent Calendar Second Day Regular Session",76,0,0,4,80
1754457,1313444,2023-04-27,Senate,"Senate 3rd Reading SCR50 Umberg et al",38,0,0,2,40
1754457,1323793,2023-05-11,Assembly,"Be adopted. To Consent Calendar",10,0,0,3,13
1754457,1328578,2023-05-18,Assembly,"SCR 50 Umberg Consent Calendar Second Day Regular Session",74,0,0,6,80
1754458,1302612,2023-04-17,Senate,"Senate 3rd Reading SCR51 Becker et al",37,0,0,3,40
1754458,1318979,2023-05-04,Assembly,"Be adopted. To Consent Calendar",12,0,0,1,13
1754458,1323846,2023-05-11,Assembly,"SCR 51 Becker Consent Calendar Second Day Regular Session",66,0,0,14,80
1754459,1324960,2023-05-15,Senate,"Senate 3rd Reading SCR52 Alvarado-Gil",38,0,0,2,40
1754459,1334444,2023-05-26,Assembly,"Be adopted. To Consent Calendar",12,0,0,1,13
1754459,1340065,2023-05-31,Assembly,"SCR 52 Alvarado-Gil Consent Calendar Second Day Regular Session",78,0,0,2,80
1754460,1306756,2023-04-20,Senate,"Senate 3rd Reading SR25 Gonzalez",36,0,0,4,40
1754869,1306791,2023-04-20,Assembly,"Be adopted. To Consent Calendar",13,0,0,0,13
1754869,1313391,2023-04-27,Assembly,"ACR 57 Alanis Consent Calendar Second Day Regular Session",79,0,0,1,80
1754869,1328500,2023-05-18,Senate,"Special Consent ACR57 Alanis et al",38,0,0,2,40
1754870,1328190,2023-05-18,Senate,"Senate 3rd Reading SR26 Eggman et al",35,0,0,5,40
1755201,1310407,2023-04-25,Assembly,"Be adopted and re-referred to the Committee on [Appropriations]",12,3,0,0,15
1755201,1338209,2023-05-31,Assembly,"AJR 4 Schiavo Assembly Third Reading",63,15,0,2,80
1755201,1350696,2023-07-12,Senate,"Be adopted. Ordered to third reading",10,0,0,2,12
1755201,1353386,2023-09-07,Senate,"Assembly 3rd Reading AJR4 Schiavo et al. By McGuire",30,6,0,4,40
1755202,1306763,2023-04-20,Assembly,"Be adopted. To third reading",13,0,0,0,13
1755203,1349779,2023-07-06,Senate,"Be adopted and be ordered to the Consent Calendar",11,0,0,0,11
1755203,1350683,2023-07-13,Senate,"Consent Calendar SR27 Cortese",37,0,0,3,40
1755204,1308845,2023-04-24,Senate,"Senate 3rd Reading SR28 Portantino et al",39,0,0,1,40
1755550,1306740,2023-04-20,Assembly,"Be adopted. To Consent Calendar",13,0,0,0,13
1755550,1313328,2023-04-27,Assembly,"ACR 58 Reyes Consent Calendar Second Day Regular Session",79,0,0,1,80
1755550,1328478,2023-05-18,Senate,"Special Consent ACR58 Reyes et al",38,0,0,2,40
1755551,1313449,2023-04-27,Assembly,"Be adopted. To Consent Calendar",13,0,0,0,13
1755551,1318978,2023-05-04,Assembly,"ACR 59 Robert Rivas Consent Calendar Second Day Regular Session",75,0,0,5,80
1755551,1334443,2023-05-26,Senate,"Special Consent ACR59 Robert Rivas et al",37,0,0,3,40
1755552,1310208,2023-04-25,Assembly,"Be adopted. To Consent Calendar",7,0,0,0,7
1755552,1313482,2023-04-27,Assembly,"ACR 60 Holden Consent Calendar Second Day Regular Session",79,0,0,1,80
1755552,1328710,2023-05-18,Senate,"Special Consent ACR60 Holden et al",38,0,0,2,40
1755552,1343132,2023-06-12,Assembly,"ACR 60 Holden Concurrence in Senate Amendments",76,0,0,4,80
1756155,1317099,2023-05-02,Assembly,"Be adopted. To third reading",8,0,0,3,11
1756155,1324975,2023-05-15,Assembly,"AJR 5 Gipson Assembly Third Reading",63,0,0,17,80
1756155,1345610,2023-06-20,Senate,"Be adopted. Ordered to third reading",10,0,0,1,11
1756155,1353371,2023-09-07,Senate,"Assembly 3rd Reading AJR5 Gipson et al. By Smallwood-Cuevas",31,2,0,7,40
1756155,1353372,2023-09-07,Senate,"Assembly 3rd Reading AJR5 Gipson et al. By Smallwood-Cuevas Motion To Reconsider",40,0,0,0,40
1756155,1353373,2023-09-07,Senate,"Assembly 3rd Reading AJR5 Gipson et al. By Smallwood-Cuevas",32,0,0,8,40
1756156,1313453,2023-04-27,Senate,"Senate 3rd Reading SCR53 Allen",38,0,0,2,40
1756156,1323837,2023-05-11,Assembly,"Be adopted. To Consent Calendar",10,0,0,3,13
1756156,1328893,2023-05-18,Assembly,"SCR 53 Allen Consent Calendar Second Day Regular Session",74,0,0,6,80
1756905,1306739,2023-04-20,Assembly,"Be adopted. To Consent Calendar",13,0,0,0,13
1756905,1313450,2023-04-27,Assembly,"ACR 61 Waldron Consent Calendar Second Day Regular Session",79,0,0,1,80
1756905,1328170,2023-05-18,Senate,"Special Consent ACR61 Waldron et al",38,0,0,2,40
1757399,1310313,2023-04-25,Assembly,"Be adopted. To Consent Calendar",7,0,0,0,7
1757399,1313418,2023-04-27,Assembly,"ACR 62 Quirk-Silva Consent Calendar Second Day Regular Session",79,0,0,1,80
1757400,1306765,2023-04-20,Assembly,"Be adopted. To third reading",13,0,0,0,13
1757400,1323794,2023-05-11,Senate,"Special Consent ACR63 Wood et al",39,0,0,1,40
1757401,1340070,2023-06-06,Assembly,"Be adopted. To Consent Calendar",11,0,0,0,11
1757401,1341933,2023-06-08,Assembly,"HR 30 Essayli Consent Calendar Second Day",66,0,0,14,80
1757402,1318951,2023-05-04,Senate,"Senate 3rd Reading SCR55 Portantino",37,0,0,3,40
1757402,1328525,2023-05-18,Assembly,"Be adopted. To Consent Calendar",12,0,0,1,13
1757402,1333724,2023-05-25,Assembly,"SCR 55 Portantino Consent Calendar Second Day Regular Session",76,0,0,4,80
1757948,1344722,2023-06-15,Assembly,"Be adopted. To third reading",13,0,0,0,13
1757948,1349782,2023-07-06,Senate,"Special Consent ACR64 Bains et al",40,0,0,0,40
1757949,1313397,2023-04-27,Assembly,"Be adopted. To third reading",13,0,0,0,13
1757949,1337204,2023-06-01,Senate,"Special Consent ACR65 Alanis et al",40,0,0,0,40
1757950,1330101,2023-05-22,Senate,"Senate 3rd Reading SR29 Min et al",40,0,0,0,40
1758598,1328742,2023-05-18,Assembly,"Be adopted. To Consent Calendar",12,0,0,1,13
1758598,1333621,2023-05-25,Assembly,"ACR 66 Wilson Consent Calendar Second Day Regular Session",76,0,0,4,80
1758598,1351354,2023-08-14,Senate,"Assembly 3rd Reading ACR66 Wilson et al. By Min",39,0,0,1,40
1758599,1313454,2023-04-27,Assembly,"Be adopted. To third reading",13,0,0,0,13
1758600,1320539,2023-05-08,Senate,"Senate 3rd Reading SR30 Archuleta",36,0,0,4,40
1758601,1323799,2023-05-11,Senate,"Senate 3rd Reading SR31 Jones",39,0,0,1,40
1759048,1343764,2023-06-13,Assembly,"Amend, and be adopted as amended and re-refer to the Committee on [Appropriations] with the recommendation: To Consent Calendar",15,0,0,0,15
1759048,1347811,2023-06-27,Assembly,"ACR 67 Waldron Consent Calendar Second Day",78,0,0,2,80
1759048,1350672,2023-07-13,Senate,"Special Consent ACR67 Waldron et al",37,0,0,3,40
1759049,1352231,2023-08-24,Senate,"Special Consent SR32 Seyarto",40,0,0,0,40
1759484,1318931,2023-05-04,Assembly,"Be adopted. To Consent Calendar",12,0,0,1,13
1759484,1323876,2023-05-11,Assembly,"HR 32 McKinnor Consent Calendar Second Day Regular Session",66,0,0,14,80
1759809,1352646,2023-09-01,Senate,"Special Consent SCR56 Niello",37,0,0,3,40
1759809,1389449,2024-02-20,Assembly,"Be adopted. To Consent Calendar",7,0,0,4,11
1759809,1392708,2024-02-22,Assembly,"SCR 56 Niello Consent Calendar Second Day",70,0,0,10,80
1759810,1324956,2023-05-15,Senate,"Senate 3rd Reading SCR57 Portantino et al",38,0,0,2,40
1759810,1350293,2023-07-11,Assembly,"Be adopted. To Consent Calendar",7,0,0,0,7
1759810,1351508,2023-08-14,Assembly,"SCR 57 Portantino Consent Calendar Second Day Regular Session",74,0,0,6,80
1759811,1351781,2023-08-22,Senate,"Be adopted. Ordered to third reading",11,0,0,4,15
1759811,1352317,2023-08-28,Senate,"Senate 3rd Reading SCR58 Glazer et al",39,0,0,1,40
1760512,1318986,2023-05-04,Assembly,"Be adopted. To Consent Calendar",12,0,0,1,13
1760513,1318915,2023-05-04,Assembly,"Be adopted. To Consent Calendar",12,0,0,1,13
1760513,1323827,2023-05-11,Assembly,"ACR 69 Aguiar-Curry Consent Calendar Second Day Regular Session",66,0,0,14,80
1760513,1337245,2023-06-01,Senate,"Special Consent ACR69 Aguiar-Curry et al",40,0,0,0,40
1760514,1318899,2023-05-04,Assembly,"Be adopted. To third reading",12,0,0,1,13
1760514,1337198,2023-06-01,Senate,"Special Consent ACR70 Pellerin et al",40,0,0,0,40
1760515,1349589,2023-07-05,Assembly,"Be adopted. To third reading",15,0,0,0,15
1760515,1349905,2023-07-10,Assembly,"ACR 71 Ta Assembly Third Reading",74,0,0,6,80
1760516,1318924,2023-05-04,Assembly,"Be adopted. To third reading",12,0,0,1,13
1760516,1341937,2023-06-08,Senate,"Special Consent ACR72 Wallis et al",39,0,0,1,40
1760517,1328462,2023-05-18,Assembly,"Be adopted. To third reading",12,0,0,1,13
1760518,1346985,2023-06-22,Senate,"Be adopted as amended, but first amend, and re-refer to the Committee on [Elections and Constitutional Amendments]",4,1,0,0,5
1760519,1343769,2023-06-13,Senate,"Be adopted and be ordered to the Consent Calendar",16,0,0,0,16
1760519,1346963,2023-06-22,Senate,"Consent Calendar SCR59 Ochoa Bogh et al",39,0,0,1,40
1760519,1363622,2024-01-08,Assembly,"Be adopted. To Consent Calendar",14,0,0,1,15
1760519,1364238,2024-01-12,Assembly,"SCR 59 Ochoa Bogh Consent Calendar Second Day Regular Session",67,0,0,13,80
1760520,1338792,2023-06-05,Senate,"Senate 3rd Reading SR33 Eggman et al",31,0,0,9,40
1760892,1318943,2023-05-04,Assembly,"Be adopted. To Consent Calendar",12,0,0,1,13
1760892,1323877,2023-05-11,Assembly,"ACR 73 Bains Consent Calendar Second Day Regular Session",66,0,0,14,80
1760892,1337186,2023-06-01,Senate,"Special Consent ACR73 Bains et al",40,0,0,0,40
1760893,1352249,2023-08-24,Senate,"Special Consent SCR60 Seyarto",40,0,0,0,40
1760893,1352481,2023-08-31,Assembly,"Be adopted. To Consent Calendar",10,0,0,3,13
1760893,1353179,2023-09-05,Assembly,"SCR 60 Seyarto Consent Calendar Second Day Regular Session",79,0,0,1,80
1760894,1353393,2023-09-07,Senate,"Senate 3rd Reading SCR61 Seyarto et al",40,0,0,0,40
1760894,1402354,2024-03-04,Assembly,"Be adopted. To Consent Calendar",8,0,0,3,11
1760894,1405814,2024-03-07,Assembly,"SCR 61 Seyarto Consent Calendar Second Day Regular Session",69,0,0,11,80
1760895,1341053,2023-06-07,Senate,"Be adopted as amended",5,0,0,2,7
1760895,1349478,2023-07-03,Senate,"Senate 3rd Reading SR34 Cortese",29,0,0,11,40
1761241,1323892,2023-05-11,Senate,"Senate 3rd Reading SCR62 Rubio et al",39,0,0,1,40
1761241,1334468,2023-05-26,Assembly,"Be adopted. To Consent Calendar",12,0,0,1,13
1761241,1340019,2023-05-31,Assembly,"SCR 62 Rubio Consent Calendar Second Day Regular Session",78,0,0,2,80
1761242,1324952,2023-05-15,Senate,"Senate 3rd Reading SR35 Caballero",38,0,0,2,40
1761498,1323841,2023-05-11,Assembly,"Be adopted. To third reading",10,0,0,3,13
1761498,1344724,2023-06-15,Senate,"Special Consent ACR74 Friedman et al",40,0,0,0,40
1761499,1323879,2023-05-11,Assembly,"Be adopted. To third reading",10,0,0,3,13
1761499,1341939,2023-06-08,Senate,"Special Consent ACR75 Ramos et al",39,0,0,1,40
1761501,1323849,2023-05-11,Assembly,"Be adopted. To third reading",10,0,0,3,13
1761502,1328740,2023-05-18,Senate,"Senate 3rd Reading SCR63 Hurtado et al",38,0,0,2,40
1761502,1337250,2023-06-01,Assembly,"Be adopted. To Consent Calendar",12,0,0,1,13
1761502,1341952,2023-06-08,Assembly,"SCR 63 Hurtado Consent Calendar Second Day Regular Session",66,0,0,14,80
1761503,1338797,2023-06-05,Senate,"Senate 3rd Reading SCR64 Dodd et al",37,0,0,3,40
1761503,1344709,2023-06-15,Assembly,"Be adopted. To Consent Calendar",13,0,0,0,13
1761503,1346984,2023-06-22,Assembly,"SCR 64 Dodd Consent Calendar Second Day Regular Session",71,0,0,9,80
1761504,1344195,2023-06-14,Senate,"Be adopted. Ordered to third reading",4,1,0,0,5
1761504,1346960,2023-06-22,Senate,"Senate 3rd Reading SJR5 Durazo et al",32,7,0,1,40
1761504,1352450,2023-08-30,Assembly,"Be adopted. To third reading",6,0,0,1,7
1761504,1380152,2024-02-08,Assembly,"SJR 5 Durazo Senate Third Reading By Gipson",61,0,0,19,80
1761505,1341932,2023-06-08,Senate,"Senate 3rd Reading SR36 Menjivar et al",36,0,0,4,40
1761507,1341014,2023-06-07,Senate,"Be adopted. Ordered to third reading",7,0,0,0,7
1761507,1347485,2023-06-26,Senate,"Senate 3rd Reading SR38 Durazo et al",39,0,0,1,40
1762431,1323848,2023-05-11,Assembly,"Be adopted. To third reading",10,0,0,3,13
1762431,1341950,2023-06-08,Senate,"Special Consent ACR76 Grayson et al",39,0,0,1,40
1762432,1323896,2023-05-11,Assembly,"Be adopted. To Consent Calendar",10,0,0,3,13
1762432,1328855,2023-05-18,Assembly,"HR 35 Reyes Consent Calendar Second Day Regular Session",74,0,0,6,80
1762433,1341928,2023-06-08,Assembly,"Be adopted. To third reading",12,0,0,1,13
1762434,1340137,2023-06-06,Assembly,"Be adopted. To third reading",11,0,0,0,11
1762435,1328227,2023-05-18,Senate,"Senate 3rd Reading SCR65 Ashby",38,0,0,2,40
1762435,1337213,2023-06-01,Assembly,"Be adopted. To Consent Calendar",12,0,0,1,13
1762435,1341954,2023-06-08,Assembly,"SCR 65 Ashby Consent Calendar Second Day Regular Session",66,0,0,14,80
1762436,1327937,2023-05-18,Senate,"Senate 3rd Reading SCR66 Hurtado",38,0,0,2,40
1762436,1337218,2023-06-01,Assembly,"Be adopted. To Consent Calendar",12,0,0,1,13
1762436,1341922,2023-06-08,Assembly,"SCR 66 Hurtado Consent Calendar Second Day Regular Session",66,0,0,14,80
1762437,1328870,2023-05-18,Senate,"Senate 3rd Reading SCR67 Portantino et al",38,0,0,2,40
1762437,1337240,2023-06-01,Assembly,"Be adopted. To Consent Calendar",12,0,0,1,13
1762437,1341955,2023-06-08,Assembly,"SCR 67 Portantino Consent Calendar Second Day Regular Session",66,0,0,14,80
1762438,1328155,2023-05-18,Senate,"Senate 3rd Reading SR39 Wiener",38,0,0,2,40
1762869,1323847,2023-05-11,Assembly,"Be adopted. To third reading",10,0,0,3,13
1762870,1352819,2023-09-01,Senate,"Special Consent SR40 Alvarado-Gil",37,0,0,3,40
1763373,1328752,2023-05-18,Assembly,"Be adopted. To Consent Calendar",12,0,0,1,13
1763373,1333577,2023-05-25,Assembly,"ACR 77 Alanis Consent Calendar Second Day Regular Session",76,0,0,4,80
1763373,1344731,2023-06-15,Senate,"Special Consent ACR77 Alanis et al",40,0,0,0,40
1763374,1328839,2023-05-18,Senate,"Senate 3rd Reading SCR68 Padilla et al",38,0,0,2,40
1763374,1341923,2023-06-08,Assembly,"Be adopted. To Consent Calendar",12,0,0,1,13
1763374,1344717,2023-06-15,Assembly,"SCR 68 Padilla Consent Calendar Second Day Regular Session",74,0,0,6,80
1763964,1334466,2023-05-26,Assembly,"Be adopted. To Consent Calendar",12,0,0,1,13
1763964,1337897,2023-05-31,Assembly,"ACR 78 Kalra Consent Calendar Second Day",78,0,0,2,80
1763964,1346962,2023-06-22,Senate,"Special Consent ACR78 Kalra et al",39,0,0,1,40
1764675,1328440,2023-05-18,Assembly,"Be adopted. To third reading",12,0,0,1,13
1764675,1344736,2023-06-15,Senate,"Special Consent ACR79 Connolly et al",40,0,0,0,40
1764676,1334461,2023-05-26,Assembly,"Be adopted. To third reading",12,0,0,1,13
1764677,1353487,2023-09-07,Senate,"Senate 3rd Reading SCR69 Dahle et al",40,0,0,0,40
1764677,1410537,2024-03-18,Assembly,"Be adopted. To Consent Calendar",9,0,0,2,11
1764677,1413844,2024-03-21,Assembly,"SCR 69 Dahle Consent Calendar Second Day Regular Session",57,0,0,23,80
1764677,1425883,2024-04-11,Senate,"Special Consent SCR69 Dahle et al",39,0,0,1,40
1765317,1328052,2023-05-18,Assembly,"Be adopted. To third reading",12,0,0,1,13
1765317,1353394,2023-09-07,Senate,"Assembly 3rd Reading ACR80 Villapudua et al. By Caballero",40,0,0,0,40
1765922,1334452,2023-05-26,Assembly,"Be adopted. To Consent Calendar",12,0,0,1,13
1765922,1338813,2023-05-31,Assembly,"HR 40 Gabriel Consent Calendar Second Day Regular Session",78,0,0,2,80
1765923,1334465,2023-05-26,Assembly,"Be adopted. To Consent Calendar",12,0,0,1,13
1765923,1338811,2023-05-31,Assembly,"HR 41 Mike Fong Consent Calendar Second Day Regular Session",78,0,0,2,80
1765924,1352222,2023-08-24,Senate,"Special Consent SCR70 Seyarto et al",40,0,0,0,40
1765924,1352466,2023-08-31,Assembly,"Be adopted. To Consent Calendar",10,0,0,3,13
1765924,1353189,2023-09-05,Assembly,"SCR 70 Seyarto Consent Calendar Second Day Regular Session",79,0,0,1,80
1766578,1334457,2023-05-26,Assembly,"Be adopted. To third reading",12,0,0,1,13
1767413,1334460,2023-05-26,Assembly,"Be adopted. To Consent Calendar",12,0,0,1,13
1767413,1337948,2023-05-31,Assembly,"ACR 82 Weber Consent Calendar Second Day Regular Session",78,0,0,2,80
1767413,1346946,2023-06-22,Senate,"Special Consent ACR82 Weber et al",39,0,0,1,40
1767414,1334455,2023-05-26,Assembly,"Be adopted. To third reading",12,0,0,1,13
1767414,1349788,2023-07-06,Senate,"Special Consent ACR83 Aguiar-Curry et al",40,0,0,0,40
1767415,1334467,2023-05-26,Assembly,"Be adopted. To third reading",12,0,0,1,13
1767416,1346970,2023-06-22,Senate,"Senate 3rd Reading SR41 Menjivar et al",39,0,0,1,40
1768136,1349612,2023-07-05,Assembly,"Be adopted. To Consent Calendar",15,0,0,0,15
1768136,1395223,2024-02-26,Assembly,"ACR 85 Villapudua Assembly Third Reading",72,0,0,8,80
1768136,1424836,2024-04-09,Senate,"Be adopted, but first be re-referred to the Committee on [Appropriations] with recommendation: To Consent Calendar",15,0,0,0,15
1768136,1435294,2024-04-25,Senate,"Consent Calendar 2nd ACR85 Villapudua et al",36,0,0,4,40
1768137,1345615,2023-06-20,Assembly,"Be adopted and re-referred to the Committee on [Appropriations]",18,0,0,1,19
1768137,1348402,2023-06-28,Assembly,"Be adopted. To third reading",14,0,0,2,16
1768137,1349454,2023-07-03,Assembly,"ACR 86 Kalra Assembly Third Reading",68,0,0,12,80
1768137,1352310,2023-08-28,Senate,"Be adopted, but first be re-referred to the Committee on [Appropriations]",12,0,0,1,13
1768137,1410553,2024-03-18,Senate,"Assembly 3rd Reading ACR86 Kalra et al. By Eggman",40,0,0,0,40
1768137,1431002,2024-04-18,Assembly,"ACR 86 Kalra Concurrence in Senate Amendments",67,0,0,13,80
1768138,1352719,2023-09-01,Senate,"Senate 3rd Reading SCR71 Rubio et al",37,0,0,3,40
1768138,1389471,2024-02-20,Assembly,"Be adopted. To Consent Calendar",7,0,0,4,11
1768138,1392709,2024-02-22,Assembly,"SCR 71 Rubio Consent Calendar Second Day Regular Session",70,0,0,10,80
1768978,1349655,2023-07-05,Assembly,"Be adopted. To Consent Calendar",15,0,0,0,15
1768978,1351270,2023-08-14,Assembly,"ACR 87 Ta Consent Calendar Second Day",74,0,0,6,80
1768978,1424894,2024-04-09,Senate,"Be adopted, but first be re-referred to the Committee on [Appropriations] with recommendation: To Consent Calendar",15,0,0,0,15
1768978,1435354,2024-04-25,Senate,"Consent Calendar 2nd ACR87 Ta et al",36,0,0,4,40
1769358,1344726,2023-06-15,Assembly,"Be adopted. To third reading",13,0,0,0,13
1769540,1341938,2023-06-08,Assembly,"Be adopted. To Consent Calendar",12,0,0,1,13
1769540,1344708,2023-06-15,Assembly,"ACR 89 Calderon Consent Calendar Second Day",74,0,0,6,80
1769540,1349761,2023-07-06,Senate,"Special Consent ACR89 Calderon et al",40,0,0,0,40
1769541,1347488,2023-06-26,Senate,"Be adopted and be ordered to the Consent Calendar",13,0,0,0,13
1769541,1348873,2023-06-29,Senate,"Consent Calendar SCR72 Min et al",39,0,0,1,40
1769541,1352237,2023-08-24,Assembly,"Be adopted. To Consent Calendar",11,0,0,2,13
1769541,1352473,2023-08-31,Assembly,"SCR 72 Min Consent Calendar Second Day Regular Session",79,0,0,1,80
1769779,1349410,2023-06-29,Assembly,"Be adopted. To third reading",7,0,0,6,13
1769779,1352511,2023-09-01,Senate,"Special Consent ACR90 Kalra et al",37,0,0,3,40
1769780,1349418,2023-06-29,Assembly,"Be adopted. To Consent Calendar",7,0,0,6,13
1769780,1349815,2023-07-06,Assembly,"ACR 91 Kalra Consent Calendar Second Day",70,0,0,10,80
1769780,1352258,2023-08-24,Senate,"Special Consent ACR91 Kalra et al",40,0,0,0,40
1769781,1349405,2023-06-29,Assembly,"Be adopted. To Consent Calendar",7,0,0,6,13
1769781,1349806,2023-07-06,Assembly,"HR 43 Kalra Consent Calendar Second Day Regular Session",70,0,0,10,80
1769782,1346981,2023-06-22,Senate,"Senate 3rd Reading SCR73 Gonzalez et al",39,0,0,1,40
1769782,1349404,2023-06-29,Assembly,"Be adopted. To Consent Calendar",7,0,0,6,13
1769782,1349762,2023-07-06,Assembly,"SCR 73 Gonzalez Consent Calendar Second Day Regular Session",70,0,0,10,80
1770185,1349615,2023-07-05,Assembly,"Be adopted. To Consent Calendar",15,0,0,0,15
1770185,1351373,2023-08-14,Assembly,"ACR 92 Schiavo Consent Calendar Second Day Regular Session",74,0,0,6,80
1770185,1424782,2024-04-09,Senate,"Be adopted, but first be re-referred to the Committee on [Appropriations] with recommendation: To Consent Calendar",15,0,0,0,15
1770185,1435266,2024-04-25,Senate,"Consent Calendar 2nd ACR92 Schiavo et al",36,0,0,4,40
1770186,1349667,2023-07-05,Assembly,"Be adopted. To Consent Calendar",15,0,0,0,15
1770186,1351266,2023-08-14,Assembly,"ACR 93 Dixon Assembly Third Reading",73,0,0,7,80
1770186,1424883,2024-04-09,Senate,"Be adopted, but first be re-referred to the Committee on [Appropriations] with recommendation: To Consent Calendar",15,0,0,0,15
1770186,1435325,2024-04-25,Senate,"Consent Calendar 2nd ACR93 Dixon et al",36,0,0,4,40
1770187,1350412,2023-07-11,Senate,"Be adopted, but first be re-referred to the Committee on [Appropriations] with recommendation: To Consent Calendar",16,0,0,0,16
1770187,1351687,2023-08-17,Senate,"Consent Calendar 2nd SCR74 Nguyen et al",38,0,0,2,40
1770187,1363621,2024-01-08,Assembly,"Be adopted. To Consent Calendar",14,0,0,1,15
1770187,1364233,2024-01-12,Assembly,"SCR 74 Nguyen Consent Calendar Second Day Regular Session",67,0,0,13,80
1770188,1352598,2023-09-01,Senate,"Senate 3rd Reading SCR75 Ochoa Bogh et al",37,0,0,3,40
1770188,1389452,2024-02-20,Assembly,"Be adopted. To Consent Calendar",7,0,0,4,11
1770188,1392725,2024-02-22,Assembly,"SCR 75 Ochoa Bogh Consent Calendar Second Day Regular Session",70,0,0,10,80
1770441,1341924,2023-06-08,Assembly,"Be adopted. To third reading",12,0,0,1,13
1770441,1349817,2023-07-06,Senate,"Special Consent ACR94 Jones-Sawyer et al",40,0,0,0,40
1770442,1345199,2023-06-19,Senate,"Senate 3rd Reading SCR76 Bradford et al",39,0,0,1,40
1770442,1351443,2023-08-14,Assembly,"Be adopted. To Consent Calendar",12,0,0,1,13
1770442,1351667,2023-08-17,Assembly,"SCR 76 Bradford Consent Calendar Second Day Regular Session",75,0,0,5,80
1770443,1343133,2023-06-12,Senate,"Senate 3rd Reading SR42 Grove",35,0,0,5,40
1770740,1344729,2023-06-15,Assembly,"Be adopted. To third reading",13,0,0,0,13
1770740,1352862,2023-09-01,Senate,"Special Consent ACR95 Wicks et al",37,0,0,3,40
1770741,1341958,2023-06-08,Assembly,"Be adopted. To Consent Calendar",12,0,0,1,13
1770741,1344704,2023-06-15,Assembly,"HR 44 Soria Consent Calendar Second Day Regular Session",74,0,0,6,80
1771300,1350195,2023-07-11,Assembly,"Be adopted. To Consent Calendar",10,0,0,1,11
1771300,1351499,2023-08-14,Assembly,"ACR 96 Hoover Consent Calendar Second Day Regular Session",74,0,0,6,80
1771301,1349411,2023-06-29,Assembly,"Be adopted. To third reading",7,0,0,6,13
1771479,1346990,2023-06-22,Senate,"Senate 3rd Reading SCR77 Newman et al",38,0,0,2,40
1771479,1349403,2023-06-29,Assembly,"Be adopted. To Consent Calendar",7,0,0,6,13
1771479,1349750,2023-07-06,Assembly,"SCR 77 Newman Consent Calendar Second Day Regular Session",70,0,0,10,80
1771713,1349414,2023-06-29,Assembly,"Be adopted. To Consent Calendar",7,0,0,6,13
1771713,1349792,2023-07-06,Assembly,"ACR 97 Ward Consent Calendar Second Day Regular Session",70,0,0,10,80
1771713,1352230,2023-08-24,Senate,"Special Consent ACR97 Ward et al",40,0,0,0,40
1771714,1349402,2023-06-29,Assembly,"Be adopted. To third reading",7,0,0,6,13
1771715,1348882,2023-06-29,Senate,"Senate 3rd Reading SCR78 Niello et al",36,0,0,4,40
1771715,1349916,2023-07-10,Assembly,"Be adopted. To Consent Calendar",13,0,0,0,13
1771715,1351343,2023-08-14,Assembly,"SCR 78 Niello Consent Calendar Second Day Regular Session",74,0,0,6,80
1771716,1352524,2023-09-01,Senate,"Senate 3rd Reading SR43 Grove",37,0,0,3,40
1772089,1346986,2023-06-22,Assembly,"HR 47 Reyes Assembly Third Reading",71,0,0,9,80
1772090,1350679,2023-07-13,Senate,"Senate 3rd Reading SCR79 McGuire",37,0,0,3,40
1772090,1351313,2023-08-14,Assembly,"Be adopted. To Consent Calendar",12,0,0,1,13
1772090,1351686,2023-08-17,Assembly,"SCR 79 McGuire Consent Calendar Second Day Regular Session",75,0,0,5,80
1772091,1458769,2024-06-20,Senate,"Senate 3rd Reading SR44 Caballero",35,0,0,5,40
1772290,1349618,2023-07-05,Assembly,"Be adopted. To Consent Calendar",15,0,0,0,15
1772290,1350646,2023-07-13,Assembly,"ACR 98 Lackey Assembly Third Reading",71,0,0,9,80
1772290,1424798,2024-04-09,Senate,"Be adopted, but first be re-referred to the Committee on [Appropriations] with recommendation: To Consent Calendar",15,0,0,0,15
1772290,1435262,2024-04-25,Senate,"Consent Calendar 2nd ACR98 Lackey et al",36,0,0,4,40
1772291,1465520,2024-08-22,Senate,"Special Consent SCR80 Roth et al",33,0,0,7,40
1772291,1465626,2024-08-26,Assembly,"Be adopted. To Consent Calendar",9,0,0,2,11
1772291,1467189,2024-08-28,Assembly,"SCR 80 Roth Consent Calendar Second Day Regular Session",75,0,0,4,79
1772423,1346989,2023-06-22,Assembly,"Be adopted. To third reading",11,0,0,2,13
1772423,1350617,2023-07-13,Senate,"Special Consent ACR99 Cervantes et al",37,0,0,3,40
1772424,1354239,2023-09-13,Assembly,"Be adopted. To third reading",6,0,0,2,8
1772424,1354568,2023-09-14,Assembly,"AJR 8 Essayli Assembly Third Reading",63,0,0,17,80
1772424,1419212,2024-04-02,Senate,"Be adopted as amended, and be ordered to the Consent Calendar",5,0,0,0,5
1772424,1422041,2024-04-08,Senate,"Consent Calendar 2nd AJR8 Essayli et al",37,0,0,3,40
1772424,1425939,2024-04-11,Assembly,"AJR 8 Essayli Concurrence in Senate Amendments",31,0,0,49,80
1772563,1349413,2023-06-29,Assembly,"Be adopted. To Consent Calendar",7,0,0,6,13
1772563,1349744,2023-07-06,Assembly,"ACR 100 Kalra Consent Calendar Second Day Regular Session",70,0,0,10,80
1772563,1352240,2023-08-24,Senate,"Special Consent ACR100 Kalra et al",40,0,0,0,40
1772761,1349406,2023-06-29,Assembly,"Be adopted. To Consent Calendar",7,0,0,6,13
1772761,1349825,2023-07-06,Assembly,"HR 48 Low Consent Calendar Second Day Regular Session",70,0,0,10,80
1773123,1349401,2023-06-29,Assembly,"Be adopted. To third reading",7,0,0,6,13
1773123,1352263,2023-08-24,Senate,"Special Consent ACR101 Wallis et al",40,0,0,0,40
1773266,1349400,2023-06-29,Assembly,"Be adopted. To third reading",7,0,0,6,13
1773266,1351676,2023-08-17,Senate,"Assembly 3rd Reading ACR102 Cervantes et al. By Padilla",38,0,0,2,40
1773442,1349959,2023-07-10,Assembly,"Be adopted. To Consent Calendar",13,0,0,0,13
1773442,1351349,2023-08-14,Assembly,"ACR 103 Vince Fong Consent Calendar Second Day Regular Session",74,0,0,6,80
1773442,1353045,2023-09-01,Senate,"Special Consent ACR103 Vince Fong et al",37,0,0,3,40
1773443,1349915,2023-07-10,Assembly,"Be adopted. To third reading",13,0,0,0,13
1773504,1431932,2024-04-22,Senate,"Be adopted. Ordered to third reading",4,0,0,1,5
1773504,1452962,2024-06-03,Senate,"Senate 3rd Reading SJR6 Caballero et al",29,0,0,11,40
1773504,1459995,2024-06-25,Assembly,"Be adopted. To third reading",7,0,0,3,10
1773504,1464160,2024-08-15,Assembly,"SJR 6 Caballero Senate Third Reading By Ward",62,0,0,17,79
1773720,1349931,2023-07-10,Assembly,"Be adopted. To Consent Calendar",13,0,0,0,13
1773720,1351250,2023-08-14,Assembly,"ACR 104 Low Consent Calendar Second Day Regular Session",74,0,0,6,80
1773720,1352922,2023-09-01,Senate,"Special Consent ACR104 Low et al",37,0,0,3,40
1773721,1351315,2023-08-14,Senate,"Senate 3rd Reading SCR81 Bradford",39,0,0,1,40
1773721,1351707,2023-08-17,Assembly,"Be adopted. To Consent Calendar",10,0,0,3,13
1773721,1352229,2023-08-24,Assembly,"SCR 81 Bradford Consent Calendar Second Day Regular Session",73,0,0,7,80
1773775,1352307,2023-08-28,Senate,"Senate 3rd Reading SCR82 Wahab et al",39,0,0,1,40
1773775,1352469,2023-08-31,Assembly,"Be adopted. To Consent Calendar",10,0,0,3,13
1773775,1353115,2023-09-05,Assembly,"SCR 82 Wahab Consent Calendar Second Day Regular Session",79,0,0,1,80
1773814,1349923,2023-07-10,Assembly,"Be adopted. To Consent Calendar",13,0,0,0,13
1773814,1351376,2023-08-14,Assembly,"ACR 105 Berman Consent Calendar Second Day Regular Session",74,0,0,6,80
1773814,1352993,2023-09-01,Senate,"Special Consent ACR105 Berman et al",37,0,0,3,40
1774069,1351411,2023-08-14,Assembly,"Be adopted. To third reading",12,0,0,1,13
1774069,1353459,2023-09-07,Senate,"Special Consent ACR106 Pellerin et al",40,0,0,0,40
1774070,1352252,2023-08-24,Senate,"Senate 3rd Reading SR45 Min",40,0,0,0,40
1774255,1351318,2023-08-14,Assembly,"Be adopted. To Consent Calendar",12,0,0,1,13
1774255,1351653,2023-08-17,Assembly,"ACR 107 Aguiar-Curry Consent Calendar Second Day",75,0,0,5,80
1774255,1353514,2023-09-07,Senate,"Special Consent ACR107 Aguiar-Curry et al",40,0,0,0,40
1774256,1353446,2023-09-07,Senate,"Senate 3rd Reading SR46 Lim√≥n",38,0,0,2,40
1774386,1352121,2023-08-23,Assembly,"Be adopted and re-referred to the Committee on [Appropriations]",5,2,0,1,8
1774386,1352686,2023-09-01,Assembly,"Be adopted as amended",9,4,0,3,16
1774386,1353303,2023-09-06,Assembly,"ACA 13 Ward Assembly Third Reading",57,19,0,4,80
1774386,1353918,2023-09-11,Senate,"Be adopted as amended, but first amend, and re-refer to the Committee on [Appropriations]",6,1,0,0,7
1774386,1353919,2023-09-12,Senate,"Be adopted",5,2,0,0,7
1774386,1354566,2023-09-14,Senate,"Assembly 3rd Reading ACA13 Ward et al. Glazer",28,9,0,3,40
1774386,1354567,2023-09-14,Assembly,"ACA 13 Ward Concurrence in Senate Amendments",55,19,0,6,80
1774387,1351390,2023-08-14,Assembly,"Be adopted. To third reading",12,0,0,1,13
1774387,1395211,2024-02-26,Senate,"Special Consent ACR108 Davies et al",37,0,0,3,40
1774388,1351505,2023-08-14,Assembly,"Be adopted. To third reading",12,0,0,1,13
1774388,1353498,2023-09-07,Senate,"Special Consent ACR109 Reyes et al",40,0,0,0,40
1774389,1351249,2023-08-14,Assembly,"Be adopted. To Consent Calendar",12,0,0,1,13
1774389,1351649,2023-08-17,Assembly,"HR 50 Soria Consent Calendar Second Day Regular Session",75,0,0,5,80
1774391,1352468,2023-08-31,Assembly,"Be adopted. To third reading",10,0,0,3,13
1774392,1352793,2023-09-01,Senate,"Special Consent SCR83 Menjivar",37,0,0,3,40
1774393,1352323,2023-08-28,Senate,"Senate 3rd Reading SCR84 Alvarado-Gil",39,0,0,1,40
1774393,1352472,2023-08-31,Assembly,"Be adopted. To Consent Calendar",10,0,0,3,13
1774393,1353185,2023-09-05,Assembly,"SCR 84 Alvarado-Gil Consent Calendar Second Day Regular Session",79,0,0,1,80
1776203,1351690,2023-08-17,Assembly,"Be adopted. To third reading",10,0,0,3,13
1776203,1395220,2024-02-26,Senate,"Special Consent ACR110 Quirk-Silva et al",37,0,0,3,40
1776204,1351685,2023-08-17,Assembly,"Be adopted. To Consent Calendar",10,0,0,3,13
1776204,1352215,2023-08-24,Assembly,"ACR 111 Papan Consent Calendar Second Day",73,0,0,7,80
1776204,1353468,2023-09-07,Senate,"Special Consent ACR111 Papan et al",40,0,0,0,40
1776205,1351670,2023-08-17,Assembly,"Be adopted. To third reading",10,0,0,3,13
1776205,1353358,2023-09-07,Senate,"Special Consent ACR112 Rodriguez et al",40,0,0,0,40
1776206,1351659,2023-08-17,Assembly,"Be adopted. To Consent Calendar",10,0,0,3,13
1776206,1352232,2023-08-24,Assembly,"HR 53 Quirk-Silva Consent Calendar Second Day Regular Session",73,0,0,7,80
1776207,1351689,2023-08-17,Assembly,"Be adopted. To Consent Calendar",10,0,0,3,13
1776207,1352238,2023-08-24,Assembly,"HR 54 Vince Fong Consent Calendar Second Day Regular Session",73,0,0,7,80
1776208,1351655,2023-08-17,Assembly,"Be adopted. To third reading",10,0,0,3,13
1776209,1352350,2023-08-28,Senate,"Senate 3rd Reading SCR85 Niello",37,0,0,3,40
1776209,1352477,2023-08-31,Assembly,"Be adopted. To Consent Calendar",10,0,0,3,13
1776209,1353149,2023-09-05,Assembly,"SCR 85 Niello Consent Calendar Second Day Regular Session",79,0,0,1,80
1776210,1351693,2023-08-17,Senate,"Senate 3rd Reading SCR86 Ochoa Bogh et al",38,0,0,2,40
1776210,1352217,2023-08-24,Assembly,"Be adopted. To Consent Calendar",11,0,0,2,13
1776210,1352462,2023-08-31,Assembly,"SCR 86 Ochoa Bogh Consent Calendar Second Day Regular Session",79,0,0,1,80
1776211,1352372,2023-08-29,Senate,"Be adopted. Ordered to third reading",3,1,0,1,5
1776211,1353300,2023-09-06,Senate,"Senate 3rd Reading SJR7 Wahab et al",24,11,0,5,40
1776211,1354213,2023-09-13,Assembly,"Be adopted. To third reading",5,2,0,1,8
1776211,1354841,2023-09-14,Assembly,"SJR 7 Wahab Senate Third Reading By Jones-Sawyer",53,17,0,10,80
1776212,1352328,2023-08-28,Senate,"Senate 3rd Reading SR47 Bradford",38,0,0,2,40
1776223,1353377,2023-09-07,Senate,"Senate 3rd Reading SCR88 Ochoa Bogh",40,0,0,0,40
1776223,1389465,2024-02-20,Assembly,"Be adopted. To Consent Calendar",7,0,0,4,11
1776223,1392719,2024-02-22,Assembly,"SCR 88 Ochoa Bogh Consent Calendar Second Day Regular Session",70,0,0,10,80
1776224,1352878,2023-09-01,Senate,"Special Consent SCR89 Dodd et al",37,0,0,3,40
1776224,1389457,2024-02-20,Assembly,"Be adopted. To Consent Calendar",7,0,0,4,11
1776224,1392727,2024-02-22,Assembly,"SCR 89 Dodd Consent Calendar Second Day Regular Session",70,0,0,10,80
1776225,1352967,2023-09-01,Senate,"Special Consent SR48 Durazo",37,0,0,3,40
1776410,1352570,2023-09-01,Senate,"Special Consent SCR90 Rubio et al",37,0,0,3,40
1776410,1389475,2024-02-20,Assembly,"Be adopted. To Consent Calendar",7,0,0,4,11
1776410,1392720,2024-02-22,Assembly,"SCR 90 Rubio Consent Calendar Second Day Regular Session",70,0,0,10,80
1776827,1352255,2023-08-24,Assembly,"Be adopted. To third reading",11,0,0,2,13
1776827,1395216,2024-02-26,Senate,"Special Consent ACR114 Luz Rivas et al",37,0,0,3,40
1776828,1352542,2023-09-01,Senate,"Special Consent SCR91 Ashby et al",37,0,0,3,40
1776828,1395252,2024-02-26,Assembly,"Be adopted. To Consent Calendar",7,0,0,4,11
1776828,1400014,2024-02-29,Assembly,"SCR 91 Ashby Consent Calendar Second Day Regular Session",73,0,0,7,80
1776882,1353398,2023-09-07,Senate,"Senate 3rd Reading SCR92 Nguyen et al",40,0,0,0,40
1776943,1352461,2023-08-31,Assembly,"Be adopted. To Consent Calendar",10,0,0,3,13
1776943,1353146,2023-09-05,Assembly,"ACR 115 Waldron Consent Calendar Second Day",79,0,0,1,80
1776943,1395230,2024-02-26,Senate,"Special Consent ACR115 Waldron et al",37,0,0,3,40
1776944,1363965,2024-01-10,Assembly,"Be adopted. To third reading",6,1,0,1,8
1776944,1372101,2024-01-30,Assembly,"AJR 9 McKinnor Assembly Third Reading",66,0,0,14,80
1776944,1453477,2024-06-04,Senate,"Be adopted, but first be re-referred to the Committee on [Appropriations]",7,2,0,1,10
1776944,1464075,2024-08-15,Senate,"Assembly 3rd Reading AJR9 McKinnor et al. By Wiener",28,8,0,4,40
1776945,1352501,2023-09-01,Senate,"Special Consent SR49 McGuire et al",37,0,0,3,40
1776965,1423827,2024-04-09,Assembly,"Be adopted. To Consent Calendar",16,0,0,0,16
1776965,1427355,2024-04-15,Assembly,"AJR 10 Irwin Assembly Third Reading",75,0,0,5,80
1776965,1451593,2024-05-29,Senate,"Be adopted. Ordered to third reading",11,0,0,0,11
1776965,1461268,2024-06-27,Senate,"Special Consent AJR10 Irwin et al. By Rubio",40,0,0,0,40
1776965,1462058,2024-07-01,Assembly,"AJR 10 Irwin Concurrence in Senate Amendments",72,0,0,7,79
1776966,1352458,2023-08-31,Assembly,"Be adopted. To Consent Calendar",10,0,0,3,13
1776966,1353184,2023-09-05,Assembly,"HR 56 Rodriguez Consent Calendar Second Day Regular Session",79,0,0,1,80
1777097,1352456,2023-08-31,Assembly,"Be adopted. To third reading",10,0,0,3,13
1777368,1432944,2024-04-23,Assembly,"Be adopted. To Consent Calendar",16,0,0,0,16
1777368,1436167,2024-04-29,Assembly,"HR 58 Jackson Consent Calendar Second Day Regular Session",74,0,0,6,80
1777520,1363475,2024-01-04,Assembly,"Be adopted. To third reading",10,0,0,0,10
1777520,1395214,2024-02-26,Senate,"Special Consent ACR116 Wilson et al",37,0,0,3,40
1777578,1464011,2024-08-15,Assembly,"Be adopted. To Consent Calendar",7,0,0,4,11
1777578,1465475,2024-08-22,Assembly,"HR 59 McKinnor Consent Calendar Second Day",57,0,0,22,79
1777761,1408828,2024-03-13,Assembly,"Be adopted and re-referred to the Committee on [Appropriations]",5,0,0,2,7
1777761,1444340,2024-05-16,Assembly,"Be adopted",11,4,0,0,15
1777761,1449556,2024-05-23,Assembly,"ACA 14 Ortega Assembly Third Reading",57,9,0,14,80
1796673,1424953,2024-04-09,Assembly,"Do pass and be re-referred to the Committee on [Appropriations] with recommendation: To Consent Calendar",8,0,0,0,8
1796675,1422048,2024-04-08,Assembly,"Do pass and be re-referred to the Committee on [Appropriations] with recommendation: To Consent Calendar",15,0,0,0,15
1796675,1434110,2024-04-24,Assembly,"Do pass. To Consent Calendar",14,0,0,1,15
1796675,1438525,2024-05-02,Assembly,"AB 1774 Dixon Consent Calendar Second Day Regular Session",73,0,0,7,80
1796675,1451602,2024-05-28,Senate,"Do pass, but first be re-referred to the Committee on [Appropriations] with the recommendation: To Consent Calendar",12,0,0,3,15
1796675,1457323,2024-06-13,Senate,"Consent Calendar 2nd AB1774 Dixon et al",37,0,0,3,40
1796676,1419193,2024-04-02,Assembly,"Do pass as amended and be re-referred to the Committee on [Governmental Organization]",14,2,0,2,18
1796676,1430095,2024-04-17,Assembly,"Do pass",13,2,0,7,22
1796676,1445259,2024-05-20,Assembly,"AB 1775 Haney Assembly Third Reading",58,6,0,16,80
1796676,1455781,2024-06-10,Senate,"Do pass",9,2,0,2,13
1796676,1465862,2024-08-27,Senate,"Assembly 3rd Reading AB1775 Haney et al. By Allen",30,7,0,3,40
1796676,1466676,2024-08-28,Assembly,"AB 1775 Haney Concurrence in Senate Amendments",63,5,0,11,79
1796678,1431976,2024-04-22,Assembly,"Do pass and be re-referred to the Committee on [Appropriations]",15,0,0,0,15
1796678,1444570,2024-05-16,Assembly,"Do pass as amended",11,0,0,4,15
1796678,1446093,2024-05-21,Assembly,"AB 1777 Ting Assembly Third Reading",72,0,0,8,80
1796678,1460508,2024-06-25,Senate,"Do pass as amended, but first amend, and re-refer to the Committee on [Appropriations]",15,0,0,0,15
1796678,1463849,2024-08-12,Senate,"Do pass",7,0,0,0,7
1796678,1466485,2024-08-30,Senate,"Assembly 3rd Reading AB1777 Ting et al. By Becker",23,9,0,8,40
1796678,1467027,2024-08-31,Assembly,"AB 1777 Ting Concurrence in Senate Amendments",41,1,0,37,79
1796679,1422094,2024-04-08,Assembly,"Do pass",13,0,0,2,15
1796679,1436157,2024-04-29,Assembly,"AB 1778 Connolly Assembly Third Reading",72,0,0,8,80
1796679,1451583,2024-05-28,Senate,"Do pass as amended",12,0,0,3,15
1796679,1465325,2024-08-20,Senate,"Assembly 3rd Reading AB1778 Connolly By Dodd",39,0,0,1,40
1796679,1465507,2024-08-22,Assembly,"AB 1778 Connolly Concurrence in Senate Amendments",59,0,0,20,79
1796680,1424820,2024-04-09,Assembly,"Do pass",8,0,0,0,8
1796680,1448670,2024-05-22,Assembly,"AB 1779 Irwin Assembly Third Reading",71,0,0,9,80
1796680,1456444,2024-06-11,Senate,"Do pass, but first be re-referred to the Committee on [Appropriations]",4,0,0,1,5
1796680,1457956,2024-06-17,Senate,"Do pass as amended",5,0,0,2,7
1796680,1463773,2024-08-08,Senate,"Assembly 3rd Reading AB1779 Irwin et al. By Newman",38,0,0,2,40
1796680,1463847,2024-08-12,Assembly,"AB 1779 Irwin Concurrence in Senate Amendments",71,1,0,7,79
1796681,1430082,2024-04-16,Assembly,"Do pass as amended and be re-referred to the Committee on [Appropriations]",8,0,0,3,11
1796681,1444601,2024-05-16,Assembly,"Do pass",11,0,0,4,15
1796681,1446088,2024-05-21,Assembly,"AB 1780 Ting Assembly Third Reading",55,0,0,25,80
1796681,1458513,2024-06-19,Senate,"Do pass as amended, but first amend, and re-refer to the Committee on [Judiciary]",4,0,0,3,7
1796681,1463632,2024-08-05,Senate,"Placed on suspense file",7,0,0,0,7
1796681,1464562,2024-08-15,Senate,"Do pass as amended",5,2,0,0,7
1796681,1465857,2024-08-27,Senate,"Assembly 3rd Reading AB1780 Ting et al. By Lim√≥n",26,5,0,9,40
1796681,1466741,2024-08-28,Assembly,"AB 1780 Ting Concurrence in Senate Amendments",62,0,0,17,79
1796683,1412592,2024-03-20,Assembly,"Do pass and be re-referred to the Committee on [Local Government] with recommendation: To Consent Calendar",9,0,0,0,9
1796683,1425902,2024-04-10,Assembly,"Do pass and be re-referred to the Committee on [Appropriations] with recommendation: To Consent Calendar",9,0,0,0,9
1796683,1430023,2024-04-17,Assembly,"Do pass. To Consent Calendar",15,0,0,0,15
1796683,1435195,2024-04-25,Assembly,"AB 1782 Ta Consent Calendar Second Day Regular Session",75,0,0,5,80
1796683,1453451,2024-06-04,Senate,"Do pass, but first be re-referred to the Committee on [Appropriations] with the recommendation: To Consent Calendar",9,0,0,1,10
1796683,1458838,2024-06-20,Senate,"Consent Calendar 2nd AB1782 Ta",36,0,0,4,40
1796683,1459337,2024-06-24,Assembly,"AB 1782 Ta Concurrence in Senate Amendments",74,0,0,5,79
1796685,1424964,2024-04-10,Assembly,"Do pass as amended, and be re-referred to the Committee on [Appropriations] with recommendation: To Consent Calendar",8,0,0,0,8
1796685,1437599,2024-05-01,Assembly,"Do pass. To Consent Calendar",14,0,0,1,15
1796685,1441981,2024-05-09,Assembly,"AB 1784 Pellerin Consent Calendar Second Day Regular Session",65,0,0,15,80
1796685,1462213,2024-07-02,Senate,"Do pass, but first be re-referred to the Committee on [Appropriations]",7,0,0,0,7
1796685,1465379,2024-08-20,Senate,"Assembly 3rd Reading AB1784 Pellerin et al. By Blakespear",40,0,0,0,40
1796685,1465459,2024-08-22,Assembly,"AB 1784 Pellerin Concurrence in Senate Amendments",62,0,0,17,79
1796686,1419224,2024-04-02,Assembly,"Do pass as amended, and be re-referred to the Committee on [Appropriations] with recommendation: To Consent Calendar",12,0,0,0,12
1796686,1429997,2024-04-17,Assembly,"Do pass. To Consent Calendar",15,0,0,0,15
1796686,1435203,2024-04-25,Assembly,"AB 1785 Pacheco Consent Calendar Second Day Regular Session",75,0,0,5,80
1796686,1456357,2024-06-11,Senate,"Do pass, but first be re-referred to the Committee on [Appropriations] with the recommendation: To Consent Calendar",11,0,0,0,11
1796686,1465624,2024-08-26,Senate,"Assembly 3rd Reading AB1785 Pacheco By Umberg",40,0,0,0,40
1796686,1465884,2024-08-27,Assembly,"AB 1785 Pacheco Concurrence in Senate Amendments",77,0,0,2,79
1796687,1423796,2024-04-08,Assembly,"Do pass and be re-referred to the Committee on [Human Services]",6,0,0,2,8
1796687,1432930,2024-04-23,Assembly,"Do pass and be re-referred to the Committee on [Appropriations]",5,0,0,2,7
1796689,1427218,2024-04-15,Assembly,"Be adopted. To third reading",7,0,0,4,11
1796689,1449575,2024-05-23,Senate,"Special Consent ACR118 Ta et al. By Umberg",37,0,0,3,40
1796691,1423782,2024-04-09,Senate,"Do pass as amended, but first amend, and re-refer to the Committee on [Judiciary]",14,0,0,2,16
1796691,1428945,2024-04-16,Senate,"Do pass, but first be re-referred to the Committee on [Appropriations] with the recommendation: To Consent Calendar",11,0,0,0,11
1796691,1436246,2024-04-29,Senate,"Placed on suspense file",5,0,0,2,7
1796691,1443964,2024-05-16,Senate,"Do pass",7,0,0,0,7
1796691,1449668,2024-05-23,Senate,"Special Consent SB892 Padilla",37,0,0,3,40
1796691,1462612,2024-07-02,Assembly,"Do pass as amended and be re-referred to the Committee on [Appropriations]",8,0,0,3,11
1796691,1464580,2024-08-15,Assembly,"Do pass as amended",12,0,0,3,15
1796691,1466960,2024-08-28,Assembly,"SB 892 Padilla Senate Third Reading By Irwin",75,0,0,4,79
1796691,1466961,2024-08-31,Senate,"Unfinished Business SB892 Padilla et al. Concurrence",40,0,0,0,40
1796692,1423896,2024-04-09,Senate,"Do pass, but first be re-referred to the Committee on [Judiciary]",14,0,0,2,16
1796692,1428860,2024-04-16,Senate,"Do pass, but first be re-referred to the Committee on [Appropriations] with the recommendation: To Consent Calendar",11,0,0,0,11
1796692,1436215,2024-04-29,Senate,"Placed on suspense file",5,0,0,2,7
1796692,1444063,2024-05-16,Senate,"Do pass",7,0,0,0,7
1796692,1449703,2024-05-23,Senate,"Special Consent SB893 Padilla et al",37,0,0,3,40
1796692,1462533,2024-07-02,Assembly,"Do pass as amended and be re-referred to the Committee on [Appropriations]",11,0,0,0,11
1796694,1434112,2024-04-24,Senate,"Do pass as amended, but first amend, and re-refer to the Committee on [Appropriations]",7,0,0,0,7
1796694,1442649,2024-05-13,Senate,"Placed on suspense file",7,0,0,0,7
1796694,1443897,2024-05-16,Senate,"Do pass as amended",7,0,0,0,7
1796694,1448697,2024-05-22,Senate,"Senate 3rd Reading SB895 Roth et al",38,0,0,2,40
1796694,1462365,2024-07-02,Assembly,"Do pass and be re-referred to the Committee on [Appropriations]",9,1,0,1,11
1796694,1464150,2024-08-15,Assembly,"Do pass as amended",11,0,0,4,15
1796694,1466349,2024-08-29,Senate,"Unfinished Business SB895 Roth et al. Concurrence",40,0,0,0,40
1796694,1466899,2024-08-28,Assembly,"SB 895 Roth Senate Third Reading By Reyes",72,2,0,5,79
1796695,1423818,2024-04-09,Senate,"Do pass as amended, but first amend, and re-refer to the Committee on [Judiciary]",14,0,0,2,16
1796695,1428776,2024-04-16,Senate,"Do pass, but first be re-referred to the Committee on [Appropriations] with the recommendation: To Consent Calendar",11,0,0,0,11
1796695,1436247,2024-04-29,Senate,"Placed on suspense file",5,0,0,2,7
1796695,1444350,2024-05-16,Senate,"Do pass as amended",7,0,0,0,7
1796695,1450038,2024-05-24,Senate,"Special Consent SB896 Dodd et al",38,0,0,2,40
1796695,1462665,2024-07-02,Assembly,"Do pass as amended, and be re-referred to the Committee on [Appropriations] with recommendation: To Consent Calendar",11,0,0,0,11
1796695,1464183,2024-08-15,Assembly,"Do pass as amended",11,0,0,4,15
1796695,1465637,2024-08-26,Assembly,"SB 896 Dodd Senate Third Reading By Low",76,0,0,3,79
1796695,1466939,2024-08-28,Senate,"Special Consent SB896 Dodd et al",39,0,0,1,40
1796696,1412553,2024-03-20,Senate,"Do pass, but first be re-referred to the Committee on [Appropriations]",7,0,0,0,7
1796696,1422056,2024-04-08,Senate,"Placed on suspense file",6,0,0,1,7
1796696,1444089,2024-05-16,Senate,"Do pass as amended",7,0,0,0,7
1796696,1448752,2024-05-22,Senate,"Senate 3rd Reading SB897 Newman et al",38,0,0,2,40
1796696,1460452,2024-06-26,Assembly,"Do pass as amended and be re-referred to the Committee on [Appropriations]",6,0,0,1,7
1796696,1464098,2024-08-15,Assembly,"Do pass as amended",11,0,0,4,15
1796696,1466128,2024-08-29,Senate,"Unfinished Business SB897 Newman et al. Concurrence",40,0,0,0,40
1796696,1466717,2024-08-28,Assembly,"SB 897 Newman Senate Third Reading By Irwin",76,0,0,3,79
1796697,1434265,2024-04-23,Senate,"Do pass, but first be re-referred to the Committee on [Appropriations]",9,4,0,2,15
1796697,1450355,2024-05-21,Senate,"Senate 3rd Reading SB898 Skinner",26,9,0,5,40
1796697,1462572,2024-07-02,Assembly,"Do pass and be re-referred to the Committee on [Appropriations]",6,1,0,1,8
1796697,1464100,2024-08-15,Assembly,"Do pass as amended",11,3,0,1,15
1796698,1408250,2024-03-12,Senate,"Do pass, but first be re-referred to the Committee on [Judiciary]",5,0,0,0,5
1796698,1428891,2024-04-16,Senate,"Do pass, but first be re-referred to the Committee on [Appropriations] with the recommendation: To Consent Calendar",11,0,0,0,11
1796698,1442574,2024-05-13,Senate,"Placed on suspense file",7,0,0,0,7
1796698,1444330,2024-05-16,Senate,"Do pass as amended",7,0,0,0,7
1796698,1450000,2024-05-24,Senate,"Special Consent SB899 Skinner et al",38,0,0,2,40
1796698,1458318,2024-06-18,Assembly,"Do pass and be re-referred to the Committee on [Judiciary] with recommendation: To Consent Calendar",7,0,0,1,8
1796698,1460027,2024-06-25,Assembly,"Do pass and be re-referred to the Committee on [Appropriations] with recommendation: To Consent Calendar",11,0,0,1,12
1796698,1464051,2024-08-15,Assembly,"Do pass as amended",11,0,0,4,15
1796698,1466488,2024-08-30,Senate,"Special Consent SB899 Skinner et al",40,0,0,0,40
1796698,1466973,2024-08-28,Assembly,"SB 899 Skinner Senate Third Reading By Petrie-Norris",76,0,0,3,79
1796699,1420047,2024-04-02,Senate,"Do pass, but first be re-referred to the Committee on [Judiciary]",8,2,0,0,10
1796699,1437579,2024-04-30,Senate,"Do pass",11,0,0,0,11
1796699,1445149,2024-05-20,Senate,"Senate 3rd Reading SB900 Umberg",39,0,0,1,40
1796699,1458559,2024-06-19,Assembly,"Do pass and be re-referred to the Committee on [Judiciary]",8,0,0,1,9
1796699,1460051,2024-06-25,Assembly,"Do pass as amended",11,0,0,1,12
1796699,1465672,2024-08-26,Assembly,"SB 900 Umberg Senate Third Reading By Valencia",74,0,0,5,79
1796699,1467060,2024-08-28,Senate,"Unfinished Business SB900 Umberg Concurrence",39,0,0,1,40
1796700,1423902,2024-04-08,Senate,"Do pass as amended, but first amend, and re-refer to the Committee on [Judiciary]",5,0,0,0,5
1796700,1434124,2024-04-23,Senate,"Do pass, but first be re-referred to the Committee on [Appropriations] with the recommendation: To Consent Calendar",11,0,0,0,11
1796700,1444652,2024-05-16,Senate,"Consent Calendar 2nd SB901 Umberg",38,0,0,2,40
1796700,1455771,2024-06-10,Assembly,"Amendments (Committee's)",9,0,0,1,10
1796700,1455772,2024-06-10,Assembly,"Do pass as amended and be re-referred to the Committee on [Judiciary]",9,0,0,1,10
1796700,1458279,2024-06-18,Assembly,"Do pass and be re-referred to the Committee on [Appropriations]",11,0,0,1,12
1796700,1462347,2024-07-02,Assembly,"Do pass",12,0,0,3,15
1796700,1465436,2024-08-22,Assembly,"SB 901 Umberg Senate Third Reading By Jackson",54,0,0,25,79
1796700,1466163,2024-08-29,Senate,"Unfinished Business SB901 Umberg Concurrence",33,0,0,7,40
1796701,1419209,2024-04-02,Senate,"Do pass as amended, but first amend, and re-refer to the Committee on [Appropriations]",5,0,0,0,5
1796701,1442553,2024-05-13,Senate,"Placed on suspense file",7,0,0,0,7
1796701,1444292,2024-05-16,Senate,"Do pass",6,1,0,0,7
1796701,1450272,2024-05-21,Senate,"Senate 3rd Reading SB902 Roth et al",36,1,0,3,40
1796701,1458206,2024-06-18,Assembly,"Do pass and be re-referred to the Committee on [Appropriations]",7,0,0,1,8
1796701,1464310,2024-08-15,Assembly,"Do pass as amended",11,0,0,4,15
1796701,1466122,2024-08-29,Senate,"Unfinished Business SB902 Roth et al. Concurrence",37,3,0,0,40
1796701,1466670,2024-08-28,Assembly,"SB 902 Roth Senate Third Reading By Gabriel",76,0,0,3,79
1796702,1367514,2024-01-22,Senate,"Senate 3rd Reading SCR94 Dodd et al",39,0,0,1,40
1796702,1371121,2024-01-29,Assembly,"Be adopted. To Consent Calendar",8,0,0,3,11
1796702,1374196,2024-02-01,Assembly,"SCR 94 Dodd Consent Calendar Second Day Regular Session",67,0,0,13,80
1796703,1364240,2024-01-12,Senate,"Senate 3rd Reading SCR95 Bradford et al",35,0,0,5,40
1796703,1395225,2024-02-26,Assembly,"Be adopted. To Consent Calendar",7,0,0,4,11
1796703,1400007,2024-02-29,Assembly,"SCR 95 Bradford Consent Calendar Second Day Regular Session",73,0,0,7,80
1796704,1364793,2024-01-16,Senate,"Senate 3rd Reading SR51 Min",36,0,0,4,40
1798413,1408221,2024-03-12,Assembly,"Do pass and be re-referred to the Committee on [Privacy and Consumer Protection] with recommendation: To Consent Calendar",8,0,0,0,8
1798413,1429901,2024-04-16,Assembly,"Do pass as amended and be re-referred to the Committee on [Appropriations]",11,0,0,0,11
1798413,1437619,2024-05-01,Assembly,"Do pass. To Consent Calendar",14,0,0,1,15
1798413,1441940,2024-05-09,Assembly,"AB 1788 Quirk-Silva Consent Calendar Second Day Regular Session",65,0,0,15,80
1798413,1453394,2024-06-04,Senate,"Do pass as amended, but first amend, and re-refer to the Committee on [Judiciary]",5,0,0,0,5
1798413,1458201,2024-06-18,Senate,"Do pass as amended, but first amend, and re-refer to the Committee on [Appropriations] with the recommendation: To Consent Calendar",10,0,0,1,11
1798413,1462092,2024-07-01,Senate,"Placed on suspense file",7,0,0,0,7
1798413,1464045,2024-08-15,Senate,"Do pass as amended",7,0,0,0,7
1798413,1465793,2024-08-27,Senate,"Assembly 3rd Reading AB1788 Quirk-Silva et al. By Roth",40,0,0,0,40
1798413,1466724,2024-08-28,Assembly,"AB 1788 Quirk-Silva Concurrence in Senate Amendments",76,0,0,3,79
1798414,1424863,2024-04-10,Assembly,"Do pass and be re-referred to the Committee on [Appropriations]",8,0,0,1,9
1798414,1444480,2024-05-16,Assembly,"Do pass",15,0,0,0,15
1798414,1445935,2024-05-21,Assembly,"AB 1789 Quirk-Silva Assembly Third Reading",73,0,0,7,80
1798414,1458412,2024-06-18,Senate,"Do pass, but first be re-referred to the Committee on [Appropriations]",10,0,0,0,10
1798414,1462035,2024-07-01,Senate,"Placed on suspense file",7,0,0,0,7
1798415,1430043,2024-04-16,Assembly,"Do pass as amended and be re-referred to the Committee on [Appropriations]",11,0,0,0,11
1798415,1441332,2024-05-08,Assembly,"Do pass. To Consent Calendar",15,0,0,0,15
1798415,1444447,2024-05-16,Assembly,"AB 1790 Connolly Consent Calendar Second Day",71,0,0,9,80
1798415,1456875,2024-06-12,Senate,"Do pass, but first be re-referred to the Committee on [Appropriations] with the recommendation: To Consent Calendar",7,0,0,0,7
1798415,1461266,2024-06-27,Senate,"Consent Calendar 2nd AB1790 Connolly et al",40,0,0,0,40
1798416,1436931,2024-04-30,Assembly,"Do pass as amended",7,1,0,3,11
1798416,1446001,2024-05-21,Assembly,"AB 1791 Weber Assembly Third Reading",50,10,0,20,80
1798416,1458314,2024-06-18,Senate,"Do pass as amended, but first amend, and re-refer to the Committee on [Appropriations]",7,2,0,2,11
1798416,1462042,2024-07-01,Senate,"Placed on suspense file",7,0,0,0,7
1798417,1423751,2024-04-08,Assembly,"Do pass and be re-referred to the Committee on [Appropriations] with recommendation: To Consent Calendar",7,0,0,1,8
1798417,1444375,2024-05-16,Assembly,"Do pass",15,0,0,0,15
1798417,1446035,2024-05-21,Assembly,"AB 1792 Rodriguez Assembly Third Reading",73,0,0,7,80
1798417,1454188,2024-06-05,Senate,"Do pass, but first be re-referred to the Committee on [Appropriations] with the recommendation: To Consent Calendar",11,0,0,0,11
1798417,1457989,2024-06-17,Senate,"Placed on suspense file",7,0,0,0,7
1798417,1464174,2024-08-15,Senate,"Do pass",7,0,0,0,7
1798418,1408215,2024-03-12,Assembly,"Do pass and be re-referred to the Committee on [Military and Veterans Affairs] with recommendation: To Consent Calendar",10,0,0,1,11
1798418,1424851,2024-04-09,Assembly,"Do pass and be re-referred to the Committee on [Appropriations]",10,0,0,0,10
1798418,1444518,2024-05-16,Assembly,"Do pass",15,0,0,0,15
1798418,1449632,2024-05-23,Assembly,"AB 1793 Ta Assembly Third Reading",66,0,0,14,80
1798418,1458507,2024-06-19,Senate,"Do pass, but first be re-referred to the Committee on [Military and Veterans Affairs]",7,0,0,0,7
1798418,1459978,2024-06-24,Senate,"Do pass, but first be re-referred to the Committee on [Appropriations]",5,0,0,0,5
1798418,1463633,2024-08-05,Senate,"Placed on suspense file",7,0,0,0,7
1798419,1424922,2024-04-09,Assembly,"Do pass as amended and be re-referred to the Committee on [Appropriations]",8,0,0,0,8
1798419,1444080,2024-05-16,Assembly,"Do pass",15,0,0,0,15
1798419,1448748,2024-05-22,Assembly,"AB 1794 McCarty Assembly Third Reading",69,0,0,11,80
1798419,1456403,2024-06-11,Senate,"Do pass, but first be re-referred to the Committee on [Appropriations]",4,0,0,1,5
1798419,1463620,2024-08-05,Senate,"Placed on suspense file",7,0,0,0,7
1798421,1412535,2024-03-20,Assembly,"Do pass as amended, and be re-referred to the Committee on [Appropriations] with recommendation: To Consent Calendar",7,0,0,0,7
1798421,1424982,2024-04-10,Assembly,"Do pass. To Consent Calendar",14,0,0,1,15
1798421,1431063,2024-04-18,Assembly,"AB 1796 Alanis Consent Calendar Second Day Regular Session",72,0,0,8,80
1798421,1451562,2024-05-29,Senate,"Do pass, but first be re-referred to the Committee on [Appropriations] with the recommendation: To Consent Calendar",7,0,0,0,7
1798421,1457330,2024-06-13,Senate,"Consent Calendar 2nd AB1796 Alanis et al",37,0,0,3,40
1798421,1462574,2024-07-03,Assembly,"AB 1796 Alanis Concurrence in Senate Amendments",70,0,0,9,79
1798422,1411406,2024-03-19,Assembly,"Do pass. To Consent Calendar",13,0,0,2,15
1798422,1438466,2024-04-01,Assembly,"AB 1797 Wood Consent Calendar Second Day Regular Session",72,0,0,8,80
1798422,1450938,2024-05-28,Senate,"Do pass",11,0,0,5,16
1798422,1465255,2024-08-19,Senate,"Assembly 3rd Reading AB1797 Wood et al. By Laird",40,0,0,0,40
1798422,1465445,2024-08-22,Assembly,"AB 1797 Wood Concurrence in Senate Amendments",61,0,0,18,79
1798423,1420097,2024-04-03,Senate,"Do pass, but first be re-referred to the Committee on [Judiciary]",4,2,0,1,7
1798423,1436213,2024-04-29,Senate,"Placed on suspense file",5,0,0,2,7
1798424,1424805,2024-04-09,Senate,"Do pass, but first be re-referred to the Committee on [Elections and Constitutional Amendments]",11,4,0,0,15
1798424,1428978,2024-04-16,Senate,"Do pass, but first be re-referred to the Committee on [Appropriations]",6,1,0,0,7
1798424,1450385,2024-05-21,Senate,"Senate 3rd Reading SB904 Dodd et al",29,8,0,3,40
1798424,1458167,2024-06-17,Assembly,"Do pass and be re-referred to the Committee on [Elections]",11,3,0,1,15
1798424,1460543,2024-06-26,Assembly,"Do pass and be re-referred to the Committee on [Appropriations]",6,2,0,0,8
1798424,1464333,2024-08-15,Assembly,"Do pass as amended",11,3,0,1,15
1798424,1465602,2024-08-26,Assembly,"SB 904 Dodd Senate Third Reading By Connolly",56,15,0,8,79
1798424,1465823,2024-08-27,Senate,"Unfinished Business SB904 Dodd et al. Concurrence",31,9,0,0,40
1798425,1419203,2024-04-02,Senate,"Do pass as amended, but first amend, and re-refer to the Committee on [Appropriations]",5,0,0,0,5
1798425,1439669,2024-05-06,Senate,"Placed on suspense file",7,0,0,0,7
1798425,1444341,2024-05-16,Senate,"Do pass as amended",7,0,0,0,7
1798425,1448743,2024-05-22,Senate,"Senate 3rd Reading SB905 Wiener et al",38,0,0,2,40
1798425,1456293,2024-06-11,Assembly,"Do pass and be re-referred to the Committee on [Appropriations]",8,0,0,0,8
1798425,1458401,2024-06-19,Assembly,"Do pass as amended",9,4,0,2,15
1798425,1463769,2024-08-08,Assembly,"SB 905 Wiener Senate Third Reading By Zbur",64,2,0,13,79
1798425,1463872,2024-08-12,Senate,"Unfinished Business SB905 Wiener et al. Concurrence",37,0,0,3,40
1798426,1412598,2024-03-20,Senate,"Do pass as amended, but first amend, and re-refer to the Committee on [Judiciary]",6,0,0,1,7
1798426,1428807,2024-04-16,Senate,"Do pass as amended, but first amend, and re-refer to the Committee on [Appropriations]",11,0,0,0,11
1798426,1439653,2024-05-06,Senate,"Placed on suspense file",7,0,0,0,7
1798426,1444537,2024-05-16,Senate,"Do pass",7,0,0,0,7
1798426,1449710,2024-05-23,Senate,"Special Consent SB906 Skinner",37,0,0,3,40
1798426,1458280,2024-06-18,Assembly,"Do pass and be re-referred to the Committee on [Arts, Entertainment, Sports, and Tourism]",8,0,0,3,11
1798426,1462207,2024-07-02,Assembly,"Do pass and be re-referred to the Committee on [Appropriations]",7,0,0,0,7
1798426,1464119,2024-08-15,Assembly,"Do pass",14,0,0,1,15
1798426,1465607,2024-08-26,Assembly,"SB 906 Skinner Senate Third Reading By Friedman",76,0,0,3,79
1798426,1467006,2024-08-28,Senate,"Special Consent SB906 Skinner et al",39,0,0,1,40
1798427,1412533,2024-03-20,Senate,"Do pass, but first be re-referred to the Committee on [Elections and Constitutional Amendments]",5,2,0,0,7
1798427,1428815,2024-04-16,Senate,"Do pass, but first be re-referred to the Committee on [Appropriations]",5,1,0,1,7
1798427,1436166,2024-04-29,Senate,"Placed on suspense file",5,0,0,2,7
1798427,1444177,2024-05-16,Senate,"Do pass",5,2,0,0,7
1798427,1450361,2024-05-21,Senate,"Senate 3rd Reading SB907 Newman et al",30,9,0,1,40
1798427,1456843,2024-06-12,Assembly,"Do pass and be re-referred to the Committee on [Education]",6,2,0,0,8
1798427,1460548,2024-06-26,Assembly,"Do pass and be re-referred to the Committee on [Appropriations]",5,2,0,0,7
1798427,1464437,2024-08-15,Assembly,"Do pass as amended",11,3,0,1,15
1798427,1465734,2024-08-26,Assembly,"SB 907 Newman Senate Third Reading By Berman",58,17,0,4,79
1798427,1466935,2024-08-28,Senate,"Unfinished Business SB907 Newman et al. Concurrence",29,6,0,5,40
1798428,1366772,2024-01-18,Senate,"Senate 3rd Reading SCR96 Dodd",37,0,0,3,40
1798428,1428885,2024-04-16,Assembly,"Be adopted. To third reading",7,0,0,0,7
1800461,1411357,2024-03-19,Assembly,"Do pass and be re-referred to the Committee on [Environmental Safety and Toxic Materials]",10,0,0,5,15
1800461,1424872,2024-04-09,Assembly,"Do pass and be re-referred to the Committee on [Appropriations]",5,0,0,2,7
1800462,1428846,2024-04-16,Assembly,"Do pass and be re-referred to the Committee on [Appropriations]",12,3,0,1,16
1800462,1437621,2024-05-01,Assembly,"Do pass",11,2,0,2,15
1800462,1442586,2024-05-13,Assembly,"AB 1799 Jackson Assembly Third Reading",59,4,0,17,80
1800462,1462340,2024-07-02,Senate,"Do pass, but first be re-referred to the Committee on [Appropriations]",4,0,0,1,5
1800462,1466621,2024-08-28,Senate,"Assembly 3rd Reading AB1799 Jackson By Wiener",22,11,0,7,40
1800464,1424787,2024-04-10,Assembly,"Do pass and be re-referred to the Committee on [Local Government] with recommendation: To Consent Calendar",9,0,0,0,9
1800464,1431064,2024-04-17,Assembly,"Do pass and be re-referred to the Committee on [Appropriations]",9,0,0,0,9
1800464,1444081,2024-05-16,Assembly,"Do pass",15,0,0,0,15
1800464,1445966,2024-05-21,Assembly,"AB 1801 Jackson Assembly Third Reading",73,0,0,7,80
1800464,1453429,2024-06-04,Senate,"Do pass, but first be re-referred to the Committee on [Local Government] with the recommendation: To Consent Calendar",9,0,0,1,10
1800464,1460660,2024-06-26,Senate,"Do pass as amended, but first amend, and re-refer to the Committee on [Appropriations]",7,0,0,0,7
1800464,1463572,2024-08-05,Senate,"Placed on suspense file",7,0,0,0,7
1800464,1464046,2024-08-15,Senate,"Do pass",7,0,0,0,7
1800464,1466358,2024-08-29,Assembly,"AB 1801 Jackson Concurrence in Senate Amendments",76,0,0,3,79
1800464,1466822,2024-08-28,Senate,"Assembly 3rd Reading AB1801 Jackson By Blakespear",40,0,0,0,40
1800465,1424850,2024-04-09,Assembly,"Do pass and be re-referred to the Committee on [Appropriations]",8,0,0,0,8
1800465,1444224,2024-05-16,Assembly,"Do pass",15,0,0,0,15
1800465,1445953,2024-05-21,Assembly,"AB 1802 Jones-Sawyer Assembly Third Reading",72,0,0,8,80
1800465,1456278,2024-06-11,Senate,"Do pass, but first be re-referred to the Committee on [Appropriations]",4,0,0,1,5
1800465,1457999,2024-06-17,Senate,"Placed on suspense file",1,3,0,3,7
1800465,1458000,2024-06-17,Senate,"Do pass as amended",5,0,0,2,7
1800465,1463806,2024-08-08,Senate,"Assembly 3rd Reading AB1802 Jones-Sawyer et al. By Wahab",38,0,0,2,40
1800465,1463853,2024-08-12,Assembly,"AB 1802 Jones-Sawyer Concurrence in Senate Amendments",74,0,0,5,79
1800466,1396940,2024-02-27,Assembly,"Do pass",7,0,0,1,8
1800467,1396925,2024-02-27,Assembly,"Do pass and be re-referred to the Committee on [Appropriations]",7,0,0,1,8
1800468,1412596,2024-03-20,Assembly,"Do pass as amended and be re-referred to the Committee on [Appropriations]",7,0,0,0,7
1800468,1430066,2024-04-17,Assembly,"Do pass. To Consent Calendar",15,0,0,0,15
1800468,1436182,2024-04-29,Assembly,"AB 1805 Ta Assembly Third Reading",73,0,0,7,80
1800468,1451565,2024-05-29,Senate,"Do pass, but first be re-referred to the Committee on [Appropriations] with the recommendation: To Consent Calendar",7,0,0,0,7
1800468,1457362,2024-06-13,Senate,"Consent Calendar 2nd AB1805 Ta et al. By Umberg",37,0,0,3,40
1800468,1465258,2024-08-19,Senate,"Assembly 3rd Reading AB1805 Ta et al. By Umberg",40,0,0,0,40
1800468,1465614,2024-08-26,Assembly,"AB 1805 Ta Concurrence in Senate Amendments",77,0,0,2,79
1800470,1364779,2024-01-16,Assembly,"Be adopted. To third reading",8,0,0,2,10
1800471,1364774,2024-01-16,Assembly,"Be adopted. To Consent Calendar",8,0,0,2,10
1800471,1366793,2024-01-18,Assembly,"HR 60 Hoover Consent Calendar Second Day Regular Session",68,0,0,12,80
1800472,1435315,2024-04-24,Senate,"Do pass as amended, but first amend, and re-refer to the Committee on [Appropriations] with the recommendation: To Consent Calendar",11,0,0,0,11
1800472,1439611,2024-05-06,Senate,"Placed on suspense file",7,0,0,0,7
1800472,1444185,2024-05-16,Senate,"Do pass as amended",7,0,0,0,7
1800472,1448638,2024-05-22,Senate,"Senate 3rd Reading SB908 Cortese et al",38,0,0,2,40
1800472,1453450,2024-06-04,Assembly,"Do pass and be re-referred to the Committee on [Appropriations] with recommendation: To Consent Calendar",15,0,0,1,16
1800472,1464298,2024-08-15,Assembly,"Do pass",14,0,0,1,15
1800472,1465738,2024-08-26,Assembly,"SB 908 Cortese Senate Third Reading By Arambula",77,0,0,2,79
1800472,1466956,2024-08-28,Senate,"Special Consent SB908 Cortese et al",39,0,0,1,40
1800473,1420096,2024-04-03,Senate,"Do pass, but first be re-referred to the Committee on [Appropriations]",10,0,0,1,11
1800473,1427358,2024-04-15,Senate,"Placed on suspense file",6,0,0,1,7
1800473,1444240,2024-05-16,Senate,"Do pass as amended",7,0,0,0,7
1800473,1448663,2024-05-22,Senate,"Senate 3rd Reading SB909 Umberg et al",39,0,0,1,40
1800473,1458210,2024-06-18,Assembly,"Do pass and be re-referred to the Committee on [Appropriations]",16,0,0,0,16
1800473,1462361,2024-07-02,Assembly,"Do pass",15,0,0,0,15
1800473,1465287,2024-08-19,Assembly,"SB 909 Umberg Senate Third Reading By Weber",74,0,0,5,79
1800473,1466994,2024-08-28,Senate,"Special Consent SB909 Umberg et al",39,0,0,1,40
1800474,1424813,2024-04-10,Senate,"Do pass as amended, but first amend, and re-refer to the Committee on [Public Safety] with the recommendation: To Consent Calendar",11,0,0,0,11
1800474,1432920,2024-04-23,Senate,"Do pass, but first be re-referred to the Committee on [Appropriations]",5,0,0,0,5
1800474,1439649,2024-05-06,Senate,"Placed on suspense file",7,0,0,0,7
1800474,1444374,2024-05-16,Senate,"Do pass as amended",7,0,0,0,7
1800474,1448566,2024-05-22,Senate,"Senate 3rd Reading SB910 Umberg et al",39,0,0,1,40
1800474,1458329,2024-06-18,Assembly,"Do pass and be re-referred to the Committee on [Appropriations] with recommendation: To Consent Calendar",7,0,0,1,8
1800474,1464338,2024-08-15,Assembly,"Do pass as amended",11,0,0,4,15
1800474,1466554,2024-08-30,Senate,"Special Consent SB910 Umberg et al",40,0,0,0,40
1800474,1467036,2024-08-28,Assembly,"SB 910 Umberg Senate Third Reading By Kalra",76,0,0,3,79
1800475,1408822,2024-03-13,Senate,"Do pass, but first be re-referred to the Committee on [Military and Veterans Affairs]",6,0,0,1,7
1800475,1423923,2024-04-08,Senate,"Do pass, but first be re-referred to the Committee on [Appropriations] with the recommendation: To Consent Calendar",5,0,0,0,5
1800475,1431957,2024-04-22,Senate,"Placed on suspense file",7,0,0,0,7
1800476,1408247,2024-03-12,Senate,"Do pass, but first be re-referred to the Committee on [Appropriations]",4,1,0,0,5
1800476,1422051,2024-04-08,Senate,"Placed on suspense file",6,0,0,1,7
1800477,1424795,2024-04-10,Senate,"Do pass, but first be re-referred to the Committee on [Judiciary]",10,0,0,1,11
1800477,1434031,2024-04-23,Senate,"Do pass as amended, but first amend, and re-refer to the Committee on [Appropriations]",11,0,0,0,11
1800477,1442634,2024-05-13,Senate,"Placed on suspense file",7,0,0,0,7
1800478,1431875,2024-04-22,Senate,"Do pass as amended, but first amend, and re-refer to the Committee on [Appropriations] with the recommendation: To Consent Calendar",5,0,0,0,5
1800478,1442520,2024-05-13,Senate,"Placed on suspense file",7,0,0,0,7
1800478,1444311,2024-05-16,Senate,"Do pass as amended",7,0,0,0,7
1800478,1450039,2024-05-24,Senate,"Special Consent SB914 Umberg",38,0,0,2,40
1800478,1460040,2024-06-25,Assembly,"Do pass and be re-referred to the Committee on [Appropriations]",9,0,0,1,10
1807830,1424858,2024-04-10,Assembly,"Do pass and be re-referred to the Committee on [Local Government]",6,2,0,0,8
1807830,1435194,2024-04-24,Assembly,"Do pass and be re-referred to the Committee on [Appropriations]",7,1,0,1,9
1807830,1444336,2024-05-16,Assembly,"Do pass",11,4,0,0,15
1807830,1445991,2024-05-21,Assembly,"AB 1807 Cervantes Assembly Third Reading By GARCIA",58,13,0,9,80
1807830,1458214,2024-06-18,Senate,"Do pass, but first be re-referred to the Committee on [Local Government]",6,1,0,0,7
1807830,1460566,2024-06-26,Senate,"Do pass, but first be re-referred to the Committee on [Appropriations]",5,2,0,0,7
1807830,1463360,2024-08-05,Senate,"Placed on suspense file",7,0,0,0,7
1807830,1464429,2024-08-15,Senate,"Do pass",5,2,0,0,7
1807830,1465785,2024-08-27,Senate,"Assembly 3rd Reading AB1807 Cervantes By Ashby",32,8,0,0,40
1807831,1419229,2024-04-02,Assembly,"Do pass and be re-referred to the Committee on [Appropriations] with recommendation: To Consent Calendar",7,0,0,0,7
1807831,1444251,2024-05-16,Assembly,"Do pass",15,0,0,0,15
1807831,1446061,2024-05-21,Assembly,"AB 1808 Stephanie Nguyen Assembly Third Reading",73,0,0,7,80
1807831,1458162,2024-06-17,Senate,"Do pass, but first be re-referred to the Committee on [Appropriations] with the recommendation: To Consent Calendar",5,0,0,0,5
1807831,1462020,2024-07-01,Senate,"Placed on suspense file",7,0,0,0,7
1807831,1464029,2024-08-15,Senate,"Do pass",7,0,0,0,7
1807831,1466372,2024-08-29,Assembly,"AB 1808 Stephanie Nguyen Concurrence in Senate Amendments",76,0,0,3,79
1807831,1466832,2024-08-28,Senate,"Special Consent AB1808 Stephanie Nguyen et By Lim√≥n",39,0,0,1,40
1807832,1408238,2024-03-12,Assembly,"Do pass as amended",8,0,0,0,8
1807832,1448708,2024-05-22,Assembly,"AB 1809 Rodriguez Assembly Third Reading",64,0,0,16,80
1807833,1396924,2024-02-27,Assembly,"Do pass and be re-referred to the Committee on [Appropriations]",8,0,0,0,8
1807833,1444329,2024-05-16,Assembly,"Do pass",15,0,0,0,15
1807833,1445980,2024-05-21,Assembly,"AB 1810 Bryan Assembly Third Reading",71,0,0,9,80
1807833,1456289,2024-06-11,Senate,"Do pass as amended, but first amend, and re-refer to the Committee on [Appropriations]",5,0,0,0,5
1807833,1465306,2024-08-19,Senate,"Assembly 3rd Reading AB1810 Bryan et al. By Skinner",40,0,0,0,40
1807833,1465500,2024-08-22,Assembly,"AB 1810 Bryan Concurrence in Senate Amendments",60,0,0,19,79
1807834,1423719,2024-04-09,Assembly,"Do pass as amended and be re-referred to the Committee on [Appropriations]",9,2,0,1,12
1807835,1427292,2024-04-15,Assembly,"Be adopted. To Consent Calendar",15,0,0,0,15
1807835,1430992,2024-04-18,Assembly,"ACR 121 Gallagher Consent Calendar Second Day Regular Session",72,0,0,8,80
1807835,1456405,2024-06-11,Senate,"Be adopted, but first be re-referred to the Committee on [Appropriations] with recommendation: To Consent Calendar",15,0,0,0,15
1807835,1461258,2024-06-27,Senate,"Consent Calendar 2nd ACR121 Gallagher et al",40,0,0,0,40
1807837,1364831,2024-01-16,Assembly,"Be adopted. To third reading",8,0,0,2,10
1807838,1430087,2024-04-17,Senate,"Do pass, but first be re-referred to the Committee on [Transportation]",4,2,0,1,7
1807838,1434220,2024-04-23,Senate,"Do pass, but first be re-referred to the Committee on [Appropriations]",10,5,0,0,15
1807838,1439658,2024-05-06,Senate,"Placed on suspense file",7,0,0,0,7
1807838,1444454,2024-05-16,Senate,"Do pass as amended",5,2,0,0,7
1807838,1450347,2024-05-21,Senate,"Senate 3rd Reading SB915 Cortese et al",26,9,0,5,40
1807839,1412501,2024-03-20,Senate,"Do pass as amended, but first amend, and re-refer to the Committee on [Military and Veterans Affairs] with the recommendation: To Consent Calendar",7,0,0,0,7
1807839,1423922,2024-04-08,Senate,"Do pass, but first be re-referred to the Committee on [Appropriations] with the recommendation: To Consent Calendar",5,0,0,0,5
1807839,1431985,2024-04-22,Senate,"Placed on suspense file",7,0,0,0,7
1807839,1444354,2024-05-16,Senate,"Do pass",7,0,0,0,7
1807839,1449709,2024-05-23,Senate,"Special Consent SB916 Seyarto et al",37,0,0,3,40
1807839,1458178,2024-06-18,Assembly,"Do pass and be re-referred to the Committee on [Military and Veterans Affairs]",9,0,0,2,11
1807839,1460082,2024-06-25,Assembly,"Do pass and be re-referred to the Committee on [Appropriations]",9,0,0,1,10
1807840,1367508,2024-01-22,Senate,"Senate 3rd Reading SR53 Lim√≥n et al",39,0,0,1,40
1810641,1396938,2024-02-27,Assembly,"Do pass as amended and be re-referred to the Committee on [Privacy and Consumer Protection]",7,0,0,1,8
1810641,1436946,2024-04-30,Assembly,"Do pass as amended",10,0,0,1,11
1810641,1445221,2024-05-20,Assembly,"AB 1814 Ting Assembly Third Reading",70,0,0,10,80
1810641,1456420,2024-06-11,Senate,"Do pass as amended, but first amend, and re-refer to the Committee on [Judiciary]",5,0,0,0,5
1810641,1462450,2024-07-02,Senate,"Do pass, but first be re-referred to the Committee on [Appropriations]",11,0,0,0,11
1810641,1463462,2024-08-05,Senate,"Placed on suspense file",7,0,0,0,7
1810642,1419182,2024-04-02,Assembly,"Do pass and be re-referred to the Committee on [Appropriations]",11,1,0,0,12
1810642,1434225,2024-04-24,Assembly,"Do pass",14,0,0,1,15
1810642,1438458,2024-05-02,Assembly,"AB 1815 Weber Assembly Third Reading",71,0,0,9,80
1810642,1453392,2024-06-04,Senate,"Do pass, but first be re-referred to the Committee on [Appropriations]",11,0,0,0,11
1810642,1465758,2024-08-26,Senate,"Assembly 3rd Reading AB1815 Weber et al. By Smallwood-Cuevas",40,0,0,0,40
1810642,1465982,2024-08-27,Assembly,"AB 1815 Weber Concurrence in Senate Amendments",76,0,0,3,79
1810643,1364731,2024-01-16,Assembly,"Be adopted. To Consent Calendar",8,0,0,2,10
1810643,1366767,2024-01-18,Assembly,"ACR 122 Weber Consent Calendar Second Day",68,0,0,12,80
1810643,1395242,2024-02-26,Senate,"Special Consent ACR122 Weber et al",37,0,0,3,40
1810645,1437657,2024-04-30,Senate,"Do pass as amended",11,0,0,0,11
1810645,1445296,2024-05-20,Senate,"Senate 3rd Reading SB918 Umberg",39,0,0,1,40
1810645,1462564,2024-07-02,Assembly,"Do pass as amended",11,0,0,0,11
1810645,1466243,2024-08-29,Senate,"That the Assembly amendments be concurred in",5,0,0,0,5
1810645,1466565,2024-08-30,Senate,"Unfinished Business SB918 Umberg et al. Concurrence",39,1,0,0,40
1810645,1467096,2024-08-28,Assembly,"SB 918 Umberg Senate Third Reading By Bauer-Kahan",75,0,0,4,79
1810646,1430026,2024-04-17,Senate,"Do pass, but first be re-referred to the Committee on [Judiciary]",6,1,0,0,7
1810646,1434222,2024-04-23,Senate,"Do pass, but first be re-referred to the Committee on [Appropriations]",11,0,0,0,11
1810646,1439650,2024-05-06,Senate,"Placed on suspense file",7,0,0,0,7
1810646,1444547,2024-05-16,Senate,"Do pass as amended",7,0,0,0,7
1810646,1448736,2024-05-22,Senate,"Senate 3rd Reading SB919 Umberg",37,1,0,2,40
1810646,1457997,2024-06-17,Assembly,"Do pass as amended and be re-referred to the Committee on [Judiciary]",8,0,0,1,9
1810646,1460020,2024-06-25,Assembly,"Do pass as amended and be re-referred to the Committee on [Appropriations]",11,0,0,1,12
1810646,1464463,2024-08-15,Assembly,"Do pass as amended",11,0,0,4,15
1810646,1465699,2024-08-26,Assembly,"SB 919 Umberg Senate Third Reading By Pacheco",75,0,0,4,79
1810646,1467192,2024-08-28,Senate,"Unfinished Business SB919 Umberg Concurrence",39,0,0,1,40
1810647,1412504,2024-03-20,Senate,"Do pass as amended, but first amend, and re-refer to the Committee on [Military and Veterans Affairs] with the recommendation: To Consent Calendar",7,0,0,0,7
1810647,1423934,2024-04-08,Senate,"Do pass, but first be re-referred to the Committee on [Appropriations] with the recommendation: To Consent Calendar",5,0,0,0,5
1810647,1431942,2024-04-22,Senate,"Placed on suspense file",7,0,0,0,7
1810647,1444191,2024-05-16,Senate,"Do pass",7,0,0,0,7
1810647,1449693,2024-05-23,Senate,"Special Consent SB920 Seyarto et al",37,0,0,3,40
1810647,1456951,2024-06-12,Assembly,"Do pass and be re-referred to the Committee on [Military and Veterans Affairs] with recommendation: To Consent Calendar",7,0,0,0,7
1810647,1460079,2024-06-25,Assembly,"Do pass and be re-referred to the Committee on [Appropriations]",9,0,0,1,10
1810647,1464531,2024-08-15,Assembly,"Do pass",14,0,0,1,15
1810647,1465615,2024-08-26,Assembly,"SB 920 Seyarto Senate Third Reading By Mathis",77,0,0,2,79
1810648,1367515,2024-01-22,Senate,"Senate 3rd Reading SCR97 Grove et al",39,0,0,1,40
1810648,1376369,2024-02-05,Assembly,"Be adopted. To Consent Calendar",7,0,0,4,11
1810648,1380147,2024-02-08,Assembly,"SCR 97 Grove Consent Calendar Second Day Regular Session",72,0,0,8,80
1812198,1423904,2024-04-09,Assembly,"Do pass and be re-referred to the Committee on [Appropriations] with recommendation: To Consent Calendar",6,0,0,1,7
1812198,1444220,2024-05-16,Assembly,"Do pass",15,0,0,0,15
1812198,1445957,2024-05-21,Assembly,"AB 1817 Alanis Assembly Third Reading",73,0,0,7,80
1812198,1458293,2024-06-17,Senate,"Do pass, but first be re-referred to the Committee on [Housing]",5,0,0,0,5
1812198,1462578,2024-07-02,Senate,"Do pass, but first be re-referred to the Committee on [Appropriations] with the recommendation: To Consent Calendar",10,0,0,0,10
1812198,1463588,2024-08-05,Senate,"Placed on suspense file",7,0,0,0,7
1812198,1464556,2024-08-15,Senate,"Do pass as amended",7,0,0,0,7
1812198,1466521,2024-08-30,Senate,"Special Consent AB1817 Alanis By Ochoa Bogh",40,0,0,0,40
1812198,1467050,2024-08-31,Assembly,"AB 1817 Alanis Concurrence in Senate Amendments",77,0,0,2,79
1812199,1430062,2024-04-16,Assembly,"Do pass as amended and be re-referred to the Committee on [Appropriations]",10,0,0,1,11
1812199,1444617,2024-05-16,Assembly,"Do pass as amended",12,0,0,3,15
1812199,1448806,2024-05-22,Assembly,"AB 1818 Jackson Assembly Third Reading",63,0,0,17,80
1812199,1458455,2024-06-19,Senate,"Do pass as amended, but first amend, and re-refer to the Committee on [Judiciary]",5,0,0,2,7
1812199,1462575,2024-07-02,Senate,"Do pass as amended, but first amend, and re-refer to the Committee on [Appropriations]",6,1,0,4,11
1812199,1463668,2024-08-05,Senate,"Placed on suspense file",7,0,0,0,7
1812200,1438459,2024-05-01,Assembly,"Do pass as amended",9,0,0,0,9
1812200,1445275,2024-05-20,Assembly,"AB 1819 Waldron Assembly Third Reading",73,0,0,7,80
1812200,1460752,2024-06-26,Senate,"Do pass as amended",7,0,0,0,7
1812200,1466160,2024-08-29,Assembly,"AB 1819 Waldron Concurrence in Senate Amendments",76,0,0,3,79
1812200,1466656,2024-08-28,Senate,"Assembly 3rd Reading AB1819 Waldron By Lim√≥n",40,0,0,0,40
1812201,1424864,2024-04-10,Assembly,"Do pass as amended and be re-referred to the Committee on [Local Government]",9,0,0,0,9
1812201,1435358,2024-04-24,Assembly,"Do pass as amended and be re-referred to the Committee on [Appropriations]",8,0,0,1,9
1812201,1443486,2024-05-15,Assembly,"Do pass",15,0,0,0,15
1812201,1445961,2024-05-21,Assembly,"AB 1820 Schiavo Assembly Third Reading",72,0,0,8,80
1812201,1456406,2024-06-11,Senate,"Do pass, but first be re-referred to the Committee on [Housing]",7,0,0,0,7
1812201,1462585,2024-07-02,Senate,"Do pass, but first be re-referred to the Committee on [Appropriations]",9,0,0,1,10
1812201,1465721,2024-08-26,Senate,"Assembly 3rd Reading AB1820 Schiavo et al. By Blakespear",40,0,0,0,40
1812201,1465967,2024-08-27,Assembly,"AB 1820 Schiavo Concurrence in Senate Amendments",76,0,0,3,79
1812202,1412608,2024-03-20,Assembly,"Do pass as amended and be re-referred to the Committee on [Appropriations]",7,0,0,0,7
1812202,1429973,2024-04-17,Assembly,"Do pass. To Consent Calendar",15,0,0,0,15
1812202,1435251,2024-04-25,Assembly,"AB 1821 Ramos Consent Calendar Second Day Regular Session",75,0,0,5,80
1812202,1451592,2024-05-29,Senate,"Do pass, but first be re-referred to the Committee on [Appropriations] with the recommendation: To Consent Calendar",7,0,0,0,7
1812202,1457306,2024-06-13,Senate,"Consent Calendar 2nd AB1821 Ramos et al. By Archuleta",37,0,0,3,40
1812202,1466552,2024-08-30,Senate,"Assembly 3rd Reading AB1821 Ramos et al. By Archuleta",40,0,0,0,40
1812202,1467034,2024-08-31,Assembly,"AB 1821 Ramos Concurrence in Senate Amendments",77,0,0,2,79
1812205,1419210,2024-04-02,Assembly,"Do pass and be re-referred to the Committee on [Appropriations] with recommendation: To Consent Calendar",11,0,0,0,11
1812205,1434195,2024-04-24,Assembly,"Do pass. To Consent Calendar",14,0,0,1,15
1812205,1438457,2024-05-02,Assembly,"AB 1824 Valencia Consent Calendar Second Day Regular Session",73,0,0,7,80
1812205,1453385,2024-06-04,Senate,"Do pass, but first be re-referred to the Committee on [Appropriations] with the recommendation: To Consent Calendar",11,0,0,0,11
1812205,1465943,2024-08-27,Senate,"Assembly 3rd Reading AB1824 Valencia By Becker",40,0,0,0,40
1812205,1466707,2024-08-28,Assembly,"AB 1824 Valencia Concurrence in Senate Amendments",77,0,0,2,79
1812206,1424790,2024-04-10,Assembly,"Do pass and be re-referred to the Committee on [Judiciary]",5,1,0,1,7
1812206,1433139,2024-04-23,Assembly,"Do pass as amended and be re-referred to the Committee on [Appropriations]",11,0,0,1,12
1812206,1443949,2024-05-16,Assembly,"Do pass as amended",12,1,0,2,15
1812206,1449721,2024-05-23,Assembly,"AB 1825 Muratsuchi Assembly Third Reading",62,3,0,15,80
1812206,1460483,2024-06-26,Senate,"Do pass, but first be re-referred to the Committee on [Judiciary]",5,0,0,2,7
1812206,1462482,2024-07-02,Senate,"Do pass as amended, but first amend, and re-refer to the Committee on [Appropriations]",9,2,0,0,11
1812206,1465879,2024-08-27,Senate,"Assembly 3rd Reading AB1825 Muratsuchi et al. By Min",31,7,0,2,40
1812206,1466650,2024-08-28,Assembly,"AB 1825 Muratsuchi Concurrence in Senate Amendments",64,9,0,6,79
1812207,1419155,2024-04-02,Senate,"Do pass as amended, but first amend, and re-refer to the Committee on [Appropriations]",5,0,0,0,5
1812210,1420177,2024-04-02,Senate,"Do pass, but first be re-referred to the Committee on [Appropriations]",10,1,0,0,11
1812210,1450307,2024-05-21,Senate,"Senate 3rd Reading SB924 Bradford",34,3,0,3,40
1812210,1453418,2024-06-04,Assembly,"Do pass and be re-referred to the Committee on [Appropriations]",8,0,0,4,12
1812210,1458397,2024-06-19,Assembly,"Do pass",10,0,0,5,15
1812210,1466031,2024-08-27,Assembly,"SB 924 Bradford Senate Third Reading By Haney",64,0,0,15,79
1812211,1432966,2024-04-23,Senate,"Do pass and be ordered to the Consent Calendar",16,0,0,0,16
1812211,1438420,2024-05-02,Senate,"Consent Calendar 2nd SB925 Wiener",38,0,0,2,40
1812211,1460732,2024-06-26,Assembly,"Do pass and be re-referred to the Committee on [Public Safety]",8,0,0,1,9
1812211,1462506,2024-07-02,Assembly,"Do pass and be re-referred to the Committee on [Appropriations]",7,0,0,1,8
1813226,1434123,2024-04-24,Assembly,"Do pass as amended and be re-referred to the Committee on [Appropriations]",7,1,0,3,11
1813226,1444257,2024-05-16,Assembly,"Do pass as amended",11,3,0,1,15
1813226,1446123,2024-05-21,Assembly,"AB 1826 Holden Assembly Third Reading",47,15,0,18,80
1813226,1459350,2024-06-24,Senate,"Do pass as amended, but first amend, and re-refer to the Committee on [Appropriations]",12,4,0,2,18
1813226,1463613,2024-08-05,Senate,"Placed on suspense file",7,0,0,0,7
1813226,1464020,2024-08-15,Senate,"Do pass as amended",5,2,0,0,7
1813226,1466219,2024-08-29,Assembly,"AB 1826 Holden Concurrence in Senate Amendments",50,16,0,13,79
1813226,1466672,2024-08-28,Senate,"Assembly 3rd Reading AB1826 Holden By Wiener",25,10,0,5,40
1813227,1435347,2024-04-24,Assembly,"Do pass",7,1,0,1,9
1813227,1445182,2024-05-20,Assembly,"AB 1827 Papan Assembly Third Reading",55,15,0,10,80
1813227,1460593,2024-06-26,Senate,"Do pass",5,2,0,0,7
1813227,1465329,2024-08-20,Senate,"Assembly 3rd Reading AB1827 Papan By Min",30,9,0,1,40
1813228,1403640,2024-03-04,Assembly,"Do pass as amended and be re-referred to the Committee on [Appropriations]",6,0,0,1,7
1813228,1412532,2024-03-20,Assembly,"Do pass. To Consent Calendar",12,0,0,3,15
1813228,1421177,2024-04-04,Assembly,"AB 1828 Waldron Consent Calendar Second Day",70,0,0,10,80
1813228,1456888,2024-06-12,Senate,"Do pass, but first be re-referred to the Committee on [Natural Resources and Water] with the recommendation: To Consent Calendar",6,0,0,1,7
1813228,1459948,2024-06-25,Senate,"Do pass, but first be re-referred to the Committee on [Appropriations] with the recommendation: To Consent Calendar",11,0,0,0,11
1813228,1463846,2024-08-12,Senate,"Consent Calendar 2nd AB1828 Waldron et al",38,0,0,2,40
1813228,1466594,2024-08-30,Senate,"Assembly 3rd Reading AB1828 Waldron et al. By Laird",40,0,0,0,40
1813228,1467224,2024-08-31,Assembly,"AB 1828 Waldron Concurrence in Senate Amendments",77,0,0,2,79
1813230,1411317,2024-03-19,Assembly,"Do pass as amended and be re-referred to the Committee on [Appropriations]",14,0,0,2,16
1813230,1424764,2024-04-10,Assembly,"Do pass. To Consent Calendar",14,0,0,1,15
1813230,1431017,2024-04-18,Assembly,"AB 1830 Arambula Consent Calendar Second Day Regular Session",72,0,0,8,80
1813230,1460715,2024-06-26,Senate,"Do pass, but first be re-referred to the Committee on [Appropriations]",10,1,0,0,11
1813230,1465395,2024-08-21,Senate,"Assembly 3rd Reading AB1830 Arambula et al. By Lim√≥n",33,0,0,7,40
1813230,1465586,2024-08-26,Assembly,"AB 1830 Arambula Concurrence in Senate Amendments",77,0,0,2,79
1813231,1424949,2024-04-09,Assembly,"Do pass and be re-referred to the Committee on [Privacy and Consumer Protection]",8,0,0,0,8
1813231,1435316,2024-04-23,Assembly,"Do pass as amended and be re-referred to the Committee on [Appropriations]",11,0,0,0,11
1813231,1444503,2024-05-16,Assembly,"Do pass",15,0,0,0,15
1813231,1449691,2024-05-23,Assembly,"AB 1831 Berman Assembly Third Reading",71,0,0,9,80
1813231,1458260,2024-06-18,Senate,"Do pass as amended, but first amend, and re-refer to the Committee on [Appropriations]",5,0,0,0,5
1813231,1462014,2024-07-01,Senate,"Placed on suspense file",7,0,0,0,7
1813231,1464200,2024-08-15,Senate,"Do pass as amended",7,0,0,0,7
1813231,1466859,2024-08-31,Senate,"Assembly 3rd Reading AB1831 Berman et al. By Wahab",40,0,0,0,40
1813231,1466860,2024-08-31,Assembly,"AB 1831 Berman Concurrence in Senate Amendments",73,0,0,6,79
1813232,1408826,2024-03-13,Assembly,"Do pass and be re-referred to the Committee on [Public Safety] with recommendation: To Consent Calendar",7,0,0,0,7
1813232,1420181,2024-04-02,Assembly,"Do pass and be re-referred to the Committee on [Appropriations] with recommendation: To Consent Calendar",8,0,0,0,8
1813232,1444212,2024-05-16,Assembly,"Do pass as amended",11,0,0,4,15
1813232,1448821,2024-05-22,Assembly,"AB 1832 Blanca Rubio Assembly Third Reading",71,0,0,9,80
1813232,1458347,2024-06-18,Senate,"Do pass, but first be re-referred to the Committee on [Labor, Public Employment and Retirement ] with the recommendation: To Consent Calendar",5,0,0,0,5
1813232,1460438,2024-06-26,Senate,"Do pass, but first be re-referred to the Committee on [Appropriations] with the recommendation: To Consent Calendar",5,0,0,0,5
1813232,1463410,2024-08-05,Senate,"Placed on suspense file",7,0,0,0,7
1813232,1464593,2024-08-15,Senate,"Do pass as amended",7,0,0,0,7
1813232,1466542,2024-08-30,Senate,"Special Consent AB1832 Blanca Rubio et al. By Rubio",40,0,0,0,40
1813232,1467058,2024-08-31,Assembly,"AB 1832 Blanca Rubio Concurrence in Senate Amendments",77,0,0,2,79
1813233,1424812,2024-04-10,Assembly,"Do pass and be re-referred to the Committee on [Appropriations]",10,0,0,0,10
1813234,1371129,2024-01-29,Assembly,"Be adopted. To third reading",8,0,0,3,11
1813234,1395229,2024-02-26,Senate,"Special Consent ACR123 McCarty et al",37,0,0,3,40
1813235,1427227,2024-04-15,Assembly,"Be adopted. To Consent Calendar",15,0,0,0,15
1813235,1431044,2024-04-18,Assembly,"ACR 124 Pellerin Consent Calendar Second Day Regular Session",72,0,0,8,80
1813235,1451615,2024-05-28,Senate,"Be adopted, but first be re-referred to the Committee on [Appropriations] with recommendation: To Consent Calendar",12,0,0,3,15
1813235,1457328,2024-06-13,Senate,"Consent Calendar 2nd ACR124 Pellerin et al",37,0,0,3,40
1813236,1364810,2024-01-16,Assembly,"Be adopted. To third reading",8,0,0,2,10
1813236,1395217,2024-02-26,Senate,"Special Consent ACR125 Pellerin et al",37,0,0,3,40
1813237,1437613,2024-05-01,Assembly,"Be adopted. To Consent Calendar",6,0,0,1,7
1813238,1433000,2024-04-23,Senate,"Do pass as amended, but first amend, and re-refer to the Committee on [Appropriations]",5,0,0,0,5
1813238,1439717,2024-05-06,Senate,"Placed on suspense file",7,0,0,0,7
1813238,1444074,2024-05-16,Senate,"Do pass as amended",7,0,0,0,7
1813238,1450003,2024-05-24,Senate,"Special Consent SB926 Wahab et al",38,0,0,2,40
1813238,1458281,2024-06-18,Assembly,"Do pass and be re-referred to the Committee on [Privacy and Consumer Protection] with recommendation: To Consent Calendar",7,0,0,1,8
1813238,1462576,2024-07-02,Assembly,"Do pass and be re-referred to the Committee on [Appropriations] with recommendation: To Consent Calendar",11,0,0,0,11
1813238,1464082,2024-08-15,Assembly,"Do pass as amended",11,0,0,4,15
1813238,1466384,2024-08-30,Senate,"Special Consent SB926 Wahab et al",40,0,0,0,40
1813238,1466920,2024-08-28,Assembly,"SB 926 Wahab Senate Third Reading By McCarty",75,0,0,4,79
1813239,1408833,2024-03-13,Senate,"Do pass as amended, but first amend, and re-refer to the Committee on [Appropriations]",6,0,0,1,7
1813239,1422099,2024-04-08,Senate,"Placed on suspense file",6,0,0,1,7
1814894,1434176,2024-04-24,Assembly,"Do pass and be re-referred to the Committee on [Appropriations] with recommendation: To Consent Calendar",16,0,0,0,16
1814894,1444303,2024-05-16,Assembly,"Do pass",15,0,0,0,15
1814894,1449562,2024-05-23,Assembly,"AB 1834 Garcia Assembly Third Reading",72,0,0,8,80
1814894,1459411,2024-06-24,Senate,"Do pass, but first be re-referred to the Committee on [Appropriations]",17,0,0,1,18
1814894,1463593,2024-08-05,Senate,"Placed on suspense file",7,0,0,0,7
1814894,1464412,2024-08-15,Senate,"Do pass",7,0,0,0,7
1814894,1465968,2024-08-27,Senate,"Assembly 3rd Reading AB1834 Garcia By Bradford",40,0,0,0,40
1814897,1430074,2024-04-16,Assembly,"Do pass as amended and be re-referred to the Committee on [Judiciary]",8,0,0,3,11
1814897,1436902,2024-04-30,Assembly,"Do pass as amended and be re-referred to the Committee on [Appropriations]",9,0,0,3,12
1814897,1441283,2024-05-08,Assembly,"Do pass",11,0,0,4,15
1814897,1445138,2024-05-20,Assembly,"AB 1836 Bauer-Kahan Assembly Third Reading",59,0,0,21,80
1814897,1462620,2024-07-02,Senate,"Do pass as amended, but first amend, and re-refer to the Committee on [Appropriations]",11,0,0,0,11
1814897,1463490,2024-08-05,Senate,"Placed on suspense file",7,0,0,0,7
1814897,1464087,2024-08-15,Senate,"Do pass as amended",5,1,0,1,7
1814897,1466618,2024-08-31,Senate,"Assembly 3rd Reading AB1836 Bauer-Kahan By Ashby",33,4,0,3,40
1814897,1466619,2024-08-31,Assembly,"AB 1836 BAUER-KAHAN Concurrence in Senate Amendments",57,8,0,14,79
1814898,1431931,2024-04-22,Assembly,"Do pass and be re-referred to the Committee on [Appropriations]",15,0,0,0,15
1814898,1443490,2024-05-15,Assembly,"Do pass. To Consent Calendar",15,0,0,0,15
1814898,1446031,2024-05-21,Assembly,"AB 1837 Papan Consent Calendar Second Day",71,0,0,9,80
1814899,1423835,2024-04-09,Assembly,"Do pass and be re-referred to the Committee on [Appropriations] with recommendation: To Consent Calendar",14,0,0,1,15
1814901,1408240,2024-03-12,Assembly,"Do pass and be re-referred to the Committee on [Public Safety]",10,0,0,1,11
1814901,1428796,2024-04-16,Assembly,"Do pass and be re-referred to the Committee on [Appropriations] with recommendation: To Consent Calendar",8,0,0,0,8
1814902,1430094,2024-04-17,Assembly,"Do pass as amended and be re-referred to the Committee on [Appropriations]",6,2,0,1,9
1814902,1444068,2024-05-16,Assembly,"Do pass",11,4,0,0,15
1814902,1445937,2024-05-21,Assembly,"AB 1840 Arambula Assembly Third Reading",56,15,0,9,80
1814902,1458501,2024-06-18,Senate,"Do pass, but first be re-referred to the Committee on [Judiciary]",7,3,0,0,10
1814902,1462595,2024-07-02,Senate,"Do pass, but first be re-referred to the Committee on [Appropriations]",9,2,0,0,11
1814902,1463525,2024-08-05,Senate,"Placed on suspense file",7,0,0,0,7
1814902,1464227,2024-08-15,Senate,"Do pass as amended",5,2,0,0,7
1814902,1465960,2024-08-27,Senate,"Assembly 3rd Reading AB1840 Arambula By Wiener",25,14,0,1,40
1814902,1466742,2024-08-28,Assembly,"AB 1840 Arambula Concurrence in Senate Amendments",53,18,0,8,79
1814903,1408267,2024-03-12,Assembly,"Do pass and be re-referred to the Committee on [Appropriations]",11,0,0,0,11
1814903,1424918,2024-04-10,Assembly,"Do pass. To Consent Calendar",14,0,0,1,15
1814903,1430973,2024-04-18,Assembly,"AB 1841 Weber Consent Calendar Second Day Regular Session",72,0,0,8,80
1814903,1451610,2024-05-29,Senate,"Do pass, but first be re-referred to the Committee on [Health]",7,0,0,0,7
1814903,1458407,2024-06-19,Senate,"Do pass, but first be re-referred to the Committee on [Appropriations] with the recommendation: To Consent Calendar",11,0,0,0,11
1814903,1463426,2024-08-05,Senate,"Placed on suspense file",7,0,0,0,7
1814903,1464207,2024-08-15,Senate,"Do pass",6,0,0,1,7
1814903,1465639,2024-08-26,Senate,"Assembly 3rd Reading AB1841 Weber By Hurtado",40,0,0,0,40
1814903,1465820,2024-08-27,Assembly,"AB 1841 Weber Concurrence in Senate Amendments",77,0,0,2,79
1814905,1411338,2024-03-19,Assembly,"Do pass and be re-referred to the Committee on [Appropriations]",13,0,0,3,16
1814905,1424878,2024-04-10,Assembly,"Do pass",14,0,0,1,15
1814905,1436242,2024-04-29,Assembly,"AB 1842 Reyes Assembly Third Reading",73,0,0,7,80
1814905,1451582,2024-05-29,Senate,"Do pass, but first be re-referred to the Committee on [Appropriations]",11,0,0,0,11
1814905,1455808,2024-06-10,Senate,"Do pass",7,0,0,0,7
1814905,1466105,2024-08-29,Assembly,"AB 1842 Reyes Concurrence in Senate Amendments",75,0,0,4,79
1814905,1466662,2024-08-28,Senate,"Assembly 3rd Reading AB1842 Reyes et al. By Lim√≥n",39,0,0,1,40
1814906,1408834,2024-03-13,Assembly,"Do pass and be re-referred to the Committee on [Appropriations]",7,0,0,0,7
1814906,1434133,2024-04-24,Assembly,"Do pass",13,0,0,2,15
1814906,1449555,2024-05-23,Assembly,"AB 1843 Rodriguez Assembly Third Reading",69,0,0,11,80
1814906,1458420,2024-06-19,Senate,"Do pass as amended, but first amend, and re-refer to the Committee on [Judiciary]",11,0,0,0,11
1814906,1460523,2024-06-25,Senate,"Do pass as amended, but first amend, and re-refer to the Committee on [Appropriations]",11,0,0,0,11
1814906,1465815,2024-08-27,Senate,"Assembly 3rd Reading AB1843 Rodriguez et al. By Seyarto",40,0,0,0,40
1814906,1465816,2024-08-27,Senate,"Assembly 3rd Reading AB1843 Rodriguez et al. By Seyarto Reconsider",40,0,0,0,40
1814906,1466641,2024-08-31,Senate,"Assembly 3rd Reading AB1843 Rodriguez et al. By Seyarto",40,0,0,0,40
1814906,1466642,2024-08-31,Assembly,"AB 1843 Rodriguez Concurrence in Senate Amendments",74,0,0,5,79
1814906,1467558,2024-08-27,Senate,"Assembly 3rd Reading AB1843 Rodriguez et al. By Seyarto Motion to Reconsider",40,0,0,0,40
1814906,1467559,2024-08-27,Senate,"Assembly 3rd Reading AB1843 Rodriguez et al. By Seyarto Motion to Reconsider Reconsider",40,0,0,0,40
1814907,1420041,2024-04-03,Assembly,"Do pass",12,0,0,3,15
1814907,1422055,2024-04-08,Assembly,"AB 1844 Calderon Assembly Third Reading",74,0,0,6,80
1814909,1427325,2024-04-15,Assembly,"Be adopted. To Consent Calendar",15,0,0,0,15
1814909,1449538,2024-05-23,Assembly,"ACR 126 Joe Patterson Assembly Third Reading",72,0,0,8,80
1814909,1456421,2024-06-11,Senate,"Be adopted as amended, but first amend, and re-refer to the Committee on [Appropriations] with the recommendation: To Consent Calendar",15,0,0,0,15
1814909,1461994,2024-07-01,Senate,"Assembly 3rd Reading ACR126 Joe Patterson et al. By Niello",40,0,0,0,40
1814909,1462480,2024-07-03,Assembly,"ACR 126 Joe Patterson Concurrence in Senate Amendments",71,0,0,8,79
1814911,1367510,2024-01-22,Assembly,"Be adopted. To Consent Calendar",9,0,0,2,11
1814911,1369558,2024-01-25,Assembly,"HR 64 Bennett Consent Calendar Second Day Regular Session",69,0,0,11,80
1814914,1434236,2024-04-23,Senate,"Do pass as amended, but first amend, and re-refer to the Committee on [Appropriations]",11,4,0,0,15
1814914,1442628,2024-05-13,Senate,"Placed on suspense file",7,0,0,0,7
1814914,1444600,2024-05-16,Senate,"Do pass",5,2,0,0,7
1814914,1450265,2024-05-21,Senate,"Senate 3rd Reading SB930 Laird",33,6,0,1,40
1814914,1458297,2024-06-17,Assembly,"Do pass and be re-referred to the Committee on [Appropriations]",11,1,0,3,15
1814915,1408249,2024-03-12,Senate,"Do pass, but first be re-referred to the Committee on [Appropriations] with the recommendation: To Consent Calendar",16,0,0,0,16
1814915,1425882,2024-04-11,Senate,"Consent Calendar 2nd SB931 G.O. (Dodd)",39,0,0,1,40
1814915,1454226,2024-06-05,Assembly,"Do pass and be re-referred to the Committee on [Appropriations] with recommendation: To Consent Calendar",19,0,0,3,22
1814915,1458511,2024-06-19,Assembly,"Do pass. To Consent Calendar",14,0,0,1,15
1814915,1465683,2024-08-26,Assembly,"SB 931 Dodd Third Reading Urgency By Ramos",77,0,0,2,79
1814915,1467193,2024-08-28,Senate,"Special Consent SB931 Dodd et al. Urgency Clause",39,0,0,1,40
1814917,1424806,2024-04-09,Senate,"Do pass, but first be re-referred to the Committee on [Appropriations] with the recommendation: To Consent Calendar",15,0,0,0,15
1814917,1431896,2024-04-22,Senate,"Placed on suspense file",7,0,0,0,7
1814918,1411347,2024-03-19,Senate,"Do pass, but first be re-referred to the Committee on [Appropriations] with the recommendation: To Consent Calendar",5,0,0,0,5
1814918,1441912,2024-05-09,Senate,"Consent Calendar 2nd SB933 Wahab et al",37,0,0,3,40
1814918,1458288,2024-06-18,Assembly,"Do pass and be re-referred to the Committee on [Privacy and Consumer Protection] with recommendation: To Consent Calendar",7,0,0,1,8
1814918,1462635,2024-07-02,Assembly,"Do pass as amended, and be re-referred to the Committee on [Appropriations] with recommendation: To Consent Calendar",11,0,0,0,11
1814919,1424940,2024-04-09,Senate,"Do pass, but first be re-referred to the Committee on [Energy, Utilities and Communications]",11,1,0,3,15
1814919,1433033,2024-04-22,Senate,"Do pass, but first be re-referred to the Committee on [Appropriations]",14,1,0,3,18
1814919,1439689,2024-05-06,Senate,"Placed on suspense file",7,0,0,0,7
1814919,1444096,2024-05-16,Senate,"Do pass as amended",5,2,0,0,7
1814919,1450306,2024-05-21,Senate,"Senate 3rd Reading SB934 Gonzalez",31,3,0,6,40
1814919,1458211,2024-06-17,Assembly,"Do pass and be re-referred to the Committee on [Utilities and Energy]",11,0,0,4,15
1814919,1461981,2024-07-01,Assembly,"Do pass and be re-referred to the Committee on [Appropriations] with recommendation: To Consent Calendar",15,0,0,1,16
1814921,1433032,2024-04-23,Senate,"Do pass as amended, but first amend, and re-refer to the Committee on [Appropriations]",4,0,0,1,5
1814921,1448643,2024-05-22,Senate,"Senate 3rd Reading SB935 Becker",39,0,0,1,40
1814922,1402349,2024-03-04,Senate,"Senate 3rd Reading SCR98 Umberg",34,0,0,6,40
1814922,1422100,2024-04-08,Assembly,"Be adopted. To Consent Calendar",10,0,0,1,11
1814922,1427241,2024-04-15,Assembly,"SCR 98 Umberg Senate Third Reading",75,0,0,5,80
1814923,1413831,2024-03-21,Assembly,"Be adopted. To Consent Calendar",8,0,0,3,11
1814923,1416676,2024-02-16,Senate,"Senate 3rd Reading SCR99 Alvarado-Gil et al",33,0,0,7,40
1814923,1421159,2024-04-04,Assembly,"SCR 99 Alvarado-Gil Consent Calendar Second Day Regular Session",70,0,0,10,80
1819719,1424777,2024-04-09,Assembly,"Do pass and be re-referred to the Committee on [Appropriations]",8,0,0,0,8
1819720,1408222,2024-03-12,Assembly,"Do pass as amended, and be re-referred to the Committee on [Appropriations] with recommendation: To Consent Calendar",10,0,0,2,12
1819720,1444344,2024-05-16,Assembly,"Do pass",15,0,0,0,15
1819720,1446008,2024-05-21,Assembly,"AB 1846 Bauer-Kahan Assembly Third Reading",73,0,0,7,80
1819720,1460594,2024-06-25,Senate,"Do pass as amended, but first amend, and re-refer to the Committee on [Appropriations]",11,0,0,0,11
1819720,1463430,2024-08-05,Senate,"Placed on suspense file",7,0,0,0,7
1819723,1408835,2024-03-12,Assembly,"Do pass as amended",10,0,0,1,11
1819723,1445168,2024-05-20,Assembly,"AB 1849 Grayson Assembly Third Reading",72,0,0,8,80
1819723,1458308,2024-06-18,Senate,"Do pass and be ordered to the Consent Calendar",10,0,0,1,11
1819723,1461252,2024-06-27,Senate,"Consent Calendar 2nd AB1849 Grayson",40,0,0,0,40
1819723,1463895,2024-08-12,Assembly,"AB 1849 Grayson Concurrence in Senate Amendments",74,0,0,5,79
1819724,1411376,2024-03-19,Assembly,"Do pass",13,0,0,2,15
1819724,1427232,2024-04-15,Assembly,"AB 1850 Pellerin Assembly Third Reading",73,1,0,6,80
1819724,1450961,2024-05-28,Senate,"Do pass",11,0,0,5,16
1819724,1465260,2024-08-19,Senate,"Assembly 3rd Reading AB1850 Pellerin et al. By Laird",40,0,0,0,40
1819725,1411370,2024-03-19,Assembly,"Do pass and be re-referred to the Committee on [Education]",7,0,0,0,7
1819725,1421176,2024-04-03,Assembly,"Do pass as amended and be re-referred to the Committee on [Appropriations]",7,0,0,0,7
1819725,1444630,2024-05-16,Assembly,"Do pass",15,0,0,0,15
1819725,1445997,2024-05-21,Assembly,"AB 1851 Holden Assembly Third Reading By ARAMBULA",72,0,0,8,80
1819725,1456940,2024-06-12,Senate,"Do pass, but first be re-referred to the Committee on [Environmental Quality] with the recommendation: To Consent Calendar",7,0,0,0,7
1819725,1462521,2024-07-03,Senate,"Do pass, but first be re-referred to the Committee on [Appropriations] with the recommendation: To Consent Calendar",7,0,0,0,7
1819725,1463468,2024-08-05,Senate,"Placed on suspense file",7,0,0,0,7
1819726,1412591,2024-03-20,Assembly,"Do pass. To Consent Calendar",8,0,0,1,9
1819726,1421187,2024-04-04,Assembly,"AB 1852 Pacheco Consent Calendar Second Day Regular Session",70,0,0,10,80
1819726,1451559,2024-05-29,Senate,"Do pass, but first be re-referred to the Committee on [Judiciary] with the recommendation: To Consent Calendar",7,0,0,0,7
1819726,1453393,2024-06-04,Senate,"Do pass and be ordered to the Consent Calendar",11,0,0,0,11
1819726,1455812,2024-06-10,Senate,"Consent Calendar 2nd AB1852 Pacheco et al",37,0,0,3,40
1819727,1412571,2024-03-20,Assembly,"Do pass",8,0,0,1,9
1819727,1435220,2024-04-25,Assembly,"AB 1853 Villapudua Assembly Third Reading",75,0,0,5,80
1819727,1456412,2024-06-11,Senate,"Do pass",15,0,0,0,15
1819727,1465357,2024-08-20,Senate,"Assembly 3rd Reading AB1853 Villapudua et al. By Wilk",40,0,0,0,40
1819727,1465515,2024-08-22,Assembly,"AB 1853 Villapudua Concurrence in Senate Amendments",62,0,0,17,79
1819728,1424912,2024-04-09,Assembly,"Do pass. To Consent Calendar",10,0,0,0,10
1819728,1431015,2024-04-18,Assembly,"AB 1854 Schiavo Consent Calendar Second Day Regular Session",72,0,0,8,80
1819728,1460049,2024-06-24,Senate,"Do pass and be ordered to the Consent Calendar",5,0,0,0,5
1819728,1462067,2024-07-01,Senate,"Consent Calendar 2nd AB1854 Schiavo",40,0,0,0,40
1819728,1462682,2024-07-03,Assembly,"AB 1854 Schiavo Concurrence in Senate Amendments",73,0,0,6,79
1819729,1382176,2024-02-12,Assembly,"Be adopted. To third reading",8,0,0,3,11
1819729,1409571,2024-03-14,Senate,"Special Consent ACR127 Irwin et al",38,0,0,2,40
1819730,1376399,2024-02-05,Assembly,"Be adopted. To Consent Calendar",7,0,0,4,11
1819730,1380155,2024-02-08,Assembly,"HR 65 Wallis Consent Calendar Second Day",72,0,0,8,80
1819731,1430006,2024-04-17,Senate,"Do pass as amended, but first amend, and re-refer to the Committee on [Transportation]",7,0,0,0,7
1819731,1434094,2024-04-23,Senate,"Do pass as amended, but first amend, and re-refer to the Committee on [Appropriations]",14,1,0,0,15
1819731,1442577,2024-05-13,Senate,"Placed on suspense file",7,0,0,0,7
1819731,1444179,2024-05-16,Senate,"Do pass as amended",7,0,0,0,7
1819731,1449584,2024-05-23,Senate,"Senate 3rd Reading SB936 Seyarto et al",36,0,0,4,40
1819731,1462345,2024-07-01,Assembly,"Do pass and be re-referred to the Committee on [Appropriations] with recommendation: To Consent Calendar",15,0,0,0,15
1819731,1464256,2024-08-15,Assembly,"Do pass as amended",11,0,0,4,15
1819731,1465682,2024-08-26,Assembly,"SB 936 Seyarto Senate Third Reading By Lackey",76,0,0,3,79
1819731,1466980,2024-08-28,Senate,"Unfinished Business SB936 Seyarto et al. Concurrence",39,0,0,1,40
1819732,1420108,2024-04-03,Senate,"Do pass as amended, but first amend, and re-refer to the Committee on [Housing]",6,0,0,1,7
1819732,1428998,2024-04-16,Senate,"Do pass, but first be re-referred to the Committee on [Appropriations]",9,0,0,1,10
1819732,1445205,2024-05-20,Senate,"Senate 3rd Reading SB937 Wiener et al",36,0,0,4,40
1819732,1456931,2024-06-12,Assembly,"Do pass as amended and be re-referred to the Committee on [Housing and Community Development]",8,0,0,1,9
1819732,1460768,2024-06-26,Assembly,"Do pass as amended and be re-referred to the Committee on [Appropriations]",8,0,0,1,9
1819732,1463751,2024-08-07,Assembly,"Do pass",11,1,0,3,15
1819732,1465882,2024-08-27,Assembly,"SB 937 Wiener Senate Third Reading By Joe Patterson",63,1,0,15,79
1819732,1466908,2024-08-28,Senate,"Unfinished Business SB937 Wiener et al. Concurrence",30,1,0,9,40
1819733,1428770,2024-04-16,Senate,"Do pass as amended, but first amend, and re-refer to the Committee on [Appropriations]",8,4,0,6,18
1819733,1428771,2024-04-16,Senate,"[First] hearing set for [04-16-2024]: Failed passage in Committee. Reconsideration granted",18,0,0,0,18
1819733,1432973,2024-04-22,Senate,"Do pass as amended, but first amend, and re-refer to the Committee on [Appropriations]",9,3,0,6,18
1819734,1429955,2024-04-17,Senate,"Do pass as amended, but first amend, and re-refer to the Committee on [Appropriations]",7,0,0,0,7
1819734,1439693,2024-05-06,Senate,"Placed on suspense file",7,0,0,0,7
1819734,1444157,2024-05-16,Senate,"Do pass",7,0,0,0,7
1819734,1449594,2024-05-23,Senate,"Special Consent SB939 Umberg",37,0,0,3,40
1819734,1456950,2024-06-12,Assembly,"Do pass as amended, and be re-referred to the Committee on [Higher Education] with recommendation: To Consent Calendar",7,0,0,0,7
1819734,1462364,2024-07-02,Assembly,"Do pass and be re-referred to the Committee on [Appropriations] with recommendation: To Consent Calendar",11,0,0,0,11
1819734,1463757,2024-08-07,Assembly,"Do pass. To Consent Calendar",14,0,0,1,15
1819734,1464004,2024-08-15,Assembly,"SB 939 Umberg Consent Calendar Second Day Regular Session",75,0,0,4,79
1819734,1465495,2024-08-22,Senate,"Special Consent SB939 Umberg",33,0,0,7,40
1819735,1437655,2024-04-30,Senate,"Do pass as amended",9,1,0,1,11
1819735,1450331,2024-05-21,Senate,"Senate 3rd Reading SB940 Umberg",30,9,0,1,40
1819735,1456369,2024-06-11,Assembly,"Do pass as amended",8,3,0,1,12
1819735,1465944,2024-08-27,Assembly,"SB 940 Umberg Senate Third Reading By Haney",56,16,0,7,79
1819735,1467019,2024-08-28,Senate,"Unfinished Business SB940 Umberg Concurrence",31,6,0,3,40
1819736,1434100,2024-04-24,Senate,"Do pass, but first be re-referred to the Committee on [Appropriations]",5,0,0,2,7
1819736,1442570,2024-05-13,Senate,"Placed on suspense file",7,0,0,0,7
1819736,1444015,2024-05-16,Senate,"Do pass as amended",5,2,0,0,7
1819736,1450279,2024-05-21,Senate,"Senate 3rd Reading SB941 Skinner",31,5,0,4,40
1819736,1457990,2024-06-17,Assembly,"Do pass and be re-referred to the Committee on [Appropriations] with recommendation: To Consent Calendar",10,0,0,1,11
1819736,1464567,2024-08-15,Assembly,"Do pass",14,0,0,1,15
1819736,1465711,2024-08-26,Assembly,"SB 941 Skinner Senate Third Reading By Berman",75,1,0,3,79
1819737,1428810,2024-04-16,Senate,"Do pass, but first be re-referred to the Committee on [Governmental Organization]",10,1,0,0,11
1819737,1432949,2024-04-23,Senate,"Do pass, but first be re-referred to the Committee on [Appropriations]",11,1,0,4,16
1819737,1439725,2024-05-06,Senate,"Placed on suspense file",7,0,0,0,7
1819737,1444639,2024-05-16,Senate,"Do pass as amended",5,0,0,2,7
1819737,1450335,2024-05-21,Senate,"Senate 3rd Reading SB942 Becker",32,1,0,7,40
1819737,1458165,2024-06-18,Assembly,"Do pass as amended and be re-referred to the Committee on [Judiciary]",8,0,0,3,11
1819737,1462287,2024-07-02,Assembly,"Do pass as amended and be re-referred to the Committee on [Appropriations]",9,1,0,2,12
1819737,1464311,2024-08-15,Assembly,"Do pass as amended",11,0,0,4,15
1819737,1466089,2024-08-29,Senate,"Unfinished Business SB942 Becker Concurrence",35,2,0,3,40
1819737,1466635,2024-08-28,Assembly,"SB 942 Becker Senate Third Reading By Kalra",73,0,0,6,79
1819738,1382166,2024-02-12,Senate,"Senate 3rd Reading SR54 Min",35,0,0,5,40
1819739,1369546,2024-01-25,Senate,"Senate 3rd Reading SR55 Alvarado-Gil",34,0,0,6,40
1821698,1412510,2024-03-20,Assembly,"Do pass as amended and be re-referred to the Committee on [Higher Education]",8,0,0,1,9
1821698,1423804,2024-04-09,Assembly,"Do pass",7,2,0,2,11
1821698,1431926,2024-04-22,Assembly,"AB 1855 Arambula Assembly Third Reading",53,12,0,15,80
1821698,1451577,2024-05-29,Senate,"Do pass, but first be re-referred to the Committee on [Education]",5,2,0,0,7
1821698,1456964,2024-06-12,Senate,"Do pass",5,2,0,0,7
1821698,1465352,2024-08-20,Senate,"Assembly 3rd Reading AB1855 Arambula By Portantino",30,9,0,1,40
1821698,1465757,2024-08-26,Assembly,"AB 1855 Arambula Concurrence in Senate Amendments",60,12,0,7,79
1821699,1429003,2024-04-16,Assembly,"Do pass and be re-referred to the Committee on [Appropriations]",8,0,0,0,8
1821699,1435327,2024-04-23,Assembly,"Do pass as amended and be re-referred to the Committee on [Appropriations]",9,0,0,2,11
1821699,1444464,2024-05-16,Assembly,"Do pass as amended",10,0,0,5,15
1821699,1448781,2024-05-22,Assembly,"AB 1856 Ta Assembly Third Reading",62,0,0,18,80
1821699,1460066,2024-06-25,Senate,"Do pass as amended, but first amend, and re-refer to the Committee on [Appropriations]",4,0,0,1,5
1821699,1463679,2024-08-05,Senate,"Placed on suspense file",7,0,0,0,7
1821701,1411315,2024-03-19,Assembly,"Do pass and be re-referred to the Committee on [Appropriations]",8,2,0,1,11
1821702,1424924,2024-04-10,Assembly,"Do pass as amended and be re-referred to the Committee on [Appropriations]",6,0,0,1,7
1821702,1444092,2024-05-16,Assembly,"Do pass",11,1,0,3,15
1821702,1446070,2024-05-21,Assembly,"AB 1858 Ward Assembly Third Reading",61,0,0,19,80
1821702,1458509,2024-06-19,Senate,"Do pass as amended, but first amend, and re-refer to the Committee on [Appropriations]",7,0,0,0,7
1821702,1463602,2024-08-05,Senate,"Placed on suspense file",7,0,0,0,7
1821702,1464475,2024-08-15,Senate,"Do pass",6,0,0,1,7
1821702,1466522,2024-08-30,Senate,"Assembly 3rd Reading AB1858 Ward et al. By Wilk",40,0,0,0,40
1821702,1467020,2024-08-31,Assembly,"AB 1858 Ward Concurrence in Senate Amendments",66,0,0,13,79
1821703,1396935,2024-02-27,Assembly,"Do pass and be re-referred to the Committee on [Appropriations] with recommendation: To Consent Calendar",8,0,0,0,8
1821703,1444161,2024-05-16,Assembly,"Do pass",15,0,0,0,15
1821703,1449723,2024-05-23,Assembly,"AB 1859 Alanis Assembly Third Reading",72,0,0,8,80
1821703,1458254,2024-06-18,Senate,"Do pass, but first be re-referred to the Committee on [Health] with the recommendation: To Consent Calendar",5,0,0,0,5
1821703,1460777,2024-06-26,Senate,"Do pass, but first be re-referred to the Committee on [Appropriations] with the recommendation: To Consent Calendar",11,0,0,0,11
1821703,1463896,2024-08-12,Senate,"Placed on suspense file",7,0,0,0,7
1821703,1464427,2024-08-15,Senate,"Do pass as amended",7,0,0,0,7
1821703,1466086,2024-08-29,Senate,"Assembly 3rd Reading AB1859 Alanis By Seyarto",40,0,0,0,40
1821703,1466451,2024-08-30,Assembly,"AB 1859 Alanis Concurrence in Senate Amendments",77,0,0,2,79
1821705,1436912,2024-04-29,Assembly,"Do pass and be re-referred to the Committee on [Appropriations]",7,0,0,0,7
1821706,1424842,2024-04-10,Assembly,"Do pass and be re-referred to the Committee on [Appropriations] with recommendation: To Consent Calendar",9,0,0,1,10
1821706,1444516,2024-05-16,Assembly,"Do pass",15,0,0,0,15
1821706,1446020,2024-05-21,Assembly,"AB 1861 Addis Assembly Third Reading",73,0,0,7,80
1821706,1458304,2024-06-18,Senate,"Do pass, but first be re-referred to the Committee on [Judiciary] with the recommendation: To Consent Calendar",5,0,0,0,5
1821706,1460497,2024-06-25,Senate,"Do pass, but first be re-referred to the Committee on [Appropriations] with the recommendation: To Consent Calendar",11,0,0,0,11
1821706,1463845,2024-08-12,Senate,"Consent Calendar 2nd AB1861 Addis et al. By Dodd",38,0,0,2,40
1821707,1433030,2024-04-23,Assembly,"Do pass and be re-referred to the Committee on [Appropriations] with recommendation: To Consent Calendar",17,0,0,1,18
1821707,1437604,2024-05-01,Assembly,"Do pass. To Consent Calendar",14,0,0,1,15
1821707,1445134,2024-05-20,Assembly,"AB 1862 Chen Assembly Third Reading",68,0,0,12,80
1821707,1459390,2024-06-24,Senate,"Do pass, but first be re-referred to the Committee on [Judiciary] with the recommendation: To Consent Calendar",12,0,0,1,13
1821707,1462621,2024-07-02,Senate,"Do pass as amended, but first amend, and re-refer to the Committee on [Appropriations] with the recommendation: To Consent Calendar",11,0,0,0,11
1821707,1466255,2024-08-29,Senate,"Assembly 3rd Reading AB1862 Chen By Wilk",40,0,0,0,40
1821707,1466576,2024-08-30,Assembly,"AB 1862 Chen Concurrence in Senate Amendments",77,0,0,2,79
1821708,1423870,2024-04-08,Assembly,"Do pass and be re-referred to the Committee on [Public Safety] with recommendation: To Consent Calendar",7,0,0,1,8
1821708,1433160,2024-04-23,Assembly,"Do pass and be re-referred to the Committee on [Appropriations] with recommendation: To Consent Calendar",8,0,0,0,8
1821708,1444379,2024-05-16,Assembly,"Do pass as amended",11,0,0,4,15
1821708,1448744,2024-05-22,Assembly,"AB 1863 Ramos Assembly Third Reading",70,0,0,10,80
1821708,1460008,2024-06-25,Senate,"Do pass, but first be re-referred to the Committee on [Appropriations] with the recommendation: To Consent Calendar",5,0,0,0,5
1821708,1463867,2024-08-12,Senate,"Consent Calendar 2nd AB1863 Ramos et al",38,0,0,2,40
1821710,1424822,2024-04-09,Assembly,"Do pass and be re-referred to the Committee on [Education]",5,1,0,1,7
1821710,1435322,2024-04-24,Assembly,"Do pass and be re-referred to the Committee on [Appropriations]",4,1,0,2,7
1821710,1444498,2024-05-16,Assembly,"Do pass as amended",11,4,0,0,15
1821710,1445962,2024-05-21,Assembly,"AB 1864 Connolly Assembly Third Reading",47,14,0,19,80
1821710,1458411,2024-06-19,Senate,"Do pass as amended, but first amend, and re-refer to the Committee on [Agriculture]",4,2,0,1,7
1821710,1462249,2024-07-02,Senate,"Do pass, but first be re-referred to the Committee on [Appropriations]",4,0,0,1,5
1821710,1463919,2024-08-12,Senate,"Placed on suspense file",7,0,0,0,7
1821710,1464442,2024-08-15,Senate,"Do pass as amended",5,2,0,0,7
1821710,1465833,2024-08-27,Senate,"Assembly 3rd Reading AB1864 Connolly et al. By Hurtado",33,5,0,2,40
1821710,1466777,2024-08-28,Assembly,"AB 1864 Connolly Concurrence in Senate Amendments",64,10,0,5,79
1821712,1436903,2024-04-29,Assembly,"Do pass and be re-referred to the Committee on [Appropriations]",7,0,0,0,7
1821713,1411362,2024-03-19,Assembly,"Do pass and be re-referred to the Committee on [Appropriations]",7,3,0,1,11
1821713,1444276,2024-05-16,Assembly,"Do pass",10,4,0,1,15
1821713,1445974,2024-05-21,Assembly,"AB 1866 Hart Assembly Third Reading",49,17,0,14,80
1821713,1456346,2024-06-11,Senate,"Do pass, but first be re-referred to the Committee on [Judiciary]",6,4,0,1,11
1821713,1459410,2024-06-24,Senate,"Placed on suspense file",6,0,0,1,7
1821713,1464400,2024-08-15,Senate,"Do pass",4,2,0,1,7
1821713,1466253,2024-08-29,Assembly,"AB 1866 Hart Concurrence in Senate Amendments",48,17,0,14,79
1821713,1466895,2024-08-28,Senate,"Assembly 3rd Reading AB1866 Hart et al. By Lim√≥n",29,8,0,3,40
1821716,1423798,2024-04-08,Assembly,"Do pass as amended and be re-referred to the Committee on [Appropriations]",7,0,0,0,7
1821716,1437628,2024-05-01,Assembly,"Do pass",14,0,0,1,15
1821716,1441973,2024-05-09,Assembly,"AB 1868 Friedman Assembly Third Reading",66,0,0,14,80
1821716,1456885,2024-06-12,Senate,"Do pass as amended, but first amend, and re-refer to the Committee on [Appropriations]",6,0,0,1,7
1821716,1459349,2024-06-24,Senate,"Placed on suspense file",6,0,0,1,7
1821716,1464571,2024-08-15,Senate,"Do pass",7,0,0,0,7
1821716,1466322,2024-08-29,Assembly,"AB 1868 Friedman Concurrence in Senate Amendments",76,0,0,3,79
1821716,1466759,2024-08-28,Senate,"Assembly 3rd Reading AB1868 Friedman et al. By Dahle",39,0,0,1,40
1821719,1457973,2024-06-17,Assembly,"Be adopted. To third reading",10,0,0,1,11
1821719,1463863,2024-08-12,Assembly,"ACR 128 Arambula Assembly Third Reading",76,0,0,3,79
1821719,1465511,2024-08-22,Senate,"Special Consent ACR128 Arambula By Hurtado",33,0,0,7,40
1821721,1424815,2024-04-10,Senate,"Do pass, but first be re-referred to the Committee on [Military and Veterans Affairs] with the recommendation: To Consent Calendar",5,0,0,0,5
1821721,1431950,2024-04-22,Senate,"Do pass, but first be re-referred to the Committee on [Appropriations]",5,0,0,0,5
1821721,1439721,2024-05-06,Senate,"Placed on suspense file",7,0,0,0,7
1821724,1412567,2024-03-20,Senate,"Do pass as amended, but first amend, and re-refer to the Committee on [Environmental Quality] with the recommendation: To Consent Calendar",11,0,0,0,11
1821724,1430029,2024-04-17,Senate,"Do pass, but first be re-referred to the Committee on [Appropriations] with the recommendation: To Consent Calendar",7,0,0,0,7
1821724,1436218,2024-04-29,Senate,"Placed on suspense file",5,0,0,2,7
1821724,1444104,2024-05-16,Senate,"Do pass as amended",7,0,0,0,7
1821724,1450001,2024-05-24,Senate,"Special Consent SB945 Alvarado-Gil et al",38,0,0,2,40
1821724,1460002,2024-06-25,Assembly,"Do pass and be re-referred to the Committee on [Natural Resources] with recommendation: To Consent Calendar",16,0,0,0,16
1821724,1462084,2024-07-01,Assembly,"Do pass and be re-referred to the Committee on [Appropriations] with recommendation: To Consent Calendar",12,0,0,0,12
1821725,1441344,2024-05-08,Senate,"Do pass, but first be re-referred to the Committee on [Appropriations] with the recommendation: To Consent Calendar",6,0,0,1,7
1821725,1442619,2024-05-13,Senate,"Placed on suspense file",7,0,0,0,7
1821725,1444552,2024-05-16,Senate,"Do pass",7,0,0,0,7
1821725,1449664,2024-05-23,Senate,"Special Consent SB946 McGuire",37,0,0,3,40
1821725,1462312,2024-07-01,Assembly,"Do pass as amended and be re-referred to the Committee on [Appropriations]",6,0,0,1,7
1821725,1464527,2024-08-15,Assembly,"Do pass",14,0,0,1,15
1821725,1465612,2024-08-26,Assembly,"SB 946 McGuire Senate Third Reading By Wood",77,0,0,2,79
1821725,1467186,2024-08-28,Senate,"Special Consent SB946 McGuire",39,0,0,1,40
1821728,1436904,2024-04-30,Senate,"Do pass and be ordered to the Consent Calendar",7,0,0,0,7
1821728,1441935,2024-05-09,Senate,"Consent Calendar 2nd SB948 Lim√≥n et al",37,0,0,3,40
1821728,1456889,2024-06-12,Assembly,"Do pass as amended. To Consent Calendar",8,0,0,0,8
1821728,1459334,2024-06-24,Assembly,"SB 948 Lim√≥n Consent Calendar Second Day",76,0,0,3,79
1821728,1461234,2024-06-27,Senate,"Special Consent SB948 Lim√≥n et al",40,0,0,0,40
1821729,1420183,2024-04-02,Senate,"Do pass, but first be re-referred to the Committee on [Appropriations] with the recommendation: To Consent Calendar",11,0,0,0,11
1821729,1435270,2024-04-25,Senate,"Consent Calendar 2nd SB949 Blakespear",36,0,0,4,40
1821729,1453438,2024-06-04,Assembly,"Do pass as amended, and be re-referred to the Committee on [Appropriations] with recommendation: To Consent Calendar",8,0,0,4,12
1821729,1458536,2024-06-19,Assembly,"Do pass. To Consent Calendar",14,0,0,1,15
1821729,1460557,2024-06-26,Assembly,"SB 949 Blakespear Consent Calendar Second Day Regular Session",75,0,0,4,79
1821729,1462497,2024-07-03,Senate,"Special Consent SB949 Blakespear et al",39,0,0,1,40
1821731,1423762,2024-04-09,Senate,"Do pass, but first be re-referred to the Committee on [Appropriations]",5,0,0,0,5
1821731,1436219,2024-04-29,Senate,"Placed on suspense file",5,0,0,2,7
1821731,1444221,2024-05-16,Senate,"Do pass as amended",7,0,0,0,7
1821731,1448631,2024-05-22,Senate,"Senate 3rd Reading SB950 Skinner et al",39,0,0,1,40
1821731,1458215,2024-06-18,Assembly,"Do pass and be re-referred to the Committee on [Appropriations] with recommendation: To Consent Calendar",7,0,0,1,8
1821731,1464099,2024-08-15,Assembly,"Do pass as amended",11,0,0,4,15
1821732,1423732,2024-04-09,Senate,"Do pass, but first be re-referred to the Committee on [Housing]",10,0,0,1,11
1821732,1428756,2024-04-16,Senate,"Do pass, but first be re-referred to the Committee on [Appropriations]",10,0,0,0,10
1821732,1436164,2024-04-29,Senate,"Placed on suspense file",5,0,0,2,7
1821732,1444234,2024-05-16,Senate,"Do pass",7,0,0,0,7
1821732,1450326,2024-05-21,Senate,"Senate 3rd Reading SB951 Wiener",37,0,0,3,40
1821732,1458018,2024-06-17,Assembly,"Do pass as amended and be re-referred to the Committee on [Housing and Community Development]",9,0,0,2,11
1821732,1460631,2024-06-26,Assembly,"Do pass as amended and be re-referred to the Committee on [Appropriations]",9,0,0,0,9
1821732,1464169,2024-08-15,Assembly,"Do pass",14,0,0,1,15
1821732,1465566,2024-08-26,Assembly,"SB 951 Wiener Senate Third Reading By Haney",76,0,0,3,79
1821732,1466289,2024-08-29,Senate,"Unfinished Business SB951 Wiener Concurrence",38,0,0,2,40
1821733,1436204,2024-04-29,Senate,"Senate 3rd Reading SCR100 Nguyen",32,0,0,8,40
1821733,1457993,2024-06-17,Assembly,"Be adopted. To Consent Calendar",10,0,0,1,11
1821733,1458790,2024-06-20,Assembly,"SCR 100 Nguyen Consent Calendar Second Day Regular Session",67,0,0,12,79
1821734,1439612,2024-05-06,Senate,"Senate 3rd Reading SCR101 Nguyen",38,0,0,2,40
1821734,1457983,2024-06-17,Assembly,"Be adopted. To Consent Calendar",10,0,0,1,11
1821734,1458796,2024-06-20,Assembly,"SCR 101 Nguyen Consent Calendar Second Day Regular Session",67,0,0,12,79
1821735,1424976,2024-04-09,Senate,"Be adopted, but first be re-referred to the Committee on [Appropriations] with recommendation: To Consent Calendar",15,0,0,0,15
1821735,1435319,2024-04-25,Senate,"Consent Calendar 2nd SCR102 Alvarado-Gil",36,0,0,4,40
1821735,1458285,2024-06-17,Assembly,"Be adopted. To Consent Calendar",15,0,0,0,15
1821735,1458794,2024-06-20,Assembly,"SCR 102 Alvarado-Gil Consent Calendar Second Day Regular Session",67,0,0,12,79
1821736,1427345,2024-04-15,Senate,"Be adopted as amended",9,0,0,2,11
1821736,1431917,2024-04-22,Senate,"Senate 3rd Reading SJR10 Dodd et al",36,0,0,4,40
1821737,1407468,2024-03-11,Senate,"Senate 3rd Reading SR56 Skinner",38,0,0,2,40
1821739,1374213,2024-02-01,Senate,"Senate 3rd Reading SR58 Caballero",34,0,0,6,40
1821740,1380148,2024-02-08,Senate,"Senate 3rd Reading SR59 Newman",34,0,0,6,40
1824465,1420085,2024-04-03,Assembly,"Do pass and be re-referred to the Committee on [Appropriations]",12,0,0,3,15
1824465,1429936,2024-04-17,Assembly,"Do pass. To Consent Calendar",15,0,0,0,15
1824465,1435359,2024-04-25,Assembly,"AB 1870 Ortega Consent Calendar Second Day Regular Session",75,0,0,5,80
1824465,1454272,2024-06-05,Senate,"Do pass, but first be re-referred to the Committee on [Appropriations] with the recommendation: To Consent Calendar",5,0,0,0,5
1824465,1458810,2024-06-20,Senate,"Consent Calendar 2nd AB1870 Ortega",36,0,0,4,40
1824466,1412573,2024-03-20,Assembly,"Do pass as amended, and be re-referred to the Committee on [Appropriations] with recommendation: To Consent Calendar",7,0,0,0,7
1824466,1429988,2024-04-17,Assembly,"Do pass. To Consent Calendar",15,0,0,0,15
1824466,1435250,2024-04-25,Assembly,"AB 1871 Alanis Consent Calendar Second Day Regular Session",75,0,0,5,80
1824466,1451603,2024-05-29,Senate,"Do pass, but first be re-referred to the Committee on [Appropriations] with the recommendation: To Consent Calendar",7,0,0,0,7
1824466,1457364,2024-06-13,Senate,"Consent Calendar 2nd AB1871 Alanis et al",37,0,0,3,40
1824466,1466316,2024-08-29,Senate,"Assembly 3rd Reading AB1871 Alanis et al. By Seyarto",40,0,0,0,40
1824466,1466408,2024-08-30,Assembly,"AB 1871 Alanis Concurrence in Senate Amendments",77,0,0,2,79
1824467,1424778,2024-04-09,Assembly,"Do pass and be re-referred to the Committee on [Appropriations]",7,0,0,1,8
1824469,1408207,2024-03-12,Assembly,"Do pass as amended and be re-referred to the Committee on [Appropriations]",8,0,0,0,8
1824469,1444236,2024-05-16,Assembly,"Do pass",14,0,0,1,15
1824469,1445973,2024-05-21,Assembly,"AB 1874 Sanchez Assembly Third Reading",68,0,0,12,80
1824469,1458170,2024-06-18,Senate,"Do pass, but first be re-referred to the Committee on [Appropriations]",4,0,0,1,5
1824469,1462002,2024-07-01,Senate,"Placed on suspense file",7,0,0,0,7
1824469,1464193,2024-08-15,Senate,"Do pass",7,0,0,0,7
1824469,1466538,2024-08-30,Senate,"Assembly 3rd Reading AB1874 Sanchez By Seyarto",40,0,0,0,40
1824469,1467091,2024-08-31,Assembly,"AB 1874 Sanchez Concurrence in Senate Amendments",73,0,0,6,79
1824470,1396934,2024-02-27,Assembly,"Do pass and be re-referred to the Committee on [Appropriations] with recommendation: To Consent Calendar",8,0,0,0,8
1824470,1412585,2024-03-20,Assembly,"Do pass. To Consent Calendar",12,0,0,3,15
1824470,1421162,2024-04-04,Assembly,"AB 1875 McKinnor Consent Calendar Second Day Regular Session",70,0,0,10,80
1824470,1450935,2024-05-28,Senate,"Do pass, but first be re-referred to the Committee on [Appropriations] with the recommendation: To Consent Calendar",4,0,0,1,5
1824470,1457319,2024-06-13,Senate,"Consent Calendar 2nd AB1875 McKinnor et al",37,0,0,3,40
1824471,1419157,2024-04-02,Assembly,"Do pass and be re-referred to the Committee on [Judiciary] with recommendation: To Consent Calendar",7,0,0,0,7
1824471,1423824,2024-04-09,Assembly,"Do pass and be re-referred to the Committee on [Appropriations] with recommendation: To Consent Calendar",12,0,0,0,12
1824471,1437611,2024-05-01,Assembly,"Do pass. To Consent Calendar",14,0,0,1,15
1824471,1441948,2024-05-09,Assembly,"AB 1876 Jackson Consent Calendar Second Day Regular Session",65,0,0,15,80
1824471,1458283,2024-06-17,Senate,"Do pass, but first be re-referred to the Committee on [Judiciary] with the recommendation: To Consent Calendar",5,0,0,0,5
1824471,1462462,2024-07-02,Senate,"Do pass, but first be re-referred to the Committee on [Appropriations] with the recommendation: To Consent Calendar",11,0,0,0,11
1824472,1408219,2024-03-12,Assembly,"Do pass as amended and be re-referred to the Committee on [Appropriations]",6,0,0,2,8
1824472,1444663,2024-05-16,Assembly,"Do pass",11,3,0,1,15
1824472,1446057,2024-05-21,Assembly,"AB 1877 Jackson Assembly Third Reading",57,11,0,12,80
1824472,1458266,2024-06-18,Senate,"Do pass, but first be re-referred to the Committee on [Appropriations]",4,1,0,0,5
1824472,1462110,2024-07-01,Senate,"Placed on suspense file",7,0,0,0,7
1824472,1464287,2024-08-15,Senate,"Do pass as amended",5,2,0,0,7
1824472,1466016,2024-08-27,Senate,"Assembly 3rd Reading AB1877 Jackson By Bradford",31,8,0,1,40
1824472,1466748,2024-08-28,Assembly,"AB 1877 Jackson Concurrence in Senate Amendments",60,12,0,7,79
1824473,1412550,2024-03-20,Assembly,"Do pass and be re-referred to the Committee on [Appropriations] with recommendation: To Consent Calendar",9,0,0,0,9
1824473,1443928,2024-05-16,Assembly,"Do pass",15,0,0,0,15
1824473,1449687,2024-05-23,Assembly,"AB 1878 Garcia Assembly Third Reading",72,0,0,8,80
1824473,1460059,2024-06-24,Senate,"Do pass, but first be re-referred to the Committee on [Judiciary] with the recommendation: To Consent Calendar",10,0,0,0,10
1824473,1462460,2024-07-02,Senate,"Do pass, but first be re-referred to the Committee on [Appropriations] with the recommendation: To Consent Calendar",11,0,0,0,11
1824473,1463433,2024-08-05,Senate,"Placed on suspense file",7,0,0,0,7
1824473,1464362,2024-08-15,Senate,"Do pass",7,0,0,0,7
1824473,1465942,2024-08-27,Senate,"That the measure be returned to Senate Floor for consideration. Ordered to third reading",7,0,0,0,7
1824473,1466481,2024-08-30,Senate,"Assembly 3rd Reading AB1878 Garcia By Padilla",40,0,0,0,40
1824473,1466996,2024-08-31,Assembly,"AB 1878 Garcia Concurrence in Senate Amendments",77,0,0,2,79
1824474,1408211,2024-03-12,Assembly,"Do pass and be re-referred to the Committee on [Revenue and Taxation] with recommendation: To Consent Calendar",10,0,0,2,12
1824474,1419228,2024-04-01,Assembly,"Do pass and be re-referred to the Committee on [Appropriations] with recommendation: To Consent Calendar",7,0,0,0,7
1824474,1424881,2024-04-10,Assembly,"Do pass. To Consent Calendar",14,0,0,1,15
1824474,1431007,2024-04-18,Assembly,"AB 1879 Gipson Consent Calendar Second Day Regular Session",72,0,0,8,80
1824474,1453414,2024-06-04,Senate,"Do pass, but first be re-referred to the Committee on [Revenue and Taxation] with the recommendation: To Consent Calendar",11,0,0,0,11
1824474,1460470,2024-06-26,Senate,"Do pass, but first be re-referred to the Committee on [Appropriations] with the recommendation: To Consent Calendar",7,0,0,0,7
1824474,1463866,2024-08-12,Senate,"Consent Calendar 2nd AB1879 Gipson",38,0,0,2,40
1824474,1464363,2024-08-15,Assembly,"AB 1879 Gipson Concurrence in Senate Amendments",75,0,0,4,79
1824475,1408225,2024-03-12,Assembly,"Do pass. To Consent Calendar",10,0,0,2,12
1824475,1410547,2024-03-18,Assembly,"AB 1880 Alanis Consent Calendar Second Day",74,0,0,6,80
1824475,1453422,2024-06-04,Senate,"Do pass and be ordered to the Consent Calendar",11,0,0,0,11
1824475,1465302,2024-08-19,Senate,"Assembly 3rd Reading AB1880 Alanis et al. By Rubio",40,0,0,0,40
1824475,1465472,2024-08-22,Assembly,"AB 1880 Alanis Concurrence in Senate Amendments",62,0,0,17,79
1824476,1411323,2024-03-19,Assembly,"Do pass and be re-referred to the Committee on [Appropriations] with recommendation: To Consent Calendar",11,0,0,0,11
1824476,1421185,2024-04-04,Assembly,"AB 1881 Davies Consent Calendar Second Day Regular Session",70,0,0,10,80
1824476,1456448,2024-06-11,Senate,"Do pass and be ordered to the Consent Calendar",11,0,0,0,11
1824476,1458030,2024-06-17,Senate,"Consent Calendar 2nd AB1881 Davies",39,0,0,1,40
1824477,1424945,2024-04-09,Assembly,"Do pass and be re-referred to the Committee on [Transportation]",10,0,0,0,10
1824477,1431991,2024-04-22,Assembly,"Do pass and be re-referred to the Committee on [Appropriations] with recommendation: To Consent Calendar",15,0,0,0,15
1824478,1429963,2024-04-17,Assembly,"Do pass and be re-referred to the Committee on [Appropriations]",15,0,0,0,15
1824478,1444280,2024-05-16,Assembly,"Do pass",14,0,0,1,15
1824478,1446100,2024-05-21,Assembly,"AB 1883 Calderon Assembly Third Reading",72,0,0,8,80
1824479,1412530,2024-03-20,Assembly,"Do pass and be re-referred to the Committee on [Appropriations] with recommendation: To Consent Calendar",7,0,0,0,7
1824479,1444200,2024-05-16,Assembly,"Do pass",15,0,0,0,15
1824479,1446113,2024-05-21,Assembly,"AB 1884 Ward Assembly Third Reading",73,0,0,7,80
1824479,1456927,2024-06-12,Senate,"Do pass, but first be re-referred to the Committee on [Military and Veterans Affairs] with the recommendation: To Consent Calendar",7,0,0,0,7
1824479,1460052,2024-06-24,Senate,"Do pass, but first be re-referred to the Committee on [Appropriations] with the recommendation: To Consent Calendar",5,0,0,0,5
1824479,1463362,2024-08-05,Senate,"Placed on suspense file",7,0,0,0,7
1824479,1464423,2024-08-15,Senate,"Do pass",6,0,0,1,7
1824479,1465797,2024-08-27,Senate,"Assembly 3rd Reading AB1884 Ward By Newman",40,0,0,0,40
1824479,1466727,2024-08-28,Assembly,"AB 1884 Ward Concurrence in Senate Amendments",76,0,0,3,79
1824480,1408229,2024-03-12,Assembly,"Do pass and be re-referred to the Committee on [Appropriations]",10,0,0,1,11
1824480,1444579,2024-05-16,Assembly,"Do pass",15,0,0,0,15
1824480,1445972,2024-05-21,Assembly,"AB 1885 Addis Assembly Third Reading",73,0,0,7,80
1824480,1460611,2024-06-26,Senate,"Do pass, but first be re-referred to the Committee on [Appropriations] with the recommendation: To Consent Calendar",7,0,0,0,7
1824480,1463479,2024-08-05,Senate,"Placed on suspense file",7,0,0,0,7
1824480,1464283,2024-08-15,Senate,"Do pass",7,0,0,0,7
1824480,1466690,2024-08-28,Senate,"Special Consent AB1885 Addis et al. By Ochoa Bogh",39,0,0,1,40
1824481,1424988,2024-04-10,Assembly,"Do pass as amended and be re-referred to the Committee on [Local Government]",7,0,0,2,9
1824481,1435281,2024-04-24,Assembly,"Do pass and be re-referred to the Committee on [Appropriations]",7,0,0,2,9
1824481,1441334,2024-05-08,Assembly,"Do pass",11,0,0,4,15
1824481,1445208,2024-05-20,Assembly,"AB 1886 Alvarez Assembly Third Reading",52,3,0,25,80
1824481,1458424,2024-06-18,Senate,"Do pass, but first be re-referred to the Committee on [Appropriations]",8,2,0,0,10
1824481,1466232,2024-08-29,Senate,"Assembly 3rd Reading AB1886 Alvarez et al. By Skinner",26,7,0,7,40
1824481,1466590,2024-08-30,Assembly,"AB 1886 Alvarez Concurrence in Senate Amendments",56,7,0,16,79
1824482,1410564,2024-03-18,Assembly,"Do pass",10,0,0,1,11
1824482,1410565,2024-03-18,Assembly,"AB 1887 CERVANTES Third Reading Urgency",74,0,0,6,80
1824482,1412563,2024-03-20,Senate,"Do pass, but first be re-referred to the Committee on [Appropriations]",7,0,0,0,7
1824482,1412564,2024-03-20,Senate,"Do pass",7,0,0,0,7
1824482,1413851,2024-03-21,Senate,"Assembly 3rd Reading AB1887 Cervantes By Wiener Urgency Clause",37,0,0,3,40
1824483,1408818,2024-03-13,Assembly,"Do pass and be re-referred to the Committee on [Public Safety] with recommendation: To Consent Calendar",7,0,0,0,7
1824483,1420067,2024-04-02,Assembly,"Do pass and be re-referred to the Committee on [Appropriations] with recommendation: To Consent Calendar",8,0,0,0,8
1824483,1444615,2024-05-16,Assembly,"Do pass as amended",11,0,0,4,15
1824483,1448715,2024-05-22,Assembly,"AB 1888 Arambula Assembly Third Reading",70,0,0,10,80
1824483,1458342,2024-06-18,Senate,"Do pass, but first be re-referred to the Committee on [Labor, Public Employment and Retirement ] with the recommendation: To Consent Calendar",5,0,0,0,5
1824483,1460676,2024-06-26,Senate,"Do pass, but first be re-referred to the Committee on [Appropriations] with the recommendation: To Consent Calendar",5,0,0,0,5
1824483,1463555,2024-08-05,Senate,"Placed on suspense file",7,0,0,0,7
1824483,1464003,2024-08-15,Senate,"Do pass",7,0,0,0,7
1824483,1466187,2024-08-29,Assembly,"AB 1888 Arambula Concurrence in Senate Amendments",76,0,0,3,79
1824483,1466774,2024-08-28,Senate,"Special Consent AB1888 Arambula et al. By Glazer",39,0,0,1,40
1824484,1425889,2024-04-10,Assembly,"Do pass as amended and be re-referred to the Committee on [Water, Parks, and Wildlife]",8,1,0,0,9
1824484,1432924,2024-04-23,Assembly,"Do pass and be re-referred to the Committee on [Appropriations]",10,3,0,2,15
1824484,1441289,2024-05-08,Assembly,"Do pass",10,4,0,1,15
1824484,1445196,2024-05-20,Assembly,"AB 1889 Friedman Assembly Third Reading",53,14,0,13,80
1824484,1456432,2024-06-11,Senate,"Do pass as amended, but first amend, and re-refer to the Committee on [Natural Resources and Water]",4,1,0,2,7
1824484,1460018,2024-06-25,Senate,"Do pass, but first be re-referred to the Committee on [Appropriations]",8,2,0,1,11
1824484,1463484,2024-08-05,Senate,"Placed on suspense file",7,0,0,0,7
1824484,1464145,2024-08-15,Senate,"Do pass as amended",5,2,0,0,7
1824484,1465959,2024-08-27,Senate,"Assembly 3rd Reading AB1889 Friedman et al. By Stern",32,8,0,0,40
1824484,1466799,2024-08-28,Assembly,"AB 1889 Friedman Concurrence in Senate Amendments",57,16,0,6,79
1824485,1408829,2024-03-13,Assembly,"Do pass and be re-referred to the Committee on [Appropriations] with recommendation: To Consent Calendar",7,0,0,0,7
1824485,1424824,2024-04-10,Assembly,"Do pass. To Consent Calendar",14,0,0,1,15
1824485,1430993,2024-04-18,Assembly,"AB 1890 Joe Patterson Consent Calendar Second Day Regular Session",72,0,0,8,80
1824485,1454216,2024-06-05,Senate,"Do pass, but first be re-referred to the Committee on [Appropriations]",5,0,0,0,5
1824485,1465368,2024-08-20,Senate,"Assembly 3rd Reading AB1890 Joe Patterson et al. By Jones",40,0,0,0,40
1824485,1465501,2024-08-22,Assembly,"AB 1890 Joe Patterson Concurrence in Senate Amendments",62,0,0,17,79
1824486,1408244,2024-03-12,Assembly,"Do pass as amended and be re-referred to the Committee on [Appropriations]",10,0,0,1,11
1824486,1424873,2024-04-10,Assembly,"Do pass. To Consent Calendar",14,0,0,1,15
1824486,1431045,2024-04-18,Assembly,"AB 1891 Weber Consent Calendar Second Day Regular Session",72,0,0,8,80
1824486,1451563,2024-05-29,Senate,"Do pass, but first be re-referred to the Committee on [Appropriations]",7,0,0,0,7
1824486,1455785,2024-06-10,Senate,"Placed on suspense file",7,0,0,0,7
1824486,1464341,2024-08-15,Senate,"Do pass",6,0,0,1,7
1824486,1465564,2024-08-26,Senate,"Assembly 3rd Reading AB1891 Weber By Ochoa Bogh",40,0,0,0,40
1824486,1465950,2024-08-27,Assembly,"AB 1891 Weber Concurrence in Senate Amendments",77,0,0,2,79
1824487,1408241,2024-03-12,Assembly,"Do pass as amended and be re-referred to the Committee on [Appropriations]",8,0,0,0,8
1824487,1444465,2024-05-16,Assembly,"Do pass",15,0,0,0,15
1824487,1445970,2024-05-21,Assembly,"AB 1892 Flora Assembly Third Reading",69,0,0,11,80
1824487,1460053,2024-06-25,Senate,"Do pass",5,0,0,0,5
1824487,1465812,2024-08-27,Senate,"Assembly 3rd Reading AB1892 Flora et al. By Seyarto",40,0,0,0,40
1824489,1436203,2024-04-29,Assembly,"Be adopted. To Consent Calendar",9,0,0,2,11
1824489,1438472,2024-05-02,Assembly,"ACR 129 Villapudua Consent Calendar Second Day Regular Session",73,0,0,7,80
1824489,1449716,2024-05-23,Senate,"Special Consent ACR129 Villapudua et al",37,0,0,3,40
1824490,1382161,2024-02-12,Assembly,"Be adopted. To third reading",8,0,0,3,11
1824490,1409558,2024-03-14,Senate,"Special Consent ACR130 Luz Rivas et al",38,0,0,2,40
1824491,1371080,2024-01-29,Assembly,"Be adopted. To Consent Calendar",8,0,0,3,11
1824491,1374190,2024-02-01,Assembly,"ACR 131 Muratsuchi Consent Calendar Second Day",67,0,0,13,80
1824491,1395238,2024-02-26,Senate,"Special Consent ACR131 Muratsuchi et al",37,0,0,3,40
1824492,1371126,2024-01-29,Assembly,"Be adopted. To Consent Calendar",8,0,0,3,11
1824493,1441326,2024-05-08,Senate,"Do pass, but first be re-referred to the Committee on [Appropriations]",5,0,0,2,7
1824493,1442648,2024-05-13,Senate,"Placed on suspense file",7,0,0,0,7
1824494,1412527,2024-03-20,Senate,"Do pass as amended, but first amend, and re-refer to the Committee on [Appropriations]",9,0,0,2,11
1824494,1422095,2024-04-08,Senate,"Placed on suspense file",6,0,0,1,7
1824495,1412579,2024-03-20,Senate,"Do pass, but first be re-referred to the Committee on [Health]",5,2,0,0,7
1824495,1435236,2024-04-24,Senate,"Do pass, but first be re-referred to the Committee on [Appropriations]",9,1,0,1,11
1824495,1442600,2024-05-13,Senate,"Placed on suspense file",7,0,0,0,7
1824495,1444197,2024-05-16,Senate,"Do pass as amended",5,2,0,0,7
1824495,1448812,2024-05-22,Senate,"Senate 3rd Reading SB954 Menjivar et al",29,9,0,2,40
1824495,1456914,2024-06-12,Assembly,"Do pass and be re-referred to the Committee on [Health]",5,0,0,2,7
1824495,1459987,2024-06-25,Assembly,"Do pass and be re-referred to the Committee on [Appropriations]",14,2,0,0,16
1824495,1464069,2024-08-15,Assembly,"Do pass as amended",11,3,0,1,15
1824495,1467108,2024-08-31,Senate,"Unfinished Business SB954 Menjivar et al. Concurrence",31,9,0,0,40
1824495,1467109,2024-08-31,Assembly,"SB 954 Menjivar Senate Third Reading By Bonta",63,7,0,9,79
1824496,1420133,2024-04-03,Senate,"Do pass as amended, but first amend, and re-refer to the Committee on [Appropriations]",6,0,0,1,7
1824496,1427361,2024-04-15,Senate,"Placed on suspense file",6,0,0,1,7
1824497,1412534,2024-03-20,Senate,"Do pass, but first be re-referred to the Committee on [Appropriations]",6,0,0,1,7
1824497,1445242,2024-05-20,Senate,"Senate 3rd Reading SB956 Cortese",32,5,0,3,40
1824497,1456967,2024-06-12,Assembly,"Do pass and be re-referred to the Committee on [Appropriations]",7,0,0,0,7
1824497,1462219,2024-07-02,Assembly,"Do pass. To Consent Calendar",15,0,0,0,15
1824497,1463775,2024-08-08,Assembly,"SB 956 Cortese Consent Calendar Second Day Regular Session",72,0,0,7,79
1824498,1412503,2024-03-20,Senate,"Do pass, but first be re-referred to the Committee on [Judiciary]",9,2,0,0,11
1824498,1420207,2024-04-02,Senate,"Do pass, but first be re-referred to the Committee on [Appropriations]",9,2,0,0,11
1824498,1427303,2024-04-15,Senate,"Placed on suspense file",6,0,0,1,7
1824498,1444029,2024-05-16,Senate,"Do pass",5,2,0,0,7
1824498,1450317,2024-05-21,Senate,"Senate 3rd Reading SB957 Wiener",31,8,0,1,40
1824498,1458187,2024-06-18,Assembly,"Do pass as amended and be re-referred to the Committee on [Privacy and Consumer Protection]",14,1,0,1,16
1824498,1464154,2024-08-15,Assembly,"Do pass as amended",12,0,0,3,15
1824498,1466324,2024-08-29,Senate,"Unfinished Business SB957 Wiener et al. Concurrence",31,9,0,0,40
1824498,1466852,2024-08-28,Assembly,"SB 957 Wiener Senate Third Reading By Zbur",66,0,0,13,79
1824499,1463912,2024-08-12,Senate,"Senate 3rd Reading SCR103 Nguyen",38,0,0,2,40
1824499,1464012,2024-08-15,Assembly,"Be adopted. To Consent Calendar",7,0,0,4,11
1824499,1465517,2024-08-22,Assembly,"SCR 103 Nguyen Consent Calendar Second Day Regular Session",57,0,0,22,79
1824500,1442629,2024-05-13,Senate,"Senate 3rd Reading SCR104 Nguyen",36,0,0,4,40
1824500,1457934,2024-06-17,Assembly,"Be adopted. To Consent Calendar",10,0,0,1,11
1824500,1458776,2024-06-20,Assembly,"SCR 104 Nguyen Consent Calendar Second Day Regular Session",67,0,0,12,79
1826179,1429899,2024-04-17,Assembly,"Do pass and be re-referred to the Committee on [Local Government]",7,0,0,2,9
1826179,1435214,2024-04-24,Assembly,"Do pass as amended and be re-referred to the Committee on [Appropriations]",7,0,0,2,9
1826179,1444396,2024-05-16,Assembly,"Do pass",11,2,0,2,15
1826179,1445945,2024-05-21,Assembly,"AB 1893 Wicks Assembly Third Reading",54,1,0,25,80
1826179,1458475,2024-06-18,Senate,"Do pass as amended, but first amend, and re-refer to the Committee on [Local Government]",7,1,0,2,10
1826179,1462456,2024-07-03,Senate,"Do pass, but first be re-referred to the Committee on [Appropriations]",5,1,0,1,7
1826179,1463892,2024-08-12,Senate,"Placed on suspense file",7,0,0,0,7
1826179,1464178,2024-08-15,Senate,"Do pass",5,1,0,1,7
1826179,1467126,2024-08-31,Senate,"Assembly 3rd Reading AB1893 Wicks By Skinner",27,4,0,9,40
1826179,1467127,2024-08-31,Assembly,"AB 1893 Wicks Concurrence in Senate Amendments",50,9,0,20,79
1826182,1428816,2024-04-16,Assembly,"Do pass and be re-referred to the Committee on [Appropriations]",13,1,0,2,16
1826182,1444415,2024-05-16,Assembly,"Do pass as amended",11,3,0,1,15
1826182,1445986,2024-05-21,Assembly,"AB 1895 Weber Assembly Third Reading",64,1,0,15,80
1826182,1462623,2024-07-03,Senate,"Do pass, but first be re-referred to the Committee on [Appropriations]",9,2,0,0,11
1826182,1463391,2024-08-05,Senate,"Placed on suspense file",7,0,0,0,7
1826182,1464094,2024-08-15,Senate,"Do pass",4,2,0,1,7
1826182,1466302,2024-08-29,Senate,"Assembly 3rd Reading AB1895 Weber et al. By Skinner",31,7,0,2,40
1826182,1466491,2024-08-30,Assembly,"AB 1895 Weber Concurrence in Senate Amendments",70,0,0,9,79
1826183,1420172,2024-04-02,Assembly,"Do pass",2,4,0,2,8
1826183,1420173,2024-04-02,Assembly,Reconsideration,2,6,0,0,8
1826186,1411348,2024-03-19,Assembly,"Do pass and be re-referred to the Committee on [Appropriations]",7,0,0,1,8
1826187,1411322,2024-03-19,Assembly,"Do pass as amended and be re-referred to the Committee on [Public Safety]",10,2,0,0,12
1826187,1434061,2024-04-24,Assembly,"Do pass",11,3,0,1,15
1826187,1445263,2024-05-20,Assembly,"AB 1899 Cervantes Assembly Third Reading By WARD",60,8,0,12,80
1826187,1456443,2024-06-11,Senate,"Do pass, but first be re-referred to the Committee on [Appropriations]",9,2,0,0,11
1826187,1459330,2024-06-24,Senate,"Placed on suspense file",6,0,0,1,7
1826187,1464253,2024-08-15,Senate,"Do pass as amended",5,0,0,2,7
1826187,1466395,2024-08-30,Assembly,"AB 1899 Cervantes Concurrence in Senate Amendments By WARD",63,3,0,13,79
1826187,1466928,2024-08-28,Senate,"Assembly 3rd Reading AB1899 Cervantes et al. By Eggman",34,0,0,6,40
1826188,1419191,2024-04-02,Assembly,"Do pass as amended. To Consent Calendar",12,0,0,0,12
1826188,1427333,2024-04-15,Assembly,"AB 1900 Weber Assembly Third Reading",75,0,0,5,80
1826188,1456286,2024-06-11,Senate,"Do pass and be ordered to the Consent Calendar",11,0,0,0,11
1826188,1458831,2024-06-20,Senate,"Consent Calendar 2nd AB1900 Weber",36,0,0,4,40
1826188,1460471,2024-06-26,Assembly,"AB 1900 Weber Concurrence in Senate Amendments",72,0,0,7,79
1826189,1411339,2024-03-19,Assembly,"Do pass and be re-referred to the Committee on [Appropriations] with recommendation: To Consent Calendar",13,0,0,2,15
1826189,1424963,2024-04-10,Assembly,"Do pass. To Consent Calendar",14,0,0,1,15
1826189,1431056,2024-04-18,Assembly,"AB 1901 Chen Consent Calendar Second Day Regular Session",72,0,0,8,80
1826189,1456295,2024-06-11,Senate,"Do pass, but first be re-referred to the Committee on [Appropriations] with the recommendation: To Consent Calendar",15,0,0,0,15
1826189,1462098,2024-07-01,Senate,"Do pass",6,0,0,1,7
1826189,1466281,2024-08-29,Senate,"Assembly 3rd Reading AB1901 Chen By Niello",40,0,0,0,40
1826189,1466478,2024-08-30,Assembly,"AB 1901 Chen Concurrence in Senate Amendments",77,0,0,2,79
1826190,1423898,2024-04-09,Assembly,"Do pass and be re-referred to the Committee on [Appropriations] with recommendation: To Consent Calendar",18,0,0,0,18
1826190,1434122,2024-04-24,Assembly,"Do pass. To Consent Calendar",14,0,0,1,15
1826190,1438450,2024-05-02,Assembly,"AB 1902 Alanis Consent Calendar Second Day Regular Session",73,0,0,7,80
1826190,1458015,2024-06-17,Senate,"Do pass, but first be re-referred to the Committee on [Appropriations]",12,0,0,1,13
1826190,1465327,2024-08-20,Senate,"Assembly 3rd Reading AB1902 Alanis et al. By Dahle",40,0,0,0,40
1826190,1465429,2024-08-22,Assembly,"AB 1902 Alanis Concurrence in Senate Amendments",62,0,0,17,79
1826191,1408246,2024-03-12,Assembly,"Do pass and be re-referred to the Committee on [Appropriations] with recommendation: To Consent Calendar",10,0,0,2,12
1826191,1412545,2024-03-20,Assembly,"Do pass. To Consent Calendar",12,0,0,3,15
1826191,1421144,2024-04-04,Assembly,"AB 1903 Maienschein Consent Calendar Second Day Regular Session",70,0,0,10,80
1826191,1453434,2024-06-04,Senate,"Do pass, but first be re-referred to the Committee on [Appropriations] with the recommendation: To Consent Calendar",11,0,0,0,11
1826191,1458804,2024-06-20,Senate,"Consent Calendar 2nd AB1903 Maienschein",36,0,0,4,40
1826192,1411350,2024-03-19,Assembly,"Do pass. To Consent Calendar",13,0,0,2,15
1826192,1438473,2024-04-01,Assembly,"AB 1904 Ward Consent Calendar Second Day",72,0,0,8,80
1826192,1451609,2024-05-28,Senate,"Do pass",9,3,0,3,15
1826192,1465335,2024-08-20,Senate,"Assembly 3rd Reading AB1904 Ward By Cortese",32,8,0,0,40
1826193,1423745,2024-04-09,Assembly,"Do pass and be re-referred to the Committee on [Public Employment and Retirement]",11,0,0,0,11
1826193,1429938,2024-04-17,Assembly,"Do pass and be re-referred to the Committee on [Appropriations] with recommendation: To Consent Calendar",7,0,0,0,7
1826193,1444076,2024-05-16,Assembly,"Do pass",15,0,0,0,15
1826193,1445934,2024-05-21,Assembly,"AB 1905 Addis Assembly Third Reading",73,0,0,7,80
1826193,1456882,2024-06-12,Senate,"Do pass, but first be re-referred to the Committee on [Judiciary] with the recommendation: To Consent Calendar",7,0,0,0,7
1826193,1458273,2024-06-18,Senate,"Do pass, but first be re-referred to the Committee on [Appropriations]",10,0,0,1,11
1826193,1463584,2024-08-05,Senate,"Placed on suspense file",7,0,0,0,7
1826193,1464165,2024-08-15,Senate,"Do pass as amended",7,0,0,0,7
1826193,1466211,2024-08-29,Assembly,"AB 1905 Addis Concurrence in Senate Amendments",75,0,0,4,79
1826193,1466695,2024-08-28,Senate,"Assembly 3rd Reading AB1905 Addis et al. By Smallwood-Cuevas",39,0,0,1,40
1826194,1408254,2024-03-12,Assembly,"Do pass as amended. To Consent Calendar",10,0,0,2,12
1826194,1444222,2024-05-16,Assembly,"Do pass",15,0,0,0,15
1826194,1446080,2024-05-21,Assembly,"AB 1906 Gipson Assembly Third Reading",73,0,0,7,80
1826194,1456336,2024-06-11,Senate,"Do pass, but first be re-referred to the Committee on [Appropriations] with the recommendation: To Consent Calendar",11,0,0,0,11
1826194,1465911,2024-08-27,Senate,"Assembly 3rd Reading AB1906 Gipson By Rubio",40,0,0,0,40
1826194,1466847,2024-08-28,Assembly,"AB 1906 Gipson Concurrence in Senate Amendments",77,0,0,2,79
1826195,1408251,2024-03-12,Senate,"Do pass, but first be re-referred to the Committee on [Appropriations] with the recommendation: To Consent Calendar",16,0,0,0,16
1826195,1422050,2024-04-08,Senate,"Placed on suspense file",6,0,0,1,7
1826195,1444621,2024-05-16,Senate,"Do pass",7,0,0,0,7
1826195,1449648,2024-05-23,Senate,"Special Consent SB958 Dodd et al. Urgency Clause",37,0,0,3,40
1826195,1458815,2024-06-19,Assembly,"Do pass and be re-referred to the Committee on [Appropriations] with recommendation: To Consent Calendar",19,0,0,3,22
1826195,1464640,2024-08-15,Assembly,"Do pass",14,0,0,1,15
1826195,1466484,2024-08-30,Senate,"Special Consent SB958 Dodd et al. Urgency Clause",40,0,0,0,40
1826195,1466974,2024-08-28,Assembly,"SB 958 Dodd Third Reading Urgency By Aguiar-Curry",76,0,0,3,79
1826196,1420192,2024-04-03,Senate,"Do pass as amended, but first amend, and re-refer to the Committee on [Appropriations]",8,1,0,2,11
1826196,1427271,2024-04-15,Senate,"Placed on suspense file",6,0,0,1,7
1826196,1444045,2024-05-16,Senate,"Do pass as amended",5,2,0,0,7
1826196,1450309,2024-05-21,Senate,"Senate 3rd Reading SB959 Menjivar et al",31,8,0,1,40
1826196,1456331,2024-06-11,Assembly,"Do pass and be re-referred to the Committee on [Judiciary]",13,3,0,0,16
1826196,1458289,2024-06-18,Assembly,"Do pass and be re-referred to the Committee on [Appropriations]",9,3,0,0,12
1826196,1464303,2024-08-15,Assembly,"Do pass as amended",11,3,0,1,15
1826197,1434158,2024-04-23,Senate,"Do pass, but first be re-referred to the Committee on [Appropriations]",11,4,0,0,15
1826197,1439607,2024-05-06,Senate,"Placed on suspense file",7,0,0,0,7
1826197,1443991,2024-05-16,Senate,"Do pass as amended",5,2,0,0,7
1826197,1448688,2024-05-22,Senate,"Senate 3rd Reading SB960 Wiener et al",28,9,0,3,40
1826197,1462252,2024-07-01,Assembly,"Do pass as amended and be re-referred to the Committee on [Appropriations]",11,4,0,0,15
1826197,1464241,2024-08-15,Assembly,"Do pass as amended",11,3,0,1,15
1826197,1465642,2024-08-26,Assembly,"SB 960 Wiener Senate Third Reading By Friedman",58,17,0,4,79
1826197,1466274,2024-08-29,Senate,"Unfinished Business SB960 Wiener et al. Concurrence",31,9,0,0,40
1826198,1434064,2024-04-23,Senate,"Do pass, but first be re-referred to the Committee on [Appropriations]",8,4,0,3,15
1826198,1450325,2024-05-21,Senate,"Senate 3rd Reading SB961 Wiener",22,13,0,5,40
1826198,1458151,2024-06-17,Assembly,"Do pass as amended and be re-referred to the Committee on [Privacy and Consumer Protection]",9,4,0,2,15
1826198,1462700,2024-07-02,Assembly,"Do pass and be re-referred to the Committee on [Appropriations]",8,3,0,0,11
1826198,1463742,2024-08-07,Assembly,"Do pass",9,4,0,2,15
1826198,1467129,2024-08-31,Senate,"Unfinished Business SB961 Wiener et al. Concurrence",26,9,0,5,40
1826198,1467130,2024-08-31,Assembly,"SB 961 Wiener Senate Third Reading By Lowenthal",47,17,0,15,79
1826199,1429918,2024-04-17,Senate,"Do pass as amended",5,0,0,0,5
1826199,1449669,2024-05-23,Senate,"Senate 3rd Reading SB962 Padilla Urgency Clause",36,0,0,4,40
1826199,1458446,2024-06-19,Assembly,"Do pass. To Consent Calendar",7,0,0,0,7
1826199,1460623,2024-06-26,Assembly,"SB 962 Padilla Consent Calendar Second Day Regular Session",75,0,0,4,79
1826200,1424786,2024-04-10,Senate,"Do pass as amended, but first amend, and re-refer to the Committee on [Rules] with the recommendation: To Consent Calendar",11,0,0,0,11
1826200,1434135,2024-04-23,Senate,"Do pass as amended, but first amend, and re-refer to the Committee on [Appropriations] with the recommendation: To Consent Calendar",11,0,0,0,11
1826200,1444189,2024-05-16,Senate,"Consent Calendar 2nd SB963 Ashby",38,0,0,2,40
1826200,1458351,2024-06-18,Assembly,"Do pass and be re-referred to the Committee on [Judiciary] with recommendation: To Consent Calendar",16,0,0,0,16
1826200,1459949,2024-06-25,Assembly,"Do pass and be re-referred to the Committee on [Appropriations] with recommendation: To Consent Calendar",11,0,0,1,12
1826200,1463733,2024-08-07,Assembly,"Do pass. To Consent Calendar",14,0,0,1,15
1826200,1465671,2024-08-26,Assembly,"SB 963 Ashby Senate Third Reading By Wicks",77,0,0,2,79
1826200,1467075,2024-08-28,Senate,"Special Consent SB963 Ashby et al",39,0,0,1,40
1826201,1434117,2024-04-24,Senate,"Do pass as amended, but first amend, and re-refer to the Committee on [Appropriations]",6,0,0,1,7
1826201,1442645,2024-05-13,Senate,"Placed on suspense file",7,0,0,0,7
1827727,1433027,2024-04-23,Assembly,"Do pass and be re-referred to the Committee on [Appropriations] with recommendation: To Consent Calendar",6,0,0,1,7
1827727,1444116,2024-05-16,Assembly,"Do pass",15,0,0,0,15
1827727,1445933,2024-05-21,Assembly,"AB 1907 Pellerin Assembly Third Reading",73,0,0,7,80
1827727,1462321,2024-07-01,Senate,"Do pass, but first be re-referred to the Committee on [Appropriations]",5,0,0,0,5
1827727,1463656,2024-08-05,Senate,"Placed on suspense file",7,0,0,0,7
1827727,1464374,2024-08-15,Senate,"Do pass as amended",7,0,0,0,7
1827727,1466577,2024-08-30,Senate,"Special Consent AB1907 Pellerin et al",40,0,0,0,40
1827727,1467012,2024-08-31,Assembly,"AB 1907 Pellerin Concurrence in Senate Amendments",77,0,0,2,79
1827728,1424875,2024-04-09,Assembly,"Do pass and be re-referred to the Committee on [Appropriations]",10,0,0,0,10
1827728,1444561,2024-05-16,Assembly,"Do pass",15,0,0,0,15
1827728,1445940,2024-05-21,Assembly,"AB 1908 Schiavo Assembly Third Reading",73,0,0,7,80
1827729,1396929,2024-02-27,Assembly,"Do pass and be re-referred to the Committee on [Appropriations]",8,0,0,0,8
1827732,1419120,2024-04-02,Assembly,"Do pass as amended and be re-referred to the Committee on [Appropriations]",7,0,0,0,7
1827732,1444680,2024-05-16,Assembly,"Do pass as amended",11,0,0,4,15
1827732,1446095,2024-05-21,Assembly,"AB 1911 Reyes Assembly Third Reading",74,0,0,6,80
1827732,1458251,2024-06-17,Senate,"Do pass, but first be re-referred to the Committee on [Appropriations]",5,0,0,0,5
1827732,1462056,2024-07-01,Senate,"Placed on suspense file",7,0,0,0,7
1827733,1408827,2024-03-13,Assembly,"Do pass as amended and be re-referred to the Committee on [Appropriations]",14,0,0,2,16
1827733,1444091,2024-05-16,Assembly,"Do pass as amended",11,1,0,3,15
1827733,1448542,2024-05-22,Assembly,"AB 1912 Pacheco Assembly Third Reading",65,1,0,14,80
1827733,1462243,2024-07-02,Senate,"Do pass as amended, but first amend, and re-refer to the Committee on [Appropriations]",15,1,0,2,18
1827733,1463672,2024-08-05,Senate,"Placed on suspense file",7,0,0,0,7
1827734,1412519,2024-03-20,Assembly,"Do pass and be re-referred to the Committee on [Human Services] with recommendation: To Consent Calendar",7,0,0,0,7
1827734,1432934,2024-04-23,Assembly,"Do pass and be re-referred to the Committee on [Appropriations] with recommendation: To Consent Calendar",6,0,0,1,7
1827734,1441312,2024-05-08,Assembly,"Do pass. To Consent Calendar",15,0,0,0,15
1827734,1444643,2024-05-16,Assembly,"AB 1913 Addis Consent Calendar Second Day Regular Session",71,0,0,9,80
1827734,1454206,2024-06-05,Senate,"Do pass, but first be re-referred to the Committee on [Human Services] with the recommendation: To Consent Calendar",7,0,0,0,7
1827734,1462325,2024-07-01,Senate,"Do pass, but first be re-referred to the Committee on [Appropriations] with the recommendation: To Consent Calendar",5,0,0,0,5
1827734,1465756,2024-08-26,Senate,"Assembly 3rd Reading AB1913 Addis et al. By Blakespear",40,0,0,0,40
1827734,1465789,2024-08-27,Assembly,"AB 1913 Addis Concurrence in Senate Amendments",77,0,0,2,79
1827736,1408218,2024-03-12,Assembly,"Do pass and be re-referred to the Committee on [Appropriations]",10,0,0,1,11
1827737,1412614,2024-03-20,Assembly,"Do pass as amended and be re-referred to the Committee on [Health]",7,0,0,0,7
1827737,1423761,2024-04-09,Assembly,"Do pass and be re-referred to the Committee on [Appropriations] with recommendation: To Consent Calendar",16,0,0,0,16
1827738,1408243,2024-03-12,Assembly,"Do pass. To Consent Calendar",10,0,0,2,12
1827738,1410530,2024-03-18,Assembly,"AB 1916 Maienschein Consent Calendar Second Day Regular Session",74,0,0,6,80
1827738,1453413,2024-06-04,Senate,"Do pass as amended, and be ordered to the Consent Calendar",11,0,0,0,11
1827738,1457333,2024-06-13,Senate,"Consent Calendar 2nd AB1916 Maienschein",37,0,0,3,40
1827738,1458029,2024-06-17,Assembly,"AB 1916 Maienschein Concurrence in Senate Amendments",74,0,0,5,79
1827739,1412570,2024-03-20,Assembly,"Do pass and be re-referred to the Committee on [Appropriations]",6,0,0,1,7
1827739,1443979,2024-05-16,Assembly,"Do pass as amended",11,0,0,4,15
1827739,1449706,2024-05-23,Assembly,"AB 1917 Muratsuchi Assembly Third Reading",72,0,0,8,80
1827739,1460560,2024-06-26,Senate,"Do pass, but first be re-referred to the Committee on [Appropriations]",7,0,0,0,7
1827739,1463550,2024-08-05,Senate,"Placed on suspense file",7,0,0,0,7
1827739,1464452,2024-08-15,Senate,"Do pass as amended",7,0,0,0,7
1827741,1408816,2024-03-13,Assembly,"Do pass as amended, and be re-referred to the Committee on [Business and Professions] with recommendation: To Consent Calendar",15,0,0,1,16
1827741,1419123,2024-04-02,Assembly,"Do pass as amended and be re-referred to the Committee on [Appropriations]",18,0,0,0,18
1827741,1434045,2024-04-24,Assembly,"Do pass. To Consent Calendar",14,0,0,1,15
1827741,1438501,2024-05-02,Assembly,"AB 1918 Wood Consent Calendar Second Day Regular Session",73,0,0,7,80
1827741,1453469,2024-06-04,Senate,"Do pass, but first be re-referred to the Committee on [Housing]",18,0,0,0,18
1827741,1465284,2024-08-19,Senate,"Assembly 3rd Reading AB1918 Wood By Dahle",40,0,0,0,40
1827741,1465506,2024-08-22,Assembly,"AB 1918 Wood Concurrence in Senate Amendments",60,0,0,19,79
1827742,1435344,2024-04-24,Assembly,"Do pass and be re-referred to the Committee on [Appropriations]",5,1,0,1,7
1827742,1444118,2024-05-16,Assembly,"Do pass",11,4,0,0,15
1827742,1449576,2024-05-23,Assembly,"AB 1919 Weber Assembly Third Reading",59,7,0,14,80
1827742,1460440,2024-06-26,Senate,"Do pass, but first be re-referred to the Committee on [Appropriations]",5,0,0,2,7
1827742,1463640,2024-08-05,Senate,"Placed on suspense file",7,0,0,0,7
1827742,1464512,2024-08-15,Senate,"Do pass",4,2,0,1,7
1827742,1465654,2024-08-26,Senate,"Assembly 3rd Reading AB1919 Weber et al. By Bradford",31,7,0,2,40
1827742,1465861,2024-08-27,Assembly,"AB 1919 Weber Concurrence in Senate Amendments",63,10,0,6,79
1827743,1431973,2024-04-22,Assembly,"Be adopted. To third reading",7,0,0,4,11
1827743,1449627,2024-05-23,Senate,"Special Consent ACR133 Ramos et al",37,0,0,3,40
1827745,1389453,2024-02-20,Assembly,"Be adopted. To third reading",7,0,0,0,7
1827745,1400032,2024-02-29,Assembly,"AJR 12 Alvarez Assembly Third Reading",73,0,0,7,80
1827745,1454231,2024-06-05,Senate,"Be adopted and be ordered to the Consent Calendar",7,0,0,0,7
1827745,1457342,2024-06-13,Senate,"Consent Calendar 2nd AJR12 Alvarez et al",37,0,0,3,40
1827745,1465463,2024-08-22,Assembly,"AJR 12 Alvarez Concurrence in Senate Amendments",62,0,0,17,79
1827746,1408234,2024-03-12,Senate,"Do pass, but first be re-referred to the Committee on [Appropriations]",5,0,0,0,5
1827746,1427275,2024-04-15,Senate,"Placed on suspense file",6,0,0,1,7
1827746,1444073,2024-05-16,Senate,"Do pass as amended",7,0,0,0,7
1827746,1450040,2024-05-24,Senate,"Special Consent SB965 Min",38,0,0,2,40
1827746,1458269,2024-06-18,Assembly,"Do pass and be re-referred to the Committee on [Appropriations] with recommendation: To Consent Calendar",7,0,0,1,8
1827746,1464486,2024-08-15,Assembly,"Do pass",14,0,0,1,15
1827746,1466953,2024-08-28,Assembly,"SB 965 Min Senate Third Reading By McCarty",73,0,0,6,79
1827747,1427319,2024-04-15,Senate,"Do pass, but first be re-referred to the Committee on [Health]",12,0,0,1,13
1827747,1435278,2024-04-24,Senate,"Do pass as amended, but first amend, and re-refer to the Committee on [Appropriations]",11,0,0,0,11
1827747,1442605,2024-05-13,Senate,"Placed on suspense file",7,0,0,0,7
1827747,1444581,2024-05-16,Senate,"Do pass",7,0,0,0,7
1827747,1445238,2024-05-20,Senate,"Senate 3rd Reading SB966 Wiener",39,0,0,1,40
1827747,1460004,2024-06-25,Assembly,"Do pass and be re-referred to the Committee on [Judiciary]",15,0,0,1,16
1827747,1462366,2024-07-02,Assembly,"Do pass as amended and be re-referred to the Committee on [Appropriations]",10,0,0,2,12
1827747,1464276,2024-08-15,Assembly,"Do pass as amended",11,0,0,4,15
1827747,1466339,2024-08-29,Senate,"Unfinished Business SB966 Wiener et al. Concurrence",38,2,0,0,40
1827747,1466890,2024-08-28,Assembly,"SB 966 Wiener Senate Third Reading By Wood",70,0,0,9,79
1827748,1412514,2024-03-20,Senate,"Do pass as amended, but first amend, and re-refer to the Committee on [Appropriations]",7,0,0,0,7
1827748,1427209,2024-04-15,Senate,"Placed on suspense file",6,0,0,1,7
1827750,1412542,2024-03-19,Senate,"Do pass, but first be re-referred to the Committee on [Appropriations]",2,4,0,4,10
1827750,1412543,2024-03-19,Senate,"[First] hearing set for [03-20-2024]: Failed passage in Committee. Reconsideration granted",10,0,0,0,10
1829018,1420070,2024-04-03,Assembly,"Do pass as amended, and be re-referred to the Committee on [Natural Resources] with recommendation: To Consent Calendar",16,0,0,0,16
1829018,1427254,2024-04-15,Assembly,"Do pass and be re-referred to the Committee on [Appropriations] with recommendation: To Consent Calendar",10,0,0,1,11
1829018,1444165,2024-05-16,Assembly,"Do pass as amended",11,0,0,4,15
1829018,1445987,2024-05-21,Assembly,"AB 1921 Papan Assembly Third Reading",74,0,0,6,80
1829018,1458163,2024-06-18,Senate,"Do pass, but first be re-referred to the Committee on [Environmental Quality]",17,0,0,1,18
1829018,1462466,2024-07-03,Senate,"Do pass, but first be re-referred to the Committee on [Appropriations]",6,0,0,1,7
1829018,1465330,2024-08-20,Senate,"Assembly 3rd Reading AB1921 Papan By Caballero",38,0,0,2,40
1829019,1411401,2024-03-19,Assembly,"Do pass and be re-referred to the Committee on [Appropriations]",11,0,0,0,11
1829020,1411394,2024-03-19,Assembly,"Do pass and be re-referred to the Committee on [Appropriations] with recommendation: To Consent Calendar",11,0,0,0,11
1829021,1412552,2024-03-20,Assembly,"Do pass",8,0,0,1,9
1829021,1422074,2024-04-08,Assembly,"AB 1924 Stephanie Nguyen Assembly Third Reading",76,0,0,4,80
1829021,1451566,2024-05-28,Senate,"Do pass and be ordered to the Consent Calendar",12,0,0,3,15
1829021,1454837,2024-06-06,Senate,"Consent Calendar 2nd AB1924 Stephanie Nguyen et",32,0,0,8,40
1829021,1458798,2024-06-20,Assembly,"AB 1924 Stephanie Nguyen Concurrence in Senate Amendments",66,0,0,13,79
1829022,1419158,2024-04-02,Assembly,"Do pass and be re-referred to the Committee on [Appropriations]",5,0,0,2,7
1829023,1419226,2024-04-02,Assembly,"Do pass and be re-referred to the Committee on [Appropriations]",15,0,0,1,16
1829023,1444572,2024-05-16,Assembly,"Do pass",14,1,0,0,15
1829023,1445967,2024-05-21,Assembly,"AB 1926 Connolly Assembly Third Reading",67,0,0,13,80
1829023,1456842,2024-06-12,Senate,"Do pass, but first be re-referred to the Committee on [Appropriations]",8,0,0,3,11
1829023,1459386,2024-06-24,Senate,"Placed on suspense file",6,0,0,1,7
1829024,1408253,2024-03-12,Assembly,"Do pass and be re-referred to the Committee on [Appropriations]",9,0,0,2,11
1829024,1435302,2024-04-24,Assembly,"Do pass and be re-referred to the Committee on [Appropriations]",6,0,0,1,7
1829026,1412500,2024-03-20,Assembly,"Do pass and be re-referred to the Committee on [Higher Education]",7,0,0,0,7
1829026,1423894,2024-04-09,Assembly,"Do pass as amended and be re-referred to the Committee on [Appropriations]",10,0,0,1,11
1829026,1437600,2024-05-01,Assembly,"Do pass. To Consent Calendar",14,0,0,1,15
1829026,1441923,2024-05-09,Assembly,"AB 1929 McKinnor Consent Calendar Second Day Regular Session",65,0,0,15,80
1829026,1454270,2024-06-05,Senate,"Do pass, but first be re-referred to the Committee on [Appropriations] with the recommendation: To Consent Calendar",7,0,0,0,7
1829026,1458792,2024-06-20,Senate,"Consent Calendar 2nd AB1929 McKinnor et al",36,0,0,4,40
1829026,1461986,2024-07-01,Assembly,"AB 1929 McKinnor Concurrence in Senate Amendments",73,0,0,6,79
1829027,1412572,2024-03-20,Assembly,"Do pass and be re-referred to the Committee on [Appropriations] with recommendation: To Consent Calendar",7,0,0,0,7
1829027,1424927,2024-04-10,Assembly,"Do pass. To Consent Calendar",14,0,0,1,15
1829027,1431019,2024-04-18,Assembly,"AB 1930 Reyes Consent Calendar Second Day Regular Session",72,0,0,8,80
1829027,1451595,2024-05-29,Senate,"Do pass, but first be re-referred to the Committee on [Rules] with the recommendation: To Consent Calendar",7,0,0,0,7
1829027,1462266,2024-07-01,Senate,"Do pass, but first be re-referred to the Committee on [Appropriations] with the recommendation: To Consent Calendar",5,0,0,0,5
1829027,1466412,2024-08-30,Senate,"Assembly 3rd Reading AB1930 Reyes et al. By Newman",40,0,0,0,40
1829027,1467163,2024-08-31,Assembly,"AB 1930 Reyes Concurrence in Senate Amendments",77,0,0,2,79
1829028,1428971,2024-04-16,Assembly,"Do pass and be re-referred to the Committee on [Appropriations]",3,2,0,3,8
1829029,1430008,2024-04-17,Assembly,"Do pass and be re-referred to the Committee on [Revenue and Taxation]",7,2,0,0,9
1829029,1433026,2024-04-22,Assembly,"Do pass and be re-referred to the Committee on [Appropriations]",4,3,0,0,7
1829030,1420153,2024-04-03,Assembly,"Do pass and be re-referred to the Committee on [Appropriations] with recommendation: To Consent Calendar",12,0,0,3,15
1829030,1444338,2024-05-16,Assembly,"Do pass",15,0,0,0,15
1829030,1445982,2024-05-21,Assembly,"AB 1933 Calderon Assembly Third Reading",73,0,0,7,80
1829031,1418412,2024-04-01,Assembly,"Do pass and be re-referred to the Committee on [Appropriations] with recommendation: To Consent Calendar",8,0,0,1,9
1829031,1424762,2024-04-10,Assembly,"Do pass. To Consent Calendar",14,0,0,1,15
1829031,1430982,2024-04-18,Assembly,"AB 1934 Grayson Consent Calendar Second Day Regular Session",72,0,0,8,80
1829031,1458434,2024-06-19,Senate,"Do pass, but first be re-referred to the Committee on [Judiciary]",6,0,0,1,7
1829031,1462539,2024-07-02,Senate,"Do pass, but first be re-referred to the Committee on [Appropriations] with the recommendation: To Consent Calendar",11,0,0,0,11
1829031,1463839,2024-08-12,Senate,"Consent Calendar 2nd AB1934 Grayson",38,0,0,2,40
1829031,1464056,2024-08-15,Assembly,"AB 1934 Grayson Concurrence in Senate Amendments",75,0,0,4,79
1829032,1430060,2024-04-17,Assembly,"Do pass and be re-referred to the Committee on [Appropriations] with recommendation: To Consent Calendar",21,0,0,1,22
1829032,1444331,2024-05-16,Assembly,"Do pass as amended",11,0,0,4,15
1829032,1445923,2024-05-21,Assembly,"AB 1935 Blanca Rubio Third Reading Urgency",74,0,0,6,80
1829032,1456299,2024-06-11,Senate,"Do pass, but first be re-referred to the Committee on [Appropriations] with the recommendation: To Consent Calendar",15,0,0,1,16
1829032,1460602,2024-06-26,Senate,"Do pass",7,0,0,0,7
1829032,1461265,2024-06-27,Senate,"Assembly 3rd Reading AB1935 Blanca Rubio By Dodd Urgency Clause",40,0,0,0,40
1829033,1428857,2024-04-16,Assembly,"Do pass and be re-referred to the Committee on [Appropriations] with recommendation: To Consent Calendar",16,0,0,0,16
1829033,1437653,2024-05-01,Assembly,"Do pass. To Consent Calendar",14,0,0,1,15
1829033,1441947,2024-05-09,Assembly,"AB 1936 Cervantes Consent Calendar Second Day Regular Session",65,0,0,15,80
1829033,1454183,2024-06-05,Senate,"Do pass, but first be re-referred to the Committee on [Appropriations] with the recommendation: To Consent Calendar",11,0,0,0,11
1829033,1458783,2024-06-20,Senate,"Consent Calendar 2nd AB1936 Cervantes et al",36,0,0,4,40
1829033,1465414,2024-08-21,Senate,"Assembly 3rd Reading AB1936 Cervantes et al. By Rubio",33,0,0,7,40
1829033,1466108,2024-08-29,Assembly,"AB 1936 Cervantes Concurrence in Senate Amendments By MAIENSCHEIN",76,0,0,3,79
1829034,1423784,2024-04-08,Assembly,"Be adopted and re-referred to the Committee on [Appropriations]",8,3,0,0,11
1829034,1444003,2024-05-16,Assembly,"Be adopted",11,4,0,0,15
1829035,1371111,2024-01-29,Assembly,"Be adopted. To third reading",8,0,0,3,11
1829035,1395237,2024-02-26,Senate,"Special Consent ACR134 Wood et al",37,0,0,3,40
1829036,1408232,2024-03-12,Senate,"Do pass, but first be re-referred to the Committee on [Appropriations]",16,0,0,0,16
1829036,1422103,2024-04-08,Senate,"Placed on suspense file",6,0,0,1,7
1829036,1443969,2024-05-16,Senate,"Do pass",7,0,0,0,7
1829036,1449547,2024-05-23,Senate,"Special Consent SB969 Wiener et al",37,0,0,3,40
1829036,1458761,2024-06-19,Assembly,"Do pass and be re-referred to the Committee on [Appropriations]",18,1,0,3,22
1829036,1464505,2024-08-15,Assembly,"Do pass as amended",11,0,0,4,15
1829036,1465695,2024-08-26,Assembly,"SB 969 Wiener Senate Third Reading By Haney",72,2,0,5,79
1829036,1465923,2024-08-27,Senate,"Unfinished Business SB969 Wiener et al. Concurrence",40,0,0,0,40
1829037,1423757,2024-04-09,Senate,"Do pass as amended, but first amend, and re-refer to the Committee on [Public Safety]",11,0,0,0,11
1829037,1433008,2024-04-23,Senate,"Do pass, but first be re-referred to the Committee on [Appropriations]",5,0,0,0,5
1829037,1439661,2024-05-06,Senate,"Placed on suspense file",7,0,0,0,7
1829038,1412507,2024-03-20,Senate,"Do pass as amended, but first amend, and re-refer to the Committee on [Appropriations]",7,0,0,0,7
1829038,1422082,2024-04-08,Senate,"Placed on suspense file",6,0,0,1,7
1829038,1444095,2024-05-16,Senate,"Do pass as amended",5,2,0,0,7
1829038,1450334,2024-05-21,Senate,"Senate 3rd Reading SB971 Portantino",33,4,0,3,40
1829038,1458284,2024-06-18,Assembly,"Do pass and be re-referred to the Committee on [Appropriations]",8,0,0,3,11
1829038,1464212,2024-08-15,Assembly,"Do pass as amended",11,1,0,3,15
1829038,1465766,2024-08-26,Assembly,"SB 971 Portantino Senate Third Reading By Mike Fong",73,0,0,6,79
1829038,1465875,2024-08-27,Senate,"Unfinished Business SB971 Portantino Concurrence",35,3,0,2,40
1829039,1434273,2024-04-24,Senate,"Do pass, but first be re-referred to the Committee on [Appropriations] with the recommendation: To Consent Calendar",7,0,0,0,7
1829039,1442633,2024-05-13,Senate,"Placed on suspense file",7,0,0,0,7
1829039,1444109,2024-05-16,Senate,"Do pass as amended",7,0,0,0,7
1829039,1450010,2024-05-24,Senate,"Special Consent SB972 Min",38,0,0,2,40
1829039,1458004,2024-06-17,Assembly,"Do pass as amended, and be re-referred to the Committee on [Appropriations] with recommendation: To Consent Calendar",10,0,0,1,11
1829039,1464028,2024-08-15,Assembly,"Do pass as amended",11,0,0,4,15
1829039,1465632,2024-08-26,Assembly,"SB 972 Min Senate Third Reading",77,0,0,2,79
1829039,1467033,2024-08-28,Senate,"Special Consent SB972 Min",39,0,0,1,40
1829040,1405810,2024-03-07,Senate,"Senate 3rd Reading SR60 Ochoa Bogh et al",38,0,0,2,40
1831220,1422091,2024-04-08,Assembly,"Do pass and be re-referred to the Committee on [Water, Parks, and Wildlife] with recommendation: To Consent Calendar",15,0,0,0,15
1831220,1433065,2024-04-23,Assembly,"Do pass and be re-referred to the Committee on [Appropriations] with recommendation: To Consent Calendar",14,0,0,1,15
1831220,1443957,2024-05-16,Assembly,"Do pass",15,0,0,0,15
1831220,1449684,2024-05-23,Assembly,"AB 1937 Berman Assembly Third Reading",72,0,0,8,80
1831220,1456281,2024-06-11,Senate,"Do pass, but first be re-referred to the Committee on [Natural Resources and Water] with the recommendation: To Consent Calendar",15,0,0,0,15
1831220,1460070,2024-06-25,Senate,"Do pass, but first be re-referred to the Committee on [Appropriations] with the recommendation: To Consent Calendar",11,0,0,0,11
1831220,1463464,2024-08-05,Senate,"Placed on suspense file",7,0,0,0,7
1831220,1464398,2024-08-15,Senate,"Do pass as amended",5,0,0,2,7
1831220,1465649,2024-08-26,Senate,"Assembly 3rd Reading AB1937 Berman By Becker",37,2,0,1,40
1831220,1465988,2024-08-27,Assembly,"AB 1937 Berman Concurrence in Senate Amendments",77,0,0,2,79
1831221,1435223,2024-04-24,Assembly,"Do pass as amended and be re-referred to the Committee on [Appropriations]",6,0,0,1,7
1831221,1441292,2024-05-08,Assembly,"Do pass. To Consent Calendar",15,0,0,0,15
1831221,1443951,2024-05-16,Assembly,"AB 1938 Gallagher Consent Calendar Second Day Regular Session",71,0,0,9,80
1831221,1454254,2024-06-05,Senate,"Do pass, but first be re-referred to the Committee on [Appropriations] with the recommendation: To Consent Calendar",7,0,0,0,7
1831221,1458001,2024-06-17,Senate,"Placed on suspense file",7,0,0,0,7
1831221,1464629,2024-08-15,Senate,"Do pass",7,0,0,0,7
1831221,1466518,2024-08-30,Senate,"Assembly 3rd Reading AB1938 Gallagher et al. By Ochoa Bogh",40,0,0,0,40
1831221,1467041,2024-08-31,Assembly,"AB 1938 Gallagher Concurrence in Senate Amendments",77,0,0,2,79
1831222,1412559,2024-03-20,Assembly,"Do pass. To Consent Calendar",7,0,0,0,7
1831222,1421129,2024-04-04,Assembly,"AB 1939 Maienschein Consent Calendar Second Day Regular Session",70,0,0,10,80
1831222,1451586,2024-05-29,Senate,"Do pass and be ordered to the Consent Calendar",7,0,0,0,7
1831222,1454843,2024-06-06,Senate,"Consent Calendar 2nd AB1939 Maienschein",32,0,0,8,40
1831223,1420140,2024-04-03,Assembly,"Do pass and be re-referred to the Committee on [Appropriations] with recommendation: To Consent Calendar",21,0,0,1,22
1831223,1429969,2024-04-17,Assembly,"Do pass. To Consent Calendar",15,0,0,0,15
1831223,1435370,2024-04-25,Assembly,"AB 1940 Villapudua Consent Calendar Second Day Regular Session",75,0,0,5,80
1831223,1450934,2024-05-28,Senate,"Do pass, but first be re-referred to the Committee on [Appropriations] with the recommendation: To Consent Calendar",12,0,0,4,16
1831223,1465543,2024-08-26,Senate,"Assembly 3rd Reading AB1940 Villapudua By Dodd",40,0,0,0,40
1831224,1420119,2024-04-03,Assembly,"Do pass. To Consent Calendar",7,0,0,0,7
1831224,1427359,2024-04-15,Assembly,"AB 1941 Quirk-Silva Assembly Third Reading",75,0,0,5,80
1831224,1454227,2024-06-05,Senate,"Do pass and be ordered to the Consent Calendar",5,0,0,0,5
1831224,1457322,2024-06-13,Senate,"Consent Calendar 2nd AB1941 Quirk-Silva",37,0,0,3,40
1831226,1419206,2024-04-02,Assembly,"Do pass as amended, and be re-referred to the Committee on [Privacy and Consumer Protection] with recommendation: To Consent Calendar",15,0,0,1,16
1831226,1437652,2024-05-01,Assembly,"Do pass. To Consent Calendar",14,0,0,1,15
1831226,1441956,2024-05-09,Assembly,"AB 1943 Weber Consent Calendar Second Day Regular Session",65,0,0,15,80
1831226,1454221,2024-06-05,Senate,"Do pass as amended, but first amend, and re-refer to the Committee on [Appropriations] with the recommendation: To Consent Calendar",11,0,0,0,11
1831226,1457984,2024-06-17,Senate,"Placed on suspense file",7,0,0,0,7
1831229,1420160,2024-04-03,Assembly,"Do pass. To Consent Calendar",21,0,0,1,22
1831229,1427255,2024-04-15,Assembly,"AB 1946 Alanis Assembly Third Reading",75,0,0,5,80
1831229,1450944,2024-05-28,Senate,"Do pass and be ordered to the Consent Calendar",12,0,0,4,16
1831229,1465728,2024-08-26,Senate,"Assembly 3rd Reading AB1946 Alanis By Dodd",40,0,0,0,40
1831229,1465826,2024-08-27,Assembly,"AB 1946 Alanis Concurrence in Senate Amendments",77,0,0,2,79
1831230,1421167,2024-04-03,Assembly,"Do pass and be re-referred to the Committee on [Appropriations]",7,0,0,0,7
1831230,1430076,2024-04-17,Assembly,"Do pass. To Consent Calendar",15,0,0,0,15
1831230,1435197,2024-04-25,Assembly,"AB 1947 Luz Rivas Consent Calendar Second Day Regular Session",75,0,0,5,80
1831230,1451564,2024-05-29,Senate,"Do pass, but first be re-referred to the Committee on [Human Services]",7,0,0,0,7
1831230,1458203,2024-06-17,Senate,"Do pass, but first be re-referred to the Committee on [Appropriations]",5,0,0,0,5
1831230,1465401,2024-08-21,Senate,"Assembly 3rd Reading AB1947 Luz Rivas By Lim√≥n",33,0,0,7,40
1831230,1465576,2024-08-26,Assembly,"AB 1947 Luz Rivas Concurrence in Senate Amendments",77,0,0,2,79
1831231,1419124,2024-04-02,Assembly,"Do pass",7,0,0,0,7
1831231,1422044,2024-04-08,Assembly,"AB 1948 Rendon Assembly Third Reading",75,0,0,5,80
1831231,1453399,2024-06-03,Senate,"Do pass, but first be re-referred to the Committee on [Judiciary]",4,0,0,1,5
1831231,1456294,2024-06-11,Senate,"Do pass and be ordered to the Consent Calendar",11,0,0,0,11
1831231,1458842,2024-06-20,Senate,"Consent Calendar 2nd AB1948 Rendon et al",36,0,0,4,40
1831232,1419205,2024-04-02,Assembly,"Do pass as amended and be re-referred to the Committee on [Appropriations]",8,0,0,3,11
1831232,1444211,2024-05-16,Assembly,"Do pass",11,0,0,4,15
1831232,1446068,2024-05-21,Assembly,"AB 1949 Wicks Assembly Third Reading",58,0,0,22,80
1831232,1462549,2024-07-02,Senate,"Do pass as amended, but first amend, and re-refer to the Committee on [Appropriations]",11,0,0,0,11
1831232,1463544,2024-08-05,Senate,"Placed on suspense file",7,0,0,0,7
1831232,1464278,2024-08-15,Senate,"Do pass",4,1,0,2,7
1831232,1466336,2024-08-29,Assembly,"AB 1949 Wicks Concurrence in Senate Amendments",60,0,0,19,79
1831232,1466826,2024-08-28,Senate,"Assembly 3rd Reading AB1949 Wicks et al. By Wilk",33,0,0,7,40
1831233,1423785,2024-04-09,Assembly,"Do pass as amended and be re-referred to the Committee on [Local Government]",10,1,0,1,12
1831233,1435279,2024-04-24,Assembly,"Do pass as amended and be re-referred to the Committee on [Appropriations]",8,0,0,1,9
1831233,1444691,2024-05-16,Assembly,"Do pass",11,2,0,2,15
1831233,1445976,2024-05-21,Assembly,"AB 1950 Wendy Carrillo Assembly Third Reading",60,6,0,14,80
1831233,1460434,2024-06-26,Senate,"Do pass, but first be re-referred to the Committee on [Judiciary]",6,0,0,1,7
1831233,1462505,2024-07-02,Senate,"Do pass as amended, but first amend, and re-refer to the Committee on [Appropriations]",11,0,0,0,11
1831233,1463829,2024-08-12,Senate,"Placed on suspense file",7,0,0,0,7
1831233,1464121,2024-08-15,Senate,"Do pass",5,2,0,0,7
1831233,1466262,2024-08-29,Senate,"Assembly 3rd Reading AB1950 Wendy Carrillo By Lim√≥n",33,6,0,1,40
1831233,1466397,2024-08-30,Assembly,"AB 1950 Wendy Carrillo Concurrence in Senate Amendments",65,0,0,14,79
1831235,1419175,2024-04-02,Assembly,"Do pass and be re-referred to the Committee on [Appropriations]",7,0,0,0,7
1831236,1418359,2024-04-01,Assembly,"Do pass. To Consent Calendar",15,0,0,0,15
1831236,1422035,2024-04-08,Assembly,"AB 1953 Villapudua Consent Calendar Second Day Regular Session",74,0,0,6,80
1831236,1451601,2024-05-28,Senate,"Do pass and be ordered to the Consent Calendar",12,0,0,3,15
1831236,1465650,2024-08-26,Senate,"Assembly 3rd Reading AB1953 Villapudua By Cortese",40,0,0,0,40
1831236,1465963,2024-08-27,Assembly,"AB 1953 Villapudua Concurrence in Senate Amendments",76,0,0,3,79
1831237,1428943,2024-04-16,Assembly,"Do pass and be re-referred to the Committee on [Appropriations] with recommendation: To Consent Calendar",8,0,0,0,8
1831237,1434036,2024-04-24,Assembly,"Do pass. To Consent Calendar",14,0,0,1,15
1831237,1438441,2024-05-02,Assembly,"AB 1954 Alanis Consent Calendar Second Day Regular Session",73,0,0,7,80
1831237,1456427,2024-06-11,Senate,"Do pass, but first be re-referred to the Committee on [Appropriations] with the recommendation: To Consent Calendar",5,0,0,0,5
1831237,1466176,2024-08-29,Senate,"Assembly 3rd Reading AB1954 Alanis et al. By Grove",40,0,0,0,40
1831237,1466440,2024-08-30,Assembly,"AB 1954 Alanis Concurrence in Senate Amendments",75,0,0,4,79
1831238,1412565,2024-03-20,Assembly,"Do pass and be re-referred to the Committee on [Appropriations] with recommendation: To Consent Calendar",7,0,0,0,7
1831238,1430047,2024-04-17,Assembly,"Do pass. To Consent Calendar",15,0,0,0,15
1831238,1435350,2024-04-25,Assembly,"AB 1955 Ward Consent Calendar Second Day Regular Session",75,0,0,5,80
1831238,1451567,2024-05-29,Senate,"Do pass, but first be re-referred to the Committee on [Health]",5,2,0,0,7
1831238,1455769,2024-06-10,Senate,"Placed on suspense file",2,2,0,3,7
1831238,1455770,2024-06-10,Senate,"Do pass",5,2,0,0,7
1831238,1457334,2024-06-13,Senate,"Assembly 3rd Reading AB1955 Ward et al. By Eggman",29,8,0,3,40
1831238,1460599,2024-06-26,Assembly,"With recommendation: That Senate amendments be concurred in",5,2,0,0,7
1831238,1461236,2024-06-27,Assembly,"AB 1955 Ward Concurrence in Senate Amendments Appeal the Decision of the Chair By ESSAYLI",55,15,0,9,79
1831238,1461237,2024-06-27,Assembly,"AB 1955 Ward Concurrence in Senate Amendments Appeal the Decision of the Chair By ESSAYLI",57,12,0,10,79
1831238,1461238,2024-06-27,Assembly,"AB 1955 Ward Concurrence in Senate Amendments",61,16,0,2,79
1831239,1408245,2024-03-12,Assembly,"Do pass and be re-referred to the Committee on [Appropriations]",8,0,0,0,8
1831240,1430987,2024-04-17,Assembly,"Do pass and be re-referred to the Committee on [Appropriations]",9,0,0,0,9
1831240,1437664,2024-05-01,Assembly,"Do pass. To Consent Calendar",14,0,0,1,15
1831240,1441888,2024-05-09,Assembly,"AB 1957 Wilson Consent Calendar Second Day Regular Session",65,0,0,15,80
1831240,1451617,2024-05-29,Senate,"Do pass, but first be re-referred to the Committee on [Appropriations] with the recommendation: To Consent Calendar",7,0,0,0,7
1831240,1457313,2024-06-13,Senate,"Consent Calendar 2nd AB1957 Wilson",37,0,0,3,40
1831241,1412517,2024-03-20,Assembly,"Do pass. To Consent Calendar",8,0,0,1,9
1831241,1421125,2024-04-04,Assembly,"AB 1958 Berman Consent Calendar Second Day Regular Session",70,0,0,10,80
1831242,1411383,2024-03-19,Assembly,"Do pass and be re-referred to the Committee on [Appropriations] with recommendation: To Consent Calendar",8,0,0,0,8
1831243,1424889,2024-04-09,Assembly,"Do pass and be re-referred to the Committee on [Appropriations]",7,0,0,1,8
1831243,1444558,2024-05-16,Assembly,"Do pass as amended",10,0,0,5,15
1831243,1448616,2024-05-22,Assembly,"AB 1960 Soria Assembly Third Reading",60,5,0,15,80
1831243,1456457,2024-06-11,Senate,"Do pass, but first be re-referred to the Committee on [Appropriations]",4,0,0,1,5
1831243,1457949,2024-06-17,Senate,"Placed on suspense file",1,3,0,3,7
1831243,1457950,2024-06-17,Senate,"Do pass as amended",5,0,0,2,7
1831243,1466762,2024-08-28,Senate,"Assembly 3rd Reading AB1960 Robert Rivas et al. By Newman",34,2,0,4,40
1831243,1466763,2024-08-31,Assembly,"AB 1960 Robert Rivas Concurrence in Senate Amendments By ZBUR",64,4,0,11,79
1831244,1423725,2024-04-09,Assembly,"Do pass and be re-referred to the Committee on [Agriculture]",5,0,0,2,7
1831244,1434121,2024-04-24,Assembly,"Do pass and be re-referred to the Committee on [Appropriations]",9,0,0,1,10
1831244,1443995,2024-05-16,Assembly,"Do pass as amended",11,0,0,4,15
1831244,1448776,2024-05-22,Assembly,"AB 1961 Wicks Assembly Third Reading",70,0,0,10,80
1831244,1462203,2024-07-01,Senate,"Do pass as amended, but first amend, and re-refer to the Committee on [Appropriations]",5,0,0,0,5
1831244,1463565,2024-08-05,Senate,"Placed on suspense file",7,0,0,0,7
1831244,1464613,2024-08-15,Senate,"Do pass as amended",6,0,0,1,7
1831244,1466437,2024-08-30,Senate,"Assembly 3rd Reading AB1961 Wicks et al. By Wiener",40,0,0,0,40
1831244,1466919,2024-08-31,Assembly,"AB 1961 Wicks Concurrence in Senate Amendments",72,0,0,7,79
1831245,1424826,2024-04-09,Assembly,"Do pass and be re-referred to the Committee on [Appropriations] with recommendation: To Consent Calendar",8,0,0,0,8
1831245,1444247,2024-05-16,Assembly,"Do pass as amended",11,0,0,4,15
1831245,1446045,2024-05-21,Assembly,"AB 1962 Berman Assembly Third Reading",73,0,0,7,80
1831245,1462223,2024-07-02,Senate,"Do pass as amended, but first amend, and re-refer to the Committee on [Appropriations]",5,0,0,0,5
1831245,1463541,2024-08-05,Senate,"Placed on suspense file",7,0,0,0,7
1831245,1464641,2024-08-15,Senate,"Do pass",7,0,0,0,7
1831245,1465641,2024-08-26,Senate,"Assembly 3rd Reading AB1962 Berman et al. By Rubio",40,0,0,0,40
1831245,1466024,2024-08-27,Assembly,"AB 1962 Berman Concurrence in Senate Amendments",77,0,0,2,79
1831246,1435934,2024-04-23,Assembly,"Do pass as amended and be re-referred to the Committee on [Appropriations]",5,2,0,0,7
1831246,1444367,2024-05-16,Assembly,"Do pass",11,4,0,0,15
1831246,1449711,2024-05-23,Assembly,"AB 1963 Friedman Assembly Third Reading",46,16,0,18,80
1831246,1458406,2024-06-19,Senate,"Do pass as amended, but first amend, and re-refer to the Committee on [Agriculture]",4,3,0,0,7
1831246,1462256,2024-07-02,Senate,"Do pass as amended, but first amend, and re-refer to the Committee on [Appropriations]",3,0,0,2,5
1831246,1463388,2024-08-05,Senate,"Placed on suspense file",7,0,0,0,7
1831246,1464426,2024-08-15,Senate,"Do pass",4,2,0,1,7
1831246,1466098,2024-08-29,Assembly,"AB 1963 Friedman Concurrence in Senate Amendments",51,16,0,12,79
1831246,1466685,2024-08-28,Senate,"Assembly 3rd Reading AB1963 Friedman et al. By Cortese",29,8,0,3,40
1831248,1419116,2024-04-02,Assembly,"Do pass as amended and be re-referred to the Committee on [Appropriations]",15,0,0,1,16
1831248,1434142,2024-04-24,Assembly,"Do pass",15,0,0,0,15
1831248,1438430,2024-05-02,Assembly,"AB 1965 Blanca Rubio Assembly Third Reading",73,0,0,7,80
1831248,1451590,2024-05-29,Senate,"Do pass as amended, but first amend, and re-refer to the Committee on [Appropriations] with the recommendation: To Consent Calendar",11,0,0,0,11
1831248,1455819,2024-06-10,Senate,"Placed on suspense file",7,0,0,0,7
1831250,1424803,2024-04-10,Senate,"Do pass, but first be re-referred to the Committee on [Appropriations] with the recommendation: To Consent Calendar",6,0,0,1,7
1831250,1432000,2024-04-22,Senate,"Placed on suspense file",7,0,0,0,7
1831250,1444201,2024-05-16,Senate,"Do pass",7,0,0,0,7
1831250,1449633,2024-05-23,Senate,"Special Consent SB974 Grove",37,0,0,3,40
1831250,1460023,2024-06-24,Assembly,"Do pass and be re-referred to the Committee on [Appropriations]",6,0,0,1,7
1831250,1464441,2024-08-15,Assembly,"Do pass",14,0,0,1,15
1831250,1465572,2024-08-26,Assembly,"SB 974 Grove Senate Third Reading By Lackey",77,0,0,2,79
1831252,1434089,2024-04-23,Senate,"Do pass as amended, but first amend, and re-refer to the Committee on [Appropriations]",9,0,0,2,11
1831252,1442529,2024-05-13,Senate,"Placed on suspense file",7,0,0,0,7
1831252,1444571,2024-05-16,Senate,"Do pass",5,2,0,0,7
1831252,1445292,2024-05-20,Senate,"Senate 3rd Reading SB976 Skinner et al",35,2,0,3,40
1831252,1462614,2024-07-02,Assembly,"Do pass as amended and be re-referred to the Committee on [Appropriations]",7,0,0,4,11
1831252,1464268,2024-08-15,Assembly,"Do pass as amended",11,0,0,4,15
1831252,1467100,2024-08-31,Senate,"Unfinished Business SB976 Skinner et al. Concurrence",28,2,0,10,40
1831252,1467101,2024-08-31,Assembly,"SB 976 Skinner Senate Third Reading By Bauer-Kahan",47,4,0,28,79
1831253,1428745,2024-04-16,Senate,"Do pass, but first be re-referred to the Committee on [Local Government]",6,1,0,0,7
1831253,1430004,2024-04-17,Senate,"Do pass as amended, but first amend, and re-refer to the Committee on [Appropriations]",5,2,0,0,7
1831253,1439672,2024-05-06,Senate,"Placed on suspense file",7,0,0,0,7
1831253,1444230,2024-05-16,Senate,"Do pass as amended",5,2,0,0,7
1831253,1450269,2024-05-21,Senate,"Senate 3rd Reading SB977 Laird et al",31,8,0,1,40
1831253,1456881,2024-06-12,Assembly,"Do pass as amended and be re-referred to the Committee on [Local Government]",6,2,0,0,8
1831253,1460658,2024-06-26,Assembly,"Do pass and be re-referred to the Committee on [Appropriations]",6,0,0,3,9
1831253,1464618,2024-08-15,Assembly,"Do pass",11,3,0,1,15
1831253,1465664,2024-08-26,Assembly,"SB 977 Laird Senate Third Reading By Addis",60,15,0,4,79
1831253,1465971,2024-08-27,Senate,"Unfinished Business SB977 Laird et al. Concurrence",31,9,0,0,40
1831254,1408226,2024-03-12,Senate,"Do pass, but first be re-referred to the Committee on [Appropriations] with the recommendation: To Consent Calendar",16,0,0,0,16
1831254,1427207,2024-04-15,Senate,"Placed on suspense file",6,0,0,1,7
1831254,1444115,2024-05-16,Senate,"Do pass as amended",7,0,0,0,7
1831254,1450004,2024-05-24,Senate,"Special Consent SB978 Seyarto",38,0,0,2,40
1831254,1458805,2024-06-19,Assembly,"Do pass and be re-referred to the Committee on [Appropriations] with recommendation: To Consent Calendar",19,0,0,3,22
1831254,1464354,2024-08-15,Assembly,"Do pass",14,0,0,1,15
1831254,1465636,2024-08-26,Assembly,"SB 978 Seyarto Senate Third Reading By Lackey",77,0,0,2,79
1831256,1412549,2024-03-20,Senate,"Do pass as amended, but first amend, and re-refer to the Committee on [Appropriations]",11,0,0,0,11
1831256,1422068,2024-04-08,Senate,"Placed on suspense file",6,0,0,1,7
1831256,1444390,2024-05-16,Senate,"Do pass as amended",7,0,0,0,7
1831256,1450002,2024-05-24,Senate,"Special Consent SB980 Wahab et al",38,0,0,2,40
1831256,1458250,2024-06-18,Assembly,"Do pass and be re-referred to the Committee on [Appropriations]",16,0,0,0,16
1831257,1437641,2024-04-30,Senate,"Do pass as amended",11,0,0,0,11
1831257,1442621,2024-05-13,Senate,"Senate 3rd Reading SB981 Wahab",36,0,0,4,40
1831257,1462591,2024-07-02,Assembly,"Do pass as amended",10,0,0,1,11
1831257,1463873,2024-08-12,Assembly,"SB 981 Wahab Senate Third Reading By Bauer-Kahan",73,0,0,6,79
1831257,1465266,2024-08-19,Senate,"Unfinished Business SB981 Wahab et al. Concurrence",40,0,0,0,40
1831258,1408217,2024-03-12,Senate,"Do pass, but first be re-referred to the Committee on [Appropriations]",5,0,0,0,5
1831258,1422084,2024-04-08,Senate,"Placed on suspense file",6,0,0,1,7
1831258,1444417,2024-05-16,Senate,"Do pass as amended",7,0,0,0,7
1831258,1448712,2024-05-22,Senate,"Senate 3rd Reading SB982 Wahab et al",39,0,0,1,40
1831258,1456410,2024-06-11,Assembly,"Do pass and be re-referred to the Committee on [Appropriations]",8,0,0,0,8
1831258,1458550,2024-06-19,Assembly,"Do pass as amended",9,4,0,2,15
1831258,1463788,2024-08-08,Assembly,"SB 982 Wahab Senate Third Reading By Jones-Sawyer",72,0,0,7,79
1831258,1463894,2024-08-12,Senate,"Unfinished Business SB982 Wahab et al. Concurrence",38,0,0,2,40
1831259,1411361,2024-03-19,Senate,"Do pass as amended, but first amend, and re-refer to the Committee on [Rules]",13,0,0,5,18
1831259,1434090,2024-04-23,Senate,"Do pass, but first be re-referred to the Committee on [Appropriations]",11,0,0,4,15
1831259,1439700,2024-05-06,Senate,"Placed on suspense file",7,0,0,0,7
1831259,1444243,2024-05-16,Senate,"Do pass",7,0,0,0,7
1831259,1450351,2024-05-21,Senate,"Senate 3rd Reading SB983 Wahab et al",32,0,0,8,40
1831259,1458490,2024-06-19,Assembly,"Do pass and be re-referred to the Committee on [Transportation]",16,0,0,0,16
1831259,1462273,2024-07-01,Assembly,"Do pass and be re-referred to the Committee on [Appropriations] with recommendation: To Consent Calendar",15,0,0,0,15
1831259,1464215,2024-08-15,Assembly,"Do pass as amended",11,0,0,4,15
1831259,1466306,2024-08-29,Senate,"Unfinished Business SB983 Wahab et al. Concurrence",36,0,0,4,40
1831259,1466897,2024-08-28,Assembly,"SB 983 Wahab Senate Third Reading By Gabriel",74,0,0,5,79
1831260,1433012,2024-04-23,Senate,"Do pass, but first be re-referred to the Committee on [Labor, Public Employment and Retirement ]",10,5,0,1,16
1831260,1434058,2024-04-24,Senate,"Do pass, but first be re-referred to the Committee on [Appropriations]",5,0,0,0,5
1831260,1439696,2024-05-06,Senate,"Placed on suspense file",7,0,0,0,7
1831260,1444580,2024-05-16,Senate,"Do pass as amended",5,2,0,0,7
1831260,1450346,2024-05-21,Senate,"Senate 3rd Reading SB984 Wahab et al",28,10,0,2,40
1831260,1458547,2024-06-19,Assembly,"Do pass and be re-referred to the Committee on [Governmental Organization]",7,0,0,0,7
1831260,1464104,2024-08-15,Assembly,"Do pass as amended",11,0,0,4,15
1831260,1466278,2024-08-29,Senate,"Unfinished Business SB984 Wahab et al. Concurrence",31,8,0,1,40
1831260,1466857,2024-08-28,Assembly,"SB 984 Wahab Senate Third Reading By Haney",65,3,0,11,79
1831261,1420107,2024-04-03,Senate,"Do pass, but first be re-referred to the Committee on [Appropriations] with the recommendation: To Consent Calendar",7,0,0,0,7
1831261,1430989,2024-04-18,Senate,"Consent Calendar 2nd SB985 Ochoa Bogh",39,0,0,1,40
1831261,1458036,2024-06-17,Assembly,"Do pass and be re-referred to the Committee on [Appropriations]",8,0,0,1,9
1831261,1462286,2024-07-02,Assembly,"Do pass. To Consent Calendar",15,0,0,0,15
1831261,1463810,2024-08-08,Assembly,"SB 985 Ochoa Bogh Consent Calendar Second Day Regular Session",72,0,0,7,79
1831262,1389464,2024-02-20,Senate,"Senate 3rd Reading SR61 Min",39,0,0,1,40
1832565,1419196,2024-04-02,Assembly,"Do pass",6,0,0,1,7
1832565,1422025,2024-04-08,Assembly,"AB 1966 Davies Assembly Third Reading",74,0,0,6,80
1832565,1453416,2024-06-04,Senate,"Do pass, but first be re-referred to the Committee on [Business, Professions and Economic Development] with the recommendation: To Consent Calendar",11,0,0,0,11
1832565,1457964,2024-06-17,Senate,"Do pass and be ordered to the Consent Calendar",12,0,0,1,13
1832565,1458788,2024-06-20,Senate,"Consent Calendar 2nd AB1966 Davies",36,0,0,4,40
1832565,1463801,2024-08-08,Assembly,"AB 1966 Davies Concurrence in Senate Amendments",71,0,0,8,79
1832566,1433049,2024-04-23,Assembly,"Do pass and be re-referred to the Committee on [Appropriations]",6,0,0,1,7
1832566,1443982,2024-05-16,Assembly,"Do pass",12,1,0,2,15
1832566,1446072,2024-05-21,Assembly,"AB 1967 Jackson Assembly Third Reading",64,1,0,15,80
1832566,1458298,2024-06-17,Senate,"Do pass, but first be re-referred to the Committee on [Appropriations]",5,0,0,0,5
1832566,1462095,2024-07-01,Senate,"Placed on suspense file",7,0,0,0,7
1832567,1419177,2024-04-02,Assembly,"Do pass as amended and be re-referred to the Committee on [Appropriations]",5,1,0,1,7
1832568,1411388,2024-03-19,Assembly,"Do pass and be re-referred to the Committee on [Appropriations] with recommendation: To Consent Calendar",11,0,0,0,11
1832569,1423886,2024-04-09,Assembly,"Do pass and be re-referred to the Committee on [Appropriations]",13,0,0,3,16
1832569,1444428,2024-05-16,Assembly,"Do pass",11,2,0,2,15
1832569,1446114,2024-05-21,Assembly,"AB 1970 Jackson Assembly Third Reading",62,1,0,17,80
1832569,1456943,2024-06-12,Senate,"Do pass, but first be re-referred to the Committee on [Appropriations]",9,0,0,2,11
1832569,1459331,2024-06-24,Senate,"Placed on suspense file",6,0,0,1,7
1832570,1408821,2024-03-12,Assembly,"Do pass and be re-referred to the Committee on [Education] with recommendation: To Consent Calendar",10,0,0,1,11
1832570,1421169,2024-04-03,Assembly,"Do pass. To Consent Calendar",7,0,0,0,7
1832570,1427312,2024-04-15,Assembly,"AB 1971 Addis Assembly Third Reading",75,0,0,5,80
1832570,1458419,2024-06-19,Senate,"Do pass, but first be re-referred to the Committee on [Judiciary]",6,0,0,1,7
1832570,1462667,2024-07-02,Senate,"Do pass",9,1,0,1,11
1832570,1466097,2024-08-29,Assembly,"AB 1971 Addis Concurrence in Senate Amendments",75,0,0,4,79
1832570,1466739,2024-08-28,Senate,"Assembly 3rd Reading AB1971 Addis By Newman",39,0,0,1,40
1832571,1424769,2024-04-09,Assembly,"Do pass as amended, and be re-referred to the Committee on [Appropriations] with recommendation: To Consent Calendar",8,0,0,0,8
1832571,1434187,2024-04-24,Assembly,"Do pass. To Consent Calendar",14,0,0,1,15
1832571,1448559,2024-05-22,Assembly,"AB 1972 Alanis Assembly Third Reading",70,0,0,10,80
1832571,1456275,2024-06-11,Senate,"Do pass, but first be re-referred to the Committee on [Appropriations] with the recommendation: To Consent Calendar",5,0,0,0,5
1832571,1458035,2024-06-17,Senate,"Do pass as amended",7,0,0,0,7
1832571,1463792,2024-08-08,Senate,"Assembly 3rd Reading AB1972 Alanis et al. By Wilk Urgency Clause",38,0,0,2,40
1832571,1463860,2024-08-12,Assembly,"AB 1972 Alanis Concurrence - Urgency Added",75,0,0,4,79
1832572,1436916,2024-04-29,Assembly,"Do pass and be re-referred to the Committee on [Appropriations]",7,0,0,0,7
1832572,1444202,2024-05-16,Assembly,"Do pass",15,0,0,0,15
1832572,1445949,2024-05-21,Assembly,"AB 1973 Lackey Third Reading Urgency",70,0,0,10,80
1832572,1460540,2024-06-26,Senate,"Do pass, but first be re-referred to the Committee on [Appropriations]",6,0,0,1,7
1832572,1463685,2024-08-05,Senate,"Placed on suspense file",7,0,0,0,7
1832572,1464249,2024-08-15,Senate,"Do pass",7,0,0,0,7
1832572,1467251,2024-08-28,Senate,"Special Consent AB1973 Lackey et al. By Wilk Urgency Clause",39,0,0,1,40
1832573,1408206,2024-03-12,Assembly,"Do pass and be re-referred to the Committee on [Appropriations] with recommendation: To Consent Calendar",10,0,0,2,12
1832573,1412502,2024-03-20,Assembly,"Do pass. To Consent Calendar",12,0,0,3,15
1832573,1421143,2024-04-04,Assembly,"AB 1974 Petrie-Norris Consent Calendar Second Day Regular Session",70,0,0,10,80
1832573,1453475,2024-06-04,Senate,"Do pass, but first be re-referred to the Committee on [Appropriations] with the recommendation: To Consent Calendar",11,0,0,0,11
1832573,1458789,2024-06-20,Senate,"Consent Calendar 2nd AB1974 Petrie-Norris et al",36,0,0,4,40
1832574,1428929,2024-04-16,Assembly,"Do pass and be re-referred to the Committee on [Appropriations]",14,1,0,1,16
1832574,1444335,2024-05-16,Assembly,"Do pass",12,2,0,1,15
1832574,1446038,2024-05-21,Assembly,"AB 1975 Bonta Assembly Third Reading",64,0,0,16,80
1832574,1456957,2024-06-12,Senate,"Do pass, but first be re-referred to the Committee on [Appropriations]",9,0,0,2,11
1832574,1459373,2024-06-24,Senate,"Placed on suspense file",6,0,0,1,7
1832574,1464035,2024-08-15,Senate,"Do pass as amended",5,0,0,2,7
1832574,1466286,2024-08-29,Assembly,"AB 1975 Bonta Concurrence in Senate Amendments",73,0,0,6,79
1832574,1466775,2024-08-28,Senate,"Assembly 3rd Reading AB1975 Bonta et al. By Smallwood-Cuevas",37,0,0,3,40
1832575,1421154,2024-04-03,Assembly,"Do pass and be re-referred to the Committee on [Appropriations]",6,0,0,1,7
1832575,1444685,2024-05-16,Assembly,"Do pass as amended",11,0,0,4,15
1832575,1448706,2024-05-22,Assembly,"AB 1976 Haney Assembly Third Reading",69,0,0,11,80
1832575,1456947,2024-06-12,Senate,"Do pass as amended, but first amend, and re-refer to the Committee on [Appropriations]",5,0,0,0,5
1832575,1459433,2024-06-24,Senate,"Placed on suspense file",6,0,0,1,7
1832575,1464373,2024-08-15,Senate,"Do pass as amended",7,0,0,0,7
1832575,1465919,2024-08-27,Senate,"Assembly 3rd Reading AB1976 Haney By Roth",40,0,0,0,40
1832575,1466861,2024-08-28,Assembly,"AB 1976 Haney Concurrence in Senate Amendments",76,0,0,3,79
1832576,1423777,2024-04-09,Assembly,"Do pass and be re-referred to the Committee on [Appropriations]",16,0,0,0,16
1832576,1434143,2024-04-24,Assembly,"Do pass. To Consent Calendar",14,0,0,1,15
1832576,1438486,2024-05-02,Assembly,"AB 1977 Ta Consent Calendar Second Day Regular Session",73,0,0,7,80
1832576,1451558,2024-05-29,Senate,"Do pass as amended, but first amend, and re-refer to the Committee on [Appropriations]",11,0,0,0,11
1832576,1465811,2024-08-27,Senate,"Assembly 3rd Reading AB1977 Ta et al. By Menjivar",40,0,0,0,40
1832576,1466809,2024-08-28,Assembly,"AB 1977 Ta Concurrence in Senate Amendments",77,0,0,2,79
1832577,1420080,2024-04-02,Assembly,"Do pass and be re-referred to the Committee on [Transportation]",5,0,0,3,8
1832577,1431990,2024-04-22,Assembly,"Do pass and be re-referred to the Committee on [Appropriations]",15,0,0,0,15
1832577,1437654,2024-05-01,Assembly,"Do pass. To Consent Calendar",14,0,0,1,15
1832577,1446118,2024-05-21,Assembly,"AB 1978 Vince Fong Assembly Third Reading",65,0,0,15,80
1832577,1460677,2024-06-25,Senate,"Do pass, but first be re-referred to the Committee on [Public Safety] with the recommendation: To Consent Calendar",15,0,0,0,15
1832577,1462355,2024-07-02,Senate,"Do pass, but first be re-referred to the Committee on [Appropriations]",4,0,0,1,5
1832577,1465433,2024-08-22,Senate,"Assembly 3rd Reading AB1978 Sanchez By Wilk",33,0,0,7,40
1832577,1466524,2024-08-30,Senate,"Assembly 3rd Reading AB1978 Sanchez By Wilk",37,2,0,1,40
1832577,1466995,2024-08-31,Assembly,"AB 1978 Sanchez Concurrence in Senate Amendments",72,0,0,7,79
1832578,1419197,2024-04-02,Assembly,"Do pass as amended and be re-referred to the Committee on [Appropriations]",10,1,0,1,12
1832578,1444333,2024-05-16,Assembly,"Do pass as amended",11,1,0,3,15
1832578,1448549,2024-05-22,Assembly,"AB 1979 Ward Assembly Third Reading",61,1,0,18,80
1832578,1458348,2024-06-18,Senate,"Do pass, but first be re-referred to the Committee on [Appropriations]",9,0,0,2,11
1832578,1461977,2024-07-01,Senate,"Placed on suspense file",7,0,0,0,7
1832578,1464478,2024-08-15,Senate,"Do pass",4,2,0,1,7
1832578,1465677,2024-08-26,Senate,"Assembly 3rd Reading AB1979 Ward et al. By Wiener",32,5,0,3,40
1832579,1422087,2024-04-08,Assembly,"Do pass and be re-referred to the Committee on [Appropriations] with recommendation: To Consent Calendar",15,0,0,0,15
1832581,1408264,2024-03-12,Assembly,"Do pass. To Consent Calendar",8,0,0,0,8
1832581,1410541,2024-03-18,Assembly,"AB 1982 Mathis Consent Calendar Second Day Regular Session",74,0,0,6,80
1832581,1450933,2024-05-28,Senate,"Do pass, but first be re-referred to the Committee on [Military and Veterans Affairs] with the recommendation: To Consent Calendar",4,0,0,1,5
1832581,1460097,2024-06-24,Senate,"Do pass and be ordered to the Consent Calendar",5,0,0,0,5
1832581,1461956,2024-07-01,Senate,"Consent Calendar 2nd AB1982 Mathis et al",40,0,0,0,40
1832582,1403643,2024-03-04,Assembly,"Do pass as amended and be re-referred to the Committee on [Appropriations]",6,0,0,1,7
1832582,1412593,2024-03-20,Assembly,"Do pass. To Consent Calendar",12,0,0,3,15
1832582,1421139,2024-04-04,Assembly,"AB 1983 Maienschein Consent Calendar Second Day Regular Session",70,0,0,10,80
1832582,1456887,2024-06-12,Senate,"Do pass, but first be re-referred to the Committee on [Appropriations] with the recommendation: To Consent Calendar",6,0,0,1,7
1832582,1465347,2024-08-20,Senate,"Assembly 3rd Reading AB1983 Maienschein By Stern",40,0,0,0,40
1832582,1465442,2024-08-22,Assembly,"AB 1983 Maienschein Concurrence in Senate Amendments",63,0,0,16,79
1832583,1424946,2024-04-10,Assembly,"Do pass as amended and be re-referred to the Committee on [Appropriations]",7,0,0,0,7
1832583,1444075,2024-05-16,Assembly,"Do pass",15,0,0,0,15
1832583,1446079,2024-05-21,Assembly,"AB 1984 Weber Assembly Third Reading",72,0,0,8,80
1832583,1458409,2024-06-19,Senate,"Do pass as amended, but first amend, and re-refer to the Committee on [Appropriations] with the recommendation: To Consent Calendar",7,0,0,0,7
1832583,1463378,2024-08-05,Senate,"Placed on suspense file",7,0,0,0,7
1832583,1464456,2024-08-15,Senate,"Do pass as amended",6,0,0,1,7
1832583,1466315,2024-08-29,Assembly,"AB 1984 Weber Concurrence in Senate Amendments",76,0,0,3,79
1832583,1466870,2024-08-28,Senate,"Assembly 3rd Reading AB1984 Weber By Newman",39,0,0,1,40
1832585,1408213,2024-03-12,Assembly,"Do pass and be re-referred to the Committee on [Appropriations]",8,0,0,0,8
1832585,1424950,2024-04-10,Assembly,"Do pass",14,0,0,1,15
1832585,1427238,2024-04-15,Assembly,"AB 1986 Bryan Assembly Third Reading",71,0,0,9,80
1832585,1450946,2024-05-28,Senate,"Do pass, but first be re-referred to the Committee on [Appropriations] with the recommendation: To Consent Calendar",4,0,0,1,5
1832585,1466011,2024-08-27,Senate,"Assembly 3rd Reading AB1986 Bryan et al. By Smallwood-Cuevas",40,0,0,0,40
1832585,1466800,2024-08-28,Assembly,"AB 1986 Bryan Concurrence in Senate Amendments",75,0,0,4,79
1832587,1423733,2024-04-09,Assembly,"Do pass and be re-referred to the Committee on [Appropriations] with recommendation: To Consent Calendar",18,0,0,0,18
1832587,1434189,2024-04-24,Assembly,"Do pass. To Consent Calendar",14,0,0,1,15
1832587,1438429,2024-05-02,Assembly,"AB 1988 Muratsuchi Consent Calendar Second Day Regular Session",73,0,0,7,80
1832587,1452963,2024-06-03,Senate,"Do pass, but first be re-referred to the Committee on [Appropriations] with the recommendation: To Consent Calendar",13,0,0,0,13
1832587,1458772,2024-06-20,Senate,"Consent Calendar 2nd AB1988 Muratsuchi",36,0,0,4,40
1832588,1428972,2024-04-16,Assembly,"Do pass and be re-referred to the Committee on [Appropriations] with recommendation: To Consent Calendar",5,0,0,2,7
1832589,1424981,2024-04-09,Assembly,"Do pass as amended",7,0,0,1,8
1832589,1449582,2024-05-23,Assembly,"AB 1990 Wendy Carrillo Assembly Third Reading",44,1,0,35,80
1832590,1428994,2024-04-16,Assembly,"Do pass as amended and be re-referred to the Committee on [Appropriations]",17,0,0,1,18
1832590,1437612,2024-05-01,Assembly,"Do pass",14,0,0,1,15
1832590,1442609,2024-05-13,Assembly,"AB 1991 Bonta Assembly Third Reading",73,0,0,7,80
1832590,1457988,2024-06-17,Senate,"Do pass as amended, but first amend, and re-refer to the Committee on [Appropriations]",12,0,0,1,13
1832590,1465279,2024-08-19,Senate,"Assembly 3rd Reading AB1991 Bonta By Eggman",40,0,0,0,40
1832590,1465630,2024-08-26,Assembly,"AB 1991 Bonta Concurrence in Senate Amendments",77,0,0,2,79
1832591,1411351,2024-03-19,Assembly,"Do pass and be re-referred to the Committee on [Appropriations]",7,0,0,4,11
1832591,1444483,2024-05-16,Assembly,"Do pass as amended",10,3,0,2,15
1832591,1446092,2024-05-21,Assembly,"AB 1992 Boerner Assembly Third Reading",53,7,0,20,80
1832591,1457959,2024-06-17,Senate,"Do pass, but first be re-referred to the Committee on [Appropriations]",8,3,0,0,11
1832591,1461950,2024-07-01,Senate,"Placed on suspense file",7,0,0,0,7
1832591,1464188,2024-08-15,Senate,"Do pass as amended",5,2,0,0,7
1832591,1466326,2024-08-29,Senate,"Assembly 3rd Reading AB1992 Boerner By Padilla",31,9,0,0,40
1832591,1466533,2024-08-30,Assembly,"AB 1992 Boerner Concurrence in Senate Amendments",58,9,0,12,79
1832592,1419121,2024-04-02,Assembly,"Do pass and be re-referred to the Committee on [Appropriations]",7,0,0,0,7
1832592,1444414,2024-05-16,Assembly,"Do pass as amended",11,1,0,3,15
1832592,1448680,2024-05-22,Assembly,"AB 1993 Kalra Assembly Third Reading",65,2,0,13,80
1832592,1462352,2024-07-01,Senate,"Do pass, but first be re-referred to the Committee on [Appropriations]",5,0,0,0,5
1832592,1463351,2024-08-05,Senate,"Placed on suspense file",7,0,0,0,7
1832593,1424828,2024-04-09,Assembly,"Do pass and be re-referred to the Committee on [Appropriations]",10,0,0,0,10
1832593,1429957,2024-04-17,Assembly,"Do pass. To Consent Calendar",15,0,0,0,15
1832593,1435321,2024-04-25,Assembly,"AB 1994 Military and Veterans Affairs Consent Calendar Second Day Regular Session",75,0,0,5,80
1832593,1460041,2024-06-24,Senate,"Do pass, but first be re-referred to the Committee on [Appropriations]",5,0,0,0,5
1832593,1463606,2024-08-05,Senate,"Placed on suspense file",7,0,0,0,7
1832593,1464234,2024-08-15,Senate,"Do pass",5,0,0,2,7
1832593,1465539,2024-08-26,Senate,"Assembly 3rd Reading AB1994 M. & V.A. (Schiavo) By Archuleta",36,0,0,4,40
1832595,1423848,2024-04-09,Assembly,"Do pass as amended, and be re-referred to the Committee on [Arts, Entertainment, Sports, and Tourism] with recommendation: To Consent Calendar",16,0,0,0,16
1832595,1428852,2024-04-16,Assembly,"Do pass and be re-referred to the Committee on [Appropriations]",7,0,0,0,7
1832595,1444166,2024-05-16,Assembly,"Do pass as amended",11,0,0,4,15
1832595,1448695,2024-05-22,Assembly,"AB 1996 Alanis Assembly Third Reading",70,0,0,10,80
1832595,1460500,2024-06-26,Senate,"Do pass and be ordered to the Consent Calendar",11,0,0,0,11
1832595,1462699,2024-07-03,Senate,"Consent Calendar 2nd AB1996 Alanis",39,0,0,1,40
1832595,1463824,2024-08-08,Assembly,"AB 1996 Alanis Concurrence in Senate Amendments",72,0,0,7,79
1832596,1420127,2024-04-03,Assembly,"Do pass and be re-referred to the Committee on [Appropriations]",7,0,0,0,7
1832596,1444436,2024-05-16,Assembly,"Do pass",14,0,0,1,15
1832596,1446059,2024-05-21,Assembly,"AB 1997 McKinnor Assembly Third Reading",72,0,0,8,80
1832596,1456896,2024-06-12,Senate,"Do pass, but first be re-referred to the Committee on [Appropriations]",5,0,0,0,5
1832596,1459376,2024-06-24,Senate,"Placed on suspense file",6,0,0,1,7
1832596,1464146,2024-08-15,Senate,"Do pass",7,0,0,0,7
1832596,1466632,2024-08-28,Senate,"Special Consent AB1997 McKinnor",39,0,0,1,40
1832598,1443459,2024-05-15,Assembly,"Do pass and be re-referred to the Committee on [Appropriations]",9,0,0,7,16
1832598,1444233,2024-05-16,Assembly,"Do pass as amended",2,0,0,13,15
1832600,1412513,2024-03-20,Assembly,"Do pass and be re-referred to the Committee on [Appropriations] with recommendation: To Consent Calendar",8,0,0,0,8
1832600,1424899,2024-04-10,Assembly,"Do pass. To Consent Calendar",14,0,0,1,15
1832600,1431066,2024-04-18,Assembly,"AB 2001 Gallagher Consent Calendar Second Day Regular Session",72,0,0,8,80
1832600,1456434,2024-06-11,Senate,"Do pass, but first be re-referred to the Committee on [Appropriations] with the recommendation: To Consent Calendar",7,0,0,0,7
1832600,1461239,2024-06-27,Senate,"Consent Calendar 2nd AB2001 Gallagher",40,0,0,0,40
1832601,1411379,2024-03-19,Assembly,"Do pass and be re-referred to the Committee on [Appropriations]",13,0,0,2,15
1832602,1389459,2024-02-20,Assembly,"Be adopted as amended",9,0,0,3,12
1832602,1395207,2024-02-26,Assembly,"ACR 135 Weber Assembly Third Reading",59,0,0,21,80
1832603,1376396,2024-02-05,Assembly,"Be adopted. To third reading",7,0,0,4,11
1832604,1411334,2024-03-19,Senate,"Do pass, but first be re-referred to the Committee on [Appropriations]",1,0,0,6,7
1832604,1411335,2024-03-19,Senate,"[First] hearing set for [03-19-2024]: Failed passage in Committee. Reconsideration granted",7,0,0,0,7
1832605,1408228,2024-03-12,Senate,"Do pass, but first be re-referred to the Committee on [Appropriations]",5,0,0,0,5
1832605,1436188,2024-04-29,Senate,"Placed on suspense file",5,0,0,2,7
1832605,1444551,2024-05-16,Senate,"Do pass as amended",7,0,0,0,7
1832605,1449583,2024-05-23,Senate,"Senate 3rd Reading SB987 Menjivar",35,0,0,5,40
1832605,1462562,2024-07-02,Assembly,"Do pass and be re-referred to the Committee on [Appropriations]",6,0,0,2,8
1832606,1424841,2024-04-10,Senate,"Do pass, but first be re-referred to the Committee on [Judiciary]",5,0,0,0,5
1832606,1428937,2024-04-16,Senate,"Do pass as amended, but first amend, and re-refer to the Committee on [Appropriations]",10,0,0,1,11
1832606,1436244,2024-04-29,Senate,"Placed on suspense file",5,0,0,2,7
1832606,1444586,2024-05-16,Senate,"Do pass",5,2,0,0,7
1832606,1445255,2024-05-20,Senate,"Senate 3rd Reading SB988 Wiener",33,3,0,4,40
1832606,1458395,2024-06-19,Assembly,"Do pass and be re-referred to the Committee on [Judiciary]",7,0,0,0,7
1832606,1460048,2024-06-25,Assembly,"Do pass and be re-referred to the Committee on [Appropriations]",9,0,0,3,12
1832606,1464449,2024-08-15,Assembly,"Do pass as amended",12,0,0,3,15
1832606,1465714,2024-08-26,Assembly,"SB 988 Wiener Senate Third Reading By Lee",70,0,0,9,79
1832606,1466985,2024-08-28,Senate,"Unfinished Business SB988 Wiener Concurrence",34,3,0,3,40
1832607,1428965,2024-04-16,Senate,"Do pass as amended, but first amend, and re-refer to the Committee on [Judiciary]",5,0,0,0,5
1832607,1434247,2024-04-23,Senate,"Do pass as amended, but first amend, and re-refer to the Committee on [Appropriations]",11,0,0,0,11
1832607,1442541,2024-05-13,Senate,"Placed on suspense file",7,0,0,0,7
1832607,1444077,2024-05-16,Senate,"Do pass",6,0,0,1,7
1832607,1449640,2024-05-23,Senate,"Senate 3rd Reading SB989 Ashby et al",36,0,0,4,40
1832607,1458270,2024-06-18,Assembly,"Do pass and be re-referred to the Committee on [Judiciary] with recommendation: To Consent Calendar",7,0,0,1,8
1832607,1460037,2024-06-25,Assembly,"Do pass and be re-referred to the Committee on [Appropriations] with recommendation: To Consent Calendar",11,0,0,1,12
1832607,1464487,2024-08-15,Assembly,"Do pass",14,0,0,1,15
1832607,1465634,2024-08-26,Assembly,"SB 989 Ashby Senate Third Reading By Pellerin",77,0,0,2,79
1832607,1466979,2024-08-28,Senate,"Special Consent SB989 Ashby et al",39,0,0,1,40
1832608,1432921,2024-04-23,Senate,"Do pass as amended, but first amend, and re-refer to the Committee on [Appropriations]",12,1,0,3,16
1832608,1442597,2024-05-13,Senate,"Placed on suspense file",7,0,0,0,7
1832608,1444146,2024-05-16,Senate,"Do pass",5,0,0,2,7
1832608,1445249,2024-05-20,Senate,"Senate 3rd Reading SB990 Padilla et al",32,1,0,7,40
1832608,1455817,2024-06-10,Assembly,"Do pass and be re-referred to the Committee on [Appropriations]",7,0,0,1,8
1832608,1462344,2024-07-02,Assembly,"Do pass",11,0,0,4,15
1832608,1464313,2024-08-15,Assembly,"SB 990 Padilla Senate Third Reading By Ward",65,0,0,14,79
1832609,1392718,2024-02-22,Senate,"Senate 3rd Reading SCR105 Dodd et al",39,0,0,1,40
1832609,1402367,2024-03-04,Assembly,"Be adopted. To Consent Calendar",8,0,0,3,11
1832609,1405804,2024-03-07,Assembly,"SCR 105 Dodd Consent Calendar Second Day Regular Session",69,0,0,11,80
1834290,1408258,2024-03-12,Assembly,"Do pass as amended and be re-referred to the Committee on [Appropriations]",10,0,0,2,12
1834290,1444496,2024-05-16,Assembly,"Do pass",15,0,0,0,15
1834290,1445926,2024-05-21,Assembly,"AB 2004 Petrie-Norris Assembly Third Reading",73,0,0,7,80
1834290,1458267,2024-06-18,Senate,"Do pass as amended, but first amend, and re-refer to the Committee on [Local Government]",10,0,0,1,11
1834290,1462577,2024-07-03,Senate,"Do pass, but first be re-referred to the Committee on [Appropriations] with the recommendation: To Consent Calendar",7,0,0,0,7
1834290,1463575,2024-08-05,Senate,"Placed on suspense file",7,0,0,0,7
1834290,1464199,2024-08-15,Senate,"Do pass",7,0,0,0,7
1834290,1465498,2024-08-22,Senate,"Assembly 3rd Reading AB2004 Petrie-Norris By Portantino",33,0,0,7,40
1834290,1466118,2024-08-29,Assembly,"AB 2004 Petrie-Norris Concurrence in Senate Amendments",76,0,0,3,79
1834291,1412548,2024-03-20,Assembly,"Do pass and be re-referred to the Committee on [Higher Education]",7,0,0,2,9
1834291,1423789,2024-04-09,Assembly,"Do pass and be re-referred to the Committee on [Appropriations]",7,2,0,2,11
1834291,1444219,2024-05-16,Assembly,"Do pass as amended",11,4,0,0,15
1834291,1446134,2024-05-21,Assembly,"AB 2005 Ward Assembly Third Reading",61,7,0,12,80
1834291,1458451,2024-06-18,Senate,"Do pass, but first be re-referred to the Committee on [Appropriations]",9,1,0,0,10
1834291,1462038,2024-07-01,Senate,"Placed on suspense file",7,0,0,0,7
1834291,1464267,2024-08-15,Senate,"Do pass",4,2,0,1,7
1834291,1465708,2024-08-26,Senate,"Assembly 3rd Reading AB2005 Ward et al. By Menjivar",32,8,0,0,40
1834293,1412580,2024-03-20,Assembly,"Do pass and be re-referred to the Committee on [Human Services]",7,0,0,2,9
1834293,1433048,2024-04-23,Assembly,"Do pass and be re-referred to the Committee on [Appropriations]",5,0,0,2,7
1834297,1408817,2024-03-13,Assembly,"Do pass and be re-referred to the Committee on [Judiciary]",7,0,0,0,7
1834297,1411320,2024-03-19,Assembly,"Do pass and be re-referred to the Committee on [Appropriations] with recommendation: To Consent Calendar",12,0,0,0,12
1834297,1424910,2024-04-10,Assembly,"Do pass. To Consent Calendar",14,0,0,1,15
1834297,1431040,2024-04-18,Assembly,"AB 2011 Bauer-Kahan Consent Calendar Second Day Regular Session",72,0,0,8,80
1834297,1453474,2024-06-04,Senate,"Do pass, but first be re-referred to the Committee on [Labor, Public Employment and Retirement ] with the recommendation: To Consent Calendar",11,0,0,0,11
1834297,1456859,2024-06-12,Senate,"Do pass, but first be re-referred to the Committee on [Appropriations] with the recommendation: To Consent Calendar",5,0,0,0,5
1834297,1461254,2024-06-27,Senate,"Consent Calendar 2nd AB2011 Bauer-Kahan et al",40,0,0,0,40
1834297,1462479,2024-07-03,Assembly,"AB 2011 Bauer-Kahan Concurrence in Senate Amendments",71,0,0,8,79
1834298,1419164,2024-04-02,Assembly,"Do pass and be re-referred to the Committee on [Appropriations]",18,0,0,0,18
1834299,1436919,2024-04-30,Assembly,"Do pass as amended",8,1,0,2,11
1834299,1445187,2024-05-20,Assembly,"AB 2013 Irwin Assembly Third Reading",56,8,0,16,80
1834299,1460625,2024-06-25,Senate,"Do pass",10,1,0,0,11
1834299,1465604,2024-08-26,Senate,"Assembly 3rd Reading AB2013 Irwin By Padilla",39,0,0,1,40
1834299,1465941,2024-08-27,Assembly,"AB 2013 Irwin Concurrence in Senate Amendments",75,0,0,4,79
1834301,1433050,2024-04-23,Assembly,"Do pass as amended and be re-referred to the Committee on [Appropriations]",13,2,0,3,18
1834301,1441291,2024-05-08,Assembly,"Do pass",11,3,0,1,15
1834301,1445150,2024-05-20,Assembly,"AB 2015 Schiavo Assembly Third Reading",59,9,0,12,80
1834301,1457992,2024-06-17,Senate,"Do pass as amended, but first amend, and re-refer to the Committee on [Appropriations]",11,1,0,1,13
1834301,1465419,2024-08-21,Senate,"Assembly 3rd Reading AB2015 Schiavo By Roth",28,4,0,8,40
1834301,1465597,2024-08-26,Assembly,"AB 2015 Schiavo Concurrence in Senate Amendments",62,8,0,9,79
1834302,1408205,2024-03-12,Assembly,"Do pass and be re-referred to the Committee on [Appropriations]",10,0,0,2,12
1834302,1424902,2024-04-10,Assembly,"Do pass. To Consent Calendar",14,0,0,1,15
1834302,1430986,2024-04-18,Assembly,"AB 2016 Maienschein Consent Calendar Second Day Regular Session",72,0,0,8,80
1834302,1462583,2024-07-02,Senate,"Do pass",10,0,0,1,11
1834302,1465720,2024-08-26,Senate,"Assembly 3rd Reading AB2016 Maienschein et al. By Laird",39,0,0,1,40
1834302,1465874,2024-08-27,Assembly,"AB 2016 Maienschein Concurrence in Senate Amendments",77,0,0,2,79
1834303,1427230,2024-04-15,Assembly,"Do pass and be re-referred to the Committee on [Appropriations]",8,0,0,1,9
1834303,1437583,2024-05-01,Assembly,"Do pass",11,0,0,4,15
1834303,1444159,2024-05-16,Assembly,"AB 2017 Grayson Assembly Third Reading",62,1,0,17,80
1834303,1458479,2024-06-19,Senate,"Do pass, but first be re-referred to the Committee on [Judiciary]",6,0,0,1,7
1834303,1460592,2024-06-25,Senate,"Do pass, but first be re-referred to the Committee on [Appropriations]",11,0,0,0,11
1834303,1465397,2024-08-21,Senate,"Assembly 3rd Reading AB2017 Grayson By Caballero",32,0,0,8,40
1834304,1408248,2024-03-12,Assembly,"Do pass and be re-referred to the Committee on [Appropriations] with recommendation: To Consent Calendar",8,0,0,0,8
1834304,1412528,2024-03-20,Assembly,"Do pass. To Consent Calendar",12,0,0,3,15
1834304,1421156,2024-04-04,Assembly,"AB 2018 Rodriguez Consent Calendar Second Day Regular Session",70,0,0,10,80
1834304,1453389,2024-06-04,Senate,"Do pass, but first be re-referred to the Committee on [Appropriations] with the recommendation: To Consent Calendar",5,0,0,0,5
1834304,1458827,2024-06-20,Senate,"Consent Calendar 2nd AB2018 Rodriguez et al",36,0,0,4,40
1834305,1420037,2024-04-02,Assembly,"Do pass and be re-referred to the Committee on [Education]",11,0,0,0,11
1834305,1424775,2024-04-10,Assembly,"Do pass and be re-referred to the Committee on [Appropriations]",7,0,0,0,7
1834305,1443911,2024-05-16,Assembly,"Do pass as amended",11,0,0,4,15
1834305,1450031,2024-05-24,Assembly,"AB 2019 Hoover Assembly Third Reading",65,0,0,15,80
1834305,1460545,2024-06-26,Senate,"Do pass as amended, but first amend, and re-refer to the Committee on [Appropriations] with the recommendation: To Consent Calendar",7,0,0,0,7
1834305,1463502,2024-08-05,Senate,"Placed on suspense file",7,0,0,0,7
1834306,1432990,2024-04-23,Assembly,"Do pass and be re-referred to the Committee on [Appropriations] with recommendation: To Consent Calendar",8,0,0,0,8
1834306,1444332,2024-05-16,Assembly,"Do pass as amended",11,0,0,4,15
1834306,1446076,2024-05-21,Assembly,"AB 2020 Bonta Assembly Third Reading",71,0,0,9,80
1834306,1458195,2024-06-18,Senate,"Do pass, but first be re-referred to the Committee on [Appropriations] with the recommendation: To Consent Calendar",5,0,0,0,5
1834306,1462001,2024-07-01,Senate,"Placed on suspense file",7,0,0,0,7
1834306,1464255,2024-08-15,Senate,"Do pass as amended",7,0,0,0,7
1834306,1466465,2024-08-30,Senate,"Special Consent AB2020 Bonta et al. By Wahab",40,0,0,0,40
1834306,1467081,2024-08-31,Assembly,"AB 2020 Bonta Concurrence in Senate Amendments",77,0,0,2,79
1834307,1408239,2024-03-12,Assembly,"Do pass as amended and be re-referred to the Committee on [Appropriations]",8,0,0,0,8
1834307,1424791,2024-04-10,Assembly,"Do pass. To Consent Calendar",14,0,0,1,15
1834307,1431012,2024-04-18,Assembly,"AB 2021 Bauer-Kahan Consent Calendar Second Day Regular Session",72,0,0,8,80
1834307,1460035,2024-06-25,Senate,"Do pass, but first be re-referred to the Committee on [Appropriations]",4,1,0,0,5
1834307,1465356,2024-08-20,Senate,"Assembly 3rd Reading AB2021 Bauer-Kahan By Becker",34,2,0,4,40
1834307,1465557,2024-08-26,Assembly,"AB 2021 Bauer-Kahan Concurrence in Senate Amendments",75,0,0,4,79
1834308,1434040,2024-04-24,Assembly,"Do pass as amended and be re-referred to the Committee on [Appropriations]",7,1,0,1,9
1834308,1444133,2024-05-16,Assembly,"Do pass as amended",11,3,0,1,15
1834308,1448640,2024-05-22,Assembly,"AB 2022 Addis Assembly Third Reading",56,4,0,20,80
1834308,1462619,2024-07-02,Senate,"Do pass, but first be re-referred to the Committee on [Appropriations]",7,1,0,2,10
1834308,1463589,2024-08-05,Senate,"Placed on suspense file",7,0,0,0,7
1834308,1464591,2024-08-15,Senate,"Do pass",5,2,0,0,7
1834308,1466233,2024-08-29,Assembly,"AB 2022 Addis Concurrence in Senate Amendments",54,13,0,12,79
1834308,1466798,2024-08-28,Senate,"Assembly 3rd Reading AB2022 Addis et al. By Skinner",31,6,0,3,40
1834309,1424915,2024-04-10,Assembly,"Do pass and be re-referred to the Committee on [Local Government]",6,0,0,3,9
1834309,1435351,2024-04-24,Assembly,"Do pass and be re-referred to the Committee on [Appropriations]",7,1,0,1,9
1834309,1441287,2024-05-08,Assembly,"Do pass",11,3,0,1,15
1834309,1445293,2024-05-20,Assembly,"AB 2023 Quirk-Silva Assembly Third Reading",56,7,0,17,80
1834309,1460055,2024-06-24,Senate,"Do pass as amended, but first amend, and re-refer to the Committee on [Judiciary]",8,2,0,0,10
1834309,1462687,2024-07-02,Senate,"Do pass, but first be re-referred to the Committee on [Appropriations]",7,2,0,2,11
1834309,1465984,2024-08-27,Senate,"Assembly 3rd Reading AB2023 Quirk-Silva et al. By Umberg",21,12,0,7,40
1834309,1466753,2024-08-28,Assembly,"AB 2023 Quirk-Silva Concurrence in Senate Amendments",58,9,0,12,79
1834310,1389476,2024-02-20,Assembly,"Be adopted. To third reading",7,0,0,4,11
1834310,1409576,2024-03-14,Senate,"Special Consent ACR136 Holden et al",38,0,0,2,40
1834311,1420033,2024-04-03,Senate,"Do pass as amended, but first amend, and re-refer to the Committee on [Appropriations]",6,0,0,1,7
1834311,1427267,2024-04-15,Senate,"Placed on suspense file",6,0,0,1,7
1834311,1443919,2024-05-16,Senate,"Do pass",5,2,0,0,7
1834311,1445301,2024-05-20,Senate,"Senate 3rd Reading SB991 Gonzalez",31,8,0,1,40
1834311,1456856,2024-06-12,Assembly,"Do pass as amended and be re-referred to the Committee on [Appropriations]",7,0,0,0,7
1834311,1464446,2024-08-15,Assembly,"Do pass",13,0,0,2,15
1834311,1465706,2024-08-26,Assembly,"SB 991 Gonzalez Senate Third Reading By Santiago",74,0,0,5,79
1834311,1465800,2024-08-27,Senate,"Unfinished Business SB991 Gonzalez Concurrence",31,8,0,1,40
1834313,1428752,2024-04-16,Senate,"Do pass as amended, but first amend, and re-refer to the Committee on [Appropriations]",15,2,0,1,18
1834313,1439702,2024-05-06,Senate,"Placed on suspense file",7,0,0,0,7
1834314,1437661,2024-05-01,Senate,"Do pass and be ordered to the Consent Calendar",6,0,0,1,7
1834314,1441932,2024-05-09,Senate,"Consent Calendar 2nd SB994 Roth",37,0,0,3,40
1834314,1454196,2024-06-05,Assembly,"Do pass. To Consent Calendar",9,0,0,0,9
1834314,1457343,2024-06-13,Assembly,"SB 994 Roth Consent Calendar Second Day Regular Session",77,0,0,2,79
1834315,1412601,2024-03-20,Senate,"Do pass as amended, but first amend, and re-refer to the Committee on [Appropriations]",7,0,0,0,7
1834315,1427253,2024-04-15,Senate,"Placed on suspense file",6,0,0,1,7
1834315,1444509,2024-05-16,Senate,"Do pass",7,0,0,0,7
1834315,1449565,2024-05-23,Senate,"Special Consent SB995 Padilla",37,0,0,3,40
1834315,1458216,2024-06-18,Assembly,"Do pass as amended and be re-referred to the Committee on [Appropriations]",8,0,0,3,11
1834316,1429903,2024-04-17,Senate,"Do pass, but first be re-referred to the Committee on [Appropriations]",5,1,0,1,7
1834316,1436231,2024-04-29,Senate,"Placed on suspense file",5,0,0,2,7
1834317,1412538,2024-03-20,Senate,"Do pass as amended, but first amend, and re-refer to the Committee on [Health] with the recommendation: To Consent Calendar",7,0,0,0,7
1834317,1431887,2024-04-22,Senate,"Do pass, but first be re-referred to the Committee on [Appropriations] with the recommendation: To Consent Calendar",11,0,0,0,11
1834317,1439716,2024-05-06,Senate,"Placed on suspense file",7,0,0,0,7
1834317,1444363,2024-05-16,Senate,"Do pass",7,0,0,0,7
1834317,1449698,2024-05-23,Senate,"Special Consent SB997 Portantino et al",37,0,0,3,40
1834317,1456876,2024-06-12,Assembly,"Do pass as amended and be re-referred to the Committee on [Appropriations]",7,0,0,0,7
1834317,1464257,2024-08-15,Assembly,"Do pass",14,0,0,1,15
1834317,1466505,2024-08-30,Senate,"Special Consent SB997 Portantino et al",40,0,0,0,40
1834317,1467042,2024-08-28,Assembly,"SB 997 Portantino Senate Third Reading By Boerner",77,0,0,2,79
1834318,1416674,2024-02-16,Senate,"Senate 3rd Reading SR63 Rubio et al",33,0,0,7,40
1835418,1408235,2024-03-12,Assembly,"Do pass as amended",10,0,0,2,12
1835418,1413837,2024-03-21,Assembly,"AB 2024 Pacheco Assembly Third Reading",66,0,0,14,80
1835418,1453383,2024-06-04,Senate,"Do pass, but first be re-referred to the Committee on [Appropriations] with the recommendation: To Consent Calendar",11,0,0,0,11
1835418,1457974,2024-06-17,Senate,"Placed on suspense file",7,0,0,0,7
1835418,1464149,2024-08-15,Senate,"Do pass",7,0,0,0,7
1835418,1466182,2024-08-29,Assembly,"AB 2024 Pacheco Concurrence in Senate Amendments",76,0,0,3,79
1835418,1466758,2024-08-28,Senate,"Special Consent AB2024 Pacheco",39,0,0,1,40
1835421,1432982,2024-04-23,Assembly,"Do pass and be re-referred to the Committee on [Appropriations]",10,0,0,1,11
1835423,1411319,2024-03-19,Assembly,"Do pass and be re-referred to the Committee on [Utilities and Energy]",13,0,0,2,15
1835423,1429981,2024-04-17,Assembly,"Do pass as amended, and be re-referred to the Committee on [Appropriations] with recommendation: To Consent Calendar",16,0,0,0,16
1835424,1428755,2024-04-16,Assembly,"Do pass and be re-referred to the Committee on [Appropriations]",7,0,0,0,7
1835426,1466218,2024-08-29,Assembly,"AB 2032 Jim Patterson Third Reading Urgency",76,0,0,3,79
1835426,1467160,2024-08-31,Senate,"Assembly 2nd Reading AB2032 Jim Patterson et al. By Grove Urgency Clause",39,0,0,1,40
1835427,1420128,2024-04-02,Assembly,"Do pass and be re-referred to the Committee on [Human Services]",10,0,0,1,11
1835427,1432954,2024-04-23,Assembly,"Do pass and be re-referred to the Committee on [Appropriations] with recommendation: To Consent Calendar",6,0,0,1,7
1835427,1444047,2024-05-16,Assembly,"Do pass as amended",11,0,0,4,15
1835427,1446042,2024-05-21,Assembly,"AB 2033 Reyes Assembly Third Reading",73,0,0,7,80
1835427,1454247,2024-06-05,Senate,"Do pass, but first be re-referred to the Committee on [Human Services]",7,0,0,0,7
1835427,1462234,2024-07-01,Senate,"Do pass, but first be re-referred to the Committee on [Appropriations]",5,0,0,0,5
1835427,1463423,2024-08-05,Senate,"Placed on suspense file",7,0,0,0,7
1835427,1464036,2024-08-15,Senate,"Do pass",7,0,0,0,7
1835427,1466377,2024-08-29,Assembly,"AB 2033 Reyes Concurrence in Senate Amendments",75,0,0,4,79
1835427,1466882,2024-08-28,Senate,"Special Consent AB2033 Reyes et al. By Menjivar",39,0,0,1,40
1835429,1408230,2024-03-12,Assembly,"Do pass and be re-referred to the Committee on [Appropriations]",2,0,0,6,8
1835430,1428777,2024-04-16,Assembly,"Do pass and be re-referred to the Committee on [Appropriations] with recommendation: To Consent Calendar",8,0,0,0,8
1835431,1408825,2024-03-12,Assembly,"Do pass as amended and be re-referred to the Committee on [Appropriations]",10,0,0,1,11
1835431,1424808,2024-04-10,Assembly,"Do pass",14,0,0,1,15
1835431,1436220,2024-04-29,Assembly,"AB 2037 Papan Assembly Third Reading",73,0,0,7,80
1835431,1455767,2024-06-10,Senate,"Do pass, but first be re-referred to the Committee on [Judiciary]",9,0,0,4,13
1835431,1462684,2024-07-02,Senate,"Do pass, but first be re-referred to the Committee on [Appropriations]",11,0,0,0,11
1835431,1465712,2024-08-26,Senate,"Assembly 3rd Reading AB2037 Papan et al. By Becker",38,0,0,2,40
1835431,1465804,2024-08-27,Assembly,"AB 2037 Papan Concurrence in Senate Amendments",76,0,0,3,79
1835432,1433076,2024-04-23,Assembly,"Do pass as amended and be re-referred to the Committee on [Appropriations]",13,0,0,2,15
1835432,1444532,2024-05-16,Assembly,"Do pass as amended",11,0,0,4,15
1835432,1448784,2024-05-22,Assembly,"AB 2038 Quirk-Silva Assembly Third Reading",70,0,0,10,80
1835432,1458033,2024-06-17,Senate,"Do pass, but first be re-referred to the Committee on [Appropriations]",11,0,0,0,11
1835432,1462087,2024-07-01,Senate,"Placed on suspense file",7,0,0,0,7
1835432,1464457,2024-08-15,Senate,"Do pass",7,0,0,0,7
1835432,1466193,2024-08-29,Assembly,"AB 2038 Quirk-Silva Concurrence in Senate Amendments",76,0,0,3,79
1835432,1466729,2024-08-28,Senate,"Special Consent AB2038 Quirk-Silva et al. By Blakespear",39,0,0,1,40
1835434,1411390,2024-03-19,Assembly,"Do pass and be re-referred to the Committee on [Appropriations] with recommendation: To Consent Calendar",8,0,0,0,8
1835434,1444648,2024-05-16,Assembly,"Do pass",15,0,0,0,15
1835434,1446000,2024-05-21,Assembly,"AB 2040 Waldron Assembly Third Reading",73,0,0,7,80
1835434,1460113,2024-06-25,Senate,"Do pass, but first be re-referred to the Committee on [Appropriations] with the recommendation: To Consent Calendar",5,0,0,0,5
1835434,1463652,2024-08-05,Senate,"Placed on suspense file",7,0,0,0,7
1835435,1412597,2024-03-20,Assembly,"Do pass and be re-referred to the Committee on [Appropriations]",7,0,0,1,8
1835435,1424913,2024-04-10,Assembly,"Do pass",13,0,0,2,15
1835435,1435318,2024-04-25,Assembly,"AB 2041 Bonta Third Reading Urgency",72,0,0,8,80
1835435,1456314,2024-06-11,Senate,"Do pass as amended, but first amend, and re-refer to the Committee on [Appropriations]",7,0,0,0,7
1835435,1467118,2024-08-31,Senate,"Assembly 3rd Reading AB2041 Bonta et al. By Menjivar Urgency Clause",34,5,0,1,40
1835435,1467119,2024-09-01,Assembly,"AB 2041 Bonta Concurrence in Senate Amendments",68,0,0,11,79
1835436,1424909,2024-04-09,Assembly,"Do pass and be re-referred to the Committee on [Appropriations]",6,1,0,1,8
1835436,1444119,2024-05-16,Assembly,"Do pass as amended",9,4,0,2,15
1835436,1449639,2024-05-23,Assembly,"AB 2042 Jackson Assembly Third Reading",49,6,0,25,80
1835436,1462268,2024-07-02,Senate,"Do pass as amended, but first amend, and re-refer to the Committee on [Appropriations]",4,0,0,1,5
1835436,1463465,2024-08-05,Senate,"Placed on suspense file",7,0,0,0,7
1835437,1423908,2024-04-09,Assembly,"Do pass and be re-referred to the Committee on [Appropriations] with recommendation: To Consent Calendar",16,0,0,0,16
1835437,1444018,2024-05-16,Assembly,"Do pass",15,0,0,0,15
1835437,1445984,2024-05-21,Assembly,"AB 2043 Boerner Assembly Third Reading",73,0,0,7,80
1835437,1456926,2024-06-12,Senate,"Do pass, but first be re-referred to the Committee on [Appropriations] with the recommendation: To Consent Calendar",10,0,0,1,11
1835437,1459404,2024-06-24,Senate,"Placed on suspense file",6,0,0,1,7
1835438,1420171,2024-04-02,Assembly,"Do pass and be re-referred to the Committee on [Appropriations] with recommendation: To Consent Calendar",11,0,0,0,11
1835438,1429928,2024-04-17,Assembly,"Do pass. To Consent Calendar",15,0,0,0,15
1835438,1435227,2024-04-25,Assembly,"AB 2044 Chen Consent Calendar Second Day Regular Session",75,0,0,5,80
1835438,1451568,2024-05-29,Senate,"Do pass, but first be re-referred to the Committee on [Appropriations] with the recommendation: To Consent Calendar",7,0,0,0,7
1835438,1455818,2024-06-10,Senate,"Placed on suspense file",7,0,0,0,7
1835439,1424847,2024-04-09,Assembly,"Do pass as amended and be re-referred to the Committee on [Appropriations]",7,0,0,1,8
1835440,1412546,2024-03-20,Assembly,"Do pass and be re-referred to the Committee on [Appropriations] with recommendation: To Consent Calendar",7,0,0,0,7
1835440,1424983,2024-04-10,Assembly,"Do pass. To Consent Calendar",14,0,0,1,15
1835440,1430976,2024-04-18,Assembly,"AB 2046 Bryan Consent Calendar Second Day Regular Session",72,0,0,8,80
1835440,1454211,2024-06-05,Senate,"Do pass as amended, but first amend, and re-refer to the Committee on [Judiciary]",5,1,0,1,7
1835440,1458217,2024-06-18,Senate,"Do pass, but first be re-referred to the Committee on [Appropriations]",8,0,0,3,11
1835440,1465660,2024-08-26,Senate,"Assembly 3rd Reading AB2046 Bryan By Bradford",31,8,0,1,40
1835440,1465839,2024-08-27,Assembly,"AB 2046 Bryan Concurrence in Senate Amendments",65,0,0,14,79
1835441,1430056,2024-04-16,Assembly,"Do pass as amended and be re-referred to the Committee on [Appropriations]",11,0,0,0,11
1835441,1444169,2024-05-16,Assembly,"Do pass as amended",11,0,0,4,15
1835441,1448710,2024-05-22,Assembly,"AB 2047 Mike Fong Assembly Third Reading",70,0,0,10,80
1835441,1458541,2024-06-19,Senate,"Do pass, but first be re-referred to the Committee on [Judiciary]",7,0,0,0,7
1835441,1460773,2024-06-25,Senate,"Do pass, but first be re-referred to the Committee on [Appropriations]",11,0,0,0,11
1835441,1465787,2024-08-27,Senate,"Assembly 3rd Reading AB2047 Mike Fong By Dodd",40,0,0,0,40
1835441,1466889,2024-08-28,Assembly,"AB 2047 Mike Fong Concurrence in Senate Amendments",77,0,0,2,79
1835442,1430099,2024-04-16,Assembly,"Do pass as amended and be re-referred to the Committee on [Appropriations]",11,0,0,0,11
1835442,1444550,2024-05-16,Assembly,"Do pass as amended",11,0,0,4,15
1835442,1448639,2024-05-22,Assembly,"AB 2048 Mike Fong Assembly Third Reading",69,0,0,11,80
1835442,1458546,2024-06-19,Senate,"Do pass, but first be re-referred to the Committee on [Judiciary] with the recommendation: To Consent Calendar",7,0,0,0,7
1835442,1460605,2024-06-25,Senate,"Do pass, but first be re-referred to the Committee on [Appropriations]",11,0,0,0,11
1835442,1463477,2024-08-05,Senate,"Placed on suspense file",7,0,0,0,7
1835442,1464435,2024-08-15,Senate,"Do pass as amended",7,0,0,0,7
1835442,1465905,2024-08-27,Senate,"Assembly 3rd Reading AB2048 Mike Fong By Dodd",40,0,0,0,40
1835442,1466886,2024-08-28,Assembly,"AB 2048 Mike Fong Concurrence in Senate Amendments",76,0,0,3,79
1835443,1436934,2024-04-30,Assembly,"Do pass. To Consent Calendar",12,0,0,0,12
1835443,1441954,2024-05-09,Assembly,"AB 2049 Pacheco Consent Calendar Second Day Regular Session",65,0,0,15,80
1835443,1456433,2024-06-11,Senate,"Do pass and be ordered to the Consent Calendar",11,0,0,0,11
1835443,1458841,2024-06-20,Senate,"Consent Calendar 2nd AB2049 Pacheco",36,0,0,4,40
1835444,1412499,2024-03-20,Assembly,"Do pass and be re-referred to the Committee on [Privacy and Consumer Protection]",7,0,0,1,8
1835444,1430057,2024-04-16,Assembly,"Do pass and be re-referred to the Committee on [Appropriations]",8,1,0,2,11
1835444,1443992,2024-05-16,Assembly,"Do pass as amended",11,2,0,2,15
1835444,1448629,2024-05-22,Assembly,"AB 2050 Pellerin Assembly Third Reading",59,1,0,20,80
1835444,1458169,2024-06-18,Senate,"Do pass, but first be re-referred to the Committee on [Judiciary]",6,1,0,0,7
1835444,1462637,2024-07-02,Senate,"Do pass, but first be re-referred to the Committee on [Appropriations]",7,2,0,2,11
1835444,1463368,2024-08-05,Senate,"Placed on suspense file",7,0,0,0,7
1835445,1428896,2024-04-16,Assembly,"Do pass as amended and be re-referred to the Committee on [Appropriations]",17,0,0,1,18
1835445,1443978,2024-05-16,Assembly,"Do pass",15,0,0,0,15
1835445,1449586,2024-05-23,Assembly,"AB 2051 Bonta Assembly Third Reading",67,0,0,13,80
1835446,1419111,2024-04-02,Assembly,"Do pass as amended and be re-referred to the Committee on [Education]",14,0,0,2,16
1835446,1435228,2024-04-24,Assembly,"Do pass and be re-referred to the Committee on [Appropriations]",6,0,0,1,7
1835447,1412561,2024-03-20,Assembly,"Do pass and be re-referred to the Committee on [Appropriations]",6,0,0,1,7
1835447,1424942,2024-04-10,Assembly,"Do pass. To Consent Calendar",14,0,0,1,15
1835447,1431050,2024-04-18,Assembly,"AB 2053 Mathis Consent Calendar Second Day Regular Session",72,0,0,8,80
1835447,1451612,2024-05-29,Senate,"Do pass, but first be re-referred to the Committee on [Appropriations]",7,0,0,0,7
1835447,1465370,2024-08-20,Senate,"Assembly 3rd Reading AB2053 Mathis et al. By Ochoa Bogh",40,0,0,0,40
1835447,1465516,2024-08-22,Assembly,"AB 2053 Mathis Concurrence in Senate Amendments",62,0,0,17,79
1835448,1420092,2024-04-03,Assembly,"Do pass as amended and be re-referred to the Committee on [Appropriations]",12,2,0,2,16
1835448,1444282,2024-05-16,Assembly,"Do pass as amended",10,2,0,3,15
1835448,1448788,2024-05-22,Assembly,"AB 2054 Bauer-Kahan Assembly Third Reading",48,10,0,22,80
1835448,1462372,2024-07-02,Senate,"Do pass as amended, but first amend, and re-refer to the Committee on [Appropriations]",15,2,0,1,18
1835448,1463424,2024-08-05,Senate,"Placed on suspense file",7,0,0,0,7
1835449,1408212,2024-03-12,Assembly,"Do pass and be re-referred to the Committee on [Appropriations] with recommendation: To Consent Calendar",8,0,0,0,8
1835451,1429979,2024-04-16,Assembly,"Do pass as amended, and be re-referred to the Committee on [Appropriations] with recommendation: To Consent Calendar",11,0,0,0,11
1835451,1444020,2024-05-16,Assembly,"Do pass as amended",11,0,0,4,15
1835451,1446074,2024-05-21,Assembly,"AB 2057 Berman Assembly Third Reading",73,0,0,7,80
1835451,1458517,2024-06-19,Senate,"Do pass, but first be re-referred to the Committee on [Appropriations]",7,0,0,0,7
1835451,1461970,2024-07-01,Senate,"Placed on suspense file",7,0,0,0,7
1835451,1464162,2024-08-15,Senate,"Do pass as amended",7,0,0,0,7
1835451,1466268,2024-08-29,Assembly,"AB 2057 Berman Concurrence in Senate Amendments",76,0,0,3,79
1835451,1466863,2024-08-28,Senate,"Assembly 3rd Reading AB2057 Berman By Glazer",38,0,0,2,40
1835452,1423795,2024-04-09,Assembly,"Do pass and be re-referred to the Committee on [Appropriations]",15,0,0,1,16
1835452,1437627,2024-05-01,Assembly,"Do pass",13,0,0,2,15
1835452,1442594,2024-05-13,Assembly,"AB 2058 Weber Assembly Third Reading",69,0,0,11,80
1835452,1462490,2024-07-03,Senate,"Do pass, but first be re-referred to the Committee on [Appropriations] with the recommendation: To Consent Calendar",11,0,0,0,11
1835452,1466099,2024-08-29,Assembly,"AB 2058 Weber Concurrence in Senate Amendments",75,0,0,4,79
1835452,1466706,2024-08-28,Senate,"Assembly 3rd Reading AB2058 Weber By Eggman",39,0,0,1,40
1835454,1432950,2024-04-23,Assembly,"Do pass and be re-referred to the Committee on [Appropriations]",13,0,0,2,15
1835454,1444209,2024-05-16,Assembly,"Do pass as amended",11,0,0,4,15
1835454,1445971,2024-05-21,Assembly,"AB 2060 Soria Assembly Third Reading",71,0,0,9,80
1835454,1460067,2024-06-25,Senate,"Do pass as amended, but first amend, and re-refer to the Committee on [Appropriations]",11,0,0,0,11
1835454,1463650,2024-08-05,Senate,"Placed on suspense file",7,0,0,0,7
1835454,1464546,2024-08-15,Senate,"Do pass as amended",7,0,0,0,7
1835455,1436973,2024-04-29,Assembly,"Do pass as amended and be re-referred to the Committee on [Appropriations]",7,0,0,0,7
1835455,1444373,2024-05-16,Assembly,"Do pass",15,0,0,0,15
1835455,1446034,2024-05-21,Assembly,"AB 2061 Wilson Assembly Third Reading",71,0,0,9,80
1835455,1460704,2024-06-26,Senate,"Do pass, but first be re-referred to the Committee on [Appropriations]",7,0,0,0,7
1835455,1463583,2024-08-05,Senate,"Placed on suspense file",7,0,0,0,7
1835455,1464517,2024-08-15,Senate,"Do pass",6,0,0,1,7
1835455,1465545,2024-08-26,Senate,"Assembly 3rd Reading AB2061 Wilson By Becker",40,0,0,0,40
1835456,1427337,2024-04-15,Assembly,"Do pass and be re-referred to the Committee on [Appropriations]",9,0,0,0,9
1835456,1437617,2024-05-01,Assembly,"Do pass. To Consent Calendar",14,0,0,1,15
1835456,1441915,2024-05-09,Assembly,"AB 2062 Grayson Consent Calendar Second Day Regular Session",65,0,0,15,80
1835456,1458425,2024-06-19,Senate,"Do pass as amended, but first amend, and re-refer to the Committee on [Appropriations] with the recommendation: To Consent Calendar",6,0,0,1,7
1835456,1458800,2024-06-19,Senate,"Do pass as amended, but first amend, and re-refer to the Committee on [Judiciary] with the recommendation: To Consent Calendar",6,0,0,1,7
1835456,1462694,2024-07-02,Senate,"Do pass as amended, but first amend, and re-refer to the Committee on [Appropriations]",11,0,0,0,11
1835456,1465382,2024-08-20,Senate,"Assembly 3rd Reading AB2062 Grayson By Portantino",40,0,0,0,40
1835456,1465518,2024-08-22,Assembly,"AB 2062 Grayson Concurrence in Senate Amendments",62,0,0,17,79
1835457,1428864,2024-04-16,Assembly,"Do pass and be re-referred to the Committee on [Appropriations]",15,0,0,1,16
1835457,1444677,2024-05-16,Assembly,"Do pass",14,0,0,1,15
1835457,1445963,2024-05-21,Assembly,"AB 2063 Maienschein Assembly Third Reading",72,0,0,8,80
1835457,1456963,2024-06-12,Senate,"Do pass as amended, but first amend, and re-refer to the Committee on [Appropriations]",10,0,0,1,11
1835457,1459352,2024-06-24,Senate,"Placed on suspense file",6,0,0,1,7
1835457,1464026,2024-08-15,Senate,"Do pass",6,0,0,1,7
1835457,1465680,2024-08-26,Senate,"Assembly 3rd Reading AB2063 Maienschein By Blakespear",40,0,0,0,40
1835457,1465946,2024-08-27,Assembly,"AB 2063 Maienschein Concurrence in Senate Amendments",77,0,0,2,79
1835458,1424789,2024-04-09,Assembly,"Do pass and be re-referred to the Committee on [Health]",7,1,0,0,8
1835458,1433150,2024-04-23,Assembly,"Do pass and be re-referred to the Committee on [Appropriations]",15,1,0,0,16
1835458,1443930,2024-05-16,Assembly,"Do pass as amended",11,4,0,0,15
1835458,1446090,2024-05-21,Assembly,"AB 2064 Jones-Sawyer Assembly Third Reading",64,7,0,9,80
1835458,1458518,2024-06-19,Senate,"Do pass, but first be re-referred to the Committee on [Public Safety]",9,2,0,0,11
1835458,1462338,2024-07-02,Senate,"Do pass, but first be re-referred to the Committee on [Appropriations]",4,1,0,0,5
1835458,1463466,2024-08-05,Senate,"Placed on suspense file",7,0,0,0,7
1835459,1434262,2024-04-24,Assembly,"Do pass and be re-referred to the Committee on [Appropriations]",6,0,0,2,8
1835460,1428901,2024-04-16,Assembly,"Do pass as amended and be re-referred to the Committee on [Judiciary]",13,3,0,0,16
1835460,1432953,2024-04-23,Assembly,"Do pass and be re-referred to the Committee on [Appropriations]",7,2,0,3,12
1835461,1418369,2024-04-01,Assembly,"Be adopted. To third reading",8,0,0,3,11
1835461,1441927,2024-05-09,Senate,"Special Consent ACR137 Pacheco et al",37,0,0,3,40
1835462,1382165,2024-02-12,Assembly,"Be adopted. To third reading",8,0,0,3,11
1835463,1434027,2024-04-23,Senate,"Do pass as amended, but first amend, and re-refer to the Committee on [Appropriations] with the recommendation: To Consent Calendar",11,0,0,0,11
1835463,1442543,2024-05-13,Senate,"Placed on suspense file",7,0,0,0,7
1835463,1444623,2024-05-16,Senate,"Do pass as amended",7,0,0,0,7
1835463,1449999,2024-05-24,Senate,"Special Consent SB1000 Ashby et al",38,0,0,2,40
1835463,1458360,2024-06-18,Assembly,"Do pass as amended and be re-referred to the Committee on [Judiciary]",11,0,0,0,11
1835463,1462379,2024-07-02,Assembly,"Do pass and be re-referred to the Committee on [Appropriations]",11,0,0,1,12
1835464,1411328,2024-03-19,Senate,"Do pass",4,0,0,1,5
1835464,1450365,2024-05-21,Senate,"Senate 3rd Reading SB1001 Skinner",28,8,0,4,40
1835464,1462608,2024-07-02,Assembly,"Do pass",6,1,0,1,8
1835464,1465611,2024-08-26,Assembly,"SB 1001 Skinner Senate Third Reading By Grayson",57,12,0,10,79
1835464,1465962,2024-08-27,Senate,"Unfinished Business SB1001 Skinner Concurrence",30,9,0,1,40
1835465,1411363,2024-03-19,Senate,"Do pass, but first be re-referred to the Committee on [Appropriations]",5,0,0,0,5
1835465,1442608,2024-05-13,Senate,"Placed on suspense file",7,0,0,0,7
1835465,1444510,2024-05-16,Senate,"Do pass",7,0,0,0,7
1835465,1449677,2024-05-23,Senate,"Special Consent SB1002 Blakespear et al",37,0,0,3,40
1835465,1462696,2024-07-02,Assembly,"Do pass and be re-referred to the Committee on [Appropriations]",8,0,0,0,8
1835465,1464634,2024-08-15,Assembly,"Do pass as amended",11,0,0,4,15
1835465,1466088,2024-08-29,Senate,"Unfinished Business SB1002 Blakespear et al. Concurrence",40,0,0,0,40
1835465,1466666,2024-08-28,Assembly,"SB 1002 Blakespear Senate Third Reading By Zbur",76,0,0,3,79
1835466,1411399,2024-03-19,Senate,"Do pass as amended, but first amend, and re-refer to the Committee on [Appropriations]",17,0,0,1,18
1835466,1427329,2024-04-15,Senate,"Placed on suspense file",6,0,0,1,7
1835466,1444397,2024-05-16,Senate,"Do pass",7,0,0,0,7
1835466,1445234,2024-05-20,Senate,"Senate 3rd Reading SB1003 Dodd",39,0,0,1,40
1835466,1462103,2024-07-01,Assembly,"Do pass and be re-referred to the Committee on [Appropriations] with recommendation: To Consent Calendar",15,0,0,1,16
1835466,1464173,2024-08-15,Assembly,"Do pass as amended",11,0,0,4,15
1835466,1466399,2024-08-30,Assembly,"Do pass",16,0,0,0,16
1835467,1408823,2024-03-13,Senate,"Do pass as amended, but first amend, and re-refer to the Committee on [Appropriations]",7,0,0,0,7
1835467,1422096,2024-04-08,Senate,"Placed on suspense file",6,0,0,1,7
1835467,1444002,2024-05-16,Senate,"Do pass",7,0,0,0,7
1835467,1449608,2024-05-23,Senate,"Special Consent SB1004 Wilk",37,0,0,3,40
1835467,1462374,2024-07-01,Assembly,"Do pass and be re-referred to the Committee on [Appropriations]",6,0,0,1,7
1835468,1419198,2024-04-02,Senate,"Do pass, but first be re-referred to the Committee on [Appropriations] with the recommendation: To Consent Calendar",5,0,0,0,5
1835468,1435304,2024-04-25,Senate,"Consent Calendar 2nd SB1005 Ashby",36,0,0,4,40
1835468,1453376,2024-06-04,Assembly,"Do pass and be re-referred to the Committee on [Appropriations] with recommendation: To Consent Calendar",7,0,0,1,8
1835468,1462327,2024-07-02,Assembly,"Do pass. To Consent Calendar",15,0,0,0,15
1835468,1463776,2024-08-08,Assembly,"SB 1005 Ashby Consent Calendar Second Day Regular Session",72,0,0,7,79
1835469,1428913,2024-04-16,Senate,"Do pass as amended, but first amend, and re-refer to the Committee on [Rules]",18,0,0,0,18
1835469,1436239,2024-04-29,Senate,"Placed on suspense file",5,0,0,2,7
1835469,1443954,2024-05-16,Senate,"Do pass",7,0,0,0,7
1835469,1445225,2024-05-20,Senate,"Senate 3rd Reading SB1006 Padilla",39,0,0,1,40
1835469,1458437,2024-06-19,Assembly,"Do pass as amended, and be re-referred to the Committee on [Appropriations] with recommendation: To Consent Calendar",16,0,0,0,16
1835469,1463728,2024-08-07,Assembly,"Do pass. To Consent Calendar",14,0,0,1,15
1835469,1466177,2024-08-29,Senate,"Unfinished Business SB1006 Padilla Concurrence",40,0,0,0,40
1835469,1466703,2024-08-28,Assembly,"SB 1006 Padilla Senate Third Reading By Petrie-Norris",77,0,0,2,79
1835470,1420182,2024-04-02,Senate,"Do pass, but first be re-referred to the Committee on [Appropriations]",8,1,0,1,10
1835470,1427244,2024-04-15,Senate,"Placed on suspense file",6,0,0,1,7
1835471,1435254,2024-04-24,Senate,"Do pass as amended, but first amend, and re-refer to the Committee on [Appropriations]",9,2,0,0,11
1835471,1439724,2024-05-06,Senate,"Placed on suspense file",7,0,0,0,7
1835472,1423736,2024-04-09,Senate,"Do pass, but first be re-referred to the Committee on [Natural Resources and Water] with the recommendation: To Consent Calendar",14,0,0,2,16
1835472,1433131,2024-04-23,Senate,"Do pass, but first be re-referred to the Committee on [Appropriations] with the recommendation: To Consent Calendar",11,0,0,0,11
1835472,1441950,2024-05-09,Senate,"Consent Calendar 2nd SB1009 Dahle",37,0,0,3,40
1835472,1456430,2024-06-11,Assembly,"Do pass and be re-referred to the Committee on [Appropriations]",13,0,0,2,15
1835472,1458444,2024-06-19,Assembly,"Do pass. To Consent Calendar",14,0,0,1,15
1835472,1460706,2024-06-26,Assembly,"SB 1009 Dahle Consent Calendar Second Day Regular Session",75,0,0,4,79
1835474,1428889,2024-04-15,Senate,"Do pass, but first be re-referred to the Committee on [Judiciary]",3,1,0,1,5
1835474,1439713,2024-05-06,Senate,"Placed on suspense file",7,0,0,0,7
1835475,1435258,2024-04-24,Senate,"Do pass, but first be re-referred to the Committee on [Appropriations]",9,1,0,1,11
1835475,1439626,2024-05-06,Senate,"Placed on suspense file",7,0,0,0,7
1835475,1443970,2024-05-16,Senate,"Do pass",5,2,0,0,7
1835475,1450273,2024-05-21,Senate,"Senate 3rd Reading SB999 Cortese et al",31,7,0,2,40
1835475,1456311,2024-06-11,Assembly,"Do pass and be re-referred to the Committee on [Appropriations]",14,1,0,1,16
1837731,1411382,2024-03-19,Assembly,"Do pass and be re-referred to the Committee on [Appropriations] with recommendation: To Consent Calendar",12,0,0,0,12
1837731,1424937,2024-04-10,Assembly,"Do pass. To Consent Calendar",14,0,0,1,15
1837731,1431011,2024-04-18,Assembly,"AB 2067 Dixon Consent Calendar Second Day Regular Session",72,0,0,8,80
1837731,1456386,2024-06-11,Senate,"Do pass, but first be re-referred to the Committee on [Banking and Financial Institutions] with the recommendation: To Consent Calendar",11,0,0,0,11
1837731,1458563,2024-06-19,Senate,"Do pass as amended, but first amend, and re-refer to the Committee on [Appropriations] with the recommendation: To Consent Calendar",6,0,0,1,7
1837731,1463903,2024-08-12,Senate,"Consent Calendar 2nd AB2067 Dixon",38,0,0,2,40
1837731,1465283,2024-08-19,Assembly,"AB 2067 Dixon Concurrence in Senate Amendments",77,0,0,2,79
1837732,1431025,2024-04-17,Assembly,"Do pass and be re-referred to the Committee on [Appropriations]",7,0,0,0,7
1837732,1444592,2024-05-16,Assembly,"Do pass as amended",12,2,0,1,15
1837732,1448725,2024-05-22,Assembly,"AB 2068 Ortega Assembly Third Reading",66,0,0,14,80
1837732,1456408,2024-06-11,Senate,"Do pass, but first be re-referred to the Committee on [Labor, Public Employment and Retirement ]",12,1,0,3,16
1837732,1460569,2024-06-26,Senate,"Do pass, but first be re-referred to the Committee on [Appropriations]",5,0,0,0,5
1837732,1463533,2024-08-05,Senate,"Placed on suspense file",7,0,0,0,7
1837732,1464218,2024-08-15,Senate,"Do pass",5,2,0,0,7
1837732,1466347,2024-08-29,Senate,"Assembly 3rd Reading AB2068 Ortega By Lim√≥n",32,7,0,1,40
1837732,1466589,2024-08-30,Assembly,"AB 2068 Ortega Concurrence in Senate Amendments By LEE",74,0,0,5,79
1837733,1429992,2024-04-17,Assembly,"Do pass and be re-referred to the Committee on [Appropriations]",21,0,0,1,22
1837733,1437649,2024-05-01,Assembly,"Do pass. To Consent Calendar",14,0,0,1,15
1837733,1441904,2024-05-09,Assembly,"AB 2069 Gallagher Consent Calendar Second Day Regular Session",65,0,0,15,80
1837733,1456308,2024-06-11,Senate,"Do pass, but first be re-referred to the Committee on [Appropriations]",15,0,0,1,16
1837733,1465916,2024-08-27,Senate,"Assembly 3rd Reading AB2069 Gallagher et al. By Jones",40,0,0,0,40
1837734,1420129,2024-04-02,Assembly,"Do pass and be re-referred to the Committee on [Appropriations]",9,1,0,1,11
1837734,1430034,2024-04-17,Assembly,"Do pass",11,3,0,1,15
1837735,1412588,2024-03-20,Assembly,"Do pass and be re-referred to the Committee on [Appropriations]",6,0,0,1,7
1837735,1444506,2024-05-16,Assembly,"Do pass as amended",11,0,0,4,15
1837735,1446026,2024-05-21,Assembly,"AB 2071 Juan Carrillo Assembly Third Reading",74,0,0,6,80
1837735,1456959,2024-06-12,Senate,"Do pass, but first be re-referred to the Committee on [Appropriations]",7,0,0,0,7
1837735,1459359,2024-06-24,Senate,"Placed on suspense file",6,0,0,1,7
1837736,1428883,2024-04-16,Assembly,"Do pass as amended, and be re-referred to the Committee on [Appropriations] with recommendation: To Consent Calendar",16,0,0,0,16
1837736,1437636,2024-05-01,Assembly,"Do pass. To Consent Calendar",14,0,0,1,15
1837736,1441974,2024-05-09,Assembly,"AB 2072 Weber Consent Calendar Second Day Regular Session",65,0,0,15,80
1837736,1462508,2024-07-03,Senate,"Do pass as amended, but first amend, and re-refer to the Committee on [Appropriations] with the recommendation: To Consent Calendar",11,0,0,0,11
1837736,1463402,2024-08-05,Senate,"Placed on suspense file",7,0,0,0,7
1837736,1464016,2024-08-15,Senate,"Do pass",6,0,0,1,7
1837736,1465907,2024-08-27,Senate,"Assembly 3rd Reading AB2072 Weber et al. By Atkins",40,0,0,0,40
1837736,1466719,2024-08-28,Assembly,"AB 2072 Weber Concurrence in Senate Amendments",77,0,0,2,79
1837737,1412611,2024-03-20,Assembly,"Do pass as amended, and be re-referred to the Committee on [Appropriations] with recommendation: To Consent Calendar",7,0,0,0,7
1837737,1424772,2024-04-10,Assembly,"Do pass. To Consent Calendar",14,0,0,1,15
1837737,1431038,2024-04-18,Assembly,"AB 2073 Quirk-Silva Consent Calendar Second Day Regular Session",72,0,0,8,80
1837737,1454260,2024-06-05,Senate,"Do pass, but first be re-referred to the Committee on [Appropriations] with the recommendation: To Consent Calendar",7,0,0,0,7
1837737,1465889,2024-08-27,Senate,"Assembly 3rd Reading AB2073 Quirk-Silva By Newman",40,0,0,0,40
1837737,1466264,2024-08-29,Assembly,"AB 2073 Quirk-Silva Concurrence in Senate Amendments",76,0,0,3,79
1837738,1412529,2024-03-20,Assembly,"Do pass and be re-referred to the Committee on [Appropriations]",6,0,0,1,7
1837738,1444481,2024-05-16,Assembly,"Do pass",15,0,0,0,15
1837738,1449563,2024-05-23,Assembly,"AB 2074 Muratsuchi Assembly Third Reading",72,0,0,8,80
1837738,1458415,2024-06-19,Senate,"Do pass, but first be re-referred to the Committee on [Appropriations] with the recommendation: To Consent Calendar",7,0,0,0,7
1837738,1461979,2024-07-01,Senate,"Placed on suspense file",7,0,0,0,7
1837738,1464269,2024-08-15,Senate,"Do pass as amended",7,0,0,0,7
1837738,1466387,2024-08-30,Senate,"Special Consent AB2074 Muratsuchi et al. By Lim√≥n",40,0,0,0,40
1837738,1466918,2024-08-31,Assembly,"AB 2074 Muratsuchi Concurrence in Senate Amendments",77,0,0,2,79
1837739,1428759,2024-04-16,Assembly,"Do pass and be re-referred to the Committee on [Health]",5,0,0,2,7
1837739,1433013,2024-04-23,Assembly,"Do pass as amended and be re-referred to the Committee on [Appropriations]",15,0,0,1,16
1837739,1444271,2024-05-16,Assembly,"Do pass",15,0,0,0,15
1837739,1449615,2024-05-23,Assembly,"AB 2075 Alvarez Assembly Third Reading",72,0,0,8,80
1837739,1458463,2024-06-19,Senate,"Do pass as amended, but first amend, and re-refer to the Committee on [Human Services]",8,1,0,2,11
1837739,1462335,2024-07-01,Senate,"Do pass, but first be re-referred to the Committee on [Appropriations]",5,0,0,0,5
1837739,1463680,2024-08-05,Senate,"Placed on suspense file",7,0,0,0,7
1837740,1433099,2024-04-23,Assembly,"Do pass and be re-referred to the Committee on [Appropriations]",9,1,0,1,11
1837740,1444274,2024-05-16,Assembly,"Do pass as amended",12,3,0,0,15
1837740,1445941,2024-05-21,Assembly,"AB 2076 McCarty Assembly Third Reading",72,0,0,8,80
1837740,1454269,2024-06-05,Senate,"Do pass, but first be re-referred to the Committee on [Appropriations]",6,0,0,1,7
1837740,1457991,2024-06-17,Senate,"Placed on suspense file",7,0,0,0,7
1837743,1433080,2024-04-23,Assembly,"Do pass as amended and be re-referred to the Committee on [Appropriations]",10,3,0,2,15
1837743,1441365,2024-05-08,Assembly,"Do pass",10,4,0,1,15
1837743,1445206,2024-05-20,Assembly,"AB 2079 Bennett Assembly Third Reading",41,17,0,22,80
1837743,1456315,2024-06-11,Senate,"Do pass as amended, but first amend, and re-refer to the Committee on [Local Government]",5,6,0,0,11
1837744,1433130,2024-04-23,Assembly,"Do pass as amended and be re-referred to the Committee on [Appropriations]",10,0,0,1,11
1837744,1444479,2024-05-16,Assembly,"Do pass",15,0,0,0,15
1837744,1446024,2024-05-21,Assembly,"AB 2080 Arambula Assembly Third Reading",73,0,0,7,80
1837744,1462558,2024-07-03,Senate,"Do pass, but first be re-referred to the Committee on [Appropriations] with the recommendation: To Consent Calendar",7,0,0,0,7
1837744,1463549,2024-08-05,Senate,"Placed on suspense file",7,0,0,0,7
1837744,1464106,2024-08-15,Senate,"Do pass",7,0,0,0,7
1837744,1465840,2024-08-27,Senate,"Assembly 3rd Reading AB2080 Arambula et al. By Newman",40,0,0,0,40
1837744,1466637,2024-08-28,Assembly,"AB 2080 Arambula Concurrence in Senate Amendments",77,0,0,2,79
1837745,1419154,2024-04-02,Assembly,"Do pass as amended and be re-referred to the Committee on [Judiciary]",15,0,0,1,16
1837745,1441288,2024-05-08,Assembly,"Do pass. To Consent Calendar",15,0,0,0,15
1837745,1444360,2024-05-16,Assembly,"AB 2081 Davies Consent Calendar Second Day Regular Session",71,0,0,9,80
1837745,1456846,2024-06-12,Senate,"Do pass, but first be re-referred to the Committee on [Appropriations]",10,0,0,1,11
1837745,1465380,2024-08-20,Senate,"Assembly 3rd Reading AB2081 Davies By Nguyen",40,0,0,0,40
1837746,1411393,2024-03-19,Assembly,"Do pass and be re-referred to the Committee on [Appropriations] with recommendation: To Consent Calendar",13,0,0,2,15
1837746,1444217,2024-05-16,Assembly,"Do pass",15,0,0,0,15
1837746,1446131,2024-05-21,Assembly,"AB 2082 Juan Carrillo Assembly Third Reading",73,0,0,7,80
1837746,1460537,2024-06-25,Senate,"Do pass, but first be re-referred to the Committee on [Appropriations] with the recommendation: To Consent Calendar",15,0,0,0,15
1837746,1463467,2024-08-05,Senate,"Placed on suspense file",7,0,0,0,7
1837746,1464434,2024-08-15,Senate,"Do pass",7,0,0,0,7
1837746,1466613,2024-08-28,Senate,"Special Consent AB2082 Juan Carrillo By Wilk",39,0,0,1,40
1837747,1423731,2024-04-08,Assembly,"Do pass and be re-referred to the Committee on [Utilities and Energy]",9,0,0,2,11
1837747,1434067,2024-04-24,Assembly,"Do pass as amended and be re-referred to the Committee on [Appropriations]",12,1,0,3,16
1837747,1444352,2024-05-16,Assembly,"Do pass as amended",11,4,0,0,15
1837747,1445978,2024-05-21,Assembly,"AB 2083 Berman Assembly Third Reading",53,10,0,17,80
1837747,1458339,2024-06-18,Senate,"Do pass as amended, but first amend, and re-refer to the Committee on [Environmental Quality]",15,3,0,0,18
1837747,1462671,2024-07-03,Senate,"Do pass as amended, but first amend, and re-refer to the Committee on [Appropriations]",5,2,0,0,7
1837747,1463363,2024-08-05,Senate,"Placed on suspense file",7,0,0,0,7
1837749,1430991,2024-04-17,Assembly,"Do pass and be re-referred to the Committee on [Natural Resources]",8,1,0,0,9
1837749,1431928,2024-04-22,Assembly,"Do pass and be re-referred to the Committee on [Appropriations]",7,1,0,3,11
1837749,1444139,2024-05-16,Assembly,"Do pass",11,3,0,1,15
1837749,1446130,2024-05-21,Assembly,"AB 2085 Bauer-Kahan Assembly Third Reading",60,8,0,12,80
1837749,1454199,2024-06-05,Senate,"Do pass as amended, but first amend, and re-refer to the Committee on [Environmental Quality]",5,2,0,0,7
1837749,1462544,2024-07-03,Senate,"Do pass as amended, but first amend, and re-refer to the Committee on [Appropriations]",5,2,0,0,7
1837749,1463530,2024-08-05,Senate,"Placed on suspense file",7,0,0,0,7
1837749,1464521,2024-08-15,Senate,"Do pass",5,2,0,0,7
1837749,1466296,2024-08-29,Assembly,"AB 2085 Bauer-Kahan Concurrence in Senate Amendments",62,6,0,11,79
1837749,1466865,2024-08-28,Senate,"Assembly 3rd Reading AB2085 Bauer-Kahan et al. By Atkins",31,8,0,1,40
1837750,1431876,2024-04-22,Assembly,"Do pass and be re-referred to the Committee on [Appropriations]",15,0,0,0,15
1837750,1444412,2024-05-16,Assembly,"Do pass",15,0,0,0,15
1837750,1446002,2024-05-21,Assembly,"AB 2086 Schiavo Assembly Third Reading",72,0,0,8,80
1837750,1460580,2024-06-25,Senate,"Do pass, but first be re-referred to the Committee on [Appropriations]",15,0,0,0,15
1837750,1463657,2024-08-05,Senate,"Placed on suspense file",7,0,0,0,7
1837750,1464110,2024-08-15,Senate,"Do pass as amended",7,0,0,0,7
1837750,1466482,2024-08-30,Senate,"Special Consent AB2086 Schiavo",40,0,0,0,40
1837750,1467065,2024-08-31,Assembly,"AB 2086 Schiavo Concurrence in Senate Amendments",77,0,0,2,79
1837752,1420142,2024-04-03,Assembly,"Do pass and be re-referred to the Committee on [Higher Education]",5,2,0,0,7
1837752,1433136,2024-04-23,Assembly,"Do pass and be re-referred to the Committee on [Appropriations]",7,2,0,2,11
1837752,1444324,2024-05-16,Assembly,"Do pass as amended",11,3,0,1,15
1837752,1448727,2024-05-22,Assembly,"AB 2088 McCarty Assembly Third Reading",52,11,0,17,80
1837752,1460424,2024-06-26,Senate,"Do pass, but first be re-referred to the Committee on [Appropriations]",4,1,0,0,5
1837752,1463557,2024-08-05,Senate,"Placed on suspense file",7,0,0,0,7
1837752,1464290,2024-08-15,Senate,"Do pass",4,3,0,0,7
1837752,1466314,2024-08-29,Senate,"Assembly 3rd Reading AB2088 McCarty By Cortese",22,14,0,4,40
1837752,1466410,2024-08-30,Assembly,"AB 2088 McCarty Concurrence in Senate Amendments",52,14,0,13,79
1837753,1428853,2024-04-16,Assembly,"Do pass and be re-referred to the Committee on [Appropriations]",9,1,0,2,12
1837754,1424779,2024-04-10,Assembly,"Do pass and be re-referred to the Committee on [Appropriations]",10,0,0,0,10
1837755,1411355,2024-03-19,Assembly,"Do pass as amended and be re-referred to the Committee on [Water, Parks, and Wildlife]",11,0,0,0,11
1837755,1433148,2024-04-23,Assembly,"Do pass and be re-referred to the Committee on [Appropriations]",14,0,0,1,15
1837755,1437658,2024-05-01,Assembly,"Do pass. To Consent Calendar",14,0,0,1,15
1837755,1441967,2024-05-09,Assembly,"AB 2091 Grayson Consent Calendar Second Day Regular Session",65,0,0,15,80
1837755,1458442,2024-06-19,Senate,"Do pass, but first be re-referred to the Committee on [Natural Resources and Water]",7,0,0,0,7
1837755,1460093,2024-06-25,Senate,"Do pass as amended, but first amend, and re-refer to the Committee on [Appropriations]",9,0,0,2,11
1837755,1463520,2024-08-05,Senate,"Placed on suspense file",7,0,0,0,7
1837755,1464387,2024-08-15,Senate,"Do pass as amended",5,0,0,2,7
1837755,1466159,2024-08-29,Assembly,"AB 2091 Grayson Concurrence in Senate Amendments",73,0,0,6,79
1837755,1466649,2024-08-28,Senate,"Assembly 3rd Reading AB2091 Grayson By Glazer",39,0,0,1,40
1837756,1408830,2024-03-13,Assembly,"Do pass as amended, and be re-referred to the Committee on [Appropriations] with recommendation: To Consent Calendar",15,0,0,1,16
1837757,1430010,2024-04-16,Assembly,"Do pass and be re-referred to the Committee on [Appropriations]",9,0,0,2,11
1837757,1444392,2024-05-16,Assembly,"Do pass",11,1,0,3,15
1837757,1449679,2024-05-23,Assembly,"AB 2093 Santiago Assembly Third Reading",62,3,0,15,80
1837757,1460645,2024-06-26,Senate,"Do pass as amended, but first amend, and re-refer to the Committee on [Appropriations]",6,0,0,1,7
1837757,1463599,2024-08-05,Senate,"Placed on suspense file",7,0,0,0,7
1837757,1464584,2024-08-15,Senate,"Do pass as amended",6,0,0,1,7
1837757,1465824,2024-08-27,Senate,"Assembly 3rd Reading AB2093 Santiago et al. By Newman",37,0,0,3,40
1837757,1466858,2024-08-28,Assembly,"AB 2093 Santiago Concurrence in Senate Amendments",66,1,0,12,79
1837758,1420204,2024-04-03,Assembly,"Do pass and be re-referred to the Committee on [Higher Education]",21,0,0,1,22
1837758,1429968,2024-04-16,Assembly,"Do pass and be re-referred to the Committee on [Appropriations]",11,0,0,0,11
1837758,1437645,2024-05-01,Assembly,"Do pass. To Consent Calendar",14,0,0,1,15
1837758,1445990,2024-05-21,Assembly,"AB 2094 Flora Assembly Third Reading",70,0,0,10,80
1837758,1456454,2024-06-11,Senate,"Do pass, but first be re-referred to the Committee on [Appropriations]",14,0,0,2,16
1837758,1465400,2024-08-21,Senate,"Assembly 3rd Reading AB2094 Flora By Hurtado",33,0,0,7,40
1837759,1411396,2024-03-19,Assembly,"Do pass and be re-referred to the Committee on [Appropriations]",10,0,0,2,12
1837759,1443903,2024-05-16,Assembly,"Do pass as amended",11,0,0,4,15
1837759,1446121,2024-05-21,Assembly,"AB 2095 Maienschein Assembly Third Reading",73,0,0,7,80
1837759,1460420,2024-06-25,Senate,"Do pass as amended",11,0,0,0,11
1837759,1466828,2024-08-31,Senate,"Assembly 3rd Reading AB2095 Maienschein By Umberg",40,0,0,0,40
1837759,1466829,2024-08-31,Assembly,"AB 2095 Maienschein Concurrence in Senate Amendments",73,1,0,5,79
1837760,1408227,2024-03-12,Assembly,"Do pass and be re-referred to the Committee on [Higher Education] with recommendation: To Consent Calendar",10,0,0,2,12
1837760,1423885,2024-04-09,Assembly,"Do pass and be re-referred to the Committee on [Appropriations] with recommendation: To Consent Calendar",11,0,0,0,11
1837760,1443937,2024-05-16,Assembly,"Do pass as amended",11,0,0,4,15
1837760,1445985,2024-05-21,Assembly,"AB 2096 Petrie-Norris Assembly Third Reading",74,0,0,6,80
1837760,1456438,2024-06-11,Senate,"Do pass, but first be re-referred to the Committee on [Education] with the recommendation: To Consent Calendar",11,0,0,0,11
1837760,1462686,2024-07-03,Senate,"Do pass, but first be re-referred to the Committee on [Appropriations] with the recommendation: To Consent Calendar",7,0,0,0,7
1837760,1463452,2024-08-05,Senate,"Placed on suspense file",7,0,0,0,7
1837760,1464518,2024-08-15,Senate,"Do pass",7,0,0,0,7
1837760,1466154,2024-08-29,Assembly,"AB 2096 Petrie-Norris Concurrence in Senate Amendments",76,0,0,3,79
1837760,1466701,2024-08-28,Senate,"Special Consent AB2096 Petrie-Norris et al. By Blakespear",39,0,0,1,40
1837761,1435355,2024-04-24,Assembly,"Do pass as amended and be re-referred to the Committee on [Appropriations]",6,0,0,1,7
1837761,1444563,2024-05-16,Assembly,"Do pass as amended",11,0,0,4,15
1837761,1446115,2024-05-21,Assembly,"AB 2097 Berman Assembly Third Reading",73,0,0,7,80
1837761,1456958,2024-06-12,Senate,"Do pass, but first be re-referred to the Committee on [Appropriations]",7,0,0,0,7
1837761,1459340,2024-06-24,Senate,"Placed on suspense file",6,0,0,1,7
1837762,1428905,2024-04-16,Assembly,"Do pass and be re-referred to the Committee on [Appropriations]",16,0,0,0,16
1837762,1437597,2024-05-01,Assembly,"Do pass. To Consent Calendar",14,0,0,1,15
1837762,1449722,2024-05-23,Assembly,"AB 2098 Garcia Assembly Third Reading",72,0,0,8,80
1837762,1460439,2024-06-26,Senate,"Do pass, but first be re-referred to the Committee on [Appropriations] with the recommendation: To Consent Calendar",11,0,0,0,11
1837762,1463663,2024-08-05,Senate,"Placed on suspense file",7,0,0,0,7
1837762,1464494,2024-08-15,Senate,"Do pass as amended",7,0,0,0,7
1837762,1466472,2024-08-30,Senate,"Special Consent AB2098 Garcia et al. By Padilla",40,0,0,0,40
1837762,1467162,2024-08-31,Assembly,"AB 2098 Garcia Concurrence in Senate Amendments",77,0,0,2,79
1837763,1420146,2024-04-02,Assembly,"Do pass and be re-referred to the Committee on [Appropriations]",8,0,0,0,8
1837763,1444113,2024-05-16,Assembly,"Do pass",13,0,0,2,15
1837763,1449725,2024-05-23,Assembly,"AB 2099 Bauer-Kahan Assembly Third Reading",63,0,0,17,80
1837763,1462323,2024-07-02,Senate,"Do pass as amended, but first amend, and re-refer to the Committee on [Appropriations]",4,0,0,1,5
1837763,1463590,2024-08-05,Senate,"Placed on suspense file",7,0,0,0,7
1837763,1464184,2024-08-15,Senate,"Do pass",5,2,0,0,7
1837763,1465906,2024-08-27,Senate,"Assembly 3rd Reading AB2099 Bauer-Kahan et al. By Skinner",31,9,0,0,40
1837763,1466789,2024-08-28,Assembly,"AB 2099 Bauer-Kahan Concurrence in Senate Amendments",68,0,0,11,79
1837765,1423816,2024-04-08,Assembly,"Do pass and be re-referred to the Committee on [Health] with recommendation: To Consent Calendar",7,0,0,1,8
1837765,1432928,2024-04-23,Assembly,"Do pass as amended, and be re-referred to the Committee on [Appropriations] with recommendation: To Consent Calendar",16,0,0,0,16
1837766,1431883,2024-04-22,Assembly,"Do pass and be re-referred to the Committee on [Appropriations]",15,0,0,0,15
1837767,1433016,2024-04-23,Assembly,"Do pass as amended and be re-referred to the Committee on [Appropriations]",12,0,0,3,15
1837767,1444368,2024-05-16,Assembly,"Do pass as amended",11,0,0,4,15
1837767,1448734,2024-05-22,Assembly,"AB 2103 Pellerin Assembly Third Reading",65,1,0,14,80
1837767,1457958,2024-06-17,Senate,"Do pass as amended, but first amend, and re-refer to the Committee on [Appropriations]",9,0,0,2,11
1837767,1462040,2024-07-01,Senate,"Placed on suspense file",7,0,0,0,7
1837767,1464539,2024-08-15,Senate,"Do pass as amended",5,1,0,1,7
1837767,1465628,2024-08-26,Senate,"Assembly 3rd Reading AB2103 Pellerin et al. By Laird",32,1,0,7,40
1837767,1465807,2024-08-27,Assembly,"AB 2103 Pellerin Concurrence in Senate Amendments",72,1,0,6,79
1837768,1429954,2024-04-16,Assembly,"Do pass and be re-referred to the Committee on [Appropriations]",10,0,0,1,11
1837768,1444631,2024-05-16,Assembly,"Do pass as amended",12,3,0,0,15
1837768,1448687,2024-05-22,Assembly,"AB 2104 Soria Assembly Third Reading",65,1,0,14,80
1837768,1462557,2024-07-03,Senate,"Do pass, but first be re-referred to the Committee on [Appropriations]",6,1,0,0,7
1837768,1463458,2024-08-05,Senate,"Placed on suspense file",7,0,0,0,7
1837768,1464114,2024-08-15,Senate,"Do pass",7,0,0,0,7
1837768,1466386,2024-08-30,Senate,"Assembly 3rd Reading AB2104 Soria et al. By Hurtado",32,1,0,7,40
1837769,1428923,2024-04-16,Assembly,"Do pass as amended and be re-referred to the Committee on [Appropriations]",14,0,0,2,16
1837769,1443968,2024-05-16,Assembly,"Do pass",14,0,0,1,15
1837769,1446081,2024-05-21,Assembly,"AB 2105 Lowenthal Assembly Third Reading",68,0,0,12,80
1837769,1456877,2024-06-12,Senate,"Do pass as amended, but first amend, and re-refer to the Committee on [Appropriations]",9,0,0,2,11
1837769,1459377,2024-06-24,Senate,"Do pass",5,0,0,2,7
1837769,1466197,2024-08-29,Assembly,"AB 2105 Lowenthal Concurrence in Senate Amendments",72,0,0,7,79
1837769,1466810,2024-08-28,Senate,"Assembly 3rd Reading AB2105 Lowenthal et al. By Rubio",39,0,0,1,40
1837770,1428802,2024-04-16,Assembly,"Do pass as amended and be re-referred to the Committee on [Appropriations]",8,0,0,0,8
1837770,1444625,2024-05-16,Assembly,"Do pass as amended",10,0,0,5,15
1837770,1449540,2024-05-23,Assembly,"AB 2106 McCarty Assembly Third Reading",53,0,0,27,80
1837770,1462254,2024-07-02,Senate,"Do pass as amended, but first amend, and re-refer to the Committee on [Appropriations]",4,0,0,1,5
1837770,1463553,2024-08-05,Senate,"Placed on suspense file",7,0,0,0,7
1837770,1464645,2024-08-15,Senate,"Do pass as amended",6,0,0,1,7
1837770,1465952,2024-08-27,Senate,"Assembly 3rd Reading AB2106 McCarty By Wahab",39,0,0,1,40
1837770,1466373,2024-08-29,Assembly,"AB 2106 McCarty Concurrence in Senate Amendments",70,0,0,9,79
1837771,1419215,2024-04-02,Assembly,"Do pass as amended and be re-referred to the Committee on [Appropriations]",16,0,0,2,18
1837771,1434208,2024-04-24,Assembly,"Do pass. To Consent Calendar",14,0,0,1,15
1837771,1449718,2024-05-23,Assembly,"AB 2107 Chen Assembly Third Reading",69,0,0,11,80
1837771,1459414,2024-06-24,Senate,"Do pass, but first be re-referred to the Committee on [Appropriations] with the recommendation: To Consent Calendar",12,0,0,1,13
1837771,1463414,2024-08-05,Senate,"Do pass",7,0,0,0,7
1837771,1467112,2024-08-31,Senate,"Assembly 3rd Reading AB2107 Chen By Wilk",40,0,0,0,40
1837771,1467113,2024-08-31,Assembly,"AB 2107 Chen Concurrence in Senate Amendments",73,0,0,6,79
1837772,1419127,2024-04-02,Assembly,"Do pass and be re-referred to the Committee on [Appropriations] with recommendation: To Consent Calendar",7,0,0,0,7
1837772,1444395,2024-05-16,Assembly,"Do pass",15,0,0,0,15
1837772,1445951,2024-05-21,Assembly,"AB 2108 Ramos Assembly Third Reading",73,0,0,7,80
1837772,1462339,2024-07-01,Senate,"Do pass, but first be re-referred to the Committee on [Appropriations] with the recommendation: To Consent Calendar",5,0,0,0,5
1837772,1463431,2024-08-05,Senate,"Placed on suspense file",7,0,0,0,7
1837772,1464410,2024-08-15,Senate,"Do pass as amended",7,0,0,0,7
1837772,1466578,2024-08-30,Senate,"Special Consent AB2108 Ramos By Ashby",40,0,0,0,40
1837772,1467079,2024-08-31,Assembly,"AB 2108 Ramos Concurrence in Senate Amendments",77,0,0,2,79
1837773,1430092,2024-04-17,Assembly,"Do pass as amended and be re-referred to the Committee on [Appropriations]",16,0,0,0,16
1837773,1444218,2024-05-16,Assembly,"Do pass",15,0,0,0,15
1837773,1445958,2024-05-21,Assembly,"AB 2109 Juan Carrillo Assembly Third Reading",73,0,0,7,80
1837773,1458300,2024-06-18,Senate,"Do pass, but first be re-referred to the Committee on [Appropriations]",14,0,0,4,18
1837773,1462043,2024-07-01,Senate,"Placed on suspense file",7,0,0,0,7
1837773,1464151,2024-08-15,Senate,"Do pass",7,0,0,0,7
1837773,1465784,2024-08-27,Senate,"Assembly 3rd Reading AB2109 Juan Carrillo By Becker",39,0,0,1,40
1837773,1466803,2024-08-28,Assembly,"AB 2109 Juan Carrillo Concurrence in Senate Amendments",77,0,0,2,79
1837774,1423843,2024-04-09,Assembly,"Do pass and be re-referred to the Committee on [Appropriations]",16,0,0,0,16
1837775,1422101,2024-04-08,Assembly,"Do pass and be re-referred to the Committee on [Appropriations] with recommendation: To Consent Calendar",14,0,0,1,15
1837775,1434274,2024-04-24,Assembly,"Do pass. To Consent Calendar",14,0,0,1,15
1837775,1438524,2024-05-02,Assembly,"AB 2111 Wallis Consent Calendar Second Day Regular Session",73,0,0,7,80
1837775,1451589,2024-05-28,Senate,"Do pass, but first be re-referred to the Committee on [Appropriations] with the recommendation: To Consent Calendar",12,0,0,3,15
1837775,1457357,2024-06-13,Senate,"Consent Calendar 2nd AB2111 Wallis",37,0,0,3,40
1837776,1424967,2024-04-10,Assembly,"Do pass and be re-referred to the Committee on [Appropriations]",7,0,0,0,7
1837776,1444017,2024-05-16,Assembly,"Do pass",15,0,0,0,15
1837776,1449690,2024-05-23,Assembly,"AB 2112 Muratsuchi Assembly Third Reading",71,0,0,9,80
1837776,1458421,2024-06-19,Senate,"Do pass, but first be re-referred to the Committee on [Appropriations] with the recommendation: To Consent Calendar",7,0,0,0,7
1837776,1462064,2024-07-01,Senate,"Placed on suspense file",7,0,0,0,7
1837777,1435944,2024-04-23,Assembly,"Do pass and be re-referred to the Committee on [Appropriations]",5,2,0,0,7
1837777,1444192,2024-05-16,Assembly,"Do pass",11,4,0,0,15
1837777,1446089,2024-05-21,Assembly,"AB 2113 Garcia Assembly Third Reading",54,16,0,10,80
1837777,1458492,2024-06-19,Senate,"Do pass, but first be re-referred to the Committee on [Agriculture]",4,2,0,1,7
1837777,1460026,2024-06-25,Senate,"Do pass, but first be re-referred to the Committee on [Appropriations]",4,0,0,1,5
1837777,1460747,2024-06-26,Senate,"Do pass",5,2,0,0,7
1837777,1461261,2024-06-27,Senate,"Assembly 3rd Reading AB2113 Garcia By Becker Urgency Clause",29,9,0,2,40
1837777,1462062,2024-07-01,Assembly,"AB 2113 Garcia Concurrence - Urgency Added",56,14,0,9,79
1837778,1412600,2024-03-20,Assembly,"Do pass",9,0,0,0,9
1837778,1438446,2024-04-01,Assembly,"AB 2114 Irwin Third Reading Urgency",71,0,0,9,80
1837778,1453382,2024-06-04,Senate,"Do pass, but first be re-referred to the Committee on [Judiciary]",9,0,0,1,10
1837778,1458311,2024-06-18,Senate,"Do pass and be ordered to the Consent Calendar",10,0,0,1,11
1837778,1461259,2024-06-27,Senate,"Consent Calendar 2nd AB2114 Irwin Urgency Clause",40,0,0,0,40
1837779,1428804,2024-04-16,Assembly,"Do pass and be re-referred to the Committee on [Health]",17,0,0,1,18
1837779,1433137,2024-04-23,Assembly,"Do pass and be re-referred to the Committee on [Appropriations]",16,0,0,0,16
1837779,1441285,2024-05-08,Assembly,"Do pass. To Consent Calendar",15,0,0,0,15
1837779,1448729,2024-05-22,Assembly,"AB 2115 Haney Assembly Third Reading",67,0,0,13,80
1837779,1459372,2024-06-24,Senate,"Do pass, but first be re-referred to the Committee on [Health]",12,0,0,1,13
1837779,1462504,2024-07-03,Senate,"Do pass, but first be re-referred to the Committee on [Appropriations]",9,0,0,2,11
1837779,1463387,2024-08-05,Senate,"Placed on suspense file",7,0,0,0,7
1837779,1464513,2024-08-15,Senate,"Do pass as amended",6,0,0,1,7
1837779,1466504,2024-08-30,Senate,"Assembly 3rd Reading AB2115 Haney By Wiener Urgency Clause",38,0,0,2,40
1837779,1467023,2024-08-31,Assembly,"AB 2115 Haney Concurrence - Urgency Added",77,0,0,2,79
1837780,1418342,2024-04-01,Assembly,"Do pass and be re-referred to the Committee on [Appropriations] with recommendation: To Consent Calendar",15,0,0,0,15
1837781,1429907,2024-04-17,Assembly,"Do pass and be re-referred to the Committee on [Local Government] with recommendation: To Consent Calendar",9,0,0,0,9
1837781,1435308,2024-04-24,Assembly,"Do pass and be re-referred to the Committee on [Appropriations] with recommendation: To Consent Calendar",8,0,0,1,9
1837781,1441305,2024-05-08,Assembly,"Do pass. To Consent Calendar",15,0,0,0,15
1837781,1444122,2024-05-16,Assembly,"AB 2117 Joe Patterson Consent Calendar Second Day Regular Session",71,0,0,9,80
1837781,1456303,2024-06-11,Senate,"Do pass as amended, but first amend, and re-refer to the Committee on [Housing] with the recommendation: To Consent Calendar",7,0,0,0,7
1837781,1462461,2024-07-02,Senate,"Do pass, but first be re-referred to the Committee on [Appropriations] with the recommendation: To Consent Calendar",10,0,0,0,10
1837781,1463900,2024-08-12,Senate,"Consent Calendar 2nd AB2117 Joe Patterson et al",38,0,0,2,40
1837781,1464450,2024-08-15,Assembly,"AB 2117 Joe Patterson Concurrence in Senate Amendments",76,0,0,3,79
1837782,1428947,2024-04-16,Senate,"Do pass, but first be re-referred to the Committee on [Appropriations]",1,3,0,1,5
1837782,1428948,2024-04-16,Senate,"[First] hearing set for [04-16-2024]: Failed passage in Committee. Reconsideration granted",5,0,0,0,5
1837783,1427281,2024-04-15,Senate,"Do pass, but first be re-referred to the Committee on [Public Safety]",7,4,0,2,13
1837783,1433127,2024-04-23,Senate,"Do pass, but first be re-referred to the Committee on [Appropriations]",3,2,0,0,5
1837783,1442614,2024-05-13,Senate,"Placed on suspense file",7,0,0,0,7
1837784,1434130,2024-04-24,Senate,"Do pass as amended, but first amend, and re-refer to the Committee on [Appropriations]",6,0,0,1,7
1837784,1442583,2024-05-13,Senate,"Placed on suspense file",7,0,0,0,7
1837785,1408255,2024-03-12,Senate,"Do pass, but first be re-referred to the Committee on [Natural Resources and Water] with the recommendation: To Consent Calendar",16,0,0,0,16
1837785,1427309,2024-04-15,Senate,"Do pass as amended, but first amend, and re-refer to the Committee on [Appropriations] with the recommendation: To Consent Calendar",10,0,0,1,11
1837785,1436161,2024-04-29,Senate,"Placed on suspense file",5,0,0,2,7
1837785,1444010,2024-05-16,Senate,"Do pass as amended",7,0,0,0,7
1837785,1450027,2024-05-24,Senate,"Special Consent SB1014 Dodd",38,0,0,2,40
1837785,1455813,2024-06-10,Assembly,"Do pass and be re-referred to the Committee on [Natural Resources] with recommendation: To Consent Calendar",7,0,0,1,8
1837785,1457976,2024-06-17,Assembly,"Do pass and be re-referred to the Committee on [Appropriations] with recommendation: To Consent Calendar",10,0,0,1,11
1837786,1422089,2024-04-08,Senate,"Do pass, but first be re-referred to the Committee on [Appropriations]",11,0,0,2,13
1837786,1431854,2024-04-22,Senate,"Placed on suspense file",7,0,0,0,7
1837786,1443945,2024-05-16,Senate,"Do pass",7,0,0,0,7
1837786,1449715,2024-05-23,Senate,"Special Consent SB1015 Cortese et al",37,0,0,3,40
1837786,1456450,2024-06-11,Assembly,"Do pass and be re-referred to the Committee on [Appropriations]",16,0,0,2,18
1837786,1464404,2024-08-15,Assembly,"Do pass",13,0,0,2,15
1837786,1465678,2024-08-26,Assembly,"SB 1015 Cortese Senate Third Reading By Bains",76,0,0,3,79
1837787,1419147,2024-04-01,Senate,"Do pass, but first be re-referred to the Committee on [Health]",4,0,0,1,5
1837787,1424833,2024-04-10,Senate,"Do pass as amended, but first amend, and re-refer to the Committee on [Appropriations]",10,0,0,1,11
1837787,1431910,2024-04-22,Senate,"Placed on suspense file",7,0,0,0,7
1837787,1444410,2024-05-16,Senate,"Do pass as amended",5,0,0,2,7
1837787,1450374,2024-05-21,Senate,"Senate 3rd Reading SB1016 Gonzalez et al",34,0,0,6,40
1837787,1456332,2024-06-11,Assembly,"Do pass and be re-referred to the Committee on [Appropriations]",16,0,0,0,16
1837787,1464129,2024-08-15,Assembly,"Do pass as amended",12,1,0,2,15
1837787,1465753,2024-08-26,Assembly,"SB 1016 Gonzalez Senate Third Reading By Arambula",73,0,0,6,79
1837787,1465939,2024-08-27,Senate,"Unfinished Business SB1016 Gonzalez et al. Concurrence",34,0,0,6,40
1837788,1412531,2024-03-20,Senate,"Do pass, but first be re-referred to the Committee on [Judiciary]",11,0,0,0,11
1837788,1420158,2024-04-02,Senate,"Do pass, but first be re-referred to the Committee on [Appropriations]",11,0,0,0,11
1837788,1427257,2024-04-15,Senate,"Placed on suspense file",6,0,0,1,7
1837789,1428819,2024-04-16,Senate,"Do pass, but first be re-referred to the Committee on [Appropriations]",14,3,0,1,18
1837789,1450339,2024-05-21,Senate,"Senate 3rd Reading SB1018 Becker",30,8,0,2,40
1837789,1461967,2024-07-01,Assembly,"Do pass as amended and be re-referred to the Committee on [Appropriations]",14,0,0,2,16
1837790,1400015,2024-02-29,Senate,"Senate 3rd Reading SCR106 Padilla et al",38,0,0,2,40
1837790,1413858,2024-03-21,Assembly,"Be adopted. To Consent Calendar",8,0,0,3,11
1837790,1421128,2024-04-04,Assembly,"SCR 106 Padilla Consent Calendar Second Day Regular Session",70,0,0,10,80
1839058,1428959,2024-04-16,Assembly,"Do pass. To Consent Calendar",16,0,0,0,16
1839058,1435288,2024-04-25,Assembly,"AB 2119 Weber Consent Calendar Second Day Regular Session",75,0,0,5,80
1839058,1451560,2024-05-29,Senate,"Do pass, but first be re-referred to the Committee on [Appropriations] with the recommendation: To Consent Calendar",11,0,0,0,11
1839058,1455801,2024-06-10,Senate,"Placed on suspense file",7,0,0,0,7
1839058,1464043,2024-08-15,Senate,"Do pass",6,0,0,1,7
1839058,1466129,2024-08-29,Assembly,"AB 2119 Weber Concurrence in Senate Amendments",76,0,0,3,79
1839058,1466688,2024-08-28,Senate,"Assembly 3rd Reading AB2119 Weber By Grove",39,0,0,1,40
1839059,1411365,2024-03-19,Assembly,"Do pass and be re-referred to the Committee on [Appropriations] with recommendation: To Consent Calendar",8,0,0,0,8
1839059,1424895,2024-04-10,Assembly,"Do pass. To Consent Calendar",14,0,0,1,15
1839059,1430990,2024-04-18,Assembly,"AB 2120 Chen Consent Calendar Second Day Regular Session",72,0,0,8,80
1839059,1453430,2024-06-04,Senate,"Do pass, but first be re-referred to the Committee on [Appropriations]",5,0,0,0,5
1839059,1458003,2024-06-17,Senate,"Placed on suspense file",7,0,0,0,7
1839059,1464194,2024-08-15,Senate,"Do pass",7,0,0,0,7
1839059,1466257,2024-08-29,Assembly,"AB 2120 Chen Concurrence in Senate Amendments",75,0,0,4,79
1839059,1466833,2024-08-28,Senate,"Assembly 3rd Reading AB2120 Chen By Seyarto",40,0,0,0,40
1839062,1420122,2024-04-03,Assembly,"Do pass and be re-referred to the Committee on [Appropriations]",12,0,0,3,15
1839062,1429948,2024-04-17,Assembly,"Do pass. To Consent Calendar",15,0,0,0,15
1839062,1435326,2024-04-25,Assembly,"AB 2123 Papan Consent Calendar Second Day Regular Session",75,0,0,5,80
1839062,1454213,2024-06-05,Senate,"Do pass, but first be re-referred to the Committee on [Appropriations] with the recommendation: To Consent Calendar",5,0,0,0,5
1839062,1457955,2024-06-17,Senate,"Do pass",7,0,0,0,7
1839062,1465362,2024-08-20,Senate,"Assembly 3rd Reading AB2123 Papan et al. By Ashby",40,0,0,0,40
1839062,1465743,2024-08-26,Assembly,"AB 2123 Papan Concurrence in Senate Amendments",77,0,0,2,79
1839063,1423813,2024-04-09,Assembly,"Do pass and be re-referred to the Committee on [Appropriations] with recommendation: To Consent Calendar",14,0,0,1,15
1839064,1423752,2024-04-09,Assembly,"Do pass as amended and be re-referred to the Committee on [Appropriations]",9,2,0,1,12
1839064,1443985,2024-05-16,Assembly,"Do pass as amended",11,3,0,1,15
1839064,1448656,2024-05-22,Assembly,"AB 2125 Garcia Assembly Third Reading",66,0,0,14,80
1839064,1460670,2024-06-25,Senate,"Do pass, but first be re-referred to the Committee on [Appropriations]",11,0,0,0,11
1839064,1463386,2024-08-05,Senate,"Placed on suspense file",7,0,0,0,7
1839066,1412516,2024-03-20,Assembly,"Do pass and be re-referred to the Committee on [Appropriations]",6,1,0,1,8
1839066,1424860,2024-04-10,Assembly,"Do pass",10,4,0,1,15
1839066,1431052,2024-04-18,Assembly,"AB 2127 Berman Assembly Third Reading",59,7,0,14,80
1839066,1453440,2024-06-04,Senate,"Do pass, but first be re-referred to the Committee on [Transportation]",6,1,0,0,7
1839066,1460571,2024-06-25,Senate,"Do pass, but first be re-referred to the Committee on [Appropriations]",11,4,0,0,15
1839066,1466239,2024-08-29,Senate,"Assembly 3rd Reading AB2127 Berman By Blakespear",31,9,0,0,40
1839067,1436920,2024-04-29,Assembly,"Do pass as amended and be re-referred to the Committee on [Appropriations]",6,0,0,1,7
1839068,1423919,2024-04-09,Assembly,"Do pass as amended, and be re-referred to the Committee on [Appropriations] with recommendation: To Consent Calendar",16,0,0,0,16
1839068,1434054,2024-04-24,Assembly,"Do pass. To Consent Calendar",14,0,0,1,15
1839068,1438456,2024-05-02,Assembly,"AB 2129 Petrie-Norris Consent Calendar Second Day Regular Session",73,0,0,7,80
1839068,1454265,2024-06-05,Senate,"Do pass, but first be re-referred to the Committee on [Appropriations] with the recommendation: To Consent Calendar",11,0,0,0,11
1839068,1458787,2024-06-20,Senate,"Consent Calendar 2nd AB2129 Petrie-Norris",36,0,0,4,40
1839068,1465364,2024-08-20,Senate,"Assembly 3rd Reading AB2129 Petrie-Norris et al. By Rubio",40,0,0,0,40
1839068,1465810,2024-08-27,Assembly,"AB 2129 Petrie-Norris Concurrence in Senate Amendments",77,0,0,2,79
1839069,1411410,2024-03-19,Assembly,"Do pass and be re-referred to the Committee on [Appropriations] with recommendation: To Consent Calendar",13,0,0,2,15
1839069,1444064,2024-05-16,Assembly,"Do pass as amended",11,0,0,4,15
1839069,1449682,2024-05-23,Assembly,"AB 2130 Santiago Assembly Third Reading",73,0,0,7,80
1839069,1460584,2024-06-25,Senate,"Do pass, but first be re-referred to the Committee on [Appropriations] with the recommendation: To Consent Calendar",15,0,0,0,15
1839069,1463876,2024-08-12,Senate,"Consent Calendar 2nd AB2130 Santiago",38,0,0,2,40
1839070,1428892,2024-04-16,Assembly,"Do pass and be re-referred to the Committee on [Appropriations] with recommendation: To Consent Calendar",16,0,0,0,16
1839070,1444582,2024-05-16,Assembly,"Do pass as amended",11,0,0,4,15
1839070,1446107,2024-05-21,Assembly,"AB 2131 Valencia Assembly Third Reading",74,0,0,6,80
1839070,1454223,2024-06-05,Senate,"Do pass as amended, but first amend, and re-refer to the Committee on [Appropriations] with the recommendation: To Consent Calendar",11,0,0,0,11
1839070,1458008,2024-06-17,Senate,"Placed on suspense file",7,0,0,0,7
1839070,1464111,2024-08-15,Senate,"Do pass as amended",7,0,0,0,7
1839070,1466464,2024-08-30,Senate,"Special Consent AB2131 Valencia et al. By Hurtado",40,0,0,0,40
1839070,1467184,2024-08-31,Assembly,"AB 2131 Valencia Concurrence in Senate Amendments",76,0,0,3,79
1839071,1411326,2024-03-19,Assembly,"Do pass and be re-referred to the Committee on [Appropriations]",13,1,0,2,16
1839071,1444467,2024-05-16,Assembly,"Do pass",15,0,0,0,15
1839071,1445943,2024-05-21,Assembly,"AB 2132 Low Assembly Third Reading",70,0,0,10,80
1839071,1458408,2024-06-19,Senate,"Do pass as amended, but first amend, and re-refer to the Committee on [Judiciary]",11,0,0,0,11
1839071,1462529,2024-07-02,Senate,"Do pass, but first be re-referred to the Committee on [Appropriations]",11,0,0,0,11
1839071,1463647,2024-08-05,Senate,"Placed on suspense file",7,0,0,0,7
1839071,1464612,2024-08-15,Senate,"Do pass as amended",7,0,0,0,7
1839071,1465887,2024-08-27,Senate,"Assembly 3rd Reading AB2132 Low et al. By Wiener",40,0,0,0,40
1839071,1466647,2024-08-28,Assembly,"AB 2132 Low Concurrence in Senate Amendments",75,0,0,4,79
1839072,1423776,2024-04-09,Assembly,"Do pass as amended and be re-referred to the Committee on [Appropriations]",13,3,0,2,18
1839073,1421133,2024-04-03,Assembly,"Do pass as amended and be re-referred to the Committee on [Public Employment and Retirement]",7,0,0,0,7
1839073,1430007,2024-04-17,Assembly,"Do pass and be re-referred to the Committee on [Appropriations]",6,0,0,1,7
1839073,1444356,2024-05-16,Assembly,"Do pass as amended",11,1,0,3,15
1839073,1445930,2024-05-21,Assembly,"AB 2134 Muratsuchi Assembly Third Reading",73,0,0,7,80
1839073,1456922,2024-06-12,Senate,"Do pass, but first be re-referred to the Committee on [Labor, Public Employment and Retirement ] with the recommendation: To Consent Calendar",7,0,0,0,7
1839073,1462649,2024-07-03,Senate,"Do pass, but first be re-referred to the Committee on [Appropriations] with the recommendation: To Consent Calendar",5,0,0,0,5
1839073,1463394,2024-08-05,Senate,"Placed on suspense file",7,0,0,0,7
1839073,1464130,2024-08-15,Senate,"Do pass",7,0,0,0,7
1839073,1466614,2024-08-28,Senate,"Assembly 3rd Reading AB2134 Muratsuchi By Cortese",40,0,0,0,40
1839074,1408831,2024-03-13,Assembly,"Do pass and be re-referred to the Committee on [Appropriations]",5,0,0,2,7
1839074,1444669,2024-05-16,Assembly,"Do pass as amended",11,3,0,1,15
1839074,1448607,2024-05-22,Assembly,"AB 2135 Schiavo Assembly Third Reading",56,4,0,20,80
1839074,1456962,2024-06-12,Senate,"Do pass as amended, but first amend, and re-refer to the Committee on [Judiciary]",4,0,0,1,5
1839074,1460475,2024-06-25,Senate,"Do pass, but first be re-referred to the Committee on [Appropriations]",9,1,0,1,11
1839074,1463515,2024-08-05,Senate,"Placed on suspense file",7,0,0,0,7
1839075,1433177,2024-04-23,Assembly,"Do pass and be re-referred to the Committee on [Appropriations]",7,0,0,1,8
1839075,1441343,2024-05-08,Assembly,"Do pass",10,3,0,2,15
1839075,1448642,2024-05-22,Assembly,"AB 2136 Jones-Sawyer Assembly Third Reading",46,5,0,29,80
1839075,1458334,2024-06-18,Senate,"Do pass, but first be re-referred to the Committee on [Judiciary]",4,1,0,0,5
1839075,1462519,2024-07-02,Senate,"Do pass as amended, but first amend, and re-refer to the Committee on [Appropriations]",9,2,0,0,11
1839075,1466158,2024-08-29,Senate,"Assembly 3rd Reading AB2136 Jones-Sawyer By Eggman",30,10,0,0,40
1839075,1466543,2024-08-30,Assembly,"AB 2136 Jones-Sawyer Concurrence in Senate Amendments",59,5,0,15,79
1839076,1421164,2024-04-03,Assembly,"Do pass as amended, and be re-referred to the Committee on [Human Services] with recommendation: To Consent Calendar",7,0,0,0,7
1839076,1432951,2024-04-23,Assembly,"Do pass and be re-referred to the Committee on [Appropriations] with recommendation: To Consent Calendar",6,0,0,1,7
1839076,1441357,2024-05-08,Assembly,"Do pass. To Consent Calendar",15,0,0,0,15
1839076,1444097,2024-05-16,Assembly,"AB 2137 Quirk-Silva Consent Calendar Second Day Regular Session",71,0,0,9,80
1839076,1454271,2024-06-05,Senate,"Do pass, but first be re-referred to the Committee on [Appropriations]",7,0,0,0,7
1839076,1458009,2024-06-17,Senate,"Placed on suspense file",7,0,0,0,7
1839076,1464091,2024-08-15,Senate,"Do pass",7,0,0,0,7
1839076,1466134,2024-08-29,Assembly,"AB 2137 Quirk-Silva Concurrence in Senate Amendments",76,0,0,3,79
1839076,1466696,2024-08-28,Senate,"Assembly 3rd Reading AB2137 Quirk-Silva et al. By Cortese",39,0,0,1,40
1839077,1428809,2024-04-16,Assembly,"Do pass as amended, and be re-referred to the Committee on [Appropriations] with recommendation: To Consent Calendar",8,0,0,0,8
1839077,1444497,2024-05-16,Assembly,"Do pass",15,0,0,0,15
1839077,1445968,2024-05-21,Assembly,"AB 2138 Ramos Assembly Third Reading",73,0,0,7,80
1839077,1460088,2024-06-25,Senate,"Do pass as amended, but first amend, and re-refer to the Committee on [Appropriations] with the recommendation: To Consent Calendar",5,0,0,0,5
1839077,1463576,2024-08-05,Senate,"Placed on suspense file",7,0,0,0,7
1839077,1464132,2024-08-15,Senate,"Do pass",7,0,0,0,7
1839077,1466283,2024-08-29,Assembly,"AB 2138 Ramos Concurrence in Senate Amendments",76,0,0,3,79
1839077,1466868,2024-08-28,Senate,"Special Consent AB2138 Ramos By Laird",39,0,0,1,40
1839079,1412569,2024-03-20,Assembly,"Do pass and be re-referred to the Committee on [Appropriations]",8,0,0,1,9
1839080,1419183,2024-04-02,Assembly,"Do pass as amended and be re-referred to the Committee on [Appropriations]",7,0,0,0,7
1839081,1420194,2024-04-02,Assembly,"Do pass and be re-referred to the Committee on [Appropriations]",8,0,0,0,8
1839082,1424846,2024-04-10,Assembly,"Do pass and be re-referred to the Committee on [Appropriations] with recommendation: To Consent Calendar",9,0,0,1,10
1839082,1437656,2024-05-01,Assembly,"Do pass. To Consent Calendar",14,0,0,1,15
1839082,1441978,2024-05-09,Assembly,"AB 2143 Connolly Consent Calendar Second Day Regular Session",65,0,0,15,80
1839082,1458156,2024-06-18,Senate,"Do pass as amended, but first amend, and re-refer to the Committee on [Appropriations] with the recommendation: To Consent Calendar",5,0,0,0,5
1839082,1463831,2024-08-12,Senate,"Consent Calendar 2nd AB2143 Connolly",38,0,0,2,40
1839082,1465537,2024-08-26,Senate,"Assembly 3rd Reading AB2143 Connolly By Dodd",40,0,0,0,40
1839082,1465877,2024-08-27,Assembly,"AB 2143 Connolly Concurrence in Senate Amendments",77,0,0,2,79
1839083,1412583,2024-03-20,Assembly,"Do pass and be re-referred to the Committee on [Local Government] with recommendation: To Consent Calendar",9,0,0,0,9
1839083,1431005,2024-04-17,Assembly,"Do pass and be re-referred to the Committee on [Appropriations] with recommendation: To Consent Calendar",9,0,0,0,9
1839083,1444437,2024-05-16,Assembly,"Do pass",15,0,0,0,15
1839083,1446110,2024-05-21,Assembly,"AB 2144 Grayson Assembly Third Reading",72,0,0,8,80
1839083,1458521,2024-06-18,Senate,"Do pass, but first be re-referred to the Committee on [Appropriations] with the recommendation: To Consent Calendar",10,0,0,0,10
1839083,1461999,2024-07-01,Senate,"Placed on suspense file",7,0,0,0,7
1839084,1411316,2024-03-19,Assembly,"Do pass and be re-referred to the Committee on [Appropriations] with recommendation: To Consent Calendar",13,0,0,2,15
1839085,1436921,2024-04-30,Assembly,"Do pass as amended",11,0,0,0,11
1839085,1446039,2024-05-21,Assembly,"AB 2146 Rodriguez Assembly Third Reading",74,0,0,6,80
1839085,1454262,2024-06-05,Senate,"Do pass as amended, and be ordered to the Consent Calendar",11,0,0,0,11
1839085,1465407,2024-08-21,Senate,"Assembly 3rd Reading AB2146 Rodriguez et al. By Rubio",33,0,0,7,40
1839085,1466765,2024-08-28,Assembly,"AB 2146 Rodriguez Concurrence in Senate Amendments",77,0,0,2,79
1839086,1422046,2024-04-08,Assembly,"Do pass and be re-referred to the Committee on [Appropriations] with recommendation: To Consent Calendar",15,0,0,0,15
1839087,1419135,2024-04-02,Assembly,"Do pass as amended and be re-referred to the Committee on [Judiciary]",18,0,0,0,18
1839087,1428856,2024-04-16,Assembly,"Do pass and be re-referred to the Committee on [Appropriations]",12,0,0,0,12
1839087,1444005,2024-05-16,Assembly,"Do pass",15,0,0,0,15
1839087,1446108,2024-05-21,Assembly,"AB 2148 Low Assembly Third Reading",71,0,0,9,80
1839087,1458028,2024-06-17,Senate,"Do pass, but first be re-referred to the Committee on [Judiciary]",11,0,0,2,13
1839087,1462622,2024-07-02,Senate,"Do pass, but first be re-referred to the Committee on [Appropriations] with the recommendation: To Consent Calendar",11,0,0,0,11
1839087,1463489,2024-08-05,Senate,"Placed on suspense file",7,0,0,0,7
1839088,1428763,2024-04-16,Assembly,"Do pass as amended and be re-referred to the Committee on [Appropriations]",10,1,0,1,12
1839088,1444079,2024-05-16,Assembly,"Do pass as amended",11,3,0,1,15
1839088,1446135,2024-05-21,Assembly,"AB 2149 Connolly Assembly Third Reading",51,10,0,19,80
1839088,1462647,2024-07-02,Senate,"Do pass as amended, but first amend, and re-refer to the Committee on [Appropriations]",9,0,0,2,11
1839088,1463612,2024-08-05,Senate,"Placed on suspense file",7,0,0,0,7
1839089,1419144,2024-04-02,Assembly,"Do pass and be re-referred to the Committee on [Higher Education]",7,0,0,0,7
1839089,1429980,2024-04-16,Assembly,"Do pass as amended and be re-referred to the Committee on [Appropriations]",11,0,0,0,11
1839091,1420215,2024-04-02,Assembly,"Do pass and be re-referred to the Committee on [Appropriations]",8,0,0,3,11
1839093,1419148,2024-04-02,Assembly,"Do pass as amended and be re-referred to the Committee on [Appropriations]",15,0,0,1,16
1839093,1430053,2024-04-17,Assembly,"Do pass. To Consent Calendar",15,0,0,0,15
1839093,1435289,2024-04-25,Assembly,"AB 2154 Berman Consent Calendar Second Day Regular Session",75,0,0,5,80
1839093,1454240,2024-06-05,Senate,"Do pass, but first be re-referred to the Committee on [Judiciary] with the recommendation: To Consent Calendar",11,0,0,0,11
1839093,1458237,2024-06-18,Senate,"Do pass, but first be re-referred to the Committee on [Appropriations] with the recommendation: To Consent Calendar",10,0,0,1,11
1839093,1463408,2024-08-05,Senate,"Consent Calendar 2nd AB2154 Berman et al",40,0,0,0,40
1839093,1464355,2024-08-15,Assembly,"AB 2154 Berman Concurrence in Senate Amendments",76,0,0,3,79
1839094,1432987,2024-04-23,Assembly,"Do pass as amended and be re-referred to the Committee on [Appropriations]",6,0,0,1,7
1839095,1419202,2024-04-02,Assembly,"Do pass as amended and be re-referred to the Committee on [Appropriations]",15,0,0,1,16
1839096,1412512,2024-03-20,Assembly,"Do pass",8,0,0,1,9
1839096,1427223,2024-04-15,Assembly,"AB 2157 Bonta Third Reading Urgency",72,0,0,8,80
1839096,1451581,2024-05-29,Senate,"Do pass as amended",7,0,0,0,7
1839096,1462048,2024-07-01,Senate,"Assembly 3rd Reading AB2157 Bonta By Skinner Urgency Clause",40,0,0,0,40
1839096,1462476,2024-07-03,Assembly,"AB 2157 Bonta Concurrence in Senate Amendments",73,0,0,6,79
1839098,1424784,2024-04-10,Assembly,"Do pass as amended and be re-referred to the Committee on [Judiciary]",8,0,0,1,9
1839098,1436913,2024-04-30,Assembly,"Do pass as amended",12,0,0,0,12
1839098,1445232,2024-05-20,Assembly,"AB 2159 Maienschein Assembly Third Reading",73,0,0,7,80
1839098,1458435,2024-06-18,Senate,"Do pass, but first be re-referred to the Committee on [Judiciary]",7,1,0,2,10
1839098,1462438,2024-07-02,Senate,"Do pass as amended",10,1,0,0,11
1839098,1466367,2024-08-29,Senate,"Assembly 3rd Reading AB2159 Maienschein By Bradford",39,0,0,1,40
1839098,1466562,2024-08-30,Assembly,"AB 2159 Maienschein Concurrence in Senate Amendments",76,0,0,3,79
1839099,1434283,2024-04-24,Assembly,"Do pass and be re-referred to the Committee on [Appropriations]",6,0,0,2,8
1839100,1423748,2024-04-09,Assembly,"Do pass as amended and be re-referred to the Committee on [Appropriations]",16,0,0,0,16
1839100,1444307,2024-05-16,Assembly,"Do pass",15,0,0,0,15
1839100,1446075,2024-05-21,Assembly,"AB 2161 Arambula Assembly Third Reading",71,0,0,9,80
1839100,1458525,2024-06-19,Senate,"Do pass, but first be re-referred to the Committee on [Appropriations] with the recommendation: To Consent Calendar",11,0,0,0,11
1839100,1461971,2024-07-01,Senate,"Placed on suspense file",7,0,0,0,7
1839102,1428921,2024-04-16,Assembly,"Do pass as amended, and be re-referred to the Committee on [Appropriations] with recommendation: To Consent Calendar",7,0,0,0,7
1839103,1433014,2024-04-23,Assembly,"Do pass and be re-referred to the Committee on [Appropriations] with recommendation: To Consent Calendar",17,0,0,1,18
1839103,1441358,2024-05-08,Assembly,"Do pass. To Consent Calendar",15,0,0,0,15
1839103,1444426,2024-05-16,Assembly,"AB 2164 Berman Consent Calendar Second Day Regular Session",71,0,0,9,80
1839103,1462104,2024-07-01,Senate,"Do pass, but first be re-referred to the Committee on [Appropriations]",13,0,0,0,13
1839103,1465481,2024-08-22,Senate,"Assembly 3rd Reading AB2164 Berman By Eggman",33,0,0,7,40
1839104,1424930,2024-04-10,Assembly,"Do pass as amended, and be re-referred to the Committee on [Appropriations] with recommendation: To Consent Calendar",7,0,0,0,7
1839104,1444520,2024-05-16,Assembly,"Do pass",15,0,0,0,15
1839104,1446011,2024-05-21,Assembly,"AB 2165 Reyes Assembly Third Reading",73,0,0,7,80
1839104,1458514,2024-06-19,Senate,"Do pass, but first be re-referred to the Committee on [Appropriations] with the recommendation: To Consent Calendar",7,0,0,0,7
1839104,1462016,2024-07-01,Senate,"Placed on suspense file",7,0,0,0,7
1839104,1464096,2024-08-15,Senate,"Do pass as amended",7,0,0,0,7
1839104,1466461,2024-08-30,Senate,"Special Consent AB2165 Reyes By Caballero",40,0,0,0,40
1839104,1466943,2024-08-31,Assembly,"AB 2165 Reyes Concurrence in Senate Amendments",76,0,0,3,79
1839105,1423867,2024-04-09,Assembly,"Do pass and be re-referred to the Committee on [Appropriations] with recommendation: To Consent Calendar",18,0,0,0,18
1839105,1429995,2024-04-17,Assembly,"Do pass. To Consent Calendar",15,0,0,0,15
1839105,1435346,2024-04-25,Assembly,"AB 2166 Weber Consent Calendar Second Day Regular Session",75,0,0,5,80
1839105,1459401,2024-06-24,Senate,"Do pass, but first be re-referred to the Committee on [Appropriations]",12,0,0,1,13
1839105,1465273,2024-08-19,Senate,"Assembly 3rd Reading AB2166 Weber By Smallwood-Cuevas",40,0,0,0,40
1839106,1430091,2024-04-17,Assembly,"Do pass and be re-referred to the Committee on [Appropriations]",14,0,0,1,15
1839106,1443996,2024-05-16,Assembly,"Do pass as amended",12,0,0,3,15
1839106,1448669,2024-05-22,Assembly,"AB 2167 Cervantes Assembly Third Reading By REYES",67,0,0,13,80
1839106,1456917,2024-06-12,Senate,"Do pass as amended, but first amend, and re-refer to the Committee on [Appropriations]",5,0,0,0,5
1839106,1462079,2024-07-01,Senate,"Placed on suspense file",7,0,0,0,7
1839107,1382155,2024-02-12,Assembly,"Be adopted. To Consent Calendar",8,0,0,3,11
1839107,1387162,2024-02-16,Assembly,"ACR 138 Essayli Consent Calendar Second Day",63,0,0,17,80
1839107,1409589,2024-03-14,Senate,"Special Consent ACR138 Essayli et al",38,0,0,2,40
1839108,1411407,2024-03-19,Senate,"Do pass, but first be re-referred to the Committee on [Appropriations]",5,0,0,0,5
1839108,1431979,2024-04-22,Senate,"Placed on suspense file",7,0,0,0,7
1839108,1444556,2024-05-16,Senate,"Do pass",7,0,0,0,7
1839108,1449707,2024-05-23,Senate,"Special Consent SB1019 Blakespear et al",37,0,0,3,40
1839108,1458292,2024-06-18,Assembly,"Do pass and be re-referred to the Committee on [Appropriations] with recommendation: To Consent Calendar",7,0,0,1,8
1839108,1464578,2024-08-15,Assembly,"Do pass as amended",11,0,0,4,15
1839108,1466447,2024-08-30,Senate,"Special Consent SB1019 Blakespear et al",40,0,0,0,40
1839108,1467009,2024-08-28,Assembly,"SB 1019 Blakespear Senate Third Reading By Papan",73,1,0,5,79
1839109,1428786,2024-04-16,Senate,"Do pass, but first be re-referred to the Committee on [Appropriations]",4,0,0,1,5
1839109,1445227,2024-05-20,Senate,"Senate 3rd Reading SB1020 Bradford",33,0,0,7,40
1839109,1458196,2024-06-18,Assembly,"Do pass and be re-referred to the Committee on [Appropriations]",5,1,0,2,8
1839109,1462370,2024-07-02,Assembly,"Do pass",11,3,0,1,15
1839109,1466018,2024-08-27,Assembly,"SB 1020 Bradford Senate Third Reading By Jones-Sawyer",55,1,0,23,79
1839110,1424821,2024-04-09,Senate,"Do pass, but first be re-referred to the Committee on [Public Safety] with the recommendation: To Consent Calendar",15,0,0,0,15
1839110,1433188,2024-04-23,Senate,"Do pass, but first be re-referred to the Committee on [Appropriations] with the recommendation: To Consent Calendar",5,0,0,0,5
1839110,1439639,2024-05-06,Senate,"Placed on suspense file",7,0,0,0,7
1839111,1423790,2024-04-09,Senate,"Do pass as amended, but first amend, and re-refer to the Committee on [Appropriations]",9,2,0,0,11
1839111,1439645,2024-05-06,Senate,"Placed on suspense file",7,0,0,0,7
1839111,1444151,2024-05-16,Senate,"Do pass",5,2,0,0,7
1839111,1450304,2024-05-21,Senate,"Senate 3rd Reading SB1022 Skinner et al",30,9,0,1,40
1839111,1456429,2024-06-11,Assembly,"Do pass and be re-referred to the Committee on [Appropriations]",9,3,0,0,12
1839111,1462309,2024-07-02,Assembly,"Do pass",11,4,0,0,15
1839111,1465277,2024-08-19,Assembly,"SB 1022 Skinner Senate Third Reading By Kalra",51,16,0,12,79
1839111,1465540,2024-08-26,Senate,"Unfinished Business SB1022 Skinner et al. Concurrence",31,9,0,0,40
1839112,1412522,2024-03-20,Senate,"Do pass, but first be re-referred to the Committee on [Appropriations]",7,0,0,0,7
1839112,1422097,2024-04-08,Senate,"Placed on suspense file",6,0,0,1,7
1839113,1410551,2024-03-18,Senate,"Do pass, but first be re-referred to the Committee on [Appropriations] with the recommendation: To Consent Calendar",12,0,0,1,13
1839113,1425921,2024-04-11,Senate,"Consent Calendar 2nd SB1024 Ochoa Bogh",39,0,0,1,40
1839113,1456388,2024-06-11,Assembly,"Do pass and be re-referred to the Committee on [Appropriations] with recommendation: To Consent Calendar",17,0,0,1,18
1839113,1458523,2024-06-19,Assembly,"Do pass. To Consent Calendar",14,0,0,1,15
1839113,1460665,2024-06-26,Assembly,"SB 1024 Ochoa Bogh Consent Calendar Second Day Regular Session",75,0,0,4,79
1839113,1462453,2024-07-03,Senate,"Special Consent SB1024 Ochoa Bogh",39,0,0,1,40
1839114,1411375,2024-03-19,Senate,"Do pass as amended, but first amend, and re-refer to the Committee on [Appropriations]",4,0,0,1,5
1839114,1427357,2024-04-15,Senate,"Placed on suspense file",6,0,0,1,7
1839114,1444180,2024-05-16,Senate,"Do pass",5,2,0,0,7
1839114,1445217,2024-05-20,Senate,"Senate 3rd Reading SB1025 Eggman",33,0,0,7,40
1839114,1458345,2024-06-18,Assembly,"Do pass and be re-referred to the Committee on [Appropriations]",7,0,0,1,8
1839114,1464312,2024-08-15,Assembly,"Do pass as amended",12,0,0,3,15
1839114,1466210,2024-08-29,Assembly,"SB 1025 Eggman Senate Third Reading By Lackey",74,0,0,5,79
1839114,1466489,2024-08-30,Senate,"Unfinished Business SB1025 Eggman Concurrence",35,0,0,5,40
1839116,1411366,2024-03-19,Senate,"Do pass as amended, but first amend, and re-refer to the Committee on [Judiciary]",7,0,0,0,7
1839116,1420114,2024-04-02,Senate,"Do pass, but first be re-referred to the Committee on [Appropriations] with the recommendation: To Consent Calendar",11,0,0,0,11
1839116,1431058,2024-04-18,Senate,"Consent Calendar 2nd SB1027 Menjivar",39,0,0,1,40
1839116,1456858,2024-06-12,Assembly,"Do pass and be re-referred to the Committee on [Judiciary] with recommendation: To Consent Calendar",8,0,0,0,8
1839116,1458253,2024-06-18,Assembly,"Do pass and be re-referred to the Committee on [Appropriations] with recommendation: To Consent Calendar",12,0,0,0,12
1839116,1462280,2024-07-02,Assembly,"Do pass. To Consent Calendar",15,0,0,0,15
1839116,1463772,2024-08-08,Assembly,"SB 1027 Menjivar Consent Calendar Second Day Regular Session",72,0,0,7,79
1839117,1408242,2024-03-12,Senate,"Do pass as amended, but first amend, and re-refer to the Committee on [Appropriations]",16,0,0,0,16
1839117,1422049,2024-04-08,Senate,"Placed on suspense file",6,0,0,1,7
1839118,1427306,2024-04-15,Senate,"Do pass, but first be re-referred to the Committee on [Appropriations] with the recommendation: To Consent Calendar",10,0,0,1,11
1839118,1436191,2024-04-29,Senate,"Placed on suspense file",5,0,0,2,7
1839119,1424865,2024-04-10,Senate,"Do pass, but first be re-referred to the Committee on [Appropriations]",4,0,0,1,5
1839119,1431898,2024-04-22,Senate,"Placed on suspense file",7,0,0,0,7
1839120,1434150,2024-04-23,Senate,"Do pass, but first be re-referred to the Committee on [Revenue and Taxation]",11,4,0,0,15
1839120,1434151,2024-04-24,Senate,"Do pass, but first be re-referred to the Committee on [Appropriations]",6,1,0,0,7
1839120,1442657,2024-05-13,Senate,"Placed on suspense file",7,0,0,0,7
1839120,1443960,2024-05-16,Senate,"Do pass as amended",5,2,0,0,7
1839120,1450021,2024-05-24,Senate,"Senate 3rd Reading SB1031 Wiener et al",26,10,0,4,40
1839121,1412605,2024-03-19,Senate,"Do pass as amended, but first amend, and re-refer to the Committee on [Appropriations]",8,0,0,2,10
1839121,1422098,2024-04-08,Senate,"Placed on suspense file",6,0,0,1,7
1839121,1444371,2024-05-16,Senate,"Do pass as amended",5,2,0,0,7
1839121,1450261,2024-05-21,Senate,"Senate 3rd Reading SB1032 Padilla et al",31,7,0,2,40
1839121,1460709,2024-06-26,Assembly,"Do pass and be re-referred to the Committee on [Appropriations]",7,1,0,1,9
1839122,1435229,2024-04-24,Senate,"Do pass, but first be re-referred to the Committee on [Appropriations] with the recommendation: To Consent Calendar",11,0,0,0,11
1839122,1439647,2024-05-06,Senate,"Placed on suspense file",7,0,0,0,7
1839122,1444607,2024-05-16,Senate,"Do pass as amended",7,0,0,0,7
1839122,1450019,2024-05-24,Senate,"Special Consent SB1033 Menjivar",38,0,0,2,40
1839123,1420090,2024-04-02,Senate,"Do pass as amended, but first amend, and re-refer to the Committee on [Appropriations] with the recommendation: To Consent Calendar",11,0,0,0,11
1839123,1435342,2024-04-25,Senate,"Consent Calendar 2nd SB1034 Seyarto et al",36,0,0,4,40
1839123,1453432,2024-06-04,Assembly,"Do pass as amended, and be re-referred to the Committee on [Appropriations] with recommendation: To Consent Calendar",8,0,0,4,12
1839123,1458429,2024-06-19,Assembly,"Do pass. To Consent Calendar",14,0,0,1,15
1839123,1460771,2024-06-26,Assembly,"SB 1034 Seyarto Consent Calendar Second Day Regular Session",75,0,0,4,79
1839123,1462683,2024-07-03,Senate,"Special Consent SB1034 Seyarto et al",39,0,0,1,40
1839124,1419211,2024-04-02,Senate,"Do pass, but first be re-referred to the Committee on [Revenue and Taxation]",4,1,0,0,5
1839124,1434216,2024-04-24,Senate,"Do pass as amended, but first amend, and re-refer to the Committee on [Appropriations]",6,0,0,1,7
1839124,1442589,2024-05-13,Senate,"Placed on suspense file",7,0,0,0,7
1839125,1412603,2024-03-20,Senate,"Do pass, but first be re-referred to the Committee on [Judiciary]",5,0,0,2,7
1839125,1423888,2024-04-09,Senate,"Do pass, but first be re-referred to the Committee on [Appropriations]",9,1,0,1,11
1839125,1431905,2024-04-22,Senate,"Placed on suspense file",7,0,0,0,7
1839125,1444365,2024-05-16,Senate,"Do pass as amended",5,2,0,0,7
1839125,1450318,2024-05-21,Senate,"Senate 3rd Reading SB1036 Lim√≥n",31,5,0,4,40
1839126,1428826,2024-04-16,Senate,"Do pass, but first be re-referred to the Committee on [Judiciary]",7,2,0,1,10
1839126,1434091,2024-04-23,Senate,"Do pass as amended, but first amend, and re-refer to the Committee on [Appropriations]",9,2,0,0,11
1839126,1450297,2024-05-21,Senate,"Senate 3rd Reading SB1037 Wiener",24,9,0,7,40
1839126,1456918,2024-06-12,Assembly,"Do pass and be re-referred to the Committee on [Judiciary]",8,1,0,0,9
1839126,1458218,2024-06-18,Assembly,"Do pass and be re-referred to the Committee on [Appropriations]",8,2,0,2,12
1839126,1462333,2024-07-02,Assembly,"Do pass",11,4,0,0,15
1839126,1467013,2024-08-31,Senate,"Unfinished Business SB1037 Wiener et al. Concurrence",23,9,0,8,40
1839126,1467014,2024-08-31,Assembly,"SB 1037 Wiener Senate Third Reading By Wicks",46,16,0,17,79
1839127,1411369,2024-03-19,Senate,"Do pass, but first be re-referred to the Committee on [Judiciary]",4,1,0,0,5
1839127,1423756,2024-04-09,Senate,"Do pass as amended, but first amend, and re-refer to the Committee on [Appropriations]",8,2,0,1,11
1839127,1442549,2024-05-13,Senate,"Placed on suspense file",7,0,0,0,7
1839129,1395248,2024-02-26,Senate,"Senate 3rd Reading SCR107 Smallwood-Cuevas et",37,0,0,3,40
1839129,1413836,2024-03-21,Assembly,"Be adopted. To Consent Calendar",8,0,0,3,11
1839129,1421166,2024-04-04,Assembly,"SCR 107 Smallwood-Cuevas Consent Calendar Second Day Regular Session",70,0,0,10,80
1839130,1392729,2024-02-22,Senate,"Senate 3rd Reading SCR108 Hurtado et al",39,0,0,1,40
1839130,1413846,2024-03-21,Assembly,"Be adopted. To Consent Calendar",8,0,0,3,11
1839130,1421173,2024-04-04,Assembly,"SCR 108 Hurtado Consent Calendar Second Day Regular Session",70,0,0,10,80
1839131,1402356,2024-03-04,Senate,"Senate 3rd Reading SCR109 Niello et al",34,0,0,6,40
1839131,1413835,2024-03-21,Assembly,"Be adopted. To Consent Calendar",8,0,0,3,11
1839131,1421147,2024-04-04,Assembly,"SCR 109 Niello Consent Calendar Second Day Regular Session",70,0,0,10,80
1840382,1428851,2024-04-16,Assembly,"Do pass as amended and be re-referred to the Committee on [Appropriations]",5,2,0,1,8
1840382,1443910,2024-05-16,Assembly,"Do pass",10,4,0,1,15
1840383,1423715,2024-04-09,Assembly,"Do pass and be re-referred to the Committee on [Appropriations]",14,0,0,2,16
1840383,1444261,2024-05-16,Assembly,"Do pass",12,1,0,2,15
1840383,1449591,2024-05-23,Assembly,"AB 2169 Bauer-Kahan Assembly Third Reading",65,1,0,14,80
1840383,1460574,2024-06-26,Senate,"Do pass, but first be re-referred to the Committee on [Appropriations]",10,0,0,1,11
1840383,1463687,2024-08-05,Senate,"Placed on suspense file",7,0,0,0,7
1840386,1430051,2024-04-17,Assembly,"Do pass and be re-referred to the Committee on [Appropriations]",12,0,0,4,16
1840386,1444514,2024-05-16,Assembly,"Do pass",14,0,0,1,15
1840386,1449692,2024-05-23,Assembly,"AB 2172 Wallis Assembly Third Reading",71,0,0,9,80
1840387,1412544,2024-03-20,Assembly,"Do pass and be re-referred to the Committee on [Appropriations]",6,0,0,1,7
1840387,1424939,2024-04-10,Assembly,"Do pass. To Consent Calendar",14,0,0,1,15
1840387,1431054,2024-04-18,Assembly,"AB 2173 Addis Consent Calendar Second Day Regular Session",72,0,0,8,80
1840387,1451576,2024-05-29,Senate,"Do pass, but first be re-referred to the Committee on [Appropriations] with the recommendation: To Consent Calendar",7,0,0,0,7
1840387,1457363,2024-06-13,Senate,"Consent Calendar 2nd AB2173 Addis et al",37,0,0,3,40
1840387,1462625,2024-07-03,Assembly,"AB 2173 Addis Concurrence in Senate Amendments",72,0,0,7,79
1840388,1430039,2024-04-17,Assembly,"Do pass as amended and be re-referred to the Committee on [Appropriations]",21,0,0,1,22
1840388,1441383,2024-05-08,Assembly,"Do pass. To Consent Calendar",15,0,0,0,15
1840388,1443941,2024-05-16,Assembly,"AB 2174 Aguiar-Curry Consent Calendar Second Day Regular Session",71,0,0,9,80
1840388,1460065,2024-06-25,Senate,"Do pass, but first be re-referred to the Committee on [Appropriations] with the recommendation: To Consent Calendar",14,0,0,2,16
1840388,1465417,2024-08-21,Senate,"Assembly 3rd Reading AB2174 Aguiar-Curry By Ashby",33,0,0,7,40
1840388,1465777,2024-08-26,Assembly,"AB 2174 Aguiar-Curry Concurrence in Senate Amendments",77,0,0,2,79
1840389,1419176,2024-04-02,Assembly,"Do pass as amended and be re-referred to the Committee on [Appropriations]",14,0,0,2,16
1840390,1420034,2024-04-02,Assembly,"Do pass as amended and be re-referred to the Committee on [Appropriations]",8,0,0,0,8
1840390,1437598,2024-05-01,Assembly,"Do pass. To Consent Calendar",14,0,0,1,15
1840390,1441937,2024-05-09,Assembly,"AB 2176 Berman Consent Calendar Second Day Regular Session",65,0,0,15,80
1840390,1456381,2024-06-11,Senate,"Do pass, but first be re-referred to the Committee on [Appropriations] with the recommendation: To Consent Calendar",5,0,0,0,5
1840390,1465373,2024-08-20,Senate,"Assembly 3rd Reading AB2176 Berman By Laird",40,0,0,0,40
1840390,1465435,2024-08-22,Assembly,"AB 2176 Berman Concurrence in Senate Amendments",62,0,0,17,79
1840391,1420150,2024-04-03,Assembly,"Do pass and be re-referred to the Committee on [Appropriations] with recommendation: To Consent Calendar",21,0,0,1,22
1840391,1429983,2024-04-17,Assembly,"Do pass. To Consent Calendar",15,0,0,0,15
1840391,1435293,2024-04-25,Assembly,"AB 2177 McKinnor Consent Calendar Second Day Regular Session",75,0,0,5,80
1840391,1450963,2024-05-28,Senate,"Do pass, but first be re-referred to the Committee on [Appropriations] with the recommendation: To Consent Calendar",12,0,0,4,16
1840391,1457341,2024-06-13,Senate,"Consent Calendar 2nd AB2177 McKinnor",37,0,0,3,40
1840392,1434079,2024-04-24,Assembly,"Do pass and be re-referred to the Committee on [Appropriations]",6,1,0,1,8
1840392,1444541,2024-05-16,Assembly,"Do pass",11,4,0,0,15
1840392,1446098,2024-05-21,Assembly,"AB 2178 Ting Assembly Third Reading",46,17,0,17,80
1840392,1458344,2024-06-18,Senate,"Do pass, but first be re-referred to the Committee on [Appropriations]",4,1,0,0,5
1840392,1462036,2024-07-01,Senate,"Placed on suspense file",7,0,0,0,7
1840392,1464263,2024-08-15,Senate,"Do pass as amended",5,2,0,0,7
1840392,1465732,2024-08-26,Senate,"Assembly 3rd Reading AB2178 Ting By Skinner",22,14,0,4,40
1840392,1465978,2024-08-27,Assembly,"AB 2178 Ting Concurrence in Senate Amendments",47,17,0,15,79
1840393,1412604,2024-03-20,Assembly,"Do pass as amended and be re-referred to the Committee on [Appropriations]",7,0,0,0,7
1840393,1424776,2024-04-10,Assembly,"Do pass. To Consent Calendar",14,0,0,1,15
1840393,1431059,2024-04-18,Assembly,"AB 2179 Davies Consent Calendar Second Day Regular Session",72,0,0,8,80
1840393,1451588,2024-05-29,Senate,"Do pass, but first be re-referred to the Committee on [Appropriations] with the recommendation: To Consent Calendar",7,0,0,0,7
1840393,1457326,2024-06-13,Senate,"Consent Calendar 2nd AB2179 Davies",37,0,0,3,40
1840394,1433037,2024-04-23,Assembly,"Do pass as amended and be re-referred to the Committee on [Appropriations]",16,0,0,0,16
1840395,1421155,2024-04-03,Assembly,"Do pass as amended, and be re-referred to the Committee on [Appropriations] with recommendation: To Consent Calendar",7,0,0,0,7
1840395,1444277,2024-05-16,Assembly,"Do pass",15,0,0,0,15
1840395,1449719,2024-05-23,Assembly,"AB 2181 Gipson Assembly Third Reading",71,0,0,9,80
1840395,1458448,2024-06-19,Senate,"Do pass, but first be re-referred to the Committee on [Appropriations] with the recommendation: To Consent Calendar",7,0,0,0,7
1840395,1462114,2024-07-01,Senate,"Placed on suspense file",7,0,0,0,7
1840395,1464063,2024-08-15,Senate,"Do pass",7,0,0,0,7
1840395,1466120,2024-08-29,Assembly,"AB 2181 Gipson Concurrence in Senate Amendments",76,0,0,3,79
1840395,1466638,2024-08-28,Senate,"Special Consent AB2181 Gipson By Skinner",39,0,0,1,40
1840396,1431008,2024-04-17,Assembly,"Do pass and be re-referred to the Committee on [Appropriations]",7,0,0,0,7
1840396,1444637,2024-05-16,Assembly,"Do pass",11,2,0,2,15
1840396,1446023,2024-05-21,Assembly,"AB 2182 Haney Assembly Third Reading",65,5,0,10,80
1840396,1456952,2024-06-12,Senate,"Do pass, but first be re-referred to the Committee on [Judiciary]",4,0,0,1,5
1840396,1460549,2024-06-25,Senate,"Do pass, but first be re-referred to the Committee on [Appropriations]",9,1,0,1,11
1840396,1463407,2024-08-05,Senate,"Placed on suspense file",7,0,0,0,7
1840396,1464359,2024-08-15,Senate,"Do pass as amended",5,2,0,0,7
1840396,1466217,2024-08-29,Senate,"Assembly 3rd Reading AB2182 Haney By Lim√≥n",30,8,0,2,40
1840396,1466592,2024-08-30,Assembly,"AB 2182 Haney Concurrence in Senate Amendments",70,0,0,9,79
1840398,1420088,2024-04-02,Assembly,"Do pass and be re-referred to the Committee on [Appropriations] with recommendation: To Consent Calendar",11,0,0,0,11
1840400,1431871,2024-04-22,Assembly,"Do pass and be re-referred to the Committee on [Appropriations] with recommendation: To Consent Calendar",15,0,0,0,15
1840400,1443477,2024-05-15,Assembly,"Do pass. To Consent Calendar",15,0,0,0,15
1840400,1446111,2024-05-21,Assembly,"AB 2186 Vince Fong Consent Calendar Second Day Regular Session",71,0,0,9,80
1840400,1460646,2024-06-25,Senate,"Do pass, but first be re-referred to the Committee on [Public Safety] with the recommendation: To Consent Calendar",15,0,0,0,15
1840400,1462362,2024-07-02,Senate,"Do pass, but first be re-referred to the Committee on [Appropriations]",5,0,0,0,5
1840400,1466103,2024-08-29,Senate,"Assembly 3rd Reading AB2186 Wallis By Seyarto",40,0,0,0,40
1840400,1466394,2024-08-30,Assembly,"AB 2186 Wallis Concurrence in Senate Amendments",76,0,0,3,79
1840401,1432922,2024-04-23,Assembly,"Do pass and be re-referred to the Committee on [Appropriations]",8,2,0,2,12
1840405,1423814,2024-04-08,Assembly,"Do pass and be re-referred to the Committee on [Appropriations]",6,0,0,1,7
1840406,1435295,2024-04-24,Assembly,"Do pass and be re-referred to the Committee on [Appropriations] with recommendation: To Consent Calendar",8,0,0,1,9
1840406,1441394,2024-05-08,Assembly,"Do pass. To Consent Calendar",15,0,0,0,15
1840406,1444260,2024-05-16,Assembly,"AB 2192 Juan Carrillo Consent Calendar Second Day Regular Session",71,0,0,9,80
1840406,1462630,2024-07-03,Senate,"Do pass, but first be re-referred to the Committee on [Appropriations] with the recommendation: To Consent Calendar",7,0,0,0,7
1840406,1465909,2024-08-27,Senate,"Assembly 3rd Reading AB2192 Juan Carrillo By Durazo",40,0,0,0,40
1840406,1466805,2024-08-28,Assembly,"AB 2192 Juan Carrillo Concurrence in Senate Amendments",77,0,0,2,79
1840407,1411340,2024-03-19,Assembly,"Do pass and be re-referred to the Committee on [Higher Education]",10,0,0,2,12
1840407,1432994,2024-04-23,Assembly,"Do pass as amended and be re-referred to the Committee on [Appropriations]",7,0,0,4,11
1840407,1444425,2024-05-16,Assembly,"Do pass as amended",12,1,0,2,15
1840407,1446067,2024-05-21,Assembly,"AB 2193 Holden Assembly Third Reading",55,1,0,24,80
1840407,1458155,2024-06-18,Senate,"Do pass, but first be re-referred to the Committee on [Education]",8,1,0,2,11
1840407,1462441,2024-07-03,Senate,"Do pass as amended, but first amend, and re-refer to the Committee on [Appropriations]",6,0,0,1,7
1840407,1463512,2024-08-05,Senate,"Placed on suspense file",7,0,0,0,7
1840407,1464375,2024-08-15,Senate,"Do pass as amended",5,2,0,0,7
1840407,1465710,2024-08-26,Senate,"Assembly 3rd Reading AB2193 Holden et al. By Umberg",29,7,0,4,40
1840407,1465827,2024-08-27,Assembly,"AB 2193 Holden Concurrence in Senate Amendments",63,2,0,14,79
1840408,1433141,2024-04-23,Assembly,"Do pass as amended and be re-referred to the Committee on [Appropriations]",15,0,0,3,18
1840408,1441284,2024-05-08,Assembly,"Do pass. To Consent Calendar",15,0,0,0,15
1840408,1445148,2024-05-20,Assembly,"AB 2194 Joe Patterson Assembly Third Reading",56,1,0,23,80
1840410,1423924,2024-04-09,Assembly,"Do pass and be re-referred to the Committee on [Appropriations]",13,0,0,2,15
1840410,1444343,2024-05-16,Assembly,"Do pass",14,0,0,1,15
1840410,1445929,2024-05-21,Assembly,"AB 2196 Connolly Assembly Third Reading",72,0,0,8,80
1840410,1456453,2024-06-11,Senate,"Do pass, but first be re-referred to the Committee on [Appropriations]",11,0,0,0,11
1840410,1459329,2024-06-24,Senate,"Placed on suspense file",6,0,0,1,7
1840410,1464644,2024-08-15,Senate,"Do pass as amended",7,0,0,0,7
1840410,1466460,2024-08-30,Senate,"Special Consent AB2196 Connolly",40,0,0,0,40
1840410,1466962,2024-08-31,Assembly,"AB 2196 Connolly Concurrence in Senate Amendments",76,0,0,3,79
1840411,1408820,2024-03-11,Assembly,"Do pass and be re-referred to the Committee on [Appropriations]",7,0,0,0,7
1840411,1412554,2024-03-20,Assembly,"Do pass. To Consent Calendar",12,0,0,3,15
1840411,1421165,2024-04-04,Assembly,"AB 2197 Addis Consent Calendar Second Day Regular Session",70,0,0,10,80
1840411,1456893,2024-06-12,Senate,"Do pass as amended, but first amend, and re-refer to the Committee on [Appropriations] with the recommendation: To Consent Calendar",6,0,0,1,7
1840411,1461264,2024-06-27,Senate,"Consent Calendar 2nd AB2197 Addis et al",40,0,0,0,40
1840411,1462581,2024-07-03,Assembly,"AB 2197 Addis Concurrence in Senate Amendments",72,0,0,7,79
1840412,1433060,2024-04-23,Assembly,"Do pass as amended and be re-referred to the Committee on [Appropriations]",16,0,0,0,16
1840412,1443456,2024-05-15,Assembly,"Do pass. To Consent Calendar",15,0,0,0,15
1840412,1446145,2024-05-21,Assembly,"AB 2198 Flora Consent Calendar Second Day Regular Session",71,0,0,9,80
1840412,1456903,2024-06-12,Senate,"Do pass as amended, but first amend, and re-refer to the Committee on [Appropriations]",10,0,0,1,11
1840412,1466294,2024-08-29,Assembly,"AB 2198 Flora Concurrence in Senate Amendments",76,0,0,3,79
1840412,1466881,2024-08-28,Senate,"Assembly 3rd Reading AB2198 Flora By Glazer",39,0,0,1,40
1840413,1427250,2024-04-15,Assembly,"Do pass as amended and be re-referred to the Committee on [Appropriations]",9,0,0,2,11
1840413,1437589,2024-05-01,Assembly,"Do pass. To Consent Calendar",14,0,0,1,15
1840413,1441958,2024-05-09,Assembly,"AB 2199 Berman Consent Calendar Second Day Regular Session",63,0,0,17,80
1840413,1454228,2024-06-05,Senate,"Do pass as amended, but first amend, and re-refer to the Committee on [Housing]",7,0,0,0,7
1840413,1459971,2024-06-24,Senate,"Do pass, but first be re-referred to the Committee on [Appropriations]",10,0,0,0,10
1840413,1465328,2024-08-20,Senate,"Assembly 3rd Reading AB2199 Berman By Skinner",40,0,0,0,40
1840413,1465428,2024-08-22,Assembly,"AB 2199 Berman Concurrence in Senate Amendments",60,0,0,19,79
1840414,1433082,2024-04-23,Assembly,"Do pass as amended and be re-referred to the Committee on [Appropriations]",9,4,0,3,16
1840415,1435935,2024-04-23,Assembly,"Do pass as amended and be re-referred to the Committee on [Appropriations]",5,2,0,0,7
1840415,1443989,2024-05-16,Assembly,"Do pass",10,4,0,1,15
1840416,1419160,2024-04-02,Assembly,"Do pass and be re-referred to the Committee on [Appropriations]",16,1,0,1,18
1840416,1443956,2024-05-16,Assembly,"Do pass",13,1,0,1,15
1840416,1445928,2024-05-21,Assembly,"AB 2202 Rendon Assembly Third Reading",65,0,0,15,80
1840416,1458272,2024-06-18,Senate,"Do pass, but first be re-referred to the Committee on [Appropriations]",10,0,0,1,11
1840416,1462011,2024-07-01,Senate,"Placed on suspense file",7,0,0,0,7
1840416,1464361,2024-08-15,Senate,"Do pass as amended",5,2,0,0,7
1840416,1465763,2024-08-26,Senate,"Assembly 3rd Reading AB2202 Rendon et al. By Laird",35,4,0,1,40
1840416,1466014,2024-08-27,Assembly,"AB 2202 Rendon Concurrence in Senate Amendments",71,0,0,8,79
1840417,1419141,2024-04-02,Assembly,"Do pass as amended and be re-referred to the Committee on [Privacy and Consumer Protection]",6,0,0,1,7
1840417,1435245,2024-04-23,Assembly,"Do pass as amended and be re-referred to the Committee on [Appropriations]",11,0,0,0,11
1840417,1444123,2024-05-16,Assembly,"Do pass",15,0,0,0,15
1840417,1449604,2024-05-23,Assembly,"AB 2203 McCarty Assembly Third Reading",71,0,0,9,80
1840420,1423880,2024-04-09,Assembly,"Do pass as amended and be re-referred to the Committee on [Education]",6,0,0,1,7
1840420,1435341,2024-04-24,Assembly,"Do pass as amended, and be re-referred to the Committee on [Appropriations] with recommendation: To Consent Calendar",7,0,0,0,7
1840421,1428915,2024-04-16,Assembly,"Do pass and be re-referred to the Committee on [Human Services]",5,0,0,2,7
1840421,1433020,2024-04-23,Assembly,"Do pass and be re-referred to the Committee on [Appropriations] with recommendation: To Consent Calendar",6,0,0,1,7
1840421,1441302,2024-05-08,Assembly,"Do pass. To Consent Calendar",15,0,0,0,15
1840421,1443977,2024-05-16,Assembly,"AB 2207 Reyes Consent Calendar Second Day Regular Session",71,0,0,9,80
1840421,1458317,2024-06-17,Senate,"Do pass, but first be re-referred to the Committee on [Health] with the recommendation: To Consent Calendar",5,0,0,0,5
1840421,1462518,2024-07-03,Senate,"Do pass, but first be re-referred to the Committee on [Appropriations] with the recommendation: To Consent Calendar",11,0,0,0,11
1840421,1463436,2024-08-05,Senate,"Placed on suspense file",7,0,0,0,7
1840421,1464307,2024-08-15,Senate,"Do pass as amended",7,0,0,0,7
1840421,1466148,2024-08-29,Assembly,"AB 2207 Reyes Concurrence in Senate Amendments",76,0,0,3,79
1840421,1466661,2024-08-28,Senate,"Assembly 3rd Reading AB2207 Reyes By Laird",39,0,0,1,40
1840423,1424925,2024-04-09,Assembly,"Do pass and be re-referred to the Committee on [Appropriations]",2,5,0,1,8
1840423,1424926,2024-04-09,Assembly,Reconsideration,2,5,0,1,8
1840424,1433167,2024-04-23,Assembly,"Do pass as amended",8,0,0,0,8
1840426,1431969,2024-04-22,Assembly,"Do pass and be re-referred to the Committee on [Utilities and Energy]",9,1,0,1,11
1840426,1434254,2024-04-24,Assembly,"Do pass and be re-referred to the Committee on [Appropriations]",15,1,0,0,16
1840427,1425937,2024-04-10,Assembly,"Do pass and be re-referred to the Committee on [Appropriations] with recommendation: To Consent Calendar",9,0,0,0,9
1840427,1434182,2024-04-24,Assembly,"Do pass. To Consent Calendar",14,0,0,1,15
1840427,1438463,2024-05-02,Assembly,"AB 2213 Blanca Rubio Consent Calendar Second Day Regular Session",73,0,0,7,80
1840427,1451555,2024-05-29,Senate,"Do pass, but first be re-referred to the Committee on [Appropriations] with the recommendation: To Consent Calendar",7,0,0,0,7
1840427,1457355,2024-06-13,Senate,"Consent Calendar 2nd AB2213 Blanca Rubio",37,0,0,3,40
1840428,1423780,2024-04-09,Assembly,"Do pass and be re-referred to the Committee on [Environmental Safety and Toxic Materials]",12,2,0,1,15
1840428,1435946,2024-04-23,Assembly,"Do pass and be re-referred to the Committee on [Appropriations]",5,1,0,1,7
1840428,1444692,2024-05-16,Assembly,"Do pass",11,3,0,1,15
1840428,1445981,2024-05-21,Assembly,"AB 2214 Bauer-Kahan Assembly Third Reading",61,8,0,11,80
1840428,1456354,2024-06-11,Senate,"Do pass, but first be re-referred to the Committee on [Environmental Quality]",8,2,0,1,11
1840428,1462613,2024-07-03,Senate,"Do pass, but first be re-referred to the Committee on [Appropriations]",5,1,0,1,7
1840428,1465386,2024-08-20,Senate,"Assembly 3rd Reading AB2214 Bauer-Kahan et al. By Glazer",33,6,0,1,40
1840428,1465730,2024-08-26,Assembly,"AB 2214 Bauer-Kahan Concurrence in Senate Amendments",64,7,0,8,79
1840429,1420156,2024-04-02,Assembly,"Do pass",8,0,0,0,8
1840429,1425929,2024-04-11,Assembly,"AB 2215 Bryan Assembly Third Reading",72,0,0,8,80
1840429,1456277,2024-06-11,Senate,"Do pass",4,1,0,0,5
1840429,1465321,2024-08-20,Senate,"Assembly 3rd Reading AB2215 Bryan et al. By Umberg",31,9,0,0,40
1840429,1465496,2024-08-22,Assembly,"AB 2215 Bryan Concurrence in Senate Amendments",56,0,0,23,79
1840430,1423884,2024-04-09,Assembly,"Do pass",9,1,0,2,12
1840430,1449573,2024-05-23,Assembly,"AB 2216 Haney Assembly Third Reading",46,9,0,25,80
1840432,1433058,2024-04-23,Assembly,"Do pass and be re-referred to the Committee on [Appropriations] with recommendation: To Consent Calendar",6,0,0,1,7
1840435,1429993,2024-04-17,Assembly,"Do pass as amended and be re-referred to the Committee on [Communications and Conveyance]",13,0,0,3,16
1840435,1434041,2024-04-24,Assembly,"Do pass and be re-referred to the Committee on [Appropriations]",10,0,0,1,11
1840437,1423808,2024-04-09,Assembly,"Do pass as amended and be re-referred to the Committee on [Judiciary]",18,0,0,0,18
1840437,1428773,2024-04-16,Assembly,"Do pass and be re-referred to the Committee on [Appropriations]",12,0,0,0,12
1840437,1444071,2024-05-16,Assembly,"Do pass as amended",11,0,0,4,15
1840437,1446082,2024-05-21,Assembly,"AB 2223 Aguiar-Curry Assembly Third Reading",73,0,0,7,80
1840437,1459355,2024-06-24,Senate,"Do pass, but first be re-referred to the Committee on [Health]",9,0,0,4,13
1840437,1462584,2024-07-03,Senate,"Do pass, but first be re-referred to the Committee on [Appropriations]",11,0,0,0,11
1840437,1463923,2024-08-12,Senate,"Placed on suspense file",7,0,0,0,7
1840438,1423887,2024-04-09,Assembly,"Do pass and be re-referred to the Committee on [Judiciary]",5,0,0,2,7
1840438,1428837,2024-04-16,Assembly,"Do pass and be re-referred to the Committee on [Appropriations]",10,0,0,2,12
1840438,1444545,2024-05-16,Assembly,"Do pass as amended",11,2,0,2,15
1840438,1449714,2024-05-23,Assembly,"AB 2224 Santiago Assembly Third Reading",71,0,0,9,80
1840438,1458183,2024-06-18,Senate,"Do pass as amended, but first amend, and re-refer to the Committee on [Appropriations]",10,0,0,1,11
1840438,1465385,2024-08-20,Senate,"Assembly 3rd Reading AB2224 Santiago By Durazo",40,0,0,0,40
1840438,1465956,2024-08-27,Assembly,"AB 2224 Santiago Concurrence in Senate Amendments",76,0,0,3,79
1840439,1411353,2024-03-19,Assembly,"Do pass. To Consent Calendar",12,0,0,0,12
1840439,1438427,2024-04-01,Assembly,"AB 2225 Rodriguez Consent Calendar Second Day Regular Session",72,0,0,8,80
1840439,1456310,2024-06-11,Senate,"Do pass and be ordered to the Consent Calendar",11,0,0,0,11
1840439,1465254,2024-08-19,Senate,"Assembly 3rd Reading AB2225 Rodriguez By Lim√≥n",40,0,0,0,40
1840440,1424802,2024-04-10,Assembly,"Do pass and be re-referred to the Committee on [Appropriations]",5,1,0,1,7
1840440,1444022,2024-05-16,Assembly,"Do pass as amended",11,4,0,0,15
1840440,1446091,2024-05-21,Assembly,"AB 2226 Muratsuchi Assembly Third Reading",61,11,0,8,80
1840440,1460531,2024-06-26,Senate,"Do pass, but first be re-referred to the Committee on [Appropriations]",6,1,0,0,7
1840440,1463463,2024-08-05,Senate,"Placed on suspense file",7,0,0,0,7
1840441,1420055,2024-04-03,Assembly,"Do pass and be re-referred to the Committee on [Appropriations]",12,0,0,3,15
1840441,1429927,2024-04-17,Assembly,"Do pass. To Consent Calendar",15,0,0,0,15
1840441,1435226,2024-04-25,Assembly,"AB 2227 Hoover Consent Calendar Second Day Regular Session",75,0,0,5,80
1840441,1454275,2024-06-05,Senate,"Do pass, but first be re-referred to the Committee on [Appropriations] with the recommendation: To Consent Calendar",5,0,0,0,5
1840441,1458822,2024-06-20,Senate,"Consent Calendar 2nd AB2227 Hoover",36,0,0,4,40
1840442,1423851,2024-04-09,Assembly,"Do pass as amended and be re-referred to the Committee on [Judiciary]",18,0,0,0,18
1840442,1433002,2024-04-23,Assembly,"Do pass as amended, and be re-referred to the Committee on [Appropriations] with recommendation: To Consent Calendar",11,0,0,1,12
1840442,1441363,2024-05-08,Assembly,"Do pass. To Consent Calendar",15,0,0,0,15
1840442,1444286,2024-05-16,Assembly,"AB 2228 Villapudua Consent Calendar Second Day Regular Session",71,0,0,9,80
1840443,1421141,2024-04-03,Assembly,"Do pass as amended and be re-referred to the Committee on [Appropriations]",7,0,0,0,7
1840443,1444636,2024-05-16,Assembly,"Do pass",15,0,0,0,15
1840443,1446063,2024-05-21,Assembly,"AB 2229 Wilson Assembly Third Reading",73,0,0,7,80
1840443,1456939,2024-06-12,Senate,"Do pass, but first be re-referred to the Committee on [Appropriations] with the recommendation: To Consent Calendar",7,0,0,0,7
1840443,1459388,2024-06-24,Senate,"Placed on suspense file",6,0,0,1,7
1840443,1464484,2024-08-15,Senate,"Do pass",6,0,0,1,7
1840443,1466612,2024-08-28,Senate,"Assembly 3rd Reading AB2229 Wilson et al. By Rubio",40,0,0,0,40
1840444,1395236,2024-02-26,Assembly,"Be adopted. To Consent Calendar",7,0,0,4,11
1840444,1400017,2024-02-29,Assembly,"ACR 139 Rodriguez Consent Calendar Second Day",73,0,0,7,80
1840444,1413847,2024-03-21,Senate,"Special Consent ACR139 Rodriguez et al",37,0,0,3,40
1840445,1389470,2024-02-20,Assembly,"Be adopted. To third reading",7,0,0,4,11
1840446,1428865,2024-04-16,Senate,"Do pass, but first be re-referred to the Committee on [Public Safety]",11,0,0,0,11
1840446,1433077,2024-04-23,Senate,"Do pass, but first be re-referred to the Committee on [Appropriations] with the recommendation: To Consent Calendar",5,0,0,0,5
1840446,1439617,2024-05-06,Senate,"Placed on suspense file",7,0,0,0,7
1840447,1427323,2024-04-15,Senate,"Do pass, but first be re-referred to the Committee on [Health]",12,0,0,1,13
1840447,1436172,2024-04-29,Senate,"Placed on suspense file",5,0,0,2,7
1840448,1424931,2024-04-10,Senate,"Do pass, but first be re-referred to the Committee on [Business, Professions and Economic Development]",11,0,0,0,11
1840448,1431947,2024-04-22,Senate,"Do pass, but first be re-referred to the Committee on [Appropriations]",11,0,0,2,13
1840448,1439683,2024-05-06,Senate,"Placed on suspense file",7,0,0,0,7
1840448,1444534,2024-05-16,Senate,"Do pass as amended",5,0,0,2,7
1840448,1448761,2024-05-22,Senate,"Senate 3rd Reading SB1042 Roth et al",35,2,0,3,40
1840448,1456312,2024-06-11,Assembly,"Do pass and be re-referred to the Committee on [Business and Professions]",15,1,0,0,16
1840448,1459950,2024-06-25,Assembly,"Do pass and be re-referred to the Committee on [Appropriations]",16,0,0,2,18
1840449,1428789,2024-04-15,Senate,"Do pass, but first be re-referred to the Committee on [Appropriations]",5,0,0,0,5
1840449,1436211,2024-04-29,Senate,"Placed on suspense file",5,0,0,2,7
1840449,1444069,2024-05-16,Senate,"Do pass",7,0,0,0,7
1840449,1449603,2024-05-23,Senate,"Special Consent SB1043 Grove et al",37,0,0,3,40
1840449,1460076,2024-06-25,Assembly,"Do pass as amended and be re-referred to the Committee on [Appropriations]",6,0,0,1,7
1840449,1464103,2024-08-15,Assembly,"Do pass as amended",11,0,0,4,15
1840449,1465773,2024-08-26,Assembly,"SB 1043 Grove Senate Third Reading By Lee",77,0,0,2,79
1840449,1467063,2024-08-28,Senate,"Special Consent SB1043 Grove et al",39,0,0,1,40
1840450,1423774,2024-04-09,Senate,"Do pass, but first be re-referred to the Committee on [Appropriations] with the recommendation: To Consent Calendar",14,0,0,2,16
1840450,1435239,2024-04-25,Senate,"Consent Calendar 2nd SB1044 Seyarto et al",36,0,0,4,40
1840450,1454203,2024-06-05,Assembly,"Do pass and be re-referred to the Committee on [Appropriations] with recommendation: To Consent Calendar",19,0,0,3,22
1840450,1458441,2024-06-19,Assembly,"Do pass. To Consent Calendar",14,0,0,1,15
1840450,1460707,2024-06-26,Assembly,"SB 1044 Seyarto Consent Calendar Second Day Regular Session",75,0,0,4,79
1840451,1430001,2024-04-17,Senate,"Do pass, but first be re-referred to the Committee on [Environmental Quality]",5,2,0,0,7
1840451,1434113,2024-04-24,Senate,"Do pass as amended, but first amend, and re-refer to the Committee on [Appropriations]",5,2,0,0,7
1840451,1442547,2024-05-13,Senate,"Placed on suspense file",7,0,0,0,7
1840451,1444449,2024-05-16,Senate,"Do pass",5,2,0,0,7
1840451,1450360,2024-05-21,Senate,"Senate 3rd Reading SB1045 Blakespear",32,7,0,1,40
1840451,1457940,2024-06-17,Assembly,"Do pass and be re-referred to the Committee on [Local Government]",9,0,0,2,11
1840451,1460738,2024-06-26,Assembly,"Do pass and be re-referred to the Committee on [Appropriations]",6,0,0,3,9
1840452,1412576,2024-03-20,Senate,"Do pass as amended, but first amend, and re-refer to the Committee on [Appropriations] with the recommendation: To Consent Calendar",6,0,0,1,7
1840452,1435202,2024-04-25,Senate,"Consent Calendar 2nd SB1046 Laird",36,0,0,4,40
1840452,1455803,2024-06-10,Assembly,"Do pass as amended, and be re-referred to the Committee on [Appropriations] with recommendation: To Consent Calendar",10,0,0,1,11
1840452,1464550,2024-08-15,Assembly,"Do pass",14,0,0,1,15
1840452,1465458,2024-08-22,Assembly,"SB 1046 Laird Senate Third Reading By Wood",62,0,0,17,79
1840452,1465745,2024-08-26,Senate,"Unfinished Business SB1046 Laird Concurrence",40,0,0,0,40
1840453,1420118,2024-04-02,Senate,"Do pass as amended, but first amend, and re-refer to the Committee on [Governmental Organization]",9,0,0,2,11
1840453,1433107,2024-04-23,Senate,"Do pass, but first be re-referred to the Committee on [Appropriations]",11,0,0,5,16
1840453,1439678,2024-05-06,Senate,"Placed on suspense file",7,0,0,0,7
1840453,1444453,2024-05-16,Senate,"Do pass as amended",5,0,0,2,7
1840453,1450357,2024-05-21,Senate,"Senate 3rd Reading SB1047 Wiener et al",32,1,0,7,40
1840453,1458239,2024-06-18,Assembly,"Do pass as amended and be re-referred to the Committee on [Judiciary]",8,0,0,3,11
1840453,1462291,2024-07-02,Assembly,"Do pass as amended and be re-referred to the Committee on [Appropriations]",9,1,0,2,12
1840453,1464279,2024-08-15,Assembly,"Do pass as amended",11,3,0,1,15
1840453,1466223,2024-08-29,Senate,"Unfinished Business SB1047 Wiener et al. Concurrence",30,9,0,1,40
1840453,1466702,2024-08-28,Assembly,"SB 1047 Wiener Senate Third Reading By Bennett",48,16,0,15,79
1840454,1420072,2024-04-03,Senate,"Do pass, but first be re-referred to the Committee on [Judiciary] with the recommendation: To Consent Calendar",6,0,0,1,7
1840454,1427225,2024-04-15,Senate,"Senate 3rd Reading SB1048 Jones",39,0,0,1,40
1840454,1454192,2024-06-05,Assembly,"Do pass. To Consent Calendar",9,0,0,0,9
1840454,1457302,2024-06-13,Assembly,"SB 1048 Jones Consent Calendar Second Day Regular Session",77,0,0,2,79
1840455,1424990,2024-04-10,Senate,"Do pass, but first be re-referred to the Committee on [Housing]",4,1,0,0,5
1840455,1428766,2024-04-16,Senate,"Do pass, but first be re-referred to the Committee on [Appropriations]",8,2,0,0,10
1840455,1436169,2024-04-29,Senate,"Placed on suspense file",5,0,0,2,7
1840456,1428982,2024-04-16,Senate,"Do pass, but first be re-referred to the Committee on [Appropriations]",8,1,0,2,11
1840456,1442599,2024-05-13,Senate,"Placed on suspense file",7,0,0,0,7
1840456,1444184,2024-05-16,Senate,"Do pass as amended",5,2,0,0,7
1840456,1450293,2024-05-21,Senate,"Senate 3rd Reading SB1050 Bradford et al",32,5,0,3,40
1840456,1450294,2024-05-21,Senate,"Senate 3rd Reading SB1050 Bradford et al. Reconsider",39,0,0,1,40
1840456,1450295,2024-05-21,Senate,"Senate 3rd Reading SB1050 Bradford et al",32,4,0,4,40
1840456,1456400,2024-06-11,Assembly,"Do pass as amended and be re-referred to the Committee on [Appropriations]",11,0,0,1,12
1840456,1464368,2024-08-15,Assembly,"Do pass",12,0,0,3,15
1840456,1466201,2024-08-29,Senate,"Unfinished Business SB1050 Bradford et al. Concurrence",38,0,0,2,40
1840456,1466793,2024-08-28,Assembly,"SB 1050 Bradford Senate Third Reading By McKinnor",72,0,0,7,79
1840457,1434095,2024-04-23,Senate,"Do pass, but first be re-referred to the Committee on [Appropriations]",11,0,0,0,11
1840457,1445133,2024-05-20,Senate,"Senate 3rd Reading SB1051 Eggman",38,0,0,2,40
1840457,1456305,2024-06-11,Assembly,"Do pass. To Consent Calendar",12,0,0,0,12
1840457,1457942,2024-06-17,Assembly,"SB 1051 Eggman Consent Calendar Second Day",72,0,0,7,79
1840458,1439699,2024-05-06,Senate,"Senate 3rd Reading SCR110 Umberg",38,0,0,2,40
1840458,1455791,2024-06-10,Assembly,"Be adopted. To Consent Calendar",9,0,0,2,11
1840458,1457316,2024-06-13,Assembly,"SCR 110 Umberg Consent Calendar Second Day Regular Session",77,0,0,2,79
1840459,1382163,2024-02-12,Senate,"Senate 3rd Reading SR64 Laird",35,0,0,5,40
1840460,1382167,2024-02-12,Senate,"Senate 3rd Reading SR65 Gonzalez",34,1,0,5,40
1841925,1418337,2024-04-01,Assembly,"Do pass and be re-referred to the Committee on [Business and Professions]",7,0,0,2,9
1841925,1428958,2024-04-16,Assembly,"Do pass as amended and be re-referred to the Committee on [Appropriations]",16,0,0,2,18
1841925,1444475,2024-05-16,Assembly,"Do pass as amended",11,1,0,3,15
1841925,1448807,2024-05-22,Assembly,"AB 2231 Gipson Assembly Third Reading",66,0,0,14,80
1841925,1462094,2024-07-01,Senate,"Do pass as amended, but first amend, and re-refer to the Committee on [Appropriations]",11,0,0,2,13
1841925,1463547,2024-08-05,Senate,"Placed on suspense file",7,0,0,0,7
1841925,1464545,2024-08-15,Senate,"Do pass as amended",6,1,0,0,7
1841925,1465546,2024-08-26,Senate,"Assembly 3rd Reading AB2231 Gipson By Roth",35,1,0,4,40
1841925,1465989,2024-08-27,Assembly,"AB 2231 Gipson Concurrence in Senate Amendments",71,0,0,8,79
1841926,1431996,2024-04-22,Assembly,"Do pass. To Consent Calendar",8,0,0,0,8
1841926,1436199,2024-04-29,Assembly,"AB 2232 Maienschein Consent Calendar Second Day",74,0,0,6,80
1841926,1450952,2024-05-28,Senate,"Do pass and be ordered to the Consent Calendar",12,0,0,4,16
1841926,1452969,2024-06-03,Senate,"Consent Calendar 2nd AB2232 Maienschein",36,0,0,4,40
1841927,1432977,2024-04-23,Assembly,"Do pass and be re-referred to the Committee on [Appropriations]",17,0,0,1,18
1841928,1431907,2024-04-22,Assembly,"Do pass and be re-referred to the Committee on [Appropriations]",13,1,0,1,15
1841928,1443475,2024-05-15,Assembly,"Do pass",14,0,0,1,15
1841928,1448637,2024-05-22,Assembly,"AB 2234 Boerner Assembly Third Reading",65,0,0,15,80
1841928,1456368,2024-06-11,Senate,"Do pass as amended, but first amend, and re-refer to the Committee on [Appropriations]",15,0,0,0,15
1841928,1465281,2024-08-19,Senate,"Assembly 3rd Reading AB2234 Boerner et al. By Padilla",40,0,0,0,40
1841928,1465453,2024-08-22,Assembly,"AB 2234 Boerner Concurrence in Senate Amendments",57,0,0,22,79
1841929,1435267,2024-04-24,Assembly,"Do pass as amended and be re-referred to the Committee on [Appropriations]",8,0,0,1,9
1841929,1443494,2024-05-15,Assembly,"Do pass. To Consent Calendar",15,0,0,0,15
1841929,1450015,2024-05-24,Assembly,"AB 2235 Lowenthal Assembly Third Reading",65,0,0,15,80
1841929,1462524,2024-07-03,Senate,"Do pass, but first be re-referred to the Committee on [Appropriations]",6,0,0,1,7
1841929,1466225,2024-08-29,Assembly,"AB 2235 Lowenthal Concurrence in Senate Amendments",76,0,0,3,79
1841929,1466761,2024-08-28,Senate,"Assembly 3rd Reading AB2235 Lowenthal By Gonzalez",38,0,0,2,40
1841930,1411371,2024-03-19,Assembly,"Do pass as amended and be re-referred to the Committee on [Appropriations]",7,2,0,2,11
1841930,1444070,2024-05-16,Assembly,"Do pass as amended",11,4,0,0,15
1841930,1446087,2024-05-21,Assembly,"AB 2236 Bauer-Kahan Assembly Third Reading",51,7,0,22,80
1841930,1462492,2024-07-03,Senate,"Do pass as amended, but first amend, and re-refer to the Committee on [Appropriations]",5,2,0,0,7
1841930,1463596,2024-08-05,Senate,"Placed on suspense file",7,0,0,0,7
1841930,1464093,2024-08-15,Senate,"Do pass",5,2,0,0,7
1841930,1466694,2024-08-28,Senate,"Assembly 3rd Reading AB2236 Bauer-Kahan et al. By Blakespear",31,8,0,1,40
1841931,1423865,2024-04-09,Assembly,"Do pass as amended and be re-referred to the Committee on [Human Services]",16,0,0,0,16
1841931,1443999,2024-05-16,Assembly,"Do pass",15,0,0,0,15
1841931,1446137,2024-05-21,Assembly,"AB 2237 Aguiar-Curry Assembly Third Reading",73,0,0,7,80
1841931,1458464,2024-06-19,Senate,"Do pass, but first be re-referred to the Committee on [Governmental Organization] with the recommendation: To Consent Calendar",11,0,0,0,11
1841931,1460100,2024-06-25,Senate,"Do pass as amended, but first amend, and re-refer to the Committee on [Appropriations]",14,0,0,2,16
1841931,1463357,2024-08-05,Senate,"Placed on suspense file",7,0,0,0,7
1841931,1464148,2024-08-15,Senate,"Do pass",7,0,0,0,7
1841931,1466141,2024-08-29,Assembly,"AB 2237 Aguiar-Curry Concurrence in Senate Amendments",75,0,0,4,79
1841931,1466683,2024-08-28,Senate,"Assembly 3rd Reading AB2237 Aguiar-Curry et al. By Menjivar",39,0,0,1,40
1841932,1419171,2024-04-01,Assembly,"Do pass and be re-referred to the Committee on [Appropriations]",4,2,0,1,7
1841932,1441298,2024-05-08,Assembly,"Do pass",11,4,0,0,15
1841932,1448580,2024-05-22,Assembly,"AB 2238 Low Assembly Third Reading",50,11,0,19,80
1841932,1460659,2024-06-26,Senate,"Do pass, but first be re-referred to the Committee on [Appropriations]",4,0,0,3,7
1841932,1465372,2024-08-20,Senate,"Assembly 3rd Reading AB2238 Low By Blakespear",26,10,0,4,40
1841933,1424989,2024-04-10,Assembly,"Do pass as amended and be re-referred to the Committee on [Judiciary]",7,3,0,1,11
1841933,1432979,2024-04-23,Assembly,"Do pass as amended and be re-referred to the Committee on [Appropriations]",9,2,0,1,12
1841933,1444328,2024-05-16,Assembly,"Do pass",11,4,0,0,15
1841933,1448820,2024-05-22,Assembly,"AB 2239 Bonta Assembly Third Reading",43,10,0,27,80
1841933,1462378,2024-07-02,Senate,"Do pass, but first be re-referred to the Committee on [Judiciary]",11,4,0,3,18
1841933,1462488,2024-07-02,Senate,"Do pass as amended, but first amend, and re-refer to the Committee on [Appropriations]",9,2,0,0,11
1841933,1463373,2024-08-05,Senate,"Placed on suspense file",7,0,0,0,7
1841934,1424797,2024-04-10,Assembly,"Do pass and be re-referred to the Committee on [Appropriations]",7,0,0,2,9
1841934,1444309,2024-05-16,Assembly,"Do pass as amended",11,2,0,2,15
1841934,1446120,2024-05-21,Assembly,"AB 2240 Arambula Assembly Third Reading",59,6,0,15,80
1841934,1460116,2024-06-24,Senate,"Do pass, but first be re-referred to the Committee on [Appropriations]",8,2,0,0,10
1841934,1463858,2024-08-12,Senate,"Placed on suspense file",7,0,0,0,7
1841934,1464327,2024-08-15,Senate,"Do pass",4,3,0,0,7
1841934,1466352,2024-08-29,Senate,"Assembly 3rd Reading AB2240 Arambula et al. By Hurtado",31,8,0,1,40
1841934,1466493,2024-08-30,Assembly,"AB 2240 Arambula Concurrence in Senate Amendments",72,0,0,7,79
1841935,1423925,2024-04-09,Assembly,"Do pass as amended and be re-referred to the Committee on [Appropriations]",6,0,0,1,7
1841937,1430018,2024-04-17,Assembly,"Do pass and be re-referred to the Committee on [Local Government]",9,0,0,0,9
1841937,1435284,2024-04-24,Assembly,"Do pass and be re-referred to the Committee on [Appropriations]",8,0,0,1,9
1841937,1441348,2024-05-08,Assembly,"Do pass. To Consent Calendar",15,0,0,0,15
1841937,1444460,2024-05-16,Assembly,"AB 2243 Wicks Consent Calendar Second Day Regular Session",71,0,0,9,80
1841937,1458495,2024-06-18,Senate,"Do pass as amended, but first amend, and re-refer to the Committee on [Local Government]",8,0,0,2,10
1841937,1462459,2024-07-03,Senate,"Do pass as amended, but first amend, and re-refer to the Committee on [Appropriations]",5,1,0,1,7
1841937,1463883,2024-08-12,Senate,"Placed on suspense file",7,0,0,0,7
1841937,1464074,2024-08-15,Senate,"Do pass",5,1,0,1,7
1841937,1466165,2024-08-29,Senate,"That the measure be returned to Senate Floor for consideration. Ordered to third reading",8,0,0,2,10
1841937,1466725,2024-08-31,Senate,"Assembly 3rd Reading AB2243 Wicks",28,0,0,12,40
1841937,1466726,2024-08-31,Assembly,"AB 2243 Wicks Concurrence in Senate Amendments",69,0,0,10,79
1841938,1424831,2024-04-09,Assembly,"Do pass as amended and be re-referred to the Committee on [Judiciary]",5,2,0,0,7
1841938,1428930,2024-04-16,Assembly,"Do pass as amended and be re-referred to the Committee on [Appropriations]",9,3,0,0,12
1841938,1443931,2024-05-16,Assembly,"Do pass as amended",11,4,0,0,15
1841938,1446014,2024-05-21,Assembly,"AB 2244 Ting Assembly Third Reading",55,16,0,9,80
1841938,1458449,2024-06-19,Senate,"Do pass, but first be re-referred to the Committee on [Judiciary]",6,0,0,1,7
1841938,1460556,2024-06-25,Senate,"Do pass as amended, but first amend, and re-refer to the Committee on [Appropriations]",10,0,0,1,11
1841938,1463677,2024-08-05,Senate,"Placed on suspense file",7,0,0,0,7
1841939,1421170,2024-04-03,Assembly,"Do pass and be re-referred to the Committee on [Appropriations]",5,1,0,1,7
1841939,1444160,2024-05-16,Assembly,"Do pass",11,4,0,0,15
1841939,1445921,2024-05-21,Assembly,"AB 2245 Juan Carrillo Assembly Third Reading",55,4,0,21,80
1841939,1458533,2024-06-19,Senate,"Do pass, but first be re-referred to the Committee on [Appropriations]",4,2,0,1,7
1841939,1462046,2024-07-01,Senate,"Placed on suspense file",7,0,0,0,7
1841939,1464259,2024-08-15,Senate,"Do pass",5,2,0,0,7
1841939,1466298,2024-08-29,Assembly,"AB 2245 Juan Carrillo Concurrence in Senate Amendments",60,11,0,8,79
1841939,1466854,2024-08-28,Senate,"Assembly 3rd Reading AB2245 Juan Carrillo By Cortese",29,9,0,2,40
1841940,1428855,2024-04-16,Assembly,"Do pass and be re-referred to the Committee on [Appropriations] with recommendation: To Consent Calendar",18,0,0,0,18
1841940,1437580,2024-05-01,Assembly,"Do pass. To Consent Calendar",14,0,0,1,15
1841940,1441916,2024-05-09,Assembly,"AB 2246 Ramos Consent Calendar Second Day Regular Session",65,0,0,15,80
1841940,1457980,2024-06-17,Senate,"Do pass, but first be re-referred to the Committee on [Appropriations] with the recommendation: To Consent Calendar",12,0,0,1,13
1841940,1463684,2024-08-05,Senate,"Placed on suspense file",7,0,0,0,7
1841941,1434167,2024-04-24,Assembly,"Do pass as amended and be re-referred to the Committee on [Appropriations]",9,0,0,0,9
1841941,1443909,2024-05-16,Assembly,"Do pass",15,0,0,0,15
1841941,1449634,2024-05-23,Assembly,"AB 2247 Wallis Assembly Third Reading",71,0,0,9,80
1841941,1460090,2024-06-24,Senate,"Do pass, but first be re-referred to the Committee on [Appropriations] with the recommendation: To Consent Calendar",10,0,0,0,10
1841941,1463361,2024-08-05,Senate,"Placed on suspense file",7,0,0,0,7
1841941,1464444,2024-08-15,Senate,"Do pass",6,0,0,1,7
1841941,1466271,2024-08-29,Assembly,"AB 2247 Wallis Concurrence in Senate Amendments",76,0,0,3,79
1841941,1466764,2024-08-28,Senate,"Assembly 3rd Reading AB2247 Wallis By Newman",39,0,0,1,40
1841942,1408220,2024-03-12,Assembly,"Do pass",10,0,0,2,12
1841942,1410559,2024-03-18,Assembly,"AB 2248 Maienschein Assembly Third Reading",73,0,0,7,80
1841942,1452967,2024-06-03,Senate,"Do pass, but first be re-referred to the Committee on [Judiciary]",13,0,0,0,13
1841942,1458309,2024-06-18,Senate,"Do pass as amended, but first amend, and re-refer to the Committee on [Appropriations] with the recommendation: To Consent Calendar",10,0,0,1,11
1841942,1463416,2024-08-05,Senate,"Placed on suspense file",7,0,0,0,7
1841943,1412541,2024-03-20,Assembly,"Do pass as amended and be re-referred to the Committee on [Appropriations]",7,0,0,1,8
1841943,1429971,2024-04-17,Assembly,"Do pass",11,2,0,2,15
1841943,1435360,2024-04-25,Assembly,"AB 2249 Pellerin Assembly Third Reading",61,3,0,16,80
1841943,1453374,2024-06-04,Senate,"Do pass as amended, but first amend, and re-refer to the Committee on [Judiciary]",6,0,0,1,7
1841943,1458180,2024-06-18,Senate,"Do pass as amended, but first amend, and re-refer to the Committee on [Appropriations]",10,0,0,1,11
1841943,1462083,2024-07-01,Senate,"Placed on suspense file",7,0,0,0,7
1841944,1419129,2024-04-02,Assembly,"Do pass and be re-referred to the Committee on [Appropriations]",15,0,0,1,16
1841944,1444054,2024-05-16,Assembly,"Do pass",12,2,0,1,15
1841944,1446052,2024-05-21,Assembly,"AB 2250 Weber Assembly Third Reading",66,0,0,14,80
1841944,1454204,2024-06-05,Senate,"Do pass as amended, but first amend, and re-refer to the Committee on [Appropriations]",9,0,0,2,11
1841944,1458020,2024-06-17,Senate,"Placed on suspense file",7,0,0,0,7
1841944,1464462,2024-08-15,Senate,"Do pass as amended",4,2,0,1,7
1841944,1466606,2024-08-31,Senate,"Assembly 3rd Reading AB2250 Weber et al. By Wiener",33,4,0,3,40
1841944,1466607,2024-08-31,Assembly,"AB 2250 Weber Concurrence in Senate Amendments",64,6,0,9,79
1841945,1412556,2024-03-20,Assembly,"Do pass as amended. To Consent Calendar",7,0,0,0,7
1841945,1422062,2024-04-08,Assembly,"AB 2251 Connolly Consent Calendar Second Day",74,0,0,6,80
1841945,1454181,2024-06-05,Senate,"Do pass and be ordered to the Consent Calendar",7,0,0,0,7
1841945,1465402,2024-08-21,Senate,"Assembly 3rd Reading AB2251 Connolly By Stern",33,0,0,7,40
1841945,1465778,2024-08-26,Assembly,"AB 2251 Connolly Concurrence in Senate Amendments",77,0,0,2,79
1841946,1423730,2024-04-09,Assembly,"Do pass and be re-referred to the Committee on [Appropriations] with recommendation: To Consent Calendar",14,0,0,1,15
1841948,1435235,2024-04-24,Assembly,"Do pass as amended and be re-referred to the Committee on [Appropriations]",7,0,0,0,7
1841948,1444451,2024-05-16,Assembly,"Do pass",15,0,0,0,15
1841948,1445988,2024-05-21,Assembly,"AB 2254 Blanca Rubio Assembly Third Reading",58,1,0,21,80
1841949,1423921,2024-04-09,Assembly,"Do pass and be re-referred to the Committee on [Judiciary]",6,0,0,1,7
1841949,1428797,2024-04-16,Assembly,"Do pass and be re-referred to the Committee on [Appropriations]",12,0,0,0,12
1841950,1434141,2024-04-24,Assembly,"Do pass as amended and be re-referred to the Committee on [Appropriations]",14,0,0,2,16
1841951,1411380,2024-03-19,Assembly,"Do pass as amended and be re-referred to the Committee on [Local Government]",7,1,0,4,12
1841951,1438481,2024-05-01,Assembly,"Do pass",7,2,0,0,9
1841951,1443998,2024-05-16,Assembly,"AB 2257 Wilson Assembly Third Reading",52,12,0,16,80
1841951,1458230,2024-06-18,Senate,"Do pass as amended, but first amend, and re-refer to the Committee on [Local Government]",8,2,0,1,11
1841951,1462477,2024-07-03,Senate,"Do pass as amended",5,2,0,0,7
1841951,1465336,2024-08-20,Senate,"Assembly 3rd Reading AB2257 Wilson By Caballero",29,11,0,0,40
1841951,1465900,2024-08-27,Assembly,"AB 2257 Wilson Concurrence in Senate Amendments",53,17,0,9,79
1841952,1423809,2024-04-09,Assembly,"Do pass and be re-referred to the Committee on [Appropriations]",13,0,0,3,16
1841952,1444515,2024-05-16,Assembly,"Do pass",11,2,0,2,15
1841952,1449544,2024-05-23,Assembly,"AB 2258 Zbur Assembly Third Reading",62,0,0,18,80
1841952,1458537,2024-06-19,Senate,"Do pass as amended, but first amend, and re-refer to the Committee on [Appropriations]",9,0,0,2,11
1841952,1462052,2024-07-01,Senate,"Placed on suspense file",7,0,0,0,7
1841952,1464378,2024-08-15,Senate,"Do pass",4,2,0,1,7
1841952,1466265,2024-08-29,Senate,"Assembly 3rd Reading AB2258 Zbur et al. By Wiener",31,1,0,8,40
1841952,1467083,2024-08-31,Assembly,"AB 2258 Zbur Concurrence in Senate Amendments",66,0,0,13,79
1841953,1411354,2024-03-19,Assembly,"Do pass and be re-referred to the Committee on [Appropriations] with recommendation: To Consent Calendar",13,0,0,2,15
1841953,1444174,2024-05-16,Assembly,"Do pass as amended",11,0,0,4,15
1841953,1446007,2024-05-21,Assembly,"AB 2259 Boerner Assembly Third Reading",73,0,0,7,80
1841953,1456460,2024-06-11,Senate,"Do pass, but first be re-referred to the Committee on [Appropriations] with the recommendation: To Consent Calendar",15,0,0,0,15
1841953,1459389,2024-06-24,Senate,"Placed on suspense file",6,0,0,1,7
1841954,1420170,2024-04-03,Assembly,"Do pass as amended and be re-referred to the Committee on [Appropriations]",12,0,0,3,15
1841954,1437615,2024-05-01,Assembly,"Do pass",14,0,0,1,15
1841954,1441909,2024-05-09,Assembly,"AB 2260 Calderon Assembly Third Reading",65,0,0,15,80
1841955,1422067,2024-04-08,Assembly,"Do pass and be re-referred to the Committee on [Appropriations] with recommendation: To Consent Calendar",15,0,0,0,15
1841955,1434140,2024-04-24,Assembly,"Do pass. To Consent Calendar",14,0,0,1,15
1841955,1438425,2024-05-02,Assembly,"AB 2261 Garcia Consent Calendar Second Day Regular Session",73,0,0,7,80
1841955,1451611,2024-05-28,Senate,"Do pass, but first be re-referred to the Committee on [Appropriations] with the recommendation: To Consent Calendar",12,0,0,3,15
1841955,1457325,2024-06-13,Senate,"Consent Calendar 2nd AB2261 Garcia Urgency Clause",37,0,0,3,40
1841955,1459338,2024-06-24,Assembly,"AB 2261 Garcia Concurrence - Urgency Added",76,0,0,3,79
1841956,1428751,2024-04-16,Assembly,"Do pass and be re-referred to the Committee on [Appropriations] with recommendation: To Consent Calendar",7,0,0,0,7
1841956,1444488,2024-05-16,Assembly,"Do pass as amended",11,0,0,4,15
1841956,1445952,2024-05-21,Assembly,"AB 2262 Reyes Assembly Third Reading",73,0,0,7,80
1841956,1457960,2024-06-17,Senate,"Do pass, but first be re-referred to the Committee on [Local Government]",12,0,0,1,13
1841956,1462491,2024-07-03,Senate,"Do pass, but first be re-referred to the Committee on [Appropriations] with the recommendation: To Consent Calendar",7,0,0,0,7
1841956,1463571,2024-08-05,Senate,"Placed on suspense file",7,0,0,0,7
1841957,1432946,2024-04-23,Assembly,"Do pass and be re-referred to the Committee on [Appropriations]",5,1,0,1,7
1841957,1444690,2024-05-16,Assembly,"Do pass",11,4,0,0,15
1841957,1449564,2024-05-23,Assembly,"AB 2263 Friedman Assembly Third Reading",54,14,0,12,80
1841957,1462261,2024-07-01,Senate,"Do pass, but first be re-referred to the Committee on [Appropriations]",4,0,0,1,5
1841957,1463622,2024-08-05,Senate,"Placed on suspense file",7,0,0,0,7
1841957,1464572,2024-08-15,Senate,"Do pass",5,2,0,0,7
1841957,1466624,2024-08-31,Senate,"Assembly 3rd Reading AB2263 Friedman et al. By Wiener",30,9,0,1,40
1841957,1466625,2024-08-31,Assembly,"AB 2263 Friedman Concurrence in Senate Amendments",51,12,0,16,79
1841959,1428878,2024-04-16,Assembly,"Do pass as amended and be re-referred to the Committee on [Appropriations]",13,1,0,4,18
1841961,1408237,2024-03-12,Assembly,"Do pass and be re-referred to the Committee on [Appropriations] with recommendation: To Consent Calendar",8,0,0,0,8
1841962,1421175,2024-04-03,Assembly,"Do pass",7,0,0,0,7
1841962,1425934,2024-04-11,Assembly,"AB 2268 Muratsuchi Assembly Third Reading",73,0,0,7,80
1841962,1451597,2024-05-29,Senate,"Do pass and be ordered to the Consent Calendar",7,0,0,0,7
1841962,1454828,2024-06-06,Senate,"Consent Calendar 2nd AB2268 Muratsuchi Urgency Clause",32,0,0,8,40
1841962,1457360,2024-06-13,Assembly,"AB 2268 Muratsuchi Concurrence - Urgency Added",75,0,0,4,79
1841963,1419168,2024-04-02,Assembly,"Do pass and be re-referred to the Committee on [Appropriations] with recommendation: To Consent Calendar",18,0,0,0,18
1841963,1430009,2024-04-17,Assembly,"Do pass. To Consent Calendar",15,0,0,0,15
1841963,1435269,2024-04-25,Assembly,"AB 2269 Flora Consent Calendar Second Day Regular Session",75,0,0,5,80
1841964,1423740,2024-04-09,Assembly,"Do pass as amended and be re-referred to the Committee on [Appropriations]",18,0,0,0,18
1841964,1434072,2024-04-24,Assembly,"Do pass. To Consent Calendar",14,0,0,1,15
1841964,1438503,2024-05-02,Assembly,"AB 2270 Maienschein Consent Calendar Second Day Regular Session",73,0,0,7,80
1841964,1452980,2024-06-03,Senate,"Do pass, but first be re-referred to the Committee on [Appropriations]",13,0,0,0,13
1841964,1465396,2024-08-21,Senate,"Assembly 3rd Reading AB2270 Maienschein et al. By Lim√≥n",33,0,0,7,40
1841964,1465562,2024-08-26,Assembly,"AB 2270 Maienschein Concurrence in Senate Amendments",77,0,0,2,79
1841965,1433118,2024-04-23,Assembly,"Do pass and be re-referred to the Committee on [Appropriations]",15,0,0,1,16
1841965,1444323,2024-05-16,Assembly,"Do pass as amended",12,0,0,3,15
1841965,1446105,2024-05-21,Assembly,"AB 2271 Ortega Assembly Third Reading",69,0,0,11,80
1841965,1458520,2024-06-19,Senate,"Do pass as amended, but first amend, and re-refer to the Committee on [Appropriations] with the recommendation: To Consent Calendar",11,0,0,0,11
1841965,1461953,2024-07-01,Senate,"Placed on suspense file",7,0,0,0,7
1841965,1464023,2024-08-15,Senate,"Do pass",7,0,0,0,7
1841965,1466152,2024-08-29,Assembly,"AB 2271 Ortega Concurrence - Urgency Added",71,0,0,8,79
1841965,1466680,2024-08-28,Senate,"Special Consent AB2271 Ortega et al. By Wahab Urgency Clause",39,0,0,1,40
1841967,1412595,2024-03-20,Assembly,"Do pass and be re-referred to the Committee on [Appropriations]",5,2,0,0,7
1841969,1420110,2024-04-02,Assembly,"Do pass and be re-referred to the Committee on [Appropriations] with recommendation: To Consent Calendar",11,0,0,0,11
1841969,1429895,2024-04-17,Assembly,"Do pass. To Consent Calendar",15,0,0,0,15
1841969,1435201,2024-04-25,Assembly,"AB 2275 Mike Fong Consent Calendar Second Day Regular Session",75,0,0,5,80
1841969,1454255,2024-06-05,Senate,"Do pass, but first be re-referred to the Committee on [Appropriations] with the recommendation: To Consent Calendar",7,0,0,0,7
1841969,1458784,2024-06-20,Senate,"Consent Calendar 2nd AB2275 Mike Fong et al",36,0,0,4,40
1841970,1431959,2024-04-22,Assembly,"Do pass and be re-referred to the Committee on [Appropriations] with recommendation: To Consent Calendar",11,0,0,0,11
1841970,1437647,2024-05-01,Assembly,"Do pass. To Consent Calendar",14,0,0,1,15
1841970,1441908,2024-05-09,Assembly,"AB 2276 Wood Consent Calendar Second Day Regular Session",65,0,0,15,80
1841970,1456342,2024-06-11,Senate,"Do pass as amended, but first amend, and re-refer to the Committee on [Appropriations] with the recommendation: To Consent Calendar",11,0,0,0,11
1841970,1465698,2024-08-26,Senate,"Assembly 3rd Reading AB2276 Wood By Dodd",40,0,0,0,40
1841970,1465845,2024-08-27,Assembly,"AB 2276 Wood Concurrence in Senate Amendments",77,0,0,2,79
1841971,1429998,2024-04-16,Assembly,"Do pass and be re-referred to the Committee on [Appropriations] with recommendation: To Consent Calendar",11,0,0,0,11
1841971,1444653,2024-05-16,Assembly,"Do pass",15,0,0,0,15
1841971,1449622,2024-05-23,Assembly,"AB 2277 Wallis Assembly Third Reading",72,0,0,8,80
1841971,1462443,2024-07-03,Senate,"Do pass, but first be re-referred to the Committee on [Appropriations]",6,0,0,1,7
1841971,1463413,2024-08-05,Senate,"Placed on suspense file",7,0,0,0,7
1841971,1464008,2024-08-15,Senate,"Do pass as amended",6,0,0,1,7
1841971,1466470,2024-08-30,Senate,"Assembly 3rd Reading AB2277 Wallis et al. By Wilk",40,0,0,0,40
1841971,1467001,2024-08-31,Assembly,"AB 2277 Wallis Concurrence in Senate Amendments",75,1,0,3,79
1841972,1412602,2024-03-20,Assembly,"Do pass as amended and be re-referred to the Committee on [Appropriations]",9,0,0,0,9
1841972,1424874,2024-04-10,Assembly,"Do pass. To Consent Calendar",14,0,0,1,15
1841972,1430977,2024-04-18,Assembly,"AB 2278 Wendy Carrillo Consent Calendar Second Day Regular Session",72,0,0,8,80
1841972,1456439,2024-06-11,Senate,"Do pass, but first be re-referred to the Committee on [Appropriations]",11,0,0,0,11
1841972,1459360,2024-06-24,Senate,"Placed on suspense file",6,0,0,1,7
1841973,1428772,2024-04-16,Assembly,"Do pass and be re-referred to the Committee on [Appropriations] with recommendation: To Consent Calendar",8,0,0,0,8
1841973,1444620,2024-05-16,Assembly,"Do pass",15,0,0,0,15
1841973,1446009,2024-05-21,Assembly,"AB 2279 Cervantes Assembly Third Reading By RAMOS",73,0,0,7,80
1841973,1458346,2024-06-18,Senate,"Do pass, but first be re-referred to the Committee on [Appropriations] with the recommendation: To Consent Calendar",5,0,0,0,5
1841973,1462025,2024-07-01,Senate,"Placed on suspense file",7,0,0,0,7
1841973,1464474,2024-08-15,Senate,"Do pass as amended",7,0,0,0,7
1841973,1466380,2024-08-30,Senate,"Special Consent AB2279 Cervantes et al. By Lim√≥n",40,0,0,0,40
1841973,1466903,2024-08-31,Assembly,"AB 2279 Cervantes Concurrence in Senate Amendments",77,0,0,2,79
1841974,1408210,2024-03-12,Assembly,"Do pass as amended and be re-referred to the Committee on [Appropriations]",6,0,0,2,8
1841975,1424923,2024-04-09,Assembly,"Do pass and be re-referred to the Committee on [Transportation] with recommendation: To Consent Calendar",8,0,0,0,8
1841975,1431880,2024-04-22,Assembly,"Do pass and be re-referred to the Committee on [Appropriations] with recommendation: To Consent Calendar",15,0,0,0,15
1841975,1444362,2024-05-16,Assembly,"Do pass",15,0,0,0,15
1841975,1446064,2024-05-21,Assembly,"AB 2281 Soria Assembly Third Reading",73,0,0,7,80
1841975,1458276,2024-06-18,Senate,"Do pass, but first be re-referred to the Committee on [Appropriations]",5,0,0,0,5
1841975,1461988,2024-07-01,Senate,"Placed on suspense file",7,0,0,0,7
1841976,1423801,2024-04-09,Assembly,"Do pass and be re-referred to the Committee on [Human Services]",8,0,0,4,12
1841976,1432999,2024-04-23,Assembly,"Do pass and be re-referred to the Committee on [Appropriations]",5,1,0,1,7
1841976,1444452,2024-05-16,Assembly,"Do pass",11,2,0,2,15
1841976,1449599,2024-05-23,Assembly,"AB 2282 McKinnor Assembly Third Reading",56,7,0,17,80
1841977,1436947,2024-04-30,Assembly,"Do pass. To Consent Calendar",12,0,0,0,12
1841977,1445130,2024-05-20,Assembly,"AB 2283 Pacheco Third Reading Urgency",73,0,0,7,80
1841977,1460604,2024-06-25,Senate,"Do pass and be ordered to the Consent Calendar",11,0,0,0,11
1841977,1462640,2024-07-03,Senate,"Consent Calendar 2nd AB2283 Pacheco Urgency Clause",39,0,0,1,40
1841978,1429885,2024-04-17,Assembly,"Do pass as amended",7,0,0,0,7
1841978,1449557,2024-05-23,Assembly,"AB 2284 Grayson Assembly Third Reading",72,0,0,8,80
1841978,1460575,2024-06-26,Senate,"Do pass as amended",5,0,0,0,5
1841978,1465770,2024-08-26,Senate,"Assembly 3rd Reading AB2284 Grayson By Umberg",40,0,0,0,40
1841978,1465976,2024-08-27,Assembly,"AB 2284 Grayson Concurrence in Senate Amendments",77,0,0,2,79
1841979,1411352,2024-03-19,Assembly,"Do pass as amended and be re-referred to the Committee on [Water, Parks, and Wildlife]",11,0,0,0,11
1841979,1423735,2024-04-09,Assembly,"Do pass as amended and be re-referred to the Committee on [Appropriations]",14,0,0,1,15
1841979,1444682,2024-05-16,Assembly,"Do pass",15,0,0,0,15
1841979,1446018,2024-05-21,Assembly,"AB 2285 Rendon Assembly Third Reading",73,0,0,7,80
1841979,1456313,2024-06-11,Senate,"Do pass as amended, but first amend, and re-refer to the Committee on [Appropriations]",9,0,0,2,11
1841979,1459393,2024-06-24,Senate,"Placed on suspense file",6,0,0,1,7
1841980,1427335,2024-04-15,Assembly,"Do pass and be re-referred to the Committee on [Communications and Conveyance]",13,1,0,1,15
1841980,1434085,2024-04-24,Assembly,"Do pass and be re-referred to the Committee on [Appropriations]",10,1,0,0,11
1841980,1443963,2024-05-16,Assembly,"Do pass",13,1,0,1,15
1841980,1445996,2024-05-21,Assembly,"AB 2286 Aguiar-Curry Assembly Third Reading",63,4,0,13,80
1841980,1460640,2024-06-25,Senate,"Do pass, but first be re-referred to the Committee on [Appropriations]",11,1,0,3,15
1841980,1463409,2024-08-05,Senate,"Placed on suspense file",7,0,0,0,7
1841980,1464491,2024-08-15,Senate,"Do pass",6,0,0,1,7
1841980,1466226,2024-08-29,Assembly,"AB 2286 Aguiar-Curry Concurrence in Senate Amendments",70,1,0,8,79
1841980,1466766,2024-08-28,Senate,"Assembly 3rd Reading AB2286 Aguiar-Curry et al. By Gonzalez",32,3,0,5,40
1841981,1411342,2024-03-19,Assembly,"Do pass. To Consent Calendar",12,0,0,0,12
1841981,1438479,2024-04-01,Assembly,"AB 2287 Chen Consent Calendar Second Day Regular Session",72,0,0,8,80
1841981,1456355,2024-06-11,Senate,"Do pass and be ordered to the Consent Calendar",11,0,0,0,11
1841981,1458791,2024-06-20,Senate,"Consent Calendar 2nd AB2287 Chen et al. By Niello",36,0,0,4,40
1841982,1433178,2024-04-23,Assembly,"Do pass and be re-referred to the Committee on [Appropriations]",7,2,0,3,12
1841982,1437581,2024-05-01,Assembly,"Do pass",10,3,0,2,15
1841982,1442552,2024-05-13,Assembly,"AB 2288 Kalra Assembly Third Reading",44,21,0,15,80
1841982,1458515,2024-06-19,Senate,"Do pass, but first be re-referred to the Committee on [Judiciary]",4,1,0,0,5
1841982,1460687,2024-06-25,Senate,"Do pass, but first be re-referred to the Committee on [Appropriations]",11,0,0,0,11
1841982,1460688,2024-06-26,Senate,"Do pass",7,0,0,0,7
1841982,1461232,2024-06-27,Senate,"Assembly 3rd Reading AB2288 Kalra et al. By Umberg Urgency Clause",39,0,0,1,40
1841982,1461233,2024-06-27,Assembly,"AB 2288 KALRA Concurrence - Urgency Added",77,0,0,2,79
1841983,1418400,2024-04-01,Assembly,"Do pass and be re-referred to the Committee on [Military and Veterans Affairs] with recommendation: To Consent Calendar",15,0,0,0,15
1841983,1444645,2024-05-16,Assembly,"Do pass as amended",11,0,0,4,15
1841983,1446028,2024-05-21,Assembly,"AB 2289 Low Assembly Third Reading",73,0,0,7,80
1841983,1456287,2024-06-11,Senate,"Do pass as amended, but first amend, and re-refer to the Committee on [Appropriations] with the recommendation: To Consent Calendar",15,0,0,0,15
1841983,1459364,2024-06-24,Senate,"Placed on suspense file",6,0,0,1,7
1841984,1452976,2024-06-03,Assembly,"Be adopted. To Consent Calendar",6,0,0,5,11
1841984,1454841,2024-06-06,Assembly,"ACR 140 Ramos Consent Calendar Second Day",64,0,0,15,79
1841984,1459412,2024-06-24,Senate,"Assembly 3rd Reading ACR140 Ramos et al. By Gonzalez",38,0,0,2,40
1841984,1463440,2024-08-05,Assembly,"ACR 140 Ramos Concurrence in Senate Amendments",75,0,0,4,79
1841985,1412574,2024-03-19,Senate,"Do pass, but first be re-referred to the Committee on [Judiciary]",2,4,0,4,10
1841985,1412575,2024-03-19,Senate,"[First] hearing set for [03-20-2024]: Failed passage in Committee. Reconsideration granted",10,0,0,0,10
1841986,1430070,2024-04-17,Senate,"Do pass as amended, but first amend, and re-refer to the Committee on [Appropriations]",5,2,0,0,7
1841986,1439694,2024-05-06,Senate,"Placed on suspense file",7,0,0,0,7
1841986,1444471,2024-05-16,Senate,"Do pass as amended",5,2,0,0,7
1841986,1450366,2024-05-21,Senate,"Senate 3rd Reading SB1053 Blakespear et al",31,7,0,2,40
1841986,1461998,2024-07-01,Assembly,"Do pass as amended and be re-referred to the Committee on [Appropriations]",9,3,0,0,12
1841986,1463716,2024-08-07,Assembly,"Do pass",10,3,0,2,15
1841986,1466277,2024-08-29,Assembly,"SB 1053 Blakespear Senate Third Reading By Bauer-Kahan",56,7,0,16,79
1841986,1466566,2024-08-30,Senate,"Unfinished Business SB1053 Blakespear et al. Concurrence",32,8,0,0,40
1841987,1433140,2024-04-22,Senate,"Do pass as amended, but first amend, and re-refer to the Committee on [Appropriations]",16,1,0,1,18
1841987,1442615,2024-05-13,Senate,"Placed on suspense file",7,0,0,0,7
1841987,1444041,2024-05-16,Senate,"Do pass as amended",5,1,0,1,7
1841987,1449567,2024-05-23,Senate,"Senate 3rd Reading SB1054 Rubio",34,0,0,6,40
1841987,1461965,2024-07-01,Assembly,"Do pass and be re-referred to the Committee on [Appropriations] with recommendation: To Consent Calendar",15,0,0,1,16
1841989,1424991,2024-04-10,Senate,"Do pass, but first be re-referred to the Committee on [Appropriations]",6,1,0,0,7
1841989,1431934,2024-04-22,Senate,"Placed on suspense file",7,0,0,0,7
1841990,1432932,2024-04-23,Senate,"Do pass as amended, but first amend, and re-refer to the Committee on [Appropriations]",4,1,0,0,5
1841990,1442568,2024-05-13,Senate,"Placed on suspense file",7,0,0,0,7
1841990,1443899,2024-05-16,Senate,"Do pass as amended",5,2,0,0,7
1841990,1448746,2024-05-22,Senate,"Senate 3rd Reading SB1057 Menjivar et al",26,9,0,5,40
1841990,1462527,2024-07-02,Assembly,"Do pass and be re-referred to the Committee on [Appropriations]",5,2,0,1,8
1841991,1429961,2024-04-17,Senate,"Do pass as amended",5,0,0,0,5
1841991,1445192,2024-05-20,Senate,"Senate 3rd Reading SB1058 Ashby et al",37,0,0,3,40
1841991,1460642,2024-06-26,Assembly,"Do pass",15,0,0,0,15
1841991,1463812,2024-08-08,Assembly,"SB 1058 Ashby Senate Third Reading By Low",70,0,0,9,79
1841991,1464157,2024-08-15,Senate,"Special Consent SB1058 Ashby et al",37,0,0,3,40
1841992,1424780,2024-04-10,Senate,"Do pass, but first be re-referred to the Committee on [Business, Professions and Economic Development]",7,0,0,0,7
1841992,1431860,2024-04-22,Senate,"Do pass as amended, but first amend, and re-refer to the Committee on [Appropriations]",11,0,0,2,13
1841992,1439622,2024-05-06,Senate,"Placed on suspense file",7,0,0,0,7
1841992,1444599,2024-05-16,Senate,"Do pass",6,1,0,0,7
1841992,1448772,2024-05-22,Senate,"Senate 3rd Reading SB1059 Bradford",35,0,0,5,40
1841992,1459998,2024-06-24,Assembly,"Do pass and be re-referred to the Committee on [Business and Professions]",5,0,0,2,7
1841992,1459999,2024-06-25,Assembly,"Do pass and be re-referred to the Committee on [Appropriations]",18,0,0,0,18
1841992,1464477,2024-08-15,Assembly,"Do pass",13,0,0,2,15
1841992,1466119,2024-08-29,Assembly,"SB 1059 Bradford Senate Third Reading By Bonta",75,0,0,4,79
1841993,1434267,2024-04-24,Senate,"Do pass as amended, but first amend, and re-refer to the Committee on [Appropriations]",4,2,0,1,7
1841993,1442559,2024-05-13,Senate,"Placed on suspense file",7,0,0,0,7
1841993,1444524,2024-05-16,Senate,"Do pass as amended",5,2,0,0,7
1841993,1448709,2024-05-22,Senate,"Senate 3rd Reading SB1060 Becker et al",29,8,0,3,40
1841994,1420116,2024-04-02,Senate,"Do pass as amended, but first amend, and re-refer to the Committee on [Rules]",9,2,0,0,11
1841994,1435337,2024-04-24,Senate,"Do pass as amended, but first amend, and re-refer to the Committee on [Appropriations]",9,0,0,2,11
1841994,1439644,2024-05-06,Senate,"Placed on suspense file",7,0,0,0,7
1841994,1444153,2024-05-16,Senate,"Do pass",5,2,0,0,7
1841994,1450336,2024-05-21,Senate,"Senate 3rd Reading SB1061 Lim√≥n",31,8,0,1,40
1841994,1458331,2024-06-18,Assembly,"Do pass as amended and be re-referred to the Committee on [Health]",8,1,0,3,12
1841994,1460032,2024-06-25,Assembly,"Do pass and be re-referred to the Committee on [Banking and Finance]",12,2,0,2,16
1841994,1462113,2024-07-01,Assembly,"Do pass as amended and be re-referred to the Committee on [Appropriations]",7,1,0,1,9
1841994,1464396,2024-08-15,Assembly,"Do pass as amended",11,3,0,1,15
1841994,1465561,2024-08-26,Assembly,"SB 1061 Lim√≥n Senate Third Reading By Friedman",58,9,0,12,79
1841994,1467051,2024-08-28,Senate,"Unfinished Business SB1061 Lim√≥n et al. Concurrence",31,8,0,1,40
1841995,1428900,2024-04-16,Senate,"Do pass, but first be re-referred to the Committee on [Environmental Quality]",17,0,0,1,18
1841995,1434052,2024-04-24,Senate,"Do pass as amended, but first amend, and re-refer to the Committee on [Appropriations]",6,0,0,1,7
1841995,1442602,2024-05-13,Senate,"Placed on suspense file",7,0,0,0,7
1841995,1444418,2024-05-16,Senate,"Do pass",7,0,0,0,7
1841995,1448740,2024-05-22,Senate,"Senate 3rd Reading SB1062 Dahle",38,0,0,2,40
1841995,1458524,2024-06-19,Assembly,"Do pass as amended and be re-referred to the Committee on [Natural Resources]",13,0,0,3,16
1841995,1462111,2024-07-01,Assembly,"Do pass as amended and be re-referred to the Committee on [Appropriations]",8,0,0,4,12
1841996,1424960,2024-04-10,Senate,"Do pass as amended",7,0,0,0,7
1841996,1431016,2024-04-18,Senate,"Special Consent SB1063 Grove",39,0,0,1,40
1841996,1460524,2024-06-26,Assembly,"Do pass as amended. To Consent Calendar",7,0,0,0,7
1841996,1463696,2024-08-05,Assembly,"SB 1063 Grove Consent Calendar Second Day Regular Session",71,0,0,8,79
1841996,1464244,2024-08-15,Senate,"Special Consent SB1063 Grove",37,0,0,3,40
1841997,1431869,2024-04-22,Senate,"Do pass, but first be re-referred to the Committee on [Appropriations]",11,0,0,2,13
1841997,1439719,2024-05-06,Senate,"Placed on suspense file",7,0,0,0,7
1841997,1444618,2024-05-16,Senate,"Do pass as amended",7,0,0,0,7
1841997,1448814,2024-05-22,Senate,"Senate 3rd Reading SB1064 Laird",35,0,0,5,40
1841997,1459992,2024-06-25,Assembly,"Do pass and be re-referred to the Committee on [Appropriations]",18,0,0,0,18
1841997,1464570,2024-08-15,Assembly,"Do pass as amended",11,0,0,4,15
1841997,1465609,2024-08-26,Assembly,"SB 1064 Laird Senate Third Reading By Berman",73,0,0,6,79
1841997,1466969,2024-08-28,Senate,"Unfinished Business SB1064 Laird Concurrence",37,1,0,2,40
1845057,1422053,2024-04-08,Assembly,"Do pass and be re-referred to the Committee on [Appropriations]",11,4,0,0,15
1845057,1443905,2024-05-16,Assembly,"Do pass",11,4,0,0,15
1845057,1449561,2024-05-23,Assembly,"AB 2290 Friedman Assembly Third Reading",57,14,0,9,80
1845057,1456374,2024-06-11,Senate,"Do pass as amended, but first amend, and re-refer to the Committee on [Appropriations]",11,4,0,0,15
1845057,1459435,2024-06-24,Senate,"Placed on suspense file",6,0,0,1,7
1845058,1434120,2024-04-24,Assembly,"Do pass as amended and be re-referred to the Committee on [Appropriations]",9,0,0,0,9
1845058,1443464,2024-05-15,Assembly,"Do pass. To Consent Calendar",15,0,0,0,15
1845058,1446112,2024-05-21,Assembly,"AB 2291 Alanis Consent Calendar Second Day Regular Session",71,0,0,9,80
1845059,1420084,2024-04-03,Assembly,"Do pass and be re-referred to the Committee on [Appropriations]",14,0,0,2,16
1845059,1437634,2024-05-01,Assembly,"Do pass",11,0,0,4,15
1845059,1449727,2024-05-23,Assembly,"AB 2292 Petrie-Norris Assembly Third Reading",65,0,0,15,80
1845059,1459370,2024-06-24,Senate,"Do pass, but first be re-referred to the Committee on [Appropriations]",13,0,0,5,18
1845059,1467237,2024-08-28,Senate,"Assembly 3rd Reading AB2292 Petrie-Norris By Padilla",30,7,0,3,40
1845060,1438474,2024-05-01,Assembly,"Do pass as amended. To Consent Calendar",9,0,0,0,9
1845060,1443483,2024-05-15,Assembly,"Do pass. To Consent Calendar",15,0,0,0,15
1845060,1445959,2024-05-21,Assembly,"AB 2293 Mathis Consent Calendar Second Day Regular Session",71,0,0,9,80
1845060,1462532,2024-07-03,Senate,"Do pass as amended, but first amend, and re-refer to the Committee on [Appropriations]",7,0,0,0,7
1845060,1466174,2024-08-29,Assembly,"AB 2293 Mathis Concurrence in Senate Amendments",76,0,0,3,79
1845060,1467217,2024-08-28,Senate,"Assembly 3rd Reading AB2293 Mathis By Durazo",40,0,0,0,40
1845062,1433041,2024-04-23,Assembly,"Do pass as amended and be re-referred to the Committee on [Appropriations]",8,0,0,0,8
1845062,1443917,2024-05-16,Assembly,"Do pass",15,0,0,0,15
1845062,1445942,2024-05-21,Assembly,"AB 2295 Addis Assembly Third Reading",73,0,0,7,80
1845062,1456322,2024-06-11,Senate,"Do pass, but first be re-referred to the Committee on [Appropriations]",5,0,0,0,5
1845062,1459375,2024-06-24,Senate,"Placed on suspense file",6,0,0,1,7
1845062,1464206,2024-08-15,Senate,"Do pass as amended",7,0,0,0,7
1845062,1466370,2024-08-29,Assembly,"AB 2295 Addis Concurrence in Senate Amendments",76,0,0,3,79
1845062,1466874,2024-08-28,Senate,"Assembly 3rd Reading AB2295 Addis et al. By Min",39,0,0,1,40
1845064,1423863,2024-04-09,Assembly,"Do pass as amended and be re-referred to the Committee on [Judiciary]",13,2,0,1,16
1845064,1433031,2024-04-23,Assembly,"Do pass and be re-referred to the Committee on [Appropriations]",9,2,0,1,12
1845064,1441393,2024-05-08,Assembly,"Do pass",11,2,0,2,15
1845064,1445172,2024-05-20,Assembly,"AB 2297 Friedman Assembly Third Reading",56,6,0,18,80
1845064,1456912,2024-06-12,Senate,"Do pass as amended, but first amend, and re-refer to the Committee on [Judiciary]",7,2,0,2,11
1845064,1460528,2024-06-25,Senate,"Do pass, but first be re-referred to the Committee on [Appropriations]",9,2,0,0,11
1845064,1466162,2024-08-29,Assembly,"AB 2297 Friedman Concurrence in Senate Amendments",60,0,0,19,79
1845064,1466747,2024-08-28,Senate,"Assembly 3rd Reading AB2297 Friedman et al. By Lim√≥n",31,7,0,2,40
1845065,1411372,2024-03-19,Assembly,"Do pass as amended and be re-referred to the Committee on [Natural Resources]",13,0,0,2,15
1845065,1423931,2024-04-08,Assembly,"Do pass and be re-referred to the Committee on [Appropriations] with recommendation: To Consent Calendar",10,0,0,1,11
1845065,1444057,2024-05-16,Assembly,"Do pass as amended",11,0,0,4,15
1845065,1448571,2024-05-22,Assembly,"AB 2298 Hart Assembly Third Reading",70,0,0,10,80
1845065,1456317,2024-06-11,Senate,"Do pass, but first be re-referred to the Committee on [Environmental Quality]",11,0,0,0,11
1845065,1462589,2024-07-03,Senate,"Do pass as amended, but first amend, and re-refer to the Committee on [Appropriations]",7,0,0,0,7
1845065,1463482,2024-08-05,Senate,"Placed on suspense file",7,0,0,0,7
1845066,1431023,2024-04-17,Assembly,"Do pass and be re-referred to the Committee on [Appropriations] with recommendation: To Consent Calendar",7,0,0,0,7
1845066,1441345,2024-05-08,Assembly,"Do pass. To Consent Calendar",15,0,0,0,15
1845066,1444512,2024-05-16,Assembly,"AB 2299 Flora Consent Calendar Second Day Regular Session",71,0,0,9,80
1845066,1454197,2024-06-05,Senate,"Do pass, but first be re-referred to the Committee on [Appropriations] with the recommendation: To Consent Calendar",5,0,0,0,5
1845066,1458801,2024-06-20,Senate,"Consent Calendar 2nd AB2299 Flora",36,0,0,4,40
1845067,1419114,2024-04-02,Assembly,"Do pass and be re-referred to the Committee on [Environmental Safety and Toxic Materials]",10,1,0,5,16
1845067,1435938,2024-04-23,Assembly,"Do pass",5,1,0,1,7
1845067,1445233,2024-05-20,Assembly,"AB 2300 Wilson Assembly Third Reading Amendment Set #1",55,11,0,14,80
1845067,1448619,2024-05-22,Assembly,"AB 2300 Wilson Assembly Third Reading",58,1,0,21,80
1845067,1460572,2024-06-26,Senate,"Do pass as amended, but first amend, and re-refer to the Committee on [Environmental Quality]",11,0,0,0,11
1845067,1462650,2024-07-03,Senate,"Do pass",7,0,0,0,7
1845067,1465705,2024-08-26,Senate,"Assembly 3rd Reading AB2300 Wilson et al. By Min",40,0,0,0,40
1845067,1465981,2024-08-27,Assembly,"AB 2300 Wilson Concurrence in Senate Amendments",74,0,0,5,79
1845068,1420203,2024-04-03,Assembly,"Do pass. To Consent Calendar",7,0,0,0,7
1845068,1427354,2024-04-15,Assembly,"AB 2301 Stephanie Nguyen Third Reading Urgency",75,0,0,5,80
1845068,1454220,2024-06-05,Senate,"Do pass and be ordered to the Consent Calendar",5,0,0,0,5
1845068,1457338,2024-06-13,Senate,"Consent Calendar 2nd AB2301 Stephanie Nguyen et Urgency Clause",37,0,0,3,40
1845069,1425887,2024-04-10,Assembly,"Do pass",9,0,0,0,9
1845069,1441905,2024-05-09,Assembly,"AB 2302 Addis Assembly Third Reading",63,0,0,17,80
1845069,1454187,2024-06-05,Senate,"Do pass",7,0,0,0,7
1845069,1465291,2024-08-19,Senate,"Assembly 3rd Reading AB2302 Addis et al. By Laird",40,0,0,0,40
1845071,1411336,2024-03-19,Assembly,"Do pass and be re-referred to the Committee on [Appropriations]",6,2,0,4,12
1845071,1423846,2024-04-09,Assembly,"Do pass and be re-referred to the Committee on [Appropriations]",7,2,0,3,12
1845071,1444463,2024-05-16,Assembly,"Do pass",10,4,0,1,15
1845071,1450036,2024-05-24,Assembly,"AB 2304 Lee Assembly Third Reading",51,13,0,16,80
1845071,1460526,2024-06-25,Senate,"Do pass, but first be re-referred to the Committee on [Appropriations]",9,2,0,0,11
1845071,1465361,2024-08-20,Senate,"Assembly 3rd Reading AB2304 Lee By Roth",31,9,0,0,40
1845072,1420164,2024-04-02,Assembly,"Do pass and be re-referred to the Committee on [Appropriations] with recommendation: To Consent Calendar",11,0,0,0,11
1845072,1429917,2024-04-17,Assembly,"Do pass. To Consent Calendar",15,0,0,0,15
1845072,1435285,2024-04-25,Assembly,"AB 2305 Mike Fong Consent Calendar Second Day Regular Session",75,0,0,5,80
1845073,1411341,2024-03-19,Assembly,"Do pass as amended, and be re-referred to the Committee on [Military and Veterans Affairs] with recommendation: To Consent Calendar",12,0,0,0,12
1845073,1433091,2024-04-23,Assembly,"Do pass and be re-referred to the Committee on [Appropriations]",9,0,0,1,10
1845074,1411373,2024-03-19,Assembly,"Do pass and be re-referred to the Committee on [Appropriations] with recommendation: To Consent Calendar",8,0,0,0,8
1845075,1428849,2024-04-16,Assembly,"Do pass as amended and be re-referred to the Committee on [Appropriations]",8,0,0,0,8
1845075,1444125,2024-05-16,Assembly,"Do pass",15,0,0,0,15
1845075,1449623,2024-05-23,Assembly,"AB 2308 Davies Assembly Third Reading",67,0,0,13,80
1845075,1460024,2024-06-25,Senate,"Do pass, but first be re-referred to the Committee on [Appropriations]",5,0,0,0,5
1845075,1463683,2024-08-05,Senate,"Placed on suspense file",7,0,0,0,7
1845075,1464034,2024-08-15,Senate,"Do pass as amended",7,0,0,0,7
1845075,1466085,2024-08-29,Senate,"Assembly 3rd Reading AB2308 Davies et al. By Ochoa Bogh",40,0,0,0,40
1845075,1466496,2024-08-30,Assembly,"AB 2308 Davies Concurrence in Senate Amendments",77,0,0,2,79
1845076,1433092,2024-04-23,Assembly,"Do pass",7,0,0,1,8
1845076,1442624,2024-05-13,Assembly,"AB 2309 Muratsuchi Assembly Third Reading",50,6,0,24,80
1845076,1462229,2024-07-02,Senate,"Do pass as amended, but first amend, and re-refer to the Committee on [Local Government]",4,0,0,1,5
1845076,1463374,2024-08-05,Senate,"Placed on suspense file",7,0,0,0,7
1845077,1428884,2024-04-16,Assembly,"Do pass and be re-referred to the Committee on [Appropriations] with recommendation: To Consent Calendar",8,0,0,0,8
1845077,1443984,2024-05-16,Assembly,"Do pass as amended",11,0,0,4,15
1845077,1446084,2024-05-21,Assembly,"AB 2310 Hart Assembly Third Reading",73,0,0,7,80
1845077,1458338,2024-06-18,Senate,"Do pass, but first be re-referred to the Committee on [Appropriations] with the recommendation: To Consent Calendar",5,0,0,0,5
1845077,1461996,2024-07-01,Senate,"Placed on suspense file",7,0,0,0,7
1845077,1464430,2024-08-15,Senate,"Do pass as amended",7,0,0,0,7
1845077,1466553,2024-08-30,Senate,"Special Consent AB2310 Hart By Caballero",40,0,0,0,40
1845077,1467197,2024-08-31,Assembly,"AB 2310 Hart Concurrence in Senate Amendments",77,0,0,2,79
1845078,1411321,2024-03-19,Assembly,"Do pass and be re-referred to the Committee on [Appropriations] with recommendation: To Consent Calendar",11,0,0,0,11
1845078,1444539,2024-05-16,Assembly,"Do pass",15,0,0,0,15
1845078,1446117,2024-05-21,Assembly,"AB 2311 Bennett Assembly Third Reading",72,0,0,8,80
1845078,1458545,2024-06-19,Senate,"Do pass, but first be re-referred to the Committee on [Appropriations] with the recommendation: To Consent Calendar",7,0,0,0,7
1845078,1462099,2024-07-01,Senate,"Placed on suspense file",7,0,0,0,7
1845079,1436909,2024-04-29,Assembly,"Do pass as amended and be re-referred to the Committee on [Appropriations]",7,0,0,0,7
1845080,1424897,2024-04-10,Assembly,"Do pass and be re-referred to the Committee on [Appropriations]",9,1,0,0,10
1845080,1444469,2024-05-16,Assembly,"Do pass",11,4,0,0,15
1845080,1446050,2024-05-21,Assembly,"AB 2313 Bennett Assembly Third Reading",60,7,0,13,80
1845080,1458164,2024-06-18,Senate,"Do pass, but first be re-referred to the Committee on [Appropriations]",4,0,0,1,5
1845080,1462044,2024-07-01,Senate,"Placed on suspense file",7,0,0,0,7
1845080,1464424,2024-08-15,Senate,"Do pass as amended",5,2,0,0,7
1845080,1466313,2024-08-29,Senate,"Assembly 3rd Reading AB2313 Bennett et al. By Becker",33,7,0,0,40
1845080,1466417,2024-08-30,Assembly,"AB 2313 Bennett Concurrence in Senate Amendments",64,3,0,12,79
1845083,1421183,2024-04-03,Assembly,"Do pass as amended and be re-referred to the Committee on [Environmental Safety and Toxic Materials]",6,0,0,1,7
1845083,1435950,2024-04-23,Assembly,"Do pass and be re-referred to the Committee on [Appropriations]",5,1,0,1,7
1845083,1444609,2024-05-16,Assembly,"Do pass",12,3,0,0,15
1845083,1445936,2024-05-21,Assembly,"AB 2316 Gabriel Assembly Third Reading",59,0,0,21,80
1845083,1460603,2024-06-26,Senate,"Do pass as amended, but first amend, and re-refer to the Committee on [Health]",7,0,0,0,7
1845083,1462639,2024-07-03,Senate,"Do pass as amended, but first amend, and re-refer to the Committee on [Appropriations]",8,0,0,3,11
1845083,1463434,2024-08-05,Senate,"Placed on suspense file",7,0,0,0,7
1845083,1464112,2024-08-15,Senate,"Do pass as amended",5,0,0,2,7
1845083,1466312,2024-08-29,Assembly,"AB 2316 Gabriel Concurrence in Senate Amendments",70,0,0,9,79
1845083,1466812,2024-08-28,Senate,"Assembly 3rd Reading AB2316 Gabriel et al. By Lim√≥n",36,0,0,4,40
1845084,1419115,2024-04-02,Assembly,"Do pass and be re-referred to the Committee on [Education] with recommendation: To Consent Calendar",7,0,0,0,7
1845084,1424917,2024-04-10,Assembly,"Do pass and be re-referred to the Committee on [Appropriations] with recommendation: To Consent Calendar",7,0,0,0,7
1845084,1444679,2024-05-16,Assembly,"Do pass",15,0,0,0,15
1845084,1446019,2024-05-21,Assembly,"AB 2317 Stephanie Nguyen Assembly Third Reading",73,0,0,7,80
1845084,1458349,2024-06-17,Senate,"Do pass, but first be re-referred to the Committee on [Education]",5,0,0,0,5
1845084,1462674,2024-07-03,Senate,"Do pass, but first be re-referred to the Committee on [Appropriations] with the recommendation: To Consent Calendar",7,0,0,0,7
1845084,1463625,2024-08-05,Senate,"Placed on suspense file",7,0,0,0,7
1845084,1464232,2024-08-15,Senate,"Do pass",7,0,0,0,7
1845084,1466495,2024-08-30,Senate,"Assembly 3rd Reading AB2317 Stephanie Nguyen et By Menjivar",40,0,0,0,40
1845084,1467064,2024-08-31,Assembly,"AB 2317 Stephanie Nguyen Concurrence in Senate Amendments",77,0,0,2,79
1845085,1411385,2024-03-19,Assembly,"Do pass and be re-referred to the Committee on [Appropriations] with recommendation: To Consent Calendar",7,0,0,0,7
1845085,1444594,2024-05-16,Assembly,"Do pass",15,0,0,0,15
1845085,1446097,2024-05-21,Assembly,"AB 2318 Papan Assembly Third Reading",72,0,0,8,80
1845085,1462496,2024-07-03,Senate,"Do pass, but first be re-referred to the Committee on [Appropriations] with the recommendation: To Consent Calendar",7,0,0,0,7
1845085,1465658,2024-08-26,Senate,"Assembly 3rd Reading AB2318 Papan By Allen",40,0,0,0,40
1845085,1465886,2024-08-27,Assembly,"AB 2318 Papan Concurrence in Senate Amendments",77,0,0,2,79
1845086,1419131,2024-04-02,Assembly,"Do pass and be re-referred to the Committee on [Appropriations]",12,2,0,2,16
1845086,1444171,2024-05-16,Assembly,"Do pass as amended",11,4,0,0,15
1845086,1450026,2024-05-24,Assembly,"AB 2319 Wilson Assembly Third Reading",56,5,0,19,80
1845086,1460627,2024-06-26,Senate,"Do pass as amended, but first amend, and re-refer to the Committee on [Judiciary]",9,2,0,0,11
1845086,1462511,2024-07-02,Senate,"Do pass, but first be re-referred to the Committee on [Appropriations]",10,1,0,0,11
1845086,1463607,2024-08-05,Senate,"Placed on suspense file",7,0,0,0,7
1845086,1464027,2024-08-15,Senate,"Do pass as amended",4,2,0,1,7
1845086,1466353,2024-08-29,Assembly,"AB 2319 Wilson Concurrence in Senate Amendments",62,9,0,8,79
1845086,1466879,2024-08-28,Senate,"Assembly 3rd Reading AB2319 Wilson et al. By Smallwood-Cuevas",32,6,0,2,40
1845087,1423817,2024-04-09,Assembly,"Do pass as amended and be re-referred to the Committee on [Natural Resources]",12,2,0,1,15
1845087,1432001,2024-04-22,Assembly,"Do pass as amended and be re-referred to the Committee on [Appropriations]",10,0,0,1,11
1845087,1444655,2024-05-16,Assembly,"Do pass as amended",12,1,0,2,15
1845087,1446085,2024-05-21,Assembly,"AB 2320 Irwin Assembly Third Reading",64,2,0,14,80
1845087,1457947,2024-06-17,Senate,"Do pass as amended, but first amend, and re-refer to the Committee on [Appropriations]",8,0,0,3,11
1845087,1462072,2024-07-01,Senate,"Placed on suspense file",7,0,0,0,7
1845088,1411358,2024-03-19,Assembly,"Do pass and be re-referred to the Committee on [Appropriations] with recommendation: To Consent Calendar",8,0,0,0,8
1845089,1420065,2024-04-03,Assembly,"Do pass and be re-referred to the Committee on [Appropriations] with recommendation: To Consent Calendar",21,0,0,1,22
1845089,1444053,2024-05-16,Assembly,"Do pass as amended",11,0,0,4,15
1845089,1448828,2024-05-22,Assembly,"AB 2322 Hart Assembly Third Reading",70,0,0,10,80
1845089,1460029,2024-06-25,Senate,"Do pass, but first be re-referred to the Committee on [Appropriations] with the recommendation: To Consent Calendar",14,0,0,2,16
1845089,1463348,2024-08-05,Senate,"Placed on suspense file",7,0,0,0,7
1845090,1431924,2024-04-22,Assembly,"Do pass and be re-referred to the Committee on [Appropriations]",7,0,0,4,11
1845090,1444443,2024-05-16,Assembly,"Do pass as amended",11,0,0,4,15
1845090,1448823,2024-05-22,Assembly,"AB 2323 Pacheco Assembly Third Reading",68,0,0,12,80
1845091,1434227,2024-04-24,Assembly,"Do pass and be re-referred to the Committee on [Appropriations] with recommendation: To Consent Calendar",9,0,0,1,10
1845091,1444256,2024-05-16,Assembly,"Do pass. To Consent Calendar",15,0,0,0,15
1845091,1448822,2024-05-22,Assembly,"AB 2324 Alanis Consent Calendar Second Day Regular Session",69,0,0,11,80
1845091,1462231,2024-07-02,Senate,"Do pass, but first be re-referred to the Committee on [Appropriations] with the recommendation: To Consent Calendar",4,0,0,1,5
1845091,1463882,2024-08-12,Senate,"Consent Calendar 2nd AB2324 Alanis",38,0,0,2,40
1845092,1438484,2024-05-01,Assembly,"Do pass. To Consent Calendar",9,0,0,0,9
1845092,1441930,2024-05-09,Assembly,"AB 2325 Lee Consent Calendar Second Day Regular Session",65,0,0,15,80
1845092,1456387,2024-06-11,Senate,"Do pass and be ordered to the Consent Calendar",15,0,0,0,15
1845092,1458795,2024-06-20,Senate,"Consent Calendar 2nd AB2325 Lee",36,0,0,4,40
1845092,1459327,2024-06-24,Assembly,"AB 2325 Lee Concurrence in Senate Amendments",74,0,0,5,79
1845093,1429922,2024-04-16,Assembly,"Do pass as amended and be re-referred to the Committee on [Appropriations]",11,0,0,0,11
1845093,1444208,2024-05-16,Assembly,"Do pass",15,0,0,0,15
1845093,1446116,2024-05-21,Assembly,"AB 2326 Alvarez Assembly Third Reading",72,0,0,8,80
1845093,1456933,2024-06-12,Senate,"Do pass, but first be re-referred to the Committee on [Judiciary] with the recommendation: To Consent Calendar",7,0,0,0,7
1845093,1458264,2024-06-18,Senate,"Do pass, but first be re-referred to the Committee on [Appropriations]",10,0,0,1,11
1845093,1463420,2024-08-05,Senate,"Placed on suspense file",7,0,0,0,7
1845093,1464024,2024-08-15,Senate,"Do pass as amended",7,0,0,0,7
1845093,1465948,2024-08-27,Senate,"Assembly 3rd Reading AB2326 Alvarez et al. By Dodd",40,0,0,0,40
1845093,1466709,2024-08-28,Assembly,"AB 2326 Alvarez Concurrence in Senate Amendments",77,0,0,2,79
1845094,1419159,2024-04-02,Assembly,"Do pass as amended and be re-referred to the Committee on [Appropriations]",18,0,0,0,18
1845094,1430054,2024-04-17,Assembly,"Do pass. To Consent Calendar",15,0,0,0,15
1845094,1435368,2024-04-25,Assembly,"AB 2327 Wendy Carrillo Consent Calendar Second Day Regular Session",75,0,0,5,80
1845094,1462108,2024-07-01,Senate,"Do pass as amended, but first amend, and re-refer to the Committee on [Appropriations]",13,0,0,0,13
1845094,1465621,2024-08-26,Senate,"Assembly 3rd Reading AB2327 Wendy Carrillo et al By Allen",39,0,0,1,40
1845094,1465878,2024-08-27,Assembly,"AB 2327 Wendy Carrillo Concurrence in Senate Amendments",77,0,0,2,79
1845095,1420165,2024-04-03,Assembly,"Do pass and be re-referred to the Committee on [Higher Education]",5,0,0,2,7
1845096,1429911,2024-04-17,Assembly,"Do pass and be re-referred to the Committee on [Natural Resources]",13,0,0,3,16
1845096,1431989,2024-04-22,Assembly,"Do pass and be re-referred to the Committee on [Appropriations]",10,0,0,1,11
1845097,1433070,2024-04-23,Assembly,"Do pass as amended and be re-referred to the Committee on [Appropriations]",13,0,0,2,15
1845097,1444006,2024-05-16,Assembly,"Do pass as amended",11,0,0,4,15
1845097,1445975,2024-05-21,Assembly,"AB 2330 Holden Assembly Third Reading",73,0,0,7,80
1845097,1459938,2024-06-25,Senate,"Do pass as amended, but first amend, and re-refer to the Committee on [Appropriations]",11,0,0,0,11
1845097,1463493,2024-08-05,Senate,"Placed on suspense file",7,0,0,0,7
1845097,1464598,2024-08-15,Senate,"Do pass",7,0,0,0,7
1845097,1466208,2024-08-29,Assembly,"AB 2330 Holden Concurrence in Senate Amendments",76,0,0,3,79
1845097,1467211,2024-08-28,Senate,"Special Consent AB2330 Holden et al. By Rubio",39,0,0,1,40
1845098,1427266,2024-04-15,Assembly,"Do pass and be re-referred to the Committee on [Appropriations]",10,0,0,1,11
1845098,1434203,2024-04-24,Assembly,"Do pass",14,0,0,1,15
1845098,1442533,2024-05-13,Assembly,"AB 2331 Gabriel Assembly Third Reading",67,1,0,12,80
1845098,1458539,2024-06-19,Senate,"Do pass as amended, but first amend, and re-refer to the Committee on [Judiciary] with the recommendation: To Consent Calendar",7,0,0,0,7
1845098,1462494,2024-07-02,Senate,"Do pass, but first be re-referred to the Committee on [Appropriations]",11,0,0,0,11
1845098,1463585,2024-08-05,Senate,"Placed on suspense file",7,0,0,0,7
1845098,1464608,2024-08-15,Senate,"Do pass as amended",7,0,0,0,7
1845098,1466820,2024-08-28,Senate,"Assembly 3rd Reading AB2331 Gabriel By Allen",39,0,0,1,40
1845099,1428906,2024-04-16,Assembly,"Do pass and be re-referred to the Committee on [Appropriations] with recommendation: To Consent Calendar",8,0,0,0,8
1845100,1418340,2024-04-01,Assembly,"Do pass and be re-referred to the Committee on [Appropriations] with recommendation: To Consent Calendar",15,0,0,0,15
1845100,1444640,2024-05-16,Assembly,"Do pass",15,0,0,0,15
1845100,1446083,2024-05-21,Assembly,"AB 2333 Santiago Assembly Third Reading",69,0,0,11,80
1845100,1456378,2024-06-11,Senate,"Do pass as amended, but first amend, and re-refer to the Committee on [Appropriations] with the recommendation: To Consent Calendar",15,0,0,0,15
1845100,1459395,2024-06-24,Senate,"Placed on suspense file",6,0,0,1,7
1845102,1430068,2024-04-17,Assembly,"Do pass and be re-referred to the Committee on [Appropriations]",5,0,0,2,7
1845102,1444334,2024-05-16,Assembly,"Do pass as amended",11,1,0,3,15
1845102,1446043,2024-05-21,Assembly,"AB 2335 McKinnor Assembly Third Reading",65,1,0,14,80
1845102,1460447,2024-06-26,Senate,"Do pass, but first be re-referred to the Committee on [Appropriations]",5,0,0,0,5
1845102,1463365,2024-08-05,Senate,"Placed on suspense file",7,0,0,0,7
1845102,1464233,2024-08-15,Senate,"Do pass",5,2,0,0,7
1845102,1465617,2024-08-26,Senate,"Assembly 3rd Reading AB2335 McKinnor et al. By Cortese",32,7,0,1,40
1845103,1411344,2024-03-19,Assembly,"Do pass as amended and be re-referred to the Committee on [Appropriations]",7,0,0,1,8
1845104,1420074,2024-04-03,Assembly,"Do pass and be re-referred to the Committee on [Judiciary] with recommendation: To Consent Calendar",12,0,0,3,15
1845104,1423753,2024-04-09,Assembly,"Do pass and be re-referred to the Committee on [Appropriations] with recommendation: To Consent Calendar",12,0,0,0,12
1845104,1434081,2024-04-24,Assembly,"Do pass. To Consent Calendar",14,0,0,1,15
1845104,1438494,2024-05-02,Assembly,"AB 2337 Dixon Consent Calendar Second Day Regular Session",73,0,0,7,80
1845104,1454250,2024-06-05,Senate,"Do pass, but first be re-referred to the Committee on [Judiciary] with the recommendation: To Consent Calendar",5,0,0,0,5
1845104,1458190,2024-06-18,Senate,"Do pass as amended, but first amend, and re-refer to the Committee on [Appropriations] with the recommendation: To Consent Calendar",10,0,0,1,11
1845104,1466393,2024-08-30,Senate,"Assembly 3rd Reading AB2337 Dixon By Niello",40,0,0,0,40
1845104,1466911,2024-08-31,Assembly,"AB 2337 Dixon Concurrence in Senate Amendments",76,0,0,3,79
1845105,1434109,2024-04-24,Assembly,"Do pass and be re-referred to the Committee on [Appropriations]",9,0,0,0,9
1845105,1444016,2024-05-16,Assembly,"Do pass",12,1,0,2,15
1845105,1446094,2024-05-21,Assembly,"AB 2338 Jones-Sawyer Assembly Third Reading",62,3,0,15,80
1845105,1453478,2024-06-04,Senate,"Do pass, but first be re-referred to the Committee on [Human Services]",5,0,0,5,10
1845105,1453479,2024-06-04,Senate,"[First] hearing set for [06-04-2024]: Failed passage in Committee. Reconsideration granted",9,0,0,1,10
1845105,1458505,2024-06-18,Senate,"Do pass, but first be re-referred to the Committee on [Human Services]",7,1,0,2,10
1845105,1462298,2024-07-01,Senate,"Do pass, but first be re-referred to the Committee on [Appropriations]",4,0,0,1,5
1845105,1463561,2024-08-05,Senate,"Placed on suspense file",7,0,0,0,7
1845106,1419130,2024-04-02,Assembly,"Do pass and be re-referred to the Committee on [Appropriations]",15,0,0,1,16
1845106,1444422,2024-05-16,Assembly,"Do pass",15,0,0,0,15
1845106,1446119,2024-05-21,Assembly,"AB 2339 Aguiar-Curry Assembly Third Reading",71,0,0,9,80
1845106,1458497,2024-06-19,Senate,"Do pass, but first be re-referred to the Committee on [Appropriations]",9,0,0,2,11
1845106,1465855,2024-08-27,Senate,"Assembly 3rd Reading AB2339 Aguiar-Curry et al. By Atkins",34,0,0,6,40
1845106,1466751,2024-08-28,Assembly,"AB 2339 Aguiar-Curry Concurrence in Senate Amendments",77,0,0,2,79
1845107,1428869,2024-04-16,Assembly,"Do pass and be re-referred to the Committee on [Appropriations] with recommendation: To Consent Calendar",16,0,0,0,16
1845107,1441300,2024-05-08,Assembly,"Do pass. To Consent Calendar",15,0,0,0,15
1845107,1443918,2024-05-16,Assembly,"AB 2340 Bonta Consent Calendar Second Day Regular Session",71,0,0,9,80
1845107,1456849,2024-06-12,Senate,"Do pass, but first be re-referred to the Committee on [Appropriations] with the recommendation: To Consent Calendar",10,0,0,1,11
1845107,1465408,2024-08-21,Senate,"Assembly 3rd Reading AB2340 Bonta et al. By Rubio",33,0,0,7,40
1845107,1465550,2024-08-26,Assembly,"AB 2340 Bonta Concurrence in Senate Amendments",77,0,0,2,79
1845110,1433072,2024-04-23,Assembly,"Do pass and be re-referred to the Committee on [Appropriations] with recommendation: To Consent Calendar",6,0,0,1,7
1845110,1443467,2024-05-15,Assembly,"Do pass. To Consent Calendar",15,0,0,0,15
1845110,1446065,2024-05-21,Assembly,"AB 2343 Schiavo Consent Calendar Second Day Regular Session",71,0,0,9,80
1845110,1458322,2024-06-17,Senate,"Do pass, but first be re-referred to the Committee on [Appropriations] with the recommendation: To Consent Calendar",5,0,0,0,5
1845110,1465723,2024-08-26,Senate,"Assembly 3rd Reading AB2343 Schiavo By Menjivar",40,0,0,0,40
1845110,1465819,2024-08-27,Assembly,"AB 2343 Schiavo Concurrence in Senate Amendments",77,0,0,2,79
1845111,1411359,2024-03-19,Assembly,"Do pass and be re-referred to the Committee on [Appropriations] with recommendation: To Consent Calendar",11,0,0,0,11
1845112,1412515,2024-03-20,Assembly,"Do pass as amended, and be re-referred to the Committee on [Appropriations] with recommendation: To Consent Calendar",7,0,0,0,7
1845112,1430079,2024-04-17,Assembly,"Do pass. To Consent Calendar",15,0,0,0,15
1845112,1435244,2024-04-25,Assembly,"AB 2345 Jim Patterson Consent Calendar Second Day Regular Session",75,0,0,5,80
1845112,1451596,2024-05-29,Senate,"Do pass, but first be re-referred to the Committee on [Appropriations] with the recommendation: To Consent Calendar",7,0,0,0,7
1845112,1457358,2024-06-13,Senate,"Consent Calendar 2nd AB2345 Jim Patterson et al",37,0,0,3,40
1845113,1423779,2024-04-08,Assembly,"Do pass as amended and be re-referred to the Committee on [Appropriations]",11,0,0,0,11
1845113,1434275,2024-04-24,Assembly,"Do pass. To Consent Calendar",14,0,0,1,15
1845113,1438526,2024-05-02,Assembly,"AB 2346 Lee Consent Calendar Second Day Regular Session",73,0,0,7,80
1845113,1462447,2024-07-03,Senate,"Do pass as amended, but first amend, and re-refer to the Committee on [Appropriations]",7,0,0,0,7
1845113,1463667,2024-08-05,Senate,"Placed on suspense file",7,0,0,0,7
1845113,1464469,2024-08-15,Senate,"Do pass as amended",7,0,0,0,7
1845113,1466354,2024-08-29,Assembly,"AB 2346 Lee Concurrence in Senate Amendments",75,0,0,4,79
1845113,1466896,2024-08-28,Senate,"Assembly 3rd Reading AB2346 Lee By Ashby",39,0,0,1,40
1845114,1436926,2024-04-30,Assembly,"Do pass",8,1,0,3,12
1845114,1450033,2024-05-24,Assembly,"AB 2347 Kalra Assembly Third Reading",48,12,0,20,80
1845114,1462598,2024-07-02,Senate,"Do pass as amended",9,2,0,0,11
1845114,1466019,2024-08-27,Senate,"Assembly 3rd Reading AB2347 Kalra By Durazo",24,9,0,7,40
1845114,1466648,2024-08-28,Assembly,"AB 2347 Kalra Concurrence in Senate Amendments",52,16,0,11,79
1845115,1423815,2024-04-08,Assembly,"Do pass and be re-referred to the Committee on [Health] with recommendation: To Consent Calendar",7,0,0,1,8
1845115,1433142,2024-04-23,Assembly,"Do pass as amended, and be re-referred to the Committee on [Appropriations] with recommendation: To Consent Calendar",16,0,0,0,16
1845115,1444290,2024-05-16,Assembly,"Do pass",15,0,0,0,15
1845115,1446029,2024-05-21,Assembly,"AB 2348 Rodriguez Assembly Third Reading",71,0,0,9,80
1845115,1456861,2024-06-12,Senate,"Do pass as amended, but first amend, and re-refer to the Committee on [Appropriations] with the recommendation: To Consent Calendar",10,0,0,1,11
1845115,1459333,2024-06-24,Senate,"Placed on suspense file",6,0,0,1,7
1845115,1464543,2024-08-15,Senate,"Do pass",7,0,0,0,7
1845115,1466104,2024-08-29,Senate,"Do pass, but first be re-referred to the Committee on [Appropriations]",5,0,0,0,5
1845115,1466519,2024-08-30,Senate,"Do pass",7,0,0,0,7
1845115,1466916,2024-08-31,Senate,"Assembly 3rd Reading AB2348 Ramos",40,0,0,0,40
1845115,1466917,2024-08-31,Assembly,"AB 2348 Ramos Concurrence in Senate Amendments",69,0,0,10,79
1845116,1420148,2024-04-02,Assembly,"Do pass and be re-referred to the Committee on [Appropriations]",11,0,0,0,11
1845116,1444693,2024-05-16,Assembly,"Do pass",15,0,0,0,15
1845116,1445932,2024-05-21,Assembly,"AB 2349 Wilson Assembly Third Reading",70,0,0,10,80
1845116,1456924,2024-06-12,Senate,"Do pass, but first be re-referred to the Committee on [Appropriations] with the recommendation: To Consent Calendar",7,0,0,0,7
1845116,1459381,2024-06-24,Senate,"Placed on suspense file",6,0,0,1,7
1845117,1431028,2024-04-17,Assembly,"Do pass and be re-referred to the Committee on [Education] with recommendation: To Consent Calendar",9,0,0,0,9
1845117,1435363,2024-04-24,Assembly,"Do pass and be re-referred to the Committee on [Appropriations] with recommendation: To Consent Calendar",7,0,0,0,7
1845117,1441392,2024-05-08,Assembly,"Do pass. To Consent Calendar",15,0,0,0,15
1845117,1444299,2024-05-16,Assembly,"AB 2350 Hoover Consent Calendar Second Day Regular Session",71,0,0,9,80
1845117,1454214,2024-06-05,Senate,"Do pass, but first be re-referred to the Committee on [Education]",7,0,0,0,7
1845117,1462501,2024-07-03,Senate,"Do pass, but first be re-referred to the Committee on [Appropriations] with the recommendation: To Consent Calendar",7,0,0,0,7
1845117,1463835,2024-08-12,Senate,"Consent Calendar 2nd AB2350 Hoover",38,0,0,2,40
1845117,1464254,2024-08-15,Assembly,"AB 2350 Hoover Concurrence in Senate Amendments",76,0,0,3,79
1845118,1421145,2024-04-03,Assembly,"Do pass as amended and be re-referred to the Committee on [Judiciary]",5,1,0,1,7
1845118,1436911,2024-04-30,Assembly,"Do pass as amended",11,0,0,1,12
1845119,1423834,2024-04-09,Assembly,"Do pass as amended and be re-referred to the Committee on [Health]",10,0,0,2,12
1845119,1433079,2024-04-23,Assembly,"Do pass as amended and be re-referred to the Committee on [Appropriations]",15,0,0,1,16
1845119,1444298,2024-05-16,Assembly,"Do pass",14,0,0,1,15
1845119,1446125,2024-05-21,Assembly,"AB 2352 Irwin Assembly Third Reading",70,0,0,10,80
1845120,1424972,2024-04-10,Assembly,"Do pass and be re-referred to the Committee on [Revenue and Taxation]",8,0,0,1,9
1845120,1433133,2024-04-22,Assembly,"Do pass as amended and be re-referred to the Committee on [Appropriations]",7,0,0,0,7
1845120,1444554,2024-05-16,Assembly,"Do pass",15,0,0,0,15
1845120,1448759,2024-05-22,Assembly,"AB 2353 Ward Assembly Third Reading",72,0,0,8,80
1845120,1460451,2024-06-26,Senate,"Do pass as amended, but first amend, and re-refer to the Committee on [Appropriations]",7,0,0,0,7
1845120,1463442,2024-08-05,Senate,"Placed on suspense file",7,0,0,0,7
1845120,1464274,2024-08-15,Senate,"Do pass",6,0,0,1,7
1845120,1465552,2024-08-26,Senate,"Assembly 3rd Reading AB2353 Ward By Padilla",40,0,0,0,40
1845120,1465928,2024-08-27,Assembly,"AB 2353 Ward Concurrence in Senate Amendments",77,0,0,2,79
1845121,1428859,2024-04-16,Assembly,"Do pass and be re-referred to the Committee on [Appropriations]",6,0,0,2,8
1845122,1424891,2024-04-10,Assembly,"Do pass as amended and be re-referred to the Committee on [Privacy and Consumer Protection]",7,1,0,0,8
1845122,1435367,2024-04-23,Assembly,"Do pass and be re-referred to the Committee on [Judiciary]",9,1,0,1,11
1845122,1436935,2024-04-30,Assembly,"Do pass and be re-referred to the Committee on [Appropriations]",9,1,0,2,12
1845122,1443973,2024-05-16,Assembly,"Do pass",13,0,0,2,15
1845122,1448791,2024-05-22,Assembly,"AB 2355 Wendy Carrillo Assembly Third Reading",64,0,0,16,80
1845122,1458241,2024-06-18,Senate,"Do pass, but first be re-referred to the Committee on [Judiciary]",6,0,0,1,7
1845122,1462525,2024-07-02,Senate,"Do pass, but first be re-referred to the Committee on [Appropriations]",11,0,0,0,11
1845122,1463375,2024-08-05,Senate,"Placed on suspense file",7,0,0,0,7
1845122,1464251,2024-08-15,Senate,"Do pass as amended",7,0,0,0,7
1845122,1466003,2024-08-27,Senate,"Assembly 3rd Reading AB2355 Wendy Carrillo et al By Wilk",40,0,0,0,40
1845122,1466844,2024-08-28,Assembly,"AB 2355 Wendy Carrillo Concurrence in Senate Amendments",75,0,0,4,79
1845123,1423905,2024-04-09,Assembly,"Do pass and be re-referred to the Committee on [Appropriations] with recommendation: To Consent Calendar",16,0,0,0,16
1845124,1423850,2024-04-09,Assembly,"Do pass and be re-referred to the Committee on [Appropriations]",10,0,0,1,11
1845124,1444489,2024-05-16,Assembly,"Do pass",15,0,0,0,15
1845124,1448630,2024-05-22,Assembly,"AB 2357 Bains Assembly Third Reading",72,0,0,8,80
1845124,1458445,2024-06-19,Senate,"Do pass as amended, but first amend, and re-refer to the Committee on [Appropriations]",7,0,0,0,7
1845124,1463382,2024-08-05,Senate,"Placed on suspense file",7,0,0,0,7
1845124,1464428,2024-08-15,Senate,"Do pass",7,0,0,0,7
1845124,1466341,2024-08-29,Assembly,"AB 2357 Bains Concurrence in Senate Amendments",76,0,0,3,79
1845124,1466887,2024-08-28,Senate,"Assembly 3rd Reading AB2357 Bains By Newman",39,0,0,1,40
1845125,1430083,2024-04-17,Assembly,"Do pass and be re-referred to the Committee on [Appropriations]",15,0,0,0,15
1845126,1420083,2024-04-03,Assembly,"Do pass and be re-referred to the Committee on [Appropriations]",21,0,0,1,22
1845126,1430080,2024-04-17,Assembly,"Do pass. To Consent Calendar",15,0,0,0,15
1845126,1435255,2024-04-25,Assembly,"AB 2359 Ting Consent Calendar Second Day Regular Session",75,0,0,5,80
1845126,1450951,2024-05-28,Senate,"Do pass, but first be re-referred to the Committee on [Appropriations]",12,0,0,4,16
1845126,1465371,2024-08-20,Senate,"Assembly 3rd Reading AB2359 Ting et al. By Wiener",40,0,0,0,40
1845127,1419181,2024-04-02,Assembly,"Do pass and be re-referred to the Committee on [Appropriations]",7,0,0,0,7
1845127,1443966,2024-05-16,Assembly,"Do pass as amended",11,0,0,4,15
1845127,1448716,2024-05-22,Assembly,"AB 2360 Rendon Assembly Third Reading",70,0,0,10,80
1845127,1462360,2024-07-01,Senate,"Do pass, but first be re-referred to the Committee on [Appropriations] with the recommendation: To Consent Calendar",5,0,0,0,5
1845127,1463367,2024-08-05,Senate,"Placed on suspense file",7,0,0,0,7
1845131,1431009,2024-04-17,Assembly,"Do pass and be re-referred to the Committee on [Appropriations]",5,2,0,0,7
1845131,1443926,2024-05-16,Assembly,"Do pass as amended",11,4,0,0,15
1845131,1448560,2024-05-22,Assembly,"AB 2364 Luz Rivas Assembly Third Reading By ORTEGA",50,10,0,20,80
1845131,1456937,2024-06-12,Senate,"Do pass, but first be re-referred to the Committee on [Appropriations]",4,1,0,0,5
1845131,1459402,2024-06-24,Senate,"Placed on suspense file",6,0,0,1,7
1845131,1464558,2024-08-15,Senate,"Do pass as amended",5,2,0,0,7
1845131,1465854,2024-08-27,Senate,"Assembly 3rd Reading AB2364 Luz Rivas By Durazo",28,9,0,3,40
1845131,1466693,2024-08-28,Assembly,"AB 2364 Luz Rivas Concurrence in Senate Amendments",57,16,0,6,79
1845132,1423907,2024-04-09,Assembly,"Do pass and be re-referred to the Committee on [Environmental Safety and Toxic Materials]",15,0,0,1,16
1845132,1435940,2024-04-23,Assembly,"Do pass and be re-referred to the Committee on [Appropriations]",7,0,0,0,7
1845132,1444273,2024-05-16,Assembly,"Do pass as amended",11,0,0,4,15
1845132,1446141,2024-05-21,Assembly,"AB 2365 Haney Assembly Third Reading",73,0,0,7,80
1845132,1456921,2024-06-12,Senate,"Do pass as amended, but first amend, and re-refer to the Committee on [Appropriations]",10,0,0,1,11
1845132,1459351,2024-06-24,Senate,"Placed on suspense file",6,0,0,1,7
1845134,1418346,2024-04-01,Assembly,"Do pass and be re-referred to the Committee on [Appropriations] with recommendation: To Consent Calendar",15,0,0,0,15
1845134,1441335,2024-05-08,Assembly,"Do pass. To Consent Calendar",15,0,0,0,15
1845134,1444544,2024-05-16,Assembly,"AB 2367 Lee Consent Calendar Second Day Regular Session",71,0,0,9,80
1845134,1456333,2024-06-11,Senate,"Do pass, but first be re-referred to the Committee on [Appropriations] with the recommendation: To Consent Calendar",15,0,0,0,15
1845134,1461242,2024-06-27,Senate,"Consent Calendar 2nd AB2367 Lee",40,0,0,0,40
1845134,1462028,2024-07-01,Assembly,"AB 2367 Lee Concurrence in Senate Amendments",72,0,0,7,79
1845135,1434253,2024-04-24,Assembly,"Do pass and be re-referred to the Committee on [Appropriations] with recommendation: To Consent Calendar",16,0,0,0,16
1845135,1444163,2024-05-16,Assembly,"Do pass",15,0,0,0,15
1845135,1448771,2024-05-22,Assembly,"AB 2368 Petrie-Norris Assembly Third Reading",72,0,0,8,80
1845135,1462250,2024-07-02,Senate,"Do pass as amended, but first amend, and re-refer to the Committee on [Appropriations]",18,0,0,0,18
1845135,1463403,2024-08-05,Senate,"Placed on suspense file",7,0,0,0,7
1845135,1464272,2024-08-15,Senate,"Do pass",7,0,0,0,7
1845135,1465798,2024-08-27,Senate,"Assembly 3rd Reading AB2368 Petrie-Norris et al. By Becker",40,0,0,0,40
1845135,1466311,2024-08-29,Assembly,"AB 2368 Petrie-Norris Concurrence in Senate Amendments",76,0,0,3,79
1845136,1424788,2024-04-10,Assembly,"Do pass and be re-referred to the Committee on [Appropriations] with recommendation: To Consent Calendar",11,0,0,0,11
1845137,1432937,2024-04-23,Assembly,"Do pass",10,0,0,1,11
1845137,1438447,2024-05-02,Assembly,"AB 2370 Cervantes Assembly Third Reading",73,0,0,7,80
1845137,1454232,2024-06-05,Senate,"Do pass and be ordered to the Consent Calendar",7,0,0,0,7
1845137,1457352,2024-06-13,Senate,"Consent Calendar 2nd AB2370 Cervantes",37,0,0,3,40
1845138,1425893,2024-04-10,Assembly,"Do pass",9,0,0,0,9
1845138,1435261,2024-04-25,Assembly,"AB 2371 Juan Carrillo Third Reading Urgency",73,0,0,7,80
1845138,1460476,2024-06-25,Senate,"Do pass, but first be re-referred to the Committee on [Local Government]",11,0,0,0,11
1845138,1462475,2024-07-03,Senate,"Do pass as amended",7,0,0,0,7
1845138,1465389,2024-08-20,Senate,"Assembly 3rd Reading AB2371 Juan Carrillo et al. By Rubio Urgency Clause",40,0,0,0,40
1845138,1465438,2024-08-22,Assembly,"AB 2371 Juan Carrillo Concurrence in Senate Amendments",62,0,0,17,79
1845140,1434263,2024-04-24,Assembly,"Do pass and be re-referred to the Committee on [Appropriations] with recommendation: To Consent Calendar",9,0,0,0,9
1845140,1441386,2024-05-08,Assembly,"Do pass. To Consent Calendar",15,0,0,0,15
1845140,1444486,2024-05-16,Assembly,"AB 2373 Rendon Consent Calendar Second Day Regular Session",71,0,0,9,80
1845140,1456367,2024-06-11,Senate,"Do pass, but first be re-referred to the Committee on [Appropriations] with the recommendation: To Consent Calendar",11,0,0,0,11
1845140,1459398,2024-06-24,Senate,"Placed on suspense file",6,0,0,1,7
1845140,1464153,2024-08-15,Senate,"Do pass",7,0,0,0,7
1845140,1465859,2024-08-27,Senate,"Assembly 3rd Reading AB2373 Rendon By Roth",40,0,0,0,40
1845140,1466771,2024-08-28,Assembly,"AB 2373 Rendon Concurrence in Senate Amendments",77,0,0,2,79
1845141,1421182,2024-04-03,Assembly,"Do pass and be re-referred to the Committee on [Judiciary]",5,1,0,1,7
1845141,1428926,2024-04-16,Assembly,"Do pass and be re-referred to the Committee on [Appropriations]",9,0,0,3,12
1845141,1444112,2024-05-16,Assembly,"Do pass as amended",10,2,0,3,15
1845141,1448623,2024-05-22,Assembly,"AB 2374 Haney Assembly Third Reading",52,11,0,17,80
1845141,1458433,2024-06-19,Senate,"Do pass, but first be re-referred to the Committee on [Judiciary]",4,1,0,0,5
1845141,1462677,2024-07-02,Senate,"Do pass, but first be re-referred to the Committee on [Appropriations]",9,2,0,0,11
1845141,1463619,2024-08-05,Senate,"Placed on suspense file",7,0,0,0,7
1845142,1420103,2024-04-03,Assembly,"Do pass as amended and be re-referred to the Committee on [Appropriations]",21,0,0,1,22
1845142,1444103,2024-05-16,Assembly,"Do pass as amended",11,0,0,4,15
1845142,1448615,2024-05-22,Assembly,"AB 2375 Lowenthal Assembly Third Reading",70,0,0,10,80
1845142,1459975,2024-06-25,Senate,"Do pass as amended, but first amend, and re-refer to the Committee on [Appropriations]",13,0,0,3,16
1845142,1466237,2024-08-29,Assembly,"AB 2375 Lowenthal Concurrence in Senate Amendments",76,0,0,3,79
1845142,1466743,2024-08-28,Senate,"Assembly 3rd Reading AB2375 Lowenthal et al. By Rubio",40,0,0,0,40
1845143,1428764,2024-04-16,Assembly,"Do pass and be re-referred to the Committee on [Appropriations] with recommendation: To Consent Calendar",16,0,0,0,16
1845143,1444206,2024-05-16,Assembly,"Do pass",15,0,0,0,15
1845143,1448683,2024-05-22,Assembly,"AB 2376 Bains Assembly Third Reading",72,0,0,8,80
1845143,1462616,2024-07-03,Senate,"Do pass as amended, but first amend, and re-refer to the Committee on [Appropriations] with the recommendation: To Consent Calendar",11,0,0,0,11
1845143,1463546,2024-08-05,Senate,"Placed on suspense file",7,0,0,0,7
1845143,1464322,2024-08-15,Senate,"Do pass",7,0,0,0,7
1845143,1465902,2024-08-27,Senate,"Assembly 3rd Reading AB2376 Bains By Wiener",40,0,0,0,40
1845143,1467233,2024-08-28,Assembly,"AB 2376 Bains Concurrence in Senate Amendments",76,0,0,3,79
1845144,1412547,2024-03-20,Assembly,"Do pass as amended, and be re-referred to the Committee on [Judiciary] with recommendation: To Consent Calendar",7,0,0,0,7
1845144,1423737,2024-04-09,Assembly,"Do pass and be re-referred to the Committee on [Appropriations]",11,0,0,1,12
1845144,1434244,2024-04-24,Assembly,"Do pass. To Consent Calendar",14,0,0,1,15
1845144,1438468,2024-05-02,Assembly,"AB 2377 Luz Rivas Consent Calendar Second Day Regular Session",73,0,0,7,80
1845144,1454205,2024-06-05,Senate,"Do pass, but first be re-referred to the Committee on [Judiciary]",7,0,0,0,7
1845144,1458189,2024-06-18,Senate,"Do pass as amended, but first amend, and re-refer to the Committee on [Appropriations]",10,0,0,1,11
1845144,1465666,2024-08-26,Senate,"Assembly 3rd Reading AB2377 Luz Rivas By Newman",40,0,0,0,40
1845144,1466026,2024-08-27,Assembly,"AB 2377 Luz Rivas Concurrence in Senate Amendments",77,0,0,2,79
1845145,1420161,2024-04-03,Assembly,"Do pass and be re-referred to the Committee on [Appropriations]",21,0,0,1,22
1845145,1430084,2024-04-17,Assembly,"Do pass. To Consent Calendar",15,0,0,0,15
1845145,1435287,2024-04-25,Assembly,"AB 2378 Calderon Consent Calendar Second Day Regular Session",75,0,0,5,80
1845145,1450960,2024-05-28,Senate,"Do pass as amended, but first amend, and re-refer to the Committee on [Appropriations]",11,0,0,5,16
1845145,1465296,2024-08-19,Senate,"Assembly 3rd Reading AB2378 Calderon By Durazo",40,0,0,0,40
1845145,1465432,2024-08-22,Assembly,"AB 2378 Calderon Concurrence in Senate Amendments",62,0,0,17,79
1845148,1424954,2024-04-10,Assembly,"Do pass and be re-referred to the Committee on [Human Services] with recommendation: To Consent Calendar",7,0,0,0,7
1845148,1433040,2024-04-23,Assembly,"Do pass and be re-referred to the Committee on [Appropriations] with recommendation: To Consent Calendar",6,0,0,1,7
1845148,1444513,2024-05-16,Assembly,"Do pass",15,0,0,0,15
1845148,1448556,2024-05-22,Assembly,"AB 2381 Bonta Assembly Third Reading",72,0,0,8,80
1845148,1462632,2024-07-03,Senate,"Do pass, but first be re-referred to the Committee on [Appropriations]",7,0,0,0,7
1845148,1463543,2024-08-05,Senate,"Placed on suspense file",7,0,0,0,7
1845148,1464616,2024-08-15,Senate,"Do pass",7,0,0,0,7
1845148,1466479,2024-08-30,Senate,"Assembly 3rd Reading AB2381 Bonta By Ashby",40,0,0,0,40
1845149,1428824,2024-04-16,Assembly,"Do pass as amended and be re-referred to the Committee on [Appropriations]",7,0,0,1,8
1845150,1423932,2024-04-09,Assembly,"Do pass as amended and be re-referred to the Committee on [Health]",6,0,0,1,7
1845150,1433193,2024-04-23,Assembly,"Do pass as amended, and be re-referred to the Committee on [Appropriations] with recommendation: To Consent Calendar",16,0,0,0,16
1845150,1444105,2024-05-16,Assembly,"Do pass",15,0,0,0,15
1845150,1448750,2024-05-22,Assembly,"AB 2383 Wendy Carrillo Assembly Third Reading",72,0,0,8,80
1845150,1458286,2024-06-17,Senate,"Do pass, but first be re-referred to the Committee on [Health]",5,0,0,0,5
1845150,1462691,2024-07-03,Senate,"Do pass as amended, but first amend, and re-refer to the Committee on [Appropriations] with the recommendation: To Consent Calendar",11,0,0,0,11
1845150,1463370,2024-08-05,Senate,"Placed on suspense file",7,0,0,0,7
1845152,1431920,2024-04-22,Assembly,"Do pass and be re-referred to the Committee on [Appropriations] with recommendation: To Consent Calendar",15,0,0,0,15
1845154,1412612,2024-03-20,Assembly,"Do pass as amended and be re-referred to the Committee on [Appropriations]",9,0,0,0,9
1845154,1444566,2024-05-16,Assembly,"Do pass as amended",11,0,0,4,15
1845154,1448624,2024-05-22,Assembly,"AB 2387 Pellerin Assembly Third Reading",69,0,0,11,80
1845154,1458504,2024-06-18,Senate,"Do pass, but first be re-referred to the Committee on [Local Government]",10,0,0,0,10
1845154,1460617,2024-06-26,Senate,"Do pass, but first be re-referred to the Committee on [Appropriations]",7,0,0,0,7
1845154,1463354,2024-08-05,Senate,"Placed on suspense file",7,0,0,0,7
1845154,1464334,2024-08-15,Senate,"Do pass",7,0,0,0,7
1845154,1465790,2024-08-27,Senate,"Assembly 3rd Reading AB2387 Pellerin By Durazo",40,0,0,0,40
1845155,1419178,2024-04-02,Assembly,"Do pass as amended, and be re-referred to the Committee on [Appropriations] with recommendation: To Consent Calendar",11,0,0,0,11
1845155,1444528,2024-05-16,Assembly,"Do pass",15,0,0,0,15
1845155,1448655,2024-05-22,Assembly,"AB 2388 Joe Patterson Assembly Third Reading",67,0,0,13,80
1845155,1458356,2024-06-18,Senate,"Do pass, but first be re-referred to the Committee on [Appropriations]",10,0,0,1,11
1845155,1462068,2024-07-01,Senate,"Placed on suspense file",7,0,0,0,7
1845156,1429989,2024-04-17,Assembly,"Do pass and be re-referred to the Committee on [Appropriations]",21,0,0,1,22
1845156,1437605,2024-05-01,Assembly,"Do pass. To Consent Calendar",14,0,0,1,15
1845156,1441976,2024-05-09,Assembly,"AB 2389 Lowenthal Consent Calendar Second Day Regular Session",65,0,0,15,80
1845156,1460104,2024-06-25,Senate,"Do pass as amended, but first amend, and re-refer to the Committee on [Appropriations]",13,0,0,3,16
1845156,1463604,2024-08-05,Senate,"Placed on suspense file",7,0,0,0,7
1845156,1464089,2024-08-15,Senate,"Do pass as amended",7,0,0,0,7
1845156,1465926,2024-08-27,Senate,"Assembly 3rd Reading AB2389 Lowenthal By Menjivar",40,0,0,0,40
1845156,1466818,2024-08-28,Assembly,"AB 2389 Lowenthal Concurrence in Senate Amendments",77,0,0,2,79
1845157,1423832,2024-04-09,Assembly,"Do pass and be re-referred to the Committee on [Privacy and Consumer Protection]",15,0,0,1,16
1845157,1435364,2024-04-23,Assembly,"Do pass and be re-referred to the Committee on [Appropriations]",10,0,0,1,11
1845160,1411364,2024-03-19,Assembly,"Do pass and be re-referred to the Committee on [Appropriations] with recommendation: To Consent Calendar",11,0,0,0,11
1845160,1424819,2024-04-10,Assembly,"Do pass. To Consent Calendar",14,0,0,1,15
1845160,1431034,2024-04-18,Assembly,"AB 2393 Dixon Consent Calendar Second Day Regular Session",72,0,0,8,80
1845160,1456300,2024-06-11,Senate,"Do pass, but first be re-referred to the Committee on [Appropriations] with the recommendation: To Consent Calendar",11,0,0,0,11
1845160,1461222,2024-06-27,Senate,"Consent Calendar 2nd AB2393 Dixon",40,0,0,0,40
1845162,1423914,2024-04-09,Assembly,"Do pass and be re-referred to the Committee on [Appropriations]",9,1,0,1,11
1845162,1444664,2024-05-16,Assembly,"Do pass as amended",12,3,0,0,15
1845162,1446103,2024-05-21,Assembly,"AB 2395 Quirk-Silva Assembly Third Reading",63,6,0,11,80
1845162,1456899,2024-06-12,Senate,"Do pass, but first be re-referred to the Committee on [Appropriations]",6,0,0,1,7
1845162,1459383,2024-06-24,Senate,"Placed on suspense file",6,0,0,1,7
1845162,1464170,2024-08-15,Senate,"Do pass",5,2,0,0,7
1845162,1465993,2024-08-27,Senate,"Assembly 3rd Reading AB2395 Quirk-Silva By Newman",31,8,0,1,40
1845163,1412610,2024-03-20,Assembly,"Do pass as amended and be re-referred to the Committee on [Appropriations]",9,0,0,0,9
1845164,1423764,2024-04-09,Assembly,"Do pass. To Consent Calendar",12,0,0,0,12
1845164,1427211,2024-04-15,Assembly,"AB 2397 Maienschein Assembly Third Reading",75,0,0,5,80
1845164,1453410,2024-06-04,Senate,"Do pass and be ordered to the Consent Calendar",11,0,0,0,11
1845164,1455825,2024-06-10,Senate,"Consent Calendar 2nd AB2397 Maienschein",37,0,0,3,40
1845164,1457335,2024-06-13,Assembly,"AB 2397 Maienschein Concurrence in Senate Amendments",76,0,0,3,79
1845165,1420031,2024-04-02,Assembly,"Do pass and be re-referred to the Committee on [Appropriations]",9,1,0,1,11
1845165,1444686,2024-05-16,Assembly,"Do pass as amended",11,2,0,2,15
1845165,1448599,2024-05-22,Assembly,"AB 2398 Kalra Assembly Third Reading",66,0,0,14,80
1845165,1458480,2024-06-19,Senate,"Do pass, but first be re-referred to the Committee on [Appropriations]",5,0,0,2,7
1845165,1461966,2024-07-01,Senate,"Placed on suspense file",7,0,0,0,7
1845166,1434050,2024-04-24,Assembly,"Do pass",7,1,0,1,9
1845166,1438477,2024-05-02,Assembly,"AB 2399 Rendon Assembly Third Reading",57,4,0,19,80
1845166,1453425,2024-06-04,Senate,"Do pass",9,2,0,0,11
1845166,1465384,2024-08-20,Senate,"Assembly 3rd Reading AB2399 Rendon By Laird",31,9,0,0,40
1845167,1418389,2024-04-01,Assembly,"Do pass and be re-referred to the Committee on [Revenue and Taxation]",15,0,0,0,15
1845167,1436974,2024-04-29,Assembly,"Do pass and be re-referred to the Committee on [Appropriations]",7,0,0,0,7
1845168,1427229,2024-04-15,Assembly,"Do pass and be re-referred to the Committee on [Natural Resources]",15,0,0,0,15
1845168,1431949,2024-04-22,Assembly,"Do pass and be re-referred to the Committee on [Appropriations] with recommendation: To Consent Calendar",11,0,0,0,11
1845168,1443947,2024-05-16,Assembly,"Do pass",15,0,0,0,15
1845168,1448545,2024-05-22,Assembly,"AB 2401 Ting Assembly Third Reading",72,0,0,8,80
1845168,1458459,2024-06-19,Senate,"Do pass, but first be re-referred to the Committee on [Transportation]",7,0,0,0,7
1845168,1460482,2024-06-25,Senate,"Do pass, but first be re-referred to the Committee on [Appropriations] with the recommendation: To Consent Calendar",15,0,0,0,15
1845168,1463918,2024-08-12,Senate,"Placed on suspense file",7,0,0,0,7
1845168,1464271,2024-08-15,Senate,"Do pass",7,0,0,0,7
1845168,1466376,2024-08-29,Assembly,"AB 2401 Ting Concurrence in Senate Amendments",74,0,0,5,79
1845168,1466804,2024-08-28,Senate,"Special Consent AB2401 Ting et al. By Hurtado",39,0,0,1,40
1845169,1419137,2024-04-02,Assembly,"Do pass as amended and be re-referred to the Committee on [Governmental Organization]",15,0,0,1,16
1845169,1430033,2024-04-17,Assembly,"Do pass as amended and be re-referred to the Committee on [Appropriations]",21,0,0,1,22
1845169,1444666,2024-05-16,Assembly,"Do pass as amended",11,0,0,4,15
1845169,1448603,2024-05-22,Assembly,"AB 2402 Lowenthal Assembly Third Reading",70,0,0,10,80
1845169,1460021,2024-06-25,Senate,"Do pass as amended, but first amend, and re-refer to the Committee on [Appropriations]",14,0,0,2,16
1845169,1465725,2024-08-26,Senate,"Assembly 3rd Reading AB2402 Lowenthal et al. By Lim√≥n",40,0,0,0,40
1845169,1466027,2024-08-27,Assembly,"AB 2402 Lowenthal Concurrence in Senate Amendments",77,0,0,2,79
1845170,1433096,2024-04-23,Assembly,"Do pass and be re-referred to the Committee on [Appropriations] with recommendation: To Consent Calendar",10,0,0,1,11
1845170,1441318,2024-05-08,Assembly,"Do pass. To Consent Calendar",15,0,0,0,15
1845170,1444372,2024-05-16,Assembly,"AB 2403 Bonta Consent Calendar Second Day Regular Session",71,0,0,9,80
1845170,1454273,2024-06-05,Senate,"Do pass, but first be re-referred to the Committee on [Appropriations] with the recommendation: To Consent Calendar",7,0,0,0,7
1845170,1465404,2024-08-21,Senate,"Assembly 3rd Reading AB2403 Bonta By Cortese",33,0,0,7,40
1845171,1429965,2024-04-17,Assembly,"Do pass and be re-referred to the Committee on [Judiciary]",5,1,0,1,7
1845171,1433171,2024-04-23,Assembly,"Do pass and be re-referred to the Committee on [Appropriations]",8,2,0,2,12
1845173,1433039,2024-04-23,Assembly,"Do pass and be re-referred to the Committee on [Appropriations]",2,0,0,6,8
1845174,1429900,2024-04-16,Assembly,"Do pass and be re-referred to the Committee on [Appropriations]",11,0,0,0,11
1845174,1444386,2024-05-16,Assembly,"Do pass as amended",11,0,0,4,15
1845174,1446006,2024-05-21,Assembly,"AB 2407 Hart Assembly Third Reading",73,0,0,7,80
1845174,1456880,2024-06-12,Senate,"Do pass, but first be re-referred to the Committee on [Appropriations] with the recommendation: To Consent Calendar",7,0,0,0,7
1845174,1459345,2024-06-24,Senate,"Placed on suspense file",6,0,0,1,7
1845174,1464305,2024-08-15,Senate,"Do pass",7,0,0,0,7
1845174,1466140,2024-08-29,Assembly,"AB 2407 Hart Concurrence in Senate Amendments",76,0,0,3,79
1845174,1466653,2024-08-28,Senate,"Special Consent AB2407 Hart et al",39,0,0,1,40
1845175,1424986,2024-04-09,Assembly,"Do pass and be re-referred to the Committee on [Labor and Employment]",7,0,0,0,7
1845175,1431060,2024-04-17,Assembly,"Do pass and be re-referred to the Committee on [Appropriations] with recommendation: To Consent Calendar",7,0,0,0,7
1845175,1444602,2024-05-16,Assembly,"Do pass as amended",11,0,0,4,15
1845175,1446104,2024-05-21,Assembly,"AB 2408 Haney Assembly Third Reading",73,0,0,7,80
1845175,1458554,2024-06-19,Senate,"Do pass, but first be re-referred to the Committee on [Labor, Public Employment and Retirement ] with the recommendation: To Consent Calendar",7,0,0,0,7
1845175,1460722,2024-06-26,Senate,"Do pass, but first be re-referred to the Committee on [Appropriations] with the recommendation: To Consent Calendar",5,0,0,0,5
1845175,1463486,2024-08-05,Senate,"Placed on suspense file",7,0,0,0,7
1845176,1428750,2024-04-16,Assembly,"Do pass and be re-referred to the Committee on [Appropriations] with recommendation: To Consent Calendar",15,0,0,0,15
1845177,1428758,2024-04-16,Assembly,"Do pass and be re-referred to the Committee on [Appropriations]",5,0,0,2,7
1845177,1444148,2024-05-16,Assembly,"Do pass as amended",11,0,0,4,15
1845177,1446054,2024-05-21,Assembly,"AB 2410 Wallis Assembly Third Reading",73,0,0,7,80
1845177,1458278,2024-06-17,Senate,"Do pass, but first be re-referred to the Committee on [Appropriations]",5,0,0,0,5
1845177,1461968,2024-07-01,Senate,"Placed on suspense file",7,0,0,0,7
1845178,1423805,2024-04-09,Assembly,"Do pass and be re-referred to the Committee on [Appropriations]",15,0,0,1,16
1845184,1420075,2024-04-03,Senate,"Do pass, but first be re-referred to the Committee on [Judiciary]",7,0,0,0,7
1845184,1428917,2024-04-16,Senate,"Do pass as amended, but first amend, and re-refer to the Committee on [Appropriations]",11,0,0,0,11
1845184,1436212,2024-04-29,Senate,"Placed on suspense file",5,0,0,2,7
1845184,1444325,2024-05-16,Senate,"Do pass",7,0,0,0,7
1845184,1450358,2024-05-21,Senate,"Senate 3rd Reading SB1066 Blakespear",39,0,0,1,40
1845184,1460696,2024-06-25,Assembly,"Do pass and be re-referred to the Committee on [Appropriations]",6,0,0,1,7
1845184,1464229,2024-08-15,Assembly,"Do pass as amended",11,0,0,4,15
1845184,1466290,2024-08-29,Senate,"Unfinished Business SB1066 Blakespear Concurrence",40,0,0,0,40
1845184,1466856,2024-08-28,Assembly,"SB 1066 Blakespear Senate Third Reading By Connolly",67,2,0,10,79
1845185,1422045,2024-04-08,Senate,"Do pass, but first be re-referred to the Committee on [Appropriations]",9,0,0,4,13
1845185,1431895,2024-04-22,Senate,"Placed on suspense file",7,0,0,0,7
1845185,1443939,2024-05-16,Senate,"Do pass as amended",7,0,0,0,7
1845185,1448741,2024-05-22,Senate,"Senate 3rd Reading SB1067 Smallwood-Cuevas",35,0,0,5,40
1845185,1456353,2024-06-11,Assembly,"Do pass as amended and be re-referred to the Committee on [Appropriations]",17,0,0,1,18
1845185,1462230,2024-07-02,Assembly,"Do pass. To Consent Calendar",15,0,0,0,15
1845185,1465717,2024-08-26,Assembly,"SB 1067 Smallwood-Cuevas Senate Third Reading By Jackson",77,0,0,2,79
1845185,1466287,2024-08-29,Senate,"Unfinished Business SB1067 Smallwood-Cuevas et al. Concurrence",39,0,0,1,40
1845186,1424898,2024-04-09,Senate,"Do pass, but first be re-referred to the Committee on [Appropriations] with the recommendation: To Consent Calendar",15,0,0,0,15
1845186,1435305,2024-04-25,Senate,"Consent Calendar 2nd SB1068 Eggman",36,0,0,4,40
1845186,1458193,2024-06-17,Assembly,"Do pass and be re-referred to the Committee on [Appropriations] with recommendation: To Consent Calendar",15,0,0,0,15
1845186,1462343,2024-07-02,Assembly,"Do pass. To Consent Calendar",15,0,0,0,15
1845186,1463783,2024-08-08,Assembly,"SB 1068 Eggman Consent Calendar Second Day Regular Session",72,0,0,7,79
1845187,1419150,2024-04-02,Senate,"Do pass, but first be re-referred to the Committee on [Appropriations]",5,0,0,0,5
1845187,1431862,2024-04-22,Senate,"Placed on suspense file",7,0,0,0,7
1845187,1444235,2024-05-16,Senate,"Do pass as amended",7,0,0,0,7
1845187,1450029,2024-05-24,Senate,"Special Consent SB1069 Menjivar",38,0,0,2,40
1845187,1458199,2024-06-18,Assembly,"Do pass and be re-referred to the Committee on [Appropriations] with recommendation: To Consent Calendar",7,0,0,1,8
1845187,1464047,2024-08-15,Assembly,"Do pass as amended",11,0,0,4,15
1845187,1466531,2024-08-30,Senate,"Special Consent SB1069 Menjivar",40,0,0,0,40
1845187,1467047,2024-08-28,Assembly,"SB 1069 Menjivar Senate Third Reading By Aguiar-Curry",77,0,0,2,79
1845188,1434168,2024-04-24,Senate,"Do pass as amended, but first amend, and re-refer to the Committee on [Appropriations]",5,0,0,0,5
1845188,1442623,2024-05-13,Senate,"Placed on suspense file",7,0,0,0,7
1845188,1444387,2024-05-16,Senate,"Do pass",7,0,0,0,7
1845188,1449548,2024-05-23,Senate,"Senate 3rd Reading SB1070 Padilla et al",37,0,0,3,40
1845188,1458404,2024-06-19,Assembly,"Do pass as amended and be re-referred to the Committee on [Appropriations]",7,0,0,0,7
1845188,1464240,2024-08-15,Assembly,"Do pass",14,0,0,1,15
1845188,1466058,2024-08-28,Assembly,"Do pass",7,2,0,0,9
1845188,1466837,2024-08-31,Senate,"Unfinished Business SB1070 Padilla et al. Concurrence",31,8,0,1,40
1845188,1466838,2024-08-31,Assembly,"SB 1070 Padilla Senate Third Reading By Garcia",61,15,0,3,79
1845189,1431921,2024-04-22,Senate,"Do pass as amended, but first amend, and re-refer to the Committee on [Appropriations]",12,0,0,1,13
1845189,1442638,2024-05-13,Senate,"Placed on suspense file",7,0,0,0,7
1845190,1437596,2024-05-01,Senate,"Do pass",4,1,0,2,7
1845190,1448738,2024-05-22,Senate,"Senate 3rd Reading SB1072 Padilla",31,5,0,4,40
1845190,1460585,2024-06-26,Assembly,"Do pass",8,0,0,1,9
1845190,1466235,2024-08-29,Senate,"Unfinished Business SB1072 Padilla Concurrence",30,9,0,1,40
1845190,1466797,2024-08-28,Assembly,"SB 1072 Padilla Senate Third Reading By Pacheco",59,13,0,7,79
1845191,1423853,2024-04-09,Senate,"Do pass, but first be re-referred to the Committee on [Environmental Quality]",13,0,0,3,16
1845191,1434223,2024-04-24,Senate,"Do pass as amended, but first amend, and re-refer to the Committee on [Appropriations]",7,0,0,0,7
1845191,1442616,2024-05-13,Senate,"Placed on suspense file",7,0,0,0,7
1845191,1443944,2024-05-16,Senate,"Do pass",7,0,0,0,7
1845191,1449532,2024-05-23,Senate,"Special Consent SB1073 Skinner",37,0,0,3,40
1845191,1457939,2024-06-17,Assembly,"Do pass and be re-referred to the Committee on [Appropriations]",9,0,0,2,11
1845192,1423847,2024-04-09,Senate,"Do pass, but first be re-referred to the Committee on [Appropriations]",4,0,0,1,5
1845192,1442659,2024-05-13,Senate,"Placed on suspense file",7,0,0,0,7
1845192,1444061,2024-05-16,Senate,"Do pass as amended",7,0,0,0,7
1845192,1448707,2024-05-22,Senate,"Senate 3rd Reading SB1074 Jones et al. Urgency Clause",38,0,0,2,40
1845192,1462451,2024-07-02,Assembly,"Do pass and be re-referred to the Committee on [Appropriations]",8,0,0,0,8
1845193,1420147,2024-04-03,Senate,"Do pass as amended, but first amend, and re-refer to the Committee on [Appropriations]",4,2,0,1,7
1845193,1449656,2024-05-23,Senate,"Senate 3rd Reading SB1075 Bradford et al",24,7,0,9,40
1845193,1461975,2024-07-01,Assembly,"Do pass and be re-referred to the Committee on [Appropriations]",9,0,0,0,9
1845193,1463726,2024-08-07,Assembly,"Do pass",14,0,0,1,15
1845193,1465895,2024-08-27,Assembly,"SB 1075 Bradford Senate Third Reading By Ting",76,0,0,3,79
1845193,1467093,2024-08-28,Senate,"Unfinished Business SB1075 Bradford et al. Concurrence",36,2,0,2,40
1845195,1423911,2024-04-09,Senate,"Do pass as amended, but first amend, and re-refer to the Committee on [Housing]",11,0,0,0,11
1845195,1428843,2024-04-16,Senate,"Do pass, but first be re-referred to the Committee on [Appropriations]",8,1,0,1,10
1845195,1436222,2024-04-29,Senate,"Placed on suspense file",5,0,0,2,7
1845195,1444011,2024-05-16,Senate,"Do pass",6,1,0,0,7
1845195,1449612,2024-05-23,Senate,"Senate 3rd Reading SB1077 Blakespear",36,0,0,4,40
1845195,1457946,2024-06-17,Assembly,"Do pass as amended and be re-referred to the Committee on [Housing and Community Development]",10,0,0,1,11
1845195,1460484,2024-06-26,Assembly,"Do pass as amended and be re-referred to the Committee on [Appropriations]",9,0,0,0,9
1845195,1464297,2024-08-15,Assembly,"Do pass",14,0,0,1,15
1845195,1466106,2024-08-29,Senate,"Unfinished Business SB1077 Blakespear Concurrence",39,0,0,1,40
1845195,1466652,2024-08-28,Assembly,"SB 1077 Blakespear Senate Third Reading By Wicks",75,1,0,3,79
1845196,1424848,2024-04-10,Senate,"Do pass, but first be re-referred to the Committee on [Human Services]",11,0,0,0,11
1845196,1428960,2024-04-15,Senate,"Do pass as amended, but first amend, and re-refer to the Committee on [Appropriations]",5,0,0,0,5
1845196,1436243,2024-04-29,Senate,"Placed on suspense file",5,0,0,2,7
1845196,1444536,2024-05-16,Senate,"Do pass",7,0,0,0,7
1845196,1449702,2024-05-23,Senate,"Senate 3rd Reading SB1078 Min et al",36,0,0,4,40
1845196,1456392,2024-06-11,Assembly,"Do pass and be re-referred to the Committee on [Human Services]",16,0,0,0,16
1845196,1460006,2024-06-25,Assembly,"Do pass as amended and be re-referred to the Committee on [Appropriations]",4,0,0,3,7
1845197,1412536,2024-03-19,Senate,"Do pass, but first be re-referred to the Committee on [Appropriations]",9,1,0,0,10
1845197,1422102,2024-04-08,Senate,"Placed on suspense file",6,0,0,1,7
1845197,1444421,2024-05-16,Senate,"Do pass as amended",5,2,0,0,7
1845197,1448593,2024-05-22,Senate,"Senate 3rd Reading SB1079 Menjivar Urgency Clause",30,7,0,3,40
1845198,1430059,2024-04-17,Senate,"Do pass, but first be re-referred to the Committee on [Appropriations]",7,0,0,0,7
1845198,1436235,2024-04-29,Senate,"Placed on suspense file",5,0,0,2,7
1845199,1424961,2024-04-09,Senate,"Do pass, but first be re-referred to the Committee on [Appropriations]",12,2,0,1,15
1845199,1431847,2024-04-22,Senate,"Placed on suspense file",7,0,0,0,7
1845199,1444675,2024-05-16,Senate,"Do pass as amended",4,2,0,1,7
1845199,1448540,2024-05-22,Senate,"Senate 3rd Reading SB1081 Archuleta",24,2,0,14,40
1845200,1424905,2024-04-10,Senate,"Do pass, but first be re-referred to the Committee on [Human Services] with the recommendation: To Consent Calendar",11,0,0,0,11
1845200,1428801,2024-04-15,Senate,"Do pass as amended, but first amend, and re-refer to the Committee on [Appropriations]",5,0,0,0,5
1845200,1436236,2024-04-29,Senate,"Placed on suspense file",5,0,0,2,7
1845204,1424969,2024-04-10,Senate,"Do pass, but first be re-referred to the Committee on [Appropriations]",2,4,0,1,7
1845204,1424970,2024-04-10,Senate,"[First] hearing set for [04-10-2024]: Failed passage in Committee. Reconsideration granted",7,0,0,0,7
1845205,1412566,2024-03-20,Senate,"Do pass, but first be re-referred to the Committee on [Energy, Utilities and Communications] with the recommendation: To Consent Calendar",6,0,0,1,7
1845205,1432978,2024-04-22,Senate,"Do pass as amended, but first amend, and re-refer to the Committee on [Appropriations]",17,0,0,1,18
1845205,1442537,2024-05-13,Senate,"Placed on suspense file",7,0,0,0,7
1845206,1423788,2024-04-09,Senate,"Do pass, but first be re-referred to the Committee on [Natural Resources and Water]",14,0,0,2,16
1845206,1433182,2024-04-23,Senate,"Do pass, but first be re-referred to the Committee on [Appropriations] with the recommendation: To Consent Calendar",11,0,0,0,11
1845206,1439637,2024-05-06,Senate,"Placed on suspense file",7,0,0,0,7
1845206,1444595,2024-05-16,Senate,"Do pass",7,0,0,0,7
1845206,1449536,2024-05-23,Senate,"Special Consent SB1088 Alvarado-Gil",37,0,0,3,40
1845206,1459984,2024-06-24,Assembly,"Do pass and be re-referred to the Committee on [Appropriations]",8,0,0,0,8
1845207,1430021,2024-04-17,Senate,"Do pass, but first be re-referred to the Committee on [Judiciary]",4,0,0,1,5
1845207,1434126,2024-04-23,Senate,"Do pass, but first be re-referred to the Committee on [Appropriations]",9,1,0,1,11
1845207,1439615,2024-05-06,Senate,"Placed on suspense file",7,0,0,0,7
1845207,1444406,2024-05-16,Senate,"Do pass as amended",5,2,0,0,7
1845207,1450280,2024-05-21,Senate,"Senate 3rd Reading SB1089 Smallwood-Cuevas",29,9,0,2,40
1845207,1458440,2024-06-19,Assembly,"Do pass and be re-referred to the Committee on [Judiciary]",5,1,0,1,7
1845207,1462289,2024-07-02,Assembly,"Do pass and be re-referred to the Committee on [Appropriations]",9,3,0,0,12
1845207,1464425,2024-08-15,Assembly,"Do pass as amended",11,3,0,1,15
1845207,1466256,2024-08-29,Senate,"Unfinished Business SB1089 Smallwood-Cuevas et Concurrence",30,9,0,1,40
1845207,1466757,2024-08-28,Assembly,"SB 1089 Smallwood-Cuevas Senate Third Reading By Gipson",57,16,0,6,79
1845208,1434030,2024-04-24,Senate,"Do pass, but first be re-referred to the Committee on [Appropriations] with the recommendation: To Consent Calendar",5,0,0,0,5
1845208,1439632,2024-05-06,Senate,"Placed on suspense file",7,0,0,0,7
1845208,1444060,2024-05-16,Senate,"Do pass as amended",7,0,0,0,7
1845208,1450041,2024-05-24,Senate,"Special Consent SB1090 Durazo et al",38,0,0,2,40
1845208,1460507,2024-06-26,Assembly,"Do pass and be re-referred to the Committee on [Appropriations] with recommendation: To Consent Calendar",15,0,0,0,15
1845208,1464388,2024-08-15,Assembly,"Do pass as amended",11,0,0,4,15
1845208,1466474,2024-08-30,Senate,"Special Consent SB1090 Durazo et al",40,0,0,0,40
1845208,1466988,2024-08-28,Assembly,"SB 1090 Durazo Senate Third Reading By Alanis",77,0,0,2,79
1845209,1420167,2024-04-03,Senate,"Do pass, but first be re-referred to the Committee on [Appropriations]",6,0,0,1,7
1845209,1445243,2024-05-20,Senate,"Senate 3rd Reading SB1091 Menjivar",38,0,0,2,40
1845209,1460629,2024-06-26,Assembly,"Do pass as amended, and be re-referred to the Committee on [Appropriations] with recommendation: To Consent Calendar",7,0,0,0,7
1845209,1463748,2024-08-07,Assembly,"Do pass. To Consent Calendar",14,0,0,1,15
1845209,1465731,2024-08-26,Assembly,"SB 1091 Menjivar Senate Third Reading By Calderon",77,0,0,2,79
1845209,1466986,2024-08-28,Senate,"Special Consent SB1091 Menjivar",39,0,0,1,40
1845210,1423841,2024-04-09,Senate,"Do pass, but first be re-referred to the Committee on [Housing]",10,0,0,1,11
1845210,1428981,2024-04-16,Senate,"Do pass, but first be re-referred to the Committee on [Appropriations]",10,0,0,0,10
1845210,1436195,2024-04-29,Senate,"Placed on suspense file",5,0,0,2,7
1845210,1444404,2024-05-16,Senate,"Do pass as amended",7,0,0,0,7
1845210,1448692,2024-05-22,Senate,"Senate 3rd Reading SB1092 Blakespear",38,0,0,2,40
1845210,1457936,2024-06-17,Assembly,"Do pass and be re-referred to the Committee on [Local Government]",10,0,0,1,11
1845212,1424965,2024-04-10,Senate,"Do pass, but first be re-referred to the Committee on [Appropriations]",7,0,0,0,7
1845212,1431888,2024-04-22,Senate,"Placed on suspense file",7,0,0,0,7
1845212,1444145,2024-05-16,Senate,"Do pass",5,2,0,0,7
1845212,1450298,2024-05-21,Senate,"Senate 3rd Reading SB1094 Lim√≥n et al",34,4,0,2,40
1845212,1456895,2024-06-12,Assembly,"Do pass as amended, and be re-referred to the Committee on [Appropriations] with recommendation: To Consent Calendar",7,0,0,0,7
1845213,1412523,2024-03-19,Senate,"Do pass as amended, but first amend, and re-refer to the Committee on [Judiciary]",7,1,0,2,10
1845213,1420136,2024-04-02,Senate,"Do pass as amended, but first amend, and re-refer to the Committee on [Appropriations]",11,0,0,0,11
1845213,1427344,2024-04-15,Senate,"Placed on suspense file",6,0,0,1,7
1846132,1433018,2024-04-23,Assembly,"Do pass and be re-referred to the Committee on [Appropriations]",5,1,0,1,7
1846133,1430061,2024-04-17,Assembly,"Do pass as amended and be re-referred to the Committee on [Appropriations]",12,2,0,1,15
1846133,1444432,2024-05-16,Assembly,"Do pass",11,4,0,0,15
1846133,1448558,2024-05-22,Assembly,"AB 2416 Connolly Assembly Third Reading",51,14,0,15,80
1846133,1460505,2024-06-26,Senate,"Do pass as amended, but first amend, and re-refer to the Committee on [Appropriations]",6,0,0,1,7
1846133,1463618,2024-08-05,Senate,"Placed on suspense file",7,0,0,0,7
1846133,1464022,2024-08-15,Senate,"Do pass",7,0,0,0,7
1846136,1420048,2024-04-02,Assembly,"Do pass",7,1,0,0,8
1846136,1449616,2024-05-23,Assembly,"AB 2419 Gipson Assembly Third Reading",57,0,0,23,80
1846137,1411330,2024-03-19,Assembly,"Do pass and be re-referred to the Committee on [Appropriations]",6,0,0,2,8
1846138,1420188,2024-04-03,Assembly,"Do pass and be re-referred to the Committee on [Appropriations]",5,0,0,2,7
1846138,1444407,2024-05-16,Assembly,"Do pass",11,2,0,2,15
1846138,1448769,2024-05-22,Assembly,"AB 2421 Low Assembly Third Reading",61,0,0,19,80
1846138,1460749,2024-06-26,Senate,"Do pass, but first be re-referred to the Committee on [Judiciary]",5,0,0,0,5
1846138,1462678,2024-07-02,Senate,"Do pass, but first be re-referred to the Committee on [Appropriations]",10,0,0,1,11
1846138,1463608,2024-08-05,Senate,"Placed on suspense file",7,0,0,0,7
1846139,1418336,2024-04-01,Assembly,"Do pass and be re-referred to the Committee on [Appropriations] with recommendation: To Consent Calendar",8,0,0,1,9
1846139,1434177,2024-04-24,Assembly,"Do pass. To Consent Calendar",14,0,0,1,15
1846139,1438460,2024-05-02,Assembly,"AB 2422 Grayson Consent Calendar Second Day Regular Session",73,0,0,7,80
1846139,1458416,2024-06-19,Senate,"Do pass, but first be re-referred to the Committee on [Appropriations] with the recommendation: To Consent Calendar",6,0,0,1,7
1846139,1463917,2024-08-12,Senate,"Consent Calendar 2nd AB2422 Grayson",38,0,0,2,40
1846139,1464032,2024-08-15,Assembly,"AB 2422 Grayson Concurrence in Senate Amendments",76,0,0,3,79
1846140,1423839,2024-04-09,Assembly,"Do pass and be re-referred to the Committee on [Appropriations] with recommendation: To Consent Calendar",6,0,0,1,7
1846140,1443895,2024-05-16,Assembly,"Do pass",15,0,0,0,15
1846140,1448825,2024-05-22,Assembly,"AB 2423 Mathis Assembly Third Reading",72,0,0,8,80
1846140,1462251,2024-07-01,Senate,"Do pass, but first be re-referred to the Committee on [Appropriations] with the recommendation: To Consent Calendar",5,0,0,0,5
1846140,1463369,2024-08-05,Senate,"Placed on suspense file",7,0,0,0,7
1846140,1464637,2024-08-15,Senate,"Do pass",6,0,0,1,7
1846140,1465752,2024-08-26,Senate,"Assembly 3rd Reading AB2423 Mathis et al. By Grove",40,0,0,0,40
1846141,1427222,2024-04-15,Assembly,"Do pass as amended and be re-referred to the Committee on [Judiciary]",9,0,0,0,9
1846141,1433001,2024-04-23,Assembly,"Do pass and be re-referred to the Committee on [Appropriations] with recommendation: To Consent Calendar",11,0,0,1,12
1846141,1441382,2024-05-08,Assembly,"Do pass. To Consent Calendar",15,0,0,0,15
1846141,1444305,2024-05-16,Assembly,"AB 2424 Schiavo Consent Calendar Second Day Regular Session",71,0,0,9,80
1846141,1458553,2024-06-19,Senate,"Do pass as amended, but first amend, and re-refer to the Committee on [Judiciary]",6,0,0,1,7
1846141,1462599,2024-07-02,Senate,"Do pass and be ordered to the Consent Calendar",11,0,0,0,11
1846141,1465662,2024-08-26,Senate,"Assembly 3rd Reading AB2424 Schiavo By Atkins",40,0,0,0,40
1846141,1465832,2024-08-27,Assembly,"AB 2424 Schiavo Concurrence in Senate Amendments",77,0,0,2,79
1846143,1419146,2024-04-02,Assembly,"Do pass and be re-referred to the Committee on [Appropriations] with recommendation: To Consent Calendar",11,0,0,0,11
1846143,1444138,2024-05-16,Assembly,"Do pass",15,0,0,0,15
1846143,1448590,2024-05-22,Assembly,"AB 2426 Irwin Assembly Third Reading",72,0,0,8,80
1846143,1460536,2024-06-25,Senate,"Do pass, but first be re-referred to the Committee on [Appropriations]",10,0,0,1,11
1846143,1463609,2024-08-05,Senate,"Placed on suspense file",7,0,0,0,7
1846143,1464560,2024-08-15,Senate,"Do pass as amended",5,2,0,0,7
1846143,1465992,2024-08-27,Senate,"Assembly 3rd Reading AB2426 Irwin By Ashby",33,4,0,3,40
1846143,1466872,2024-08-28,Assembly,"AB 2426 Irwin Concurrence in Senate Amendments",76,0,0,3,79
1846144,1425890,2024-04-10,Assembly,"Do pass and be re-referred to the Committee on [Transportation]",9,0,0,0,9
1846144,1431977,2024-04-22,Assembly,"Do pass and be re-referred to the Committee on [Appropriations]",15,0,0,0,15
1846144,1444183,2024-05-16,Assembly,"Do pass",15,0,0,0,15
1846144,1449574,2024-05-23,Assembly,"AB 2427 McCarty Assembly Third Reading",71,0,0,9,80
1846144,1456274,2024-06-11,Senate,"Do pass as amended, but first amend, and re-refer to the Committee on [Energy, Utilities and Communications]",5,0,0,2,7
1846144,1462027,2024-07-01,Senate,"Placed on suspense file",7,0,0,0,7
1846144,1464105,2024-08-15,Senate,"Do pass as amended",4,0,0,3,7
1846144,1465707,2024-08-26,Senate,"Assembly 3rd Reading AB2427 McCarty et al. By Becker",31,4,0,5,40
1846144,1466776,2024-08-28,Assembly,"AB 2427 McCarty Concurrence in Senate Amendments",76,0,0,3,79
1846145,1423901,2024-04-09,Assembly,"Do pass and be re-referred to the Committee on [Appropriations]",16,0,0,0,16
1846145,1444044,2024-05-16,Assembly,"Do pass as amended",11,0,0,4,15
1846145,1446106,2024-05-21,Assembly,"AB 2428 Calderon Assembly Third Reading",73,0,0,7,80
1846145,1458526,2024-06-19,Senate,"Do pass, but first be re-referred to the Committee on [Appropriations] with the recommendation: To Consent Calendar",11,0,0,0,11
1846145,1462037,2024-07-01,Senate,"Placed on suspense file",7,0,0,0,7
1846145,1464380,2024-08-15,Senate,"Do pass as amended",7,0,0,0,7
1846145,1465324,2024-08-20,Senate,"Assembly 3rd Reading AB2428 Calderon et al. By Dodd",40,0,0,0,40
1846145,1465485,2024-08-22,Assembly,"AB 2428 Calderon Concurrence in Senate Amendments",63,0,0,16,79
1846146,1412581,2024-03-20,Assembly,"Do pass as amended",7,0,0,0,7
1846146,1442643,2024-05-13,Assembly,"AB 2429 Alvarez Assembly Third Reading",74,0,0,6,80
1846146,1454259,2024-06-05,Senate,"Do pass and be ordered to the Consent Calendar",7,0,0,0,7
1846146,1457356,2024-06-13,Senate,"Consent Calendar 2nd AB2429 Alvarez",37,0,0,3,40
1846147,1430028,2024-04-17,Assembly,"Do pass and be re-referred to the Committee on [Local Government]",9,0,0,0,9
1846147,1435300,2024-04-24,Assembly,"Do pass and be re-referred to the Committee on [Appropriations]",8,0,0,1,9
1846147,1441317,2024-05-08,Assembly,"Do pass. To Consent Calendar",15,0,0,0,15
1846147,1444244,2024-05-16,Assembly,"AB 2430 Alvarez Consent Calendar Second Day Regular Session",71,0,0,9,80
1846147,1458489,2024-06-18,Senate,"Do pass as amended, but first amend, and re-refer to the Committee on [Local Government] with the recommendation: To Consent Calendar",10,0,0,0,10
1846147,1460541,2024-06-26,Senate,"Do pass, but first be re-referred to the Committee on [Appropriations] with the recommendation: To Consent Calendar",7,0,0,0,7
1846147,1465933,2024-08-27,Senate,"Assembly 3rd Reading AB2430 Alvarez et al. By Caballero",40,0,0,0,40
1846147,1466784,2024-08-28,Assembly,"AB 2430 Alvarez Concurrence in Senate Amendments",76,0,0,3,79
1846149,1424914,2024-04-09,Assembly,"Do pass and be re-referred to the Committee on [Banking and Finance]",8,0,0,0,8
1846149,1427282,2024-04-15,Assembly,"Do pass and be re-referred to the Committee on [Appropriations]",8,0,0,1,9
1846149,1444672,2024-05-16,Assembly,"Do pass as amended",12,0,0,3,15
1846149,1449595,2024-05-23,Assembly,"AB 2432 Gabriel Assembly Third Reading",71,0,0,9,80
1846149,1459969,2024-06-25,Senate,"Do pass, but first be re-referred to the Committee on [Appropriations]",5,0,0,0,5
1846149,1465544,2024-08-26,Senate,"Assembly 3rd Reading AB2432 Gabriel et al. By Rubio",40,0,0,0,40
1846149,1465994,2024-08-27,Assembly,"AB 2432 Gabriel Concurrence in Senate Amendments",75,0,0,4,79
1846150,1425919,2024-04-10,Assembly,"Do pass as amended and be re-referred to the Committee on [Housing and Community Development]",8,0,0,1,9
1846150,1434105,2024-04-24,Assembly,"Do pass and be re-referred to the Committee on [Appropriations]",9,0,0,0,9
1846150,1443480,2024-05-15,Assembly,"Do pass",14,0,0,1,15
1846150,1446040,2024-05-21,Assembly,"AB 2433 Quirk-Silva Assembly Third Reading",67,0,0,13,80
1846151,1428866,2024-04-16,Assembly,"Do pass as amended, and be re-referred to the Committee on [Appropriations] with recommendation: To Consent Calendar",16,0,0,0,16
1846151,1441336,2024-05-08,Assembly,"Do pass. To Consent Calendar",15,0,0,0,15
1846151,1444287,2024-05-16,Assembly,"AB 2434 Grayson Consent Calendar Second Day Regular Session",71,0,0,9,80
1846151,1462634,2024-07-03,Senate,"Do pass as amended, but first amend, and re-refer to the Committee on [Appropriations] with the recommendation: To Consent Calendar",11,0,0,0,11
1846151,1463439,2024-08-05,Senate,"Placed on suspense file",7,0,0,0,7
1846151,1464520,2024-08-15,Senate,"Do pass",7,0,0,0,7
1846151,1466166,2024-08-29,Assembly,"AB 2434 Grayson Concurrence in Senate Amendments",76,0,0,3,79
1846151,1466794,2024-08-28,Senate,"Special Consent AB2434 Grayson et al. By Allen",39,0,0,1,40
1846152,1419199,2024-04-02,Assembly,"Do pass and be re-referred to the Committee on [Appropriations]",11,0,0,5,16
1846152,1424853,2024-04-10,Assembly,"Do pass",10,4,0,1,15
1846152,1431889,2024-04-22,Assembly,"AB 2435 Maienschein Assembly Third Reading",53,13,0,14,80
1846152,1451579,2024-05-29,Senate,"Do pass, but first be re-referred to the Committee on [Governmental Organization]",9,1,0,1,11
1846152,1456383,2024-06-11,Senate,"Do pass, but first be re-referred to the Committee on [Appropriations]",10,5,0,1,16
1846152,1465350,2024-08-20,Senate,"Assembly 3rd Reading AB2435 Maienschein By Padilla",32,8,0,0,40
1846153,1424934,2024-04-10,Assembly,"Do pass and be re-referred to the Committee on [Appropriations]",9,0,0,1,10
1846153,1444130,2024-05-16,Assembly,"Do pass",14,0,0,1,15
1846153,1448721,2024-05-22,Assembly,"AB 2436 Alanis Assembly Third Reading",71,0,0,9,80
1846153,1462277,2024-07-02,Senate,"Do pass, but first be re-referred to the Committee on [Appropriations]",4,0,0,1,5
1846153,1465494,2024-08-22,Senate,"Assembly 3rd Reading AB2436 Alanis By Grove",33,0,0,7,40
1846155,1424781,2024-04-09,Assembly,"Do pass and be re-referred to the Committee on [Appropriations]",3,0,0,5,8
1846156,1431043,2024-04-17,Assembly,"Do pass and be re-referred to the Committee on [Appropriations]",6,0,0,1,7
1846157,1411409,2024-03-19,Assembly,"Do pass and be re-referred to the Committee on [Water, Parks, and Wildlife]",11,0,0,0,11
1846157,1433019,2024-04-23,Assembly,"Do pass and be re-referred to the Committee on [Appropriations] with recommendation: To Consent Calendar",14,0,0,1,15
1846157,1444444,2024-05-16,Assembly,"Do pass",15,0,0,0,15
1846157,1448732,2024-05-22,Assembly,"AB 2440 Reyes Assembly Third Reading",72,0,0,8,80
1846157,1458016,2024-06-17,Senate,"Do pass, but first be re-referred to the Committee on [Appropriations]",6,0,0,5,11
1846157,1461978,2024-07-01,Senate,"Placed on suspense file",7,0,0,0,7
1846157,1464070,2024-08-15,Senate,"Do pass as amended",6,0,0,1,7
1846157,1465627,2024-08-26,Senate,"Assembly 3rd Reading AB2440 Reyes By Padilla",37,0,0,3,40
1846157,1465930,2024-08-27,Assembly,"AB 2440 Reyes Concurrence in Senate Amendments",77,0,0,2,79
1846158,1435323,2024-04-24,Assembly,"Do pass as amended and be re-referred to the Committee on [Appropriations]",5,2,0,0,7
1846158,1443469,2024-05-15,Assembly,"Do pass",9,4,0,2,15
1846158,1449724,2024-05-23,Assembly,"AB 2441 Kalra Assembly Third Reading",41,22,0,17,80
1846158,1462470,2024-07-03,Senate,"Do pass as amended, but first amend, and re-refer to the Committee on [Appropriations]",5,2,0,0,7
1846158,1466266,2024-08-29,Senate,"Assembly 3rd Reading AB2441 Kalra et al. By Bradford",20,14,0,6,40
1846158,1466267,2024-08-29,Senate,"Assembly 3rd Reading AB2441 Kalra et al. By Bradford Reconsider",40,0,0,0,40
1846159,1423803,2024-04-09,Assembly,"Do pass as amended and be re-referred to the Committee on [Appropriations]",13,1,0,4,18
1846159,1434111,2024-04-24,Assembly,"Do pass",11,4,0,0,15
1846159,1442534,2024-05-13,Assembly,"AB 2442 Zbur Assembly Third Reading",62,10,0,8,80
1846159,1452953,2024-06-03,Senate,"Do pass, but first be re-referred to the Committee on [Appropriations]",10,3,0,0,13
1846159,1465367,2024-08-20,Senate,"Assembly 3rd Reading AB2442 Zbur By Atkins",31,7,0,2,40
1846160,1433124,2024-04-23,Assembly,"Do pass as amended and be re-referred to the Committee on [Appropriations]",12,0,0,3,15
1846160,1441314,2024-05-08,Assembly,"Do pass. To Consent Calendar",15,0,0,0,15
1846160,1443902,2024-05-16,Assembly,"AB 2443 Juan Carrillo Consent Calendar Second Day Regular Session",71,0,0,9,80
1846160,1460673,2024-06-26,Senate,"Do pass, but first be re-referred to the Committee on [Local Government]",6,1,0,0,7
1846160,1462552,2024-07-03,Senate,"Do pass",5,2,0,0,7
1846160,1465348,2024-08-20,Senate,"Assembly 3rd Reading AB2443 Juan Carrillo By Glazer Urgency Clause",31,9,0,0,40
1846160,1466061,2024-08-28,Assembly,"With recommendation: That Senate amendments be concurred in",7,2,0,0,9
1846160,1466269,2024-08-29,Assembly,"AB 2443 Juan Carrillo Concurrence - Urgency Added",55,16,0,8,79
1846161,1423929,2024-04-09,Assembly,"Do pass and be re-referred to the Committee on [Labor and Employment]",13,5,0,0,18
1846161,1431010,2024-04-17,Assembly,"Do pass and be re-referred to the Committee on [Appropriations]",5,2,0,0,7
1846163,1419195,2024-04-02,Assembly,"Do pass as amended and be re-referred to the Committee on [Appropriations]",15,0,0,1,16
1846163,1444576,2024-05-16,Assembly,"Do pass as amended",11,0,0,4,15
1846163,1446048,2024-05-21,Assembly,"AB 2446 Ortega Assembly Third Reading",71,0,0,9,80
1846163,1460529,2024-06-26,Senate,"Do pass, but first be re-referred to the Committee on [Appropriations]",11,0,0,0,11
1846163,1463538,2024-08-05,Senate,"Placed on suspense file",7,0,0,0,7
1846163,1464415,2024-08-15,Senate,"Do pass as amended",7,0,0,0,7
1846163,1466310,2024-08-29,Assembly,"AB 2446 Ortega Concurrence in Senate Amendments",74,0,0,5,79
1846163,1466801,2024-08-28,Senate,"Assembly 3rd Reading AB2446 Ortega et al. By Blakespear",39,0,0,1,40
1846164,1432983,2024-04-23,Assembly,"Do pass as amended and be re-referred to the Committee on [Appropriations]",8,0,0,3,11
1846164,1441347,2024-05-08,Assembly,"Do pass",15,0,0,0,15
1846164,1445277,2024-05-20,Assembly,"AB 2447 Valencia Assembly Third Reading",70,0,0,10,80
1846164,1456862,2024-06-12,Senate,"Do pass as amended, but first amend, and re-refer to the Committee on [Appropriations]",5,1,0,1,7
1846164,1462077,2024-07-01,Senate,"Placed on suspense file",7,0,0,0,7
1846164,1464482,2024-08-15,Senate,"Do pass as amended",7,0,0,0,7
1846164,1466199,2024-08-29,Assembly,"AB 2447 Valencia Concurrence in Senate Amendments",74,0,0,5,79
1846164,1467210,2024-08-28,Senate,"Assembly 3rd Reading AB2447 Valencia By Durazo",35,1,0,4,40
1846165,1428787,2024-04-16,Assembly,"Do pass and be re-referred to the Committee on [Appropriations]",7,0,0,0,7
1846165,1444529,2024-05-16,Assembly,"Do pass as amended",11,0,0,4,15
1846165,1449537,2024-05-23,Assembly,"AB 2448 Jackson Assembly Third Reading",71,0,0,9,80
1846165,1458498,2024-06-19,Senate,"Do pass as amended, but first amend, and re-refer to the Committee on [Local Government]",5,0,0,0,5
1846165,1463389,2024-08-05,Senate,"Placed on suspense file",7,0,0,0,7
1846165,1464451,2024-08-15,Senate,"Do pass",6,1,0,0,7
1846165,1465751,2024-08-26,Senate,"Assembly 3rd Reading AB2448 Jackson By Roth",33,4,0,3,40
1846165,1465891,2024-08-27,Assembly,"AB 2448 Jackson Concurrence in Senate Amendments",75,0,0,4,79
1846166,1428775,2024-04-16,Assembly,"Do pass and be re-referred to the Committee on [Appropriations]",15,0,0,1,16
1846166,1435313,2024-04-25,Assembly,"AB 2449 Ta Assembly Third Reading",72,0,0,8,80
1846166,1451608,2024-05-29,Senate,"Do pass as amended",9,0,0,2,11
1846166,1457965,2024-06-17,Senate,"Placed on suspense file",7,0,0,0,7
1846167,1423857,2024-04-09,Assembly,"Do pass as amended and be re-referred to the Committee on [Appropriations]",14,0,0,1,15
1846169,1433129,2024-04-23,Assembly,"Do pass as amended and be re-referred to the Committee on [Appropriations]",5,0,0,2,7
1846169,1444624,2024-05-16,Assembly,"Do pass",12,1,0,2,15
1846169,1448539,2024-05-22,Assembly,"AB 2452 Quirk-Silva Assembly Third Reading",60,0,0,20,80
1846169,1462221,2024-07-01,Senate,"Do pass, but first be re-referred to the Committee on [Appropriations]",5,0,0,0,5
1846169,1463611,2024-08-05,Senate,"Placed on suspense file",7,0,0,0,7
1846170,1435246,2024-04-23,Assembly,"Do pass and be re-referred to the Committee on [Appropriations]",10,0,0,1,11
1846170,1441395,2024-05-08,Assembly,"Do pass. To Consent Calendar",15,0,0,0,15
1846170,1444083,2024-05-16,Assembly,"AB 2453 Villapudua Consent Calendar Second Day Regular Session",71,0,0,9,80
1846170,1462106,2024-07-01,Senate,"Do pass, but first be re-referred to the Committee on [Appropriations]",13,0,0,0,13
1846170,1466583,2024-08-30,Senate,"Assembly 3rd Reading AB2453 Villapudua By Becker",40,0,0,0,40
1846170,1467214,2024-08-31,Assembly,"AB 2453 Villapudua Concurrence in Senate Amendments",76,0,0,3,79
1846171,1435951,2024-04-23,Assembly,"Do pass and be re-referred to the Committee on [Appropriations]",5,0,0,2,7
1846171,1444357,2024-05-16,Assembly,"Do pass",11,1,0,3,15
1846171,1448720,2024-05-22,Assembly,"AB 2454 Lee Assembly Third Reading",59,0,0,21,80
1846171,1462536,2024-07-03,Senate,"Do pass, but first be re-referred to the Committee on [Appropriations]",5,0,0,2,7
1846171,1463359,2024-08-05,Senate,"Placed on suspense file",7,0,0,0,7
1846171,1464619,2024-08-15,Senate,"Do pass as amended",5,2,0,0,7
1846171,1466348,2024-08-29,Assembly,"AB 2454 Lee Concurrence in Senate Amendments",61,0,0,18,79
1846171,1466894,2024-08-28,Senate,"Assembly 3rd Reading AB2454 Lee By Allen",31,6,0,3,40
1846172,1423875,2024-04-09,Assembly,"Do pass and be re-referred to the Committee on [Public Employment and Retirement] with recommendation: To Consent Calendar",12,0,0,0,12
1846172,1429897,2024-04-17,Assembly,"Do pass and be re-referred to the Committee on [Appropriations] with recommendation: To Consent Calendar",7,0,0,0,7
1846172,1437644,2024-05-01,Assembly,"Do pass. To Consent Calendar",14,0,0,1,15
1846172,1441892,2024-05-09,Assembly,"AB 2455 Gabriel Consent Calendar Second Day Regular Session",65,0,0,15,80
1846172,1456426,2024-06-11,Senate,"Do pass as amended, but first amend, and re-refer to the Committee on [Local Government] with the recommendation: To Consent Calendar",11,0,0,0,11
1846172,1460751,2024-06-26,Senate,"Do pass as amended, but first amend, and re-refer to the Committee on [Appropriations] with the recommendation: To Consent Calendar",7,0,0,0,7
1846172,1463444,2024-08-05,Senate,"Placed on suspense file",7,0,0,0,7
1846172,1464573,2024-08-15,Senate,"Do pass as amended",7,0,0,0,7
1846172,1466398,2024-08-30,Senate,"Special Consent AB2455 Gabriel et al. By Blakespear",40,0,0,0,40
1846172,1466963,2024-08-31,Assembly,"AB 2455 Gabriel Concurrence in Senate Amendments",77,0,0,2,79
1846174,1418344,2024-04-01,Assembly,"Do pass as amended and be re-referred to the Committee on [Local Government]",8,0,0,1,9
1846174,1438483,2024-05-01,Assembly,"Do pass as amended",8,1,0,0,9
1846174,1445295,2024-05-20,Assembly,"AB 2457 McCarty Assembly Third Reading",67,1,0,12,80
1846174,1460473,2024-06-26,Senate,"Do pass",7,0,0,0,7
1846174,1465337,2024-08-20,Senate,"Assembly 3rd Reading AB2457 McCarty By Niello",40,0,0,0,40
1846175,1420199,2024-04-02,Assembly,"Do pass as amended and be re-referred to the Committee on [Appropriations]",11,0,0,0,11
1846175,1443994,2024-05-16,Assembly,"Do pass as amended",11,0,0,4,15
1846175,1446005,2024-05-21,Assembly,"AB 2458 Berman Assembly Third Reading",73,0,0,7,80
1846175,1456907,2024-06-12,Senate,"Do pass, but first be re-referred to the Committee on [Appropriations] with the recommendation: To Consent Calendar",7,0,0,0,7
1846175,1459403,2024-06-24,Senate,"Placed on suspense file",6,0,0,1,7
1846175,1464455,2024-08-15,Senate,"Do pass as amended",7,0,0,0,7
1846175,1466534,2024-08-30,Senate,"Special Consent AB2458 Berman et al. By Lim√≥n",40,0,0,0,40
1846175,1467056,2024-08-31,Assembly,"AB 2458 Berman Concurrence in Senate Amendments",77,0,0,2,79
1846176,1423716,2024-04-09,Assembly,"Do pass as amended and be re-referred to the Committee on [Judiciary]",6,0,0,1,7
1846176,1428984,2024-04-16,Assembly,"Do pass as amended, and be re-referred to the Committee on [Appropriations] with recommendation: To Consent Calendar",12,0,0,0,12
1846177,1424763,2024-04-10,Assembly,"Do pass as amended and be re-referred to the Committee on [Judiciary]",7,1,0,1,9
1846177,1436938,2024-04-30,Assembly,"Do pass as amended",12,0,0,0,12
1846177,1450011,2024-05-24,Assembly,"AB 2460 Ta Assembly Third Reading",58,1,0,21,80
1846177,1458538,2024-06-18,Senate,"Do pass, but first be re-referred to the Committee on [Judiciary]",10,0,0,0,10
1846177,1462638,2024-07-02,Senate,"Do pass",11,0,0,0,11
1846177,1467154,2024-08-31,Senate,"Assembly 3rd Reading AB2460 Ta By Umberg",40,0,0,0,40
1846177,1467155,2024-08-31,Assembly,"AB 2460 Ta Concurrence in Senate Amendments",69,1,0,9,79
1846179,1420043,2024-04-03,Assembly,"Do pass as amended, and be re-referred to the Committee on [Appropriations] with recommendation: To Consent Calendar",16,0,0,0,16
1846179,1444359,2024-05-16,Assembly,"Do pass",15,0,0,0,15
1846179,1449613,2024-05-23,Assembly,"AB 2462 Calderon Assembly Third Reading",72,0,0,8,80
1846179,1458255,2024-06-18,Senate,"Do pass as amended, but first amend, and re-refer to the Committee on [Appropriations]",18,0,0,0,18
1846179,1463481,2024-08-05,Senate,"Placed on suspense file",7,0,0,0,7
1846179,1464454,2024-08-15,Senate,"Do pass as amended",7,0,0,0,7
1846179,1466116,2024-08-29,Assembly,"AB 2462 Calderon Concurrence in Senate Amendments",76,0,0,3,79
1846179,1467176,2024-08-28,Senate,"Assembly 3rd Reading AB2462 Calderon et al. By Eggman",40,0,0,0,40
1846182,1423791,2024-04-08,Assembly,"Do pass as amended and be re-referred to the Committee on [Water, Parks, and Wildlife]",9,0,0,2,11
1846182,1432927,2024-04-23,Assembly,"Do pass and be re-referred to the Committee on [Appropriations]",11,1,0,3,15
1846182,1444678,2024-05-16,Assembly,"Do pass",11,4,0,0,15
1846182,1448668,2024-05-22,Assembly,"AB 2465 Gipson Assembly Third Reading",59,3,0,18,80
1846182,1458012,2024-06-17,Senate,"Do pass, but first be re-referred to the Committee on [Appropriations]",7,2,0,2,11
1846182,1462013,2024-07-01,Senate,"Placed on suspense file",7,0,0,0,7
1846182,1464500,2024-08-15,Senate,"Do pass as amended",5,2,0,0,7
1846182,1466185,2024-08-29,Senate,"Assembly 3rd Reading AB2465 Gipson et al. By Hurtado",31,9,0,0,40
1846183,1428847,2024-04-16,Assembly,"Do pass as amended and be re-referred to the Committee on [Appropriations]",13,0,0,3,16
1846184,1433004,2024-04-23,Assembly,"Do pass as amended and be re-referred to the Committee on [Appropriations]",16,0,0,0,16
1846184,1444391,2024-05-16,Assembly,"Do pass",15,0,0,0,15
1846184,1449655,2024-05-23,Assembly,"AB 2467 Bauer-Kahan Assembly Third Reading",70,0,0,10,80
1846184,1462454,2024-07-03,Senate,"Do pass, but first be re-referred to the Committee on [Appropriations]",9,0,0,2,11
1846184,1463506,2024-08-05,Senate,"Placed on suspense file",7,0,0,0,7
1846184,1464439,2024-08-15,Senate,"Do pass",5,0,0,2,7
1846184,1466369,2024-08-29,Senate,"Assembly 3rd Reading AB2467 Bauer-Kahan et al. By Eggman",34,1,0,5,40
1846184,1466593,2024-08-30,Assembly,"AB 2467 Bauer-Kahan Concurrence in Senate Amendments",76,0,0,3,79
1846186,1423906,2024-04-08,Assembly,"Do pass and be re-referred to the Committee on [Appropriations] with recommendation: To Consent Calendar",7,0,0,1,8
1846186,1444207,2024-05-16,Assembly,"Do pass",15,0,0,0,15
1846186,1448826,2024-05-22,Assembly,"AB 2469 Emergency Management Assembly Third Reading By RODRIGUEZ",72,0,0,8,80
1846186,1456399,2024-06-11,Senate,"Do pass, but first be re-referred to the Committee on [Natural Resources and Water] with the recommendation: To Consent Calendar",15,0,0,1,16
1846186,1460109,2024-06-25,Senate,"Do pass as amended, but first amend, and re-refer to the Committee on [Appropriations] with the recommendation: To Consent Calendar",11,0,0,0,11
1846186,1463634,2024-08-05,Senate,"Placed on suspense file",7,0,0,0,7
1846186,1464095,2024-08-15,Senate,"Do pass",7,0,0,0,7
1846186,1466378,2024-08-29,Assembly,"AB 2469 Emergency Management Concurrence in Senate Amendments",76,0,0,3,79
1846186,1466901,2024-08-28,Senate,"Special Consent AB2469 E.M. (Rodriguez)",39,0,0,1,40
1846188,1419145,2024-04-02,Assembly,"Do pass and be re-referred to the Committee on [Appropriations] with recommendation: To Consent Calendar",18,0,0,0,18
1846188,1444565,2024-05-16,Assembly,"Do pass",15,0,0,0,15
1846188,1448614,2024-05-22,Assembly,"AB 2471 Jim Patterson Assembly Third Reading",69,0,0,11,80
1846188,1455775,2024-06-10,Senate,"Do pass, but first be re-referred to the Committee on [Appropriations]",12,0,0,1,13
1846188,1459384,2024-06-24,Senate,"Placed on suspense file",6,0,0,1,7
1846188,1463999,2024-08-15,Senate,"Do pass as amended",7,0,0,0,7
1846188,1467208,2024-08-31,Senate,"Assembly 3rd Reading AB2471 Jim Patterson et al. By Niello",40,0,0,0,40
1846188,1467209,2024-08-31,Assembly,"AB 2471 Jim Patterson Concurrence in Senate Amendments",74,0,0,5,79
1846190,1435331,2024-04-24,Assembly,"Do pass as amended and be re-referred to the Committee on [Appropriations]",6,0,0,1,7
1846190,1444321,2024-05-16,Assembly,"Do pass",15,0,0,0,15
1846190,1448758,2024-05-22,Assembly,"AB 2473 Education Assembly Third Reading By MURATSUCHI",72,0,0,8,80
1846190,1462669,2024-07-03,Senate,"Do pass, but first be re-referred to the Committee on [Appropriations]",7,0,0,0,7
1846190,1463379,2024-08-05,Senate,"Placed on suspense file",7,0,0,0,7
1846190,1464384,2024-08-15,Senate,"Do pass as amended",7,0,0,0,7
1846190,1465986,2024-08-27,Senate,"Assembly 3rd Reading AB2473 ED. (Muratsuchi) By Newman Urgency Clause",40,0,0,0,40
1846190,1466658,2024-08-28,Assembly,"AB 2473 ED. Concurrence - Urgency Added By MURATSUCHI",77,0,0,2,79
1846191,1429937,2024-04-17,Assembly,"Do pass as amended. To Consent Calendar",7,0,0,0,7
1846191,1435339,2024-04-25,Assembly,"AB 2474 Lackey Consent Calendar Second Day Regular Session",75,0,0,5,80
1846191,1456936,2024-06-12,Senate,"Do pass as amended, and be ordered to the Consent Calendar",5,0,0,0,5
1846191,1458774,2024-06-20,Senate,"Consent Calendar 2nd AB2474 Lackey",36,0,0,4,40
1846191,1461227,2024-06-27,Assembly,"AB 2474 Lackey Concurrence in Senate Amendments",74,0,0,5,79
1846192,1411343,2024-03-19,Assembly,"Do pass as amended, and be re-referred to the Committee on [Appropriations] with recommendation: To Consent Calendar",8,0,0,0,8
1846192,1444628,2024-05-16,Assembly,"Do pass",15,0,0,0,15
1846192,1448829,2024-05-22,Assembly,"AB 2475 Haney Assembly Third Reading",72,0,0,8,80
1846192,1459977,2024-06-25,Senate,"Do pass, but first be re-referred to the Committee on [Appropriations] with the recommendation: To Consent Calendar",5,0,0,0,5
1846192,1463552,2024-08-05,Senate,"Placed on suspense file",7,0,0,0,7
1846192,1464196,2024-08-15,Senate,"Do pass",7,0,0,0,7
1846192,1466665,2024-08-28,Senate,"Special Consent AB2475 Haney By Wahab",39,0,0,1,40
1846193,1433116,2024-04-23,Assembly,"Do pass and be re-referred to the Committee on [Appropriations]",5,0,0,2,7
1846193,1444228,2024-05-16,Assembly,"Do pass as amended",11,0,0,4,15
1846193,1449696,2024-05-23,Assembly,"AB 2476 Bonta Assembly Third Reading",73,0,0,7,80
1846193,1462375,2024-07-01,Senate,"Do pass, but first be re-referred to the Committee on [Appropriations]",5,0,0,0,5
1846193,1463626,2024-08-05,Senate,"Placed on suspense file",7,0,0,0,7
1846194,1419208,2024-04-02,Assembly,"Do pass as amended and be re-referred to the Committee on [Appropriations]",7,0,0,0,7
1846194,1430025,2024-04-17,Assembly,"Do pass. To Consent Calendar",15,0,0,0,15
1846194,1435185,2024-04-25,Assembly,"AB 2477 Zbur Consent Calendar Second Day Regular Session",75,0,0,5,80
1846194,1453453,2024-06-03,Senate,"Do pass, but first be re-referred to the Committee on [Appropriations]",4,0,0,1,5
1846194,1465659,2024-08-26,Senate,"Assembly 3rd Reading AB2477 Zbur By Padilla",40,0,0,0,40
1846194,1465896,2024-08-27,Assembly,"AB 2477 Zbur Concurrence in Senate Amendments",77,0,0,2,79
1846195,1428833,2024-04-16,Assembly,"Do pass and be re-referred to the Committee on [Appropriations] with recommendation: To Consent Calendar",8,0,0,0,8
1846196,1434073,2024-04-24,Assembly,"Do pass as amended and be re-referred to the Committee on [Appropriations]",9,0,0,0,9
1846196,1444651,2024-05-16,Assembly,"Do pass",15,0,0,0,15
1846196,1448787,2024-05-22,Assembly,"AB 2479 Haney Assembly Third Reading",72,0,0,8,80
1846198,1436927,2024-04-30,Assembly,"Do pass as amended",6,0,0,5,11
1846198,1448617,2024-05-22,Assembly,"AB 2481 Lowenthal Assembly Third Reading",46,0,0,34,80
1846198,1462601,2024-07-02,Senate,"Do pass as amended",10,0,0,1,11
1846198,1466254,2024-08-29,Senate,"Assembly 3rd Reading AB2481 Lowenthal et al. By Stern",31,3,0,6,40
1846198,1467080,2024-08-31,Assembly,"AB 2481 Lowenthal Concurrence in Senate Amendments",58,0,0,21,79
1846199,1435265,2024-04-24,Assembly,"Do pass. To Consent Calendar",8,0,0,1,9
1846199,1438461,2024-05-02,Assembly,"AB 2482 Papan Consent Calendar Second Day Regular Session",73,0,0,7,80
1846200,1420196,2024-04-02,Assembly,"Do pass and be re-referred to the Committee on [Appropriations]",8,0,0,0,8
1846200,1444671,2024-05-16,Assembly,"Do pass as amended",11,0,0,4,15
1846200,1445977,2024-05-21,Assembly,"AB 2483 Ting Assembly Third Reading",64,0,0,16,80
1846200,1458166,2024-06-18,Senate,"Do pass, but first be re-referred to the Committee on [Appropriations]",4,0,0,1,5
1846200,1462021,2024-07-01,Senate,"Placed on suspense file",7,0,0,0,7
1846200,1464364,2024-08-15,Senate,"Do pass as amended",5,1,0,1,7
1846200,1466198,2024-08-29,Assembly,"AB 2483 Ting Concurrence in Senate Amendments",64,1,0,14,79
1846200,1466723,2024-08-28,Senate,"Assembly 3rd Reading AB2483 Ting By Skinner",26,9,0,5,40
1846201,1411378,2024-03-19,Assembly,"Do pass. To Consent Calendar",12,0,0,0,12
1846201,1438434,2024-04-01,Assembly,"AB 2484 Bryan Consent Calendar Second Day Regular Session",72,0,0,8,80
1846201,1453448,2024-06-04,Senate,"Do pass and be ordered to the Consent Calendar",11,0,0,0,11
1846201,1466244,2024-08-29,Senate,"Assembly 3rd Reading AB2484 Bryan By Becker",40,0,0,0,40
1846201,1466544,2024-08-30,Assembly,"AB 2484 Bryan Concurrence in Senate Amendments",77,0,0,2,79
1846202,1429925,2024-04-17,Assembly,"Do pass and be re-referred to the Committee on [Local Government]",8,0,0,1,9
1846202,1435330,2024-04-24,Assembly,"Do pass and be re-referred to the Committee on [Appropriations] with recommendation: To Consent Calendar",8,0,0,1,9
1846202,1443900,2024-05-16,Assembly,"Do pass",15,0,0,0,15
1846202,1448588,2024-05-22,Assembly,"AB 2485 Juan Carrillo Assembly Third Reading",72,0,0,8,80
1846202,1462702,2024-07-02,Senate,"Do pass as amended, but first amend, and re-refer to the Committee on [Appropriations]",9,0,0,1,10
1846202,1463523,2024-08-05,Senate,"Placed on suspense file",7,0,0,0,7
1846204,1421179,2024-04-03,Assembly,"Do pass and be re-referred to the Committee on [Utilities and Energy]",7,0,0,0,7
1846204,1430019,2024-04-17,Assembly,"Do pass and be re-referred to the Committee on [Appropriations]",15,0,0,1,16
1846205,1431057,2024-04-17,Assembly,"Do pass and be re-referred to the Committee on [Housing and Community Development]",9,0,0,0,9
1846205,1434174,2024-04-24,Assembly,"Do pass",8,0,0,1,9
1846205,1442551,2024-05-13,Assembly,"AB 2488 Ting Assembly Third Reading",71,1,0,8,80
1846205,1460666,2024-06-26,Senate,"Do pass, but first be re-referred to the Committee on [Housing]",5,1,0,1,7
1846205,1462440,2024-07-02,Senate,"Do pass as amended",7,2,0,1,10
1846205,1466179,2024-08-29,Assembly,"AB 2488 Ting Concurrence in Senate Amendments",72,0,0,7,79
1846205,1466737,2024-08-28,Senate,"Assembly 3rd Reading AB2488 Ting By Wiener",32,5,0,3,40
1846206,1430042,2024-04-17,Assembly,"Do pass and be re-referred to the Committee on [Judiciary]",4,2,0,1,7
1846206,1433084,2024-04-23,Assembly,"Do pass as amended and be re-referred to the Committee on [Appropriations]",8,2,0,2,12
1846207,1428895,2024-04-16,Assembly,"Do pass and be re-referred to the Committee on [Appropriations]",12,4,0,0,16
1846207,1444241,2024-05-16,Assembly,"Do pass",11,4,0,0,15
1846207,1448610,2024-05-22,Assembly,"AB 2490 Petrie-Norris Assembly Third Reading",59,12,0,9,80
1846207,1462448,2024-07-03,Senate,"Do pass as amended, but first amend, and re-refer to the Committee on [Appropriations]",9,2,0,0,11
1846207,1463396,2024-08-05,Senate,"Placed on suspense file",7,0,0,0,7
1846207,1464204,2024-08-15,Senate,"Do pass as amended",5,2,0,0,7
1846207,1466476,2024-08-30,Senate,"Assembly 3rd Reading AB2490 Petrie-Norris et al. By Lim√≥n",31,9,0,0,40
1846207,1466975,2024-08-31,Assembly,"AB 2490 Petrie-Norris Concurrence in Senate Amendments",61,13,0,5,79
1846208,1435936,2024-04-23,Assembly,"Do pass as amended and be re-referred to the Committee on [Appropriations]",4,2,0,1,7
1846209,1430005,2024-04-16,Assembly,"Do pass as amended and be re-referred to the Committee on [Appropriations]",11,0,0,0,11
1846209,1444238,2024-05-16,Assembly,"Do pass",15,0,0,0,15
1846209,1448544,2024-05-22,Assembly,"AB 2492 Irwin Assembly Third Reading",72,0,0,8,80
1846209,1458476,2024-06-19,Senate,"Do pass, but first be re-referred to the Committee on [Judiciary] with the recommendation: To Consent Calendar",7,0,0,0,7
1846209,1460628,2024-06-25,Senate,"Do pass, but first be re-referred to the Committee on [Appropriations]",11,0,0,0,11
1846209,1463605,2024-08-05,Senate,"Placed on suspense file",7,0,0,0,7
1846210,1411324,2024-03-19,Assembly,"Do pass",8,0,0,4,12
1846210,1445166,2024-05-20,Assembly,"AB 2493 Pellerin Assembly Third Reading",59,8,0,13,80
1846210,1458222,2024-06-18,Senate,"Do pass as amended",8,2,0,1,11
1846210,1465331,2024-08-20,Senate,"Assembly 3rd Reading AB2493 Pellerin et al. By Laird",29,8,0,3,40
1846210,1465605,2024-08-26,Assembly,"AB 2493 Pellerin Concurrence in Senate Amendments",60,10,0,9,79
1846211,1421174,2024-04-03,Assembly,"Do pass and be re-referred to the Committee on [Appropriations]",7,0,0,0,7
1846211,1444129,2024-05-16,Assembly,"Do pass as amended",11,0,0,4,15
1846211,1449663,2024-05-23,Assembly,"AB 2494 Calderon Assembly Third Reading",71,0,0,9,80
1846211,1462551,2024-07-03,Senate,"Do pass as amended, but first amend, and re-refer to the Committee on [Appropriations]",5,0,0,0,5
1846211,1463574,2024-08-05,Senate,"Placed on suspense file",7,0,0,0,7
1846213,1423723,2024-04-09,Assembly,"Do pass and be re-referred to the Committee on [Appropriations] with recommendation: To Consent Calendar",18,0,0,0,18
1846213,1434276,2024-04-24,Assembly,"Do pass. To Consent Calendar",14,0,0,1,15
1846213,1438442,2024-05-02,Assembly,"AB 2496 Low Consent Calendar Second Day Regular Session",73,0,0,7,80
1846213,1462452,2024-07-02,Senate,"Do pass as amended, but first amend, and re-refer to the Committee on [Appropriations]",11,0,0,0,11
1846213,1463840,2024-08-12,Senate,"Placed on suspense file",7,0,0,0,7
1846213,1464140,2024-08-15,Senate,"Do pass",7,0,0,0,7
1846213,1466030,2024-08-27,Senate,"That the measure be returned to Senate Floor for consideration. Ordered to third reading",5,0,0,0,5
1846213,1466390,2024-08-30,Assembly,"With recommendation: That Senate amendments be concurred in",7,0,0,0,7
1846213,1466391,2024-08-30,Senate,"Assembly 3rd Reading AB2496 Pellerin By Lim√≥n Urgency Clause",40,0,0,0,40
1846213,1466926,2024-08-31,Assembly,"AB 2496 Pellerin Concurrence - Urgency Added",77,0,0,2,79
1846215,1434053,2024-04-24,Assembly,"Do pass as amended and be re-referred to the Committee on [Appropriations]",7,0,0,2,9
1846215,1444427,2024-05-16,Assembly,"Do pass as amended",11,1,0,3,15
1846215,1446129,2024-05-21,Assembly,"AB 2498 Zbur Assembly Third Reading",58,8,0,14,80
1846215,1460083,2024-06-24,Senate,"Do pass, but first be re-referred to the Committee on [Appropriations]",8,1,0,1,10
1846215,1463921,2024-08-12,Senate,"Placed on suspense file",7,0,0,0,7
1846216,1421124,2024-04-03,Assembly,"Do pass and be re-referred to the Committee on [Judiciary]",5,0,0,2,7
1846216,1428924,2024-04-16,Assembly,"Do pass as amended and be re-referred to the Committee on [Appropriations]",7,2,0,3,12
1846216,1444100,2024-05-16,Assembly,"Do pass as amended",10,4,0,1,15
1846216,1449636,2024-05-23,Assembly,"AB 2499 Schiavo Assembly Third Reading",56,8,0,16,80
1846216,1458227,2024-06-18,Senate,"Do pass, but first be re-referred to the Committee on [Labor, Public Employment and Retirement ]",9,0,0,2,11
1846216,1462571,2024-07-03,Senate,"Do pass, but first be re-referred to the Committee on [Appropriations]",5,0,0,0,5
1846216,1463568,2024-08-05,Senate,"Placed on suspense file",7,0,0,0,7
1846216,1464059,2024-08-15,Senate,"Do pass as amended",5,2,0,0,7
1846216,1465802,2024-08-27,Senate,"Assembly 3rd Reading AB2499 Schiavo et al. By Wilk",32,7,0,1,40
1846216,1466655,2024-08-28,Assembly,"AB 2499 Schiavo Concurrence in Senate Amendments",60,11,0,8,79
1846217,1432933,2024-04-23,Assembly,"Do pass and be re-referred to the Committee on [Appropriations] with recommendation: To Consent Calendar",10,0,0,1,11
1846217,1444569,2024-05-16,Assembly,"Do pass as amended",11,0,0,4,15
1846217,1446096,2024-05-21,Assembly,"AB 2500 Mike Fong Assembly Third Reading",73,0,0,7,80
1846217,1462615,2024-07-03,Senate,"Do pass, but first be re-referred to the Committee on [Appropriations] with the recommendation: To Consent Calendar",7,0,0,0,7
1846217,1463651,2024-08-05,Senate,"Placed on suspense file",7,0,0,0,7
1846217,1464394,2024-08-15,Senate,"Do pass",7,0,0,0,7
1846217,1466622,2024-08-28,Senate,"Special Consent AB2500 Mike Fong By Lim√≥n",39,0,0,1,40
1846218,1411402,2024-03-19,Assembly,"Do pass and be re-referred to the Committee on [Appropriations]",7,0,0,0,7
1846218,1443965,2024-05-16,Assembly,"Do pass as amended",11,0,0,4,15
1846218,1449601,2024-05-23,Assembly,"AB 2501 Alvarez Assembly Third Reading",72,0,0,8,80
1846218,1458560,2024-06-19,Senate,"Do pass, but first be re-referred to the Committee on [Appropriations] with the recommendation: To Consent Calendar",7,0,0,0,7
1846218,1462022,2024-07-01,Senate,"Placed on suspense file",7,0,0,0,7
1846218,1464288,2024-08-15,Senate,"Do pass",7,0,0,0,7
1846218,1466633,2024-08-28,Senate,"Special Consent AB2501 Alvarez By Atkins",39,0,0,1,40
1846220,1423718,2024-04-08,Assembly,"Do pass as amended and be re-referred to the Committee on [Appropriations]",11,0,0,0,11
1846220,1434164,2024-04-24,Assembly,"Do pass. To Consent Calendar",14,0,0,1,15
1846220,1438418,2024-05-02,Assembly,"AB 2503 Lee Consent Calendar Second Day Regular Session",73,0,0,7,80
1846220,1454239,2024-06-05,Senate,"Do pass as amended, but first amend, and re-refer to the Committee on [Transportation]",5,0,0,2,7
1846220,1460791,2024-06-25,Senate,"Do pass as amended, but first amend, and re-refer to the Committee on [Appropriations]",10,3,0,2,15
1846220,1465322,2024-08-20,Senate,"Assembly 3rd Reading AB2503 Lee By Wiener",31,5,0,4,40
1846220,1465427,2024-08-22,Assembly,"AB 2503 Lee Concurrence in Senate Amendments",60,0,0,19,79
1846221,1411337,2024-03-19,Assembly,"Do pass",13,0,0,2,15
1846221,1422090,2024-04-08,Assembly,"AB 2504 Dixon Assembly Third Reading",72,0,0,8,80
1846221,1450965,2024-05-28,Senate,"Do pass",11,0,0,5,16
1846221,1465403,2024-08-21,Senate,"Assembly 3rd Reading AB2504 Dixon et al. By Nguyen",33,0,0,7,40
1846222,1419200,2024-04-02,Assembly,"Do pass as amended",10,1,0,1,12
1846222,1442575,2024-05-13,Assembly,"AB 2505 Gabriel Assembly Third Reading",62,4,0,14,80
1846222,1456316,2024-06-11,Senate,"Do pass as amended",9,2,0,0,11
1846222,1465381,2024-08-20,Senate,"Assembly 3rd Reading AB2505 Gabriel By Umberg",31,9,0,0,40
1846222,1465674,2024-08-26,Assembly,"AB 2505 Gabriel Concurrence in Senate Amendments",64,8,0,7,79
1846223,1434211,2024-04-24,Assembly,"Do pass and be re-referred to the Committee on [Revenue and Taxation]",9,0,0,0,9
1846224,1430052,2024-04-16,Assembly,"Do pass as amended and be re-referred to the Committee on [Appropriations]",11,0,0,0,11
1846224,1444596,2024-05-16,Assembly,"Do pass",14,1,0,0,15
1846224,1448609,2024-05-22,Assembly,"AB 2507 Friedman Assembly Third Reading",69,0,0,11,80
1846224,1460621,2024-06-26,Senate,"Do pass, but first be re-referred to the Committee on [Appropriations]",6,0,0,1,7
1846224,1463886,2024-08-12,Senate,"Placed on suspense file",7,0,0,0,7
1846225,1423806,2024-04-09,Assembly,"Do pass and be re-referred to the Committee on [Human Services] with recommendation: To Consent Calendar",11,0,0,0,11
1846225,1432947,2024-04-23,Assembly,"Do pass and be re-referred to the Committee on [Appropriations] with recommendation: To Consent Calendar",6,0,0,1,7
1846225,1444567,2024-05-16,Assembly,"Do pass",15,0,0,0,15
1846225,1448569,2024-05-22,Assembly,"AB 2508 McCarty Assembly Third Reading",72,0,0,8,80
1846225,1460533,2024-06-26,Senate,"Do pass, but first be re-referred to the Committee on [Human Services]",7,0,0,0,7
1846225,1462348,2024-07-01,Senate,"Do pass, but first be re-referred to the Committee on [Appropriations] with the recommendation: To Consent Calendar",5,0,0,0,5
1846225,1463350,2024-08-05,Senate,"Placed on suspense file",7,0,0,0,7
1846225,1464072,2024-08-15,Senate,"Do pass",6,0,0,1,7
1846225,1466017,2024-08-27,Senate,"Assembly 3rd Reading AB2508 McCarty et al. By Lim√≥n",40,0,0,0,40
1846225,1466332,2024-08-29,Assembly,"AB 2508 McCarty Concurrence in Senate Amendments",76,0,0,3,79
1846226,1434097,2024-04-24,Assembly,"Do pass and be re-referred to the Committee on [Appropriations]",9,0,0,1,10
1846226,1443948,2024-05-16,Assembly,"Do pass",15,0,0,0,15
1846226,1448604,2024-05-22,Assembly,"AB 2509 Kalra Assembly Third Reading",72,0,0,8,80
1846226,1458240,2024-06-18,Senate,"Do pass, but first be re-referred to the Committee on [Natural Resources and Water]",4,0,0,1,5
1846226,1459983,2024-06-25,Senate,"Do pass, but first be re-referred to the Committee on [Appropriations]",10,0,0,1,11
1846226,1463519,2024-08-05,Senate,"Placed on suspense file",7,0,0,0,7
1846226,1464405,2024-08-15,Senate,"Do pass as amended",7,0,0,0,7
1846226,1466536,2024-08-30,Senate,"Special Consent AB2509 Kalra By Stern",40,0,0,0,40
1846226,1466971,2024-08-31,Assembly,"AB 2509 Kalra Concurrence in Senate Amendments",77,0,0,2,79
1846227,1423903,2024-04-09,Assembly,"Do pass as amended and be re-referred to the Committee on [Higher Education]",6,0,0,1,7
1846227,1433067,2024-04-23,Assembly,"Do pass and be re-referred to the Committee on [Appropriations]",10,0,0,1,11
1846228,1411411,2024-03-19,Assembly,"Do pass and be re-referred to the Committee on [Appropriations] with recommendation: To Consent Calendar",11,0,0,0,11
1846228,1444021,2024-05-16,Assembly,"Do pass as amended",11,0,0,4,15
1846228,1445998,2024-05-21,Assembly,"AB 2511 Berman Assembly Third Reading",72,0,0,8,80
1846228,1458494,2024-06-19,Senate,"Do pass, but first be re-referred to the Committee on [Appropriations] with the recommendation: To Consent Calendar",7,0,0,0,7
1846228,1462078,2024-07-01,Senate,"Placed on suspense file",7,0,0,0,7
1846228,1464138,2024-08-15,Senate,"Do pass",7,0,0,0,7
1846228,1466668,2024-08-28,Senate,"Special Consent AB2511 Berman By Roth",39,0,0,1,40
1846230,1435937,2024-04-23,Assembly,"Do pass",5,2,0,0,7
1846230,1442646,2024-05-13,Assembly,"AB 2513 Pellerin Assembly Third Reading",57,14,0,9,80
1846230,1454201,2024-06-05,Senate,"Do pass as amended",5,2,0,0,7
1846230,1465332,2024-08-20,Senate,"Assembly 3rd Reading AB2513 Pellerin et al. By Stern",17,12,0,11,40
1846230,1465333,2024-08-20,Senate,"Assembly 3rd Reading AB2513 Pellerin et al. By Stern Reconsider",39,0,0,1,40
1846230,1466422,2024-08-30,Senate,"Assembly 3rd Reading AB2513 Pellerin et al. By Stern",21,11,0,8,40
1846230,1467021,2024-08-31,Assembly,"AB 2513 Pellerin Concurrence in Senate Amendments",52,15,0,12,79
1846231,1423769,2024-04-08,Assembly,"Do pass as amended and be re-referred to the Committee on [Appropriations]",9,0,0,2,11
1846231,1444143,2024-05-16,Assembly,"Do pass as amended",11,0,0,4,15
1846231,1446051,2024-05-21,Assembly,"AB 2514 Aguiar-Curry Assembly Third Reading",60,0,0,20,80
1846231,1462648,2024-07-03,Senate,"Do pass as amended, but first amend, and re-refer to the Committee on [Appropriations]",7,0,0,0,7
1846231,1463600,2024-08-05,Senate,"Placed on suspense file",7,0,0,0,7
1846231,1464630,2024-08-15,Senate,"Do pass as amended",7,0,0,0,7
1846232,1424807,2024-04-09,Assembly,"Do pass and be re-referred to the Committee on [Judiciary]",5,0,0,2,7
1846232,1428909,2024-04-16,Assembly,"Do pass and be re-referred to the Committee on [Appropriations]",10,1,0,1,12
1846232,1443936,2024-05-16,Assembly,"Do pass",11,1,0,3,15
1846232,1448766,2024-05-22,Assembly,"AB 2515 Papan Assembly Third Reading",61,1,0,18,80
1846232,1458471,2024-06-19,Senate,"Do pass, but first be re-referred to the Committee on [Judiciary]",5,0,0,2,7
1846232,1462507,2024-07-02,Senate,"Do pass, but first be re-referred to the Committee on [Appropriations]",10,0,0,1,11
1846232,1463862,2024-08-12,Senate,"Placed on suspense file",7,0,0,0,7
1846232,1464585,2024-08-15,Senate,"Do pass as amended",5,0,0,2,7
1846232,1466091,2024-08-29,Assembly,"AB 2515 Papan Concurrence in Senate Amendments",69,0,0,10,79
1846232,1466628,2024-08-28,Senate,"Assembly 3rd Reading AB2515 Papan By Skinner",33,0,0,7,40
1846233,1420104,2024-04-02,Assembly,"Do pass and be re-referred to the Committee on [Appropriations]",8,2,0,1,11
1846233,1430073,2024-04-17,Assembly,"Do pass",11,4,0,0,15
1846234,1428850,2024-04-16,Assembly,"Do pass as amended and be re-referred to the Committee on [Appropriations]",15,0,0,0,15
1846235,1433005,2024-04-23,Assembly,"Do pass and be re-referred to the Committee on [Appropriations]",7,0,0,1,8
1846235,1443907,2024-05-16,Assembly,"Do pass",14,0,0,1,15
1846235,1448628,2024-05-22,Assembly,"AB 2518 Davies Assembly Third Reading",61,0,0,19,80
1846235,1458192,2024-06-18,Senate,"Do pass, but first be re-referred to the Committee on [Appropriations]",3,0,0,2,5
1846235,1462045,2024-07-01,Senate,"Placed on suspense file",7,0,0,0,7
1846236,1433075,2024-04-23,Assembly,"Do pass and be re-referred to the Committee on [Appropriations]",8,0,0,0,8
1846236,1444050,2024-05-16,Assembly,"Do pass",15,0,0,0,15
1846236,1448749,2024-05-22,Assembly,"AB 2519 Maienschein Assembly Third Reading",71,0,0,9,80
1846236,1458268,2024-06-18,Senate,"Do pass, but first be re-referred to the Committee on [Appropriations]",5,0,0,0,5
1846236,1462049,2024-07-01,Senate,"Placed on suspense file",7,0,0,0,7
1846237,1412617,2024-03-20,Assembly,"Do pass as amended and be re-referred to the Committee on [Human Services]",9,0,0,0,9
1846237,1432926,2024-04-23,Assembly,"Do pass and be re-referred to the Committee on [Appropriations] with recommendation: To Consent Calendar",6,0,0,1,7
1846238,1432961,2024-04-23,Assembly,"Do pass. To Consent Calendar",8,0,0,0,8
1846238,1438464,2024-05-02,Assembly,"AB 2521 Waldron Consent Calendar Second Day Regular Session",73,0,0,7,80
1846238,1460039,2024-06-25,Senate,"Do pass and be ordered to the Consent Calendar",5,0,0,0,5
1846238,1461947,2024-07-01,Senate,"Consent Calendar 2nd AB2521 Waldron",40,0,0,0,40
1846239,1423770,2024-04-08,Assembly,"Do pass as amended. To Consent Calendar",10,0,0,1,11
1846239,1425914,2024-04-08,Assembly,"Do pass. To Consent Calendar",10,0,0,1,11
1846239,1430978,2024-04-18,Assembly,"AB 2522 Wendy Carrillo Consent Calendar Second Day Regular Session",72,0,0,8,80
1846239,1454245,2024-06-05,Senate,"Do pass, but first be re-referred to the Committee on [Local Government]",5,0,0,2,7
1846239,1460559,2024-06-26,Senate,"Do pass as amended",4,3,0,0,7
1846239,1465998,2024-08-27,Senate,"Assembly 3rd Reading AB2522 Wendy Carrillo By Stern",29,11,0,0,40
1846239,1466752,2024-08-28,Assembly,"AB 2522 Wendy Carrillo Concurrence in Senate Amendments",60,15,0,4,79
1846241,1436937,2024-04-29,Assembly,"Do pass as amended and be re-referred to the Committee on [Appropriations]",7,0,0,0,7
1846242,1422036,2024-04-08,Assembly,"Do pass and be re-referred to the Committee on [Appropriations]",11,4,0,0,15
1846242,1444164,2024-05-16,Assembly,"Do pass",11,4,0,0,15
1846242,1448745,2024-05-22,Assembly,"AB 2525 Zbur Assembly Third Reading",58,12,0,10,80
1846242,1460491,2024-06-25,Senate,"Do pass, but first be re-referred to the Committee on [Appropriations]",11,3,0,1,15
1846242,1463536,2024-08-05,Senate,"Placed on suspense file",7,0,0,0,7
1846242,1464391,2024-08-15,Senate,"Do pass",4,2,0,1,7
1846242,1465866,2024-08-27,Senate,"Assembly 3rd Reading AB2525 Zbur By Durazo",31,9,0,0,40
1846242,1466772,2024-08-28,Assembly,"AB 2525 Zbur Concurrence in Senate Amendments",61,16,0,2,79
1846243,1428791,2024-04-16,Assembly,"Do pass as amended and be re-referred to the Committee on [Appropriations]",12,3,0,3,18
1846244,1411374,2024-03-19,Assembly,"Do pass and be re-referred to the Committee on [Appropriations]",7,0,0,1,8
1846244,1443971,2024-05-16,Assembly,"Do pass as amended",11,2,0,2,15
1846244,1449570,2024-05-23,Assembly,"AB 2527 Bauer-Kahan Assembly Third Reading",63,2,0,15,80
1846244,1460019,2024-06-25,Senate,"Do pass, but first be re-referred to the Committee on [Appropriations]",4,0,0,1,5
1846244,1463411,2024-08-05,Senate,"Placed on suspense file",7,0,0,0,7
1846244,1464302,2024-08-15,Senate,"Do pass as amended",6,0,0,1,7
1846244,1465931,2024-08-27,Senate,"Assembly 3rd Reading AB2527 Bauer-Kahan et al. By Smallwood-Cuevas",38,0,0,2,40
1846244,1466811,2024-08-28,Assembly,"AB 2527 Bauer-Kahan Concurrence in Senate Amendments",67,0,0,12,79
1846245,1429935,2024-04-17,Assembly,"Do pass and be re-referred to the Committee on [Agriculture]",12,0,0,4,16
1846245,1434139,2024-04-24,Assembly,"Do pass as amended",6,0,0,4,10
1846248,1424855,2024-04-09,Assembly,"Do pass and be re-referred to the Committee on [Privacy and Consumer Protection] with recommendation: To Consent Calendar",8,0,0,0,8
1846248,1437584,2024-05-01,Assembly,"Do pass. To Consent Calendar",14,0,0,1,15
1846248,1445160,2024-05-20,Assembly,"AB 2531 Bryan Assembly Third Reading",73,0,0,7,80
1846248,1456394,2024-06-11,Senate,"Do pass, but first be re-referred to the Committee on [Appropriations] with the recommendation: To Consent Calendar",5,0,0,0,5
1846248,1461255,2024-06-27,Senate,"Consent Calendar 2nd AB2531 Bryan",40,0,0,0,40
1846248,1466319,2024-08-29,Assembly,"AB 2531 Bryan Concurrence in Senate Amendments",76,0,0,3,79
1846248,1466878,2024-08-28,Senate,"Assembly 3rd Reading AB2531 Bryan By Menjivar",39,0,0,1,40
1846249,1433173,2024-04-23,Assembly,"Do pass as amended and be re-referred to the Committee on [Appropriations]",10,0,0,1,11
1846249,1443913,2024-05-16,Assembly,"Do pass",15,0,0,0,15
1846249,1448730,2024-05-22,Assembly,"AB 2532 Mathis Assembly Third Reading",72,0,0,8,80
1846250,1430996,2024-04-17,Assembly,"Do pass and be re-referred to the Committee on [Housing and Community Development]",9,0,0,0,9
1846250,1434190,2024-04-24,Assembly,"Do pass and be re-referred to the Committee on [Appropriations] with recommendation: To Consent Calendar",9,0,0,0,9
1846250,1441355,2024-05-08,Assembly,"Do pass. To Consent Calendar",15,0,0,0,15
1846250,1444408,2024-05-16,Assembly,"AB 2533 Juan Carrillo Consent Calendar Second Day Regular Session",71,0,0,9,80
1846250,1458426,2024-06-18,Senate,"Do pass, but first be re-referred to the Committee on [Local Government] with the recommendation: To Consent Calendar",10,0,0,0,10
1846250,1462446,2024-07-03,Senate,"Do pass, but first be re-referred to the Committee on [Appropriations] with the recommendation: To Consent Calendar",7,0,0,0,7
1846250,1465771,2024-08-26,Senate,"Assembly 3rd Reading AB2533 Juan Carrillo et al. By Blakespear",39,0,0,1,40
1846250,1465792,2024-08-27,Assembly,"AB 2533 Juan Carrillo Concurrence in Senate Amendments",76,0,0,3,79
1846251,1421137,2024-04-03,Assembly,"Do pass and be re-referred to the Committee on [Appropriations] with recommendation: To Consent Calendar",7,0,0,0,7
1846251,1443923,2024-05-16,Assembly,"Do pass",15,0,0,0,15
1846251,1448811,2024-05-22,Assembly,"AB 2534 Flora Assembly Third Reading",72,0,0,8,80
1846251,1460564,2024-06-26,Senate,"Do pass, but first be re-referred to the Committee on [Appropriations] with the recommendation: To Consent Calendar",7,0,0,0,7
1846251,1463603,2024-08-05,Senate,"Placed on suspense file",7,0,0,0,7
1846251,1464345,2024-08-15,Senate,"Do pass as amended",7,0,0,0,7
1846251,1466564,2024-08-30,Senate,"Special Consent AB2534 Flora et al. By Jones",40,0,0,0,40
1846251,1467188,2024-08-31,Assembly,"AB 2534 Flora Concurrence in Senate Amendments",77,0,0,2,79
1846252,1431908,2024-04-22,Assembly,"Do pass as amended and be re-referred to the Committee on [Appropriations]",9,4,0,2,15
1846253,1422088,2024-04-08,Assembly,"Do pass. To Consent Calendar",15,0,0,0,15
1846253,1427252,2024-04-15,Assembly,"AB 2536 Hoover Assembly Third Reading",75,0,0,5,80
1846253,1451554,2024-05-28,Senate,"Do pass and be ordered to the Consent Calendar",12,0,0,3,15
1846253,1454834,2024-06-06,Senate,"Consent Calendar 2nd AB2536 Hoover",32,0,0,8,40
1846254,1431987,2024-04-22,Assembly,"Do pass and be re-referred to the Committee on [Utilities and Energy]",10,0,0,1,11
1846254,1434076,2024-04-24,Assembly,"Do pass as amended and be re-referred to the Committee on [Appropriations]",15,0,0,1,16
1846254,1444399,2024-05-16,Assembly,"Do pass",12,1,0,2,15
1846254,1448585,2024-05-22,Assembly,"AB 2537 Addis Assembly Third Reading",64,0,0,16,80
1846254,1459358,2024-06-24,Senate,"Do pass, but first be re-referred to the Committee on [Natural Resources and Water]",13,1,0,4,18
1846254,1460050,2024-06-25,Senate,"Do pass as amended, but first amend, and re-refer to the Committee on [Appropriations]",8,2,0,1,11
1846254,1463587,2024-08-05,Senate,"Placed on suspense file",7,0,0,0,7
1846254,1464638,2024-08-15,Senate,"Do pass as amended",5,2,0,0,7
1846254,1466189,2024-08-29,Assembly,"AB 2537 Addis Concurrence in Senate Amendments",66,0,0,13,79
1846254,1466698,2024-08-28,Senate,"Assembly 3rd Reading AB2537 Addis et al. By Lim√≥n",31,8,0,1,40
1846255,1420175,2024-04-03,Assembly,"Do pass and be re-referred to the Committee on [Appropriations] with recommendation: To Consent Calendar",7,0,0,0,7
1846255,1444308,2024-05-16,Assembly,"Do pass",15,0,0,0,15
1846255,1448774,2024-05-22,Assembly,"AB 2538 Grayson Assembly Third Reading",72,0,0,8,80
1846255,1458527,2024-06-19,Senate,"Do pass, but first be re-referred to the Committee on [Natural Resources and Water] with the recommendation: To Consent Calendar",5,0,0,0,5
1846255,1459956,2024-06-25,Senate,"Do pass as amended, but first amend, and re-refer to the Committee on [Appropriations] with the recommendation: To Consent Calendar",11,0,0,0,11
1846255,1463450,2024-08-05,Senate,"Placed on suspense file",7,0,0,0,7
1846255,1464120,2024-08-15,Senate,"Do pass",7,0,0,0,7
1846255,1466234,2024-08-29,Assembly,"AB 2538 Grayson Concurrence in Senate Amendments",76,0,0,3,79
1846255,1467230,2024-08-28,Senate,"Special Consent AB2538 Grayson By Laird",39,0,0,1,40
1846256,1424919,2024-04-10,Assembly,"Do pass and be re-referred to the Committee on [Judiciary]",5,2,0,2,9
1846256,1433093,2024-04-23,Assembly,"Do pass as amended and be re-referred to the Committee on [Appropriations]",7,2,0,3,12
1846257,1419180,2024-04-02,Assembly,"Do pass and be re-referred to the Committee on [Appropriations] with recommendation: To Consent Calendar",18,0,0,0,18
1846258,1411349,2024-03-19,Assembly,"Do pass and be re-referred to the Committee on [Appropriations] with recommendation: To Consent Calendar",8,0,0,0,8
1846258,1424890,2024-04-10,Assembly,"Do pass. To Consent Calendar",14,0,0,1,15
1846258,1431055,2024-04-18,Assembly,"AB 2541 Bains Consent Calendar Second Day Regular Session",72,0,0,8,80
1846258,1450966,2024-05-28,Senate,"Do pass, but first be re-referred to the Committee on [Appropriations] with the recommendation: To Consent Calendar",4,0,0,1,5
1846258,1457332,2024-06-13,Senate,"Consent Calendar 2nd AB2541 Bains",37,0,0,3,40
1846258,1465319,2024-08-20,Senate,"Assembly 3rd Reading AB2541 Bains By Lim√≥n",40,0,0,0,40
1846258,1465464,2024-08-22,Assembly,"AB 2541 Bains Concurrence in Senate Amendments",63,0,0,16,79
1846260,1428879,2024-04-16,Assembly,"Do pass and be re-referred to the Committee on [Appropriations]",7,0,0,0,7
1846260,1441374,2024-05-08,Assembly,"Do pass",11,4,0,0,15
1846260,1446109,2024-05-21,Assembly,"AB 2543 Arambula Assembly Third Reading",61,10,0,9,80
1846260,1456284,2024-06-11,Senate,"Do pass, but first be re-referred to the Committee on [Judiciary]",10,5,0,1,16
1846260,1460681,2024-06-25,Senate,"Do pass, but first be re-referred to the Committee on [Appropriations]",9,2,0,0,11
1846260,1465885,2024-08-27,Senate,"Assembly 3rd Reading AB2543 Arambula et al. By Rubio",30,9,0,1,40
1846260,1466839,2024-08-28,Assembly,"AB 2543 Arambula Concurrence in Senate Amendments",64,9,0,6,79
1846261,1423807,2024-04-09,Assembly,"Do pass and be re-referred to the Committee on [Public Safety]",6,0,0,1,7
1846261,1432940,2024-04-23,Assembly,"Do pass and be re-referred to the Committee on [Appropriations] with recommendation: To Consent Calendar",8,0,0,0,8
1846263,1411395,2024-03-19,Assembly,"Do pass",7,0,0,1,8
1846263,1438417,2024-04-01,Assembly,"AB 2546 Rendon Assembly Third Reading",58,6,0,16,80
1846263,1450959,2024-05-28,Senate,"Do pass",3,1,0,1,5
1846263,1465320,2024-08-20,Senate,"Assembly 3rd Reading AB2546 Rendon By Atkins",33,4,0,3,40
1846264,1395231,2024-02-26,Assembly,"Be adopted. To third reading",7,0,0,4,11
1846264,1425924,2024-04-11,Senate,"Special Consent ACR141 Ortega et al",39,0,0,1,40
1846265,1420035,2024-04-02,Senate,"Do pass and be ordered to the Consent Calendar",11,0,0,0,11
1846265,1425906,2024-04-11,Senate,"Consent Calendar 2nd SB1096 Seyarto et al",39,0,0,1,40
1846265,1453473,2024-06-04,Assembly,"Do pass. To Consent Calendar",8,0,0,4,12
1846265,1455799,2024-06-10,Assembly,"SB 1096 Seyarto Consent Calendar Second Day",63,0,0,16,79
1846266,1431851,2024-04-22,Senate,"Do pass, but first be re-referred to the Committee on [Judiciary]",4,0,0,1,5
1846266,1434062,2024-04-23,Senate,"Do pass, but first be re-referred to the Committee on [Appropriations]",10,0,0,1,11
1846266,1445161,2024-05-20,Senate,"Senate 3rd Reading SB1097 Laird",32,0,0,8,40
1846266,1455793,2024-06-10,Assembly,"Do pass and be re-referred to the Committee on [Appropriations]",9,0,0,1,10
1846266,1458427,2024-06-19,Assembly,"Do pass",13,0,0,2,15
1846266,1461224,2024-06-27,Assembly,"SB 1097 Laird Senate Third Reading By Schiavo",65,0,0,14,79
1846267,1424868,2024-04-09,Senate,"Do pass, but first be re-referred to the Committee on [Appropriations]",14,0,0,1,15
1846267,1431951,2024-04-22,Senate,"Placed on suspense file",7,0,0,0,7
1846267,1444530,2024-05-16,Senate,"Do pass as amended",7,0,0,0,7
1846267,1450032,2024-05-24,Senate,"Special Consent SB1098 Blakespear et al",38,0,0,2,40
1846267,1458358,2024-06-17,Assembly,"Do pass and be re-referred to the Committee on [Appropriations]",15,0,0,0,15
1846267,1464245,2024-08-15,Assembly,"Do pass as amended",11,0,0,4,15
1846267,1465585,2024-08-26,Assembly,"SB 1098 Blakespear Senate Third Reading By Hart",73,1,0,5,79
1846267,1467007,2024-08-28,Senate,"Special Consent SB1098 Blakespear et al",39,0,0,1,40
1846268,1431881,2024-04-22,Senate,"Do pass, but first be re-referred to the Committee on [Appropriations] with the recommendation: To Consent Calendar",11,0,0,0,11
1846268,1441917,2024-05-09,Senate,"Consent Calendar 2nd SB1099 Nguyen",37,0,0,3,40
1846268,1459993,2024-06-25,Assembly,"Do pass and be re-referred to the Committee on [Appropriations] with recommendation: To Consent Calendar",16,0,0,0,16
1846268,1463723,2024-08-07,Assembly,"Do pass",13,0,0,2,15
1846268,1465633,2024-08-26,Assembly,"SB 1099 Nguyen Senate Third Reading By Sanchez",76,0,0,3,79
1846268,1466921,2024-08-28,Senate,"Special Consent SB1099 Nguyen",39,0,0,1,40
1846269,1428941,2024-04-16,Senate,"Do pass, but first be re-referred to the Committee on [Labor, Public Employment and Retirement ] with the recommendation: To Consent Calendar",11,0,0,0,11
1846269,1434134,2024-04-24,Senate,"Do pass, but first be re-referred to the Committee on [Appropriations]",5,0,0,0,5
1846269,1442656,2024-05-13,Senate,"Placed on suspense file",7,0,0,0,7
1846269,1444195,2024-05-16,Senate,"Do pass as amended",7,0,0,0,7
1846269,1450016,2024-05-24,Senate,"Special Consent SB1100 Portantino",38,0,0,2,40
1846269,1458540,2024-06-19,Assembly,"Do pass and be re-referred to the Committee on [Judiciary]",7,0,0,0,7
1846269,1462218,2024-07-02,Assembly,"Do pass and be re-referred to the Committee on [Appropriations]",10,1,0,1,12
1846269,1464569,2024-08-15,Assembly,"Do pass as amended",11,1,0,3,15
1846269,1466330,2024-08-29,Senate,"Unfinished Business SB1100 Portantino Concurrence",40,0,0,0,40
1846269,1466871,2024-08-28,Assembly,"SB 1100 Portantino Senate Third Reading By Bryan",73,2,0,4,79
1846270,1423899,2024-04-09,Senate,"Do pass, but first be re-referred to the Committee on [Governmental Organization]",11,0,0,0,11
1846270,1433161,2024-04-23,Senate,"Do pass, but first be re-referred to the Committee on [Appropriations] with the recommendation: To Consent Calendar",16,0,0,0,16
1846270,1439655,2024-05-06,Senate,"Placed on suspense file",7,0,0,0,7
1846270,1443983,2024-05-16,Senate,"Do pass as amended",7,0,0,0,7
1846270,1450006,2024-05-24,Senate,"Special Consent SB1101 Lim√≥n",38,0,0,2,40
1846270,1457996,2024-06-17,Assembly,"Do pass and be re-referred to the Committee on [Emergency Management] with recommendation: To Consent Calendar",10,0,0,1,11
1846270,1460017,2024-06-24,Assembly,"Do pass and be re-referred to the Committee on [Appropriations] with recommendation: To Consent Calendar",8,0,0,0,8
1846270,1464581,2024-08-15,Assembly,"Do pass",14,0,0,1,15
1846270,1465629,2024-08-26,Assembly,"SB 1101 Lim√≥n Senate Third Reading By Flora",77,0,0,2,79
1846270,1467072,2024-08-28,Senate,"Special Consent SB1101 Lim√≥n",39,0,0,1,40
1846271,1424840,2024-04-10,Senate,"Do pass as amended, but first amend, and re-refer to the Committee on [Appropriations] with the recommendation: To Consent Calendar",6,0,0,1,7
1846271,1431873,2024-04-22,Senate,"Placed on suspense file",7,0,0,0,7
1846272,1437608,2024-04-30,Senate,"Do pass as amended",9,2,0,0,11
1846272,1450316,2024-05-21,Senate,"Senate 3rd Reading SB1103 Menjivar",22,10,0,8,40
1846272,1459946,2024-06-25,Assembly,"Do pass as amended",7,2,0,3,12
1846272,1466575,2024-08-30,Assembly,"SB 1103 Menjivar Senate Third Reading By Lee",44,17,0,18,79
1846272,1466992,2024-08-31,Senate,"Unfinished Business SB1103 Menjivar et al. Concurrence",22,9,0,9,40
1846273,1423758,2024-04-09,Senate,"Do pass as amended, but first amend, and re-refer to the Committee on [Appropriations]",14,0,0,2,16
1846273,1431859,2024-04-22,Senate,"Placed on suspense file",7,0,0,0,7
1846274,1424943,2024-04-10,Senate,"Do pass, but first be re-referred to the Committee on [Appropriations]",5,0,0,0,5
1846274,1436181,2024-04-29,Senate,"Placed on suspense file",5,0,0,2,7
1846274,1444088,2024-05-16,Senate,"Do pass",5,2,0,0,7
1846274,1445186,2024-05-20,Senate,"Senate 3rd Reading SB1105 Padilla",34,3,0,3,40
1846274,1462259,2024-07-02,Assembly,"Do pass and be re-referred to the Committee on [Appropriations]",7,0,0,0,7
1846274,1464144,2024-08-15,Assembly,"Do pass as amended",11,0,0,4,15
1846274,1466291,2024-08-29,Assembly,"SB 1105 Padilla Senate Third Reading By Garcia",72,0,0,7,79
1846274,1466426,2024-08-30,Senate,"Unfinished Business SB1105 Padilla Concurrence",37,2,0,1,40
1846275,1437632,2024-04-30,Senate,"Do pass as amended",11,0,0,0,11
1846275,1445145,2024-05-20,Senate,"Senate 3rd Reading SB1106 Rubio",39,0,0,1,40
1846275,1460060,2024-06-25,Assembly,"Do pass. To Consent Calendar",11,0,0,1,12
1846275,1462053,2024-07-01,Assembly,"SB 1106 Rubio Consent Calendar Second Day Regular Session",72,0,0,7,79
1846275,1463807,2024-08-08,Assembly,"SB 1106 Rubio Senate Third Reading By Low",73,0,0,6,79
1846275,1464219,2024-08-15,Senate,"Special Consent SB1106 Rubio",37,0,0,3,40
1846276,1419179,2024-04-01,Senate,"Do pass as amended, but first amend, and re-refer to the Committee on [Governmental Organization]",5,0,0,0,5
1846276,1433102,2024-04-23,Senate,"Do pass, but first be re-referred to the Committee on [Appropriations]",16,0,0,0,16
1846276,1439718,2024-05-06,Senate,"Placed on suspense file",7,0,0,0,7
1846277,1412560,2024-03-19,Senate,"Do pass as amended, but first amend, and re-refer to the Committee on [Judiciary]",10,0,0,0,10
1846277,1423810,2024-04-09,Senate,"Do pass as amended, but first amend, and re-refer to the Committee on [Appropriations] with the recommendation: To Consent Calendar",11,0,0,0,11
1846277,1436179,2024-04-29,Senate,"Placed on suspense file",5,0,0,2,7
1846277,1444297,2024-05-16,Senate,"Do pass",7,0,0,0,7
1846277,1449659,2024-05-23,Senate,"Special Consent SB1108 Ochoa Bogh",37,0,0,3,40
1846277,1460596,2024-06-26,Assembly,"Do pass and be re-referred to the Committee on [Appropriations] with recommendation: To Consent Calendar",9,0,0,0,9
1846277,1464080,2024-08-15,Assembly,"Do pass as amended",11,0,0,4,15
1846277,1466421,2024-08-30,Assembly,"SB 1108 Ochoa Bogh Senate Third Reading By Wallis",76,0,0,3,79
1846277,1466950,2024-08-31,Senate,"Unfinished Business SB1108 Ochoa Bogh Concurrence",40,0,0,0,40
1846278,1427360,2024-04-15,Senate,"Do pass, but first be re-referred to the Committee on [Judiciary]",11,0,0,2,13
1846278,1434255,2024-04-23,Senate,"Do pass, but first be re-referred to the Committee on [Appropriations]",10,1,0,0,11
1846278,1442535,2024-05-13,Senate,"Placed on suspense file",7,0,0,0,7
1846278,1444032,2024-05-16,Senate,"Do pass as amended",5,2,0,0,7
1846278,1448675,2024-05-22,Senate,"Senate 3rd Reading SB1109 Bradford",31,2,0,7,40
1846278,1456384,2024-06-11,Assembly,"Do pass and be re-referred to the Committee on [Judiciary]",17,0,0,1,18
1846278,1460013,2024-06-25,Assembly,"Do pass and be re-referred to the Committee on [Appropriations]",11,0,0,1,12
1846278,1463717,2024-08-07,Assembly,"Do pass",13,0,0,2,15
1846278,1465913,2024-08-27,Assembly,"SB 1109 Bradford Senate Third Reading By Kalra",75,0,0,4,79
1846279,1433007,2024-04-23,Senate,"Do pass as amended, but first amend, and re-refer to the Committee on [Appropriations]",11,0,0,0,11
1846279,1445223,2024-05-20,Senate,"Senate 3rd Reading SB1110 Ashby",39,0,0,1,40
1846279,1459951,2024-06-25,Assembly,"Do pass as amended and be re-referred to the Committee on [Appropriations]",12,0,0,3,15
1846280,1429923,2024-04-17,Senate,"Do pass, but first be re-referred to the Committee on [Elections and Constitutional Amendments]",6,0,0,1,7
1846280,1433198,2024-04-22,Senate,"Do pass, but first be re-referred to the Committee on [Appropriations] with the recommendation: To Consent Calendar",6,0,0,1,7
1846280,1439660,2024-05-06,Senate,"Placed on suspense file",7,0,0,0,7
1846280,1444137,2024-05-16,Senate,"Do pass",7,0,0,0,7
1846280,1449662,2024-05-23,Senate,"Special Consent SB1111 Min",37,0,0,3,40
1846280,1460743,2024-06-26,Assembly,"Do pass as amended and be re-referred to the Committee on [Appropriations]",6,0,0,3,9
1846280,1460744,2024-06-26,Assembly,"Do pass and be re-referred to the Committee on [Local Government]",8,0,0,0,8
1846280,1463725,2024-08-07,Assembly,"Do pass. To Consent Calendar",14,0,0,1,15
1846280,1464275,2024-08-15,Assembly,"SB 1111 Min Consent Calendar Second Day Regular Session",75,0,0,4,79
1846280,1465431,2024-08-22,Senate,"Special Consent SB1111 Min",33,0,0,7,40
1846281,1412526,2024-03-20,Senate,"Do pass as amended, but first amend, and re-refer to the Committee on [Human Services] with the recommendation: To Consent Calendar",11,0,0,0,11
1846281,1428976,2024-04-15,Senate,"Do pass, but first be re-referred to the Committee on [Appropriations] with the recommendation: To Consent Calendar",5,0,0,0,5
1846281,1436241,2024-04-29,Senate,"Placed on suspense file",5,0,0,2,7
1846281,1444264,2024-05-16,Senate,"Do pass as amended",7,0,0,0,7
1846281,1450022,2024-05-24,Senate,"Special Consent SB1112 Menjivar et al",38,0,0,2,40
1846281,1456352,2024-06-11,Assembly,"Do pass and be re-referred to the Committee on [Human Services] with recommendation: To Consent Calendar",16,0,0,0,16
1846281,1460025,2024-06-25,Assembly,"Do pass and be re-referred to the Committee on [Appropriations] with recommendation: To Consent Calendar",6,0,0,1,7
1846281,1464480,2024-08-15,Assembly,"Do pass as amended",11,0,0,4,15
1846281,1466221,2024-08-29,Assembly,"SB 1112 Menjivar Senate Third Reading By Stephanie Nguyen",76,0,0,3,79
1846281,1466529,2024-08-30,Senate,"Unfinished Business SB1112 Menjivar et al. Concurrence",40,0,0,0,40
1846282,1412521,2024-03-20,Senate,"Do pass as amended, but first amend, and re-refer to the Committee on [Appropriations]",6,0,0,1,7
1846282,1427302,2024-04-15,Senate,"Placed on suspense file",6,0,0,1,7
1846282,1444085,2024-05-16,Senate,"Do pass",7,0,0,0,7
1846282,1449649,2024-05-23,Senate,"Special Consent SB1113 Newman et al",37,0,0,3,40
1846282,1457937,2024-06-17,Assembly,"Do pass and be re-referred to the Committee on [Appropriations]",10,0,0,1,11
1846282,1462367,2024-07-02,Assembly,"Do pass. To Consent Calendar",15,0,0,0,15
1846282,1463797,2024-08-08,Assembly,"SB 1113 Newman Consent Calendar Second Day Regular Session",72,0,0,7,79
1846283,1433003,2024-04-23,Senate,"Do pass as amended, but first amend, and re-refer to the Committee on [Appropriations]",15,0,0,1,16
1846283,1442636,2024-05-13,Senate,"Placed on suspense file",7,0,0,0,7
1846284,1434242,2024-04-24,Senate,"Do pass, but first be re-referred to the Committee on [Appropriations]",7,0,0,0,7
1846284,1439624,2024-05-06,Senate,"Placed on suspense file",7,0,0,0,7
1846285,1434215,2024-04-24,Senate,"Do pass, but first be re-referred to the Committee on [Appropriations]",4,1,0,0,5
1846285,1439620,2024-05-06,Senate,"Placed on suspense file",7,0,0,0,7
1846285,1444316,2024-05-16,Senate,"Do pass",5,2,0,0,7
1846285,1450276,2024-05-21,Senate,"Senate 3rd Reading SB1116 Portantino et al",22,12,0,6,40
1846285,1461217,2024-06-26,Assembly,"Do pass and be re-referred to the Committee on [Appropriations]",6,2,0,7,15
1846286,1419151,2024-04-02,Senate,"Do pass, but first be re-referred to the Committee on [Judiciary] with the recommendation: To Consent Calendar",3,0,0,2,5
1846286,1419152,2024-04-02,Senate,"[04-02-2024] set for [First] hearing: Reconsideration of favorable vote granted",4,0,0,1,5
1846286,1419153,2024-04-02,Senate,"Do pass, but first be re-referred to the Committee on [Judiciary] with the recommendation: To Consent Calendar",4,0,0,1,5
1846286,1428783,2024-04-16,Senate,"Do pass, but first be re-referred to the Committee on [Appropriations] with the recommendation: To Consent Calendar",11,0,0,0,11
1846286,1438431,2024-05-02,Senate,"Consent Calendar 2nd SB1117 Laird",38,0,0,2,40
1846286,1460538,2024-06-26,Assembly,"Do pass and be re-referred to the Committee on [Appropriations] with recommendation: To Consent Calendar",8,0,0,2,10
1846286,1463730,2024-08-07,Assembly,"Do pass. To Consent Calendar",14,0,0,1,15
1846286,1464620,2024-08-15,Assembly,"SB 1117 Laird Consent Calendar Second Day Regular Session",75,0,0,4,79
1846286,1465489,2024-08-22,Senate,"Special Consent SB1117 Laird",33,0,0,7,40
1846287,1428950,2024-04-16,Senate,"Do pass as amended, but first amend, and re-refer to the Committee on [Appropriations]",15,2,0,1,18
1846287,1439745,2024-05-06,Senate,"Placed on suspense file",7,0,0,0,7
1846287,1444434,2024-05-16,Senate,"Do pass",5,1,0,1,7
1846287,1450381,2024-05-21,Senate,"Senate 3rd Reading SB1118 Eggman",33,3,0,4,40
1846287,1458499,2024-06-19,Assembly,"Do pass and be re-referred to the Committee on [Appropriations]",15,0,0,1,16
1846287,1464422,2024-08-15,Assembly,"Do pass",14,0,0,1,15
1846287,1465686,2024-08-26,Assembly,"SB 1118 Eggman Senate Third Reading By Soria",74,0,0,5,79
1846288,1420086,2024-04-03,Senate,"Do pass, but first be re-referred to the Committee on [Appropriations]",9,0,0,2,11
1846288,1427365,2024-04-15,Senate,"Placed on suspense file",6,0,0,1,7
1846288,1444327,2024-05-16,Senate,"Do pass",7,0,0,0,7
1846288,1450310,2024-05-21,Senate,"Senate 3rd Reading SB1119 Newman et al. Urgency Clause",39,0,0,1,40
1846288,1456350,2024-06-11,Assembly,"Do pass and be re-referred to the Committee on [Appropriations]",15,0,0,1,16
1846288,1463995,2024-08-15,Assembly,"Do pass as amended",11,0,0,4,15
1846288,1465631,2024-08-26,Assembly,"SB 1119 Newman Third Reading Urgency By Quirk-Silva",73,0,0,6,79
1846288,1467002,2024-08-28,Senate,"Special Consent SB1119 Newman et al. Urgency Clause",39,0,0,1,40
1846289,1424962,2024-04-10,Senate,"Do pass as amended, but first amend, and re-refer to the Committee on [Appropriations]",11,0,0,0,11
1846289,1431918,2024-04-22,Senate,"Placed on suspense file",7,0,0,0,7
1846289,1443958,2024-05-16,Senate,"Do pass",7,0,0,0,7
1846289,1449671,2024-05-23,Senate,"Special Consent SB1120 Becker",37,0,0,3,40
1846289,1458277,2024-06-18,Assembly,"Do pass as amended and be re-referred to the Committee on [Privacy and Consumer Protection]",16,0,0,0,16
1846289,1462493,2024-07-02,Assembly,"Do pass as amended, and be re-referred to the Committee on [Appropriations] with recommendation: To Consent Calendar",11,0,0,0,11
1846289,1464328,2024-08-15,Assembly,"Do pass",14,0,0,1,15
1846289,1466402,2024-08-30,Assembly,"SB 1120 Becker Senate Third Reading By Reyes",76,0,0,3,79
1846289,1466934,2024-08-31,Senate,"Unfinished Business SB1120 Becker et al. Concurrence",40,0,0,0,40
1846291,1419167,2024-04-02,Senate,"Do pass and be ordered to the Consent Calendar",5,0,0,0,5
1846291,1422066,2024-04-08,Senate,"Consent Calendar 2nd SB1122 Seyarto",37,0,0,3,40
1846291,1453457,2024-06-04,Assembly,"Do pass. To Consent Calendar",7,0,0,1,8
1846291,1455768,2024-06-10,Assembly,"SB 1122 Seyarto Consent Calendar Second Day Regular Session",63,0,0,16,79
1846292,1420152,2024-04-02,Senate,"Do pass, but first be re-referred to the Committee on [Local Government]",8,0,0,2,10
1846292,1430032,2024-04-17,Senate,"Do pass as amended, but first amend, and re-refer to the Committee on [Appropriations]",5,0,0,2,7
1846292,1439642,2024-05-06,Senate,"Placed on suspense file",7,0,0,0,7
1846292,1444120,2024-05-16,Senate,"Do pass",5,1,0,1,7
1846292,1445215,2024-05-20,Senate,"Senate 3rd Reading SB1123 Caballero",31,5,0,4,40
1846292,1456910,2024-06-12,Assembly,"Do pass as amended and be re-referred to the Committee on [Local Government]",7,1,0,1,9
1846292,1460490,2024-06-26,Assembly,"Do pass as amended and be re-referred to the Committee on [Appropriations]",6,0,0,3,9
1846292,1464549,2024-08-15,Assembly,"Do pass as amended",11,3,0,1,15
1846292,1466149,2024-08-29,Senate,"Unfinished Business SB1123 Caballero Concurrence",32,6,0,2,40
1846292,1466645,2024-08-28,Assembly,"SB 1123 Caballero Senate Third Reading By Juan Carrillo",56,11,0,12,79
1846293,1423920,2024-04-09,Senate,"Do pass, but first be re-referred to the Committee on [Military and Veterans Affairs]",10,1,0,0,11
1846293,1431938,2024-04-22,Senate,"Do pass, but first be re-referred to the Committee on [Appropriations]",3,0,0,2,5
1846293,1442635,2024-05-13,Senate,"Placed on suspense file",7,0,0,0,7
1846295,1423849,2024-04-09,Senate,"Do pass",4,0,0,1,5
1846296,1420056,2024-04-02,Senate,"Do pass and be ordered to the Consent Calendar",11,0,0,0,11
1846296,1425891,2024-04-11,Senate,"Consent Calendar 2nd SB1127 Niello",39,0,0,1,40
1846296,1453401,2024-06-04,Assembly,"Do pass. To Consent Calendar",8,0,0,4,12
1846296,1455779,2024-06-10,Assembly,"SB 1127 Niello Consent Calendar Second Day Regular Session",63,0,0,16,79
1846296,1458803,2024-06-20,Senate,"Special Consent SB1127 Niello",36,0,0,4,40
1846297,1423936,2024-04-09,Senate,"Do pass as amended, but first amend, and re-refer to the Committee on [Appropriations]",3,1,0,1,5
1846297,1442653,2024-05-13,Senate,"Placed on suspense file",7,0,0,0,7
1846297,1444065,2024-05-16,Senate,"Do pass",7,0,0,0,7
1846297,1448657,2024-05-22,Senate,"Senate 3rd Reading SB1128 Portantino et al",34,3,0,3,40
1846297,1462668,2024-07-02,Assembly,"Do pass and be re-referred to the Committee on [Appropriations]",7,0,0,1,8
1846299,1411327,2024-03-19,Senate,"Do pass, but first be re-referred to the Committee on [Appropriations]",15,0,0,3,18
1846299,1422081,2024-04-08,Senate,"Placed on suspense file",6,0,0,1,7
1846299,1443959,2024-05-16,Senate,"Do pass",5,2,0,0,7
1846299,1445276,2024-05-20,Senate,"Senate 3rd Reading SB1130 Bradford",35,3,0,2,40
1846299,1458465,2024-06-19,Assembly,"Do pass and be re-referred to the Committee on [Appropriations]",15,0,0,1,16
1846299,1464409,2024-08-15,Assembly,"Do pass",12,0,0,3,15
1846299,1465685,2024-08-26,Assembly,"SB 1130 Bradford Senate Third Reading By Garcia",71,0,0,8,79
1846299,1466922,2024-08-28,Senate,"Unfinished Business SB1130 Bradford Concurrence",35,3,0,2,40
1846300,1420054,2024-04-03,Senate,"Do pass as amended, but first amend, and re-refer to the Committee on [Appropriations]",8,0,0,3,11
1846300,1427305,2024-04-15,Senate,"Placed on suspense file",6,0,0,1,7
1846300,1444167,2024-05-16,Senate,"Do pass as amended",5,2,0,0,7
1846300,1450270,2024-05-21,Senate,"Senate 3rd Reading SB1131 Gonzalez et al",31,8,0,1,40
1846300,1453398,2024-06-04,Assembly,"Do pass and be re-referred to the Committee on [Appropriations]",12,2,0,2,16
1846300,1464052,2024-08-15,Assembly,"Do pass",11,3,0,1,15
1846300,1465681,2024-08-26,Assembly,"SB 1131 Gonzalez Senate Third Reading By Schiavo",62,10,0,7,79
1846300,1465844,2024-08-27,Senate,"Unfinished Business SB1131 Gonzalez et al. Concurrence",31,9,0,0,40
1846301,1420157,2024-04-03,Senate,"Do pass, but first be re-referred to the Committee on [Public Safety]",8,1,0,2,11
1846301,1433143,2024-04-23,Senate,"Do pass",5,0,0,0,5
1846301,1445298,2024-05-20,Senate,"Senate 3rd Reading SB1132 Durazo et al",36,0,0,4,40
1846301,1453396,2024-06-04,Assembly,"Do pass and be re-referred to the Committee on [Public Safety]",15,0,0,1,16
1846301,1462514,2024-07-02,Assembly,"Do pass",8,0,0,0,8
1846301,1463794,2024-08-08,Assembly,"SB 1132 Durazo Senate Third Reading By Gipson",70,0,0,9,79
1846302,1428870,2024-04-16,Senate,"Do pass as amended, but first amend, and re-refer to the Committee on [Appropriations]",4,1,0,0,5
1846302,1439723,2024-05-06,Senate,"Placed on suspense file",7,0,0,0,7
1846302,1444409,2024-05-16,Senate,"Do pass as amended",5,2,0,0,7
1846302,1450340,2024-05-21,Senate,"Senate 3rd Reading SB1133 Becker",28,9,0,3,40
1846302,1462688,2024-07-02,Assembly,"Do pass",5,2,0,1,8
1846302,1465791,2024-08-27,Assembly,"SB 1133 Becker Senate Third Reading By McKinnor",43,25,0,11,79
1846303,1437585,2024-05-01,Senate,"Do pass",6,0,0,1,7
1846303,1445247,2024-05-20,Senate,"Senate 3rd Reading SB1134 Caballero",39,0,0,1,40
1846303,1458558,2024-06-19,Assembly,"Do pass and be re-referred to the Committee on [Appropriations]",9,0,0,0,9
1846303,1464339,2024-08-15,Assembly,"Do pass as amended",11,0,0,4,15
1846304,1423786,2024-04-09,Senate,"Do pass as amended, but first amend, and re-refer to the Committee on [Revenue and Taxation]",11,0,0,0,11
1846304,1434210,2024-04-24,Senate,"Do pass as amended, but first amend, and re-refer to the Committee on [Appropriations]",7,0,0,0,7
1846304,1442593,2024-05-13,Senate,"Placed on suspense file",7,0,0,0,7
1846305,1412551,2024-03-20,Senate,"Do pass, but first be re-referred to the Committee on [Appropriations]",6,0,0,1,7
1846305,1444048,2024-05-16,Senate,"Senate 3rd Reading SB1136 Stern et al",34,0,0,6,40
1846305,1457935,2024-06-17,Assembly,"Do pass and be re-referred to the Committee on [Appropriations] with recommendation: To Consent Calendar",10,0,0,1,11
1846305,1462241,2024-07-02,Assembly,"Do pass. To Consent Calendar",15,0,0,0,15
1846305,1463817,2024-08-08,Assembly,"SB 1136 Stern Consent Calendar Second Day Regular Session",72,0,0,7,79
1846307,1427311,2024-04-15,Senate,"Be adopted. Ordered to third reading",8,0,0,3,11
1846307,1454840,2024-06-06,Senate,"Senate 3rd Reading SJR12 Min",29,2,0,9,40
1846307,1462063,2024-07-01,Assembly,"Be adopted. To third reading",9,3,0,0,12
1846307,1464291,2024-08-15,Assembly,"SJR 12 Min Senate Third Reading By Hart",57,11,0,11,79
1847296,1428912,2024-04-16,Assembly,"Do pass and be re-referred to the Committee on [Appropriations]",2,0,0,6,8
1847297,1435345,2024-04-24,Assembly,"Do pass as amended and be re-referred to the Committee on [Appropriations]",3,2,0,2,7
1847298,1423840,2024-04-09,Assembly,"Do pass and be re-referred to the Committee on [Human Services] with recommendation: To Consent Calendar",16,0,0,0,16
1847298,1444232,2024-05-16,Assembly,"Do pass as amended",11,0,0,4,15
1847298,1446136,2024-05-21,Assembly,"AB 2549 Gallagher Assembly Third Reading",66,0,0,14,80
1847298,1458531,2024-06-19,Senate,"Do pass as amended, but first amend, and re-refer to the Committee on [Appropriations] with the recommendation: To Consent Calendar",11,0,0,0,11
1847298,1462096,2024-07-01,Senate,"Placed on suspense file",7,0,0,0,7
1847298,1464526,2024-08-15,Senate,"Do pass",7,0,0,0,7
1847298,1466168,2024-08-29,Assembly,"AB 2549 Gallagher Concurrence in Senate Amendments",75,0,0,4,79
1847298,1466736,2024-08-28,Senate,"Assembly 3rd Reading AB2549 Gallagher et al. By Dahle",39,0,0,1,40
1847299,1423765,2024-04-09,Assembly,"Do pass and be re-referred to the Committee on [Business and Professions]",16,0,0,0,16
1847299,1433036,2024-04-23,Assembly,"Do pass as amended and be re-referred to the Committee on [Appropriations]",17,0,0,1,18
1847299,1444258,2024-05-16,Assembly,"Do pass",15,0,0,0,15
1847299,1448685,2024-05-22,Assembly,"AB 2550 Gabriel Assembly Third Reading",70,0,0,10,80
1847299,1458510,2024-06-19,Senate,"Do pass, but first be re-referred to the Committee on [Housing] with the recommendation: To Consent Calendar",11,0,0,0,11
1847299,1462610,2024-07-02,Senate,"Do pass, but first be re-referred to the Committee on [Appropriations] with the recommendation: To Consent Calendar",10,0,0,0,10
1847299,1463556,2024-08-05,Senate,"Placed on suspense file",7,0,0,0,7
1847301,1424920,2024-04-09,Assembly,"Do pass and be re-referred to the Committee on [Water, Parks, and Wildlife]",4,2,0,1,7
1847301,1428949,2024-04-16,Assembly,"Do pass as amended and be re-referred to the Committee on [Judiciary]",8,4,0,3,15
1847301,1432971,2024-04-23,Assembly,"Do pass as amended and be re-referred to the Committee on [Appropriations]",9,2,0,1,12
1847301,1444094,2024-05-16,Assembly,"Do pass",10,4,0,1,15
1847301,1449580,2024-05-23,Assembly,"AB 2552 Friedman Assembly Third Reading",48,14,0,18,80
1847301,1458462,2024-06-19,Senate,"Do pass, but first be re-referred to the Committee on [Natural Resources and Water]",4,3,0,0,7
1847301,1460089,2024-06-25,Senate,"Do pass as amended, but first amend, and re-refer to the Committee on [Appropriations]",9,2,0,0,11
1847301,1463830,2024-08-12,Senate,"Placed on suspense file",7,0,0,0,7
1847301,1464514,2024-08-15,Senate,"Do pass as amended",5,1,0,1,7
1847301,1466247,2024-08-29,Assembly,"AB 2552 Friedman Concurrence in Senate Amendments",49,16,0,14,79
1847301,1466730,2024-08-28,Senate,"Assembly 3rd Reading AB2552 Friedman By Allen",28,11,0,1,40
1847302,1425903,2024-04-10,Assembly,"Do pass as amended and be re-referred to the Committee on [Housing and Community Development]",9,0,0,0,9
1847302,1434096,2024-04-24,Assembly,"Do pass. To Consent Calendar",9,0,0,0,9
1847302,1438433,2024-05-02,Assembly,"AB 2553 Friedman Consent Calendar Second Day Regular Session",73,0,0,7,80
1847302,1456375,2024-06-11,Senate,"Do pass as amended, but first amend, and re-refer to the Committee on [Housing]",5,1,0,1,7
1847302,1462660,2024-07-02,Senate,"Do pass",8,1,0,1,10
1847302,1465353,2024-08-20,Senate,"Assembly 3rd Reading AB2553 Friedman By Padilla",34,4,0,2,40
1847302,1465439,2024-08-22,Assembly,"AB 2553 Friedman Concurrence in Senate Amendments",61,0,0,18,79
1847304,1436948,2024-04-29,Assembly,"Do pass and be re-referred to the Committee on [Appropriations]",7,0,0,0,7
1847304,1444531,2024-05-16,Assembly,"Do pass",15,0,0,0,15
1847304,1448711,2024-05-22,Assembly,"AB 2555 Quirk-Silva Assembly Third Reading",72,0,0,8,80
1847304,1460720,2024-06-26,Senate,"Do pass, but first be re-referred to the Committee on [Appropriations]",7,0,0,0,7
1847304,1463548,2024-08-05,Senate,"Placed on suspense file",7,0,0,0,7
1847304,1464186,2024-08-15,Senate,"Do pass",7,0,0,0,7
1847304,1466643,2024-08-28,Senate,"Special Consent AB2555 Quirk-Silva",39,0,0,1,40
1847305,1419185,2024-04-02,Assembly,"Do pass as amended and be re-referred to the Committee on [Appropriations]",15,0,0,1,16
1847305,1434181,2024-04-24,Assembly,"Do pass. To Consent Calendar",14,0,0,1,15
1847305,1438419,2024-05-02,Assembly,"AB 2556 Jackson Consent Calendar Second Day Regular Session",73,0,0,7,80
1847305,1454274,2024-06-05,Senate,"Do pass as amended, but first amend, and re-refer to the Committee on [Appropriations] with the recommendation: To Consent Calendar",11,0,0,0,11
1847305,1458824,2024-06-20,Senate,"Consent Calendar 2nd AB2556 Jackson et al",36,0,0,4,40
1847305,1463811,2024-08-08,Assembly,"AB 2556 Jackson Concurrence in Senate Amendments",71,0,0,8,79
1847306,1429910,2024-04-17,Assembly,"Do pass and be re-referred to the Committee on [Judiciary]",4,2,0,1,7
1847306,1433009,2024-04-23,Assembly,"Do pass as amended and be re-referred to the Committee on [Appropriations]",8,2,0,2,12
1847306,1444632,2024-05-16,Assembly,"Do pass as amended",11,4,0,0,15
1847306,1445931,2024-05-21,Assembly,"AB 2557 Ortega Assembly Third Reading",51,16,0,13,80
1847306,1456447,2024-06-11,Senate,"Do pass as amended, but first amend, and re-refer to the Committee on [Labor, Public Employment and Retirement ]",4,3,0,0,7
1847306,1462542,2024-07-03,Senate,"Do pass as amended, but first amend, and re-refer to the Committee on [Appropriations]",3,2,0,0,5
1847306,1463682,2024-08-05,Senate,"Placed on suspense file",7,0,0,0,7
1847307,1418367,2024-04-01,Assembly,"Do pass and be re-referred to the Committee on [Water, Parks, and Wildlife]",12,0,0,3,15
1847307,1433145,2024-04-23,Assembly,"Do pass and be re-referred to the Committee on [Appropriations]",11,2,0,2,15
1847308,1425930,2024-04-10,Assembly,"Do pass and be re-referred to the Committee on [Jobs, Economic Development, and the Economy]",9,0,0,0,9
1847308,1428985,2024-04-16,Assembly,"Do pass and be re-referred to the Committee on [Appropriations] with recommendation: To Consent Calendar",7,0,0,0,7
1847308,1444084,2024-05-16,Assembly,"Do pass as amended",11,0,0,4,15
1847308,1449683,2024-05-23,Assembly,"AB 2559 Petrie-Norris Assembly Third Reading",73,0,0,7,80
1847308,1462097,2024-07-01,Senate,"Do pass, but first be re-referred to the Committee on [Appropriations]",13,0,0,0,13
1847308,1463498,2024-08-05,Senate,"Placed on suspense file",7,0,0,0,7
1847309,1424993,2024-04-10,Assembly,"Do pass and be re-referred to the Committee on [Natural Resources]",8,0,0,1,9
1847309,1431964,2024-04-22,Assembly,"Do pass as amended",7,1,0,3,11
1847309,1445222,2024-05-20,Assembly,"AB 2560 Alvarez Assembly Third Reading",55,6,0,19,80
1847309,1458469,2024-06-18,Senate,"Do pass, but first be re-referred to the Committee on [Natural Resources and Water]",8,1,0,1,10
1847309,1460010,2024-06-25,Senate,"Do pass as amended, but first amend, and re-refer to the Committee on [Appropriations]",11,0,0,0,11
1847309,1463922,2024-08-12,Senate,"Placed on suspense file",7,0,0,0,7
1847310,1430016,2024-04-17,Assembly,"Do pass and be re-referred to the Committee on [Appropriations]",5,1,0,1,7
1847310,1444673,2024-05-16,Assembly,"Do pass",11,2,0,2,15
1847310,1448782,2024-05-22,Assembly,"AB 2561 McKinnor Assembly Third Reading",51,5,0,24,80
1847310,1462605,2024-07-03,Senate,"Do pass as amended, but first amend, and re-refer to the Committee on [Appropriations]",4,1,0,0,5
1847310,1463397,2024-08-05,Senate,"Placed on suspense file",7,0,0,0,7
1847310,1464191,2024-08-15,Senate,"Do pass as amended",5,2,0,0,7
1847310,1467135,2024-08-31,Senate,"Assembly 3rd Reading AB2561 McKinnor By Smallwood-Cuevas",27,10,0,3,40
1847310,1467136,2024-08-31,Assembly,"AB 2561 McKinnor Concurrence in Senate Amendments Move The Previous Question By BAUER-KAHAN",53,10,0,16,79
1847310,1467137,2024-08-31,Assembly,"AB 2561 McKinnor Concurrence in Senate Amendments",57,6,0,16,79
1847312,1432988,2024-04-23,Assembly,"Do pass and be re-referred to the Committee on [Appropriations] with recommendation: To Consent Calendar",16,0,0,0,16
1847313,1433022,2024-04-22,Assembly,"Do pass and be re-referred to the Committee on [Appropriations]",7,0,0,0,7
1847313,1444688,2024-05-16,Assembly,"Do pass",15,0,0,0,15
1847313,1448717,2024-05-22,Assembly,"AB 2564 Boerner Assembly Third Reading",72,0,0,8,80
1847313,1460705,2024-06-26,Senate,"Do pass, but first be re-referred to the Committee on [Appropriations] with the recommendation: To Consent Calendar",7,0,0,0,7
1847313,1463637,2024-08-05,Senate,"Placed on suspense file",7,0,0,0,7
1847313,1464506,2024-08-15,Senate,"Do pass",7,0,0,0,7
1847313,1466617,2024-08-28,Senate,"Special Consent AB2564 Boerner By Ashby",39,0,0,1,40
1847314,1412506,2024-03-20,Assembly,"Do pass as amended and be re-referred to the Committee on [Appropriations]",6,0,0,1,7
1847314,1444676,2024-05-16,Assembly,"Do pass as amended",11,0,0,4,15
1847314,1449658,2024-05-23,Assembly,"AB 2565 McCarty Assembly Third Reading",73,0,0,7,80
1847314,1458478,2024-06-19,Senate,"Do pass, but first be re-referred to the Committee on [Appropriations]",7,0,0,0,7
1847314,1462054,2024-07-01,Senate,"Placed on suspense file",7,0,0,0,7
1847314,1464632,2024-08-15,Senate,"Do pass as amended",6,0,0,1,7
1847314,1465927,2024-08-27,Senate,"Assembly 3rd Reading AB2565 McCarty By Newman",40,0,0,0,40
1847314,1466230,2024-08-29,Assembly,"AB 2565 McCarty Concurrence in Senate Amendments",75,0,0,4,79
1847315,1428794,2024-04-16,Assembly,"Do pass as amended and be re-referred to the Committee on [Appropriations]",17,0,0,1,18
1847315,1444101,2024-05-16,Assembly,"Do pass",15,0,0,0,15
1847315,1449617,2024-05-23,Assembly,"AB 2566 Wilson Assembly Third Reading",72,0,0,8,80
1847316,1423930,2024-04-09,Assembly,"Do pass and be re-referred to the Committee on [Military and Veterans Affairs] with recommendation: To Consent Calendar",11,0,0,0,11
1847316,1433062,2024-04-23,Assembly,"Do pass and be re-referred to the Committee on [Appropriations]",9,0,0,1,10
1847316,1441356,2024-05-08,Assembly,"Do pass. To Consent Calendar",15,0,0,0,15
1847316,1444478,2024-05-16,Assembly,"AB 2567 Mathis Consent Calendar Second Day Regular Session",71,0,0,9,80
1847316,1454222,2024-06-05,Senate,"Do pass, but first be re-referred to the Committee on [Military and Veterans Affairs] with the recommendation: To Consent Calendar",7,0,0,0,7
1847316,1459996,2024-06-24,Senate,"Do pass, but first be re-referred to the Committee on [Appropriations] with the recommendation: To Consent Calendar",5,0,0,0,5
1847316,1463901,2024-08-12,Senate,"Consent Calendar 2nd AB2567 Mathis et al",38,0,0,2,40
1847319,1434228,2024-04-24,Assembly,"Do pass and be re-referred to the Committee on [Appropriations] with recommendation: To Consent Calendar",9,0,0,0,9
1847319,1441295,2024-05-08,Assembly,"Do pass as amended. To Consent Calendar",15,0,0,0,15
1847319,1444657,2024-05-16,Assembly,"AB 2570 Joe Patterson Consent Calendar Second Day Regular Session",71,0,0,9,80
1847319,1453390,2024-06-04,Senate,"Do pass, but first be re-referred to the Committee on [Appropriations] with the recommendation: To Consent Calendar",9,0,0,1,10
1847319,1458799,2024-06-20,Senate,"Consent Calendar 2nd AB2570 Joe Patterson",36,0,0,4,40
1847320,1424886,2024-04-10,Assembly,"Do pass and be re-referred to the Committee on [Higher Education]",6,0,0,1,7
1847321,1431948,2024-04-22,Assembly,"Do pass as amended, and be re-referred to the Committee on [Appropriations] with recommendation: To Consent Calendar",11,0,0,0,11
1847322,1429944,2024-04-17,Assembly,"Do pass",7,0,0,0,7
1847322,1442566,2024-05-13,Assembly,"AB 2573 Mike Fong Assembly Third Reading",74,0,0,6,80
1847322,1462538,2024-07-03,Senate,"Do pass and be ordered to the Consent Calendar",5,0,0,0,5
1847322,1463916,2024-08-12,Senate,"Consent Calendar 2nd AB2573 Mike Fong et al",38,0,0,2,40
1847322,1465293,2024-08-19,Assembly,"AB 2573 Mike Fong Concurrence in Senate Amendments",75,0,0,4,79
1847323,1433053,2024-04-23,Assembly,"Do pass as amended",16,0,0,0,16
1847323,1443501,2024-05-15,Assembly,"Do pass. To Consent Calendar",15,0,0,0,15
1847323,1446010,2024-05-21,Assembly,"AB 2574 Valencia Consent Calendar Second Day Regular Session",71,0,0,9,80
1847323,1456871,2024-06-12,Senate,"Do pass, but first be re-referred to the Committee on [Appropriations] with the recommendation: To Consent Calendar",10,0,0,1,11
1847323,1466183,2024-08-29,Assembly,"AB 2574 Valencia Concurrence in Senate Amendments",75,0,0,4,79
1847323,1466664,2024-08-28,Senate,"Assembly 3rd Reading AB2574 Valencia et al. By Lim√≥n",39,0,0,1,40
1847324,1434148,2024-04-24,Assembly,"Do pass and be re-referred to the Committee on [Appropriations]",9,0,0,2,11
1847325,1434057,2024-04-24,Assembly,"Do pass and be re-referred to the Committee on [Appropriations]",8,0,0,0,8
1847326,1411329,2024-03-19,Assembly,"Do pass and be re-referred to the Committee on [Appropriations]",8,3,0,0,11
1847327,1428975,2024-04-16,Assembly,"Do pass and be re-referred to the Committee on [Appropriations]",18,0,0,0,18
1847327,1444114,2024-05-16,Assembly,"Do pass",15,0,0,0,15
1847327,1448796,2024-05-22,Assembly,"AB 2578 Flora Assembly Third Reading",71,0,0,9,80
1847327,1462009,2024-07-01,Senate,"Do pass, but first be re-referred to the Committee on [Appropriations]",12,1,0,0,13
1847327,1463537,2024-08-05,Senate,"Placed on suspense file",7,0,0,0,7
1847328,1434138,2024-04-24,Assembly,"Do pass. To Consent Calendar",9,0,0,0,9
1847328,1438455,2024-05-02,Assembly,"AB 2579 Quirk-Silva Consent Calendar Second Day Regular Session",73,0,0,7,80
1847328,1459955,2024-06-24,Senate,"Do pass as amended, but first amend, and re-refer to the Committee on [Business, Professions and Economic Development]",10,0,0,0,10
1847328,1462071,2024-07-01,Senate,"Do pass as amended",13,0,0,0,13
1847328,1465292,2024-08-19,Senate,"Assembly 3rd Reading AB2579 Quirk-Silva By Menjivar",40,0,0,0,40
1847328,1465440,2024-08-22,Assembly,"AB 2579 Quirk-Silva Concurrence in Senate Amendments",62,0,0,17,79
1847329,1424793,2024-04-10,Assembly,"Do pass as amended and be re-referred to the Committee on [Local Government]",8,0,0,1,9
1847329,1435198,2024-04-24,Assembly,"Do pass and be re-referred to the Committee on [Appropriations]",8,0,0,1,9
1847329,1443463,2024-05-15,Assembly,"Do pass. To Consent Calendar",15,0,0,0,15
1847329,1445994,2024-05-21,Assembly,"AB 2580 Wicks Consent Calendar Second Day Regular Session",71,0,0,9,80
1847329,1458402,2024-06-18,Senate,"Do pass, but first be re-referred to the Committee on [Appropriations]",10,0,0,0,10
1847329,1466343,2024-08-29,Senate,"Assembly 3rd Reading AB2580 Wicks et al. By Blakespear",38,2,0,0,40
1847329,1466411,2024-08-30,Assembly,"AB 2580 Wicks Concurrence in Senate Amendments",76,0,0,3,79
1847330,1423937,2024-04-09,Assembly,"Do pass as amended and be re-referred to the Committee on [Appropriations]",18,0,0,0,18
1847330,1434080,2024-04-24,Assembly,"Do pass. To Consent Calendar",14,0,0,1,15
1847330,1438504,2024-05-02,Assembly,"AB 2581 Maienschein Consent Calendar Second Day Regular Session",73,0,0,7,80
1847330,1452975,2024-06-03,Senate,"Do pass, but first be re-referred to the Committee on [Appropriations]",13,0,0,0,13
1847330,1465406,2024-08-21,Senate,"Assembly 3rd Reading AB2581 Maienschein et al. By Lim√≥n",33,0,0,7,40
1847330,1465688,2024-08-26,Assembly,"AB 2581 Maienschein Concurrence in Senate Amendments",77,0,0,2,79
1847331,1412508,2024-03-20,Assembly,"Do pass as amended, and be re-referred to the Committee on [Appropriations] with recommendation: To Consent Calendar",8,0,0,0,8
1847331,1429951,2024-04-17,Assembly,"Do pass. To Consent Calendar",15,0,0,0,15
1847331,1435219,2024-04-25,Assembly,"AB 2582 Pellerin Consent Calendar Second Day Regular Session",75,0,0,5,80
1847331,1456362,2024-06-11,Senate,"Do pass, but first be re-referred to the Committee on [Appropriations] with the recommendation: To Consent Calendar",7,0,0,0,7
1847331,1461216,2024-06-27,Senate,"Consent Calendar 2nd AB2582 Pellerin",40,0,0,0,40
1847332,1427215,2024-04-15,Assembly,"Do pass and be re-referred to the Committee on [Local Government]",15,0,0,0,15
1847332,1435336,2024-04-24,Assembly,"Do pass and be re-referred to the Committee on [Appropriations]",8,0,0,1,9
1847332,1444519,2024-05-16,Assembly,"Do pass as amended",11,0,0,4,15
1847332,1446015,2024-05-21,Assembly,"AB 2583 Berman Assembly Third Reading",72,0,0,8,80
1847332,1460552,2024-06-25,Senate,"Do pass as amended, but first amend, and re-refer to the Committee on [Local Government]",13,1,0,1,15
1847332,1463485,2024-08-05,Senate,"Placed on suspense file",7,0,0,0,7
1847333,1423727,2024-04-09,Assembly,"Do pass as amended and be re-referred to the Committee on [Appropriations]",8,2,0,2,12
1847333,1444445,2024-05-16,Assembly,"Do pass",11,4,0,0,15
1847333,1446133,2024-05-21,Assembly,"AB 2584 Lee Assembly Third Reading",48,11,0,21,80
1847335,1423778,2024-04-09,Assembly,"Do pass and be re-referred to the Committee on [Appropriations]",8,2,0,1,11
1847335,1444111,2024-05-16,Assembly,"Do pass",11,4,0,0,15
1847335,1448649,2024-05-22,Assembly,"AB 2586 Alvarez Assembly Third Reading",59,4,0,17,80
1847335,1460513,2024-06-25,Senate,"Do pass, but first be re-referred to the Committee on [Education]",9,2,0,0,11
1847335,1462469,2024-07-03,Senate,"Do pass, but first be re-referred to the Committee on [Appropriations]",5,1,0,1,7
1847335,1463642,2024-08-05,Senate,"Placed on suspense file",7,0,0,0,7
1847335,1464116,2024-08-15,Senate,"Do pass as amended",5,2,0,0,7
1847335,1465340,2024-08-20,Senate,"Assembly 3rd Reading AB2586 Alvarez et al. By Durazo",31,8,0,1,40
1847335,1465598,2024-08-26,Assembly,"AB 2586 Alvarez Concurrence in Senate Amendments",63,7,0,9,79
1847336,1436914,2024-04-30,Assembly,"Do pass as amended and be re-referred to the Committee on [Appropriations]",9,1,0,2,12
1847336,1444533,2024-05-16,Assembly,"Do pass",11,2,0,2,15
1847336,1448763,2024-05-22,Assembly,"AB 2587 Aguiar-Curry Assembly Third Reading",60,0,0,20,80
1847336,1458325,2024-06-18,Senate,"Do pass as amended, but first amend, and re-refer to the Committee on [Appropriations]",9,0,0,2,11
1847336,1462101,2024-07-01,Senate,"Placed on suspense file",7,0,0,0,7
1847337,1412609,2024-03-20,Assembly,"Do pass as amended, and be re-referred to the Committee on [Higher Education] with recommendation: To Consent Calendar",7,0,0,0,7
1847337,1423746,2024-04-09,Assembly,"Do pass and be re-referred to the Committee on [Appropriations] with recommendation: To Consent Calendar",11,0,0,0,11
1847338,1429939,2024-04-17,Assembly,"Do pass as amended and be re-referred to the Committee on [Appropriations]",21,0,0,1,22
1847338,1441362,2024-05-08,Assembly,"Do pass. To Consent Calendar",15,0,0,0,15
1847338,1444190,2024-05-16,Assembly,"AB 2589 Joe Patterson Consent Calendar Second Day Regular Session",71,0,0,9,80
1847338,1456407,2024-06-11,Senate,"Do pass as amended, but first amend, and re-refer to the Committee on [Appropriations]",15,0,0,1,16
1847338,1462003,2024-07-01,Senate,"Placed on suspense file",7,0,0,0,7
1847338,1464472,2024-08-15,Senate,"Do pass as amended",7,0,0,0,7
1847338,1466444,2024-08-30,Senate,"Special Consent AB2589 Joe Patterson By Dahle",40,0,0,0,40
1847338,1467172,2024-08-31,Assembly,"AB 2589 Joe Patterson Concurrence in Senate Amendments",77,0,0,2,79
1847339,1438485,2024-05-01,Assembly,"Do pass as amended",9,0,0,0,9
1847339,1445294,2024-05-20,Assembly,"AB 2590 Reyes Assembly Third Reading",72,0,0,8,80
1847339,1456391,2024-06-11,Senate,"Do pass and be ordered to the Consent Calendar",15,0,0,0,15
1847339,1465259,2024-08-19,Senate,"Assembly 3rd Reading AB2590 Reyes By Ochoa Bogh",40,0,0,0,40
1847340,1430994,2024-04-17,Assembly,"Do pass and be re-referred to the Committee on [Appropriations]",5,0,0,4,9
1847342,1431041,2024-04-17,Assembly,"Do pass and be re-referred to the Committee on [Housing and Community Development]",9,0,0,0,9
1847342,1434065,2024-04-24,Assembly,"Do pass. To Consent Calendar",9,0,0,0,9
1847342,1438528,2024-05-02,Assembly,"AB 2593 McCarty Consent Calendar Second Day Regular Session",73,0,0,7,80
1847342,1454212,2024-06-05,Senate,"Do pass as amended, but first amend, and re-refer to the Committee on [Housing]",7,0,0,0,7
1847342,1462566,2024-07-02,Senate,"Do pass",10,0,0,0,10
1847343,1423742,2024-04-08,Assembly,"Do pass and be re-referred to the Committee on [Appropriations] with recommendation: To Consent Calendar",7,0,0,1,8
1847344,1412606,2024-03-20,Assembly,"Do pass and be re-referred to the Committee on [Appropriations]",6,0,0,1,7
1847344,1444507,2024-05-16,Assembly,"Do pass",11,2,0,2,15
1847344,1448754,2024-05-22,Assembly,"AB 2595 Luz Rivas Assembly Third Reading",65,5,0,10,80
1847344,1458556,2024-06-19,Senate,"Do pass, but first be re-referred to the Committee on [Appropriations]",5,0,0,2,7
1847344,1462012,2024-07-01,Senate,"Placed on suspense file",7,0,0,0,7
1847346,1424801,2024-04-10,Assembly,"Do pass and be re-referred to the Committee on [Local Government] with recommendation: To Consent Calendar",9,0,0,0,9
1847346,1431048,2024-04-17,Assembly,"Do pass. To Consent Calendar",9,0,0,0,9
1847346,1441377,2024-05-08,Assembly,"Do pass. To Consent Calendar",15,0,0,0,15
1847346,1444401,2024-05-16,Assembly,"AB 2597 Ward Consent Calendar Second Day Regular Session",71,0,0,9,80
1847346,1458432,2024-06-18,Senate,"Do pass, but first be re-referred to the Committee on [Appropriations]",8,2,0,0,10
1847346,1466329,2024-08-29,Assembly,"AB 2597 Ward Concurrence in Senate Amendments",58,13,0,8,79
1847346,1466808,2024-08-28,Senate,"Assembly 3rd Reading AB2597 Ward By Blakespear",30,6,0,4,40
1847348,1411333,2024-03-19,Assembly,"Do pass and be re-referred to the Committee on [Appropriations] with recommendation: To Consent Calendar",7,0,0,0,7
1847348,1424975,2024-04-10,Assembly,"Do pass. To Consent Calendar",14,0,0,1,15
1847348,1430979,2024-04-18,Assembly,"AB 2599 Environmental Safety and Toxic Materials Consent Calendar Second Day Regular Session",72,0,0,8,80
1847348,1454263,2024-06-05,Senate,"Do pass, but first be re-referred to the Committee on [Health] with the recommendation: To Consent Calendar",7,0,0,0,7
1847348,1458483,2024-06-19,Senate,"Do pass, but first be re-referred to the Committee on [Appropriations] with the recommendation: To Consent Calendar",11,0,0,0,11
1847348,1465276,2024-08-19,Senate,"Assembly 3rd Reading AB2599 E.S. & T.M. (Garcia) By Allen",40,0,0,0,40
1847348,1465760,2024-08-26,Assembly,"AB 2599 Environmental Safety and Concurrence in Senate Amendments By GARCIA",77,0,0,2,79
1847349,1423862,2024-04-08,Assembly,"Do pass and be re-referred to the Committee on [Appropriations] with recommendation: To Consent Calendar",10,0,0,1,11
1847351,1421142,2024-04-03,Assembly,"Do pass and be re-referred to the Committee on [Privacy and Consumer Protection]",5,0,0,2,7
1847351,1435209,2024-04-23,Assembly,"Do pass as amended and be re-referred to the Committee on [Appropriations]",9,0,0,2,11
1847351,1444450,2024-05-16,Assembly,"Do pass",11,1,0,3,15
1847351,1448726,2024-05-22,Assembly,"AB 2602 Kalra Assembly Third Reading",62,0,0,18,80
1847351,1458534,2024-06-19,Senate,"Do pass, but first be re-referred to the Committee on [Judiciary]",5,0,0,0,5
1847351,1462547,2024-07-02,Senate,"Do pass, but first be re-referred to the Committee on [Appropriations]",11,0,0,0,11
1847351,1463659,2024-08-05,Senate,"Placed on suspense file",7,0,0,0,7
1847351,1464015,2024-08-15,Senate,"Do pass",7,0,0,0,7
1847351,1465858,2024-08-27,Senate,"Assembly 3rd Reading AB2602 Kalra et al. By Smallwood-Cuevas",37,1,0,2,40
1847351,1466603,2024-08-28,Assembly,"AB 2602 Kalra Concurrence in Senate Amendments",73,0,0,6,79
1847355,1424984,2024-04-10,Assembly,"Do pass and be re-referred to the Committee on [Judiciary]",8,0,0,2,10
1847355,1428935,2024-04-16,Assembly,"Do pass and be re-referred to the Committee on [Appropriations]",12,0,0,0,12
1847355,1444501,2024-05-16,Assembly,"Do pass",14,0,0,1,15
1847355,1448634,2024-05-22,Assembly,"AB 2606 Aguiar-Curry Assembly Third Reading",71,0,0,9,80
1847355,1458305,2024-06-18,Senate,"Do pass, but first be re-referred to the Committee on [Judiciary] with the recommendation: To Consent Calendar",5,0,0,0,5
1847355,1462675,2024-07-02,Senate,"Do pass, but first be re-referred to the Committee on [Appropriations] with the recommendation: To Consent Calendar",11,0,0,0,11
1847355,1465696,2024-08-26,Senate,"Assembly 3rd Reading AB2606 Aguiar-Curry By Padilla",40,0,0,0,40
1847355,1465937,2024-08-27,Assembly,"AB 2606 Aguiar-Curry Concurrence in Senate Amendments",76,0,0,3,79
1847357,1430055,2024-04-16,Assembly,"Do pass as amended and be re-referred to the Committee on [Appropriations]",11,0,0,0,11
1847357,1441319,2024-05-08,Assembly,"Do pass. To Consent Calendar",15,0,0,0,15
1847357,1444400,2024-05-16,Assembly,"AB 2608 Gabriel Consent Calendar Second Day Regular Session",71,0,0,9,80
1847357,1456872,2024-06-12,Senate,"Do pass, but first be re-referred to the Committee on [Appropriations] with the recommendation: To Consent Calendar",7,0,0,0,7
1847357,1461241,2024-06-27,Senate,"Consent Calendar 2nd AB2608 Gabriel et al",40,0,0,0,40
1847358,1420124,2024-04-02,Assembly,"Do pass and be re-referred to the Committee on [Appropriations]",2,3,0,3,8
1847358,1420125,2024-04-02,Assembly,Reconsideration,8,0,0,0,8
1847358,1432938,2024-04-23,Assembly,"Do pass as amended and be re-referred to the Committee on [Appropriations]",8,0,0,0,8
1847359,1423858,2024-04-09,Assembly,"Do pass as amended and be re-referred to the Committee on [Appropriations]",14,0,0,1,15
1847359,1434098,2024-04-24,Assembly,"Do pass. To Consent Calendar",14,0,0,1,15
1847359,1438478,2024-05-02,Assembly,"AB 2610 Garcia Consent Calendar Second Day Regular Session",73,0,0,7,80
1847359,1457957,2024-06-17,Senate,"Do pass, but first be re-referred to the Committee on [Appropriations] with the recommendation: To Consent Calendar",11,0,0,0,11
1847359,1463573,2024-08-05,Senate,"Placed on suspense file",7,0,0,0,7
1847362,1432996,2024-04-23,Assembly,"Do pass as amended and be re-referred to the Committee on [Appropriations]",16,0,0,0,16
1847362,1443904,2024-05-16,Assembly,"Do pass",15,0,0,0,15
1847362,1448572,2024-05-22,Assembly,"AB 2613 Zbur Assembly Third Reading",72,0,0,8,80
1847362,1460554,2024-06-26,Senate,"Do pass as amended, but first amend, and re-refer to the Committee on [Appropriations] with the recommendation: To Consent Calendar",11,0,0,0,11
1847362,1463476,2024-08-05,Senate,"Placed on suspense file",7,0,0,0,7
1847362,1464383,2024-08-15,Senate,"Do pass",6,0,0,1,7
1847362,1465803,2024-08-27,Senate,"Assembly 3rd Reading AB2613 Zbur et al. By Eggman",40,0,0,0,40
1847362,1466825,2024-08-28,Assembly,"AB 2613 Zbur Concurrence in Senate Amendments",76,0,0,3,79
1847363,1424857,2024-04-09,Assembly,"Do pass and be re-referred to the Committee on [Water, Parks, and Wildlife]",6,0,0,1,7
1847363,1433023,2024-04-23,Assembly,"Do pass and be re-referred to the Committee on [Appropriations]",12,0,0,3,15
1847364,1430088,2024-04-17,Assembly,"Do pass and be re-referred to the Committee on [Appropriations]",17,0,0,5,22
1847367,1427226,2024-04-15,Assembly,"Do pass and be re-referred to the Committee on [Local Government]",9,0,0,0,9
1847367,1438449,2024-05-01,Assembly,"Do pass. To Consent Calendar",9,0,0,0,9
1847367,1441897,2024-05-09,Assembly,"AB 2618 Chen Consent Calendar Second Day Regular Session",65,0,0,15,80
1847367,1451571,2024-05-29,Senate,"Do pass as amended, but first amend, and re-refer to the Committee on [Banking and Financial Institutions]",7,0,0,0,7
1847367,1458542,2024-06-19,Senate,"Do pass, but first be re-referred to the Committee on [Appropriations]",6,0,0,1,7
1847367,1465326,2024-08-20,Senate,"Assembly 3rd Reading AB2618 Chen By Niello",40,0,0,0,40
1847367,1465483,2024-08-22,Assembly,"AB 2618 Chen Concurrence in Senate Amendments",61,0,0,18,79
1847369,1428820,2024-04-16,Assembly,"Do pass and be re-referred to the Committee on [Appropriations]",5,0,0,2,7
1847369,1437602,2024-05-01,Assembly,"Do pass. To Consent Calendar",14,0,0,1,15
1847369,1441933,2024-05-09,Assembly,"AB 2620 Bains Consent Calendar Second Day Regular Session",65,0,0,15,80
1847369,1453459,2024-06-03,Senate,"Do pass, but first be re-referred to the Committee on [Appropriations]",4,0,0,1,5
1847369,1465466,2024-08-22,Senate,"Assembly 3rd Reading AB2620 Bains By Roth",33,0,0,7,40
1847370,1420184,2024-04-02,Assembly,"Do pass as amended, and be re-referred to the Committee on [Appropriations] with recommendation: To Consent Calendar",8,0,0,0,8
1847370,1430037,2024-04-17,Assembly,"Do pass. To Consent Calendar",15,0,0,0,15
1847370,1435303,2024-04-25,Assembly,"AB 2621 Gabriel Consent Calendar Second Day Regular Session",75,0,0,5,80
1847370,1453447,2024-06-04,Senate,"Do pass, but first be re-referred to the Committee on [Appropriations] with the recommendation: To Consent Calendar",5,0,0,0,5
1847370,1458002,2024-06-17,Senate,"Placed on suspense file",7,0,0,0,7
1847370,1464084,2024-08-15,Senate,"Do pass",7,0,0,0,7
1847370,1466194,2024-08-29,Assembly,"AB 2621 Gabriel Concurrence in Senate Amendments",76,0,0,3,79
1847370,1466677,2024-08-28,Senate,"Special Consent AB2621 Gabriel et al. By Min",39,0,0,1,40
1847371,1433152,2024-04-23,Assembly,"Do pass as amended and be re-referred to the Committee on [Appropriations]",16,0,0,2,18
1847371,1444213,2024-05-16,Assembly,"Do pass",15,0,0,0,15
1847371,1448641,2024-05-22,Assembly,"AB 2622 Juan Carrillo Assembly Third Reading",57,0,0,23,80
1847371,1461946,2024-07-01,Senate,"Do pass, but first be re-referred to the Committee on [Appropriations]",12,0,0,1,13
1847371,1463474,2024-08-05,Senate,"Placed on suspense file",7,0,0,0,7
1847371,1464627,2024-08-15,Senate,"Do pass",7,0,0,0,7
1847371,1465338,2024-08-20,Senate,"Assembly 3rd Reading AB2622 Juan Carrillo By Dodd",40,0,0,0,40
1847371,1465502,2024-08-22,Assembly,"AB 2622 Juan Carrillo Concurrence in Senate Amendments",61,0,0,18,79
1847373,1428805,2024-04-16,Assembly,"Do pass as amended, and be re-referred to the Committee on [Appropriations] with recommendation: To Consent Calendar",8,0,0,0,8
1847373,1437637,2024-05-01,Assembly,"Do pass. To Consent Calendar",14,0,0,1,15
1847373,1441895,2024-05-09,Assembly,"AB 2624 Waldron Consent Calendar Second Day Regular Session",65,0,0,15,80
1847373,1456416,2024-06-11,Senate,"Do pass as amended, but first amend, and re-refer to the Committee on [Appropriations]",5,0,0,0,5
1847373,1465565,2024-08-26,Senate,"Assembly 3rd Reading AB2624 Waldron By Durazo",39,0,0,1,40
1847373,1465892,2024-08-27,Assembly,"AB 2624 Waldron Concurrence in Senate Amendments",77,0,0,2,79
1847374,1424947,2024-04-09,Assembly,"Do pass as amended, and be re-referred to the Committee on [Judiciary] with recommendation: To Consent Calendar",8,0,0,0,8
1847374,1432968,2024-04-23,Assembly,"Do pass and be re-referred to the Committee on [Appropriations] with recommendation: To Consent Calendar",11,0,0,1,12
1847376,1424774,2024-04-10,Assembly,"Do pass as amended and be re-referred to the Committee on [Education]",7,1,0,0,8
1847376,1435312,2024-04-24,Assembly,"Do pass as amended and be re-referred to the Committee on [Appropriations]",6,0,0,1,7
1847377,1423852,2024-04-09,Assembly,"Do pass and be re-referred to the Committee on [Appropriations] with recommendation: To Consent Calendar",12,0,0,0,12
1847377,1434145,2024-04-24,Assembly,"Do pass. To Consent Calendar",14,0,0,1,15
1847377,1438443,2024-05-02,Assembly,"AB 2628 Hart Consent Calendar Second Day Regular Session",73,0,0,7,80
1847377,1450937,2024-05-28,Senate,"Do pass, but first be re-referred to the Committee on [Judiciary] with the recommendation: To Consent Calendar",12,0,0,4,16
1847377,1456276,2024-06-11,Senate,"Do pass, but first be re-referred to the Committee on [Appropriations] with the recommendation: To Consent Calendar",11,0,0,0,11
1847377,1465339,2024-08-20,Senate,"Assembly 3rd Reading AB2628 Hart By Laird",40,0,0,0,40
1847377,1465469,2024-08-22,Assembly,"AB 2628 Hart Concurrence in Senate Amendments",62,0,0,17,79
1847378,1433025,2024-04-23,Assembly,"Do pass and be re-referred to the Committee on [Appropriations]",8,0,0,0,8
1847378,1444423,2024-05-16,Assembly,"Do pass as amended",11,0,0,4,15
1847378,1449625,2024-05-23,Assembly,"AB 2629 Haney Assembly Third Reading",72,0,0,8,80
1847378,1460022,2024-06-25,Senate,"Do pass, but first be re-referred to the Committee on [Appropriations]",5,0,0,0,5
1847378,1463529,2024-08-05,Senate,"Placed on suspense file",7,0,0,0,7
1847378,1464039,2024-08-15,Senate,"Do pass as amended",7,0,0,0,7
1847378,1466600,2024-08-31,Senate,"Assembly 3rd Reading AB2629 Haney By Portantino",39,1,0,0,40
1847378,1466601,2024-08-31,Assembly,"AB 2629 Haney Concurrence in Senate Amendments Move The Previous Question By AGUIAR-CURRY",58,2,0,19,79
1847378,1466602,2024-08-31,Assembly,"AB 2629 Haney Concurrence in Senate Amendments",68,0,0,11,79
1847379,1412539,2024-03-20,Assembly,"Do pass and be re-referred to the Committee on [Appropriations] with recommendation: To Consent Calendar",7,0,0,0,7
1847379,1424817,2024-04-10,Assembly,"Do pass. To Consent Calendar",14,0,0,1,15
1847379,1430972,2024-04-18,Assembly,"AB 2630 Bonta Consent Calendar Second Day Regular Session",72,0,0,8,80
1847379,1451572,2024-05-29,Senate,"Do pass, but first be re-referred to the Committee on [Health] with the recommendation: To Consent Calendar",7,0,0,0,7
1847379,1456932,2024-06-12,Senate,"Do pass, but first be re-referred to the Committee on [Appropriations] with the recommendation: To Consent Calendar",10,0,0,1,11
1847379,1465405,2024-08-21,Senate,"Assembly 3rd Reading AB2630 Bonta By Rubio",33,0,0,7,40
1847380,1412615,2024-03-20,Assembly,"Do pass and be re-referred to the Committee on [Appropriations] with recommendation: To Consent Calendar",8,0,0,0,8
1847380,1444538,2024-05-16,Assembly,"Do pass as amended",11,0,0,4,15
1847380,1448816,2024-05-22,Assembly,"AB 2631 Mike Fong Assembly Third Reading",70,0,0,10,80
1847380,1462274,2024-07-02,Senate,"Do pass, but first be re-referred to the Committee on [Appropriations] with the recommendation: To Consent Calendar",7,0,0,0,7
1847380,1463913,2024-08-12,Senate,"Consent Calendar 2nd AB2631 Mike Fong",38,0,0,2,40
1847381,1430997,2024-04-17,Assembly,"Do pass as amended and be re-referred to the Committee on [Appropriations]",9,0,0,0,9
1847381,1443493,2024-05-15,Assembly,"Do pass. To Consent Calendar",15,0,0,0,15
1847381,1446140,2024-05-21,Assembly,"AB 2632 Wilson Consent Calendar Second Day Regular Session",71,0,0,9,80
1847381,1460429,2024-06-26,Senate,"Do pass as amended, but first amend, and re-refer to the Committee on [Appropriations]",6,1,0,0,7
1847381,1465997,2024-08-27,Senate,"Assembly 3rd Reading AB2632 Wilson et al. By Skinner",37,2,0,1,40
1847381,1467242,2024-08-28,Assembly,"AB 2632 Wilson Concurrence in Senate Amendments",77,0,0,2,79
1847382,1433192,2024-04-23,Assembly,"Do pass and be re-referred to the Committee on [Appropriations]",10,0,0,1,11
1847382,1444252,2024-05-16,Assembly,"Do pass",15,0,0,0,15
1847382,1448564,2024-05-22,Assembly,"AB 2633 Alvarez Assembly Third Reading",71,0,0,9,80
1847382,1458516,2024-06-19,Senate,"Do pass as amended, but first amend, and re-refer to the Committee on [Appropriations]",7,0,0,0,7
1847382,1465387,2024-08-20,Senate,"Assembly 3rd Reading AB2633 Alvarez et al. By Lim√≥n",40,0,0,0,40
1847382,1465724,2024-08-26,Assembly,"AB 2633 Alvarez Concurrence in Senate Amendments",76,0,0,3,79
1847383,1425933,2024-04-10,Assembly,"Do pass and be re-referred to the Committee on [Transportation] with recommendation: To Consent Calendar",9,0,0,0,9
1847383,1431967,2024-04-22,Assembly,"Do pass as amended",15,0,0,0,15
1847383,1438502,2024-05-02,Assembly,"AB 2634 McCarty Assembly Third Reading",74,0,0,6,80
1847383,1451570,2024-05-28,Senate,"Do pass as amended, and be ordered to the Consent Calendar",12,0,0,3,15
1847383,1454831,2024-06-06,Senate,"Consent Calendar 2nd AB2634 McCarty et al",32,0,0,8,40
1847383,1458014,2024-06-17,Assembly,"AB 2634 McCarty Concurrence in Senate Amendments",75,0,0,4,79
1847384,1424921,2024-04-10,Assembly,"Do pass and be re-referred to the Committee on [Judiciary]",8,0,0,2,10
1847385,1428899,2024-04-16,Assembly,"Do pass and be re-referred to the Committee on [Appropriations]",5,0,0,2,7
1847385,1444262,2024-05-16,Assembly,"Do pass as amended",11,0,0,4,15
1847385,1449704,2024-05-23,Assembly,"AB 2636 Bains Assembly Third Reading",73,0,0,7,80
1847385,1462208,2024-07-01,Senate,"Do pass, but first be re-referred to the Committee on [Appropriations] with the recommendation: To Consent Calendar",5,0,0,0,5
1847385,1463869,2024-08-12,Senate,"Consent Calendar 2nd AB2636 Bains",38,0,0,2,40
1847386,1433097,2024-04-23,Assembly,"Do pass and be re-referred to the Committee on [Appropriations]",16,0,0,0,16
1847386,1443499,2024-05-15,Assembly,"Do pass. To Consent Calendar",15,0,0,0,15
1847386,1445960,2024-05-21,Assembly,"AB 2637 Schiavo Consent Calendar Second Day Regular Session",71,0,0,9,80
1847386,1460674,2024-06-26,Senate,"Do pass, but first be re-referred to the Committee on [Appropriations] with the recommendation: To Consent Calendar",11,0,0,0,11
1847386,1463908,2024-08-12,Senate,"Consent Calendar 2nd AB2637 Schiavo",38,0,0,2,40
1847386,1464285,2024-08-15,Assembly,"AB 2637 Schiavo Concurrence in Senate Amendments",76,0,0,3,79
1847387,1429958,2024-04-17,Assembly,"Do pass and be re-referred to the Committee on [Appropriations] with recommendation: To Consent Calendar",9,0,0,0,9
1847387,1444543,2024-05-16,Assembly,"Do pass",15,0,0,0,15
1847387,1448797,2024-05-22,Assembly,"AB 2638 Ward Assembly Third Reading",70,0,0,10,80
1847387,1460091,2024-06-24,Senate,"Do pass, but first be re-referred to the Committee on [Appropriations]",10,0,0,0,10
1847387,1463859,2024-08-12,Senate,"Placed on suspense file",7,0,0,0,7
1847388,1423724,2024-04-08,Assembly,"Do pass as amended and be re-referred to the Committee on [Appropriations]",11,0,0,0,11
1847389,1424971,2024-04-10,Assembly,"Do pass as amended and be re-referred to the Committee on [Appropriations]",7,0,0,0,7
1847389,1444058,2024-05-16,Assembly,"Do pass as amended",11,0,0,4,15
1847389,1449680,2024-05-23,Assembly,"AB 2640 Kalra Assembly Third Reading",68,0,0,12,80
1847389,1458530,2024-06-19,Senate,"Do pass as amended, but first amend, and re-refer to the Committee on [Appropriations]",7,0,0,0,7
1847389,1463570,2024-08-05,Senate,"Placed on suspense file",7,0,0,0,7
1847391,1424882,2024-04-10,Assembly,"Do pass as amended and be re-referred to the Committee on [Judiciary]",6,2,0,0,8
1847391,1436915,2024-04-30,Assembly,"Do pass as amended and be re-referred to the Committee on [Appropriations]",9,3,0,0,12
1847391,1444152,2024-05-16,Assembly,"Do pass",11,4,0,0,15
1847391,1446049,2024-05-21,Assembly,"AB 2642 Berman Third Reading Urgency",59,10,0,11,80
1847391,1458327,2024-06-18,Senate,"Do pass, but first be re-referred to the Committee on [Judiciary]",6,1,0,0,7
1847391,1460632,2024-06-25,Senate,"Do pass, but first be re-referred to the Committee on [Appropriations]",9,2,0,0,11
1847391,1463628,2024-08-05,Senate,"Placed on suspense file",7,0,0,0,7
1847391,1464124,2024-08-15,Senate,"Do pass",5,2,0,0,7
1847391,1466309,2024-08-29,Assembly,"AB 2642 Berman Concurrence in Senate Amendments",60,13,0,6,79
1847391,1466834,2024-08-28,Senate,"Assembly 3rd Reading AB2642 Berman et al. By Newman Urgency Clause",31,8,0,1,40
1847392,1433164,2024-04-23,Assembly,"Do pass and be re-referred to the Committee on [Appropriations]",13,0,0,2,15
1847392,1444028,2024-05-16,Assembly,"Do pass",15,0,0,0,15
1847392,1446032,2024-05-21,Assembly,"AB 2643 Wood Assembly Third Reading",73,0,0,7,80
1847392,1458011,2024-06-17,Senate,"Do pass, but first be re-referred to the Committee on [Appropriations] with the recommendation: To Consent Calendar",11,0,0,0,11
1847392,1463488,2024-08-05,Senate,"Placed on suspense file",7,0,0,0,7
1847392,1464081,2024-08-15,Senate,"Do pass as amended",6,0,0,1,7
1847392,1465974,2024-08-27,Senate,"Assembly 3rd Reading AB2643 Wood et al. By Allen",40,0,0,0,40
1847392,1467205,2024-08-28,Assembly,"AB 2643 Wood Concurrence in Senate Amendments",77,0,0,2,79
1847394,1424827,2024-04-09,Assembly,"Do pass and be re-referred to the Committee on [Transportation] with recommendation: To Consent Calendar",8,0,0,0,8
1847394,1431933,2024-04-22,Assembly,"Do pass and be re-referred to the Committee on [Appropriations] with recommendation: To Consent Calendar",15,0,0,0,15
1847394,1444314,2024-05-16,Assembly,"Do pass",15,0,0,0,15
1847394,1448703,2024-05-22,Assembly,"AB 2645 Lackey Assembly Third Reading",68,0,0,12,80
1847394,1458326,2024-06-18,Senate,"Do pass, but first be re-referred to the Committee on [Transportation]",5,0,0,0,5
1847394,1460522,2024-06-25,Senate,"Do pass as amended, but first amend, and re-refer to the Committee on [Appropriations] with the recommendation: To Consent Calendar",15,0,0,0,15
1847394,1463631,2024-08-05,Senate,"Placed on suspense file",7,0,0,0,7
1847394,1464163,2024-08-15,Senate,"Do pass",7,0,0,0,7
1847394,1466272,2024-08-29,Assembly,"AB 2645 Lackey Concurrence in Senate Amendments",76,0,0,3,79
1847394,1467219,2024-08-28,Senate,"Special Consent AB2645 Lackey et al. By Seyarto",39,0,0,1,40
1847397,1411377,2024-03-19,Assembly,"Do pass as amended and be re-referred to the Committee on [Appropriations]",8,3,0,0,11
1847397,1444199,2024-05-16,Assembly,"Do pass as amended",8,4,0,3,15
1847399,1423882,2024-04-09,Assembly,"Do pass and be re-referred to the Committee on [Health]",6,0,0,1,7
1847399,1428830,2024-04-16,Assembly,"Do pass and be re-referred to the Committee on [Appropriations] with recommendation: To Consent Calendar",16,0,0,0,16
1847400,1428854,2024-04-16,Assembly,"Do pass and be re-referred to the Committee on [Appropriations]",17,0,0,1,18
1847401,1421151,2024-04-03,Assembly,"Do pass as amended and be re-referred to the Committee on [Privacy and Consumer Protection]",7,0,0,0,7
1847401,1430036,2024-04-16,Assembly,"Do pass as amended, and be re-referred to the Committee on [Appropriations] with recommendation: To Consent Calendar",11,0,0,0,11
1847403,1435217,2024-04-25,Assembly,"Do pass and be re-referred to the Committee on [Appropriations]",2,1,0,5,8
1847403,1435218,2024-04-25,Assembly,Reconsideration,7,0,0,1,8
1847404,1424765,2024-04-10,Assembly,"Do pass and be re-referred to the Committee on [Judiciary]",6,1,0,1,8
1847404,1433125,2024-04-23,Assembly,"Do pass as amended and be re-referred to the Committee on [Appropriations]",9,0,0,3,12
1847404,1444658,2024-05-16,Assembly,"Do pass as amended",11,1,0,3,15
1847404,1448798,2024-05-22,Assembly,"AB 2655 Berman Assembly Third Reading",56,1,0,23,80
1847404,1458295,2024-06-18,Senate,"Do pass, but first be re-referred to the Committee on [Judiciary]",6,1,0,0,7
1847404,1462472,2024-07-02,Senate,"Do pass as amended, but first amend, and re-refer to the Committee on [Appropriations]",9,2,0,0,11
1847404,1463399,2024-08-05,Senate,"Placed on suspense file",7,0,0,0,7
1847404,1464542,2024-08-15,Senate,"Do pass as amended",5,2,0,0,7
1847404,1465881,2024-08-27,Senate,"Assembly 3rd Reading AB2655 Berman et al. By Umberg",31,9,0,0,40
1847404,1466893,2024-08-28,Assembly,"AB 2655 Berman Concurrence in Senate Amendments",59,8,0,12,79
1847405,1465768,2024-08-26,Assembly,"AB 2656 Ramos Third Reading Urgency",77,0,0,2,79
1847405,1467243,2024-08-28,Senate,"Assembly 3rd Reading AB2656 Ramos By Grove Urgency Clause",39,0,0,1,40
1847406,1423943,2024-04-09,Assembly,"Do pass and be re-referred to the Committee on [Privacy and Consumer Protection]",15,0,0,1,16
1847406,1435231,2024-04-23,Assembly,"Do pass and be re-referred to the Committee on [Appropriations]",10,0,0,1,11
1847409,1431998,2024-04-22,Assembly,"Do pass and be re-referred to the Committee on [Appropriations] with recommendation: To Consent Calendar",8,0,0,0,8
1847409,1444606,2024-05-16,Assembly,"Do pass as amended",11,0,0,4,15
1847409,1448575,2024-05-22,Assembly,"AB 2660 Emergency Management Assembly Third Reading By RODRIGUEZ",70,0,0,10,80
1847409,1459952,2024-06-25,Senate,"Do pass, but first be re-referred to the Committee on [Appropriations]",14,0,0,2,16
1847409,1463646,2024-08-05,Senate,"Placed on suspense file",7,0,0,0,7
1847410,1429964,2024-04-17,Assembly,"Do pass and be re-referred to the Committee on [Natural Resources]",16,0,0,0,16
1847410,1431992,2024-04-22,Assembly,"Do pass as amended and be re-referred to the Committee on [Appropriations]",11,0,0,0,11
1847410,1444482,2024-05-16,Assembly,"Do pass as amended",11,0,0,4,15
1847410,1449560,2024-05-23,Assembly,"AB 2661 Soria Assembly Third Reading",73,0,0,7,80
1847410,1456413,2024-06-11,Senate,"Do pass, but first be re-referred to the Committee on [Energy, Utilities and Communications]",7,0,0,0,7
1847410,1462227,2024-07-02,Senate,"Do pass",18,0,0,0,18
1847410,1466525,2024-08-30,Senate,"Assembly 3rd Reading AB2661 Soria By Hurtado",40,0,0,0,40
1847410,1467070,2024-08-31,Assembly,"AB 2661 Soria Concurrence in Senate Amendments",76,0,0,3,79
1847412,1430048,2024-04-17,Assembly,"Do pass and be re-referred to the Committee on [Local Government] with recommendation: To Consent Calendar",9,0,0,0,9
1847412,1438415,2024-05-01,Assembly,"Do pass as amended. To Consent Calendar",9,0,0,0,9
1847412,1441938,2024-05-09,Assembly,"AB 2663 Grayson Consent Calendar Second Day Regular Session",65,0,0,15,80
1847412,1453476,2024-06-04,Senate,"Do pass, but first be re-referred to the Committee on [Local Government] with the recommendation: To Consent Calendar",9,0,0,1,10
1847412,1460463,2024-06-26,Senate,"Do pass and be ordered to the Consent Calendar",7,0,0,0,7
1847412,1462603,2024-07-03,Senate,"Consent Calendar 2nd AB2663 Grayson",39,0,0,1,40
1847412,1463856,2024-08-12,Assembly,"AB 2663 Grayson Concurrence in Senate Amendments",76,0,0,3,79
1847413,1419188,2024-04-02,Assembly,"Do pass and be re-referred to the Committee on [Judiciary]",7,0,0,0,7
1847413,1428862,2024-04-16,Assembly,"Do pass and be re-referred to the Committee on [Appropriations] with recommendation: To Consent Calendar",12,0,0,0,12
1847413,1437662,2024-05-01,Assembly,"Do pass. To Consent Calendar",14,0,0,1,15
1847413,1441889,2024-05-09,Assembly,"AB 2664 Bryan Consent Calendar Second Day Regular Session",65,0,0,15,80
1847413,1458212,2024-06-17,Senate,"Do pass, but first be re-referred to the Committee on [Judiciary] with the recommendation: To Consent Calendar",5,0,0,0,5
1847413,1462478,2024-07-02,Senate,"Do pass as amended, but first amend, and re-refer to the Committee on [Appropriations] with the recommendation: To Consent Calendar",11,0,0,0,11
1847413,1466114,2024-08-29,Assembly,"AB 2664 Bryan Concurrence in Senate Amendments",76,0,0,3,79
1847413,1466654,2024-08-28,Senate,"Assembly 3rd Reading AB2664 Bryan By Glazer",39,0,0,1,40
1847414,1424825,2024-04-10,Assembly,"Do pass as amended and be re-referred to the Committee on [Appropriations]",7,0,0,2,9
1847415,1434055,2024-04-24,Assembly,"Do pass as amended and be re-referred to the Committee on [Appropriations]",12,0,0,4,16
1847415,1444462,2024-05-16,Assembly,"Do pass as amended",9,1,0,5,15
1847415,1449534,2024-05-23,Assembly,"AB 2666 Boerner Assembly Third Reading",52,1,0,27,80
1847415,1462202,2024-07-02,Senate,"Do pass as amended, but first amend, and re-refer to the Committee on [Appropriations]",15,3,0,0,18
1847415,1463443,2024-08-05,Senate,"Placed on suspense file",7,0,0,0,7
1847415,1464220,2024-08-15,Senate,"Do pass",5,2,0,0,7
1847415,1466260,2024-08-29,Senate,"Assembly 3rd Reading AB2666 Boerner By Becker",32,7,0,1,40
1847415,1466572,2024-08-30,Assembly,"AB 2666 Boerner Concurrence in Senate Amendments",56,4,0,19,79
1847416,1430067,2024-04-17,Assembly,"Do pass and be re-referred to the Committee on [Local Government]",7,2,0,0,9
1847416,1435221,2024-04-24,Assembly,"Do pass and be re-referred to the Committee on [Appropriations]",7,0,0,2,9
1847416,1443955,2024-05-16,Assembly,"Do pass",11,4,0,0,15
1847416,1449566,2024-05-23,Assembly,"AB 2667 Santiago Assembly Third Reading",57,12,0,11,80
1847416,1460069,2024-06-24,Senate,"Do pass, but first be re-referred to the Committee on [Appropriations]",8,2,0,0,10
1847416,1463586,2024-08-05,Senate,"Placed on suspense file",7,0,0,0,7
1847416,1464001,2024-08-15,Senate,"Do pass",5,2,0,0,7
1847416,1465830,2024-08-27,Senate,"Assembly 3rd Reading AB2667 Santiago By Bradford",30,8,0,2,40
1847416,1466853,2024-08-28,Assembly,"AB 2667 Santiago Concurrence in Senate Amendments",61,14,0,4,79
1847417,1433109,2024-04-23,Assembly,"Do pass and be re-referred to the Committee on [Appropriations]",16,0,0,0,16
1847418,1422076,2024-04-08,Assembly,"Do pass and be re-referred to the Committee on [Appropriations]",14,0,0,1,15
1847418,1444339,2024-05-16,Assembly,"Do pass",13,2,0,0,15
1847418,1448674,2024-05-22,Assembly,"AB 2669 Ting Assembly Third Reading",65,0,0,15,80
1847418,1456334,2024-06-11,Senate,"Do pass, but first be re-referred to the Committee on [Appropriations]",11,2,0,2,15
1847418,1459379,2024-06-24,Senate,"Placed on suspense file",6,0,0,1,7
1847418,1464280,2024-08-15,Senate,"Do pass",5,2,0,0,7
1847418,1465589,2024-08-26,Senate,"Assembly 3rd Reading AB2669 Ting By Dodd",32,7,0,1,40
1847419,1433134,2024-04-23,Assembly,"Do pass and be re-referred to the Committee on [Appropriations]",12,4,0,0,16
1847419,1443906,2024-05-16,Assembly,"Do pass",11,4,0,0,15
1847419,1448696,2024-05-22,Assembly,"AB 2670 Schiavo Assembly Third Reading",58,13,0,9,80
1847419,1462628,2024-07-03,Senate,"Do pass, but first be re-referred to the Committee on [Appropriations]",9,2,0,0,11
1847419,1463581,2024-08-05,Senate,"Placed on suspense file",7,0,0,0,7
1847419,1464189,2024-08-15,Senate,"Do pass",5,2,0,0,7
1847419,1466167,2024-08-29,Assembly,"AB 2670 Schiavo Concurrence in Senate Amendments",59,16,0,4,79
1847419,1466716,2024-08-28,Senate,"Assembly 3rd Reading AB2670 Schiavo et al. By Caballero",31,8,0,1,40
1847420,1423767,2024-04-09,Assembly,"Do pass and be re-referred to the Committee on [Environmental Safety and Toxic Materials]",6,0,0,1,7
1847420,1435933,2024-04-23,Assembly,"Do pass and be re-referred to the Committee on [Appropriations]",6,0,0,1,7
1847421,1430081,2024-04-17,Assembly,"Do pass as amended and be re-referred to the Committee on [Appropriations]",16,0,0,0,16
1847421,1443465,2024-05-15,Assembly,"Do pass",14,1,0,0,15
1847421,1449676,2024-05-23,Assembly,"AB 2672 Petrie-Norris Assembly Third Reading",71,0,0,9,80
1847421,1462283,2024-07-02,Senate,"Do pass as amended, but first amend, and re-refer to the Committee on [Appropriations]",15,0,0,3,18
1847421,1463904,2024-08-12,Senate,"Placed on suspense file",7,0,0,0,7
1847421,1464352,2024-08-15,Senate,"Do pass",7,0,0,0,7
1847421,1466157,2024-08-29,Senate,"Assembly 3rd Reading AB2672 Petrie-Norris et al. By Bradford",37,0,0,3,40
1847421,1466591,2024-08-30,Assembly,"AB 2672 Petrie-Norris Concurrence in Senate Amendments",74,1,0,4,79
1847422,1428954,2024-04-16,Assembly,"Do pass and be re-referred to the Committee on [Appropriations]",8,0,0,0,8
1847423,1424879,2024-04-10,Assembly,"Do pass and be re-referred to the Committee on [Human Services]",9,0,0,0,9
1847423,1433028,2024-04-23,Assembly,"Do pass as amended and be re-referred to the Committee on [Appropriations]",5,0,0,2,7
1847426,1428989,2024-04-16,Assembly,"Do pass as amended. To Consent Calendar",12,0,0,0,12
1847426,1435286,2024-04-25,Assembly,"AB 2677 Chen Consent Calendar Second Day",75,0,0,5,80
1847426,1460449,2024-06-25,Senate,"Do pass",8,1,0,2,11
1847426,1460450,2024-06-25,Senate,"Do pass",7,1,0,3,11
1847426,1461866,2024-06-25,Senate,"[06-25-2024] set for [First] hearing: Reconsideration of favorable vote granted",11,0,0,0,11
1847426,1466598,2024-08-30,Senate,"Assembly 3rd Reading AB2677 Chen By Umberg",34,3,0,3,40
1847427,1422027,2024-04-08,Assembly,"Do pass and be re-referred to the Committee on [Appropriations]",15,0,0,0,15
1847427,1444549,2024-05-16,Assembly,"Do pass",15,0,0,0,15
1847427,1448660,2024-05-22,Assembly,"AB 2678 Wallis Assembly Third Reading",71,0,0,9,80
1847427,1460467,2024-06-25,Senate,"Do pass, but first be re-referred to the Committee on [Appropriations]",13,1,0,1,15
1847427,1463598,2024-08-05,Senate,"Placed on suspense file",7,0,0,0,7
1847427,1464496,2024-08-15,Senate,"Do pass",5,1,0,1,7
1847427,1466231,2024-08-29,Senate,"Assembly 3rd Reading AB2678 Wallis By Umberg",35,3,0,2,40
1847429,1428903,2024-04-16,Assembly,"Do pass and be re-referred to the Committee on [Appropriations] with recommendation: To Consent Calendar",16,0,0,0,16
1847429,1443473,2024-05-15,Assembly,"Do pass. To Consent Calendar",15,0,0,0,15
1847429,1445979,2024-05-21,Assembly,"AB 2680 Aguiar-Curry Consent Calendar Second Day Regular Session",71,0,0,9,80
1847429,1456930,2024-06-12,Senate,"Do pass, but first be re-referred to the Committee on [Appropriations] with the recommendation: To Consent Calendar",10,0,0,1,11
1847429,1466005,2024-08-27,Senate,"Assembly 3rd Reading AB2680 Aguiar-Curry By Lim√≥n",40,0,0,0,40
1847429,1467216,2024-08-28,Assembly,"AB 2680 Aguiar-Curry Concurrence in Senate Amendments",77,0,0,2,79
1847430,1424907,2024-04-09,Assembly,"Do pass as amended, and be re-referred to the Committee on [Privacy and Consumer Protection] with recommendation: To Consent Calendar",8,0,0,0,8
1847430,1435253,2024-04-23,Assembly,"Do pass and be re-referred to the Committee on [Appropriations] with recommendation: To Consent Calendar",11,0,0,0,11
1847430,1441338,2024-05-08,Assembly,"Do pass. To Consent Calendar",15,0,0,0,15
1847430,1443974,2024-05-16,Assembly,"AB 2681 Weber Consent Calendar Second Day Regular Session",71,0,0,9,80
1847430,1456449,2024-06-11,Senate,"Do pass as amended, but first amend, and re-refer to the Committee on [Appropriations]",5,0,0,0,5
1847430,1466022,2024-08-27,Senate,"Assembly 3rd Reading AB2681 Weber By Becker",39,0,0,1,40
1847430,1466610,2024-08-28,Assembly,"AB 2681 Weber Concurrence in Senate Amendments",61,0,0,18,79
1847431,1435238,2024-04-24,Assembly,"Do pass",7,0,0,2,9
1847431,1442612,2024-05-13,Assembly,"AB 2682 Kalra Assembly Third Reading",58,5,0,17,80
1847431,1460624,2024-06-26,Senate,"Do pass",5,2,0,0,7
1847431,1465374,2024-08-20,Senate,"Assembly 3rd Reading AB2682 Kalra By Laird",31,8,0,1,40
1847432,1434038,2024-04-24,Assembly,"Do pass as amended and be re-referred to the Committee on [Appropriations]",15,0,0,1,16
1847433,1425912,2024-04-10,Assembly,"Do pass as amended and be re-referred to the Committee on [Emergency Management]",8,1,0,0,9
1847433,1431944,2024-04-22,Assembly,"Do pass and be re-referred to the Committee on [Appropriations]",8,0,0,0,8
1847433,1441329,2024-05-08,Assembly,"Do pass",12,2,0,1,15
1847433,1445267,2024-05-20,Assembly,"AB 2684 Bryan Assembly Third Reading",62,4,0,14,80
1847433,1454251,2024-06-05,Senate,"Do pass as amended, but first amend, and re-refer to the Committee on [Appropriations]",5,1,0,1,7
1847433,1465908,2024-08-27,Senate,"Assembly 3rd Reading AB2684 Bryan et al. By Stern",28,8,0,4,40
1847433,1466892,2024-08-28,Assembly,"AB 2684 Bryan Concurrence in Senate Amendments",67,4,0,8,79
1847434,1428749,2024-04-16,Assembly,"Do pass and be re-referred to the Committee on [Appropriations]",5,0,0,2,7
1847435,1424938,2024-04-09,Assembly,"Do pass as amended and be re-referred to the Committee on [Revenue and Taxation]",7,0,0,0,7
1847437,1433089,2024-04-23,Assembly,"Do pass and be re-referred to the Committee on [Appropriations] with recommendation: To Consent Calendar",17,0,0,1,18
1847437,1441325,2024-05-08,Assembly,"Do pass. To Consent Calendar",15,0,0,0,15
1847437,1444485,2024-05-16,Assembly,"AB 2688 Berman Consent Calendar Second Day Regular Session",71,0,0,9,80
1847437,1462015,2024-07-01,Senate,"Do pass, but first be re-referred to the Committee on [Appropriations]",13,0,0,0,13
1847438,1419125,2024-04-01,Assembly,"Do pass and be re-referred to the Committee on [Appropriations]",7,0,0,0,7
1847438,1424885,2024-04-10,Assembly,"Do pass. To Consent Calendar",14,0,0,1,15
1847438,1431026,2024-04-18,Assembly,"AB 2689 Bains Consent Calendar Second Day Regular Session",72,0,0,8,80
1847438,1456955,2024-06-12,Senate,"Do pass, but first be re-referred to the Committee on [Appropriations] with the recommendation: To Consent Calendar",6,0,0,1,7
1847438,1461256,2024-06-27,Senate,"Consent Calendar 2nd AB2689 Bains et al",40,0,0,0,40
1847439,1424770,2024-04-10,Assembly,"Do pass and be re-referred to the Committee on [Appropriations] with recommendation: To Consent Calendar",7,0,0,0,7
1847439,1444110,2024-05-16,Assembly,"Do pass",15,0,0,0,15
1847439,1448699,2024-05-22,Assembly,"AB 2690 Joe Patterson Assembly Third Reading",65,0,0,15,80
1847439,1460525,2024-06-26,Senate,"Do pass, but first be re-referred to the Committee on [Appropriations] with the recommendation: To Consent Calendar",7,0,0,0,7
1847439,1463841,2024-08-12,Senate,"Consent Calendar 2nd AB2690 Joe Patterson",38,0,0,2,40
1847441,1434159,2024-04-24,Assembly,"Do pass as amended and be re-referred to the Committee on [Appropriations]",7,0,0,1,8
1847441,1443497,2024-05-15,Assembly,"Do pass. To Consent Calendar",15,0,0,0,15
1847441,1448598,2024-05-22,Assembly,"AB 2692 Papan Assembly Third Reading",58,0,0,22,80
1847441,1460105,2024-06-25,Senate,"Do pass as amended, but first amend, and re-refer to the Committee on [Appropriations]",5,0,0,0,5
1847441,1463638,2024-08-05,Senate,"Placed on suspense file",7,0,0,0,7
1847442,1436951,2024-04-30,Assembly,"Do pass and be re-referred to the Committee on [Appropriations]",11,0,0,1,12
1847442,1444525,2024-05-16,Assembly,"Do pass",15,0,0,0,15
1847442,1448613,2024-05-22,Assembly,"AB 2693 Wicks Assembly Third Reading",70,0,0,10,80
1847442,1458353,2024-06-18,Senate,"Do pass, but first be re-referred to the Committee on [Appropriations]",10,0,0,1,11
1847442,1461989,2024-07-01,Senate,"Placed on suspense file",7,0,0,0,7
1847442,1464508,2024-08-15,Senate,"Do pass",5,1,0,1,7
1847442,1466419,2024-08-30,Senate,"Assembly 3rd Reading AB2693 Wicks By Menjivar",39,0,0,1,40
1847443,1429946,2024-04-17,Assembly,"Do pass and be re-referred to the Committee on [Appropriations] with recommendation: To Consent Calendar",9,0,0,0,9
1847443,1437593,2024-05-01,Assembly,"Do pass. To Consent Calendar",14,0,0,1,15
1847443,1441878,2024-05-09,Assembly,"AB 2694 Ward Consent Calendar Second Day Regular Session",64,0,0,16,80
1847443,1453462,2024-06-04,Senate,"Do pass, but first be re-referred to the Committee on [Appropriations] with the recommendation: To Consent Calendar",9,0,0,1,10
1847443,1466161,2024-08-29,Assembly,"AB 2694 Ward Concurrence in Senate Amendments",75,0,0,4,79
1847443,1466667,2024-08-28,Senate,"Assembly 3rd Reading AB2694 Ward By Skinner",39,0,0,1,40
1847444,1433046,2024-04-23,Assembly,"Do pass and be re-referred to the Committee on [Appropriations] with recommendation: To Consent Calendar",8,0,0,0,8
1847444,1444492,2024-05-16,Assembly,"Do pass as amended",12,0,0,3,15
1847444,1449577,2024-05-23,Assembly,"AB 2695 Ramos Assembly Third Reading",73,0,0,7,80
1847444,1459985,2024-06-25,Senate,"Do pass, but first be re-referred to the Committee on [Appropriations] with the recommendation: To Consent Calendar",5,0,0,0,5
1847444,1463636,2024-08-05,Senate,"Placed on suspense file",7,0,0,0,7
1847444,1464633,2024-08-15,Senate,"Do pass",7,0,0,0,7
1847444,1466640,2024-08-28,Senate,"Special Consent AB2695 Ramos By Skinner",39,0,0,1,40
1847445,1421168,2024-04-03,Assembly,"Do pass and be re-referred to the Committee on [Judiciary]",7,0,0,0,7
1847445,1436929,2024-04-30,Assembly,"Do pass and be re-referred to the Committee on [Appropriations]",11,1,0,0,12
1847445,1444117,2024-05-16,Assembly,"Do pass",14,1,0,0,15
1847445,1448541,2024-05-22,Assembly,"AB 2696 Rendon Assembly Third Reading",69,0,0,11,80
1847445,1458544,2024-06-19,Senate,"Do pass, but first be re-referred to the Committee on [Judiciary]",4,0,0,1,5
1847445,1462609,2024-07-02,Senate,"Do pass, but first be re-referred to the Committee on [Appropriations]",11,0,0,0,11
1847445,1463653,2024-08-05,Senate,"Placed on suspense file",7,0,0,0,7
1847445,1464060,2024-08-15,Senate,"Do pass",5,2,0,0,7
1847445,1465935,2024-08-27,Senate,"Assembly 3rd Reading AB2696 Rendon By Atkins",33,5,0,2,40
1847445,1466663,2024-08-28,Assembly,"AB 2696 Rendon Concurrence in Senate Amendments",71,0,0,8,79
1847446,1427368,2024-04-15,Assembly,"Do pass and be re-referred to the Committee on [Utilities and Energy]",14,0,0,1,15
1847446,1434243,2024-04-24,Assembly,"Do pass and be re-referred to the Committee on [Appropriations]",15,0,0,1,16
1847446,1443470,2024-05-15,Assembly,"Do pass",15,0,0,0,15
1847446,1445231,2024-05-20,Assembly,"AB 2697 Irwin Assembly Third Reading",70,0,0,10,80
1847446,1458242,2024-06-18,Senate,"Do pass, but first be re-referred to the Committee on [Transportation]",14,0,0,4,18
1847446,1460425,2024-06-25,Senate,"Do pass as amended, but first amend, and re-refer to the Committee on [Appropriations]",11,4,0,0,15
1847446,1465805,2024-08-27,Senate,"Assembly 3rd Reading AB2697 Irwin et al. By Skinner",40,0,0,0,40
1847446,1466749,2024-08-28,Assembly,"AB 2697 Irwin Concurrence in Senate Amendments",76,0,0,3,79
1847447,1427279,2024-04-15,Assembly,"Do pass and be re-referred to the Committee on [Appropriations] with recommendation: To Consent Calendar",15,0,0,0,15
1847447,1443472,2024-05-15,Assembly,"Do pass as amended. To Consent Calendar",15,0,0,0,15
1847447,1448570,2024-05-22,Assembly,"AB 2698 Ta Consent Calendar Second Day",69,0,0,11,80
1847447,1460618,2024-06-25,Senate,"Do pass, but first be re-referred to the Committee on [Appropriations]",15,0,0,0,15
1847447,1465415,2024-08-21,Senate,"Assembly 3rd Reading AB2698 Ta et al. By Dahle",33,0,0,7,40
1847447,1465689,2024-08-26,Assembly,"AB 2698 Ta Concurrence in Senate Amendments",76,0,0,3,79
1847448,1424979,2024-04-09,Assembly,"Do pass and be re-referred to the Committee on [Judiciary]",5,2,0,0,7
1847448,1428821,2024-04-16,Assembly,"Do pass and be re-referred to the Committee on [Appropriations]",9,3,0,0,12
1847449,1423819,2024-04-09,Assembly,"Do pass as amended and be re-referred to the Committee on [Emergency Management]",13,0,0,3,16
1847449,1431961,2024-04-22,Assembly,"Do pass and be re-referred to the Committee on [Appropriations]",8,0,0,0,8
1847450,1423747,2024-04-09,Assembly,"Do pass and be re-referred to the Committee on [Appropriations]",16,0,0,0,16
1847450,1443961,2024-05-16,Assembly,"Do pass as amended",11,0,0,4,15
1847450,1446036,2024-05-21,Assembly,"AB 2701 Villapudua Assembly Third Reading",72,0,0,8,80
1847450,1456928,2024-06-12,Senate,"Do pass as amended, but first amend, and re-refer to the Committee on [Appropriations] with the recommendation: To Consent Calendar",10,0,0,1,11
1847450,1459354,2024-06-24,Senate,"Placed on suspense file",6,0,0,1,7
1847451,1419170,2024-04-02,Assembly,"Do pass and be re-referred to the Committee on [Higher Education] with recommendation: To Consent Calendar",18,0,0,0,18
1847451,1429982,2024-04-16,Assembly,"Do pass and be re-referred to the Committee on [Appropriations] with recommendation: To Consent Calendar",11,0,0,0,11
1847452,1419118,2024-04-02,Assembly,"Do pass and be re-referred to the Committee on [Appropriations] with recommendation: To Consent Calendar",15,0,0,1,16
1847452,1444603,2024-05-16,Assembly,"Do pass",15,0,0,0,15
1847452,1448557,2024-05-22,Assembly,"AB 2703 Aguiar-Curry Assembly Third Reading",71,0,0,9,80
1847452,1458519,2024-06-19,Senate,"Do pass, but first be re-referred to the Committee on [Appropriations] with the recommendation: To Consent Calendar",11,0,0,0,11
1847452,1461992,2024-07-01,Senate,"Placed on suspense file",7,0,0,0,7
1847452,1464537,2024-08-15,Senate,"Do pass as amended",7,0,0,0,7
1847452,1466581,2024-08-30,Senate,"Special Consent AB2703 Aguiar-Curry By Eggman",40,0,0,0,40
1847452,1467029,2024-08-31,Assembly,"AB 2703 Aguiar-Curry Concurrence in Senate Amendments",77,0,0,2,79
1847453,1432948,2024-04-23,Assembly,"Do pass as amended and be re-referred to the Committee on [Appropriations]",5,0,0,2,7
1847453,1444162,2024-05-16,Assembly,"Do pass",12,1,0,2,15
1847453,1449642,2024-05-23,Assembly,"AB 2704 Zbur Assembly Third Reading",66,0,0,14,80
1847453,1462315,2024-07-01,Senate,"Do pass, but first be re-referred to the Committee on [Appropriations]",5,0,0,0,5
1847453,1463616,2024-08-05,Senate,"Placed on suspense file",7,0,0,0,7
1847453,1464626,2024-08-15,Senate,"Do pass",4,2,0,1,7
1847453,1465701,2024-08-26,Senate,"Assembly 3rd Reading AB2704 Zbur et al. By Menjivar",34,5,0,1,40
1847454,1421158,2024-04-03,Assembly,"Do pass and be re-referred to the Committee on [Judiciary] with recommendation: To Consent Calendar",7,0,0,0,7
1847454,1428956,2024-04-16,Assembly,"Do pass and be re-referred to the Committee on [Appropriations]",11,1,0,0,12
1847454,1437586,2024-05-01,Assembly,"Do pass",14,0,0,1,15
1847454,1444150,2024-05-16,Assembly,"AB 2705 Ortega Assembly Third Reading",69,0,0,11,80
1847454,1456906,2024-06-12,Senate,"Do pass, but first be re-referred to the Committee on [Judiciary]",5,0,0,0,5
1847454,1460622,2024-06-25,Senate,"Do pass, but first be re-referred to the Committee on [Appropriations]",11,0,0,0,11
1847454,1465893,2024-08-27,Senate,"Assembly 3rd Reading AB2705 Ortega By Laird",37,1,0,2,40
1847454,1467175,2024-08-28,Assembly,"AB 2705 Ortega Concurrence in Senate Amendments By LEE",71,4,0,4,79
1847456,1423797,2024-04-09,Assembly,"Do pass and be re-referred to the Committee on [Appropriations]",11,0,0,0,11
1847456,1444633,2024-05-16,Assembly,"Do pass as amended",11,0,0,4,15
1847456,1446073,2024-05-21,Assembly,"AB 2707 Mike Fong Assembly Third Reading",73,0,0,7,80
1847456,1454236,2024-06-05,Senate,"Do pass, but first be re-referred to the Committee on [Appropriations] with the recommendation: To Consent Calendar",7,0,0,0,7
1847456,1458007,2024-06-17,Senate,"Placed on suspense file",7,0,0,0,7
1847457,1424768,2024-04-10,Assembly,"Do pass and be re-referred to the Committee on [Appropriations] with recommendation: To Consent Calendar",11,0,0,0,11
1847457,1437626,2024-05-01,Assembly,"Do pass. To Consent Calendar",14,0,0,1,15
1847457,1441961,2024-05-09,Assembly,"AB 2708 Jim Patterson Consent Calendar Second Day Regular Session",65,0,0,15,80
1847457,1453431,2024-06-04,Senate,"Do pass, but first be re-referred to the Committee on [Appropriations] with the recommendation: To Consent Calendar",18,0,0,0,18
1847457,1458823,2024-06-20,Senate,"Consent Calendar 2nd AB2708 Jim Patterson",36,0,0,4,40
1847458,1420066,2024-04-02,Assembly,"Do pass and be re-referred to the Committee on [Appropriations]",6,0,0,2,8
1847458,1444650,2024-05-16,Assembly,"Do pass as amended",10,4,0,1,15
1847458,1449726,2024-05-23,Assembly,"AB 2709 Bonta Assembly Third Reading",47,8,0,25,80
1847458,1462217,2024-07-02,Senate,"Do pass as amended, but first amend, and re-refer to the Committee on [Appropriations]",4,1,0,0,5
1847458,1463610,2024-08-05,Senate,"Placed on suspense file",7,0,0,0,7
1847459,1433021,2024-04-23,Assembly,"Do pass and be re-referred to the Committee on [Appropriations] with recommendation: To Consent Calendar",8,0,0,0,8
1847460,1435361,2024-04-24,Assembly,"Do pass as amended and be re-referred to the Committee on [Appropriations]",6,0,0,1,7
1847460,1444019,2024-05-16,Assembly,"Do pass",11,3,0,1,15
1847460,1448802,2024-05-22,Assembly,"AB 2711 Ramos Assembly Third Reading",59,8,0,13,80
1847460,1462545,2024-07-03,Senate,"Do pass as amended, but first amend, and re-refer to the Committee on [Appropriations]",6,1,0,0,7
1847460,1463654,2024-08-05,Senate,"Placed on suspense file",7,0,0,0,7
1847460,1464490,2024-08-15,Senate,"Do pass",5,2,0,0,7
1847460,1466107,2024-08-29,Assembly,"AB 2711 Ramos Concurrence in Senate Amendments",60,9,0,10,79
1847460,1466673,2024-08-28,Senate,"Assembly 3rd Reading AB2711 Ramos By Glazer",33,6,0,1,40
1847461,1425895,2024-04-10,Assembly,"Do pass and be re-referred to the Committee on [Housing and Community Development]",3,5,0,1,9
1847461,1425896,2024-04-10,Assembly,Reconsideration,7,1,0,1,9
1847461,1431031,2024-04-17,Assembly,"Do pass and be re-referred to the Committee on [Housing and Community Development]",7,1,0,1,9
1847461,1434258,2024-04-24,Assembly,"Do pass",8,0,0,1,9
1847461,1445271,2024-05-20,Assembly,"AB 2712 Friedman Assembly Third Reading",57,10,0,13,80
1847461,1456422,2024-06-11,Senate,"Do pass as amended, but first amend, and re-refer to the Committee on [Housing]",4,2,0,1,7
1847461,1462701,2024-07-02,Senate,"Do pass",7,2,0,1,10
1847461,1465850,2024-08-27,Senate,"Assembly 3rd Reading AB2712 Friedman et al. By Stern",28,11,0,1,40
1847461,1466821,2024-08-28,Assembly,"AB 2712 Friedman Concurrence in Senate Amendments",57,14,0,8,79
1847462,1423916,2024-04-09,Assembly,"Do pass and be re-referred to the Committee on [Military and Veterans Affairs]",14,0,0,1,15
1847462,1433135,2024-04-23,Assembly,"Do pass and be re-referred to the Committee on [Appropriations]",9,0,0,1,10
1847463,1421160,2024-04-03,Assembly,"Do pass and be re-referred to the Committee on [Appropriations] with recommendation: To Consent Calendar",7,0,0,0,7
1847464,1438436,2024-05-01,Assembly,"Do pass",8,0,0,1,9
1847464,1444353,2024-05-16,Assembly,"AB 2715 Boerner Assembly Third Reading",69,0,0,11,80
1847464,1454258,2024-06-05,Senate,"Do pass, but first be re-referred to the Committee on [Judiciary]",7,0,0,0,7
1847464,1460644,2024-06-25,Senate,"Do pass",11,0,0,0,11
1847464,1465253,2024-08-19,Senate,"Assembly 3rd Reading AB2715 Boerner By Wahab",40,0,0,0,40
1847465,1423794,2024-04-08,Assembly,"Do pass as amended and be re-referred to the Committee on [Appropriations]",8,3,0,0,11
1847465,1444027,2024-05-16,Assembly,"Do pass",11,4,0,0,15
1847465,1446037,2024-05-21,Assembly,"AB 2716 Bryan Assembly Third Reading",46,15,0,19,80
1847465,1460106,2024-06-25,Senate,"Do pass, but first be re-referred to the Committee on [Appropriations]",6,4,0,1,11
1847465,1463419,2024-08-05,Senate,"Placed on suspense file",7,0,0,0,7
1847465,1464266,2024-08-15,Senate,"Do pass as amended",5,2,0,0,7
1847465,1467122,2024-08-31,Senate,"Assembly 3rd Reading AB2716 Bryan et al. By Smallwood-Cuevas",29,9,0,2,40
1847465,1467123,2024-08-31,Assembly,"AB 2716 Bryan Concurrence in Senate Amendments",49,13,0,17,79
1847468,1418341,2024-04-01,Assembly,"Do pass and be re-referred to the Committee on [Appropriations] with recommendation: To Consent Calendar",15,0,0,0,15
1847469,1428867,2024-04-16,Assembly,"Do pass and be re-referred to the Committee on [Appropriations]",7,0,0,0,7
1847470,1434088,2024-04-24,Assembly,"Do pass and be re-referred to the Committee on [Appropriations] with recommendation: To Consent Calendar",9,0,0,1,10
1847470,1444128,2024-05-16,Assembly,"Do pass",15,0,0,0,15
1847470,1448659,2024-05-22,Assembly,"AB 2721 Agriculture Assembly Third Reading By SORIA",72,0,0,8,80
1847470,1462377,2024-07-02,Senate,"Do pass, but first be re-referred to the Committee on [Appropriations] with the recommendation: To Consent Calendar",4,0,0,1,5
1847470,1465295,2024-08-19,Senate,"Assembly 3rd Reading AB2721 AGRI. (Soria) By Caballero",40,0,0,0,40
1847470,1465555,2024-08-26,Assembly,"AB 2721 Agriculture Concurrence in Senate Amendments By SORIA",77,0,0,2,79
1847471,1423917,2024-04-09,Assembly,"Do pass and be re-referred to the Committee on [Appropriations]",11,3,0,1,15
1847472,1423738,2024-04-09,Assembly,"Do pass as amended and be re-referred to the Committee on [Education]",11,0,0,0,11
1847472,1435190,2024-04-24,Assembly,"Do pass as amended and be re-referred to the Committee on [Appropriations]",7,0,0,0,7
1847472,1443474,2024-05-15,Assembly,"Do pass. To Consent Calendar",15,0,0,0,15
1847472,1445969,2024-05-21,Assembly,"AB 2723 Irwin Consent Calendar Second Day Regular Session",71,0,0,9,80
1847472,1458423,2024-06-19,Senate,"Do pass, but first be re-referred to the Committee on [Judiciary]",6,0,0,1,7
1847472,1462607,2024-07-02,Senate,"Do pass as amended, but first amend, and re-refer to the Committee on [Appropriations]",10,0,0,1,11
1847472,1465341,2024-08-20,Senate,"Assembly 3rd Reading AB2723 Irwin By Laird Urgency Clause",39,1,0,0,40
1847472,1465676,2024-08-26,Assembly,"AB 2723 Irwin Concurrence - Urgency Added",77,0,0,2,79
1847473,1412505,2024-03-20,Assembly,"Do pass as amended and be re-referred to the Committee on [Elections]",6,0,0,1,7
1847473,1434239,2024-04-24,Assembly,"Do pass and be re-referred to the Committee on [Appropriations]",8,0,0,0,8
1847473,1444627,2024-05-16,Assembly,"Do pass",13,1,0,1,15
1847473,1448804,2024-05-22,Assembly,"AB 2724 Reyes Assembly Third Reading",66,2,0,12,80
1847473,1458400,2024-06-19,Senate,"Do pass, but first be re-referred to the Committee on [Elections and Constitutional Amendments]",5,0,0,2,7
1847473,1462318,2024-07-02,Senate,"Do pass, but first be re-referred to the Committee on [Appropriations]",6,1,0,0,7
1847473,1463438,2024-08-05,Senate,"Placed on suspense file",7,0,0,0,7
1847473,1464528,2024-08-15,Senate,"Do pass as amended",5,2,0,0,7
1847473,1465808,2024-08-27,Senate,"Assembly 3rd Reading AB2724 Reyes et al. By Newman",31,8,0,1,40
1847473,1466733,2024-08-28,Assembly,"AB 2724 Reyes Concurrence in Senate Amendments",71,2,0,6,79
1847474,1424936,2024-04-10,Assembly,"Do pass as amended, and be re-referred to the Committee on [Appropriations] with recommendation: To Consent Calendar",7,0,0,0,7
1847474,1437629,2024-05-01,Assembly,"Do pass. To Consent Calendar",14,0,0,1,15
1847474,1441918,2024-05-09,Assembly,"AB 2725 Blanca Rubio Consent Calendar Second Day Regular Session",65,0,0,15,80
1847474,1454209,2024-06-05,Senate,"Do pass, but first be re-referred to the Committee on [Appropriations] with the recommendation: To Consent Calendar",7,0,0,0,7
1847474,1458031,2024-06-17,Senate,"Placed on suspense file",7,0,0,0,7
1847474,1464319,2024-08-15,Senate,"Do pass",7,0,0,0,7
1847474,1465955,2024-08-27,Senate,"Assembly 3rd Reading AB2725 Blanca Rubio et al. By Cortese",40,0,0,0,40
1847474,1467171,2024-08-28,Assembly,"AB 2725 Blanca Rubio Concurrence in Senate Amendments",77,0,0,2,79
1847475,1432964,2024-04-23,Assembly,"Do pass as amended, and be re-referred to the Committee on [Appropriations] with recommendation: To Consent Calendar",16,0,0,0,16
1847476,1431937,2024-04-22,Assembly,"Do pass and be re-referred to the Committee on [Appropriations]",8,0,0,0,8
1847477,1424834,2024-04-10,Assembly,"Do pass as amended and be re-referred to the Committee on [Local Government]",7,0,0,2,9
1847477,1435191,2024-04-24,Assembly,"Do pass and be re-referred to the Committee on [Appropriations] with recommendation: To Consent Calendar",8,0,0,1,9
1847477,1443924,2024-05-16,Assembly,"Do pass",14,0,0,1,15
1847477,1448543,2024-05-22,Assembly,"AB 2728 Gabriel Assembly Third Reading",69,0,0,11,80
1847477,1459989,2024-06-24,Senate,"Do pass, but first be re-referred to the Committee on [Appropriations] with the recommendation: To Consent Calendar",10,0,0,0,10
1847477,1463473,2024-08-05,Senate,"Placed on suspense file",7,0,0,0,7
1847478,1402353,2024-03-04,Assembly,"Be adopted. To third reading",8,0,0,3,11
1847478,1425894,2024-04-11,Senate,"Special Consent ACR142 Essayli et al",39,0,0,1,40
1847479,1423866,2024-04-09,Senate,"Do pass, but first be re-referred to the Committee on [Appropriations]",9,0,0,2,11
1847479,1450274,2024-05-21,Senate,"Senate 3rd Reading SB1137 Smallwood-Cuevas et",31,6,0,3,40
1847479,1456440,2024-06-11,Assembly,"Do pass as amended and be re-referred to the Committee on [Appropriations]",9,3,0,0,12
1847479,1462270,2024-07-02,Assembly,"Do pass",11,4,0,0,15
1847479,1465269,2024-08-19,Assembly,"SB 1137 Smallwood-Cuevas Senate Third Reading By McKinnor",62,6,0,11,79
1847479,1467030,2024-08-28,Senate,"Unfinished Business SB1137 Smallwood-Cuevas et Concurrence",31,8,0,1,40
1847480,1424845,2024-04-10,Senate,"Do pass, but first be re-referred to the Committee on [Military and Veterans Affairs] with the recommendation: To Consent Calendar",7,0,0,0,7
1847480,1431945,2024-04-22,Senate,"Do pass, but first be re-referred to the Committee on [Appropriations] with the recommendation: To Consent Calendar",5,0,0,0,5
1847480,1439722,2024-05-06,Senate,"Placed on suspense file",7,0,0,0,7
1847480,1444584,2024-05-16,Senate,"Do pass",7,0,0,0,7
1847480,1449666,2024-05-23,Senate,"Special Consent SB1138 Newman",37,0,0,3,40
1847480,1456941,2024-06-12,Assembly,"Do pass and be re-referred to the Committee on [Military and Veterans Affairs] with recommendation: To Consent Calendar",7,0,0,0,7
1847480,1460101,2024-06-25,Assembly,"Do pass and be re-referred to the Committee on [Appropriations]",9,0,0,1,10
1847480,1464481,2024-08-15,Assembly,"Do pass",14,0,0,1,15
1847480,1465733,2024-08-26,Assembly,"SB 1138 Newman Senate Third Reading By Alvarez",76,1,0,2,79
1847480,1467156,2024-08-28,Senate,"Special Consent SB1138 Newman",39,0,0,1,40
1847481,1423739,2024-04-09,Senate,"Do pass as amended, but first amend, and re-refer to the Committee on [Local Government] with the recommendation: To Consent Calendar",11,0,0,0,11
1847482,1412525,2024-03-20,Senate,"Do pass as amended, but first amend, and re-refer to the Committee on [Environmental Quality]",6,0,0,1,7
1847482,1434238,2024-04-24,Senate,"Do pass",5,2,0,0,7
1847482,1450364,2024-05-21,Senate,"Senate 3rd Reading SB1140 Caballero",32,7,0,1,40
1847482,1456866,2024-06-12,Assembly,"Do pass as amended",8,1,0,0,9
1847482,1463893,2024-08-12,Assembly,"SB 1140 Caballero Senate Third Reading By Juan Carrillo",64,5,0,10,79
1847482,1465365,2024-08-20,Senate,"Unfinished Business SB1140 Caballero Concurrence",32,7,0,1,40
1847483,1437594,2024-04-30,Senate,"Do pass as amended",11,0,0,0,11
1847483,1445224,2024-05-20,Senate,"Senate 3rd Reading SB1141 Niello",38,0,0,2,40
1847483,1462308,2024-07-02,Assembly,"Do pass",2,6,0,4,12
1847484,1433151,2024-04-22,Senate,"Do pass as amended, but first amend, and re-refer to the Committee on [Appropriations]",14,3,0,1,18
1847484,1442601,2024-05-13,Senate,"Placed on suspense file",7,0,0,0,7
1847484,1444226,2024-05-16,Senate,"Do pass",5,2,0,0,7
1847484,1450320,2024-05-21,Senate,"Senate 3rd Reading SB1142 Menjivar",30,8,0,2,40
1847484,1462008,2024-07-01,Assembly,"Do pass as amended and be re-referred to the Committee on [Appropriations]",12,0,0,4,16
1847484,1464243,2024-08-15,Assembly,"Do pass as amended",11,2,0,2,15
1847484,1466202,2024-08-29,Senate,"Unfinished Business SB1142 Menjivar Concurrence",31,8,0,1,40
1847484,1467204,2024-08-28,Assembly,"SB 1142 Menjivar Senate Third Reading By Bauer-Kahan",64,6,0,9,79
1847485,1420079,2024-04-03,Senate,"Do pass, but first be re-referred to the Committee on [Judiciary]",5,2,0,0,7
1847485,1428920,2024-04-16,Senate,"Do pass as amended, but first amend, and re-refer to the Committee on [Appropriations]",10,0,0,1,11
1847485,1436228,2024-04-29,Senate,"Placed on suspense file",5,0,0,2,7
1847485,1444495,2024-05-16,Senate,"Do pass as amended",5,2,0,0,7
1847485,1450287,2024-05-21,Senate,"Senate 3rd Reading SB1143 Allen By Skinner",30,7,0,3,40
1847485,1460433,2024-06-25,Assembly,"Do pass and be re-referred to the Committee on [Natural Resources]",5,2,0,0,7
1847485,1461990,2024-07-01,Assembly,"Do pass and be re-referred to the Committee on [Appropriations]",9,2,0,1,12
1847485,1464402,2024-08-15,Assembly,"Do pass as amended",11,3,0,1,15
1847485,1466196,2024-08-29,Senate,"That the Assembly amendments be concurred in",5,1,0,1,7
1847485,1466573,2024-08-30,Senate,"Unfinished Business SB1143 Allen Concurrence",36,3,0,1,40
1847485,1467061,2024-08-28,Assembly,"SB 1143 Allen Senate Third Reading By Friedman",65,3,0,11,79
1847486,1420038,2024-04-02,Senate,"Do pass as amended, but first amend, and re-refer to the Committee on [Public Safety]",10,1,0,0,11
1847486,1432980,2024-04-23,Senate,"Do pass, but first be re-referred to the Committee on [Appropriations]",4,0,0,1,5
1847486,1439692,2024-05-06,Senate,"Placed on suspense file",7,0,0,0,7
1847486,1443915,2024-05-16,Senate,"Do pass as amended",5,2,0,0,7
1847486,1448767,2024-05-22,Senate,"Senate 3rd Reading SB1144 Skinner et al",33,1,0,6,40
1847486,1456290,2024-06-11,Assembly,"Do pass and be re-referred to the Committee on [Privacy and Consumer Protection]",11,0,0,1,12
1847486,1456911,2024-06-11,Assembly,"Do pass and be re-referred to the Committee on [Appropriations]",11,0,0,0,11
1847486,1458436,2024-06-19,Assembly,"Do pass as amended",10,4,0,1,15
1847486,1463787,2024-08-08,Assembly,"SB 1144 Skinner Senate Third Reading By Wilson",73,0,0,6,79
1847486,1463874,2024-08-12,Senate,"Unfinished Business SB1144 Skinner et al. Concurrence",38,0,0,2,40
1847487,1432992,2024-04-23,Senate,"Do pass, but first be re-referred to the Committee on [Appropriations] with the recommendation: To Consent Calendar",16,0,0,0,16
1847487,1441901,2024-05-09,Senate,"Consent Calendar 2nd SB1145 Alvarado-Gil",37,0,0,3,40
1847488,1429942,2024-04-17,Senate,"Do pass, but first be re-referred to the Committee on [Judiciary] with the recommendation: To Consent Calendar",7,0,0,0,7
1847488,1437630,2024-04-30,Senate,"Do pass as amended, and be ordered to the Consent Calendar",11,0,0,0,11
1847488,1441880,2024-05-09,Senate,"Consent Calendar 2nd SB1146 Wilk",37,0,0,3,40
1847488,1458037,2024-06-17,Assembly,"Do pass and be re-referred to the Committee on [Judiciary]",8,0,0,1,9
1847488,1459972,2024-06-25,Assembly,"Do pass. To Consent Calendar",11,0,0,1,12
1847488,1462066,2024-07-01,Assembly,"SB 1146 Wilk Consent Calendar Second Day Regular Session",72,0,0,7,79
1847488,1465541,2024-08-26,Assembly,"SB 1146 Wilk Senate Third Reading By Chen",77,0,0,2,79
1847488,1467043,2024-08-28,Senate,"Special Consent SB1146 Wilk",39,0,0,1,40
1847489,1429884,2024-04-17,Senate,"Do pass, but first be re-referred to the Committee on [Rules]",5,0,0,2,7
1847489,1435222,2024-04-24,Senate,"Do pass, but first be re-referred to the Committee on [Appropriations]",9,0,0,2,11
1847489,1442647,2024-05-13,Senate,"Placed on suspense file",7,0,0,0,7
1847489,1444668,2024-05-16,Senate,"Do pass",5,2,0,0,7
1847489,1445241,2024-05-20,Senate,"Senate 3rd Reading SB1147 Portantino et al",32,3,0,5,40
1847489,1458310,2024-06-18,Assembly,"Do pass and be re-referred to the Committee on [Environmental Safety and Toxic Materials]",14,0,0,2,16
1847489,1460589,2024-06-25,Assembly,"Do pass and be re-referred to the Committee on [Appropriations]",6,0,0,1,7
1847489,1464113,2024-08-15,Assembly,"Do pass as amended",12,1,0,2,15
1847489,1466307,2024-08-29,Senate,"Unfinished Business SB1147 Portantino et al. Concurrence",33,4,0,3,40
1847489,1466817,2024-08-28,Assembly,"SB 1147 Portantino Senate Third Reading By Lowenthal",66,0,0,13,79
1847490,1433064,2024-04-22,Senate,"Do pass, but first be re-referred to the Committee on [Labor, Public Employment and Retirement ]",6,6,0,6,18
1847492,1420174,2024-04-02,Senate,"Do pass",10,0,0,1,11
1847492,1422038,2024-04-08,Senate,"Senate 3rd Reading SB1150 Laird",32,0,0,8,40
1847492,1456372,2024-06-11,Assembly,"Do pass as amended. To Consent Calendar",12,0,0,0,12
1847492,1466551,2024-08-30,Senate,"Special Consent SB1150 Laird",40,0,0,0,40
1847492,1467185,2024-08-28,Assembly,"SB 1150 Laird Senate Third Reading By Reyes",77,0,0,2,79
1847493,1428894,2024-04-16,Senate,"Do pass, but first be re-referred to the Committee on [Appropriations]",7,0,0,0,7
1847493,1436176,2024-04-29,Senate,"Placed on suspense file",5,0,0,2,7
1847493,1444446,2024-05-16,Senate,"Do pass",7,0,0,0,7
1847493,1449678,2024-05-23,Senate,"Special Consent SB1151 Hurtado",37,0,0,3,40
1847493,1460427,2024-06-26,Assembly,"Do pass and be re-referred to the Committee on [Appropriations]",8,0,0,0,8
1847494,1433169,2024-04-23,Senate,"Do pass as amended, but first amend, and re-refer to the Committee on [Appropriations]",16,0,0,0,16
1847494,1442556,2024-05-13,Senate,"Placed on suspense file",7,0,0,0,7
1847494,1444405,2024-05-16,Senate,"Do pass",7,0,0,0,7
1847494,1449554,2024-05-23,Senate,"Special Consent SB1152 Lim√≥n",37,0,0,3,40
1847494,1459963,2024-06-24,Assembly,"Do pass as amended and be re-referred to the Committee on [Appropriations]",8,0,0,0,8
1847494,1464403,2024-08-15,Assembly,"Do pass as amended",11,0,0,4,15
1847494,1466156,2024-08-29,Senate,"Unfinished Business SB1152 Lim√≥n Concurrence",40,0,0,0,40
1847494,1466700,2024-08-28,Assembly,"SB 1152 Lim√≥n Senate Third Reading By Rodriguez",77,0,0,2,79
1847497,1428814,2024-04-16,Senate,"Do pass as amended, but first amend, and re-refer to the Committee on [Appropriations]",6,0,0,1,7
1847497,1445270,2024-05-20,Senate,"Senate 3rd Reading SB1155 Hurtado",39,0,0,1,40
1847497,1460607,2024-06-26,Assembly,"Do pass and be re-referred to the Committee on [Appropriations]",8,0,0,0,8
1847497,1463759,2024-08-07,Assembly,"Do pass. To Consent Calendar",14,0,0,1,15
1847497,1464536,2024-08-15,Assembly,"SB 1155 Hurtado Consent Calendar Second Day Regular Session",75,0,0,4,79
1847497,1466439,2024-08-30,Assembly,"SB 1155 Hurtado Senate Third Reading By Pellerin",77,0,0,2,79
1847497,1466990,2024-08-31,Senate,"Unfinished Business SB1155 Hurtado Concurrence",40,0,0,0,40
1847498,1423825,2024-04-09,Senate,"Do pass, but first be re-referred to the Committee on [Elections and Constitutional Amendments] with the recommendation: To Consent Calendar",11,0,0,0,11
1847498,1428964,2024-04-16,Senate,"Do pass, but first be re-referred to the Committee on [Appropriations] with the recommendation: To Consent Calendar",7,0,0,0,7
1847498,1445273,2024-05-20,Senate,"Senate 3rd Reading SB1156 Hurtado",39,0,0,1,40
1847498,1460493,2024-06-26,Assembly,"Do pass and be re-referred to the Committee on [Appropriations]",8,0,0,0,8
1847498,1463714,2024-08-07,Assembly,"Do pass. To Consent Calendar",14,0,0,1,15
1847498,1464202,2024-08-15,Assembly,"SB 1156 Hurtado Consent Calendar Second Day Regular Session",75,0,0,4,79
1847498,1465441,2024-08-22,Senate,"Special Consent SB1156 Hurtado et al",33,0,0,7,40
1847499,1423879,2024-04-09,Senate,"Do pass as amended, but first amend, and re-refer to the Committee on [Labor, Public Employment and Retirement ]",14,0,0,2,16
1847499,1430085,2024-04-17,Senate,"Do pass, but first be re-referred to the Committee on [Appropriations]",5,0,0,0,5
1847499,1436186,2024-04-29,Senate,"Placed on suspense file",5,0,0,2,7
1847500,1412520,2024-03-20,Senate,"Do pass, but first be re-referred to the Committee on [Transportation]",5,0,0,2,7
1847500,1434178,2024-04-23,Senate,"Do pass, but first be re-referred to the Committee on [Appropriations] with the recommendation: To Consent Calendar",15,0,0,0,15
1847500,1441894,2024-05-09,Senate,"Consent Calendar 2nd SB1158 Archuleta",37,0,0,3,40
1847500,1458194,2024-06-17,Assembly,"Do pass and be re-referred to the Committee on [Natural Resources] with recommendation: To Consent Calendar",15,0,0,0,15
1847500,1459382,2024-06-24,Assembly,"Do pass and be re-referred to the Committee on [Appropriations] with recommendation: To Consent Calendar",10,0,0,1,11
1847500,1463708,2024-08-07,Assembly,"Do pass. To Consent Calendar",14,0,0,1,15
1847500,1464050,2024-08-15,Assembly,"SB 1158 Archuleta Consent Calendar Second Day Regular Session",75,0,0,4,79
1847501,1420123,2024-04-03,Senate,"Do pass, but first be re-referred to the Committee on [Natural Resources and Water]",7,0,0,0,7
1847501,1433183,2024-04-23,Senate,"Do pass as amended, but first amend, and re-refer to the Committee on [Appropriations]",11,0,0,0,11
1847501,1442665,2024-05-13,Senate,"Placed on suspense file",7,0,0,0,7
1847501,1444661,2024-05-16,Senate,"Do pass",7,0,0,0,7
1847501,1449654,2024-05-23,Senate,"Special Consent SB1159 Dodd",37,0,0,3,40
1847501,1458013,2024-06-17,Assembly,"Do pass as amended and be re-referred to the Committee on [Appropriations]",10,0,0,1,11
1847502,1433180,2024-04-23,Senate,"Do pass as amended, but first amend, and re-refer to the Committee on [Appropriations]",4,0,0,1,5
1847502,1439740,2024-05-06,Senate,"Placed on suspense file",7,0,0,0,7
1847503,1411412,2024-03-19,Senate,"Do pass, but first be re-referred to the Committee on [Judiciary]",5,0,0,0,5
1847503,1420078,2024-04-02,Senate,"Do pass, but first be re-referred to the Committee on [Appropriations] with the recommendation: To Consent Calendar",11,0,0,0,11
1847503,1431971,2024-04-22,Senate,"Placed on suspense file",7,0,0,0,7
1847503,1444555,2024-05-16,Senate,"Do pass",7,0,0,0,7
1847503,1449607,2024-05-23,Senate,"Special Consent SB1161 Becker",37,0,0,3,40
1847503,1462481,2024-07-02,Assembly,"Do pass and be re-referred to the Committee on [Appropriations]",7,0,0,1,8
1847503,1463997,2024-08-15,Assembly,"Do pass",11,2,0,2,15
1847503,1465549,2024-08-26,Assembly,"SB 1161 Becker Senate Third Reading By Jackson",62,6,0,11,79
1847503,1465821,2024-08-27,Senate,"Unfinished Business SB1161 Becker Concurrence",40,0,0,0,40
1847504,1429966,2024-04-17,Senate,"Do pass, but first be re-referred to the Committee on [Rules]",5,0,0,0,5
1847504,1434044,2024-04-23,Senate,"Do pass, but first be re-referred to the Committee on [Appropriations] with the recommendation: To Consent Calendar",11,0,0,0,11
1847504,1439671,2024-05-06,Senate,"Placed on suspense file",7,0,0,0,7
1847504,1444504,2024-05-16,Senate,"Do pass",7,0,0,0,7
1847504,1445280,2024-05-20,Senate,"Senate 3rd Reading SB1162 Cortese",39,0,0,1,40
1847504,1458484,2024-06-19,Assembly,"Do pass and be re-referred to the Committee on [Privacy and Consumer Protection] with recommendation: To Consent Calendar",7,0,0,0,7
1847504,1462457,2024-07-02,Assembly,"Do pass and be re-referred to the Committee on [Appropriations] with recommendation: To Consent Calendar",11,0,0,0,11
1847504,1464102,2024-08-15,Assembly,"Do pass as amended",11,0,0,4,15
1847504,1466436,2024-08-30,Assembly,"Do pass",7,0,0,0,7
1847504,1466940,2024-08-31,Senate,"Unfinished Business SB1162 Cortese Concurrence",30,8,0,2,40
1847504,1466941,2024-08-31,Assembly,"SB 1162 Cortese Senate Third Reading By Kalra",72,0,0,7,79
1847505,1427265,2024-04-15,Senate,"Do pass as amended, but first amend, and re-refer to the Committee on [Appropriations] with the recommendation: To Consent Calendar",10,0,0,1,11
1847505,1436170,2024-04-29,Senate,"Placed on suspense file",5,0,0,2,7
1847505,1444056,2024-05-16,Senate,"Do pass as amended",7,0,0,0,7
1847505,1450005,2024-05-24,Senate,"Special Consent SB1163 Dahle et al",38,0,0,2,40
1847505,1459974,2024-06-25,Assembly,"Do pass as amended, and be re-referred to the Committee on [Appropriations] with recommendation: To Consent Calendar",13,0,0,2,15
1847506,1424852,2024-04-10,Senate,"Do pass as amended, but first amend, and re-refer to the Committee on [Appropriations]",6,0,0,1,7
1847506,1431997,2024-04-22,Senate,"Placed on suspense file",7,0,0,0,7
1847506,1443927,2024-05-16,Senate,"Do pass as amended",5,2,0,0,7
1847506,1448762,2024-05-22,Senate,"Senate 3rd Reading SB1164 Newman",29,6,0,5,40
1847507,1419139,2024-04-02,Senate,"Do pass, but first be re-referred to the Committee on [Environmental Quality]",15,1,0,2,18
1847507,1434235,2024-04-24,Senate,"Do pass as amended, but first amend, and re-refer to the Committee on [Appropriations]",5,0,0,2,7
1847507,1442522,2024-05-13,Senate,"Placed on suspense file",7,0,0,0,7
1847508,1424904,2024-04-10,Senate,"Do pass, but first be re-referred to the Committee on [Appropriations]",7,0,0,0,7
1847508,1431892,2024-04-22,Senate,"Placed on suspense file",7,0,0,0,7
1847508,1444385,2024-05-16,Senate,"Do pass",7,0,0,0,7
1847508,1449672,2024-05-23,Senate,"Special Consent SB1166 Dodd",37,0,0,3,40
1847508,1458275,2024-06-18,Assembly,"Do pass as amended and be re-referred to the Committee on [Appropriations]",9,0,0,2,11
1847508,1464295,2024-08-15,Assembly,"Do pass as amended",11,0,0,4,15
1847508,1466506,2024-08-30,Senate,"Special Consent SB1166 Dodd et al",40,0,0,0,40
1847508,1467028,2024-08-28,Assembly,"SB 1166 Dodd Senate Third Reading By Mike Fong",77,0,0,2,79
1847509,1430038,2024-04-17,Senate,"Do pass, but first be re-referred to the Committee on [Appropriations]",2,2,0,3,7
1847510,1423722,2024-04-09,Senate,"Do pass, but first be re-referred to the Committee on [Banking and Financial Institutions] with the recommendation: To Consent Calendar",11,0,0,0,11
1847510,1441885,2024-05-09,Senate,"Consent Calendar 2nd SB1168 Lim√≥n",37,0,0,3,40
1847510,1458171,2024-06-18,Assembly,"Do pass and be re-referred to the Committee on [Judiciary] with recommendation: To Consent Calendar",11,0,0,0,11
1847510,1462376,2024-07-02,Assembly,"Do pass and be re-referred to the Committee on [Appropriations] with recommendation: To Consent Calendar",11,0,0,1,12
1847510,1463712,2024-08-07,Assembly,"Do pass. To Consent Calendar",14,0,0,1,15
1847510,1464438,2024-08-15,Assembly,"SB 1168 Lim√≥n Consent Calendar Second Day Regular Session",75,0,0,4,79
1847511,1437622,2024-05-01,Senate,"Do pass and be ordered to the Consent Calendar",6,0,0,1,7
1847511,1441943,2024-05-09,Senate,"Consent Calendar 2nd SB1169 Stern et al",37,0,0,3,40
1847511,1456874,2024-06-12,Assembly,"Do pass. To Consent Calendar",9,0,0,0,9
1847511,1458778,2024-06-20,Assembly,"SB 1169 Stern Consent Calendar Second Day Regular Session",67,0,0,12,79
1847512,1436949,2024-04-30,Senate,"Do pass",6,0,0,1,7
1847512,1450308,2024-05-21,Senate,"Senate 3rd Reading SB1170 Menjivar",31,8,0,1,40
1847512,1456886,2024-06-12,Assembly,"Do pass and be re-referred to the Committee on [Appropriations]",6,0,0,2,8
1847512,1464006,2024-08-15,Assembly,"Do pass as amended",11,3,0,1,15
1847512,1466512,2024-08-30,Assembly,"SB 1170 Menjivar Senate Third Reading By Pellerin",60,11,0,8,79
1847512,1467084,2024-08-31,Senate,"Unfinished Business SB1170 Menjivar et al. Concurrence",31,9,0,0,40
1847513,1430011,2024-04-17,Senate,"Do pass, but first be re-referred to the Committee on [Appropriations]",7,0,0,0,7
1847513,1436177,2024-04-29,Senate,"Placed on suspense file",5,0,0,2,7
1847514,1424987,2024-04-10,Senate,"Do pass, but first be re-referred to the Committee on [Appropriations] with the recommendation: To Consent Calendar",6,0,0,1,7
1847514,1435247,2024-04-25,Senate,"Consent Calendar 2nd SB1172 Grove",36,0,0,4,40
1847514,1456417,2024-06-10,Assembly,"Do pass and be re-referred to the Committee on [Appropriations]",6,0,0,1,7
1847514,1458486,2024-06-19,Assembly,"Do pass. To Consent Calendar",14,0,0,1,15
1847514,1460753,2024-06-26,Assembly,"SB 1172 Grove Consent Calendar Second Day Regular Session",75,0,0,4,79
1847516,1419136,2024-04-02,Senate,"Do pass, but first be re-referred to the Committee on [Local Government]",6,1,0,0,7
1847516,1437607,2024-05-01,Senate,"Do pass as amended",4,2,0,1,7
1847516,1450277,2024-05-21,Senate,"Senate 3rd Reading SB1174 Min et al",30,8,0,2,40
1847516,1456865,2024-06-12,Assembly,"Do pass and be re-referred to the Committee on [Local Government]",6,2,0,0,8
1847516,1458460,2024-06-19,Assembly,"Do pass",7,2,0,0,9
1847516,1465843,2024-08-27,Assembly,"SB 1174 Min Senate Third Reading By BERMAN",57,16,0,6,79
1847517,1420102,2024-04-03,Senate,"Do pass as amended, but first amend, and re-refer to the Committee on [Appropriations]",7,0,0,0,7
1847517,1445230,2024-05-20,Senate,"Senate 3rd Reading SB1175 Ochoa Bogh et al",36,1,0,3,40
1847517,1455802,2024-06-10,Assembly,"Do pass and be re-referred to the Committee on [Appropriations]",10,0,0,1,11
1847518,1423768,2024-04-09,Senate,"Do pass, but first be re-referred to the Committee on [Environmental Quality] with the recommendation: To Consent Calendar",11,0,0,0,11
1847518,1434115,2024-04-24,Senate,"Do pass, but first be re-referred to the Committee on [Appropriations] with the recommendation: To Consent Calendar",7,0,0,0,7
1847518,1442521,2024-05-13,Senate,"Placed on suspense file",7,0,0,0,7
1847518,1444383,2024-05-16,Senate,"Do pass as amended",7,0,0,0,7
1847518,1450007,2024-05-24,Senate,"Special Consent SB1176 Niello",38,0,0,2,40
1847518,1458023,2024-06-17,Assembly,"Do pass and be re-referred to the Committee on [Environmental Safety and Toxic Materials] with recommendation: To Consent Calendar",10,0,0,1,11
1847518,1460692,2024-06-25,Assembly,"Do pass and be re-referred to the Committee on [Appropriations] with recommendation: To Consent Calendar",7,0,0,0,7
1847519,1411368,2024-03-19,Senate,"Do pass as amended, but first amend, and re-refer to the Committee on [Appropriations]",14,0,0,4,18
1847519,1445235,2024-05-20,Senate,"Senate 3rd Reading SB1177 Bradford",33,0,0,7,40
1847519,1462081,2024-07-01,Assembly,"Do pass and be re-referred to the Committee on [Appropriations]",13,0,0,3,16
1847519,1463743,2024-08-07,Assembly,"Do pass",10,2,0,3,15
1847519,1465737,2024-08-26,Assembly,"SB 1177 Bradford Senate Third Reading By Santiago",65,2,0,12,79
1847519,1466905,2024-08-28,Senate,"Unfinished Business SB1177 Bradford Concurrence",32,1,0,7,40
1847520,1434074,2024-04-24,Senate,"Do pass as amended, but first amend, and re-refer to the Committee on [Revenue and Taxation]",5,2,0,0,7
1847520,1442548,2024-05-13,Senate,"Placed on suspense file",7,0,0,0,7
1847520,1444380,2024-05-16,Senate,"Do pass",5,2,0,0,7
1847520,1450323,2024-05-21,Senate,"Senate 3rd Reading SB1178 Padilla et al",31,8,0,1,40
1847520,1460472,2024-06-25,Assembly,"Do pass and be re-referred to the Committee on [Appropriations]",5,2,0,0,7
1847522,1435320,2024-04-24,Senate,"Do pass as amended, but first amend, and re-refer to the Committee on [Appropriations]",10,0,0,1,11
1847522,1439629,2024-05-06,Senate,"Placed on suspense file",7,0,0,0,7
1847522,1444237,2024-05-16,Senate,"Do pass as amended",5,0,0,2,7
1847522,1450328,2024-05-21,Senate,"Senate 3rd Reading SB1180 Ashby",35,0,0,5,40
1847522,1458312,2024-06-18,Assembly,"Do pass as amended and be re-referred to the Committee on [Appropriations]",16,0,0,0,16
1847522,1464030,2024-08-15,Assembly,"Do pass",13,0,0,2,15
1847522,1466428,2024-08-30,Senate,"Special Consent SB1180 Ashby et al",40,0,0,0,40
1847522,1466907,2024-08-28,Assembly,"SB 1180 Ashby Senate Third Reading By Bonta",76,0,0,3,79
1847523,1433094,2024-04-22,Senate,"Do pass as amended, but first amend, and re-refer to the Committee on [Appropriations]",6,0,0,1,7
1847523,1449579,2024-05-23,Senate,"Senate 3rd Reading SB1181 Glazer",37,0,0,3,40
1847523,1460568,2024-06-26,Assembly,"Do pass as amended and be re-referred to the Committee on [Appropriations]",7,0,0,1,8
1847523,1463754,2024-08-07,Assembly,"Do pass",13,0,0,2,15
1847523,1466414,2024-08-30,Assembly,"SB 1181 Glazer Senate Third Reading By Berman",74,0,0,5,79
1847523,1467157,2024-08-31,Senate,"Unfinished Business SB1181 Glazer Concurrence",40,0,0,0,40
1847524,1411392,2024-03-19,Senate,"Do pass, but first be re-referred to the Committee on [Education]",17,0,0,1,18
1847524,1420115,2024-04-03,Senate,"Do pass, but first be re-referred to the Committee on [Appropriations]",6,0,0,1,7
1847524,1427240,2024-04-15,Senate,"Placed on suspense file",6,0,0,1,7
1847524,1444203,2024-05-16,Senate,"Do pass as amended",6,0,0,1,7
1847524,1450264,2024-05-21,Senate,"Senate 3rd Reading SB1182 Gonzalez et al",36,0,0,4,40
1847524,1457967,2024-06-17,Assembly,"Do pass as amended and be re-referred to the Committee on [Education]",8,0,0,3,11
1847524,1460786,2024-06-26,Assembly,"Do pass and be re-referred to the Committee on [Appropriations]",6,0,0,1,7
1847524,1464382,2024-08-15,Assembly,"Do pass",11,1,0,3,15
1847524,1465594,2024-08-26,Assembly,"SB 1182 Gonzalez Senate Third Reading By Ting",69,1,0,9,79
1847524,1465856,2024-08-27,Senate,"Unfinished Business SB1182 Gonzalez et al. Concurrence",39,0,0,1,40
1847525,1420087,2024-04-03,Senate,"Do pass, but first be re-referred to the Committee on [Appropriations] with the recommendation: To Consent Calendar",6,0,0,1,7
1847525,1430968,2024-04-18,Senate,"Consent Calendar 2nd SB1183 Hurtado",39,0,0,1,40
1847525,1458336,2024-06-18,Assembly,"Do pass as amended and be re-referred to the Committee on [Appropriations]",8,0,0,3,11
1847525,1464299,2024-08-15,Assembly,"Do pass",14,0,0,1,15
1847525,1465618,2024-08-26,Assembly,"SB 1183 Hurtado Senate Third Reading By Weber",77,0,0,2,79
1847525,1467031,2024-08-28,Senate,"Special Consent SB1183 Hurtado",39,0,0,1,40
1847526,1412594,2024-03-20,Senate,"Do pass as amended, but first amend, and re-refer to the Committee on [Judiciary]",11,0,0,0,11
1847526,1437660,2024-04-30,Senate,"Do pass as amended",11,0,0,0,11
1847526,1450376,2024-05-21,Senate,"Senate 3rd Reading SB1184 Eggman",39,0,0,1,40
1847526,1456373,2024-06-11,Assembly,"Do pass and be re-referred to the Committee on [Judiciary]",16,0,0,0,16
1847526,1460107,2024-06-25,Assembly,"Do pass as amended",10,0,0,2,12
1847526,1464420,2024-08-15,Assembly,"Do pass",14,0,0,1,15
1847526,1465663,2024-08-26,Assembly,"SB 1184 Eggman Senate Third Reading By Maienschein",75,0,0,4,79
1847526,1467048,2024-08-28,Senate,"Unfinished Business SB1184 Eggman Concurrence",39,0,0,1,40
1847527,1432958,2024-04-23,Senate,"Do pass, but first be re-referred to the Committee on [Appropriations]",3,8,0,0,11
1847528,1419221,2024-04-02,Senate,"Do pass, but first be re-referred to the Committee on [Appropriations] with the recommendation: To Consent Calendar",3,0,0,2,5
1847528,1419222,2024-04-02,Senate,"[04-02-2024] set for [First] hearing: Reconsideration of favorable vote granted",4,0,0,1,5
1847528,1419223,2024-04-02,Senate,"Do pass, but first be re-referred to the Committee on [Appropriations] with the recommendation: To Consent Calendar",4,0,0,1,5
1847528,1430995,2024-04-18,Senate,"Consent Calendar 2nd SB1186 Ochoa Bogh",39,0,0,1,40
1847528,1460455,2024-06-26,Assembly,"Do pass and be re-referred to the Committee on [Appropriations] with recommendation: To Consent Calendar",8,0,0,2,10
1847528,1463732,2024-08-07,Assembly,"Do pass. To Consent Calendar",14,0,0,1,15
1847528,1464504,2024-08-15,Assembly,"SB 1186 Ochoa Bogh Consent Calendar Second Day Regular Session",75,0,0,4,79
1847529,1420169,2024-04-02,Senate,"Do pass, but first be re-referred to the Committee on [Appropriations]",10,0,0,0,10
1847529,1427340,2024-04-15,Senate,"Placed on suspense file",6,0,0,1,7
1847529,1444181,2024-05-16,Senate,"Do pass",7,0,0,0,7
1847529,1449665,2024-05-23,Senate,"Special Consent SB1187 McGuire",37,0,0,3,40
1847529,1460430,2024-06-26,Assembly,"Do pass and be re-referred to the Committee on [Appropriations] with recommendation: To Consent Calendar",9,0,0,0,9
1847529,1464448,2024-08-15,Assembly,"Do pass",14,0,0,1,15
1847529,1466405,2024-08-30,Senate,"Special Consent SB1187 McGuire",40,0,0,0,40
1847529,1466925,2024-08-28,Assembly,"SB 1187 McGuire Senate Third Reading By Aguiar-Curry",77,0,0,2,79
1847530,1429906,2024-04-17,Senate,"Do pass, but first be re-referred to the Committee on [Appropriations]",5,2,0,0,7
1847530,1436230,2024-04-29,Senate,"Placed on suspense file",5,0,0,2,7
1847530,1444411,2024-05-16,Senate,"Do pass as amended",5,2,0,0,7
1847530,1450380,2024-05-21,Senate,"Senate 3rd Reading SB1188 Laird",29,8,0,3,40
1847530,1460614,2024-06-25,Assembly,"Do pass and be re-referred to the Committee on [Appropriations]",6,1,0,0,7
1847530,1464459,2024-08-15,Assembly,"Do pass",11,3,0,1,15
1847530,1465577,2024-08-26,Assembly,"SB 1188 Laird Senate Third Reading By Pellerin",64,5,0,10,79
1847530,1465912,2024-08-27,Senate,"Unfinished Business SB1188 Laird Concurrence",31,9,0,0,40
1847531,1430065,2024-04-17,Senate,"Do pass and be ordered to the Consent Calendar",5,0,0,0,5
1847531,1435306,2024-04-25,Senate,"Consent Calendar 2nd SB1189 Lim√≥n",36,0,0,4,40
1847531,1458405,2024-06-19,Assembly,"Do pass. To Consent Calendar",7,0,0,0,7
1847531,1460695,2024-06-26,Assembly,"SB 1189 Lim√≥n Consent Calendar Second Day Regular Session",75,0,0,4,79
1847532,1434119,2024-04-23,Senate,"Do pass, but first be re-referred to the Committee on [Appropriations]",11,0,0,0,11
1847532,1445257,2024-05-20,Senate,"Senate 3rd Reading SB1190 Laird",39,0,0,1,40
1847532,1456923,2024-06-12,Assembly,"Do pass and be re-referred to the Committee on [Judiciary] with recommendation: To Consent Calendar",9,0,0,0,9
1847532,1458352,2024-06-18,Assembly,"Do pass as amended. To Consent Calendar",12,0,0,0,12
1847532,1460765,2024-06-26,Assembly,"SB 1190 Laird Consent Calendar Second Day Regular Session",75,0,0,4,79
1847532,1462664,2024-07-03,Senate,"Special Consent SB1190 Laird",39,0,0,1,40
1847533,1424992,2024-04-10,Senate,"Do pass as amended, but first amend, and re-refer to the Committee on [Appropriations]",7,0,0,0,7
1847533,1431894,2024-04-22,Senate,"Placed on suspense file",7,0,0,0,7
1847534,1424968,2024-04-10,Senate,"Do pass, but first be re-referred to the Committee on [Appropriations]",7,0,0,0,7
1847534,1431936,2024-04-22,Senate,"Placed on suspense file",7,0,0,0,7
1847534,1444435,2024-05-16,Senate,"Do pass",7,0,0,0,7
1847534,1449628,2024-05-23,Senate,"Special Consent SB1192 Portantino",37,0,0,3,40
1847534,1460112,2024-06-24,Assembly,"Do pass as amended and be re-referred to the Committee on [Appropriations]",6,0,0,1,7
1847535,1424796,2024-04-09,Senate,"Do pass as amended, but first amend, and re-refer to the Committee on [Judiciary]",11,3,0,1,15
1847535,1436189,2024-04-29,Senate,"Placed on suspense file",5,0,0,2,7
1847535,1444215,2024-05-16,Senate,"Do pass as amended",4,2,0,1,7
1847535,1448813,2024-05-22,Senate,"Senate 3rd Reading SB1193 Menjivar et al",29,8,0,3,40
1847535,1458228,2024-06-17,Assembly,"Do pass as amended and be re-referred to the Committee on [Local Government]",11,1,0,3,15
1847535,1460694,2024-06-26,Assembly,"Do pass as amended and be re-referred to the Committee on [Appropriations]",8,0,0,1,9
1847535,1463738,2024-08-07,Assembly,"Do pass",10,2,0,3,15
1847535,1466124,2024-08-29,Senate,"Unfinished Business SB1193 Menjivar et al. Concurrence",31,9,0,0,40
1847535,1466686,2024-08-28,Assembly,"SB 1193 Menjivar Senate Third Reading By Gabriel",59,11,0,9,79
1847536,1424814,2024-04-10,Senate,"Do pass, but first be re-referred to the Committee on [Judiciary]",7,0,0,0,7
1847536,1434180,2024-04-23,Senate,"Do pass, but first be re-referred to the Committee on [Appropriations] with the recommendation: To Consent Calendar",11,0,0,0,11
1847536,1448662,2024-05-22,Senate,"Senate 3rd Reading SB1194 Wilk",33,1,0,6,40
1847536,1456904,2024-06-12,Assembly,"Do pass as amended and be re-referred to the Committee on [Appropriations]",6,0,0,1,7
1847537,1434198,2024-04-24,Senate,"Do pass",7,0,0,0,7
1847537,1445279,2024-05-20,Senate,"Senate 3rd Reading SB1195 Lim√≥n",39,0,0,1,40
1847537,1460748,2024-06-26,Assembly,"Do pass and be re-referred to the Committee on [Appropriations]",7,0,0,0,7
1847537,1463746,2024-08-07,Assembly,"Do pass. To Consent Calendar",14,0,0,1,15
1847537,1464021,2024-08-15,Assembly,"SB 1195 Lim√≥n Consent Calendar Second Day Regular Session",75,0,0,4,79
1847537,1465505,2024-08-22,Senate,"Special Consent SB1195 Lim√≥n",33,0,0,7,40
1847539,1461229,2024-06-27,Senate,"Senate 3rd Reading SCR111 Seyarto et al",40,0,0,0,40
1847539,1463381,2024-08-05,Assembly,"Be adopted. To Consent Calendar",10,0,0,1,11
1847539,1463782,2024-08-08,Assembly,"SCR 111 Seyarto Consent Calendar Second Day Regular Session",72,0,0,7,79
1847540,1402350,2024-03-04,Senate,"Senate 3rd Reading SCR112 Umberg",34,0,0,6,40
1847540,1422075,2024-04-08,Assembly,"Be adopted. To Consent Calendar",10,0,0,1,11
1847540,1427322,2024-04-15,Assembly,"SCR 112 Umberg Senate Third Reading",75,0,0,5,80
1847541,1400012,2024-02-29,Senate,"Senate 3rd Reading SR66 Newman et al",38,0,0,2,40
1848277,1425884,2024-04-10,Assembly,"Do pass and be re-referred to the Committee on [Housing and Community Development]",5,4,0,0,9
1848277,1434042,2024-04-24,Assembly,"Do pass as amended",7,0,0,2,9
1848277,1445197,2024-05-20,Assembly,"AB 2729 Joe Patterson Assembly Third Reading",49,2,0,29,80
1848277,1460506,2024-06-26,Senate,"Do pass, but first be re-referred to the Committee on [Housing]",7,0,0,0,7
1848277,1462624,2024-07-02,Senate,"Do pass as amended",9,0,0,1,10
1848277,1467102,2024-08-31,Senate,"Assembly 3rd Reading AB2729 Joe Patterson et al. By Wiener",37,2,0,1,40
1848277,1467103,2024-08-31,Assembly,"AB 2729 Joe Patterson Concurrence in Senate Amendments",66,0,0,13,79
1848278,1420138,2024-04-02,Assembly,"Do pass. To Consent Calendar",8,0,0,0,8
1848278,1427220,2024-04-15,Assembly,"AB 2730 Lackey Assembly Third Reading",75,0,0,5,80
1848278,1456297,2024-06-11,Senate,"Do pass and be ordered to the Consent Calendar",5,0,0,0,5
1848278,1457994,2024-06-17,Senate,"Consent Calendar 2nd AB2730 Lackey",39,0,0,1,40
1848279,1423823,2024-04-08,Assembly,"Do pass and be re-referred to the Committee on [Appropriations] with recommendation: To Consent Calendar",10,0,0,1,11
1848279,1434166,2024-04-24,Assembly,"Do pass. To Consent Calendar",14,0,0,1,15
1848279,1438444,2024-05-02,Assembly,"AB 2731 Wendy Carrillo Consent Calendar Second Day Regular Session",73,0,0,7,80
1848279,1454194,2024-06-05,Senate,"Do pass, but first be re-referred to the Committee on [Appropriations] with the recommendation: To Consent Calendar",7,0,0,0,7
1848279,1458812,2024-06-20,Senate,"Consent Calendar 2nd AB2731 Wendy Carrillo",36,0,0,4,40
1848280,1433197,2024-04-23,Assembly,"Do pass and be re-referred to the Committee on [Appropriations] with recommendation: To Consent Calendar",6,0,0,1,7
1848282,1424859,2024-04-10,Assembly,"Do pass and be re-referred to the Committee on [Appropriations]",10,0,0,0,10
1848282,1444461,2024-05-16,Assembly,"Do pass as amended",11,1,0,3,15
1848282,1446132,2024-05-21,Assembly,"AB 2734 Connolly Assembly Third Reading",72,0,0,8,80
1848282,1458235,2024-06-18,Senate,"Do pass, but first be re-referred to the Committee on [Appropriations]",4,0,0,1,5
1848282,1461952,2024-07-01,Senate,"Placed on suspense file",7,0,0,0,7
1848282,1464248,2024-08-15,Senate,"Do pass",7,0,0,0,7
1848282,1465719,2024-08-26,Senate,"Assembly 3rd Reading AB2734 Connolly et al. By Lim√≥n",38,0,0,2,40
1848282,1465918,2024-08-27,Assembly,"AB 2734 Connolly Concurrence in Senate Amendments",75,0,0,4,79
1848283,1429929,2024-04-17,Assembly,"Do pass and be re-referred to the Committee on [Local Government]",15,0,0,0,15
1848283,1435248,2024-04-24,Assembly,"Do pass as amended and be re-referred to the Committee on [Appropriations]",7,0,0,2,9
1848283,1441375,2024-05-08,Assembly,"Do pass",15,0,0,0,15
1848283,1445137,2024-05-20,Assembly,"AB 2735 Blanca Rubio Assembly Third Reading",71,0,0,9,80
1848283,1462473,2024-07-03,Senate,"Do pass as amended, but first amend, and re-refer to the Committee on [Appropriations]",6,1,0,0,7
1848283,1465360,2024-08-20,Senate,"Assembly 3rd Reading AB2735 Blanca Rubio By Durazo",38,2,0,0,40
1848283,1465590,2024-08-26,Assembly,"AB 2735 Blanca Rubio Concurrence in Senate Amendments",77,0,0,2,79
1848284,1424869,2024-04-09,Assembly,"Do pass and be re-referred to the Committee on [Appropriations]",10,0,0,0,10
1848284,1444205,2024-05-16,Assembly,"Do pass",15,0,0,0,15
1848284,1448795,2024-05-22,Assembly,"AB 2736 Juan Carrillo Assembly Third Reading",72,0,0,8,80
1848284,1460114,2024-06-24,Senate,"Do pass, but first be re-referred to the Committee on [Appropriations] with the recommendation: To Consent Calendar",5,0,0,0,5
1848284,1463355,2024-08-05,Senate,"Placed on suspense file",7,0,0,0,7
1848284,1464414,2024-08-15,Senate,"Do pass",7,0,0,0,7
1848284,1467252,2024-08-28,Senate,"Special Consent AB2736 Juan Carrillo et al. By Archuleta",39,0,0,1,40
1848286,1421150,2024-04-03,Assembly,"Do pass and be re-referred to the Committee on [Judiciary]",5,2,0,0,7
1848286,1423874,2024-04-09,Assembly,"Do pass and be re-referred to the Committee on [Appropriations]",9,2,0,1,12
1848286,1443952,2024-05-16,Assembly,"Do pass as amended",11,4,0,0,15
1848286,1448800,2024-05-22,Assembly,"AB 2738 Luz Rivas Assembly Third Reading By MAIENSCHEIN",49,10,0,21,80
1848286,1456966,2024-06-12,Senate,"Do pass, but first be re-referred to the Committee on [Judiciary]",4,1,0,0,5
1848286,1460682,2024-06-25,Senate,"Do pass, but first be re-referred to the Committee on [Appropriations]",8,2,0,1,11
1848286,1460683,2024-06-25,Senate,"Do pass, but first be re-referred to the Committee on [Appropriations]",8,1,0,2,11
1848286,1461867,2024-06-25,Senate,"[06-25-2024] set for [First] hearing: Reconsideration of favorable vote granted",11,0,0,0,11
1848286,1463595,2024-08-05,Senate,"Placed on suspense file",7,0,0,0,7
1848286,1464125,2024-08-15,Senate,"Do pass as amended",5,2,0,0,7
1848286,1465704,2024-08-26,Senate,"Assembly 3rd Reading AB2738 Luz Rivas et al. By Cortese",30,9,0,1,40
1848286,1465829,2024-08-27,Assembly,"AB 2738 Luz Rivas Concurrence in Senate Amendments",58,12,0,9,79
1848287,1420061,2024-04-02,Assembly,"Do pass and be re-referred to the Committee on [Appropriations]",7,0,0,1,8
1848287,1430013,2024-04-17,Assembly,"Do pass",13,0,0,2,15
1848287,1442563,2024-05-13,Assembly,"AB 2739 Maienschein Assembly Third Reading",63,0,0,17,80
1848287,1456279,2024-06-11,Senate,"Do pass, but first be re-referred to the Committee on [Appropriations]",4,0,0,1,5
1848287,1459346,2024-06-24,Senate,"Placed on suspense file",6,0,0,1,7
1848287,1464123,2024-08-15,Senate,"Do pass as amended",4,2,0,1,7
1848287,1466252,2024-08-29,Senate,"Assembly 3rd Reading AB2739 Maienschein By Becker",31,5,0,4,40
1848287,1466567,2024-08-30,Assembly,"AB 2739 Maienschein Concurrence in Senate Amendments",66,3,0,10,79
1848288,1411386,2024-03-19,Assembly,"Do pass and be re-referred to the Committee on [Appropriations] with recommendation: To Consent Calendar",8,0,0,0,8
1848288,1444173,2024-05-16,Assembly,"Do pass",15,0,0,0,15
1848288,1448602,2024-05-22,Assembly,"AB 2740 Waldron Assembly Third Reading",72,0,0,8,80
1848288,1459997,2024-06-25,Senate,"Do pass, but first be re-referred to the Committee on [Appropriations] with the recommendation: To Consent Calendar",5,0,0,0,5
1848288,1463405,2024-08-05,Senate,"Placed on suspense file",7,0,0,0,7
1848288,1464147,2024-08-15,Senate,"Do pass as amended",7,0,0,0,7
1848288,1465851,2024-08-27,Senate,"Assembly 3rd Reading AB2740 Waldron By Wahab",40,0,0,0,40
1848288,1466715,2024-08-28,Assembly,"AB 2740 Waldron Concurrence in Senate Amendments",77,0,0,2,79
1848289,1436944,2024-04-30,Assembly,"Do pass as amended",11,0,0,0,11
1848289,1445178,2024-05-20,Assembly,"AB 2741 Haney Assembly Third Reading",73,0,0,7,80
1848289,1462499,2024-07-02,Senate,"Do pass as amended",11,0,0,0,11
1848289,1465547,2024-08-26,Senate,"Assembly 3rd Reading AB2741 Haney By Umberg",40,0,0,0,40
1848289,1466007,2024-08-27,Assembly,"AB 2741 Haney Concurrence in Senate Amendments",76,0,0,3,79
1848290,1431849,2024-04-22,Assembly,"Do pass and be re-referred to the Committee on [Appropriations]",8,5,0,2,15
1848291,1429924,2024-04-17,Assembly,"Do pass and be re-referred to the Committee on [Appropriations]",15,0,0,0,15
1848291,1437606,2024-05-01,Assembly,"Do pass. To Consent Calendar",14,0,0,1,15
1848291,1441934,2024-05-09,Assembly,"AB 2743 Pacheco Consent Calendar Second Day Regular Session",65,0,0,15,80
1848291,1456847,2024-06-12,Senate,"Do pass, but first be re-referred to the Committee on [Judiciary]",7,0,0,0,7
1848291,1460766,2024-06-25,Senate,"Do pass as amended, but first amend, and re-refer to the Committee on [Appropriations]",10,0,0,1,11
1848291,1465754,2024-08-26,Senate,"Assembly 3rd Reading AB2743 Pacheco By Dodd",38,0,0,2,40
1848291,1465825,2024-08-27,Assembly,"AB 2743 Pacheco Concurrence in Senate Amendments",77,0,0,2,79
1848293,1424818,2024-04-10,Assembly,"Do pass and be re-referred to the Committee on [Appropriations]",9,0,0,1,10
1848293,1434114,2024-04-24,Assembly,"Do pass",14,0,0,1,15
1848293,1445993,2024-05-21,Assembly,"AB 2745 Mathis Assembly Third Reading",70,0,0,10,80
1848293,1458330,2024-06-18,Senate,"Do pass, but first be re-referred to the Committee on [Appropriations] with the recommendation: To Consent Calendar",5,0,0,0,5
1848293,1467253,2024-08-31,Senate,"Assembly 3rd Reading AB2745 Mathis et al. By Dahle",23,4,0,13,40
1848293,1467254,2024-08-31,Assembly,"AB 2745 Mathis Concurrence in Senate Amendments",56,2,0,21,79
1848295,1423935,2024-04-09,Assembly,"Do pass as amended",9,2,0,1,12
1848295,1445165,2024-05-20,Assembly,"AB 2747 Haney Assembly Third Reading",59,13,0,8,80
1848295,1458204,2024-06-18,Senate,"Do pass",6,2,0,3,11
1848295,1466320,2024-08-29,Assembly,"AB 2747 Haney Concurrence in Senate Amendments",56,14,0,9,79
1848295,1466786,2024-08-28,Senate,"Assembly 3rd Reading AB2747 Haney By Wiener",26,8,0,6,40
1848296,1430971,2024-04-17,Assembly,"Do pass. To Consent Calendar",9,0,0,0,9
1848296,1435314,2024-04-25,Assembly,"AB 2748 Flora Consent Calendar Second Day Regular Session",75,0,0,5,80
1848296,1451580,2024-05-29,Senate,"Do pass and be ordered to the Consent Calendar",7,0,0,0,7
1848296,1454833,2024-06-06,Senate,"Consent Calendar 2nd AB2748 Flora",32,0,0,8,40
1848296,1457331,2024-06-13,Assembly,"AB 2748 Flora Concurrence in Senate Amendments",77,0,0,2,79
1848297,1423821,2024-04-09,Assembly,"Do pass as amended and be re-referred to the Committee on [Appropriations]",14,0,0,2,16
1848297,1443468,2024-05-15,Assembly,"Do pass",11,1,0,3,15
1848297,1445240,2024-05-20,Assembly,"AB 2749 Wood Assembly Third Reading",63,0,0,17,80
1848297,1458399,2024-06-19,Senate,"Do pass, but first be re-referred to the Committee on [Appropriations]",9,0,0,2,11
1848297,1465342,2024-08-20,Senate,"Assembly 3rd Reading AB2749 Wood By Smallwood-Cuevas",34,0,0,6,40
1848298,1429990,2024-04-17,Assembly,"Do pass and be re-referred to the Committee on [Appropriations]",16,0,0,0,16
1848298,1441384,2024-05-08,Assembly,"Do pass",15,0,0,0,15
1848298,1445207,2024-05-20,Assembly,"AB 2750 Gallagher Assembly Third Reading",58,0,0,22,80
1848298,1458246,2024-06-18,Senate,"Do pass, but first be re-referred to the Committee on [Appropriations]",15,0,0,3,18
1848298,1461957,2024-07-01,Senate,"Placed on suspense file",7,0,0,0,7
1848298,1464277,2024-08-15,Senate,"Do pass as amended",7,0,0,0,7
1848298,1466214,2024-08-29,Senate,"Assembly 3rd Reading AB2750 Gallagher et al. By Caballero",35,3,0,2,40
1848298,1466580,2024-08-30,Assembly,"AB 2750 Gallagher Concurrence in Senate Amendments",67,1,0,11,79
1848299,1431035,2024-04-17,Assembly,"Do pass and be re-referred to the Committee on [Appropriations]",4,2,0,1,7
1848300,1423864,2024-04-09,Assembly,"Do pass as amended and be re-referred to the Committee on [Human Services]",9,2,0,1,12
1848300,1432976,2024-04-23,Assembly,"Do pass as amended and be re-referred to the Committee on [Appropriations]",5,0,0,2,7
1848300,1443980,2024-05-16,Assembly,"Do pass",11,3,0,1,15
1848300,1449611,2024-05-23,Assembly,"AB 2752 Calderon Assembly Third Reading",55,10,0,15,80
1848300,1460679,2024-06-25,Senate,"Do pass as amended, but first amend, and re-refer to the Committee on [Human Services]",8,2,0,1,11
1848300,1462328,2024-07-01,Senate,"Do pass, but first be re-referred to the Committee on [Appropriations]",4,0,0,1,5
1848300,1463627,2024-08-05,Senate,"Placed on suspense file",7,0,0,0,7
1848301,1419227,2024-04-02,Assembly,"Do pass and be re-referred to the Committee on [Appropriations]",12,0,0,4,16
1848302,1431049,2024-04-17,Assembly,"Do pass and be re-referred to the Committee on [Judiciary]",5,0,0,2,7
1848302,1433042,2024-04-23,Assembly,"Do pass and be re-referred to the Committee on [Appropriations]",9,2,0,1,12
1848302,1444431,2024-05-16,Assembly,"Do pass as amended",11,4,0,0,15
1848302,1448818,2024-05-22,Assembly,"AB 2754 Rendon Assembly Third Reading",52,3,0,25,80
1848302,1460669,2024-06-26,Senate,"Do pass, but first be re-referred to the Committee on [Judiciary]",4,1,0,0,5
1848302,1462458,2024-07-02,Senate,"Do pass, but first be re-referred to the Committee on [Appropriations]",9,2,0,0,11
1848302,1463507,2024-08-05,Senate,"Placed on suspense file",7,0,0,0,7
1848302,1464476,2024-08-15,Senate,"Do pass",5,2,0,0,7
1848302,1465806,2024-08-27,Senate,"Assembly 3rd Reading AB2754 Rendon By Durazo",29,10,0,1,40
1848303,1434087,2024-04-24,Assembly,"Do pass as amended",15,0,0,0,15
1848303,1445157,2024-05-20,Assembly,"AB 2755 Wicks Third Reading Urgency",73,0,0,7,80
1848303,1455816,2024-06-10,Senate,"Do pass",5,0,0,2,7
1848303,1457975,2024-06-17,Senate,"Assembly 3rd Reading AB2755 Wicks By Caballero Urgency Clause",33,4,0,3,40
1848304,1433017,2024-04-23,Assembly,"Do pass and be re-referred to the Committee on [Appropriations] with recommendation: To Consent Calendar",16,0,0,0,16
1848304,1444124,2024-05-16,Assembly,"Do pass as amended",11,0,0,4,15
1848304,1449695,2024-05-23,Assembly,"AB 2756 Boerner Assembly Third Reading",73,0,0,7,80
1848304,1460468,2024-06-26,Senate,"Do pass and be ordered to the Consent Calendar",11,0,0,0,11
1848304,1462690,2024-07-03,Senate,"Consent Calendar 2nd AB2756 Boerner",39,0,0,1,40
1848304,1463798,2024-08-08,Assembly,"AB 2756 Boerner Concurrence in Senate Amendments",72,0,0,7,79
1848305,1428780,2024-04-16,Assembly,"Do pass and be re-referred to the Committee on [Appropriations]",7,0,0,0,7
1848305,1444499,2024-05-16,Assembly,"Do pass",15,0,0,0,15
1848305,1448658,2024-05-22,Assembly,"AB 2757 Garcia Assembly Third Reading",72,0,0,8,80
1848305,1462010,2024-07-01,Senate,"Do pass, but first be re-referred to the Committee on [Appropriations]",13,0,0,0,13
1848305,1463459,2024-08-05,Senate,"Placed on suspense file",7,0,0,0,7
1848305,1464324,2024-08-15,Senate,"Do pass",7,0,0,0,7
1848305,1466207,2024-08-29,Assembly,"AB 2757 Garcia Concurrence in Senate Amendments",76,0,0,3,79
1848305,1467207,2024-08-28,Senate,"Assembly 3rd Reading AB2757 Garcia et al. By Padilla",39,0,0,1,40
1848307,1420120,2024-04-02,Assembly,"Do pass and be re-referred to the Committee on [Judiciary] with recommendation: To Consent Calendar",8,0,0,0,8
1848307,1423844,2024-04-09,Assembly,"Do pass as amended. To Consent Calendar",12,0,0,0,12
1848307,1430974,2024-04-18,Assembly,"AB 2759 Petrie-Norris Consent Calendar Second Day",72,0,0,8,80
1848307,1453470,2024-06-04,Senate,"Do pass, but first be re-referred to the Committee on [Judiciary] with the recommendation: To Consent Calendar",5,0,0,0,5
1848307,1458354,2024-06-18,Senate,"Do pass as amended, and be ordered to the Consent Calendar",10,0,0,1,11
1848307,1461228,2024-06-27,Senate,"Consent Calendar 2nd AB2759 Petrie-Norris",40,0,0,0,40
1848307,1466190,2024-08-29,Assembly,"AB 2759 Petrie-Norris Concurrence in Senate Amendments",76,0,0,3,79
1848307,1466734,2024-08-28,Senate,"Assembly 3rd Reading AB2759 Petrie-Norris By Skinner",39,0,0,1,40
1848308,1427300,2024-04-15,Assembly,"Do pass and be re-referred to the Committee on [Natural Resources] with recommendation: To Consent Calendar",15,0,0,0,15
1848308,1431929,2024-04-22,Assembly,"Do pass as amended, and be re-referred to the Committee on [Appropriations] with recommendation: To Consent Calendar",11,0,0,0,11
1848309,1424876,2024-04-09,Assembly,"Do pass and be re-referred to the Committee on [Judiciary]",5,2,0,0,7
1848309,1428828,2024-04-16,Assembly,"Do pass and be re-referred to the Committee on [Appropriations]",8,3,0,1,12
1848309,1444291,2024-05-16,Assembly,"Do pass",10,4,0,1,15
1848309,1448583,2024-05-22,Assembly,"AB 2761 Hart Assembly Third Reading",41,11,0,28,80
1848310,1431914,2024-04-22,Assembly,"Do pass as amended and be re-referred to the Committee on [Appropriations]",7,3,0,1,11
1848311,1423783,2024-04-09,Assembly,"Do pass and be re-referred to the Committee on [Public Safety] with recommendation: To Consent Calendar",12,0,0,0,12
1848311,1428746,2024-04-16,Assembly,"Do pass and be re-referred to the Committee on [Appropriations] with recommendation: To Consent Calendar",8,0,0,0,8
1848312,1420060,2024-04-03,Assembly,"Do pass and be re-referred to the Committee on [Appropriations] with recommendation: To Consent Calendar",16,0,0,0,16
1848313,1424832,2024-04-10,Assembly,"Do pass as amended and be re-referred to the Committee on [Appropriations]",11,0,0,0,11
1848313,1443489,2024-05-15,Assembly,"Do pass. To Consent Calendar",15,0,0,0,15
1848313,1445939,2024-05-21,Assembly,"AB 2765 Pellerin Consent Calendar Second Day Regular Session",71,0,0,9,80
1848313,1458282,2024-06-18,Senate,"Do pass as amended, but first amend, and re-refer to the Committee on [Appropriations]",17,0,0,1,18
1848313,1465656,2024-08-26,Senate,"Assembly 3rd Reading AB2765 Pellerin By Ashby",40,0,0,0,40
1848313,1465872,2024-08-27,Assembly,"AB 2765 Pellerin Concurrence in Senate Amendments",77,0,0,2,79
1848314,1411367,2024-03-19,Assembly,"Do pass and be re-referred to the Committee on [Judiciary]",8,0,0,0,8
1848314,1419187,2024-04-02,Assembly,"Do pass as amended",11,0,0,1,12
1848314,1444144,2024-05-16,Assembly,"Do pass as amended",10,0,0,5,15
1848314,1446053,2024-05-21,Assembly,"AB 2766 Low Assembly Third Reading",72,0,0,8,80
1848314,1458181,2024-06-18,Senate,"Do pass, but first be re-referred to the Committee on [Appropriations] with the recommendation: To Consent Calendar",5,0,0,0,5
1848314,1461948,2024-07-01,Senate,"Placed on suspense file",7,0,0,0,7
1848315,1433038,2024-04-23,Assembly,"Do pass as amended, and be re-referred to the Committee on [Appropriations] with recommendation: To Consent Calendar",16,0,0,0,16
1848315,1443481,2024-05-15,Assembly,"Do pass. To Consent Calendar",15,0,0,0,15
1848315,1446021,2024-05-21,Assembly,"AB 2767 Santiago Consent Calendar Second Day Regular Session",71,0,0,9,80
1848315,1456864,2024-06-12,Senate,"Do pass, but first be re-referred to the Committee on [Appropriations] with the recommendation: To Consent Calendar",10,0,0,1,11
1848315,1461245,2024-06-27,Senate,"Consent Calendar 2nd AB2767 Santiago",40,0,0,0,40
1848316,1423915,2024-04-09,Assembly,"Do pass and be re-referred to the Committee on [Appropriations]",10,0,0,1,11
1848316,1424800,2024-04-09,Assembly,"Do pass and be re-referred to the Committee on [Education]",10,0,0,1,11
1848316,1435208,2024-04-24,Assembly,"Do pass as amended, and be re-referred to the Committee on [Appropriations] with recommendation: To Consent Calendar",7,0,0,0,7
1848316,1444178,2024-05-16,Assembly,"Do pass",15,0,0,0,15
1848316,1448747,2024-05-22,Assembly,"AB 2768 Berman Assembly Third Reading",72,0,0,8,80
1848316,1458450,2024-06-19,Senate,"Do pass, but first be re-referred to the Committee on [Appropriations] with the recommendation: To Consent Calendar",7,0,0,0,7
1848316,1462088,2024-07-01,Senate,"Placed on suspense file",7,0,0,0,7
1848317,1432991,2024-04-22,Assembly,"Do pass and be re-referred to the Committee on [Appropriations]",7,0,0,0,7
1848318,1420036,2024-04-03,Assembly,"Do pass and be re-referred to the Committee on [Appropriations] with recommendation: To Consent Calendar",7,0,0,0,7
1848318,1429914,2024-04-17,Assembly,"Do pass. To Consent Calendar",15,0,0,0,15
1848318,1435329,2024-04-25,Assembly,"AB 2770 Public Employment and Retirement Consent Calendar Second Day Regular Session",75,0,0,5,80
1848318,1454189,2024-06-05,Senate,"Do pass, but first be re-referred to the Committee on [Appropriations] with the recommendation: To Consent Calendar",5,0,0,0,5
1848318,1458767,2024-06-20,Senate,"Consent Calendar 2nd AB2770 P. E. & R. (McKinnor)",36,0,0,4,40
1848319,1421135,2024-04-03,Assembly,"Do pass and be re-referred to the Committee on [Appropriations] with recommendation: To Consent Calendar",7,0,0,0,7
1848319,1434224,2024-04-24,Assembly,"Do pass. To Consent Calendar",14,0,0,1,15
1848319,1438451,2024-05-02,Assembly,"AB 2771 Maienschein Consent Calendar Second Day Regular Session",73,0,0,7,80
1848319,1454234,2024-06-05,Senate,"Do pass, but first be re-referred to the Committee on [Appropriations] with the recommendation: To Consent Calendar",7,0,0,0,7
1848319,1458771,2024-06-20,Senate,"Consent Calendar 2nd AB2771 Maienschein",36,0,0,4,40
1848319,1462061,2024-07-01,Assembly,"AB 2771 Maienschein Concurrence in Senate Amendments",72,0,0,7,79
1848321,1436901,2024-04-30,Assembly,"Do pass and be re-referred to the Committee on [Appropriations]",9,2,0,1,12
1848321,1444358,2024-05-16,Assembly,"Do pass",11,4,0,0,15
1848321,1448654,2024-05-22,Assembly,"AB 2773 Kalra Assembly Third Reading",49,15,0,16,80
1848321,1460504,2024-06-25,Senate,"Do pass as amended",9,2,0,0,11
1848321,1465625,2024-08-26,Senate,"Assembly 3rd Reading AB2773 Kalra By Eggman",30,9,0,1,40
1848321,1465979,2024-08-27,Assembly,"AB 2773 Kalra Concurrence in Senate Amendments",55,16,0,8,79
1848322,1423826,2024-04-09,Assembly,"Do pass as amended and be re-referred to the Committee on [Jobs, Economic Development, and the Economy]",6,0,0,1,7
1848322,1428754,2024-04-16,Assembly,"Do pass as amended and be re-referred to the Committee on [Appropriations]",7,0,0,0,7
1848322,1444306,2024-05-16,Assembly,"Do pass",15,0,0,0,15
1848322,1448735,2024-05-22,Assembly,"AB 2774 Grayson Assembly Third Reading",72,0,0,8,80
1848322,1458271,2024-06-17,Senate,"Do pass, but first be re-referred to the Committee on [Business, Professions and Economic Development]",5,0,0,0,5
1848322,1462082,2024-07-01,Senate,"Do pass, but first be re-referred to the Committee on [Appropriations]",13,0,0,0,13
1848322,1463415,2024-08-05,Senate,"Placed on suspense file",7,0,0,0,7
1848323,1428834,2024-04-16,Assembly,"Do pass and be re-referred to the Committee on [Appropriations]",16,0,0,0,16
1848324,1423842,2024-04-08,Assembly,"Do pass and be re-referred to the Committee on [Natural Resources] with recommendation: To Consent Calendar",7,0,0,1,8
1848324,1431993,2024-04-22,Assembly,"Do pass as amended and be re-referred to the Committee on [Appropriations]",10,0,0,1,11
1848324,1444610,2024-05-16,Assembly,"Do pass as amended",11,0,0,4,15
1848324,1448679,2024-05-22,Assembly,"AB 2776 Rodriguez Assembly Third Reading",70,0,0,10,80
1848324,1456356,2024-06-11,Senate,"Do pass, but first be re-referred to the Committee on [Appropriations] with the recommendation: To Consent Calendar",15,0,0,1,16
1848324,1463630,2024-08-05,Senate,"Placed on suspense file",7,0,0,0,7
1848325,1435309,2024-04-23,Assembly,"Do pass as amended, and be re-referred to the Committee on [Appropriations] with recommendation: To Consent Calendar",11,0,0,0,11
1848325,1444468,2024-05-16,Assembly,"Do pass",15,0,0,0,15
1848325,1449568,2024-05-23,Assembly,"AB 2777 Calderon Assembly Third Reading",72,0,0,8,80
1848325,1459988,2024-06-25,Senate,"Do pass, but first be re-referred to the Committee on [Appropriations] with the recommendation: To Consent Calendar",14,0,0,2,16
1848325,1463385,2024-08-05,Senate,"Placed on suspense file",7,0,0,0,7
1848327,1429879,2024-04-17,Assembly,"Do pass and be re-referred to the Committee on [Appropriations] with recommendation: To Consent Calendar",16,0,0,0,16
1848327,1437595,2024-05-01,Assembly,"Do pass. To Consent Calendar",14,0,0,1,15
1848327,1441890,2024-05-09,Assembly,"AB 2779 Petrie-Norris Consent Calendar Second Day Regular Session",65,0,0,15,80
1848327,1453461,2024-06-04,Senate,"Do pass as amended, but first amend, and re-refer to the Committee on [Appropriations]",17,0,0,1,18
1848327,1465969,2024-08-27,Senate,"Assembly 3rd Reading AB2779 Petrie-Norris By Padilla",38,0,0,2,40
1848327,1466246,2024-08-29,Assembly,"AB 2779 Petrie-Norris Concurrence in Senate Amendments",76,0,0,3,79
1848328,1434118,2024-04-24,Assembly,"Do pass and be re-referred to the Committee on [Appropriations]",10,1,0,0,11
1848328,1441282,2024-05-08,Assembly,"Do pass",14,0,0,1,15
1848328,1445282,2024-05-20,Assembly,"AB 2780 McKinnor Assembly Third Reading",64,1,0,15,80
1848328,1458306,2024-06-18,Senate,"Do pass, but first be re-referred to the Committee on [Judiciary]",14,1,0,3,18
1848328,1462602,2024-07-02,Senate,"Do pass, but first be re-referred to the Committee on [Appropriations]",10,0,0,1,11
1848328,1463503,2024-08-05,Senate,"Placed on suspense file",7,0,0,0,7
1848328,1464590,2024-08-15,Senate,"Do pass",5,2,0,0,7
1848328,1465635,2024-08-26,Senate,"Assembly 3rd Reading AB2780 McKinnor By Durazo",32,5,0,3,40
1848328,1465945,2024-08-27,Assembly,"AB 2780 McKinnor Concurrence in Senate Amendments",66,0,0,13,79
1848329,1429967,2024-04-17,Assembly,"Do pass and be re-referred to the Committee on [Appropriations] with recommendation: To Consent Calendar",21,0,0,1,22
1848331,1425923,2024-04-10,Assembly,"Do pass as amended and be re-referred to the Committee on [Judiciary]",5,1,0,3,9
1848331,1444575,2024-05-16,Assembly,"Do pass as amended",12,1,0,2,15
1848331,1448756,2024-05-22,Assembly,"AB 2783 Alvarez Assembly Third Reading",61,0,0,19,80
1848331,1462672,2024-07-03,Senate,"Do pass as amended, but first amend, and re-refer to the Committee on [Appropriations]",5,1,0,1,7
1848331,1463843,2024-08-12,Senate,"Placed on suspense file",7,0,0,0,7
1848331,1464168,2024-08-15,Senate,"Do pass as amended",5,2,0,0,7
1848331,1466615,2024-08-28,Senate,"Assembly 3rd Reading AB2783 Alvarez By Atkins",38,0,0,2,40
1848333,1419166,2024-04-02,Assembly,"Do pass as amended",8,3,0,1,12
1848334,1433035,2024-04-23,Assembly,"Do pass and be re-referred to the Committee on [Appropriations]",16,0,0,0,16
1848334,1444548,2024-05-16,Assembly,"Do pass as amended",11,0,0,4,15
1848334,1446012,2024-05-21,Assembly,"AB 2786 Bonta Assembly Third Reading",73,0,0,7,80
1848334,1456867,2024-06-12,Senate,"Do pass as amended, but first amend, and re-refer to the Committee on [Appropriations]",10,0,0,1,11
1848334,1459332,2024-06-24,Senate,"Placed on suspense file",6,0,0,1,7
1848334,1464453,2024-08-15,Senate,"Do pass as amended",7,0,0,0,7
1848334,1465782,2024-08-27,Senate,"Assembly 3rd Reading AB2786 Bonta et al. By Hurtado",40,0,0,0,40
1848334,1467238,2024-08-28,Assembly,"AB 2786 Bonta Concurrence in Senate Amendments",77,0,0,2,79
1848335,1423754,2024-04-08,Assembly,"Do pass and be re-referred to the Committee on [Appropriations]",11,0,0,0,11
1848335,1429956,2024-04-17,Assembly,"Do pass. To Consent Calendar",15,0,0,0,15
1848335,1435186,2024-04-25,Assembly,"AB 2787 Joe Patterson Consent Calendar Second Day Regular Session",75,0,0,5,80
1848335,1453395,2024-06-04,Senate,"Do pass, but first be re-referred to the Committee on [Appropriations]",17,0,0,1,18
1848335,1465575,2024-08-26,Senate,"Assembly 3rd Reading AB2787 Joe Patterson et al. By Dahle",40,0,0,0,40
1848336,1433071,2024-04-23,Assembly,"Do pass and be re-referred to the Committee on [Appropriations]",6,0,0,2,8
1848337,1432959,2024-04-23,Assembly,"Do pass and be re-referred to the Committee on [Appropriations]",16,0,0,0,16
1848339,1438426,2024-05-01,Assembly,"Do pass as amended",9,0,0,0,9
1848339,1445159,2024-05-20,Assembly,"AB 2791 Wilson Assembly Third Reading",71,0,0,9,80
1848342,1428812,2024-04-16,Assembly,"Do pass and be re-referred to the Committee on [Judiciary]",5,2,0,0,7
1848342,1432998,2024-04-23,Assembly,"Do pass and be re-referred to the Committee on [Appropriations]",10,1,0,1,12
1848343,1433105,2024-04-23,Assembly,"Do pass and be re-referred to the Committee on [Appropriations] with recommendation: To Consent Calendar",6,0,0,1,7
1848343,1444231,2024-05-16,Assembly,"Do pass",15,0,0,0,15
1848343,1448536,2024-05-22,Assembly,"AB 2795 Arambula Assembly Third Reading",72,0,0,8,80
1848343,1462264,2024-07-01,Senate,"Do pass, but first be re-referred to the Committee on [Appropriations] with the recommendation: To Consent Calendar",5,0,0,0,5
1848343,1463661,2024-08-05,Senate,"Placed on suspense file",7,0,0,0,7
1848343,1464554,2024-08-15,Senate,"Do pass as amended",7,0,0,0,7
1848343,1467235,2024-08-31,Senate,"Assembly 3rd Reading AB2795 Arambula et al. By Menjivar",40,0,0,0,40
1848343,1467236,2024-08-31,Assembly,"AB 2795 Arambula Concurrence in Senate Amendments",72,0,0,7,79
1848345,1420112,2024-04-03,Assembly,"Do pass and be re-referred to the Committee on [Appropriations] with recommendation: To Consent Calendar",21,0,0,1,22
1848345,1430098,2024-04-17,Assembly,"Do pass. To Consent Calendar",15,0,0,0,15
1848345,1435307,2024-04-25,Assembly,"AB 2797 Blanca Rubio Consent Calendar Second Day Regular Session",75,0,0,5,80
1848347,1428970,2024-04-16,Assembly,"Do pass and be re-referred to the Committee on [Agriculture]",15,0,0,0,15
1848347,1434093,2024-04-24,Assembly,"Do pass",9,0,0,1,10
1848347,1446146,2024-05-21,Assembly,"AB 2799 Vince Fong Assembly Third Reading",70,0,0,10,80
1848349,1436942,2024-04-30,Assembly,"Do pass",9,3,0,0,12
1848349,1442606,2024-05-13,Assembly,"AB 2801 Friedman Assembly Third Reading",54,14,0,12,80
1848349,1456451,2024-06-11,Senate,"Do pass",9,2,0,0,11
1848349,1465860,2024-08-27,Senate,"Assembly 3rd Reading AB2801 Friedman By Wahab",25,10,0,5,40
1848349,1466782,2024-08-28,Assembly,"AB 2801 Friedman Concurrence in Senate Amendments",52,16,0,11,79
1848350,1423781,2024-04-09,Assembly,"Do pass and be re-referred to the Committee on [Appropriations]",5,1,0,1,7
1848350,1434270,2024-04-24,Assembly,"Do pass",11,4,0,0,15
1848350,1438500,2024-05-02,Assembly,"AB 2802 Maienschein Assembly Third Reading",60,7,0,13,80
1848350,1458175,2024-06-17,Senate,"Do pass, but first be re-referred to the Committee on [Governmental Organization]",4,0,0,1,5
1848350,1459937,2024-06-25,Senate,"Do pass, but first be re-referred to the Committee on [Appropriations]",10,2,0,4,16
1848350,1465570,2024-08-26,Senate,"Assembly 3rd Reading AB2802 Maienschein et al. By Atkins",32,1,0,7,40
1848350,1465914,2024-08-27,Assembly,"AB 2802 Maienschein Concurrence in Senate Amendments",62,6,0,11,79
1848351,1434147,2024-04-24,Assembly,"Do pass and be re-referred to the Committee on [Appropriations]",8,0,0,0,8
1848351,1441310,2024-05-08,Assembly,"Do pass. To Consent Calendar",15,0,0,0,15
1848351,1444646,2024-05-16,Assembly,"AB 2803 Valencia Consent Calendar Second Day Regular Session",71,0,0,9,80
1848351,1462225,2024-07-02,Senate,"Do pass, but first be re-referred to the Committee on [Appropriations]",7,0,0,0,7
1848351,1467110,2024-08-31,Senate,"Assembly 3rd Reading AB2803 Valencia et al. By Menjivar",40,0,0,0,40
1848351,1467111,2024-08-31,Assembly,"AB 2803 Valencia Concurrence in Senate Amendments",71,1,0,7,79
1848355,1427213,2024-04-15,Assembly,"Do pass and be re-referred to the Committee on [Public Safety] with recommendation: To Consent Calendar",15,0,0,0,15
1848355,1441942,2024-05-09,Assembly,"AB 2807 Villapudua Assembly Third Reading",66,0,0,14,80
1848355,1456390,2024-06-11,Senate,"Do pass, but first be re-referred to the Committee on [Public Safety] with the recommendation: To Consent Calendar",15,0,0,0,15
1848355,1462257,2024-07-02,Senate,"Do pass and be ordered to the Consent Calendar",5,0,0,0,5
1848355,1466155,2024-08-29,Senate,"Assembly 3rd Reading AB2807 Villapudua By Newman",40,0,0,0,40
1848355,1466388,2024-08-30,Assembly,"AB 2807 Villapudua Concurrence in Senate Amendments",77,0,0,2,79
1848356,1428748,2024-04-16,Assembly,"Do pass and be re-referred to the Committee on [Privacy and Consumer Protection]",5,1,0,1,7
1848356,1435333,2024-04-23,Assembly,"Do pass as amended and be re-referred to the Committee on [Appropriations]",7,3,0,1,11
1848360,1425918,2024-04-10,Assembly,"Do pass. To Consent Calendar",9,0,0,0,9
1848360,1431037,2024-04-18,Assembly,"AB 2812 Kalra Consent Calendar Second Day Regular Session",72,0,0,8,80
1848360,1451569,2024-05-28,Senate,"Do pass and be ordered to the Consent Calendar",12,0,0,3,15
1848360,1454842,2024-06-06,Senate,"Consent Calendar 2nd AB2812 Kalra",32,0,0,8,40
1848361,1435283,2024-04-24,Assembly,"Do pass as amended and be re-referred to the Committee on [Appropriations]",6,0,0,3,9
1848361,1443943,2024-05-16,Assembly,"Do pass",11,4,0,0,15
1848361,1457307,2024-06-13,Assembly,"AB 2813 Aguiar-Curry Assembly Third Reading Amendment Set #1",56,5,0,18,79
1848361,1459344,2024-06-24,Assembly,"AB 2813 AGUIAR-CURRY Third Reading Urgency",55,3,0,21,79
1848361,1460649,2024-06-26,Senate,"Do pass, but first be re-referred to the Committee on [Appropriations]",5,1,0,1,7
1848361,1460650,2024-06-26,Senate,"Do pass as amended",5,2,0,0,7
1848361,1461955,2024-07-01,Senate,"Assembly 3rd Reading AB2813 Aguiar-Curry et al. By Glazer Urgency Clause",31,8,0,1,40
1848361,1462471,2024-07-03,Assembly,"AB 2813 Aguiar-Curry Concurrence in Senate Amendments",56,2,0,21,79
1848362,1424835,2024-04-09,Assembly,"Do pass and be re-referred to the Committee on [Appropriations]",8,0,0,0,8
1848363,1427327,2024-04-15,Assembly,"Do pass and be re-referred to the Committee on [Natural Resources]",15,0,0,0,15
1848363,1431850,2024-04-22,Assembly,"Do pass and be re-referred to the Committee on [Appropriations] with recommendation: To Consent Calendar",11,0,0,0,11
1848363,1444347,2024-05-16,Assembly,"Do pass as amended",11,0,0,4,15
1848363,1446077,2024-05-21,Assembly,"AB 2815 Petrie-Norris Assembly Third Reading",73,0,0,7,80
1848363,1456419,2024-06-11,Senate,"Do pass, but first be re-referred to the Committee on [Energy, Utilities and Communications] with the recommendation: To Consent Calendar",15,0,0,0,15
1848363,1459399,2024-06-24,Senate,"Do pass as amended, but first amend, and re-refer to the Committee on [Appropriations]",17,0,0,1,18
1848363,1463417,2024-08-05,Senate,"Placed on suspense file",7,0,0,0,7
1848364,1435369,2024-04-24,Assembly,"Do pass as amended and be re-referred to the Committee on [Appropriations]",6,0,0,1,7
1848364,1444136,2024-05-16,Assembly,"Do pass",15,0,0,0,15
1848364,1448793,2024-05-22,Assembly,"AB 2816 Gipson Assembly Third Reading",71,0,0,9,80
1848364,1456890,2024-06-12,Senate,"Do pass, but first be re-referred to the Committee on [Governmental Organization]",7,0,0,0,7
1848364,1459944,2024-06-25,Senate,"Do pass, but first be re-referred to the Committee on [Appropriations]",13,0,0,3,16
1848364,1463451,2024-08-05,Senate,"Placed on suspense file",7,0,0,0,7
1848365,1418404,2024-04-01,Assembly,"Do pass and be re-referred to the Committee on [Appropriations] with recommendation: To Consent Calendar",15,0,0,0,15
1848365,1444598,2024-05-16,Assembly,"Do pass",15,0,0,0,15
1848365,1448723,2024-05-22,Assembly,"AB 2817 Dixon Assembly Third Reading",66,0,0,14,80
1848365,1460724,2024-06-25,Senate,"Do pass, but first be re-referred to the Committee on [Appropriations] with the recommendation: To Consent Calendar",15,0,0,0,15
1848365,1463401,2024-08-05,Senate,"Placed on suspense file",7,0,0,0,7
1848365,1464336,2024-08-15,Senate,"Do pass",7,0,0,0,7
1848365,1467249,2024-08-28,Senate,"Special Consent AB2817 Dixon By Niello",39,0,0,1,40
1848366,1420155,2024-04-02,Assembly,"Do pass as amended, and be re-referred to the Committee on [Human Services] with recommendation: To Consent Calendar",8,0,0,0,8
1848366,1433066,2024-04-23,Assembly,"Do pass and be re-referred to the Committee on [Appropriations] with recommendation: To Consent Calendar",6,0,0,1,7
1848366,1444470,2024-05-16,Assembly,"Do pass",15,0,0,0,15
1848366,1448632,2024-05-22,Assembly,"AB 2818 Mathis Assembly Third Reading By WALDRON",71,0,0,9,80
1848366,1459976,2024-06-25,Senate,"Do pass, but first be re-referred to the Committee on [Appropriations] with the recommendation: To Consent Calendar",5,0,0,0,5
1848366,1463673,2024-08-05,Senate,"Placed on suspense file",7,0,0,0,7
1848369,1423750,2024-04-09,Assembly,"Do pass and be re-referred to the Committee on [Appropriations]",10,0,0,1,11
1848369,1443972,2024-05-16,Assembly,"Do pass as amended",11,0,0,4,15
1848369,1449569,2024-05-23,Assembly,"AB 2821 Grayson Assembly Third Reading",73,0,0,7,80
1848369,1462685,2024-07-03,Senate,"Do pass, but first be re-referred to the Committee on [Appropriations] with the recommendation: To Consent Calendar",7,0,0,0,7
1848369,1463352,2024-08-05,Senate,"Placed on suspense file",7,0,0,0,7
1848369,1464389,2024-08-15,Senate,"Do pass",7,0,0,0,7
1848369,1466188,2024-08-29,Assembly,"AB 2821 Grayson Concurrence in Senate Amendments",76,0,0,3,79
1848369,1466681,2024-08-28,Senate,"Special Consent AB2821 Grayson By Roth",39,0,0,1,40
1848370,1420154,2024-04-02,Assembly,"Do pass and be re-referred to the Committee on [Appropriations] with recommendation: To Consent Calendar",8,0,0,0,8
1848370,1429891,2024-04-17,Assembly,"Do pass. To Consent Calendar",15,0,0,0,15
1848370,1435357,2024-04-25,Assembly,"AB 2822 Gabriel Consent Calendar Second Day Regular Session",75,0,0,5,80
1848370,1450968,2024-05-28,Senate,"Do pass, but first be re-referred to the Committee on [Appropriations] with the recommendation: To Consent Calendar",4,0,0,1,5
1848370,1465288,2024-08-19,Senate,"Assembly 3rd Reading AB2822 Gabriel et al. By Rubio",40,0,0,0,40
1848370,1465477,2024-08-22,Assembly,"AB 2822 Gabriel Concurrence in Senate Amendments",62,0,0,17,79
1848375,1424893,2024-04-10,Assembly,"Do pass and be re-referred to the Committee on [Environmental Safety and Toxic Materials]",10,0,0,0,10
1848375,1435952,2024-04-23,Assembly,"Do pass and be re-referred to the Committee on [Appropriations]",7,0,0,0,7
1848375,1444004,2024-05-16,Assembly,"Do pass",15,0,0,0,15
1848375,1448830,2024-05-22,Assembly,"AB 2827 Reyes Assembly Third Reading",72,0,0,8,80
1848375,1458301,2024-06-18,Senate,"Do pass, but first be re-referred to the Committee on [Natural Resources and Water] with the recommendation: To Consent Calendar",5,0,0,0,5
1848375,1459958,2024-06-25,Senate,"Do pass, but first be re-referred to the Committee on [Appropriations]",11,0,0,0,11
1848375,1463364,2024-08-05,Senate,"Placed on suspense file",7,0,0,0,7
1848376,1419220,2024-04-02,Assembly,"Do pass and be re-referred to the Committee on [Transportation]",7,0,0,0,7
1848376,1431866,2024-04-22,Assembly,"Do pass and be re-referred to the Committee on [Appropriations]",15,0,0,0,15
1848377,1435280,2024-04-23,Assembly,"Do pass and be re-referred to the Committee on [Revenue and Taxation]",6,3,0,2,11
1848378,1433045,2024-04-23,Assembly,"Do pass and be re-referred to the Committee on [Appropriations] with recommendation: To Consent Calendar",6,0,0,1,7
1848378,1444389,2024-05-16,Assembly,"Do pass",15,0,0,0,15
1848378,1445956,2024-05-21,Assembly,"AB 2830 Robert Rivas Assembly Third Reading",73,0,0,7,80
1848378,1458185,2024-06-17,Senate,"Do pass, but first be re-referred to the Committee on [Appropriations] with the recommendation: To Consent Calendar",5,0,0,0,5
1848378,1462019,2024-07-01,Senate,"Placed on suspense file",7,0,0,0,7
1848378,1464079,2024-08-15,Senate,"Do pass",7,0,0,0,7
1848378,1465548,2024-08-26,Senate,"Assembly 3rd Reading AB2830 Robert Rivas By Menjivar",40,0,0,0,40
1848378,1466130,2024-08-29,Assembly,"AB 2830 Robert Rivas Concurrence in Senate Amendments",76,0,0,3,79
1848379,1412524,2024-03-20,Assembly,"Do pass as amended, and be re-referred to the Committee on [Appropriations] with recommendation: To Consent Calendar",7,0,0,0,7
1848379,1444605,2024-05-16,Assembly,"Do pass as amended",11,0,0,4,15
1848379,1449605,2024-05-23,Assembly,"AB 2831 Hoover Assembly Third Reading",73,0,0,7,80
1848379,1460708,2024-06-26,Senate,"Do pass, but first be re-referred to the Committee on [Appropriations] with the recommendation: To Consent Calendar",7,0,0,0,7
1848379,1463670,2024-08-05,Senate,"Placed on suspense file",7,0,0,0,7
1848380,1428798,2024-04-16,Assembly,"Do pass and be re-referred to the Committee on [Appropriations] with recommendation: To Consent Calendar",7,0,0,0,7
1848380,1441381,2024-05-08,Assembly,"Do pass. To Consent Calendar",15,0,0,0,15
1848380,1444245,2024-05-16,Assembly,"AB 2832 Ward Consent Calendar Second Day Regular Session",71,0,0,9,80
1848380,1459387,2024-06-24,Senate,"Do pass, but first be re-referred to the Committee on [Governmental Organization]",11,0,0,2,13
1848380,1460064,2024-06-25,Senate,"Do pass, but first be re-referred to the Committee on [Appropriations]",14,0,0,2,16
1848380,1465369,2024-08-20,Senate,"Assembly 3rd Reading AB2832 Ward By Dodd",40,0,0,0,40
1848380,1465504,2024-08-22,Assembly,"AB 2832 Ward Concurrence in Senate Amendments",60,0,0,19,79
1848381,1420134,2024-04-02,Assembly,"Do pass as amended, and be re-referred to the Committee on [Judiciary] with recommendation: To Consent Calendar",8,0,0,0,8
1848381,1436940,2024-04-30,Assembly,"Do pass as amended. To Consent Calendar",12,0,0,0,12
1848381,1441920,2024-05-09,Assembly,"AB 2833 McKinnor Consent Calendar Second Day Regular Session",65,0,0,15,80
1848381,1456402,2024-06-11,Senate,"Do pass as amended, but first amend, and re-refer to the Committee on [Judiciary]",4,0,0,1,5
1848381,1458177,2024-06-18,Senate,"Do pass",9,0,0,2,11
1848382,1429909,2024-04-16,Assembly,"Do pass and be re-referred to the Committee on [Appropriations] with recommendation: To Consent Calendar",11,0,0,0,11
1848382,1443929,2024-05-16,Assembly,"Do pass",15,0,0,0,15
1848382,1448647,2024-05-22,Assembly,"AB 2834 Rendon Assembly Third Reading",72,0,0,8,80
1848382,1460714,2024-06-26,Senate,"Do pass, but first be re-referred to the Committee on [Appropriations] with the recommendation: To Consent Calendar",7,0,0,0,7
1848382,1463437,2024-08-05,Senate,"Placed on suspense file",7,0,0,0,7
1848382,1464293,2024-08-15,Senate,"Do pass as amended",7,0,0,0,7
1848382,1466431,2024-08-30,Senate,"Special Consent AB2834 Rendon et al. By Newman",40,0,0,0,40
1848382,1466954,2024-08-31,Assembly,"AB 2834 Rendon Concurrence in Senate Amendments",77,0,0,2,79
1848383,1429932,2024-04-17,Assembly,"Do pass and be re-referred to the Committee on [Appropriations] with recommendation: To Consent Calendar",9,0,0,0,9
1848383,1434206,2024-04-24,Assembly,"Do pass. To Consent Calendar",14,0,0,1,15
1848383,1438492,2024-05-02,Assembly,"AB 2835 Gabriel Consent Calendar Second Day Regular Session",73,0,0,7,80
1848383,1456385,2024-06-11,Senate,"Do pass, but first be re-referred to the Committee on [Appropriations] with the recommendation: To Consent Calendar",11,0,0,0,11
1848383,1461240,2024-06-27,Senate,"Consent Calendar 2nd AB2835 Gabriel",40,0,0,0,40
1848383,1463767,2024-08-08,Assembly,"AB 2835 Gabriel Concurrence in Senate Amendments",72,0,0,7,79
1848385,1436936,2024-04-30,Assembly,"Do pass as amended",9,3,0,0,12
1848385,1445183,2024-05-20,Assembly,"AB 2837 Bauer-Kahan Assembly Third Reading",55,13,0,12,80
1848385,1460509,2024-06-25,Senate,"Do pass as amended",9,2,0,0,11
1848385,1466501,2024-08-30,Senate,"Assembly 3rd Reading AB2837 Bauer-Kahan By Lim√≥n",31,9,0,0,40
1848385,1467057,2024-08-31,Assembly,"AB 2837 Bauer-Kahan Concurrence in Senate Amendments",58,15,0,6,79
1848387,1424861,2024-04-10,Assembly,"Do pass as amended and be re-referred to the Committee on [Judiciary]",6,1,0,1,8
1848387,1436945,2024-04-30,Assembly,"Do pass as amended and be re-referred to the Committee on [Appropriations]",8,2,0,2,12
1848387,1444583,2024-05-16,Assembly,"Do pass",11,3,0,1,15
1848387,1448705,2024-05-22,Assembly,"AB 2839 Pellerin Assembly Third Reading",59,4,0,17,80
1848387,1458265,2024-06-18,Senate,"Do pass, but first be re-referred to the Committee on [Judiciary]",6,0,0,1,7
1848387,1462611,2024-07-02,Senate,"Do pass as amended, but first amend, and re-refer to the Committee on [Appropriations]",10,1,0,0,11
1848387,1463635,2024-08-05,Senate,"Placed on suspense file",7,0,0,0,7
1848387,1464432,2024-08-15,Senate,"Do pass as amended",5,2,0,0,7
1848387,1466303,2024-08-29,Senate,"Assembly 3rd Reading AB2839 Pellerin et al. By Blakespear Urgency Clause",32,6,0,2,40
1848387,1466550,2024-08-30,Assembly,"AB 2839 Pellerin Concurrence - Urgency Added",63,8,0,8,79
1848389,1419204,2024-04-02,Assembly,"Do pass as amended. To Consent Calendar",15,0,0,1,16
1848389,1437588,2024-04-30,Assembly,"Do pass as amended. To Consent Calendar",9,0,0,7,16
1848389,1441879,2024-05-09,Assembly,"AB 2841 Waldron Consent Calendar Second Day",65,0,0,15,80
1848389,1454198,2024-06-05,Senate,"Do pass, but first be re-referred to the Committee on [Judiciary] with the recommendation: To Consent Calendar",11,0,0,0,11
1848389,1456338,2024-06-11,Senate,"Do pass as amended, and be ordered to the Consent Calendar",11,0,0,0,11
1848389,1461267,2024-06-27,Senate,"Consent Calendar 2nd AB2841 Waldron et al. Urgency Clause",40,0,0,0,40
1848389,1462570,2024-07-03,Assembly,"AB 2841 Waldron Concurrence in Senate Amendments",72,0,0,7,79
1848390,1428922,2024-04-16,Assembly,"Do pass and be re-referred to the Committee on [Appropriations] with recommendation: To Consent Calendar",8,0,0,0,8
1848390,1437591,2024-05-01,Assembly,"Do pass. To Consent Calendar",14,0,0,1,15
1848390,1441891,2024-05-09,Assembly,"AB 2842 Papan Consent Calendar Second Day Regular Session",65,0,0,15,80
1848390,1456364,2024-06-11,Senate,"Do pass, but first be re-referred to the Committee on [Appropriations]",5,0,0,0,5
1848390,1459385,2024-06-24,Senate,"Placed on suspense file",6,0,0,1,7
1848390,1464201,2024-08-15,Senate,"Do pass as amended",7,0,0,0,7
1848390,1466574,2024-08-30,Senate,"Assembly 3rd Reading AB2842 Papan et al. By Blakespear",40,0,0,0,40
1848390,1467086,2024-08-31,Assembly,"AB 2842 Papan Concurrence in Senate Amendments",75,1,0,3,79
1848391,1433154,2024-04-23,Assembly,"Do pass and be re-referred to the Committee on [Appropriations] with recommendation: To Consent Calendar",16,0,0,0,16
1848391,1441324,2024-05-08,Assembly,"Do pass. To Consent Calendar",15,0,0,0,15
1848391,1444593,2024-05-16,Assembly,"AB 2843 Petrie-Norris Consent Calendar Second Day Regular Session",71,0,0,9,80
1848391,1462661,2024-07-03,Senate,"Do pass as amended, but first amend, and re-refer to the Committee on [Appropriations] with the recommendation: To Consent Calendar",11,0,0,0,11
1848391,1466150,2024-08-29,Assembly,"AB 2843 Petrie-Norris Concurrence in Senate Amendments",74,0,0,5,79
1848391,1466651,2024-08-28,Senate,"Assembly 3rd Reading AB2843 Petrie-Norris et al. By Rubio",39,0,0,1,40
1848393,1435301,2024-04-24,Assembly,"Do pass as amended, and be re-referred to the Committee on [Appropriations] with recommendation: To Consent Calendar",7,0,0,0,7
1848393,1444317,2024-05-16,Assembly,"Do pass as amended",11,0,0,4,15
1848393,1445954,2024-05-21,Assembly,"AB 2845 Robert Rivas Assembly Third Reading",73,0,0,7,80
1848394,1434245,2024-04-24,Assembly,"Do pass and be re-referred to the Committee on [Appropriations]",6,0,0,2,8
1848395,1420159,2024-04-03,Assembly,"Do pass and be re-referred to the Committee on [Appropriations]",13,2,0,1,16
1848395,1437639,2024-05-01,Assembly,"Do pass",11,3,0,1,15
1848395,1445299,2024-05-20,Assembly,"AB 2847 Addis Assembly Third Reading",52,11,0,17,80
1848395,1462357,2024-07-02,Senate,"Do pass as amended, but first amend, and re-refer to the Committee on [Appropriations]",15,3,0,0,18
1848395,1465355,2024-08-20,Senate,"Assembly 3rd Reading AB2847 Addis et al. By Durazo",32,8,0,0,40
1848395,1465761,2024-08-26,Assembly,"AB 2847 Addis Concurrence in Senate Amendments",57,11,0,11,79
1848397,1420058,2024-04-03,Assembly,"Do pass and be re-referred to the Committee on [Appropriations] with recommendation: To Consent Calendar",21,0,0,1,22
1848397,1429960,2024-04-17,Assembly,"Do pass. To Consent Calendar",15,0,0,0,15
1848397,1435224,2024-04-25,Assembly,"AB 2849 Blanca Rubio Consent Calendar Second Day Regular Session",75,0,0,5,80
1848397,1450957,2024-05-28,Senate,"Do pass, but first be re-referred to the Committee on [Appropriations] with the recommendation: To Consent Calendar",12,0,0,4,16
1848399,1424978,2024-04-09,Assembly,"Do pass and be re-referred to the Committee on [Natural Resources]",5,2,0,0,7
1848399,1431865,2024-04-22,Assembly,"Do pass and be re-referred to the Committee on [Appropriations]",8,2,0,1,11
1848399,1444591,2024-05-16,Assembly,"Do pass as amended",11,4,0,0,15
1848399,1449572,2024-05-23,Assembly,"AB 2851 Bonta Assembly Third Reading",57,13,0,10,80
1848399,1462626,2024-07-03,Senate,"Do pass as amended, but first amend, and re-refer to the Committee on [Appropriations]",5,0,0,2,7
1848399,1463483,2024-08-05,Senate,"Placed on suspense file",7,0,0,0,7
1848399,1464176,2024-08-15,Senate,"Do pass",5,2,0,0,7
1848399,1466604,2024-08-31,Senate,"Assembly 3rd Reading AB2851 Bonta By Laird",32,7,0,1,40
1848399,1466605,2024-08-31,Assembly,"AB 2851 Bonta Concurrence in Senate Amendments",59,12,0,8,79
1848400,1423854,2024-04-09,Assembly,"Do pass and be re-referred to the Committee on [Appropriations]",7,2,0,2,11
1848402,1423938,2024-04-08,Assembly,"Do pass as amended and be re-referred to the Committee on [Appropriations]",6,0,0,1,7
1848402,1443981,2024-05-16,Assembly,"Do pass",12,1,0,2,15
1848402,1448592,2024-05-22,Assembly,"AB 2854 Irwin Assembly Third Reading",61,3,0,16,80
1848402,1460774,2024-06-26,Senate,"Do pass, but first be re-referred to the Committee on [Appropriations]",7,0,0,0,7
1848402,1463681,2024-08-05,Senate,"Placed on suspense file",7,0,0,0,7
1848402,1464226,2024-08-15,Senate,"Do pass as amended",6,1,0,0,7
1848402,1465853,2024-08-27,Senate,"Assembly 3rd Reading AB2854 Irwin By Dahle",35,4,0,1,40
1848402,1466880,2024-08-28,Assembly,"AB 2854 Irwin Concurrence in Senate Amendments",67,3,0,9,79
1848407,1428822,2024-04-16,Assembly,"Do pass as amended and be re-referred to the Committee on [Judiciary]",16,0,0,0,16
1848407,1433100,2024-04-23,Assembly,"Do pass as amended, and be re-referred to the Committee on [Appropriations] with recommendation: To Consent Calendar",11,0,0,1,12
1848407,1443509,2024-05-15,Assembly,"Do pass. To Consent Calendar",15,0,0,0,15
1848407,1446139,2024-05-21,Assembly,"AB 2859 Jim Patterson Consent Calendar Second Day Regular Session",71,0,0,9,80
1848407,1458503,2024-06-19,Senate,"Do pass as amended, but first amend, and re-refer to the Committee on [Judiciary] with the recommendation: To Consent Calendar",11,0,0,0,11
1848407,1460701,2024-06-25,Senate,"Do pass as amended, but first amend, and re-refer to the Committee on [Appropriations] with the recommendation: To Consent Calendar",11,0,0,0,11
1848407,1465651,2024-08-26,Senate,"Assembly 3rd Reading AB2859 Jim Patterson et al. By Alvarado-Gil",40,0,0,0,40
1848407,1465852,2024-08-27,Assembly,"AB 2859 Jim Patterson Concurrence in Senate Amendments",77,0,0,2,79
1848408,1419225,2024-04-02,Assembly,"Do pass as amended and be re-referred to the Committee on [Appropriations]",18,0,0,0,18
1848408,1430041,2024-04-17,Assembly,"Do pass. To Consent Calendar",15,0,0,0,15
1848408,1438428,2024-05-02,Assembly,"AB 2860 Garcia Assembly Third Reading",75,0,0,5,80
1848408,1455795,2024-06-10,Senate,"Do pass, but first be re-referred to the Committee on [Appropriations]",12,0,0,1,13
1848408,1465667,2024-08-26,Senate,"Assembly 3rd Reading AB2860 Garcia et al. By Hurtado",40,0,0,0,40
1848408,1466012,2024-08-27,Assembly,"AB 2860 Garcia Concurrence in Senate Amendments",77,0,0,2,79
1848410,1428918,2024-04-16,Assembly,"Do pass as amended and be re-referred to the Committee on [Judiciary]",13,2,0,3,18
1848410,1433081,2024-04-23,Assembly,"Do pass and be re-referred to the Committee on [Appropriations]",9,2,0,1,12
1848410,1443908,2024-05-16,Assembly,"Do pass",11,4,0,0,15
1848410,1448718,2024-05-22,Assembly,"AB 2862 Gipson Assembly Third Reading",56,1,0,23,80
1848411,1436943,2024-04-30,Assembly,"Do pass",10,0,0,1,11
1848411,1444078,2024-05-16,Assembly,"AB 2863 Schiavo Assembly Third Reading",65,0,0,15,80
1848411,1460492,2024-06-25,Senate,"Do pass as amended",11,0,0,0,11
1848411,1466009,2024-08-27,Senate,"Assembly 3rd Reading AB2863 Schiavo et al. By Umberg",36,1,0,3,40
1848411,1467128,2024-08-28,Assembly,"AB 2863 Schiavo Concurrence in Senate Amendments",75,0,0,4,79
1848412,1419128,2024-04-02,Assembly,"Do pass as amended, and be re-referred to the Committee on [Appropriations] with recommendation: To Consent Calendar",18,0,0,0,18
1848412,1429877,2024-04-17,Assembly,"Do pass. To Consent Calendar",15,0,0,0,15
1848412,1435215,2024-04-25,Assembly,"AB 2864 Garcia Consent Calendar Second Day Regular Session",75,0,0,5,80
1848412,1455790,2024-06-10,Senate,"Do pass, but first be re-referred to the Committee on [Appropriations]",12,0,0,1,13
1848412,1465304,2024-08-19,Senate,"Assembly 3rd Reading AB2864 Garcia By Hurtado Urgency Clause",40,0,0,0,40
1848412,1465559,2024-08-26,Assembly,"AB 2864 Garcia Concurrence in Senate Amendments",77,0,0,2,79
1848413,1435225,2024-04-24,Assembly,"Do pass as amended, and be re-referred to the Committee on [Appropriations] with recommendation: To Consent Calendar",7,0,0,0,7
1848413,1441396,2024-05-08,Assembly,"Do pass. To Consent Calendar",15,0,0,0,15
1848413,1444614,2024-05-16,Assembly,"AB 2865 Wendy Carrillo Consent Calendar Second Day Regular Session",71,0,0,9,80
1848413,1456901,2024-06-12,Senate,"Do pass, but first be re-referred to the Committee on [Appropriations]",7,0,0,0,7
1848413,1467145,2024-08-28,Senate,"Assembly 3rd Reading AB2865 Wendy Carrillo By Lim√≥n",40,0,0,0,40
1848414,1419126,2024-04-02,Assembly,"Do pass and be re-referred to the Committee on [Health]",7,0,0,0,7
1848414,1428963,2024-04-16,Assembly,"Do pass and be re-referred to the Committee on [Appropriations]",15,0,0,1,16
1848414,1443934,2024-05-16,Assembly,"Do pass",15,0,0,0,15
1848414,1448620,2024-05-22,Assembly,"AB 2866 Pellerin Assembly Third Reading",72,0,0,8,80
1848414,1458238,2024-06-17,Senate,"Do pass, but first be re-referred to the Committee on [Health] with the recommendation: To Consent Calendar",5,0,0,0,5
1848414,1462546,2024-07-03,Senate,"Do pass as amended, but first amend, and re-refer to the Committee on [Appropriations] with the recommendation: To Consent Calendar",11,0,0,0,11
1848414,1463643,2024-08-05,Senate,"Placed on suspense file",7,0,0,0,7
1848414,1464413,2024-08-15,Senate,"Do pass",7,0,0,0,7
1848414,1466186,2024-08-29,Assembly,"AB 2866 Pellerin Concurrence in Senate Amendments",76,0,0,3,79
1848414,1467212,2024-08-28,Senate,"Assembly 3rd Reading AB2866 Pellerin et al. By Cortese",39,0,0,1,40
1848415,1436895,2024-04-30,Assembly,"Do pass",12,0,0,0,12
1848415,1442523,2024-05-13,Assembly,"AB 2867 Gabriel Assembly Third Reading",75,0,0,5,80
1848415,1460686,2024-06-25,Senate,"Do pass as amended, and be ordered to the Consent Calendar",11,0,0,0,11
1848415,1463877,2024-08-12,Senate,"Assembly 3rd Reading AB2867 Gabriel et al. By Wiener Urgency Clause",38,0,0,2,40
1848415,1464343,2024-08-15,Assembly,"AB 2867 Gabriel Concurrence - Urgency Added",76,0,0,3,79
1848417,1422085,2024-04-08,Assembly,"Do pass and be re-referred to the Committee on [Appropriations]",12,0,0,3,15
1848418,1431899,2024-04-22,Assembly,"Do pass and be re-referred to the Committee on [Agriculture]",7,3,0,1,11
1848419,1423855,2024-04-09,Assembly,"Do pass and be re-referred to the Committee on [Privacy and Consumer Protection]",16,0,0,0,16
1848419,1430002,2024-04-16,Assembly,"Do pass as amended and be re-referred to the Committee on [Appropriations]",11,0,0,0,11
1848419,1443508,2024-05-15,Assembly,"Do pass. To Consent Calendar",15,0,0,0,15
1848419,1445925,2024-05-21,Assembly,"AB 2871 Maienschein Consent Calendar Second Day Regular Session",71,0,0,9,80
1848419,1458261,2024-06-18,Senate,"Do pass, but first be re-referred to the Committee on [Health] with the recommendation: To Consent Calendar",5,0,0,0,5
1848419,1462455,2024-07-03,Senate,"Do pass, but first be re-referred to the Committee on [Appropriations] with the recommendation: To Consent Calendar",11,0,0,0,11
1848419,1465716,2024-08-26,Senate,"Assembly 3rd Reading AB2871 Maienschein By Padilla",40,0,0,0,40
1848419,1465949,2024-08-27,Assembly,"AB 2871 Maienschein Concurrence in Senate Amendments",77,0,0,2,79
1848420,1420069,2024-04-03,Assembly,"Do pass and be re-referred to the Committee on [Public Employment and Retirement]",12,0,0,3,15
1848420,1429882,2024-04-17,Assembly,"Do pass and be re-referred to the Committee on [Appropriations]",7,0,0,0,7
1848420,1444472,2024-05-16,Assembly,"Do pass",13,0,0,2,15
1848420,1449673,2024-05-23,Assembly,"AB 2872 Calderon Assembly Third Reading",70,0,0,10,80
1848420,1462629,2024-07-03,Senate,"Do pass, but first be re-referred to the Committee on [Appropriations]",5,0,0,0,5
1848420,1463425,2024-08-05,Senate,"Placed on suspense file",7,0,0,0,7
1848420,1464588,2024-08-15,Senate,"Do pass",5,2,0,0,7
1848420,1465582,2024-08-26,Senate,"Assembly 3rd Reading AB2872 Calderon By Laird",32,7,0,1,40
1848421,1421180,2024-04-03,Assembly,"Do pass and be re-referred to the Committee on [Jobs, Economic Development, and the Economy]",7,0,0,0,7
1848421,1428876,2024-04-16,Assembly,"Do pass and be re-referred to the Committee on [Appropriations]",7,0,0,0,7
1848421,1444155,2024-05-16,Assembly,"Do pass as amended",13,0,0,2,15
1848421,1448672,2024-05-22,Assembly,"AB 2873 Garcia Assembly Third Reading",68,0,0,12,80
1848421,1458512,2024-06-19,Senate,"Do pass, but first be re-referred to the Committee on [Appropriations]",5,0,0,0,5
1848421,1462075,2024-07-01,Senate,"Placed on suspense file",7,0,0,0,7
1848421,1464547,2024-08-15,Senate,"Do pass",6,0,0,1,7
1848421,1465554,2024-08-26,Senate,"Assembly 3rd Reading AB2873 Garcia et al. By Durazo",36,0,0,4,40
1848423,1423871,2024-04-09,Assembly,"Do pass and be re-referred to the Committee on [Appropriations]",14,0,0,1,15
1848423,1444099,2024-05-16,Assembly,"Do pass",15,0,0,0,15
1848423,1448742,2024-05-22,Assembly,"AB 2875 Friedman Assembly Third Reading By PAPAN",72,0,0,8,80
1848423,1457982,2024-06-17,Senate,"Do pass",9,0,0,2,11
1848423,1465560,2024-08-26,Senate,"Assembly 3rd Reading AB2875 Friedman By Caballero",37,0,0,3,40
1848423,1465880,2024-08-27,Assembly,"AB 2875 Friedman Concurrence in Senate Amendments",76,0,0,3,79
1848424,1421161,2024-04-03,Assembly,"Do pass as amended and be re-referred to the Committee on [Appropriations]",7,0,0,0,7
1848424,1437601,2024-05-01,Assembly,"Do pass. To Consent Calendar",14,0,0,1,15
1848424,1441960,2024-05-09,Assembly,"AB 2876 Berman Consent Calendar Second Day Regular Session",65,0,0,15,80
1848424,1456863,2024-06-12,Senate,"Do pass, but first be re-referred to the Committee on [Appropriations]",7,0,0,0,7
1848424,1465334,2024-08-20,Senate,"Assembly 3rd Reading AB2876 Berman et al. By Padilla",40,0,0,0,40
1848425,1435349,2024-04-23,Assembly,"Do pass as amended and be re-referred to the Committee on [Appropriations]",11,0,0,0,11
1848425,1441294,2024-05-08,Assembly,"Do pass",15,0,0,0,15
1848425,1445236,2024-05-20,Assembly,"AB 2877 Bauer-Kahan Assembly Third Reading",73,0,0,7,80
1848425,1460542,2024-06-25,Senate,"Do pass as amended, but first amend, and re-refer to the Committee on [Appropriations]",11,0,0,0,11
1848425,1463456,2024-08-05,Senate,"Placed on suspense file",7,0,0,0,7
1848426,1433120,2024-04-23,Assembly,"Do pass and be re-referred to the Committee on [Appropriations] with recommendation: To Consent Calendar",8,0,0,0,8
1848427,1422054,2024-04-08,Assembly,"Do pass and be re-referred to the Committee on [Appropriations] with recommendation: To Consent Calendar",15,0,0,0,15
1848427,1443466,2024-05-15,Assembly,"Do pass. To Consent Calendar",15,0,0,0,15
1848427,1446062,2024-05-21,Assembly,"AB 2879 Vince Fong Consent Calendar Second Day Regular Session",71,0,0,9,80
1848427,1460453,2024-06-25,Senate,"Do pass, but first be re-referred to the Committee on [Appropriations] with the recommendation: To Consent Calendar",15,0,0,0,15
1848427,1464061,2024-08-15,Senate,"Consent Calendar 2nd AB2879 Lackey",37,0,0,3,40
1848427,1465274,2024-08-19,Assembly,"AB 2879 Lackey Concurrence in Senate Amendments",75,0,0,4,79
1848429,1434259,2024-04-24,Assembly,"Do pass and be re-referred to the Committee on [Appropriations]",6,2,0,1,9
1848430,1420162,2024-04-02,Assembly,"Do pass and be re-referred to the Committee on [Appropriations]",6,1,0,1,8
1848430,1444388,2024-05-16,Assembly,"Do pass as amended",11,4,0,0,15
1848430,1449670,2024-05-23,Assembly,"AB 2882 McCarty Assembly Third Reading",46,17,0,17,80
1848430,1462373,2024-07-02,Senate,"Do pass, but first be re-referred to the Committee on [Appropriations]",4,1,0,0,5
1848430,1463377,2024-08-05,Senate,"Placed on suspense file",7,0,0,0,7
1848431,1432943,2024-04-23,Assembly,"Do pass and be re-referred to the Committee on [Appropriations]",9,0,0,2,11
1848431,1444140,2024-05-16,Assembly,"Do pass as amended",11,0,0,4,15
1848431,1446022,2024-05-21,Assembly,"AB 2883 Low Assembly Third Reading",73,0,0,7,80
1848431,1460462,2024-06-26,Senate,"Do pass, but first be re-referred to the Committee on [Appropriations]",7,0,0,0,7
1848431,1463492,2024-08-05,Senate,"Placed on suspense file",7,0,0,0,7
1848431,1464365,2024-08-15,Senate,"Do pass",7,0,0,0,7
1848431,1466657,2024-08-28,Senate,"Special Consent AB2883 Low By Durazo",39,0,0,1,40
1848433,1429904,2024-04-16,Assembly,"Do pass as amended, and be re-referred to the Committee on [Appropriations] with recommendation: To Consent Calendar",11,0,0,0,11
1848433,1441391,2024-05-08,Assembly,"Do pass. To Consent Calendar",15,0,0,0,15
1848433,1444487,2024-05-16,Assembly,"AB 2885 Bauer-Kahan Consent Calendar Second Day Regular Session",71,0,0,9,80
1848433,1458245,2024-06-18,Senate,"Do pass, but first be re-referred to the Committee on [Appropriations] with the recommendation: To Consent Calendar",10,0,0,1,11
1848433,1466434,2024-08-30,Senate,"Assembly 3rd Reading AB2885 Bauer-Kahan et al. By Umberg",40,0,0,0,40
1848433,1466904,2024-08-31,Assembly,"AB 2885 Bauer-Kahan Concurrence in Senate Amendments",76,0,0,3,79
1848434,1430064,2024-04-17,Assembly,"Do pass and be re-referred to the Committee on [Appropriations] with recommendation: To Consent Calendar",21,0,0,1,22
1848434,1437592,2024-05-01,Assembly,"Do pass. To Consent Calendar",14,0,0,1,15
1848434,1441971,2024-05-09,Assembly,"AB 2886 Aguiar-Curry Consent Calendar Second Day Regular Session",65,0,0,15,80
1848434,1456415,2024-06-11,Senate,"Do pass, but first be re-referred to the Committee on [Appropriations] with the recommendation: To Consent Calendar",15,0,0,1,16
1848435,1421184,2024-04-03,Assembly,"Do pass as amended and be re-referred to the Committee on [Appropriations]",7,0,0,0,7
1848435,1444269,2024-05-16,Assembly,"Do pass as amended",11,0,0,4,15
1848435,1446127,2024-05-21,Assembly,"AB 2887 Maienschein Assembly Third Reading",73,0,0,7,80
1848435,1456948,2024-06-12,Senate,"Do pass, but first be re-referred to the Committee on [Appropriations] with the recommendation: To Consent Calendar",7,0,0,0,7
1848435,1459363,2024-06-24,Senate,"Placed on suspense file",6,0,0,1,7
1848435,1464318,2024-08-15,Senate,"Do pass as amended",6,0,0,1,7
1848435,1465871,2024-08-27,Senate,"Assembly 3rd Reading AB2887 Maienschein By Padilla",40,0,0,0,40
1848435,1466806,2024-08-28,Assembly,"AB 2887 Maienschein Concurrence in Senate Amendments",77,0,0,2,79
1848436,1419122,2024-04-02,Assembly,"Do pass as amended and be re-referred to the Committee on [Appropriations]",18,0,0,0,18
1848437,1420113,2024-04-03,Assembly,"Do pass and be re-referred to the Committee on [Appropriations]",5,1,0,1,7
1848437,1434192,2024-04-24,Assembly,"Do pass",11,4,0,0,15
1848437,1442525,2024-05-13,Assembly,"AB 2889 Zbur Assembly Third Reading",59,11,0,10,80
1848437,1460436,2024-06-26,Senate,"Do pass, but first be re-referred to the Committee on [Judiciary]",4,0,0,1,5
1848437,1462606,2024-07-02,Senate,"Do pass, but first be re-referred to the Committee on [Appropriations]",9,1,0,1,11
1848437,1463658,2024-08-05,Senate,"Placed on suspense file",7,0,0,0,7
1848437,1464238,2024-08-15,Senate,"Do pass",4,2,0,1,7
1848437,1465375,2024-08-20,Senate,"Assembly 3rd Reading AB2889 Zbur By Portantino",30,9,0,1,40
1848439,1429890,2024-04-17,Assembly,"Do pass and be re-referred to the Committee on [Appropriations] with recommendation: To Consent Calendar",16,0,0,0,16
1848440,1429977,2024-04-17,Assembly,"Do pass as amended and be re-referred to the Committee on [Transportation]",15,0,0,0,15
1848440,1431925,2024-04-22,Assembly,"Do pass and be re-referred to the Committee on [Appropriations]",15,0,0,0,15
1848440,1444448,2024-05-16,Assembly,"Do pass",15,0,0,0,15
1848440,1448789,2024-05-22,Assembly,"AB 2892 Low Assembly Third Reading",72,0,0,8,80
1848440,1460598,2024-06-25,Senate,"Do pass, but first be re-referred to the Committee on [Appropriations]",15,0,0,0,15
1848440,1463509,2024-08-05,Senate,"Placed on suspense file",7,0,0,0,7
1848440,1464192,2024-08-15,Senate,"Do pass",7,0,0,0,7
1848440,1466420,2024-08-30,Senate,"Assembly 3rd Reading AB2892 Low By Portantino",40,0,0,0,40
1848441,1429889,2024-04-17,Assembly,"Do pass and be re-referred to the Committee on [Health]",7,0,0,2,9
1848441,1432939,2024-04-23,Assembly,"Do pass and be re-referred to the Committee on [Appropriations]",14,0,0,2,16
1848441,1444106,2024-05-16,Assembly,"Do pass",11,0,0,4,15
1848441,1448704,2024-05-22,Assembly,"AB 2893 Ward Assembly Third Reading",60,0,0,20,80
1848441,1458456,2024-06-18,Senate,"Do pass as amended, but first amend, and re-refer to the Committee on [Health]",8,2,0,0,10
1848441,1462445,2024-07-03,Senate,"Do pass as amended, but first amend, and re-refer to the Committee on [Appropriations]",9,0,0,2,11
1848441,1463875,2024-08-12,Senate,"Placed on suspense file",7,0,0,0,7
1848445,1424862,2024-04-10,Assembly,"Do pass and be re-referred to the Committee on [Revenue and Taxation] with recommendation: To Consent Calendar",9,0,0,0,9
1848445,1433098,2024-04-22,Assembly,"Do pass and be re-referred to the Committee on [Appropriations]",7,0,0,0,7
1848445,1443460,2024-05-15,Assembly,"Do pass. To Consent Calendar",15,0,0,0,15
1848445,1445955,2024-05-21,Assembly,"AB 2897 Connolly Consent Calendar Second Day Regular Session",71,0,0,9,80
1848445,1453378,2024-06-04,Senate,"Do pass, but first be re-referred to the Committee on [Revenue and Taxation]",9,0,0,1,10
1848445,1460726,2024-06-26,Senate,"Do pass, but first be re-referred to the Committee on [Appropriations] with the recommendation: To Consent Calendar",7,0,0,0,7
1848445,1465755,2024-08-26,Senate,"Assembly 3rd Reading AB2897 Connolly et al. By Blakespear",40,0,0,0,40
1848445,1465779,2024-08-27,Assembly,"AB 2897 Connolly Concurrence in Senate Amendments",77,0,0,2,79
1848446,1430058,2024-04-17,Assembly,"Do pass and be re-referred to the Committee on [Judiciary] with recommendation: To Consent Calendar",9,0,0,0,9
1848446,1432997,2024-04-23,Assembly,"Do pass. To Consent Calendar",11,0,0,1,12
1848446,1436224,2024-04-29,Assembly,"AB 2898 Wendy Carrillo Consent Calendar Second Day Regular Session",74,0,0,6,80
1848446,1453441,2024-06-04,Senate,"Do pass",11,0,0,0,11
1848446,1465690,2024-08-26,Senate,"Assembly 3rd Reading AB2898 Wendy Carrillo By Wiener",40,0,0,0,40
1848447,1423720,2024-04-09,Assembly,"Do pass as amended and be re-referred to the Committee on [Appropriations]",15,0,0,1,16
1848447,1444310,2024-05-16,Assembly,"Do pass",14,1,0,0,15
1848447,1448778,2024-05-22,Assembly,"AB 2899 Gabriel Assembly Third Reading",67,0,0,13,80
1848447,1460636,2024-06-26,Senate,"Do pass, but first be re-referred to the Committee on [Appropriations]",9,0,0,2,11
1848447,1463393,2024-08-05,Senate,"Placed on suspense file",7,0,0,0,7
1848447,1464221,2024-08-15,Senate,"Do pass",6,0,0,1,7
1848447,1465413,2024-08-21,Senate,"Assembly 3rd Reading AB2899 Gabriel By Roth",27,1,0,12,40
1848448,1427224,2024-04-15,Assembly,"Do pass and be re-referred to the Committee on [Appropriations] with recommendation: To Consent Calendar",15,0,0,0,15
1848448,1444526,2024-05-16,Assembly,"Do pass as amended",11,0,0,4,15
1848448,1446047,2024-05-21,Assembly,"AB 2900 Soria Assembly Third Reading",73,0,0,7,80
1848448,1458477,2024-06-19,Senate,"Do pass, but first be re-referred to the Committee on [Transportation] with the recommendation: To Consent Calendar",7,0,0,0,7
1848448,1460737,2024-06-25,Senate,"Do pass, but first be re-referred to the Committee on [Appropriations] with the recommendation: To Consent Calendar",15,0,0,0,15
1848448,1463891,2024-08-12,Senate,"Consent Calendar 2nd AB2900 Soria",38,0,0,2,40
1848449,1421132,2024-04-03,Assembly,"Do pass and be re-referred to the Committee on [Higher Education]",7,0,0,0,7
1848449,1433006,2024-04-23,Assembly,"Do pass and be re-referred to the Committee on [Appropriations]",9,1,0,1,11
1848449,1444301,2024-05-16,Assembly,"Do pass as amended",11,1,0,3,15
1848449,1446142,2024-05-21,Assembly,"AB 2901 Aguiar-Curry Assembly Third Reading",67,1,0,12,80
1848449,1456870,2024-06-12,Senate,"Do pass, but first be re-referred to the Committee on [Labor, Public Employment and Retirement ]",5,0,0,2,7
1848449,1458488,2024-06-19,Senate,"Do pass, but first be re-referred to the Committee on [Appropriations]",5,0,0,0,5
1848449,1463518,2024-08-05,Senate,"Placed on suspense file",7,0,0,0,7
1848449,1464217,2024-08-15,Senate,"Do pass as amended",5,2,0,0,7
1848450,1423830,2024-04-08,Assembly,"Do pass as amended and be re-referred to the Committee on [Appropriations]",11,0,0,0,11
1848450,1444589,2024-05-16,Assembly,"Do pass",15,0,0,0,15
1848450,1445922,2024-05-21,Assembly,"AB 2902 Wood Assembly Third Reading",73,0,0,7,80
1848450,1458398,2024-06-19,Senate,"Do pass as amended, but first amend, and re-refer to the Committee on [Appropriations]",7,0,0,0,7
1848450,1463924,2024-08-12,Senate,"Placed on suspense file",7,0,0,0,7
1848450,1463998,2024-08-15,Senate,"Do pass as amended",6,0,0,1,7
1848450,1465834,2024-08-27,Senate,"Assembly 3rd Reading AB2902 Wood et al. By Laird",38,0,0,2,40
1848450,1465835,2024-08-27,Senate,"Assembly 3rd Reading AB2902 Wood et al. By Laird Reconsider",39,0,0,1,40
1848450,1465836,2024-08-27,Senate,"Assembly 3rd Reading AB2902 Wood et al. By Laird",38,1,0,1,40
1848450,1466813,2024-08-28,Assembly,"AB 2902 Wood Concurrence in Senate Amendments",77,0,0,2,79
1848451,1434183,2024-04-24,Assembly,"Do pass and be re-referred to the Committee on [Appropriations] with recommendation: To Consent Calendar",9,0,0,0,9
1848451,1443967,2024-05-16,Assembly,"Do pass",15,0,0,0,15
1848451,1448719,2024-05-22,Assembly,"AB 2903 Hoover Assembly Third Reading",72,0,0,8,80
1848451,1458535,2024-06-18,Senate,"Do pass, but first be re-referred to the Committee on [Human Services] with the recommendation: To Consent Calendar",10,0,0,0,10
1848451,1462288,2024-07-01,Senate,"Do pass, but first be re-referred to the Committee on [Appropriations]",5,0,0,0,5
1848451,1463902,2024-08-12,Senate,"Placed on suspense file",7,0,0,0,7
1848451,1464041,2024-08-15,Senate,"Do pass as amended",7,0,0,0,7
1848451,1466547,2024-08-30,Senate,"Special Consent AB2903 Hoover et al. By Niello",40,0,0,0,40
1848451,1466970,2024-08-31,Assembly,"AB 2903 Hoover Concurrence in Senate Amendments",77,0,0,2,79
1848452,1431062,2024-04-17,Assembly,"Do pass as amended and be re-referred to the Committee on [Appropriations]",9,0,0,0,9
1848452,1437633,2024-05-01,Assembly,"Do pass. To Consent Calendar",14,0,0,1,15
1848452,1441900,2024-05-09,Assembly,"AB 2904 Quirk-Silva Consent Calendar Second Day Regular Session",65,0,0,15,80
1848452,1451607,2024-05-29,Senate,"Do pass as amended, but first amend, and re-refer to the Committee on [Appropriations]",6,1,0,0,7
1848452,1465298,2024-08-19,Senate,"Assembly 3rd Reading AB2904 Quirk-Silva By Skinner",39,0,0,1,40
1848452,1465480,2024-08-22,Assembly,"AB 2904 Quirk-Silva Concurrence in Senate Amendments",62,0,0,17,79
1848453,1424877,2024-04-10,Assembly,"Do pass as amended, and be re-referred to the Committee on [Privacy and Consumer Protection] with recommendation: To Consent Calendar",11,0,0,0,11
1848453,1435310,2024-04-23,Assembly,"Do pass as amended, and be re-referred to the Committee on [Appropriations] with recommendation: To Consent Calendar",11,0,0,0,11
1848453,1443458,2024-05-15,Assembly,"Do pass. To Consent Calendar",15,0,0,0,15
1848453,1446099,2024-05-21,Assembly,"AB 2905 Low Consent Calendar Second Day Regular Session",71,0,0,9,80
1848453,1458161,2024-06-18,Senate,"Do pass, but first be re-referred to the Committee on [Appropriations]",18,0,0,0,18
1848453,1465268,2024-08-19,Senate,"Assembly 3rd Reading AB2905 Low et al. By Dodd",40,0,0,0,40
1848454,1423918,2024-04-09,Assembly,"Do pass as amended and be re-referred to the Committee on [Appropriations]",6,0,0,1,7
1848454,1444009,2024-05-16,Assembly,"Do pass as amended",11,0,0,4,15
1848454,1445927,2024-05-21,Assembly,"AB 2906 Bryan Assembly Third Reading",73,0,0,7,80
1848454,1458290,2024-06-17,Senate,"Do pass, but first be re-referred to the Committee on [Appropriations] with the recommendation: To Consent Calendar",5,0,0,0,5
1848454,1462031,2024-07-01,Senate,"Placed on suspense file",7,0,0,0,7
1848454,1464067,2024-08-15,Senate,"Do pass",7,0,0,0,7
1848454,1466096,2024-08-29,Assembly,"AB 2906 Bryan Concurrence in Senate Amendments",76,0,0,3,79
1848454,1466639,2024-08-28,Senate,"Assembly 3rd Reading AB2906 Bryan et al. By Ochoa Bogh",39,0,0,1,40
1848455,1432962,2024-04-23,Assembly,"Do pass and be re-referred to the Committee on [Appropriations] with recommendation: To Consent Calendar",8,0,0,0,8
1848455,1444361,2024-05-16,Assembly,"Do pass",14,0,0,1,15
1848455,1448728,2024-05-22,Assembly,"AB 2907 Zbur Assembly Third Reading",70,0,0,10,80
1848455,1460000,2024-06-25,Senate,"Do pass, but first be re-referred to the Committee on [Appropriations] with the recommendation: To Consent Calendar",5,0,0,0,5
1848455,1463534,2024-08-05,Senate,"Placed on suspense file",7,0,0,0,7
1848455,1464635,2024-08-15,Senate,"Do pass as amended",6,0,0,1,7
1848455,1465990,2024-08-27,Senate,"Assembly 3rd Reading AB2907 Zbur By Newman",40,0,0,0,40
1848455,1466869,2024-08-28,Assembly,"AB 2907 Zbur Concurrence in Senate Amendments",77,0,0,2,79
1848456,1418407,2024-04-01,Assembly,"Do pass",8,0,0,1,9
1848456,1427264,2024-04-15,Assembly,"AB 2908 Chen Assembly Third Reading",73,0,0,7,80
1848456,1458532,2024-06-19,Senate,"Do pass, but first be re-referred to the Committee on [Judiciary] with the recommendation: To Consent Calendar",6,0,0,1,7
1848456,1460633,2024-06-25,Senate,"Do pass and be ordered to the Consent Calendar",11,0,0,0,11
1848456,1462517,2024-07-03,Senate,"Consent Calendar 2nd AB2908 Chen",39,0,0,1,40
1848457,1431006,2024-04-17,Assembly,"Do pass and be re-referred to the Committee on [Housing and Community Development]",9,0,0,0,9
1848457,1434047,2024-04-24,Assembly,"Do pass and be re-referred to the Committee on [Appropriations]",9,0,0,0,9
1848457,1441327,2024-05-08,Assembly,"Do pass. To Consent Calendar",15,0,0,0,15
1848457,1444270,2024-05-16,Assembly,"AB 2909 Santiago Consent Calendar Second Day Regular Session",71,0,0,9,80
1848458,1429902,2024-04-17,Assembly,"Do pass and be re-referred to the Committee on [Local Government]",9,0,0,0,9
1848458,1435348,2024-04-24,Assembly,"Do pass and be re-referred to the Committee on [Appropriations]",8,0,0,1,9
1848458,1444225,2024-05-16,Assembly,"Do pass",15,0,0,0,15
1848458,1448561,2024-05-22,Assembly,"AB 2910 Santiago Assembly Third Reading",72,0,0,8,80
1848458,1462559,2024-07-02,Senate,"Do pass, but first be re-referred to the Committee on [Appropriations]",10,0,0,0,10
1848458,1463671,2024-08-05,Senate,"Placed on suspense file",7,0,0,0,7
1848458,1464360,2024-08-15,Senate,"Do pass as amended",7,0,0,0,7
1848458,1465556,2024-08-26,Senate,"Assembly 3rd Reading AB2910 Santiago By Smallwood-Cuevas",40,0,0,0,40
1848458,1465899,2024-08-27,Assembly,"AB 2910 Santiago Concurrence in Senate Amendments",77,0,0,2,79
1848459,1434029,2024-04-24,Assembly,"Do pass",7,0,0,1,8
1848459,1445999,2024-05-21,Assembly,"AB 2911 McKinnor Assembly Third Reading",63,0,0,17,80
1848461,1420106,2024-04-02,Assembly,"Do pass and be re-referred to the Committee on [Appropriations]",7,0,0,1,8
1848462,1433056,2024-04-23,Assembly,"Do pass and be re-referred to the Committee on [Appropriations]",16,0,0,0,16
1848462,1441311,2024-05-08,Assembly,"Do pass. To Consent Calendar",15,0,0,0,15
1848462,1444320,2024-05-16,Assembly,"AB 2914 Bonta Consent Calendar Second Day Regular Session",71,0,0,9,80
1848462,1462645,2024-07-03,Senate,"Do pass, but first be re-referred to the Committee on [Appropriations] with the recommendation: To Consent Calendar",11,0,0,0,11
1848464,1435948,2024-04-23,Assembly,"Do pass and be re-referred to the Committee on [Appropriations]",5,1,0,1,7
1848465,1434157,2024-04-24,Assembly,"Do pass and be re-referred to the Committee on [Appropriations]",6,0,0,2,8
1848465,1441351,2024-05-08,Assembly,"Do pass",11,0,0,4,15
1848465,1448777,2024-05-22,Assembly,"AB 2917 Zbur Assembly Third Reading",57,3,0,20,80
1848465,1460011,2024-06-25,Senate,"Do pass, but first be re-referred to the Committee on [Appropriations]",4,1,0,0,5
1848465,1463592,2024-08-05,Senate,"Placed on suspense file",7,0,0,0,7
1848465,1464497,2024-08-15,Senate,"Do pass as amended",4,2,0,1,7
1848465,1465722,2024-08-26,Senate,"Assembly 3rd Reading AB2917 Zbur et al. By Blakespear",32,6,0,2,40
1848465,1465973,2024-08-27,Assembly,"AB 2917 Zbur Concurrence in Senate Amendments",60,6,0,13,79
1848466,1428808,2024-04-16,Assembly,"Do pass and be re-referred to the Committee on [Appropriations]",18,0,0,0,18
1848466,1434048,2024-04-24,Assembly,"Do pass. To Consent Calendar",14,0,0,1,15
1848466,1438495,2024-05-02,Assembly,"AB 2918 Zbur Consent Calendar Second Day Regular Session",73,0,0,7,80
1848466,1462590,2024-07-03,Senate,"Do pass as amended, but first amend, and re-refer to the Committee on [Appropriations]",5,0,0,2,7
1848466,1463542,2024-08-05,Senate,"Placed on suspense file",7,0,0,0,7
1848470,1425926,2024-04-10,Assembly,"Do pass as amended and be re-referred to the Committee on [Appropriations]",9,0,0,0,9
1848470,1437648,2024-05-01,Assembly,"Do pass. To Consent Calendar",14,0,0,1,15
1848470,1441887,2024-05-09,Assembly,"AB 2922 Garcia Consent Calendar Second Day Regular Session",65,0,0,15,80
1848470,1462522,2024-07-03,Senate,"Do pass as amended, but first amend, and re-refer to the Committee on [Appropriations]",7,0,0,0,7
1848470,1466582,2024-08-30,Assembly,"With recommendation: That Senate amendments be concurred in",8,0,0,1,9
1848470,1467089,2024-08-28,Senate,"Assembly 3rd Reading AB2922 Garcia By Padilla Urgency Clause",39,0,0,1,40
1848470,1467090,2024-08-31,Assembly,"AB 2922 Garcia Concurrence in Senate Amendments",76,0,0,3,79
1848471,1420200,2024-04-02,Assembly,"Do pass and be re-referred to the Committee on [Appropriations]",3,0,0,5,8
1848471,1420201,2024-04-02,Assembly,Reconsideration,8,0,0,0,8
1848473,1423743,2024-04-09,Assembly,"Do pass as amended and be re-referred to the Committee on [Judiciary]",11,0,0,0,11
1848473,1428967,2024-04-16,Assembly,"Do pass as amended, and be re-referred to the Committee on [Appropriations] with recommendation: To Consent Calendar",12,0,0,0,12
1848473,1444255,2024-05-16,Assembly,"Do pass as amended",11,0,0,4,15
1848473,1446041,2024-05-21,Assembly,"AB 2925 Friedman Assembly Third Reading By LOWENTHAL",73,0,0,7,80
1848473,1458561,2024-06-19,Senate,"Do pass, but first be re-referred to the Committee on [Judiciary]",6,0,0,1,7
1848473,1460516,2024-06-25,Senate,"Do pass, but first be re-referred to the Committee on [Appropriations]",11,0,0,0,11
1848473,1463531,2024-08-05,Senate,"Placed on suspense file",7,0,0,0,7
1848473,1464171,2024-08-15,Senate,"Do pass as amended",7,0,0,0,7
1848473,1466328,2024-08-29,Assembly,"AB 2925 Friedman Concurrence in Senate Amendments",75,0,0,4,79
1848473,1466842,2024-08-28,Senate,"Assembly 3rd Reading AB2925 Friedman et al. By Becker",39,0,0,1,40
1848474,1434127,2024-04-24,Assembly,"Do pass and be re-referred to the Committee on [Appropriations]",9,0,0,0,9
1848474,1443950,2024-05-16,Assembly,"Do pass",15,0,0,0,15
1848474,1448586,2024-05-22,Assembly,"AB 2926 Kalra Assembly Third Reading",71,0,0,9,80
1848474,1458562,2024-06-18,Senate,"Do pass, but first be re-referred to the Committee on [Judiciary]",10,0,0,0,10
1848474,1462586,2024-07-02,Senate,"Do pass, but first be re-referred to the Committee on [Appropriations] with the recommendation: To Consent Calendar",11,0,0,0,11
1848474,1463366,2024-08-05,Senate,"Placed on suspense file",7,0,0,0,7
1848474,1464440,2024-08-15,Senate,"Do pass",7,0,0,0,7
1848474,1465954,2024-08-27,Senate,"Assembly 3rd Reading AB2926 Kalra et al. By Caballero",40,0,0,0,40
1848474,1466835,2024-08-28,Assembly,"AB 2926 Kalra Concurrence in Senate Amendments",77,0,0,2,79
1848475,1435334,2024-04-24,Assembly,"Do pass as amended, and be re-referred to the Committee on [Appropriations] with recommendation: To Consent Calendar",7,0,0,0,7
1848475,1444588,2024-05-16,Assembly,"Do pass",15,0,0,0,15
1848475,1448690,2024-05-22,Assembly,"AB 2927 McCarty Assembly Third Reading",72,0,0,8,80
1848475,1458487,2024-06-19,Senate,"Do pass as amended, but first amend, and re-refer to the Committee on [Appropriations]",6,0,0,1,7
1848475,1460443,2024-06-26,Senate,"Do pass",7,0,0,0,7
1848475,1461218,2024-06-27,Senate,"Assembly 3rd Reading AB2927 McCarty et al. By Lim√≥n Urgency Clause",39,0,0,1,40
1848475,1461219,2024-06-27,Assembly,"AB 2927 McCARTY Concurrence - Urgency Added",77,0,0,2,79
1848477,1419142,2024-04-02,Assembly,"Do pass and be re-referred to the Committee on [Human Services] with recommendation: To Consent Calendar",12,0,0,0,12
1848477,1433103,2024-04-23,Assembly,"Do pass and be re-referred to the Committee on [Appropriations] with recommendation: To Consent Calendar",6,0,0,1,7
1848477,1444188,2024-05-16,Assembly,"Do pass",15,0,0,0,15
1848477,1448650,2024-05-22,Assembly,"AB 2929 Juan Carrillo Assembly Third Reading",71,0,0,9,80
1848477,1458313,2024-06-17,Senate,"Do pass as amended, but first amend, and re-refer to the Committee on [Judiciary]",4,0,0,1,5
1848477,1460512,2024-06-25,Senate,"Do pass as amended, but first amend, and re-refer to the Committee on [Appropriations] with the recommendation: To Consent Calendar",11,0,0,0,11
1848477,1463356,2024-08-05,Senate,"Placed on suspense file",7,0,0,0,7
1848477,1464596,2024-08-15,Senate,"Do pass",7,0,0,0,7
1848477,1466222,2024-08-29,Assembly,"AB 2929 Juan Carrillo Concurrence in Senate Amendments",76,0,0,3,79
1848477,1466679,2024-08-28,Senate,"Special Consent AB2929 Juan Carrillo et al. By Ashby",39,0,0,1,40
1848478,1429878,2024-04-16,Assembly,"Do pass as amended and be re-referred to the Committee on [Judiciary]",8,3,0,0,11
1848478,1432936,2024-04-23,Assembly,"Do pass as amended and be re-referred to the Committee on [Appropriations]",9,2,0,1,12
1848478,1443914,2024-05-16,Assembly,"Do pass as amended",11,4,0,0,15
1848478,1446102,2024-05-21,Assembly,"AB 2930 Bauer-Kahan Assembly Third Reading",50,14,0,16,80
1848478,1462617,2024-07-02,Senate,"Do pass as amended, but first amend, and re-refer to the Committee on [Appropriations]",9,2,0,0,11
1848478,1463398,2024-08-05,Senate,"Placed on suspense file",7,0,0,0,7
1848478,1464179,2024-08-15,Senate,"Do pass as amended",4,2,0,1,7
1848479,1420081,2024-04-03,Assembly,"Do pass and be re-referred to the Committee on [Higher Education]",7,0,0,0,7
1848479,1433024,2024-04-23,Assembly,"Do pass and be re-referred to the Committee on [Appropriations]",10,0,0,1,11
1848479,1444267,2024-05-16,Assembly,"Do pass",15,0,0,0,15
1848479,1448799,2024-05-22,Assembly,"AB 2931 Mike Fong Assembly Third Reading",71,0,0,9,80
1848479,1456894,2024-06-12,Senate,"Do pass, but first be re-referred to the Committee on [Education] with the recommendation: To Consent Calendar",5,0,0,0,5
1848479,1462485,2024-07-03,Senate,"Do pass, but first be re-referred to the Committee on [Appropriations] with the recommendation: To Consent Calendar",7,0,0,0,7
1848479,1463560,2024-08-05,Senate,"Placed on suspense file",7,0,0,0,7
1848479,1464289,2024-08-15,Senate,"Do pass",7,0,0,0,7
1848479,1467248,2024-08-28,Senate,"Special Consent AB2931 Mike Fong By Durazo",39,0,0,1,40
1848480,1421186,2024-04-03,Assembly,"Do pass as amended, and be re-referred to the Committee on [Appropriations] with recommendation: To Consent Calendar",7,0,0,0,7
1848480,1434137,2024-04-24,Assembly,"Do pass. To Consent Calendar",14,0,0,1,15
1848480,1438435,2024-05-02,Assembly,"AB 2932 Joe Patterson Consent Calendar Second Day Regular Session",73,0,0,7,80
1848480,1454266,2024-06-05,Senate,"Do pass, but first be re-referred to the Committee on [Appropriations] with the recommendation: To Consent Calendar",7,0,0,0,7
1848480,1458826,2024-06-20,Senate,"Consent Calendar 2nd AB2932 Joe Patterson et al",36,0,0,4,40
1848480,1459415,2024-06-24,Assembly,"AB 2932 Joe Patterson Concurrence in Senate Amendments",75,0,0,4,79
1848481,1430003,2024-04-17,Assembly,"Do pass and be re-referred to the Committee on [Environmental Safety and Toxic Materials]",7,1,0,1,9
1848481,1435945,2024-04-23,Assembly,"Do pass and be re-referred to the Committee on [Appropriations]",5,1,0,1,7
1848482,1434056,2024-04-24,Assembly,"Do pass and be re-referred to the Committee on [Appropriations] with recommendation: To Consent Calendar",9,0,0,0,9
1848482,1444036,2024-05-16,Assembly,"Do pass as amended",11,1,0,3,15
1848482,1445989,2024-05-21,Assembly,"AB 2934 Ward Assembly Third Reading",73,0,0,7,80
1848482,1460094,2024-06-24,Senate,"Do pass, but first be re-referred to the Committee on [Appropriations] with the recommendation: To Consent Calendar",10,0,0,0,10
1848482,1463471,2024-08-05,Senate,"Placed on suspense file",7,0,0,0,7
1848483,1427249,2024-04-15,Assembly,"Do pass as amended and be re-referred to the Committee on [Human Services]",9,0,0,0,9
1848483,1433179,2024-04-23,Assembly,"Do pass and be re-referred to the Committee on [Appropriations] with recommendation: To Consent Calendar",6,0,0,1,7
1848483,1441320,2024-05-08,Assembly,"Do pass. To Consent Calendar",15,0,0,0,15
1848483,1444322,2024-05-16,Assembly,"AB 2935 Maienschein Consent Calendar Second Day Regular Session",71,0,0,9,80
1848483,1458160,2024-06-18,Senate,"Do pass as amended, but first amend, and re-refer to the Committee on [Human Services]",10,0,0,1,11
1848483,1462341,2024-07-01,Senate,"Do pass",5,0,0,0,5
1848483,1466508,2024-08-30,Senate,"Assembly 3rd Reading AB2935 Maienschein et al. By Eggman",40,0,0,0,40
1848483,1467044,2024-08-31,Assembly,"AB 2935 Maienschein Concurrence in Senate Amendments",73,0,0,6,79
1848484,1433176,2024-04-23,Assembly,"Do pass as amended and be re-referred to the Committee on [Appropriations]",10,0,0,1,11
1848484,1444034,2024-05-16,Assembly,"Do pass as amended",11,0,0,4,15
1848484,1449675,2024-05-23,Assembly,"AB 2936 Jackson Assembly Third Reading",71,0,0,9,80
1848484,1460586,2024-06-26,Senate,"Do pass as amended, but first amend, and re-refer to the Committee on [Appropriations] with the recommendation: To Consent Calendar",7,0,0,0,7
1848484,1463429,2024-08-05,Senate,"Placed on suspense file",7,0,0,0,7
1848484,1464390,2024-08-15,Senate,"Do pass as amended",7,0,0,0,7
1848484,1466468,2024-08-30,Senate,"Special Consent AB2936 Jackson By Eggman",40,0,0,0,40
1848484,1467003,2024-08-31,Assembly,"AB 2936 Jackson Concurrence in Senate Amendments",77,0,0,2,79
1848487,1435249,2024-04-24,Assembly,"Do pass and be re-referred to the Committee on [Appropriations] with recommendation: To Consent Calendar",8,0,0,1,9
1848487,1441333,2024-05-08,Assembly,"Do pass. To Consent Calendar",15,0,0,0,15
1848487,1444604,2024-05-16,Assembly,"AB 2939 Rendon Consent Calendar Second Day Regular Session",71,0,0,9,80
1848487,1456418,2024-06-11,Senate,"Do pass, but first be re-referred to the Committee on [Natural Resources and Water] with the recommendation: To Consent Calendar",7,0,0,0,7
1848487,1460115,2024-06-25,Senate,"Do pass, but first be re-referred to the Committee on [Appropriations] with the recommendation: To Consent Calendar",11,0,0,0,11
1848487,1463920,2024-08-12,Senate,"Consent Calendar 2nd AB2939 Rendon",38,0,0,2,40
1848487,1465443,2024-08-22,Assembly,"AB 2939 Rendon Concurrence in Senate Amendments",62,0,0,17,79
1848489,1423773,2024-04-09,Assembly,"Do pass and be re-referred to the Committee on [Appropriations]",6,0,0,1,7
1848490,1433101,2024-04-23,Assembly,"Do pass as amended and be re-referred to the Committee on [Appropriations]",16,0,0,0,16
1848491,1424948,2024-04-09,Assembly,"Do pass as amended and be re-referred to the Committee on [Appropriations]",8,0,0,0,8
1848491,1444381,2024-05-16,Assembly,"Do pass as amended",10,0,0,5,15
1848491,1448653,2024-05-22,Assembly,"AB 2943 Zbur Assembly Third Reading",66,0,0,14,80
1848491,1456327,2024-06-11,Senate,"Do pass, but first be re-referred to the Committee on [Appropriations]",4,0,0,1,5
1848491,1457970,2024-06-17,Senate,"Placed on suspense file",1,3,0,3,7
1848491,1457971,2024-06-17,Senate,"Do pass as amended",5,0,0,2,7
1848491,1463778,2024-08-08,Senate,"Assembly 3rd Reading AB2943 Zbur et al. By Wiener",36,1,0,3,40
1848491,1463848,2024-08-12,Assembly,"AB 2943 Zbur Concurrence in Senate Amendments",64,4,0,11,79
1848492,1395209,2024-02-26,Assembly,"Be adopted. To Consent Calendar",7,0,0,4,11
1848492,1400011,2024-02-29,Assembly,"ACR 143 Bennett Consent Calendar Second Day Regular Session",73,0,0,7,80
1848492,1413852,2024-03-21,Senate,"Special Consent ACR143 Bennett et al",37,0,0,3,40
1848493,1402366,2024-03-04,Assembly,"Be adopted. To Consent Calendar",8,0,0,3,11
1848493,1405806,2024-03-07,Assembly,"ACR 144 Maienschein Consent Calendar Second Day",69,0,0,11,80
1848493,1425888,2024-04-11,Senate,"Special Consent ACR144 Maienschein et al",39,0,0,1,40
1848494,1395222,2024-02-26,Assembly,"Be adopted. To third reading",7,0,0,4,11
1848494,1413838,2024-03-21,Senate,"Special Consent ACR145 Jim Patterson et al",37,0,0,3,40
1848495,1395240,2024-02-26,Assembly,"Be adopted. To third reading",7,0,0,4,11
1848496,1407467,2024-03-11,Assembly,"Be adopted. To Consent Calendar",10,0,0,1,11
1848496,1409570,2024-03-14,Assembly,"HR 71 Mike Fong Consent Calendar Second Day Regular Session",70,0,0,10,80
1848497,1395228,2024-02-26,Assembly,"Be adopted. To third reading",7,0,0,4,11
1848498,1419186,2024-04-01,Senate,"Do pass as amended, but first amend, and re-refer to the Committee on [Appropriations]",5,0,0,0,5
1848498,1427219,2024-04-15,Senate,"Placed on suspense file",6,0,0,1,7
1848498,1444285,2024-05-16,Senate,"Do pass",7,0,0,0,7
1848498,1449708,2024-05-23,Senate,"Special Consent SB1197 Alvarado-Gil",37,0,0,3,40
1848498,1456442,2024-06-11,Assembly,"Do pass and be re-referred to the Committee on [Appropriations]",6,0,0,1,7
1848498,1464489,2024-08-15,Assembly,"Do pass as amended",11,0,0,4,15
1848498,1466587,2024-08-30,Senate,"Special Consent SB1197 Alvarado-Gil et al",40,0,0,0,40
1848498,1467052,2024-08-28,Assembly,"SB 1197 Alvarado-Gil Senate Third Reading By Gipson",77,0,0,2,79
1848499,1420053,2024-04-03,Senate,"Do pass as amended, but first amend, and re-refer to the Committee on [Judiciary]",7,0,0,0,7
1848499,1428931,2024-04-16,Senate,"Do pass, but first be re-referred to the Committee on [Appropriations] with the recommendation: To Consent Calendar",11,0,0,0,11
1848499,1438499,2024-05-02,Senate,"Consent Calendar 2nd SB1198 Roth",38,0,0,2,40
1848499,1457979,2024-06-17,Assembly,"Do pass and be re-referred to the Committee on [Appropriations]",8,0,0,1,9
1848499,1462212,2024-07-02,Assembly,"Do pass. To Consent Calendar",15,0,0,0,15
1848499,1463774,2024-08-08,Assembly,"SB 1198 Roth Consent Calendar Second Day Regular Session",72,0,0,7,79
1848501,1424844,2024-04-10,Senate,"Do pass, but first be re-referred to the Committee on [Appropriations]",7,0,0,0,7
1848501,1431903,2024-04-22,Senate,"Placed on suspense file",7,0,0,0,7
1848501,1444131,2024-05-16,Senate,"Do pass",7,0,0,0,7
1848501,1449614,2024-05-23,Senate,"Special Consent SB1200 Glazer",37,0,0,3,40
1848501,1462236,2024-07-02,Assembly,"Do pass as amended and be re-referred to the Committee on [Appropriations]",11,0,0,0,11
1848502,1420151,2024-04-02,Senate,"Do pass, but first be re-referred to the Committee on [Banking and Financial Institutions]",9,1,0,1,11
1848502,1430017,2024-04-17,Senate,"Do pass, but first be re-referred to the Committee on [Appropriations]",5,2,0,0,7
1848502,1436216,2024-04-29,Senate,"Placed on suspense file",5,0,0,2,7
1848502,1444348,2024-05-16,Senate,"Do pass as amended",5,2,0,0,7
1848502,1450281,2024-05-21,Senate,"Senate 3rd Reading SB1201 Durazo et al",23,10,0,7,40
1848503,1430040,2024-04-17,Senate,"Do pass, but first be re-referred to the Committee on [Rules]",4,0,0,1,5
1848503,1434032,2024-04-23,Senate,"Do pass as amended, but first amend, and re-refer to the Committee on [Appropriations] with the recommendation: To Consent Calendar",11,0,0,0,11
1848503,1442564,2024-05-13,Senate,"Placed on suspense file",7,0,0,0,7
1848503,1444442,2024-05-16,Senate,"Do pass",7,0,0,0,7
1848503,1450367,2024-05-21,Senate,"Senate 3rd Reading SB1202 Newman",39,0,0,1,40
1848503,1458548,2024-06-19,Assembly,"Do pass and be re-referred to the Committee on [Public Safety] with recommendation: To Consent Calendar",7,0,0,0,7
1848503,1462654,2024-07-02,Assembly,"Do pass and be re-referred to the Committee on [Appropriations] with recommendation: To Consent Calendar",8,0,0,0,8
1848504,1434204,2024-04-24,Senate,"Do pass, but first be re-referred to the Committee on [Revenue and Taxation]",2,5,0,0,7
1848506,1424870,2024-04-10,Senate,"Do pass, but first be re-referred to the Committee on [Appropriations]",4,1,0,0,5
1848506,1431870,2024-04-22,Senate,"Placed on suspense file",7,0,0,0,7
1848506,1444578,2024-05-16,Senate,"Do pass as amended",5,2,0,0,7
1848506,1448768,2024-05-22,Senate,"Senate 3rd Reading SB1205 Laird",29,8,0,3,40
1848506,1460445,2024-06-26,Assembly,"Do pass as amended and be re-referred to the Committee on [Appropriations]",10,0,0,5,15
1848506,1464294,2024-08-15,Assembly,"Do pass as amended",11,3,0,1,15
1848507,1427313,2024-04-15,Senate,"Do pass, but first be re-referred to the Committee on [Energy, Utilities and Communications]",9,1,0,3,13
1848507,1432993,2024-04-22,Senate,"Do pass as amended, but first amend, and re-refer to the Committee on [Appropriations]",15,3,0,0,18
1848507,1442590,2024-05-13,Senate,"Placed on suspense file",7,0,0,0,7
1848508,1423749,2024-04-09,Senate,"Do pass, but first be re-referred to the Committee on [Environmental Quality] with the recommendation: To Consent Calendar",14,0,0,2,16
1848508,1430093,2024-04-17,Senate,"Do pass, but first be re-referred to the Committee on [Appropriations] with the recommendation: To Consent Calendar",7,0,0,0,7
1848508,1436227,2024-04-29,Senate,"Placed on suspense file",5,0,0,2,7
1848508,1444622,2024-05-16,Senate,"Do pass",7,0,0,0,7
1848508,1449546,2024-05-23,Senate,"Special Consent SB1207 Dahle et al",37,0,0,3,40
1848508,1457969,2024-06-17,Assembly,"Do pass as amended, and be re-referred to the Committee on [Appropriations] with recommendation: To Consent Calendar",10,0,0,1,11
1848508,1464055,2024-08-15,Assembly,"Do pass",14,0,0,1,15
1848508,1465692,2024-08-26,Assembly,"SB 1207 Dahle Senate Third Reading By Connolly",76,0,0,3,79
1848508,1467071,2024-08-28,Senate,"Special Consent SB1207 Dahle et al",39,0,0,1,40
1848509,1434078,2024-04-24,Senate,"Do pass as amended, but first amend, and re-refer to the Committee on [Appropriations]",4,0,0,3,7
1848509,1442545,2024-05-13,Senate,"Placed on suspense file",7,0,0,0,7
1848509,1444659,2024-05-16,Senate,"Do pass",5,2,0,0,7
1848509,1445184,2024-05-20,Senate,"Senate 3rd Reading SB1208 Padilla",28,6,0,6,40
1848509,1460428,2024-06-25,Assembly,"Do pass and be re-referred to the Committee on [Natural Resources]",5,0,0,2,7
1848509,1462055,2024-07-01,Assembly,"Do pass as amended and be re-referred to the Committee on [Appropriations]",9,1,0,2,12
1848509,1464155,2024-08-15,Assembly,"Do pass",11,0,0,4,15
1848509,1466631,2024-09-01,Assembly,"SB 1208 Padilla Senate Third Reading By Boerner",30,8,0,41,79
1848510,1412509,2024-03-20,Senate,"Do pass",6,0,0,1,7
1848510,1450313,2024-05-21,Senate,"Senate 3rd Reading SB1209 Cortese",39,0,0,1,40
1848510,1458443,2024-06-19,Assembly,"Do pass",9,0,0,0,9
1848510,1465522,2024-08-22,Assembly,"SB 1209 Cortese Senate Third Reading By Juan Carrillo",60,0,0,19,79
1848510,1465748,2024-08-26,Senate,"Unfinished Business SB1209 Cortese Concurrence",39,0,0,1,40
1848511,1419119,2024-04-02,Senate,"Do pass as amended, but first amend, and re-refer to the Committee on [Local Government]",15,1,0,2,18
1848511,1430020,2024-04-17,Senate,"Do pass as amended, but first amend, and re-refer to the Committee on [Appropriations]",5,2,0,0,7
1848511,1450354,2024-05-21,Senate,"Senate 3rd Reading SB1210 Skinner",33,5,0,2,40
1848511,1458468,2024-06-19,Assembly,"Do pass as amended and be re-referred to the Committee on [Local Government]",13,1,0,2,16
1848511,1460630,2024-06-26,Assembly,"Do pass and be re-referred to the Committee on [Appropriations]",6,0,0,3,9
1848511,1463727,2024-08-07,Assembly,"Do pass",10,1,0,4,15
1848511,1465270,2024-08-19,Assembly,"SB 1210 Skinner Senate Third Reading By Hart",60,2,0,17,79
1848511,1465599,2024-08-26,Senate,"Unfinished Business SB1210 Skinner Concurrence",34,6,0,0,40
1848512,1412589,2024-03-19,Senate,"Do pass as amended, but first amend, and re-refer to the Committee on [Local Government]",8,2,0,0,10
1848512,1430069,2024-04-17,Senate,"Do pass as amended, but first amend, and re-refer to the Committee on [Appropriations]",5,2,0,0,7
1848512,1450378,2024-05-21,Senate,"Senate 3rd Reading SB1211 Skinner",29,8,0,3,40
1848512,1456891,2024-06-12,Assembly,"Do pass and be re-referred to the Committee on [Local Government]",8,1,0,0,9
1848512,1460591,2024-06-26,Assembly,"Do pass and be re-referred to the Committee on [Appropriations]",6,0,0,3,9
1848512,1464197,2024-08-15,Assembly,"Do pass as amended",10,2,0,3,15
1848512,1466275,2024-08-29,Senate,"Unfinished Business SB1211 Skinner et al. Concurrence",30,9,0,1,40
1848512,1466873,2024-08-28,Assembly,"SB 1211 Skinner Senate Third Reading By Alvarez",57,9,0,13,79
1848514,1420208,2024-04-03,Senate,"Do pass, but first be re-referred to the Committee on [Appropriations]",10,0,0,1,11
1848514,1427285,2024-04-15,Senate,"Placed on suspense file",6,0,0,1,7
1848514,1443962,2024-05-16,Senate,"Do pass",7,0,0,0,7
1848514,1450301,2024-05-21,Senate,"Senate 3rd Reading SB1213 Atkins et al",39,0,0,1,40
1848514,1453419,2024-06-04,Assembly,"Do pass and be re-referred to the Committee on [Appropriations]",14,0,0,2,16
1848514,1464594,2024-08-15,Assembly,"Do pass as amended",11,0,0,4,15
1848514,1466452,2024-08-30,Senate,"Special Consent SB1213 Atkins et al",40,0,0,0,40
1848514,1466929,2024-08-28,Assembly,"SB 1213 Atkins Senate Third Reading By Weber",73,0,0,6,79
1848515,1423892,2024-04-09,Senate,"Do pass, but first be re-referred to the Committee on [Appropriations] with the recommendation: To Consent Calendar",14,0,0,2,16
1848515,1431930,2024-04-22,Senate,"Placed on suspense file",7,0,0,0,7
1848515,1444141,2024-05-16,Senate,"Do pass as amended",7,0,0,0,7
1848515,1450035,2024-05-24,Senate,"Special Consent SB1214 Nguyen et al",38,0,0,2,40
1848515,1458782,2024-06-19,Assembly,"Do pass and be re-referred to the Committee on [Appropriations] with recommendation: To Consent Calendar",19,0,0,3,22
1848516,1423889,2024-04-09,Senate,"Do pass, but first be re-referred to the Committee on [Appropriations] with the recommendation: To Consent Calendar",14,0,0,2,16
1848516,1435271,2024-04-25,Senate,"Consent Calendar 2nd SB1215 G.O. (Dodd) Urgency Clause",36,0,0,4,40
1848516,1455780,2024-06-10,Assembly,"Do pass and be re-referred to the Committee on [Appropriations] with recommendation: To Consent Calendar",7,0,0,1,8
1848516,1458481,2024-06-19,Assembly,"Do pass. To Consent Calendar",14,0,0,1,15
1848516,1460437,2024-06-26,Assembly,"SB 1215 Governmental Organization Consent Calendar Second Day Regular Session",75,0,0,4,79
1848517,1434063,2024-04-23,Senate,"Do pass, but first be re-referred to the Committee on [Appropriations]",11,4,0,0,15
1848517,1450285,2024-05-21,Senate,"Senate 3rd Reading SB1216 Blakespear",30,9,0,1,40
1848517,1462330,2024-07-01,Assembly,"Do pass as amended and be re-referred to the Committee on [Appropriations]",11,4,0,0,15
1848517,1463739,2024-08-07,Assembly,"Do pass",10,4,0,1,15
1848517,1466206,2024-08-29,Senate,"Unfinished Business SB1216 Blakespear Concurrence",31,8,0,1,40
1848517,1466718,2024-08-28,Assembly,"SB 1216 Blakespear Senate Third Reading By Bryan",54,18,0,7,79
1848518,1434092,2024-04-24,Senate,"Do pass, but first be re-referred to the Committee on [Appropriations] with the recommendation: To Consent Calendar",6,0,0,1,7
1848518,1439610,2024-05-06,Senate,"Placed on suspense file",7,0,0,0,7
1848518,1444038,2024-05-16,Senate,"Do pass",7,0,0,0,7
1848518,1449699,2024-05-23,Senate,"Special Consent SB1217 Glazer",37,0,0,3,40
1848518,1460711,2024-06-26,Assembly,"Do pass and be re-referred to the Committee on [Appropriations] with recommendation: To Consent Calendar",15,0,0,0,15
1848518,1463753,2024-08-07,Assembly,"Do pass. To Consent Calendar",14,0,0,1,15
1848518,1466238,2024-08-29,Senate,"Unfinished Business SB1217 Glazer Concurrence",40,0,0,0,40
1848518,1467228,2024-08-28,Assembly,"SB 1217 Glazer Senate Third Reading By Calderon",77,0,0,2,79
1848519,1433104,2024-04-23,Senate,"Do pass, but first be re-referred to the Committee on [Appropriations] with the recommendation: To Consent Calendar",11,0,0,0,11
1848519,1439703,2024-05-06,Senate,"Placed on suspense file",7,0,0,0,7
1848519,1444611,2024-05-16,Senate,"Do pass as amended",7,0,0,0,7
1848519,1450009,2024-05-24,Senate,"Special Consent SB1218 Newman",38,0,0,2,40
1848519,1459982,2024-06-25,Assembly,"Do pass and be re-referred to the Committee on [Appropriations] with recommendation: To Consent Calendar",13,0,0,2,15
1848521,1423828,2024-04-09,Senate,"Do pass as amended, but first amend, and re-refer to the Committee on [Local Government]",10,3,0,3,16
1848521,1429892,2024-04-17,Senate,"Do pass, but first be re-referred to the Committee on [Appropriations]",5,1,0,1,7
1848521,1436173,2024-04-29,Senate,"Placed on suspense file",5,0,0,2,7
1848521,1444613,2024-05-16,Senate,"Do pass as amended",5,2,0,0,7
1848521,1450315,2024-05-21,Senate,"Senate 3rd Reading SB1220 Lim√≥n",32,7,0,1,40
1848521,1458393,2024-06-19,Assembly,"Do pass and be re-referred to the Committee on [Privacy and Consumer Protection]",5,0,0,2,7
1848521,1462467,2024-07-02,Assembly,"Do pass as amended and be re-referred to the Committee on [Appropriations]",7,2,0,2,11
1848521,1464599,2024-08-15,Assembly,"Do pass as amended",11,3,0,1,15
1848521,1466093,2024-08-29,Assembly,"SB 1220 Lim√≥n Senate Third Reading By Kalra",61,8,0,10,79
1848521,1466585,2024-08-30,Senate,"Unfinished Business SB1220 Lim√≥n et al. Concurrence",31,8,0,1,40
1848522,1433034,2024-04-22,Senate,"Do pass, but first be re-referred to the Committee on [Labor, Public Employment and Retirement ]",14,4,0,0,18
1848522,1442592,2024-05-13,Senate,"Placed on suspense file",7,0,0,0,7
1848522,1444674,2024-05-16,Senate,"Do pass",5,2,0,0,7
1848522,1450352,2024-05-21,Senate,"Senate 3rd Reading SB1221 Min",28,9,0,3,40
1848522,1461991,2024-07-01,Assembly,"Do pass as amended and be re-referred to the Committee on [Appropriations]",12,1,0,3,16
1848522,1464460,2024-08-15,Assembly,"Do pass as amended",11,3,0,1,15
1848522,1466674,2024-08-31,Senate,"Unfinished Business SB1221 Min Concurrence",30,8,0,2,40
1848522,1466675,2024-08-31,Assembly,"SB 1221 Min Senate Third Reading By Friedman",54,15,0,10,79
1848523,1424823,2024-04-10,Senate,"Do pass, but first be re-referred to the Committee on [Appropriations]",7,0,0,0,7
1848523,1431893,2024-04-22,Senate,"Placed on suspense file",7,0,0,0,7
1848524,1428916,2024-04-16,Senate,"Do pass, but first be re-referred to the Committee on [Appropriations]",11,0,0,0,11
1848524,1450348,2024-05-21,Senate,"Senate 3rd Reading SB1223 Becker",38,0,0,2,40
1848524,1462537,2024-07-02,Assembly,"Do pass and be re-referred to the Committee on [Appropriations]",10,0,0,1,11
1848524,1463761,2024-08-07,Assembly,"Do pass. To Consent Calendar",14,0,0,1,15
1848524,1467106,2024-08-31,Senate,"Unfinished Business SB1223 Becker Concurrence",38,0,0,2,40
1848524,1467107,2024-08-31,Assembly,"SB 1223 Becker Senate Third Reading By Bauer-Kahan",76,0,0,3,79
1848525,1433043,2024-04-23,Senate,"Do pass as amended, but first amend, and re-refer to the Committee on [Appropriations]",16,0,0,0,16
1848525,1450299,2024-05-21,Senate,"Senate 3rd Reading SB1224 Ochoa Bogh et al",39,0,0,1,40
1848525,1454253,2024-06-05,Assembly,"Do pass and be re-referred to the Committee on [Appropriations]",19,0,0,3,22
1848525,1458430,2024-06-19,Assembly,"Do pass. To Consent Calendar",14,0,0,1,15
1848525,1460579,2024-06-26,Assembly,"SB 1224 Ochoa Bogh Consent Calendar Second Day Regular Session",75,0,0,4,79
1848526,1410538,2024-03-18,Senate,"Do pass, but first be re-referred to the Committee on [Appropriations]",11,0,0,2,13
1848526,1450337,2024-05-21,Senate,"Senate 3rd Reading SB1225 Jones",39,0,0,1,40
1848526,1456365,2024-06-11,Assembly,"Do pass and be re-referred to the Committee on [Appropriations]",17,0,0,1,18
1848526,1458422,2024-06-19,Assembly,"Do pass. To Consent Calendar",14,0,0,1,15
1848526,1465592,2024-08-26,Assembly,"SB 1225 Jones Senate Third Reading By Chen",77,0,0,2,79
1848526,1467085,2024-08-28,Senate,"Special Consent SB1225 Jones",39,0,0,1,40
1848527,1427298,2024-04-15,Senate,"Do pass, but first be re-referred to the Committee on [Appropriations] with the recommendation: To Consent Calendar",10,0,0,1,11
1848527,1438440,2024-05-02,Senate,"Consent Calendar 2nd SB1226 Cortese",38,0,0,2,40
1848527,1456414,2024-06-11,Assembly,"Do pass and be re-referred to the Committee on [Appropriations]",13,0,0,2,15
1848527,1458474,2024-06-19,Assembly,"Do pass. To Consent Calendar",14,0,0,1,15
1848527,1463814,2024-08-08,Assembly,"SB 1226 Cortese Senate Third Reading By Soria",71,0,0,8,79
1848528,1430078,2024-04-17,Senate,"Do pass as amended, but first amend, and re-refer to the Committee on [Revenue and Taxation]",4,2,0,1,7
1848528,1434077,2024-04-24,Senate,"Do pass, but first be re-referred to the Committee on [Appropriations]",6,1,0,0,7
1848528,1439670,2024-05-06,Senate,"Placed on suspense file",7,0,0,0,7
1848529,1434205,2024-04-23,Senate,"Do pass as amended, but first amend, and re-refer to the Committee on [Appropriations]",10,1,0,0,11
1848529,1442637,2024-05-13,Senate,"Placed on suspense file",7,0,0,0,7
1848530,1434075,2024-04-24,Senate,"Do pass as amended, but first amend, and re-refer to the Committee on [Appropriations]",1,3,0,3,7
1848531,1424944,2024-04-10,Senate,"Do pass, but first be re-referred to the Committee on [Health]",6,1,0,0,7
1848531,1431962,2024-04-22,Senate,"Do pass, but first be re-referred to the Committee on [Appropriations]",9,0,0,2,11
1848531,1439709,2024-05-06,Senate,"Placed on suspense file",7,0,0,0,7
1848531,1444253,2024-05-16,Senate,"Do pass",5,2,0,0,7
1848531,1445147,2024-05-20,Senate,"Senate 3rd Reading SB1230 Rubio et al",31,5,0,4,40
1848531,1456359,2024-06-11,Assembly,"Do pass and be re-referred to the Committee on [Governmental Organization]",16,0,0,0,16
1848531,1462237,2024-07-02,Assembly,"Do pass and be re-referred to the Committee on [Appropriations]",18,0,0,4,22
1848531,1464306,2024-08-15,Assembly,"Do pass as amended",11,0,0,4,15
1848531,1465894,2024-08-27,Assembly,"SB 1230 Rubio Senate Third Reading By Wood",68,2,0,9,79
1848531,1467087,2024-08-28,Senate,"Unfinished Business SB1230 Rubio et al. Concurrence",31,5,0,4,40
1848532,1430103,2024-04-17,Senate,"Do pass, but first be re-referred to the Committee on [Appropriations] with the recommendation: To Consent Calendar",7,0,0,0,7
1848532,1436193,2024-04-29,Senate,"Placed on suspense file",5,0,0,2,7
1848532,1444268,2024-05-16,Senate,"Do pass",7,0,0,0,7
1848532,1449550,2024-05-23,Senate,"Special Consent SB1231 Allen",37,0,0,3,40
1848532,1461963,2024-07-01,Assembly,"Do pass as amended and be re-referred to the Committee on [Appropriations]",12,0,0,0,12
1848533,1430071,2024-04-17,Senate,"Do pass, but first be re-referred to the Committee on [Environmental Quality]",2,4,0,1,7
1848533,1430072,2024-04-17,Senate,"[First] hearing set for [04-17-2024]: Failed passage in Committee. Reconsideration granted",7,0,0,0,7
1848534,1424896,2024-04-10,Senate,"Do pass, but first be re-referred to the Committee on [Rules]",7,0,0,0,7
1848534,1431963,2024-04-22,Senate,"Do pass, but first be re-referred to the Committee on [Appropriations]",12,0,0,1,13
1848534,1439613,2024-05-06,Senate,"Placed on suspense file",7,0,0,0,7
1848534,1444441,2024-05-16,Senate,"Do pass as amended",7,0,0,0,7
1848534,1450014,2024-05-24,Senate,"Special Consent SB1233 Wilk",38,0,0,2,40
1848534,1458173,2024-06-18,Assembly,"Do pass and be re-referred to the Committee on [Business and Professions] with recommendation: To Consent Calendar",10,0,0,1,11
1848534,1460043,2024-06-25,Assembly,"Do pass and be re-referred to the Committee on [Appropriations] with recommendation: To Consent Calendar",18,0,0,0,18
1848534,1464239,2024-08-15,Assembly,"Do pass as amended",14,0,0,1,15
1848534,1466191,2024-08-29,Assembly,"SB 1233 Wilk Senate Third Reading By Maienschein",76,0,0,3,79
1848534,1466407,2024-08-30,Senate,"Unfinished Business SB1233 Wilk Concurrence",40,0,0,0,40
1848535,1423877,2024-04-09,Senate,"Do pass, but first be re-referred to the Committee on [Local Government]",11,0,0,0,11
1848535,1430063,2024-04-17,Senate,"Do pass as amended, but first amend, and re-refer to the Committee on [Appropriations]",7,0,0,0,7
1848535,1439614,2024-05-06,Senate,"Placed on suspense file",7,0,0,0,7
1848535,1444312,2024-05-16,Senate,"Do pass",7,0,0,0,7
1848535,1449667,2024-05-23,Senate,"Special Consent SB1234 Allen",37,0,0,3,40
1848535,1460510,2024-06-25,Assembly,"Do pass and be re-referred to the Committee on [Appropriations]",7,0,0,0,7
1848537,1435311,2024-04-24,Senate,"Do pass as amended, but first amend, and re-refer to the Committee on [Appropriations]",11,0,0,0,11
1848537,1442578,2024-05-13,Senate,"Placed on suspense file",7,0,0,0,7
1848539,1424849,2024-04-10,Senate,"Do pass, but first be re-referred to the Committee on [Judiciary]",11,0,0,0,11
1848539,1428992,2024-04-16,Senate,"Do pass as amended, but first amend, and re-refer to the Committee on [Appropriations]",11,0,0,0,11
1848539,1436196,2024-04-29,Senate,"Placed on suspense file",5,0,0,2,7
1848539,1444540,2024-05-16,Senate,"Do pass",7,0,0,0,7
1848539,1450324,2024-05-21,Senate,"Senate 3rd Reading SB1238 Eggman",39,0,0,1,40
1848539,1460085,2024-06-25,Assembly,"Do pass as amended and be re-referred to the Committee on [Appropriations]",16,0,0,0,16
1848539,1464300,2024-08-15,Assembly,"Do pass",14,0,0,1,15
1848539,1466021,2024-08-27,Assembly,"SB 1238 Eggman Senate Third Reading By Wood",75,0,0,4,79
1848539,1466964,2024-08-28,Senate,"Unfinished Business SB1238 Eggman Concurrence",39,0,0,1,40
1848540,1433172,2024-04-23,Senate,"Do pass as amended, but first amend, and re-refer to the Committee on [Appropriations]",15,0,0,1,16
1848540,1442540,2024-05-13,Senate,"Placed on suspense file",7,0,0,0,7
1848541,1424838,2024-04-10,Senate,"Do pass, but first be re-referred to the Committee on [Appropriations] with the recommendation: To Consent Calendar",5,0,0,0,5
1848541,1435362,2024-04-25,Senate,"Consent Calendar 2nd SB1240 Alvarado-Gil Urgency Clause",36,0,0,4,40
1848541,1458461,2024-06-19,Assembly,"Do pass and be re-referred to the Committee on [Appropriations] with recommendation: To Consent Calendar",7,0,0,0,7
1848541,1463713,2024-08-07,Assembly,"Do pass. To Consent Calendar",14,0,0,1,15
1848541,1464152,2024-08-15,Assembly,"SB 1240 Alvarado-Gil Consent Calendar Second Day Regular Session",75,0,0,4,79
1848541,1465455,2024-08-22,Senate,"Special Consent SB1240 Alvarado-Gil Urgency Clause",33,0,0,7,40
1848542,1424810,2024-04-10,Senate,"Do pass as amended, but first amend, and re-refer to the Committee on [Appropriations]",7,0,0,0,7
1848542,1436174,2024-04-29,Senate,"Placed on suspense file",5,0,0,2,7
1848543,1419165,2024-04-02,Senate,"Do pass, but first be re-referred to the Committee on [Appropriations]",5,0,0,0,5
1848543,1442526,2024-05-13,Senate,"Placed on suspense file",7,0,0,0,7
1848543,1444040,2024-05-16,Senate,"Do pass as amended",7,0,0,0,7
1848543,1448753,2024-05-22,Senate,"Senate 3rd Reading SB1242 Min et al",36,0,0,4,40
1848543,1456282,2024-06-11,Assembly,"Do pass and be re-referred to the Committee on [Appropriations]",8,0,0,0,8
1848543,1458522,2024-06-19,Assembly,"Do pass as amended",9,4,0,2,15
1848543,1463821,2024-08-08,Assembly,"SB 1242 Min Senate Third Reading By Zbur",68,3,0,8,79
1848543,1463907,2024-08-12,Senate,"Unfinished Business SB1242 Min et al. Concurrence",37,0,0,3,40
1848544,1436950,2024-04-30,Senate,"Do pass",4,1,0,2,7
1848544,1445254,2024-05-20,Senate,"Senate 3rd Reading SB1243 Dodd",30,2,0,8,40
1848544,1460466,2024-06-26,Assembly,"Do pass as amended",6,1,0,1,8
1848544,1467104,2024-08-31,Senate,"Unfinished Business SB1243 Dodd et al. Concurrence",40,0,0,0,40
1848544,1467105,2024-08-31,Assembly,"SB 1243 Dodd Senate Third Reading By McKinnor",71,0,0,8,79
1848545,1420077,2024-04-03,Senate,"Do pass, but first be re-referred to the Committee on [Appropriations]",6,0,0,1,7
1848545,1427363,2024-04-15,Senate,"Placed on suspense file",6,0,0,1,7
1848545,1444616,2024-05-16,Senate,"Do pass",7,0,0,0,7
1848545,1449638,2024-05-23,Senate,"Special Consent SB1244 Newman",37,0,0,3,40
1848545,1458213,2024-06-18,Assembly,"Do pass and be re-referred to the Committee on [Education]",8,0,0,3,11
1848545,1460671,2024-06-26,Assembly,"Do pass and be re-referred to the Committee on [Appropriations] with recommendation: To Consent Calendar",7,0,0,0,7
1848545,1464247,2024-08-15,Assembly,"Do pass",14,0,0,1,15
1848545,1466471,2024-08-30,Senate,"Special Consent SB1244 Newman",40,0,0,0,40
1848545,1466999,2024-08-28,Assembly,"SB 1244 Newman Senate Third Reading By McCarty",76,0,0,3,79
1848546,1419216,2024-04-01,Senate,"Do pass, but first be re-referred to the Committee on [Appropriations]",5,0,0,0,5
1848546,1427245,2024-04-15,Senate,"Placed on suspense file",6,0,0,1,7
1848547,1423759,2024-04-09,Senate,"Do pass, but first be re-referred to the Committee on [Appropriations] with the recommendation: To Consent Calendar",14,0,0,2,16
1848547,1431946,2024-04-22,Senate,"Placed on suspense file",7,0,0,0,7
1848547,1444377,2024-05-16,Senate,"Do pass",7,0,0,0,7
1848547,1449626,2024-05-23,Senate,"Special Consent SB1246 Lim√≥n",37,0,0,3,40
1848547,1458808,2024-06-19,Assembly,"Do pass and be re-referred to the Committee on [Appropriations] with recommendation: To Consent Calendar",19,0,0,3,22
1848547,1464559,2024-08-15,Assembly,"Do pass",14,0,0,1,15
1848547,1466448,2024-08-30,Senate,"Special Consent SB1246 Lim√≥n et al",40,0,0,0,40
1848547,1467164,2024-08-28,Assembly,"SB 1246 Lim√≥n Senate Third Reading By Reyes",76,0,0,3,79
1848549,1420050,2024-04-03,Senate,"Do pass as amended, but first amend, and re-refer to the Committee on [Appropriations]",6,0,0,1,7
1848549,1427338,2024-04-15,Senate,"Placed on suspense file",6,0,0,1,7
1848549,1444474,2024-05-16,Senate,"Do pass",7,0,0,0,7
1848549,1449539,2024-05-23,Senate,"Special Consent SB1248 Hurtado et al",37,0,0,3,40
1848549,1460746,2024-06-26,Assembly,"Do pass as amended, and be re-referred to the Committee on [Appropriations] with recommendation: To Consent Calendar",7,0,0,0,7
1848549,1464296,2024-08-15,Assembly,"Do pass",14,0,0,1,15
1848549,1465638,2024-08-26,Assembly,"SB 1248 Hurtado Senate Third Reading By Weber",77,0,0,2,79
1848549,1466959,2024-08-28,Senate,"Special Consent SB1248 Hurtado et al",39,0,0,1,40
1848550,1419143,2024-04-01,Senate,"Do pass, but first be re-referred to the Committee on [Governmental Organization]",5,0,0,0,5
1848550,1450359,2024-05-21,Senate,"Senate 3rd Reading SB1249 Roth",32,0,0,8,40
1848550,1458186,2024-06-18,Assembly,"Do pass and be re-referred to the Committee on [Appropriations]",6,0,0,1,7
1848550,1462206,2024-07-02,Assembly,"Do pass",15,0,0,0,15
1848550,1465647,2024-08-26,Assembly,"SB 1249 Roth Senate Third Reading By Bains",76,0,0,3,79
1848550,1466153,2024-08-29,Senate,"Unfinished Business SB1249 Roth et al. Concurrence",38,0,0,2,40
1848552,1420089,2024-04-03,Senate,"Do pass, but first be re-referred to the Committee on [Energy, Utilities and Communications]",5,1,0,1,7
1848552,1433115,2024-04-22,Senate,"Do pass as amended, but first amend, and re-refer to the Committee on [Appropriations]",15,0,0,3,18
1848552,1450266,2024-05-21,Senate,"Senate 3rd Reading SB1251 Stern",39,0,0,1,40
1848552,1456956,2024-06-12,Assembly,"Do pass and be re-referred to the Committee on [Utilities and Energy]",9,0,0,0,9
1848552,1461993,2024-07-01,Assembly,"Do pass as amended",15,0,0,1,16
1848552,1465262,2024-08-19,Assembly,"SB 1251 Stern Senate Third Reading By Schiavo",69,0,0,10,79
1848552,1465917,2024-08-27,Senate,"Unfinished Business SB1251 Stern Concurrence",40,0,0,0,40
1848553,1424985,2024-04-10,Senate,"Do pass, but first be re-referred to the Committee on [Education] with the recommendation: To Consent Calendar",11,0,0,0,11
1848553,1434209,2024-04-24,Senate,"Do pass, but first be re-referred to the Committee on [Appropriations] with the recommendation: To Consent Calendar",7,0,0,0,7
1848553,1441965,2024-05-09,Senate,"Consent Calendar 2nd SB1252 Stern",37,0,0,3,40
1848553,1460446,2024-06-25,Assembly,"Do pass and be re-referred to the Committee on [Higher Education] with recommendation: To Consent Calendar",7,0,0,0,7
1848553,1462316,2024-07-02,Assembly,"Do pass and be re-referred to the Committee on [Appropriations]",11,0,0,0,11
1848554,1419162,2024-04-02,Senate,"Do pass as amended, but first amend, and re-refer to the Committee on [Appropriations]",4,1,0,0,5
1848554,1439619,2024-05-06,Senate,"Placed on suspense file",7,0,0,0,7
1848554,1444014,2024-05-16,Senate,"Do pass as amended",5,2,0,0,7
1848554,1450382,2024-05-21,Senate,"Senate 3rd Reading SB1253 Gonzalez",26,9,0,5,40
1848554,1456288,2024-06-11,Assembly,"Do pass as amended and be re-referred to the Committee on [Appropriations]",6,1,0,1,8
1848555,1419140,2024-04-01,Senate,"Do pass as amended, but first amend, and re-refer to the Committee on [Public Safety]",4,0,0,1,5
1848555,1432967,2024-04-23,Senate,"Do pass, but first be re-referred to the Committee on [Appropriations]",4,1,0,0,5
1848555,1439633,2024-05-06,Senate,"Placed on suspense file",7,0,0,0,7
1848555,1444459,2024-05-16,Senate,"Do pass as amended",5,2,0,0,7
1848555,1450312,2024-05-21,Senate,"Senate 3rd Reading SB1254 Becker et al",33,5,0,2,40
1848555,1456348,2024-06-11,Assembly,"Do pass and be re-referred to the Committee on [Public Safety]",6,0,0,1,7
1848555,1462689,2024-07-02,Assembly,"Do pass and be re-referred to the Committee on [Appropriations]",8,0,0,0,8
1848555,1464210,2024-08-15,Assembly,"Do pass as amended",11,1,0,3,15
1848555,1466270,2024-08-29,Senate,"Unfinished Business SB1254 Becker et al. Concurrence",30,9,0,1,40
1848555,1466738,2024-08-28,Assembly,"SB 1254 Becker Senate Third Reading By Lee",72,0,0,7,79
1848556,1429920,2024-04-17,Senate,"Do pass, but first be re-referred to the Committee on [Appropriations]",5,1,0,1,7
1848556,1436248,2024-04-29,Senate,"Placed on suspense file",5,0,0,2,7
1848556,1444612,2024-05-16,Senate,"Do pass",5,2,0,0,7
1848556,1450302,2024-05-21,Senate,"Senate 3rd Reading SB1255 Durazo et al",33,6,0,1,40
1848556,1460750,2024-06-25,Assembly,"Do pass and be re-referred to the Committee on [Utilities and Energy]",6,1,0,0,7
1848556,1461964,2024-07-01,Assembly,"Do pass and be re-referred to the Committee on [Appropriations]",11,0,0,5,16
1848557,1428823,2024-04-16,Senate,"Do pass, but first be re-referred to the Committee on [Appropriations]",5,0,0,0,5
1848557,1442573,2024-05-13,Senate,"Placed on suspense file",7,0,0,0,7
1848557,1444090,2024-05-16,Senate,"Do pass as amended",7,0,0,0,7
1848557,1448722,2024-05-22,Senate,"Senate 3rd Reading SB1256 Glazer",38,0,0,2,40
1848557,1462535,2024-07-02,Assembly,"Do pass and be re-referred to the Committee on [Appropriations]",7,0,0,1,8
1848558,1424977,2024-04-10,Senate,"Do pass as amended, but first amend, and re-refer to the Committee on [Appropriations] with the recommendation: To Consent Calendar",11,0,0,0,11
1848558,1435189,2024-04-25,Senate,"Consent Calendar 2nd SB1257 Blakespear",36,0,0,4,40
1848558,1453458,2024-06-04,Assembly,"Do pass and be re-referred to the Committee on [Appropriations] with recommendation: To Consent Calendar",15,0,0,1,16
1848558,1458413,2024-06-19,Assembly,"Do pass. To Consent Calendar",14,0,0,1,15
1848558,1460553,2024-06-26,Assembly,"SB 1257 Blakespear Consent Calendar Second Day Regular Session",75,0,0,4,79
1848559,1420099,2024-04-03,Senate,"Do pass as amended, but first amend, and re-refer to the Committee on [Appropriations] with the recommendation: To Consent Calendar",10,0,0,1,11
1848559,1427334,2024-04-15,Senate,"Placed on suspense file",6,0,0,1,7
1848559,1444585,2024-05-16,Senate,"Do pass",7,0,0,0,7
1848559,1449701,2024-05-23,Senate,"Special Consent SB1258 Dahle et al",37,0,0,3,40
1848559,1459994,2024-06-25,Assembly,"Do pass and be re-referred to the Committee on [Appropriations] with recommendation: To Consent Calendar",16,0,0,0,16
1848560,1420062,2024-04-03,Senate,"Do pass, but first be re-referred to the Committee on [Judiciary]",2,0,0,5,7
1848561,1434179,2024-04-23,Senate,"Do pass, but first be re-referred to the Committee on [Appropriations]",5,8,0,2,15
1848562,1424799,2024-04-10,Senate,"Do pass, but first be re-referred to the Committee on [Appropriations]",7,0,0,0,7
1848562,1431909,2024-04-22,Senate,"Placed on suspense file",7,0,0,0,7
1848562,1444275,2024-05-16,Senate,"Do pass as amended",7,0,0,0,7
1848562,1450379,2024-05-21,Senate,"Senate 3rd Reading SB1261 Alvarado-Gil et al",37,0,0,3,40
1848562,1462337,2024-07-01,Assembly,"Do pass and be re-referred to the Committee on [Appropriations]",6,0,0,1,7
1848563,1423912,2024-04-09,Senate,"Do pass, but first be re-referred to the Committee on [Appropriations]",1,1,0,3,5
1848563,1423913,2024-04-09,Senate,"[Second] hearing set for [04-09-2024]: Failed passage in Committee. Reconsideration granted",5,0,0,0,5
1848563,1433146,2024-04-23,Senate,"Do pass as amended, but first amend, and re-refer to the Committee on [Appropriations]",5,0,0,0,5
1848563,1439608,2024-05-06,Senate,"Placed on suspense file",7,0,0,0,7
1848563,1444134,2024-05-16,Senate,"Do pass as amended",7,0,0,0,7
1848563,1450311,2024-05-21,Senate,"Senate 3rd Reading SB1262 Archuleta",39,0,0,1,40
1848563,1462503,2024-07-02,Assembly,"Do pass and be re-referred to the Committee on [Appropriations]",7,0,0,1,8
1848564,1430027,2024-04-17,Senate,"Do pass, but first be re-referred to the Committee on [Appropriations]",7,0,0,0,7
1848564,1436225,2024-04-29,Senate,"Placed on suspense file",5,0,0,2,7
1848564,1444656,2024-05-16,Senate,"Do pass as amended",4,1,0,2,7
1848564,1450330,2024-05-21,Senate,"Senate 3rd Reading SB1263 Newman",30,8,0,2,40
1848564,1460583,2024-06-26,Assembly,"Do pass and be re-referred to the Committee on [Appropriations]",7,0,0,0,7
1848564,1464167,2024-08-15,Assembly,"Do pass as amended",11,0,0,4,15
1848564,1466245,2024-08-29,Senate,"Unfinished Business SB1263 Newman Concurrence",40,0,0,0,40
1848564,1466780,2024-08-28,Assembly,"SB 1263 Newman Senate Third Reading By McCarty",76,0,0,3,79
1848565,1428983,2024-04-16,Senate,"Do pass as amended, but first amend, and re-refer to the Committee on [Labor, Public Employment and Retirement ]",10,0,0,1,11
1848565,1434188,2024-04-24,Senate,"Do pass as amended, but first amend, and re-refer to the Committee on [Appropriations]",3,1,0,1,5
1848565,1442617,2024-05-13,Senate,"Placed on suspense file",7,0,0,0,7
1848565,1444641,2024-05-16,Senate,"Do pass",7,0,0,0,7
1848565,1448537,2024-05-22,Senate,"Senate 3rd Reading SB1264 Grove",31,3,0,6,40
1848565,1458457,2024-06-19,Assembly,"Do pass and be re-referred to the Committee on [Judiciary]",3,2,0,2,7
1848565,1458458,2024-06-19,Assembly,Reconsideration,7,0,0,0,7
1848567,1420179,2024-04-03,Senate,"Do pass as amended, but first amend, and re-refer to the Committee on [Health]",7,0,0,0,7
1848567,1431955,2024-04-22,Senate,"Do pass as amended, but first amend, and re-refer to the Committee on [Appropriations]",11,0,0,0,11
1848567,1445291,2024-05-20,Senate,"Senate 3rd Reading SB1266 Lim√≥n",39,0,0,1,40
1848567,1458350,2024-06-18,Assembly,"Do pass and be re-referred to the Committee on [Environmental Safety and Toxic Materials]",16,0,0,0,16
1848567,1460423,2024-06-25,Assembly,"Do pass and be re-referred to the Committee on [Appropriations]",7,0,0,0,7
1848567,1464470,2024-08-15,Assembly,"Do pass",14,0,0,1,15
1848567,1466212,2024-08-29,Senate,"That the Assembly amendments be concurred in",9,0,0,2,11
1848567,1466423,2024-08-30,Senate,"Unfinished Business SB1266 Lim√≥n Concurrence",40,0,0,0,40
1848567,1466944,2024-08-28,Assembly,"SB 1266 Lim√≥n Senate Third Reading By Boerner",77,0,0,2,79
1848568,1432955,2024-04-23,Senate,"Do pass, but first be re-referred to the Committee on [Appropriations]",5,0,0,0,5
1848568,1439707,2024-05-06,Senate,"Placed on suspense file",7,0,0,0,7
1848571,1428795,2024-04-16,Senate,"Do pass, but first be re-referred to the Committee on [Judiciary] with the recommendation: To Consent Calendar",3,0,0,2,5
1848571,1434125,2024-04-23,Senate,"Do pass, but first be re-referred to the Committee on [Appropriations] with the recommendation: To Consent Calendar",11,0,0,0,11
1848571,1439665,2024-05-06,Senate,"Do pass",6,0,0,1,7
1848571,1444254,2024-05-16,Senate,"Senate 3rd Reading SB1270 Grove",38,0,0,2,40
1848571,1460689,2024-06-26,Assembly,"Do pass and be re-referred to the Committee on [Appropriations]",7,0,0,3,10
1848571,1464320,2024-08-15,Assembly,"Do pass",13,0,0,2,15
1848571,1465596,2024-08-26,Assembly,"SB 1270 Grove Senate Third Reading By Alanis",76,0,0,3,79
1848571,1467183,2024-08-28,Senate,"Special Consent SB1270 Grove",39,0,0,1,40
1848572,1424958,2024-04-09,Senate,"Do pass as amended, but first amend, and re-refer to the Committee on [Rules]",13,0,0,2,15
1848572,1433162,2024-04-23,Senate,"Do pass as amended, but first amend, and re-refer to the Committee on [Appropriations]",16,0,0,0,16
1848572,1450292,2024-05-21,Senate,"Senate 3rd Reading SB1271 Min",39,0,0,1,40
1848572,1458262,2024-06-17,Assembly,"Do pass and be re-referred to the Committee on [Emergency Management]",12,0,0,3,15
1848572,1459942,2024-06-24,Assembly,"Do pass as amended and be re-referred to the Committee on [Appropriations]",8,0,0,0,8
1848572,1463747,2024-08-07,Assembly,"Do pass. To Consent Calendar",14,0,0,1,15
1848572,1465652,2024-08-26,Assembly,"SB 1271 Min Senate Third Reading By Friedman",77,0,0,2,79
1848572,1466229,2024-08-29,Senate,"Unfinished Business SB1271 Min et al. Concurrence",40,0,0,0,40
1848573,1423772,2024-04-09,Senate,"Do pass",9,2,0,0,11
1848573,1450373,2024-05-21,Senate,"Senate 3rd Reading SB1272 Laird",30,6,0,4,40
1848573,1458179,2024-06-18,Assembly,"Do pass as amended",7,3,0,1,11
1848578,1424892,2024-04-10,Senate,"Do pass as amended, but first amend, and re-refer to the Committee on [Appropriations] with the recommendation: To Consent Calendar",7,0,0,0,7
1848578,1436214,2024-04-29,Senate,"Placed on suspense file",5,0,0,2,7
1848578,1444246,2024-05-16,Senate,"Do pass as amended",7,0,0,0,7
1848578,1448760,2024-05-22,Senate,"Senate 3rd Reading SB1277 Stern et al",38,0,0,2,40
1848578,1460767,2024-06-26,Assembly,"Do pass as amended and be re-referred to the Committee on [Appropriations]",7,0,0,0,7
1848578,1464609,2024-08-15,Assembly,"Do pass as amended",11,0,0,4,15
1848578,1466365,2024-08-29,Assembly,"SB 1277 Stern Senate Third Reading By Ramos",76,0,0,3,79
1848578,1466486,2024-08-30,Senate,"Unfinished Business SB1277 Stern et al. Concurrence",40,0,0,0,40
1848579,1433189,2024-04-23,Senate,"Do pass",16,0,0,0,16
1848579,1442587,2024-05-13,Senate,"Senate 3rd Reading SB1278 Laird",36,0,0,4,40
1848579,1454185,2024-06-05,Assembly,"Do pass. To Consent Calendar",19,0,0,3,22
1848579,1457304,2024-06-13,Assembly,"SB 1278 Laird Consent Calendar Second Day Regular Session",77,0,0,2,79
1848581,1420117,2024-04-03,Senate,"Do pass, but first be re-referred to the Committee on [Judiciary]",4,2,0,1,7
1848581,1450329,2024-05-21,Senate,"Senate 3rd Reading SB1280 Laird",32,7,0,1,40
1848581,1457995,2024-06-17,Assembly,"Do pass and be re-referred to the Committee on [Appropriations]",7,1,0,3,11
1848581,1464117,2024-08-15,Assembly,"Do pass as amended",11,3,0,1,15
1848581,1466203,2024-08-29,Senate,"Unfinished Business SB1280 Laird Concurrence",31,9,0,0,40
1848581,1466760,2024-08-28,Assembly,"SB 1280 Laird Senate Third Reading By Addis",49,16,0,14,79
1848582,1419194,2024-04-01,Senate,"Do pass as amended, but first amend, and re-refer to the Committee on [Appropriations]",5,0,0,0,5
1848582,1427268,2024-04-15,Senate,"Placed on suspense file",6,0,0,1,7
1848582,1444413,2024-05-16,Senate,"Do pass as amended",7,0,0,0,7
1848582,1450017,2024-05-24,Senate,"Special Consent SB1281 Menjivar et al",38,0,0,2,40
1848582,1456461,2024-06-11,Assembly,"Do pass and be re-referred to the Committee on [Appropriations]",6,0,0,1,7
1848582,1464065,2024-08-15,Assembly,"Do pass as amended",11,0,0,4,15
1848582,1466527,2024-08-30,Assembly,"SB 1281 Menjivar Senate Third Reading By Addis",76,0,0,3,79
1848582,1467045,2024-08-31,Senate,"Unfinished Business SB1281 Menjivar et al. Concurrence",40,0,0,0,40
1848583,1433203,2024-04-23,Senate,"Do pass as amended, but first amend, and re-refer to the Committee on [Appropriations]",4,1,0,0,5
1848583,1442626,2024-05-13,Senate,"Placed on suspense file",7,0,0,0,7
1848583,1444055,2024-05-16,Senate,"Do pass as amended",5,2,0,0,7
1848583,1449650,2024-05-23,Senate,"Senate 3rd Reading SB1282 Smallwood-Cuevas",17,16,0,7,40
1848583,1449651,2024-05-23,Senate,"Senate 3rd Reading SB1282 Smallwood-Cuevas Reconsider",35,0,0,5,40
1848584,1424867,2024-04-10,Senate,"Do pass as amended",6,0,0,1,7
1848584,1449602,2024-05-23,Senate,"Senate 3rd Reading SB1283 Stern",35,0,0,5,40
1848584,1460477,2024-06-26,Assembly,"Do pass and be re-referred to the Committee on [Privacy and Consumer Protection]",6,0,0,1,7
1848584,1462531,2024-07-02,Assembly,"Do pass as amended",7,0,0,4,11
1848584,1466457,2024-08-30,Assembly,"SB 1283 Stern Senate Third Reading By Bauer-Kahan",72,0,0,7,79
1848584,1466989,2024-08-31,Senate,"Unfinished Business SB1283 Stern et al. Concurrence",40,0,0,0,40
1848586,1434070,2024-04-23,Senate,"Do pass as amended, but first amend, and re-refer to the Committee on [Appropriations] with the recommendation: To Consent Calendar",15,0,0,0,15
1848586,1442662,2024-05-13,Senate,"Placed on suspense file",7,0,0,0,7
1848587,1430022,2024-04-17,Senate,"Do pass, but first be re-referred to the Committee on [Judiciary]",4,2,0,1,7
1848587,1434129,2024-04-23,Senate,"Do pass as amended, but first amend, and re-refer to the Committee on [Appropriations]",9,2,0,0,11
1848587,1450296,2024-05-21,Senate,"Senate 3rd Reading SB1286 Min",28,9,0,3,40
1848587,1462069,2024-07-01,Assembly,"Do pass and be re-referred to the Committee on [Judiciary]",6,2,0,1,9
1848587,1462332,2024-07-02,Assembly,"Do pass as amended and be re-referred to the Committee on [Appropriations]",9,2,0,1,12
1848587,1464222,2024-08-15,Assembly,"Do pass",11,3,0,1,15
1848587,1466297,2024-08-29,Assembly,"SB 1286 Min Senate Third Reading By Kalra",49,17,0,13,79
1848587,1467046,2024-08-31,Senate,"Unfinished Business SB1286 Min Concurrence",30,9,0,1,40
1848588,1424957,2024-04-10,Senate,"Do pass, but first be re-referred to the Committee on [Judiciary]",7,0,0,0,7
1848588,1434128,2024-04-23,Senate,"Do pass as amended, but first amend, and re-refer to the Committee on [Appropriations]",10,0,0,1,11
1848588,1442572,2024-05-13,Senate,"Placed on suspense file",7,0,0,0,7
1848588,1444013,2024-05-16,Senate,"Do pass as amended",5,0,0,2,7
1848588,1448751,2024-05-22,Senate,"Senate 3rd Reading SB1287 Glazer et al",30,1,0,9,40
1848588,1458291,2024-06-18,Assembly,"Do pass as amended and be re-referred to the Committee on [Judiciary]",7,1,0,3,11
1848588,1462342,2024-07-02,Assembly,"Do pass as amended and be re-referred to the Committee on [Appropriations]",11,0,0,1,12
1848588,1464419,2024-08-15,Assembly,"Do pass as amended",11,0,0,4,15
1848588,1465951,2024-08-27,Assembly,"SB 1287 Glazer Senate Third Reading By Gabriel",70,0,0,9,79
1848588,1466915,2024-08-28,Senate,"Unfinished Business SB1287 Glazer et al. Concurrence",35,3,0,2,40
1848589,1434251,2024-04-24,Senate,"Do pass, but first be re-referred to the Committee on [Appropriations] with the recommendation: To Consent Calendar",7,0,0,0,7
1848589,1439687,2024-05-06,Senate,"Placed on suspense file",7,0,0,0,7
1848589,1444304,2024-05-16,Senate,"Do pass as amended",7,0,0,0,7
1848589,1450008,2024-05-24,Senate,"Special Consent SB1288 Becker et al",38,0,0,2,40
1848589,1460668,2024-06-26,Assembly,"Do pass and be re-referred to the Committee on [Privacy and Consumer Protection] with recommendation: To Consent Calendar",7,0,0,0,7
1848589,1462568,2024-07-02,Assembly,"Do pass as amended, and be re-referred to the Committee on [Appropriations] with recommendation: To Consent Calendar",11,0,0,0,11
1848589,1464579,2024-08-15,Assembly,"Do pass",14,0,0,1,15
1848589,1465593,2024-08-26,Assembly,"SB 1288 Becker Senate Third Reading By Muratsuchi",77,0,0,2,79
1848589,1467088,2024-08-28,Senate,"Special Consent SB1288 Becker et al",39,0,0,1,40
1848590,1435335,2024-04-24,Senate,"Do pass as amended, but first amend, and re-refer to the Committee on [Appropriations]",11,0,0,0,11
1848590,1439666,2024-05-06,Senate,"Placed on suspense file",7,0,0,0,7
1848590,1443921,2024-05-16,Senate,"Do pass",7,0,0,0,7
1848590,1450350,2024-05-21,Senate,"Senate 3rd Reading SB1289 Roth",39,0,0,1,40
1848590,1453443,2024-06-04,Assembly,"Do pass as amended and be re-referred to the Committee on [Appropriations]",15,0,0,1,16
1848590,1464606,2024-08-15,Assembly,"Do pass as amended",11,0,0,4,15
1848590,1465970,2024-08-27,Assembly,"SB 1289 Roth Senate Third Reading By Bonta",76,0,0,3,79
1848590,1467062,2024-08-28,Senate,"Unfinished Business SB1289 Roth Concurrence",39,0,0,1,40
1848591,1424974,2024-04-10,Senate,"Do pass, but first be re-referred to the Committee on [Appropriations]",11,0,0,0,11
1848591,1445269,2024-05-20,Senate,"Senate 3rd Reading SB1290 Roth",39,0,0,1,40
1848591,1459986,2024-06-25,Assembly,"Do pass and be re-referred to the Committee on [Appropriations] with recommendation: To Consent Calendar",16,0,0,0,16
1848591,1463756,2024-08-07,Assembly,"Do pass. To Consent Calendar",14,0,0,1,15
1848592,1431852,2024-04-22,Senate,"Do pass, but first be re-referred to the Committee on [Local Government] with the recommendation: To Consent Calendar",5,0,0,0,5
1848593,1433055,2024-04-22,Senate,"Do pass as amended, but first amend, and re-refer to the Committee on [Appropriations]",17,0,0,1,18
1848593,1442584,2024-05-13,Senate,"Placed on suspense file",7,0,0,0,7
1848593,1444239,2024-05-16,Senate,"Do pass",7,0,0,0,7
1848593,1448689,2024-05-22,Senate,"Senate 3rd Reading SB1292 Bradford",37,0,0,3,40
1848593,1462047,2024-07-01,Assembly,"Do pass as amended, and be re-referred to the Committee on [Appropriations] with recommendation: To Consent Calendar",15,0,0,1,16
1848593,1464631,2024-08-15,Assembly,"Do pass",14,0,0,1,15
1848593,1466151,2024-08-29,Senate,"Unfinished Business SB1292 Bradford Concurrence",40,0,0,0,40
1848593,1466669,2024-08-28,Assembly,"SB 1292 Bradford Senate Third Reading By Petrie-Norris",75,0,0,4,79
1848594,1419174,2024-04-02,Senate,"Do pass as amended, but first amend, and re-refer to the Committee on [Judiciary]",7,0,0,0,7
1848594,1437590,2024-04-30,Senate,"Do pass as amended, and be ordered to the Consent Calendar",11,0,0,0,11
1848594,1442607,2024-05-13,Senate,"Placed on suspense file",7,0,0,0,7
1848595,1433117,2024-04-22,Senate,"Do pass, but first be re-referred to the Committee on [Appropriations]",1,1,0,5,7
1848596,1434252,2024-04-24,Senate,"Do pass",6,0,0,1,7
1848596,1445185,2024-05-20,Senate,"Senate 3rd Reading SB1295 Rubio et al",39,0,0,1,40
1848596,1460511,2024-06-26,Assembly,"Do pass. To Consent Calendar",15,0,0,0,15
1848596,1466360,2024-08-29,Assembly,"SB 1295 Rubio Senate Third Reading By Gipson",76,0,0,3,79
1848598,1424901,2024-04-09,Senate,"Do pass as amended, but first amend, and re-refer to the Committee on [Appropriations]",14,1,0,0,15
1848598,1431974,2024-04-22,Senate,"Placed on suspense file",7,0,0,0,7
1848598,1444315,2024-05-16,Senate,"Do pass",6,1,0,0,7
1848598,1445204,2024-05-20,Senate,"Senate 3rd Reading SB1297 Allen et al",36,3,0,1,40
1848598,1458316,2024-06-17,Assembly,"Do pass and be re-referred to the Committee on [Privacy and Consumer Protection]",13,1,0,1,15
1848598,1462502,2024-07-02,Assembly,"Do pass and be re-referred to the Committee on [Appropriations]",8,1,0,2,11
1848598,1464304,2024-08-15,Assembly,"Do pass",11,0,0,4,15
1848598,1466362,2024-08-29,Assembly,"SB 1297 Allen Senate Third Reading By Irwin",54,6,0,19,79
1848598,1466511,2024-08-30,Senate,"Unfinished Business SB1297 Allen et al. Concurrence",36,4,0,0,40
1848599,1428936,2024-04-16,Senate,"Do pass as amended, but first amend, and re-refer to the Committee on [Appropriations]",14,0,0,4,18
1848599,1439679,2024-05-06,Senate,"Placed on suspense file",7,0,0,0,7
1848599,1444455,2024-05-16,Senate,"Do pass as amended",7,0,0,0,7
1848599,1444456,2024-05-16,Senate,"[05-16-2024] set for [First] hearing: Reconsideration of favorable vote granted",7,0,0,0,7
1848599,1444457,2024-05-16,Senate,"Do pass as amended",6,0,0,1,7
1848599,1448755,2024-05-22,Senate,"Senate 3rd Reading SB1298 Cortese",33,0,0,7,40
1848599,1458418,2024-06-19,Assembly,"Do pass as amended and be re-referred to the Committee on [Labor and Employment]",14,0,0,2,16
1848599,1462070,2024-07-01,Assembly,"Do pass and be re-referred to the Committee on [Labor and Employment]",12,0,0,0,12
1848599,1462281,2024-07-02,Assembly,"Do pass as amended and be re-referred to the Committee on [Appropriations]",7,0,0,0,7
1848599,1464182,2024-08-15,Assembly,"Do pass as amended",11,0,0,4,15
1848600,1424900,2024-04-10,Senate,"Do pass, but first be re-referred to the Committee on [Judiciary]",4,1,0,0,5
1848600,1434249,2024-04-23,Senate,"Do pass, but first be re-referred to the Committee on [Appropriations]",9,2,0,0,11
1848600,1439712,2024-05-06,Senate,"Placed on suspense file",7,0,0,0,7
1848600,1444508,2024-05-16,Senate,"Do pass",5,2,0,0,7
1848600,1448686,2024-05-22,Senate,"Senate 3rd Reading SB1299 Cortese",29,9,0,2,40
1848600,1460728,2024-06-26,Assembly,"Do pass and be re-referred to the Committee on [Appropriations]",12,3,0,0,15
1848600,1464332,2024-08-15,Assembly,"Do pass",11,3,0,1,15
1848600,1466976,2024-08-28,Assembly,"SB 1299 Cortese Senate Third Reading By Calderon",60,16,0,3,79
1848601,1420135,2024-04-03,Senate,"Do pass as amended, but first amend, and re-refer to the Committee on [Appropriations]",8,2,0,1,11
1848601,1450327,2024-05-21,Senate,"Senate 3rd Reading SB1300 Cortese",27,9,0,4,40
1848601,1458307,2024-06-18,Assembly,"Do pass as amended and be re-referred to the Committee on [Appropriations]",11,3,0,2,16
1848601,1462353,2024-07-02,Assembly,"Do pass",11,4,0,0,15
1848601,1465670,2024-08-26,Assembly,"SB 1300 Cortese Senate Third Reading By Jackson",70,3,0,6,79
1848601,1465818,2024-08-27,Senate,"Unfinished Business SB1300 Cortese et al. Concurrence",28,9,0,3,40
1848602,1428840,2024-04-16,Senate,"Do pass as amended, but first amend, and re-refer to the Committee on [Appropriations]",18,0,0,0,18
1848602,1445265,2024-05-20,Senate,"Senate 3rd Reading SB1301 Stern",39,0,0,1,40
1848602,1462102,2024-07-01,Assembly,"Do pass and be re-referred to the Committee on [Appropriations] with recommendation: To Consent Calendar",15,0,0,1,16
1848602,1463718,2024-08-07,Assembly,"Do pass. To Consent Calendar",14,0,0,1,15
1848603,1434214,2024-04-24,Senate,"Do pass as amended, but first amend, and re-refer to the Committee on [Appropriations]",7,0,0,0,7
1848603,1442528,2024-05-13,Senate,"Placed on suspense file",7,0,0,0,7
1848604,1429913,2024-04-17,Senate,"Do pass, but first be re-referred to the Committee on [Judiciary]",4,1,0,0,5
1848604,1434059,2024-04-23,Senate,"Do pass as amended, but first amend, and re-refer to the Committee on [Appropriations]",9,1,0,1,11
1848604,1442555,2024-05-13,Senate,"Placed on suspense file",7,0,0,0,7
1848604,1444121,2024-05-16,Senate,"Do pass",5,2,0,0,7
1848604,1450322,2024-05-21,Senate,"Senate 3rd Reading SB1303 Caballero",31,8,0,1,40
1848604,1458485,2024-06-19,Assembly,"Do pass and be re-referred to the Committee on [Judiciary]",7,0,0,0,7
1848604,1459953,2024-06-25,Assembly,"Do pass as amended and be re-referred to the Committee on [Appropriations]",10,0,0,2,12
1848604,1464458,2024-08-15,Assembly,"Do pass as amended",11,0,0,4,15
1848604,1466626,2024-08-31,Senate,"Unfinished Business SB1303 Caballero Concurrence",33,7,0,0,40
1848604,1466627,2024-08-31,Assembly,"SB 1303 Caballero Senate Third Reading By Haney",75,0,0,4,79
1848605,1423861,2024-04-09,Senate,"Do pass as amended, but first amend, and re-refer to the Committee on [Environmental Quality]",7,3,0,1,11
1848605,1434257,2024-04-24,Senate,"Do pass, but first be re-referred to the Committee on [Appropriations]",4,3,0,0,7
1848605,1442518,2024-05-13,Senate,"Placed on suspense file",7,0,0,0,7
1848605,1444000,2024-05-16,Senate,"Do pass",5,2,0,0,7
1848605,1450275,2024-05-21,Senate,"Senate 3rd Reading SB1304 Lim√≥n",28,10,0,2,40
1848605,1459378,2024-06-24,Assembly,"Do pass as amended and be re-referred to the Committee on [Appropriations]",8,2,0,1,11
1848605,1464211,2024-08-15,Assembly,"Do pass as amended",10,3,0,2,15
1848605,1466109,2024-08-29,Assembly,"SB 1304 Lim√≥n Senate Third Reading By Hart",54,16,0,9,79
1848605,1466546,2024-08-30,Senate,"Unfinished Business SB1304 Lim√≥n Concurrence",29,10,0,1,40
1848607,1427362,2024-04-15,Senate,"Do pass, but first be re-referred to the Committee on [Environmental Quality]",12,0,0,1,13
1848607,1434154,2024-04-24,Senate,"Do pass as amended, but first amend, and re-refer to the Committee on [Appropriations] with the recommendation: To Consent Calendar",7,0,0,0,7
1848607,1442544,2024-05-13,Senate,"Placed on suspense file",7,0,0,0,7
1848608,1428793,2024-04-15,Senate,"Do pass as amended, but first amend, and re-refer to the Committee on [Appropriations]",5,0,0,0,5
1848608,1439631,2024-05-06,Senate,"Placed on suspense file",7,0,0,0,7
1848609,1420185,2024-04-03,Senate,"Do pass, but first be re-referred to the Committee on [Appropriations]",6,0,0,1,7
1848609,1445190,2024-05-20,Senate,"Senate 3rd Reading SB1308 Gonzalez",32,5,0,3,40
1848610,1411356,2024-03-19,Senate,"Do pass, but first be re-referred to the Committee on [Appropriations]",15,1,0,2,18
1848610,1422083,2024-04-08,Senate,"Placed on suspense file",6,0,0,1,7
1848612,1428831,2024-04-16,Senate,"Do pass, but first be re-referred to the Committee on [Appropriations]",17,0,0,1,18
1848612,1436192,2024-04-29,Senate,"Placed on suspense file",5,0,0,2,7
1848614,1410540,2024-03-18,Senate,"Senate 3rd Reading SR67 Dodd et al",40,0,0,0,40
1848615,1462534,2024-07-03,Senate,"Special Consent SR68 Seyarto",39,0,0,1,40
1849253,1420214,2024-04-02,Assembly,"Do pass and be re-referred to the Committee on [Appropriations] with recommendation: To Consent Calendar",8,0,0,0,8
1849254,1431013,2024-04-17,Assembly,"Do pass and be re-referred to the Committee on [Housing and Community Development]",7,0,0,2,9
1849254,1434155,2024-04-24,Assembly,"Do pass and be re-referred to the Committee on [Appropriations]",7,1,0,1,9
1849255,1435272,2024-04-24,Assembly,"Do pass as amended and be re-referred to the Committee on [Appropriations]",8,0,0,1,9
1849255,1445258,2024-05-20,Assembly,"AB 2946 Valencia Assembly Third Reading",71,1,0,8,80
1849255,1460742,2024-06-26,Senate,"Do pass as amended",6,1,0,0,7
1849255,1465781,2024-08-27,Senate,"Assembly 3rd Reading AB2946 Valencia et al. By Umberg",36,0,0,4,40
1849255,1466697,2024-08-28,Assembly,"AB 2946 Valencia Concurrence in Senate Amendments",77,0,0,2,79
1849256,1433015,2024-04-23,Assembly,"Do pass and be re-referred to the Committee on [Appropriations] with recommendation: To Consent Calendar",14,0,0,1,15
1849257,1423793,2024-04-09,Assembly,"Do pass and be re-referred to the Committee on [Judiciary]",6,0,0,1,7
1849257,1428842,2024-04-16,Assembly,"Do pass and be re-referred to the Committee on [Appropriations] with recommendation: To Consent Calendar",12,0,0,0,12
1849257,1437616,2024-05-01,Assembly,"Do pass. To Consent Calendar",14,0,0,1,15
1849257,1441939,2024-05-09,Assembly,"AB 2948 Ramos Consent Calendar Second Day Regular Session",65,0,0,15,80
1849257,1453426,2024-06-03,Senate,"Do pass, but first be re-referred to the Committee on [Judiciary] with the recommendation: To Consent Calendar",4,0,0,1,5
1849257,1458287,2024-06-18,Senate,"Do pass, but first be re-referred to the Committee on [Appropriations] with the recommendation: To Consent Calendar",10,0,0,1,11
1849257,1463580,2024-08-05,Senate,"Consent Calendar 2nd AB2948 Ramos",40,0,0,0,40
1849258,1423891,2024-04-09,Assembly,"Do pass and be re-referred to the Committee on [Education] with recommendation: To Consent Calendar",6,0,0,1,7
1849258,1435193,2024-04-24,Assembly,"Do pass and be re-referred to the Committee on [Appropriations] with recommendation: To Consent Calendar",7,0,0,0,7
1849260,1424903,2024-04-10,Assembly,"Do pass and be re-referred to the Committee on [Appropriations] with recommendation: To Consent Calendar",8,0,0,0,8
1849260,1437643,2024-05-01,Assembly,"Do pass. To Consent Calendar",14,0,0,1,15
1849260,1441929,2024-05-09,Assembly,"AB 2951 Cervantes Consent Calendar Second Day Regular Session",65,0,0,15,80
1849260,1462263,2024-07-02,Senate,"Do pass as amended, but first amend, and re-refer to the Committee on [Appropriations]",6,1,0,0,7
1849260,1465870,2024-08-27,Senate,"Assembly 3rd Reading AB2951 Cervantes et al. By Allen",31,8,0,1,40
1849260,1466127,2024-08-29,Assembly,"With recommendation: That Senate amendments be concurred in",8,0,0,0,8
1849260,1466535,2024-08-30,Assembly,"AB 2951 Cervantes Concurrence in Senate Amendments",73,0,0,6,79
1849262,1429975,2024-04-16,Assembly,"Do pass and be re-referred to the Committee on [Appropriations]",11,0,0,0,11
1849262,1444168,2024-05-16,Assembly,"Do pass",15,0,0,0,15
1849262,1448548,2024-05-22,Assembly,"AB 2953 Alvarez Assembly Third Reading",70,0,0,10,80
1849262,1458431,2024-06-19,Senate,"Do pass as amended, but first amend, and re-refer to the Committee on [Appropriations] with the recommendation: To Consent Calendar",7,0,0,0,7
1849262,1463558,2024-08-05,Senate,"Placed on suspense file",7,0,0,0,7
1849265,1428902,2024-04-16,Assembly,"Do pass as amended and be re-referred to the Committee on [Appropriations]",13,0,0,3,16
1849267,1423928,2024-04-08,Assembly,"Do pass and be re-referred to the Committee on [Appropriations] with recommendation: To Consent Calendar",10,0,0,1,11
1849267,1444296,2024-05-16,Assembly,"Do pass",14,1,0,0,15
1849267,1449596,2024-05-23,Assembly,"AB 2958 Calderon Assembly Third Reading",70,0,0,10,80
1849267,1462560,2024-07-03,Senate,"Do pass, but first be re-referred to the Committee on [Appropriations]",5,0,0,2,7
1849267,1463412,2024-08-05,Senate,"Placed on suspense file",7,0,0,0,7
1849268,1428829,2024-04-16,Assembly,"Do pass and be re-referred to the Committee on [Appropriations]",7,0,0,1,8
1849268,1444033,2024-05-16,Assembly,"Do pass",11,2,0,2,15
1849268,1448567,2024-05-22,Assembly,"AB 2959 Ortega Assembly Third Reading",60,4,0,16,80
1849268,1462302,2024-07-02,Senate,"Do pass, but first be re-referred to the Committee on [Appropriations]",4,1,0,0,5
1849268,1463527,2024-08-05,Senate,"Placed on suspense file",7,0,0,0,7
1849268,1464190,2024-08-15,Senate,"Do pass as amended",5,2,0,0,7
1849269,1428946,2024-04-16,Assembly,"Do pass and be re-referred to the Committee on [Appropriations]",5,4,0,7,16
1849269,1431463,2024-04-16,Assembly,Reconsideration,16,0,0,0,16
1849269,1433191,2024-04-23,Assembly,"Do pass as amended and be re-referred to the Committee on [Appropriations]",9,2,0,5,16
1849270,1424966,2024-04-10,Assembly,"Do pass as amended, and be re-referred to the Committee on [Labor and Employment] with recommendation: To Consent Calendar",7,0,0,0,7
1849270,1430984,2024-04-17,Assembly,"Do pass and be re-referred to the Committee on [Appropriations] with recommendation: To Consent Calendar",7,0,0,0,7
1849270,1441339,2024-05-08,Assembly,"Do pass. To Consent Calendar",15,0,0,0,15
1849270,1444430,2024-05-16,Assembly,"AB 2961 Addis Consent Calendar Second Day Regular Session",71,0,0,9,80
1849270,1454230,2024-06-05,Senate,"Do pass as amended, but first amend, and re-refer to the Committee on [Labor, Public Employment and Retirement ] with the recommendation: To Consent Calendar",7,0,0,0,7
1849270,1456848,2024-06-12,Senate,"Do pass as amended, but first amend, and re-refer to the Committee on [Appropriations] with the recommendation: To Consent Calendar",5,0,0,0,5
1849270,1459356,2024-06-24,Senate,"Placed on suspense file",6,0,0,1,7
1849271,1423755,2024-04-09,Assembly,"Do pass as amended, and be re-referred to the Committee on [Local Government] with recommendation: To Consent Calendar",14,0,0,1,15
1849271,1435243,2024-04-24,Assembly,"Do pass and be re-referred to the Committee on [Appropriations] with recommendation: To Consent Calendar",8,0,0,1,9
1849271,1441328,2024-05-08,Assembly,"Do pass. To Consent Calendar",15,0,0,0,15
1849271,1444176,2024-05-16,Assembly,"AB 2962 Papan Consent Calendar Second Day Regular Session",71,0,0,9,80
1849271,1456396,2024-06-11,Senate,"Do pass, but first be re-referred to the Committee on [Local Government] with the recommendation: To Consent Calendar",11,0,0,0,11
1849271,1460652,2024-06-26,Senate,"Do pass, but first be re-referred to the Committee on [Appropriations] with the recommendation: To Consent Calendar",7,0,0,0,7
1849271,1463855,2024-08-12,Senate,"Consent Calendar 2nd AB2962 Papan",38,0,0,2,40
1849276,1429947,2024-04-17,Assembly,"Do pass and be re-referred to the Committee on [Education]",8,0,0,1,9
1849276,1435241,2024-04-24,Assembly,"Do pass as amended",7,0,0,0,7
1849276,1442565,2024-05-13,Assembly,"AB 2967 Ting Assembly Third Reading",74,0,0,6,80
1849276,1453377,2024-06-04,Senate,"Do pass",8,0,0,2,10
1849276,1465366,2024-08-20,Senate,"Assembly 3rd Reading AB2967 Ting et al. By Becker",37,0,0,3,40
1849277,1424773,2024-04-10,Assembly,"Do pass as amended, and be re-referred to the Committee on [Natural Resources] with recommendation: To Consent Calendar",7,0,0,0,7
1849277,1431968,2024-04-22,Assembly,"Do pass as amended, and be re-referred to the Committee on [Appropriations] with recommendation: To Consent Calendar",11,0,0,0,11
1849277,1444684,2024-05-16,Assembly,"Do pass",15,0,0,0,15
1849277,1448664,2024-05-22,Assembly,"AB 2968 Connolly Assembly Third Reading",71,0,0,9,80
1849277,1458467,2024-06-19,Senate,"Do pass, but first be re-referred to the Committee on [Natural Resources and Water]",7,0,0,0,7
1849277,1460074,2024-06-25,Senate,"Do pass as amended, but first amend, and re-refer to the Committee on [Appropriations] with the recommendation: To Consent Calendar",11,0,0,0,11
1849277,1463649,2024-08-05,Senate,"Placed on suspense file",7,0,0,0,7
1849277,1464058,2024-08-15,Senate,"Do pass as amended",7,0,0,0,7
1849277,1465915,2024-08-27,Senate,"Assembly 3rd Reading AB2968 Connolly By Dodd",40,0,0,0,40
1849277,1467240,2024-08-28,Assembly,"AB 2968 Connolly Concurrence in Senate Amendments",77,0,0,2,79
1849280,1420189,2024-04-03,Assembly,"Do pass and be re-referred to the Committee on [Higher Education]",6,1,0,0,7
1849280,1432984,2024-04-23,Assembly,"Do pass as amended and be re-referred to the Committee on [Appropriations]",7,1,0,3,11
1849280,1441308,2024-05-08,Assembly,"Do pass",11,2,0,2,15
1849280,1445272,2024-05-20,Assembly,"AB 2971 Maienschein Assembly Third Reading",60,8,0,12,80
1849280,1456857,2024-06-12,Senate,"Do pass, but first be re-referred to the Committee on [Appropriations]",4,1,0,0,5
1849280,1459365,2024-06-24,Senate,"Placed on suspense file",6,0,0,1,7
1849280,1464250,2024-08-15,Senate,"Do pass",4,2,0,1,7
1849280,1465645,2024-08-26,Senate,"Assembly 3rd Reading AB2971 Maienschein By Cortese",31,9,0,0,40
1849282,1423766,2024-04-08,Assembly,"Do pass as amended and be re-referred to the Committee on [Health]",6,0,0,2,8
1849283,1420137,2024-04-02,Assembly,"Do pass. To Consent Calendar",8,0,0,0,8
1849283,1427307,2024-04-15,Assembly,"AB 2974 Megan Dahle Assembly Third Reading",75,0,0,5,80
1849283,1450970,2024-05-28,Senate,"Do pass and be ordered to the Consent Calendar",4,0,0,1,5
1849283,1452960,2024-06-03,Senate,"Consent Calendar 2nd AB2974 Megan Dahle",36,0,0,4,40
1849284,1431022,2024-04-17,Assembly,"Do pass and be re-referred to the Committee on [Appropriations]",6,0,0,1,7
1849284,1444031,2024-05-16,Assembly,"Do pass",11,1,0,3,15
1849284,1448702,2024-05-22,Assembly,"AB 2975 Gipson Assembly Third Reading",55,0,0,25,80
1849284,1460634,2024-06-26,Senate,"Do pass as amended, but first amend, and re-refer to the Committee on [Health]",5,0,0,0,5
1849284,1462512,2024-07-03,Senate,"Do pass as amended, but first amend, and re-refer to the Committee on [Appropriations]",9,0,0,2,11
1849284,1463384,2024-08-05,Senate,"Placed on suspense file",7,0,0,0,7
1849284,1464122,2024-08-15,Senate,"Do pass as amended",5,0,0,2,7
1849284,1466136,2024-08-29,Assembly,"AB 2975 Gipson Concurrence in Senate Amendments",72,0,0,7,79
1849284,1466687,2024-08-28,Senate,"Assembly 3rd Reading AB2975 Gipson et al. By Roth",34,0,0,6,40
1849286,1433069,2024-04-22,Assembly,"Do pass as amended and be re-referred to the Committee on [Appropriations]",5,0,0,2,7
1849288,1436906,2024-04-29,Assembly,"Do pass and be re-referred to the Committee on [Appropriations]",7,0,0,0,7
1849288,1443498,2024-05-15,Assembly,"Do pass. To Consent Calendar",15,0,0,0,15
1849288,1446122,2024-05-21,Assembly,"AB 2979 Mike Fong Consent Calendar Second Day Regular Session",71,0,0,9,80
1849288,1456873,2024-06-12,Senate,"Do pass, but first be re-referred to the Committee on [Appropriations] with the recommendation: To Consent Calendar",6,0,0,1,7
1849288,1461231,2024-06-27,Senate,"Consent Calendar 2nd AB2979 Mike Fong et al",40,0,0,0,40
1849289,1436898,2024-04-30,Assembly,"Do pass as amended",11,0,0,0,11
1849289,1445992,2024-05-21,Assembly,"AB 2980 Low Assembly Third Reading",67,0,0,13,80
1849290,1427330,2024-04-15,Assembly,"Do pass and be re-referred to the Committee on [Appropriations]",9,0,0,0,9
1849291,1423800,2024-04-09,Assembly,"Do pass and be re-referred to the Committee on [Appropriations] with recommendation: To Consent Calendar",6,0,0,1,7
1849292,1423873,2024-04-08,Assembly,"Do pass and be re-referred to the Committee on [Insurance] with recommendation: To Consent Calendar",7,0,0,1,8
1849292,1429926,2024-04-17,Assembly,"Do pass and be re-referred to the Committee on [Appropriations] with recommendation: To Consent Calendar",15,0,0,0,15
1849292,1444364,2024-05-16,Assembly,"Do pass as amended",11,0,0,4,15
1849292,1449635,2024-05-23,Assembly,"AB 2983 Rodriguez Assembly Third Reading",71,0,0,9,80
1849292,1456304,2024-06-11,Senate,"Do pass as amended, but first amend, and re-refer to the Committee on [Natural Resources and Water]",15,0,0,1,16
1849292,1460092,2024-06-25,Senate,"Do pass, but first be re-referred to the Committee on [Appropriations] with the recommendation: To Consent Calendar",11,0,0,0,11
1849292,1463554,2024-08-05,Senate,"Placed on suspense file",7,0,0,0,7
1849292,1464136,2024-08-15,Senate,"Do pass",7,0,0,0,7
1849292,1466213,2024-08-29,Assembly,"AB 2983 Rodriguez Concurrence in Senate Amendments",76,0,0,3,79
1849292,1466768,2024-08-28,Senate,"Special Consent AB2983 Rodriguez et al",39,0,0,1,40
1849293,1433119,2024-04-23,Assembly,"Do pass and be re-referred to the Committee on [Appropriations]",7,0,0,1,8
1849293,1444493,2024-05-16,Assembly,"Do pass as amended",10,0,0,5,15
1849293,1449553,2024-05-23,Assembly,"AB 2984 Gipson Assembly Third Reading",72,0,0,8,80
1849293,1460005,2024-06-25,Senate,"Do pass, but first be re-referred to the Committee on [Appropriations] with the recommendation: To Consent Calendar",5,0,0,0,5
1849293,1463567,2024-08-05,Senate,"Placed on suspense file",7,0,0,0,7
1849293,1464636,2024-08-15,Senate,"Do pass",7,0,0,0,7
1849293,1466620,2024-08-28,Senate,"Special Consent AB2984 Gipson By Bradford",39,0,0,1,40
1849294,1420180,2024-04-02,Assembly,"Do pass and be re-referred to the Committee on [Judiciary] with recommendation: To Consent Calendar",8,0,0,0,8
1849294,1423868,2024-04-09,Assembly,"Do pass as amended, and be re-referred to the Committee on [Appropriations] with recommendation: To Consent Calendar",12,0,0,0,12
1849294,1434146,2024-04-24,Assembly,"Do pass. To Consent Calendar",14,0,0,1,15
1849294,1438437,2024-05-02,Assembly,"AB 2985 Hart Consent Calendar Second Day Regular Session",73,0,0,7,80
1849294,1456318,2024-06-11,Senate,"Do pass, but first be re-referred to the Committee on [Appropriations] with the recommendation: To Consent Calendar",5,0,0,0,5
1849294,1463578,2024-08-05,Senate,"Consent Calendar 2nd AB2985 Hart",40,0,0,0,40
1849294,1463771,2024-08-08,Assembly,"AB 2985 Hart Concurrence in Senate Amendments",72,0,0,7,79
1849295,1435299,2024-04-24,Assembly,"Do pass as amended and be re-referred to the Committee on [Appropriations]",8,0,0,1,9
1849295,1444559,2024-05-16,Assembly,"Do pass",14,0,0,1,15
1849295,1446060,2024-05-21,Assembly,"AB 2986 Wendy Carrillo Assembly Third Reading",62,0,0,18,80
1849295,1462489,2024-07-03,Senate,"Do pass as amended, but first amend, and re-refer to the Committee on [Appropriations]",5,0,0,2,7
1849295,1463644,2024-08-05,Senate,"Placed on suspense file",7,0,0,0,7
1849295,1464198,2024-08-15,Senate,"Do pass",4,1,0,2,7
1849296,1430077,2024-04-16,Assembly,"Do pass as amended and be re-referred to the Committee on [Appropriations]",11,0,0,0,11
1849296,1441286,2024-05-08,Assembly,"Do pass. To Consent Calendar",15,0,0,0,15
1849296,1444279,2024-05-16,Assembly,"AB 2987 Ortega Consent Calendar Second Day Regular Session",71,0,0,9,80
1849296,1456935,2024-06-12,Senate,"Do pass as amended, but first amend, and re-refer to the Committee on [Appropriations] with the recommendation: To Consent Calendar",7,0,0,0,7
1849296,1463660,2024-08-05,Senate,"Consent Calendar 2nd AB2987 Ortega et al",40,0,0,0,40
1849296,1463803,2024-08-08,Assembly,"AB 2987 Ortega Concurrence in Senate Amendments",72,0,0,7,79
1849297,1411318,2024-03-19,Assembly,"Do pass and be re-referred to the Committee on [Appropriations] with recommendation: To Consent Calendar",12,0,0,0,12
1849297,1443975,2024-05-16,Assembly,"Do pass as amended",11,0,0,4,15
1849297,1449588,2024-05-23,Assembly,"AB 2988 McCarty Assembly Third Reading",69,0,0,11,80
1849297,1460690,2024-06-25,Senate,"Do pass, but first be re-referred to the Committee on [Appropriations] with the recommendation: To Consent Calendar",11,0,0,0,11
1849297,1463838,2024-08-12,Senate,"Consent Calendar 2nd AB2988 McCarty",38,0,0,2,40
1849297,1464019,2024-08-15,Assembly,"AB 2988 McCarty Concurrence in Senate Amendments",76,0,0,3,79
1849299,1434266,2024-04-24,Assembly,"Do pass and be re-referred to the Committee on [Appropriations]",6,0,0,2,8
1849300,1420202,2024-04-03,Assembly,"Do pass and be re-referred to the Committee on [Appropriations]",21,0,0,1,22
1849300,1429905,2024-04-17,Assembly,"Do pass. To Consent Calendar",15,0,0,0,15
1849300,1446003,2024-05-21,Assembly,"AB 2991 Valencia Assembly Third Reading",74,0,0,6,80
1849300,1460028,2024-06-25,Senate,"Do pass, but first be re-referred to the Committee on [Appropriations] with the recommendation: To Consent Calendar",14,0,0,2,16
1849300,1465873,2024-08-27,Senate,"Assembly 3rd Reading AB2991 Valencia et al. By Dodd",40,0,0,0,40
1849300,1466848,2024-08-28,Assembly,"AB 2991 Valencia Concurrence in Senate Amendments",77,0,0,2,79
1849301,1432929,2024-04-23,Assembly,"Do pass as amended, and be re-referred to the Committee on [Appropriations] with recommendation: To Consent Calendar",11,0,0,1,12
1849301,1441379,2024-05-08,Assembly,"Do pass. To Consent Calendar",15,0,0,0,15
1849301,1444102,2024-05-16,Assembly,"AB 2992 Stephanie Nguyen Consent Calendar Second Day Regular Session",71,0,0,9,80
1849301,1459361,2024-06-24,Senate,"Do pass, but first be re-referred to the Committee on [Judiciary]",12,0,0,1,13
1849301,1462523,2024-07-02,Senate,"Do pass, but first be re-referred to the Committee on [Appropriations] with the recommendation: To Consent Calendar",11,0,0,0,11
1849301,1463551,2024-08-05,Senate,"Placed on suspense file",7,0,0,0,7
1849301,1464511,2024-08-15,Senate,"Do pass",7,0,0,0,7
1849301,1466355,2024-08-29,Assembly,"AB 2992 Stephanie Nguyen Concurrence in Senate Amendments",76,0,0,3,79
1849301,1466816,2024-08-28,Senate,"Special Consent AB2992 Stephanie Nguyen By Caballero",39,0,0,1,40
1849302,1427258,2024-04-15,Assembly,"Do pass as amended and be re-referred to the Committee on [Judiciary]",9,0,0,0,9
1849302,1433113,2024-04-23,Assembly,"Do pass and be re-referred to the Committee on [Appropriations] with recommendation: To Consent Calendar",11,0,0,1,12
1849302,1444466,2024-05-16,Assembly,"Do pass",15,0,0,0,15
1849302,1448579,2024-05-22,Assembly,"AB 2993 Grayson Assembly Third Reading",71,0,0,9,80
1849302,1458482,2024-06-19,Senate,"Do pass as amended, but first amend, and re-refer to the Committee on [Judiciary]",6,0,0,1,7
1849304,1428955,2024-04-16,Assembly,"Do pass as amended. To Consent Calendar",16,0,0,0,16
1849304,1435264,2024-04-25,Assembly,"AB 2995 Jackson Consent Calendar Second Day Regular Session",75,0,0,5,80
1849304,1451574,2024-05-29,Senate,"Do pass",11,0,0,0,11
1849304,1465972,2024-08-27,Senate,"Assembly 3rd Reading AB2995 Jackson By Menjivar",40,0,0,0,40
1849304,1466884,2024-08-28,Assembly,"AB 2995 Jackson Concurrence in Senate Amendments",77,0,0,2,79
1849305,1428893,2024-04-16,Assembly,"Do pass and be re-referred to the Committee on [Insurance] with recommendation: To Consent Calendar",7,0,0,0,7
1849305,1435274,2024-04-25,Assembly,"Do pass and be re-referred to the Committee on [Appropriations]",12,0,0,3,15
1849305,1444001,2024-05-16,Assembly,"Do pass",15,0,0,0,15
1849305,1449589,2024-05-23,Assembly,"AB 2996 Alvarez Third Reading Urgency",72,0,0,8,80
1849305,1459369,2024-06-24,Senate,"Do pass, but first be re-referred to the Committee on [Insurance]",12,0,0,1,13
1849305,1460672,2024-06-26,Senate,"Do pass, but first be re-referred to the Committee on [Appropriations]",7,0,0,0,7
1849305,1463497,2024-08-05,Senate,"Placed on suspense file",7,0,0,0,7
1849305,1464483,2024-08-15,Senate,"Do pass",7,0,0,0,7
1849307,1423869,2024-04-09,Assembly,"Do pass as amended and be re-referred to the Committee on [Judiciary]",16,0,0,0,16
1849307,1435273,2024-04-24,Assembly,"Do pass as amended, and be re-referred to the Committee on [Appropriations] with recommendation: To Consent Calendar",7,0,0,0,7
1849307,1443484,2024-05-15,Assembly,"Do pass. To Consent Calendar",15,0,0,0,15
1849307,1445924,2024-05-21,Assembly,"AB 2998 McKinnor Consent Calendar Second Day Regular Session",71,0,0,9,80
1849307,1456913,2024-06-12,Senate,"Do pass, but first be re-referred to the Committee on [Judiciary]",7,0,0,0,7
1849307,1458198,2024-06-18,Senate,"Do pass as amended, but first amend, and re-refer to the Committee on [Appropriations] with the recommendation: To Consent Calendar",10,0,0,1,11
1849307,1463836,2024-08-12,Senate,"Consent Calendar 2nd AB2998 McKinnor et al",38,0,0,2,40
1849307,1465271,2024-08-19,Assembly,"AB 2998 McKinnor Concurrence in Senate Amendments",77,0,0,2,79
1849308,1435343,2024-04-24,Assembly,"Do pass as amended and be re-referred to the Committee on [Appropriations]",6,0,0,1,7
1849308,1444502,2024-05-16,Assembly,"Do pass",14,0,0,1,15
1849308,1446056,2024-05-21,Assembly,"AB 2999 Schiavo Assembly Third Reading",67,0,0,13,80
1849308,1462550,2024-07-03,Senate,"Do pass as amended, but first amend, and re-refer to the Committee on [Appropriations]",7,0,0,0,7
1849308,1463508,2024-08-05,Senate,"Placed on suspense file",7,0,0,0,7
1849308,1464356,2024-08-15,Senate,"Do pass as amended",7,0,0,0,7
1849308,1466427,2024-08-30,Senate,"Special Consent AB2999 Schiavo et al. By Ashby",40,0,0,0,40
1849308,1466978,2024-08-31,Assembly,"AB 2999 Schiavo Concurrence in Senate Amendments",77,0,0,2,79
1849313,1424928,2024-04-09,Assembly,"Do pass and be re-referred to the Committee on [Judiciary]",7,0,0,0,7
1849313,1428861,2024-04-16,Assembly,"Do pass and be re-referred to the Committee on [Appropriations] with recommendation: To Consent Calendar",12,0,0,0,12
1849313,1437651,2024-05-01,Assembly,"Do pass. To Consent Calendar",14,0,0,1,15
1849313,1441896,2024-05-09,Assembly,"AB 3004 Mike Fong Consent Calendar Second Day Regular Session",65,0,0,15,80
1849313,1454249,2024-06-05,Senate,"Do pass, but first be re-referred to the Committee on [Judiciary] with the recommendation: To Consent Calendar",7,0,0,0,7
1849313,1458355,2024-06-18,Senate,"Do pass, but first be re-referred to the Committee on [Appropriations] with the recommendation: To Consent Calendar",10,0,0,1,11
1849313,1461961,2024-07-01,Senate,"Placed on suspense file",7,0,0,0,7
1849315,1420198,2024-04-03,Assembly,"Do pass as amended, and be re-referred to the Committee on [Appropriations] with recommendation: To Consent Calendar",16,0,0,0,16
1849315,1443898,2024-05-16,Assembly,"Do pass",15,0,0,0,15
1849315,1448601,2024-05-22,Assembly,"AB 3006 Zbur Assembly Third Reading",70,0,0,10,80
1849315,1458231,2024-06-18,Senate,"Do pass, but first be re-referred to the Committee on [Governmental Organization]",15,2,0,1,18
1849315,1460016,2024-06-25,Senate,"Do pass as amended, but first amend, and re-refer to the Committee on [Appropriations]",11,2,0,3,16
1849315,1463480,2024-08-05,Senate,"Placed on suspense file",7,0,0,0,7
1849316,1428957,2024-04-16,Assembly,"Do pass and be re-referred to the Committee on [Appropriations]",15,0,0,0,15
1849316,1437635,2024-05-01,Assembly,"Do pass as amended. To Consent Calendar",14,0,0,1,15
1849316,1441926,2024-05-09,Assembly,"AB 3007 Hoover Consent Calendar Second Day Regular Session",65,0,0,15,80
1849316,1456324,2024-06-11,Senate,"Do pass, but first be re-referred to the Committee on [Environmental Quality] with the recommendation: To Consent Calendar",11,0,0,0,11
1849316,1462651,2024-07-03,Senate,"Do pass, but first be re-referred to the Committee on [Appropriations] with the recommendation: To Consent Calendar",7,0,0,0,7
1849316,1463887,2024-08-12,Senate,"Consent Calendar 2nd AB3007 Hoover",38,0,0,2,40
1849319,1435184,2024-04-24,Assembly,"Do pass as amended, and be re-referred to the Committee on [Appropriations] with recommendation: To Consent Calendar",7,0,0,0,7
1849319,1441350,2024-05-08,Assembly,"Do pass. To Consent Calendar",15,0,0,0,15
1849319,1444194,2024-05-16,Assembly,"AB 3010 Bauer-Kahan Consent Calendar Second Day Regular Session",71,0,0,9,80
1849319,1458508,2024-06-19,Senate,"Do pass, but first be re-referred to the Committee on [Appropriations] with the recommendation: To Consent Calendar",7,0,0,0,7
1849319,1463615,2024-08-05,Senate,"Consent Calendar 2nd AB3010 Bauer-Kahan",40,0,0,0,40
1849321,1431046,2024-04-17,Assembly,"Do pass and be re-referred to the Committee on [Housing and Community Development]",9,0,0,0,9
1849321,1434250,2024-04-24,Assembly,"Do pass and be re-referred to the Committee on [Appropriations] with recommendation: To Consent Calendar",9,0,0,0,9
1849321,1443462,2024-05-15,Assembly,"Do pass. To Consent Calendar",15,0,0,0,15
1849321,1446170,2024-05-21,Assembly,"AB 3012 Grayson Consent Calendar Second Day Regular Session",71,0,0,9,80
1849321,1456431,2024-06-11,Senate,"Do pass as amended, but first amend, and re-refer to the Committee on [Housing]",7,0,0,0,7
1849321,1462631,2024-07-02,Senate,"Do pass, but first be re-referred to the Committee on [Appropriations] with the recommendation: To Consent Calendar",10,0,0,0,10
1849321,1463645,2024-08-05,Senate,"Placed on suspense file",7,0,0,0,7
1849321,1464346,2024-08-15,Senate,"Do pass",7,0,0,0,7
1849321,1466321,2024-08-29,Assembly,"AB 3012 Grayson Concurrence in Senate Amendments",76,0,0,3,79
1849321,1466785,2024-08-28,Senate,"Special Consent AB3012 Grayson By Wiener",39,0,0,1,40
1849322,1423876,2024-04-09,Assembly,"Do pass as amended and be re-referred to the Committee on [Appropriations]",11,0,0,1,12
1849322,1444346,2024-05-16,Assembly,"Do pass",15,0,0,0,15
1849322,1448582,2024-05-22,Assembly,"AB 3013 Maienschein Assembly Third Reading",71,0,0,9,80
1849322,1460698,2024-06-25,Senate,"Do pass, but first be re-referred to the Committee on [Appropriations] with the recommendation: To Consent Calendar",11,0,0,0,11
1849322,1465947,2024-08-27,Senate,"Assembly 3rd Reading AB3013 Maienschein By Atkins",40,0,0,0,40
1849322,1466646,2024-08-28,Assembly,"AB 3013 Maienschein Concurrence in Senate Amendments",76,0,0,3,79
1849323,1420111,2024-04-02,Assembly,"Do pass. To Consent Calendar",8,0,0,0,8
1849323,1427269,2024-04-15,Assembly,"AB 3014 Irwin Assembly Third Reading",75,0,0,5,80
1849324,1430015,2024-04-16,Assembly,"Do pass and be re-referred to the Committee on [Appropriations]",11,0,0,0,11
1849324,1443916,2024-05-16,Assembly,"Do pass",15,0,0,0,15
1849324,1448625,2024-05-22,Assembly,"AB 3015 Ramos Assembly Third Reading",71,0,0,9,80
1849324,1460678,2024-06-26,Senate,"Do pass as amended, but first amend, and re-refer to the Committee on [Appropriations]",7,0,0,0,7
1849324,1463496,2024-08-05,Senate,"Placed on suspense file",7,0,0,0,7
1849326,1420076,2024-04-03,Assembly,"Do pass and be re-referred to the Committee on [Appropriations] with recommendation: To Consent Calendar",21,0,0,1,22
1849326,1434212,2024-04-24,Assembly,"Do pass. To Consent Calendar",14,0,0,1,15
1849326,1438465,2024-05-02,Assembly,"AB 3017 Hart Consent Calendar Second Day Regular Session",73,0,0,7,80
1849326,1450958,2024-05-28,Senate,"Do pass, but first be re-referred to the Committee on [Appropriations] with the recommendation: To Consent Calendar",12,0,0,4,16
1849326,1464544,2024-08-15,Senate,"Consent Calendar 2nd AB3017 Hart et al",37,0,0,3,40
1849326,1465308,2024-08-19,Assembly,"AB 3017 Hart Concurrence in Senate Amendments",77,0,0,2,79
1849328,1431901,2024-04-22,Assembly,"Do pass as amended and be re-referred to the Committee on [Appropriations]",10,0,0,1,11
1849329,1434193,2024-04-24,Assembly,"Do pass and be re-referred to the Committee on [Appropriations]",11,0,0,0,11
1849330,1420029,2024-04-02,Assembly,"Do pass and be re-referred to the Committee on [Appropriations]",6,1,0,1,8
1849330,1429991,2024-04-17,Assembly,"Do pass",11,3,0,1,15
1849330,1445219,2024-05-20,Assembly,"AB 3021 Kalra Assembly Third Reading",47,17,0,16,80
1849330,1458232,2024-06-18,Senate,"Do pass, but first be re-referred to the Committee on [Appropriations]",4,1,0,0,5
1849330,1462089,2024-07-01,Senate,"Placed on suspense file",7,0,0,0,7
1849330,1464583,2024-08-15,Senate,"Do pass",5,2,0,0,7
1849332,1431890,2024-04-22,Assembly,"Do pass and be re-referred to the Committee on [Appropriations] with recommendation: To Consent Calendar",11,0,0,0,11
1849332,1444376,2024-05-16,Assembly,"Do pass as amended",11,0,0,4,15
1849332,1448600,2024-05-22,Assembly,"AB 3023 Papan Assembly Third Reading",70,0,0,10,80
1849332,1457963,2024-06-17,Senate,"Do pass as amended, but first amend, and re-refer to the Committee on [Appropriations] with the recommendation: To Consent Calendar",11,0,0,0,11
1849332,1463478,2024-08-05,Senate,"Placed on suspense file",7,0,0,0,7
1849332,1464203,2024-08-15,Senate,"Do pass as amended",7,0,0,0,7
1849332,1466385,2024-08-30,Senate,"Special Consent AB3023 Papan By Dahle",40,0,0,0,40
1849332,1466913,2024-08-31,Assembly,"AB 3023 Papan Concurrence in Senate Amendments",77,0,0,2,79
1849333,1419230,2024-04-02,Assembly,"Do pass as amended",10,1,0,1,12
1849333,1436233,2024-04-29,Assembly,"AB 3024 Ward Third Reading Urgency",61,3,0,16,80
1849333,1458248,2024-06-18,Senate,"Do pass as amended",8,2,0,1,11
1849333,1466845,2024-08-31,Senate,"Assembly 3rd Reading AB3024 Ward et al. By Allen Urgency Clause",31,0,0,9,40
1849333,1466846,2024-08-31,Assembly,"AB 3024 Ward Concurrence in Senate Amendments",61,2,0,16,79
1849334,1437587,2024-05-01,Assembly,"Do pass as amended",6,0,0,1,7
1849334,1445136,2024-05-20,Assembly,"AB 3025 Valencia Assembly Third Reading",72,0,0,8,80
1849334,1456938,2024-06-12,Senate,"Do pass, but first be re-referred to the Committee on [Judiciary]",5,0,0,0,5
1849334,1460739,2024-06-25,Senate,"Do pass as amended",10,0,0,1,11
1849334,1465346,2024-08-20,Senate,"Assembly 3rd Reading AB3025 Valencia et al. By Min",40,0,0,0,40
1849334,1465514,2024-08-22,Assembly,"AB 3025 Valencia Concurrence in Senate Amendments",60,0,0,19,79
1849336,1424973,2024-04-09,Assembly,"Do pass as amended, and be re-referred to the Committee on [Emergency Management] with recommendation: To Consent Calendar",8,0,0,0,8
1849336,1431978,2024-04-22,Assembly,"Do pass and be re-referred to the Committee on [Appropriations]",8,0,0,0,8
1849336,1444067,2024-05-16,Assembly,"Do pass",15,0,0,0,15
1849336,1449590,2024-05-23,Assembly,"AB 3027 Bains Assembly Third Reading",72,0,0,8,80
1849336,1458174,2024-06-18,Senate,"Do pass, but first be re-referred to the Committee on [Governmental Organization] with the recommendation: To Consent Calendar",5,0,0,0,5
1849336,1460058,2024-06-25,Senate,"Do pass, but first be re-referred to the Committee on [Appropriations]",14,0,0,2,16
1849336,1463376,2024-08-05,Senate,"Placed on suspense file",7,0,0,0,7
1849338,1420149,2024-04-02,Assembly,"Do pass as amended, and be re-referred to the Committee on [Business and Professions] with recommendation: To Consent Calendar",8,0,0,0,8
1849338,1433147,2024-04-23,Assembly,"Do pass and be re-referred to the Committee on [Appropriations] with recommendation: To Consent Calendar",17,0,0,1,18
1849338,1444635,2024-05-16,Assembly,"Do pass as amended",11,0,0,4,15
1849338,1449689,2024-05-23,Assembly,"AB 3029 Bains Assembly Third Reading",73,0,0,7,80
1849338,1462209,2024-07-02,Senate,"Do pass as amended, but first amend, and re-refer to the Committee on [Appropriations]",5,0,0,0,5
1849338,1463562,2024-08-05,Senate,"Placed on suspense file",7,0,0,0,7
1849339,1423802,2024-04-09,Assembly,"Do pass as amended and be re-referred to the Committee on [Privacy and Consumer Protection]",16,0,0,0,16
1849339,1435276,2024-04-23,Assembly,"Do pass as amended and be re-referred to the Committee on [Appropriations]",10,0,0,1,11
1849339,1441321,2024-05-08,Assembly,"Do pass. To Consent Calendar",15,0,0,0,15
1849339,1445180,2024-05-20,Assembly,"AB 3030 Calderon Assembly Third Reading",71,0,0,9,80
1849339,1460712,2024-06-26,Senate,"Do pass as amended, but first amend, and re-refer to the Committee on [Appropriations]",11,0,0,0,11
1849339,1463504,2024-08-05,Senate,"Placed on suspense file",7,0,0,0,7
1849339,1464166,2024-08-15,Senate,"Do pass as amended",7,0,0,0,7
1849339,1466579,2024-08-30,Senate,"Special Consent AB3030 Calderon By Lim√≥n",40,0,0,0,40
1849339,1467040,2024-08-31,Assembly,"AB 3030 Calderon Concurrence in Senate Amendments By AGUIAR-CURRY",75,0,0,4,79
1849340,1423883,2024-04-09,Assembly,"Do pass as amended and be re-referred to the Committee on [Appropriations]",5,0,0,2,7
1849340,1444107,2024-05-16,Assembly,"Do pass",11,1,0,3,15
1849340,1448810,2024-05-22,Assembly,"AB 3031 Lee Assembly Third Reading",62,0,0,18,80
1849340,1458259,2024-06-18,Senate,"Do pass, but first be re-referred to the Committee on [Governmental Organization]",8,0,0,3,11
1849340,1459939,2024-06-25,Senate,"Do pass as amended, but first amend, and re-refer to the Committee on [Appropriations]",10,0,0,6,16
1849340,1463624,2024-08-05,Senate,"Placed on suspense file",7,0,0,0,7
1849340,1464131,2024-08-15,Senate,"Do pass as amended",5,0,0,2,7
1849340,1465693,2024-08-26,Senate,"Assembly 3rd Reading AB3031 Lee et al. By Laird",32,0,0,8,40
1849340,1466006,2024-08-27,Assembly,"AB 3031 Lee Concurrence in Senate Amendments",65,0,0,14,79
1849342,1428877,2024-04-16,Assembly,"Do pass and be re-referred to the Committee on [Appropriations] with recommendation: To Consent Calendar",7,0,0,0,7
1849343,1432925,2024-04-23,Assembly,"Do pass and be re-referred to the Committee on [Appropriations]",9,0,0,2,11
1849343,1444272,2024-05-16,Assembly,"Do pass as amended",11,1,0,3,15
1849343,1446016,2024-05-21,Assembly,"AB 3034 Low Assembly Third Reading",68,0,0,12,80
1849343,1460754,2024-06-26,Senate,"Do pass, but first be re-referred to the Committee on [Appropriations]",6,0,0,1,7
1849343,1463421,2024-08-05,Senate,"Placed on suspense file",7,0,0,0,7
1849343,1464265,2024-08-15,Senate,"Do pass as amended",5,2,0,0,7
1849343,1466279,2024-08-29,Assembly,"AB 3034 Low Concurrence in Senate Amendments",74,0,0,5,79
1849343,1466830,2024-08-28,Senate,"Assembly 3rd Reading AB3034 Low By Wilk",34,1,0,5,40
1849344,1434082,2024-04-24,Assembly,"Do pass and be re-referred to the Committee on [Appropriations]",9,0,0,0,9
1849344,1441299,2024-05-08,Assembly,"Do pass. To Consent Calendar",15,0,0,0,15
1849344,1444473,2024-05-16,Assembly,"AB 3035 Pellerin Consent Calendar Second Day Regular Session",71,0,0,9,80
1849344,1453435,2024-06-04,Senate,"Do pass, but first be re-referred to the Committee on [Local Government]",9,0,0,1,10
1849344,1460487,2024-06-26,Senate,"Do pass as amended, but first amend, and re-refer to the Committee on [Appropriations]",7,0,0,0,7
1849344,1466409,2024-08-30,Senate,"Assembly 3rd Reading AB3035 Pellerin et al. By Cortese",40,0,0,0,40
1849344,1466957,2024-08-31,Assembly,"AB 3035 Pellerin Concurrence in Senate Amendments",77,0,0,2,79
1849345,1423792,2024-04-09,Assembly,"Do pass and be re-referred to the Committee on [Natural Resources]",12,1,0,2,15
1849345,1427314,2024-04-15,Assembly,"Do pass and be re-referred to the Committee on [Appropriations]",10,0,0,1,11
1849346,1420063,2024-04-02,Assembly,"Do pass and be re-referred to the Committee on [Appropriations]",2,3,0,3,8
1849346,1420064,2024-04-02,Assembly,Reconsideration,3,5,0,0,8
1849347,1421134,2024-04-03,Assembly,"Do pass and be re-referred to the Committee on [Public Safety]",2,4,0,1,7
1849348,1428827,2024-04-16,Assembly,"Do pass and be re-referred to the Committee on [Public Safety]",4,7,0,1,12
1849350,1420139,2024-04-03,Assembly,"Do pass as amended and be re-referred to the Committee on [Labor and Employment]",7,0,0,0,7
1849351,1420132,2024-04-02,Assembly,"Do pass and be re-referred to the Committee on [Appropriations] with recommendation: To Consent Calendar",8,0,0,0,8
1849351,1444649,2024-05-16,Assembly,"Do pass as amended",11,0,0,4,15
1849351,1446027,2024-05-21,Assembly,"AB 3042 Stephanie Nguyen Assembly Third Reading",73,0,0,7,80
1849351,1458357,2024-06-18,Senate,"Do pass, but first be re-referred to the Committee on [Appropriations] with the recommendation: To Consent Calendar",5,0,0,0,5
1849351,1462051,2024-07-01,Senate,"Placed on suspense file",7,0,0,0,7
1849351,1464261,2024-08-15,Senate,"Do pass as amended",7,0,0,0,7
1849351,1465744,2024-08-26,Senate,"Assembly 3rd Reading AB3042 Stephanie Nguyen By Grove",40,0,0,0,40
1849351,1465910,2024-08-27,Assembly,"AB 3042 Stephanie Nguyen Concurrence in Senate Amendments",77,0,0,2,79
1849352,1430980,2024-04-17,Assembly,"Do pass and be re-referred to the Committee on [Judiciary]",6,1,0,0,7
1849352,1433123,2024-04-23,Assembly,"Do pass and be re-referred to the Committee on [Appropriations]",9,0,0,3,12
1849352,1444059,2024-05-16,Assembly,"Do pass as amended",11,4,0,0,15
1849352,1448635,2024-05-22,Assembly,"AB 3043 Luz Rivas Assembly Third Reading By FLORA",62,0,0,18,80
1849354,1433132,2024-04-23,Assembly,"Do pass and be re-referred to the Committee on [Appropriations]",16,0,0,0,16
1849354,1443454,2024-05-15,Assembly,"Do pass. To Consent Calendar",15,0,0,0,15
1849354,1445983,2024-05-21,Assembly,"AB 3045 Ta Consent Calendar Second Day Regular Session",71,0,0,9,80
1849354,1460685,2024-06-26,Senate,"Do pass, but first be re-referred to the Committee on [Appropriations] with the recommendation: To Consent Calendar",11,0,0,0,11
1849354,1463678,2024-08-05,Senate,"Placed on suspense file",7,0,0,0,7
1849354,1464017,2024-08-15,Senate,"Do pass",7,0,0,0,7
1849354,1467247,2024-08-28,Senate,"Special Consent AB3045 Ta et al. By Min",39,0,0,1,40
1849356,1428845,2024-04-16,Assembly,"Do pass as amended and be re-referred to the Committee on [Appropriations]",5,0,0,2,7
1849356,1444319,2024-05-16,Assembly,"Do pass",10,2,0,3,15
1849356,1448698,2024-05-22,Assembly,"AB 3047 McCarty Assembly Third Reading",55,10,0,15,80
1849356,1462676,2024-07-03,Senate,"Do pass, but first be re-referred to the Committee on [Appropriations]",8,0,0,3,11
1849356,1463514,2024-08-05,Senate,"Placed on suspense file",7,0,0,0,7
1849357,1419173,2024-04-02,Assembly,"Do pass as amended and be re-referred to the Committee on [Appropriations]",8,3,0,0,11
1849357,1434132,2024-04-24,Assembly,"Do pass",11,4,0,0,15
1849357,1448693,2024-05-22,Assembly,"AB 3048 Lowenthal Assembly Third Reading",53,7,0,20,80
1849357,1462573,2024-07-02,Senate,"Do pass as amended, but first amend, and re-refer to the Committee on [Appropriations]",10,0,0,1,11
1849357,1465901,2024-08-27,Senate,"Assembly 3rd Reading AB3048 Lowenthal By Umberg",31,7,0,2,40
1849357,1466819,2024-08-28,Assembly,"AB 3048 Lowenthal Concurrence in Senate Amendments",59,12,0,8,79
1849358,1428872,2024-04-16,Assembly,"Do pass as amended, and be re-referred to the Committee on [Human Services] with recommendation: To Consent Calendar",12,0,0,0,12
1849358,1433110,2024-04-23,Assembly,"Do pass and be re-referred to the Committee on [Appropriations] with recommendation: To Consent Calendar",6,0,0,1,7
1849358,1444142,2024-05-16,Assembly,"Do pass",15,0,0,0,15
1849358,1448652,2024-05-22,Assembly,"AB 3049 Bryan Assembly Third Reading",71,0,0,9,80
1849358,1458168,2024-06-18,Senate,"Do pass as amended, but first amend, and re-refer to the Committee on [Human Services]",10,0,0,1,11
1849358,1462275,2024-07-01,Senate,"Do pass as amended, but first amend, and re-refer to the Committee on [Appropriations]",4,0,0,1,5
1849358,1463449,2024-08-05,Senate,"Placed on suspense file",7,0,0,0,7
1849360,1427262,2024-04-15,Assembly,"Do pass as amended and be re-referred to the Committee on [Appropriations]",6,0,0,1,7
1849363,1433153,2024-04-23,Assembly,"Do pass and be re-referred to the Committee on [Appropriations] with recommendation: To Consent Calendar",17,0,0,1,18
1849363,1441349,2024-05-08,Assembly,"Do pass. To Consent Calendar",15,0,0,0,15
1849363,1444210,2024-05-16,Assembly,"AB 3054 Berman Consent Calendar Second Day Regular Session",71,0,0,9,80
1849363,1462065,2024-07-01,Senate,"Do pass, but first be re-referred to the Committee on [Appropriations]",13,0,0,0,13
1849364,1431958,2024-04-22,Assembly,"Do pass and be re-referred to the Committee on [Appropriations] with recommendation: To Consent Calendar",15,0,0,0,15
1849365,1430969,2024-04-17,Assembly,"Do pass and be re-referred to the Committee on [Appropriations]",2,5,0,0,7
1849365,1430970,2024-04-17,Assembly,Reconsideration,7,0,0,0,7
1849366,1431886,2024-04-22,Assembly,"Do pass and be re-referred to the Committee on [Housing and Community Development] with recommendation: To Consent Calendar",11,0,0,0,11
1849366,1434278,2024-04-24,Assembly,"Do pass. To Consent Calendar",9,0,0,0,9
1849366,1438493,2024-05-02,Assembly,"AB 3057 Wilson Consent Calendar Second Day Regular Session",73,0,0,7,80
1849366,1454261,2024-06-05,Senate,"Do pass, but first be re-referred to the Committee on [Housing] with the recommendation: To Consent Calendar",7,0,0,0,7
1849366,1462703,2024-07-02,Senate,"Do pass and be ordered to the Consent Calendar",10,0,0,0,10
1849366,1463850,2024-08-12,Senate,"Consent Calendar 2nd AB3057 Wilson",38,0,0,2,40
1849368,1432963,2024-04-23,Assembly,"Do pass and be re-referred to the Committee on [Appropriations]",16,0,0,0,16
1849368,1443938,2024-05-16,Assembly,"Do pass",15,0,0,0,15
1849368,1448608,2024-05-22,Assembly,"AB 3059 Weber Assembly Third Reading",71,0,0,9,80
1849368,1460590,2024-06-26,Senate,"Do pass, but first be re-referred to the Committee on [Appropriations]",11,0,0,0,11
1849368,1463688,2024-08-05,Senate,"Placed on suspense file",7,0,0,0,7
1849368,1464516,2024-08-15,Senate,"Do pass",4,1,0,2,7
1849368,1465842,2024-08-27,Senate,"Assembly 3rd Reading AB3059 Weber et al. By Lim√≥n",37,0,0,3,40
1849368,1466735,2024-08-28,Assembly,"AB 3059 Weber Concurrence in Senate Amendments",77,0,0,2,79
1849370,1427272,2024-04-15,Assembly,"Do pass and be re-referred to the Committee on [Communications and Conveyance]",12,1,0,2,15
1849370,1434037,2024-04-24,Assembly,"Do pass and be re-referred to the Committee on [Appropriations]",10,1,0,0,11
1849370,1444366,2024-05-16,Assembly,"Do pass",12,3,0,0,15
1849370,1448714,2024-05-22,Assembly,"AB 3061 Haney Assembly Third Reading",61,3,0,16,80
1849370,1460597,2024-06-25,Senate,"Do pass, but first be re-referred to the Committee on [Energy, Utilities and Communications]",11,2,0,2,15
1849370,1463880,2024-08-12,Senate,"Placed on suspense file",7,0,0,0,7
1849370,1464270,2024-08-15,Senate,"Do pass as amended",5,2,0,0,7
1849370,1465813,2024-08-27,Senate,"Assembly 3rd Reading AB3061 Haney et al. By Cortese",31,7,0,2,40
1849370,1466796,2024-08-28,Assembly,"AB 3061 Haney Concurrence in Senate Amendments",65,4,0,10,79
1849371,1434199,2024-04-24,Assembly,"Do pass as amended, and be re-referred to the Committee on [Appropriations] with recommendation: To Consent Calendar",16,0,0,0,16
1849371,1443496,2024-05-15,Assembly,"Do pass. To Consent Calendar",15,0,0,0,15
1849371,1445946,2024-05-21,Assembly,"AB 3062 Bauer-Kahan Consent Calendar Second Day Regular Session",71,0,0,9,80
1849371,1458159,2024-06-18,Senate,"Do pass, but first be re-referred to the Committee on [Local Government]",18,0,0,0,18
1849371,1462693,2024-07-03,Senate,"Do pass as amended, but first amend, and re-refer to the Committee on [Appropriations] with the recommendation: To Consent Calendar",7,0,0,0,7
1849371,1463851,2024-08-12,Senate,"Consent Calendar 2nd AB3062 Bauer-Kahan",38,0,0,2,40
1849371,1464379,2024-08-15,Assembly,"AB 3062 Bauer-Kahan Concurrence in Senate Amendments",76,0,0,3,79
1849372,1419219,2024-04-02,Assembly,"Do pass and be re-referred to the Committee on [Appropriations]",17,0,0,1,18
1849372,1434149,2024-04-24,Assembly,"Do pass. To Consent Calendar",14,0,0,1,15
1849372,1438482,2024-05-02,Assembly,"AB 3063 McKinnor Consent Calendar Second Day Regular Session",73,0,0,7,80
1849372,1455782,2024-06-10,Senate,"Do pass, but first be re-referred to the Committee on [Appropriations]",12,0,0,1,13
1849372,1465831,2024-08-27,Senate,"Assembly 3rd Reading AB3063 McKinnor et al. By Smallwood-Cuevas Urgency Clause",40,0,0,0,40
1849372,1466599,2024-08-31,Assembly,"AB 3063 McKinnor Concurrence in Senate Amendments",76,0,0,3,79
1849373,1432942,2024-04-23,Assembly,"Do pass as amended and be re-referred to the Committee on [Appropriations]",6,2,0,0,8
1849373,1444043,2024-05-16,Assembly,"Do pass",10,4,0,1,15
1849373,1449720,2024-05-23,Assembly,"AB 3064 Maienschein Assembly Third Reading",54,15,0,11,80
1849373,1460102,2024-06-25,Senate,"Do pass, but first be re-referred to the Committee on [Appropriations]",4,1,0,0,5
1849373,1463614,2024-08-05,Senate,"Placed on suspense file",7,0,0,0,7
1849373,1464538,2024-08-15,Senate,"Do pass as amended",4,2,0,1,7
1849373,1466147,2024-08-29,Senate,"Assembly 3rd Reading AB3064 Maienschein By Blakespear",28,11,0,1,40
1849373,1466548,2024-08-30,Assembly,"AB 3064 Maienschein Concurrence in Senate Amendments",53,16,0,10,79
1849374,1431900,2024-04-22,Assembly,"Do pass and be re-referred to the Committee on [Appropriations]",5,0,0,3,8
1849376,1436933,2024-04-30,Assembly,"Do pass",6,0,0,1,7
1849376,1442622,2024-05-13,Assembly,"AB 3067 Gipson Assembly Third Reading",75,0,0,5,80
1849376,1462487,2024-07-03,Senate,"Do pass as amended, and be ordered to the Consent Calendar",7,0,0,0,7
1849377,1429915,2024-04-17,Assembly,"Do pass and be re-referred to the Committee on [Local Government]",9,0,0,0,9
1849377,1435216,2024-04-24,Assembly,"Do pass and be re-referred to the Committee on [Appropriations]",6,1,0,2,9
1849377,1441322,2024-05-08,Assembly,"Do pass",11,3,0,1,15
1849377,1448757,2024-05-22,Assembly,"AB 3068 Haney Assembly Third Reading",58,5,0,17,80
1849377,1456306,2024-06-11,Senate,"Do pass as amended, but first amend, and re-refer to the Committee on [Housing]",4,3,0,0,7
1849377,1462465,2024-07-02,Senate,"Do pass as amended, but first amend, and re-refer to the Committee on [Appropriations]",8,2,0,0,10
1849377,1465961,2024-08-27,Senate,"That the measure be returned to Senate Floor for consideration. Ordered to third reading",4,1,0,2,7
1849377,1466416,2024-08-30,Senate,"Assembly 3rd Reading AB3068 Haney et al. By Blakespear",27,11,0,2,40
1849377,1466942,2024-08-31,Assembly,"AB 3068 Haney Concurrence in Senate Amendments",57,8,0,14,79
1849378,1418335,2024-04-01,Assembly,"Do pass. To Consent Calendar",15,0,0,0,15
1849378,1422052,2024-04-08,Assembly,"AB 3069 Vince Fong Consent Calendar Second Day Regular Session",74,0,0,6,80
1849378,1456423,2024-06-11,Senate,"Do pass, but first be re-referred to the Committee on [Appropriations]",15,0,0,1,16
1849378,1465299,2024-08-19,Senate,"Assembly 3rd Reading AB3069 Davies By Blakespear Urgency Clause",40,0,0,0,40
1849378,1466057,2024-08-28,Assembly,"With recommendation: That Senate amendments be concurred in",21,0,0,1,22
1849378,1466137,2024-08-29,Assembly,"AB 3069 Davies Concurrence - Urgency Added",76,0,0,3,79
1849381,1419138,2024-04-02,Assembly,"Do pass. To Consent Calendar",12,0,0,0,12
1849381,1422060,2024-04-08,Assembly,"AB 3072 Petrie-Norris Consent Calendar Second Day Regular Session",74,0,0,6,80
1849381,1453375,2024-06-04,Senate,"Do pass as amended",11,0,0,0,11
1849381,1465409,2024-08-21,Senate,"Assembly 3rd Reading AB3072 Petrie-Norris et al. By Rubio",33,0,0,7,40
1849381,1465876,2024-08-27,Assembly,"AB 3072 Petrie-Norris Concurrence in Senate Amendments",77,0,0,2,79
1849382,1424906,2024-04-09,Assembly,"Do pass and be re-referred to the Committee on [Appropriations]",6,0,0,1,7
1849383,1421136,2024-04-03,Assembly,"Do pass as amended and be re-referred to the Committee on [Higher Education]",5,0,0,2,7
1849383,1441315,2024-05-08,Assembly,"Do pass",11,0,0,4,15
1849383,1445266,2024-05-20,Assembly,"AB 3074 Schiavo Assembly Third Reading",62,0,0,18,80
1849383,1456954,2024-06-12,Senate,"Do pass, but first be re-referred to the Committee on [Appropriations]",7,0,0,0,7
1849383,1459342,2024-06-24,Senate,"Placed on suspense file",6,0,0,1,7
1849383,1464158,2024-08-15,Senate,"Do pass",6,0,0,1,7
1849383,1466133,2024-08-29,Senate,"Assembly 3rd Reading AB3074 Schiavo et al. By Umberg",36,1,0,3,40
1849386,1420040,2024-04-02,Assembly,"Do pass and be re-referred to the Committee on [Appropriations]",6,0,0,2,8
1849386,1430050,2024-04-17,Assembly,"Do pass",11,4,0,0,15
1849386,1438491,2024-05-02,Assembly,"AB 3077 Hart Assembly Third Reading",63,7,0,10,80
1849386,1456377,2024-06-11,Senate,"Do pass, but first be re-referred to the Committee on [Appropriations]",4,1,0,0,5
1849386,1465985,2024-08-27,Senate,"Assembly 3rd Reading AB3077 Hart By Wahab",29,11,0,0,40
1849386,1466611,2024-08-28,Assembly,"AB 3077 Hart Concurrence in Senate Amendments",62,10,0,7,79
1849388,1433163,2024-04-23,Assembly,"Do pass as amended and be re-referred to the Committee on [Appropriations]",5,1,0,1,7
1849389,1430035,2024-04-16,Assembly,"Do pass as amended and be re-referred to the Committee on [Judiciary]",10,0,0,1,11
1849389,1436939,2024-04-30,Assembly,"Do pass as amended",11,0,0,1,12
1849389,1443920,2024-05-16,Assembly,"AB 3080 Alanis Assembly Third Reading",65,0,0,15,80
1849389,1462486,2024-07-02,Senate,"Do pass as amended",11,0,0,0,11
1849389,1463878,2024-08-12,Senate,"Placed on suspense file",7,0,0,0,7
1849390,1433074,2024-04-23,Assembly,"Do pass and be re-referred to the Committee on [Appropriations]",8,0,0,3,11
1849392,1419207,2024-04-02,Assembly,"Do pass as amended, and be re-referred to the Committee on [Public Safety] with recommendation: To Consent Calendar",12,0,0,0,12
1849392,1428811,2024-04-16,Assembly,"Do pass and be re-referred to the Committee on [Appropriations] with recommendation: To Consent Calendar",8,0,0,0,8
1849392,1444523,2024-05-16,Assembly,"Do pass",15,0,0,0,15
1849392,1448621,2024-05-22,Assembly,"AB 3083 Lackey Assembly Third Reading",70,0,0,10,80
1849392,1458249,2024-06-18,Senate,"Do pass, but first be re-referred to the Committee on [Public Safety] with the recommendation: To Consent Calendar",10,0,0,1,11
1849392,1462245,2024-07-02,Senate,"Do pass, but first be re-referred to the Committee on [Appropriations] with the recommendation: To Consent Calendar",5,0,0,0,5
1849392,1463842,2024-08-12,Senate,"Consent Calendar 2nd AB3083 Lackey et al",38,0,0,2,40
1849394,1427370,2024-04-15,Assembly,"Do pass and be re-referred to the Committee on [Public Safety] with recommendation: To Consent Calendar",15,0,0,0,15
1849394,1441883,2024-05-09,Assembly,"AB 3085 Gipson Assembly Third Reading",66,0,0,14,80
1849394,1456319,2024-06-11,Senate,"Do pass, but first be re-referred to the Committee on [Public Safety] with the recommendation: To Consent Calendar",15,0,0,0,15
1849394,1462205,2024-07-02,Senate,"Do pass",5,0,0,0,5
1849394,1465399,2024-08-21,Senate,"Assembly 3rd Reading AB3085 Gipson et al. By Cortese",33,0,0,7,40
1849396,1433170,2024-04-23,Assembly,"Do pass and be re-referred to the Committee on [Appropriations] with recommendation: To Consent Calendar",10,0,0,1,11
1849396,1444187,2024-05-16,Assembly,"Do pass",15,0,0,0,15
1849396,1448815,2024-05-22,Assembly,"AB 3087 Mike Fong Assembly Third Reading",71,0,0,9,80
1849396,1460457,2024-06-26,Senate,"Do pass, but first be re-referred to the Committee on [Appropriations] with the recommendation: To Consent Calendar",7,0,0,0,7
1849396,1463591,2024-08-05,Senate,"Placed on suspense file",7,0,0,0,7
1849396,1464563,2024-08-15,Senate,"Do pass",7,0,0,0,7
1849396,1466623,2024-08-28,Senate,"Special Consent AB3087 Mike Fong",39,0,0,1,40
1849397,1420186,2024-04-02,Assembly,"Do pass",6,1,0,1,8
1849397,1445131,2024-05-20,Assembly,"AB 3088 Friedman Assembly Third Reading",49,14,0,17,80
1849397,1459934,2024-06-25,Senate,"Do pass as amended, but first amend, and re-refer to the Committee on [Appropriations]",4,1,0,0,5
1849397,1463392,2024-08-05,Senate,"Placed on suspense file",7,0,0,0,7
1849398,1428769,2024-04-16,Assembly,"Do pass and be re-referred to the Committee on [Appropriations]",10,0,0,2,12
1849398,1437624,2024-05-01,Assembly,"Do pass",11,0,0,4,15
1849398,1444046,2024-05-16,Assembly,"AB 3089 Jones-Sawyer Assembly Third Reading",64,0,0,16,80
1849398,1458343,2024-06-18,Senate,"Do pass as amended, but first amend, and re-refer to the Committee on [Governmental Organization]",9,0,0,2,11
1849398,1459966,2024-06-25,Senate,"Do pass, but first be re-referred to the Committee on [Appropriations]",11,0,0,5,16
1849398,1463422,2024-08-05,Senate,"Placed on suspense file",7,0,0,0,7
1849398,1464417,2024-08-15,Senate,"Do pass",5,0,0,2,7
1849398,1466293,2024-08-29,Assembly,"AB 3089 Jones-Sawyer Concurrence in Senate Amendments",72,0,0,7,79
1849398,1466864,2024-08-28,Senate,"Assembly 3rd Reading AB3089 Jones-Sawyer et al. By Bradford",32,0,0,8,40
1849399,1435939,2024-04-23,Assembly,"Do pass",7,0,0,0,7
1849399,1436245,2024-04-29,Assembly,"AB 3090 Maienschein Assembly Third Reading",73,0,0,7,80
1849399,1454200,2024-06-05,Senate,"Do pass and be ordered to the Consent Calendar",7,0,0,0,7
1849399,1457379,2024-06-13,Senate,"Consent Calendar 2nd AB3090 Maienschein",37,0,0,3,40
1849401,1420105,2024-04-02,Assembly,"Do pass and be re-referred to the Committee on [Judiciary] with recommendation: To Consent Calendar",8,0,0,0,8
1849401,1423845,2024-04-09,Assembly,"Do pass and be re-referred to the Committee on [Appropriations] with recommendation: To Consent Calendar",12,0,0,0,12
1849401,1434033,2024-04-24,Assembly,"Do pass. To Consent Calendar",14,0,0,1,15
1849401,1438421,2024-05-02,Assembly,"AB 3092 Ortega Consent Calendar Second Day Regular Session",73,0,0,7,80
1849401,1450964,2024-05-28,Senate,"Do pass, but first be re-referred to the Committee on [Appropriations] with the recommendation: To Consent Calendar",4,0,0,1,5
1849401,1457380,2024-06-13,Senate,"Consent Calendar 2nd AB3092 Ortega",37,0,0,3,40
1849402,1431912,2024-04-22,Assembly,"Do pass and be re-referred to the Committee on [Appropriations] with recommendation: To Consent Calendar",15,0,0,0,15
1849402,1443073,2024-05-14,Assembly,"Do pass and be re-referred to the Committee on [Appropriations]",7,1,0,1,9
1849402,1443476,2024-05-15,Assembly,"Do pass",12,2,0,1,15
1849402,1445964,2024-05-21,Assembly,"AB 3093 Ward Assembly Third Reading",64,5,0,11,80
1849402,1462618,2024-07-02,Senate,"Do pass as amended, but first amend, and re-refer to the Committee on [Appropriations]",7,1,0,2,10
1849402,1463871,2024-08-12,Senate,"Placed on suspense file",7,0,0,0,7
1849402,1464013,2024-08-15,Senate,"Do pass",4,2,0,1,7
1849402,1466282,2024-08-29,Assembly,"AB 3093 Ward Concurrence in Senate Amendments",59,1,0,19,79
1849402,1466802,2024-08-28,Senate,"Assembly 3rd Reading AB3093 Ward et al. By Blakespear",31,5,0,4,40
1849403,1432931,2024-04-23,Assembly,"Do pass as amended and be re-referred to the Committee on [Appropriations]",8,0,0,0,8
1849406,1423729,2024-04-09,Assembly,"Do pass as amended and be re-referred to the Committee on [Appropriations]",17,0,0,1,18
1849408,1420131,2024-04-03,Assembly,"Do pass and be re-referred to the Committee on [Appropriations]",21,0,0,1,22
1849409,1428898,2024-04-16,Assembly,"Do pass. To Consent Calendar",12,0,0,0,12
1849409,1431853,2024-04-22,Assembly,"AB 3100 Low Consent Calendar Second Day",68,0,0,12,80
1849409,1458466,2024-06-19,Senate,"Do pass, but first be re-referred to the Committee on [Judiciary]",6,0,0,1,7
1849409,1460458,2024-06-25,Senate,"Do pass, but first be re-referred to the Committee on [Appropriations] with the recommendation: To Consent Calendar",11,0,0,0,11
1849409,1463665,2024-08-05,Senate,"Do pass",7,0,0,0,7
1849409,1465764,2024-08-26,Senate,"Assembly 3rd Reading AB3100 Low By Grove",40,0,0,0,40
1849409,1465924,2024-08-27,Assembly,"AB 3100 Low Concurrence in Senate Amendments",77,0,0,2,79
1849411,1422065,2024-04-08,Assembly,"Do pass and be re-referred to the Committee on [Appropriations] with recommendation: To Consent Calendar",15,0,0,0,15
1849411,1444186,2024-05-16,Assembly,"Do pass",15,0,0,0,15
1849411,1448538,2024-05-22,Assembly,"AB 3102 Hoover Assembly Third Reading",69,1,0,10,80
1849411,1460643,2024-06-25,Senate,"Do pass, but first be re-referred to the Committee on [Appropriations] with the recommendation: To Consent Calendar",15,0,0,0,15
1849411,1463513,2024-08-05,Senate,"Placed on suspense file",7,0,0,0,7
1849413,1429887,2024-04-17,Assembly,"Do pass and be re-referred to the Committee on [Appropriations]",15,0,0,0,15
1849413,1444086,2024-05-16,Assembly,"Do pass",15,0,0,0,15
1849413,1449585,2024-05-23,Assembly,"AB 3104 Valencia Assembly Third Reading",71,0,0,9,80
1849414,1421157,2024-04-03,Assembly,"Do pass and be re-referred to the Committee on [Appropriations] with recommendation: To Consent Calendar",7,0,0,0,7
1849414,1429886,2024-04-17,Assembly,"Do pass. To Consent Calendar",15,0,0,0,15
1849414,1435353,2024-04-25,Assembly,"AB 3105 Flora Consent Calendar Second Day Regular Session",75,0,0,5,80
1849414,1454202,2024-06-05,Senate,"Do pass, but first be re-referred to the Committee on [Appropriations] with the recommendation: To Consent Calendar",5,0,0,0,5
1849414,1458777,2024-06-20,Senate,"Consent Calendar 2nd AB3105 Flora",36,0,0,4,40
1849414,1461257,2024-06-27,Assembly,"AB 3105 Flora Concurrence in Senate Amendments",74,0,0,5,79
1849415,1431021,2024-04-17,Assembly,"Do pass and be re-referred to the Committee on [Appropriations]",6,0,0,1,7
1849416,1434156,2024-04-24,Assembly,"Do pass and be re-referred to the Committee on [Appropriations]",9,0,0,7,16
1849417,1427297,2024-04-15,Assembly,"Do pass and be re-referred to the Committee on [Public Safety]",9,0,0,0,9
1849417,1433199,2024-04-23,Assembly,"Do pass and be re-referred to the Committee on [Appropriations] with recommendation: To Consent Calendar",8,0,0,0,8
1849417,1444216,2024-05-16,Assembly,"Do pass",15,0,0,0,15
1849417,1448790,2024-05-22,Assembly,"AB 3108 Jones-Sawyer Assembly Third Reading",71,0,0,9,80
1849417,1458473,2024-06-19,Senate,"Do pass as amended, but first amend, and re-refer to the Committee on [Public Safety]",6,0,0,1,7
1849417,1462319,2024-07-02,Senate,"Do pass as amended, but first amend, and re-refer to the Committee on [Appropriations]",5,0,0,0,5
1849417,1463666,2024-08-05,Senate,"Placed on suspense file",7,0,0,0,7
1849417,1464501,2024-08-15,Senate,"Do pass",7,0,0,0,7
1849417,1466375,2024-08-29,Assembly,"AB 3108 Jones-Sawyer Concurrence in Senate Amendments",76,0,0,3,79
1849417,1466902,2024-08-28,Senate,"Special Consent AB3108 Jones-Sawyer By Wiener",39,0,0,1,40
1849420,1434066,2024-04-24,Assembly,"Do pass as amended and be re-referred to the Committee on [Appropriations]",15,0,0,1,16
1849420,1443471,2024-05-15,Assembly,"Do pass. To Consent Calendar",15,0,0,0,15
1849420,1446169,2024-05-21,Assembly,"AB 3111 Calderon Consent Calendar Second Day Regular Session",71,0,0,9,80
1849420,1462269,2024-07-02,Senate,"Do pass as amended, but first amend, and re-refer to the Committee on [Appropriations]",14,0,0,4,18
1849420,1463435,2024-08-05,Senate,"Placed on suspense file",7,0,0,0,7
1849425,1429976,2024-04-17,Assembly,"Do pass and be re-referred to the Committee on [Local Government]",9,0,0,0,9
1849425,1435268,2024-04-24,Assembly,"Do pass as amended and be re-referred to the Committee on [Appropriations]",8,0,0,1,9
1849425,1443488,2024-05-15,Assembly,"Do pass. To Consent Calendar",15,0,0,0,15
1849425,1446086,2024-05-21,Assembly,"AB 3116 Garcia Consent Calendar Second Day Regular Session",71,0,0,9,80
1849425,1458428,2024-06-18,Senate,"Do pass, but first be re-referred to the Committee on [Local Government] with the recommendation: To Consent Calendar",10,0,0,0,10
1849425,1460600,2024-06-26,Senate,"Do pass, but first be re-referred to the Committee on [Appropriations] with the recommendation: To Consent Calendar",7,0,0,0,7
1849425,1463865,2024-08-12,Senate,"Consent Calendar 2nd AB3116 Garcia et al",38,0,0,2,40
1849425,1465966,2024-08-27,Senate,"Assembly 3rd Reading AB3116 Garcia et al. By Jones",40,0,0,0,40
1849425,1466705,2024-08-28,Assembly,"AB 3116 Garcia Concurrence in Senate Amendments",77,0,0,2,79
1849426,1420121,2024-04-03,Assembly,"Do pass and be re-referred to the Committee on [Transportation]",19,1,0,2,22
1849426,1431848,2024-04-22,Assembly,"Do pass and be re-referred to the Committee on [Appropriations]",15,0,0,0,15
1849428,1423820,2024-04-09,Assembly,"Do pass and be re-referred to the Committee on [Appropriations] with recommendation: To Consent Calendar",18,0,0,0,18
1849428,1434101,2024-04-24,Assembly,"Do pass. To Consent Calendar",14,0,0,1,15
1849428,1438475,2024-05-02,Assembly,"AB 3119 Low Consent Calendar Second Day Regular Session",73,0,0,7,80
1849428,1457954,2024-06-17,Senate,"Do pass, but first be re-referred to the Committee on [Appropriations]",12,0,0,1,13
1849428,1465297,2024-08-19,Senate,"Assembly 3rd Reading AB3119 Low By Becker",40,0,0,0,40
1849428,1465536,2024-08-26,Assembly,"AB 3119 Low Concurrence in Senate Amendments",77,0,0,2,79
1849430,1433063,2024-04-23,Assembly,"Do pass. To Consent Calendar",14,0,0,1,15
1849430,1436232,2024-04-29,Assembly,"AB 3121 Hart Consent Calendar Second Day Regular Session",74,0,0,6,80
1849430,1456330,2024-06-11,Senate,"Do pass as amended, and be ordered to the Consent Calendar",11,0,0,0,11
1849431,1430086,2024-04-17,Assembly,"Do pass and be re-referred to the Committee on [Local Government] with recommendation: To Consent Calendar",9,0,0,0,9
1849431,1435196,2024-04-24,Assembly,"Do pass and be re-referred to the Committee on [Appropriations] with recommendation: To Consent Calendar",8,0,0,1,9
1849431,1441296,2024-05-08,Assembly,"Do pass. To Consent Calendar",15,0,0,0,15
1849431,1444170,2024-05-16,Assembly,"AB 3122 Kalra Consent Calendar Second Day Regular Session",71,0,0,9,80
1849431,1453455,2024-06-04,Senate,"Do pass, but first be re-referred to the Committee on [Local Government] with the recommendation: To Consent Calendar",9,0,0,1,10
1849431,1460675,2024-06-26,Senate,"Do pass as amended, but first amend, and re-refer to the Committee on [Appropriations]",7,0,0,0,7
1849431,1465794,2024-08-27,Senate,"Assembly 3rd Reading AB3122 Kalra By Wiener",39,0,0,1,40
1849431,1466711,2024-08-28,Assembly,"AB 3122 Kalra Concurrence in Senate Amendments",72,2,0,5,79
1849432,1427259,2024-04-15,Assembly,"Do pass and be re-referred to the Committee on [Elections]",11,2,0,2,15
1849432,1434175,2024-04-24,Assembly,"Do pass as amended and be re-referred to the Committee on [Appropriations]",6,0,0,2,8
1849432,1441354,2024-05-08,Assembly,"Do pass",11,4,0,0,15
1849432,1445135,2024-05-20,Assembly,"AB 3123 Jones-Sawyer Assembly Third Reading",57,10,0,13,80
1849432,1456411,2024-06-11,Senate,"Do pass, but first be re-referred to the Committee on [Elections and Constitutional Amendments]",12,3,0,0,15
1849432,1462272,2024-07-02,Senate,"Do pass, but first be re-referred to the Committee on [Appropriations]",6,1,0,0,7
1849432,1466135,2024-08-29,Senate,"Assembly 3rd Reading AB3123 Jones-Sawyer By Durazo",26,11,0,3,40
1849432,1466584,2024-08-30,Assembly,"AB 3123 Jones-Sawyer Concurrence in Senate Amendments",50,14,0,15,79
1849436,1420059,2024-04-02,Assembly,"Do pass and be re-referred to the Committee on [Appropriations]",5,0,0,3,8
1849436,1424888,2024-04-10,Assembly,"Do pass",10,4,0,1,15
1849436,1442654,2024-05-13,Assembly,"AB 3127 McKinnor Assembly Third Reading",42,15,0,23,80
1849436,1456452,2024-06-11,Senate,"Do pass, but first be re-referred to the Committee on [Appropriations]",4,1,0,0,5
1849436,1459339,2024-06-24,Senate,"Placed on suspense file",6,0,0,1,7
1849438,1423734,2024-04-09,Assembly,"Do pass as amended and be re-referred to the Committee on [Judiciary]",12,4,0,0,16
1849438,1432975,2024-04-23,Assembly,"Do pass as amended and be re-referred to the Committee on [Appropriations]",9,2,0,1,12
1849438,1444351,2024-05-16,Assembly,"Do pass",11,4,0,0,15
1849438,1446044,2024-05-21,Assembly,"AB 3129 Wood Assembly Third Reading",50,16,0,14,80
1849438,1460570,2024-06-26,Senate,"Do pass as amended, but first amend, and re-refer to the Committee on [Judiciary]",6,2,0,3,11
1849438,1462594,2024-07-02,Senate,"Do pass, but first be re-referred to the Committee on [Appropriations]",9,2,0,0,11
1849438,1463623,2024-08-05,Senate,"Placed on suspense file",7,0,0,0,7
1849438,1464601,2024-08-15,Senate,"Do pass as amended",4,2,0,1,7
1849438,1466721,2024-08-31,Senate,"Assembly 3rd Reading AB3129 Wood et al. By Hurtado",21,11,0,8,40
1849438,1466722,2024-08-31,Assembly,"AB 3129 Wood Concurrence in Senate Amendments By REYES",49,14,0,16,79
1849439,1438488,2024-05-01,Assembly,"Do pass as amended",9,0,0,0,9
1849439,1445264,2024-05-20,Assembly,"AB 3130 Quirk-Silva Assembly Third Reading",72,0,0,8,80
1849439,1460494,2024-06-26,Senate,"Do pass",7,0,0,0,7
1849439,1465487,2024-08-22,Senate,"Assembly 3rd Reading AB3130 Quirk-Silva et al. By Archuleta",33,0,0,7,40
1849440,1424951,2024-04-10,Assembly,"Do pass as amended and be re-referred to the Committee on [Higher Education]",7,0,0,0,7
1849440,1432989,2024-04-23,Assembly,"Do pass as amended and be re-referred to the Committee on [Appropriations]",10,0,0,1,11
1849440,1444511,2024-05-16,Assembly,"Do pass",15,0,0,0,15
1849440,1449587,2024-05-23,Assembly,"AB 3131 McCarty Assembly Third Reading",72,0,0,8,80
1849440,1458491,2024-06-19,Senate,"Do pass, but first be re-referred to the Committee on [Appropriations] with the recommendation: To Consent Calendar",7,0,0,0,7
1849440,1462086,2024-07-01,Senate,"Placed on suspense file",7,0,0,0,7
1849440,1464530,2024-08-15,Senate,"Do pass as amended",7,0,0,0,7
1849440,1465964,2024-08-27,Senate,"Assembly 3rd Reading AB3131 McCarty et al. By Bradford",40,0,0,0,40
1849440,1466259,2024-08-29,Assembly,"AB 3131 McCarty Concurrence in Senate Amendments",76,0,0,3,79
1849443,1433165,2024-04-22,Assembly,"Do pass as amended and be re-referred to the Committee on [Appropriations]",7,0,0,0,7
1849443,1443479,2024-05-15,Assembly,"Do pass. To Consent Calendar",15,0,0,0,15
1849443,1446101,2024-05-21,Assembly,"AB 3134 Chen Consent Calendar Second Day Regular Session",71,0,0,9,80
1849443,1460573,2024-06-26,Senate,"Do pass, but first be re-referred to the Committee on [Appropriations]",7,0,0,0,7
1849443,1467245,2024-08-31,Senate,"Assembly 3rd Reading AB3134 Chen By Jones",40,0,0,0,40
1849443,1467246,2024-08-31,Assembly,"AB 3134 Chen Concurrence in Senate Amendments",73,0,0,6,79
1849445,1419163,2024-04-02,Assembly,"Do pass and be re-referred to the Committee on [Environmental Safety and Toxic Materials]",11,0,0,1,12
1849445,1435941,2024-04-23,Assembly,"Do pass and be re-referred to the Committee on [Appropriations]",5,1,0,1,7
1849447,1422071,2024-04-08,Assembly,"Do pass and be re-referred to the Committee on [Privacy and Consumer Protection]",11,0,0,4,15
1849447,1429912,2024-04-16,Assembly,"Do pass as amended and be re-referred to the Committee on [Appropriations]",11,0,0,0,11
1849447,1443485,2024-05-15,Assembly,"Do pass",13,2,0,0,15
1849447,1449618,2024-05-23,Assembly,"AB 3138 Wilson Assembly Third Reading",65,0,0,15,80
1849447,1460664,2024-06-25,Senate,"Do pass, but first be re-referred to the Committee on [Judiciary]",14,0,0,1,15
1849447,1462662,2024-07-02,Senate,"Do pass as amended, but first amend, and re-refer to the Committee on [Appropriations]",10,0,0,1,11
1849447,1463889,2024-08-12,Senate,"Do pass",6,1,0,0,7
1849447,1467124,2024-08-31,Senate,"Assembly 3rd Reading AB3138 Wilson By Cortese",26,7,0,7,40
1849447,1467125,2024-08-31,Assembly,"AB 3138 Wilson Concurrence in Senate Amendments",67,0,0,12,79
1849448,1429970,2024-04-16,Assembly,"Do pass as amended and be re-referred to the Committee on [Judiciary]",11,0,0,0,11
1849448,1432957,2024-04-23,Assembly,"Do pass as amended, and be re-referred to the Committee on [Appropriations] with recommendation: To Consent Calendar",11,0,0,1,12
1849448,1444132,2024-05-16,Assembly,"Do pass",15,0,0,0,15
1849448,1448786,2024-05-22,Assembly,"AB 3139 Weber Assembly Third Reading",71,0,0,9,80
1849448,1458150,2024-06-18,Senate,"Do pass, but first be re-referred to the Committee on [Transportation]",10,0,0,1,11
1849448,1460626,2024-06-25,Senate,"Do pass, but first be re-referred to the Committee on [Appropriations]",13,0,0,2,15
1849448,1463522,2024-08-05,Senate,"Placed on suspense file",7,0,0,0,7
1849448,1464552,2024-08-15,Senate,"Do pass",6,0,0,1,7
1849449,1421140,2024-04-03,Assembly,"Do pass as amended and be re-referred to the Committee on [Appropriations]",7,0,0,0,7
1849450,1436917,2024-04-29,Assembly,"Do pass and be re-referred to the Committee on [Appropriations]",7,0,0,0,7
1849451,1423726,2024-04-09,Assembly,"Do pass and be re-referred to the Committee on [Appropriations]",8,1,0,2,11
1849451,1444024,2024-05-16,Assembly,"Do pass as amended",11,3,0,1,15
1849451,1446025,2024-05-21,Assembly,"AB 3142 Jones-Sawyer Assembly Third Reading",68,0,0,12,80
1849451,1456852,2024-06-12,Senate,"Do pass, but first be re-referred to the Committee on [Appropriations]",7,0,0,0,7
1849451,1459347,2024-06-24,Senate,"Placed on suspense file",6,0,0,1,7
1849451,1464308,2024-08-15,Senate,"Do pass",5,0,0,2,7
1849451,1465358,2024-08-20,Senate,"Assembly 3rd Reading AB3142 Jones-Sawyer By Durazo",36,0,0,4,40
1849452,1431053,2024-04-17,Assembly,"Do pass and be re-referred to the Committee on [Appropriations]",7,0,0,0,7
1849452,1441290,2024-05-08,Assembly,"Do pass",11,0,0,4,15
1849452,1446138,2024-05-21,Assembly,"AB 3143 Lowenthal Assembly Third Reading",69,0,0,11,80
1849452,1454218,2024-06-05,Senate,"Do pass, but first be re-referred to the Committee on [Appropriations]",4,0,0,1,5
1849452,1458021,2024-06-17,Senate,"Placed on suspense file",7,0,0,0,7
1849454,1433144,2024-04-23,Assembly,"Do pass and be re-referred to the Committee on [Appropriations]",5,0,0,2,7
1849454,1444647,2024-05-16,Assembly,"Do pass",15,0,0,0,15
1849454,1448661,2024-05-22,Assembly,"AB 3145 Bryan Assembly Third Reading",71,0,0,9,80
1849454,1462255,2024-07-01,Senate,"Do pass, but first be re-referred to the Committee on [Appropriations]",4,0,0,1,5
1849454,1466363,2024-08-29,Assembly,"AB 3145 Bryan Concurrence in Senate Amendments",75,0,0,4,79
1849454,1466866,2024-08-28,Senate,"Assembly 3rd Reading AB3145 Bryan et al. By Hurtado",39,0,0,1,40
1849456,1427310,2024-04-15,Assembly,"Do pass and be re-referred to the Committee on [Appropriations] with recommendation: To Consent Calendar",10,0,0,1,11
1849457,1418403,2024-04-01,Assembly,"Do pass and be re-referred to the Committee on [Appropriations] with recommendation: To Consent Calendar",8,0,0,1,9
1849457,1424830,2024-04-10,Assembly,"Do pass. To Consent Calendar",14,0,0,1,15
1849457,1431027,2024-04-18,Assembly,"AB 3148 Chen Consent Calendar Second Day Regular Session",72,0,0,8,80
1849457,1458506,2024-06-19,Senate,"Do pass, but first be re-referred to the Committee on [Appropriations]",6,0,0,1,7
1849457,1465410,2024-08-21,Senate,"Assembly 3rd Reading AB3148 Chen By Niello",33,0,0,7,40
1849457,1465898,2024-08-27,Assembly,"With recommendation: That Senate amendments be concurred in",8,0,0,1,9
1849457,1466883,2024-08-28,Assembly,"AB 3148 Chen Concurrence in Senate Amendments",77,0,0,2,79
1849458,1428914,2024-04-16,Assembly,"Do pass as amended, and be re-referred to the Committee on [Appropriations] with recommendation: To Consent Calendar",16,0,0,0,16
1849459,1423811,2024-04-08,Assembly,"Do pass as amended and be re-referred to the Committee on [Emergency Management]",11,0,0,0,11
1849459,1431872,2024-04-22,Assembly,"Do pass and be re-referred to the Committee on [Appropriations] with recommendation: To Consent Calendar",8,0,0,0,8
1849459,1444560,2024-05-16,Assembly,"Do pass",15,0,0,0,15
1849459,1448676,2024-05-22,Assembly,"AB 3150 Quirk-Silva Assembly Third Reading",70,1,0,9,80
1849459,1457953,2024-06-17,Senate,"Do pass as amended, but first amend, and re-refer to the Committee on [Governmental Organization]",8,2,0,1,11
1849459,1459960,2024-06-25,Senate,"Do pass, but first be re-referred to the Committee on [Appropriations]",14,0,0,2,16
1849459,1463539,2024-08-05,Senate,"Placed on suspense file",7,0,0,0,7
1849462,1431868,2024-04-22,Assembly,"Do pass and be re-referred to the Committee on [Appropriations]",5,2,0,8,15
1849462,1433128,2024-04-22,Assembly,Reconsideration,14,0,0,1,15
1849464,1428835,2024-04-16,Assembly,"Do pass and be re-referred to the Committee on [Natural Resources]",7,3,0,2,12
1849464,1431858,2024-04-22,Assembly,"Do pass and be re-referred to the Committee on [Appropriations]",7,3,0,1,11
1849464,1443925,2024-05-16,Assembly,"Do pass as amended",11,4,0,0,15
1849465,1433190,2024-04-23,Assembly,"Do pass as amended, and be re-referred to the Committee on [Appropriations] with recommendation: To Consent Calendar",16,0,0,0,16
1849465,1444051,2024-05-16,Assembly,"Do pass",15,0,0,0,15
1849465,1449535,2024-05-23,Assembly,"AB 3156 Joe Patterson Assembly Third Reading",66,0,0,14,80
1849465,1462541,2024-07-03,Senate,"Do pass as amended, but first amend, and re-refer to the Committee on [Appropriations]",11,0,0,0,11
1849465,1463494,2024-08-05,Senate,"Placed on suspense file",7,0,0,0,7
1849465,1464523,2024-08-15,Senate,"Do pass",7,0,0,0,7
1849465,1466596,2024-08-30,Senate,"Assembly 3rd Reading AB3156 Joe Patterson et al. By Grove",40,0,0,0,40
1849465,1467094,2024-08-31,Assembly,"AB 3156 Joe Patterson Concurrence in Senate Amendments",75,0,0,4,79
1849467,1429945,2024-04-16,Assembly,"Do pass and be re-referred to the Committee on [Appropriations]",11,0,0,0,11
1849467,1444147,2024-05-16,Assembly,"Do pass",15,0,0,0,15
1849467,1448701,2024-05-22,Assembly,"AB 3158 Berman Assembly Third Reading",70,0,0,10,80
1849467,1460534,2024-06-26,Senate,"Do pass, but first be re-referred to the Committee on [Appropriations]",7,0,0,0,7
1849467,1465412,2024-08-21,Senate,"Assembly 3rd Reading AB3158 Berman et al. By Cortese",33,0,0,7,40
1849469,1429994,2024-04-17,Assembly,"Do pass and be re-referred to the Committee on [Revenue and Taxation]",8,0,0,1,9
1849469,1436930,2024-04-29,Assembly,"Do pass and be re-referred to the Committee on [Appropriations]",6,0,0,1,7
1849469,1444223,2024-05-16,Assembly,"Do pass as amended",12,1,0,2,15
1849469,1448584,2024-05-22,Assembly,"AB 3160 Gabriel Assembly Third Reading",65,0,0,15,80
1849469,1458557,2024-06-18,Senate,"Do pass, but first be re-referred to the Committee on [Revenue and Taxation]",8,0,0,2,10
1849469,1460486,2024-06-26,Senate,"Do pass, but first be re-referred to the Committee on [Appropriations]",7,0,0,0,7
1849469,1463349,2024-08-05,Senate,"Placed on suspense file",7,0,0,0,7
1849469,1464127,2024-08-15,Senate,"Do pass as amended",5,2,0,0,7
1849469,1466248,2024-08-29,Senate,"Assembly 3rd Reading AB3160 Gabriel et al. By Ashby",33,5,0,2,40
1849469,1466473,2024-08-30,Assembly,"AB 3160 Gabriel Concurrence in Senate Amendments",69,1,0,9,79
1849470,1423927,2024-04-09,Assembly,"Do pass and be re-referred to the Committee on [Judiciary]",15,0,0,1,16
1849470,1428785,2024-04-16,Assembly,"Do pass and be re-referred to the Committee on [Appropriations]",11,0,0,1,12
1849470,1444384,2024-05-16,Assembly,"Do pass as amended",12,1,0,2,15
1849470,1446013,2024-05-21,Assembly,"AB 3161 Bonta Assembly Third Reading",70,0,0,10,80
1849470,1456905,2024-06-12,Senate,"Do pass, but first be re-referred to the Committee on [Judiciary]",10,0,0,1,11
1849470,1462567,2024-07-02,Senate,"Do pass, but first be re-referred to the Committee on [Appropriations]",11,0,0,0,11
1849470,1463648,2024-08-05,Senate,"Placed on suspense file",7,0,0,0,7
1849470,1464000,2024-08-15,Senate,"Do pass as amended",7,0,0,0,7
1849470,1465987,2024-08-27,Senate,"Assembly 3rd Reading AB3161 Bonta et al. By Roth",40,0,0,0,40
1849470,1466815,2024-08-28,Assembly,"AB 3161 Bonta Concurrence in Senate Amendments",75,0,0,4,79
1849471,1423763,2024-04-09,Assembly,"Do pass and be re-referred to the Committee on [Appropriations]",12,1,0,2,15
1849471,1429908,2024-04-17,Assembly,"Do pass",11,4,0,0,15
1849471,1431960,2024-04-22,Assembly,"AB 3162 Bennett Assembly Third Reading",51,10,0,19,80
1849471,1456309,2024-06-11,Senate,"Do pass, but first be re-referred to the Committee on [Appropriations]",11,0,0,0,11
1849471,1459406,2024-06-24,Senate,"Placed on suspense file",6,0,0,1,7
1849471,1464246,2024-08-15,Senate,"Do pass",7,0,0,0,7
1849471,1465669,2024-08-26,Senate,"Assembly 3rd Reading AB3162 Bennett et al. By Min",37,0,0,3,40
1849471,1466015,2024-08-27,Assembly,"AB 3162 Bennett Concurrence in Senate Amendments",59,10,0,10,79
1849472,1423856,2024-04-09,Assembly,"Do pass and be re-referred to the Committee on [Military and Veterans Affairs] with recommendation: To Consent Calendar",14,0,0,1,15
1849472,1433112,2024-04-23,Assembly,"Do pass and be re-referred to the Committee on [Appropriations]",9,0,0,1,10
1849476,1430096,2024-04-16,Assembly,"Do pass and be re-referred to the Committee on [Business and Professions]",11,0,0,0,11
1849476,1433088,2024-04-23,Assembly,"Do pass as amended and be re-referred to the Committee on [Appropriations]",17,0,0,1,18
1849476,1444382,2024-05-16,Assembly,"Do pass",15,0,0,0,15
1849476,1448808,2024-05-22,Assembly,"AB 3167 Chen Assembly Third Reading",71,0,0,9,80
1849476,1462017,2024-07-01,Senate,"Do pass, but first be re-referred to the Committee on [Education]",12,0,0,1,13
1849476,1462680,2024-07-03,Senate,"Do pass, but first be re-referred to the Committee on [Appropriations]",7,0,0,0,7
1849476,1463432,2024-08-05,Senate,"Placed on suspense file",7,0,0,0,7
1849477,1431902,2024-04-22,Assembly,"Do pass and be re-referred to the Committee on [Appropriations] with recommendation: To Consent Calendar",15,0,0,0,15
1849477,1443450,2024-05-15,Assembly,"Do pass. To Consent Calendar",15,0,0,0,15
1849477,1446046,2024-05-21,Assembly,"AB 3168 Gipson Consent Calendar Second Day Regular Session",71,0,0,9,80
1849477,1458152,2024-06-18,Senate,"Do pass, but first be re-referred to the Committee on [Appropriations] with the recommendation: To Consent Calendar",5,0,0,0,5
1849477,1465700,2024-08-26,Senate,"Assembly 3rd Reading AB3168 Gipson By Rubio",40,0,0,0,40
1849477,1465975,2024-08-27,Assembly,"AB 3168 Gipson Concurrence in Senate Amendments",77,0,0,2,79
1849480,1428986,2024-04-16,Assembly,"Do pass as amended and be re-referred to the Committee on [Appropriations]",8,0,0,0,8
1849481,1429978,2024-04-16,Assembly,"Do pass as amended and be re-referred to the Committee on [Judiciary]",11,0,0,0,11
1849481,1436910,2024-04-30,Assembly,"Do pass",9,0,0,3,12
1849481,1445209,2024-05-20,Assembly,"AB 3172 Lowenthal Assembly Third Reading",65,0,0,15,80
1849481,1460755,2024-06-25,Senate,"Do pass as amended",11,0,0,0,11
1849481,1463511,2024-08-05,Senate,"Placed on suspense file",7,0,0,0,7
1849481,1464135,2024-08-15,Senate,"Do pass as amended",5,1,0,1,7
1849485,1428848,2024-04-16,Assembly,"Do pass as amended",18,0,0,0,18
1849485,1441884,2024-05-09,Assembly,"AB 3176 Hoover Assembly Third Reading",67,0,0,13,80
1849486,1429883,2024-04-17,Assembly,"Do pass and be re-referred to the Committee on [Local Government]",7,0,0,2,9
1849486,1435206,2024-04-24,Assembly,"Do pass as amended and be re-referred to the Committee on [Appropriations]",7,1,0,1,9
1849486,1443487,2024-05-15,Assembly,"Do pass",11,4,0,0,15
1849486,1446058,2024-05-21,Assembly,"AB 3177 Wendy Carrillo Assembly Third Reading",57,12,0,11,80
1849486,1456455,2024-06-11,Senate,"Do pass as amended, but first amend, and re-refer to the Committee on [Housing]",5,2,0,0,7
1849486,1462681,2024-07-02,Senate,"Do pass, but first be re-referred to the Committee on [Appropriations]",7,2,0,1,10
1849486,1466000,2024-08-27,Senate,"Assembly 3rd Reading AB3177 Wendy Carrillo By Glazer",31,8,0,1,40
1849486,1466823,2024-08-28,Assembly,"AB 3177 Wendy Carrillo Concurrence in Senate Amendments",61,13,0,5,79
1849488,1420145,2024-04-03,Assembly,"Do pass. To Consent Calendar",21,0,0,1,22
1849488,1427316,2024-04-15,Assembly,"AB 3179 Blanca Rubio Assembly Third Reading",75,0,0,5,80
1849488,1458551,2024-06-19,Senate,"Do pass, but first be re-referred to the Committee on [Transportation]",6,0,0,1,7
1849488,1460481,2024-06-25,Senate,"Do pass as amended, but first amend, and re-refer to the Committee on [Appropriations]",15,0,0,0,15
1849488,1463455,2024-08-05,Senate,"Placed on suspense file",7,0,0,0,7
1849488,1464592,2024-08-15,Senate,"Do pass",7,0,0,0,7
1849488,1465509,2024-08-22,Senate,"Assembly 3rd Reading AB3179 Juan Carrillo By Hurtado",32,0,0,8,40
1849488,1466115,2024-08-29,Assembly,"With recommendation: That Senate amendments be concurred in",13,0,0,2,15
1849488,1466588,2024-08-30,Assembly,"AB 3179 Juan Carrillo Concurrence in Senate Amendments",71,0,0,8,79
1849491,1433059,2024-04-23,Assembly,"Do pass as amended and be re-referred to the Committee on [Appropriations]",13,0,0,2,15
1849491,1444242,2024-05-16,Assembly,"Do pass",15,0,0,0,15
1849491,1448595,2024-05-22,Assembly,"AB 3182 Lackey Assembly Third Reading",68,0,0,12,80
1849491,1457962,2024-06-17,Senate,"Do pass, but first be re-referred to the Committee on [Appropriations]",10,0,0,1,11
1849491,1462090,2024-07-01,Senate,"Placed on suspense file",7,0,0,0,7
1849493,1434226,2024-04-24,Assembly,"Do pass and be re-referred to the Committee on [Appropriations] with recommendation: To Consent Calendar",8,0,0,0,8
1849493,1441281,2024-05-08,Assembly,"Do pass. To Consent Calendar",15,0,0,0,15
1849493,1443901,2024-05-16,Assembly,"AB 3184 Berman Consent Calendar Second Day Regular Session",71,0,0,9,80
1849493,1462351,2024-07-02,Senate,"Do pass, but first be re-referred to the Committee on [Appropriations]",7,0,0,0,7
1849493,1463956,2024-08-14,Senate,"That the measure be returned to Senate Floor for consideration. Ordered to third reading",5,0,0,2,7
1849493,1465482,2024-08-22,Senate,"Assembly 3rd Reading AB3184 Berman By Blakespear Urgency Clause",31,0,0,9,40
1849493,1466113,2024-08-29,Assembly,"With recommendation: That Senate amendments be concurred in",8,0,0,0,8
1849493,1466442,2024-08-30,Assembly,"AB 3184 Berman Concurrence - Urgency Added",76,0,0,3,79
1849495,1431001,2024-04-17,Assembly,"Do pass and be re-referred to the Committee on [Appropriations]",5,0,0,2,7
1849495,1444250,2024-05-16,Assembly,"Do pass as amended",11,2,0,2,15
1849495,1448733,2024-05-22,Assembly,"AB 3186 Petrie-Norris Assembly Third Reading",61,0,0,19,80
1849499,1431014,2024-04-17,Assembly,"Do pass and be re-referred to the Committee on [Appropriations]",7,0,0,0,7
1849499,1444398,2024-05-16,Assembly,"Do pass as amended",11,0,0,4,15
1849499,1449645,2024-05-23,Assembly,"AB 3190 Haney Assembly Third Reading",65,0,0,15,80
1849499,1460723,2024-06-26,Senate,"Do pass, but first be re-referred to the Committee on [Appropriations]",4,1,0,0,5
1849499,1463577,2024-08-05,Senate,"Placed on suspense file",7,0,0,0,7
1849499,1464625,2024-08-15,Senate,"Do pass as amended",5,2,0,0,7
1849499,1466250,2024-08-29,Assembly,"AB 3190 Haney Concurrence in Senate Amendments",68,0,0,11,79
1849499,1466791,2024-08-28,Senate,"Assembly 3rd Reading AB3190 Haney et al. By Wiener",28,7,0,5,40
1849501,1423859,2024-04-08,Assembly,"Do pass as amended and be re-referred to the Committee on [Judiciary]",5,3,0,3,11
1849501,1423860,2024-04-08,Assembly,Reconsideration,11,0,0,0,11
1849501,1431879,2024-04-22,Assembly,"Do pass and be re-referred to the Committee on [Judiciary]",6,3,0,2,11
1849501,1433051,2024-04-23,Assembly,"Do pass as amended and be re-referred to the Committee on [Appropriations]",8,3,0,1,12
1849502,1423812,2024-04-09,Assembly,"Do pass and be re-referred to the Committee on [Appropriations] with recommendation: To Consent Calendar",6,0,0,1,7
1849502,1434232,2024-04-24,Assembly,"Do pass. To Consent Calendar",14,0,0,1,15
1849502,1438439,2024-05-02,Assembly,"AB 3193 Calderon Consent Calendar Second Day Regular Session",73,0,0,7,80
1849502,1460063,2024-06-25,Senate,"Do pass as amended, but first amend, and re-refer to the Committee on [Human Services]",12,0,0,4,16
1849502,1462322,2024-07-01,Senate,"Do pass, but first be re-referred to the Committee on [Appropriations]",5,0,0,0,5
1849502,1463487,2024-08-05,Senate,"Placed on suspense file",7,0,0,0,7
1849502,1464445,2024-08-15,Senate,"Do pass as amended",7,0,0,0,7
1849502,1465788,2024-08-27,Senate,"Assembly 3rd Reading AB3193 Calderon By Grove",40,0,0,0,40
1849502,1467227,2024-08-28,Assembly,"AB 3193 Calderon Concurrence in Senate Amendments",76,0,0,3,79
1849505,1428988,2024-04-16,Assembly,"Do pass. To Consent Calendar",12,0,0,0,12
1849505,1431923,2024-04-22,Assembly,"AB 3196 Stephanie Nguyen Consent Calendar Second Day Regular Session",68,0,0,12,80
1849505,1456380,2024-06-11,Senate,"Do pass, but first be re-referred to the Committee on [Appropriations] with the recommendation: To Consent Calendar",11,0,0,0,11
1849505,1459400,2024-06-24,Senate,"Placed on suspense file",6,0,0,1,7
1849506,1424908,2024-04-10,Assembly,"Do pass as amended. To Consent Calendar",8,0,0,0,8
1849506,1431068,2024-04-18,Assembly,"AB 3197 Lackey Consent Calendar Second Day Regular Session",72,0,0,8,80
1849506,1456389,2024-06-11,Senate,"Do pass and be ordered to the Consent Calendar",7,0,0,0,7
1849506,1458025,2024-06-17,Senate,"Consent Calendar 2nd AB3197 Lackey",39,0,0,1,40
1849506,1459394,2024-06-24,Assembly,"AB 3197 Lackey Concurrence in Senate Amendments",75,0,0,4,79
1849507,1438470,2024-05-01,Assembly,"Do pass. To Consent Calendar",9,0,0,0,9
1849507,1441970,2024-05-09,Assembly,"AB 3198 Garcia Consent Calendar Second Day Regular Session",65,0,0,15,80
1849507,1462658,2024-07-03,Senate,"Do pass",7,0,0,0,7
1849507,1465491,2024-08-22,Senate,"Special Consent AB3198 Garcia et al",33,0,0,7,40
1849512,1420071,2024-04-03,Assembly,"Do pass and be re-referred to the Committee on [Appropriations]",21,0,0,1,22
1849512,1444429,2024-05-16,Assembly,"Do pass",15,0,0,0,15
1849512,1448691,2024-05-22,Assembly,"AB 3203 Aguiar-Curry Assembly Third Reading",70,0,0,10,80
1849512,1456424,2024-06-11,Senate,"Do pass, but first be re-referred to the Committee on [Appropriations]",15,0,0,1,16
1849512,1462007,2024-07-01,Senate,"Placed on suspense file",7,0,0,0,7
1849512,1464223,2024-08-15,Senate,"Do pass",7,0,0,0,7
1849512,1466636,2024-08-28,Senate,"Special Consent AB3203 Aguiar-Curry et al. By Wilk",39,0,0,1,40
1849513,1435317,2024-04-23,Assembly,"Do pass and be re-referred to the Committee on [Appropriations]",8,0,0,3,11
1849515,1429950,2024-04-17,Assembly,"Do pass as amended",12,2,0,8,22
1849515,1441304,2024-05-08,Assembly,"Do pass",12,1,0,2,15
1849515,1445944,2024-05-21,Assembly,"AB 3206 McKinnor Assembly Third Reading",55,8,0,17,80
1849515,1456339,2024-06-11,Senate,"Do pass, but first be re-referred to the Committee on [Appropriations]",9,4,0,3,16
1849515,1465376,2024-08-20,Senate,"Assembly 3rd Reading AB3206 McKinnor By Wiener",23,12,0,5,40
1849515,1465377,2024-08-20,Senate,"Assembly 3rd Reading AB3206 McKinnor By Wiener Reconsider",39,0,0,1,40
1849515,1465378,2024-08-20,Senate,"Assembly 3rd Reading AB3206 McKinnor By Wiener",21,14,0,5,40
1849516,1428760,2024-04-16,Assembly,"Do pass and be re-referred to the Committee on [Privacy and Consumer Protection]",5,0,0,2,7
1849516,1435340,2024-04-23,Assembly,"Do pass as amended, and be re-referred to the Committee on [Appropriations] with recommendation: To Consent Calendar",11,0,0,0,11
1849518,1424884,2024-04-09,Assembly,"Do pass and be re-referred to the Committee on [Appropriations]",8,0,0,0,8
1849518,1444026,2024-05-16,Assembly,"Do pass as amended",10,0,0,5,15
1849518,1448618,2024-05-22,Assembly,"AB 3209 Berman Assembly Third Reading",68,1,0,11,80
1849518,1456404,2024-06-11,Senate,"Do pass, but first be re-referred to the Committee on [Appropriations]",4,0,0,1,5
1849518,1457951,2024-06-17,Senate,"Placed on suspense file",2,3,0,2,7
1849518,1457952,2024-06-17,Senate,"Do pass as amended",5,0,0,2,7
1849518,1463813,2024-08-08,Senate,"Assembly 3rd Reading AB3209 Berman et al. By Wiener",38,0,0,2,40
1849518,1463857,2024-08-12,Assembly,"AB 3209 Berman Concurrence in Senate Amendments",69,5,0,5,79
1849520,1430097,2024-04-16,Assembly,"Do pass as amended and be re-referred to the Committee on [Judiciary]",10,0,0,1,11
1849520,1433149,2024-04-23,Assembly,"Do pass and be re-referred to the Committee on [Appropriations]",10,0,0,2,12
1849520,1444573,2024-05-16,Assembly,"Do pass",14,0,0,1,15
1849520,1448574,2024-05-22,Assembly,"AB 3211 Wicks Assembly Third Reading",62,0,0,18,80
1849520,1458229,2024-06-18,Senate,"Do pass as amended, but first amend, and re-refer to the Committee on [Governmental Organization]",8,2,0,1,11
1849520,1460046,2024-06-25,Senate,"Do pass, but first be re-referred to the Committee on [Appropriations]",10,2,0,4,16
1849520,1463601,2024-08-05,Senate,"Placed on suspense file",7,0,0,0,7
1849520,1464586,2024-08-15,Senate,"Do pass",4,2,0,1,7
1849525,1421138,2024-04-03,Assembly,"Do pass and be re-referred to the Committee on [Appropriations]",7,0,0,0,7
1849525,1444281,2024-05-16,Assembly,"Do pass as amended",11,0,0,4,15
1849525,1449597,2024-05-23,Assembly,"AB 3216 Hoover Assembly Third Reading",69,0,0,11,80
1849525,1460578,2024-06-26,Senate,"Do pass, but first be re-referred to the Committee on [Appropriations]",7,0,0,0,7
1849525,1463445,2024-08-05,Senate,"Placed on suspense file",7,0,0,0,7
1849525,1464301,2024-08-15,Senate,"Do pass as amended",7,0,0,0,7
1849525,1465958,2024-08-27,Senate,"Assembly 3rd Reading AB3216 Hoover et al. By Allen",38,1,0,1,40
1849525,1466684,2024-08-28,Assembly,"AB 3216 Hoover Concurrence in Senate Amendments",76,0,0,3,79
1849526,1423744,2024-04-09,Assembly,"Do pass and be re-referred to the Committee on [Appropriations]",6,0,0,1,7
1849526,1443482,2024-05-15,Assembly,"Do pass",15,0,0,0,15
1849526,1446071,2024-05-21,Assembly,"AB 3217 Bryan Assembly Third Reading",74,0,0,6,80
1849526,1458207,2024-06-17,Senate,"Do pass as amended, but first amend, and re-refer to the Committee on [Appropriations]",4,0,0,1,5
1849526,1458208,2024-06-17,Senate,"[06-18-2024] set for [First] hearing: Reconsideration of favorable vote granted",5,0,0,0,5
1849526,1458209,2024-06-17,Senate,"Do pass as amended, but first amend, and re-refer to the Committee on [Appropriations]",5,0,0,0,5
1849526,1462034,2024-07-01,Senate,"Placed on suspense file",7,0,0,0,7
1849527,1423721,2024-04-09,Assembly,"Do pass and be re-referred to the Committee on [Judiciary]",12,0,0,4,16
1849527,1428790,2024-04-16,Assembly,"Do pass and be re-referred to the Committee on [Appropriations]",10,0,0,2,12
1849527,1444433,2024-05-16,Assembly,"Do pass as amended",11,1,0,3,15
1849527,1445950,2024-05-21,Assembly,"AB 3218 Wood Assembly Third Reading",55,4,0,21,80
1849527,1460638,2024-06-26,Senate,"Do pass as amended, but first amend, and re-refer to the Committee on [Judiciary]",9,1,0,1,11
1849527,1462543,2024-07-02,Senate,"Do pass, but first be re-referred to the Committee on [Appropriations]",10,1,0,0,11
1849527,1463447,2024-08-05,Senate,"Placed on suspense file",7,0,0,0,7
1849527,1464076,2024-08-15,Senate,"Do pass as amended",4,2,0,1,7
1849527,1465957,2024-08-27,Senate,"Assembly 3rd Reading AB3218 Wood et al. By Glazer",30,7,0,3,40
1849527,1466704,2024-08-28,Assembly,"AB 3218 Wood Concurrence in Senate Amendments",65,2,0,12,79
1849529,1433052,2024-04-23,Assembly,"Do pass and be re-referred to the Committee on [Appropriations] with recommendation: To Consent Calendar",14,0,0,1,15
1849529,1441309,2024-05-08,Assembly,"Do pass. To Consent Calendar",15,0,0,0,15
1849529,1444172,2024-05-16,Assembly,"AB 3220 Papan Consent Calendar Second Day Regular Session",71,0,0,9,80
1849529,1457987,2024-06-17,Senate,"Do pass as amended, but first amend, and re-refer to the Committee on [Appropriations]",11,0,0,0,11
1849529,1463395,2024-08-05,Senate,"Placed on suspense file",7,0,0,0,7
1849530,1428841,2024-04-16,Assembly,"Do pass and be re-referred to the Committee on [Appropriations] with recommendation: To Consent Calendar",16,0,0,0,16
1849530,1437625,2024-05-01,Assembly,"Do pass",14,0,0,1,15
1849530,1442603,2024-05-13,Assembly,"AB 3221 Pellerin Assembly Third Reading",71,0,0,9,80
1849530,1456929,2024-06-12,Senate,"Do pass, but first be re-referred to the Committee on [Appropriations]",10,0,0,1,11
1849530,1465416,2024-08-21,Senate,"Assembly 3rd Reading AB3221 Pellerin et al. By Rubio",32,0,0,8,40
1849530,1465595,2024-08-26,Assembly,"AB 3221 Pellerin Concurrence in Senate Amendments",77,0,0,2,79
1849531,1433083,2024-04-23,Assembly,"Do pass and be re-referred to the Committee on [Appropriations] with recommendation: To Consent Calendar",8,0,0,0,8
1849532,1421188,2024-04-03,Assembly,"Do pass and be re-referred to the Committee on [Human Services] with recommendation: To Consent Calendar",7,0,0,0,7
1849532,1433158,2024-04-23,Assembly,"Do pass and be re-referred to the Committee on [Appropriations] with recommendation: To Consent Calendar",6,0,0,1,7
1849532,1441313,2024-05-08,Assembly,"Do pass. To Consent Calendar",15,0,0,0,15
1849532,1443935,2024-05-16,Assembly,"AB 3223 Wilson Consent Calendar Second Day Regular Session",71,0,0,9,80
1849532,1454238,2024-06-05,Senate,"Do pass, but first be re-referred to the Committee on [Appropriations]",7,0,0,0,7
1849532,1457945,2024-06-17,Senate,"Placed on suspense file",7,0,0,0,7
1849532,1464533,2024-08-15,Senate,"Do pass",6,0,0,1,7
1849532,1466513,2024-08-30,Senate,"Assembly 3rd Reading AB3223 Wilson By Lim√≥n",40,0,0,0,40
1849532,1467055,2024-08-31,Assembly,"AB 3223 Wilson Concurrence in Senate Amendments",76,0,0,3,79
1849536,1431856,2024-04-22,Assembly,"Do pass as amended and be re-referred to the Committee on [Appropriations]",11,0,0,0,11
1849536,1441397,2024-05-08,Assembly,"Do pass. To Consent Calendar",15,0,0,0,15
1849536,1444535,2024-05-16,Assembly,"AB 3227 Alvarez Consent Calendar Second Day Regular Session",71,0,0,9,80
1849536,1458438,2024-06-19,Senate,"Do pass, but first be re-referred to the Committee on [Natural Resources and Water] with the recommendation: To Consent Calendar",7,0,0,0,7
1849536,1460075,2024-06-25,Senate,"Do pass, but first be re-referred to the Committee on [Appropriations]",10,0,0,1,11
1849536,1467232,2024-08-28,Senate,"Assembly 3rd Reading AB3227 Alvarez By Atkins Urgency Clause",40,0,0,0,40
1849538,1433195,2024-04-23,Assembly,"Do pass and be re-referred to the Committee on [Appropriations] with recommendation: To Consent Calendar",6,0,0,1,7
1849538,1441364,2024-05-08,Assembly,"Do pass. To Consent Calendar",15,0,0,0,15
1849538,1444542,2024-05-16,Assembly,"AB 3229 Lee Consent Calendar Second Day Regular Session",71,0,0,9,80
1849538,1458158,2024-06-17,Senate,"Do pass, but first be re-referred to the Committee on [Appropriations]",5,0,0,0,5
1849538,1462033,2024-07-01,Senate,"Placed on suspense file",7,0,0,0,7
1849538,1464623,2024-08-15,Senate,"Do pass as amended",7,0,0,0,7
1849538,1466507,2024-08-30,Senate,"Special Consent AB3229 Lee By Hurtado",40,0,0,0,40
1849538,1466958,2024-08-31,Assembly,"AB 3229 Lee Concurrence in Senate Amendments",76,0,0,3,79
1849542,1423872,2024-04-08,Assembly,"Do pass and be re-referred to the Committee on [Utilities and Energy]",8,3,0,0,11
1849542,1444295,2024-05-16,Assembly,"Do pass",11,4,0,0,15
1849542,1448648,2024-05-22,Assembly,"AB 3233 Addis Assembly Third Reading",43,14,0,23,80
1849542,1457943,2024-06-17,Senate,"Do pass as amended, but first amend, and re-refer to the Committee on [Local Government]",7,4,0,0,11
1849542,1462600,2024-07-03,Senate,"Do pass, but first be re-referred to the Committee on [Appropriations]",4,2,0,1,7
1849542,1463521,2024-08-05,Senate,"Placed on suspense file",7,0,0,0,7
1849542,1464464,2024-08-15,Senate,"Do pass",5,2,0,0,7
1849542,1466227,2024-08-29,Senate,"Assembly 3rd Reading AB3233 Addis et al. By Laird",20,14,0,6,40
1849542,1466228,2024-08-29,Senate,"Assembly 3rd Reading AB3233 Addis et al. By Laird Reconsider",40,0,0,0,40
1849542,1466754,2024-08-31,Senate,"Assembly 3rd Reading AB3233 Addis et al. By Laird",21,12,0,7,40
1849542,1466755,2024-08-31,Assembly,"AB 3233 Addis Concurrence in Senate Amendments",46,15,0,18,79
1849543,1421178,2024-04-03,Assembly,"Do pass and be re-referred to the Committee on [Appropriations] with recommendation: To Consent Calendar",7,0,0,0,7
1849543,1437614,2024-05-01,Assembly,"Do pass. To Consent Calendar",14,0,0,1,15
1849543,1441945,2024-05-09,Assembly,"AB 3234 Ortega Consent Calendar Second Day Regular Session",65,0,0,15,80
1849543,1454191,2024-06-05,Senate,"Do pass, but first be re-referred to the Committee on [Appropriations]",5,0,0,0,5
1849543,1465363,2024-08-20,Senate,"Assembly 3rd Reading AB3234 Ortega By Cortese",36,0,0,4,40
1849543,1465571,2024-08-26,Assembly,"AB 3234 Ortega Concurrence in Senate Amendments By KALRA",77,0,0,2,79
1849544,1432981,2024-04-23,Assembly,"Do pass and be re-referred to the Committee on [Appropriations] with recommendation: To Consent Calendar",8,0,0,0,8
1849544,1441376,2024-05-08,Assembly,"Do pass. To Consent Calendar",15,0,0,0,15
1849544,1444402,2024-05-16,Assembly,"AB 3235 Bryan Consent Calendar Second Day Regular Session",71,0,0,9,80
1849544,1459968,2024-06-25,Senate,"Do pass, but first be re-referred to the Committee on [Appropriations] with the recommendation: To Consent Calendar",5,0,0,0,5
1849544,1463884,2024-08-12,Senate,"Consent Calendar 2nd AB3235 Bryan",38,0,0,2,40
1849544,1465286,2024-08-19,Assembly,"AB 3235 Bryan Concurrence in Senate Amendments",77,0,0,2,79
1849545,1428888,2024-04-16,Assembly,"Do pass and be re-referred to the Committee on [Appropriations]",7,0,0,0,7
1849547,1420205,2024-04-03,Assembly,"Do pass as amended and be re-referred to the Committee on [Water, Parks, and Wildlife]",13,1,0,2,16
1849547,1428788,2024-04-16,Assembly,"Do pass as amended and be re-referred to the Committee on [Natural Resources]",13,0,0,2,15
1849547,1431981,2024-04-22,Assembly,"Do pass as amended and be re-referred to the Committee on [Appropriations]",10,0,0,1,11
1849547,1444313,2024-05-16,Assembly,"Do pass as amended",11,0,0,4,15
1849547,1448581,2024-05-22,Assembly,"AB 3238 Garcia Assembly Third Reading",62,0,0,18,80
1849547,1459336,2024-06-24,Senate,"Do pass, but first be re-referred to the Committee on [Environmental Quality]",13,0,0,5,18
1849547,1462698,2024-07-03,Senate,"Do pass as amended, but first amend, and re-refer to the Committee on [Appropriations]",6,0,0,1,7
1849547,1463852,2024-08-12,Senate,"Placed on suspense file",7,0,0,0,7
1849548,1434136,2024-04-24,Assembly,"Do pass",7,0,0,1,8
1849548,1448573,2024-05-22,Assembly,"AB 3239 Wendy Carrillo Assembly Third Reading",56,0,0,24,80
1849549,1433181,2024-04-23,Assembly,"Do pass and be re-referred to the Committee on [Appropriations] with recommendation: To Consent Calendar",10,0,0,1,11
1849549,1441340,2024-05-08,Assembly,"Do pass. To Consent Calendar",15,0,0,0,15
1849549,1444505,2024-05-16,Assembly,"AB 3240 Calderon Consent Calendar Second Day Regular Session",71,0,0,9,80
1849549,1460595,2024-06-26,Senate,"Do pass, but first be re-referred to the Committee on [Appropriations]",7,0,0,0,7
1849549,1465837,2024-08-27,Senate,"Assembly 3rd Reading AB3240 Calderon et al. By Skinner",40,0,0,0,40
1849549,1466783,2024-08-28,Assembly,"AB 3240 Calderon Concurrence in Senate Amendments",77,0,0,2,79
1849550,1424997,2024-04-09,Assembly,"Do pass and be re-referred to the Committee on [Appropriations]",8,0,0,0,8
1849550,1444369,2024-05-16,Assembly,"Do pass as amended",11,0,0,4,15
1849550,1449674,2024-05-23,Assembly,"AB 3241 Pacheco Assembly Third Reading",66,0,0,14,80
1849550,1462224,2024-07-02,Senate,"Do pass as amended, but first amend, and re-refer to the Committee on [Appropriations]",3,0,0,2,5
1849550,1463629,2024-08-05,Senate,"Placed on suspense file",7,0,0,0,7
1849550,1464195,2024-08-15,Senate,"Do pass as amended",7,0,0,0,7
1849551,1429962,2024-04-17,Assembly,"Do pass and be re-referred to the Committee on [Appropriations] with recommendation: To Consent Calendar",21,0,0,1,22
1849552,1431904,2024-04-22,Assembly,"Do pass and be re-referred to the Committee on [Appropriations] with recommendation: To Consent Calendar",15,0,0,0,15
1849554,1433200,2024-04-23,Assembly,"Do pass as amended",16,0,0,0,16
1849554,1438469,2024-05-02,Assembly,"AB 3245 Joe Patterson Assembly Third Reading",72,0,0,8,80
1849554,1454224,2024-06-05,Senate,"Do pass as amended, but first amend, and re-refer to the Committee on [Appropriations]",10,0,0,1,11
1849554,1458027,2024-06-17,Senate,"Placed on suspense file",7,0,0,0,7
1849554,1464107,2024-08-15,Senate,"Do pass",7,0,0,0,7
1849554,1466172,2024-08-29,Assembly,"AB 3245 Joe Patterson Concurrence in Senate Amendments",76,0,0,3,79
1849554,1466660,2024-08-28,Senate,"Special Consent AB3245 Joe Patterson By Ashby",39,0,0,1,40
1849555,1430024,2024-04-17,Assembly,"Do pass and be re-referred to the Committee on [Appropriations]",16,0,0,0,16
1849555,1444135,2024-05-16,Assembly,"Do pass",15,0,0,0,15
1849555,1449620,2024-05-23,Assembly,"AB 3246 Garcia Assembly Third Reading",70,0,0,10,80
1849555,1459380,2024-06-24,Senate,"Do pass, but first be re-referred to the Committee on [Appropriations]",15,0,0,3,18
1849555,1463669,2024-08-05,Senate,"Placed on suspense file",7,0,0,0,7
1849556,1420032,2024-04-03,Assembly,"Do pass and be re-referred to the Committee on [Appropriations] with recommendation: To Consent Calendar",16,0,0,0,16
1849556,1429941,2024-04-17,Assembly,"Do pass. To Consent Calendar",15,0,0,0,15
1849556,1435332,2024-04-25,Assembly,"AB 3247 Irwin Consent Calendar Second Day Regular Session",75,0,0,5,80
1849560,1433111,2024-04-23,Assembly,"Do pass as amended",17,0,0,1,18
1849560,1444030,2024-05-16,Assembly,"Do pass",15,0,0,0,15
1849560,1448805,2024-05-22,Assembly,"AB 3251 Business and Professions Assembly Third Reading By BERMAN",71,0,0,9,80
1849560,1462093,2024-07-01,Senate,"Do pass, but first be re-referred to the Committee on [Appropriations]",13,0,0,0,13
1849560,1463517,2024-08-05,Senate,"Placed on suspense file",7,0,0,0,7
1849560,1464242,2024-08-15,Senate,"Do pass",7,0,0,0,7
1849560,1466251,2024-08-29,Assembly,"AB 3251 Berman Concurrence in Senate Amendments",76,0,0,3,79
1849560,1467221,2024-08-28,Senate,"Special Consent AB3251 Berman et al. By Ashby",39,0,0,1,40
1849561,1433122,2024-04-23,Assembly,"Do pass and be re-referred to the Committee on [Appropriations] with recommendation: To Consent Calendar",17,0,0,1,18
1849561,1444149,2024-05-16,Assembly,"Do pass",15,0,0,0,15
1849561,1448611,2024-05-22,Assembly,"AB 3252 Business and Professions Assembly Third Reading By BERMAN",71,0,0,9,80
1849561,1462029,2024-07-01,Senate,"Do pass as amended, but first amend, and re-refer to the Committee on [Appropriations]",12,0,0,1,13
1849561,1463418,2024-08-05,Senate,"Placed on suspense file",7,0,0,0,7
1849561,1464574,2024-08-15,Senate,"Do pass",7,0,0,0,7
1849561,1465936,2024-08-27,Senate,"Assembly 3rd Reading AB3252 Berman et al. By Ashby",39,0,0,1,40
1849561,1467200,2024-08-28,Assembly,"AB 3252 Berman Concurrence in Senate Amendments",75,0,0,4,79
1849562,1433159,2024-04-23,Assembly,"Do pass and be re-referred to the Committee on [Appropriations] with recommendation: To Consent Calendar",17,0,0,1,18
1849562,1444420,2024-05-16,Assembly,"Do pass",15,0,0,0,15
1849562,1448552,2024-05-22,Assembly,"AB 3253 Business and Professions Assembly Third Reading By BERMAN",71,0,0,9,80
1849562,1461995,2024-07-01,Senate,"Do pass, but first be re-referred to the Committee on [Appropriations]",13,0,0,0,13
1849562,1463579,2024-08-05,Senate,"Placed on suspense file",7,0,0,0,7
1849562,1464369,2024-08-15,Senate,"Do pass",7,0,0,0,7
1849562,1465929,2024-08-27,Senate,"Assembly 3rd Reading AB3253 Berman et al. By Ashby",40,0,0,0,40
1849562,1467234,2024-08-28,Assembly,"AB 3253 Berman Concurrence in Senate Amendments",76,0,0,3,79
1849563,1433090,2024-04-23,Assembly,"Do pass and be re-referred to the Committee on [Appropriations] with recommendation: To Consent Calendar",17,0,0,1,18
1849563,1444491,2024-05-16,Assembly,"Do pass",15,0,0,0,15
1849563,1448633,2024-05-22,Assembly,"AB 3254 Business and Professions Assembly Third Reading By BERMAN",71,0,0,9,80
1849563,1462080,2024-07-01,Senate,"Do pass, but first be re-referred to the Committee on [Appropriations]",13,0,0,0,13
1849563,1463617,2024-08-05,Senate,"Placed on suspense file",7,0,0,0,7
1849563,1464600,2024-08-15,Senate,"Do pass as amended",7,0,0,0,7
1849563,1466502,2024-08-30,Senate,"Special Consent AB3254 Berman et al. By Ashby",40,0,0,0,40
1849563,1467180,2024-08-31,Assembly,"AB 3254 Berman Concurrence in Senate Amendments",77,0,0,2,79
1849564,1433044,2024-04-23,Assembly,"Do pass as amended and be re-referred to the Committee on [Appropriations]",17,0,0,1,18
1849564,1444214,2024-05-16,Assembly,"Do pass",15,0,0,0,15
1849564,1448770,2024-05-22,Assembly,"AB 3255 Business and Professions Assembly Third Reading By BERMAN",71,0,0,9,80
1849564,1461987,2024-07-01,Senate,"Do pass, but first be re-referred to the Committee on [Appropriations]",13,0,0,0,13
1849564,1463495,2024-08-05,Senate,"Placed on suspense file",7,0,0,0,7
1849564,1464385,2024-08-15,Senate,"Do pass as amended",7,0,0,0,7
1849564,1466568,2024-08-30,Senate,"Special Consent AB3255 Berman et al. By Ashby",40,0,0,0,40
1849564,1467203,2024-08-31,Assembly,"AB 3255 Berman Concurrence in Senate Amendments",77,0,0,2,79
1849565,1434170,2024-04-24,Assembly,"Do pass as amended and be re-referred to the Committee on [Appropriations]",14,0,0,2,16
1849565,1444049,2024-05-16,Assembly,"Do pass",13,2,0,0,15
1849565,1448724,2024-05-22,Assembly,"AB 3256 Irwin Assembly Third Reading",63,0,0,17,80
1849565,1462358,2024-07-02,Senate,"Do pass as amended, but first amend, and re-refer to the Committee on [Appropriations]",17,0,0,1,18
1849565,1463505,2024-08-05,Senate,"Placed on suspense file",7,0,0,0,7
1849567,1430999,2024-04-17,Assembly,"Do pass and be re-referred to the Committee on [Appropriations] with recommendation: To Consent Calendar",7,0,0,0,7
1849567,1441297,2024-05-08,Assembly,"Do pass. To Consent Calendar",15,0,0,0,15
1849567,1443990,2024-05-16,Assembly,"AB 3258 Bryan Consent Calendar Second Day Regular Session",71,0,0,9,80
1849567,1456925,2024-06-12,Senate,"Do pass, but first be re-referred to the Committee on [Appropriations] with the recommendation: To Consent Calendar",5,0,0,0,5
1849567,1461253,2024-06-27,Senate,"Consent Calendar 2nd AB3258 Bryan",40,0,0,0,40
1849567,1465747,2024-08-26,Senate,"Assembly 3rd Reading AB3258 Bryan By Durazo",40,0,0,0,40
1849567,1465921,2024-08-27,Assembly,"AB 3258 Bryan Concurrence in Senate Amendments",77,0,0,2,79
1849568,1431067,2024-04-17,Assembly,"Do pass as amended and be re-referred to the Committee on [Revenue and Taxation]",7,0,0,2,9
1849568,1436908,2024-04-29,Assembly,"Do pass as amended",5,1,0,1,7
1849568,1449592,2024-05-23,Assembly,"AB 3259 Wilson Assembly Third Reading",49,15,0,16,80
1849568,1456285,2024-06-11,Senate,"Do pass, but first be re-referred to the Committee on [Revenue and Taxation]",5,2,0,0,7
1849568,1460474,2024-06-26,Senate,"Do pass",6,1,0,0,7
1849568,1463959,2024-08-14,Senate,"That the measure be returned to Senate Floor for consideration. Ordered to third reading",4,2,0,1,7
1849568,1466449,2024-08-30,Assembly,"With recommendation: That Senate amendments be concurred in",7,1,0,1,9
1849568,1467194,2024-08-28,Senate,"Assembly 3rd Reading AB3259 Wilson By Dodd Urgency Clause",31,8,0,1,40
1849568,1467195,2024-08-31,Assembly,"AB 3259 Wilson Concurrence - Urgency Added",54,17,0,8,79
1849569,1428944,2024-04-16,Assembly,"Do pass and be re-referred to the Committee on [Appropriations]",13,1,0,2,16
1849569,1444553,2024-05-16,Assembly,"Do pass as amended",11,2,0,2,15
1849569,1446069,2024-05-21,Assembly,"AB 3260 Pellerin Assembly Third Reading",57,1,0,22,80
1849569,1460461,2024-06-26,Senate,"Do pass as amended, but first amend, and re-refer to the Committee on [Appropriations]",9,0,0,2,11
1849569,1463500,2024-08-05,Senate,"Placed on suspense file",7,0,0,0,7
1849570,1429952,2024-04-17,Assembly,"Do pass as amended and be re-referred to the Committee on [Appropriations]",20,0,0,2,22
1849570,1441306,2024-05-08,Assembly,"Do pass. To Consent Calendar",15,0,0,0,15
1849570,1444476,2024-05-16,Assembly,"AB 3261 Mike Fong Consent Calendar Second Day Regular Session",71,0,0,9,80
1849570,1456456,2024-06-11,Senate,"Do pass, but first be re-referred to the Committee on [Appropriations] with the recommendation: To Consent Calendar",15,0,0,1,16
1849570,1466840,2024-08-31,Senate,"Assembly 3rd Reading AB3261 Mike Fong et al. By Rubio",40,0,0,0,40
1849570,1466841,2024-08-31,Assembly,"AB 3261 Mike Fong Concurrence in Senate Amendments",74,0,0,5,79
1849571,1421127,2024-04-03,Assembly,"Do pass as amended. To Consent Calendar",7,0,0,0,7
1849571,1427216,2024-04-15,Assembly,"AB 3262 Maienschein Assembly Third Reading",75,0,0,5,80
1849571,1451552,2024-05-29,Senate,"Do pass and be ordered to the Consent Calendar",7,0,0,0,7
1849571,1454825,2024-06-06,Senate,"Consent Calendar 2nd AB3262 Maienschein",32,0,0,8,40
1849572,1434160,2024-04-24,Assembly,"Do pass and be re-referred to the Committee on [Appropriations]",12,0,0,4,16
1849572,1444626,2024-05-16,Assembly,"Do pass as amended",11,0,0,4,15
1849572,1449694,2024-05-23,Assembly,"AB 3263 Calderon Assembly Third Reading",58,0,0,22,80
1849572,1462336,2024-07-02,Senate,"Do pass as amended, but first amend, and re-refer to the Committee on [Appropriations]",15,1,0,2,18
1849572,1463491,2024-08-05,Senate,"Placed on suspense file",7,0,0,0,7
1849572,1464209,2024-08-15,Senate,"Do pass",5,1,0,1,7
1849572,1466117,2024-08-29,Senate,"Assembly 3rd Reading AB3263 Calderon By Bradford",31,6,0,3,40
1849572,1467182,2024-08-31,Assembly,"AB 3263 Calderon Concurrence in Senate Amendments By AGUIAR-CURRY",62,0,0,17,79
1849573,1420098,2024-04-03,Assembly,"Do pass",15,0,0,1,16
1849573,1448684,2024-05-22,Assembly,"AB 3264 Petrie-Norris Assembly Third Reading",70,0,0,10,80
1849573,1466381,2024-08-30,Senate,"Do pass",17,0,0,1,18
1849573,1466946,2024-08-31,Senate,"Assembly 3rd Reading AB3264 Petrie-Norris et al",39,1,0,0,40
1849573,1466947,2024-08-31,Assembly,"AB 3264 Petrie-Norris Concurrence in Senate Amendments",73,0,0,6,79
1849574,1427235,2024-04-15,Assembly,"Do pass and be re-referred to the Committee on [Judiciary] with recommendation: To Consent Calendar",10,0,0,1,11
1849574,1433073,2024-04-23,Assembly,"Do pass and be re-referred to the Committee on [Appropriations] with recommendation: To Consent Calendar",11,0,0,1,12
1849574,1437609,2024-05-01,Assembly,"Do pass. To Consent Calendar",14,0,0,1,15
1849574,1441910,2024-05-09,Assembly,"AB 3265 Bryan Consent Calendar Second Day Regular Session",64,0,0,16,80
1849574,1458439,2024-06-19,Senate,"Do pass as amended, but first amend, and re-refer to the Committee on [Judiciary]",6,0,0,1,7
1849574,1462646,2024-07-02,Senate,"Do pass, but first be re-referred to the Committee on [Appropriations]",10,0,0,1,11
1849574,1463448,2024-08-05,Senate,"Placed on suspense file",7,0,0,0,7
1849574,1464465,2024-08-15,Senate,"Do pass",7,0,0,0,7
1849574,1465904,2024-08-27,Senate,"Assembly 3rd Reading AB3265 Bryan By Durazo",38,0,0,2,40
1849574,1467215,2024-08-28,Assembly,"AB 3265 Bryan Concurrence in Senate Amendments",75,0,0,4,79
1849577,1433157,2024-04-22,Assembly,"Do pass and be re-referred to the Committee on [Appropriations]",7,0,0,0,7
1849577,1443453,2024-05-15,Assembly,"Do pass. To Consent Calendar",15,0,0,0,15
1849577,1446066,2024-05-21,Assembly,"AB 3268 Low Consent Calendar Second Day Regular Session",71,0,0,9,80
1849580,1421172,2024-04-03,Assembly,"Do pass and be re-referred to the Committee on [Health] with recommendation: To Consent Calendar",7,0,0,0,7
1849580,1428991,2024-04-16,Assembly,"Do pass and be re-referred to the Committee on [Appropriations] with recommendation: To Consent Calendar",16,0,0,0,16
1849584,1428977,2024-04-16,Assembly,"Do pass as amended and be re-referred to the Committee on [Appropriations]",16,0,0,0,16
1849584,1444098,2024-05-16,Assembly,"Do pass as amended",11,0,0,4,15
1849584,1445995,2024-05-21,Assembly,"AB 3275 Soria Assembly Third Reading",72,0,0,8,80
1849584,1460721,2024-06-26,Senate,"Do pass as amended, but first amend, and re-refer to the Committee on [Appropriations]",11,0,0,0,11
1849584,1463686,2024-08-05,Senate,"Placed on suspense file",7,0,0,0,7
1849584,1464281,2024-08-15,Senate,"Do pass",7,0,0,0,7
1849584,1466323,2024-08-29,Assembly,"AB 3275 Soria Concurrence in Senate Amendments",74,0,0,5,79
1849584,1466767,2024-08-28,Senate,"Assembly 3rd Reading AB3275 Soria et al. By Caballero",39,0,0,1,40
1849585,1431020,2024-04-17,Assembly,"Do pass and be re-referred to the Committee on [Housing and Community Development]",9,0,0,0,9
1849585,1434165,2024-04-24,Assembly,"Do pass and be re-referred to the Committee on [Appropriations] with recommendation: To Consent Calendar",9,0,0,0,9
1849585,1441342,2024-05-08,Assembly,"Do pass. To Consent Calendar",15,0,0,0,15
1849585,1444642,2024-05-16,Assembly,"AB 3276 Ramos Consent Calendar Second Day Regular Session",71,0,0,9,80
1849585,1456321,2024-06-11,Senate,"Do pass as amended, but first amend, and re-refer to the Committee on [Appropriations] with the recommendation: To Consent Calendar",7,0,0,0,7
1849585,1465411,2024-08-21,Senate,"Assembly 3rd Reading AB3276 Ramos By Hurtado Urgency Clause",33,0,0,7,40
1849585,1465702,2024-08-26,Assembly,"AB 3276 Ramos Concurrence - Urgency Added",77,0,0,2,79
1849588,1439736,2024-05-06,Assembly,"Be adopted. To Consent Calendar",8,0,0,3,11
1849588,1441925,2024-05-09,Assembly,"ACR 146 Pellerin Consent Calendar Second Day Regular Session",65,0,0,15,80
1849588,1452246,2024-05-30,Senate,"Special Consent ACR146 Pellerin et al",37,0,0,3,40
1849589,1423775,2024-04-09,Assembly,"Without recommendation, and be re-referred to Committee on [Appropriations]",11,0,0,0,11
1849589,1424785,2024-04-09,Assembly,"Be adopted and re-referred to the Committee on [Appropriations]",11,0,0,0,11
1849589,1434233,2024-04-24,Assembly,"Be adopted. To Consent Calendar",14,0,0,1,15
1849589,1436202,2024-04-29,Assembly,"ACR 147 Alvarez Consent Calendar Second Day Regular Session",74,0,0,6,80
1849589,1454208,2024-06-05,Senate,"Be adopted, but first be re-referred to the Committee on [Appropriations] with recommendation: To Consent Calendar",7,0,0,0,7
1849589,1458811,2024-06-20,Senate,"Consent Calendar 2nd ACR147 Alvarez et al",36,0,0,4,40
1849591,1424811,2024-04-09,Senate,"Do pass, but first be re-referred to the Committee on [Appropriations]",15,0,0,0,15
1849591,1442651,2024-05-13,Senate,"Senate 3rd Reading SB1313 Ashby",36,0,0,4,40
1849591,1458328,2024-06-17,Assembly,"Do pass and be re-referred to the Committee on [Privacy and Consumer Protection]",15,0,0,0,15
1849591,1462516,2024-07-02,Assembly,"Do pass as amended and be re-referred to the Committee on [Appropriations]",9,0,0,2,11
1849591,1463744,2024-08-07,Assembly,"Do pass. To Consent Calendar",14,0,0,1,15
1849591,1466216,2024-08-29,Assembly,"SB 1313 Ashby Senate Third Reading By Hoover",76,0,0,3,79
1849591,1466910,2024-08-31,Senate,"Unfinished Business SB1313 Ashby Concurrence",40,0,0,0,40
1849593,1429953,2024-04-17,Senate,"Do pass as amended, but first amend, and re-refer to the Committee on [Appropriations]",7,0,0,0,7
1849593,1439685,2024-05-06,Senate,"Placed on suspense file",7,0,0,0,7
1849593,1444175,2024-05-16,Senate,"Do pass",7,0,0,0,7
1849593,1449541,2024-05-23,Senate,"Special Consent SB1315 Archuleta",37,0,0,3,40
1849593,1456854,2024-06-12,Assembly,"Do pass as amended, and be re-referred to the Committee on [Appropriations] with recommendation: To Consent Calendar",7,0,0,0,7
1849593,1464495,2024-08-15,Assembly,"Do pass as amended",11,0,0,4,15
1849593,1466345,2024-08-29,Assembly,"SB 1315 Archuleta Senate Third Reading By McCarty",76,0,0,3,79
1849593,1466539,2024-08-30,Senate,"Unfinished Business SB1315 Archuleta Concurrence",40,0,0,0,40
1849594,1429974,2024-04-17,Senate,"Do pass, but first be re-referred to the Committee on [Appropriations]",5,0,0,0,5
1849594,1436210,2024-04-29,Senate,"Placed on suspense file",5,0,0,2,7
1849595,1428768,2024-04-16,Senate,"Do pass as amended",5,0,0,0,5
1849595,1445274,2024-05-20,Senate,"Senate 3rd Reading SB1317 Wahab et al",39,0,0,1,40
1849595,1458337,2024-06-18,Assembly,"Do pass and be re-referred to the Committee on [Appropriations]",7,0,0,1,8
1849595,1463721,2024-08-07,Assembly,"Do pass. To Consent Calendar",14,0,0,1,15
1849595,1465735,2024-08-26,Assembly,"SB 1317 Wahab Senate Third Reading By McCarty",76,0,0,3,79
1849595,1466982,2024-08-28,Senate,"Special Consent SB1317 Wahab et al",39,0,0,1,40
1849596,1420168,2024-04-03,Senate,"Do pass as amended, but first amend, and re-refer to the Committee on [Appropriations]",5,0,0,2,7
1849596,1427287,2024-04-15,Senate,"Placed on suspense file",6,0,0,1,7
1849596,1444393,2024-05-16,Senate,"Do pass as amended",5,2,0,0,7
1849596,1450371,2024-05-21,Senate,"Senate 3rd Reading SB1318 Wahab et al",32,7,0,1,40
1849596,1456915,2024-06-12,Assembly,"Do pass as amended and be re-referred to the Committee on [Appropriations]",6,1,0,0,7
1849596,1464602,2024-08-15,Assembly,"Do pass",11,3,0,1,15
1849596,1465622,2024-08-26,Assembly,"SB 1318 Wahab Senate Third Reading By Gipson",63,10,0,6,79
1849596,1467005,2024-08-28,Senate,"Unfinished Business SB1318 Wahab et al. Concurrence",32,6,0,2,40
1849597,1424794,2024-04-10,Senate,"Do pass as amended, but first amend, and re-refer to the Committee on [Local Government] with the recommendation: To Consent Calendar",11,0,0,0,11
1849597,1431975,2024-04-22,Senate,"Placed on suspense file",7,0,0,0,7
1849597,1444577,2024-05-16,Senate,"Do pass as amended",7,0,0,0,7
1849597,1448565,2024-05-22,Senate,"Senate 3rd Reading SB1319 Wahab et al",39,0,0,1,40
1849597,1458191,2024-06-18,Assembly,"Do pass and be re-referred to the Committee on [Appropriations] with recommendation: To Consent Calendar",16,0,0,0,16
1849597,1464053,2024-08-15,Assembly,"Do pass",14,0,0,1,15
1849597,1465623,2024-08-26,Assembly,"SB 1319 Wahab Senate Third Reading By Ting",77,0,0,2,79
1849598,1424929,2024-04-10,Senate,"Do pass, but first be re-referred to the Committee on [Appropriations] with the recommendation: To Consent Calendar",11,0,0,0,11
1849598,1435232,2024-04-25,Senate,"Consent Calendar 2nd SB1320 Wahab",36,0,0,4,40
1849598,1456382,2024-06-11,Assembly,"Do pass and be re-referred to the Committee on [Appropriations] with recommendation: To Consent Calendar",16,0,0,0,16
1849598,1458414,2024-06-19,Assembly,"Do pass. To Consent Calendar",14,0,0,1,15
1849598,1460727,2024-06-26,Assembly,"SB 1320 Wahab Consent Calendar Second Day Regular Session",75,0,0,4,79
1849599,1434028,2024-04-24,Senate,"Do pass as amended, but first amend, and re-refer to the Committee on [Appropriations]",4,1,0,0,5
1849599,1442562,2024-05-13,Senate,"Placed on suspense file",7,0,0,0,7
1849599,1444007,2024-05-16,Senate,"Do pass",5,2,0,0,7
1849599,1450314,2024-05-21,Senate,"Senate 3rd Reading SB1321 Wahab",30,9,0,1,40
1849599,1458396,2024-06-19,Assembly,"Do pass and be re-referred to the Committee on [Appropriations]",5,1,0,1,7
1849599,1464085,2024-08-15,Assembly,"Do pass as amended",11,3,0,1,15
1849599,1466356,2024-08-29,Senate,"Unfinished Business SB1321 Wahab Concurrence",31,9,0,0,40
1849599,1466888,2024-08-28,Assembly,"SB 1321 Wahab Senate Third Reading By Haney",62,8,0,9,79
1849600,1412568,2024-03-20,Senate,"Do pass, but first be re-referred to the Committee on [Human Services] with the recommendation: To Consent Calendar",7,0,0,0,7
1849600,1419184,2024-04-01,Senate,"Do pass, but first be re-referred to the Committee on [Appropriations] with the recommendation: To Consent Calendar",5,0,0,0,5
1849600,1427261,2024-04-15,Senate,"Placed on suspense file",6,0,0,1,7
1849600,1444158,2024-05-16,Senate,"Do pass as amended",7,0,0,0,7
1849600,1450034,2024-05-24,Senate,"Special Consent SB1322 Wahab",38,0,0,2,40
1849600,1458340,2024-06-18,Assembly,"Do pass and be re-referred to the Committee on [Human Services]",8,0,0,3,11
1849600,1459979,2024-06-25,Assembly,"Do pass and be re-referred to the Committee on [Appropriations] with recommendation: To Consent Calendar",6,0,0,1,7
1849601,1423822,2024-04-09,Senate,"Do pass, but first be re-referred to the Committee on [Appropriations]",4,1,0,0,5
1849601,1442585,2024-05-13,Senate,"Placed on suspense file",7,0,0,0,7
1849601,1444574,2024-05-16,Senate,"Do pass as amended",5,2,0,0,7
1849601,1449624,2024-05-23,Senate,"Senate 3rd Reading SB1323 Menjivar et al",24,10,0,6,40
1849601,1462515,2024-07-02,Assembly,"Do pass and be re-referred to the Committee on [Appropriations]",5,1,0,2,8
1849601,1464376,2024-08-15,Assembly,"Do pass as amended",10,3,0,2,15
1849601,1467116,2024-08-31,Senate,"Unfinished Business SB1323 Menjivar et al. Concurrence",29,9,0,2,40
1849601,1467117,2024-08-31,Assembly,"SB 1323 Menjivar Senate Third Reading By Hart",56,15,0,8,79
1849602,1423878,2024-04-09,Senate,"Do pass as amended, but first amend, and re-refer to the Committee on [Environmental Quality] with the recommendation: To Consent Calendar",11,0,0,0,11
1849602,1434201,2024-04-24,Senate,"Do pass, but first be re-referred to the Committee on [Appropriations] with the recommendation: To Consent Calendar",7,0,0,0,7
1849602,1444562,2024-05-16,Senate,"Consent Calendar 2nd SB1324 Lim√≥n",38,0,0,2,40
1849602,1459954,2024-06-25,Assembly,"Do pass and be re-referred to the Committee on [Natural Resources] with recommendation: To Consent Calendar",13,0,0,2,15
1849602,1462041,2024-07-01,Assembly,"Do pass and be re-referred to the Committee on [Appropriations] with recommendation: To Consent Calendar",12,0,0,0,12
1849602,1464062,2024-08-15,Assembly,"Do pass",14,0,0,1,15
1849602,1465553,2024-08-26,Assembly,"SB 1324 Lim√≥n Senate Third Reading By Ting",77,0,0,2,79
1849603,1423895,2024-04-09,Senate,"Do pass, but first be re-referred to the Committee on [Local Government]",9,5,0,2,16
1849603,1430031,2024-04-17,Senate,"Do pass, but first be re-referred to the Committee on [Appropriations]",5,2,0,0,7
1849603,1436190,2024-04-29,Senate,"Placed on suspense file",5,0,0,2,7
1849603,1444182,2024-05-16,Senate,"Do pass",5,2,0,0,7
1849603,1448779,2024-05-22,Senate,"Senate 3rd Reading SB1325 Durazo",30,8,0,2,40
1849603,1460718,2024-06-26,Assembly,"Do pass and be re-referred to the Committee on [Appropriations]",8,0,0,1,9
1849604,1433155,2024-04-22,Senate,"Do pass, but first be re-referred to the Committee on [Appropriations]",4,0,0,14,18
1849604,1433156,2024-04-22,Senate,"[First] hearing set for [04-23-2024]: Failed passage in Committee. Reconsideration granted",18,0,0,0,18
1849605,1441361,2024-05-08,Senate,"Do pass, but first be re-referred to the Committee on [Appropriations]",4,1,0,2,7
1849605,1442610,2024-05-13,Senate,"Placed on suspense file",7,0,0,0,7
1849605,1444008,2024-05-16,Senate,"Do pass as amended",4,2,0,1,7
1849605,1461235,2024-06-27,Senate,"Senate 3rd Reading SB1327 Glazer et al. Urgency Clause",27,7,0,6,40
1849606,1419156,2024-04-02,Senate,"Do pass, but first be re-referred to the Committee on [Public Safety]",7,0,0,0,7
1849606,1428858,2024-04-16,Senate,"Do pass, but first be re-referred to the Committee on [Appropriations] with the recommendation: To Consent Calendar",5,0,0,0,5
1849606,1436209,2024-04-29,Senate,"Placed on suspense file",5,0,0,2,7
1849606,1444522,2024-05-16,Senate,"Do pass",7,0,0,0,7
1849606,1448589,2024-05-22,Senate,"Senate 3rd Reading SB1328 Bradford et al. Urgency Clause",36,0,0,4,40
1849606,1456908,2024-06-12,Assembly,"Do pass as amended and be re-referred to the Committee on [Public Safety]",7,1,0,0,8
1849606,1462449,2024-07-02,Assembly,"Do pass and be re-referred to the Committee on [Appropriations]",8,0,0,0,8
1849606,1464044,2024-08-15,Assembly,"Do pass",11,0,0,4,15
1849606,1466121,2024-08-29,Assembly,"SB 1328 Bradford Third Reading Urgency By Jackson",66,2,0,11,79
1849606,1466530,2024-08-30,Senate,"Unfinished Business SB1328 Bradford et al. Urgency Clause Concurrence",38,1,0,1,40
1849607,1434043,2024-04-24,Senate,"Do pass, but first be re-referred to the Committee on [Appropriations] with the recommendation: To Consent Calendar",7,0,0,0,7
1849607,1441968,2024-05-09,Senate,"Consent Calendar 2nd SB1329 ED. (Newman)",37,0,0,3,40
1849607,1456878,2024-06-12,Assembly,"Do pass and be re-referred to the Committee on [Appropriations] with recommendation: To Consent Calendar",7,0,0,0,7
1849607,1462349,2024-07-02,Assembly,"Do pass. To Consent Calendar",15,0,0,0,15
1849607,1466010,2024-08-27,Assembly,"SB 1329 Education Senate Third Reading By MURATSUCHI",76,0,0,3,79
1849607,1467035,2024-08-28,Senate,"Unfinished Business SB1329 ED. (Newman) Concurrence",39,0,0,1,40
1849608,1432923,2024-04-23,Senate,"Do pass as amended, but first amend, and re-refer to the Committee on [Appropriations]",11,0,0,0,11
1849608,1442598,2024-05-13,Senate,"Placed on suspense file",7,0,0,0,7
1849608,1444259,2024-05-16,Senate,"Do pass",6,1,0,0,7
1849608,1445195,2024-05-20,Senate,"Senate 3rd Reading SB1330 Archuleta et al",39,0,0,1,40
1849608,1459947,2024-06-25,Assembly,"Do pass as amended and be re-referred to the Committee on [Appropriations]",11,0,0,4,15
1849609,1428818,2024-04-16,Senate,"Do pass, but first be re-referred to the Committee on [Appropriations]",8,1,0,2,11
1849609,1442567,2024-05-13,Senate,"Placed on suspense file",7,0,0,0,7
1849609,1444662,2024-05-16,Senate,"Do pass as amended",5,2,0,0,7
1849609,1450288,2024-05-21,Senate,"Senate 3rd Reading SB1331 Bradford",29,8,0,3,40
1849609,1450289,2024-05-21,Senate,"Senate 3rd Reading SB1331 Bradford Reconsider",39,0,0,1,40
1849609,1450290,2024-05-21,Senate,"Senate 3rd Reading SB1331 Bradford",30,7,0,3,40
1849609,1456326,2024-06-11,Assembly,"Do pass and be re-referred to the Committee on [Appropriations]",9,3,0,0,12
1849609,1464557,2024-08-15,Assembly,"Do pass",11,3,0,1,15
1849610,1427296,2024-04-15,Senate,"Do pass as amended, but first amend, and re-refer to the Committee on [Appropriations]",10,0,0,1,11
1849610,1436185,2024-04-29,Senate,"Placed on suspense file",5,0,0,2,7
1849610,1443922,2024-05-16,Senate,"Do pass",7,0,0,0,7
1849610,1449652,2024-05-23,Senate,"Special Consent SB1332 Allen et al",37,0,0,3,40
1849610,1459935,2024-06-25,Assembly,"Do pass as amended and be re-referred to the Committee on [Appropriations]",11,0,0,4,15
1849611,1412558,2024-03-20,Senate,"Do pass, but first be re-referred to the Committee on [Judiciary] with the recommendation: To Consent Calendar",11,0,0,0,11
1849611,1423909,2024-04-09,Senate,"Do pass, but first be re-referred to the Committee on [Appropriations] with the recommendation: To Consent Calendar",11,0,0,0,11
1849611,1431965,2024-04-22,Senate,"Placed on suspense file",7,0,0,0,7
1849611,1444037,2024-05-16,Senate,"Do pass",7,0,0,0,7
1849611,1449581,2024-05-23,Senate,"Special Consent SB1333 Eggman et al",37,0,0,3,40
1849611,1458197,2024-06-18,Assembly,"Do pass and be re-referred to the Committee on [Judiciary] with recommendation: To Consent Calendar",16,0,0,0,16
1849611,1462697,2024-07-02,Assembly,"Do pass and be re-referred to the Committee on [Appropriations] with recommendation: To Consent Calendar",11,0,0,0,11
1849611,1463736,2024-08-07,Assembly,"Do pass. To Consent Calendar",14,0,0,1,15
1849611,1465456,2024-08-22,Assembly,"SB 1333 Eggman Senate Third Reading By Zbur",62,0,0,17,79
1849611,1466931,2024-08-28,Senate,"Special Consent SB1333 Eggman et al",39,0,0,1,40
1849613,1423893,2024-04-08,Senate,"Do pass, but first be re-referred to the Committee on [Appropriations]",5,0,0,0,5
1849613,1445214,2024-05-20,Senate,"Senate 3rd Reading SB1335 Archuleta",38,0,0,2,40
1849613,1455797,2024-06-10,Assembly,"Do pass and be re-referred to the Committee on [Appropriations]",9,0,0,1,10
1849613,1456393,2024-06-10,Assembly,"Do pass and be re-referred to the Committee on [Higher Education]",9,0,0,1,10
1849613,1462235,2024-07-02,Assembly,"Do pass and be re-referred to the Committee on [Appropriations] with recommendation: To Consent Calendar",11,0,0,0,11
1849613,1463758,2024-08-07,Assembly,"Do pass. To Consent Calendar",14,0,0,1,15
1849613,1464534,2024-08-15,Assembly,"SB 1335 Archuleta Consent Calendar Second Day Regular Session",75,0,0,4,79
1849614,1432956,2024-04-23,Senate,"Do pass, but first be re-referred to the Committee on [Appropriations] with the recommendation: To Consent Calendar",16,0,0,0,16
1849614,1441921,2024-05-09,Senate,"Consent Calendar 2nd SB1336 Archuleta",37,0,0,3,40
1849614,1458829,2024-06-19,Assembly,"Do pass and be re-referred to the Committee on [Appropriations] with recommendation: To Consent Calendar",19,0,0,3,22
1849614,1462297,2024-07-02,Assembly,"Do pass. To Consent Calendar",15,0,0,0,15
1849614,1465726,2024-08-26,Assembly,"SB 1336 Archuleta Senate Third Reading By Pacheco",77,0,0,2,79
1849614,1467011,2024-08-28,Senate,"Unfinished Business SB1336 Archuleta et al. Concurrence",39,0,0,1,40
1849615,1428747,2024-04-16,Senate,"Do pass, but first be re-referred to the Committee on [Appropriations]",6,1,0,0,7
1849615,1450349,2024-05-21,Senate,"Senate 3rd Reading SB1337 Gonzalez",28,9,0,3,40
1849615,1460729,2024-06-26,Assembly,"Do pass as amended and be re-referred to the Committee on [Appropriations]",6,2,0,0,8
1849615,1463731,2024-08-07,Assembly,"Do pass",10,4,0,1,15
1849615,1466366,2024-08-29,Senate,"Unfinished Business SB1337 Gonzalez Concurrence",28,11,0,1,40
1849615,1466900,2024-08-28,Assembly,"SB 1337 Gonzalez Senate Third Reading By Bryan",55,17,0,7,79
1849616,1412555,2024-03-20,Senate,"Do pass, but first be re-referred to the Committee on [Appropriations]",7,0,0,0,7
1849616,1442668,2024-05-13,Senate,"Placed on suspense file",7,0,0,0,7
1849617,1435290,2024-04-24,Senate,"Do pass as amended, but first amend, and re-refer to the Committee on [Appropriations]",11,0,0,0,11
1849617,1439616,2024-05-06,Senate,"Placed on suspense file",7,0,0,0,7
1849617,1444458,2024-05-16,Senate,"Do pass as amended",7,0,0,0,7
1849617,1450018,2024-05-24,Senate,"Special Consent SB1339 Allen",38,0,0,2,40
1849618,1428910,2024-04-16,Senate,"Do pass, but first be re-referred to the Committee on [Labor, Public Employment and Retirement ]",9,2,0,0,11
1849618,1434196,2024-04-24,Senate,"Do pass as amended, but first amend, and re-refer to the Committee on [Appropriations]",4,0,0,1,5
1849618,1442627,2024-05-13,Senate,"Placed on suspense file",7,0,0,0,7
1849618,1444500,2024-05-16,Senate,"Do pass",5,2,0,0,7
1849618,1450370,2024-05-21,Senate,"Senate 3rd Reading SB1340 Smallwood-Cuevas",30,8,0,2,40
1849618,1458500,2024-06-19,Assembly,"Do pass and be re-referred to the Committee on [Judiciary]",5,2,0,0,7
1849618,1462242,2024-07-02,Assembly,"Do pass as amended and be re-referred to the Committee on [Appropriations]",8,3,0,1,12
1849618,1464187,2024-08-15,Assembly,"Do pass as amended",11,3,0,1,15
1849618,1466164,2024-08-29,Assembly,"SB 1340 Smallwood-Cuevas Senate Third Reading By Kalra",62,11,0,6,79
1849618,1466492,2024-08-30,Senate,"Unfinished Business SB1340 Smallwood-Cuevas Concurrence",31,9,0,0,40
1849619,1412540,2024-03-20,Senate,"Do pass, but first be re-referred to the Committee on [Appropriations]",7,0,0,0,7
1849619,1422059,2024-04-08,Senate,"Placed on suspense file",6,0,0,1,7
1849619,1444318,2024-05-16,Senate,"Do pass",7,0,0,0,7
1849619,1449551,2024-05-23,Senate,"Special Consent SB1341 Allen et al",37,0,0,3,40
1849619,1456855,2024-06-12,Assembly,"Do pass and be re-referred to the Committee on [Appropriations] with recommendation: To Consent Calendar",7,0,0,0,7
1849620,1429972,2024-04-17,Senate,"Do pass, but first be re-referred to the Committee on [Appropriations]",7,0,0,0,7
1849620,1445250,2024-05-20,Senate,"Senate 3rd Reading SB1342 Atkins et al",39,0,0,1,40
1849620,1457986,2024-06-17,Assembly,"Do pass and be re-referred to the Committee on [Appropriations]",10,0,0,1,11
1849620,1463715,2024-08-07,Assembly,"Do pass. To Consent Calendar",14,0,0,1,15
1849620,1465801,2024-08-27,Assembly,"SB 1342 Atkins Senate Third Reading By Alvarez",77,0,0,2,79
1849620,1466981,2024-08-28,Senate,"Unfinished Business SB1342 Atkins et al. Concurrence",39,0,0,1,40
1849624,1424839,2024-04-10,Senate,"Do pass, but first be re-referred to the Committee on [Appropriations]",4,1,0,0,5
1849624,1431884,2024-04-22,Senate,"Placed on suspense file",7,0,0,0,7
1849626,1429959,2024-04-17,Senate,"Do pass, but first be re-referred to the Committee on [Appropriations]",6,0,0,1,7
1849626,1449646,2024-05-23,Senate,"Senate 3rd Reading SB1348 Bradford et al",33,0,0,7,40
1849626,1462310,2024-07-02,Assembly,"Do pass as amended and be re-referred to the Committee on [Appropriations]",9,0,0,2,11
1849626,1464214,2024-08-15,Assembly,"Do pass as amended",11,0,0,4,15
1849626,1466126,2024-08-29,Senate,"Unfinished Business SB1348 Bradford et al. Concurrence",38,0,0,2,40
1849626,1466659,2024-08-28,Assembly,"SB 1348 Bradford Senate Third Reading By McCarty",69,0,0,10,79
1849628,1429986,2024-04-17,Senate,"Do pass, but first be re-referred to the Committee on [Appropriations]",4,1,0,0,5
1849628,1439654,2024-05-06,Senate,"Do pass",5,2,0,0,7
1849628,1450278,2024-05-21,Senate,"Senate 3rd Reading SB1350 Durazo",31,8,0,1,40
1849628,1462276,2024-07-02,Assembly,"Do pass and be re-referred to the Committee on [Appropriations]",5,1,0,1,7
1849628,1464010,2024-08-15,Assembly,"Do pass",11,3,0,1,15
1849628,1466526,2024-08-30,Assembly,"Do pass",7,0,0,0,7
1849628,1467190,2024-08-31,Senate,"Unfinished Business SB1350 Durazo Concurrence",30,8,0,2,40
1849628,1467191,2024-08-31,Assembly,"SB 1350 Durazo Senate Third Reading By Bonta",65,8,0,6,79
1849629,1432974,2024-04-22,Senate,"Do pass as amended, but first amend, and re-refer to the Committee on [Appropriations]",14,1,0,3,18
1849629,1442604,2024-05-13,Senate,"Placed on suspense file",7,0,0,0,7
1849630,1428962,2024-04-15,Senate,"Do pass as amended, but first amend, and re-refer to the Committee on [Judiciary]",5,0,0,0,5
1849630,1442631,2024-05-13,Senate,"Senate 3rd Reading SB1352 Wahab",36,0,0,4,40
1849630,1458221,2024-06-18,Assembly,"Do pass and be re-referred to the Committee on [Human Services]",6,0,0,1,7
1849630,1460036,2024-06-25,Assembly,"Do pass and be re-referred to the Committee on [Appropriations] with recommendation: To Consent Calendar",6,0,0,1,7
1849630,1462354,2024-07-02,Assembly,"Do pass. To Consent Calendar",15,0,0,0,15
1849630,1463818,2024-08-08,Assembly,"SB 1352 Wahab Consent Calendar Second Day Regular Session",72,0,0,7,79
1849630,1464064,2024-08-15,Senate,"Special Consent SB1352 Wahab et al",37,0,0,3,40
1849631,1411325,2024-03-19,Senate,"Do pass",4,0,0,1,5
1849631,1422104,2024-04-08,Senate,"Senate 3rd Reading SB1353 Wahab",32,0,0,8,40
1849631,1453406,2024-06-04,Assembly,"Do pass",7,0,0,1,8
1849631,1459374,2024-06-24,Assembly,"SB 1353 Wahab Senate Third Reading By Ting",72,0,0,7,79
1849631,1462643,2024-07-03,Senate,"Special Consent SB1353 Wahab et al",39,0,0,1,40
1849632,1435328,2024-04-24,Senate,"Do pass as amended, but first amend, and re-refer to the Committee on [Appropriations]",9,2,0,0,11
1849632,1450363,2024-05-21,Senate,"Senate 3rd Reading SB1354 Wahab",30,9,0,1,40
1849632,1460015,2024-06-25,Assembly,"Do pass and be re-referred to the Committee on [Appropriations]",16,0,0,0,16
1849632,1464054,2024-08-15,Assembly,"Do pass as amended",11,0,0,4,15
1849632,1465995,2024-08-27,Assembly,"SB 1354 Wahab Senate Third Reading By Wood",75,0,0,4,79
1849632,1467016,2024-08-28,Senate,"Unfinished Business SB1354 Wahab et al. Concurrence",39,0,0,1,40
1849633,1424959,2024-04-10,Senate,"Do pass as amended, but first amend, and re-refer to the Committee on [Governmental Organization]",10,0,0,1,11
1849633,1433108,2024-04-23,Senate,"Do pass, but first be re-referred to the Committee on [Appropriations]",16,0,0,0,16
1849633,1439733,2024-05-06,Senate,"Placed on suspense file",7,0,0,0,7
1849634,1428990,2024-04-16,Senate,"Do pass, but first be re-referred to the Committee on [Appropriations]",9,0,0,2,11
1849634,1445289,2024-05-20,Senate,"Senate 3rd Reading SB1356 Wahab",32,0,0,8,40
1849634,1456445,2024-06-11,Assembly,"Do pass and be re-referred to the Committee on [Appropriations]",10,0,0,2,12
1849634,1462246,2024-07-02,Assembly,"Do pass",11,0,0,4,15
1849634,1463890,2024-08-12,Assembly,"SB 1356 Wahab Senate Third Reading By Bauer-Kahan",67,0,0,12,79
1849635,1412607,2024-03-19,Senate,"Do pass, but first be re-referred to the Committee on [Appropriations] with the recommendation: To Consent Calendar",8,0,0,2,10
1849635,1425885,2024-04-11,Senate,"Consent Calendar 2nd SB1357 Wahab",39,0,0,1,40
1849635,1456960,2024-06-12,Assembly,"Do pass and be re-referred to the Committee on [Appropriations]",9,0,0,0,9
1849635,1463741,2024-08-07,Assembly,"Do pass",14,0,0,1,15
1849635,1465285,2024-08-19,Assembly,"SB 1357 Wahab Senate Third Reading By BONTA",77,0,0,2,79
1849635,1465644,2024-08-26,Senate,"Unfinished Business SB1357 Wahab Concurrence",40,0,0,0,40
1849637,1433121,2024-04-23,Senate,"Do pass as amended, but first amend, and re-refer to the Committee on [Appropriations]",5,0,0,0,5
1849637,1439646,2024-05-06,Senate,"Placed on suspense file",7,0,0,0,7
1849637,1444198,2024-05-16,Senate,"Do pass as amended",7,0,0,0,7
1849637,1448546,2024-05-22,Senate,"Senate 3rd Reading SB1359 Wilk",35,0,0,5,40
1849639,1420068,2024-04-03,Senate,"Do pass as amended, but first amend, and re-refer to the Committee on [Housing]",7,0,0,0,7
1849639,1428806,2024-04-16,Senate,"Do pass and be ordered to the Consent Calendar",10,0,0,0,10
1849639,1435230,2024-04-25,Senate,"Consent Calendar 2nd SB1361 Blakespear",36,0,0,4,40
1849639,1455778,2024-06-10,Assembly,"Do pass and be re-referred to the Committee on [Housing and Community Development] with recommendation: To Consent Calendar",10,0,0,1,11
1849639,1460653,2024-06-26,Assembly,"Do pass. To Consent Calendar",9,0,0,0,9
1849639,1463695,2024-08-05,Assembly,"SB 1361 Blakespear Consent Calendar Second Day Regular Session",71,0,0,8,79
1849640,1428813,2024-04-15,Senate,"Do pass, but first be re-referred to the Committee on [Revenue and Taxation]",5,0,0,0,5
1849640,1434163,2024-04-24,Senate,"Do pass, but first be re-referred to the Committee on [Appropriations]",7,0,0,0,7
1849640,1439648,2024-05-06,Senate,"Placed on suspense file",7,0,0,0,7
1849643,1427248,2024-04-15,Senate,"Do pass as amended, but first amend, and re-refer to the Committee on [Appropriations]",11,0,0,2,13
1849643,1442664,2024-05-13,Senate,"Placed on suspense file",7,0,0,0,7
1849644,1420197,2024-04-02,Senate,"Do pass as amended",10,0,0,1,11
1849644,1430998,2024-04-18,Senate,"Special Consent SB1366 Hurtado",39,0,0,1,40
1849644,1453465,2024-06-04,Assembly,"Do pass. To Consent Calendar",8,0,0,4,12
1849644,1455792,2024-06-10,Assembly,"SB 1366 Hurtado Consent Calendar Second Day Regular Session",63,0,0,16,79
1849645,1419133,2024-04-02,Senate,"Do pass, but first be re-referred to the Committee on [Appropriations]",4,0,0,1,5
1849645,1450283,2024-05-21,Senate,"Senate 3rd Reading SB1367 Hurtado",39,0,0,1,40
1849645,1460667,2024-06-26,Assembly,"Do pass and be re-referred to the Committee on [Appropriations]",7,0,0,3,10
1849645,1464553,2024-08-15,Assembly,"Do pass",13,0,0,2,15
1849645,1465736,2024-08-26,Assembly,"SB 1367 Hurtado Senate Third Reading By Bains",76,0,0,3,79
1849646,1434197,2024-04-24,Senate,"Do pass, but first be re-referred to the Committee on [Appropriations]",2,4,0,1,7
1849647,1435205,2024-04-24,Senate,"Do pass as amended, but first amend, and re-refer to the Committee on [Appropriations]",10,0,0,1,11
1849647,1445261,2024-05-20,Senate,"Senate 3rd Reading SB1369 Lim√≥n",37,0,0,3,40
1849647,1456425,2024-06-11,Assembly,"Do pass as amended and be re-referred to the Committee on [Appropriations]",16,0,0,0,16
1849647,1463709,2024-08-07,Assembly,"Do pass. To Consent Calendar",14,0,0,1,15
1849647,1464344,2024-08-15,Assembly,"SB 1369 Lim√≥n Consent Calendar Second Day Regular Session",75,0,0,4,79
1849647,1466930,2024-08-28,Senate,"Special Consent SB1369 Lim√≥n",39,0,0,1,40
1849649,1433057,2024-04-23,Senate,"Do pass and be ordered to the Consent Calendar",16,0,0,0,16
1849649,1438480,2024-05-02,Senate,"Consent Calendar 2nd SB1371 Bradford",38,0,0,2,40
1849649,1458828,2024-06-19,Assembly,"Do pass",19,0,0,3,22
1849649,1466459,2024-08-30,Senate,"Special Consent SB1371 Bradford",40,0,0,0,40
1849649,1467049,2024-08-28,Assembly,"SB 1371 Bradford Senate Third Reading By McKinnor",75,0,0,4,79
1849650,1434261,2024-04-23,Senate,"Do pass as amended, but first amend, and re-refer to the Committee on [Appropriations]",8,4,0,3,15
1849650,1448827,2024-05-22,Senate,"Senate 3rd Reading SB1372 Newman",26,7,0,7,40
1849651,1433087,2024-04-23,Senate,"Do pass, but first be re-referred to the Committee on [Appropriations]",10,0,0,1,11
1849651,1439684,2024-05-06,Senate,"Placed on suspense file",7,0,0,0,7
1849652,1433085,2024-04-22,Senate,"Do pass, but first be re-referred to the Committee on [Appropriations]",11,5,0,2,18
1849652,1439677,2024-05-06,Senate,"Placed on suspense file",7,0,0,0,7
1849652,1444654,2024-05-16,Senate,"Do pass",4,2,0,1,7
1849652,1445245,2024-05-20,Senate,"Senate 3rd Reading SB1374 Becker",28,7,0,5,40
1849652,1461954,2024-07-01,Assembly,"Do pass as amended and be re-referred to the Committee on [Appropriations]",11,1,0,4,16
1849652,1464068,2024-08-15,Assembly,"Do pass as amended",9,3,0,3,15
1849652,1466240,2024-08-29,Assembly,"SB 1374 Becker Senate Third Reading By Friedman",48,9,0,22,79
1849652,1466389,2024-08-30,Senate,"Unfinished Business SB1374 Becker et al. Concurrence",28,9,0,3,40
1849653,1434185,2024-04-24,Senate,"Do pass, but first be re-referred to the Committee on [Appropriations]",4,1,0,0,5
1849653,1439675,2024-05-06,Senate,"Placed on suspense file",7,0,0,0,7
1849653,1443940,2024-05-16,Senate,"Do pass",5,2,0,0,7
1849653,1450284,2024-05-21,Senate,"Senate 3rd Reading SB1375 Durazo",31,8,0,1,40
1849653,1462215,2024-07-02,Assembly,"Do pass and be re-referred to the Committee on [Appropriations]",5,2,0,0,7
1849653,1464461,2024-08-15,Assembly,"Do pass as amended",11,3,0,1,15
1849653,1466241,2024-08-29,Senate,"Unfinished Business SB1375 Durazo Concurrence",31,9,0,0,40
1849653,1466769,2024-08-28,Assembly,"SB 1375 Durazo Senate Third Reading By Luz Rivas",61,15,0,3,79
1849654,1429949,2024-04-17,Senate,"Do pass as amended, but first amend, and re-refer to the Committee on [Appropriations]",5,2,0,0,7
1849654,1436198,2024-04-29,Senate,"Placed on suspense file",5,0,0,2,7
1849656,1424887,2024-04-10,Senate,"Do pass as amended, but first amend, and re-refer to the Committee on [Appropriations]",7,0,0,0,7
1849656,1436162,2024-04-29,Senate,"Placed on suspense file",5,0,0,2,7
1849657,1434191,2024-04-24,Senate,"Do pass as amended, but first amend, and re-refer to the Committee on [Appropriations]",5,0,0,0,5
1849657,1450303,2024-05-21,Senate,"Senate 3rd Reading SB1379 Dodd Urgency Clause",35,4,0,1,40
1849657,1458529,2024-06-19,Assembly,"Do pass as amended and be re-referred to the Committee on [Appropriations]",7,0,0,0,7
1849657,1463706,2024-08-07,Assembly,"Do pass",14,0,0,1,15
1849657,1463881,2024-08-12,Assembly,"SB 1379 Dodd Third Reading Urgency By Wilson",74,0,0,5,79
1849657,1465351,2024-08-20,Senate,"Unfinished Business SB1379 Dodd et al. Urgency Clause Concurrence",36,3,0,1,40
1849658,1430030,2024-04-17,Senate,"Do pass, but first be re-referred to the Committee on [Appropriations]",4,2,0,1,7
1849658,1436240,2024-04-29,Senate,"Placed on suspense file",5,0,0,2,7
1849658,1444265,2024-05-16,Senate,"Do pass as amended",5,2,0,0,7
1849658,1450392,2024-05-21,Senate,"Senate 3rd Reading SB1380 Dodd",13,10,0,17,40
1849659,1423787,2024-04-09,Senate,"Do pass and be ordered to the Consent Calendar",5,0,0,0,5
1849659,1427320,2024-04-15,Senate,"Consent Calendar 2nd SB1381 McGuire",38,0,0,2,40
1849659,1453403,2024-06-04,Assembly,"Do pass. To Consent Calendar",7,0,0,1,8
1849659,1455787,2024-06-10,Assembly,"SB 1381 McGuire Consent Calendar Second Day Regular Session",63,0,0,16,79
1849659,1461958,2024-07-01,Assembly,"SB 1381 Wahab Senate Third Reading Amend By ZBUR Set #1",36,16,0,27,79
1849659,1462569,2024-07-02,Assembly,"Do pass",5,2,0,1,8
1849659,1466778,2024-08-31,Senate,"Unfinished Business SB1381 Wahab et al. Concurrence",38,0,0,2,40
1849659,1466779,2024-08-31,Assembly,"SB 1381 Wahab Senate Third Reading By Berman",73,1,0,5,79
1849660,1431916,2024-04-22,Senate,"Do pass, but first be re-referred to the Committee on [Appropriations] with the recommendation: To Consent Calendar",11,0,0,0,11
1849660,1439635,2024-05-06,Senate,"Placed on suspense file",7,0,0,0,7
1849660,1444278,2024-05-16,Senate,"Do pass",7,0,0,0,7
1849660,1449700,2024-05-23,Senate,"Special Consent SB1382 Glazer",37,0,0,3,40
1849660,1458299,2024-06-18,Assembly,"Do pass and be re-referred to the Committee on [Appropriations] with recommendation: To Consent Calendar",16,0,0,0,16
1849660,1464347,2024-08-15,Assembly,"Do pass",14,0,0,1,15
1849660,1466111,2024-08-29,Assembly,"SB 1382 Glazer Senate Third Reading By Wood",76,0,0,3,79
1849660,1466454,2024-08-30,Senate,"Unfinished Business SB1382 Glazer Concurrence",40,0,0,0,40
1849661,1419213,2024-04-02,Senate,"Do pass as amended, but first amend, and re-refer to the Committee on [Appropriations]",15,0,0,3,18
1849661,1431940,2024-04-22,Senate,"Placed on suspense file",7,0,0,0,7
1849661,1444378,2024-05-16,Senate,"Do pass",7,0,0,0,7
1849661,1448765,2024-05-22,Senate,"Senate 3rd Reading SB1383 Bradford",37,0,0,3,40
1849661,1460426,2024-06-26,Assembly,"Do pass and be re-referred to the Committee on [Appropriations]",10,0,0,1,11
1849661,1464009,2024-08-15,Assembly,"Do pass",14,0,0,1,15
1849661,1465578,2024-08-26,Assembly,"SB 1383 Bradford Senate Third Reading By Wilson",77,0,0,2,79
1849662,1410567,2024-03-18,Senate,"Do pass, but first be re-referred to the Committee on [Judiciary]",12,0,0,1,13
1849662,1420044,2024-04-02,Senate,"Do pass, but first be re-referred to the Committee on [Appropriations] with the recommendation: To Consent Calendar",11,0,0,0,11
1849662,1427233,2024-04-15,Senate,"Placed on suspense file",6,0,0,1,7
1849662,1444266,2024-05-16,Senate,"Do pass",7,0,0,0,7
1849662,1449578,2024-05-23,Senate,"Special Consent SB1384 Dodd et al",37,0,0,3,40
1849662,1458333,2024-06-18,Assembly,"Do pass and be re-referred to the Committee on [Judiciary] with recommendation: To Consent Calendar",11,0,0,0,11
1849662,1460086,2024-06-25,Assembly,"Do pass and be re-referred to the Committee on [Appropriations] with recommendation: To Consent Calendar",11,0,0,1,12
1849662,1464348,2024-08-15,Assembly,"Do pass",14,0,0,1,15
1849662,1465569,2024-08-26,Assembly,"SB 1384 Dodd Senate Third Reading By Alanis",77,0,0,2,79
1849663,1424837,2024-04-10,Senate,"Do pass, but first be re-referred to the Committee on [Appropriations]",10,0,0,1,11
1849663,1431954,2024-04-22,Senate,"Placed on suspense file",7,0,0,0,7
1849663,1444337,2024-05-16,Senate,"Do pass",7,0,0,0,7
1849663,1448681,2024-05-22,Senate,"Senate 3rd Reading SB1385 Roth et al",39,0,0,1,40
1849663,1456436,2024-06-11,Assembly,"Do pass and be re-referred to the Committee on [Appropriations] with recommendation: To Consent Calendar",16,0,0,0,16
1849663,1458454,2024-06-19,Assembly,"Do pass. To Consent Calendar",14,0,0,1,15
1849663,1460736,2024-06-26,Assembly,"SB 1385 Roth Consent Calendar Second Day Regular Session",75,0,0,4,79
1849663,1462563,2024-07-03,Senate,"Special Consent SB1385 Roth et al",39,0,0,1,40
1849664,1423771,2024-04-09,Senate,"Do pass",10,0,0,1,11
1849664,1445220,2024-05-20,Senate,"Senate 3rd Reading SB1386 Caballero et al",39,0,0,1,40
1849664,1453444,2024-06-04,Assembly,"Do pass",8,0,0,4,12
1849664,1466335,2024-08-29,Senate,"Unfinished Business SB1386 Caballero et al. Concurrence",40,0,0,0,40
1849664,1466770,2024-08-28,Assembly,"SB 1386 Caballero Senate Third Reading By Petrie-Norris",72,0,0,7,79
1849665,1429921,2024-04-17,Senate,"Do pass, but first be re-referred to the Committee on [Transportation]",7,0,0,0,7
1849665,1434246,2024-04-23,Senate,"Do pass as amended, but first amend, and re-refer to the Committee on [Appropriations]",14,0,0,1,15
1849665,1442611,2024-05-13,Senate,"Placed on suspense file",7,0,0,0,7
1849665,1444681,2024-05-16,Senate,"Do pass",7,0,0,0,7
1849665,1449606,2024-05-23,Senate,"Special Consent SB1387 Newman",37,0,0,3,40
1849666,1434184,2024-04-24,Senate,"Do pass, but first be re-referred to the Committee on [Appropriations]",4,2,0,1,7
1849666,1439720,2024-05-06,Senate,"Placed on suspense file",7,0,0,0,7
1849668,1433174,2024-04-23,Senate,"Do pass as amended, but first amend, and re-refer to the Committee on [Appropriations]",11,0,0,0,11
1849668,1442625,2024-05-13,Senate,"Placed on suspense file",7,0,0,0,7
1849668,1444419,2024-05-16,Senate,"Do pass",7,0,0,0,7
1849668,1449621,2024-05-23,Senate,"Special Consent SB1390 Caballero et al",37,0,0,3,40
1849668,1460081,2024-06-25,Assembly,"Do pass as amended and be re-referred to the Committee on [Appropriations]",13,0,0,2,15
1849668,1464597,2024-08-15,Assembly,"Do pass as amended",11,0,0,4,15
1849668,1467097,2024-09-01,Assembly,"SB 1390 Caballero Senate Third Reading By Aguiar-Curry",37,2,0,40,79
1849669,1424916,2024-04-10,Senate,"Do pass, but first be re-referred to the Committee on [Appropriations] with the recommendation: To Consent Calendar",7,0,0,0,7
1849669,1431988,2024-04-22,Senate,"Placed on suspense file",7,0,0,0,7
1849669,1444062,2024-05-16,Senate,"Do pass",7,0,0,0,7
1849669,1449629,2024-05-23,Senate,"Special Consent SB1391 Rubio et al",37,0,0,3,40
1849669,1458257,2024-06-18,Assembly,"Do pass and be re-referred to the Committee on [Education]",8,0,0,3,11
1849669,1460776,2024-06-26,Assembly,"Do pass and be re-referred to the Committee on [Appropriations] with recommendation: To Consent Calendar",7,0,0,0,7
1849669,1464624,2024-08-15,Assembly,"Do pass as amended",11,0,0,4,15
1849669,1466400,2024-08-30,Senate,"Special Consent SB1391 Rubio et al",40,0,0,0,40
1849669,1466909,2024-08-28,Assembly,"SB 1391 Rubio Senate Third Reading By Quirk-Silva",77,0,0,2,79
1849671,1420094,2024-04-03,Senate,"Do pass, but first be re-referred to the Committee on [Transportation]",3,1,0,3,7
1849671,1420095,2024-04-03,Senate,"[First] hearing set for [04-03-2024]: Failed passage in Committee. Reconsideration granted",7,0,0,0,7
1849672,1424771,2024-04-09,Senate,"Do pass, but first be re-referred to the Committee on [Judiciary] with the recommendation: To Consent Calendar",15,0,0,0,15
1849672,1434269,2024-04-23,Senate,"Do pass, but first be re-referred to the Committee on [Appropriations] with the recommendation: To Consent Calendar",11,0,0,0,11
1849672,1441886,2024-05-09,Senate,"Consent Calendar 2nd SB1394 Min",37,0,0,3,40
1849672,1462554,2024-07-02,Assembly,"Do pass as amended and be re-referred to the Committee on [Appropriations]",10,0,0,1,11
1849672,1463740,2024-08-07,Assembly,"Do pass. To Consent Calendar",14,0,0,1,15
1849672,1467198,2024-08-31,Senate,"Unfinished Business SB1394 Min et al. Concurrence",38,0,0,2,40
1849672,1467199,2024-08-31,Assembly,"SB 1394 Min Senate Third Reading By Weber",76,1,0,2,79
1849673,1412577,2024-03-19,Senate,"Do pass, but first be re-referred to the Committee on [Environmental Quality]",9,0,0,1,10
1849673,1429943,2024-04-17,Senate,"Do pass as amended, but first amend, and re-refer to the Committee on [Appropriations]",7,0,0,0,7
1849673,1442595,2024-05-13,Senate,"Senate 3rd Reading SB1395 Becker",36,0,0,4,40
1849673,1456945,2024-06-12,Assembly,"Do pass and be re-referred to the Committee on [Natural Resources]",9,0,0,0,9
1849673,1459366,2024-06-24,Assembly,"Do pass and be re-referred to the Committee on [Appropriations] with recommendation: To Consent Calendar",10,0,0,1,11
1849673,1462371,2024-07-02,Assembly,"Do pass. To Consent Calendar",15,0,0,0,15
1849673,1465301,2024-08-19,Assembly,"SB 1395 Becker Senate Third Reading By Hart",74,0,0,5,79
1849674,1428836,2024-04-15,Senate,"Do pass, but first be re-referred to the Committee on [Appropriations]",5,0,0,0,5
1849674,1436171,2024-04-29,Senate,"Placed on suspense file",5,0,0,2,7
1849674,1444300,2024-05-16,Senate,"Do pass",7,0,0,0,7
1849674,1450282,2024-05-21,Senate,"Senate 3rd Reading SB1396 Alvarado-Gil",39,0,0,1,40
1849674,1456435,2024-06-11,Assembly,"Do pass and be re-referred to the Committee on [Appropriations]",6,0,0,1,7
1849675,1424871,2024-04-10,Senate,"Do pass as amended, but first amend, and re-refer to the Committee on [Appropriations]",11,0,0,0,11
1849675,1432005,2024-04-22,Senate,"Placed on suspense file",7,0,0,0,7
1849675,1444035,2024-05-16,Senate,"Do pass",7,0,0,0,7
1849675,1449681,2024-05-23,Senate,"Special Consent SB1397 Eggman",37,0,0,3,40
1849675,1458247,2024-06-18,Assembly,"Do pass and be re-referred to the Committee on [Appropriations] with recommendation: To Consent Calendar",16,0,0,0,16
1849677,1437638,2024-04-30,Senate,"Do pass",11,0,0,0,11
1849677,1445239,2024-05-20,Senate,"Senate 3rd Reading SB1399 Stern",39,0,0,1,40
1849677,1462324,2024-07-02,Assembly,"Do pass. To Consent Calendar",11,0,0,1,12
1849677,1463766,2024-08-08,Assembly,"SB 1399 Stern Consent Calendar Second Day Regular Session",72,0,0,7,79
1849677,1464073,2024-08-15,Senate,"Special Consent SB1399 Stern",37,0,0,3,40
1849678,1433168,2024-04-23,Senate,"Do pass, but first be re-referred to the Committee on [Appropriations]",5,0,0,0,5
1849678,1439668,2024-05-06,Senate,"Placed on suspense file",7,0,0,0,7
1849678,1444012,2024-05-16,Senate,"Do pass",5,0,0,2,7
1849678,1450345,2024-05-21,Senate,"Senate 3rd Reading SB1400 Stern et al",39,0,0,1,40
1849678,1458332,2024-06-18,Assembly,"Do pass and be re-referred to the Committee on [Appropriations]",5,0,0,3,8
1849678,1464225,2024-08-15,Assembly,"Do pass",11,1,0,3,15
1849678,1467131,2024-08-31,Senate,"Unfinished Business SB1400 Stern et al. Concurrence",38,0,0,2,40
1849678,1467132,2024-08-31,Assembly,"SB 1400 Stern Senate Third Reading By McCarty",64,1,0,14,79
1849679,1419132,2024-04-01,Senate,"Do pass, but first be re-referred to the Committee on [Appropriations]",5,0,0,0,5
1849679,1450341,2024-05-21,Senate,"Senate 3rd Reading SB1401 Blakespear",39,0,0,1,40
1849680,1423933,2024-04-09,Senate,"Do pass as amended, but first amend, and re-refer to the Committee on [Natural Resources and Water]",9,3,0,4,16
1849680,1432995,2024-04-23,Senate,"Do pass, but first be re-referred to the Committee on [Appropriations]",8,3,0,0,11
1849680,1439705,2024-05-06,Senate,"Placed on suspense file",7,0,0,0,7
1849680,1444229,2024-05-16,Senate,"Do pass",5,2,0,0,7
1849680,1450394,2024-05-21,Senate,"Senate 3rd Reading SB1402 Min",30,9,0,1,40
1849680,1457998,2024-06-17,Assembly,"Do pass and be re-referred to the Committee on [Water, Parks, and Wildlife]",6,3,0,2,11
1849680,1460108,2024-06-25,Assembly,"Do pass as amended and be re-referred to the Committee on [Appropriations]",10,1,0,4,15
1849681,1423728,2024-04-09,Senate,"Do pass as amended, but first amend, and re-refer to the Committee on [Governmental Organization]",8,1,0,2,11
1849681,1432972,2024-04-23,Senate,"Do pass, but first be re-referred to the Committee on [Appropriations]",11,2,0,3,16
1849681,1439627,2024-05-06,Senate,"Placed on suspense file",7,0,0,0,7
1849681,1444521,2024-05-16,Senate,"Do pass as amended",5,2,0,0,7
1849681,1450377,2024-05-21,Senate,"Senate 3rd Reading SB1403 Bradford et al",30,7,0,3,40
1849681,1456347,2024-06-11,Assembly,"Do pass and be re-referred to the Committee on [Appropriations]",9,3,0,0,12
1849681,1464014,2024-08-15,Assembly,"Do pass",11,3,0,1,15
1849682,1419201,2024-04-02,Senate,"Do pass as amended, but first amend, and re-refer to the Committee on [Appropriations]",5,0,0,2,7
1849682,1427228,2024-04-15,Senate,"Placed on suspense file",6,0,0,1,7
1849682,1444568,2024-05-16,Senate,"Do pass",5,1,0,1,7
1849682,1450342,2024-05-21,Senate,"Senate 3rd Reading SB1404 Glazer",28,2,0,10,40
1849682,1460613,2024-06-26,Assembly,"Do pass as amended and be re-referred to the Committee on [Appropriations]",6,0,0,2,8
1849683,1437659,2024-05-01,Senate,"Do pass and be ordered to the Consent Calendar",6,0,0,1,7
1849683,1441881,2024-05-09,Senate,"Consent Calendar 2nd SB1405 Ochoa Bogh",37,0,0,3,40
1849683,1456844,2024-06-12,Assembly,"Do pass. To Consent Calendar",9,0,0,0,9
1849683,1458834,2024-06-20,Assembly,"SB 1405 Ochoa Bogh Consent Calendar Second Day Regular Session",67,0,0,12,79
1849684,1428911,2024-04-15,Senate,"Do pass, but first be re-referred to the Committee on [Appropriations]",4,0,0,1,5
1849684,1436184,2024-04-29,Senate,"Placed on suspense file",5,0,0,2,7
1849684,1444283,2024-05-16,Senate,"Do pass",5,2,0,0,7
1849684,1445169,2024-05-20,Senate,"Senate 3rd Reading SB1406 Allen",31,7,0,2,40
1849684,1458341,2024-06-18,Assembly,"Do pass and be re-referred to the Committee on [Human Services]",5,1,0,1,7
1849684,1460062,2024-06-25,Assembly,"Do pass and be re-referred to the Committee on [Appropriations]",4,0,0,3,7
1849684,1464128,2024-08-15,Assembly,"Do pass as amended",11,1,0,3,15
1849684,1466242,2024-08-29,Senate,"Unfinished Business SB1406 Allen Concurrence",40,0,0,0,40
1849684,1466788,2024-08-28,Assembly,"SB 1406 Allen Senate Third Reading By Reyes",75,1,0,3,79
1849685,1423760,2024-04-09,Senate,"Do pass, but first be re-referred to the Committee on [Appropriations] with the recommendation: To Consent Calendar",14,0,0,2,16
1849685,1435204,2024-04-25,Senate,"Consent Calendar 2nd SB1407 Nguyen",36,0,0,4,40
1849685,1462026,2024-07-01,Assembly,"Do pass and be re-referred to the Committee on [Appropriations] with recommendation: To Consent Calendar",11,0,0,0,11
1849685,1464329,2024-08-15,Assembly,"Do pass",14,0,0,1,15
1849685,1467169,2024-08-28,Assembly,"SB 1407 Nguyen Senate Third Reading By Stephanie Nguyen",75,1,0,3,79
1849686,1420206,2024-04-02,Senate,"Do pass and be ordered to the Consent Calendar",11,0,0,0,11
1849686,1425898,2024-04-11,Senate,"Consent Calendar 2nd SB1408 Roth et al",39,0,0,1,40
1849686,1456965,2024-06-12,Assembly,"Do pass. To Consent Calendar",9,0,0,0,9
1849686,1458770,2024-06-20,Assembly,"SB 1408 Roth Consent Calendar Second Day Regular Session",67,0,0,12,79
1849688,1434039,2024-04-24,Senate,"Do pass as amended, but first amend, and re-refer to the Committee on [Appropriations]",7,0,0,0,7
1849688,1450291,2024-05-21,Senate,"Senate 3rd Reading SB1410 Ochoa Bogh",39,0,0,1,40
1849688,1456909,2024-06-12,Assembly,"Do pass and be re-referred to the Committee on [Appropriations] with recommendation: To Consent Calendar",7,0,0,0,7
1849688,1462314,2024-07-02,Assembly,"Do pass. To Consent Calendar",15,0,0,0,15
1849688,1463789,2024-08-08,Assembly,"SB 1410 Ochoa Bogh Consent Calendar Second Day Regular Session",72,0,0,7,79
1849688,1464401,2024-08-15,Senate,"Special Consent SB1410 Ochoa Bogh et al",37,0,0,3,40
1849689,1420052,2024-04-03,Senate,"Do pass, but first be re-referred to the Committee on [Appropriations]",6,0,0,1,7
1849689,1427236,2024-04-15,Senate,"Placed on suspense file",6,0,0,1,7
1849689,1444293,2024-05-16,Senate,"Do pass",7,0,0,0,7
1849689,1449609,2024-05-23,Senate,"Senate 3rd Reading SB1411 Ochoa Bogh",37,0,0,3,40
1849689,1456851,2024-06-12,Assembly,"Do pass as amended and be re-referred to the Committee on [Higher Education]",7,0,0,0,7
1849689,1462271,2024-07-02,Assembly,"Do pass and be re-referred to the Committee on [Appropriations]",10,0,0,1,11
1849689,1463724,2024-08-07,Assembly,"Do pass. To Consent Calendar",14,0,0,1,15
1849689,1466563,2024-08-30,Senate,"Special Consent SB1411 Ochoa Bogh",40,0,0,0,40
1849689,1467206,2024-08-28,Assembly,"SB 1411 Ochoa Bogh Senate Third Reading By Hoover",76,0,0,3,79
1849690,1420101,2024-04-03,Senate,"Do pass, but first be re-referred to the Committee on [Appropriations] with the recommendation: To Consent Calendar",6,0,0,1,7
1849690,1430988,2024-04-18,Senate,"Consent Calendar 2nd SB1412 Ochoa Bogh",39,0,0,1,40
1849690,1456879,2024-06-12,Assembly,"Do pass and be re-referred to the Committee on [Appropriations] with recommendation: To Consent Calendar",7,0,0,0,7
1849690,1462240,2024-07-02,Assembly,"Do pass. To Consent Calendar",15,0,0,0,15
1849690,1466446,2024-08-30,Senate,"Special Consent SB1412 Ochoa Bogh",40,0,0,0,40
1849690,1467170,2024-08-28,Assembly,"SB 1412 Ochoa Bogh Senate Third Reading By Hoover",77,0,0,2,79
1849691,1428825,2024-04-16,Senate,"Do pass as amended",13,0,0,5,18
1849691,1439606,2024-05-06,Senate,"Placed on suspense file",7,0,0,0,7
1849691,1444052,2024-05-16,Senate,"Do pass as amended",7,0,0,0,7
1849691,1449713,2024-05-23,Senate,"Senate 3rd Reading SB1413 Niello et al",33,1,0,6,40
1849691,1462004,2024-07-01,Assembly,"Do pass and be re-referred to the Committee on [Appropriations] with recommendation: To Consent Calendar",15,0,0,1,16
1849691,1464485,2024-08-15,Assembly,"Do pass",13,0,0,2,15
1849692,1428952,2024-04-16,Senate,"Amendments (Committee's)",3,1,0,1,5
1849692,1428953,2024-04-16,Senate,"Do pass as amended, but first amend, and re-refer to the Committee on [Appropriations]",4,0,0,1,5
1849692,1442536,2024-05-13,Senate,"Placed on suspense file",7,0,0,0,7
1849692,1444093,2024-05-16,Senate,"Do pass as amended",7,0,0,0,7
1849692,1449549,2024-05-23,Senate,"Senate 3rd Reading SB1414 Grove et al",36,0,0,4,40
1849692,1462666,2024-07-02,Assembly,"Do pass as amended and be re-referred to the Committee on [Appropriations]",8,0,0,0,8
1849692,1464509,2024-08-15,Assembly,"Do pass",14,0,0,1,15
1849692,1466586,2024-08-30,Assembly,"SB 1414 Grove Senate Third Reading By Stephanie Nguyen",73,0,0,6,79
1849692,1467038,2024-08-31,Senate,"Unfinished Business SB1414 Grove et al. Concurrence",38,0,0,2,40
1849693,1428844,2024-04-15,Senate,"Do pass, but first be re-referred to the Committee on [Appropriations]",5,0,0,0,5
1849693,1436223,2024-04-29,Senate,"Placed on suspense file",5,0,0,2,7
1849693,1444403,2024-05-16,Senate,"Do pass as amended",7,0,0,0,7
1849693,1450025,2024-05-24,Senate,"Special Consent SB1415 Glazer et al",38,0,0,2,40
1849693,1459991,2024-06-25,Assembly,"Do pass and be re-referred to the Committee on [Appropriations]",6,0,0,1,7
1849693,1463996,2024-08-15,Assembly,"Do pass as amended",11,0,0,4,15
1849693,1466382,2024-08-30,Senate,"Special Consent SB1415 Glazer et al",40,0,0,0,40
1849693,1466937,2024-08-28,Assembly,"SB 1415 Glazer Senate Third Reading By Lee",77,0,0,2,79
1849694,1423900,2024-04-09,Senate,"Do pass, but first be re-referred to the Committee on [Appropriations]",5,0,0,0,5
1849694,1442579,2024-05-13,Senate,"Placed on suspense file",7,0,0,0,7
1849694,1443993,2024-05-16,Senate,"Do pass as amended",7,0,0,0,7
1849694,1448682,2024-05-22,Senate,"Senate 3rd Reading SB1416 Newman et al",39,0,0,1,40
1849694,1456401,2024-06-11,Assembly,"Do pass and be re-referred to the Committee on [Appropriations]",8,0,0,0,8
1849694,1458528,2024-06-19,Assembly,"Do pass as amended",8,5,0,2,15
1849694,1463823,2024-08-08,Assembly,"SB 1416 Newman Senate Third Reading By Irwin",59,6,0,14,79
1849694,1463911,2024-08-12,Senate,"Unfinished Business SB1416 Newman et al. Concurrence",37,1,0,2,40
1849695,1424932,2024-04-09,Senate,"Do pass and be ordered to the Consent Calendar",15,0,0,0,15
1849695,1431000,2024-04-18,Senate,"Consent Calendar 2nd SB1417 Allen",39,0,0,1,40
1849695,1462282,2024-07-01,Assembly,"Do pass. To Consent Calendar",15,0,0,0,15
1849695,1463800,2024-08-08,Assembly,"SB 1417 Allen Consent Calendar Second Day Regular Session",72,0,0,7,79
1849696,1420109,2024-04-03,Senate,"Do pass as amended, but first amend, and re-refer to the Committee on [Transportation]",4,0,0,3,7
1849696,1434202,2024-04-23,Senate,"Do pass, but first be re-referred to the Committee on [Appropriations]",9,0,0,6,15
1849696,1450356,2024-05-21,Senate,"Senate 3rd Reading SB1418 Archuleta et al",33,0,0,7,40
1849696,1460465,2024-06-26,Assembly,"Do pass and be re-referred to the Committee on [Transportation]",7,0,0,2,9
1849696,1462296,2024-07-01,Assembly,"Do pass as amended and be re-referred to the Committee on [Appropriations]",14,1,0,0,15
1849696,1463729,2024-08-07,Assembly,"Do pass",13,0,0,2,15
1849696,1466334,2024-08-29,Senate,"Unfinished Business SB1418 Archuleta et al. Concurrence",31,1,0,8,40
1849696,1466824,2024-08-28,Assembly,"SB 1418 Archuleta Senate Third Reading By Petrie-Norris",59,3,0,17,79
1849697,1428782,2024-04-16,Senate,"Do pass, but first be re-referred to the Committee on [Revenue and Taxation]",3,0,0,2,5
1849697,1439673,2024-05-06,Senate,"Placed on suspense file",7,0,0,0,7
1849697,1443942,2024-05-16,Senate,"Do pass",7,0,0,0,7
1849697,1449686,2024-05-23,Senate,"Special Consent SB1419 Rubio",37,0,0,3,40
1849697,1460489,2024-06-26,Assembly,"Do pass and be re-referred to the Committee on [Appropriations]",8,0,0,2,10
1849697,1464371,2024-08-15,Assembly,"Do pass as amended",11,0,0,4,15
1849697,1466569,2024-08-30,Assembly,"SB 1419 Rubio Senate Third Reading By Wilson",77,0,0,2,79
1849697,1467078,2024-08-31,Senate,"Unfinished Business SB1419 Rubio et al. Concurrence",40,0,0,0,40
1849698,1420176,2024-04-03,Senate,"Do pass as amended, but first amend, and re-refer to the Committee on [Energy, Utilities and Communications]",5,0,0,2,7
1849698,1432945,2024-04-22,Senate,"Do pass as amended, but first amend, and re-refer to the Committee on [Appropriations]",14,0,0,4,18
1849698,1442519,2024-05-13,Senate,"Placed on suspense file",7,0,0,0,7
1849698,1444557,2024-05-16,Senate,"Do pass as amended",4,0,0,3,7
1849698,1448671,2024-05-22,Senate,"Senate 3rd Reading SB1420 Caballero et al",30,1,0,9,40
1849698,1458417,2024-06-19,Assembly,"Do pass as amended and be re-referred to the Committee on [Natural Resources]",13,0,0,3,16
1849698,1462091,2024-07-01,Assembly,"Do pass as amended and be re-referred to the Committee on [Appropriations]",12,0,0,0,12
1849698,1464468,2024-08-15,Assembly,"Do pass",13,0,0,2,15
1849698,1467120,2024-08-31,Senate,"Unfinished Business SB1420 Caballero et al. Concurrence",35,0,0,5,40
1849698,1467121,2024-08-31,Assembly,"SB 1420 Caballero Senate Third Reading By Petrie-Norris",60,1,0,18,79
1849699,1424792,2024-04-10,Senate,"Do pass as amended, but first amend, and re-refer to the Committee on [Judiciary]",7,0,0,0,7
1849699,1434207,2024-04-23,Senate,"Do pass, but first be re-referred to the Committee on [Appropriations]",11,0,0,0,11
1849699,1442561,2024-05-13,Senate,"Placed on suspense file",7,0,0,0,7
1849700,1428890,2024-04-16,Senate,"Do pass, but first be re-referred to the Committee on [Appropriations]",7,0,0,0,7
1849700,1436187,2024-04-29,Senate,"Placed on suspense file",5,0,0,2,7
1849701,1435187,2024-04-24,Senate,"Do pass as amended, but first amend, and re-refer to the Committee on [Appropriations]",11,0,0,0,11
1849701,1439657,2024-05-06,Senate,"Placed on suspense file",7,0,0,0,7
1849701,1444072,2024-05-16,Senate,"Do pass as amended",7,0,0,0,7
1849701,1448568,2024-05-22,Senate,"Senate 3rd Reading SB1423 Dahle et al",38,0,0,2,40
1849701,1460045,2024-06-25,Assembly,"Do pass as amended and be re-referred to the Committee on [Appropriations]",16,0,0,0,16
1849701,1464349,2024-08-15,Assembly,"Do pass",14,0,0,1,15
1849701,1465727,2024-08-26,Assembly,"SB 1423 Dahle Senate Third Reading By Wood",77,0,0,2,79
1849701,1466951,2024-08-28,Senate,"Unfinished Business SB1423 Dahle et al. Concurrence",39,0,0,1,40
1849702,1428838,2024-04-16,Senate,"Do pass as amended, but first amend, and re-refer to the Committee on [Appropriations]",5,2,0,4,11
1849702,1428839,2024-04-16,Senate,"[First] hearing set for [04-16-2024]: Failed passage in Committee. Reconsideration granted",11,0,0,0,11
1849702,1434213,2024-04-23,Senate,"Do pass as amended, but first amend, and re-refer to the Committee on [Appropriations]",6,2,0,3,11
1849702,1442557,2024-05-13,Senate,"Placed on suspense file",7,0,0,0,7
1849703,1427342,2024-04-15,Senate,"Do pass, but first be re-referred to the Committee on [Appropriations] with the recommendation: To Consent Calendar",10,0,0,1,11
1849703,1436180,2024-04-29,Senate,"Placed on suspense file",5,0,0,2,7
1849703,1444193,2024-05-16,Senate,"Do pass as amended",7,0,0,0,7
1849703,1450020,2024-05-24,Senate,"Special Consent SB1425 Gonzalez Urgency Clause",38,0,0,2,40
1849703,1457941,2024-06-17,Assembly,"Do pass and be re-referred to the Committee on [Appropriations] with recommendation: To Consent Calendar",10,0,0,1,11
1849703,1464443,2024-08-15,Assembly,"Do pass",14,0,0,1,15
1849703,1467167,2024-08-28,Assembly,"SB 1425 Gonzalez Third Reading Urgency By Lowenthal",76,0,0,3,79
1849704,1434162,2024-04-24,Senate,"Do pass as amended, but first amend, and re-refer to the Committee on [Local Government]",3,2,0,2,7
1849705,1420082,2024-04-02,Senate,"Do pass as amended, but first amend, and re-refer to the Committee on [Appropriations] with the recommendation: To Consent Calendar",11,0,0,0,11
1849705,1441893,2024-05-09,Senate,"Consent Calendar 2nd SB1427 Allen",37,0,0,3,40
1849705,1453472,2024-06-04,Assembly,"Do pass and be re-referred to the Committee on [Appropriations] with recommendation: To Consent Calendar",8,0,0,4,12
1849705,1462244,2024-07-02,Assembly,"Do pass. To Consent Calendar",15,0,0,0,15
1849705,1463796,2024-08-08,Assembly,"SB 1427 Allen Consent Calendar Second Day Regular Session",72,0,0,7,79
1849706,1420130,2024-04-03,Senate,"Do pass, but first be re-referred to the Committee on [Appropriations] with the recommendation: To Consent Calendar",10,0,0,1,11
1849706,1431003,2024-04-18,Senate,"Consent Calendar 2nd SB1428 Atkins",39,0,0,1,40
1849706,1453423,2024-06-04,Assembly,"Do pass and be re-referred to the Committee on [Appropriations] with recommendation: To Consent Calendar",15,0,0,1,16
1849707,1412582,2024-03-20,Senate,"Do pass, but first be re-referred to the Committee on [Appropriations] with the recommendation: To Consent Calendar",7,0,0,0,7
1849707,1425907,2024-04-11,Senate,"Consent Calendar 2nd SB1429 Ochoa Bogh",39,0,0,1,40
1849707,1456853,2024-06-12,Assembly,"Do pass as amended, and be re-referred to the Committee on [Appropriations] with recommendation: To Consent Calendar",7,0,0,0,7
1849707,1462317,2024-07-02,Assembly,"Do pass. To Consent Calendar",15,0,0,0,15
1849707,1463790,2024-08-08,Assembly,"SB 1429 Ochoa Bogh Consent Calendar Second Day Regular Session",72,0,0,7,79
1849707,1464541,2024-08-15,Senate,"Special Consent SB1429 Ochoa Bogh et al",37,0,0,3,40
1849708,1428803,2024-04-16,Senate,"Do pass, but first be re-referred to the Committee on [Appropriations] with the recommendation: To Consent Calendar",5,0,0,0,5
1849708,1442641,2024-05-13,Senate,"Placed on suspense file",7,0,0,0,7
1849709,1424816,2024-04-10,Senate,"Do pass as amended, but first amend, and re-refer to the Committee on [Governmental Organization]",7,0,0,0,7
1849710,1435324,2024-04-24,Senate,"Do pass as amended, but first amend, and re-refer to the Committee on [Appropriations]",11,0,0,0,11
1849710,1439726,2024-05-06,Senate,"Placed on suspense file",7,0,0,0,7
1849710,1444023,2024-05-16,Senate,"Do pass as amended",7,0,0,0,7
1849710,1448636,2024-05-22,Senate,"Senate 3rd Reading SB1432 Caballero et al",37,0,0,3,40
1849710,1460111,2024-06-25,Assembly,"Do pass as amended and be re-referred to the Committee on [Appropriations]",14,0,0,2,16
1849710,1464143,2024-08-15,Assembly,"Do pass as amended",14,0,0,1,15
1849710,1466477,2024-08-30,Senate,"Unfinished Business SB1432 Caballero et al. Concurrence",31,0,0,9,40
1849710,1466965,2024-08-28,Assembly,"SB 1432 Caballero Senate Third Reading By Blanca Rubio",56,0,0,23,79
1849711,1423831,2024-04-09,Senate,"Do pass, but first be re-referred to the Committee on [Environmental Quality]",8,0,0,3,11
1849711,1434051,2024-04-24,Senate,"Do pass, but first be re-referred to the Committee on [Appropriations]",5,0,0,2,7
1849711,1442618,2024-05-13,Senate,"Placed on suspense file",7,0,0,0,7
1849711,1444249,2024-05-16,Senate,"Do pass as amended",5,1,0,1,7
1849711,1450344,2024-05-21,Senate,"Senate 3rd Reading SB1433 Lim√≥n",32,4,0,4,40
1849711,1458019,2024-06-17,Assembly,"Do pass as amended, and be re-referred to the Committee on [Appropriations] with recommendation: To Consent Calendar",10,0,0,1,11
1849713,1429930,2024-04-17,Senate,"Do pass, but first be re-referred to the Committee on [Judiciary]",2,3,0,2,7
1849713,1429931,2024-04-17,Senate,"[04-17-2024] hearing: Motion to Reconsider. [Reconsideration Granted.]",7,0,0,0,7
1849713,1434221,2024-04-24,Senate,"Do pass, but first be re-referred to the Committee on [Judiciary]",2,3,0,2,7
1849714,1424952,2024-04-10,Senate,"Do pass, but first be re-referred to the Committee on [Governmental Organization]",6,0,0,1,7
1849714,1433061,2024-04-23,Senate,"Do pass as amended, but first amend, and re-refer to the Committee on [Appropriations]",11,1,0,4,16
1849714,1439674,2024-05-06,Senate,"Placed on suspense file",7,0,0,0,7
1849716,1420045,2024-04-02,Senate,"Do pass, but first be re-referred to the Committee on [Judiciary]",2,5,0,3,10
1849716,1420046,2024-04-02,Senate,"[First] hearing set for [04-02-2024]: Failed passage in Committee. Reconsideration granted",10,0,0,0,10
1849717,1437663,2024-05-01,Senate,"Do pass as amended",6,0,0,1,7
1849717,1445278,2024-05-20,Senate,"Senate 3rd Reading SB1439 Ashby",37,0,0,3,40
1849717,1458470,2024-06-19,Assembly,"Do pass and be re-referred to the Committee on [Housing and Community Development]",9,0,0,0,9
1849717,1460639,2024-06-26,Assembly,"Do pass and be re-referred to the Committee on [Appropriations]",2,6,0,1,9
1849718,1434103,2024-04-24,Senate,"Do pass, but first be re-referred to the Committee on [Appropriations]",7,0,0,0,7
1849718,1445290,2024-05-20,Senate,"Senate 3rd Reading SB1440 Laird",39,0,0,1,40
1849718,1460637,2024-06-26,Assembly,"Do pass as amended and be re-referred to the Committee on [Appropriations]",7,0,0,0,7
1849718,1463735,2024-08-07,Assembly,"Do pass. To Consent Calendar",14,0,0,1,15
1849718,1464522,2024-08-15,Assembly,"SB 1440 Laird Consent Calendar Second Day Regular Session",75,0,0,4,79
1849718,1465587,2024-08-26,Senate,"That the Assembly amendments be concurred in",6,0,0,1,7
1849718,1467177,2024-08-28,Senate,"Special Consent SB1440 Laird et al",39,0,0,1,40
1849719,1420049,2024-04-02,Senate,"Do pass as amended, but first amend, and re-refer to the Committee on [Elections and Constitutional Amendments]",9,2,0,0,11
1849719,1428886,2024-04-16,Senate,"Do pass, but first be re-referred to the Committee on [Appropriations]",6,1,0,0,7
1849719,1450300,2024-05-21,Senate,"Senate 3rd Reading SB1441 Allen By Umberg",31,8,0,1,40
1849719,1456329,2024-06-11,Assembly,"Do pass and be re-referred to the Committee on [Elections]",9,3,0,0,12
1849719,1460588,2024-06-26,Assembly,"Do pass and be re-referred to the Committee on [Appropriations]",6,2,0,0,8
1849719,1463760,2024-08-07,Assembly,"Do pass",10,4,0,1,15
1849719,1465675,2024-08-26,Assembly,"SB 1441 Allen Senate Third Reading By Berman",60,17,0,2,79
1849719,1467039,2024-08-28,Senate,"Unfinished Business SB1441 Allen Concurrence",31,8,0,1,40
1849720,1424866,2024-04-10,Senate,"Do pass, but first be re-referred to the Committee on [Appropriations] with the recommendation: To Consent Calendar",11,0,0,0,11
1849720,1431970,2024-04-22,Senate,"Placed on suspense file",7,0,0,0,7
1849720,1444394,2024-05-16,Senate,"Do pass as amended",7,0,0,0,7
1849720,1448824,2024-05-22,Senate,"Senate 3rd Reading SB1442 Ochoa Bogh et al",38,0,0,2,40
1849720,1456398,2024-06-11,Assembly,"Do pass as amended, and be re-referred to the Committee on [Appropriations] with recommendation: To Consent Calendar",16,0,0,0,16
1849721,1419169,2024-04-01,Senate,"Do pass, but first be re-referred to the Committee on [Housing] with the recommendation: To Consent Calendar",5,0,0,0,5
1849721,1428940,2024-04-16,Senate,"Do pass, but first be re-referred to the Committee on [Appropriations] with the recommendation: To Consent Calendar",10,0,0,0,10
1849721,1436168,2024-04-29,Senate,"Placed on suspense file",5,0,0,2,7
1849721,1444126,2024-05-16,Senate,"Do pass",7,0,0,0,7
1849721,1449661,2024-05-23,Senate,"Special Consent SB1443 Jones",37,0,0,3,40
1849721,1456946,2024-06-12,Assembly,"Do pass and be re-referred to the Committee on [Human Services] with recommendation: To Consent Calendar",9,0,0,0,9
1849721,1459959,2024-06-25,Assembly,"Do pass and be re-referred to the Committee on [Appropriations] with recommendation: To Consent Calendar",6,0,0,1,7
1849721,1464088,2024-08-15,Assembly,"Do pass",14,0,0,1,15
1849721,1466480,2024-08-30,Senate,"Special Consent SB1443 Jones",40,0,0,0,40
1849721,1466997,2024-08-28,Assembly,"SB 1443 Jones Senate Third Reading By Luz Rivas",77,0,0,2,79
1849722,1434268,2024-04-23,Senate,"Do pass as amended, but first amend, and re-refer to the Committee on [Appropriations]",9,0,0,2,11
1849722,1442639,2024-05-13,Senate,"Placed on suspense file",7,0,0,0,7
1849723,1430012,2024-04-17,Senate,"Do pass as amended",7,0,0,0,7
1849723,1445189,2024-05-20,Senate,"Senate 3rd Reading SB1445 Cortese",34,5,0,1,40
1849723,1456884,2024-06-12,Assembly,"Do pass",5,1,0,1,7
1849723,1465272,2024-08-19,Assembly,"SB 1445 Cortese Senate Third Reading By Bonta",58,16,0,5,79
1849724,1429940,2024-04-17,Senate,"Do pass, but first be re-referred to the Committee on [Appropriations]",4,1,0,0,5
1849724,1439727,2024-05-06,Senate,"Placed on suspense file",7,0,0,0,7
1849724,1443986,2024-05-16,Senate,"Do pass as amended",5,2,0,0,7
1849724,1450286,2024-05-21,Senate,"Senate 3rd Reading SB1446 Smallwood-Cuevas",25,12,0,3,40
1849724,1458555,2024-06-19,Assembly,"Do pass and be re-referred to the Committee on [Privacy and Consumer Protection]",5,2,0,0,7
1849724,1462463,2024-07-02,Assembly,"Do pass as amended and be re-referred to the Committee on [Appropriations]",7,3,0,1,11
1849724,1464002,2024-08-15,Assembly,"Do pass and be re-referred to the Committee on [Rules]",10,3,0,2,15
1849725,1435365,2024-04-24,Senate,"Do pass as amended, but first amend, and re-refer to the Committee on [Appropriations]",11,0,0,0,11
1849725,1439681,2024-05-06,Senate,"Placed on suspense file",7,0,0,0,7
1849725,1443988,2024-05-16,Senate,"Do pass",7,0,0,0,7
1849725,1448803,2024-05-22,Senate,"Senate 3rd Reading SB1447 Durazo et al",38,0,0,2,40
1849725,1458188,2024-06-18,Assembly,"Do pass and be re-referred to the Committee on [Appropriations]",13,0,0,3,16
1849725,1464399,2024-08-15,Assembly,"Do pass",14,0,0,1,15
1849725,1466433,2024-08-30,Senate,"Special Consent SB1447 Durazo et al",40,0,0,0,40
1849725,1466906,2024-08-28,Assembly,"SB 1447 Durazo Senate Third Reading By Calderon",69,0,0,10,79
1849726,1428904,2024-04-16,Senate,"Do pass, but first be re-referred to the Committee on [Natural Resources and Water]",3,0,0,2,5
1849726,1432965,2024-04-23,Senate,"Do pass, but first be re-referred to the Committee on [Appropriations]",10,0,0,1,11
1849726,1445155,2024-05-20,Senate,"Senate 3rd Reading SB1448 Hurtado",39,0,0,1,40
1849726,1460456,2024-06-26,Assembly,"Do pass and be re-referred to the Committee on [Appropriations]",6,0,0,4,10
1849726,1464109,2024-08-15,Assembly,"Do pass as amended",11,1,0,3,15
1849726,1466092,2024-08-29,Senate,"Unfinished Business SB1448 Hurtado Urgency Clause Concurrence",34,2,0,4,40
1849726,1466699,2024-08-28,Assembly,"SB 1448 Hurtado Third Reading Urgency By Wilson",66,4,0,9,79
1849727,1427208,2024-04-15,Senate,"Do pass, but first be re-referred to the Committee on [Education]",12,0,0,1,13
1849727,1434237,2024-04-24,Senate,"Do pass, but first be re-referred to the Committee on [Appropriations] with the recommendation: To Consent Calendar",7,0,0,0,7
1849727,1439636,2024-05-06,Senate,"Do pass",6,0,0,1,7
1849727,1444294,2024-05-16,Senate,"Senate 3rd Reading SB1449 Newman et al",38,0,0,2,40
1849727,1458154,2024-06-18,Assembly,"Do pass and be re-referred to the Committee on [Business and Professions]",9,0,0,2,11
1849727,1459961,2024-06-25,Assembly,"Do pass and be re-referred to the Committee on [Appropriations]",18,0,0,0,18
1849728,1428938,2024-04-16,Senate,"Do pass, but first be re-referred to the Committee on [Appropriations]",6,0,0,1,7
1849728,1436217,2024-04-29,Senate,"Placed on suspense file",5,0,0,2,7
1849728,1444438,2024-05-16,Senate,"Do pass",6,0,0,1,7
1849728,1444439,2024-05-16,Senate,"[05-16-2024] set for [First] hearing: Reconsideration of favorable vote granted",7,0,0,0,7
1849728,1444440,2024-05-16,Senate,"Do pass",5,0,0,2,7
1849728,1445194,2024-05-20,Senate,"Senate 3rd Reading SB1450 Allen",32,0,0,8,40
1849728,1460651,2024-06-26,Assembly,"Do pass and be re-referred to the Committee on [Appropriations]",6,0,0,2,8
1849728,1464377,2024-08-15,Assembly,"Do pass",11,0,0,4,15
1849728,1467098,2024-08-31,Senate,"Unfinished Business SB1450 Allen et al. Concurrence",33,0,0,7,40
1849728,1467099,2024-08-31,Assembly,"SB 1450 Allen Senate Third Reading By Berman",67,0,0,12,79
1849729,1431986,2024-04-22,Senate,"Do pass, but first be re-referred to the Committee on [Appropriations]",12,0,0,1,13
1849729,1442620,2024-05-13,Senate,"Senate 3rd Reading SB1451 Ashby",36,0,0,4,40
1849729,1460038,2024-06-25,Assembly,"Do pass and be re-referred to the Committee on [Appropriations]",13,1,0,4,18
1849729,1463749,2024-08-07,Assembly,"Do pass",10,0,0,5,15
1849729,1466020,2024-08-27,Assembly,"Do pass",14,1,0,3,18
1849729,1466520,2024-08-30,Assembly,"SB 1451 Ashby Senate Third Reading By Berman",65,1,0,13,79
1849729,1467037,2024-08-31,Senate,"Unfinished Business SB1451 Ashby Concurrence",38,0,0,2,40
1849730,1427332,2024-04-15,Senate,"Do pass, but first be re-referred to the Committee on [Judiciary]",12,0,0,1,13
1849730,1434086,2024-04-23,Senate,"Do pass, but first be re-referred to the Committee on [Appropriations] with the recommendation: To Consent Calendar",11,0,0,0,11
1849730,1439698,2024-05-06,Senate,"Placed on suspense file",7,0,0,0,7
1849730,1444370,2024-05-16,Senate,"Do pass",7,0,0,0,7
1849730,1449717,2024-05-23,Senate,"Special Consent SB1452 Ashby",37,0,0,3,40
1849730,1460034,2024-06-25,Assembly,"Do pass as amended and be re-referred to the Committee on [Judiciary]",18,0,0,0,18
1849730,1464181,2024-08-15,Assembly,"Do pass",13,0,0,2,15
1849730,1466087,2024-08-29,Senate,"Unfinished Business SB1452 Ashby Concurrence",39,0,0,1,40
1849730,1467187,2024-08-28,Assembly,"SB 1452 Ashby Senate Third Reading By Berman",76,0,0,3,79
1849731,1431972,2024-04-22,Senate,"Do pass as amended, but first amend, and re-refer to the Committee on [Appropriations]",12,0,0,1,13
1849731,1439706,2024-05-06,Senate,"Placed on suspense file",7,0,0,0,7
1849731,1443976,2024-05-16,Senate,"Do pass",7,0,0,0,7
1849731,1445212,2024-05-20,Senate,"Senate 3rd Reading SB1453 Ashby",39,0,0,1,40
1849731,1462356,2024-07-02,Assembly,"Do pass as amended and be re-referred to the Committee on [Appropriations]",16,0,0,2,18
1849731,1464164,2024-08-15,Assembly,"Do pass",13,0,0,2,15
1849731,1466528,2024-08-30,Senate,"Special Consent SB1453 Ashby et al",40,0,0,0,40
1849731,1467059,2024-08-28,Assembly,"SB 1453 Ashby Senate Third Reading By Berman",77,0,0,2,79
1849732,1427283,2024-04-15,Senate,"Do pass, but first be re-referred to the Committee on [Judiciary]",12,0,0,1,13
1849732,1434060,2024-04-23,Senate,"Do pass, but first be re-referred to the Committee on [Appropriations] with the recommendation: To Consent Calendar",11,0,0,0,11
1849732,1439643,2024-05-06,Senate,"Placed on suspense file",7,0,0,0,7
1849732,1444546,2024-05-16,Senate,"Do pass",7,0,0,0,7
1849732,1449653,2024-05-23,Senate,"Special Consent SB1454 Ashby",37,0,0,3,40
1849732,1460078,2024-06-25,Assembly,"Do pass and be re-referred to the Committee on [Appropriations]",16,0,0,2,18
1849732,1464577,2024-08-15,Assembly,"Do pass as amended",11,0,0,4,15
1849732,1466532,2024-08-30,Senate,"Unfinished Business SB1454 Ashby et al. Concurrence",40,0,0,0,40
1849732,1467076,2024-08-28,Assembly,"SB 1454 Ashby Senate Third Reading By Berman",74,0,0,5,79
1849733,1431911,2024-04-22,Senate,"Do pass, but first be re-referred to the Committee on [Appropriations]",12,0,0,1,13
1849733,1439640,2024-05-06,Senate,"Placed on suspense file",7,0,0,0,7
1849733,1444590,2024-05-16,Senate,"Do pass as amended",7,0,0,0,7
1849733,1450023,2024-05-24,Senate,"Special Consent SB1455 Ashby",38,0,0,2,40
1849733,1460033,2024-06-25,Assembly,"Do pass and be re-referred to the Committee on [Appropriations]",18,0,0,0,18
1849733,1464397,2024-08-15,Assembly,"Do pass as amended",11,0,0,4,15
1849733,1466392,2024-08-30,Senate,"Special Consent SB1455 Ashby",40,0,0,0,40
1849733,1467159,2024-08-28,Assembly,"SB 1455 Ashby Senate Third Reading By Berman",77,0,0,2,79
1849734,1431897,2024-04-22,Senate,"Do pass, but first be re-referred to the Committee on [Appropriations]",12,0,0,1,13
1849734,1439662,2024-05-06,Senate,"Placed on suspense file",7,0,0,0,7
1849734,1444248,2024-05-16,Senate,"Do pass",7,0,0,0,7
1849734,1449688,2024-05-23,Senate,"Special Consent SB1456 Ashby",37,0,0,3,40
1849734,1458224,2024-06-18,Assembly,"Do pass as amended and be re-referred to the Committee on [Business and Professions]",6,0,0,1,7
1849734,1460001,2024-06-25,Assembly,"Do pass and be re-referred to the Committee on [Appropriations]",18,0,0,0,18
1849734,1464433,2024-08-15,Assembly,"Do pass",14,0,0,1,15
1849734,1465579,2024-08-26,Assembly,"SB 1456 Ashby Senate Third Reading By Berman",77,0,0,2,79
1849734,1467158,2024-08-31,Senate,"Unfinished Business SB1456 Ashby Concurrence",39,0,0,1,40
1849736,1420100,2024-04-02,Senate,"Do pass and be ordered to the Consent Calendar",11,0,0,0,11
1849736,1425915,2024-04-11,Senate,"Consent Calendar 2nd SB1458 Allen",39,0,0,1,40
1849736,1453402,2024-06-04,Assembly,"Do pass. To Consent Calendar",8,0,0,4,12
1849736,1465280,2024-08-19,Assembly,"SB 1458 Allen Senate Third Reading By Gabriel",77,0,0,2,79
1849736,1465521,2024-08-22,Senate,"Unfinished Business SB1458 Allen Concurrence",33,0,0,7,40
1849737,1431919,2024-04-22,Senate,"Do pass as amended, but first amend, and re-refer to the Committee on [Appropriations]",12,0,0,1,13
1849737,1439656,2024-05-06,Senate,"Placed on suspense file",7,0,0,0,7
1849737,1444042,2024-05-16,Senate,"Do pass as amended",7,0,0,0,7
1849737,1450012,2024-05-24,Senate,"Special Consent SB1459 Nguyen et al",38,0,0,2,40
1849737,1459945,2024-06-25,Assembly,"Do pass as amended and be re-referred to the Committee on [Appropriations]",18,0,0,0,18
1849738,1428868,2024-04-16,Senate,"Do pass, but first be re-referred to the Committee on [Labor, Public Employment and Retirement ]",14,4,0,0,18
1849738,1434102,2024-04-24,Senate,"Do pass as amended, but first amend, and re-refer to the Committee on [Appropriations]",4,1,0,0,5
1849738,1442576,2024-05-13,Senate,"Placed on suspense file",7,0,0,0,7
1849738,1444416,2024-05-16,Senate,"Do pass",5,2,0,0,7
1849738,1450271,2024-05-21,Senate,"Senate 3rd Reading SB1460 Durazo",30,9,0,1,40
1849738,1458493,2024-06-19,Assembly,"Do pass and be re-referred to the Committee on [Communications and Conveyance]",7,0,0,0,7
1849738,1460740,2024-06-26,Assembly,"Do pass as amended and be re-referred to the Committee on [Appropriations]",10,0,0,1,11
1849739,1423926,2024-04-09,Senate,"Do pass, but first be re-referred to the Committee on [Appropriations] with the recommendation: To Consent Calendar",14,0,0,2,16
1849739,1442539,2024-05-13,Senate,"Placed on suspense file",7,0,0,0,7
1849739,1444227,2024-05-16,Senate,"Do pass as amended",7,0,0,0,7
1849739,1450037,2024-05-24,Senate,"Special Consent SB1461 Allen",38,0,0,2,40
1849739,1460014,2024-06-24,Assembly,"Do pass and be re-referred to the Committee on [Appropriations] with recommendation: To Consent Calendar",8,0,0,0,8
1849739,1464568,2024-08-15,Assembly,"Do pass",14,0,0,1,15
1849740,1427251,2024-04-15,Senate,"Do pass, but first be re-referred to the Committee on [Judiciary]",7,2,0,4,13
1849740,1434161,2024-04-23,Senate,"Do pass as amended, but first amend, and re-refer to the Committee on [Appropriations]",8,3,0,0,11
1849740,1442524,2024-05-13,Senate,"Placed on suspense file",7,0,0,0,7
1849741,1419149,2024-04-01,Senate,"Do pass, but first be re-referred to the Committee on [Appropriations]",5,0,0,0,5
1849741,1427347,2024-04-15,Senate,"Placed on suspense file",6,0,0,1,7
1849741,1444424,2024-05-16,Senate,"Do pass as amended",7,0,0,0,7
1849741,1449998,2024-05-24,Senate,"Special Consent SB1463 Niello",38,0,0,2,40
1849741,1456446,2024-06-11,Assembly,"Do pass and be re-referred to the Committee on [Appropriations]",6,0,0,1,7
1849741,1464370,2024-08-15,Assembly,"Do pass",14,0,0,1,15
1849741,1465613,2024-08-26,Assembly,"SB 1463 Niello Senate Third Reading By Stephanie Nguyen",77,0,0,2,79
1849741,1467201,2024-08-28,Senate,"Unfinished Business SB1463 Niello Concurrence",39,0,0,1,40
1849742,1435338,2024-04-24,Senate,"Do pass, but first be re-referred to the Committee on [Appropriations] with the recommendation: To Consent Calendar",11,0,0,0,11
1849742,1444196,2024-05-16,Senate,"Consent Calendar 2nd SB1464 Ashby",38,0,0,2,40
1849742,1453427,2024-06-04,Assembly,"Do pass and be re-referred to the Committee on [Appropriations] with recommendation: To Consent Calendar",15,0,0,1,16
1849742,1458403,2024-06-19,Assembly,"Do pass. To Consent Calendar",14,0,0,1,15
1849742,1460435,2024-06-26,Assembly,"SB 1464 Ashby Consent Calendar Second Day Regular Session",75,0,0,4,79
1849743,1420195,2024-04-02,Senate,"Do pass as amended, but first amend, and re-refer to the Committee on [Judiciary]",10,0,0,0,10
1849743,1428934,2024-04-16,Senate,"Do pass, but first be re-referred to the Committee on [Appropriations]",11,0,0,0,11
1849743,1436160,2024-04-29,Senate,"Placed on suspense file",5,0,0,2,7
1849743,1444477,2024-05-16,Senate,"Do pass",7,0,0,0,7
1849743,1449619,2024-05-23,Senate,"Special Consent SB1465 Archuleta et al",37,0,0,3,40
1849743,1458452,2024-06-19,Assembly,"Do pass and be re-referred to the Committee on [Appropriations]",7,0,0,2,9
1849743,1464033,2024-08-15,Assembly,"Do pass",14,0,0,1,15
1849743,1466441,2024-08-30,Senate,"Special Consent SB1465 Archuleta et al",40,0,0,0,40
1849743,1466933,2024-08-28,Assembly,"SB 1465 Archuleta Senate Third Reading By Quirk-Silva",77,0,0,2,79
1849746,1422030,2024-04-08,Senate,"Do pass, but first be re-referred to the Committee on [Appropriations] with the recommendation: To Consent Calendar",11,0,0,2,13
1849746,1436197,2024-04-29,Senate,"Placed on suspense file",5,0,0,2,7
1849746,1444683,2024-05-16,Senate,"Do pass as amended",7,0,0,0,7
1849746,1448597,2024-05-22,Senate,"Senate 3rd Reading SB1468 Ochoa Bogh et al",38,0,0,2,40
1849746,1459967,2024-06-25,Assembly,"Do pass as amended and be re-referred to the Committee on [Appropriations]",18,0,0,0,18
1849746,1463737,2024-08-07,Assembly,"Do pass. To Consent Calendar",14,0,0,1,15
1849746,1464502,2024-08-15,Assembly,"SB 1468 Ochoa Bogh Consent Calendar Second Day Regular Session",75,0,0,4,79
1849746,1465508,2024-08-22,Senate,"Special Consent SB1468 Ochoa Bogh et al",33,0,0,7,40
1849749,1434169,2024-04-24,Senate,"Do pass as amended",7,0,0,0,7
1849749,1445151,2024-05-20,Senate,"Senate 3rd Reading SB1471 Stern et al",39,0,0,1,40
1849749,1456961,2024-06-12,Assembly,"Do pass as amended",7,0,0,0,7
1849749,1466435,2024-08-30,Senate,"Special Consent SB1471 Stern et al",40,0,0,0,40
1849749,1466924,2024-08-28,Assembly,"SB 1471 Stern Senate Third Reading By Friedman",76,0,0,3,79
1849750,1432952,2024-04-23,Senate,"Do pass, but first be re-referred to the Committee on [Appropriations]",5,0,0,0,5
1849750,1439663,2024-05-06,Senate,"Placed on suspense file",7,0,0,0,7
1849751,1423881,2024-04-09,Senate,"Do pass, but first be re-referred to the Committee on [Appropriations] with the recommendation: To Consent Calendar",5,0,0,0,5
1849751,1438523,2024-05-02,Senate,"Consent Calendar 2nd SB1473 Laird",38,0,0,2,40
1849751,1453386,2024-06-04,Assembly,"Do pass and be re-referred to the Committee on [Appropriations] with recommendation: To Consent Calendar",7,0,0,1,8
1849751,1462293,2024-07-02,Assembly,"Do pass. To Consent Calendar",15,0,0,0,15
1849751,1463816,2024-08-08,Assembly,"SB 1473 Laird Consent Calendar Second Day Regular Session",72,0,0,7,79
1849752,1432935,2024-04-22,Senate,"Do pass as amended, but first amend, and re-refer to the Committee on [Appropriations]",13,4,0,1,18
1849752,1442517,2024-05-13,Senate,"Placed on suspense file",7,0,0,0,7
1849754,1419117,2024-04-02,Senate,"Do pass, but first be re-referred to the Committee on [Judiciary] with the recommendation: To Consent Calendar",7,0,0,0,7
1849754,1434240,2024-04-23,Senate,"Do pass, but first be re-referred to the Committee on [Appropriations] with the recommendation: To Consent Calendar",11,0,0,0,11
1849754,1441959,2024-05-09,Senate,"Consent Calendar 2nd SB1476 Blakespear et al",37,0,0,3,40
1849754,1456953,2024-06-12,Assembly,"Do pass and be re-referred to the Committee on [Judiciary] with recommendation: To Consent Calendar",8,0,0,0,8
1849754,1458244,2024-06-18,Assembly,"Do pass and be re-referred to the Committee on [Appropriations] with recommendation: To Consent Calendar",12,0,0,0,12
1849754,1462265,2024-07-02,Assembly,"Do pass. To Consent Calendar",15,0,0,0,15
1849754,1463770,2024-08-08,Assembly,"SB 1476 Blakespear Consent Calendar Second Day Regular Session",72,0,0,7,79
1849754,1464358,2024-08-15,Senate,"Special Consent SB1476 Blakespear et al",37,0,0,3,40
1849755,1434256,2024-04-24,Senate,"Do pass, but first be re-referred to the Committee on [Public Safety]",7,0,0,0,7
1849755,1442531,2024-05-13,Senate,"Placed on suspense file",7,0,0,0,7
1849755,1444025,2024-05-16,Senate,"Do pass as amended",7,0,0,0,7
1849755,1450028,2024-05-24,Senate,"Special Consent SB1477 Ashby",38,0,0,2,40
1849756,1432004,2024-04-22,Senate,"Do pass, but first be re-referred to the Committee on [Appropriations]",12,0,0,1,13
1849756,1448554,2024-05-22,Senate,"Senate 3rd Reading SB1478 Nguyen et al",39,0,0,1,40
1849756,1460042,2024-06-25,Assembly,"Do pass and be re-referred to the Committee on [Appropriations] with recommendation: To Consent Calendar",18,0,0,0,18
1849756,1462216,2024-07-02,Assembly,"Do pass. To Consent Calendar",15,0,0,0,15
1849756,1463777,2024-08-08,Assembly,"SB 1478 Nguyen Consent Calendar Second Day Regular Session",72,0,0,7,79
1849758,1419134,2024-04-02,Senate,"Do pass as amended, but first amend, and re-refer to the Committee on [Appropriations]",13,1,0,4,18
1849758,1431941,2024-04-22,Senate,"Placed on suspense file",7,0,0,0,7
1849759,1457944,2024-06-17,Senate,"Do pass as amended",5,0,0,2,7
1849759,1459357,2024-06-24,Senate,"Senate 3rd Reading SB1481 Caballero Urgency Clause",32,0,0,8,40
1849759,1462331,2024-07-02,Assembly,"Do pass",15,0,0,0,15
1849759,1465648,2024-08-26,Assembly,"SB 1481 Caballero Third Reading Urgency By Wicks",77,0,0,2,79
1849760,1430046,2024-04-17,Senate,"Do pass, but first be re-referred to the Committee on [Judiciary]",6,0,0,1,7
1849760,1434271,2024-04-23,Senate,"Do pass, but first be re-referred to the Committee on [Appropriations]",10,1,0,0,11
1849760,1439737,2024-05-06,Senate,"Placed on suspense file",7,0,0,0,7
1849760,1444204,2024-05-16,Senate,"Do pass as amended",6,1,0,0,7
1849760,1450353,2024-05-21,Senate,"Senate 3rd Reading SB1482 Glazer et al",39,0,0,1,40
1849760,1461976,2024-07-01,Assembly,"Do pass and be re-referred to the Committee on [Appropriations]",9,0,0,0,9
1849760,1464175,2024-08-15,Assembly,"Do pass as amended",11,0,0,4,15
1849762,1428932,2024-04-16,Senate,"Do pass",4,1,0,0,5
1849762,1445203,2024-05-20,Senate,"Senate 3rd Reading SB1484 Smallwood-Cuevas",31,6,0,3,40
1849762,1456307,2024-06-11,Assembly,"Do pass",6,2,0,0,8
1849762,1463786,2024-08-08,Assembly,"SB 1484 Smallwood-Cuevas Senate Third Reading By Reyes",55,16,0,8,79
1849765,1424783,2024-04-09,Senate,"Do pass, but first be re-referred to the Committee on [Appropriations] with the recommendation: To Consent Calendar",15,0,0,0,15
1849765,1431855,2024-04-22,Senate,"Placed on suspense file",7,0,0,0,7
1849765,1444644,2024-05-16,Senate,"Do pass",7,0,0,0,7
1849765,1449637,2024-05-23,Senate,"Special Consent SB1487 Glazer et al",37,0,0,3,40
1849765,1462363,2024-07-01,Assembly,"Do pass as amended and be re-referred to the Committee on [Appropriations]",15,0,0,0,15
1849766,1434248,2024-04-23,Senate,"Do pass as amended, but first amend, and re-refer to the Committee on [Appropriations]",11,0,0,4,15
1849766,1442542,2024-05-13,Senate,"Do pass",5,1,0,1,7
1849766,1445248,2024-05-20,Senate,"Senate 3rd Reading SB1488 Durazo",31,8,0,1,40
1849766,1458837,2024-06-19,Assembly,"Do pass and be re-referred to the Committee on [Appropriations]",15,1,0,6,22
1849766,1464418,2024-08-15,Assembly,"Do pass",11,0,0,4,15
1849766,1465580,2024-08-26,Assembly,"SB 1488 Durazo Senate Third Reading By Santiago",61,2,0,16,79
1849767,1423833,2024-04-09,Senate,"Do pass, but first be re-referred to the Committee on [Appropriations] with the recommendation: To Consent Calendar",5,0,0,0,5
1849767,1444608,2024-05-16,Senate,"Consent Calendar 2nd SB1489 McGuire",38,0,0,2,40
1849767,1453380,2024-06-04,Assembly,"Do pass and be re-referred to the Committee on [Appropriations] with recommendation: To Consent Calendar",7,0,0,1,8
1849767,1463745,2024-08-07,Assembly,"Do pass. To Consent Calendar",14,0,0,1,15
1849768,1428873,2024-04-16,Senate,"Do pass, but first be re-referred to the Committee on [Business, Professions and Economic Development]",9,2,0,0,11
1849768,1431885,2024-04-22,Senate,"Do pass as amended",9,0,0,4,13
1849768,1450362,2024-05-21,Senate,"Senate 3rd Reading SB1490 Durazo",31,8,0,1,40
1849768,1458226,2024-06-18,Assembly,"Do pass as amended",11,0,0,0,11
1849768,1465740,2024-08-26,Assembly,"SB 1490 Durazo Senate Third Reading By Lowenthal",76,0,0,3,79
1849768,1466927,2024-08-28,Senate,"Unfinished Business SB1490 Durazo et al. Concurrence",31,8,0,1,40
1849769,1420030,2024-04-03,Senate,"Do pass, but first be re-referred to the Committee on [Judiciary]",4,2,0,1,7
1849769,1428784,2024-04-16,Senate,"Do pass, but first be re-referred to the Committee on [Appropriations]",9,2,0,0,11
1849769,1439735,2024-05-06,Senate,"Placed on suspense file",7,0,0,0,7
1849769,1444288,2024-05-16,Senate,"Do pass as amended",5,2,0,0,7
1849769,1450369,2024-05-21,Senate,"Senate 3rd Reading SB1491 Eggman et al",31,8,0,1,40
1849769,1458321,2024-06-18,Assembly,"Do pass and be re-referred to the Committee on [Judiciary]",8,0,0,3,11
1849769,1460072,2024-06-25,Assembly,"Do pass and be re-referred to the Committee on [Appropriations]",9,1,0,2,12
1849769,1464137,2024-08-15,Assembly,"Do pass",11,1,0,3,15
1849769,1465601,2024-08-26,Assembly,"SB 1491 Eggman Senate Third Reading By Jackson",64,3,0,12,79
1849770,1435237,2024-04-24,Senate,"Do pass, but first be re-referred to the Committee on [Appropriations]",11,0,0,0,11
1849770,1439641,2024-05-06,Senate,"Placed on suspense file",7,0,0,0,7
1849771,1428927,2024-04-16,Senate,"Do pass, but first be re-referred to the Committee on [Appropriations] with the recommendation: To Consent Calendar",7,0,0,0,7
1849771,1438432,2024-05-02,Senate,"Consent Calendar 2nd SB1493 Blakespear",38,0,0,2,40
1849771,1460770,2024-06-26,Assembly,"Do pass and be re-referred to the Committee on [Appropriations] with recommendation: To Consent Calendar",8,0,0,0,8
1849771,1463750,2024-08-07,Assembly,"Do pass. To Consent Calendar",14,0,0,1,15
1849771,1464258,2024-08-15,Assembly,"SB 1493 Blakespear Consent Calendar Second Day Regular Session",75,0,0,4,79
1849772,1430014,2024-04-17,Senate,"Do pass, but first be re-referred to the Committee on [Revenue and Taxation]",6,1,0,0,7
1849772,1434234,2024-04-24,Senate,"Do pass",6,0,0,1,7
1849772,1449630,2024-05-23,Senate,"Senate 3rd Reading SB1494 Glazer et al",17,11,0,12,40
1849772,1449631,2024-05-23,Senate,"Senate 3rd Reading SB1494 Glazer et al. Reconsider",36,0,0,4,40
1849773,1433029,2024-04-23,Senate,"Do pass, but first be re-referred to the Committee on [Appropriations]",16,0,0,0,16
1849773,1450333,2024-05-21,Senate,"Senate 3rd Reading SB1495 Wilk",38,0,0,2,40
1849773,1454210,2024-06-05,Assembly,"Do pass and be re-referred to the Committee on [Appropriations]",19,0,0,3,22
1849773,1458502,2024-06-19,Assembly,"Do pass. To Consent Calendar",14,0,0,1,15
1849773,1460620,2024-06-26,Assembly,"SB 1495 Wilk Consent Calendar Second Day Regular Session",75,0,0,4,79
1849775,1429985,2024-04-17,Senate,"Do pass, but first be re-referred to the Committee on [Judiciary]",5,2,0,0,7
1849775,1434104,2024-04-23,Senate,"Do pass as amended, but first amend, and re-refer to the Committee on [Appropriations]",7,2,0,2,11
1849775,1442558,2024-05-13,Senate,"Placed on suspense file",7,0,0,0,7
1849775,1444638,2024-05-16,Senate,"Do pass",5,2,0,0,7
1849776,1422033,2024-04-08,Senate,"Do pass, but first be re-referred to the Committee on [Rules]",7,0,0,6,13
1849776,1434260,2024-04-23,Senate,"Do pass as amended, but first amend, and re-refer to the Committee on [Appropriations]",10,0,0,1,11
1849776,1442632,2024-05-13,Senate,"Placed on suspense file",7,0,0,0,7
1849776,1444484,2024-05-16,Senate,"Do pass",7,0,0,0,7
1849776,1450321,2024-05-21,Senate,"Senate 3rd Reading SB1498 Ashby",38,0,0,2,40
1849776,1460080,2024-06-25,Assembly,"Do pass and be re-referred to the Committee on [Judiciary]",18,0,0,0,18
1849776,1462226,2024-07-02,Assembly,"Do pass and be re-referred to the Committee on [Appropriations]",11,0,0,1,12
1849776,1464316,2024-08-15,Assembly,"Do pass as amended",11,0,0,4,15
1849776,1466263,2024-08-29,Assembly,"SB 1498 Ashby Senate Third Reading By Irwin",76,0,0,3,79
1849776,1466561,2024-08-30,Senate,"Unfinished Business SB1498 Ashby et al. Concurrence",40,0,0,0,40
1849777,1424856,2024-04-10,Senate,"Do pass, but first be re-referred to the Committee on [Appropriations] with the recommendation: To Consent Calendar",6,0,0,1,7
1849777,1431891,2024-04-22,Senate,"Placed on suspense file",7,0,0,0,7
1849777,1443912,2024-05-16,Senate,"Do pass",7,0,0,0,7
1849777,1449705,2024-05-23,Senate,"Special Consent SB1499 Glazer",37,0,0,3,40
1849778,1428928,2024-04-16,Senate,"Do pass, but first be re-referred to the Committee on [Military and Veterans Affairs]",8,2,0,0,10
1849778,1431922,2024-04-22,Senate,"Do pass, but first be re-referred to the Committee on [Appropriations]",4,0,0,1,5
1849778,1442581,2024-05-13,Senate,"Placed on suspense file",7,0,0,0,7
1849778,1444687,2024-05-16,Senate,"Do pass",5,2,0,0,7
1849778,1450343,2024-05-21,Senate,"Senate 3rd Reading SB1500 Durazo",31,8,0,1,40
1849778,1456919,2024-06-12,Assembly,"Do pass as amended and be re-referred to the Committee on [Military and Veterans Affairs]",8,0,0,1,9
1849778,1459962,2024-06-25,Assembly,"Do pass and be re-referred to the Committee on [Appropriations]",9,0,0,1,10
1849778,1464086,2024-08-15,Assembly,"Do pass",11,1,0,3,15
1849778,1466359,2024-08-29,Senate,"Unfinished Business SB1500 Durazo Concurrence",32,8,0,0,40
1849778,1466876,2024-08-28,Assembly,"SB 1500 Durazo Senate Third Reading By Jones-Sawyer",68,1,0,10,79
1849779,1424911,2024-04-10,Senate,"Do pass, but first be re-referred to the Committee on [Appropriations] with the recommendation: To Consent Calendar",6,0,0,1,7
1849779,1435366,2024-04-25,Senate,"Consent Calendar 2nd SB1501 Glazer",36,0,0,4,40
1849779,1462334,2024-07-01,Assembly,"Do pass as amended and be re-referred to the Committee on [Appropriations]",6,0,0,1,7
1849780,1423799,2024-04-09,Senate,"Do pass as amended, but first amend, and re-refer to the Committee on [Appropriations]",5,0,0,0,5
1849780,1439701,2024-05-06,Senate,"Placed on suspense file",7,0,0,0,7
1849780,1444490,2024-05-16,Senate,"Do pass as amended",7,0,0,0,7
1849780,1448785,2024-05-22,Senate,"Senate 3rd Reading SB1502 Ashby et al",38,0,0,2,40
1849782,1434021,2024-04-23,Senate,"Do pass as amended, but first amend, and re-refer to the Committee on [Appropriations]",10,0,0,1,11
1849782,1442546,2024-05-13,Senate,"Placed on suspense file",7,0,0,0,7
1849782,1444326,2024-05-16,Senate,"Do pass as amended",5,0,0,2,7
1849782,1450338,2024-05-21,Senate,"Senate 3rd Reading SB1504 Stern et al",34,0,0,6,40
1849782,1458303,2024-06-18,Assembly,"Do pass and be re-referred to the Committee on [Judiciary]",10,0,0,1,11
1849782,1462238,2024-07-02,Assembly,"Do pass and be re-referred to the Committee on [Appropriations]",11,0,0,1,12
1849782,1464230,2024-08-15,Assembly,"Do pass as amended",11,0,0,4,15
1849782,1466220,2024-08-29,Assembly,"SB 1504 Stern Senate Third Reading By Lowenthal",71,0,0,8,79
1849782,1466517,2024-08-30,Senate,"Unfinished Business SB1504 Stern et al. Concurrence",36,0,0,4,40
1849786,1433106,2024-04-22,Senate,"Do pass as amended, but first amend, and re-refer to the Committee on [Appropriations]",13,3,0,2,18
1849786,1442588,2024-05-13,Senate,"Placed on suspense file",7,0,0,0,7
1849786,1444587,2024-05-16,Senate,"Do pass as amended",5,2,0,0,7
1849786,1448547,2024-05-22,Senate,"Senate 3rd Reading SB1508 Stern",30,8,0,2,40
1849786,1461962,2024-07-01,Assembly,"Do pass and be re-referred to the Committee on [Appropriations] with recommendation: To Consent Calendar",15,0,0,1,16
1849787,1424980,2024-04-09,Senate,"Do pass as amended, but first amend, and re-refer to the Committee on [Appropriations]",12,1,0,2,15
1849787,1436206,2024-04-29,Senate,"Placed on suspense file",5,0,0,2,7
1849787,1444342,2024-05-16,Senate,"Do pass as amended",5,1,0,1,7
1849787,1448801,2024-05-22,Senate,"Senate 3rd Reading SB1509 Stern et al",28,1,0,11,40
1849787,1462350,2024-07-01,Assembly,"Do pass as amended and be re-referred to the Committee on [Appropriations]",15,0,0,0,15
1849787,1464335,2024-08-15,Assembly,"Do pass",14,0,0,1,15
1849787,1466344,2024-08-29,Senate,"Unfinished Business SB1509 Stern et al. Concurrence",36,1,0,3,40
1849787,1466851,2024-08-28,Assembly,"SB 1509 Stern Senate Third Reading By Wilson",76,0,0,3,79
1849789,1395244,2024-02-26,Senate,"Be adopted. Ordered to third reading",8,0,0,3,11
1849789,1400021,2024-02-29,Senate,"Senate 3rd Reading SCR113 Smallwood-Cuevas et",31,1,0,8,40
1849789,1419231,2024-04-02,Assembly,"Be adopted. To third reading",10,0,0,2,12
1849790,1413832,2024-03-21,Senate,"Senate 3rd Reading SR69 Menjivar et al",37,0,0,3,40
1851399,1462565,2024-07-03,Senate,"Special Consent SCR114 Seyarto et al",39,0,0,1,40
1851399,1463406,2024-08-05,Assembly,"Be adopted. To Consent Calendar",10,0,0,1,11
1851399,1463808,2024-08-08,Assembly,"SCR 114 Seyarto Consent Calendar Second Day Regular Session",72,0,0,7,79
1851400,1424933,2024-04-09,Senate,"Be adopted, but first be re-referred to the Committee on [Appropriations] with recommendation: To Consent Calendar",15,0,0,0,15
1851400,1435277,2024-04-25,Senate,"Consent Calendar 2nd SCR115 Archuleta",36,0,0,4,40
1851400,1458243,2024-06-17,Assembly,"Be adopted. To Consent Calendar",15,0,0,0,15
1851400,1458780,2024-06-20,Assembly,"SCR 115 Archuleta Consent Calendar Second Day Regular Session",67,0,0,12,79
1851401,1410549,2024-03-18,Senate,"Senate 3rd Reading SR70 Atkins et al",32,5,0,3,40
1852436,1402351,2024-03-04,Assembly,"Be adopted. To third reading",8,0,0,3,11
1852436,1431051,2024-04-18,Senate,"Special Consent ACR148 Joe Patterson et al",39,0,0,1,40
1852437,1410542,2024-03-18,Assembly,"Be adopted. To third reading",9,0,0,2,11
1852438,1432003,2024-04-22,Senate,"Do pass, but first be re-referred to the Committee on [Appropriations] with the recommendation: To Consent Calendar",11,0,0,0,11
1852438,1439711,2024-05-06,Senate,"Placed on suspense file",7,0,0,0,7
1852438,1444494,2024-05-16,Senate,"Do pass",7,0,0,0,7
1852438,1449559,2024-05-23,Senate,"Special Consent SB1511 HEALTH (Roth)",37,0,0,3,40
1852438,1460071,2024-06-25,Assembly,"Do pass as amended, and be re-referred to the Committee on [Appropriations] with recommendation: To Consent Calendar",16,0,0,0,16
1852438,1464115,2024-08-15,Assembly,"Do pass",14,0,0,1,15
1852438,1465772,2024-08-26,Assembly,"SB 1511 Health Senate Third Reading By SCHIAVO",77,0,0,2,79
1852438,1467092,2024-08-28,Senate,"Unfinished Business SB1511 HEALTH (Roth) Concurrence",39,0,0,1,40
1852439,1428939,2024-04-16,Senate,"Do pass and be ordered to the Consent Calendar",10,0,0,0,10
1852439,1435213,2024-04-25,Senate,"Consent Calendar 2nd SB1512 HOUSING (Skinner)",36,0,0,4,40
1852439,1460756,2024-06-26,Assembly,"Do pass and be re-referred to the Committee on [Appropriations] with recommendation: To Consent Calendar",9,0,0,0,9
1852439,1462329,2024-07-02,Assembly,"Do pass. To Consent Calendar",15,0,0,0,15
1852439,1463768,2024-08-08,Assembly,"SB 1512 Housing Consent Calendar Second Day Regular Session",72,0,0,7,79
1852439,1464326,2024-08-15,Senate,"Special Consent SB1512 HOUSING (Skinner)",37,0,0,3,40
1852440,1410546,2024-03-18,Senate,"Senate 3rd Reading SCR116 Jones",40,0,0,0,40
1852440,1445262,2024-05-20,Assembly,"Be adopted. To third reading",9,0,0,2,11
1854833,1402352,2024-03-04,Assembly,"Be adopted. To third reading",8,0,0,3,11
1854833,1425913,2024-04-11,Senate,"Special Consent ACR149 Gallagher et al",39,0,0,1,40
1854834,1402347,2024-03-04,Assembly,"Be adopted. To third reading",8,0,0,3,11
1854834,1430981,2024-04-18,Senate,"Special Consent ACR150 Stephanie Nguyen et",39,0,0,1,40
1854835,1460098,2024-06-24,Assembly,"Be adopted. To third reading",8,0,0,0,8
1854835,1462526,2024-07-03,Assembly,"ACR 151 Calderon Assembly Third Reading",71,0,0,8,79
1854835,1463944,2024-08-13,Senate,"Be adopted. Ordered to third reading",10,0,0,5,15
1854835,1465488,2024-08-22,Senate,"Special Consent ACR151 Calderon",33,0,0,7,40
1854836,1402368,2024-03-04,Assembly,"Be adopted. To third reading",8,0,0,3,11
1854837,1402355,2024-03-04,Assembly,"Be adopted. To Consent Calendar",8,0,0,3,11
1854837,1405803,2024-03-07,Assembly,"HR 75 Soria Consent Calendar Second Day Regular Session",69,0,0,11,80
1855706,1425899,2024-04-10,Assembly,"Do pass and be re-referred to the Committee on [Appropriations] with recommendation: To Consent Calendar",9,0,0,0,9
1855706,1436165,2024-04-29,Assembly,"AB 3277 Local Government Assembly Third Reading By CARRILLO, J",71,0,0,9,80
1855706,1451553,2024-05-29,Senate,"Do pass, but first be re-referred to the Committee on [Appropriations] with the recommendation: To Consent Calendar",7,0,0,0,7
1855706,1457374,2024-06-13,Senate,"Consent Calendar 2nd AB3277 L. GOV. (Carrillo, J.)",37,0,0,3,40
1855708,1405812,2024-03-07,Senate,"Senate 3rd Reading SCR117 Wiener",38,0,0,2,40
1855708,1422069,2024-04-08,Assembly,"Be adopted. To Consent Calendar",10,0,0,1,11
1855708,1427291,2024-04-15,Assembly,"SCR 117 Wiener Senate Third Reading",75,0,0,5,80
1855709,1462670,2024-07-03,Senate,"Special Consent SR71 Seyarto et al",39,0,0,1,40
1856843,1450962,2024-05-28,Assembly,"Be adopted. To third reading",6,0,0,5,11
1856843,1458773,2024-06-20,Senate,"Special Consent ACR152 Connolly et al",36,0,0,4,40
1856844,1409562,2024-03-14,Senate,"Senate 3rd Reading SCR118 Wahab et al",40,0,0,0,40
1856844,1445198,2024-05-20,Assembly,"Be adopted. To Consent Calendar",9,0,0,2,11
1856844,1448713,2024-05-22,Assembly,"SCR 118 Wahab Consent Calendar Second Day Regular Session",69,0,0,11,80
1856845,1441964,2024-05-09,Senate,"Senate 3rd Reading SCR119 Umberg",37,0,0,3,40
1856845,1455824,2024-06-10,Assembly,"Be adopted. To Consent Calendar",9,0,0,2,11
1856845,1457350,2024-06-13,Assembly,"SCR 119 Umberg Consent Calendar Second Day Regular Session",77,0,0,2,79
1856846,1444263,2024-05-16,Senate,"Senate 3rd Reading SR72 Rubio et al",35,0,0,5,40
1857664,1431935,2024-04-22,Assembly,"Do pass and be re-referred to the Committee on [Appropriations] with recommendation: To Consent Calendar",15,0,0,0,15
1857664,1443451,2024-05-15,Assembly,"Do pass. To Consent Calendar",15,0,0,0,15
1857664,1446128,2024-05-21,Assembly,"AB 3278 Transportation Consent Calendar Second Day Regular Session",71,0,0,9,80
1857664,1460567,2024-06-25,Senate,"Do pass, but first be re-referred to the Committee on [Appropriations] with the recommendation: To Consent Calendar",15,0,0,0,15
1857664,1463905,2024-08-12,Senate,"Consent Calendar 2nd AB3278 TRANS. (Wilson)",38,0,0,2,40
1857664,1465278,2024-08-19,Assembly,"AB 3278 Transportation Concurrence in Senate Amendments By WILSON",76,0,0,3,79
1857665,1436907,2024-04-30,Assembly,"Do pass as amended",7,3,0,2,12
1857665,1445218,2024-05-20,Assembly,"AB 3279 Judiciary Assembly Third Reading By KALRA",55,14,0,11,80
1857665,1462528,2024-07-02,Senate,"Do pass",11,0,0,0,11
1857665,1465746,2024-08-26,Senate,"Assembly 3rd Reading AB3279 JUD. (Kalra) By Umberg",33,6,0,1,40
1857665,1465953,2024-08-27,Assembly,"AB 3279 Judiciary Concurrence in Senate Amendments By KALRA",56,14,0,9,79
1857666,1419172,2024-04-02,Assembly,"Do pass and be re-referred to the Committee on [Appropriations] with recommendation: To Consent Calendar",12,0,0,0,12
1857666,1443987,2024-05-16,Assembly,"Do pass as amended",11,0,0,4,15
1857666,1449643,2024-05-23,Assembly,"AB 3280 Judiciary Assembly Third Reading By KALRA",72,0,0,8,80
1857666,1462474,2024-07-02,Senate,"Do pass, but first be re-referred to the Committee on [Appropriations] with the recommendation: To Consent Calendar",11,0,0,0,11
1857666,1463383,2024-08-05,Senate,"Placed on suspense file",7,0,0,0,7
1857666,1464337,2024-08-15,Senate,"Do pass",7,0,0,0,7
1857666,1467250,2024-08-28,Senate,"Special Consent AB3280 JUD. (Kalra)",39,0,0,1,40
1857667,1423910,2024-04-09,Assembly,"Do pass as amended and be re-referred to the Committee on [Appropriations]",9,1,0,2,12
1857667,1434264,2024-04-24,Assembly,"Do pass",11,4,0,0,15
1857667,1445156,2024-05-20,Assembly,"AB 3281 Judiciary Assembly Third Reading By KALRA",59,10,0,11,80
1857667,1458263,2024-06-18,Senate,"Do pass, but first be re-referred to the Committee on [Appropriations]",9,1,0,1,11
1857667,1465568,2024-08-26,Senate,"Assembly 3rd Reading AB3281 JUD. (Kalra) By Umberg",32,7,0,1,40
1857667,1465799,2024-08-27,Assembly,"AB 3281 Judiciary Concurrence in Senate Amendments By KALRA",62,9,0,8,79
1857668,1428980,2024-04-16,Assembly,"Do pass and be re-referred to the Committee on [Appropriations] with recommendation: To Consent Calendar",12,0,0,0,12
1857668,1444634,2024-05-16,Assembly,"Do pass as amended",11,0,0,4,15
1857668,1449545,2024-05-23,Assembly,"AB 3282 Judiciary Third Reading Urgency By KALRA",72,0,0,8,80
1857668,1458252,2024-06-18,Senate,"Do pass, but first be re-referred to the Committee on [Appropriations] with the recommendation: To Consent Calendar",10,0,0,1,11
1857668,1461985,2024-07-01,Senate,"Placed on suspense file",7,0,0,0,7
1857668,1464252,2024-08-15,Senate,"Do pass as amended",7,0,0,0,7
1857668,1465694,2024-08-26,Senate,"Assembly 3rd Reading AB3282 JUD. (Kalra) By Umberg Urgency Clause",40,0,0,0,40
1857668,1465795,2024-08-27,Assembly,"AB 3282 Judiciary Concurrence in Senate Amendments By KALRA",77,0,0,2,79
1857669,1419189,2024-04-02,Assembly,"Do pass",10,2,0,0,12
1857669,1445938,2024-05-21,Assembly,"AB 3283 Judiciary Assembly Third Reading By KALRA",59,14,0,7,80
1857669,1456379,2024-06-11,Senate,"Do pass",9,2,0,0,11
1857669,1465925,2024-08-27,Senate,"Assembly 3rd Reading AB3283 JUD. (Kalra) By Lim√≥n",31,9,0,0,40
1857669,1466855,2024-08-28,Assembly,"AB 3283 JUD. Concurrence in Senate Amendments By KALRA",62,15,0,2,79
1857670,1407466,2024-03-11,Assembly,"Be adopted. To third reading",10,0,0,1,11
1857670,1425935,2024-04-11,Senate,"Special Consent ACR153 Petrie-Norris et al",39,0,0,1,40
1857672,1407462,2024-03-11,Assembly,"Be adopted. To Consent Calendar",10,0,0,1,11
1857672,1409574,2024-03-14,Assembly,"HR 76 Gabriel Consent Calendar Second Day Regular Session",70,0,0,10,80
1857673,1407463,2024-03-11,Assembly,"Be adopted. To Consent Calendar",10,0,0,1,11
1857673,1409577,2024-03-14,Assembly,"HR 77 Soria Consent Calendar Second Day Regular Session",70,0,0,10,80
1857675,1420190,2024-04-03,Senate,"Do pass and be ordered to the Consent Calendar",6,0,0,1,7
1857675,1425916,2024-04-11,Senate,"Consent Calendar 2nd SB1514 L. GOV. (Durazo)",39,0,0,1,40
1857675,1460421,2024-06-26,Assembly,"Do pass. To Consent Calendar",7,0,0,2,9
1857675,1463692,2024-08-05,Assembly,"SB 1514 Local Government Consent Calendar Second Day Regular Session",71,0,0,8,79
1857675,1464139,2024-08-15,Senate,"Special Consent SB1514 L. GOV. (Durazo)",37,0,0,3,40
1857676,1420163,2024-04-03,Senate,"Do pass and be ordered to the Consent Calendar",6,0,0,1,7
1857676,1425917,2024-04-11,Senate,"Consent Calendar 2nd SB1515 L. GOV. (Durazo) Urgency Clause",39,0,0,1,40
1857676,1454207,2024-06-05,Assembly,"Do pass. To Consent Calendar",9,0,0,0,9
1857676,1457329,2024-06-13,Assembly,"SB 1515 Local Government Consent Calendar Second Day Regular Session",77,0,0,2,79
1857677,1420141,2024-04-03,Senate,"Do pass and be ordered to the Consent Calendar",6,0,0,1,7
1857677,1425910,2024-04-11,Senate,"Consent Calendar 2nd SB1516 L. GOV. (Durazo) Urgency Clause",39,0,0,1,40
1857677,1454279,2024-06-05,Assembly,"Do pass. To Consent Calendar",9,0,0,0,9
1857677,1457369,2024-06-13,Assembly,"SB 1516 Local Government Consent Calendar Second Day Regular Session",77,0,0,2,79
1857678,1420126,2024-04-03,Senate,"Do pass and be ordered to the Consent Calendar",6,0,0,1,7
1857678,1425900,2024-04-11,Senate,"Consent Calendar 2nd SB1517 L. GOV. (Durazo)",39,0,0,1,40
1857678,1454225,2024-06-05,Assembly,"Do pass. To Consent Calendar",9,0,0,0,9
1857678,1457339,2024-06-13,Assembly,"SB 1517 Local Government Consent Calendar Second Day Regular Session",77,0,0,2,79
1859568,1407464,2024-03-11,Assembly,"Be adopted. To Consent Calendar",10,0,0,1,11
1859568,1409578,2024-03-14,Assembly,"ACR 155 Lackey Consent Calendar Second Day",70,0,0,10,80
1859568,1425901,2024-04-11,Senate,"Special Consent ACR155 Lackey et al",39,0,0,1,40
1859569,1410548,2024-03-18,Assembly,"Be adopted. To third reading",9,0,0,2,11
1859570,1433054,2024-04-23,Senate,"Do pass, but first be re-referred to the Committee on [Appropriations] with the recommendation: To Consent Calendar",5,0,0,0,5
1859570,1441919,2024-05-09,Senate,"Consent Calendar 2nd SB1518 PUB. S. (Wahab)",37,0,0,3,40
1859570,1458296,2024-06-18,Assembly,"Do pass and be re-referred to the Committee on [Appropriations] with recommendation: To Consent Calendar",7,0,0,1,8
1859570,1462279,2024-07-02,Assembly,"Do pass. To Consent Calendar",15,0,0,0,15
1859570,1464018,2024-08-15,Assembly,"SB 1518 Public Safety Senate Third Reading By McCARTY",75,0,0,4,79
1859570,1465447,2024-08-22,Senate,"Special Consent SB1518 PUB. S. (Wahab)",33,0,0,7,40
1859571,1407472,2024-03-11,Senate,"Senate 3rd Reading SCR120 Becker",38,0,0,2,40
1859571,1422064,2024-04-08,Assembly,"Be adopted. To Consent Calendar",10,0,0,1,11
1859571,1427239,2024-04-15,Assembly,"SCR 120 Becker Senate Third Reading",75,0,0,5,80
1859572,1420093,2024-04-03,Senate,"Be adopted as amended, but first amend, and re-refer to the Committee on [Appropriations]",7,0,0,0,7
1859572,1441911,2024-05-09,Senate,"Senate 3rd Reading SJR13 Newman et al",37,0,0,3,40
1859572,1460710,2024-06-25,Assembly,"Be adopted. To Consent Calendar",7,0,0,0,7
1859572,1462050,2024-07-01,Assembly,"SJR 13 Newman Consent Calendar Second Day Regular Session",72,0,0,7,79
1859573,1424955,2024-04-10,Senate,"Be adopted. Ordered to third reading",6,1,0,0,7
1859573,1427315,2024-04-15,Senate,"Senate 3rd Reading SJR14 Becker",32,6,0,2,40
1859574,1409564,2024-03-14,Senate,"Senate 3rd Reading SR73 Hurtado et al",40,0,0,0,40
1859575,1439710,2024-05-06,Senate,"Senate 3rd Reading SR74 Gonzalez et al",38,0,0,2,40
1860070,1410550,2024-03-18,Senate,"Senate 3rd Reading SCR121 Wahab et al",40,0,0,0,40
1860070,1445210,2024-05-20,Assembly,"Be adopted. To Consent Calendar",9,0,0,2,11
1860070,1448562,2024-05-22,Assembly,"SCR 121 Wahab Consent Calendar Second Day Regular Session",69,0,0,11,80
1860071,1409565,2024-03-14,Senate,"Senate 3rd Reading SCR122 Rubio et al",36,0,0,4,40
1860071,1422034,2024-04-08,Assembly,"Be adopted. To Consent Calendar",10,0,0,1,11
1860071,1427324,2024-04-15,Assembly,"SCR 122 Rubio Senate Third Reading",74,0,0,6,80
1860072,1410566,2024-03-18,Senate,"Senate 3rd Reading SCR123 Allen et al",40,0,0,0,40
1860072,1422024,2024-04-08,Assembly,"Be adopted. To Consent Calendar",10,0,0,1,11
1860072,1427339,2024-04-15,Assembly,"SCR 123 Allen Senate Third Reading",75,0,0,5,80
1860073,1422032,2024-04-08,Senate,"Senate 3rd Reading SR75 Laird et al",38,0,0,2,40
1860905,1410557,2024-03-18,Assembly,"Be adopted. To third reading",9,0,0,2,11
1860905,1431042,2024-04-18,Senate,"Special Consent ACR156 Papan et al",39,0,0,1,40
1860906,1413850,2024-03-21,Assembly,"Be adopted. To third reading",8,0,0,3,11
1860906,1438467,2024-05-02,Senate,"Special Consent ACR157 Pacheco et al",38,0,0,2,40
1860907,1407465,2024-03-11,Assembly,"Be adopted. To third reading",10,0,0,1,11
1860908,1423829,2024-04-09,Senate,"Do pass, but first be re-referred to the Committee on [Appropriations] with the recommendation: To Consent Calendar",14,0,0,2,16
1860908,1435207,2024-04-25,Senate,"Consent Calendar 2nd SB1519 G.O. (Dodd)",36,0,0,4,40
1860908,1454242,2024-06-05,Assembly,"Do pass and be re-referred to the Committee on [Appropriations] with recommendation: To Consent Calendar",19,0,0,3,22
1860908,1458447,2024-06-19,Assembly,"Do pass. To Consent Calendar",14,0,0,1,15
1860908,1460725,2024-06-26,Assembly,"SB 1519 Governmental Organization Consent Calendar Second Day Regular Session",75,0,0,4,79
1860909,1423897,2024-04-09,Senate,"Do pass, but first be re-referred to the Committee on [Appropriations] with the recommendation: To Consent Calendar",11,0,0,0,11
1860909,1435210,2024-04-25,Senate,"Consent Calendar 2nd SB1520 N.R. & W. (Min)",36,0,0,4,40
1860909,1455804,2024-06-10,Assembly,"Do pass and be re-referred to the Committee on [Appropriations] with recommendation: To Consent Calendar",10,0,0,1,11
1860909,1458496,2024-06-19,Assembly,"Do pass. To Consent Calendar",14,0,0,1,15
1860909,1460558,2024-06-26,Assembly,"SB 1520 Natural Resources and Water Consent Calendar Second Day Regular Session",75,0,0,4,79
1860910,1439623,2024-05-06,Senate,"Senate 3rd Reading SCR124 Laird",38,0,0,2,40
1860910,1455806,2024-06-10,Assembly,"Be adopted. To Consent Calendar",9,0,0,2,11
1860910,1457378,2024-06-13,Assembly,"SCR 124 Laird Consent Calendar Second Day Regular Session",77,0,0,2,79
1861648,1427366,2024-04-15,Assembly,"Be adopted. To Consent Calendar",15,0,0,0,15
1861648,1430975,2024-04-18,Assembly,"ACR 158 Chen Consent Calendar Second Day Regular Session",72,0,0,8,80
1861648,1451591,2024-05-28,Senate,"Be adopted, but first be re-referred to the Committee on [Appropriations] with recommendation: To Consent Calendar",12,0,0,3,15
1861648,1457327,2024-06-13,Senate,"Consent Calendar 2nd ACR158 Chen et al",37,0,0,3,40
1861649,1418394,2024-04-01,Senate,"Senate 3rd Reading SR76 Portantino",31,0,0,9,40
1862917,1410525,2024-03-18,Assembly,"Be adopted. To third reading",9,0,0,2,11
1862917,1452239,2024-05-30,Senate,"Special Consent ACR159 Boerner et al",37,0,0,3,40
1862918,1410563,2024-03-18,Assembly,"Be adopted. To Consent Calendar",9,0,0,2,11
1862918,1413854,2024-03-21,Assembly,"ACR 160 Weber Consent Calendar Second Day",56,0,0,24,80
1862918,1430983,2024-04-18,Senate,"Special Consent ACR160 Weber et al",39,0,0,1,40
1862919,1429984,2024-04-17,Senate,"Do pass, but first be re-referred to the Committee on [Judiciary] with the recommendation: To Consent Calendar",7,0,0,0,7
1862919,1434200,2024-04-23,Senate,"Do pass, but first be re-referred to the Committee on [Appropriations] with the recommendation: To Consent Calendar",11,0,0,0,11
1862919,1441966,2024-05-09,Senate,"Consent Calendar 2nd SB1521 B. & F.I. (Lim√≥n)",37,0,0,3,40
1862919,1458026,2024-06-17,Assembly,"Do pass and be re-referred to the Committee on [Appropriations] with recommendation: To Consent Calendar",8,0,0,1,9
1862919,1462346,2024-07-02,Assembly,"Do pass. To Consent Calendar",15,0,0,0,15
1862919,1463802,2024-08-08,Assembly,"SB 1521 Banking and Financial Institutions Consent Calendar Second Day Regular Session",72,0,0,7,79
1862920,1428774,2024-04-16,Senate,"Do pass, but first be re-referred to the Committee on [Governmental Organization] with the recommendation: To Consent Calendar",3,0,0,2,5
1862920,1433126,2024-04-23,Senate,"Do pass, but first be re-referred to the Committee on [Appropriations] with the recommendation: To Consent Calendar",16,0,0,0,16
1862920,1441906,2024-05-09,Senate,"Consent Calendar 2nd SB1522 AGRI. (Hurtado)",37,0,0,3,40
1862920,1460719,2024-06-26,Assembly,"Do pass and be re-referred to the Committee on [Appropriations] with recommendation: To Consent Calendar",8,0,0,2,10
1862920,1463722,2024-08-07,Assembly,"Do pass",14,0,0,1,15
1862920,1464350,2024-08-15,Assembly,"SB 1522 Agriculture Senate Third Reading By CONNOLLY",76,0,0,3,79
1862921,1418353,2024-04-01,Senate,"Senate 3rd Reading SCR125 Wahab",37,0,0,3,40
1862921,1445163,2024-05-20,Assembly,"Be adopted. To Consent Calendar",9,0,0,2,11
1862921,1448792,2024-05-22,Assembly,"SCR 125 Wahab Consent Calendar Second Day Regular Session",69,0,0,11,80
1862922,1413834,2024-03-21,Senate,"Senate 3rd Reading SCR126 Wahab et al",37,0,0,3,40
1862922,1445229,2024-05-20,Assembly,"Be adopted. To Consent Calendar",9,0,0,2,11
1862922,1448809,2024-05-22,Assembly,"SCR 126 Wahab Consent Calendar Second Day Regular Session",69,0,0,11,80
1862923,1409572,2024-03-14,Senate,"Senate 3rd Reading SR77 McGuire",39,0,0,1,40
1863380,1436234,2024-04-29,Assembly,"Be adopted. To third reading",9,0,0,2,11
1863380,1452244,2024-05-30,Senate,"Special Consent ACR161 Connolly et al",37,0,0,3,40
1863381,1433068,2024-04-23,Senate,"Do pass and be ordered to the Consent Calendar",16,0,0,0,16
1863381,1438424,2024-05-02,Senate,"Consent Calendar 2nd SB1523 G.O. (Dodd)",38,0,0,2,40
1863381,1458833,2024-06-19,Assembly,"Do pass. To Consent Calendar",19,0,0,3,22
1863381,1465310,2024-08-19,Assembly,"SB 1523 Governmental Organizatio Senate Third Reading By RUBIO Amendment Set #1",77,0,0,2,79
1863381,1465619,2024-08-26,Assembly,"SB 1523 Governmental Organizatio Senate Third Reading By RUBIO",77,0,0,2,79
1863381,1467218,2024-08-28,Senate,"Unfinished Business SB1523 G.O. (Dodd) Concurrence",39,0,0,1,40
1863382,1433114,2024-04-23,Senate,"Do pass, but first be re-referred to the Committee on [Appropriations] with the recommendation: To Consent Calendar",16,0,0,0,16
1863382,1441931,2024-05-09,Senate,"Consent Calendar 2nd SB1524 G.O. (Dodd)",37,0,0,3,40
1863382,1458233,2024-06-18,Assembly,"Do pass and be re-referred to the Committee on [Privacy and Consumer Protection]",12,0,0,0,12
1863382,1458234,2024-06-18,Assembly,"Do pass as amended",11,0,0,0,11
1863382,1459438,2024-06-24,Assembly,"SB 1524 Dodd Third Reading Urgency By HANEY",73,0,0,6,79
1863382,1459990,2024-06-25,Senate,"That the Assembly amendments be concurred in",6,0,0,5,11
1863382,1461220,2024-06-27,Senate,"Unfinished Business SB1524 Dodd et al. Urgency Clause Concurrence",39,0,0,1,40
1863888,1434171,2024-04-24,Assembly,"Do pass. To Consent Calendar",8,0,0,0,8
1863888,1438445,2024-05-02,Assembly,"AB 3284 Elections Consent Calendar Second Day By PELLERIN",73,0,0,7,80
1863888,1458223,2024-06-18,Senate,"Do pass and be ordered to the Consent Calendar",7,0,0,0,7
1863888,1465687,2024-08-26,Senate,"Assembly 3rd Reading AB3284 ELECTIONS (Pellerin) By Blakespear",40,0,0,0,40
1863888,1465863,2024-08-27,Assembly,"AB 3284 Elections Concurrence in Senate Amendments By PELLERIN",76,0,0,3,79
1863889,1429987,2024-04-17,Assembly,"Do pass and be re-referred to the Committee on [Appropriations] with recommendation: To Consent Calendar",21,0,0,1,22
1863889,1437650,2024-05-01,Assembly,"Do pass. To Consent Calendar",14,0,0,1,15
1863889,1441907,2024-05-09,Assembly,"AB 3285 Governmental Organization Consent Calendar Second Day Regular Session",65,0,0,15,80
1863889,1456437,2024-06-11,Senate,"Do pass, but first be re-referred to the Committee on [Appropriations] with the recommendation: To Consent Calendar",15,0,0,1,16
1863889,1465890,2024-08-27,Senate,"Assembly 3rd Reading AB3285 G.O. (Blanca Rubio) By Dodd",40,0,0,0,40
1863889,1467229,2024-08-28,Assembly,"AB 3285 G.O. Concurrence in Senate Amendments By RUBIO",77,0,0,2,79
1863891,1421131,2024-04-04,Senate,"Senate 3rd Reading SCR127 Wahab et al",34,0,0,6,40
1863891,1445199,2024-05-20,Assembly,"Be adopted. To Consent Calendar",9,0,0,2,11
1863891,1448780,2024-05-22,Assembly,"SCR 127 Wahab Consent Calendar Second Day Regular Session",69,0,0,11,80
1864501,1439634,2024-05-06,Assembly,"Be adopted. To Consent Calendar",8,0,0,3,11
1864501,1441962,2024-05-09,Assembly,"ACR 162 Petrie-Norris Consent Calendar Second Day Regular Session",65,0,0,15,80
1864502,1410544,2024-03-18,Assembly,"Be adopted. To third reading",9,0,0,2,11
1864503,1413849,2024-03-21,Assembly,"Be adopted. To Consent Calendar",8,0,0,3,11
1864503,1421163,2024-04-04,Assembly,"HR 81 Kalra Consent Calendar Second Day Regular Session",70,0,0,10,80
1865210,1435263,2024-04-23,Assembly,"Do pass as amended, and be re-referred to the Committee on [Appropriations] with recommendation: To Consent Calendar",11,0,0,0,11
1865210,1441293,2024-05-08,Assembly,"Do pass. To Consent Calendar",15,0,0,0,15
1865210,1444689,2024-05-16,Assembly,"AB 3286 Privacy and Consumer Protection Consent Calendar Second Day Regular Session",71,0,0,9,80
1865210,1456292,2024-06-11,Senate,"Do pass, but first be re-referred to the Committee on [Appropriations] with the recommendation: To Consent Calendar",11,0,0,0,11
1865210,1461221,2024-06-27,Senate,"Consent Calendar 2nd AB3286 P. & C.P. (Bauer-Kahan)",40,0,0,0,40
1865211,1434186,2024-04-23,Senate,"Do pass and be ordered to the Consent Calendar",11,0,0,0,11
1865211,1438520,2024-05-02,Senate,"Consent Calendar 2nd SB1525 JUD. (Umberg)",38,0,0,2,40
1865211,1453466,2024-06-04,Assembly,"Do pass. To Consent Calendar",8,0,0,4,12
1865211,1455763,2024-06-10,Assembly,"SB 1525 Judiciary Consent Calendar Second Day Regular Session",63,0,0,16,79
1865211,1458806,2024-06-20,Senate,"Special Consent SB1525 JUD. (Umberg)",36,0,0,4,40
1865212,1432002,2024-04-22,Senate,"Do pass, but first be re-referred to the Committee on [Appropriations] with the recommendation: To Consent Calendar",12,0,0,1,13
1865212,1441953,2024-05-09,Senate,"Consent Calendar 2nd SB1526 B., P. & E.D. (Ashby)",37,0,0,3,40
1865212,1460057,2024-06-25,Assembly,"Do pass as amended, and be re-referred to the Committee on [Appropriations] with recommendation: To Consent Calendar",18,0,0,0,18
1865212,1462292,2024-07-02,Assembly,"Do pass. To Consent Calendar",15,0,0,0,15
1865212,1467133,2024-08-31,Senate,"Unfinished Business SB1526 B., P. & E.D. (Ashby) Concurrence",40,0,0,0,40
1865212,1467134,2024-08-31,Assembly,"SB 1526 Business, Professions an Senate Third Reading By BERMAN",77,0,0,2,79
1865554,1432969,2024-04-22,Assembly,"Do pass and be re-referred to the Committee on [Appropriations] with recommendation: To Consent Calendar",7,0,0,0,7
1865554,1443500,2024-05-15,Assembly,"Do pass. To Consent Calendar",15,0,0,0,15
1865554,1446030,2024-05-21,Assembly,"AB 3287 Revenue and Taxation Consent Calendar Second Day Regular Session",71,0,0,9,80
1865554,1456860,2024-06-12,Senate,"Do pass, but first be re-referred to the Committee on [Appropriations] with the recommendation: To Consent Calendar",6,0,0,1,7
1865554,1461250,2024-06-27,Senate,"Consent Calendar 2nd AB3287 REV. & TAX. (Irwin)",40,0,0,0,40
1865555,1433138,2024-04-22,Assembly,"Do pass. To Consent Calendar",7,0,0,0,7
1865555,1436237,2024-04-29,Assembly,"AB 3288 Revenue and Taxation Consent Calendar Second Day Regular Session",74,0,0,6,80
1865555,1456883,2024-06-12,Senate,"Do pass and be ordered to the Consent Calendar",6,0,0,1,7
1865555,1458807,2024-06-20,Senate,"Consent Calendar 2nd AB3288 REV. & TAX. (Irwin)",36,0,0,4,40
1865556,1433078,2024-04-22,Assembly,"Do pass. To Consent Calendar",7,0,0,0,7
1865556,1436178,2024-04-29,Assembly,"AB 3289 Revenue and Taxation Consent Calendar Second Day Regular Session",74,0,0,6,80
1865556,1456850,2024-06-12,Senate,"Do pass and be ordered to the Consent Calendar",6,0,0,1,7
1865556,1458814,2024-06-20,Senate,"Consent Calendar 2nd AB3289 REV. & TAX. (Irwin)",36,0,0,4,40
1865557,1434046,2024-04-24,Senate,"Do pass, but first be re-referred to the Committee on [Appropriations] with the recommendation: To Consent Calendar",7,0,0,0,7
1865557,1441969,2024-05-09,Senate,"Consent Calendar 2nd SB1527 REV. & TAX. (Glazer)",37,0,0,3,40
1865557,1462300,2024-07-01,Assembly,"Do pass and be re-referred to the Committee on [Appropriations] with recommendation: To Consent Calendar",6,0,0,1,7
1865557,1464471,2024-08-15,Assembly,"Do pass as amended",11,0,0,4,15
1865557,1466453,2024-08-30,Senate,"Special Consent SB1527 REV. & TAX. (Glazer)",40,0,0,0,40
1865557,1467010,2024-08-28,Assembly,"SB 1527 Revenue and Taxation Senate Third Reading By IRWIN",73,0,0,6,79
1865558,1434241,2024-04-24,Senate,"Do pass, but first be re-referred to the Committee on [Appropriations] with the recommendation: To Consent Calendar",7,0,0,0,7
1865558,1441903,2024-05-09,Senate,"Consent Calendar 2nd SB1528 REV. & TAX. (Glazer)",37,0,0,3,40
1865558,1462222,2024-07-01,Assembly,"Do pass and be re-referred to the Committee on [Appropriations] with recommendation: To Consent Calendar",6,0,0,1,7
1865558,1463705,2024-08-07,Assembly,"Do pass. To Consent Calendar",14,0,0,1,15
1865558,1466299,2024-08-29,Senate,"Unfinished Business SB1528 REV. & TAX. (Glazer) Concurrence",39,1,0,0,40
1865558,1466300,2024-08-29,Senate,"Unfinished Business SB1528 REV. & TAX. (Glazer) Concurrence Reconsider",40,0,0,0,40
1865558,1466301,2024-08-29,Senate,"Unfinished Business SB1528 REV. & TAX. (Glazer) Concurrence",38,0,0,2,40
1865558,1466867,2024-08-28,Assembly,"SB 1528 Revenue and Taxation Senate Third Reading By IRWIN",77,0,0,2,79
1865559,1427352,2024-04-15,Senate,"Senate 3rd Reading SCR128 Seyarto et al",39,0,0,1,40
1865559,1445226,2024-05-20,Assembly,"Be adopted. To Consent Calendar",9,0,0,2,11
1865559,1448737,2024-05-22,Assembly,"SCR 128 Seyarto Consent Calendar Second Day Regular Session",69,0,0,11,80
1865560,1425936,2024-04-11,Senate,"Special Consent SR78 Min",39,0,0,1,40
1865561,1438416,2024-05-02,Senate,"Senate 3rd Reading SR79 Min",38,0,0,2,40
1865562,1438452,2024-05-02,Senate,"Senate 3rd Reading SR80 Min",38,0,0,2,40
1865563,1442580,2024-05-13,Senate,"Senate 3rd Reading SR81 Min",36,0,0,4,40
1866111,1432960,2024-04-23,Assembly,"Do pass and be re-referred to the Committee on [Appropriations] with recommendation: To Consent Calendar",10,0,0,1,11
1866111,1441378,2024-05-08,Assembly,"Do pass. To Consent Calendar",15,0,0,0,15
1866111,1444345,2024-05-16,Assembly,"AB 3290 Higher Education Consent Calendar Second Day Regular Session",71,0,0,9,80
1866111,1454246,2024-06-05,Senate,"Do pass, but first be re-referred to the Committee on [Military and Veterans Affairs] with the recommendation: To Consent Calendar",7,0,0,0,7
1866111,1459936,2024-06-24,Senate,"Do pass, but first be re-referred to the Committee on [Appropriations] with the recommendation: To Consent Calendar",5,0,0,0,5
1866111,1463864,2024-08-12,Senate,"Consent Calendar 2nd AB3290 HIGHER ED. (Mike Fong)",38,0,0,2,40
1866111,1465309,2024-08-19,Assembly,"AB 3290 Higher Education Concurrence in Senate Amendments By FONG, M",77,0,0,2,79
1866584,1433184,2024-04-23,Assembly,"Do pass and be re-referred to the Committee on [Appropriations] with recommendation: To Consent Calendar",6,0,0,1,7
1866584,1444355,2024-05-16,Assembly,"Do pass",15,0,0,0,15
1866584,1448587,2024-05-22,Assembly,"AB 3291 Human Services Assembly Third Reading By LEE",71,0,0,9,80
1866584,1462368,2024-07-01,Senate,"Do pass, but first be re-referred to the Committee on [Appropriations] with the recommendation: To Consent Calendar",5,0,0,0,5
1866584,1463664,2024-08-05,Senate,"Placed on suspense file",7,0,0,0,7
1866584,1464628,2024-08-15,Senate,"Do pass",7,0,0,0,7
1866584,1466292,2024-08-29,Assembly,"AB 3291 Human Services Concurrence in Senate Amendments By LEE",76,0,0,3,79
1866584,1466773,2024-08-28,Senate,"Assembly 3rd Reading AB3291 HUM. S. (Lee) By Menjivar",39,0,0,1,40
1866585,1442582,2024-05-13,Assembly,"Be adopted. To Consent Calendar",10,0,0,1,11
1866585,1444629,2024-05-16,Assembly,"ACR 163 Hart Consent Calendar Second Day Regular Session",71,0,0,9,80
1866585,1454827,2024-06-06,Senate,"Special Consent ACR163 Hart et al",32,0,0,8,40
1866586,1422086,2024-04-08,Assembly,"Be adopted. To Consent Calendar",10,0,0,1,11
1866586,1427351,2024-04-15,Assembly,"ACR 164 Garcia Assembly Third Reading",75,0,0,5,80
1866586,1438462,2024-05-02,Senate,"Special Consent ACR164 Garcia",38,0,0,2,40
1866587,1433166,2024-04-23,Assembly,"Be adopted. To third reading",10,0,0,1,11
1866587,1450940,2024-05-28,Assembly,"AJR 13 Santiago Assembly Third Reading",68,0,0,11,79
1866587,1460587,2024-06-26,Senate,"Be adopted and be ordered to the Consent Calendar",7,0,0,0,7
1866587,1462553,2024-07-03,Senate,"Consent Calendar 2nd AJR13 Santiago et al",39,0,0,1,40
1866588,1431980,2024-04-22,Senate,"Do pass, but first be re-referred to the Committee on [Appropriations] with the recommendation: To Consent Calendar",5,0,0,0,5
1866588,1441898,2024-05-09,Senate,"Consent Calendar 2nd SB1529 M.&V.A. (Archuleta)",37,0,0,3,40
1866588,1455798,2024-06-10,Assembly,"Do pass and be re-referred to the Committee on [Appropriations]",9,0,0,1,10
1866588,1458549,2024-06-19,Assembly,"Do pass. To Consent Calendar",14,0,0,1,15
1866588,1460713,2024-06-26,Assembly,"SB 1529 Military and Veterans Affairs Consent Calendar Second Day Regular Session",75,0,0,4,79
1866589,1431952,2024-04-22,Senate,"Do pass, but first be re-referred to the Committee on [Appropriations] with the recommendation: To Consent Calendar",5,0,0,0,5
1866589,1441922,2024-05-09,Senate,"Consent Calendar 2nd SB1530 M.&V.A. (Archuleta)",37,0,0,3,40
1866589,1455784,2024-06-10,Assembly,"Do pass and be re-referred to the Committee on [Appropriations]",9,0,0,1,10
1866589,1458472,2024-06-19,Assembly,"Do pass. To Consent Calendar",14,0,0,1,15
1866589,1460478,2024-06-26,Assembly,"SB 1530 Military and Veterans Affairs Consent Calendar Second Day Regular Session",75,0,0,4,79
1866590,1438454,2024-05-02,Senate,"Senate 3rd Reading SR82 Blakespear",38,0,0,2,40
1869180,1422058,2024-04-08,Assembly,"Be adopted. To third reading",10,0,0,1,11
1869180,1438489,2024-05-02,Senate,"Special Consent ACR165 Schiavo et al",38,0,0,2,40
1869181,1434071,2024-04-24,Assembly,"Be adopted. To Consent Calendar",9,0,0,0,9
1869181,1436163,2024-04-29,Assembly,"AJR 14 Ward Consent Calendar Second Day Regular Session",74,0,0,6,80
1869181,1453463,2024-06-04,Senate,"Be adopted and be ordered to the Consent Calendar",9,0,0,1,10
1869181,1455822,2024-06-10,Senate,"Consent Calendar 2nd AJR14 Ward",37,0,0,3,40
1869182,1427369,2024-04-15,Assembly,"Be adopted. To third reading",7,0,0,4,11
1869183,1442591,2024-05-13,Assembly,"Be adopted. To Consent Calendar",10,0,0,1,11
1869183,1444289,2024-05-16,Assembly,"HR 83 Aguiar-Curry Consent Calendar Second Day Regular Session",71,0,0,9,80
1869184,1427286,2024-04-15,Assembly,"Be adopted. To Consent Calendar",7,0,0,4,11
1869184,1431024,2024-04-18,Assembly,"HR 84 Bonta Consent Calendar Second Day Regular Session",72,0,0,8,80
1869185,1427301,2024-04-15,Assembly,"Be adopted. To third reading",7,0,0,4,11
1869187,1431036,2024-04-18,Senate,"Senate 3rd Reading SCR129 Padilla",39,0,0,1,40
1869187,1445177,2024-05-20,Assembly,"Be adopted. To Consent Calendar",9,0,0,2,11
1869187,1448651,2024-05-22,Assembly,"SCR 129 Padilla Consent Calendar Second Day Regular Session",69,0,0,11,80
1869188,1431943,2024-04-22,Senate,"Senate 3rd Reading SR83 Wilk et al",37,0,0,3,40
1869189,1427288,2024-04-15,Senate,"Senate 3rd Reading SR84 Gonzalez et al",39,0,0,1,40
1869190,1431029,2024-04-18,Senate,"Senate 3rd Reading SR85 Gonzalez et al",39,0,0,1,40
1869785,1450956,2024-05-28,Assembly,"Be adopted. To third reading",6,0,0,5,11
1869785,1458758,2024-06-20,Senate,"Special Consent ACR166 Ramos et al",36,0,0,4,40
1869785,1462109,2024-07-01,Assembly,"ACR 166 Ramos Concurrence in Senate Amendments",73,0,0,6,79
1869786,1427367,2024-04-15,Assembly,"Be adopted and re-referred to the Committee on [Appropriations]",6,0,0,1,7
1869786,1445228,2024-05-20,Assembly,"AJR 15 Irwin Assembly Third Reading",70,0,0,10,80
1869786,1456898,2024-06-12,Senate,"Be adopted, but first be re-referred to the Committee on [Appropriations]",6,0,0,1,7
1869787,1431065,2024-04-18,Senate,"Senate 3rd Reading SCR130 Newman et al",39,0,0,1,40
1869787,1445237,2024-05-20,Assembly,"Be adopted. To Consent Calendar",9,0,0,2,11
1869787,1448596,2024-05-22,Assembly,"SCR 130 Newman Consent Calendar Second Day Regular Session",69,0,0,11,80
1870176,1436226,2024-04-29,Assembly,"Be adopted. To Consent Calendar",9,0,0,2,11
1870176,1439638,2024-05-06,Assembly,"ACR 167 Juan Carrillo Consent Calendar Second Day",65,0,0,15,80
1870176,1449610,2024-05-23,Senate,"Special Consent ACR167 Juan Carrillo et al",37,0,0,3,40
1870177,1422029,2024-04-08,Assembly,"Be adopted. To Consent Calendar",10,0,0,1,11
1870177,1427247,2024-04-15,Assembly,"HR 86 Lowenthal Assembly Third Reading",75,0,0,5,80
1870178,1427328,2024-04-15,Assembly,"Be adopted as amended",7,0,0,4,11
1870178,1430985,2024-04-18,Assembly,"HR 87 Lowenthal Assembly Third Reading",71,0,0,9,80
1870179,1436208,2024-04-29,Assembly,"Be adopted. To Consent Calendar",9,0,0,2,11
1870179,1439625,2024-05-06,Assembly,"HR 88 Boerner Consent Calendar Second Day Regular Session",65,0,0,15,80
1870180,1431047,2024-04-18,Senate,"Senate 3rd Reading SR86 Cortese et al",39,0,0,1,40
1870876,1442554,2024-05-13,Assembly,"Be adopted. To Consent Calendar",10,0,0,1,11
1870876,1444039,2024-05-16,Assembly,"ACR 168 Rodriguez Consent Calendar Second Day Regular Session",71,0,0,9,80
1870876,1454832,2024-06-06,Senate,"Special Consent ACR168 Rodriguez et al",32,0,0,8,40
1870877,1432986,2024-04-23,Assembly,"Be adopted, and re-refer to the Committee on [Appropriations] with recommendation: To Consent Calendar",11,0,0,1,12
1870877,1437582,2024-05-01,Assembly,"Be adopted. To Consent Calendar",14,0,0,1,15
1870877,1439628,2024-05-06,Assembly,"ACR 169 Kalra Consent Calendar Second Day Regular Session",65,0,0,15,80
1870877,1456428,2024-06-11,Senate,"Be adopted, but first be re-referred to the Committee on [Appropriations] with recommendation: To Consent Calendar",11,0,0,0,11
1870877,1461243,2024-06-27,Senate,"Consent Calendar 2nd ACR169 Kalra",40,0,0,0,40
1870878,1427260,2024-04-15,Assembly,"Be adopted. To Consent Calendar",7,0,0,4,11
1870878,1431061,2024-04-18,Assembly,"HR 89 Pellerin Consent Calendar Second Day Regular Session",72,0,0,8,80
1870879,1431953,2024-04-22,Assembly,"Be adopted. To third reading",7,0,0,4,11
1870880,1439667,2024-05-06,Assembly,"Be adopted. To third reading",8,0,0,3,11
1870881,1435296,2024-04-25,Senate,"Senate 3rd Reading SCR131 Min",36,0,0,4,40
1870881,1455821,2024-06-10,Assembly,"Be adopted. To Consent Calendar",9,0,0,2,11
1870881,1457367,2024-06-13,Assembly,"SCR 131 Min Consent Calendar Second Day Regular Session",77,0,0,2,79
1870882,1459396,2024-06-24,Senate,"Senate 3rd Reading SCR132 Seyarto et al",38,0,0,2,40
1870882,1462073,2024-07-01,Assembly,"Be adopted. To Consent Calendar",11,0,0,0,11
1870882,1463691,2024-08-05,Assembly,"SCR 132 Seyarto Consent Calendar Second Day Regular Session",71,0,0,8,79
1870883,1431857,2024-04-22,Senate,"Senate 3rd Reading SCR133 Wahab et al",37,0,0,3,40
1870883,1445246,2024-05-20,Assembly,"Be adopted. To Consent Calendar",9,0,0,2,11
1870883,1448694,2024-05-22,Assembly,"SCR 133 Wahab Consent Calendar Second Day Regular Session",69,0,0,11,80
1870884,1438453,2024-05-02,Senate,"Senate 3rd Reading SCR134 Grove et al",38,0,0,2,40
1870884,1445164,2024-05-20,Assembly,"Be adopted. To Consent Calendar",9,0,0,2,11
1870884,1448775,2024-05-22,Assembly,"SCR 134 Grove Consent Calendar Second Day Regular Session",69,0,0,11,80
1871205,1442650,2024-05-13,Assembly,"Be adopted. To Consent Calendar",10,0,0,1,11
1871205,1444127,2024-05-16,Assembly,"ACR 170 Hoover Consent Calendar Second Day Regular Session",71,0,0,9,80
1871205,1454826,2024-06-06,Senate,"Special Consent ACR170 Hoover et al",32,0,0,8,40
1871206,1427343,2024-04-15,Assembly,"Be adopted. To Consent Calendar",7,0,0,4,11
1871206,1431033,2024-04-18,Assembly,"ACR 171 Low Consent Calendar Second Day Regular Session",72,0,0,8,80
1871206,1441955,2024-05-09,Senate,"Special Consent ACR171 Low et al",37,0,0,3,40
1871208,1431882,2024-04-22,Assembly,"Be adopted. To Consent Calendar",7,0,0,4,11
1871208,1435356,2024-04-25,Assembly,"ACR 173 Bains Consent Calendar Second Day Regular Session",75,0,0,5,80
1871208,1449593,2024-05-23,Senate,"Special Consent ACR173 Bains et al",37,0,0,3,40
1871209,1436207,2024-04-29,Assembly,"Be adopted. To third reading",9,0,0,2,11
1871664,1442640,2024-05-13,Assembly,"Be adopted. To third reading",10,0,0,1,11
1871664,1454824,2024-06-06,Senate,"Special Consent ACR174 Grayson et al",32,0,0,8,40
1871666,1431913,2024-04-22,Assembly,"Be adopted. To third reading",7,0,0,4,11
1871666,1449641,2024-05-23,Senate,"Special Consent ACR176 Gabriel et al",37,0,0,3,40
1871667,1452968,2024-06-03,Assembly,"Be adopted as amended",6,0,0,5,11
1871668,1452243,2024-05-30,Senate,"Special Consent SR87 Blakespear",37,0,0,3,40
1871669,1432985,2024-04-23,Senate,"Be adopted and be ordered to the Consent Calendar",16,0,0,0,16
1871669,1438471,2024-05-02,Senate,"Consent Calendar 2nd SR88 Glazer",38,0,0,2,40
1872124,1436175,2024-04-29,Senate,"Senate 3rd Reading SCR135 Wiener et al",33,0,0,7,40
1872124,1445297,2024-05-20,Assembly,"Be adopted. To Consent Calendar",9,0,0,2,11
1872124,1448764,2024-05-22,Assembly,"SCR 135 Wiener Consent Calendar Second Day Regular Session",69,0,0,11,80
1872656,1435242,2024-04-25,Senate,"Senate 3rd Reading SCR137 Wahab et al",36,0,0,4,40
1873020,1445146,2024-05-20,Assembly,"Be adopted. To third reading",9,0,0,2,11
1873020,1457353,2024-06-13,Senate,"Special Consent ACR177 Ward et al",37,0,0,3,40
1873021,1431846,2024-04-22,Senate,"Senate 3rd Reading SCR138 Roth",37,0,0,3,40
1873021,1445167,2024-05-20,Assembly,"Be adopted. To Consent Calendar",9,0,0,2,11
1873021,1448773,2024-05-22,Assembly,"SCR 138 Roth Consent Calendar Second Day Regular Session",69,0,0,11,80
1873022,1441944,2024-05-09,Senate,"Senate 3rd Reading SCR139 Cortese",37,0,0,3,40
1873022,1455800,2024-06-10,Assembly,"Be adopted. To Consent Calendar",9,0,0,2,11
1873022,1457354,2024-06-13,Assembly,"SCR 139 Cortese Consent Calendar Second Day Regular Session",77,0,0,2,79
1873023,1435352,2024-04-25,Senate,"Senate 3rd Reading SR89 Rubio et al",36,0,0,4,40
1873024,1438414,2024-05-02,Senate,"Special Consent SR90 Rubio et al",38,0,0,2,40
1873271,1431956,2024-04-22,Assembly,"Be adopted. To Consent Calendar",7,0,0,4,11
1873271,1435260,2024-04-25,Assembly,"ACR 178 Jackson Consent Calendar Second Day Regular Session",75,0,0,5,80
1873271,1449543,2024-05-23,Senate,"Special Consent ACR178 Jackson et al",37,0,0,3,40
1873493,1439659,2024-05-06,Assembly,"Be adopted. To third reading",8,0,0,3,11
1873493,1452234,2024-05-30,Senate,"Special Consent ACR179 Jones-Sawyer et al",37,0,0,3,40
1873495,1460047,2024-06-25,Assembly,"Be adopted. To Consent Calendar",16,0,0,0,16
1873495,1462105,2024-07-01,Assembly,"AJR 16 Low Consent Calendar Second Day",72,0,0,7,79
1873495,1463958,2024-08-14,Senate,"Be adopted and be ordered to the Consent Calendar",9,0,0,2,11
1873495,1465449,2024-08-22,Senate,"Consent Calendar 2nd AJR16 Low et al",33,0,0,7,40
1873496,1439609,2024-05-06,Assembly,"Be adopted. To third reading",8,0,0,3,11
1873497,1457972,2024-06-17,Senate,"Be adopted and be ordered to the Consent Calendar",11,0,0,0,11
1873497,1459409,2024-06-24,Senate,"Consent Calendar 2nd SJR15 Bradford et al",38,0,0,2,40
1873946,1442596,2024-05-13,Assembly,"Be adopted. To third reading",10,0,0,1,11
1873946,1454838,2024-06-06,Senate,"Special Consent ACR181 Rodriguez et al",32,0,0,8,40
1873947,1452959,2024-06-03,Assembly,"Be adopted. To third reading",6,0,0,5,11
1873947,1464282,2024-08-15,Senate,"Assembly 3rd Reading ACR182 Dixon et al. By Jones",37,0,0,3,40
1873947,1465290,2024-08-19,Assembly,"ACR 182 Dixon Concurrence in Senate Amendments",77,0,0,2,79
1873948,1436229,2024-04-29,Assembly,"Be adopted. To Consent Calendar",9,0,0,2,11
1873948,1438490,2024-05-02,Assembly,"HR 95 Gabriel Consent Calendar Second Day Regular Session",73,0,0,7,80
1873949,1436238,2024-04-29,Assembly,"Be adopted. To third reading",9,0,0,2,11
1873950,1441902,2024-05-09,Senate,"Special Consent SCR140 Dodd",37,0,0,3,40
1873950,1445216,2024-05-20,Assembly,"Be adopted. To Consent Calendar",9,0,0,2,11
1873950,1448783,2024-05-22,Assembly,"SCR 140 Dodd Consent Calendar Second Day Regular Session",69,0,0,11,80
1874200,1439695,2024-05-06,Assembly,"Be adopted. To Consent Calendar",8,0,0,3,11
1874200,1441963,2024-05-09,Assembly,"ACR 183 Bennett Consent Calendar Second Day Regular Session",65,0,0,15,80
1874200,1452247,2024-05-30,Senate,"Special Consent ACR183 Bennett et al",37,0,0,3,40
1874201,1436205,2024-04-29,Assembly,"Be adopted. To Consent Calendar",9,0,0,2,11
1874201,1438487,2024-05-02,Assembly,"ACR 184 Bains Consent Calendar Second Day Regular Session",73,0,0,7,80
1874201,1449660,2024-05-23,Senate,"Special Consent ACR184 Bains et al",37,0,0,3,40
1874203,1442560,2024-05-13,Assembly,"Be adopted. To third reading",10,0,0,1,11
1874204,1436201,2024-04-29,Assembly,"Be adopted. To Consent Calendar",9,0,0,2,11
1874204,1438448,2024-05-02,Assembly,"HR 98 Alvarez Consent Calendar Second Day Regular Session",73,0,0,7,80
1874420,1450975,2024-05-28,Senate,"Senate 3rd Reading SCR141 Wiener et al",37,0,0,3,40
1874420,1455776,2024-06-10,Assembly,"Be adopted. To Consent Calendar",9,0,0,2,11
1874420,1457349,2024-06-13,Assembly,"SCR 141 Wiener Consent Calendar Second Day Regular Session",77,0,0,2,79
1874638,1439691,2024-05-06,Assembly,"Be adopted. To third reading",8,0,0,3,11
1874638,1452249,2024-05-30,Senate,"Special Consent ACR185 Hart et al",37,0,0,3,40
1874639,1452979,2024-06-03,Senate,"Senate 3rd Reading SCR142 Lim√≥n et al",36,0,0,4,40
1874639,1457985,2024-06-17,Assembly,"Be adopted. To Consent Calendar",10,0,0,1,11
1874639,1458766,2024-06-20,Assembly,"SCR 142 Lim√≥n Consent Calendar Second Day Regular Session",67,0,0,12,79
1874954,1442550,2024-05-13,Assembly,"Be adopted. To third reading",10,0,0,1,11
1874954,1454830,2024-06-06,Senate,"Special Consent ACR186 Gipson et al",32,0,0,8,40
1874955,1439708,2024-05-06,Assembly,"Be adopted. To Consent Calendar",8,0,0,3,11
1874955,1441899,2024-05-09,Assembly,"HR 99 Bains Consent Calendar Second Day Regular Session",65,0,0,15,80
1874956,1451551,2024-05-28,Senate,"Be adopted, but first be re-referred to the Committee on [Appropriations] with recommendation: To Consent Calendar",12,0,0,3,15
1874956,1457317,2024-06-13,Senate,"Consent Calendar 2nd SCR143 Gonzalez",37,0,0,3,40
1874956,1462214,2024-07-01,Assembly,"Be adopted. To Consent Calendar",15,0,0,0,15
1874956,1463693,2024-08-05,Assembly,"SCR 143 Gonzalez Consent Calendar Second Day Regular Session",71,0,0,8,79
1875249,1445302,2024-05-20,Assembly,"Be adopted. To third reading",9,0,0,2,11
1875249,1457315,2024-06-13,Senate,"Special Consent ACR187 Chen et al",37,0,0,3,40
1875250,1439704,2024-05-06,Assembly,"Be adopted. To Consent Calendar",8,0,0,3,11
1875250,1441913,2024-05-09,Assembly,"ACR 188 Irwin Consent Calendar Second Day Regular Session",65,0,0,15,80
1875250,1452241,2024-05-30,Senate,"Special Consent ACR188 Irwin et al",37,0,0,3,40
1875251,1439664,2024-05-06,Assembly,"Be adopted. To third reading",8,0,0,3,11
1875251,1452236,2024-05-30,Senate,"Special Consent ACR189 Wallis et al",37,0,0,3,40
1875252,1445288,2024-05-20,Senate,"Senate 3rd Reading SR91 Padilla et al",33,0,0,7,40
1875555,1442569,2024-05-13,Assembly,"Be adopted. To third reading",10,0,0,1,11
1875555,1454839,2024-06-06,Senate,"Special Consent ACR190 Dixon et al",32,0,0,8,40
1875556,1445211,2024-05-20,Assembly,"Be adopted. To third reading",9,0,0,2,11
1875556,1450954,2024-05-28,Assembly,"ACR 191 Bonta Consent Calendar Second Day",59,1,0,19,79
1875992,1455823,2024-06-10,Assembly,"Be adopted. To third reading",9,0,0,2,11
1875992,1462483,2024-07-03,Senate,"Special Consent ACR192 Jones-Sawyer et al",39,0,0,1,40
1875993,1442530,2024-05-13,Assembly,"Be adopted. To third reading",10,0,0,1,11
1875993,1458785,2024-06-20,Senate,"Special Consent ACR193 Bryan et al",36,0,0,4,40
1875994,1445260,2024-05-20,Assembly,"Be adopted. To third reading",9,0,0,2,11
1875994,1458830,2024-06-20,Senate,"Special Consent ACR194 Grayson et al",36,0,0,4,40
1875995,1442571,2024-05-13,Assembly,"Be adopted. To third reading",10,0,0,1,11
1875996,1441928,2024-05-09,Senate,"Senate 3rd Reading SCR144 Rubio et al",37,0,0,3,40
1875996,1455794,2024-06-10,Assembly,"Be adopted. To Consent Calendar",9,0,0,2,11
1875996,1457303,2024-06-13,Assembly,"SCR 144 Rubio Consent Calendar Second Day Regular Session",77,0,0,2,79
1875997,1452237,2024-05-30,Senate,"Senate 3rd Reading SR92 Rubio et al",38,0,0,2,40
1876682,1445158,2024-05-20,Assembly,"Be adopted. To third reading",9,0,0,2,11
1876682,1458836,2024-06-20,Senate,"Special Consent ACR195 Low et al",36,0,0,4,40
1876683,1455786,2024-06-10,Assembly,"Be adopted. To Consent Calendar",9,0,0,2,11
1876683,1457314,2024-06-13,Assembly,"ACR 196 Ta Consent Calendar Second Day",77,0,0,2,79
1876683,1462692,2024-07-03,Senate,"Special Consent ACR196 Ta et al",39,0,0,1,40
1876684,1442630,2024-05-13,Assembly,"Be adopted. To Consent Calendar",10,0,0,1,11
1876684,1444527,2024-05-16,Assembly,"ACR 197 Stephanie Nguyen Consent Calendar Second Day Regular Session",71,0,0,9,80
1876684,1454835,2024-06-06,Senate,"Special Consent ACR197 Stephanie Nguyen et",32,0,0,8,40
1876685,1465486,2024-08-22,Senate,"Special Consent SR93 Durazo",33,0,0,7,40
1876686,1450942,2024-05-28,Senate,"Senate 3rd Reading SR94 McGuire et al",34,0,0,6,40
1876980,1442644,2024-05-13,Assembly,"Be adopted. To third reading",10,0,0,1,11
1876980,1457351,2024-06-13,Senate,"Special Consent ACR198 Villapudua et al",37,0,0,3,40
1876981,1452961,2024-06-03,Senate,"Senate 3rd Reading SCR145 Alvarado-Gil et al",36,0,0,4,40
1876981,1458024,2024-06-17,Assembly,"Be adopted. To Consent Calendar",10,0,0,1,11
1876981,1458817,2024-06-20,Assembly,"SCR 145 Alvarado-Gil Consent Calendar Second Day Regular Session",67,0,0,12,79
1877478,1445300,2024-05-20,Assembly,"Be adopted. To Consent Calendar",9,0,0,2,11
1877478,1448646,2024-05-22,Assembly,"ACR 199 Alanis Consent Calendar Second Day Regular Session",69,0,0,11,80
1877478,1457337,2024-06-13,Senate,"Special Consent ACR199 Alanis et al",37,0,0,3,40
1877479,1462024,2024-07-01,Assembly,"Be adopted. To third reading",15,0,0,1,16
1877479,1463516,2024-08-05,Assembly,"AJR 18 Davies Assembly Third Reading",66,0,0,13,79
1877479,1463937,2024-08-13,Senate,"Be adopted. Ordered to third reading",11,0,0,7,18
1877479,1464236,2024-08-15,Senate,"Assembly 3rd Reading AJR18 Davies et al. By Blakespear",35,0,0,5,40
1877480,1463475,2024-08-05,Senate,"Senate 3rd Reading SR95 Newman et al",39,0,0,1,40
1878126,1445132,2024-05-20,Assembly,"Be adopted. To Consent Calendar",9,0,0,2,11
1878126,1448673,2024-05-22,Assembly,"ACR 200 Jones-Sawyer Consent Calendar Second Day Regular Session",69,0,0,11,80
1878126,1457318,2024-06-13,Senate,"Special Consent ACR200 Jones-Sawyer et al",37,0,0,3,40
1878127,1445244,2024-05-20,Assembly,"Be adopted. To Consent Calendar",9,0,0,2,11
1878127,1448553,2024-05-22,Assembly,"ACR 201 Alanis Consent Calendar Second Day Regular Session",69,0,0,11,80
1878127,1457305,2024-06-13,Senate,"Special Consent ACR201 Alanis et al",37,0,0,3,40
1878128,1450936,2024-05-28,Assembly,"Be adopted. To third reading",6,0,0,5,11
1878129,1463785,2024-08-08,Senate,"Senate 3rd Reading SCR146 Ochoa Bogh et al",38,0,0,2,40
1878129,1464273,2024-08-15,Assembly,"Be adopted. To Consent Calendar",7,0,0,4,11
1878129,1465503,2024-08-22,Assembly,"SCR 146 Ochoa Bogh Consent Calendar Second Day Regular Session",57,0,0,22,79
1878281,1452233,2024-05-30,Senate,"Senate 3rd Reading SCR147 Ashby et al",38,0,0,2,40
1878281,1455810,2024-06-10,Assembly,"Be adopted. To Consent Calendar",9,0,0,2,11
1878281,1457348,2024-06-13,Assembly,"SCR 147 Ashby Consent Calendar Second Day Regular Session",77,0,0,2,79
1878282,1452240,2024-05-30,Senate,"Senate 3rd Reading SCR148 Alvarado-Gil",38,0,0,2,40
1878282,1455807,2024-06-10,Assembly,"Be adopted. To Consent Calendar",9,0,0,2,11
1878282,1457361,2024-06-13,Assembly,"SCR 148 Alvarado-Gil Consent Calendar Second Day Regular Session",77,0,0,2,79
1878283,1452974,2024-06-03,Senate,"Senate 3rd Reading SR96 Eggman et al",29,0,0,11,40
1878603,1453437,2024-06-04,Assembly,"Be adopted as amended. To Consent Calendar",8,0,0,4,12
1878603,1462530,2024-07-03,Senate,"Special Consent ACR202 McCarty et al",39,0,0,1,40
1878604,1450979,2024-05-28,Senate,"Senate 3rd Reading SCR149 Cortese",37,0,0,3,40
1878604,1455773,2024-06-10,Assembly,"Be adopted. To Consent Calendar",9,0,0,2,11
1878604,1457375,2024-06-13,Assembly,"SCR 149 Cortese Consent Calendar Second Day Regular Session",77,0,0,2,79
1878605,1452245,2024-05-30,Senate,"Senate 3rd Reading SR97 Alvarado-Gil",37,0,0,3,40
1879132,1458184,2024-06-17,Assembly,"Be adopted. To Consent Calendar",15,0,0,0,15
1879132,1458757,2024-06-20,Assembly,"ACR 203 Hart Consent Calendar Second Day Regular Session",67,0,0,12,79
1879132,1463940,2024-08-13,Senate,"Be adopted, but first be re-referred to the Committee on [Appropriations] with recommendation: To Consent Calendar",13,0,0,2,15
1879132,1465497,2024-08-22,Senate,"Consent Calendar 2nd ACR203 Hart et al",33,0,0,7,40
1879133,1457948,2024-06-17,Senate,"Senate 3rd Reading SCR150 Ochoa Bogh et al",39,0,0,1,40
1879133,1459335,2024-06-24,Assembly,"Be adopted. To Consent Calendar",7,0,0,4,11
1879133,1460514,2024-06-26,Assembly,"SCR 150 Ochoa Bogh Consent Calendar Second Day Regular Session",75,0,0,4,79
1879134,1456395,2024-06-11,Senate,"Be adopted, but first be re-referred to the Committee on [Appropriations] with recommendation: To Consent Calendar",15,0,0,0,15
1879134,1461251,2024-06-27,Senate,"Consent Calendar 2nd SCR151 Stern",40,0,0,0,40
1879134,1462260,2024-07-01,Assembly,"Be adopted. To third reading",15,0,0,0,15
1879134,1464561,2024-08-15,Assembly,"SCR 151 Stern Senate Third Reading By Schiavo",76,0,0,3,79
1879135,1456298,2024-06-11,Senate,"Be adopted. Ordered to third reading",9,0,0,2,11
1879135,1458835,2024-06-20,Senate,"Senate 3rd Reading SJR16 Padilla et al",34,0,0,6,40
1879135,1464007,2024-08-15,Assembly,"Be adopted. To third reading",10,0,0,5,15
1879135,1465620,2024-08-26,Assembly,"SJR 16 Padilla Senate Third Reading By Ramos",74,0,0,5,79
1879135,1467223,2024-08-31,Senate,"Unfinished Business SJR16 Padilla et al. Concurrence",35,0,0,5,40
1879637,1448666,2024-05-22,Assembly,"Be adopted. To third reading",6,0,0,5,11
1879638,1458022,2024-06-17,Senate,"Senate 3rd Reading SCR152 Bradford et al",39,0,0,1,40
1879638,1459368,2024-06-24,Assembly,"Be adopted. To Consent Calendar",7,0,0,4,11
1879638,1460515,2024-06-26,Assembly,"SCR 152 Bradford Consent Calendar Second Day Regular Session",75,0,0,4,79
1879639,1455774,2024-06-10,Senate,"Senate 3rd Reading SCR153 Dodd et al",37,0,0,3,40
1879639,1458816,2024-06-20,Assembly,"Be adopted. To Consent Calendar",9,0,0,2,11
1879639,1460565,2024-06-26,Assembly,"SCR 153 Dodd Consent Calendar Second Day Regular Session",75,0,0,4,79
1879846,1452955,2024-06-03,Assembly,"Be adopted. To third reading",6,0,0,5,11
1879846,1461260,2024-06-27,Senate,"Special Consent ACR204 Soria et al",40,0,0,0,40
1879847,1458205,2024-06-17,Assembly,"Be adopted. To Consent Calendar",15,0,0,0,15
1879847,1458779,2024-06-20,Assembly,"AJR 19 Juan Carrillo Consent Calendar Second Day Regular Session",67,0,0,12,79
1879847,1463939,2024-08-13,Senate,"Be adopted and be ordered to the Consent Calendar",13,0,0,2,15
1879847,1465465,2024-08-22,Senate,"Consent Calendar 2nd AJR19 Juan Carrillo et al",33,0,0,7,40
1879848,1450943,2024-05-28,Assembly,"Be adopted. To third reading",6,0,0,5,11
1879849,1457968,2024-06-17,Senate,"Senate 3rd Reading SR98 Jones et al",40,0,0,0,40
1880054,1457961,2024-06-17,Assembly,"Be adopted. To third reading",10,0,0,1,11
1880054,1463784,2024-08-08,Senate,"Special Consent ACR205 Aguiar-Curry et al",37,0,0,3,40
1880621,1452978,2024-06-03,Assembly,"Be adopted. To third reading",6,0,0,5,11
1880621,1458797,2024-06-20,Senate,"Assembly 3rd Reading ACR206 Cervantes et al. By Gonzalez",36,0,0,4,40
1880622,1454829,2024-06-06,Senate,"Senate 3rd Reading SCR154 Ashby et al",32,0,0,8,40
1880622,1458032,2024-06-17,Assembly,"Be adopted. To Consent Calendar",10,0,0,1,11
1880622,1458764,2024-06-20,Assembly,"SCR 154 Ashby Consent Calendar Second Day Regular Session",67,0,0,12,79
1880623,1455820,2024-06-10,Senate,"Senate 3rd Reading SCR155 Gonzalez",37,0,0,3,40
1880623,1458781,2024-06-20,Assembly,"Be adopted. To Consent Calendar",9,0,0,2,11
1880623,1460454,2024-06-26,Assembly,"SCR 155 Gonzalez Consent Calendar Second Day Regular Session",75,0,0,4,79
1880624,1458034,2024-06-17,Senate,"Be adopted. Ordered to third reading",10,0,0,1,11
1880624,1459413,2024-06-24,Senate,"Senate 3rd Reading SJR17 Allen By Padilla",37,0,0,3,40
1880624,1464411,2024-08-15,Assembly,"Be adopted. To third reading",10,0,0,5,15
1880624,1465759,2024-08-26,Assembly,"SJR 17 Allen Senate Third Reading By Ramos",74,0,0,5,79
1880624,1467146,2024-08-31,Senate,"Unfinished Business SJR17 Allen et al. Concurrence",36,0,0,4,40
1880818,1455796,2024-06-10,Senate,"Senate 3rd Reading SCR156 Allen et al. By Rubio",37,0,0,3,40
1880818,1458756,2024-06-20,Assembly,"Be adopted. To Consent Calendar",9,0,0,2,11
1880818,1460741,2024-06-26,Assembly,"SCR 156 Allen Consent Calendar Second Day Regular Session",75,0,0,4,79
1880819,1462540,2024-07-03,Senate,"Senate 3rd Reading SR99 Blakespear et al",40,0,0,0,40
1880986,1456323,2024-06-11,Senate,"Be adopted. Ordered to third reading",6,0,0,1,7
1880986,1457308,2024-06-13,Senate,"Senate 3rd Reading SCR157 Allen",30,0,0,10,40
1880986,1459343,2024-06-24,Assembly,"SCR 157 Allen Senate Third Reading By Lee",60,2,0,17,79
1881334,1455783,2024-06-10,Assembly,"Be adopted. To Consent Calendar",9,0,0,2,11
1881334,1457324,2024-06-13,Assembly,"ACR 207 Aguiar-Curry Consent Calendar Second Day Regular Session",77,0,0,2,79
1881334,1462673,2024-07-03,Senate,"Special Consent ACR207 Aguiar-Curry et al",39,0,0,1,40
1881335,1455809,2024-06-10,Assembly,"Be adopted. To third reading",9,0,0,2,11
1881335,1462444,2024-07-03,Senate,"Special Consent ACR208 Papan et al",39,0,0,1,40
1881512,1460606,2024-06-26,Senate,"Be adopted and be ordered to the Consent Calendar",11,0,0,0,11
1881512,1462509,2024-07-03,Senate,"Consent Calendar 2nd SJR18 Padilla et al",39,0,0,1,40
1881512,1463938,2024-08-13,Assembly,"Be adopted. To Consent Calendar",7,0,0,0,7
1881512,1464551,2024-08-15,Assembly,"SJR 18 Padilla Consent Calendar Second Day Regular Session",75,0,0,4,79
1881513,1461271,2024-06-27,Senate,"Senate 3rd Reading SR100 Caballero et al",40,0,0,0,40
1881514,1461247,2024-06-27,Senate,"Senate 3rd Reading SR101 Caballero et al",40,0,0,0,40
1881628,1457977,2024-06-17,Assembly,"Be adopted. To Consent Calendar",10,0,0,1,11
1881628,1458819,2024-06-20,Assembly,"ACR 209 Kalra Consent Calendar Second Day",67,0,0,12,79
1881628,1463781,2024-08-08,Senate,"Special Consent ACR209 Kalra et al",37,0,0,3,40
1881629,1461223,2024-06-27,Senate,"Special Consent SCR158 Niello",40,0,0,0,40
1881629,1463597,2024-08-05,Assembly,"Be adopted. To Consent Calendar",10,0,0,1,11
1881629,1463799,2024-08-08,Assembly,"SCR 158 Niello Consent Calendar Second Day Regular Session",72,0,0,7,79
1881886,1460096,2024-06-25,Assembly,"Be adopted as amended, and re-refer to the Committee on [Appropriations]",10,1,0,4,15
1881886,1464548,2024-08-15,Assembly,"Be adopted. To third reading",11,3,0,1,15
1881886,1465462,2024-08-22,Assembly,"ACR 210 Bennett Assembly Third Reading",45,12,0,22,79
1881886,1466059,2024-08-28,Senate,"Be adopted, but first be re-referred to the Committee on [Appropriations]",6,4,0,1,11
1881886,1466418,2024-08-30,Senate,"Be adopted. Ordered to third reading",5,2,0,0,7
1881886,1467161,2024-08-31,Senate,"Assembly 3rd Reading ACR210 Bennett By Lim√≥n",31,8,0,1,40
1881887,1462359,2024-07-02,Assembly,"Be adopted. To third reading",7,0,0,0,7
1881887,1463960,2024-08-14,Senate,"Be adopted. Ordered to third reading",4,0,0,3,7
1881887,1464083,2024-08-15,Senate,"Assembly 3rd Reading ACR211 Kalra By Cortese",37,0,0,3,40
1881887,1465256,2024-08-19,Assembly,"ACR 211 Kalra Concurrence in Senate Amendments",77,0,0,2,79
1881888,1455805,2024-06-10,Assembly,"Be adopted. To third reading",9,0,0,2,11
1882081,1457981,2024-06-17,Assembly,"Be adopted. To Consent Calendar",10,0,0,1,11
1882081,1458786,2024-06-20,Assembly,"ACR 212 Wilson Consent Calendar Second Day Regular Session",67,0,0,12,79
1882081,1463820,2024-08-08,Senate,"Special Consent ACR212 Wilson et al",37,0,0,3,40
1882082,1458017,2024-06-17,Assembly,"Be adopted. To third reading",10,0,0,1,11
1882082,1465519,2024-08-22,Senate,"Special Consent ACR213 Waldron",33,0,0,7,40
1882083,1457938,2024-06-17,Assembly,"Be adopted. To Consent Calendar",10,0,0,1,11
1882083,1458821,2024-06-20,Assembly,"ACR 214 Kalra Consent Calendar Second Day Regular Session",67,0,0,12,79
1882083,1463791,2024-08-08,Senate,"Special Consent ACR214 Kalra et al",37,0,0,3,40
1882084,1459973,2024-06-25,Assembly,"Be adopted. To Consent Calendar",16,0,0,0,16
1882084,1462060,2024-07-01,Assembly,"HR 105 Dixon Consent Calendar Second Day Regular Session",72,0,0,7,79
1882085,1460460,2024-06-25,Senate,"Be adopted as amended, but first amend, and re-refer to the Committee on [Appropriations] with the recommendation: To Consent Calendar",15,0,0,0,15
1882085,1463833,2024-08-12,Senate,"Consent Calendar 2nd SCR159 Hurtado",38,0,0,2,40
1882085,1466295,2024-08-29,Assembly,"Be adopted. To Consent Calendar",15,0,0,0,15
1882085,1467241,2024-08-31,Assembly,"SCR 159 Hurtado Consent Calendar Second Day Regular Session",75,0,0,4,79
1882151,1458760,2024-06-20,Assembly,"Be adopted. To Consent Calendar",9,0,0,2,11
1882151,1460495,2024-06-26,Assembly,"HR 106 Calderon Consent Calendar Second Day Regular Session",75,0,0,4,79
1882342,1458274,2024-06-17,Assembly,"Be adopted. To third reading",15,0,0,0,15
1882342,1461244,2024-06-27,Assembly,"ACR 215 Waldron Assembly Third Reading",73,0,0,6,79
1882342,1463943,2024-08-13,Senate,"Be adopted, but first be re-referred to the Committee on [Appropriations] with recommendation: To Consent Calendar",13,0,0,2,15
1882342,1465457,2024-08-22,Senate,"Consent Calendar 2nd ACR215 Waldron",33,0,0,7,40
1882343,1460077,2024-06-25,Assembly,"Be adopted. To Consent Calendar",16,0,0,0,16
1882343,1462679,2024-07-03,Assembly,"HR 107 Waldron Assembly Third Reading",72,0,0,7,79
1882344,1459348,2024-06-24,Senate,"Senate 3rd Reading SCR160 Dodd et al",38,0,0,2,40
1882344,1462085,2024-07-01,Assembly,"Be adopted. To Consent Calendar",11,0,0,0,11
1882344,1463690,2024-08-05,Assembly,"SCR 160 Dodd Consent Calendar Second Day Regular Session",71,0,0,8,79
1882345,1464366,2024-08-15,Senate,"Senate 3rd Reading SCR161 Allen",38,0,0,2,40
1882345,1465588,2024-08-26,Assembly,"Be adopted. To Consent Calendar",9,0,0,2,11
1882345,1467168,2024-08-28,Assembly,"SCR 161 Allen Consent Calendar Second Day Regular Session",75,0,0,4,79
1882346,1459362,2024-06-24,Senate,"Senate 3rd Reading SCR162 Allen By Lim√≥n",38,0,0,2,40
1882346,1462112,2024-07-01,Assembly,"Be adopted. To Consent Calendar",11,0,0,0,11
1882346,1463694,2024-08-05,Assembly,"SCR 162 Allen Consent Calendar Second Day Regular Session",71,0,0,8,79
1882494,1458832,2024-06-20,Assembly,"Be adopted. To Consent Calendar",9,0,0,2,11
1882494,1460635,2024-06-26,Assembly,"ACR 216 Kalra Consent Calendar Second Day",75,0,0,4,79
1882494,1464507,2024-08-15,Senate,"Special Consent ACR216 Kalra et al",37,0,0,3,40
1882494,1465289,2024-08-19,Assembly,"ACR 216 Kalra Concurrence in Senate Amendments",77,0,0,2,79
1882495,1463582,2024-08-05,Senate,"Senate 3rd Reading SR102 Min",40,0,0,0,40
1882661,1458759,2024-06-20,Assembly,"Be adopted. To third reading",9,0,0,2,11
1882661,1464611,2024-08-15,Senate,"Special Consent ACR217 Bryan et al",37,0,0,3,40
1882662,1458825,2024-06-20,Assembly,"Be adopted. To third reading",9,0,0,2,11
1882723,1459371,2024-06-24,Assembly,"Be adopted. To third reading",7,0,0,4,11
1882724,1458809,2024-06-20,Assembly,"Be adopted. To third reading",9,0,0,2,11
1882792,1462587,2024-07-03,Senate,"Be adopted. Ordered to third reading",2,0,0,5,7
1882792,1462588,2024-07-03,Senate,"[07-03-2024] hearing: Motion to Reconsider. [Reconsideration Granted.]",7,0,0,0,7
1883009,1462204,2024-07-01,Assembly,"Be adopted. To third reading",12,2,0,1,15
1883356,1463662,2024-08-05,Senate,"Senate 3rd Reading SCR164 Durazo",40,0,0,0,40
1883356,1463804,2024-08-08,Assembly,"Be adopted. To Consent Calendar",8,0,0,3,11
1883356,1464473,2024-08-15,Assembly,"SCR 164 Durazo Consent Calendar Second Day Regular Session",75,0,0,4,79
1883539,1462005,2024-07-01,Assembly,"Be adopted. To Consent Calendar",11,0,0,0,11
1883539,1463535,2024-08-05,Assembly,"ACR 220 Kalra Consent Calendar Second Day",71,0,0,8,79
1883539,1465513,2024-08-22,Senate,"Special Consent ACR220 Kalra et al",33,0,0,7,40
1883540,1462074,2024-07-01,Assembly,"Be adopted. To third reading",11,0,0,0,11
1883540,1465437,2024-08-22,Senate,"Special Consent ACR221 Papan et al",33,0,0,7,40
1883541,1461959,2024-07-01,Assembly,"Be adopted. To Consent Calendar",11,0,0,0,11
1883541,1463372,2024-08-05,Assembly,"HR 111 Kalra Consent Calendar Second Day Regular Session",71,0,0,8,79
1883924,1463390,2024-08-05,Assembly,"Be adopted. To third reading",10,0,0,1,11
1883943,1463428,2024-08-05,Assembly,"Be adopted. To third reading",10,0,0,1,11
1883943,1463910,2024-08-12,Assembly,"ACR 222 Weber Assembly Third Reading",76,0,0,3,79
1883943,1465430,2024-08-22,Senate,"Special Consent ACR222 Weber",33,0,0,7,40
1883944,1463961,2024-08-14,Senate,"Be adopted. Ordered to third reading",4,0,0,3,7
1883944,1464582,2024-08-15,Senate,"Senate 3rd Reading SR103 Portantino et al",38,0,0,2,40
1883991,1463460,2024-08-05,Assembly,"Be adopted. To third reading",10,0,0,1,11
1883991,1465452,2024-08-22,Senate,"Special Consent ACR223 Rodriguez et al",33,0,0,7,40
1883993,1463540,2024-08-05,Assembly,"Be adopted. To third reading",10,0,0,1,11
1883993,1465454,2024-08-22,Senate,"Special Consent ACR225 Addis et al",33,0,0,7,40
1883994,1463457,2024-08-05,Assembly,"Be adopted. To third reading",8,2,0,1,11
1883995,1463371,2024-08-05,Assembly,"Be adopted. To Consent Calendar",10,0,0,1,11
1883995,1463815,2024-08-08,Assembly,"HR 114 Mike Fong Consent Calendar Second Day",72,0,0,7,79
1883997,1463780,2024-08-08,Senate,"Senate 3rd Reading SCR167 Alvarado-Gil",37,0,0,3,40
1883997,1464519,2024-08-15,Assembly,"Be adopted. To Consent Calendar",7,0,0,4,11
1883997,1465484,2024-08-22,Assembly,"SCR 167 Alvarado-Gil Consent Calendar Second Day Regular Session",57,0,0,22,79
1883998,1463915,2024-08-12,Senate,"Senate 3rd Reading SCR168 Wahab et al",38,0,0,2,40
1883998,1464431,2024-08-15,Assembly,"Be adopted. To Consent Calendar",7,0,0,4,11
1883998,1465460,2024-08-22,Assembly,"SCR 168 Wahab Consent Calendar Second Day Regular Session",57,0,0,22,79
1883999,1464587,2024-08-15,Senate,"Senate 3rd Reading SR104 Padilla et al",38,0,0,2,40
1885653,1463809,2024-08-08,Assembly,"Be adopted. To third reading",8,0,0,3,11
1885653,1463837,2024-08-12,Assembly,"ACR 226 Wilson Assembly Third Reading",75,0,0,4,79
1885654,1463793,2024-08-08,Assembly,"Be adopted. To third reading",8,0,0,3,11
1885654,1463906,2024-08-12,Assembly,"ACR 227 Wallis Assembly Third Reading",75,0,0,4,79
1885654,1464340,2024-08-15,Senate,"Assembly 3rd Reading ACR227 Wallis et al. By Durazo",37,0,0,3,40
1885655,1463819,2024-08-08,Assembly,"Be adopted. To third reading",8,0,0,3,11
1885655,1463870,2024-08-12,Assembly,"ACR 228 Pellerin Assembly Third Reading",76,0,0,3,79
1885655,1465461,2024-08-22,Senate,"Special Consent ACR228 Pellerin",33,0,0,7,40
1885656,1463805,2024-08-08,Assembly,"Be adopted. To third reading",8,0,0,3,11
1885656,1463898,2024-08-12,Assembly,"ACR 229 Pellerin Assembly Third Reading",76,0,0,3,79
1885656,1465467,2024-08-22,Senate,"Special Consent ACR229 Pellerin et al",33,0,0,7,40
1885657,1463942,2024-08-13,Senate,"Be adopted, but first be re-referred to the Committee on [Appropriations] with recommendation: To Consent Calendar",13,0,0,2,15
1885657,1465444,2024-08-22,Senate,"Consent Calendar 2nd SCR169 Dodd et al",33,0,0,7,40
1885657,1466368,2024-08-29,Assembly,"Be adopted. To Consent Calendar",15,0,0,0,15
1885657,1467225,2024-08-31,Assembly,"SCR 169 Dodd Consent Calendar Second Day Regular Session",75,0,0,4,79
1885658,1463795,2024-08-08,Senate,"Senate 3rd Reading SR105 Newman",37,0,0,3,40
1885659,1464049,2024-08-15,Senate,"Senate 3rd Reading SR106 Newman et al",37,0,0,3,40
1885660,1464532,2024-08-15,Senate,"Senate 3rd Reading SR107 Min",40,0,0,0,40
1885661,1464479,2024-08-15,Senate,"Senate 3rd Reading SR108 Nguyen et al",38,0,0,2,40
1885662,1464357,2024-08-15,Senate,"Senate 3rd Reading SR109 Grove",38,0,0,2,40
1885663,1463885,2024-08-12,Senate,"Senate 3rd Reading SR110 Bradford",38,0,0,2,40
1885666,1464161,2024-08-15,Assembly,"Be adopted. To Consent Calendar",7,0,0,4,11
1885666,1465473,2024-08-22,Assembly,"HR 115 Reyes Consent Calendar Second Day Regular Session",57,0,0,22,79
1885668,1464575,2024-08-15,Senate,"Senate 3rd Reading SR111 Blakespear",38,0,0,2,40
1885670,1464321,2024-08-15,Senate,"Senate 3rd Reading SR113 Rubio et al",38,0,0,2,40
1885707,1464330,2024-08-15,Senate,"Senate 3rd Reading SR114 McGuire et al",29,1,0,10,40
1885708,1464342,2024-08-15,Senate,"Senate 3rd Reading SR115 Grove",38,0,0,2,40
1885717,1464185,2024-08-15,Senate,"Senate 3rd Reading SR116 Cortese",37,0,0,3,40
1885718,1464317,2024-08-15,Senate,"Senate 3rd Reading SR117 Skinner et al",37,0,0,3,40
1885788,1465275,2024-08-19,Assembly,"Be adopted. To third reading",7,0,0,5,12
1885789,1464610,2024-08-15,Assembly,"Be adopted. To Consent Calendar",7,0,0,4,11
1885789,1465512,2024-08-22,Assembly,"HR 118 Gabriel Consent Calendar Second Day Regular Session",57,0,0,22,79
1885790,1465450,2024-08-22,Senate,"Special Consent SR118 Min",33,0,0,7,40
1885791,1465470,2024-08-22,Senate,"Special Consent SR119 Min",33,0,0,7,40
1885792,1465492,2024-08-22,Senate,"Special Consent SR120 Rubio et al",33,0,0,7,40
1885793,1464262,2024-08-15,Senate,"Senate 3rd Reading SR121 Rubio et al",37,0,0,3,40
1885794,1464231,2024-08-15,Senate,"Senate 3rd Reading SR122 Roth et al",37,0,0,3,40
1885795,1464555,2024-08-15,Senate,"Senate 3rd Reading SR123 Menjivar et al",37,0,0,3,40
1885819,1464042,2024-08-15,Assembly,"Be adopted. To Consent Calendar",7,0,0,4,11
1885819,1465446,2024-08-22,Assembly,"HR 119 Aguiar-Curry Consent Calendar Second Day Regular Session",57,0,0,22,79
1885820,1464292,2024-08-15,Assembly,"Be adopted. To Consent Calendar",7,0,0,4,11
1885820,1465479,2024-08-22,Assembly,"HR 120 Calderon Consent Calendar Second Day Regular Session",57,0,0,22,79
1885821,1464566,2024-08-15,Assembly,"Be adopted. To third reading",7,0,0,4,11
1885822,1464367,2024-08-15,Assembly,"Be adopted. To Consent Calendar",7,0,0,4,11
1885822,1465510,2024-08-22,Assembly,"HR 122 Soria Consent Calendar Second Day Regular Session",57,0,0,22,79
1885823,1464005,2024-08-15,Senate,"Senate 3rd Reading SR124 Caballero et al",36,0,0,4,40
1885824,1465478,2024-08-22,Senate,"Special Consent SR125 Durazo",33,0,0,7,40
1885877,1465343,2024-08-20,Assembly,"Be adopted. To Consent Calendar",8,0,0,3,11
1885877,1465499,2024-08-22,Assembly,"HR 123 Papan Consent Calendar Second Day Regular Session",57,0,0,22,79
1885878,1465323,2024-08-20,Assembly,"Be adopted. To third reading",8,0,0,3,11
1885879,1465345,2024-08-20,Assembly,"Be adopted. To Consent Calendar",8,0,0,3,11
1885879,1465471,2024-08-22,Assembly,"HR 125 Blanca Rubio Consent Calendar Second Day Regular Session",57,0,0,22,79
1886416,1465691,2024-08-26,Assembly,"Be adopted. To Consent Calendar",9,0,0,2,11
1886416,1466616,2024-08-28,Assembly,"HR 128 Petrie-Norris Consent Calendar Second Day",75,0,0,4,79
1886481,1465841,2024-08-27,Assembly,"Be adopted. To Consent Calendar",11,0,0,0,11
1886481,1466351,2024-08-29,Assembly,"HR 129 Bauer-Kahan Consent Calendar Second Day",75,0,0,4,79
1886624,1467650,2024-09-26,Assembly,"Do pass as amended",13,2,0,4,19
1886624,1468021,2024-10-01,Assembly,"AB 1 HART Assembly Third Reading Amend By GALLAGHER Set #1 Motion to Lay on the Table By AGUIAR-CURRY Second Extraordinary Session",55,18,0,6,79
1886624,1468022,2024-10-01,Assembly,"AB 1 HART Assembly Third Reading Second Extraordinary Session",44,18,0,17,79
1886624,1468288,2024-10-07,Senate,"Do pass as amended, but first amend, and re-refer to the Committee on [Appropriations]",9,2,0,0,11
1886624,1468449,2024-10-08,Senate,"Do pass",4,2,0,1,7
1886624,1468646,2024-10-11,Senate,"Assembly 3rd Reading AB1 Hart et al. By Skinner",23,9,0,8,40
1886624,1468649,2024-10-14,Assembly,"AB 1 HART Concurrence in Senate Amendments Motion to Adjourn By GALLAGHER Second Extraordinary Session",12,50,0,17,79
1886624,1468650,2024-10-14,Assembly,"AB 1 HART Concurrence in Senate Amendments Second Extraordinary Session",42,16,0,21,79
