bill_id,roll_call_id,date,chamber,description,yea,nay,nv,absent,total
437674,232344,2013-02-12,Assembly,"Do pass and be re-referred to the Committee on Appropriations",6,0,0,1,7
437675,247881,2013-03-12,Assembly,"Do pass and be re-referred to the Committee on Appropriations",2,4,0,1,7
437675,257390,2013-04-02,Assembly,"Reconsideration granted",6,0,0,1,7
437675,303931,2013-04-02,Assembly,"Reconsideration granted",6,0,0,1,7
437677,261702,2013-04-09,Assembly,"Do pass",5,2,0,0,7
437677,280264,2013-05-16,Assembly,"AB4 AMMIANO  Assembly Third Reading",44,22,0,13,79
437677,295825,2013-07-02,Senate,"Do pass",5,2,0,0,7
437677,298922,2013-09-09,Senate,"Assembly 3rd Reading AB4 Ammiano By De Le",25,11,3,0,39
437677,299126,2013-09-10,Assembly,"AB4 AMMIANO  Concurrence in Senate Amendments",48,25,0,5,78
437678,270715,2013-04-23,Assembly,"Do pass as amended and be re-referred to the Committee on 	Appropriations",7,3,0,0,10
437680,266380,2013-04-15,Assembly,"Do pass as amended and be re-referred to the Committee on 	Appropriations",7,0,0,2,9
437680,283795,2013-05-24,Assembly,"Do pass as amended",16,0,0,1,17
437680,288724,2013-06-12,Assembly,"Do pass",3,0,0,6,9
437680,288725,2013-06-12,Assembly,"Set first hearing.  Failed passage.  Reconsideration granted",8,0,0,1,9
437680,291523,2013-06-24,Assembly,"Do pass",5,2,0,2,9
437680,292153,2013-06-27,Assembly,"AB7 WIECKOWSKI  Assembly Third Reading",24,17,0,38,79
437681,261679,2013-04-08,Assembly,"Do pass and be re-referred to the Committee on Natural Resources",10,3,0,3,16
437681,276255,2013-05-06,Assembly,"Do pass as amended and be re-referred to the Committee on 	Appropriations",6,2,0,1,9
437681,283828,2013-05-24,Assembly,"Do pass",11,3,0,3,17
437681,292145,2013-06-27,Assembly,"AB8 PEREA  Third Reading Urgency",54,20,0,5,79
437681,297811,2013-08-20,Senate,"Do pass, but re-refer to the Committee on Environmental Quality",9,2,0,0,11
437681,297850,2013-08-21,Senate,"Do pass, but re-refer to the Committee on Appropriations",8,1,0,0,9
437681,297991,2013-08-26,Senate,"Placed on Appropriations Suspense file",7,0,0,0,7
437681,298270,2013-08-30,Senate,"Do pass as amended",5,2,0,0,7
437681,299445,2013-09-11,Assembly,"AB8 PEREA  Concurrence in Senate Amendments",54,19,0,5,78
437681,299446,2013-09-11,Senate,"Assembly 3rd Reading AB8 Perea Urgency Clause",29,6,4,0,39
437683,272311,2013-04-24,Assembly,"Do pass and be re-referred to the Committee on Appropriations",5,2,0,0,7
437683,283771,2013-05-24,Assembly,"Do pass",12,5,0,0,17
437683,285527,2013-05-30,Assembly,"AB 10 ALEJO  Assembly Third Reading",45,27,0,7,79
437683,291882,2013-06-26,Senate,"Do pass, but re-refer to the Committee on Appropriations",3,1,1,0,5
437683,297271,2013-08-12,Senate,"Placed on Appropriations Suspense file",6,0,1,0,7
437683,298246,2013-08-30,Senate,"Do pass, but re-refer to the Committee on Rules",5,2,0,0,7
437683,299624,2013-09-12,Senate,"Assembly 3rd Supp 2 AB10 Alejo By Monning",26,11,2,0,39
437683,299625,2013-09-12,Assembly,"AB 10 ALEJO  Concurrence in Senate Amendments",52,25,0,1,78
437684,251821,2013-03-20,Assembly,"Do pass and re-refer to Committee on Appropriations with 	recommendation:  To Consent Calendar",7,0,0,0,7
437684,262718,2013-04-10,Assembly,"Do pass, to Consent Calendar",17,0,0,0,17
437684,268737,2013-04-18,Assembly,"AB 11 LOGUE  Consent Calendar Second Day  Regular Session",76,0,0,3,79
437684,288636,2013-06-12,Senate,"Do pass, but re-refer to the Committee on Appropriations",4,0,1,0,5
437684,296239,2013-07-08,Senate,"Assembly 3rd Reading AB11 Logue By Gaines",31,1,6,0,38
437685,259010,2013-04-03,Assembly,"Do pass as amended and be re-referred to the Committee on 	Appropriations",13,0,0,0,13
437685,284062,2013-05-24,Assembly,"Do pass as amended",17,0,0,0,17
437685,285112,2013-05-29,Assembly,"AB 12 COOLEY  Assembly Third Reading",77,0,0,2,79
437685,291715,2013-06-25,Senate,"Do pass, but re-refer to the Committee on Environmental Quality 	Recommend Consent",11,0,0,0,11
437685,296128,2013-07-03,Senate,"Do pass, but re-refer to the Committee on Appropriations Recommend 	Consent",7,0,2,0,9
437685,296129,2013-07-03,Senate,"Set, first hearing.  Held in Committee.  Reconsideration of 	favorable vote granted",8,0,1,0,9
437685,296130,2013-07-03,Senate,"Do pass, but re-refer to the Committee on Appropriations",9,0,0,0,9
437685,297417,2013-08-12,Senate,"Placed on Appropriations Suspense file",6,0,1,0,7
437685,298359,2013-08-30,Senate,"Do pass",7,0,0,0,7
437685,299042,2013-09-09,Senate,"Assembly 3rd Reading AB12 Cooley By Calderon",39,0,0,0,39
437686,250857,2013-03-19,Assembly,"Do pass and be re-referred to the Committee on Veterans Affairs",13,0,0,0,13
437686,267344,2013-04-16,Assembly,"Do pass and be re-referred to the Committee on Appropriations",10,0,0,0,10
437686,283789,2013-05-24,Assembly,"Do pass",17,0,0,0,17
437686,284668,2013-05-28,Assembly,"AB 13 CHAVEZ  Assembly Third Reading",77,0,0,2,79
437686,296001,2013-07-03,Senate,"Do pass, but re-refer to the Committee on Appropriations",5,2,2,0,9
437686,297221,2013-08-12,Senate,"Placed on Appropriations Suspense file",6,0,1,0,7
437686,298293,2013-08-30,Senate,"Do pass as amended",7,0,0,0,7
437686,379075,2014-08-29,Senate,"Assembly 3rd Supp 1 AB13 Conway By Knight",36,0,4,0,40
437686,379076,2014-08-29,Assembly,"AB 13 CONWAY  Concurrence- Urgency Added",78,0,0,1,79
437687,274263,2013-04-29,Assembly,"Do pass as amended and be re-referred to the Committee on 	Appropriations",13,2,0,1,16
437687,283968,2013-05-24,Assembly,"Do pass",13,4,0,0,17
437687,284831,2013-05-28,Assembly,"AB 14 LOWENTHAL  Assembly Third Reading",59,18,0,2,79
437687,289668,2013-06-18,Senate,"Do pass, but re-refer to the Committee on Appropriations",10,0,1,0,11
437687,297810,2013-08-19,Senate,"Assembly 3rd Reading AB14 Lowenthal By DeSaulnier",31,5,3,0,39
437689,249550,2013-03-12,Assembly,"Do pass and be re-referred to the Committee on Appropriations",7,0,0,0,7
437689,283822,2013-05-24,Assembly,"Do pass",17,0,0,0,17
437689,285560,2013-05-30,Assembly,"AB 16 PEREZ, J.  Assembly Third Reading",78,0,0,1,79
437689,291564,2013-06-25,Senate,"Do pass, but re-refer to the Committee on Appropriations",7,0,0,0,7
437689,297316,2013-08-12,Senate,"Placed on Appropriations Suspense file",6,0,1,0,7
437689,298218,2013-08-30,Senate,"Do pass",7,0,0,0,7
437689,298957,2013-09-09,Senate,"Assembly 3rd Reading AB16 John A. P",39,0,0,0,39
437689,299179,2013-09-10,Assembly,"AB 16 PEREZ, J.  Concurrence in Senate Amendments",78,0,0,0,78
437691,286849,2013-06-04,Assembly,"Do pass and be re-referred to the Committee on Appropriations",12,4,0,3,19
437692,270780,2013-04-23,Assembly,"Do pass as amended and be re-referred to the Committee on 	Appropriations",4,3,0,0,7
437693,247968,2013-03-12,Assembly,"Do pass, to Consent Calendar",7,0,0,0,7
437693,256881,2013-04-01,Assembly,"AB 20 WALDRON  Consent Calendar Second Day",74,0,0,5,79
437693,286830,2013-06-04,Senate,"Do pass as amended",7,0,0,0,7
437693,296280,2013-07-08,Senate,"Assembly 3rd Reading AB20 Waldron By Block",33,0,5,0,38
437693,297151,2013-08-08,Assembly,"AB 20 WALDRON  Concurrence in Senate Amendments",77,0,0,1,78
437694,230679,2013-02-12,Assembly,"Do pass as amended and be re-referred to the Committee on 	Appropriations",6,0,0,1,7
437694,283987,2013-05-24,Assembly,"Do pass",17,0,0,0,17
437694,284704,2013-05-28,Assembly,"AB 21 ALEJO  Assembly Third Reading",77,0,0,2,79
437694,288400,2013-06-12,Senate,"Do pass, but re-refer to the Committee on Health",9,0,0,0,9
437694,291896,2013-06-26,Senate,"Do pass, but re-refer to the Committee on Appropriations",9,0,0,0,9
437694,297322,2013-08-12,Senate,"Placed on Appropriations Suspense file",6,0,1,0,7
437694,298334,2013-08-30,Senate,"Do pass as amended",7,0,0,0,7
437694,298928,2013-09-09,Senate,"Assembly 3rd Reading AB21 Alejo By Hill",38,0,1,0,39
437694,299135,2013-09-10,Assembly,"AB 21 ALEJO  Concurrence in Senate Amendments",77,0,0,1,78
437696,266566,2013-04-15,Assembly,"Do pass and be re-referred to the Committee on Appropriations",5,2,0,2,9
437698,266402,2013-04-16,Assembly,"Do pass and be re-referred to the Committee on Public Employees, 	Retirement and Social Security",8,2,0,0,10
437698,271510,2013-04-24,Assembly,"Do pass and be re-referred to the Committee on Appropriations",7,0,0,0,7
437698,277346,2013-05-08,Assembly,"Do pass",16,1,0,0,17
437698,280297,2013-05-16,Assembly,"AB 25 CAMPOS  Assembly Third Reading",63,8,0,8,79
437698,288396,2013-06-12,Senate,"Do pass, but re-refer to the Committee on Appropriations",5,0,0,0,5
437698,299405,2013-09-11,Senate,"Assembly 3rd Reading AB25 Campos By Lieu",32,1,6,0,39
437699,272313,2013-04-25,Assembly,"Be referred to Committee on Natural Resources",8,0,0,3,11
437699,274276,2013-04-29,Assembly,"Do pass and be re-referred to the Committee on Labor and Employment",6,3,0,0,9
437699,275739,2013-05-01,Assembly,"Do pass and be re-referred to the Committee on Appropriations",5,2,0,0,7
437699,284047,2013-05-24,Assembly,"Do pass as amended",12,5,0,0,17
437699,285646,2013-05-30,Assembly,"AB 26 BONILLA  Assembly Third Reading",51,25,0,3,79
437699,289868,2013-06-19,Senate,"Do pass as amended, and re-refer to the Committee on Labor and 	Industrial Relations",7,2,0,0,9
437699,370840,2014-06-11,Senate,"Do pass as amended, but re-refer to the Committee on Appropriations 	Recommend Consent",4,1,0,0,5
437699,376775,2014-08-07,Senate,"Assembly 3rd Reading AB26 Bonilla By Hueso",26,8,6,0,40
437699,377093,2014-08-13,Assembly,"Senate amendments be concurred in",5,1,0,1,7
437699,377716,2014-08-18,Assembly,"AB 26 BONILLA  Concurrence in Senate Amendments",53,22,0,4,79
437699,378668,2014-08-27,Senate,"Assembly 3rd Reading AB26 Bonilla By Hueso",25,10,5,0,40
437699,378910,2014-08-28,Assembly,"AB 26 BONILLA  Concurrence in Senate Amendments",55,22,0,2,79
437700,250803,2013-03-19,Assembly,"Do pass as amended and be re-referred to the Committee on 	Appropriations",12,0,0,1,13
437700,283783,2013-05-24,Assembly,"Do pass as amended",16,1,0,0,17
437700,285070,2013-05-29,Assembly,"AB 27 MEDINA  Third Reading Urgency",78,0,0,1,79
437700,291862,2013-06-26,Senate,"Do pass as amended, but re-refer to the Committee on Appropriations 	Recommend Consent",9,0,0,0,9
437700,374033,2014-06-24,Senate,"Do pass, but re-refer to the Committee on Appropriations",11,0,0,0,11
437700,376789,2014-08-07,Senate,"Assembly 3rd Reading AB27 Medina By Roth",34,0,6,0,40
437700,377777,2014-08-18,Assembly,"Senate amendments be concurred in",16,0,0,0,16
437700,377778,2014-08-19,Assembly,"AB 27 MEDINA  Concurrence in Senate Amendments",77,0,0,2,79
437701,271849,2013-04-23,Assembly,"Amend, and re-refer to the Committee on Jobs, Economic Development 	and The Economy",8,0,0,1,9
437702,266332,2013-04-15,Assembly,"Do pass as amended and be re-referred to the Committee on Utilities 	and Commerce",7,0,0,2,9
437703,230813,2013-02-12,Assembly,"Do pass and be re-referred to the Committee on Appropriations",5,0,0,2,7
437703,283750,2013-05-24,Assembly,"Do pass as amended",17,0,0,0,17
437703,285048,2013-05-29,Assembly,"AB 30 PEREA  Assembly Third Reading",77,0,0,2,79
437703,288411,2013-06-12,Senate,"Do pass, but re-refer to the Committee on Health",9,0,0,0,9
437703,291181,2013-06-24,Senate,"Placed on Appropriations Suspense file",7,0,0,0,7
437703,298319,2013-08-30,Senate,"Do pass",7,0,0,0,7
437703,298931,2013-09-09,Senate,"Assembly 3rd Reading AB30 Perea By Cannella",39,0,0,0,39
437704,275633,2013-05-01,Assembly,"Do pass as amended and be re-referred to the Committee on 	Appropriations",6,0,0,1,7
437705,278810,2013-05-13,Assembly,"Do pass and be re-referred to the Committee on Appropriations",9,0,0,0,9
437705,283895,2013-05-24,Assembly,"Do pass",16,0,0,1,17
437705,284860,2013-05-28,Assembly,"AB 32 PEREZ, J.  Assembly Third Reading",77,1,0,1,79
437705,297504,2013-08-14,Senate,"Do pass as amended, and re-refer to the Committee on Appropriations",7,0,0,0,7
437705,297989,2013-08-26,Senate,"Placed on Appropriations Suspense file",7,0,0,0,7
437705,298189,2013-08-30,Senate,"Do pass as amended",7,0,0,0,7
437705,298994,2013-09-09,Senate,"Assembly 3rd Reading AB32 John A. P",39,0,0,0,39
437705,299225,2013-09-10,Assembly,"AB 32 PEREZ, J.  Concurrence in Senate Amendments",77,1,0,0,78
437706,278580,2013-05-13,Assembly,"Do pass and be re-referred to the Committee on Appropriations",9,0,0,0,9
437707,258257,2013-04-02,Assembly,"Do pass as amended and be re-referred to the Committee on 	Appropriations",10,5,0,0,15
437707,267751,2013-04-17,Assembly,"Do pass",12,5,0,0,17
437707,273665,2013-04-29,Assembly,"AB 34 HERNANDEZ  Assembly Third Reading",57,19,0,3,79
437707,288092,2013-06-11,Senate,"Do pass as amended, and re-refer to the Committee on Appropriations",8,0,1,0,9
437707,298691,2013-09-03,Senate,"Assembly 3rd Reading AB34 Roger Hern",32,2,5,0,39
437707,298808,2013-09-06,Assembly,"AB 34 HERNANDEZ  Concurrence in Senate Amendments",58,19,0,1,78
437708,261671,2013-04-09,Assembly,"Do pass as amended and be re-referred to the Committee on 	Transportation",9,0,0,1,10
437708,274588,2013-04-29,Assembly,"Do pass and be re-referred to the Committee on Appropriations",13,2,0,1,16
437708,279835,2013-05-15,Assembly,"Do pass",14,3,0,0,17
437708,283071,2013-05-23,Assembly,"AB 35 HERNANDEZ  Assembly Third Reading",58,16,0,4,78
437708,288419,2013-06-12,Senate,"Do pass, but re-refer to the Committee on Judiciary",4,0,1,0,5
437708,296096,2013-07-02,Senate,"Do pass, but re-refer to the Committee on Appropriations",4,2,1,0,7
437708,298817,2013-09-06,Senate,"Assembly 3rd Reading AB35 Roger Hern",25,10,4,0,39
437708,299046,2013-09-09,Assembly,"AB 35 HERNANDEZ  Concurrence in Senate Amendments",55,18,0,5,78
437710,266705,2013-04-15,Assembly,"Do pass and be re-referred to the Committee on Appropriations",9,0,0,0,9
437710,283941,2013-05-24,Assembly,"Do pass",17,0,0,0,17
437710,284636,2013-05-28,Assembly,"AB 37 PEREA  Assembly Third Reading",78,0,0,1,79
437710,374396,2014-06-25,Senate,"Do pass, but re-refer to the Committee on Appropriations",5,0,0,0,5
437711,275539,2013-05-01,Assembly,"Do pass and re-refer to Committee on Appropriations with 	recommendation:  To Consent Calendar",7,0,0,0,7
437712,266377,2013-04-15,Assembly,"Do pass and be re-referred to the Committee on Utilities and 	Commerce",9,0,0,0,9
437712,274169,2013-04-29,Assembly,"Do pass as amended and be re-referred to the Committee on 	Appropriations",15,0,0,0,15
437712,283785,2013-05-24,Assembly,"Do pass as amended",12,0,0,5,17
437712,285029,2013-05-29,Assembly,"AB 39 SKINNER  Assembly Third Reading",76,2,0,1,79
437712,295827,2013-07-02,Senate,"Do pass, but re-refer to the Committee on Appropriations",9,2,0,0,11
437712,297286,2013-08-12,Senate,"Placed on Appropriations Suspense file",6,0,1,0,7
437712,298271,2013-08-30,Senate,"Do pass",5,2,0,0,7
437713,274148,2013-04-30,Assembly,"Do pass as amended and be re-referred to the Committee on 	Appropriations",19,0,0,0,19
437715,274114,2013-04-29,Assembly,"Do pass and be re-referred to the Committee on Appropriations",8,0,0,1,9
437716,269896,2013-04-22,Assembly,"Do pass and be re-referred to the Committee on Judiciary",9,0,0,0,9
437716,276299,2013-05-06,Assembly,"Be referred to Committee on Revenue and Taxation",10,0,0,1,11
437716,308295,2014-01-13,Assembly,"Do pass and be re-referred to the Committee on Appropriations",9,0,0,0,9
437716,311241,2014-01-23,Assembly,"Do pass, to Consent Calendar",16,0,0,1,17
437716,313237,2014-01-29,Assembly,"AB 43 BOCANEGRA  Consent Calendar Second Day",78,0,0,2,80
437716,374498,2014-06-25,Senate,"Do pass, but re-refer to the Committee on Appropriations",7,0,0,0,7
437716,376922,2014-08-11,Senate,"Placed on Appropriations Suspense file",7,0,0,0,7
437717,275600,2013-05-01,Assembly,"Be adopted and be re-referred to the Committee on Appropriations",4,8,0,1,13
437718,251369,2013-03-19,Assembly,"Be adopted, to Consent Calendar",19,0,0,0,19
437718,252375,2013-03-21,Assembly,"ACR1 MEDINA  Consent Calendar Second Day",71,0,0,8,79
437718,287194,2013-06-05,Senate,"Be adopted and be placed on the Consent Calendar",9,0,0,0,9
437718,288729,2013-06-13,Senate,"Consent Calendar 2nd ACR1 Medina",37,0,2,0,39
437719,257567,2013-04-02,Assembly,"From committee:  Be adopted.  To third reading",7,2,0,1,10
437719,298026,2013-08-26,Assembly,"AJR1 GATTO  Assembly Third Reading  Amend By GATTO  Set #1",52,26,0,0,78
437719,313879,2014-01-30,Assembly,"AJR1 GATTO  Assembly Third Reading",51,20,0,9,80
437719,370828,2014-06-10,Senate,"Be adopted",5,2,0,0,7
437719,373722,2014-06-23,Senate,"Assembly 3rd Reading AJR1 Gatto By DeSaulnier",23,11,6,0,40
437720,259589,2013-04-04,Assembly,"From committee:  Be adopted.  To third reading",11,0,0,0,11
437720,265385,2013-04-15,Assembly,"AJR2 GATTO  Assembly Third Reading",77,0,0,2,79
437720,265386,2013-04-15,Senate,"W/O REF. TO FILE AJR2 Gatto By De Le",36,0,2,0,38
437721,257437,2013-04-02,Assembly,"Be adopted as amended",7,0,0,3,10
437721,276250,2013-05-06,Assembly,"AJR3 ALEJO  Assembly Third Reading",61,1,0,17,79
437721,295418,2013-07-01,Senate,"Assembly 3rd Reading AJR3 Alejo By Cannella",28,1,9,0,38
437721,297061,2013-08-05,Assembly,"AJR3 ALEJO  Concurrence in Senate Amendments",57,3,0,18,78
437722,217003,2012-12-03,Assembly,"HR1 SKINNER  Assembly Third Reading",56,24,0,0,80
437723,217008,2012-12-03,Assembly,"HR2 PEREZ, J.  Assembly Third Reading  By ATKINS",80,0,0,0,80
437726,247802,2013-03-13,Senate,"Do pass, but re-refer to the Committee on Transportation and 	Housing",4,2,1,0,7
437726,270756,2013-04-23,Senate,"Do pass as amended, and re-refer to the Committee on 	Appropriations",8,3,0,0,11
437726,281228,2013-05-20,Senate,"Placed on Appropriations Suspense file",6,0,1,0,7
437726,283100,2013-05-23,Senate,"Do pass",5,2,0,0,7
437726,284538,2013-05-28,Senate,"Senate 3rd Reading SB1 Steinberg",27,11,1,0,39
437726,295974,2013-07-03,Assembly,"Do pass and be re-referred to the Committee on Local Government",5,2,0,0,7
437726,297521,2013-08-14,Assembly,"Do pass and be re-referred to the Committee on Appropriations",6,3,0,0,9
437726,298313,2013-08-30,Assembly,"Do pass as amended",12,5,0,0,17
437726,298937,2013-09-09,Assembly,"SB1 Steinberg  Senate Third Reading  By DICKINSON",48,28,0,2,78
437727,274770,2013-04-30,Senate,"Do pass, but re-refer to the Committee on Appropriations",4,1,0,0,5
437727,278644,2013-05-13,Senate,"Placed on Appropriations Suspense file",5,0,2,0,7
437727,283260,2013-05-23,Senate,"Do pass",5,2,0,0,7
437727,285052,2013-05-29,Senate,"Senate 3rd Reading SB2 Lieu",28,11,0,0,39
437727,297305,2013-08-13,Assembly,"Do pass and be re-referred to the Committee on Appropriations",5,1,0,1,7
437727,297848,2013-08-21,Assembly,"Do pass",12,5,0,0,17
437728,274689,2013-04-30,Senate,"Do pass, but re-refer to the Committee on Appropriations",4,1,0,0,5
437728,278634,2013-05-13,Senate,"Placed on Appropriations Suspense file",5,0,2,0,7
437728,283232,2013-05-23,Senate,"Do pass",4,1,2,0,7
437728,285036,2013-05-29,Senate,"Senate 3rd Reading SB3 Yee",30,6,3,0,39
437728,297232,2013-08-13,Assembly,"Do pass and be re-referred to the Committee on Appropriations",5,0,0,2,7
437728,298249,2013-08-30,Assembly,"Do pass",12,0,0,5,17
437728,299418,2013-09-11,Senate,"Unfinished Supp 1 SB3 Yee Concurrence",28,10,1,0,39
437728,299419,2013-09-11,Assembly,"SB3 Yee  Senate Third Reading  By PAN",55,19,0,4,78
437729,261713,2013-04-09,Senate,"Do pass, but re-refer to the Committee on Environmental Quality",6,2,1,0,9
437729,274703,2013-05-01,Senate,"Do pass as amended, and re-refer to the Committee on 	Appropriations",6,2,1,0,9
437729,281240,2013-05-20,Senate,"Placed on Appropriations Suspense file",6,0,1,0,7
437729,283258,2013-05-23,Senate,"Do pass as amended",5,2,0,0,7
437729,285063,2013-05-29,Senate,"Senate 3rd Reading SB4 Pavley",28,11,0,0,39
437729,295761,2013-07-01,Assembly,"Do pass as amended and be re-referred to the Committee on 	Appropriations",6,3,0,0,9
437729,298275,2013-08-30,Assembly,"Do pass as amended",10,5,0,2,17
437729,298775,2013-09-06,Assembly,"SB4 Pavley  Senate Third Reading  Amend By GRAY  Set #1",53,22,0,3,78
437729,299380,2013-09-11,Senate,"Unfinished Supp 1 SB4 Pavley Concurrence",29,8,2,0,39
437729,299381,2013-09-11,Assembly,"SB4 Pavley  Senate Third Reading  By GRAY",54,20,0,4,78
437730,275611,2013-05-01,Senate,"Do pass, but re-refer to the Committee on Appropriations Recommend 	Consent",9,0,0,0,9
437730,280437,2013-05-16,Senate,"Consent Calendar 2nd SB5 Padilla",37,0,1,0,38
437730,288428,2013-06-12,Assembly,"Do pass and re-refer to Committee on Appropriations with 	recommendation:  To Consent Calendar",7,0,0,0,7
437730,296101,2013-07-03,Assembly,"Do pass, to Consent Calendar",17,0,0,0,17
437730,297203,2013-08-12,Assembly,"SB5 Padilla  Senate Third Reading  By BUCHANAN",77,0,0,1,78
437730,297529,2013-08-15,Senate,"Unfinished Business SB5 Padilla Concurrence",38,0,1,0,39
437731,257481,2013-04-02,Senate,"Do pass as amended",7,0,0,0,7
437731,263541,2013-04-11,Senate,"Senate 3rd Reading SB6 Lieu Urgency Clause",35,0,3,0,38
437731,289702,2013-06-18,Assembly,"Do pass, to Consent Calendar",9,0,0,1,10
437731,291246,2013-06-24,Assembly,"SB6 Lieu  Consent Calendar Second Day",75,0,0,4,79
437732,248025,2013-03-13,Senate,"Do pass, but re-refer to the Committee on Appropriations",3,1,1,0,5
437732,260968,2013-04-08,Senate,"Placed on Appropriations Suspense file",7,0,0,0,7
437732,283099,2013-05-23,Senate,"Do pass",5,2,0,0,7
437732,284526,2013-05-28,Senate,"Senate 3rd Reading SB7 Steinberg",28,10,1,0,39
437732,291873,2013-06-26,Assembly,"Do pass and be re-referred to the Committee on Labor and Employment",6,3,0,0,9
437732,297522,2013-08-14,Assembly,"Do pass and be re-referred to the Committee on Appropriations",6,1,0,0,7
437732,298204,2013-08-30,Assembly,"Do pass",12,5,0,0,17
437732,298703,2013-09-04,Assembly,"SB7 Steinberg  Senate Third Reading  By WILLIAMS",52,22,0,4,78
437732,298799,2013-09-06,Senate,"Unfinished Business SB7 Steinberg Concurrence",22,13,4,0,39
437736,258471,2013-04-03,Senate,"Do pass, but re-refer to the Committee on Transportation and 	Housing",8,1,0,0,9
437736,262571,2013-04-09,Senate,"Do pass as amended, and re-refer to the Committee on 	Appropriations",6,2,3,0,11
437736,281246,2013-05-20,Senate,"Placed on Appropriations Suspense file",6,0,1,0,7
437736,283212,2013-05-23,Senate,"Do pass as amended",6,1,0,0,7
437736,284979,2013-05-29,Senate,"Senate 3rd Reading SB11 Pavley Urgency Clause",32,5,2,0,39
437736,295812,2013-07-01,Assembly,"Do pass and be re-referred to the Committee on Natural Resources",10,3,0,3,16
437736,297299,2013-08-12,Assembly,"Do pass and be re-referred to the Committee on Appropriations",6,2,0,1,9
437736,298244,2013-08-30,Assembly,"Do pass as amended",12,4,0,1,17
437736,298765,2013-09-06,Assembly,"SB 11 Pavley  Third Reading Urgency  By PEREA  Amend By PEREA  Set 	#1",53,24,0,1,78
437737,256863,2013-04-01,Senate,"Do pass, but re-refer to the Committee on Judiciary",9,0,1,0,10
437737,267698,2013-04-16,Senate,"Do pass, but re-refer to the Committee on Appropriations",5,2,0,0,7
437737,273640,2013-04-29,Senate,"Placed on Appropriations Suspense file",7,0,0,0,7
437737,283366,2013-05-23,Senate,"Do pass",5,2,0,0,7
437737,284637,2013-05-28,Senate,"Senate 3rd Reading SB12 Corbett",30,9,0,0,39
437737,289392,2013-06-18,Assembly,"Do pass and be re-referred to the Committee on Appropriations",6,0,0,7,13
437737,289393,2013-06-18,Assembly,"Set first hearing.  Failed passage.  Reconsideration granted",12,0,0,1,13
437737,297426,2013-08-13,Assembly,"Do pass and be re-referred to the Committee on Appropriations",8,4,0,2,14
437737,298184,2013-08-30,Assembly,"Do pass as amended",12,5,0,0,17
437737,299020,2013-09-09,Assembly,"SB 12 Corbett  Senate Third Reading  By TING",49,25,0,4,78
437737,299226,2013-09-10,Senate,"Unfinished Business SB12 Corbett Concurrence",29,9,1,0,39
437738,229051,2013-02-11,Senate,"Do pass, but re-refer to the Committee on Appropriations",4,0,1,0,5
437738,260934,2013-04-08,Senate,"Do pass",7,0,0,0,7
437738,263452,2013-04-11,Senate,"Senate 3rd Reading SB13 Beall Urgency Clause",37,0,1,0,38
437738,291872,2013-06-26,Assembly,"Do pass and be re-referred to the Committee on Appropriations",6,0,0,1,7
437738,298278,2013-08-30,Assembly,"Do pass as amended",16,0,0,1,17
437738,299428,2013-09-11,Assembly,"Do pass as amended",6,0,0,1,7
437738,299661,2013-09-12,Senate,"Unfinished Supp 2 SB13 Beall Concurrence",39,0,0,0,39
437738,299662,2013-09-12,Assembly,"SB 13 Beall  Third Reading Urgency  By BONTA",77,0,0,1,78
437739,259118,2013-04-03,Senate,"Do pass, but re-refer to the Committee on Appropriations Recommend 	Consent",9,0,0,0,9
437739,268531,2013-04-18,Senate,"Consent Calendar 2nd SB14 Gaines",36,0,2,0,38
437739,289433,2013-06-18,Assembly,"Do pass and re-refer to Committee on Appropriations with 	recommendation:  To Consent Calendar",7,0,0,0,7
437739,296173,2013-07-03,Assembly,"Do pass, to Consent Calendar",17,0,0,0,17
437739,297162,2013-08-08,Assembly,"SB 14 Gaines  Consent Calendar Second Day  Regular Session",77,0,0,1,78
437739,297592,2013-08-15,Senate,"Unfinished Business SB14 Gaines Urgency Clause",38,0,1,0,39
437740,267302,2013-04-16,Senate,"Do pass, but re-refer to the Committee on Public Safety",5,1,1,0,7
437740,274772,2013-04-30,Senate,"Do pass, but re-refer to the Committee on Appropriations",6,1,0,0,7
437740,278647,2013-05-13,Senate,"Placed on Appropriations Suspense file",5,0,2,0,7
437740,283191,2013-05-23,Senate,"Do pass as amended",7,0,0,0,7
437740,284568,2013-05-28,Senate,"Senate 3rd Reading SB15 Padilla",38,1,0,0,39
437740,289356,2013-06-18,Assembly,"Do pass and be re-referred to the Committee on Public Safety",9,0,0,1,10
437740,297229,2013-08-13,Assembly,"Do pass and be re-referred to the Committee on Appropriations",3,1,0,3,7
437740,298126,2013-08-27,Assembly,"Reconsideration granted",7,0,0,0,7
437741,279814,2013-05-15,Senate,"Do pass as amended, and re-refer to the Committee on Public Safety",7,0,0,0,7
437741,310304,2014-01-21,Senate,"Placed on Appropriations Suspense file",5,0,2,0,7
437741,311162,2014-01-23,Senate,"Do pass",6,0,1,0,7
437741,314011,2014-01-30,Senate,"Senate 3rd Reading SB16 Gaines Urgency Clause",34,0,5,0,39
437741,374294,2014-06-25,Assembly,"Do pass and be re-referred to the Committee on Appropriations",9,0,0,0,9
437742,261784,2013-04-09,Senate,"Do pass, but re-refer to the Committee on Appropriations",3,4,2,0,9
437742,261785,2013-04-09,Senate,"Set, first hearing.  Failed passage in Committee.  Reconsideration 	granted",9,0,0,0,9
437743,275561,2013-05-01,Senate,"Do pass and be placed on the Consent Calendar",9,0,0,0,9
437743,278021,2013-05-09,Senate,"Consent Calendar 2nd SB18 Hernandez",34,0,4,0,38
437743,374367,2014-06-24,Assembly,"Do pass and be re-referred to the Committee on Appropriations",13,5,0,1,19
437743,377164,2014-08-14,Assembly,"Do pass as amended",12,0,0,5,17
437743,377922,2014-08-20,Assembly,"SB 18 Leno  Senate Third Reading  By SKINNER",55,21,0,3,79
437743,378622,2014-08-27,Senate,"From committee:  That the Assembly Amendments be concurred in",6,2,1,0,9
437743,378861,2014-08-28,Senate,"Unfinished Business SB18 Leno Concurrence",24,10,6,0,40
437744,277788,2013-05-08,Senate,"Do pass as amended, and re-refer to the Committee on 	Appropriations",7,0,0,0,7
437744,281201,2013-05-20,Senate,"Placed on Appropriations Suspense file",6,0,1,0,7
437745,258479,2013-04-03,Senate,"Do pass, but re-refer to the Committee on Appropriations",9,0,0,0,9
437745,265200,2013-04-15,Senate,"Placed on Appropriations Suspense file",7,0,0,0,7
437745,283078,2013-05-23,Senate,"Do pass",7,0,0,0,7
437745,284587,2013-05-28,Senate,"Senate 3rd Reading SB20 Hernandez",38,0,1,0,39
437745,295939,2013-07-02,Assembly,"Do pass and be re-referred to the Committee on Appropriations",19,0,0,0,19
437745,359553,2014-04-24,Assembly,"Be referred to Committee on Health",10,0,0,1,11
437745,362621,2014-05-06,Assembly,"Do pass as amended and be re-referred to the Committee on 	Appropriations",14,4,0,1,19
437745,364261,2014-05-14,Assembly,"Do pass",12,5,0,0,17
437745,368017,2014-05-28,Assembly,"SB 20 Hernandez  Third Reading Urgency  By BONTA",56,20,0,3,79
437745,369130,2014-05-29,Senate,"From committee:  That the Assembly Amendments be concurred in",7,0,2,0,9
437745,370058,2014-06-05,Senate,"Unfinished Business SB20 Hernandez Concurrence",33,0,7,0,40
437746,267312,2013-04-17,Senate,"Do pass as amended, and re-refer to the Committee on Appropriations",9,0,0,0,9
437746,276239,2013-05-06,Senate,"Placed on Appropriations Suspense file",7,0,0,0,7
437746,283205,2013-05-23,Senate,"Do pass as amended",7,0,0,0,7
437746,284559,2013-05-28,Senate,"Senate 3rd Reading SB21 Roth Urgency Clause",39,0,0,0,39
437746,297071,2013-08-06,Assembly,"Do pass",12,0,0,1,13
437746,297677,2013-08-19,Assembly,"SB 21 Roth  Senate Third Reading  By MEDINA",77,0,0,1,78
437746,297902,2013-08-22,Senate,"Unfinished Business SB21 Roth Concurrence",37,0,2,0,39
437747,262598,2013-04-10,Senate,"Do pass, but re-refer to the Committee on Judiciary",9,0,0,0,9
437747,273528,2013-04-29,Senate,"Placed on Appropriations Suspense file",7,0,0,0,7
437747,283207,2013-05-23,Senate,"Do pass as amended",5,1,1,0,7
437747,284957,2013-05-29,Senate,"Senate 3rd Reading SB22 Beall",38,0,1,0,39
437747,291585,2013-06-25,Assembly,"Do pass as amended and be re-referred to the Committee on 	Appropriations",17,2,0,0,19
437748,271020,2013-04-23,Senate,"Do pass as amended, and re-refer to the Committee on Appropriations",4,2,0,0,6
437748,276300,2013-05-06,Senate,"Placed on Appropriations Suspense file",7,0,0,0,7
437748,283396,2013-05-23,Senate,"Do pass as amended",5,2,0,0,7
437748,284520,2013-05-28,Senate,"Senate 3rd Reading SB23 Lara",29,10,0,0,39
437748,291542,2013-06-25,Assembly,"Do pass and be re-referred to the Committee on Appropriations",8,1,0,1,10
437750,247930,2013-03-13,Senate,"Do pass",3,1,1,0,5
437750,276244,2013-05-06,Senate,"Senate 3rd Reading SB25 Steinberg",23,10,5,0,38
437750,288717,2013-06-12,Assembly,"Do pass and be re-referred to the Committee on Judiciary",3,2,0,2,7
437750,288718,2013-06-12,Assembly,"Set first hearing.  Failed passage.  Reconsideration granted",5,0,0,2,7
437750,292147,2013-06-26,Assembly,"Do pass and be re-referred to the Committee on Judiciary",4,2,0,1,7
437750,295821,2013-07-02,Assembly,"Do pass",6,3,0,1,10
437750,297690,2013-08-19,Assembly,"SB 25 Steinberg  Senate Third Reading  By BONTA",43,25,0,10,78
437750,379038,2014-08-30,Senate,"W/O REF. TO FILE SB25 Steinberg Concurrence",22,12,6,0,40
437750,379039,2014-08-30,Assembly,"SB 25 Steinberg  Senate Third Reading  By BONTA",42,25,0,12,79
437751,250876,2013-03-19,Senate,"Do pass, but re-refer to the Committee on Appropriations",4,0,1,0,5
437751,270129,2013-04-22,Senate,"Senate 3rd Reading SB26 Correa",29,8,1,0,38
437751,288086,2013-06-11,Assembly,"Do pass and be re-referred to the Committee on Appropriations",3,1,0,3,7
437751,288087,2013-06-11,Assembly,"Set first hearing.  Failed passage.  Reconsideration granted",5,0,0,2,7
437751,370225,2014-06-09,Assembly,"Be referred to Committee on Local Government",10,0,0,1,11
437751,374421,2014-06-25,Assembly,"Do pass and be re-referred to the Committee on Appropriations",9,0,0,0,9
437751,376736,2014-08-06,Assembly,"Do pass, to Consent Calendar",17,0,0,0,17
437751,377229,2014-08-14,Assembly,"SB 26 Correa  Consent Calendar Second Day  Regular Session",78,0,0,1,79
437751,377940,2014-08-20,Senate,"From committee:  That the Assembly Amendments be concurred in",5,0,2,0,7
437751,378100,2014-08-21,Senate,"Unfinished Business SB26 Correa Concurrence",31,0,9,0,40
437752,274818,2013-04-30,Senate,"Do pass, but re-refer to the Committee on Appropriations",4,1,0,0,5
437752,278590,2013-05-13,Senate,"Placed on Appropriations Suspense file",5,0,2,0,7
437752,283402,2013-05-23,Senate,"Do pass",5,2,0,0,7
437752,284539,2013-05-28,Senate,"Senate 3rd Reading SB27 Correa",28,8,3,0,39
437752,297226,2013-08-13,Assembly,"Do pass and be re-referred to the Committee on Appropriations",5,1,0,1,7
437752,298358,2013-08-30,Assembly,"Do pass",12,5,0,0,17
437752,309845,2014-01-17,Assembly,"SB 27 Correa  Senate Third Reading  Amend By GORDON  Set #1",50,23,0,7,80
437752,325742,2014-02-20,Assembly,"SB 27 Correa  Third Reading Urgency  By GORDON",58,18,0,4,80
437752,343951,2014-03-17,Senate,"Unfinished Business SB27 Correa Urgency Clause",26,4,9,0,39
437752,343952,2014-03-17,Senate,"Unfinished Business SB27 Correa Reconsider",35,0,4,0,39
437752,362185,2014-05-05,Assembly,"SB 27 Correa  Third Reading Urgency  By GORDON",58,12,0,9,79
437752,363352,2014-05-08,Senate,"Unfinished Business SB27 Correa Urgency Clause",28,7,5,0,40
437753,272291,2013-04-24,Senate,"Do pass, but re-refer to the Committee on Appropriations Recommend 	Consent",9,0,0,0,9
437753,276242,2013-05-06,Senate,"Do pass as amended",5,0,2,0,7
437753,280247,2013-05-16,Senate,"Senate 3rd Reading SB28 Hernandez",32,0,6,0,38
437753,297292,2013-08-13,Assembly,"Do pass and be re-referred to the Committee on Appropriations",13,5,0,1,19
437753,298258,2013-08-30,Assembly,"Do pass",12,5,0,0,17
437753,298772,2013-09-06,Assembly,"SB 28 Hernandez  Senate Third Reading  By MITCHELL  Amend By 	MITCHELL  Set #1",53,25,0,0,78
437753,299208,2013-09-10,Assembly,"SB 28 Hernandez  Senate Third Reading  By MITCHELL",54,23,0,1,78
437753,299389,2013-09-11,Senate,"Unfinished Business SB28 Hernandez Concurrence",26,10,3,0,39
437754,251289,2013-03-19,Senate,"Do pass, but re-refer to the Committee on Appropriations",3,1,1,0,5
437754,260938,2013-04-08,Senate,"Placed on Appropriations Suspense file",7,0,0,0,7
437754,283251,2013-05-23,Senate,"Do pass",5,2,0,0,7
437754,284612,2013-05-28,Senate,"Senate 3rd Reading SB29 Correa",27,10,2,0,39
437754,291770,2013-06-25,Assembly,"Do pass as amended and be re-referred to the Committee on 	Appropriations",5,2,0,0,7
437754,377050,2014-08-13,Assembly,"Do pass",12,5,0,0,17
437754,378330,2014-08-25,Assembly,"SB 29 Correa  Senate Third Reading  By MULLIN",54,25,0,0,79
437754,378495,2014-08-26,Senate,"Unfinished Supp 1 SB29 Correa Concurrence",21,11,8,0,40
437755,247897,2013-03-13,Senate,"Do pass, but re-refer to the Committee on Appropriations",6,0,1,0,7
437755,260932,2013-04-08,Senate,"Placed on Appropriations Suspense file",7,0,0,0,7
437755,283237,2013-05-23,Senate,"Do pass as amended",7,0,0,0,7
437755,290209,2013-06-20,Senate,"Senate 3rd Reading SB30 Calderon Lay on Table",23,12,4,0,39
437755,290210,2013-06-20,Senate,"Senate 3rd Reading SB30 Calderon Urgency Clause",36,0,3,0,39
437755,297187,2013-08-12,Assembly,"Do pass as amended and be re-referred to the Committee on 	Appropriations",9,0,0,0,9
437756,262615,2013-04-09,Senate,"Do pass, but re-refer to the Committee on Appropriations",8,0,3,0,11
437756,270076,2013-04-22,Senate,"Do pass",7,0,0,0,7
437756,273556,2013-04-29,Senate,"Special Consent #2 SB31 Padilla",37,0,1,0,38
437756,288402,2013-06-12,Assembly,"Do pass and be re-referred to the Committee on Appropriations",16,0,0,1,17
437756,295973,2013-07-03,Assembly,"Do pass, to Consent Calendar",17,0,0,0,17
437756,298753,2013-09-06,Assembly,"SB 31 Padilla  Senate Third Reading  By HALL",77,0,0,1,78
437756,299345,2013-09-11,Senate,"Unfinished Business SB31 Padilla Concurrence",39,0,0,0,39
437758,247990,2013-03-13,Senate,"Do pass, but re-refer to the Committee on Appropriations",4,1,2,0,7
437758,263475,2013-04-11,Senate,"Senate 3rd Reading SB33 Wolk",24,13,1,0,38
437758,288393,2013-06-12,Assembly,"Do pass and be re-referred to the Committee on Appropriations",5,2,0,2,9
437758,296095,2013-07-03,Assembly,"Do pass",11,5,0,1,17
437758,378210,2014-08-22,Assembly,"SB 33 Wolk  Senate Third Reading  Amend By CHESBRO  Set #1",53,22,0,4,79
437759,267185,2013-04-17,Senate,"Do pass, but re-refer to the Committee on Natural Resources and 	Water",8,0,1,0,9
437759,270783,2013-04-23,Senate,"Do pass as amended, and re-refer to the Committee on Appropriations",8,0,1,0,9
437759,278606,2013-05-13,Senate,"Placed on Appropriations Suspense file",5,0,2,0,7
437760,266387,2013-04-16,Senate,"Do pass as amended, and re-refer to the Committee on Education",8,2,1,0,11
437760,308701,2014-01-14,Senate,"Do pass, but re-refer to the Committee on Appropriations",6,0,1,0,7
437760,310316,2014-01-21,Senate,"Placed on Appropriations Suspense file",5,0,2,0,7
437760,311196,2014-01-23,Senate,"Do pass",6,0,1,0,7
437760,312672,2014-01-28,Senate,"Senate 3rd Reading SB35 Pavley",32,0,7,0,39
437760,370437,2014-06-10,Assembly,"Do pass and re-refer to Committee on Appropriations with 	recommendation:  To Consent Calendar",7,0,0,0,7
437760,377189,2014-08-14,Assembly,"Do pass",17,0,0,0,17
437760,378277,2014-08-25,Assembly,"SB 35 Pavley  Senate Third Reading  By HOLDEN",79,0,0,0,79
437760,378480,2014-08-26,Senate,"Unfinished Supp 1 SB35 Pavley Concurrence",35,0,5,0,40
437761,271758,2013-04-24,Senate,"Do pass as amended, and re-refer to the Committee on 	Appropriations",8,1,0,0,9
437761,278992,2013-05-13,Senate,"Do pass",5,0,2,0,7
437761,280417,2013-05-16,Senate,"Senate 3rd Reading SB36 Hueso",30,6,2,0,38
437761,297092,2013-08-07,Assembly,"Do pass as amended and be re-referred to the Committee on 	Appropriations",12,0,0,0,12
437761,297879,2013-08-21,Assembly,"Do pass, to Consent Calendar",17,0,0,0,17
437761,298988,2013-09-09,Assembly,"SB 36 Hueso  Senate Third Reading  By FRAZIER",78,0,0,0,78
437761,299328,2013-09-10,Senate,"Unfinished Business SB36 Hueso Concurrence",36,2,1,0,39
437762,266405,2013-04-16,Senate,"Do pass, but re-refer to the Committee on Judiciary",5,5,1,0,11
437762,266406,2013-04-16,Senate,"Set, first hearing.  Failed passage in Committee.  Reconsideration 	granted",10,0,1,0,11
437762,274084,2013-04-30,Senate,"Do pass, but re-refer to the Committee on Judiciary",5,4,2,0,11
437763,274842,2013-04-30,Senate,"Do pass, but re-refer to the Committee on Appropriations",7,0,0,0,7
437763,278551,2013-05-13,Senate,"Placed on Appropriations Suspense file",5,0,2,0,7
437763,283179,2013-05-23,Senate,"Do pass as amended",7,0,0,0,7
437763,284567,2013-05-28,Senate,"Senate 3rd Reading SB38 De Le",39,0,0,0,39
437763,295763,2013-07-02,Assembly,"Do pass as amended and be re-referred to the Committee on 	Appropriations",7,0,0,0,7
437763,377399,2014-08-14,Assembly,"Do pass as amended",12,0,0,5,17
437763,378701,2014-08-27,Assembly,"SB 38 Padilla  Senate Third Reading  By BRADFORD",78,0,0,1,79
437763,378919,2014-08-28,Senate,"Unfinished Business SB38 Padilla Concurrence",34,0,6,0,40
437764,267350,2013-04-17,Senate,"Do pass as amended, and re-refer to the Committee on Energy, 	Utilities and Communications",8,0,1,0,9
437764,274152,2013-04-30,Senate,"Do pass as amended, and re-refer to the Committee on Appropriations",11,0,0,0,11
437764,281159,2013-05-20,Senate,"Placed on Appropriations Suspense file",6,0,1,0,7
437764,283148,2013-05-23,Senate,"Do pass as amended",5,0,2,0,7
437764,285535,2013-05-30,Senate,"Senate 3rd Reading SB39 De Le",38,0,1,0,39
437764,297115,2013-08-08,Assembly,"Be referred to Committee on Natural Resources",9,0,0,2,11
437764,297225,2013-08-12,Assembly,"Do pass and be re-referred to the Committee on Appropriations",8,0,0,1,9
437764,298302,2013-08-30,Assembly,"Do pass",16,0,0,1,17
437764,299461,2013-09-11,Assembly,"Do pass",10,0,0,0,10
437764,299586,2013-09-12,Senate,"From committee:  That the Assembly Amendments be concurred in",3,0,2,0,5
437764,299587,2013-09-12,Assembly,"SB 39 De Leon  Third Reading Urgency  By PEREZ, J",77,0,0,1,78
437764,299588,2013-09-12,Senate,"Unfinished Supp 2 SB39 Senator De Le",38,0,1,0,39
437766,239462,2013-02-27,Senate,"Do pass",9,0,0,0,9
437766,241562,2013-03-04,Senate,"Senate 3rd Reading SB41 Wright Urgency Clause",34,0,3,0,37
437766,252354,2013-03-20,Assembly,"Do pass, to Consent Calendar",6,0,0,1,7
437766,259625,2013-04-04,Assembly,"SB 41 Wright  Consent Calendar Second Day",71,0,0,8,79
437768,274085,2013-04-30,Senate,"Do pass as amended, and re-refer to the Committee on Rules",6,4,1,0,11
437768,281260,2013-05-20,Senate,"Placed on Appropriations Suspense file",6,0,1,0,7
437768,283121,2013-05-23,Senate,"Do pass as amended",5,2,0,0,7
437768,285522,2013-05-30,Senate,"Senate 3rd Reading SB43 Wolk",27,9,3,0,39
437768,291192,2013-06-24,Assembly,"Do pass as amended and be re-referred to the Committee on 	Appropriations",11,1,0,3,15
437768,298226,2013-08-30,Assembly,"Do pass as amended",13,1,0,3,17
437768,298762,2013-09-06,Assembly,"SB 43 Wolk  Senate Third Reading  By WILLIAMS  Amend By WILLIAMS 	Set #1",53,22,0,3,78
437768,299384,2013-09-11,Senate,"Unfinished Supp 1 SB43 Wolk Concurrence",27,12,0,0,39
437768,299385,2013-09-11,Assembly,"SB 43 Wolk  Senate Third Reading  By WILLIAMS",57,16,0,5,78
437769,250659,2013-03-19,Senate,"Do pass, but re-refer to the Committee on Governmental Organization",3,1,1,0,5
437769,261695,2013-04-09,Senate,"Do pass, but re-refer to the Committee on Appropriations",9,2,0,0,11
437769,277999,2013-05-09,Senate,"Senate 3rd Reading SB44 Yee",25,8,5,0,38
437769,288036,2013-06-11,Assembly,"Do pass and be re-referred to the Committee on Appropriations",5,1,0,1,7
437769,295995,2013-07-03,Assembly,"Do pass",12,5,0,0,17
437769,297985,2013-08-26,Assembly,"SB 44 Yee  Senate Third Reading  By GRAY",56,22,0,0,78
437771,271594,2013-04-23,Senate,"Do pass, but re-refer to the Committee on Appropriations",6,0,1,0,7
437771,278683,2013-05-13,Senate,"Do pass",5,0,2,0,7
437771,280329,2013-05-16,Senate,"Senate 3rd Reading SB46 Corbett",37,0,1,0,38
437771,289402,2013-06-18,Assembly,"Do pass and re-refer to Committee on Appropriations with 	recommendation:  To Consent Calendar",9,0,0,1,10
437771,295991,2013-07-03,Assembly,"Do pass, to Consent Calendar",17,0,0,0,17
437771,298618,2013-09-03,Assembly,"SB 46 Corbett  Senate Third Reading  By GARCIA",77,0,0,1,78
437771,298702,2013-09-04,Senate,"Unfinished Business SB46 Corbett Concurrence",38,0,1,0,39
437774,279668,2013-05-15,Senate,"Be adopted as amended, and re-refer to the Committee on Elections 	and Constitutional Amendments",5,2,0,0,7
437774,289398,2013-06-18,Senate,"Be adopted, but re-refer to the Committee on Rules",3,0,2,0,5
437774,291551,2013-06-25,Senate,"Be adopted",6,0,1,0,7
437774,291552,2013-06-25,Senate,"Be adopted, but re-refer to the Committee on Appropriations",7,0,0,0,7
437774,296002,2013-07-03,Senate,"Senate 3rd Reading SCA3 Leno",37,0,1,0,38
437774,297537,2013-08-14,Assembly,"Be adopted and be re-referred to the Committee on Budget",9,0,0,0,9
437774,298165,2013-08-29,Assembly,"Be adopted",24,0,0,1,25
437774,299129,2013-09-10,Assembly,"SCA3 Leno  Senate Third Reading  By LEVINE",78,0,0,0,78
437775,279847,2013-05-15,Senate,"Be adopted as amended, and re-refer to the Committee on Rules",5,1,1,0,7
437775,298124,2013-08-27,Senate,"Be adopted as amended, and re-refer to the Committee on Rules",7,2,2,0,11
437776,295968,2013-07-03,Senate,"Do pass, but re-refer to the Committee on Elections and 	Constitutional Amendments",7,2,0,0,9
437776,297820,2013-08-20,Senate,"Do pass, but re-refer to the Committee on Rules",4,1,0,0,5
437776,310329,2014-01-21,Senate,"Placed on Appropriations Suspense file",5,0,2,0,7
437776,311182,2014-01-23,Senate,"Be adopted",5,1,1,0,7
437776,313934,2014-01-30,Senate,"Senate 3rd Reading SCA5 Hernandez",27,9,3,0,39
437777,250717,2013-03-19,Senate,"Be adopted, but re-refer to the Committee on Appropriations",3,1,1,0,5
437777,260967,2013-04-08,Senate,"Placed on Appropriations Suspense file",7,0,0,0,7
437777,285523,2013-05-23,Senate,"Be adopted",5,2,0,0,7
437778,279675,2013-05-15,Senate,"Be adopted, but re-refer to the Committee on Elections and 	Constitutional Amendments",5,2,0,0,7
437778,289415,2013-06-18,Senate,"Be adopted, but re-refer to the Committee on Rules",3,0,2,0,5
437779,280062,2013-05-15,Senate,"Be adopted as amended, and re-refer to the Committee on Rules",5,2,0,0,7
437779,298130,2013-08-27,Senate,"Be adopted, but re-refer to the Committee on Rules",7,2,2,0,11
437780,217067,2012-12-03,Assembly,"SCR1 Steinberg  Senate Third Reading  By ATKINS",80,0,0,0,80
437780,217068,2012-12-03,Senate,"W/O REF. TO FILE SCR1 Steinberg",39,0,0,0,39
437783,257980,2013-04-02,Senate,"Be adopted, but re-refer to the Committee on Appropriations 	Recommend Consent",11,0,0,0,11
437783,268484,2013-04-18,Senate,"Consent Calendar 2nd SCR4 Fuller",36,0,2,0,38
437783,295848,2013-07-01,Assembly,"Be adopted, and re-refer to Committee on Appropriations with 	recommendation:  To Consent Calendar",15,0,0,1,16
437783,296141,2013-07-03,Assembly,"Be adopted, to Consent Calendar",17,0,0,0,17
437783,297173,2013-08-08,Assembly,"SCR4 Fuller  Consent Calendar Second Day  Regular Session",77,0,0,1,78
437918,257376,2013-04-02,Assembly,"Do pass and be re-referred to the Committee on Appropriations",13,0,0,0,13
437918,262716,2013-04-10,Assembly,"Do pass, to Consent Calendar",17,0,0,0,17
437918,268657,2013-04-18,Assembly,"AB 44 BUCHANAN  Consent Calendar Second Day  Regular Session",76,0,0,3,79
437918,291614,2013-06-25,Senate,"Do pass, but re-refer to the Committee on Appropriations Recommend 	Consent",11,0,0,0,11
437918,297583,2013-08-15,Senate,"Consent Calendar 2nd AB44 Buchanan",38,0,1,0,39
437918,297962,2013-08-22,Assembly,"AB 44 BUCHANAN  Concurrence in Senate Amendments",78,0,0,0,78
438339,267283,2013-04-16,Senate,"Do pass, but re-refer to the Committee on Appropriations",5,2,0,0,7
438339,276265,2013-05-06,Senate,"Placed on Appropriations Suspense file",7,0,0,0,7
438339,283080,2013-05-23,Senate,"Do pass as amended",5,2,0,0,7
438339,285028,2013-05-29,Senate,"Special Order SB47 Yee",23,15,1,0,39
438339,297252,2013-08-13,Assembly,"Do pass and be re-referred to the Committee on Appropriations",4,2,0,1,7
438408,279753,2013-05-15,Senate,"Be adopted as amended, and re-refer to the Committee on Elections 	and Constitutional Amendments",5,1,1,0,7
438408,281188,2013-05-15,Senate,"Be adopted as amended, and re-refer to the Committee on Elections 	and Constitutional Amendments",5,1,1,0,7
438408,289606,2013-06-18,Senate,"Be adopted, but re-refer to the Committee on Rules",3,0,2,0,5
438861,270947,2013-04-23,Assembly,"Do pass as amended and be re-referred to the Committee on 	Appropriations",5,2,0,0,7
438861,277472,2013-05-08,Assembly,"Do pass",12,5,0,0,17
438861,285621,2013-05-30,Assembly,"AB 45 DICKINSON  Assembly Third Reading",53,24,0,2,79
438861,285972,2013-05-31,Assembly,"AB 45 DICKINSON  Motion to Reconsider",53,22,0,4,79
438861,285973,2013-05-31,Assembly,"AB 45 DICKINSON  Assembly Third Reading  Amend By DICKINSON  Set #1",53,21,0,5,79
438861,288076,2013-06-11,Assembly,"Do pass",5,1,0,1,7
438861,290216,2013-06-20,Assembly,"AB 45 DICKINSON  Assembly Third Reading",54,22,0,3,79
438894,251085,2013-03-19,Assembly,"Do pass and be re-referred to the Committee on Appropriations",9,3,0,1,13
438894,262620,2013-04-10,Assembly,"Do pass",12,5,0,0,17
438894,268800,2013-04-18,Assembly,"AB 46 PAN  Assembly Third Reading",52,24,0,3,79
438894,372579,2014-06-18,Senate,"Do pass as amended, and re-refer to the Committee on Rules",4,2,1,0,7
438894,377693,2014-08-18,Senate,"Assembly 3rd Reading AB46 Pan By Evans",23,11,6,0,40
438894,378552,2014-08-25,Assembly,"Senate amendments be concurred in",7,3,0,3,13
438894,378619,2014-08-27,Assembly,"AB 46 PAN  Concurrence in Senate Amendments",54,23,0,2,79
438931,266341,2013-04-16,Assembly,"Do pass as amended and be re-referred to the Committee on 	Appropriations",7,0,0,0,7
438931,283846,2013-05-24,Assembly,"Do pass",17,0,0,0,17
438931,284631,2013-05-28,Assembly,"AB 47 GATTO  Assembly Third Reading",76,0,0,3,79
438931,295759,2013-07-02,Senate,"Do pass as amended, and re-refer to the Committee on Appropriations",7,0,0,0,7
438931,297283,2013-08-12,Senate,"Do pass as amended",4,0,3,0,7
438931,374274,2014-06-24,Senate,"Do pass as amended, and re-refer to the Committee on Appropriations",6,1,0,0,7
438931,376561,2014-08-04,Senate,"Placed on Appropriations Suspense file",7,0,0,0,7
438931,377416,2014-08-14,Senate,"Do pass",5,0,2,0,7
438931,378069,2014-08-21,Senate,"Assembly 3rd Reading AB47 Gatto By Knight",35,1,4,0,40
438931,378544,2014-08-26,Assembly,"Senate amendments be concurred in",7,0,0,0,7
438931,378879,2014-08-28,Assembly,"AB 47 GATTO  Concurrence in Senate Amendments",76,2,0,1,79
439103,274204,2013-04-30,Senate,"Do pass as amended, and re-refer to the Committee on Appropriations",10,0,1,0,11
439103,284042,2013-05-24,Senate,"Senate 3rd Reading SB48 Hill",35,0,4,0,39
439103,374133,2014-06-23,Assembly,"Do pass as amended and be re-referred to the Committee on 	Appropriations",3,8,0,4,15
439140,272310,2013-04-24,Senate,"Do pass as amended, and re-refer to the Committee on Appropriations",9,0,0,0,9
439140,278608,2013-05-13,Senate,"Placed on Appropriations Suspense file",5,0,2,0,7
439140,283073,2013-05-23,Senate,"Do pass as amended",7,0,0,0,7
439140,285065,2013-05-29,Senate,"Senate 3rd Reading SB49 Lieu",39,0,0,0,39
439140,291860,2013-06-26,Assembly,"Do pass as amended and re-refer to Committee on Appropriations 	with recommendation:  To Consent Calendar",7,0,0,0,7
439174,266682,2013-04-16,Senate,"Do pass, but re-refer to the Committee on Appropriations",10,0,1,0,11
439174,276308,2013-05-06,Senate,"Special Consent #3 SB50 Lieu",32,0,6,0,38
439174,289454,2013-06-17,Assembly,"Do pass and re-refer to Committee on Appropriations with 	recommendation:  To Consent Calendar",12,0,0,3,15
439174,296125,2013-07-03,Assembly,"Do pass, to Consent Calendar",17,0,0,0,17
439174,297159,2013-08-08,Assembly,"SB 50 Lieu  Consent Calendar Second Day  Regular Session",77,0,0,1,78
439261,229688,2013-02-11,Senate,"Do pass as amended",4,0,1,0,5
439261,232795,2013-02-15,Senate,"Senate 3rd Reading SB54 Hancock Urgency Clause",32,0,6,0,38
439261,297140,2013-08-08,Assembly,"Be referred to Committee on Labor and Employment",9,0,0,2,11
439261,297587,2013-08-14,Assembly,"Do pass and be re-referred to the Committee on Appropriations",5,2,0,0,7
439261,298299,2013-08-30,Assembly,"Do pass as amended",11,5,0,1,17
439261,298932,2013-09-09,Assembly,"SB 54 Hancock  Senate Third Reading  By BONILLA",51,24,0,3,78
439261,299137,2013-09-10,Senate,"From committee:  That the Assembly Amendments be concurred in",7,2,0,0,9
439261,299450,2013-09-11,Senate,"Unfinished Business SB54 Hancock Concurrence",27,11,1,0,39
439269,267335,2013-04-16,Senate,"Do pass, but re-refer to the Committee on Appropriations",5,2,0,0,7
439269,276245,2013-05-06,Senate,"Placed on Appropriations Suspense file",7,0,0,0,7
439269,283149,2013-05-23,Senate,"Do pass as amended",5,2,0,0,7
439269,284968,2013-05-29,Senate,"Special Order SB53 De Le",23,15,1,0,39
439269,295786,2013-07-02,Assembly,"Do pass and be re-referred to the Committee on Appropriations",5,2,0,0,7
439269,298210,2013-08-30,Assembly,"Do pass as amended",11,6,0,0,17
439269,370481,2014-06-10,Assembly,"Do pass",5,2,0,0,7
439269,378220,2014-08-22,Assembly,"SB 53 De Leon  Senate Third Reading  By BONTA  Amend By BONTA  Set 	#1",44,27,0,8,79
439269,379032,2014-08-30,Assembly,"SB 53 De Leon  Senate Third Reading  By BONTA",35,35,0,9,79
439280,274779,2013-04-30,Senate,"Do pass, but re-refer to the Committee on Appropriations",4,1,0,0,5
439280,278625,2013-05-13,Senate,"Placed on Appropriations Suspense file",5,0,2,0,7
439280,283216,2013-05-23,Senate,"Do pass",5,2,0,0,7
439280,285003,2013-05-29,Senate,"Senate 3rd Reading SB52 Leno",28,11,0,0,39
439280,374500,2014-06-24,Assembly,"Do pass as amended and be re-referred to the Committee on 	Appropriations",5,1,0,1,7
439280,377179,2014-08-14,Assembly,"Do pass as amended",9,6,0,2,17
439332,266413,2013-04-15,Assembly,"Do pass and be re-referred to the Committee on Appropriations",5,0,0,4,9
439332,283820,2013-05-24,Assembly,"Do pass",12,0,0,5,17
439332,291616,2013-06-24,Assembly,"Do pass",6,0,0,3,9
439332,292146,2013-06-27,Assembly,"AB 52 GATTO  Assembly Third Reading",58,0,0,21,79
439332,374368,2014-06-25,Senate,"Do pass as amended, and re-refer to the Committee on 	Appropriations",6,0,1,0,7
439332,376435,2014-08-04,Senate,"Placed on Appropriations Suspense file",7,0,0,0,7
439332,377202,2014-08-14,Senate,"Do pass as amended",5,0,2,0,7
439332,378739,2014-08-27,Senate,"Assembly 3rd Reading AB52 Gatto By Wyland",35,0,5,0,40
439332,378921,2014-08-28,Assembly,"AB 52 GATTO  Concurrence in Senate Amendments",78,0,0,1,79
439354,276793,2013-05-07,Assembly,"Do pass as amended and be re-referred to the Committee on 	Appropriations",13,5,0,1,19
439354,283839,2013-05-24,Assembly,"Do pass",12,5,0,0,17
439354,289015,2013-06-14,Assembly,"AB 50 PAN  Third Reading Urgency",54,24,0,1,79
439354,297846,2013-08-21,Senate,"Do pass, but re-refer to the Committee on Appropriations",7,1,1,0,9
439354,297982,2013-08-26,Senate,"Placed on Appropriations Suspense file",7,0,0,0,7
439354,298273,2013-08-30,Senate,"Do pass as amended",6,1,0,0,7
439354,298917,2013-09-09,Senate,"Assembly 3rd Reading AB50 Pan By DeSaulnier",33,5,1,0,39
439354,299118,2013-09-10,Assembly,"AB 50 PAN  Concurrence in Senate Amendments",57,19,0,2,78
439365,266602,2013-04-15,Assembly,"Do pass and be re-referred to the Committee on Appropriations",16,0,0,0,16
439365,284036,2013-05-24,Assembly,"Do pass",17,0,0,0,17
439365,285667,2013-05-30,Assembly,"AB 49 BUCHANAN  Assembly Third Reading",78,0,0,1,79
439365,296331,2013-07-09,Senate,"Do pass, but re-refer to the Committee on Appropriations Recommend 	Consent",10,0,1,0,11
439365,378764,2014-08-27,Senate,"Assembly 3rd Reading AB49 Buchanan Reconsider",36,0,4,0,40
439365,378765,2014-08-27,Senate,"Assembly 3rd Reading AB49 Buchanan Urgency Clause",35,0,5,0,40
439365,378930,2014-08-28,Assembly,"AB 49 BUCHANAN  Concurrence- Urgency Added",79,0,0,0,79
439365,378931,2014-08-28,Senate,"Assembly 3rd Reading AB49 Buchanan Urgency Clause",34,0,6,0,40
439376,257368,2013-04-02,Assembly,"Do pass as amended and be re-referred to the Committee on 	Appropriations",5,2,0,0,7
439376,283802,2013-05-24,Assembly,"Do pass as amended",11,2,0,4,17
439376,284950,2013-05-29,Assembly,"AB 48 SKINNER  Assembly Third Reading  Amend By MELENDEZ  Set #1 	Motion to  Lay on the Table  By ATKINS",50,25,0,4,79
439376,284951,2013-05-29,Assembly,"AB 48 SKINNER  Assembly Third Reading  Amend By JONES  Set #2 	Motion to  Lay on the Table  By ATKINS",49,25,0,5,79
439376,284952,2013-05-29,Assembly,"AB 48 SKINNER  Assembly Third Reading",46,26,0,7,79
439376,295783,2013-07-02,Senate,"Do pass as amended, and re-refer to the Committee on Appropriations",5,1,1,0,7
439376,297302,2013-08-12,Senate,"Placed on Appropriations Suspense file",6,0,1,0,7
439376,298266,2013-08-30,Senate,"Do pass",5,2,0,0,7
439376,299110,2013-09-10,Senate,"Assembly 3rd Reading AB48 Skinner By Block",22,14,3,0,39
439376,299404,2013-09-11,Assembly,"AB 48 SKINNER  Concurrence in Senate Amendments",46,30,0,2,78
439663,271918,2013-04-23,Senate,"Do pass as amended, and re-refer to the Committee on Appropriations",7,0,0,0,7
439663,281276,2013-05-20,Senate,"Placed on Appropriations Suspense file",6,0,1,0,7
439663,283386,2013-05-23,Senate,"Do pass as amended",7,0,0,0,7
439663,285088,2013-05-29,Senate,"Senate 3rd Reading SB55 Hill",39,0,0,0,39
439663,295885,2013-07-02,Assembly,"Do pass and be re-referred to the Committee on Transportation",3,1,0,3,7
439663,295886,2013-07-02,Assembly,"Set first hearing.  Failed passage.  Reconsideration granted",7,0,0,0,7
439663,297328,2013-08-13,Assembly,"Do pass and be re-referred to the Committee on Transportation",5,0,0,2,7
439663,297566,2013-08-15,Assembly,"Do pass and be re-referred to the Committee on Appropriations",12,0,0,4,16
440129,216424,2013-01-07,Senate,"W/O REF. TO FILE SCR5 Steinberg",37,0,0,0,37
445044,257411,2013-04-02,Senate,"Do pass, but re-refer to the Committee on Appropriations",7,0,0,0,7
445044,270052,2013-04-22,Senate,"Placed on Appropriations Suspense file",7,0,0,0,7
445044,283252,2013-05-23,Senate,"Do pass as amended",7,0,0,0,7
445044,284959,2013-05-29,Senate,"Senate 3rd Reading SB60 Wright",39,0,0,0,39
445044,291539,2013-06-25,Assembly,"Do pass and re-refer to Committee on Appropriations with 	recommendation:  To Consent Calendar",7,0,0,0,7
445044,295958,2013-07-03,Assembly,"Do pass, to Consent Calendar",17,0,0,0,17
445044,297134,2013-08-08,Assembly,"SB 60 Wright  Consent Calendar Second Day  Regular Session",77,0,0,1,78
445046,237637,2013-02-26,Senate,"Do pass, but re-refer to the Committee on Appropriations",6,0,1,0,7
445046,260981,2013-04-08,Senate,"Do pass as amended",7,0,0,0,7
445046,269931,2013-04-22,Senate,"Senate 3rd Reading SB59 Evans Urgency Clause",38,0,0,0,38
445046,289360,2013-06-18,Assembly,"Do pass and be re-referred to the Committee on Appropriations",4,0,0,3,7
445046,297442,2013-08-14,Assembly,"Do pass, to Consent Calendar",17,0,0,0,17
445046,297891,2013-08-22,Assembly,"SB 59 Evans  Consent Calendar Second Day  Regular Session",78,0,0,0,78
445046,297992,2013-08-26,Senate,"Unfinished Business SB59 Evans Concurrence",37,0,2,0,39
445054,274719,2013-04-30,Senate,"Do pass as amended, and re-refer to the Committee on Appropriations",7,0,0,0,7
445054,281263,2013-05-20,Senate,"Placed on Appropriations Suspense file",6,0,1,0,7
445054,283129,2013-05-23,Senate,"Do pass",7,0,0,0,7
445054,284544,2013-05-28,Senate,"Senate 3rd Reading SB57 Lieu",39,0,0,0,39
445054,291586,2013-06-25,Assembly,"Do pass as amended and be re-referred to the Committee on 	Appropriations",5,0,0,2,7
445054,298287,2013-08-30,Assembly,"Do pass as amended",17,0,0,0,17
445054,299424,2013-09-11,Senate,"Unfinished Supp 1 SB57 Lieu Concurrence",39,0,0,0,39
445054,299425,2013-09-11,Assembly,"SB 57 Lieu  Senate Third Reading  By GONZALEZ",77,0,0,1,78
445055,289923,2013-06-19,Senate,"Do pass, but re-refer to the Committee on Appropriations",7,0,0,0,7
445078,262580,2013-04-09,Assembly,"Do pass and be re-referred to the Committee on Appropriations",11,0,0,2,13
445084,274089,2013-04-29,Assembly,"Do pass as amended and be re-referred to the Committee on 	Appropriations",14,1,0,0,15
445084,283803,2013-05-24,Assembly,"Do pass",17,0,0,0,17
445084,284685,2013-05-28,Assembly,"AB 66 MURATSUCHI  Assembly Third Reading",75,1,0,3,79
445084,289386,2013-06-18,Senate,"Do pass as amended, and re-refer to the Committee on Appropriations",8,0,3,0,11
445084,297228,2013-08-12,Senate,"Placed on Appropriations Suspense file",6,0,1,0,7
445084,298335,2013-08-30,Senate,"Do pass as amended",7,0,0,0,7
445084,298950,2013-09-09,Senate,"Assembly 3rd Reading AB66 Muratsuchi By Hill",39,0,0,0,39
445084,299167,2013-09-10,Assembly,"AB 66 MURATSUCHI  Concurrence in Senate Amendments",77,1,0,0,78
445090,248076,2013-03-12,Assembly,"Do pass as amended and be re-referred to the Committee on 	Appropriations",7,0,0,0,7
445090,262637,2013-04-10,Assembly,"Do pass, to Consent Calendar",17,0,0,0,17
445090,268487,2013-04-18,Assembly,"AB 65 ACHADJIAN  Consent Calendar Second Day  Regular Session",76,0,0,3,79
445090,279226,2013-05-14,Senate,"Do pass, but re-refer to the Committee on Appropriations",7,0,0,0,7
445090,295078,2013-07-01,Senate,"Do pass",6,0,1,0,7
445090,297536,2013-08-15,Senate,"Assembly 3rd Reading AB65 Achadjian Urgency Clause",38,0,1,0,39
445090,297654,2013-08-19,Assembly,"AB 65 ACHADJIAN  Concurrence in Senate Amendments",77,0,0,1,78
445095,269922,2013-04-22,Assembly,"Do pass, to Consent Calendar",16,0,0,0,16
445095,274682,2013-05-01,Assembly,"Do pass as amended, to Consent Calendar",17,0,0,0,17
445095,280223,2013-05-16,Assembly,"AB 64 DONNELLY  Consent Calendar Second Day",70,0,0,9,79
445095,296329,2013-07-09,Senate,"Do pass as amended, and re-refer to the Committee on 	Appropriations",10,0,1,0,11
445095,299391,2013-09-11,Assembly,"Senate amendments be concurred in",15,0,0,1,16
445095,299392,2013-09-11,Senate,"Assembly 3rd Reading AB64 Donnelly By Wyland",38,0,1,0,39
445095,299635,2013-09-12,Assembly,"AB 64 DONNELLY  Concurrence in Senate Amendments",77,0,0,1,78
445102,274840,2013-04-30,Assembly,"Do pass and be re-referred to the Committee on Appropriations",2,5,0,0,7
445102,277332,2013-05-07,Assembly,"Reconsideration granted",7,0,0,0,7
445114,278222,2013-05-08,Assembly,"Do pass",8,0,0,1,9
445114,280397,2013-05-16,Assembly,"AB 61 GATTO  Assembly Third Reading",72,0,0,7,79
445114,288220,2013-06-11,Senate,"Do pass",11,0,0,0,11
445114,296135,2013-07-03,Senate,"Assembly 3rd Reading AB61 Gatto By DeSaulnier",36,1,1,0,38
445120,269940,2013-04-22,Assembly,"Do pass and be re-referred to the Committee on Appropriations",11,4,0,1,16
445120,283791,2013-05-24,Assembly,"Do pass as amended",12,5,0,0,17
445120,284956,2013-05-29,Assembly,"AB 60 ALEJO  Assembly Third Reading",55,20,0,4,79
445120,295796,2013-07-02,Senate,"Do pass as amended, and re-refer to the Committee on 	Appropriations",8,2,1,0,11
445120,297649,2013-08-19,Senate,"Placed on Appropriations Suspense file",7,0,0,0,7
445120,298209,2013-08-30,Senate,"Do pass as amended",5,2,0,0,7
445120,299632,2013-09-12,Senate,"W/O REF. TO FILE AB60 Alejo By De Le",28,8,3,0,39
445120,299633,2013-09-12,Assembly,"AB 60 ALEJO  Concurrence in Senate Amendments",55,21,0,2,78
445126,305729,2014-01-06,Assembly,"Be referred to Committee on Judiciary",9,0,0,1,10
445132,250669,2013-03-19,Assembly,"Do pass as amended",19,0,0,0,19
445132,261049,2013-04-08,Assembly,"AB 58 WIECKOWSKI  Assembly Third Reading",76,0,0,3,79
445132,287178,2013-06-05,Senate,"Do pass",9,0,0,0,9
445132,298668,2013-09-03,Senate,"Assembly 3rd Reading AB58 Wieckowski By Anderson",36,0,3,0,39
445144,252191,2013-03-20,Assembly,"Do pass as amended and be re-referred to the Committee on 	Appropriations",6,0,0,1,7
445144,283917,2013-05-24,Assembly,"Do pass as amended",17,0,0,0,17
445144,285020,2013-05-29,Assembly,"AB 56 WEBER  Assembly Third Reading",76,0,0,3,79
445144,295951,2013-07-03,Senate,"Do pass as amended, but re-refer to the Committee on Appropriations 	Recommend Consent",9,0,0,0,9
445144,297251,2013-08-12,Senate,"Placed on Appropriations Suspense file",6,0,1,0,7
445144,298360,2013-08-30,Senate,"Do pass as amended",7,0,0,0,7
445144,299097,2013-09-09,Senate,"Assembly 3rd Reading AB56 Weber By Padilla",39,0,0,0,39
445144,299316,2013-09-10,Assembly,"AB 56 WEBER  Concurrence in Senate Amendments",78,0,0,0,78
445150,262672,2013-04-10,Assembly,"Do pass and be re-referred to the Committee on Appropriations",13,0,0,4,17
445156,271239,2013-04-23,Assembly,"Do pass and be re-referred to the Committee on Appropriations",2,4,0,1,7
445156,271240,2013-04-23,Assembly,"Set second hearing.  Failed passage.  Reconsideration granted",7,0,0,0,7
445162,271768,2013-04-23,Assembly,"Do pass as amended and be re-referred to the Committee on 	Appropriations",6,3,0,0,9
445162,283807,2013-05-24,Assembly,"Do pass as amended",12,5,0,0,17
445162,285505,2013-05-30,Assembly,"AB 53 PEREZ, J.  Assembly Third Reading",55,21,0,3,79
445162,295391,2013-07-01,Senate,"Do pass as amended, and re-refer to the Committee on Appropriations",8,1,1,0,10
445162,297290,2013-08-12,Senate,"Placed on Appropriations Suspense file",6,0,1,0,7
445162,298250,2013-08-30,Senate,"Do pass as amended",5,2,0,0,7
445162,298911,2013-09-09,Senate,"Assembly 3rd Reading AB53 John A. P",28,11,0,0,39
445162,299204,2013-09-10,Assembly,"AB 53 PEREZ, J.  Concurrence in Senate Amendments",57,19,0,2,78
446612,271606,2013-04-23,Senate,"Do pass as amended, and re-refer to the Committee on Appropriations",5,2,0,0,7
446612,278618,2013-05-13,Senate,"Placed on Appropriations Suspense file",5,0,2,0,7
446612,283250,2013-05-23,Senate,"Do pass as amended",5,2,0,0,7
446612,285006,2013-05-29,Senate,"Senate 3rd Reading SB61 Yee",24,14,1,0,39
446612,291601,2013-06-25,Assembly,"Do pass as amended and be re-referred to the Committee on 	Appropriations",5,2,0,0,7
446612,298257,2013-08-30,Assembly,"Do pass as amended",11,5,0,1,17
446632,266210,2013-04-15,Senate,"Do pass as amended, and re-refer to the Committee on Appropriations",10,0,0,0,10
446632,273501,2013-04-29,Senate,"Placed on Appropriations Suspense file",7,0,0,0,7
446632,283209,2013-05-23,Senate,"Do pass",7,0,0,0,7
446632,284562,2013-05-28,Senate,"Senate 3rd Reading SB62 Price",39,0,0,0,39
446632,291569,2013-06-25,Assembly,"Do pass as amended and be re-referred to the Committee on 	Appropriations",9,4,0,0,13
446632,298243,2013-08-30,Assembly,"Do pass as amended",12,1,0,4,17
446632,298973,2013-09-09,Assembly,"SB 62 Lieu  Senate Third Reading  By PAN",54,24,0,0,78
446632,299200,2013-09-10,Senate,"Unfinished Business SB62 Lieu Concurrence",38,0,1,0,39
446653,257458,2013-04-02,Senate,"Be adopted, but re-refer to the Committee on Appropriations 	Recommend Consent",11,0,0,0,11
446653,268713,2013-04-18,Senate,"Consent Calendar 2nd SCR6 Wolk",36,0,2,0,38
446653,297215,2013-08-12,Assembly,"Be adopted, and re-refer to Committee on Appropriations with 	recommendation:  To Consent Calendar",15,0,0,1,16
446653,297843,2013-08-21,Assembly,"Be adopted, to Consent Calendar",17,0,0,0,17
446653,298013,2013-08-26,Assembly,"SCR6 Wolk  Consent Calendar Second Day  Regular Session",77,0,0,1,78
447705,257402,2013-04-02,Assembly,"Do pass and be re-referred to the Committee on Appropriations",7,0,0,0,7
447705,262721,2013-04-10,Assembly,"Do pass as amended, to Consent Calendar",17,0,0,0,17
447705,268443,2013-04-18,Assembly,"AB 68 MAIENSCHEIN  Consent Calendar Second Day  Regular Session",76,0,0,3,79
447705,279231,2013-05-14,Senate,"Do pass, but re-refer to the Committee on Appropriations",7,0,0,0,7
447705,298806,2013-09-06,Senate,"Assembly 3rd Reading AB68 Maienschein By Wyland",39,0,0,0,39
447705,299025,2013-09-09,Assembly,"AB 68 MAIENSCHEIN  Concurrence in Senate Amendments",77,0,0,1,78
447716,217742,2013-01-14,Assembly,"From committee:  Be adopted.  To third reading",12,0,0,1,13
447716,232674,2013-02-15,Senate,"Special Consent Cal ACR2 Mitchell",32,0,6,0,38
447773,275528,2013-05-01,Senate,"Do pass, but re-refer to the Committee on Appropriations",9,0,0,0,9
447773,278868,2013-05-13,Senate,"Placed on Appropriations Suspense file",5,0,2,0,7
447785,218504,2013-01-18,Senate,"Senate 3rd Reading SCR7 Wright By Senator Price",32,0,6,0,38
449208,261684,2013-04-09,Senate,"Do pass, but re-refer to the Committee on Appropriations",7,0,0,0,7
449208,270061,2013-04-22,Senate,"Do pass as amended",6,0,1,0,7
449208,275553,2013-05-02,Senate,"Senate 3rd Reading SB107 Corbett",38,0,0,0,38
449208,288021,2013-06-11,Assembly,"Do pass and re-refer to Committee on Appropriations with 	recommendation:  To Consent Calendar",7,0,0,0,7
449208,296033,2013-07-03,Assembly,"Do pass, to Consent Calendar",17,0,0,0,17
449208,297168,2013-08-08,Assembly,"SB 107 Corbett  Consent Calendar Second Day  Regular Session",77,0,0,1,78
449209,262715,2013-04-09,Senate,"Do pass, but re-refer to the Committee on Appropriations",6,0,1,0,7
449209,273629,2013-04-29,Senate,"Special Consent #2 SB106 Monning",37,0,1,0,38
449209,287183,2013-06-04,Assembly,"Do pass and be re-referred to the Committee on Appropriations",10,0,0,0,10
449209,287794,2013-06-10,Assembly,"Do pass as amended",15,0,0,2,17
449209,289052,2013-06-14,Assembly,"SB 106 Monning  Third Reading Urgency  By STONE",79,0,0,0,79
449209,291242,2013-06-24,Senate,"Unfinished Business SB106 Monning Concurrence",39,0,0,0,39
449211,278684,2013-05-13,Senate,"Senate 3rd Reading SB105 Committee on B. & F.R. (Leno)",24,9,5,0,38
449211,298169,2013-08-29,Assembly,"Do pass as amended",23,0,0,2,25
449211,299366,2013-09-11,Senate,"Unfinished Supp 1 SB105 Steinberg Concurrence",35,2,2,0,39
449211,299367,2013-09-11,Assembly,"SB 105 Steinberg  Senate Third Reading  By PEREZ, J",78,0,0,0,78
449212,278728,2013-05-13,Senate,"Senate 3rd Reading SB104 Committee on B. & F.R. (Leno)",24,9,5,0,38
449212,331485,2014-02-27,Assembly,"SB 104 B.& F. R.  Senate Third Reading  By SKINNER",68,1,0,11,80
449212,331486,2014-02-27,Senate,"W/O REF. TO FILE SB104 Committee on B. & F.R. (Leno) Concurrence",33,3,3,0,39
449214,278796,2013-05-13,Senate,"Senate 3rd Reading SB103 Committee on B. & F.R. (Leno)",24,9,5,0,38
449214,331468,2014-02-27,Assembly,"SB 103 B.& F. R.  Senate Third Reading  By SKINNER",64,3,0,13,80
449214,331469,2014-02-27,Senate,"W/O REF. TO FILE SB103 Committee on B. & F.R. (Leno) Concurrence",34,2,3,0,39
449215,278696,2013-05-13,Senate,"Senate 3rd Reading SB102 Committee on B. & F.R. (Leno)",24,9,5,0,38
449215,298174,2013-08-29,Assembly,"Do pass",14,10,0,1,25
449215,298761,2013-09-06,Assembly,"SB 102 B.& F. R.  Senate Third Reading  By SKINNER",51,23,0,4,78
449215,299184,2013-09-10,Senate,"Unfinished Business SB102 Committee on B. & F.R. (Leno) Concurrence",34,5,0,0,39
449217,278620,2013-05-13,Senate,"Senate 3rd Reading SB101 Committee on B. & F.R. (Leno)",24,9,5,0,38
449217,298177,2013-08-29,Assembly,"Do pass",17,5,0,3,25
449217,298852,2013-09-06,Assembly,"SB 101 B.& F. R.  Senate Third Reading  By SKINNER",57,17,0,4,78
449217,299285,2013-09-10,Senate,"Unfinished Business SB101 Committee on B. & F.R. (Leno) Concurrence",26,12,1,0,39
449218,278585,2013-05-13,Senate,"Senate 3rd Reading SB100 Committee on B. & F.R. (Leno)",24,9,5,0,38
449218,298166,2013-08-29,Assembly,"Do pass",17,2,0,6,25
449218,298838,2013-09-06,Assembly,"SB 100 B.& F. R.  Senate Third Reading  By SKINNER",57,8,0,13,78
449218,299496,2013-09-11,Senate,"Unfinished Business SB100 Committee on B. & F.R. (Leno) Concurrence",35,2,2,0,39
449219,278753,2013-05-13,Senate,"Senate 3rd Reading SB99 Committee on B. & F.R. (Leno)",24,9,5,0,38
449219,298167,2013-08-29,Assembly,"Do pass",22,0,0,3,25
449219,298826,2013-09-06,Assembly,"SB 99 B.& F. R.  Senate Third Reading  By SKINNER",66,8,0,4,78
449219,299274,2013-09-10,Senate,"Unfinished Business SB99 Committee on B. & F.R. (Leno) Concurrence",32,6,1,0,39
449221,278710,2013-05-13,Senate,"Senate 3rd Reading SB98 Committee on B. & F.R. (Leno)",24,9,5,0,38
449221,298168,2013-08-29,Assembly,"Do pass",15,9,0,1,25
449221,298836,2013-09-06,Assembly,"SB 98 B.& F. R.  Senate Third Reading  By SKINNER",51,25,0,2,78
449221,299275,2013-09-10,Senate,"Unfinished Business SB98 Committee on B. & F.R. (Leno)",21,16,2,0,39
449222,278707,2013-05-13,Senate,"Senate 3rd Reading SB97 Committee on B. & F.R. (Leno)",24,9,5,0,38
449222,298181,2013-08-29,Assembly,"Do pass",14,10,0,1,25
449222,299791,2013-09-12,Senate,"Unfinished Supp 2 SB97 Committee on B. & F.R. (Leno) Concurrence",36,0,3,0,39
449222,299792,2013-09-12,Assembly,"SB 97 B.& F. R.  Senate Third Reading  By SKINNER",77,1,0,0,78
449224,278649,2013-05-13,Senate,"Senate 3rd Reading SB96 Committee on B. & F.R. (Leno)",24,9,5,0,38
449224,298180,2013-08-29,Assembly,"Do pass",14,10,0,1,25
449224,298787,2013-09-06,Assembly,"SB 96 B.& F. R.  Senate Third Reading",51,24,0,3,78
449224,299127,2013-09-10,Senate,"Unfinished Business SB96 Committee on B. & F.R. (Leno) Concurrence",25,13,1,0,39
449225,278786,2013-05-13,Senate,"Senate 3rd Reading SB95 Committee on B. & F.R. (Leno)",24,9,5,0,38
449225,298176,2013-08-29,Assembly,"Do pass",14,10,0,1,25
449225,299343,2013-09-11,Senate,"Unfinished Supp 1 SB95 Committee on B. & F.R. (Leno) Concurrence",36,0,3,0,39
449225,299344,2013-09-11,Assembly,"SB 95 B.& F. R.  Senate Third Reading  By SKINNER",53,25,0,0,78
449227,278734,2013-05-13,Senate,"Senate 3rd Reading SB94 Committee on B. & F.R. (Leno)",24,9,5,0,38
449227,289078,2013-06-15,Assembly,"SB 94 B.& F. R.  Senate Third Reading  By BLUMENFIELD",53,24,0,2,79
449227,289136,2013-06-17,Senate,"Unfinished Business SB94 Committee on B. & F.R. (Leno) Concurrence",23,8,8,0,39
449228,278655,2013-05-13,Senate,"Senate 3rd Reading SB93 Committee on B. & F.R. (Leno)",24,9,5,0,38
449229,278756,2013-05-13,Senate,"Senate 3rd Reading SB92 Committee on B. & F.R. (Leno)",24,9,5,0,38
449231,278716,2013-05-13,Senate,"Senate 3rd Reading SB91 Committee on B. & F.R. (Leno)",24,9,5,0,38
449231,290212,2013-06-20,Senate,"From committee:  That the Assembly Amendments be concurred in",13,1,2,0,16
449231,290213,2013-06-20,Assembly,"SB 91 B.& F. R.  Senate Third Reading  By BLUMENFIELD",64,14,0,1,79
449231,291198,2013-06-24,Senate,"Unfinished Business SB91 Committee on B. & F.R. (Leno) Concurrence",38,1,0,0,39
449232,278582,2013-05-13,Senate,"Senate 3rd Reading SB90 Committee on B. & F.R. (Leno)",24,9,5,0,38
449232,292195,2013-06-27,Assembly,"Do pass",7,0,0,2,9
449232,296087,2013-07-03,Senate,"From committee:  That the Assembly Amendments be concurred in",14,0,1,0,15
449232,296088,2013-07-03,Senate,"Unfinished Supp 1 SB90 Galgiani Concurrence",36,1,1,0,38
449232,296089,2013-07-03,Assembly,"SB 90 B.& F. R.  Third Reading Urgency  By SKINNER",76,0,0,2,78
449234,278566,2013-05-13,Senate,"Senate 3rd Reading SB89 Committee on B. & F.R. (Leno)",24,9,5,0,38
449234,288998,2013-06-14,Senate,"Unfinished Supp 2 SB89 Committee on B. & F.R. (Leno) Concurrence",38,0,1,0,39
449234,288999,2013-06-14,Assembly,"SB 89 B.& F. R.  Senate Third Reading  By BLUMENFIELD",62,14,0,3,79
449235,278768,2013-05-13,Senate,"Senate 3rd Reading SB88 Committee on B. & F.R. (Leno)",24,9,5,0,38
449237,278740,2013-05-13,Senate,"Senate 3rd Reading SB87 Committee on B. & F.R. (Leno)",24,9,5,0,38
449238,278708,2013-05-13,Senate,"Senate 3rd Reading SB86 Committee on B. & F.R. (Leno)",24,9,5,0,38
449239,278722,2013-05-13,Senate,"Senate 3rd Reading SB85 Committee on B. & F.R. (Leno)",24,9,5,0,38
449239,289043,2013-06-14,Senate,"Unfinished Supp 2 SB85 Committee on B. & F.R. (Leno) Concurrence",29,8,2,0,39
449239,289044,2013-06-14,Assembly,"SB 85 B.& F. R.  Senate Third Reading  By BLUMENFIELD",54,25,0,0,79
449241,278781,2013-05-13,Senate,"Senate 3rd Reading SB84 Committee on B. & F.R. (Leno)",24,9,5,0,38
449241,296055,2013-07-03,Assembly,"SB 84 B.& F. R.  Senate Third Reading  By SKINNER",50,24,0,4,78
449242,278651,2013-05-13,Senate,"Senate 3rd Reading SB83 Committee on B. & F.R. (Leno)",24,9,5,0,38
449244,278593,2013-05-13,Senate,"Senate 3rd Reading SB82 Committee on B. & F.R. (Leno)",24,9,5,0,38
449244,289008,2013-06-14,Senate,"Unfinished Supp 2 SB82 Committee on B. & F.R. (Leno) Concurrence",36,1,2,0,39
449244,289009,2013-06-14,Assembly,"SB 82 B.& F. R.  Senate Third Reading  By BLUMENFIELD",59,20,0,0,79
449245,278747,2013-05-13,Senate,"Senate 3rd Reading SB81 Committee on B. & F.R. (Leno)",24,9,5,0,38
449247,278804,2013-05-13,Senate,"Senate 3rd Reading SB80 Committee on B. & F.R. (Leno)",24,9,5,0,38
449248,278780,2013-05-13,Senate,"Senate 3rd Reading SB79 Committee on B. & F.R. (Leno)",24,9,5,0,38
449249,278725,2013-05-13,Senate,"Senate 3rd Reading SB78 Committee on B. & F.R. (Leno)",24,9,5,0,38
449249,289072,2013-06-15,Assembly,"SB 78 B.& F. R.  Senate Third Reading  By BLUMENFIELD",54,25,0,0,79
449249,289073,2013-06-15,Senate,"Unfinished Supp 1 SB78 Committee on B. & F.R. (Leno) Concurrence",27,10,2,0,39
449251,278830,2013-05-13,Senate,"Senate 3rd Reading SB77 Committee on B. & F.R. (Leno)",24,9,5,0,38
449251,289011,2013-06-14,Assembly,"SB 77 B.& F. R.  Senate Third Reading  By BLUMENFIELD  Amend By 	GAINES  Set #1  Motion to  Suspend the Rules  By BLUMENFIELD",54,21,0,4,79
449251,289012,2013-06-14,Assembly,"SB 77 B.& F. R.  Senate Third Reading  By BLUMENFIELD  Amend By 	GAINES  Set #1  Question #1  Motion to  Lay on the Table  By PEREZ, 	J",54,22,0,3,79
449251,289013,2013-06-14,Assembly,"SB 77 B.& F. R.  Senate Third Reading  By BLUMENFIELD  Amend By 	GAINES  Set #1  Question #2",0,69,0,10,79
449251,289014,2013-06-14,Assembly,"SB 77 B.& F. R.  Senate Third Reading  By BLUMENFIELD  Amend By 	GROVE  Set #2  Motion to  Lay on the Table  By ATKINS",53,24,0,2,79
449252,278828,2013-05-13,Senate,"Senate 3rd Reading SB76 Committee on B. & F.R. (Leno)",24,9,5,0,38
449252,289053,2013-06-14,Senate,"Unfinished Supp 2 SB76 Committee on B. & F.R. (Leno) Concurrence",30,8,1,0,39
449252,289054,2013-06-14,Assembly,"SB 76 B.& F. R.  Senate Third Reading  By BLUMENFIELD  Amend By 	PATTERSON  Set #1  Motion to  Lay on the Table  By ATKINS",54,25,0,0,79
449252,289055,2013-06-14,Assembly,"SB 76 B.& F. R.  Senate Third Reading  By BLUMENFIELD",54,25,0,0,79
449254,278698,2013-05-13,Senate,"Senate 3rd Reading SB75 Committee on B. & F.R. (Leno)",24,9,5,0,38
449254,289006,2013-06-14,Senate,"Unfinished Supp 2 SB75 Committee on B. & F.R. (Leno) Concurrence",35,1,3,0,39
449254,289007,2013-06-14,Assembly,"SB 75 B.& F. R.  Senate Third Reading  By BLUMENFIELD",59,16,0,4,79
449255,278672,2013-05-13,Senate,"Senate 3rd Reading SB74 Committee on B. & F.R. (Leno)",24,9,5,0,38
449255,289034,2013-06-14,Senate,"Unfinished Supp 2 SB74 Committee on B. & F.R. (Leno) Concurrence",32,4,3,0,39
449255,289035,2013-06-14,Assembly,"SB 74 B.& F. R.  Senate Third Reading  By BLUMENFIELD",59,14,0,6,79
449257,278771,2013-05-13,Senate,"Senate 3rd Reading SB73 Committee on B. & F.R. (Leno)",24,9,5,0,38
449257,289076,2013-06-15,Assembly,"SB 73 B.& F. R.  Senate Third Reading  By BLUMENFIELD",69,9,0,1,79
449257,289077,2013-06-15,Senate,"Unfinished Supp 1 SB73 Committee on B. & F.R. (Leno) Concurrence",33,1,5,0,39
449258,278616,2013-05-13,Senate,"Senate 3rd Reading SB72 Committee on B. & F.R. (Leno)",24,9,5,0,38
449258,289074,2013-06-15,Assembly,"SB 72 B.& F. R.  Senate Third Reading  By BLUMENFIELD",54,25,0,0,79
449259,278718,2013-05-13,Senate,"Senate 3rd Reading SB71 Committee on B. & F.R. (Leno)",24,9,5,0,38
449259,290218,2013-06-20,Assembly,"SB 71 B.& F. R.  Senate Third Reading  By BLUMENFIELD",54,25,0,0,79
449259,291283,2013-06-24,Senate,"Unfinished Business SB71 Committee on B. & F.R. (Leno) Concurrence",28,11,0,0,39
449261,278592,2013-05-13,Senate,"Senate 3rd Reading SB70 Committee on B. & F.R. (Leno)",24,9,5,0,38
449262,275519,2013-05-01,Senate,"Do pass as amended, and re-refer to the Committee on Appropriations",7,0,2,0,9
449262,281220,2013-05-20,Senate,"Placed on Appropriations Suspense file",6,0,1,0,7
449262,283257,2013-05-23,Senate,"Do pass as amended",5,0,2,0,7
449262,285493,2013-05-30,Senate,"Senate 3rd Reading SB69 Liu",30,6,3,0,39
449262,370074,2014-06-05,Assembly,"Be referred to Committee on Local Government",10,0,0,1,11
449262,374386,2014-06-25,Assembly,"Do pass and be re-referred to the Committee on Appropriations",9,0,0,0,9
449262,377169,2014-08-14,Assembly,"Do pass as amended",16,0,0,1,17
449262,377892,2014-08-20,Assembly,"SB 69 Roth  Senate Third Reading  By FOX",76,0,0,3,79
449262,378033,2014-08-21,Senate,"Unfinished Business SB69 Roth Concurrence",32,0,8,0,40
449264,277959,2013-05-09,Senate,"Do pass",10,2,4,0,16
449264,278626,2013-05-13,Senate,"Senate 3rd Reading SB68 Committee on B. & F.R. (Leno)",24,9,5,0,38
449264,281200,2013-05-20,Assembly,"SB 68 B.& F. R.  Senate Third Reading  By BLUMENFIELD",51,22,0,5,78
449265,277980,2013-05-09,Senate,"Do pass",10,4,2,0,16
449265,278610,2013-05-13,Senate,"Senate 3rd Reading SB67 Committee on B. & F.R. (Leno)",24,9,5,0,38
449265,281157,2013-05-20,Assembly,"SB 67 B.& F. R.  Senate Third Reading  By BLUMENFIELD",53,19,0,6,78
449267,278692,2013-05-13,Senate,"Senate 3rd Reading SB66 Committee on B. & F.R. (Leno)",24,9,5,0,38
449269,266400,2013-04-16,Senate,"Do pass as amended, and re-refer to the Committee on Appropriations",8,2,1,0,11
449269,278635,2013-05-13,Senate,"Placed on Appropriations Suspense file",5,0,2,0,7
449269,283106,2013-05-23,Senate,"Do pass as amended",5,0,2,0,7
449269,284954,2013-05-29,Senate,"Senate 2nd Reading SB64 Corbett",30,7,2,0,39
449269,291215,2013-06-24,Assembly,"Be referred to Committee on Natural Resources",9,0,0,2,11
449269,374859,2014-06-26,Assembly,"Do pass as amended and be re-referred to the Committee on 	Appropriations",6,3,0,0,9
449273,250551,2013-03-18,Assembly,"Do pass",22,1,0,4,27
449273,250552,2013-03-18,Assembly,"AB 113 BUDGET  Assembly Third Reading  By BLUMENFIELD",71,1,0,8,80
449273,268683,2013-04-18,Senate,"Do pass as amended",10,1,5,0,16
449273,272334,2013-04-25,Senate,"Assembly 3rd Reading AB113 Committee on BUDGET (Blumenfield) By Leno",25,10,3,0,38
449273,273657,2013-04-29,Assembly,"AB 113 BUDGET  Concurrence in Senate Amendments By BLUMENFIELD",69,6,0,4,79
449274,277998,2013-05-09,Assembly,"Do pass",16,9,0,2,27
449275,277965,2013-05-09,Assembly,"Do pass",18,7,0,2,27
449277,278671,2013-05-13,Assembly,"AB 110 BUDGET  Assembly Third Reading  By BLUMENFIELD",51,24,0,4,79
449277,285146,2013-05-29,Senate,"Assembly 3rd Reading AB110 Committee on BUDGET (Blumenfield)",26,11,2,0,39
449277,285580,2013-05-30,Assembly,"AB 110 BUDGET  Concurrence in Senate Amendments By BLUMENFIELD",1,77,0,1,79
449277,289019,2013-06-14,Assembly,"AB 110 BLUMENFIELD  Conference Report",54,25,0,0,79
449277,289020,2013-06-14,Senate,"Conference Reports AB110 Blumenfield By Leno",28,10,1,0,39
449278,278639,2013-05-13,Assembly,"AB 109 BUDGET  Assembly Third Reading  By BLUMENFIELD",51,24,0,4,79
449280,278789,2013-05-13,Assembly,"AB 108 BUDGET  Assembly Third Reading  By BLUMENFIELD",51,24,0,4,79
449280,298998,2013-09-09,Senate,"Do pass",13,1,2,0,16
449281,278843,2013-05-13,Assembly,"AB 107 BUDGET  Assembly Third Reading  By BLUMENFIELD",51,24,0,4,79
449281,298179,2013-08-29,Senate,"Do pass",10,3,2,0,15
449283,278787,2013-05-13,Assembly,"AB 106 BUDGET  Assembly Third Reading  By BLUMENFIELD",51,24,0,4,79
449283,298991,2013-09-09,Senate,"Do pass",10,5,1,0,16
449283,299478,2013-09-11,Senate,"Assembly 2nd Reading AB106 Committee on BUDGET (Skinner) By Leno",39,0,0,0,39
449283,299699,2013-09-12,Assembly,"AB 106 BUDGET  Concurrence in Senate Amendments By SKINNER",78,0,0,0,78
449284,278741,2013-05-13,Assembly,"AB 105 BUDGET  Assembly Third Reading  By BLUMENFIELD",51,24,0,4,79
449284,298170,2013-08-29,Senate,"Do pass",10,1,4,0,15
449284,298171,2013-08-29,Senate,"Do pass as amended",10,1,4,0,15
449285,278711,2013-05-13,Assembly,"AB 104 BUDGET  Assembly Third Reading  By BLUMENFIELD",51,24,0,4,79
449287,278746,2013-05-13,Assembly,"AB 103 BUDGET  Assembly Third Reading  By BLUMENFIELD",51,24,0,4,79
449287,298995,2013-09-09,Senate,"Do pass as amended",10,2,4,0,16
449288,278603,2013-05-13,Assembly,"AB 102 BUDGET  Assembly Third Reading  By BLUMENFIELD",51,24,0,4,79
449288,298172,2013-08-29,Senate,"Do pass",5,6,4,0,15
449288,298173,2013-08-29,Senate,"Set, first hearing.  Failed passage in Committee.  Reconsideration 	granted",15,0,0,0,15
449288,298999,2013-09-09,Senate,"Do pass",10,5,1,0,16
449290,278700,2013-05-13,Assembly,"AB 101 BUDGET  Assembly Third Reading  By BLUMENFIELD",51,24,0,4,79
449290,298164,2013-08-29,Senate,"Do pass as amended",10,5,0,0,15
449290,299678,2013-09-12,Senate,"Assembly 3rd Supp 1 AB101 Committee on BUDGET (Skinner) By Leno",35,2,2,0,39
449290,299679,2013-09-12,Assembly,"AB 101 BUDGET  Concurrence in Senate Amendments By SKINNER",53,25,0,0,78
449291,278624,2013-05-13,Assembly,"AB 100 BUDGET  Assembly Third Reading  By BLUMENFIELD",51,24,0,4,79
449293,278636,2013-05-13,Assembly,"AB 99 BUDGET  Assembly Third Reading  By BLUMENFIELD",51,24,0,4,79
449294,278560,2013-05-13,Assembly,"AB 98 BUDGET  Assembly Third Reading  By BLUMENFIELD",51,24,0,4,79
449294,289049,2013-06-14,Senate,"Assembly 3rd Reading AB98 Committee on BUDGET (Blumenfield) Urgency 	Clause",28,9,2,0,39
449294,289050,2013-06-14,Assembly,"AB 98 BUDGET  Concurrence- Urgency Added  By BLUMENFIELD",54,24,0,1,79
449295,278742,2013-05-13,Assembly,"AB 97 BUDGET  Assembly Third Reading  By BLUMENFIELD",51,24,0,4,79
449295,289026,2013-06-14,Senate,"Assembly 3rd Reading AB97 Committee on BUDGET (Blumenfield) Lay on 	Table",27,9,3,0,39
449295,289027,2013-06-14,Senate,"Assembly 3rd Reading AB97 Committee on BUDGET (Blumenfield) By Leno",38,0,1,0,39
449295,289028,2013-06-14,Assembly,"AB 97 BUDGET  Concurrence in Senate Amendments By BLUMENFIELD",65,12,0,2,79
449297,278605,2013-05-13,Assembly,"AB 96 BUDGET  Assembly Third Reading  By BLUMENFIELD",51,24,0,4,79
449298,278652,2013-05-13,Assembly,"AB 95 BUDGET  Assembly Third Reading  By BLUMENFIELD",51,24,0,4,79
449300,278769,2013-05-13,Assembly,"AB 94 BUDGET  Assembly Third Reading  By BLUMENFIELD",51,24,0,4,79
449300,289069,2013-06-15,Senate,"Assembly 3rd Reading AB94 Committee on BUDGET (Blumenfield) By Leno",37,0,2,0,39
449300,289070,2013-06-15,Assembly,"AB 94 BUDGET  Concurrence in Senate Amendments By BLUMENFIELD",65,9,0,5,79
449301,278659,2013-05-13,Assembly,"AB 93 BUDGET  Assembly Third Reading  By BLUMENFIELD",51,24,0,4,79
449301,291243,2013-06-24,Senate,"Do pass as amended",9,5,2,0,16
449301,291620,2013-06-25,Senate,"Assembly 3rd Reading AB93 Committee on BUDGET (Blumenfield) By Wolk",30,9,0,0,39
449301,292142,2013-06-27,Assembly,"Senate amendments be concurred in",7,0,0,2,9
449301,292143,2013-06-27,Assembly,"AB 93 BUDGET  Concurrence- Urgency Added  By BLUMENFIELD",54,16,0,9,79
449303,278750,2013-05-13,Assembly,"AB 92 BUDGET  Assembly Third Reading  By BLUMENFIELD",51,24,0,4,79
449303,289047,2013-06-14,Senate,"Assembly 3rd Reading AB92 Committee on BUDGET (Blumenfield) By Leno",37,1,1,0,39
449303,289048,2013-06-14,Assembly,"AB 92 BUDGET  Concurrence in Senate Amendments By BLUMENFIELD",55,23,0,1,79
449304,278770,2013-05-13,Assembly,"AB 91 BUDGET  Assembly Third Reading  By BLUMENFIELD",51,24,0,4,79
449305,278727,2013-05-13,Assembly,"AB 90 BUDGET  Assembly Third Reading  By BLUMENFIELD",51,24,0,4,79
449307,278797,2013-05-13,Assembly,"AB 89 BUDGET  Assembly Third Reading  By BLUMENFIELD",51,24,0,4,79
449307,289037,2013-06-14,Senate,"Assembly 3rd Reading AB89 Committee on BUDGET (Blumenfield) By Leno",36,2,1,0,39
449307,289038,2013-06-14,Assembly,"AB 89 BUDGET  Concurrence in Senate Amendments By BLUMENFIELD",63,15,0,1,79
449308,263461,2013-04-11,Assembly,"Be referred to Committee on Education",10,1,0,0,11
449308,275591,2013-05-01,Assembly,"Amend, and re-refer to the Committee on Education",7,0,0,0,7
449310,278702,2013-05-13,Assembly,"AB 87 BUDGET  Assembly Third Reading  By BLUMENFIELD",51,24,0,4,79
449311,278815,2013-05-13,Assembly,"AB 86 BUDGET  Assembly Third Reading  By BLUMENFIELD",51,24,0,4,79
449311,289029,2013-06-14,Senate,"Assembly 3rd Supp 1 AB86 Committee on BUDGET (Blumenfield) Lay on 	Table",26,9,4,0,39
449311,289030,2013-06-14,Senate,"Assembly 3rd Supp 1 AB86 Committee on BUDGET (Blumenfield) By Leno",33,3,3,0,39
449311,289075,2013-06-15,Assembly,"AB 86 BUDGET  Concurrence in Senate Amendments By BLUMENFIELD",61,16,0,2,79
449313,278820,2013-05-13,Assembly,"AB 85 BUDGET  Assembly Third Reading  By BLUMENFIELD",51,24,0,4,79
449313,289060,2013-06-15,Senate,"Assembly 3rd Reading AB85 Committee on BUDGET (Blumenfield) By Leno",24,11,4,0,39
449313,289061,2013-06-15,Assembly,"AB 85 BUDGET  Concurrence in Senate Amendments By BLUMENFIELD",53,23,0,3,79
449314,278674,2013-05-13,Assembly,"AB 84 BUDGET  Assembly Third Reading  By BLUMENFIELD",51,24,0,4,79
449314,298725,2013-09-04,Senate,"Do pass as amended",11,5,0,0,16
449315,278831,2013-05-13,Assembly,"AB 83 BUDGET  Assembly Third Reading  By BLUMENFIELD",51,24,0,4,79
449317,278824,2013-05-13,Assembly,"AB 82 BUDGET  Assembly Third Reading  By BLUMENFIELD",51,24,0,4,79
449317,289081,2013-06-15,Senate,"Assembly 3rd Reading AB82 Committee on BUDGET (Blumenfield) Lay on 	Table",25,8,6,0,39
449317,289082,2013-06-15,Senate,"Assembly 3rd Reading AB82 Committee on BUDGET (Blumenfield) Lay on 	Table",23,10,6,0,39
449317,289083,2013-06-15,Senate,"Assembly 3rd Reading AB82 Committee on BUDGET (Blumenfield) By Leno",36,0,3,0,39
449317,289084,2013-06-15,Assembly,"AB 82 BUDGET  Concurrence in Senate Amendments By BLUMENFIELD",72,3,0,4,79
449318,278731,2013-05-13,Assembly,"AB 81 BUDGET  Assembly Third Reading  By BLUMENFIELD",51,24,0,4,79
449318,295986,2013-07-03,Senate,"Assembly 3rd Reading AB81 Committee on BUDGET (Blumenfield) Urgency 	Clause",37,0,1,0,38
449318,297172,2013-08-08,Assembly,"AB 81 BUDGET  Concurrence in Senate Amendments By SKINNER",76,0,0,2,78
449320,278629,2013-05-13,Assembly,"AB 80 BUDGET  Assembly Third Reading  By BLUMENFIELD",51,24,0,4,79
449320,330421,2014-02-26,Senate,"Do pass as amended",12,0,4,0,16
449321,278757,2013-05-13,Assembly,"AB 79 BUDGET  Assembly Third Reading  By BLUMENFIELD",51,24,0,4,79
449321,330470,2014-02-26,Senate,"Do pass as amended",12,0,4,0,16
449321,330471,2014-02-26,Senate,"Do pass as amended",12,0,4,0,16
449323,278713,2013-05-13,Assembly,"AB 78 BUDGET  Assembly Third Reading  By BLUMENFIELD",51,24,0,4,79
449324,278638,2013-05-13,Assembly,"AB 77 BUDGET  Assembly Third Reading  By BLUMENFIELD",51,24,0,4,79
449324,289002,2013-06-14,Senate,"Assembly 2nd Reading AB77 Committee on BUDGET (Blumenfield) Lay on 	Table",27,10,2,0,39
449324,289003,2013-06-14,Senate,"Assembly 2nd Reading AB77 Committee on BUDGET (Blumenfield) By Leno",10,19,10,0,39
449324,289004,2013-06-14,Senate,"Assembly 2nd Reading AB77 Committee on BUDGET (Blumenfield) 	Reconsider",38,0,1,0,39
449324,289068,2013-06-15,Senate,"Assembly 3rd Reading AB77 Committee on BUDGET (Blumenfield) By Leno",25,10,4,0,39
449324,290305,2013-06-20,Assembly,"AB 77 BUDGET  Concurrence in Senate Amendments By BLUMENFIELD",2,77,0,0,79
449325,278679,2013-05-13,Assembly,"AB 76 BUDGET  Assembly Third Reading  By BLUMENFIELD",51,24,0,4,79
449325,289056,2013-06-14,Senate,"Assembly 3rd Reading AB76 Committee on BUDGET (Blumenfield) By Leno",23,11,5,0,39
449325,289057,2013-06-14,Assembly,"AB 76 BUDGET  Concurrence in Senate Amendments By BLUMENFIELD",53,25,0,1,79
449327,278660,2013-05-13,Assembly,"AB 75 BUDGET  Assembly Third Reading  By BLUMENFIELD",51,24,0,4,79
449327,289024,2013-06-14,Senate,"Assembly 3rd Reading AB75 Committee on BUDGET (Blumenfield) By Leno",38,0,1,0,39
449327,289025,2013-06-14,Assembly,"AB 75 BUDGET  Concurrence in Senate Amendments By BLUMENFIELD",68,9,0,2,79
449328,278552,2013-05-13,Assembly,"AB 74 BUDGET  Assembly Third Reading  By BLUMENFIELD",51,24,0,4,79
449328,289032,2013-06-14,Senate,"Assembly 3rd Reading AB74 Committee on BUDGET (Blumenfield) By Leno",28,10,1,0,39
449328,289033,2013-06-14,Assembly,"AB 74 BUDGET  Concurrence in Senate Amendments By BLUMENFIELD",54,25,0,0,79
449331,258747,2013-04-03,Assembly,"Do pass",9,0,0,0,9
449331,263566,2013-04-11,Assembly,"AB 72 HOLDEN  Assembly Third Reading",75,0,0,4,79
449331,279655,2013-05-15,Senate,"Do pass and be placed on the Consent Calendar",7,0,0,0,7
449331,283975,2013-05-24,Senate,"Consent Calendar 2nd AB72 Holden",36,0,3,0,39
449332,257606,2013-04-02,Assembly,"Do pass and be re-referred to the Committee on Appropriations",15,0,0,0,15
449332,262736,2013-04-10,Assembly,"Do pass",17,0,0,0,17
449332,272395,2013-04-25,Assembly,"AB 71 PEREZ, V.M.  Assembly Third Reading",76,0,0,3,79
449332,288383,2013-06-11,Senate,"Do pass, but re-refer to the Committee on Appropriations",8,1,0,0,9
449332,291414,2013-06-24,Senate,"Placed on Appropriations Suspense file",7,0,0,0,7
449332,298507,2013-08-30,Senate,"Do pass as amended",5,2,0,0,7
449332,299083,2013-09-09,Senate,"Assembly 3rd Reading AB71 V. Manuel P",31,7,1,0,39
449332,299223,2013-09-10,Assembly,"AB 71 PEREZ, V.M.  Concurrence in Senate Amendments",78,0,0,0,78
449334,245388,2013-03-12,Assembly,"Do pass and be re-referred to the Committee on Appropriations",5,2,0,0,7
449334,262960,2013-04-10,Assembly,"Do pass",12,5,0,0,17
449334,265489,2013-04-15,Assembly,"AB 69 PEREA  Assembly Third Reading",53,23,0,3,79
451476,218265,2012-12-03,Senate,"W/O REF. TO FILE SR4 Steinberg",38,0,1,0,39
451664,217945,2013-01-07,Senate,"W/O REF. TO FILE SR7 Steinberg",37,0,0,0,37
451728,229838,2013-02-11,Senate,"Senate 3rd Reading SR8 Yee",31,0,7,0,38
451790,223388,2013-01-28,Senate,"Senate 3rd Reading SR9 Huff",27,0,11,0,38
452005,266330,2013-04-15,Assembly,"Do pass as amended and be re-referred to the Committee on Utilities 	and Commerce",6,0,0,3,9
452005,274158,2013-04-29,Assembly,"Do pass as amended and be re-referred to the Committee on 	Appropriations",14,0,0,1,15
452005,283773,2013-05-24,Assembly,"Do pass",16,0,0,1,17
452005,284647,2013-05-28,Assembly,"AB 114 SALAS  Assembly Third Reading",75,2,0,2,79
452005,288403,2013-06-12,Senate,"Do pass, but re-refer to the Committee on Energy, Utilities and 	Communications",4,0,1,0,5
452005,295819,2013-07-02,Senate,"Do pass as amended, and re-refer to the Committee on Appropriations",9,2,0,0,11
452015,245577,2013-03-12,Assembly,"Do pass and be re-referred to the Committee on Appropriations",7,0,0,0,7
452015,262699,2013-04-10,Assembly,"Do pass, to Consent Calendar",17,0,0,0,17
452015,268625,2013-04-18,Assembly,"AB 115 PEREA  Consent Calendar Second Day  Regular Session",76,0,0,3,79
452015,288375,2013-06-12,Senate,"Do pass as amended, and re-refer to the Committee on 	Appropriations",9,0,0,0,9
452015,295658,2013-07-01,Senate,"Placed on Appropriations Suspense file",6,0,1,0,7
452015,298484,2013-08-30,Senate,"Do pass",7,0,0,0,7
452015,299296,2013-09-10,Senate,"Assembly 3rd Reading AB115 Perea By Wolk",36,0,3,0,39
452015,299550,2013-09-11,Assembly,"AB 115 PEREA  Concurrence in Senate Amendments",78,0,0,0,78
452026,258447,2013-04-03,Assembly,"Do pass and be re-referred to the Committee on Housing and 	Community Development",9,0,0,0,9
452026,267207,2013-04-17,Assembly,"Do pass and be re-referred to the Committee on Appropriations",7,0,0,0,7
452026,274776,2013-05-01,Assembly,"Do pass, to Consent Calendar",17,0,0,0,17
452026,281268,2013-05-20,Assembly,"AB 116 BOCANEGRA  Third Reading Urgency",75,0,0,3,78
452026,287188,2013-06-05,Senate,"Do pass, but re-refer to the Committee on Appropriations",7,0,0,0,7
452026,295402,2013-07-01,Senate,"Assembly 3rd Reading AB116 Bocanegra Urgency Clause",36,0,2,0,38
452036,258526,2013-04-03,Assembly,"Do pass and be re-referred to the Committee on Appropriations",13,0,0,0,13
452036,267502,2013-04-17,Assembly,"Do pass, to Consent Calendar",17,0,0,0,17
452036,272461,2013-04-25,Assembly,"AB 117 COOLEY  Consent Calendar Second Day  Regular Session",76,0,0,3,79
452036,288144,2013-06-11,Senate,"Do pass, but re-refer to the Committee on Governance and Finance",10,0,1,0,11
452036,296161,2013-07-03,Senate,"Do pass, but re-refer to the Committee on Appropriations Recommend 	Consent",7,0,0,0,7
452036,297588,2013-08-15,Senate,"Consent Calendar 2nd AB117 Cooley",38,0,1,0,39
452047,245639,2013-03-12,Assembly,"Do pass and be re-referred to the Committee on Appropriations",7,0,0,0,7
452047,283875,2013-05-24,Assembly,"Do pass",17,0,0,0,17
452047,284842,2013-05-28,Assembly,"AB 118 E.S.& T.M.  Assembly Third Reading  By ALEJO",78,0,0,1,79
452047,288560,2013-06-12,Senate,"Do pass as amended, and re-refer to the Committee on Health",9,0,0,0,9
452047,291903,2013-06-26,Senate,"Do pass, but re-refer to the Committee on Appropriations",9,0,0,0,9
452047,297357,2013-08-12,Senate,"Placed on Appropriations Suspense file",6,0,1,0,7
452047,298501,2013-08-30,Senate,"Do pass",7,0,0,0,7
452047,299746,2013-09-12,Assembly,"AB 118 E.S.& T.M.  Concurrence in Senate Amendments By ALEJO",77,0,0,1,78
452047,299747,2013-09-12,Senate,"Special Consent #10 AB118 Committee on E.S. & T.M.(Alejo) By Monning",39,0,0,0,39
452057,245549,2013-03-12,Assembly,"Do pass and be re-referred to the Committee on Health",7,0,0,0,7
452057,262668,2013-04-09,Assembly,"Do pass as amended and be re-referred to the Committee on 	Appropriations",19,0,0,0,19
452057,275045,2013-05-01,Assembly,"Do pass, to Consent Calendar",17,0,0,0,17
452057,278567,2013-05-13,Assembly,"AB 119 E.S.& T.M.  Assembly Third Reading  By ALEJO",73,0,0,6,79
452057,288633,2013-06-12,Senate,"Do pass as amended, and re-refer to the Committee on Health",9,0,0,0,9
452057,291963,2013-06-26,Senate,"Do pass as amended, and re-refer to the Committee on 	Appropriations",9,0,0,0,9
452057,297713,2013-08-19,Senate,"Do pass as amended",7,0,0,0,7
452057,298984,2013-09-09,Senate,"Assembly 3rd Reading AB119 Committee on E.S. & T.M.(Alejo) By 	Anderson",39,0,0,0,39
452057,299290,2013-09-10,Assembly,"AB 119 E.S.& T.M.  Concurrence in Senate Amendments By ALEJO",75,0,0,3,78
452068,245642,2013-03-12,Assembly,"Do pass and be re-referred to the Committee on Appropriations",7,0,0,0,7
452068,284011,2013-05-24,Assembly,"Do pass",17,0,0,0,17
452068,284725,2013-05-28,Assembly,"AB 120 E.S.& T.M.  Assembly Third Reading  By ALEJO",78,0,0,1,79
452068,290056,2013-06-19,Senate,"Do pass, but re-refer to the Committee on Appropriations Recommend 	Consent",9,0,0,0,9
452068,295346,2013-07-01,Senate,"Placed on Appropriations Suspense file",6,0,1,0,7
452068,298316,2013-08-30,Senate,"Do pass",7,0,0,0,7
452068,299088,2013-09-09,Senate,"Assembly 3rd Reading AB120 Committee on E.S. & T.M.(Alejo) By Hill",39,0,0,0,39
452077,262722,2013-04-10,Assembly,"Do pass as amended",7,2,0,0,9
452077,269912,2013-04-22,Assembly,"AB 121 DICKINSON  Assembly Third Reading",58,18,0,3,79
452077,280146,2013-05-15,Senate,"Do pass",7,0,0,0,7
452077,297581,2013-08-15,Senate,"Assembly 3rd Reading AB121 Dickinson By Huff",37,0,2,0,39
452077,297960,2013-08-22,Assembly,"AB 121 DICKINSON  Concurrence in Senate Amendments",60,16,0,2,78
452087,261705,2013-04-08,Assembly,"Do pass and be re-referred to the Committee on Utilities and 	Commerce",8,3,0,1,12
452087,274103,2013-04-29,Assembly,"Do pass and be re-referred to the Committee on Appropriations",10,5,0,0,15
452098,252181,2013-03-20,Assembly,"Do pass as amended and be re-referred to the Committee on 	Appropriations",6,0,0,1,7
452098,283809,2013-05-24,Assembly,"Do pass as amended",13,0,0,4,17
452098,284965,2013-05-29,Assembly,"AB 123 BONTA  Assembly Third Reading",68,0,0,11,79
452098,289855,2013-06-19,Senate,"Do pass, but re-refer to the Committee on Appropriations",9,0,0,0,9
452098,295252,2013-07-01,Senate,"Placed on Appropriations Suspense file",6,0,1,0,7
452098,298256,2013-08-30,Senate,"Do pass",7,0,0,0,7
452098,298965,2013-09-09,Senate,"Assembly 3rd Reading AB123 Bonta By Lara",36,1,2,0,39
452108,266568,2013-04-15,Assembly,"Do pass and be re-referred to the Committee on Appropriations",6,2,0,1,9
452119,263359,2013-04-10,Assembly,"Do pass and re-refer to Committee on Appropriations with 	recommendation:  To Consent Calendar",7,0,0,0,7
452119,284063,2013-05-24,Assembly,"Do pass as amended",17,0,0,0,17
452119,285209,2013-05-29,Assembly,"AB 125 WIECKOWSKI  Assembly Third Reading",75,1,0,3,79
452119,291221,2013-06-24,Senate,"Do pass, but re-refer to the Committee on Appropriations",5,0,0,0,5
452119,297365,2013-08-12,Senate,"Placed on Appropriations Suspense file",6,0,1,0,7
452119,298489,2013-08-30,Senate,"Do pass",7,0,0,0,7
452119,379062,2014-08-30,Senate,"Assembly 3rd Supp 7 AB125 Eggman Urgency Clause",35,0,5,0,40
452140,274241,2013-04-29,Assembly,"Do pass and be re-referred to the Committee on Appropriations",6,3,0,0,9
452140,283932,2013-05-24,Assembly,"Do pass",12,5,0,0,17
452140,285615,2013-05-30,Assembly,"AB 127 SKINNER  Assembly Third Reading",49,26,0,4,79
452140,291235,2013-06-24,Senate,"Do pass, but re-refer to the Committee on Rules",6,1,3,0,10
452140,297241,2013-08-12,Senate,"Placed on Appropriations Suspense file",6,0,1,0,7
452140,298506,2013-08-30,Senate,"Do pass as amended",5,2,0,0,7
452140,299352,2013-09-11,Assembly,"AB 127 SKINNER  Concurrence in Senate Amendments",76,2,0,0,78
452140,299353,2013-09-11,Senate,"Assembly 3rd Reading AB127 Skinner By De Le",29,7,3,0,39
452150,274237,2013-04-29,Assembly,"Be adopted, and re-refer to Committee on Appropriations with 	recommendation:  To Consent Calendar",16,0,0,0,16
452150,277469,2013-05-08,Assembly,"Be adopted, to Consent Calendar",17,0,0,0,17
452150,280239,2013-05-16,Assembly,"ACR3 LOGUE  Consent Calendar Second Day  Regular Session",70,0,0,9,79
452150,286860,2013-06-04,Senate,"Be adopted, but re-refer to the Committee on Appropriations 	Recommend Consent",10,0,1,0,11
452150,296221,2013-07-08,Senate,"Consent Calendar 2nd ACR3 Logue",29,0,9,0,38
452150,297164,2013-08-08,Assembly,"ACR3 LOGUE  Concurrence in Senate Amendments",74,0,0,4,78
452160,241584,2013-03-05,Assembly,"Be adopted",9,0,0,0,9
452160,243449,2013-03-07,Assembly,"AJR4 HUESO  Assembly Third Reading",75,0,0,5,80
452160,262666,2013-04-09,Senate,"Be adopted and be placed on the Consent Calendar",10,0,1,0,11
452160,268798,2013-04-18,Senate,"Consent Calendar 2nd AJR4 Hueso",36,0,2,0,38
452160,272416,2013-04-25,Assembly,"AJR4  Concurrence in Senate Amendments By PEREZ, V.M",77,0,0,2,79
452171,267315,2013-04-16,Senate,"Do pass, but re-refer to the Committee on Appropriations",5,2,0,0,7
452171,284589,2013-05-28,Senate,"Senate 3rd Reading SB108 Yee",21,17,1,0,39
452171,297887,2013-08-15,Assembly,"Subject matter be referred",7,0,0,0,7
452181,257358,2013-04-02,Senate,"Do pass as amended",11,0,0,0,11
452181,263466,2013-04-11,Senate,"Senate 3rd Reading SB109 Corbett",37,0,1,0,38
452181,289246,2013-06-17,Assembly,"Do pass and be re-referred to the Committee on Appropriations",10,3,0,3,16
452181,296121,2013-07-03,Assembly,"Do pass",12,5,0,0,17
452181,299232,2013-09-10,Assembly,"SB 109 Corbett  Senate Third Reading  By LOWENTHAL",49,28,0,1,78
452181,299826,2013-09-12,Senate,"From committee:  That the Assembly Amendments be concurred in",11,0,0,0,11
452181,299827,2013-09-12,Senate,"Unfinished Supp 2 SB109 Corbett Concurrence",35,3,1,0,39
452192,257667,2013-04-02,Senate,"Do pass, but re-refer to the Committee on Appropriations Recommend 	Consent",11,0,0,0,11
452192,265300,2013-04-15,Senate,"Do pass",7,0,0,0,7
452192,269945,2013-04-22,Senate,"Special Consent #1 SB110 Steinberg",38,0,0,0,38
452192,289134,2013-06-17,Assembly,"Be referred to Committee on Transportation",9,0,0,2,11
452192,291680,2013-06-25,Assembly,"Do pass and be re-referred to the Committee on Transportation",10,0,0,0,10
452192,295787,2013-07-01,Assembly,"Do pass as amended and be re-referred to the Committee on 	Appropriations",13,0,0,3,16
452192,297451,2013-08-14,Assembly,"Do pass",17,0,0,0,17
452192,297770,2013-08-19,Assembly,"SB 110 DeSaulnier  Third Reading Urgency  By AMMIANO",76,0,0,2,78
452192,297928,2013-08-22,Senate,"From committee:  That the Assembly Amendments be concurred in",8,0,3,0,11
452192,298038,2013-08-26,Senate,"Unfinished Business SB110 DeSaulnier Concurrence",37,0,2,0,39
452202,221249,2013-01-24,Senate,"Special Consent SCR8 DeSaulnier",28,0,10,0,38
452202,252206,2013-03-21,Assembly,"From committee:  Be adopted.  To third reading",11,0,0,0,11
452202,276279,2013-05-06,Senate,"Special Consent #3 SCR8 DeSaulnier",32,0,6,0,38
452212,257420,2013-04-02,Senate,"Be adopted",5,2,0,0,7
452212,261066,2013-04-08,Senate,"Senate 3rd Reading SR10 Jackson",27,6,5,0,38
454929,249096,2013-03-12,Assembly,"Do pass and be re-referred to the Committee on Appropriations",6,0,0,1,7
454929,283881,2013-05-24,Assembly,"Do pass",10,1,0,6,17
454929,284794,2013-05-28,Assembly,"AB 128 BRADFORD  Assembly Third Reading",62,4,0,13,79
454929,288067,2013-06-11,Senate,"Do pass, but re-refer to the Committee on Appropriations",3,3,1,0,7
454929,288068,2013-06-11,Senate,"Set, first hearing.  Failed passage in Committee.  Reconsideration 	granted",6,0,1,0,7
454929,291611,2013-06-25,Senate,"Do pass, but re-refer to the Committee on Appropriations",4,2,1,0,7
454929,297408,2013-08-12,Senate,"Placed on Appropriations Suspense file",6,0,1,0,7
454929,298347,2013-08-30,Senate,"Do pass as amended",5,0,2,0,7
454929,299180,2013-09-10,Senate,"Assembly 3rd Reading AB128 Bradford By De Le",30,7,2,0,39
454929,299416,2013-09-11,Assembly,"AB 128 BRADFORD  Concurrence in Senate Amendments",73,0,0,5,78
454968,307156,2014-01-09,Assembly,"Be referred to Committee on Banking and Finance",7,4,0,0,11
454968,310757,2014-01-21,Assembly,"Do pass as amended",10,0,0,2,12
454968,313192,2014-01-29,Assembly,"AB 129 DICKINSON  Assembly Third Reading",75,0,0,5,80
454968,369936,2014-06-04,Senate,"Do pass",7,1,1,0,9
454968,373236,2014-06-19,Senate,"Assembly 3rd Reading AB129 Dickinson By Hill",28,3,9,0,40
454968,373746,2014-06-23,Assembly,"AB 129 DICKINSON  Concurrence in Senate Amendments",52,11,0,16,79
455006,258492,2013-04-03,Assembly,"Do pass and be re-referred to the Committee on Health",9,0,0,0,9
455006,276790,2013-05-07,Assembly,"Do pass, to Consent Calendar",18,0,0,1,19
455006,278554,2013-05-13,Assembly,"AB 130 ALEJO  Consent Calendar Second Day  Regular Session",75,0,0,4,79
455006,288726,2013-06-12,Senate,"Do pass and be placed on the Consent Calendar",6,0,1,0,7
455006,291205,2013-06-24,Senate,"Consent Calendar 2nd AB130 Alejo",39,0,0,0,39
455006,292171,2013-06-27,Assembly,"AB 130 ALEJO  Concurrence in Senate Amendments",77,0,0,2,79
455044,251132,2013-03-19,Assembly,"Do pass",5,1,0,1,7
455044,259648,2013-04-04,Assembly,"AB 131 WILLIAMS  Assembly Third Reading",47,23,0,9,79
455044,286825,2013-06-04,Senate,"Do pass",3,1,1,0,5
455044,295701,2013-07-01,Senate,"Assembly 3rd Reading AB131 Williams By Yee",26,10,2,0,38
455083,221447,2013-01-24,Assembly,"From committee:  Be adopted.  To third reading",9,0,0,4,13
455083,223026,2013-01-24,Assembly,"From committee:  Be adopted.  To third reading",9,0,0,2,11
455083,232774,2013-02-15,Senate,"Special Consent Cal ACR4 Buchanan",32,0,6,0,38
455121,257627,2013-04-02,Senate,"Do pass, but re-refer to the Committee on Appropriations",4,1,0,0,5
455121,268746,2013-04-18,Senate,"Senate 3rd Reading SB111 Beall",36,0,2,0,38
455121,288354,2013-06-11,Assembly,"Do pass and re-refer to Committee on Appropriations with 	recommendation:  To Consent Calendar",6,0,0,1,7
455121,296038,2013-07-03,Assembly,"Do pass, to Consent Calendar",17,0,0,0,17
455121,297158,2013-08-08,Assembly,"SB 111 Beall  Consent Calendar Second Day  Regular Session",77,0,0,1,78
455159,274862,2013-04-30,Senate,"Do pass",5,0,0,0,5
455159,278550,2013-05-13,Senate,"Special Consent #4 SB112 Monning",34,0,4,0,38
455159,288165,2013-06-11,Assembly,"Do pass",5,1,0,1,7
455159,295705,2013-07-01,Assembly,"SB 112 Monning  Senate Third Reading  By PEREA",72,1,0,5,78
455159,296232,2013-07-08,Senate,"Unfinished Business SB112 Monning Concurrence",29,0,9,0,38
455198,257441,2013-04-02,Senate,"Do pass, but re-refer to the Committee on Appropriations",4,1,0,0,5
455198,265530,2013-04-15,Senate,"Placed on Appropriations Suspense file",7,0,0,0,7
455198,311112,2014-01-23,Senate,"Do pass",5,1,1,0,7
455198,312702,2014-01-28,Senate,"Senate 3rd Reading SB113 Jackson",24,8,7,0,39
455198,374530,2014-06-24,Assembly,"Do pass as amended and be re-referred to the Committee on 	Appropriations",5,1,0,1,7
455198,376673,2014-08-06,Assembly,"Do pass",12,4,0,1,17
455198,378284,2014-08-25,Assembly,"SB 113 Jackson  Senate Third Reading  By MULLIN",54,21,0,4,79
455198,378554,2014-08-26,Senate,"Unfinished Supp 1 SB113 Jackson Concurrence",22,12,6,0,40
455236,257735,2013-04-02,Senate,"Do pass as amended",7,0,0,0,7
455236,263549,2013-04-11,Senate,"Senate 3rd Reading SB114 Pavley",37,0,1,0,38
455236,288330,2013-06-11,Assembly,"Do pass, to Consent Calendar",7,0,0,0,7
455236,289085,2013-06-15,Assembly,"SB 114 Pavley  Consent Calendar Second Day",75,0,0,4,79
457026,262624,2013-04-10,Senate,"Do pass as amended, and re-refer to the Committee on Appropriations",7,0,0,0,7
457026,276351,2013-05-06,Senate,"Do pass",6,0,1,0,7
457026,278764,2013-05-13,Senate,"Senate 3rd Reading SB116 Liu",34,0,4,0,38
457026,287807,2013-06-10,Assembly,"Do pass as amended and be re-referred to the Committee on 	Appropriations",9,0,0,0,9
457026,296169,2013-07-03,Assembly,"Do pass, to Consent Calendar",17,0,0,0,17
457026,297704,2013-08-19,Assembly,"SB 116 Liu  Senate Third Reading  By BOCANEGRA",77,0,0,1,78
457026,297940,2013-08-22,Senate,"Unfinished Business SB116 Liu Concurrence",37,0,2,0,39
457082,267199,2013-04-16,Senate,"Do pass",6,1,0,0,7
457082,272329,2013-04-25,Senate,"Senate 3rd Reading SB115 Hill",35,0,3,0,38
457082,371333,2014-06-12,Assembly,"Be referred to Committee on Utilities and Commerce",10,0,0,1,11
457082,374021,2014-06-23,Assembly,"Do pass and be re-referred to the Committee on Appropriations",15,0,0,0,15
457082,376685,2014-08-06,Assembly,"Do pass, to Consent Calendar",17,0,0,0,17
457140,224382,2013-01-31,Assembly,"From committee:  Be adopted.  To third reading",11,0,0,0,11
457140,232769,2013-02-15,Senate,"Special Consent Cal ACR6 Donnelly",32,0,6,0,38
457197,224383,2013-01-31,Assembly,"From committee:  Be adopted.  To third reading",11,0,0,0,11
457197,232768,2013-02-15,Senate,"Special Consent Cal ACR5 Wilk",32,0,6,0,38
457312,268687,2013-04-17,Assembly,"Do pass and re-refer to Committee on Appropriations with 	recommendation:  To Consent Calendar",7,0,0,0,7
457312,275274,2013-05-01,Assembly,"Do pass as amended, to Consent Calendar",17,0,0,0,17
457312,277958,2013-05-09,Assembly,"AB 137 BUCHANAN  Consent Calendar Second Day  Regular Session",75,0,0,4,79
457312,288602,2013-06-12,Senate,"Do pass as amended, and re-refer to the Committee on Appropriations",9,0,0,0,9
457312,297735,2013-08-19,Senate,"Assembly 3rd Reading AB137 Buchanan By Yee",37,0,2,0,39
457312,297935,2013-08-22,Assembly,"AB 137 BUCHANAN  Concurrence in Senate Amendments",78,0,0,0,78
457426,309098,2014-01-15,Assembly,"Do pass and re-refer to Committee on Appropriations with 	recommendation:  To Consent Calendar",7,0,0,0,7
457426,311202,2014-01-23,Assembly,"Do pass",16,0,0,1,17
457426,312272,2014-01-27,Assembly,"AB 135 BUCHANAN  Assembly Third Reading",77,0,0,3,80
457426,365961,2014-05-14,Senate,"Do pass as amended, and re-refer to the Committee on Appropriations",7,0,2,0,9
457426,373911,2014-06-23,Senate,"Placed on Appropriations Suspense file",7,0,0,0,7
457541,259572,2013-04-03,Assembly,"Do pass as amended, to Consent Calendar",7,0,0,0,7
457541,268671,2013-04-18,Assembly,"AB 133 HAGMAN  Consent Calendar Second Day  Regular Session",76,0,0,3,79
457541,287184,2013-06-05,Senate,"Do pass as amended",9,0,0,0,9
457541,296213,2013-07-08,Senate,"Assembly 3rd Reading AB133 Hagman By Liu",33,0,5,0,38
457541,297108,2013-08-08,Assembly,"AB 133 HAGMAN  Concurrence in Senate Amendments",77,0,0,1,78
461001,247871,2013-03-12,Assembly,"Do pass",7,0,0,0,7
461001,252484,2013-03-21,Assembly,"AB 139 HOLDEN  Assembly Third Reading",74,0,0,5,79
461001,286871,2013-06-04,Senate,"Do pass as amended",7,0,0,0,7
461001,296208,2013-07-08,Senate,"Assembly 3rd Reading AB139 Holden By Liu",33,0,5,0,38
461001,297121,2013-08-08,Assembly,"AB 139 HOLDEN  Concurrence in Senate Amendments",75,0,0,3,78
461029,257410,2013-04-02,Assembly,"Do pass as amended and be re-referred to the Committee on Aging and 	Long",7,2,0,1,10
461029,270766,2013-04-23,Assembly,"Do pass",4,0,0,3,7
461029,277368,2013-05-08,Assembly,"Do pass as amended",12,0,0,5,17
461029,280232,2013-05-16,Assembly,"AB 140 DICKINSON  Assembly Third Reading",57,10,0,12,79
461029,291591,2013-06-25,Senate,"Do pass as amended, and re-refer to the Committee on 	Appropriations",6,1,0,0,7
461029,299364,2013-09-11,Assembly,"AB 140 DICKINSON  Concurrence in Senate Amendments",77,0,0,1,78
461029,299365,2013-09-11,Senate,"Assembly 3rd Reading AB140 Dickinson By Wyland",36,0,3,0,39
461059,277057,2013-05-07,Assembly,"Do pass and be re-referred to the Committee on Appropriations",5,1,0,1,7
461059,279727,2013-05-15,Assembly,"Do pass",16,1,0,0,17
461059,283354,2013-05-23,Assembly,"AB 141 GORELL  Assembly Third Reading",65,8,0,5,78
461059,297829,2013-08-20,Senate,"Do pass, but re-refer to the Committee on Appropriations",10,0,1,0,11
461059,298029,2013-08-26,Senate,"Placed on Appropriations Suspense file",7,0,0,0,7
461059,376471,2014-08-05,Senate,"Do pass as amended",10,0,1,0,11
461059,377072,2014-08-13,Senate,"Assembly 3rd Reading AB141 Ammiano Urgency Clause",34,0,6,0,40
461059,378556,2014-08-25,Assembly,"Senate amendments be concurred in",15,0,0,1,16
461059,378795,2014-08-27,Assembly,"AB 141 AMMIANO  Concurrence- Urgency Added",74,1,0,4,79
461088,274195,2013-04-30,Assembly,"Do pass as amended and be re-referred to the Committee on 	Appropriations",10,0,0,5,15
461117,278694,2013-05-13,Assembly,"Do pass and be re-referred to the Committee on Appropriations",9,0,0,0,9
461117,283965,2013-05-24,Assembly,"Do pass, to Consent Calendar",17,0,0,0,17
461117,285237,2013-05-29,Assembly,"AB 143 HOLDEN  Consent Calendar Second Day",77,0,0,2,79
461117,297493,2013-08-14,Senate,"Do pass, but re-refer to the Committee on Appropriations Recommend 	Consent",7,0,0,0,7
461117,297494,2013-08-14,Senate,"Do pass, but re-refer to the Committee on Appropriations Recommend 	Consent",7,0,0,0,7
461117,298099,2013-08-26,Senate,"Consent Calendar 2nd AB143 Holden",39,0,0,0,39
461147,355128,2014-04-10,Assembly,"From committee:  Be adopted.  To third reading",7,0,0,4,11
461147,357925,2014-04-21,Assembly,"AJR5 GOMEZ  Assembly Third Reading",76,0,0,3,79
461147,366674,2014-05-23,Senate,"Special Consent #15 AJR5 Gomez",32,0,8,0,40
461176,224453,2013-01-31,Assembly,"From committee:  Be adopted.  To third reading",11,0,0,0,11
461205,272244,2013-04-24,Senate,"Do pass, but re-refer to the Committee on Business, Professions and 	Economic Development",7,2,0,0,9
461234,248994,2013-03-13,Senate,"Do pass, but re-refer to the Committee on Appropriations",4,0,1,0,5
461234,270060,2013-04-22,Senate,"Senate 3rd Reading SB118 Lieu",35,3,0,0,38
461234,288730,2013-06-12,Assembly,"Do pass and be re-referred to the Committee on Jobs, Economic 	Development and The Economy",7,0,0,0,7
461234,297485,2013-08-12,Assembly,"Do pass as amended and be re-referred to the Committee on 	Appropriations",8,0,0,1,9
461234,297875,2013-08-21,Assembly,"Do pass",17,0,0,0,17
461234,298097,2013-08-26,Assembly,"SB 118 Lieu  Senate Third Reading  By HERNANDEZ",76,1,0,1,78
461234,298186,2013-08-30,Senate,"Unfinished Business SB118 Lieu Concurrence",35,3,1,0,39
461262,266582,2013-04-15,Senate,"Do pass, but re-refer to the Committee on Appropriations",10,0,0,0,10
461262,276249,2013-05-06,Senate,"Special Consent #3 SB119 Calderon",32,0,6,0,38
461262,288071,2013-06-11,Assembly,"Do pass and be re-referred to the Committee on Appropriations",12,0,0,1,13
461262,296134,2013-07-03,Assembly,"Do pass",17,0,0,0,17
461262,297890,2013-08-22,Assembly,"SB 119 Calderon  Senate Third Reading  By GOMEZ",78,0,0,0,78
461290,261773,2013-04-09,Senate,"Do pass and be placed on the Consent Calendar",11,0,0,0,11
461290,265361,2013-04-15,Senate,"Consent Calendar 2nd SB120 Roth",36,0,2,0,38
461290,288401,2013-06-12,Assembly,"Do pass",15,0,0,2,17
461290,289010,2013-06-14,Assembly,"SB 120 Roth  Third Reading Urgency  By MEDINA",78,0,0,1,79
462362,257409,2013-04-02,Assembly,"Do pass and be re-referred to the Committee on Environmental Safety 	and Toxic Materials",9,2,0,4,15
462362,275536,2013-04-30,Assembly,"Do pass and be re-referred to the Committee on Appropriations",5,2,0,0,7
462362,283780,2013-05-24,Assembly,"Do pass",16,1,0,0,17
462362,284682,2013-05-28,Assembly,"AB 145 PEREA  Assembly Third Reading",45,24,0,10,79
462362,288380,2013-06-12,Senate,"Do pass as amended, and re-refer to the Committee on Health",7,0,2,0,9
462362,295989,2013-07-03,Senate,"Do pass, but re-refer to the Committee on Appropriations",7,2,0,0,9
462362,297236,2013-08-12,Senate,"Placed on Appropriations Suspense file",6,0,1,0,7
462397,278105,2013-05-08,Assembly,"Do pass",7,0,0,2,9
462397,280409,2013-05-16,Assembly,"AB 146 GORELL  Assembly Third Reading",70,1,0,8,79
462431,266540,2013-04-16,Assembly,"Do pass and be re-referred to the Committee on Natural Resources to 	Consent Calendar",15,0,0,0,15
462431,274236,2013-04-29,Assembly,"Do pass and re-refer to Committee on Appropriations with 	recommendation:  To Consent Calendar",9,0,0,0,9
462431,284006,2013-05-24,Assembly,"Do pass as amended",17,0,0,0,17
462431,284971,2013-05-29,Assembly,"AB 147 PEREZ, V.M.  Assembly Third Reading",77,0,0,2,79
462467,305732,2014-01-06,Assembly,"Be referred to Committee on Water, Parks and Wildlife",9,0,0,1,10
462467,308647,2014-01-14,Assembly,"Do pass and be re-referred to the Committee on Appropriations",15,0,0,0,15
462467,311283,2014-01-23,Assembly,"Do pass, to Consent Calendar",16,0,0,1,17
462467,313294,2014-01-29,Assembly,"AB 148 PEREZ, V.M.  Consent Calendar Second Day  Regular Session",78,0,0,2,80
462467,370772,2014-06-10,Senate,"Do pass as amended, but re-refer to the Committee on 	Appropriations Recommend Consent",9,0,0,0,9
462467,374848,2014-06-26,Senate,"Consent Calendar 2nd AB148 V. Manuel P",32,0,8,0,40
462467,375288,2014-06-30,Assembly,"AB 148 PEREZ, V.M.  Concurrence in Senate Amendments",77,0,0,2,79
462502,266626,2013-04-16,Assembly,"Do pass and be re-referred to the Committee on Elections and 	Redistricting",5,2,0,0,7
462502,270765,2013-04-23,Assembly,"Do pass and be re-referred to the Committee on Appropriations",5,2,0,0,7
462502,283857,2013-05-24,Assembly,"Do pass as amended",12,5,0,0,17
462502,285649,2013-05-30,Assembly,"AB 149 WEBER  Assembly Third Reading",62,13,0,4,79
462502,296048,2013-07-02,Senate,"Do pass, but re-refer to the Committee on Appropriations",4,1,0,0,5
462502,297390,2013-08-12,Senate,"Do pass",4,2,1,0,7
462502,298039,2013-08-26,Senate,"Assembly 3rd Reading AB149 Weber By Hancock",26,11,2,0,39
462537,257442,2013-04-02,Assembly,"Amend, and do pass as amended and be re-referred to the Committee 	on Veterans Affairs with the recommendation:  To Consent Calendar",15,0,0,0,15
462537,267590,2013-04-16,Assembly,"Do pass and be re-referred to the Committee on Appropriations",10,0,0,0,10
462537,283761,2013-05-24,Assembly,"Do pass as amended",17,0,0,0,17
462537,285156,2013-05-29,Assembly,"AB 150 OLSEN  Assembly Third Reading",77,0,0,2,79
462537,291631,2013-06-25,Senate,"Do pass, but re-refer to the Committee on Appropriations Recommend 	Consent",9,0,0,0,9
462537,297409,2013-08-12,Senate,"Placed on Appropriations Suspense file",6,0,1,0,7
462537,298521,2013-08-30,Senate,"Do pass as amended",7,0,0,0,7
462537,298981,2013-09-09,Senate,"Assembly 3rd Reading AB150 Olsen By Fuller",39,0,0,0,39
462537,299261,2013-09-10,Assembly,"AB 150 OLSEN  Concurrence in Senate Amendments",77,0,0,1,78
462571,258935,2013-04-03,Assembly,"Do pass, to Consent Calendar",9,0,0,0,9
462571,263524,2013-04-11,Assembly,"AB 151 OLSEN  Consent Calendar Second Day  Regular Session",75,0,0,4,79
462571,296355,2013-07-09,Senate,"Do pass",7,0,0,0,7
462571,297728,2013-08-19,Senate,"Assembly 3rd Reading AB151 Olsen By Gaines",37,0,2,0,39
462571,297934,2013-08-22,Assembly,"AB 151 OLSEN  Concurrence in Senate Amendments",78,0,0,0,78
462606,251570,2013-03-20,Assembly,"Do pass as amended and be re-referred to the Committee on 	Appropriations",9,2,0,2,13
462640,274436,2013-04-29,Assembly,"Do pass and be re-referred to the Committee on Appropriations",9,0,0,0,9
462676,268667,2013-04-17,Senate,"Do pass as amended, and re-refer to the Committee on Judiciary",3,5,1,0,9
462676,268668,2013-04-17,Senate,"Set, second hearing.  Failed passage in Committee. 	Reconsideration granted",9,0,0,0,9
462710,261745,2013-04-09,Senate,"Do pass, but re-refer to the Committee on Appropriations Recommend 	Consent",9,0,0,0,9
462710,270200,2013-04-22,Senate,"Placed on Appropriations Suspense file",7,0,0,0,7
462710,283327,2013-05-23,Senate,"Do pass",7,0,0,0,7
462710,285126,2013-05-29,Senate,"Special Consent #7 SB122 Lieu",38,0,1,0,39
462710,295863,2013-07-01,Assembly,"Do pass and re-refer to Committee on Appropriations with 	recommendation:  To Consent Calendar",15,0,0,1,16
462710,297481,2013-08-14,Assembly,"Do pass, to Consent Calendar",17,0,0,0,17
462710,297961,2013-08-22,Assembly,"SB 122 Lieu  Consent Calendar Second Day  Regular Session",78,0,0,0,78
462745,267548,2013-04-16,Senate,"Do pass as amended, and re-refer to the Committee on 	Appropriations",4,3,0,0,7
462745,278865,2013-05-13,Senate,"Placed on Appropriations Suspense file",5,0,2,0,7
462780,257338,2013-04-02,Senate,"Do pass as amended, and re-refer to the Committee on Governmental 	Organization",10,1,0,0,11
462780,270679,2013-04-23,Senate,"Do pass as amended, and re-refer to the Committee on 	Appropriations",9,2,0,0,11
462780,278667,2013-05-13,Senate,"Placed on Appropriations Suspense file",5,0,2,0,7
462780,283247,2013-05-23,Senate,"Do pass",5,2,0,0,7
462780,284514,2013-05-28,Senate,"Senate 3rd Reading SB124 Corbett",28,8,3,0,39
462780,295813,2013-07-01,Assembly,"Do pass and be re-referred to the Committee on Accountability and 	Administrative Review",10,3,0,2,15
462780,295967,2013-07-03,Assembly,"Do pass as amended and be re-referred to the Committee on 	Appropriations",7,2,0,4,13
462780,332920,2014-03-03,Assembly,"Be referred to Committee on Business, Professions and Consumer 	Protection",10,0,0,1,11
462780,341887,2014-03-13,Assembly,"Do pass as amended",13,0,0,1,14
462780,346358,2014-03-20,Assembly,"SB 124 Corbett  Third Reading Urgency  By QUIRK",76,0,0,4,80
462780,347078,2014-03-24,Senate,"Unfinished Business SB124 Corbett Concurrence",31,0,8,0,39
462814,237766,2013-02-26,Senate,"Be adopted",4,2,1,0,7
462814,243247,2013-03-07,Senate,"Senate 3rd Reading SJR1 Wolk",24,10,3,0,37
462814,289390,2013-06-18,Assembly,"Be adopted",5,1,0,1,7
462814,297125,2013-08-08,Assembly,"SJR1 Wolk  Senate Third Reading  By BONTA",49,26,0,3,78
462814,297531,2013-08-15,Senate,"Unfinished Business SJR1 Wolk Concurrence",26,12,1,0,39
466413,277376,2013-05-08,Senate,"Do pass as amended. To Consent Calendar",8,0,1,0,9
466413,281373,2013-05-20,Senate,"Consent Calendar 2nd SB128 Emmerson",36,0,3,0,39
466413,291887,2013-06-26,Assembly,"Do pass and be re-referred to the Committee on Education to Consent 	Calendar",9,0,0,0,9
466413,297448,2013-08-14,Assembly,"Do pass, to Consent Calendar",7,0,0,0,7
466413,297897,2013-08-22,Assembly,"SB 128 Emmerson  Consent Calendar Second Day  Regular Session",78,0,0,0,78
466435,274676,2013-04-30,Senate,"Do pass, but re-refer to the Committee on Appropriations",7,0,0,0,7
466435,281416,2013-05-20,Senate,"Special Consent #5 SB127 Gaines",36,0,3,0,39
466435,295752,2013-07-02,Assembly,"Do pass and be re-referred to the Committee on Appropriations",7,0,0,0,7
466435,297444,2013-08-14,Assembly,"Do pass",16,0,0,1,17
466435,298979,2013-09-09,Assembly,"SB 127 Gaines  Senate Third Reading  By MELENDEZ",77,0,0,1,78
466456,275716,2013-05-01,Senate,"Do pass, but re-refer to the Committee on Appropriations",9,0,0,0,9
466456,278763,2013-05-13,Senate,"Do pass",5,0,2,0,7
466456,280378,2013-05-16,Senate,"Senate 3rd Reading SB126 Steinberg",37,0,1,0,38
466456,288314,2013-06-11,Assembly,"Do pass as amended and be re-referred to the Committee on 	Appropriations",18,0,0,1,19
466456,297884,2013-08-21,Assembly,"Do pass, to Consent Calendar",17,0,0,0,17
466456,298462,2013-08-30,Assembly,"SB 126 Steinberg  Consent Calendar Second Day",78,0,0,0,78
466456,298905,2013-09-06,Senate,"Unfinished Business SB126 Steinberg Concurrence",37,0,2,0,39
466477,270945,2013-04-23,Senate,"Do pass, but re-refer to the Committee on Rules",3,4,2,0,9
466499,259747,2013-04-04,Assembly,"From committee:  Be adopted.  To third reading",11,0,0,0,11
466499,272280,2013-04-25,Senate,"Special Consent Cal ACR7 Wagner",36,0,2,0,38
466542,257728,2013-04-02,Assembly,"Do pass as amended, to Consent Calendar",9,0,0,1,10
466542,263538,2013-04-11,Assembly,"AB 161 CAMPOS  Consent Calendar Second Day  Regular Session",75,0,0,4,79
466542,286950,2013-06-04,Senate,"Do pass and be placed on the Consent Calendar",6,0,1,0,7
466542,296188,2013-07-08,Senate,"Assembly 3rd Reading AB161 Campos By Jackson",33,0,5,0,38
466542,297662,2013-08-19,Assembly,"AB 161 CAMPOS  Concurrence in Senate Amendments",77,0,0,1,78
466563,271529,2013-04-24,Assembly,"Do pass and be re-referred to the Committee on Appropriations",5,2,0,0,7
466563,283990,2013-05-24,Assembly,"Amend, and re-refer to the Committee on Appropriations",12,5,0,0,17
466563,285153,2013-05-24,Assembly,"Amend, and re-refer to the Committee on Appropriations",12,5,0,0,17
466606,257406,2013-04-01,Assembly,"Do pass as amended and be re-referred to the Committee on 	Appropriations",6,3,0,0,9
466606,311163,2014-01-23,Assembly,"Do pass as amended",11,4,0,2,17
466628,257392,2013-04-02,Assembly,"Do pass as amended and be re-referred to the Committee on 	Appropriations",9,0,0,1,10
466628,267536,2013-04-17,Assembly,"Do pass as amended, to Consent Calendar",17,0,0,0,17
466628,275614,2013-05-02,Assembly,"AB 157 CAMPOS  Assembly Third Reading",75,0,0,4,79
466628,287024,2013-06-04,Senate,"Do pass, but re-refer to the Committee on Appropriations Recommend 	Consent",6,0,1,0,7
466628,297651,2013-08-19,Senate,"Assembly 3rd Reading AB157 Campos By Galgiani",37,0,2,0,39
466649,248685,2013-03-12,Assembly,"Do pass and be re-referred to the Committee on Appropriations",7,0,0,0,7
466670,252007,2013-03-20,Assembly,"Do pass",5,0,0,2,7
466670,285518,2013-05-30,Assembly,"AB 155 ALEJO  Assembly Third Reading",47,22,0,10,79
466670,374445,2014-06-25,Senate,"Do pass as amended",6,1,0,0,7
466670,377706,2014-08-18,Senate,"Assembly 3rd Reading AB155 Alejo By Cannella",25,10,5,0,40
466670,378682,2014-08-27,Assembly,"Senate amendments be concurred in",5,2,0,2,9
466670,378896,2014-08-28,Assembly,"AB 155 ALEJO  Concurrence in Senate Amendments",55,23,0,1,79
466692,261697,2013-04-09,Assembly,"Do pass and be re-referred to the Committee on Health",9,4,0,0,13
466692,270725,2013-04-23,Assembly,"Do pass as amended and be re-referred to the Committee on 	Appropriations",13,6,0,0,19
466692,283786,2013-05-24,Assembly,"Do pass",12,5,0,0,17
466692,284644,2013-05-28,Assembly,"AB 154 ATKINS  Assembly Third Reading  Amend By WALDRON  Set #3 	Motion to  Lay on the Table  By PEREZ, V.M",52,25,0,2,79
466692,284645,2013-05-28,Assembly,"AB 154 ATKINS  Assembly Third Reading",50,25,0,4,79
466692,289145,2013-06-17,Senate,"Do pass, but re-refer to the Committee on Appropriations",8,2,0,0,10
466692,295945,2013-07-03,Senate,"Do pass, but re-refer to the Committee on Appropriations",7,2,0,0,9
466692,297239,2013-08-12,Senate,"Do pass",4,1,2,0,7
466692,298024,2013-08-26,Senate,"Assembly 3rd Reading AB154 Atkins By Jackson",25,11,3,0,39
466692,298195,2013-08-30,Assembly,"AB 154 ATKINS  Concurrence in Senate Amendments",49,25,0,4,78
470212,261792,2013-04-09,Senate,"Do pass, but re-refer to the Committee on Appropriations",7,0,0,0,7
470212,273637,2013-04-29,Senate,"Senate 3rd Reading SB130 Corbett",37,0,1,0,38
470212,288100,2013-06-11,Assembly,"Do pass",7,0,0,0,7
470212,290237,2013-06-20,Assembly,"SB 130 Corbett  Senate Third Reading  By ALEJO",77,0,0,2,79
470234,257350,2013-04-02,Senate,"Do pass as amended, and re-refer to the Committee on Appropriations",11,0,0,0,11
470234,276342,2013-05-06,Senate,"Do pass",6,1,0,0,7
470234,278676,2013-05-13,Senate,"Senate 3rd Reading SB129 Wright Urgency Clause",34,0,4,0,38
470234,289758,2013-06-17,Assembly,"Do pass and be re-referred to the Committee on Appropriations",12,0,0,3,15
470234,298490,2013-08-30,Assembly,"Do pass",16,0,0,1,17
470234,298720,2013-09-04,Assembly,"SB 129 Wright  Third Reading Urgency  By GOMEZ",72,1,0,5,78
470234,298876,2013-09-06,Senate,"Unfinished Business SB129 Wright Concurrence",35,0,4,0,39
470234,298877,2013-09-06,Senate,"Unfinished Business SB129 Wright Reconsider",37,0,2,0,39
470234,298878,2013-09-06,Senate,"Unfinished Business SB129 Wright Concurrence",37,0,2,0,39
470257,228019,2013-02-07,Assembly,"From committee:  Be adopted.  To third reading",10,0,0,1,11
470257,237452,2013-02-25,Senate,"Special Consent Cal ACR8 Ch",33,0,4,0,37
470320,252194,2013-03-20,Assembly,"Do pass as amended and re-refer to Committee on Appropriations 	with recommendation:  To Consent Calendar",6,0,0,1,7
470320,262659,2013-04-10,Assembly,"Do pass",17,0,0,0,17
470320,265388,2013-04-15,Assembly,"AB 166 HERNANDEZ  Assembly Third Reading",77,0,0,2,79
470320,288453,2013-06-12,Senate,"Do pass, but re-refer to the Committee on Appropriations",9,0,0,0,9
470320,296294,2013-07-08,Senate,"Assembly 3rd Reading AB166 Roger Hern",33,0,5,0,38
470320,297112,2013-08-08,Assembly,"AB 166 HERNANDEZ  Concurrence in Senate Amendments",77,0,0,1,78
470337,266585,2013-04-16,Assembly,"Do pass and re-refer to Committee on Appropriations with 	recommendation:  To Consent Calendar",15,0,0,0,15
470337,274875,2013-05-01,Assembly,"Do pass",17,0,0,0,17
470337,278007,2013-05-09,Assembly,"AB 165 GAINES  Assembly Third Reading",76,0,0,3,79
470337,288277,2013-06-11,Senate,"Do pass as amended, but re-refer to the Committee on Appropriations 	Recommend Consent",9,0,0,0,9
470337,295281,2013-07-01,Senate,"Do pass as amended",6,0,1,0,7
470337,297707,2013-08-19,Senate,"Assembly 3rd Reading AB165 Beth Gaines By Gaines",37,0,2,0,39
470337,297923,2013-08-22,Assembly,"AB 165 GAINES  Concurrence in Senate Amendments",78,0,0,0,78
470360,274913,2013-05-01,Assembly,"Do pass",9,0,0,0,9
470360,280348,2013-05-16,Assembly,"AB 164 WIECKOWSKI  Assembly Third Reading",73,0,0,6,79
470360,288918,2013-06-12,Senate,"Do pass and be placed on the Consent Calendar",6,0,1,0,7
470360,291345,2013-06-24,Senate,"Consent Calendar 2nd AB164 Wieckowski",39,0,0,0,39
470360,292260,2013-06-27,Assembly,"AB 164 WIECKOWSKI  Concurrence in Senate Amendments",79,0,0,0,79
470382,256801,2013-04-01,Assembly,"Do pass as amended and be re-referred to the Committee on 	Appropriations",9,0,0,0,9
470382,267551,2013-04-17,Assembly,"Do pass, to Consent Calendar",17,0,0,0,17
470382,272261,2013-04-25,Assembly,"AB 163 ATKINS  Consent Calendar Second Day  Regular Session",76,0,0,3,79
470382,287222,2013-06-05,Senate,"Do pass, but re-refer to the Committee on Appropriations Recommend 	Consent",7,0,0,0,7
470382,295364,2013-07-01,Senate,"Consent Calendar 2nd AB163 Atkins",33,0,5,0,38
473698,257348,2013-04-02,Assembly,"Do pass and be re-referred to the Committee on Appropriations",5,2,0,0,7
473698,267300,2013-04-17,Assembly,"Do pass",12,5,0,0,17
473698,275577,2013-05-02,Assembly,"AB 169 DICKINSON  Assembly Third Reading",43,27,0,9,79
473698,288024,2013-06-11,Senate,"Do pass, but re-refer to the Committee on Appropriations",5,2,0,0,7
473698,295316,2013-07-01,Senate,"Placed on Appropriations Suspense file",6,0,1,0,7
473698,298222,2013-08-30,Senate,"Do pass as amended",5,2,0,0,7
473698,298961,2013-09-09,Senate,"Assembly 3rd Reading AB169 Dickinson By Leno",21,15,3,0,39
473698,299168,2013-09-10,Assembly,"AB 169 DICKINSON  Concurrence in Senate Amendments",46,30,0,2,78
473704,248755,2013-03-12,Assembly,"Do pass as amended and be re-referred to the Committee on 	Appropriations",5,2,0,0,7
473704,262662,2013-04-10,Assembly,"Do pass",12,5,0,0,17
473704,265405,2013-04-15,Assembly,"AB 170 BRADFORD  Assembly Third Reading",49,24,0,6,79
473704,288039,2013-06-11,Senate,"Do pass, but re-refer to the Committee on Appropriations",5,2,0,0,7
473704,299452,2013-09-11,Assembly,"AB 170 BRADFORD  Concurrence in Senate Amendments",48,28,0,2,78
473704,299453,2013-09-11,Senate,"Assembly 3rd Reading AB170 Bradford By Yee",21,14,4,0,39
473721,261659,2013-04-09,Assembly,"Do pass and be re-referred to the Committee on Appropriations",6,2,0,1,9
473730,275581,2013-05-01,Assembly,"Do pass and be re-referred to the Committee on Appropriations",12,0,0,1,13
473730,279702,2013-05-15,Assembly,"Do pass",12,0,0,5,17
473730,284672,2013-05-28,Assembly,"AB 173 WEBER  Assembly Third Reading",60,13,0,6,79
473730,289832,2013-06-19,Senate,"Do pass, but re-refer to the Committee on Governmental Organization",7,1,1,0,9
473730,291528,2013-06-25,Senate,"Do pass, but re-refer to the Committee on Appropriations",9,2,0,0,11
473730,297688,2013-08-19,Senate,"Assembly 3rd Reading AB173 Weber By Galgiani",27,10,2,0,39
473739,262599,2013-04-09,Assembly,"Do pass as amended and be re-referred to the Committee on 	Appropriations",13,5,0,1,19
473739,283810,2013-05-24,Assembly,"Do pass as amended",12,0,0,5,17
473739,285054,2013-05-29,Assembly,"AB 174 BONTA  Assembly Third Reading",52,24,0,3,79
473739,295964,2013-07-03,Senate,"Do pass, but re-refer to the Committee on Appropriations",7,2,0,0,9
473739,297237,2013-08-12,Senate,"Placed on Appropriations Suspense file",6,0,1,0,7
473739,298324,2013-08-30,Senate,"Do pass as amended",6,1,0,0,7
473739,298920,2013-09-09,Senate,"Assembly 3rd Reading AB174 Bonta By Hancock",29,10,0,0,39
473739,299123,2013-09-10,Assembly,"AB 174 BONTA  Concurrence in Senate Amendments",53,24,0,1,78
473748,309012,2014-01-14,Assembly,"Do pass and be re-referred to the Committee on Appropriations",11,5,0,3,19
473757,266603,2013-04-16,Assembly,"Do pass and re-refer to Committee on Appropriations with 	recommendation:  To Consent Calendar",10,0,0,0,10
473757,274827,2013-05-01,Assembly,"Do pass, to Consent Calendar",17,0,0,0,17
473757,278089,2013-05-09,Assembly,"AB 176 CAMPOS  Consent Calendar Second Day  Regular Session",75,0,0,4,79
473757,288336,2013-06-11,Senate,"Do pass, but re-refer to the Committee on Public Safety",7,0,0,0,7
473757,289513,2013-06-18,Senate,"Do pass, but re-refer to the Committee on Appropriations",6,0,1,0,7
473757,297995,2013-08-26,Senate,"Assembly 3rd Reading AB176 Campos By Evans",39,0,0,0,39
473757,298276,2013-08-30,Assembly,"AB 176 CAMPOS  Concurrence in Senate Amendments",78,0,0,0,78
473766,305723,2014-01-06,Assembly,"Be referred to Committee on Utilities and Commerce",9,0,0,1,10
473766,308626,2014-01-13,Assembly,"Do pass and be re-referred to the Committee on Natural Resources",9,4,0,2,15
473766,309475,2014-01-16,Assembly,"Do pass and be re-referred to the Committee on Appropriations",5,1,0,3,9
473766,311184,2014-01-23,Assembly,"Do pass as amended",11,0,0,6,17
473775,262444,2013-04-08,Assembly,"Do pass and re-refer to Committee on Appropriations with 	recommendation:  To Consent Calendar",16,0,0,0,16
473775,267190,2013-04-17,Assembly,"Do pass, to Consent Calendar",17,0,0,0,17
473775,272328,2013-04-25,Assembly,"AB 178 GAINES  Consent Calendar Second Day  Regular Session",76,0,0,3,79
473775,286833,2013-06-04,Senate,"Do pass as amended, and re-refer to the Committee on 	Appropriations",10,0,1,0,11
473775,296275,2013-07-08,Senate,"Assembly 3rd Reading AB178 Beth Gaines By Gaines",33,0,5,0,38
473775,297142,2013-08-08,Assembly,"AB 178 GAINES  Concurrence in Senate Amendments",76,0,0,2,78
473785,270069,2013-04-22,Assembly,"Do pass as amended and be re-referred to the Committee on Judiciary",16,0,0,0,16
473785,277413,2013-05-08,Assembly,"Do pass",16,0,0,1,17
473785,284093,2013-05-24,Assembly,"AB 179 BOCANEGRA  Assembly Third Reading",70,1,0,7,78
473785,289396,2013-06-18,Senate,"Do pass, but re-refer to the Committee on Judiciary",10,0,1,0,11
473785,291538,2013-06-25,Senate,"Do pass, but re-refer to the Committee on Appropriations",5,2,0,0,7
473785,298980,2013-09-09,Senate,"Assembly 3rd Reading AB179 Bocanegra By DeSaulnier",33,4,2,0,39
473785,299109,2013-09-10,Assembly,"AB 179 BOCANEGRA  Concurrence in Senate Amendments",77,1,0,0,78
473794,277362,2013-05-07,Assembly,"Do pass",5,2,0,0,7
473794,284635,2013-05-28,Assembly,"AB 180 BONTA  Assembly Third Reading",46,29,0,4,79
473794,289401,2013-06-18,Senate,"Do pass",5,1,1,0,7
473794,298790,2013-09-06,Senate,"Assembly 3rd Reading AB180 Bonta By Hancock",21,15,3,0,39
473794,298791,2013-09-06,Senate,"Assembly 3rd Reading AB180 Bonta Lay on Table",21,11,7,0,39
473794,298792,2013-09-06,Senate,"Assembly 3rd Reading AB180 Bonta Lay on Table",21,11,7,0,39
473812,252205,2013-03-20,Assembly,"Do pass as amended",6,0,0,1,7
473812,260970,2013-04-08,Assembly,"AB 182 BUCHANAN  Assembly Third Reading",75,0,0,4,79
473812,291881,2013-06-26,Senate,"Do pass as amended, and re-refer to the Committee on Governance and 	Finance",8,0,1,0,9
473812,296018,2013-07-03,Senate,"Do pass as amended",7,0,0,0,7
473812,298617,2013-09-03,Senate,"Assembly 3rd Reading AB182 Buchanan By Hueso",36,0,3,0,39
473812,298794,2013-09-06,Assembly,"AB 182 BUCHANAN  Concurrence in Senate Amendments",78,0,0,0,78
473821,277343,2013-05-07,Senate,"Do pass, but re-refer to the Committee on Appropriations",5,1,1,0,7
473821,281202,2013-05-20,Senate,"Placed on Appropriations Suspense file",6,0,1,0,7
473821,283085,2013-05-23,Senate,"Do pass as amended",5,1,1,0,7
473821,285068,2013-05-29,Senate,"Senate 3rd Reading SB131 Beall",21,10,8,0,39
473821,289385,2013-06-18,Assembly,"Do pass as amended",6,1,0,3,10
473821,297457,2013-08-14,Assembly,"Do pass",6,4,0,7,17
473821,297458,2013-08-14,Assembly,"Set first hearing.  Failed passage.  Reconsideration granted",17,0,0,0,17
473821,297834,2013-08-21,Assembly,"Do pass",11,3,0,3,17
473821,298708,2013-09-04,Assembly,"SB 131 Beall  Senate Third Reading  By SKINNER  Amend By WAGNER 	Set #1  Motion to  Lay on the Table  By ATKINS",48,26,0,4,78
473821,298709,2013-09-04,Assembly,"SB 131 Beall  Senate Third Reading  By SKINNER",44,15,0,19,78
473821,298756,2013-09-06,Senate,"Unfinished Business SB131 Beall Concurrence",21,8,10,0,39
475138,261761,2013-04-09,Senate,"Do pass as amended, and re-refer to the Committee on Appropriations",9,0,0,0,9
475138,269929,2013-04-22,Senate,"Placed on Appropriations Suspense file",7,0,0,0,7
475138,283158,2013-05-23,Senate,"Do pass as amended",7,0,0,0,7
475138,284554,2013-05-28,Senate,"Senate 3rd Reading SB132 Hill",39,0,0,0,39
475138,295788,2013-07-02,Assembly,"Do pass and re-refer to Committee on Appropriations with 	recommendation:  To Consent Calendar",15,0,0,0,15
475138,297456,2013-08-14,Assembly,"Do pass",16,0,0,1,17
475138,297692,2013-08-19,Assembly,"SB 132 Hill  Senate Third Reading  By DICKINSON",75,0,0,3,78
475138,298027,2013-08-26,Senate,"Unfinished Business SB132 Hill Concurrence",35,2,2,0,39
475139,279691,2013-05-15,Senate,"Be adopted as amended, and re-refer to the Committee on Elections 	and Constitutional Amendments",5,1,1,0,7
475139,289383,2013-06-18,Senate,"Be adopted, but re-refer to the Committee on Rules",3,0,2,0,5
477249,234704,2013-02-20,Senate,"Do pass, but re-refer to the Committee on Appropriations",7,2,0,0,9
477249,235550,2013-02-21,Senate,"Do pass",5,2,0,0,7
477249,239509,2013-02-28,Senate,"Senate 3rd Reading SB2 Hernandez",26,10,1,0,37
477249,262602,2013-04-09,Assembly,"Do pass and be re-referred to the Committee on Appropriations",13,6,0,0,19
477249,267184,2013-04-17,Assembly,"Do pass",12,5,0,0,17
477249,272331,2013-04-25,Assembly,"SB2 Hernandez  Senate Third Reading  By PAN  First Extraordinary 	Session",51,25,0,3,79
477249,273532,2013-04-29,Senate,"Unfinished Business SB2 Hernandez Concurrence",27,9,2,0,38
477250,238611,2013-02-27,Senate,"Do pass, but re-refer to the Committee on Appropriations",6,1,1,0,8
477250,240889,2013-03-04,Senate,"Do pass",4,1,2,0,7
477250,243271,2013-03-07,Senate,"Senate 3rd Reading SB1 Hernandez",24,7,6,0,37
477250,288046,2013-06-11,Assembly,"Do pass and be re-referred to the Committee on Appropriations",13,5,0,1,19
477250,289018,2013-06-14,Assembly,"SB1 Hernandez  Senate Third Reading  Amend By PAN  Set #1  First 	Extraordinary Session",54,25,0,0,79
477250,289066,2013-06-15,Assembly,"SB1 Hernandez  Senate Third Reading  By PAN  First Extraordinary 	Session",55,24,0,0,79
477250,289067,2013-06-15,Senate,"W/O REF. TO FILE SB1 Hernandez Concurrence",29,8,2,0,39
477251,258450,2013-04-03,Senate,"Do pass, but re-refer to the Committee on Judiciary",7,2,0,0,9
477251,267221,2013-04-16,Senate,"Do pass, but re-refer to the Committee on Appropriations",5,2,0,0,7
477251,273520,2013-04-29,Senate,"Placed on Appropriations Suspense file",7,0,0,0,7
477251,283242,2013-05-23,Senate,"Do pass as amended",5,2,0,0,7
477251,285011,2013-05-29,Senate,"Senate 3rd Reading SB138 Hernandez",26,11,2,0,39
477251,291577,2013-06-25,Assembly,"Do pass and be re-referred to the Committee on Health",7,3,0,0,10
477251,295929,2013-07-02,Assembly,"Do pass as amended and be re-referred to the Committee on 	Appropriations",13,5,0,1,19
477251,298307,2013-08-30,Assembly,"Do pass as amended",12,5,0,0,17
477251,298925,2013-09-09,Assembly,"SB 138 Hernandez  Senate Third Reading  By MITCHELL",51,25,0,2,78
477251,299133,2013-09-10,Senate,"Unfinished Business SB138 Hernandez Concurrence",34,4,1,0,39
477252,262398,2013-04-09,Senate,"Do pass, but re-refer to the Committee on Appropriations Recommend 	Consent",6,0,0,0,6
477252,270227,2013-04-22,Senate,"Placed on Appropriations Suspense file",7,0,0,0,7
477252,283131,2013-05-23,Senate,"Do pass",7,0,0,0,7
477252,284595,2013-05-28,Senate,"Senate 3rd Reading SB137 Emmerson",39,0,0,0,39
477252,289501,2013-06-18,Assembly,"Do pass and be re-referred to the Committee on Appropriations",7,0,0,0,7
477254,261852,2013-04-09,Senate,"Do pass, but re-refer to the Committee on Natural Resources and 	Water",11,0,0,0,11
477254,271325,2013-04-23,Senate,"Do pass, but re-refer to the Committee on Appropriations",9,0,0,0,9
477254,276333,2013-05-06,Senate,"Placed on Appropriations Suspense file",7,0,0,0,7
477254,283307,2013-05-23,Senate,"Do pass as amended",7,0,0,0,7
477254,284613,2013-05-28,Senate,"Senate 3rd Reading SB135 Padilla",39,0,0,0,39
477254,297106,2013-08-07,Assembly,"Do pass as amended and be re-referred to the Committee on 	Appropriations",15,0,0,2,17
477254,298283,2013-08-30,Assembly,"Do pass as amended",17,0,0,0,17
477254,299415,2013-09-11,Assembly,"Do pass as amended, to Consent Calendar",16,0,0,1,17
477254,299684,2013-09-12,Senate,"Unfinished Supp 2 SB135 Padilla Concurrence",38,0,1,0,39
477254,299838,2013-09-12,Assembly,"SB 135 Padilla  Consent Calendar First Day  Regular Session",78,0,0,0,78
477255,270866,2013-04-23,Senate,"Do pass as amended, but re-refer to the Committee on Appropriations 	Recommend Consent",6,0,0,0,6
477255,276306,2013-05-06,Senate,"Placed on Appropriations Suspense file",7,0,0,0,7
477255,283315,2013-05-23,Senate,"Do pass as amended",7,0,0,0,7
477255,285183,2013-05-29,Senate,"Senate 3rd Reading SB134 Hueso",39,0,0,0,39
477255,295874,2013-07-02,Assembly,"Do pass as amended",7,0,0,0,7
477255,297126,2013-08-08,Assembly,"SB 134 Hueso  Senate Third Reading  By ATKINS",76,0,0,2,78
477255,297947,2013-08-22,Senate,"Unfinished Business SB134 Hueso Concurrence",37,0,2,0,39
477256,257434,2013-04-02,Senate,"Do pass and be placed on the Consent Calendar",11,0,0,0,11
477256,260947,2013-04-08,Senate,"Consent Calendar 2nd SB133 DeSaulnier",38,0,0,0,38
477256,289254,2013-06-17,Assembly,"Be referred to Committee on Housing and Community Development",9,0,0,2,11
477256,296080,2013-07-03,Assembly,"Do pass and be re-referred to the Committee on Local Government",7,0,0,0,7
477256,297596,2013-08-14,Assembly,"Do pass and be re-referred to the Committee on Appropriations",9,0,0,0,9
477256,298479,2013-08-30,Assembly,"Do pass",17,0,0,0,17
477256,298711,2013-09-04,Assembly,"SB 133 DeSaulnier  Senate Third Reading  By CHAU",77,0,0,1,78
477256,378923,2014-08-28,Senate,"Unfinished Business SB133 DeSaulnier Concurrence",37,0,3,0,40
477257,266910,2013-04-15,Assembly,"Be adopted, to Consent Calendar",16,0,0,0,16
477257,273668,2013-04-29,Assembly,"AJR6 FOX  Assembly Third Reading",70,1,0,8,79
477257,287090,2013-06-04,Senate,"Be adopted",10,0,1,0,11
477257,296298,2013-07-08,Senate,"Assembly 3rd Reading AJR6 Fox By Block",30,0,8,0,38
477258,227899,2013-02-07,Assembly,"From committee:  Be adopted.  To third reading",10,0,0,1,11
477258,237454,2013-02-25,Senate,"Assembly 3rd Reading ACR9 Mitchell By Wright",33,0,4,0,37
477259,309077,2014-01-14,Assembly,"Be adopted and be re-referred to the Committee on Judiciary",5,12,0,2,19
477260,233871,2013-02-19,Assembly,"Do pass and be re-referred to the Committee on Appropriations",13,6,0,0,19
477260,236832,2013-02-25,Assembly,"Do pass",12,5,0,0,17
477260,243261,2013-03-07,Assembly,"AB1 PEREZ, J.  Assembly Third Reading  First Extraordinary Session",54,22,0,4,80
477260,288397,2013-06-12,Senate,"Do pass, but re-refer to the Committee on Appropriations",7,2,0,0,9
477260,289062,2013-06-15,Senate,"Assembly 2nd Reading AB1 John A. P",28,8,3,0,39
477260,289063,2013-06-15,Assembly,"AB1 PEREZ, J.  Concurrence in Senate Amendments  First 	Extraordinary Session",54,24,0,1,79
477261,274743,2013-04-30,Assembly,"Do pass as amended and be re-referred to the Committee on 	Appropriations",6,0,0,1,7
477262,275195,2013-05-01,Assembly,"Do pass and be re-referred to the Committee on Appropriations",7,1,0,1,9
477262,279735,2013-05-15,Assembly,"Do pass as amended",16,1,0,0,17
477262,283976,2013-05-24,Assembly,"AB 195 HALL  Assembly Third Reading",59,9,0,10,78
477262,288794,2013-06-12,Senate,"Do pass, but re-refer to the Committee on Appropriations",6,0,1,0,7
477262,291193,2013-06-24,Senate,"Do pass",6,0,1,0,7
477262,296276,2013-07-08,Senate,"Assembly 3rd Reading AB195 Hall By Wolk",33,0,5,0,38
477263,309095,2014-01-15,Assembly,"Do pass",6,0,0,3,9
477263,313252,2014-01-29,Assembly,"AB 194 CAMPOS  Assembly Third Reading",46,11,0,23,80
477263,374390,2014-06-25,Senate,"Do pass as amended",5,2,0,0,7
477263,378500,2014-08-26,Senate,"Assembly 3rd Reading AB194 Campos By Leno",26,8,6,0,40
477263,378757,2014-08-27,Assembly,"AB 194 CAMPOS  Concurrence in Senate Amendments",56,13,0,10,79
477264,270832,2013-04-23,Assembly,"Do pass as amended and be re-referred to the Committee on 	Appropriations",5,0,0,2,7
477265,268462,2013-04-17,Assembly,"Do pass and be re-referred to the Committee on Appropriations",3,5,0,1,9
477265,268463,2013-04-17,Assembly,"Set second hearing.  Failed passage.  Reconsideration granted",9,0,0,0,9
477266,258451,2013-04-02,Assembly,"Do pass and be re-referred to the Committee on Appropriations",5,2,0,0,7
477266,283758,2013-05-24,Assembly,"Do pass as amended",12,5,0,0,17
477266,285043,2013-05-29,Assembly,"AB 191 BOCANEGRA  Assembly Third Reading",54,23,0,2,79
477266,291573,2013-06-25,Senate,"Do pass as amended, and re-refer to the Committee on Appropriations",4,2,0,0,6
477266,297257,2013-08-12,Senate,"Placed on Appropriations Suspense file",6,0,1,0,7
477266,298219,2013-08-30,Senate,"Do pass",5,2,0,0,7
477266,298951,2013-09-09,Senate,"Assembly 3rd Reading AB191 Bocanegra By Leno",28,10,1,0,39
477266,299177,2013-09-10,Assembly,"AB 191 BOCANEGRA  Concurrence in Senate Amendments",54,24,0,0,78
477270,278562,2013-05-13,Assembly,"Do pass as amended and be re-referred to the Committee on 	Appropriations",5,3,0,1,9
477271,274316,2013-04-30,Assembly,"Do pass and be re-referred to the Committee on Appropriations",10,1,0,2,13
477271,284012,2013-05-24,Assembly,"Do pass as amended",17,0,0,0,17
477271,284980,2013-05-29,Assembly,"AB 186 MAIENSCHEIN  Assembly Third Reading",75,1,0,3,79
477271,371725,2014-06-16,Senate,"Do pass, but re-refer to the Committee on Appropriations",9,0,0,0,9
477271,375224,2014-06-30,Senate,"Do pass",5,0,2,0,7
477271,378402,2014-08-25,Senate,"Assembly 3rd Reading AB186 Maienschein By Correa",33,0,7,0,40
477271,378561,2014-08-26,Assembly,"AB 186 MAIENSCHEIN  Concurrence in Senate Amendments",78,0,0,1,79
477273,249406,2013-03-12,Assembly,"Do pass and be re-referred to the Committee on Appropriations",7,0,0,0,7
477273,284055,2013-05-24,Assembly,"Do pass as amended",17,0,0,0,17
477273,285216,2013-05-29,Assembly,"AB 184 GATTO  Assembly Third Reading",76,0,0,3,79
477273,291788,2013-06-25,Senate,"Do pass, but re-refer to the Committee on Appropriations",7,0,0,0,7
477273,297327,2013-08-12,Senate,"Placed on Appropriations Suspense file",6,0,1,0,7
477273,298224,2013-08-30,Senate,"Do pass as amended",7,0,0,0,7
477273,299059,2013-09-09,Senate,"Assembly 3rd Reading AB184 Gatto By Nielsen",37,0,2,0,39
477273,299244,2013-09-10,Assembly,"AB 184 GATTO  Concurrence in Senate Amendments",78,0,0,0,78
479107,275678,2013-05-01,Senate,"Do pass as amended, and re-refer to the Committee on Appropriations",8,0,1,0,9
479107,281323,2013-05-20,Senate,"Placed on Appropriations Suspense file",6,0,1,0,7
479107,283072,2013-05-23,Senate,"Do pass",7,0,0,0,7
479107,284624,2013-05-28,Senate,"Senate 3rd Reading SB141 Correa",35,1,3,0,39
479107,297074,2013-08-06,Assembly,"Do pass and be re-referred to the Committee on Appropriations",11,0,0,2,13
479107,298237,2013-08-30,Assembly,"Do pass as amended",14,1,0,2,17
479107,298823,2013-09-06,Assembly,"SB 141 Correa  Senate Third Reading  By GARCIA  Amend By GARCIA 	Set #1",54,21,0,3,78
479107,299483,2013-09-11,Senate,"Unfinished Supp 1 SB141 Correa Concurrence",35,4,0,0,39
479107,299484,2013-09-11,Assembly,"SB 141 Correa  Senate Third Reading  By GARCIA",68,1,0,9,78
479108,240844,2013-03-04,Senate,"Do pass",14,0,2,0,16
479108,243105,2013-03-07,Senate,"Senate 3rd Reading SB140 Leno Urgency Clause",31,0,6,0,37
479108,262654,2013-04-10,Assembly,"Do pass as amended",12,1,0,4,17
479108,268558,2013-04-18,Assembly,"SB 140 Leno  Third Reading Urgency  By BLUMENFIELD  Amend By JONES 	Set #1  Motion to  Lay on the Table  By ATKINS",52,25,0,2,79
479108,268559,2013-04-18,Assembly,"SB 140 Leno  Third Reading Urgency  By BLUMENFIELD  Amend By WAGNER 	Set #2  Motion to  Lay on the Table  By ATKINS",51,25,0,3,79
479108,268560,2013-04-18,Assembly,"SB 140 Leno  Third Reading Urgency  By BLUMENFIELD",65,10,0,4,79
479108,269902,2013-04-22,Senate,"Unfinished Business SB140 Leno Concurrence",37,0,1,0,38
479109,259121,2013-04-03,Senate,"Do pass, but re-refer to the Committee on Appropriations Recommend 	Consent",8,0,1,0,9
479109,270003,2013-04-22,Senate,"Special Consent #1 SB139 Hill",38,0,0,0,38
479109,288347,2013-06-10,Assembly,"Do pass, to Consent Calendar",11,0,0,0,11
479109,289046,2013-06-14,Assembly,"SB 139 Hill  Consent Calendar Second Day",78,0,0,1,79
479110,234674,2013-02-20,Assembly,"Do pass and be re-referred to the Committee on Appropriations",13,6,0,0,19
479110,237487,2013-02-25,Assembly,"Do pass",12,5,0,0,17
479110,239477,2013-02-28,Assembly,"AB2 PAN  Assembly Third Reading  First Extraordinary Session",53,25,0,2,80
479110,262569,2013-04-10,Senate,"Do pass, but re-refer to the Committee on Appropriations",8,1,0,0,9
479110,265155,2013-04-15,Senate,"Do pass",7,0,0,0,7
479110,272267,2013-04-25,Senate,"Assembly 3rd Reading AB2 Pan By Hernandez",27,9,2,0,38
479110,273540,2013-04-29,Assembly,"AB2 PAN  Concurrence in Senate Amendments  First Extraordinary 	Session",52,25,0,2,79
479111,268911,2013-04-17,Assembly,"Do pass and be re-referred to the Committee on Judiciary",1,5,0,1,7
479112,271595,2013-04-23,Assembly,"Amend, and do pass as amended and be re-referred to the Committee 	on Appropriations with the recommendation:  To Consent Calendar",9,0,0,0,9
479112,280034,2013-05-15,Assembly,"Do pass, to Consent Calendar",17,0,0,0,17
479112,283331,2013-05-23,Assembly,"AB 201 HOLDEN  Consent Calendar Second Day  Regular Session",74,0,0,4,78
479112,288030,2013-06-11,Senate,"Do pass, but re-refer to the Committee on Appropriations Recommend 	Consent",11,0,0,0,11
479112,295582,2013-07-01,Senate,"Consent Calendar 2nd AB201 Holden",33,0,5,0,38
479112,297957,2013-08-22,Senate,"Assembly 3rd Reading AB201 Holden By Padilla",37,0,2,0,39
479112,298012,2013-08-26,Assembly,"AB 201 HOLDEN  Concurrence in Senate Amendments",78,0,0,0,78
479113,275731,2013-05-01,Assembly,"Do pass and be re-referred to the Committee on Appropriations",2,4,0,1,7
479113,275732,2013-05-01,Assembly,"Set second hearing.  Failed passage.  Reconsideration granted",7,0,0,0,7
479114,258764,2013-04-03,Assembly,"Do pass and be re-referred to the Committee on Agriculture",12,1,0,0,13
479114,267957,2013-04-17,Assembly,"Do pass and be re-referred to the Committee on Appropriations",7,0,0,0,7
479114,283916,2013-05-24,Assembly,"Do pass as amended",16,1,0,0,17
479114,285079,2013-05-29,Assembly,"AB 199 HOLDEN  Assembly Third Reading",77,0,0,2,79
479114,297826,2013-08-20,Senate,"Do pass, but re-refer to the Committee on Appropriations",7,0,3,0,10
479114,298095,2013-08-26,Senate,"Placed on Appropriations Suspense file",7,0,0,0,7
479114,298446,2013-08-30,Senate,"Do pass",7,0,0,0,7
479114,299062,2013-09-09,Senate,"Assembly 3rd Reading AB199 Holden By Liu",39,0,0,0,39
479114,299124,2013-09-10,Assembly,"AB 199 HOLDEN  Concurrence in Senate Amendments",77,1,0,0,78
479115,257354,2013-04-02,Assembly,"Do pass and be re-referred to the Committee on Appropriations",7,2,0,1,10
479116,259321,2013-04-02,Assembly,"Do pass and be re-referred to the Committee on Appropriations",6,1,0,0,7
481221,273538,2013-04-29,Senate,"Do pass",5,9,2,0,16
481222,262744,2013-04-10,Senate,"Do pass as amended, and re-refer to the Committee on Appropriations",9,0,0,0,9
481222,273835,2013-04-29,Senate,"Placed on Appropriations Suspense file",7,0,0,0,7
481223,267638,2013-04-17,Senate,"Do pass as amended, and re-refer to the Committee on 	Appropriations",5,2,0,0,7
481223,284665,2013-05-28,Senate,"Senate 3rd Reading SB142 DeSaulnier",24,11,4,0,39
481223,295872,2013-07-01,Assembly,"Do pass and be re-referred to the Committee on Local Government",11,3,0,2,16
481223,297609,2013-08-14,Assembly,"Do pass and be re-referred to the Committee on Appropriations",6,2,0,1,9
481223,297842,2013-08-21,Assembly,"Do pass as amended",12,5,0,0,17
481223,299093,2013-09-09,Assembly,"SB 142 DeSaulnier  Senate Third Reading  By GORDON",49,28,0,1,78
481223,299199,2013-09-10,Senate,"Unfinished Business SB142 DeSaulnier Concurrence",26,11,2,0,39
481224,250868,2013-03-19,Assembly,"From committee:  Be adopted.  To third reading",5,2,0,0,7
481224,256831,2013-04-01,Assembly,"AJR7 BONTA  Assembly Third Reading",42,17,0,20,79
481224,271002,2013-04-23,Senate,"Do pass",4,0,2,0,6
481224,278241,2013-05-09,Senate,"Assembly 3rd Reading AJR7 Bonta By Yee",24,10,4,0,38
481225,236313,2013-02-21,Assembly,"From committee:  Be adopted.  To third reading",9,0,0,2,11
481225,250505,2013-03-18,Senate,"Special Consent Cal ACR10 Buchanan",31,0,6,0,37
481227,259184,2013-04-03,Assembly,"Do pass and be re-referred to the Committee on Revenue and Taxation",7,2,0,0,9
481227,276416,2013-05-06,Assembly,"Do pass",5,3,0,1,9
481227,278134,2013-05-09,Assembly,"AB 210 WIECKOWSKI  Assembly Third Reading",46,23,0,10,79
481227,287173,2013-06-05,Senate,"Do pass",5,2,0,0,7
481227,296206,2013-07-08,Senate,"Assembly 3rd Reading AB210 Wieckowski By Corbett",20,12,6,0,38
481227,296207,2013-07-08,Senate,"Assembly 3rd Reading AB210 Wieckowski Reconsider",31,0,7,0,38
481227,297539,2013-08-15,Senate,"Assembly 3rd Reading AB210 Wieckowski By Corbett",25,12,2,0,39
481228,257404,2013-04-02,Assembly,"Do pass as amended and be re-referred to the Committee on 	Appropriations",17,0,0,2,19
481228,274732,2013-05-01,Assembly,"Do pass, to Consent Calendar",17,0,0,0,17
481228,277955,2013-05-09,Assembly,"AB 209 PAN  Consent Calendar Second Day  Regular Session",75,0,0,4,79
481228,287185,2013-06-05,Senate,"Do pass, but re-refer to the Committee on Appropriations",9,0,0,0,9
481228,291219,2013-06-24,Senate,"Do pass",7,0,0,0,7
481229,271922,2013-04-24,Assembly,"Do pass and be re-referred to the Committee on Appropriations",6,0,0,1,7
481230,266696,2013-04-16,Assembly,"Do pass and re-refer to Committee on Appropriations with 	recommendation:  To Consent Calendar",15,0,0,0,15
481231,261841,2013-04-08,Assembly,"Do pass",16,0,0,0,16
481231,265430,2013-04-15,Assembly,"AB 206 DICKINSON  Assembly Third Reading",76,0,0,3,79
481231,287023,2013-06-04,Senate,"Do pass",10,0,1,0,11
481231,295579,2013-07-01,Senate,"Assembly 3rd Reading AB206 Dickinson By Gaines",36,0,2,0,38
481232,277322,2013-05-08,Assembly,"Do pass",5,2,0,0,7
481232,278623,2013-05-13,Assembly,"AB 205 PAN  Assembly Third Reading",55,20,0,4,79
481232,287866,2013-06-10,Senate,"Do pass",5,0,0,0,5
481232,298082,2013-08-26,Senate,"Assembly 3rd Reading AB205 Pan By Beall",39,0,0,0,39
481234,257613,2013-04-01,Assembly,"Do pass and be re-referred to the Committee on Appropriations",6,2,0,1,9
481234,274833,2013-05-01,Assembly,"Do pass",11,5,0,1,17
481234,313238,2014-01-28,Assembly,"Do pass and be re-referred to the Committee on Appropriations",5,0,0,4,9
481234,313239,2014-01-29,Assembly,"Do pass",12,0,0,5,17
481234,313922,2014-01-30,Assembly,"AB 203 STONE  Assembly Third Reading",71,0,0,9,80
483460,229183,2013-02-11,Senate,"Senate 3rd Reading SJR2 Jackson",31,0,7,0,38
483460,232755,2013-02-15,Assembly,"Be adopted, to Consent Calendar",9,0,0,2,11
483460,237455,2013-02-25,Assembly,"SJR2 Jackson  Senate Third Reading  By LOWENTHAL",75,0,0,5,80
483462,271504,2013-04-23,Senate,"Do pass",7,0,0,0,7
483462,273649,2013-04-29,Senate,"Senate 3rd Reading SB156 Beall",37,0,1,0,38
483462,289520,2013-06-18,Assembly,"Do pass as amended",9,0,0,1,10
483462,292170,2013-06-27,Assembly,"SB 156 Beall  Senate Third Reading  By FONG",78,0,0,1,79
483462,298085,2013-08-26,Assembly,"SB 156 Beall  Senate Third Reading  By FONG",55,22,0,1,78
483462,298255,2013-08-30,Senate,"Unfinished Business SB156 Beall",26,12,1,0,39
483463,274918,2013-04-30,Senate,"Do pass as amended, and re-refer to the Committee on 	Appropriations",7,0,0,0,7
483463,284010,2013-05-24,Senate,"Senate 3rd Reading SB155 Padilla",36,0,3,0,39
483463,289144,2013-06-17,Assembly,"Do pass and be re-referred to the Committee on Judiciary",15,0,0,1,16
483463,297370,2013-08-13,Assembly,"Do pass and be re-referred to the Committee on Appropriations",10,0,0,0,10
483463,298364,2013-08-30,Assembly,"Do pass",16,0,0,1,17
483463,299205,2013-09-10,Assembly,"SB 155 Padilla  Senate Third Reading  By HOLDEN",77,1,0,0,78
483463,299406,2013-09-11,Senate,"Unfinished Business SB155 Padilla Concurrence",38,0,1,0,39
483468,257044,2013-04-01,Senate,"Do pass as amended, and re-refer to the Committee on Appropriations",8,1,1,0,10
483468,269982,2013-04-22,Senate,"Senate 3rd Reading SB152 Roth",35,1,2,0,38
483468,288122,2013-06-11,Assembly,"Do pass and be re-referred to the Committee on Appropriations",9,3,0,1,13
483468,295993,2013-07-03,Assembly,"Do pass",13,4,0,0,17
483468,297204,2013-08-12,Assembly,"SB 152 Roth  Senate Third Reading  By GORDON",57,19,0,2,78
483468,297580,2013-08-15,Senate,"Unfinished Business SB152 Roth Concurrence",37,1,1,0,39
483469,266495,2013-04-16,Senate,"Do pass, but re-refer to the Committee on Appropriations",10,0,1,0,11
483469,278689,2013-05-13,Senate,"Senate 3rd Reading SB151 DeSaulnier",34,0,4,0,38
483469,373921,2014-06-23,Assembly,"Do pass as amended and be re-referred to the Committee on 	Appropriations",13,0,0,3,16
483470,275544,2013-05-01,Senate,"Do pass",7,0,2,0,9
483470,278210,2013-05-09,Senate,"Senate 3rd Reading SB150 Lara",30,1,7,0,38
483470,288059,2013-06-11,Assembly,"Do pass",8,0,0,5,13
483470,295633,2013-07-01,Assembly,"SB 150 Lara  Senate Third Reading  By ALEJO  Amend By ALEJO  Set #1",50,19,0,9,78
483470,296060,2013-07-03,Assembly,"SB 150 Lara  Senate Third Reading  By ALEJO",52,14,0,12,78
483470,299161,2013-09-10,Assembly,"SB 150 Lara  Senate Third Reading  By GONZALEZ",54,17,0,7,78
483470,299387,2013-09-11,Senate,"Unfinished Business SB150 Lara Concurrence",34,2,3,0,39
483475,308655,2014-01-14,Senate,"Do pass, but re-refer to the Committee on Rules",1,6,2,0,9
483476,247992,2013-03-13,Senate,"Do pass",4,0,1,0,5
483476,250008,2013-03-18,Senate,"Senate 3rd Reading SB146 Lara",32,0,5,0,37
483476,288395,2013-06-12,Assembly,"Do pass as amended",13,0,0,0,13
483476,292182,2013-06-27,Assembly,"SB 146 Lara  Third Reading Urgency  By GONZALEZ",36,30,0,13,79
483476,295269,2013-07-01,Assembly,"SB 146 Lara  Motion to Reconsider  By GONZALEZ",65,5,0,8,78
483476,295270,2013-07-01,Assembly,"SB 146 Lara  Third Reading Urgency  By GONZALEZ",73,0,0,5,78
483476,296000,2013-07-03,Senate,"Unfinished Business SB146 Lara Concurrence",36,0,2,0,38
483478,261746,2013-04-09,Senate,"Do pass, but re-refer to the Committee on Appropriations",7,0,0,0,7
483478,273864,2013-04-29,Senate,"Placed on Appropriations Suspense file",7,0,0,0,7
483478,283367,2013-05-23,Senate,"Do pass as amended",5,1,1,0,7
483478,285165,2013-05-29,Senate,"Senate 3rd Reading SB145 Pavley",39,0,0,0,39
483478,297380,2013-08-13,Assembly,"Do pass as amended and be re-referred to the Committee on 	Appropriations",6,0,0,1,7
483478,298447,2013-08-30,Assembly,"Do pass as amended",17,0,0,0,17
483478,299070,2013-09-09,Assembly,"SB 145 Pavley  Senate Third Reading  By GORELL",78,0,0,0,78
483478,299293,2013-09-10,Senate,"Unfinished Business SB145 Pavley Concurrence",38,0,1,0,39
483479,277956,2013-05-08,Assembly,"Be adopted, to Consent Calendar",7,0,0,0,7
483479,280308,2013-05-16,Assembly,"AJR9 DAHLE  Consent Calendar Second Day  Regular Session",70,0,0,9,79
483479,285512,2013-05-30,Senate,"Special Consent Cal AJR9 Dahle",38,0,1,0,39
483480,227874,2013-02-07,Assembly,"From committee:  Be adopted.  To third reading",7,1,0,3,11
483480,229191,2013-02-11,Assembly,"AJR8 PEREZ, J.  Assembly Third Reading",72,0,0,8,80
483480,237388,2013-02-25,Senate,"Assembly 3rd Reading AJR8 John A. P",33,0,4,0,37
483481,232759,2013-02-15,Assembly,"From committee:  Be adopted.  To third reading",9,0,0,2,11
483481,239861,2013-02-28,Senate,"Special Consent Cal ACR11 Muratsuchi",36,0,1,0,37
483483,260965,2013-04-08,Assembly,"Do pass as amended and be re-referred to the Committee on 	Appropriations",12,3,0,0,15
483483,283806,2013-05-24,Assembly,"Do pass",12,5,0,0,17
483483,285526,2013-05-30,Assembly,"AB 217 BRADFORD  Assembly Third Reading",54,23,0,2,79
483483,295747,2013-07-02,Senate,"Do pass as amended, and re-refer to the Committee on Appropriations",8,2,1,0,11
483483,297650,2013-08-19,Senate,"Placed on Appropriations Suspense file",7,0,0,0,7
483483,298227,2013-08-30,Senate,"Do pass as amended",5,2,0,0,7
483483,299371,2013-09-11,Senate,"Assembly 3rd Reading AB217 Bradford By De Le",27,11,1,0,39
483483,299634,2013-09-12,Assembly,"AB 217 BRADFORD  Concurrence in Senate Amendments",55,21,0,2,78
483485,252177,2013-03-20,Assembly,"Do pass and re-refer to Committee on Appropriations with 	recommendation:  To Consent Calendar",6,0,0,1,7
483485,262679,2013-04-10,Assembly,"Do pass, to Consent Calendar",17,0,0,0,17
483485,268439,2013-04-18,Assembly,"AB 216 STONE  Consent Calendar Second Day  Regular Session",76,0,0,3,79
483485,288488,2013-06-12,Senate,"Do pass as amended, and re-refer to the Committee on Appropriations",9,0,0,0,9
483485,295580,2013-07-01,Senate,"Placed on Appropriations Suspense file",6,0,1,0,7
483485,298642,2013-08-30,Senate,"Do pass as amended",7,0,0,0,7
483485,299023,2013-09-09,Senate,"Assembly 3rd Reading AB216 Stone Urgency Clause",38,0,1,0,39
483485,299216,2013-09-10,Assembly,"AB 216 STONE  Concurrence in Senate Amendments",78,0,0,0,78
483486,257386,2013-04-01,Assembly,"Do pass and re-refer to Committee on Appropriations with 	recommendation:  To Consent Calendar",9,0,0,0,9
483486,267183,2013-04-17,Assembly,"Do pass",17,0,0,0,17
483486,275558,2013-05-02,Assembly,"AB 215 CHESBRO  Assembly Third Reading",73,0,0,6,79
483486,361599,2014-04-30,Senate,"Do pass as amended, and re-refer to the Committee on Appropriations",9,0,0,0,9
483486,365334,2014-05-19,Senate,"Placed on Appropriations Suspense file",7,0,0,0,7
483486,366732,2014-05-23,Senate,"Do pass",7,0,0,0,7
483486,370166,2014-06-09,Senate,"Assembly 3rd Reading AB215 Buchanan By Padilla",33,0,7,0,40
483486,371319,2014-06-12,Assembly,"AB 215 BUCHANAN  Concurrence in Senate Amendments",77,0,0,2,79
483487,250760,2013-03-19,Assembly,"Do pass as amended and be re-referred to the Committee on 	Appropriations",5,0,0,2,7
483487,262634,2013-04-10,Assembly,"Do pass",12,0,0,5,17
483487,265722,2013-04-15,Assembly,"AB 214 SKINNER  Assembly Third Reading",65,5,0,9,79
483487,286852,2013-06-04,Senate,"Do pass, but re-refer to the Committee on Appropriations",3,1,1,0,5
483487,291266,2013-06-24,Senate,"Placed on Appropriations Suspense file",7,0,0,0,7
483487,298194,2013-08-30,Senate,"Do pass",7,0,0,0,7
483487,298944,2013-09-09,Senate,"Assembly 3rd Reading AB214 Skinner By Torres",34,3,2,0,39
483487,299329,2013-09-10,Assembly,"AB 214 SKINNER  Concurrence in Senate Amendments",66,9,0,3,78
483488,261791,2013-04-09,Assembly,"Do pass as amended and be re-referred to the Committee on Veterans 	Affairs",13,0,0,0,13
483488,274690,2013-04-30,Assembly,"Do pass and be re-referred to the Committee on Appropriations",8,0,0,2,10
483489,257461,2013-04-02,Assembly,"Do pass and be re-referred to the Committee on Appropriations",7,2,0,1,10
483489,284094,2013-05-24,Assembly,"Do pass as amended",12,5,0,0,17
483489,285155,2013-05-29,Assembly,"AB 212 LOWENTHAL  Assembly Third Reading",54,22,0,3,79
483489,296137,2013-07-02,Senate,"Do pass, but re-refer to the Committee on Appropriations",4,2,1,0,7
483489,297412,2013-08-12,Senate,"Placed on Appropriations Suspense file",6,0,1,0,7
483489,298494,2013-08-30,Senate,"Do pass",7,0,0,0,7
483489,299078,2013-09-09,Senate,"Assembly 3rd Reading AB212 Lowenthal By Leno",39,0,0,0,39
483489,299304,2013-09-10,Assembly,"AB 212 LOWENTHAL  Concurrence in Senate Amendments",54,23,0,1,78
484734,257429,2013-04-02,Senate,"Do pass, but re-refer to the Committee on Appropriations",5,1,1,0,7
484734,265257,2013-04-15,Senate,"Placed on Appropriations Suspense file",7,0,0,0,7
484739,270989,2013-04-23,Senate,"Do pass as amended, and re-refer to the Committee on Appropriations",6,0,0,0,6
484739,276264,2013-05-06,Senate,"Placed on Appropriations Suspense file",7,0,0,0,7
484742,272134,2013-04-23,Senate,"Do pass",7,0,0,0,7
484742,276421,2013-05-06,Senate,"Senate 3rd Reading SB162 Lieu",35,0,3,0,38
484742,289518,2013-06-18,Assembly,"Do pass, to Consent Calendar",6,0,0,1,7
484742,291339,2013-06-24,Assembly,"SB 162 Lieu  Consent Calendar Second Day  Regular Session",75,0,0,4,79
484744,275556,2013-05-01,Senate,"Do pass, but re-refer to the Committee on Appropriations",7,2,0,0,9
484744,278558,2013-05-13,Senate,"Do pass",4,1,2,0,7
484744,285576,2013-05-30,Senate,"Senate 3rd Reading SB161 Hernandez",32,4,3,0,39
484744,295941,2013-07-02,Assembly,"Do pass as amended and be re-referred to the Committee on 	Appropriations",16,3,0,0,19
484744,297447,2013-08-14,Assembly,"Do pass",14,3,0,0,17
484744,298005,2013-08-26,Assembly,"SB 161 Hernandez  Senate Third Reading  By PEREA",51,21,0,6,78
484744,298303,2013-08-30,Senate,"Unfinished Business SB161 Hernandez Concurrence",25,11,3,0,39
484746,267577,2013-04-17,Senate,"Do pass as amended, and re-refer to the Committee on Public Safety",9,0,0,0,9
484746,281417,2013-05-20,Senate,"Placed on Appropriations Suspense file",6,0,1,0,7
484746,285650,2013-05-30,Senate,"Senate 3rd Reading SB160 Lara",38,0,1,0,39
484749,247857,2013-03-13,Senate,"Do pass",6,0,1,0,7
484749,252562,2013-03-21,Senate,"Senate 3rd Reading SB159 Fuller",33,0,5,0,38
484749,288615,2013-06-12,Assembly,"Do pass",9,0,0,0,9
484749,291241,2013-06-24,Assembly,"SB 159 Fuller  Senate Third Reading  By CONWAY",75,0,0,4,79
484751,261711,2013-04-09,Senate,"Do pass, but re-refer to the Committee on Appropriations",5,0,1,0,6
484751,270054,2013-04-22,Senate,"Placed on Appropriations Suspense file",7,0,0,0,7
484751,283335,2013-05-23,Senate,"Do pass as amended",7,0,0,0,7
484751,285089,2013-05-29,Senate,"Senate 3rd Reading SB158 Correa",39,0,0,0,39
484751,295856,2013-07-02,Assembly,"Do pass and be re-referred to the Committee on Appropriations",7,0,0,0,7
484751,298499,2013-08-30,Assembly,"Do pass",16,0,0,1,17
484751,298747,2013-09-04,Assembly,"SB 158 Correa  Senate Third Reading  By STONE",76,0,0,2,78
485979,257697,2013-04-02,Assembly,"Do pass as amended and be re-referred to the Committee on 	Appropriations",6,3,0,1,10
485979,283837,2013-05-24,Assembly,"Do pass as amended",12,5,0,0,17
485979,285549,2013-05-30,Assembly,"AB 218 DICKINSON  Assembly Third Reading",48,29,0,2,79
485979,291846,2013-06-26,Senate,"Do pass, but re-refer to the Committee on Judiciary",3,1,1,0,5
485979,295983,2013-07-02,Senate,"Do pass, but re-refer to the Committee on Appropriations",4,2,1,0,7
485979,297262,2013-08-12,Senate,"Placed on Appropriations Suspense file",6,0,1,0,7
485979,298217,2013-08-30,Senate,"Do pass",5,2,0,0,7
485979,299355,2013-09-11,Senate,"Assembly 3rd Reading AB218 Dickinson By De Le",20,16,3,0,39
485979,299356,2013-09-11,Senate,"Assembly 3rd Reading AB218 Dickinson Reconsider",38,0,1,0,39
485979,299612,2013-09-12,Senate,"Assembly 3rd Reading AB218 Dickinson By De Le",21,16,2,0,39
485980,262742,2013-04-09,Assembly,"Do pass and be re-referred to the Committee on Appropriations",15,2,0,2,19
485980,267589,2013-04-17,Assembly,"Do pass",15,0,0,2,17
485980,269915,2013-04-22,Assembly,"AB 219 PEREA  Assembly Third Reading",64,9,0,6,79
485980,291950,2013-06-26,Senate,"Do pass as amended, and re-refer to the Committee on 	Appropriations",7,2,0,0,9
485980,297352,2013-08-12,Senate,"Do pass as amended",4,2,1,0,7
485980,299068,2013-09-09,Senate,"Assembly 3rd Reading AB219 Perea By Wright",29,9,1,0,39
485980,299217,2013-09-10,Assembly,"AB 219 PEREA  Concurrence in Senate Amendments",65,11,0,2,78
485983,258377,2013-04-01,Assembly,"Do pass as amended and be re-referred to the Committee on 	Appropriations",9,0,0,0,9
485983,267463,2013-04-17,Assembly,"Do pass, to Consent Calendar",17,0,0,0,17
485983,275620,2013-05-02,Assembly,"AB 221 QUIRK-SILVA  Assembly Third Reading",76,0,0,3,79
485983,289861,2013-06-19,Senate,"Do pass, but re-refer to the Committee on Appropriations Recommend 	Consent",9,0,0,0,9
485983,296220,2013-07-08,Senate,"Consent Calendar 2nd AB221 Quirk-Silva",29,0,9,0,38
485983,297107,2013-08-08,Assembly,"AB 221 QUIRK-SILVA  Concurrence in Senate Amendments",77,0,0,1,78
485984,274698,2013-04-30,Assembly,"Do pass and be re-referred to the Committee on Appropriations",2,3,0,2,7
485984,274699,2013-04-30,Assembly,"Set first hearing.  Failed passage.  Reconsideration granted",7,0,0,0,7
485988,275599,2013-05-01,Assembly,"Do pass as amended and be re-referred to the Committee on 	Appropriations",7,0,0,0,7
485988,283910,2013-05-24,Assembly,"Do pass as amended",17,0,0,0,17
485988,284953,2013-05-29,Assembly,"AB 224 GORDON  Assembly Third Reading",76,0,0,3,79
485988,295860,2013-07-02,Senate,"Do pass, but re-refer to the Committee on Appropriations",4,0,1,0,5
485988,297332,2013-08-12,Senate,"Do pass",5,0,2,0,7
485988,299066,2013-09-09,Senate,"Assembly 3rd Reading AB224 Gordon By Wolk",36,0,3,0,39
485988,299292,2013-09-10,Assembly,"AB 224 GORDON  Concurrence in Senate Amendments",78,0,0,0,78
485989,266620,2013-04-15,Assembly,"Do pass as amended and be re-referred to the Committee on 	Appropriations",12,0,0,4,16
485989,274881,2013-05-01,Assembly,"Do pass",17,0,0,0,17
485989,280292,2013-05-16,Assembly,"AB 225 NESTANDE  Assembly Third Reading",66,0,0,13,79
485989,376450,2014-08-05,Senate,"Do pass as amended, and re-refer to the Committee on 	Appropriations",10,0,1,0,11
485989,376869,2014-08-11,Senate,"Placed on Appropriations Suspense file",7,0,0,0,7
485989,377382,2014-08-14,Senate,"Do pass",5,0,2,0,7
485989,378418,2014-08-25,Senate,"Assembly 3rd Reading AB225 Chau Urgency Clause",32,0,8,0,40
485989,378730,2014-08-27,Assembly,"Senate amendments be concurred in",6,1,0,0,7
485989,378933,2014-08-28,Assembly,"AB 225 CHAU  Concurrence- Urgency Added",70,5,0,4,79
485990,277736,2013-05-08,Assembly,"Do pass",7,0,0,0,7
485990,278765,2013-05-13,Assembly,"AB 226 ATKINS  Assembly Third Reading",75,0,0,4,79
485990,287907,2013-06-10,Senate,"Do pass and be placed on the Consent Calendar",5,0,0,0,5
485990,291275,2013-06-24,Senate,"Consent Calendar 2nd AB226 Atkins",39,0,0,0,39
485992,267241,2013-04-16,Assembly,"Do pass and be re-referred to the Committee on Judiciary",7,0,0,0,7
485992,274094,2013-04-30,Assembly,"Do pass as amended and be re-referred to the Committee on 	Appropriations",10,0,0,0,10
485992,279887,2013-05-15,Assembly,"Do pass, to Consent Calendar",17,0,0,0,17
485992,283906,2013-05-24,Assembly,"AB 227 GATTO  Third Reading Urgency",72,0,0,6,78
485992,289860,2013-06-19,Senate,"Do pass, but re-refer to the Committee on Judiciary",9,0,0,0,9
485992,291688,2013-06-25,Senate,"Do pass as amended, and re-refer to the Committee on 	Appropriations",7,0,0,0,7
485992,299280,2013-09-10,Senate,"Assembly 3rd Reading AB227 Gatto Urgency Clause",37,0,2,0,39
485992,299541,2013-09-11,Assembly,"AB 227 GATTO  Concurrence in Senate Amendments",78,0,0,0,78
485995,268455,2013-04-17,Assembly,"Do pass and be re-referred to the Committee on Appropriations",8,1,0,0,9
485995,274741,2013-05-01,Assembly,"Do pass",16,1,0,0,17
485995,278106,2013-05-09,Assembly,"AB 229 PEREZ, J.  Assembly Third Reading",71,3,0,5,79
485995,287203,2013-06-05,Senate,"Do pass as amended, and re-refer to the Committee on Appropriations",6,1,0,0,7
485995,297920,2013-08-22,Senate,"Assembly 3rd Reading AB229 John A. P",30,6,3,0,39
485995,378686,2014-08-27,Assembly,"AB 229 PEREZ, J.  Concurrence in Senate Amendments",74,4,0,1,79
485998,248800,2013-03-13,Senate,"Do pass, but re-refer to the Committee on Appropriations",3,1,1,0,5
485998,268674,2013-04-18,Senate,"Senate 3rd Reading SB168 Monning",21,11,6,0,38
485998,292237,2013-06-26,Assembly,"Do pass and be re-referred to the Committee on Appropriations",5,2,0,0,7
485998,297437,2013-08-14,Assembly,"Do pass",12,5,0,0,17
485998,298064,2013-08-26,Assembly,"SB 168 Monning  Senate Third Reading  By ALEJO",49,25,0,4,78
485998,298386,2013-08-30,Senate,"Unfinished Business SB168 Monning Concurrence",24,12,3,0,39
485999,258208,2013-04-02,Senate,"Do pass, but re-refer to the Committee on Appropriations",10,1,0,0,11
485999,268733,2013-04-18,Senate,"Senate 3rd Reading SB169 Emmerson",35,0,3,0,38
485999,295894,2013-07-01,Assembly,"Do pass as amended and be re-referred to the Committee on 	Appropriations",15,0,0,1,16
485999,297205,2013-08-12,Assembly,"SB 169 Emmerson  Senate Third Reading  By NESTANDE",72,3,0,3,78
485999,297562,2013-08-15,Senate,"Unfinished Business SB169 Emmerson Concurrence",37,1,1,0,39
486000,259367,2013-04-03,Senate,"Do pass as amended, but re-refer to the Committee on Natural 	Resources and Water Recommend Consent",9,0,0,0,9
486000,270846,2013-04-23,Senate,"Do pass and be placed on the Consent Calendar",9,0,0,0,9
486000,273589,2013-04-29,Senate,"Consent Calendar 2nd SB170 Wolk",37,0,1,0,38
486000,295850,2013-07-02,Assembly,"Do pass, to Consent Calendar",15,0,0,0,15
486000,378583,2014-08-26,Assembly,"SB 170 Wolk  Senate Third Reading  By FRAZIER",78,0,0,1,79
486000,378611,2014-08-27,Senate,"Unfinished Business SB170 Wolk Concurrence",36,0,4,0,40
487893,232749,2013-02-15,Senate,"Special Consent Cal SCR10 Yee",32,0,6,0,38
487895,251986,2013-03-20,Senate,"Do pass, but re-refer to the Committee on Appropriations",8,0,0,0,8
487895,260923,2013-04-08,Senate,"Do pass",7,0,0,0,7
487895,263454,2013-04-11,Senate,"Senate 3rd Reading SB3 Hernandez",37,0,1,0,38
487895,288097,2013-06-11,Assembly,"Do pass as amended and be re-referred to the Committee on 	Appropriations",18,0,0,1,19
487895,291284,2013-06-24,Assembly,"Do pass",12,1,0,4,17
487895,292277,2013-06-27,Assembly,"SB3 Hernandez  Senate Third Reading  By PAN  First Extraordinary 	Session",77,1,0,1,79
487895,295589,2013-07-01,Senate,"Unfinished Business SB3 Hernandez Concurrence",36,0,2,0,38
487899,309088,2014-01-15,Senate,"Do pass, but re-refer to the Committee on Appropriations Recommend 	Consent",9,0,0,0,9
487899,310314,2014-01-21,Senate,"Placed on Appropriations Suspense file",5,0,2,0,7
487899,311137,2014-01-23,Senate,"Do pass",6,0,1,0,7
487899,312688,2014-01-28,Senate,"Senate 3rd Reading SB174 De Le",34,0,5,0,39
487899,370400,2014-06-10,Assembly,"Do pass and be re-referred to the Committee on Appropriations",11,0,0,2,13
487899,377277,2014-08-14,Assembly,"Do pass",17,0,0,0,17
487899,378000,2014-08-20,Assembly,"SB 174 De Leon  Third Reading Urgency  By QUIRK-SILVA",77,1,0,1,79
487902,267585,2013-04-17,Senate,"Do pass as amended, and re-refer to the Committee on Appropriations",9,0,0,0,9
487902,278586,2013-05-13,Senate,"Placed on Appropriations Suspense file",5,0,2,0,7
487902,283140,2013-05-23,Senate,"Do pass as amended",7,0,0,0,7
487902,284940,2013-05-29,Senate,"Senate 3rd Reading SB173 Liu",36,1,2,0,39
487902,291891,2013-06-26,Assembly,"Do pass as amended and be re-referred to the Committee on Higher 	Education",6,0,0,1,7
487902,370434,2014-06-10,Assembly,"Do pass as amended and be re-referred to the Committee on 	Appropriations",11,0,0,2,13
487902,377342,2014-08-14,Assembly,"Do pass as amended",17,0,0,0,17
487902,378776,2014-08-27,Assembly,"SB 173 Liu  Senate Third Reading  By WILLIAMS",75,2,0,2,79
487902,378901,2014-08-28,Senate,"Unfinished Business SB173 Liu Concurrence",35,0,5,0,40
487909,277820,2013-05-08,Senate,"Do pass",6,1,0,0,7
487909,280383,2013-05-16,Senate,"Senate 3rd Reading SB171 Hueso",29,8,1,0,38
487909,288555,2013-06-12,Assembly,"Do pass",8,1,0,0,9
487909,296150,2013-07-03,Assembly,"SB 171 Hueso  Senate Third Reading  By RENDON",53,16,0,9,78
487912,251946,2013-03-19,Assembly,"Be adopted",6,0,0,1,7
487912,259569,2013-04-04,Senate,"Special Consent Cal ACR12 Ian Calderon",33,0,5,0,38
487916,268887,2013-04-17,Assembly,"Do pass",9,0,0,0,9
487916,273485,2013-04-29,Assembly,"AB 240 RENDON  Assembly Third Reading",76,0,0,3,79
487916,288789,2013-06-12,Senate,"Do pass as amended, and re-refer to the Committee on Natural 	Resources and Water",4,1,2,0,7
487916,297936,2013-08-22,Senate,"Do pass, but re-refer to the Committee on Budget and Fiscal Review",7,5,3,0,15
487916,297937,2013-08-22,Senate,"Set, first hearing.  Failed passage in Committee.  Reconsideration 	granted",13,0,2,0,15
487916,298141,2013-08-22,Senate,"Do pass",7,5,3,0,15
487916,298142,2013-08-22,Senate,"Set, first hearing.  Failed passage in Committee.  Reconsideration 	granted",13,0,2,0,15
487916,298175,2013-08-29,Senate,"Do pass",9,5,1,0,15
487916,298647,2013-09-03,Senate,"Assembly 3rd Reading AB240 Rendon By Wolk",22,13,4,0,39
487916,299498,2013-09-11,Assembly,"Senate amendments be concurred in",6,2,0,1,9
487916,299714,2013-09-12,Assembly,"AB 240 RENDON  Concurrence in Senate Amendments",52,24,0,2,78
487919,266189,2013-04-15,Assembly,"Do pass and be re-referred to the Committee on Utilities and 	Commerce",5,0,0,4,9
487919,274142,2013-04-29,Assembly,"Do pass as amended and be re-referred to the Committee on 	Appropriations",7,0,0,8,15
487919,274143,2013-04-29,Assembly,"Set first hearing.  Failed passage.  Reconsideration granted",15,0,0,0,15
487922,257328,2013-04-02,Assembly,"Do pass and re-refer to Committee on Appropriations with 	recommendation:  To Consent Calendar",9,0,0,1,10
487922,262696,2013-04-10,Assembly,"Do pass, to Consent Calendar",17,0,0,0,17
487922,268679,2013-04-18,Assembly,"AB 238 GOMEZ  Consent Calendar Second Day  Regular Session",76,0,0,3,79
487922,279515,2013-05-14,Senate,"Do pass as amended, and re-refer to the Committee on Appropriations",7,0,0,0,7
487922,291224,2013-06-24,Senate,"Do pass",7,0,0,0,7
487922,296195,2013-07-08,Senate,"Assembly 3rd Reading AB238 Gomez By Correa",33,0,5,0,38
487922,297137,2013-08-08,Assembly,"AB 238 GOMEZ  Concurrence in Senate Amendments",77,0,0,1,78
487925,272009,2013-04-24,Assembly,"Do pass and be re-referred to the Committee on Appropriations",5,2,0,0,7
487925,283825,2013-05-24,Assembly,"Do pass",12,0,0,5,17
487929,271584,2013-04-24,Assembly,"Do pass and be re-referred to the Committee on Appropriations",5,2,0,0,7
487929,283829,2013-05-24,Assembly,"Do pass",12,1,0,4,17
487932,274926,2013-05-01,Assembly,"Do pass",12,0,0,5,17
487932,278254,2013-05-09,Assembly,"AB 235 GATTO  Third Reading Urgency",71,1,0,7,79
487932,291362,2013-06-24,Senate,"Do pass",7,0,0,0,7
487932,296449,2013-07-11,Senate,"Assembly 3rd Reading AB235 Gatto Urgency Clause",30,0,8,0,38
487936,297438,2013-08-14,Assembly,"Do pass",16,0,0,1,17
487936,297647,2013-08-19,Assembly,"AB 234 GATTO  Third Reading Urgency",74,1,0,3,78
487936,297978,2013-08-26,Senate,"Do pass",7,0,0,0,7
487936,299375,2013-09-11,Senate,"Assembly 3rd Reading AB234 Gatto Urgency Clause",36,1,2,0,39
487939,257552,2013-04-02,Assembly,"Do pass as amended",7,2,0,1,10
487939,263459,2013-04-11,Assembly,"AB 233 WIECKOWSKI  Assembly Third Reading",50,23,0,6,79
487939,289404,2013-06-18,Senate,"Do pass",5,1,1,0,7
487939,299399,2013-09-11,Senate,"Assembly 3rd Reading AB233 Wieckowski By Evans",14,19,6,0,39
487939,299400,2013-09-11,Senate,"Assembly 3rd Reading AB233 Wieckowski Reconsider",38,0,1,0,39
487939,378888,2014-08-28,Senate,"Assembly 3rd Reading AB233 Wieckowski By Evans",13,17,10,0,40
487940,266271,2013-04-16,Assembly,"Do pass and be re-referred to the Committee on Revenue and Taxation",5,2,0,0,7
487940,305725,2014-01-06,Assembly,"Be referred to Committee on Public Safety",9,0,0,1,10
487941,266293,2013-04-16,Assembly,"Do pass as amended and be re-referred to the Committee on 	Appropriations",5,2,0,0,7
487941,274784,2013-05-01,Assembly,"Do pass as amended",11,5,0,1,17
487941,284649,2013-05-28,Assembly,"AB 231 TING  Assembly Third Reading",46,30,0,3,79
487941,289357,2013-06-18,Senate,"Do pass, but re-refer to the Committee on Appropriations",5,1,1,0,7
487941,298915,2013-09-09,Senate,"Assembly 3rd Reading AB231 Ting By DeSaulnier",24,15,0,0,39
487941,299206,2013-09-10,Assembly,"AB 231 TING  Concurrence in Senate Amendments",48,30,0,0,78
487942,308658,2014-01-14,Assembly,"Do pass",14,0,0,0,14
487942,309852,2014-01-17,Assembly,"AB 230 MAIENSCHEIN  Assembly Third Reading",73,0,0,7,80
487942,372312,2014-06-17,Senate,"Do pass",5,0,2,0,7
487942,375714,2014-07-03,Senate,"Special Consent #18 AB230 Maienschein",35,0,5,0,40
489646,272277,2013-04-24,Assembly,"Do pass and be re-referred to the Committee on Appropriations",5,2,0,0,7
489646,283775,2013-05-24,Assembly,"Do pass as amended",12,5,0,0,17
489646,285066,2013-05-29,Assembly,"AB 241 AMMIANO  Assembly Third Reading",45,25,0,9,79
489646,291871,2013-06-26,Senate,"Do pass as amended, and re-refer to the Committee on Appropriations",3,1,1,0,5
489646,297667,2013-08-19,Senate,"Placed on Appropriations Suspense file",7,0,0,0,7
489646,298267,2013-08-30,Senate,"Do pass as amended",5,2,0,0,7
489646,299417,2013-09-11,Senate,"Assembly 3rd Reading AB241 Ammiano By De Le",23,12,4,0,39
489646,299653,2013-09-12,Assembly,"AB 241 AMMIANO  Concurrence in Senate Amendments",52,25,0,1,78
489648,268701,2013-04-17,Assembly,"Do pass and be re-referred to the Committee on Appropriations",6,3,0,0,9
489648,275307,2013-05-01,Assembly,"Do pass",12,5,0,0,17
489648,278169,2013-05-09,Assembly,"AB 243 DICKINSON  Assembly Third Reading",44,29,0,6,79
489648,288722,2013-06-12,Senate,"Do pass as amended, and re-refer to the Committee on 	Appropriations",4,2,1,0,7
489648,298688,2013-09-03,Senate,"Assembly 3rd Reading AB243 Dickinson By Wolk",22,13,4,0,39
489649,270189,2013-04-22,Assembly,"Do pass as amended and be re-referred to the Committee on Veterans 	Affairs",16,0,0,0,16
489649,274880,2013-04-30,Assembly,"Do pass and be re-referred to the Committee on Appropriations",7,0,0,3,10
489649,283817,2013-05-24,Assembly,"Do pass",17,0,0,0,17
489649,284724,2013-05-28,Assembly,"AB 244 BONILLA  Assembly Third Reading",78,0,0,1,79
489649,291582,2013-06-25,Senate,"Do pass, but re-refer to the Committee on Transportation and 	Housing",7,0,0,0,7
489649,295785,2013-07-02,Senate,"Do pass as amended, but re-refer to the Committee on Appropriations 	Recommend Consent",11,0,0,0,11
489649,297691,2013-08-19,Senate,"Do pass",7,0,0,0,7
489649,298640,2013-09-03,Senate,"Assembly 3rd Reading AB244 Bonilla By Gaines",38,0,1,0,39
489649,298880,2013-09-06,Assembly,"AB 244 BONILLA  Concurrence in Senate Amendments",78,0,0,0,78
489650,272487,2013-04-24,Assembly,"Do pass and be re-referred to the Committee on Appropriations",5,9,0,3,17
489650,272488,2013-04-24,Assembly,"Set first hearing.  Failed passage.  Reconsideration granted",17,0,0,0,17
489651,258455,2013-04-03,Assembly,"Do pass",9,0,0,0,9
489651,265866,2013-04-15,Assembly,"AB 246 BRADFORD  Assembly Third Reading",69,5,0,5,79
489651,279916,2013-05-15,Senate,"Do pass",7,0,0,0,7
489651,286583,2013-06-03,Senate,"Assembly 3rd Reading AB246 Bradford By Hernandez",32,4,3,0,39
489652,270079,2013-04-22,Assembly,"Do pass and be re-referred to the Committee on Appropriations",9,0,0,0,9
489652,274837,2013-05-01,Assembly,"Do pass, to Consent Calendar",17,0,0,0,17
489652,278808,2013-05-13,Assembly,"AB 247 WAGNER  Assembly Third Reading",75,0,0,4,79
489652,291879,2013-06-26,Senate,"Do pass, but re-refer to the Committee on Appropriations",7,0,0,0,7
489652,297249,2013-08-12,Senate,"Do pass",5,0,2,0,7
489652,298695,2013-09-03,Senate,"Assembly 3rd Reading AB247 Wagner By Berryhill",38,0,1,0,39
489654,274131,2013-04-29,Assembly,"Do pass and be re-referred to the Committee on Utilities and 	Commerce",3,2,0,4,9
489654,274132,2013-04-29,Assembly,"Set second hearing.  Failed passage.  Reconsideration granted",9,0,0,0,9
489655,266316,2013-04-16,Assembly,"Do pass and be re-referred to the Committee on Business, 	Professions and Consumer Protection",2,5,0,0,7
489656,262111,2013-04-09,Assembly,"Do pass as amended and be re-referred to the Committee on 	Appropriations",7,1,0,1,9
489656,283843,2013-05-24,Assembly,"Do pass as amended",13,0,0,4,17
489656,285607,2013-05-30,Assembly,"AB 250 HOLDEN  Assembly Third Reading",73,5,0,1,79
489656,291270,2013-06-24,Senate,"Do pass as amended, and re-refer to the Committee on Appropriations",9,0,1,0,10
489656,298047,2013-08-26,Senate,"Assembly 3rd Reading AB250 Holden By Hill",39,0,0,0,39
489656,298465,2013-08-30,Assembly,"AB 250 HOLDEN  Concurrence in Senate Amendments",74,4,0,0,78
489657,261709,2013-04-09,Assembly,"Do pass and be re-referred to the Committee on Appropriations",3,6,0,1,10
489657,261710,2013-04-09,Assembly,"Set second hearing.  Failed passage.  Reconsideration granted",10,0,0,0,10
489658,270730,2013-04-23,Assembly,"Do pass and be re-referred to the Committee on Appropriations",11,1,0,1,13
489659,262772,2013-04-10,Assembly,"Do pass and be re-referred to the Committee on Housing and 	Community Development",9,0,0,0,9
489659,274789,2013-05-01,Assembly,"Do pass as amended and be re-referred to the Committee on 	Appropriations",7,0,0,0,7
489659,279708,2013-05-15,Assembly,"Do pass, to Consent Calendar",17,0,0,0,17
489659,283318,2013-05-23,Assembly,"AB 253 LEVINE  Consent Calendar Second Day  Regular Session",74,0,0,4,78
489659,289823,2013-06-19,Senate,"Do pass as amended, and re-refer to the Committee on Appropriations",6,0,1,0,7
489659,298035,2013-08-26,Senate,"Assembly 3rd Reading AB253 Levine By Evans",39,0,0,0,39
489659,299007,2013-09-09,Senate,"Assembly 3rd Reading AB253 Levine By Evans",39,0,0,0,39
489659,299240,2013-09-10,Assembly,"AB 253 LEVINE  Concurrence in Senate Amendments",78,0,0,0,78
489660,258500,2013-04-03,Assembly,"Do pass",9,0,0,0,9
489660,263456,2013-04-11,Assembly,"AB 254 DAHLE  Assembly Third Reading",76,0,0,3,79
489660,279681,2013-05-15,Senate,"Do pass",7,0,0,0,7
489660,287719,2013-06-10,Senate,"Assembly 3rd Reading AB254 Dahle By Wolk",31,0,8,0,39
489663,276888,2013-05-06,Assembly,"Be adopted as amended",7,4,0,1,12
489663,280411,2013-05-16,Assembly,"AJR 11 WIECKOWSKI  Assembly Third Reading",46,19,0,14,79
489663,289416,2013-06-18,Senate,"Be adopted",5,1,1,0,7
489663,298623,2013-09-03,Senate,"Assembly 3rd Reading AJR11 Wieckowski By Leno",22,11,6,0,39
489664,297507,2013-08-12,Assembly,"Be adopted as amended",5,2,0,2,9
489664,297716,2013-08-19,Assembly,"AJR 12 GATTO  Assembly Third Reading",52,22,0,4,78
489664,299414,2013-09-11,Senate,"Assembly 3rd Reading AJR12 Gatto By Lieu",26,10,3,0,39
489666,261913,2013-04-09,Senate,"Do pass, but re-refer to the Committee on Appropriations",11,0,0,0,11
489666,273539,2013-04-29,Senate,"Placed on Appropriations Suspense file",7,0,0,0,7
489666,283156,2013-05-23,Senate,"Do pass as amended",7,0,0,0,7
489666,285211,2013-05-29,Senate,"Senate 3rd Reading SB176 Galgiani",39,0,0,0,39
489666,297443,2013-08-14,Assembly,"Do pass and be re-referred to the Committee on Appropriations",12,0,0,1,13
489667,258791,2013-04-03,Senate,"Do pass as amended, and re-refer to the Committee on Human Services",9,0,0,0,9
489667,270842,2013-04-23,Senate,"Do pass as amended, but re-refer to the Committee on Appropriations 	Recommend Consent",6,0,0,0,6
489667,272370,2013-04-23,Senate,"Do pass, but re-refer to the Committee on Appropriations Recommend 	Consent",6,0,0,0,6
489667,276334,2013-05-06,Senate,"Placed on Appropriations Suspense file",7,0,0,0,7
489667,283193,2013-05-23,Senate,"Do pass as amended",7,0,0,0,7
489667,284604,2013-05-28,Senate,"Senate 3rd Reading SB177 Liu",39,0,0,0,39
489667,295909,2013-07-02,Assembly,"Do pass and be re-referred to the Committee on Education to Consent 	Calendar",7,0,0,0,7
489667,297476,2013-08-14,Assembly,"Do pass and re-refer to Committee on Appropriations with 	recommendation:  To Consent Calendar",7,0,0,0,7
489667,298349,2013-08-30,Assembly,"Do pass",17,0,0,0,17
489667,299006,2013-09-09,Assembly,"SB 177 Liu  Senate Third Reading  By EGGMAN",78,0,0,0,78
489667,299306,2013-09-10,Senate,"Unfinished Business SB177 Liu Concurrence",37,0,2,0,39
489671,247855,2013-03-13,Senate,"Do pass, but re-refer to the Committee on Appropriations Recommend 	Consent",6,0,1,0,7
489671,263478,2013-04-11,Senate,"Consent Calendar 2nd SB181 Committee on GOV. & F. (Wolk)",36,0,2,0,38
489671,288435,2013-06-12,Assembly,"Do pass, to Consent Calendar",9,0,0,0,9
489671,290181,2013-06-20,Assembly,"SB 181 GOV.& F.  Consent Calendar Second Day",79,0,0,0,79
489671,291218,2013-06-24,Senate,"Unfinished Business SB181 Committee on GOV. & F. (Wolk) Concurrence",39,0,0,0,39
489673,247850,2013-03-13,Senate,"Do pass, but re-refer to the Committee on Appropriations Recommend 	Consent",6,0,1,0,7
489673,263509,2013-04-11,Senate,"Consent Calendar 2nd SB182 Committee on GOV. & F. (Wolk)",36,0,2,0,38
489673,288492,2013-06-12,Assembly,"Do pass, to Consent Calendar",9,0,0,0,9
489673,290265,2013-06-20,Assembly,"SB 182 GOV.& F.  Consent Calendar Second Day  Regular Session",79,0,0,0,79
489673,298037,2013-08-26,Senate,"Unfinished Business SB182 Committee on GOV. & F. (Wolk) Concurrence",37,0,2,0,39
489674,248082,2013-03-13,Senate,"Do pass and be placed on the Consent Calendar",6,0,1,0,7
489674,252634,2013-03-21,Senate,"Consent Calendar 2nd SB183 Committee on GOV. & F. (Wolk)",33,0,5,0,38
489674,288445,2013-06-12,Assembly,"Do pass, to Consent Calendar",9,0,0,0,9
489674,290211,2013-06-20,Assembly,"SB 183 GOV.& F.  Consent Calendar Second Day  Regular Session",79,0,0,0,79
489674,298051,2013-08-26,Senate,"Unfinished Business SB183 Committee on GOV. & F. (Wolk) Concurrence",37,0,2,0,39
489675,267363,2013-04-17,Senate,"Do pass, but re-refer to the Committee on Appropriations Recommend 	Consent",7,0,0,0,7
489675,275690,2013-05-02,Senate,"Consent Calendar 2nd SB184 Committee on GOV. & F. (Wolk)",35,0,3,0,38
489675,291973,2013-06-26,Assembly,"Do pass and be re-referred to the Committee on Appropriations to 	Consent Calendar",9,0,0,0,9
489675,296081,2013-07-03,Assembly,"Do pass, to Consent Calendar",17,0,0,0,17
489675,297763,2013-08-19,Assembly,"SB 184 GOV.& F.  Senate Third Reading  By ACHADJIAN",77,0,0,1,78
489675,297964,2013-08-22,Senate,"Unfinished Business SB184 Committee on GOV. & F. (Wolk) Concurrence",37,0,2,0,39
489676,277409,2013-05-08,Senate,"Do pass as amended",7,0,2,0,9
489676,281360,2013-05-20,Senate,"Senate 3rd Reading SB185 Walters",34,0,5,0,39
489676,288561,2013-06-12,Assembly,"Do pass as amended",7,0,0,0,7
489676,297177,2013-08-08,Assembly,"SB 185 Walters  Senate Third Reading  By OLSEN",76,1,0,1,78
489676,297594,2013-08-15,Senate,"Unfinished Business SB185 Walters Concurrence",38,0,1,0,39
489679,257618,2013-04-02,Senate,"Do pass, but re-refer to the Committee on Rules",7,0,0,0,7
489679,265271,2013-04-15,Senate,"Placed on Appropriations Suspense file",7,0,0,0,7
489680,232742,2013-02-15,Senate,"Senate 3rd Reading SR11 Cannella",32,0,6,0,38
491243,271082,2013-04-23,Senate,"Do pass as amended",11,0,0,0,11
491243,281318,2013-05-20,Senate,"Special Consent #5 SB203 Pavley",36,0,3,0,39
491243,295869,2013-07-01,Assembly,"Do pass as amended and re-refer to Committee on Appropriations 	with recommendation:  To Consent Calendar",15,0,0,1,16
491243,297473,2013-08-14,Assembly,"Do pass, to Consent Calendar",17,0,0,0,17
491243,297942,2013-08-22,Assembly,"SB 203 Pavley  Consent Calendar Second Day  Regular Session",78,0,0,0,78
491243,298400,2013-08-30,Senate,"Special Consent #9 SB203 Pavley",38,0,1,0,39
491244,261415,2013-04-08,Senate,"Do pass, but re-refer to the Committee on Appropriations",10,0,0,0,10
491244,270011,2013-04-22,Senate,"Do pass",7,0,0,0,7
491244,278145,2013-05-09,Senate,"Senate 3rd Reading SB202 Galgiani",34,0,4,0,38
491244,288156,2013-06-11,Assembly,"Do pass and be re-referred to the Committee on Appropriations",12,0,0,1,13
491245,258512,2013-04-03,Senate,"Do pass, but re-refer to the Committee on Appropriations",8,1,0,0,9
491245,265392,2013-04-15,Senate,"Placed on Appropriations Suspense file",7,0,0,0,7
491245,283141,2013-05-23,Senate,"Do pass",5,2,0,0,7
491245,284600,2013-05-28,Senate,"Senate 3rd Reading SB201 Liu",30,9,0,0,39
491245,297491,2013-08-14,Assembly,"Do pass and be re-referred to the Committee on Appropriations",7,0,0,0,7
491245,298370,2013-08-30,Assembly,"Do pass as amended",13,0,0,4,17
491245,299019,2013-09-09,Assembly,"SB 201 Liu  Senate Third Reading  By GONZALEZ",59,14,0,5,78
491245,299230,2013-09-10,Senate,"Unfinished Business SB201 Liu Concurrence",28,9,2,0,39
491247,308576,2014-01-14,Senate,"Do pass, but re-refer to the Committee on Appropriations",5,1,1,0,7
491247,310355,2014-01-21,Senate,"Placed on Appropriations Suspense file",5,0,2,0,7
491247,311134,2014-01-23,Senate,"Do pass",5,1,1,0,7
491247,312707,2014-01-28,Senate,"Senate 3rd Reading SB199 De Le",23,8,8,0,39
491247,374044,2014-06-24,Assembly,"Do pass and be re-referred to the Committee on Appropriations",5,2,0,0,7
491247,376660,2014-08-06,Assembly,"Do pass",12,5,0,0,17
491247,378555,2014-08-26,Assembly,"SB 199 De Leon  Senate Third Reading  By LEVINE",43,34,0,2,79
491247,378845,2014-08-28,Senate,"Unfinished Business SB199 De Le",23,12,5,0,40
491248,273603,2013-04-29,Senate,"Do pass as amended, and re-refer to the Committee on Appropriations",10,0,0,0,10
491248,281408,2013-05-20,Senate,"Do pass",6,0,1,0,7
491248,284598,2013-05-28,Senate,"Special Consent #6 SB198 Price",39,0,0,0,39
491248,291548,2013-06-25,Assembly,"Do pass and be re-referred to the Committee on Appropriations",13,0,0,0,13
491248,298292,2013-08-30,Assembly,"Do pass",16,0,0,1,17
491248,299210,2013-09-10,Assembly,"SB 198 Lieu  Senate Third Reading  By WIECKOWSKI",74,1,0,3,78
491248,299459,2013-09-11,Senate,"Unfinished Business SB198 Lieu Concurrence",37,0,2,0,39
491249,262189,2013-04-09,Senate,"Do pass, but re-refer to the Committee on Appropriations",9,0,0,0,9
491249,270149,2013-04-22,Senate,"Placed on Appropriations Suspense file",7,0,0,0,7
491249,283343,2013-05-23,Senate,"Do pass",7,0,0,0,7
491249,284676,2013-05-28,Senate,"Senate 3rd Reading SB197 Evans",34,3,2,0,39
491249,289458,2013-06-18,Assembly,"Do pass and be re-referred to the Committee on Appropriations",10,2,0,3,15
491249,298352,2013-08-30,Assembly,"Do pass as amended",13,3,0,1,17
491249,299094,2013-09-09,Assembly,"SB 197 Evans  Senate Third Reading  By CHESBRO",63,10,0,5,78
491249,299312,2013-09-10,Senate,"Unfinished Business SB197 Evans Concurrence",36,2,1,0,39
491250,267347,2013-04-16,Senate,"Do pass as amended, and re-refer to the Committee on Rules",7,0,0,0,7
491250,274163,2013-04-30,Senate,"Do pass",11,0,0,0,11
491250,276273,2013-05-06,Senate,"Senate 3rd Reading SB196 Cannella",34,0,4,0,38
491250,289403,2013-06-17,Assembly,"Amend, and do pass as amended and be re-referred to the Committee 	on Housing and Community Development with the recommendation:  To 	Consent Calendar",12,0,0,3,15
491250,297180,2013-08-12,Assembly,"Do pass, to Consent Calendar",7,0,0,0,7
491250,297547,2013-08-15,Assembly,"SB 196 Cannella  Consent Calendar Second Day  Regular Session",76,0,0,2,78
491250,297657,2013-08-19,Senate,"Unfinished Business SB196 Cannella Concurrence",36,0,3,0,39
491251,267525,2013-04-17,Senate,"Do pass as amended, and re-refer to the Committee on Appropriations",8,1,0,0,9
491251,278848,2013-05-13,Senate,"Placed on Appropriations Suspense file",5,0,2,0,7
491251,283165,2013-05-23,Senate,"Do pass as amended",6,1,0,0,7
491251,284599,2013-05-28,Senate,"Senate 3rd Reading SB195 Liu",30,8,1,0,39
491251,297478,2013-08-14,Assembly,"Do pass as amended and be re-referred to the Committee on 	Appropriations",13,0,0,0,13
491251,298442,2013-08-30,Assembly,"Do pass",17,0,0,0,17
491251,298894,2013-09-06,Assembly,"SB 195 Liu  Senate Third Reading  By WILLIAMS  Amend By WILLIAMS 	Set #1",53,24,0,1,78
491251,299257,2013-09-10,Assembly,"SB 195 Liu  Senate Third Reading  By WILLIAMS",57,19,0,2,78
491251,299518,2013-09-11,Senate,"Unfinished Business SB195 Liu Concurrence",26,10,3,0,39
491252,257545,2013-04-02,Senate,"Do pass, but re-refer to the Committee on Appropriations",11,0,0,0,11
491252,270029,2013-04-22,Senate,"Senate 3rd Reading SB194 Galgiani",35,3,0,0,38
491252,289391,2013-06-17,Assembly,"Do pass and be re-referred to the Committee on Appropriations",15,0,0,1,16
491252,296071,2013-07-03,Assembly,"Do pass",16,1,0,0,17
491252,298603,2013-09-03,Assembly,"SB 194 Galgiani  Senate Third Reading  By FRAZIER",70,4,0,4,78
491253,271582,2013-04-23,Senate,"Do pass, but re-refer to the Committee on Appropriations",5,2,0,0,7
491253,284627,2013-05-28,Senate,"Senate 3rd Reading SB193 Monning",21,14,4,0,39
491253,291543,2013-06-25,Assembly,"Do pass and be re-referred to the Committee on Environmental Safety 	and Toxic Materials",6,2,0,2,10
491253,295798,2013-07-02,Assembly,"Do pass as amended and be re-referred to the Committee on 	Appropriations",5,2,0,0,7
491253,377044,2014-08-13,Assembly,"Do pass as amended",12,4,0,1,17
491253,378342,2014-08-25,Assembly,"SB 193 Monning  Senate Third Reading  By MURATSUCHI",56,23,0,0,79
491253,378477,2014-08-26,Senate,"Unfinished Supp 1 SB193 Monning Concurrence",27,8,5,0,40
491254,272273,2013-04-24,Senate,"Do pass, but re-refer to the Committee on Appropriations",7,1,1,0,9
491254,276261,2013-05-06,Senate,"Placed on Appropriations Suspense file",7,0,0,0,7
491254,283266,2013-05-23,Senate,"Do pass as amended",5,2,0,0,7
491254,285064,2013-05-29,Senate,"Senate 3rd Reading SB192 Liu",32,5,2,0,39
491254,374839,2014-06-25,Assembly,"Do pass and be re-referred to the Committee on Appropriations",6,0,0,1,7
491255,262566,2013-04-10,Senate,"Do pass, but re-refer to the Committee on Public Safety",9,0,0,0,9
491255,274920,2013-04-30,Senate,"Do pass",7,0,0,0,7
491255,276305,2013-05-06,Senate,"Senate 3rd Reading SB191 Padilla",33,1,4,0,38
491255,289575,2013-06-18,Assembly,"Do pass as amended",19,0,0,0,19
491255,295505,2013-07-01,Assembly,"SB 191 Padilla  Senate Third Reading  By PAN",70,2,0,6,78
491255,298055,2013-08-26,Assembly,"SB 191 Padilla  Senate Third Reading  By PAN",74,2,0,2,78
491255,298375,2013-08-30,Senate,"Unfinished Business SB191 Padilla Concurrence",37,1,1,0,39
491256,270759,2013-04-23,Senate,"Do pass as amended, and re-refer to the Committee on 	Appropriations",11,0,0,0,11
491256,278577,2013-05-13,Senate,"Placed on Appropriations Suspense file",5,0,2,0,7
491257,275635,2013-05-01,Senate,"Do pass as amended, and re-refer to the Committee on 	Appropriations",5,2,2,0,9
491257,281511,2013-05-20,Senate,"Placed on Appropriations Suspense file",6,0,1,0,7
491257,283280,2013-05-23,Senate,"Do pass",2,3,2,0,7
491258,275831,2013-05-01,Assembly,"Do pass and be re-referred to the Committee on Appropriations",6,1,0,0,7
491259,247898,2013-03-13,Assembly,"Do pass and be re-referred to the Committee on Appropriations",7,0,0,0,7
491259,262801,2013-04-10,Assembly,"Do pass, to Consent Calendar",17,0,0,0,17
491259,269913,2013-04-22,Assembly,"Do pass, to Consent Calendar",10,0,0,1,11
491259,272262,2013-04-25,Assembly,"AB 272 GOMEZ  Consent Calendar Second Day  Regular Session",76,0,0,3,79
491259,291964,2013-06-26,Senate,"Do pass as amended, and re-refer to the Committee on 	Appropriations",9,0,0,0,9
491259,298684,2013-09-03,Senate,"Assembly 3rd Reading AB272 Gomez By Pavley",38,0,1,0,39
491259,298898,2013-09-06,Assembly,"AB 272 GOMEZ  Concurrence in Senate Amendments",75,0,0,3,78
491260,258527,2013-04-02,Assembly,"Do pass as amended and be re-referred to the Committee on 	Appropriations",5,1,0,1,7
491260,284038,2013-05-24,Assembly,"Do pass as amended",12,5,0,0,17
491260,285641,2013-05-30,Assembly,"AB 271 MITCHELL  Assembly Third Reading",53,25,0,1,79
491260,291677,2013-06-25,Senate,"Do pass, but re-refer to the Committee on Appropriations",4,2,0,0,6
491260,297358,2013-08-12,Senate,"Placed on Appropriations Suspense file",6,0,1,0,7
491261,260985,2013-04-08,Assembly,"Do pass as amended and be re-referred to the Committee on 	Appropriations",15,0,0,0,15
491261,277416,2013-05-08,Assembly,"Do pass, to Consent Calendar",17,0,0,0,17
491261,280250,2013-05-16,Assembly,"AB 270 BRADFORD  Consent Calendar Second Day  Regular Session",70,0,0,9,79
491261,289701,2013-06-18,Senate,"Do pass as amended, and re-refer to the Committee on Appropriations",8,0,3,0,11
491261,298625,2013-09-03,Senate,"Assembly 3rd Reading AB270 Bradford By Hueso",37,0,2,0,39
491261,298871,2013-09-06,Assembly,"AB 270 BRADFORD  Concurrence in Senate Amendments",78,0,0,0,78
491262,261779,2013-04-09,Assembly,"Do pass as amended and be re-referred to the Committee on Veterans 	Affairs",7,0,0,0,7
491262,274972,2013-04-30,Assembly,"Do pass and be re-referred to the Committee on Appropriations",8,0,0,2,10
491262,283852,2013-05-24,Assembly,"Do pass",17,0,0,0,17
491262,285676,2013-05-30,Assembly,"AB 269 GROVE  Assembly Third Reading",78,0,0,1,79
491262,374551,2014-06-24,Senate,"Do pass as amended, and re-refer to the Committee on Appropriations",4,1,0,0,5
491264,257908,2013-04-02,Assembly,"Do pass as amended",8,1,0,1,10
491264,268699,2013-04-18,Assembly,"AB 267 CHAU  Assembly Third Reading",56,20,0,3,79
491264,286949,2013-06-04,Senate,"Do pass",6,0,1,0,7
491264,296238,2013-07-08,Senate,"Assembly 3rd Reading AB267 Chau By Evans",32,0,6,0,38
491265,266554,2013-04-15,Assembly,"Do pass and be re-referred to the Committee on Appropriations",12,3,0,1,16
491265,274785,2013-05-01,Assembly,"Do pass",13,4,0,0,17
491265,281244,2013-05-20,Assembly,"AB 266 BLUMENFIELD  Assembly Third Reading",49,22,0,7,78
491265,295794,2013-07-02,Senate,"Do pass as amended, and re-refer to the Committee on 	Appropriations",11,0,0,0,11
491265,298579,2013-09-03,Senate,"Assembly 3rd Reading AB266 Blumenfield By Yee",29,8,2,0,39
491265,298758,2013-09-06,Assembly,"AB 266  Concurrence in Senate Amendments By BLOOM",56,20,0,2,78
491266,257551,2013-04-02,Assembly,"Do pass and be re-referred to the Committee on Local Government",9,0,0,1,10
491266,278239,2013-05-08,Assembly,"Do pass, to Consent Calendar",8,0,0,1,9
491266,281361,2013-05-20,Assembly,"AB 265 GATTO  Assembly Third Reading",75,0,0,3,78
491266,289425,2013-06-18,Senate,"Do pass and be placed on the Consent Calendar",6,0,1,0,7
491266,291239,2013-06-24,Senate,"Consent Calendar 2nd AB265 Gatto",39,0,0,0,39
491266,292152,2013-06-27,Assembly,"AB 265 GATTO  Concurrence in Senate Amendments",78,0,0,1,79
491267,308664,2014-01-14,Assembly,"Do pass and be re-referred to the Committee on Appropriations",5,0,0,2,7
491267,311108,2014-01-23,Assembly,"Do pass as amended",16,0,0,1,17
491267,313207,2014-01-29,Assembly,"AB 264 MAIENSCHEIN  Assembly Third Reading",78,0,0,2,80
491267,370700,2014-06-10,Senate,"Do pass as amended, but re-refer to the Committee on Appropriations 	Recommend Consent",4,0,1,0,5
491267,373760,2014-06-23,Senate,"Placed on Appropriations Suspense file",7,0,0,0,7
491268,270785,2013-04-23,Assembly,"Do pass and be re-referred to the Committee on Labor and Employment",7,2,0,1,10
491268,275615,2013-05-01,Assembly,"Do pass and be re-referred to the Committee on Appropriations",5,1,0,1,7
491268,283960,2013-05-24,Assembly,"Do pass as amended",12,4,0,1,17
491268,285117,2013-05-29,Assembly,"AB 263 HERNANDEZ  Assembly Third Reading",52,23,0,4,79
491268,291914,2013-06-26,Senate,"Do pass, but re-refer to the Committee on Judiciary",3,0,2,0,5
491268,296003,2013-07-02,Senate,"Do pass as amended, and re-refer to the Committee on 	Appropriations",4,2,1,0,7
491268,297747,2013-08-19,Senate,"Placed on Appropriations Suspense file",7,0,0,0,7
491268,298425,2013-08-30,Senate,"Do pass as amended",5,2,0,0,7
491268,299089,2013-09-09,Senate,"Assembly 3rd Reading AB263 Roger Hern",27,11,1,0,39
491268,299311,2013-09-10,Assembly,"AB 263 HERNANDEZ  Concurrence in Senate Amendments",54,19,0,5,78
491268,370125,2014-06-02,Assembly,"Be referred to Committee on Labor and Employment",11,0,0,0,11
491270,258513,2013-04-02,Assembly,"Do pass and re-refer to Committee on Appropriations with 	recommendation:  To Consent Calendar",7,0,0,0,7
491270,267200,2013-04-17,Assembly,"Do pass, to Consent Calendar",17,0,0,0,17
491270,272325,2013-04-25,Assembly,"AB 261 CHESBRO  Consent Calendar Second Day  Regular Session",76,0,0,3,79
491270,291648,2013-06-25,Senate,"Do pass, but re-refer to the Committee on Appropriations Recommend 	Consent",6,0,0,0,6
491270,297567,2013-08-15,Senate,"Consent Calendar 2nd AB261 Chesbro By Wolk",38,0,1,0,39
491270,297730,2013-08-19,Assembly,"AB 261 CHESBRO  Concurrence in Senate Amendments",77,0,0,1,78
491271,267926,2013-04-16,Assembly,"Do pass as amended and be re-referred to the Committee on 	Appropriations",7,0,0,0,7
491271,283823,2013-05-24,Assembly,"Do pass",17,0,0,0,17
491271,284657,2013-05-28,Assembly,"AB 260 GORDON  Assembly Third Reading",78,0,0,1,79
491271,289822,2013-06-19,Senate,"Do pass, but re-refer to the Committee on Appropriations",9,0,0,0,9
491271,295322,2013-07-01,Senate,"Placed on Appropriations Suspense file",6,0,1,0,7
491271,298311,2013-08-30,Senate,"Do pass as amended",7,0,0,0,7
491271,298935,2013-09-09,Senate,"Assembly 3rd Reading AB260 Gordon By Hill",39,0,0,0,39
491271,299143,2013-09-10,Assembly,"AB 260 GORDON  Concurrence in Senate Amendments",77,0,0,1,78
491272,262747,2013-04-09,Assembly,"Do pass as amended and be re-referred to the Committee on Business, 	Professions and Consumer Protection",18,0,0,1,19
491272,275272,2013-05-01,Assembly,"Do pass, to Consent Calendar",17,0,0,0,17
491272,278220,2013-05-09,Assembly,"AB 259 LOGUE  Consent Calendar Second Day  Regular Session",75,0,0,4,79
491273,258487,2013-04-02,Assembly,"Do pass and be re-referred to the Committee on Appropriations",9,0,0,1,10
491273,267863,2013-04-17,Assembly,"Do pass as amended, to Consent Calendar",17,0,0,0,17
491273,273559,2013-04-29,Assembly,"AB 258 CHAVEZ  Assembly Third Reading",78,0,0,1,79
491273,289040,2013-06-11,Senate,"Do pass, but re-refer to the Committee on Appropriations",7,0,0,0,7
491273,297781,2013-08-19,Senate,"Assembly 3rd Reading AB258 Ch",37,0,2,0,39
491275,278361,2013-05-08,Assembly,"Do pass as amended",7,0,0,0,7
491275,280260,2013-05-16,Assembly,"AB 256 GARCIA  Assembly Third Reading",68,1,0,10,79
491275,292015,2013-06-26,Senate,"Do pass",8,0,1,0,9
491275,298862,2013-09-06,Senate,"Assembly 3rd Reading AB256 Garcia By Wyland",37,0,2,0,39
492497,269936,2013-04-22,Senate,"Do pass as amended, and re-refer to the Committee on Appropriations",7,2,1,0,10
492497,278584,2013-05-13,Senate,"Do pass",4,1,2,0,7
492497,284579,2013-05-28,Senate,"Senate 3rd Reading SB204 Corbett",21,14,4,0,39
492497,291549,2013-06-25,Assembly,"Do pass as amended and be re-referred to the Committee on Business, 	Professions and Consumer Protection",9,6,0,4,19
492497,291550,2013-06-25,Assembly,"Set first hearing.  Failed passage.  Reconsideration granted",19,0,0,0,19
492497,372163,2014-06-17,Assembly,"Do pass and be re-referred to the Committee on Business, 	Professions and Consumer Protection",13,5,0,1,19
492497,374097,2014-06-24,Assembly,"Do pass and be re-referred to the Committee on Appropriations",8,4,0,2,14
492497,375587,2014-07-02,Assembly,"Do pass",12,5,0,0,17
492497,378158,2014-08-21,Assembly,"SB 204 Corbett  Senate Third Reading  By BONILLA",55,23,0,1,79
492497,378520,2014-08-26,Senate,"From committee:  That the Assembly Amendments be concurred in",5,0,4,0,9
492497,378521,2014-08-26,Senate,"Unfinished Supp 1 SB204 Corbett Concurrence",24,11,5,0,40
492500,269950,2013-04-22,Senate,"Do pass as amended, and re-refer to the Committee on Appropriations",6,0,4,0,10
492500,278654,2013-05-13,Senate,"Do pass",5,0,2,0,7
492500,280266,2013-05-16,Senate,"Senate 3rd Reading SB205 Corbett",23,9,6,0,38
492500,291617,2013-06-25,Assembly,"Do pass as amended and be re-referred to the Committee on Business, 	Professions and Consumer Protection",12,6,0,1,19
492500,297250,2013-08-13,Assembly,"Do pass and be re-referred to the Committee on Appropriations",9,3,0,2,14
492500,297856,2013-08-21,Assembly,"Do pass",12,5,0,0,17
492500,298796,2013-09-06,Assembly,"SB 205 Corbett  Senate Third Reading  By AMMIANO  Amend By AMMIANO 	Set #1",51,25,0,2,78
492500,299151,2013-09-10,Assembly,"SB 205 Corbett  Senate Third Reading  By AMMIANO",47,27,0,4,78
492500,299455,2013-09-11,Senate,"Unfinished Business SB205 Corbett Concurrence",24,12,3,0,39
492520,261737,2013-04-09,Senate,"Do pass as amended, and re-refer to the Committee on Appropriations",6,0,0,0,6
492520,269930,2013-04-22,Senate,"Placed on Appropriations Suspense file",7,0,0,0,7
492520,283189,2013-05-23,Senate,"Do pass as amended",7,0,0,0,7
492520,285008,2013-05-29,Senate,"Senate 3rd Reading SB208 Lara",39,0,0,0,39
492520,295921,2013-07-02,Assembly,"Do pass",7,0,0,0,7
492520,299265,2013-09-10,Assembly,"Do pass",18,0,0,1,19
492520,299521,2013-09-11,Assembly,"Do pass, to Consent Calendar",16,0,0,1,17
492520,299772,2013-09-12,Senate,"Unfinished Supp 2 SB208 Lara Concurrence",38,0,1,0,39
492520,299834,2013-09-12,Assembly,"SB 208 Lara  Consent Calendar First Day  Regular Session",78,0,0,0,78
493858,268971,2013-04-17,Senate,"Do pass as amended, and re-refer to the Committee on Judiciary",8,0,1,0,9
493858,277424,2013-05-07,Senate,"Do pass",6,0,1,0,7
493858,283994,2013-05-24,Senate,"Senate 3rd Reading SB233 Leno",36,0,3,0,39
493858,289453,2013-06-18,Assembly,"Do pass and be re-referred to the Committee on Banking and Finance",9,0,0,1,10
493858,291938,2013-06-24,Assembly,"Do pass",10,0,0,1,11
493858,295100,2013-07-01,Assembly,"SB 233 Leno  Senate Third Reading  By GORELL",72,0,0,6,78
493861,262727,2013-04-10,Senate,"Do pass, but re-refer to the Committee on Appropriations",4,1,0,0,5
493861,270045,2013-04-22,Senate,"Placed on Appropriations Suspense file",7,0,0,0,7
493861,283313,2013-05-23,Senate,"Do pass",5,2,0,0,7
493861,284596,2013-05-28,Senate,"Senate 3rd Reading SB232 Monning",28,11,0,0,39
493861,292275,2013-06-26,Assembly,"Do pass and be re-referred to the Committee on Appropriations",5,2,0,0,7
493861,298354,2013-08-30,Assembly,"Do pass as amended",12,0,0,5,17
493861,299548,2013-09-11,Assembly,"SB 232 Monning  Third Reading Urgency  By STONE",77,0,0,1,78
493861,299794,2013-09-12,Senate,"From committee:  That the Assembly Amendments be concurred in",14,0,2,0,16
493861,299795,2013-09-12,Senate,"Unfinished Supp 2 SB232 Monning Concurrence",38,0,1,0,39
493864,275684,2013-05-01,Senate,"Do pass, but re-refer to the Committee on Appropriations",9,0,0,0,9
493864,278681,2013-05-13,Senate,"Placed on Appropriations Suspense file",5,0,2,0,7
493864,283218,2013-05-23,Senate,"Do pass as amended",7,0,0,0,7
493864,285027,2013-05-29,Senate,"Senate 3rd Reading SB231 Correa",38,0,1,0,39
493864,291856,2013-06-26,Assembly,"Do pass as amended and re-refer to Committee on Appropriations 	with recommendation:  To Consent Calendar",7,0,0,0,7
493882,271496,2013-04-23,Senate,"Do pass, but re-refer to the Committee on Appropriations",2,4,1,0,7
493882,271497,2013-04-23,Senate,"Set, first hearing.  Failed passage in Committee.  Reconsideration 	granted",7,0,0,0,7
493885,271600,2013-04-23,Senate,"Do pass as amended, and re-refer to the Committee on Appropriations",2,3,2,0,7
493885,271601,2013-04-23,Senate,"Set, first hearing.  Failed passage in Committee.  Reconsideration 	granted",7,0,0,0,7
493889,258498,2013-04-03,Senate,"Do pass, but re-refer to the Committee on Appropriations",9,0,0,0,9
493889,265707,2013-04-15,Senate,"Placed on Appropriations Suspense file",7,0,0,0,7
493889,283132,2013-05-23,Senate,"Do pass as amended",7,0,0,0,7
493889,285121,2013-05-29,Senate,"Senate 3rd Reading SB224 Walters",38,0,1,0,39
493889,291738,2013-06-25,Assembly,"Do pass and be re-referred to the Committee on Appropriations",18,0,0,1,19
493893,258550,2013-04-03,Senate,"Do pass as amended, and re-refer to the Committee on Appropriations",9,0,0,0,9
493893,278581,2013-05-13,Senate,"Placed on Appropriations Suspense file",5,0,2,0,7
493896,274748,2013-04-30,Senate,"Do pass as amended, and re-refer to the Committee on 	Appropriations",4,3,0,0,7
493896,281250,2013-05-20,Senate,"Placed on Appropriations Suspense file",6,0,1,0,7
493903,269981,2013-04-22,Senate,"Do pass, but re-refer to the Committee on Appropriations Recommend 	Consent",5,0,0,0,5
493903,278144,2013-05-09,Senate,"Consent Calendar 2nd SB220 Beall",34,0,4,0,38
493903,291921,2013-06-26,Assembly,"Do pass and re-refer to Committee on Appropriations with 	recommendation:  To Consent Calendar",6,0,0,1,7
493903,297495,2013-08-14,Assembly,"Do pass, to Consent Calendar",17,0,0,0,17
493903,298639,2013-09-03,Assembly,"SB 220 Beall  Senate Third Reading  By BONTA",76,0,0,2,78
493903,298733,2013-09-04,Senate,"Unfinished Business SB220 Beall Concurrence",38,0,1,0,39
493911,270031,2013-04-22,Senate,"Do pass, but re-refer to the Committee on Appropriations",4,2,4,0,10
493911,270032,2013-04-22,Senate,"Set, first hearing.  Failed passage in Committee.  Reconsideration 	granted",10,0,0,0,10
493911,273675,2013-04-29,Senate,"Do pass, but re-refer to the Committee on Appropriations",6,1,3,0,10
493911,281390,2013-05-20,Senate,"Placed on Appropriations Suspense file",6,0,1,0,7
493911,283299,2013-05-23,Senate,"Do pass as amended",4,2,1,0,7
493911,285173,2013-05-29,Senate,"Senate 3rd Reading SB218 Yee",23,6,10,0,39
493917,261033,2013-04-08,Senate,"Do pass, but re-refer to the Committee on Appropriations",5,0,0,0,5
493917,270037,2013-04-22,Senate,"Placed on Appropriations Suspense file",7,0,0,0,7
493917,283202,2013-05-23,Senate,"Do pass",6,0,1,0,7
493917,284988,2013-05-29,Senate,"Special Consent #7 SB216 Beall",38,0,1,0,39
493917,291907,2013-06-26,Assembly,"Do pass and be re-referred to the Committee on Appropriations",6,0,0,1,7
493917,377423,2014-08-14,Assembly,"Do pass as amended",16,1,0,0,17
493917,377879,2014-08-20,Assembly,"SB 216 Beall  Senate Third Reading  By BONTA",76,0,0,3,79
493917,378999,2014-08-29,Senate,"Unfinished Business SB216 Beall Concurrence",37,0,3,0,40
493921,261005,2013-04-08,Senate,"Do pass, but re-refer to the Committee on Appropriations",5,0,0,0,5
493921,272410,2013-04-25,Senate,"Senate 3rd Reading SB215 Beall",33,2,3,0,38
493921,291920,2013-06-26,Assembly,"Do pass and be re-referred to the Committee on Appropriations",6,0,0,1,7
493921,296113,2013-07-03,Assembly,"Do pass as amended, to Consent Calendar",17,0,0,0,17
493921,298048,2013-08-26,Assembly,"SB 215 Beall  Senate Third Reading  By BONTA",77,1,0,0,78
493921,298444,2013-08-30,Senate,"Unfinished Business SB215 Beall Concurrence",35,3,1,0,39
493928,251231,2013-03-19,Senate,"Do pass, but re-refer to the Committee on Rules",4,0,1,0,5
493928,267194,2013-04-16,Senate,"Do pass, but re-refer to the Committee on Appropriations",7,0,0,0,7
493928,273527,2013-04-29,Senate,"Placed on Appropriations Suspense file",7,0,0,0,7
493928,283134,2013-05-23,Senate,"Do pass as amended",7,0,0,0,7
493928,284961,2013-05-29,Senate,"Senate 3rd Reading SB213 Galgiani",38,0,1,0,39
493928,291525,2013-06-25,Assembly,"Do pass",5,1,0,1,7
493928,297976,2013-08-26,Assembly,"SB 213 Galgiani  Senate Third Reading  By EGGMAN  Amend By WAGNER 	Set #1  Motion to  Lay on the Table  By ATKINS",54,23,0,1,78
493928,297977,2013-08-26,Assembly,"SB 213 Galgiani  Senate Third Reading  By EGGMAN",51,23,0,4,78
493932,275734,2013-05-01,Senate,"Do pass, but re-refer to the Committee on Appropriations",8,1,0,0,9
493932,278866,2013-05-13,Senate,"Placed on Appropriations Suspense file",5,0,2,0,7
493935,274855,2013-05-01,Senate,"Do pass as amended, and re-refer to the Committee on Appropriations",7,0,0,0,7
493935,281307,2013-05-20,Senate,"Do pass",4,2,1,0,7
493935,284634,2013-05-28,Senate,"Senate 3rd Reading SB211 Price",32,6,1,0,39
493935,297208,2013-08-12,Assembly,"Do pass and be re-referred to the Committee on Appropriations",6,1,0,2,9
493935,298445,2013-08-30,Assembly,"Do pass as amended",12,4,0,1,17
493935,299488,2013-09-11,Senate,"Unfinished Supp 1 SB211 Hernandez Concurrence",32,7,0,0,39
493935,299489,2013-09-11,Assembly,"SB 211 Hernandez  Senate Third Reading  By PEREZ, V.M",53,22,0,3,78
493938,308646,2014-01-14,Senate,"Do pass, but re-refer to the Committee on Appropriations",5,1,1,0,7
493938,310345,2014-01-21,Senate,"Placed on Appropriations Suspense file",5,0,2,0,7
493938,311115,2014-01-23,Senate,"Do pass as amended",5,1,1,0,7
493938,313920,2014-01-30,Senate,"Senate 3rd Reading SB210 Hancock",25,9,5,0,39
493938,372209,2014-06-17,Assembly,"Do pass",5,2,0,0,7
493943,274674,2013-05-01,Senate,"Do pass, but re-refer to the Committee on Appropriations",6,1,0,0,7
493943,278613,2013-05-13,Senate,"Placed on Appropriations Suspense file",5,0,2,0,7
493943,283090,2013-05-23,Senate,"Do pass as amended",5,0,2,0,7
493943,285510,2013-05-30,Senate,"Senate 3rd Reading SB209 Lieu",34,3,2,0,39
493943,297190,2013-08-12,Assembly,"Do pass and be re-referred to the Committee on Appropriations",9,0,0,0,9
493943,298208,2013-08-30,Assembly,"Do pass as amended",17,0,0,0,17
493943,299657,2013-09-12,Assembly,"SB 209 Lieu  Senate Third Reading  By GORELL",73,0,0,5,78
493943,299658,2013-09-12,Senate,"Unfinished Supp 2 SB209 Lieu Concurrence",36,2,1,0,39
493946,262207,2013-04-08,Assembly,"Be adopted, and re-refer to Committee on Appropriations with 	recommendation:  To Consent Calendar",16,0,0,0,16
493946,267328,2013-04-17,Assembly,"Be adopted, to Consent Calendar",17,0,0,0,17
493946,269974,2013-04-22,Assembly,"ACR 14 YAMADA  Consent Calendar Second Day  Regular Session",78,0,0,1,79
493946,276885,2013-05-07,Senate,"Be adopted as amended, but re-refer to the Committee on 	Appropriations Recommend Consent",10,0,1,0,11
493946,295593,2013-07-01,Senate,"Consent Calendar 2nd ACR14 Yamada",33,0,5,0,38
493946,296107,2013-07-03,Assembly,"ACR 14 YAMADA  Concurrence in Senate Amendments",73,0,0,5,78
493950,269921,2013-04-22,Assembly,"From committee:  Be adopted.  To third reading",11,0,0,0,11
493950,275743,2013-05-02,Assembly,"ACR 13 PAN  Assembly Third Reading",72,0,0,7,79
493950,296450,2013-07-11,Senate,"Assembly 3rd Reading ACR13 Pan By Yee",30,0,8,0,38
493953,276880,2013-05-07,Assembly,"Be adopted and be re-referred to the Committee on Appropriations",5,2,0,0,7
493953,283949,2013-05-24,Assembly,"Be adopted",12,5,0,0,17
493953,375723,2014-07-03,Assembly,"ACA6 GATTO  Assembly Third Reading  Amend By GATTO  Set #1",53,18,0,8,79
493956,270845,2013-04-23,Assembly,"Do pass as amended, to Consent Calendar",18,0,0,1,19
493956,275537,2013-05-02,Assembly,"AB 297 CHESBRO  Consent Calendar Second Day  Regular Session",75,0,0,4,79
493956,291892,2013-06-26,Senate,"Do pass as amended",9,0,0,0,9
493956,298680,2013-09-03,Senate,"Assembly 3rd Reading AB297 Chesbro By DeSaulnier",37,0,2,0,39
493956,298879,2013-09-06,Assembly,"AB 297 CHESBRO  Concurrence in Senate Amendments",78,0,0,0,78
493961,275090,2013-04-30,Assembly,"Do pass as amended and be re-referred to the Committee on Judiciary",7,1,0,2,10
493961,276844,2013-05-07,Assembly,"Do pass as amended",10,0,0,0,10
493961,281284,2013-05-20,Assembly,"AB 296 WAGNER  Assembly Third Reading",73,0,0,5,78
493961,374317,2014-06-24,Senate,"Do pass",7,0,0,0,7
493961,375269,2014-06-30,Senate,"Assembly 3rd Reading AB296 Wagner Urgency Clause",36,0,4,0,40
493961,377027,2014-08-12,Assembly,"Senate amendments be concurred in",9,0,0,1,10
493961,377633,2014-08-18,Assembly,"AB 296 WAGNER  Concurrence- Urgency Added",78,0,0,1,79
493964,274197,2013-04-30,Assembly,"Do pass as amended and be re-referred to the Committee on 	Appropriations",10,0,0,5,15
493967,274677,2013-05-01,Assembly,"Do pass as amended and be re-referred to the Committee on 	Appropriations",8,0,0,1,9
493971,266685,2013-04-15,Assembly,"Do pass and be re-referred to the Committee on Utilities and 	Commerce",5,1,0,3,9
493971,274359,2013-04-29,Assembly,"Do pass as amended and be re-referred to the Committee on 	Appropriations",13,0,0,2,15
493982,258482,2013-04-02,Assembly,"Do pass and be re-referred to the Committee on Appropriations",7,0,0,0,7
493982,267331,2013-04-17,Assembly,"Do pass, to Consent Calendar",17,0,0,0,17
493982,273490,2013-04-29,Assembly,"AB 290 ALEJO  Assembly Third Reading",77,0,0,2,79
493982,288026,2013-06-11,Senate,"Do pass, but re-refer to the Committee on Appropriations",6,0,0,0,6
493982,291195,2013-06-24,Senate,"Placed on Appropriations Suspense file",7,0,0,0,7
493982,298290,2013-08-30,Senate,"Do pass as amended",7,0,0,0,7
493982,298786,2013-09-06,Senate,"Assembly 3rd Reading AB290 Alejo By Jackson",38,0,1,0,39
493982,298919,2013-09-09,Assembly,"AB 290 ALEJO  Concurrence in Senate Amendments",77,0,0,1,78
493988,266386,2013-04-15,Assembly,"Do pass and be re-referred to the Committee on Appropriations",6,3,0,0,9
493988,283848,2013-05-24,Assembly,"Do pass as amended",12,0,0,5,17
493988,285558,2013-05-30,Assembly,"AB 288 LEVINE  Assembly Third Reading",25,34,0,20,79
493988,309469,2014-01-16,Assembly,"Do pass and be re-referred to the Committee on Appropriations",7,0,0,2,9
493988,311171,2014-01-23,Assembly,"Do pass",15,0,0,2,17
493988,312244,2014-01-27,Assembly,"AB 288 LEVINE  Assembly Third Reading",69,2,0,9,80
493988,370408,2014-06-10,Senate,"Do pass, but re-refer to the Committee on Appropriations",8,1,0,0,9
493988,373710,2014-06-23,Senate,"Placed on Appropriations Suspense file",7,0,0,0,7
493988,377206,2014-08-14,Senate,"Do pass",5,0,2,0,7
493988,377789,2014-08-19,Senate,"Assembly 3rd Reading AB288 Levine By Hueso",30,2,8,0,40
493993,267491,2013-04-16,Assembly,"Do pass as amended and be re-referred to the Committee on 	Appropriations",10,0,0,0,10
493993,277427,2013-05-08,Assembly,"Do pass, to Consent Calendar",17,0,0,0,17
493993,280404,2013-05-16,Assembly,"AB 287 FRAZIER  Consent Calendar Second Day  Regular Session",70,0,0,9,79
493993,291798,2013-06-25,Senate,"Do pass, but re-refer to the Committee on Appropriations",7,0,0,0,7
493993,297660,2013-08-19,Senate,"Assembly 3rd Reading AB287 Frazier By Roth",37,0,2,0,39
493999,262543,2013-04-09,Assembly,"Do pass and be re-referred to the Committee on Appropriations",8,0,0,1,9
493999,267318,2013-04-17,Assembly,"Do pass, to Consent Calendar",17,0,0,0,17
493999,272357,2013-04-25,Assembly,"AB 285 BROWN  Consent Calendar Second Day  Regular Session",76,0,0,3,79
493999,286641,2013-06-03,Senate,"Do pass, but re-refer to the Committee on Labor and Industrial 	Relations",10,0,0,0,10
493999,288500,2013-06-12,Senate,"Do pass, but re-refer to the Committee on Appropriations",4,0,1,0,5
493999,297682,2013-08-19,Senate,"Assembly 3rd Reading AB285 Brown By Roth",37,0,2,0,39
493999,297986,2013-08-26,Assembly,"AB 285 BROWN  Concurrence in Senate Amendments",78,0,0,0,78
494003,266362,2013-04-15,Assembly,"Do pass and be re-referred to the Committee on Utilities and 	Commerce",6,0,0,3,9
494003,274076,2013-04-29,Assembly,"Do pass as amended and be re-referred to the Committee on 	Appropriations",10,1,0,4,15
494006,263077,2013-04-09,Assembly,"Do pass and be re-referred to the Committee on Appropriations",11,1,0,1,13
494010,267500,2013-04-16,Assembly,"Do pass and be re-referred to the Committee on Appropriations",5,2,0,0,7
494010,284065,2013-05-24,Assembly,"Do pass",12,1,0,4,17
494010,284660,2013-05-28,Assembly,"AB 282 WIECKOWSKI  Assembly Third Reading",55,21,0,3,79
494010,290122,2013-06-19,Senate,"Do pass as amended, and re-refer to the Committee on 	Appropriations",7,1,1,0,9
494010,297406,2013-08-12,Senate,"Placed on Appropriations Suspense file",6,0,1,0,7
494014,261752,2013-04-08,Assembly,"Do pass and be re-referred to the Committee on Appropriations",5,11,0,0,16
494014,261753,2013-04-08,Assembly,"Set first hearing.  Failed passage.  Reconsideration granted",16,0,0,0,16
494014,308634,2014-01-13,Assembly,"Do pass and be re-referred to the Committee on Appropriations",4,10,0,2,16
494017,278349,2013-05-08,Assembly,"Do pass as amended",6,0,0,1,7
494017,283171,2013-05-23,Assembly,"AB 280 ALEJO  Assembly Third Reading",73,0,0,5,78
494017,374429,2014-06-24,Senate,"Do pass, but re-refer to the Committee on Appropriations",3,1,1,0,5
494017,376412,2014-08-04,Senate,"Placed on Appropriations Suspense file",7,0,0,0,7
494020,258739,2013-04-03,Assembly,"Do pass and be re-referred to the Committee on Banking and Finance",9,0,0,0,9
494020,261882,2013-04-08,Assembly,"Do pass, to Consent Calendar",12,0,0,0,12
494020,265396,2013-04-15,Assembly,"AB 279 DICKINSON  Consent Calendar Second Day",77,0,0,2,79
494020,287267,2013-06-05,Senate,"Do pass as amended, and re-refer to the Committee on Banking and 	Financial Institution",7,0,0,0,7
494020,289922,2013-06-19,Senate,"Do pass as amended",9,0,0,0,9
494020,296314,2013-07-08,Senate,"Assembly 3rd Reading AB279 Dickinson By Correa",33,0,5,0,38
494020,297675,2013-08-19,Assembly,"AB 279 DICKINSON  Concurrence in Senate Amendments",77,0,0,1,78
494024,257569,2013-04-01,Assembly,"Do pass as amended and be re-referred to the Committee on 	Appropriations",9,0,0,0,9
494024,283850,2013-05-24,Assembly,"Do pass",17,0,0,0,17
494024,284840,2013-05-28,Assembly,"AB 278 GATTO  Assembly Third Reading",77,0,0,2,79
494024,291671,2013-06-25,Senate,"Do pass, but re-refer to the Committee on Environmental Quality",9,0,2,0,11
494024,296045,2013-07-03,Senate,"Do pass as amended, and re-refer to the Committee on 	Appropriations",9,0,0,0,9
494024,297416,2013-08-12,Senate,"Placed on Appropriations Suspense file",6,0,1,0,7
494024,298513,2013-08-30,Senate,"Do pass as amended",7,0,0,0,7
494024,379091,2014-08-29,Senate,"Assembly 3rd Reading AB278 Gatto By Pavley",36,0,4,0,40
494024,379092,2014-08-29,Assembly,"AB 278 GATTO  Concurrence in Senate Amendments",77,0,0,2,79
494028,275534,2013-05-02,Assembly,"AB 277 HALL  Assembly Third Reading",38,12,0,29,79
494028,275535,2013-05-02,Assembly,"AB 277 HALL  Assembly Third Reading",41,12,0,26,79
494028,292196,2013-06-27,Senate,"Assembly 3rd Reading AB277 Hall By Wright",22,11,6,0,39
494035,275596,2013-05-01,Assembly,"Do pass and be re-referred to the Committee on Appropriations",7,0,0,0,7
494038,267565,2013-04-16,Assembly,"Do pass as amended and be re-referred to the Committee on 	Appropriations",7,0,0,0,7
494038,284095,2013-05-24,Assembly,"Do pass as amended",17,0,0,0,17
494038,285162,2013-05-29,Assembly,"AB 274 BONILLA  Assembly Third Reading",77,0,0,2,79
494038,296152,2013-07-03,Senate,"Do pass as amended, and re-refer to the Committee on Appropriations",9,0,0,0,9
494038,297659,2013-08-19,Senate,"Do pass as amended",7,0,0,0,7
494038,298604,2013-09-03,Senate,"Assembly 3rd Reading AB274 Bonilla By Liu",37,0,2,0,39
494038,298771,2013-09-06,Assembly,"AB 274 BONILLA  Concurrence in Senate Amendments",78,0,0,0,78
495235,269941,2013-04-22,Assembly,"Be referred to Committee on Public Employees, Retirement and Social 	Security",10,0,0,1,11
495235,274765,2013-05-01,Assembly,"Do pass and be re-referred to the Committee on Appropriations",5,1,0,1,7
495236,270951,2013-04-23,Assembly,"Do pass and be re-referred to the Committee on Health",8,3,0,2,13
495236,274201,2013-04-30,Assembly,"Do pass as amended and be re-referred to the Committee on 	Appropriations",11,6,0,2,19
495238,261038,2013-04-08,Assembly,"Do pass as amended and be re-referred to the Committee on Revenue 	and Taxation",14,0,0,1,15
495238,278816,2013-05-13,Assembly,"Do pass as amended and be re-referred to the Committee on 	Appropriations",8,0,0,1,9
495238,284052,2013-05-24,Assembly,"Do pass",16,0,0,1,17
495238,287488,2013-06-06,Assembly,"AB 300 PEREA  Third Reading Urgency",65,1,0,13,79
495238,295789,2013-07-02,Senate,"Do pass as amended, and re-refer to the Committee on Governance and 	Finance",6,0,5,0,11
495238,297859,2013-08-21,Senate,"Do pass as amended, and re-refer to the Committee on 	Appropriations",7,0,0,0,7
495238,298083,2013-08-26,Senate,"Placed on Appropriations Suspense file",7,0,0,0,7
495238,298245,2013-08-30,Senate,"Do pass",7,0,0,0,7
495238,299538,2013-09-11,Senate,"Assembly 3rd Reading AB300 Perea By Hill",31,4,4,0,39
495238,299719,2013-09-12,Assembly,"AB 300 PEREA  Concurrence in Senate Amendments",72,2,0,4,78
495240,270946,2013-04-23,Assembly,"Do pass and be re-referred to the Committee on Elections and 	Redistricting",3,7,0,0,10
495242,251401,2013-03-20,Assembly,"Do pass and be re-referred to the Committee on Appropriations",5,2,0,0,7
495242,262762,2013-04-10,Assembly,"Do pass",12,5,0,0,17
495242,268792,2013-04-18,Assembly,"AB 302 CHAU  Assembly Third Reading",53,24,0,2,79
495242,291847,2013-06-26,Senate,"Do pass, but re-refer to the Committee on Appropriations",3,1,1,0,5
495242,298597,2013-09-03,Senate,"Assembly 3rd Reading AB302 Chau By Monning",24,11,4,0,39
495242,298777,2013-09-06,Assembly,"AB 302 CHAU  Concurrence in Senate Amendments",55,21,0,2,78
495247,267485,2013-04-16,Assembly,"Do pass and be re-referred to the Committee on Appropriations",7,0,0,0,7
495247,283859,2013-05-24,Assembly,"Do pass",17,0,0,0,17
495247,285666,2013-05-30,Assembly,"AB 304 WILLIAMS  Assembly Third Reading",78,0,0,1,79
495247,291876,2013-06-26,Senate,"Do pass, but re-refer to the Committee on Appropriations",9,0,0,0,9
495247,297246,2013-08-12,Senate,"Placed on Appropriations Suspense file",6,0,1,0,7
495247,298239,2013-08-30,Senate,"Do pass",7,0,0,0,7
495247,298918,2013-09-09,Senate,"Assembly 3rd Reading AB304 Williams By Gaines",37,0,2,0,39
495247,299125,2013-09-10,Assembly,"AB 304 WILLIAMS  Concurrence in Senate Amendments",78,0,0,0,78
495249,262362,2013-04-09,Assembly,"Do pass as amended and be re-referred to the Committee on Revenue 	and Taxation",8,0,0,1,9
495249,278748,2013-05-13,Assembly,"Do pass as amended and be re-referred to the Committee on 	Appropriations",9,0,0,0,9
495250,262432,2013-04-08,Assembly,"Do pass and re-refer to Committee on Appropriations with 	recommendation:  To Consent Calendar",16,0,0,0,16
495250,267442,2013-04-17,Assembly,"Do pass, to Consent Calendar",17,0,0,0,17
495250,272418,2013-04-25,Assembly,"AB 306 LOWENTHAL  Consent Calendar Second Day  Regular Session",76,0,0,3,79
495250,288053,2013-06-11,Senate,"Do pass, but re-refer to the Committee on Appropriations Recommend 	Consent",11,0,0,0,11
495250,295568,2013-07-01,Senate,"Consent Calendar 2nd AB306 Lowenthal",33,0,5,0,38
495250,296079,2013-07-03,Assembly,"AB 306 LOWENTHAL  Concurrence in Senate Amendments",74,0,0,4,78
495252,261699,2013-04-09,Assembly,"Do pass and be re-referred to the Committee on Appropriations",7,0,0,0,7
495252,267495,2013-04-17,Assembly,"Do pass, to Consent Calendar",17,0,0,0,17
495252,272382,2013-04-25,Assembly,"AB 307 CAMPOS  Consent Calendar Second Day  Regular Session",76,0,0,3,79
495252,289424,2013-06-18,Senate,"Do pass, but re-refer to the Committee on Appropriations",6,0,1,0,7
495252,298032,2013-08-26,Senate,"Assembly 3rd Reading AB307 Campos By Hancock",39,0,0,0,39
495252,298461,2013-08-30,Assembly,"AB 307 CAMPOS  Concurrence in Senate Amendments",78,0,0,0,78
495254,275771,2013-05-01,Assembly,"Do pass as amended and re-refer to Committee on Appropriations 	with recommendation:  To Consent Calendar",7,0,0,0,7
495254,279810,2013-05-15,Assembly,"Do pass as amended, to Consent Calendar",17,0,0,0,17
495254,283093,2013-05-23,Assembly,"AB 308 HAGMAN  Consent Calendar Second Day  Regular Session",74,0,0,4,78
495254,290076,2013-06-19,Senate,"Do pass as amended, and re-refer to the Committee on Appropriations",9,0,0,0,9
495254,297371,2013-08-12,Senate,"Do pass",5,0,2,0,7
495254,297993,2013-08-26,Senate,"Assembly 3rd Reading AB308 Hagman By Liu",37,0,2,0,39
495254,298437,2013-08-30,Assembly,"AB 308 HAGMAN  Concurrence in Senate Amendments",78,0,0,0,78
495256,258535,2013-04-02,Assembly,"Do pass and be re-referred to the Committee on Appropriations",7,0,0,0,7
495256,267225,2013-04-17,Assembly,"Do pass, to Consent Calendar",17,0,0,0,17
495256,272296,2013-04-25,Assembly,"AB 309 MITCHELL  Consent Calendar Second Day  Regular Session",76,0,0,3,79
495256,288033,2013-06-11,Senate,"Do pass, but re-refer to the Committee on Appropriations Recommend 	Consent",6,0,0,0,6
495256,295342,2013-07-01,Senate,"Consent Calendar 2nd AB309 Mitchell",33,0,5,0,38
495256,296013,2013-07-03,Assembly,"AB 309 MITCHELL  Concurrence in Senate Amendments",74,0,0,4,78
495259,261810,2013-04-09,Assembly,"Do pass and re-refer to Committee on Appropriations with 	recommendation:  To Consent Calendar",6,0,0,1,7
495260,262030,2013-04-09,Assembly,"Do pass and be re-referred to the Committee on Appropriations",6,2,0,1,9
495261,274907,2013-05-01,Assembly,"Do pass and be re-referred to the Committee on Appropriations",9,0,0,0,9
495261,279936,2013-05-15,Assembly,"Do pass, to Consent Calendar",17,0,0,0,17
495261,283385,2013-05-23,Assembly,"AB 312 WIECKOWSKI  Consent Calendar Second Day  Regular Session",74,0,0,4,78
495261,292016,2013-06-26,Senate,"Do pass, but re-refer to the Committee on Appropriations Recommend 	Consent",7,0,0,0,7
495261,297584,2013-08-15,Senate,"Consent Calendar 2nd AB312 Wieckowski",38,0,1,0,39
495262,266574,2013-04-15,Assembly,"Reconsideration granted",16,0,0,0,16
495262,266575,2013-04-15,Assembly,"Do pass and be re-referred to the Committee on Appropriations",9,5,0,2,16
495262,274915,2013-05-01,Assembly,"Do pass",6,6,0,5,17
495262,274916,2013-05-01,Assembly,"Reconsideration granted",17,0,0,0,17
495263,251227,2013-03-19,Assembly,"Do pass and be re-referred to the Committee on Appropriations",14,5,0,0,19
495263,267433,2013-04-17,Assembly,"Do pass",12,5,0,0,17
495263,275817,2013-05-02,Assembly,"AB 314 PAN  Assembly Third Reading",52,21,0,6,79
495263,291917,2013-06-26,Senate,"Do pass, but re-refer to the Committee on Education",6,2,1,0,9
495263,295934,2013-07-03,Senate,"Do pass as amended, and re-refer to the Committee on Appropriations",4,3,2,0,9
495263,295935,2013-07-03,Senate,"Set, first hearing.  Failed passage in Committee.  Reconsideration 	granted",9,0,0,0,9
495264,258242,2013-04-02,Assembly,"Do pass and be re-referred to the Committee on Veterans Affairs to 	Consent Calendar",15,0,0,0,15
495264,267558,2013-04-16,Assembly,"Do pass and be re-referred to the Committee on Appropriations",10,0,0,0,10
495264,283945,2013-05-24,Assembly,"Do pass",17,0,0,0,17
495264,285509,2013-05-30,Assembly,"AB 315 V. A.  Assembly Third Reading  By MURATSUCHI",78,0,0,1,79
495264,291759,2013-06-25,Senate,"Do pass, but re-refer to the Committee on Appropriations Recommend 	Consent",9,0,0,0,9
495264,297245,2013-08-12,Senate,"Placed on Appropriations Suspense file",6,0,1,0,7
495269,305888,2014-01-06,Assembly,"Be referred to Committee on Public Safety",9,0,0,1,10
495269,308618,2014-01-14,Assembly,"Do pass, to Consent Calendar",7,0,0,0,7
495269,309846,2014-01-17,Assembly,"AB 319 CAMPOS  Consent Calendar Second Day",73,0,0,7,80
495269,372897,2014-06-17,Senate,"Do pass as amended. To Consent Calendar",6,0,1,0,7
495269,374806,2014-06-26,Senate,"Consent Calendar 2nd AB319 Campos",32,0,8,0,40
495269,375337,2014-06-30,Assembly,"AB 319 CAMPOS  Concurrence in Senate Amendments",78,0,0,1,79
495270,252179,2013-03-20,Assembly,"Do pass as amended and be re-referred to the Committee on 	Appropriations",6,0,0,1,7
495273,267203,2013-04-16,Assembly,"Do pass as amended and be re-referred to the Committee on 	Appropriations",5,1,0,1,7
495275,274093,2013-04-29,Assembly,"Do pass and be re-referred to the Committee on Appropriations",6,3,0,0,9
495277,245319,2013-03-11,Assembly,"From committee:  Be adopted.  To third reading",10,0,0,1,11
495277,263503,2013-04-11,Senate,"Assembly 3rd Reading ACR15 Chesbro By Wolk",37,0,1,0,38
495277,265391,2013-04-15,Assembly,"ACR 15 CHESBRO  Concurrence in Senate Amendments",77,0,0,2,79
495279,261769,2013-04-08,Assembly,"Be adopted, and re-refer to Committee on Appropriations with 	recommendation:  To Consent Calendar",16,0,0,0,16
495279,267559,2013-04-17,Assembly,"Be adopted, to Consent Calendar",17,0,0,0,17
495279,270165,2013-04-22,Assembly,"ACR 16 HAGMAN  Consent Calendar Second Day  Regular Session",78,0,0,1,79
495279,286937,2013-06-04,Senate,"Be adopted, but re-refer to the Committee on Appropriations 	Recommend Consent",10,0,1,0,11
495279,295550,2013-07-01,Senate,"Consent Calendar 2nd ACR16 Hagman",33,0,5,0,38
495279,296052,2013-07-03,Assembly,"ACR 16 HAGMAN  Concurrence in Senate Amendments",73,0,0,5,78
495281,287455,2013-06-06,Assembly,"From committee:  Be adopted.  To third reading",10,0,0,1,11
495281,297975,2013-08-26,Senate,"Assembly 3rd Reading ACR17 Wieckowski By Beall",39,0,0,0,39
495282,262656,2013-04-09,Senate,"Do pass, but re-refer to the Committee on Appropriations",10,0,1,0,11
495282,273604,2013-04-29,Senate,"Special Consent #2 SB234 Walters",37,0,1,0,38
495282,289222,2013-06-17,Assembly,"Do pass and re-refer to Committee on Appropriations with 	recommendation:  To Consent Calendar",15,0,0,1,16
495282,295966,2013-07-03,Assembly,"Do pass, to Consent Calendar",17,0,0,0,17
495282,297157,2013-08-08,Assembly,"SB 234 Walters  Consent Calendar Second Day  Regular Session",77,0,0,1,78
495282,297575,2013-08-15,Senate,"Unfinished Business SB234 Walters Urgency Clause",38,0,1,0,39
495287,258821,2013-04-03,Senate,"Do pass as amended, and re-refer to the Committee on Appropriations",9,0,0,0,9
495287,273577,2013-04-29,Senate,"Do pass as amended",7,0,0,0,7
495287,281412,2013-05-20,Senate,"Special Consent #5 SB236 Pavley",36,0,3,0,39
495287,288580,2013-06-12,Assembly,"Do pass as amended and re-refer to Committee on Appropriations 	with recommendation:  To Consent Calendar",7,0,0,0,7
495287,296039,2013-07-03,Assembly,"Do pass, to Consent Calendar",17,0,0,0,17
495287,297751,2013-08-19,Assembly,"SB 236 Pavley  Third Reading Urgency  By GORELL",76,0,0,2,78
495287,298229,2013-08-30,Senate,"Special Consent #9 SB236 Pavley",38,0,1,0,39
495289,277467,2013-05-08,Senate,"Do pass as amended. To Consent Calendar",8,0,1,0,9
495289,281311,2013-05-20,Senate,"Consent Calendar 2nd SB237 Calderon",36,0,3,0,39
495289,288374,2013-06-12,Assembly,"Do pass and be re-referred to the Committee on Veterans Affairs to 	Consent Calendar",7,0,0,0,7
495291,261736,2013-04-09,Senate,"Do pass, but re-refer to the Committee on Appropriations",8,1,0,0,9
495291,272306,2013-04-25,Senate,"Senate 3rd Reading SB238 Liu",26,9,3,0,38
495291,291529,2013-06-24,Assembly,"Do pass and be re-referred to the Committee on Appropriations",5,3,0,1,9
495291,296030,2013-07-03,Assembly,"Do pass as amended",12,5,0,0,17
495291,297656,2013-08-19,Assembly,"SB 238 Liu  Senate Third Reading  By GATTO",54,23,0,1,78
495291,297910,2013-08-22,Senate,"Unfinished Business SB238 Liu Concurrence",28,7,4,0,39
495292,277375,2013-05-08,Senate,"Do pass, but re-refer to the Committee on Appropriations",8,0,1,0,9
495292,281391,2013-05-20,Senate,"Placed on Appropriations Suspense file",6,0,1,0,7
495292,283185,2013-05-23,Senate,"Do pass",7,0,0,0,7
495292,284617,2013-05-28,Senate,"Senate 3rd Reading SB239 Hernandez Urgency Clause",36,0,3,0,39
495292,297816,2013-08-20,Assembly,"Do pass and be re-referred to the Committee on Appropriations",19,0,0,0,19
495292,298408,2013-08-30,Assembly,"Do pass",16,0,0,1,17
495292,299494,2013-09-11,Assembly,"Do pass as amended",16,0,0,3,19
495292,299807,2013-09-12,Assembly,"SB 239 Hernandez  Third Reading Urgency  By MITCHELL",77,0,0,1,78
495292,299808,2013-09-12,Senate,"Unfinished Supp 2 SB239 Hernandez Concurrence",38,0,1,0,39
495296,305953,2014-01-07,Senate,"Do pass, but re-refer to the Committee on Education",3,1,1,0,5
495296,309131,2014-01-15,Senate,"Do pass as amended, and re-refer to the Committee on Appropriations",5,2,2,0,9
495296,311188,2014-01-23,Senate,"Placed on Appropriations Suspense file",6,0,1,0,7
495296,311189,2014-01-23,Senate,"Do pass as amended",5,1,1,0,7
495296,313906,2014-01-30,Senate,"Senate 3rd Reading SB240 Yee",24,9,6,0,39
495297,274730,2013-05-01,Senate,"Do pass as amended, and re-refer to the Committee on Appropriations",5,2,0,0,7
495297,281158,2013-05-20,Senate,"Placed on Appropriations Suspense file",6,0,1,0,7
495299,266589,2013-04-16,Senate,"Do pass as amended, and re-refer to the Committee on 	Appropriations",10,0,1,0,11
495299,278773,2013-05-13,Senate,"Special Consent #4 SB242 Wyland",34,0,4,0,38
495301,276332,2013-05-06,Senate,"Do pass as amended",9,0,1,0,10
495301,278687,2013-05-13,Senate,"Special Consent #4 SB243 Wyland",34,0,4,0,38
495301,288309,2013-06-11,Assembly,"Do pass",12,0,0,1,13
495301,298034,2013-08-26,Assembly,"SB 243 Wyland  Senate Third Reading  By MAIENSCHEIN",77,0,0,1,78
495301,298296,2013-08-30,Senate,"Special Consent #9 SB243 Wyland",38,0,1,0,39
495303,274845,2013-04-30,Senate,"Do pass as amended, and re-refer to the Committee on Appropriations",7,0,0,0,7
495303,284654,2013-05-28,Senate,"Senate 3rd Reading SB244 Liu",39,0,0,0,39
495305,309025,2014-01-14,Senate,"Do pass as amended",6,0,1,0,7
495305,311096,2014-01-23,Senate,"Senate 3rd Reading SB245 Correa",33,0,6,0,39
495305,370552,2014-06-10,Assembly,"Do pass as amended, to Consent Calendar",9,0,0,1,10
495305,371788,2014-06-16,Assembly,"SB 245 Correa  Consent Calendar Second Day  Regular Session",77,0,0,2,79
495305,374796,2014-06-26,Senate,"Special Consent #17 SB245 Correa",32,0,8,0,40
495308,267874,2013-04-17,Senate,"Do pass as amended",7,0,0,0,7
495308,273526,2013-04-29,Senate,"Special Consent #2 SB246 Fuller",37,0,1,0,38
495308,297563,2013-08-14,Assembly,"Do pass",9,0,0,0,9
495308,298043,2013-08-26,Assembly,"SB 246 Fuller  Senate Third Reading  By NESTANDE",78,0,0,0,78
495308,298336,2013-08-30,Senate,"Special Consent #9 SB246 Fuller",38,0,1,0,39
495309,262846,2013-04-10,Senate,"Do pass, but re-refer to the Committee on Appropriations",6,1,2,0,9
495309,270147,2013-04-22,Senate,"Placed on Appropriations Suspense file",7,0,0,0,7
495309,283095,2013-05-23,Senate,"Do pass as amended",5,2,0,0,7
495309,284594,2013-05-28,Senate,"Senate 3rd Reading SB247 Liu",27,11,1,0,39
495309,292029,2013-06-26,Assembly,"Do pass and be re-referred to the Committee on Appropriations",7,0,0,0,7
495309,298487,2013-08-30,Assembly,"Do pass as amended",12,1,0,4,17
495309,299014,2013-09-09,Assembly,"SB 247 Liu  Senate Third Reading  By BONILLA",58,17,0,3,78
495309,299213,2013-09-10,Senate,"Unfinished Business SB247 Liu Concurrence",33,4,2,0,39
495313,272245,2013-04-24,Senate,"Do pass, but re-refer to the Committee on Judiciary",9,0,0,0,9
495313,274908,2013-04-30,Senate,"Do pass, but re-refer to the Committee on Appropriations Recommend 	Consent",7,0,0,0,7
495313,278829,2013-05-13,Senate,"Placed on Appropriations Suspense file",5,0,2,0,7
495313,283069,2013-05-23,Senate,"Do pass",7,0,0,0,7
495313,284577,2013-05-28,Senate,"Senate 3rd Reading SB249 Leno",39,0,0,0,39
495313,291603,2013-06-25,Assembly,"Do pass and be re-referred to the Committee on Judiciary",18,0,0,1,19
495313,295881,2013-07-02,Assembly,"Do pass and re-refer to Committee on Appropriations with 	recommendation:  To Consent Calendar",10,0,0,0,10
495313,298371,2013-08-30,Assembly,"Do pass as amended",17,0,0,0,17
495313,299032,2013-09-09,Assembly,"SB 249 Leno  Senate Third Reading  By MAIENSCHEIN",77,0,0,1,78
495313,299321,2013-09-10,Senate,"Unfinished Business SB249 Leno Concurrence",37,0,2,0,39
495315,266331,2013-04-16,Senate,"Do pass, but re-refer to the Committee on Appropriations",5,0,0,0,5
495315,273512,2013-04-29,Senate,"Do pass",7,0,0,0,7
495315,280278,2013-05-16,Senate,"Senate 3rd Reading SB250 Wolk",35,2,1,0,38
495315,291541,2013-06-25,Assembly,"Do pass and be re-referred to the Committee on Agriculture",9,1,0,0,10
495315,297440,2013-08-14,Assembly,"Do pass and be re-referred to the Committee on Appropriations",7,0,0,0,7
495315,298312,2013-08-30,Assembly,"Do pass",16,1,0,0,17
495315,298698,2013-09-04,Assembly,"SB 250 Wolk  Senate Third Reading  By PAN",67,7,0,4,78
495315,298789,2013-09-06,Senate,"Unfinished Business SB250 Wolk Concurrence",32,2,5,0,39
495317,271607,2013-04-24,Senate,"Do pass, but re-refer to the Committee on Judiciary",9,0,0,0,9
495317,278238,2013-05-09,Senate,"Senate 3rd Reading SB251 Calderon",35,0,3,0,38
495317,291940,2013-06-26,Assembly,"Do pass and be re-referred to the Committee on Judiciary",12,0,0,1,13
495317,297345,2013-08-13,Assembly,"Do pass and be re-referred to the Committee on Appropriations",7,0,0,3,10
495317,298333,2013-08-30,Assembly,"Do pass as amended",17,0,0,0,17
495317,298992,2013-09-09,Assembly,"SB 251 Calderon  Senate Third Reading  By PEREA",76,0,0,2,78
495317,299279,2013-09-10,Senate,"Unfinished Business SB251 Calderon Concurrence",36,0,3,0,39
495318,261845,2013-04-09,Senate,"Do pass as amended, and re-refer to the Committee on Appropriations",6,0,0,0,6
495318,276370,2013-05-06,Senate,"Placed on Appropriations Suspense file",7,0,0,0,7
495318,283118,2013-05-23,Senate,"Do pass as amended",5,1,1,0,7
495318,285076,2013-05-29,Senate,"Senate 3rd Reading SB252 Liu",34,4,1,0,39
495318,295828,2013-07-02,Assembly,"Do pass as amended and be re-referred to the Committee on 	Appropriations",5,2,0,0,7
495318,297488,2013-08-14,Assembly,"Do pass",12,5,0,0,17
495318,298065,2013-08-26,Assembly,"SB 252 Liu  Senate Third Reading  By SKINNER",53,24,0,1,78
495318,298475,2013-08-30,Senate,"Unfinished Business SB252 Liu Concurrence",30,8,1,0,39
497740,258395,2013-04-02,Assembly,"Do pass and be re-referred to the Committee on Appropriations",6,0,0,1,7
497740,267713,2013-04-17,Assembly,"Do pass, to Consent Calendar",17,0,0,0,17
497740,272360,2013-04-25,Assembly,"AB 324 BLOOM  Consent Calendar Second Day  Regular Session",76,0,0,3,79
497740,291864,2013-06-26,Senate,"Do pass as amended, and re-refer to the Committee on 	Appropriations",9,0,0,0,9
497740,297705,2013-08-19,Senate,"Assembly 3rd Reading AB324 Bloom By Lara",37,0,2,0,39
497740,297922,2013-08-22,Assembly,"AB 324 BLOOM  Concurrence in Senate Amendments",77,0,0,1,78
497743,274882,2013-05-01,Assembly,"Do pass and be re-referred to the Committee on Local Government",5,2,0,0,7
497743,278161,2013-05-08,Assembly,"Do pass",5,3,0,1,9
497743,285086,2013-05-29,Assembly,"AB 325 ALEJO  Assembly Third Reading  Amend By ALEJO  Set #1",51,25,0,3,79
497743,286002,2013-05-31,Assembly,"AB 325 ALEJO  Assembly Third Reading",41,30,0,8,79
497743,291644,2013-06-25,Senate,"Do pass",7,3,1,0,11
497743,299122,2013-09-10,Senate,"Assembly 3rd Reading AB325 Alejo By DeSaulnier",35,1,3,0,39
497743,299350,2013-09-11,Assembly,"AB 325 ALEJO  Concurrence in Senate Amendments",59,15,0,4,78
497746,263611,2013-04-10,Assembly,"Do pass and be re-referred to the Committee on Appropriations",2,5,0,0,7
497746,263612,2013-04-10,Assembly,"Set first hearing.  Failed passage.  Reconsideration granted",7,0,0,0,7
497746,306369,2014-01-08,Assembly,"Do pass",7,0,0,0,7
497746,309821,2014-01-17,Assembly,"AB 326 MORRELL  Assembly Third Reading",72,0,0,8,80
497746,371193,2014-06-11,Senate,"Do pass",5,0,0,0,5
497746,374847,2014-06-26,Senate,"Special Consent #17 AB326 Morrell",32,0,8,0,40
497750,265339,2013-04-15,Assembly,"Do pass as amended and be re-referred to the Committee on 	Appropriations",15,0,0,0,15
497750,279825,2013-05-15,Assembly,"Do pass",17,0,0,0,17
497750,283380,2013-05-23,Assembly,"AB 327 PEREA  Assembly Third Reading",66,4,0,8,78
497750,295782,2013-07-02,Senate,"Do pass as amended, and re-refer to the Committee on Appropriations",10,0,1,0,11
497750,297987,2013-08-26,Senate,"Placed on Appropriations Suspense file",7,0,0,0,7
497750,298263,2013-08-30,Senate,"Do pass as amended",6,0,1,0,7
497750,298968,2013-09-09,Senate,"Assembly 2nd Reading AB327 Perea Lay on Table",24,12,3,0,39
497750,298969,2013-09-09,Senate,"Assembly 2nd Reading AB327 Perea",33,5,1,0,39
497750,299368,2013-09-11,Assembly,"Senate amendments be concurred in",14,0,0,0,14
497750,299621,2013-09-12,Assembly,"AB 327 PEREA  Concurrence in Senate Amendments",74,1,0,3,78
497758,271508,2013-04-23,Assembly,"Do pass as amended and be re-referred to the Committee on Judiciary",5,2,0,0,7
497758,274124,2013-04-30,Assembly,"Do pass as amended and be re-referred to the Committee on 	Appropriations",10,0,0,0,10
497758,279718,2013-05-15,Assembly,"Do pass",16,1,0,0,17
497758,283166,2013-05-23,Assembly,"AB 329 PAN  Assembly Third Reading",72,2,0,4,78
497758,295356,2013-07-01,Senate,"Do pass, but re-refer to the Committee on Appropriations",10,0,0,0,10
497758,298614,2013-09-03,Senate,"Assembly 3rd Reading AB329 Pan By Lieu",36,0,3,0,39
497762,308668,2014-01-14,Assembly,"Do pass and be re-referred to the Committee on Appropriations",9,2,0,2,13
497762,311173,2014-01-23,Assembly,"Do pass as amended",12,3,0,2,17
497762,313266,2014-01-29,Assembly,"AB 330 CHAU  Assembly Third Reading",53,24,0,3,80
497762,369815,2014-06-04,Senate,"Do pass as amended, and re-refer to the Committee on Business, 	Professions and Economic Development",6,0,1,0,7
497762,374078,2014-06-23,Senate,"Do pass, but re-refer to the Committee on Appropriations",8,0,1,0,9
497765,276840,2013-05-07,Assembly,"Do pass, to Consent Calendar",6,0,0,1,7
497765,280287,2013-05-16,Assembly,"AB 331 GARCIA  Consent Calendar Second Day  Regular Session",70,0,0,9,79
497765,289584,2013-06-18,Senate,"Do pass and be placed on the Consent Calendar",4,0,1,0,5
497765,295643,2013-07-01,Senate,"Consent Calendar 2nd AB331 Garcia",33,0,5,0,38
497768,261911,2013-04-09,Assembly,"Do pass and be re-referred to the Committee on Labor and Employment",5,1,0,1,7
497768,272436,2013-04-24,Assembly,"Do pass and be re-referred to the Committee on Appropriations",5,0,0,2,7
497772,267423,2013-04-16,Assembly,"Do pass and be re-referred to the Committee on Appropriations",7,0,0,0,7
497772,279874,2013-05-15,Assembly,"Do pass",17,0,0,0,17
497772,283317,2013-05-23,Assembly,"AB 333 WIECKOWSKI  Assembly Third Reading",67,6,0,5,78
497772,372896,2014-06-18,Senate,"Do pass as amended, and re-refer to the Committee on 	Appropriations",7,0,0,0,7
497772,376542,2014-08-04,Senate,"Placed on Appropriations Suspense file",7,0,0,0,7
497772,377317,2014-08-14,Senate,"Do pass as amended",5,0,2,0,7
497772,378615,2014-08-27,Senate,"Assembly 3rd Reading AB333 Wieckowski By Hill",33,0,7,0,40
497772,379102,2014-08-29,Assembly,"Senate amendments be concurred in",6,0,0,1,7
497772,379103,2014-08-29,Assembly,"AB 333 WIECKOWSKI  Concurrence in Senate Amendments",74,2,0,3,79
497777,263020,2013-04-10,Assembly,"Do pass and be re-referred to the Committee on Appropriations",5,2,0,0,7
497777,267486,2013-04-17,Assembly,"Do pass",12,3,0,2,17
497777,270067,2013-04-22,Assembly,"AB 334 GOMEZ  Assembly Third Reading",53,25,0,1,79
497777,287911,2013-06-10,Senate,"Do pass, but re-refer to the Committee on Appropriations",3,2,0,0,5
497777,295600,2013-07-01,Senate,"Do pass",4,2,1,0,7
497777,379028,2014-08-29,Senate,"Do pass",6,2,1,0,9
497777,379029,2014-08-29,Senate,"Assembly 3rd Supp 1 AB334 Buchanan Urgency Clause",31,4,5,0,40
497777,379030,2014-08-29,Assembly,"AB 334 BUCHANAN  Concurrence- Urgency Added",60,15,0,4,79
497783,270687,2013-04-23,Assembly,"Do pass as amended",4,2,0,1,7
497783,284969,2013-05-29,Assembly,"AB 336 AMMIANO  Assembly Third Reading  Amend By AMMIANO  Set #1",51,24,0,4,79
497783,285969,2013-05-31,Assembly,"AB 336 AMMIANO  Assembly Third Reading",44,32,0,3,79
497783,374441,2014-06-24,Senate,"Do pass",5,2,0,0,7
497783,376480,2014-08-04,Senate,"Placed on Appropriations Suspense file",7,0,0,0,7
497783,377200,2014-08-14,Senate,"Do pass",5,1,1,0,7
497783,378469,2014-08-26,Senate,"Assembly 3rd Reading AB336 Ammiano By Mitchell",21,13,6,0,40
497788,306181,2014-01-07,Assembly,"Do pass as amended and be re-referred to the Committee on 	Appropriations",8,0,0,1,9
497788,311209,2014-01-23,Assembly,"Do pass",16,0,0,1,17
497788,312295,2014-01-27,Assembly,"AB 337 ALLEN  Assembly Third Reading",76,1,0,3,80
497788,371697,2014-06-16,Senate,"Do pass, but re-refer to the Committee on Appropriations",9,0,0,0,9
497788,378331,2014-08-25,Senate,"Assembly 3rd Reading AB337 Allen By Walters",34,0,6,0,40
497788,378578,2014-08-26,Assembly,"AB 337 ALLEN  Concurrence in Senate Amendments",77,1,0,1,79
497795,257745,2013-04-02,Assembly,"Do pass and be re-referred to the Committee on Appropriations",6,0,0,1,7
497795,277337,2013-05-08,Assembly,"Do pass",12,3,0,2,17
497795,283219,2013-05-23,Assembly,"AB 339 DICKINSON  Assembly Third Reading",63,10,0,5,78
497795,289394,2013-06-18,Senate,"Do pass as amended, and re-refer to the Committee on Appropriations",5,1,1,0,7
497795,297676,2013-08-19,Senate,"Assembly 3rd Reading AB339 Dickinson By Hill",30,4,5,0,39
497795,297896,2013-08-22,Assembly,"AB 339 DICKINSON  Concurrence in Senate Amendments",64,12,0,2,78
497799,271057,2013-04-22,Assembly,"Do pass as amended and be re-referred to the Committee on 	Appropriations",10,4,0,1,15
497799,280086,2013-05-15,Assembly,"Do pass",12,5,0,0,17
497799,283347,2013-05-23,Assembly,"AB 340 BRADFORD  Assembly Third Reading",50,21,0,7,78
497799,289447,2013-06-18,Senate,"Do pass, but re-refer to the Committee on Appropriations",6,2,3,0,11
497799,295597,2013-07-01,Senate,"Placed on Appropriations Suspense file",6,0,1,0,7
497799,298363,2013-08-30,Senate,"Do pass",5,2,0,0,7
497799,299024,2013-09-09,Senate,"Assembly 3rd Reading AB340 Bradford By Lara",27,11,1,0,39
497802,266379,2013-04-15,Assembly,"Do pass as amended and be re-referred to the Committee on 	Appropriations",7,1,0,1,9
497802,284033,2013-05-24,Assembly,"Do pass",16,0,0,1,17
497802,284759,2013-05-28,Assembly,"AB 341 DICKINSON  Assembly Third Reading",76,1,0,2,79
497802,289462,2013-06-18,Senate,"Do pass as amended, and re-refer to the Committee on Energy, 	Utilities and Communications",10,0,1,0,11
497802,295910,2013-07-02,Senate,"Do pass, but re-refer to the Committee on Appropriations",9,0,2,0,11
497802,297432,2013-08-12,Senate,"Do pass",5,0,2,0,7
497802,298021,2013-08-26,Senate,"Assembly 3rd Reading AB341 Dickinson By Lieu",38,0,1,0,39
497802,298452,2013-08-30,Assembly,"AB 341 DICKINSON  Concurrence in Senate Amendments",77,1,0,0,78
497806,275641,2013-05-01,Assembly,"Do pass and re-refer to Committee on Appropriations with 	recommendation:  To Consent Calendar",7,0,0,0,7
497806,284018,2013-05-24,Assembly,"Do pass as amended",12,0,0,5,17
497806,285176,2013-05-29,Assembly,"AB 342 BLUMENFIELD  Assembly Third Reading",76,0,0,3,79
497806,291897,2013-06-26,Senate,"Do pass as amended, and re-refer to the Committee on Appropriations",9,0,0,0,9
497814,251721,2013-03-19,Assembly,"Do pass and be re-referred to the Committee on Labor and Employment",5,1,0,1,7
497814,263458,2013-04-10,Assembly,"Do pass and be re-referred to the Committee on Appropriations",6,1,0,0,7
497820,258740,2013-04-02,Assembly,"Do pass and be re-referred to the Committee on Appropriations",7,0,0,0,7
497820,267206,2013-04-17,Assembly,"Do pass, to Consent Calendar",17,0,0,0,17
497820,272332,2013-04-25,Assembly,"AB 346 STONE  Consent Calendar Second Day  Regular Session",76,0,0,3,79
497820,288103,2013-06-11,Senate,"Do pass as amended, and re-refer to the Committee on Appropriations",6,0,0,0,6
497820,295655,2013-07-01,Senate,"Do pass",6,0,1,0,7
497820,299112,2013-09-10,Senate,"Assembly 3rd Reading AB346 Stone By Berryhill",36,0,3,0,39
497820,299580,2013-09-11,Assembly,"AB 346 STONE  Concurrence in Senate Amendments",78,0,0,0,78
497825,261740,2013-04-09,Assembly,"Do pass and re-refer to Committee on Appropriations with 	recommendation:  To Consent Calendar",6,0,0,1,7
497832,275740,2013-05-01,Assembly,"Do pass and be re-referred to the Committee on Appropriations",6,0,0,1,7
497832,283909,2013-05-24,Assembly,"Do pass as amended",12,0,0,5,17
497832,285627,2013-05-30,Assembly,"AB 349 GATTO  Assembly Third Reading",77,0,0,2,79
497832,296154,2013-07-03,Senate,"Do pass as amended, and re-refer to the Committee on Appropriations",9,0,0,0,9
497832,297341,2013-08-12,Senate,"Placed on Appropriations Suspense file",6,0,1,0,7
497835,274166,2013-04-29,Assembly,"Do pass and be re-referred to the Committee on Appropriations",3,1,0,5,9
497835,274167,2013-04-29,Assembly,"Set first hearing.  Failed passage.  Reconsideration granted",9,0,0,0,9
497840,261723,2013-04-09,Assembly,"Do pass and be re-referred to the Committee on Appropriations",6,0,0,1,7
497840,283865,2013-05-24,Assembly,"Do pass as amended",14,0,0,3,17
497840,285554,2013-05-30,Assembly,"AB 351 DONNELLY  Assembly Third Reading",71,1,0,7,79
497840,291536,2013-06-25,Senate,"Do pass, but re-refer to the Committee on Appropriations",7,0,0,0,7
497840,298620,2013-09-03,Senate,"Assembly 3rd Reading AB351 Donnelly By Leno",37,0,2,0,39
497843,267554,2013-04-16,Assembly,"Do pass as amended and be re-referred to the Committee on 	Governmental Organization",5,2,0,0,7
497843,272453,2013-04-24,Assembly,"Do pass and be re-referred to the Committee on Appropriations",12,0,0,5,17
497843,277390,2013-05-08,Assembly,"Do pass",12,5,0,0,17
497843,280335,2013-05-16,Assembly,"AB 352 HALL  Assembly Third Reading",51,19,0,9,79
497843,288052,2013-06-11,Senate,"Do pass as amended, and re-refer to the Committee on Appropriations",4,0,2,0,6
497843,297645,2013-08-19,Senate,"Assembly 3rd Reading AB352 Hall By Monning",24,8,7,0,39
497843,297885,2013-08-22,Assembly,"AB 352 HALL  Concurrence in Senate Amendments",55,20,0,3,78
497847,276848,2013-05-07,Assembly,"Do pass as amended, to Consent Calendar",6,0,0,1,7
497847,281184,2013-05-20,Assembly,"AB 354 DAHLE  Consent Calendar Second Day",73,0,0,5,78
497847,296163,2013-07-02,Senate,"Do pass as amended",5,0,0,0,5
497847,297789,2013-08-19,Senate,"Assembly 3rd Reading AB354 Dahle By Emmerson",37,0,2,0,39
497847,297917,2013-08-22,Assembly,"AB 354 DAHLE  Concurrence in Senate Amendments",76,0,0,2,78
497848,262815,2013-04-10,Assembly,"Do pass as amended and be re-referred to the Committee on 	Appropriations",16,1,0,0,17
497848,283797,2013-05-24,Assembly,"Do pass as amended",14,0,0,3,17
497848,285541,2013-05-30,Assembly,"AB 355 COOLEY  Assembly Third Reading",77,1,0,1,79
497848,295933,2013-07-03,Senate,"Do pass, but re-refer to the Committee on Appropriations",9,0,0,0,9
497848,297298,2013-08-12,Senate,"Placed on Appropriations Suspense file",6,0,1,0,7
497850,276896,2013-05-07,Assembly,"Be adopted and be re-referred to the Committee on Appropriations",5,2,0,0,7
497852,289079,2013-06-15,Assembly,"ACA8 BLUMENFIELD  Assembly Third Reading",54,25,0,0,79
497862,267338,2013-04-17,Senate,"Do pass, but re-refer to the Committee on Appropriations",6,0,3,0,9
497862,273504,2013-04-29,Senate,"Placed on Appropriations Suspense file",7,0,0,0,7
497862,283145,2013-05-23,Senate,"Do pass as amended",5,1,1,0,7
497862,284974,2013-05-29,Senate,"Senate 3rd Reading SB254 Hancock",32,5,2,0,39
497862,297264,2013-08-12,Assembly,"Do pass as amended and be re-referred to the Committee on 	Appropriations",7,0,0,2,9
497862,298253,2013-08-30,Assembly,"Do pass as amended",15,1,0,1,17
497862,299401,2013-09-11,Assembly,"SB 254 Hancock  Senate Third Reading  By EGGMAN",66,11,0,1,78
497862,299644,2013-09-12,Senate,"Unfinished Business SB254 Hancock Concurrence",31,8,0,0,39
497867,286844,2013-06-04,Senate,"Do pass as amended, and re-refer to the Committee on Appropriations",7,0,0,0,7
497867,295657,2013-07-01,Senate,"Do pass",6,0,1,0,7
497867,297576,2013-08-15,Senate,"Senate 3rd Reading SB255 Cannella Urgency Clause",37,1,1,0,39
497867,298134,2013-08-27,Assembly,"Do pass and be re-referred to the Committee on Appropriations",7,0,0,0,7
497867,298485,2013-08-30,Assembly,"Do pass as amended",16,0,0,1,17
497867,299576,2013-09-11,Senate,"Unfinished Supp 1 SB255 Cannella Concurrence",39,0,0,0,39
497867,299577,2013-09-11,Assembly,"SB 255 Cannella  Third Reading Urgency  By QUIRK",77,1,0,0,78
497870,271848,2013-04-24,Senate,"Do pass as amended, and re-refer to the Committee on Appropriations",4,0,1,0,5
497870,278668,2013-05-13,Senate,"Placed on Appropriations Suspense file",5,0,2,0,7
497870,283245,2013-05-23,Senate,"Do pass as amended",5,0,2,0,7
497870,284593,2013-05-28,Senate,"Senate 3rd Reading SB256 Lieu",28,10,1,0,39
497870,292159,2013-06-26,Assembly,"Do pass and be re-referred to the Committee on Business, 	Professions and Consumer Protection",7,0,0,0,7
497870,297314,2013-08-13,Assembly,"Do pass and be re-referred to the Committee on Appropriations",10,2,0,2,14
497878,277498,2013-05-08,Senate,"Do pass",4,1,0,0,5
497878,280367,2013-05-16,Senate,"Senate 3rd Reading SB258 Lieu",25,11,2,0,38
497878,297082,2013-08-07,Assembly,"Do pass",8,4,0,0,12
497878,298589,2013-09-03,Assembly,"SB 258 Lieu  Senate Third Reading  By PEREA",51,25,0,2,78
497878,298768,2013-09-06,Senate,"Unfinished Business SB258 Lieu Concurrence",26,11,2,0,39
497882,261048,2013-04-08,Senate,"Do pass, but re-refer to the Committee on Appropriations",3,2,0,0,5
497882,269893,2013-04-22,Senate,"Placed on Appropriations Suspense file",7,0,0,0,7
497885,261730,2013-04-09,Senate,"Do pass, but re-refer to the Committee on Appropriations",4,2,1,0,7
497885,269919,2013-04-22,Senate,"Placed on Appropriations Suspense file",7,0,0,0,7
497885,283066,2013-05-23,Senate,"Do pass as amended",6,0,1,0,7
497885,284585,2013-05-28,Senate,"Senate 3rd Reading SB260 Hancock",27,11,1,0,39
497885,295811,2013-07-02,Assembly,"Do pass and be re-referred to the Committee on Appropriations",5,2,0,0,7
497885,298264,2013-08-30,Assembly,"Do pass as amended",12,5,0,0,17
497885,298780,2013-09-06,Assembly,"SB 260 Hancock  Senate Third Reading  By BLOOM",52,24,0,2,78
497885,299192,2013-09-10,Senate,"Unfinished Business SB260 Hancock Concurrence",22,14,3,0,39
497888,261075,2013-04-08,Senate,"Do pass, but re-refer to the Committee on Appropriations",10,0,0,0,10
497888,273508,2013-04-29,Senate,"Special Consent #2 SB261 Monning",37,0,1,0,38
497888,288296,2013-06-11,Assembly,"Do pass and be re-referred to the Committee on Appropriations",12,0,0,1,13
497888,296120,2013-07-03,Assembly,"Do pass",16,1,0,0,17
497888,297169,2013-08-08,Assembly,"SB 261 Monning  Senate Third Reading  By ACHADJIAN",74,3,0,1,78
497892,261011,2013-04-08,Senate,"Do pass as amended, and re-refer to the Committee on Appropriations",10,0,0,0,10
497892,272302,2013-04-25,Senate,"Senate 3rd Reading SB262 Monning",36,0,2,0,38
497892,288105,2013-06-11,Assembly,"Do pass as amended and be re-referred to the Committee on 	Appropriations",12,0,0,1,13
497892,296077,2013-07-03,Assembly,"Do pass as amended, to Consent Calendar",17,0,0,0,17
497892,297128,2013-08-08,Assembly,"SB 262 Monning  Consent Calendar Second Day  Regular Session",77,0,0,1,78
497892,297559,2013-08-15,Senate,"Unfinished Business SB262 Monning Concurrence",38,0,1,0,39
497895,260925,2013-04-08,Senate,"Do pass as amended, and re-refer to the Committee on Appropriations",10,0,0,0,10
497895,281393,2013-05-20,Senate,"Special Consent #5 SB263 Monning",36,0,3,0,39
497895,370630,2014-06-02,Assembly,"Be referred to Committee on Labor and Employment",11,0,0,0,11
497895,374913,2014-06-25,Assembly,"Do pass and be re-referred to the Committee on Appropriations",5,1,0,1,7
497907,262708,2013-04-10,Senate,"Do pass, but re-refer to the Committee on Appropriations",9,0,0,0,9
497907,276369,2013-05-06,Senate,"Placed on Appropriations Suspense file",7,0,0,0,7
497907,309011,2014-01-15,Senate,"Do pass, but re-refer to the Committee on Appropriations",3,0,2,0,5
497907,311168,2014-01-23,Senate,"Senate 3rd Reading SB266 Lieu",28,5,6,0,39
497907,374861,2014-06-25,Assembly,"Do pass as amended and be re-referred to the Committee on 	Appropriations",5,1,0,1,7
497907,376698,2014-08-06,Assembly,"Do pass",12,5,0,0,17
497907,378573,2014-08-26,Assembly,"SB 266 Lieu  Senate Third Reading  By HERNANDEZ",55,22,0,2,79
497907,378962,2014-08-28,Senate,"Unfinished Business SB266 Lieu Concurrence",28,9,3,0,40
497910,272259,2013-04-24,Senate,"Do pass, but re-refer to the Committee on Elections and 	Constitutional Amendments",7,2,0,0,9
497910,274762,2013-04-30,Senate,"Do pass as amended, and re-refer to the Committee on Appropriations",4,1,0,0,5
497910,281289,2013-05-20,Senate,"Placed on Appropriations Suspense file",6,0,1,0,7
497910,283368,2013-05-23,Senate,"Do pass as amended",5,2,0,0,7
497910,285269,2013-05-29,Senate,"Senate 3rd Reading SB267 Pavley",31,8,0,0,39
497910,285574,2013-05-30,Senate,"W/O REF. TO FILE SB267 Pavley Reconsider",37,0,2,0,39
497910,285575,2013-05-30,Senate,"W/O REF. TO FILE SB267 Pavley",31,8,0,0,39
497910,373167,2014-06-19,Assembly,"Be referred to Committee on Education",11,0,0,0,11
497910,374761,2014-06-25,Assembly,"Do pass as amended and be re-referred to the Committee on 	Appropriations",5,0,0,2,7
497910,376691,2014-08-06,Assembly,"Do pass",12,5,0,0,17
497910,378428,2014-08-25,Assembly,"SB 267 Pavley  Senate Third Reading  By BUCHANAN",57,19,0,3,79
497910,378716,2014-08-27,Senate,"From committee:  That the Assembly Amendments be concurred in",7,0,0,0,7
497910,378867,2014-08-28,Senate,"Unfinished Business SB267 Pavley Concurrence",32,0,8,0,40
497913,309102,2014-01-15,Senate,"Do pass as amended",6,0,0,0,6
497913,313862,2014-01-30,Senate,"Senate 3rd Reading SB268 Gaines Urgency Clause",35,0,4,0,39
497913,363125,2014-05-07,Assembly,"Do pass",9,0,0,0,9
497913,365295,2014-05-19,Assembly,"SB 268 Gaines  Third Reading Urgency  By DAHLE",73,0,0,6,79
500186,245542,2013-03-11,Senate,"Senate 3rd Reading SCR11 Corbett",31,0,6,0,37
500186,297065,2013-08-05,Assembly,"Be adopted, to Consent Calendar",10,0,0,1,11
500186,297154,2013-08-08,Assembly,"SCR 11 Corbett  Consent Calendar Second Day  Regular Session",77,0,0,1,78
500187,267271,2013-04-16,Senate,"Do pass, but re-refer to the Committee on Appropriations",5,2,0,0,7
500187,273544,2013-04-29,Senate,"Placed on Appropriations Suspense file",7,0,0,0,7
500187,283222,2013-05-23,Senate,"Do pass as amended",5,2,0,0,7
500187,284997,2013-05-29,Senate,"Senate 3rd Reading SB293 DeSaulnier",22,14,3,0,39
500187,295751,2013-07-02,Assembly,"Do pass and be re-referred to the Committee on Appropriations",5,2,0,0,7
500189,267198,2013-04-16,Senate,"Do pass",7,0,0,0,7
500189,269958,2013-04-22,Senate,"Senate 3rd Reading SB292 Corbett",38,0,0,0,38
500189,289397,2013-06-18,Assembly,"Do pass and be re-referred to the Committee on Labor and Employment",9,0,0,1,10
500189,292151,2013-06-26,Assembly,"Do pass, to Consent Calendar",7,0,0,0,7
500189,295981,2013-07-03,Assembly,"SB 292 Corbett  Consent Calendar Second Day",74,0,0,4,78
500191,257413,2013-04-02,Senate,"Do pass, but re-refer to the Committee on Appropriations",11,0,0,0,11
500191,265348,2013-04-15,Senate,"Do pass",7,0,0,0,7
500191,268732,2013-04-18,Senate,"Senate 3rd Reading SB291 Hill",36,0,2,0,38
500191,289469,2013-06-17,Assembly,"Do pass as amended and be re-referred to the Committee on 	Appropriations",12,0,0,3,15
500191,298436,2013-08-30,Assembly,"Do pass as amended",16,0,0,1,17
500191,299546,2013-09-11,Senate,"Unfinished Supp 1 SB291 Hill Concurrence",39,0,0,0,39
500191,299547,2013-09-11,Assembly,"SB 291 Hill  Senate Third Reading  By GORDON",78,0,0,0,78
500193,272659,2013-04-24,Senate,"Do pass as amended, and re-refer to the Committee on Appropriations",9,0,0,0,9
500193,278790,2013-05-13,Senate,"Placed on Appropriations Suspense file",5,0,2,0,7
500193,283379,2013-05-23,Senate,"Do pass as amended",7,0,0,0,7
500193,285215,2013-05-29,Senate,"Senate 3rd Reading SB290 Knight",39,0,0,0,39
500193,297080,2013-08-06,Assembly,"Do pass and be re-referred to the Committee on Veterans Affairs",12,0,0,1,13
500193,297466,2013-08-13,Assembly,"Do pass as amended and be re-referred to the Committee on 	Appropriations",9,0,0,1,10
500193,298477,2013-08-30,Assembly,"Do pass",17,0,0,0,17
500193,298744,2013-09-04,Assembly,"SB 290 Knight  Senate Third Reading  By GORELL",77,0,0,1,78
500193,299686,2013-09-12,Senate,"Special Consent #10 SB290 Knight",39,0,0,0,39
500197,271617,2013-04-24,Senate,"Do pass, but re-refer to the Committee on Appropriations",4,0,1,0,5
500197,278751,2013-05-13,Senate,"Senate 3rd Reading SB288 Lieu",34,0,4,0,38
500197,288721,2013-06-12,Assembly,"Do pass and be re-referred to the Committee on Appropriations",7,0,0,0,7
500197,296170,2013-07-03,Assembly,"Do pass",14,1,0,2,17
500197,298658,2013-09-03,Assembly,"SB 288 Lieu  Senate Third Reading  By LOWENTHAL",68,7,0,3,78
500197,298867,2013-09-06,Senate,"Unfinished Business SB288 Lieu Concurrence",37,0,2,0,39
500200,271555,2013-04-23,Senate,"Do pass, but re-refer to the Committee on Appropriations",3,4,0,0,7
500200,271556,2013-04-23,Senate,"Set, first hearing.  Failed passage in Committee.  Reconsideration 	granted",7,0,0,0,7
500201,257453,2013-04-02,Senate,"Do pass, but re-refer to the Committee on Appropriations",11,0,0,0,11
500201,272366,2013-04-25,Senate,"Senate 3rd Reading SB286 Yee",34,0,4,0,38
500201,289238,2013-06-17,Assembly,"Do pass as amended and be re-referred to the Committee on 	Appropriations",13,1,0,2,16
500201,295930,2013-07-03,Assembly,"Do pass as amended",16,1,0,0,17
500201,298587,2013-09-03,Assembly,"SB 286  Senate Third Reading  By BLOOM",69,5,0,4,78
500201,298712,2013-09-04,Senate,"Unfinished Business SB286 Yee Concurrence",30,8,1,0,39
500203,267440,2013-04-17,Senate,"Do pass as amended, and re-refer to the Committee on Appropriations",9,0,0,0,9
500203,281326,2013-05-20,Senate,"Do pass as amended",6,0,1,0,7
500203,284569,2013-05-28,Senate,"Senate 3rd Reading SB285 De Le",39,0,0,0,39
500203,297077,2013-08-06,Assembly,"Do pass and be re-referred to the Committee on Appropriations",12,0,0,1,13
500203,298230,2013-08-30,Assembly,"Do pass",16,0,0,1,17
500203,299050,2013-09-09,Assembly,"SB 285 De Leon  Senate Third Reading  By WILLIAMS",77,1,0,0,78
500206,271639,2013-04-24,Senate,"Do pass as amended, and re-refer to the Committee on Appropriations",7,0,0,0,7
500206,279090,2013-05-13,Senate,"Placed on Appropriations Suspense file",5,0,2,0,7
500206,283102,2013-05-23,Senate,"Do pass",7,0,0,0,7
500206,284588,2013-05-28,Senate,"Senate 3rd Reading SB284 De Le",39,0,0,0,39
500206,297210,2013-08-12,Assembly,"Do pass as amended and be re-referred to the Committee on 	Appropriations",9,0,0,0,9
500206,298366,2013-08-30,Assembly,"Do pass",16,1,0,0,17
500206,299026,2013-09-09,Assembly,"SB 284 De Leon  Senate Third Reading  By NESTANDE",76,1,0,1,78
500206,299253,2013-09-10,Senate,"Unfinished Business SB284 De Le",37,0,2,0,39
500208,261770,2013-04-09,Senate,"Do pass, but re-refer to the Committee on Appropriations",4,1,1,0,6
500208,273602,2013-04-29,Senate,"Placed on Appropriations Suspense file",7,0,0,0,7
500208,283109,2013-05-23,Senate,"Do pass as amended",5,2,0,0,7
500208,285119,2013-05-29,Senate,"Senate 3rd Reading SB283 Hancock",26,8,5,0,39
500208,295838,2013-07-02,Assembly,"Do pass as amended and be re-referred to the Committee on 	Appropriations",5,2,0,0,7
500209,277426,2013-05-07,Senate,"Do pass and be placed on the Consent Calendar",6,0,1,0,7
500209,280261,2013-05-16,Senate,"Consent Calendar 2nd SB282 Yee",37,0,1,0,38
500209,289446,2013-06-18,Assembly,"Do pass, to Consent Calendar",9,0,0,1,10
500209,291262,2013-06-24,Assembly,"SB 282 Yee  Consent Calendar Second Day  Regular Session",75,0,0,4,79
500212,271502,2013-04-24,Senate,"Do pass as amended, and re-refer to the Committee on 	Appropriations",9,0,0,0,9
500212,281288,2013-05-20,Senate,"Placed on Appropriations Suspense file",6,0,1,0,7
500212,283398,2013-05-23,Senate,"Do pass",7,0,0,0,7
500212,285143,2013-05-29,Senate,"Special Consent #7 SB281 Calderon",38,0,1,0,39
500212,297081,2013-08-07,Assembly,"Do pass and be re-referred to the Committee on Appropriations",12,0,0,0,12
500212,298379,2013-08-30,Assembly,"Do pass as amended",12,0,0,5,17
500212,299407,2013-09-11,Senate,"Unfinished Supp 1 SB281 Calderon Concurrence",39,0,0,0,39
500212,299408,2013-09-11,Assembly,"SB 281 Calderon  Senate Third Reading  By COOLEY",77,0,0,1,78
500214,308987,2014-01-15,Senate,"Do pass, but re-refer to the Committee on Appropriations",7,0,2,0,9
500214,310351,2014-01-21,Senate,"Placed on Appropriations Suspense file",5,0,2,0,7
500216,267314,2013-04-17,Senate,"Do pass as amended, and re-refer to the Committee on Rules",7,0,0,0,7
500216,281382,2013-05-20,Senate,"Senate 3rd Reading SB279 Hancock",36,0,3,0,39
500216,288409,2013-06-12,Assembly,"Do pass as amended and be re-referred to the Committee on 	Appropriations",9,0,0,0,9
500216,295984,2013-07-03,Assembly,"Do pass, to Consent Calendar",17,0,0,0,17
500216,298596,2013-09-03,Assembly,"SB 279 Hancock  Senate Third Reading  By LEVINE",74,1,0,3,78
500216,298718,2013-09-04,Senate,"Unfinished Business SB279 Hancock Concurrence",38,0,1,0,39
500220,260978,2013-04-08,Senate,"Do pass, but re-refer to the Committee on Appropriations Recommend 	Consent",5,0,0,0,5
500220,269885,2013-04-22,Senate,"Placed on Appropriations Suspense file",7,0,0,0,7
500220,283139,2013-05-23,Senate,"Do pass",6,0,1,0,7
500220,284996,2013-05-29,Senate,"Special Consent #7 SB277 Beall",38,0,1,0,39
500220,291893,2013-06-26,Assembly,"Do pass and re-refer to Committee on Appropriations with 	recommendation:  To Consent Calendar",6,0,0,1,7
500220,298234,2013-08-30,Assembly,"Do pass",17,0,0,0,17
500220,298949,2013-09-09,Assembly,"SB 277 Beall  Senate Third Reading  By BONTA",78,0,0,0,78
500220,299172,2013-09-10,Senate,"Unfinished Business SB277 Beall Concurrence",36,0,3,0,39
500222,271166,2013-04-23,Senate,"Do pass, but re-refer to the Committee on Appropriations",9,0,2,0,11
500222,276511,2013-05-06,Senate,"Placed on Appropriations Suspense file",7,0,0,0,7
500226,274817,2013-04-30,Senate,"Do pass, but re-refer to the Committee on Appropriations",5,2,0,0,7
500226,281175,2013-05-20,Senate,"Do pass",4,2,1,0,7
500226,284643,2013-05-28,Senate,"Senate 3rd Reading SB274 Leno",28,11,0,0,39
500226,289405,2013-06-18,Assembly,"Do pass and be re-referred to the Committee on Appropriations",7,2,0,1,10
500226,295963,2013-07-03,Assembly,"Do pass",12,5,0,0,17
500226,298574,2013-09-03,Assembly,"SB 274 Leno  Senate Third Reading  By STONE",48,27,0,3,78
500226,298755,2013-09-06,Senate,"Unfinished Business SB274 Leno Concurrence",26,11,2,0,39
500231,266511,2013-04-15,Senate,"Do pass, but re-refer to the Committee on Rules",10,0,0,0,10
500231,274828,2013-04-30,Senate,"Do pass, but re-refer to the Committee on Appropriations",7,0,0,0,7
500231,280318,2013-05-16,Senate,"Senate 3rd Reading SB272 Corbett",37,0,1,0,38
500231,291562,2013-06-25,Assembly,"Do pass as amended and be re-referred to the Committee on 	Appropriations",13,0,0,0,13
500231,297467,2013-08-14,Assembly,"Do pass, to Consent Calendar",17,0,0,0,17
500231,298062,2013-08-26,Assembly,"SB 272 Corbett  Senate Third Reading  By MURATSUCHI",77,0,0,1,78
500231,298381,2013-08-30,Senate,"Special Consent #9 SB272 Corbett",38,0,1,0,39
500232,258701,2013-04-03,Senate,"Do pass, but re-refer to the Committee on Appropriations",9,0,0,0,9
500232,265673,2013-04-15,Senate,"Placed on Appropriations Suspense file",7,0,0,0,7
500232,283206,2013-05-23,Senate,"Do pass",7,0,0,0,7
500232,285009,2013-05-29,Senate,"Special Consent #7 SB271 Hernandez",38,0,1,0,39
500232,296172,2013-07-02,Assembly,"Do pass as amended and be re-referred to the Committee on 	Appropriations",19,0,0,0,19
500232,298460,2013-08-30,Assembly,"Do pass",17,0,0,0,17
500232,298740,2013-09-04,Assembly,"SB 271 Hernandez  Senate Third Reading  By DICKINSON",77,0,0,1,78
500232,298821,2013-09-06,Senate,"Unfinished Business SB271 Hernandez Concurrence",38,0,1,0,39
500234,263091,2013-04-10,Senate,"Do pass, but re-refer to the Committee on Appropriations",4,0,1,0,5
500234,273576,2013-04-29,Senate,"Special Consent #2 SB270 Padilla",37,0,1,0,38
500234,358390,2014-04-21,Assembly,"Be referred to Committee on Natural Resources",9,0,0,2,11
500234,364394,2014-05-14,Assembly,"Do pass as amended and be re-referred to the Committee on 	Appropriations",5,3,0,1,9
500234,377327,2014-08-14,Assembly,"Do pass as amended",11,3,0,3,17
500234,378291,2014-08-25,Assembly,"SB 270 Padilla  Senate Third Reading  By BONTA",38,33,0,8,79
500234,378868,2014-08-28,Assembly,"SB 270 Padilla  Motion to Reconsider",51,25,0,3,79
500234,378869,2014-08-28,Assembly,"SB 270 Padilla  Senate Third Reading  By BONTA",45,31,0,3,79
500234,379042,2014-08-29,Senate,"From committee:  That the Assembly Amendments be concurred in",5,2,0,0,7
500234,379043,2014-08-29,Senate,"Unfinished Supp 1 SB270 Padilla Concurrence",22,15,3,0,40
500237,256799,2013-04-01,Senate,"Do pass, but re-refer to the Committee on Appropriations",10,0,0,0,10
500237,268656,2013-04-18,Senate,"Senate 3rd Reading SB269 Hill",36,0,2,0,38
500237,288337,2013-06-11,Assembly,"Do pass and be re-referred to the Committee on Appropriations",12,0,0,1,13
500237,296122,2013-07-03,Assembly,"Do pass",16,1,0,0,17
500237,298236,2013-08-30,Assembly,"SB 269 Hill  Senate Third Reading  By BONILLA  Amend By BONILLA 	Set #1",70,4,0,4,78
500237,299162,2013-09-10,Assembly,"Do pass",14,0,0,0,14
500237,299757,2013-09-12,Assembly,"SB 269 Hill  Senate Third Reading  By BONILLA",75,1,0,2,78
500237,299758,2013-09-12,Senate,"Unfinished Supp 2 SB269 Hill Concurrence",37,0,2,0,39
500239,235720,2013-02-21,Assembly,"From committee:  Be adopted.  To third reading",9,0,0,2,11
500240,240030,2013-02-28,Assembly,"From committee:  Be adopted.  To third reading",11,0,0,0,11
500243,261782,2013-04-08,Assembly,"Do pass and be re-referred to the Committee on Appropriations",10,0,0,2,12
500243,283969,2013-05-24,Assembly,"Do pass as amended",13,4,0,0,17
500243,285204,2013-05-29,Assembly,"AB 385 DICKINSON  Assembly Third Reading",56,21,0,2,79
500243,289897,2013-06-19,Senate,"Do pass, but re-refer to the Committee on Appropriations",7,1,1,0,9
500243,295479,2013-07-01,Senate,"Placed on Appropriations Suspense file",6,0,1,0,7
500247,257359,2013-04-02,Assembly,"Do pass, to Consent Calendar",9,0,0,1,10
500247,260930,2013-04-08,Assembly,"AB 383 WAGNER  Consent Calendar Second Day",75,0,0,4,79
500247,291557,2013-06-25,Senate,"Do pass and be placed on the Consent Calendar",7,0,0,0,7
500247,295272,2013-07-01,Senate,"Consent Calendar 2nd AB383 Wagner",33,0,5,0,38
500247,295992,2013-07-03,Assembly,"AB 383 WAGNER  Concurrence in Senate Amendments",72,1,0,5,78
500249,270912,2013-04-23,Assembly,"Do pass and be re-referred to the Committee on Local Government",9,1,0,0,10
500249,278139,2013-05-08,Assembly,"Do pass",8,0,0,1,9
500249,280227,2013-05-16,Assembly,"AB 382 MULLIN  Assembly Third Reading",67,2,0,10,79
500249,291931,2013-06-26,Senate,"Do pass",6,1,0,0,7
500249,297799,2013-08-19,Senate,"Assembly 3rd Reading AB382 Mullin By Emmerson",28,9,2,0,39
500249,298063,2013-08-26,Assembly,"AB 382 MULLIN  Concurrence in Senate Amendments",68,6,0,4,78
500251,257540,2013-04-02,Assembly,"Do pass",9,0,0,1,10
500251,265458,2013-04-15,Assembly,"AB 381 CHAU  Assembly Third Reading",77,0,0,2,79
500251,286853,2013-06-04,Senate,"Do pass",6,0,1,0,7
500251,295634,2013-07-01,Senate,"Assembly 3rd Reading AB381 Chau By Corbett",36,0,2,0,38
500251,295950,2013-07-03,Assembly,"AB 381 CHAU  Concurrence in Senate Amendments",74,0,0,4,78
500253,258019,2013-04-01,Assembly,"Do pass and be re-referred to the Committee on Local Government",6,2,0,1,9
500253,275059,2013-05-01,Assembly,"Do pass and be re-referred to the Committee on Appropriations",7,0,0,2,9
500253,283842,2013-05-24,Assembly,"Do pass as amended",12,5,0,0,17
500253,284970,2013-05-29,Assembly,"AB 380 DICKINSON  Assembly Third Reading",53,23,0,3,79
500253,369887,2014-06-04,Senate,"Do pass as amended, and re-refer to the Committee on Rules",6,0,1,0,7
500253,376964,2014-08-11,Senate,"Do pass as amended",6,1,0,0,7
500253,378297,2014-08-25,Senate,"Assembly 3rd Reading AB380 Dickinson By Hill",28,4,8,0,40
500253,379077,2014-08-29,Assembly,"Senate amendments be concurred in",6,0,0,1,7
500253,379078,2014-08-29,Assembly,"AB 380 DICKINSON  Concurrence in Senate Amendments",76,2,0,1,79
500256,258508,2013-04-03,Assembly,"Do pass, to Consent Calendar",7,0,0,0,7
500256,263457,2013-04-11,Assembly,"AB 379 BROWN  Consent Calendar Second Day  Regular Session",75,0,0,4,79
500256,286861,2013-06-04,Senate,"Do pass and be placed on the Consent Calendar",10,0,1,0,11
500256,296194,2013-07-08,Senate,"Assembly 3rd Reading AB379 Brown By Torres",33,0,5,0,38
500256,297136,2013-08-08,Assembly,"AB 379 BROWN  Concurrence in Senate Amendments",77,0,0,1,78
500259,268720,2013-04-17,Assembly,"Do pass and be re-referred to the Committee on Appropriations",2,5,0,0,7
500264,259667,2013-04-03,Assembly,"Do pass as amended and be re-referred to the Committee on Judiciary",7,0,0,0,7
500264,274318,2013-04-30,Assembly,"Do pass as amended and be re-referred to the Committee on 	Appropriations",7,1,0,2,10
500264,284035,2013-05-24,Assembly,"Do pass",13,0,0,4,17
500264,285274,2013-05-29,Assembly,"AB 375 BUCHANAN  Assembly Third Reading  Amend By WILK  Set #1 	Motion to  Lay on the Table  By ATKINS",51,24,0,4,79
500264,285275,2013-05-29,Assembly,"AB 375 BUCHANAN  Assembly Third Reading",64,11,0,4,79
500264,296102,2013-07-03,Senate,"Do pass, but re-refer to the Committee on Appropriations",4,0,5,0,9
500264,296103,2013-07-03,Senate,"Set, first hearing.  Failed passage in Committee.  Reconsideration 	granted",9,0,0,0,9
500264,299246,2013-09-10,Senate,"Do pass, but re-refer to the Committee on Appropriations",5,0,4,0,9
500264,299505,2013-09-11,Senate,"Do pass",5,2,0,0,7
500264,299744,2013-09-12,Assembly,"AB 375 BUCHANAN  Concurrence in Senate Amendments",52,22,0,4,78
500264,299745,2013-09-12,Senate,"Assembly 3rd Reading AB375 Buchanan By Padilla",25,13,1,0,39
500265,261775,2013-04-09,Assembly,"Do pass",10,0,0,0,10
500265,263488,2013-04-11,Assembly,"AB 374 WAGNER  Assembly Third Reading",75,0,0,4,79
500265,287007,2013-06-04,Senate,"Do pass",5,0,2,0,7
500265,298635,2013-09-03,Senate,"Assembly 3rd Reading AB374 Wagner By Berryhill",36,0,3,0,39
500268,262789,2013-04-10,Assembly,"Do pass and be re-referred to the Committee on Appropriations",5,2,0,0,7
500268,267287,2013-04-17,Assembly,"Do pass",12,5,0,0,17
500268,272344,2013-04-25,Assembly,"AB 373 MULLIN  Assembly Third Reading",48,26,0,5,79
500268,287831,2013-06-10,Senate,"Do pass, but re-refer to the Committee on Appropriations",4,0,1,0,5
500268,291344,2013-06-24,Senate,"Do pass",7,0,0,0,7
500268,298092,2013-08-26,Senate,"Assembly 3rd Reading AB373 Mullin By Beall",33,3,3,0,39
500270,258533,2013-04-02,Assembly,"Do pass as amended and be re-referred to the Committee on Public 	Employees, Retirement and Social Security",9,0,0,1,10
500270,271569,2013-04-24,Assembly,"Do pass and be re-referred to the Committee on Appropriations",7,0,0,0,7
500270,277509,2013-05-08,Assembly,"Do pass, to Consent Calendar",17,0,0,0,17
500270,280402,2013-05-16,Assembly,"AB 372 EGGMAN  Consent Calendar Second Day  Regular Session",70,0,0,9,79
500270,287745,2013-06-10,Senate,"Do pass, but re-refer to the Committee on Appropriations Recommend 	Consent",5,0,0,0,5
500270,295604,2013-07-01,Senate,"Consent Calendar 2nd AB372 Eggman",33,0,5,0,38
500272,257379,2013-04-02,Assembly,"Do pass and be re-referred to the Committee on Local Government",5,0,0,2,7
500272,277990,2013-05-08,Assembly,"Do pass",6,0,0,3,9
500272,312194,2014-01-27,Assembly,"AB 371 SALAS  Assembly Third Reading  Amend By SALAS  Set #1",53,21,0,6,80
500272,312677,2014-01-28,Assembly,"Do pass and be re-referred to the Committee on Appropriations",4,1,0,2,7
500272,313234,2014-01-29,Assembly,"Do pass as amended",12,1,0,4,17
500272,313891,2014-01-30,Assembly,"AB 371 SALAS  Assembly Third Reading",49,6,0,25,80
500272,372784,2014-06-18,Senate,"Do pass as amended, and re-refer to the Committee on 	Appropriations",7,0,0,0,7
500272,376517,2014-08-04,Senate,"Placed on Appropriations Suspense file",7,0,0,0,7
500272,377352,2014-08-14,Senate,"Do pass as amended",5,0,2,0,7
500274,266422,2013-04-16,Assembly,"Do pass and be re-referred to the Committee on Arts, Entertain, 	Sports, Tourism, & Internet Media",12,0,0,1,13
500274,271799,2013-04-23,Assembly,"Do pass",6,1,0,0,7
500274,275639,2013-05-02,Assembly,"AB 370 MURATSUCHI  Assembly Third Reading",73,0,0,6,79
500274,287801,2013-06-10,Senate,"Do pass, but re-refer to the Committee on Judiciary",10,0,0,0,10
500274,291589,2013-06-25,Senate,"Do pass",6,1,0,0,7
500274,297971,2013-08-22,Senate,"Assembly 3rd Reading AB370 Muratsuchi By Padilla",37,0,2,0,39
500274,298015,2013-08-26,Assembly,"AB 370 MURATSUCHI  Concurrence in Senate Amendments",78,0,0,0,78
500276,308996,2014-01-14,Assembly,"Do pass as amended and be re-referred to the Committee on 	Appropriations",16,0,0,3,19
500276,311170,2014-01-23,Assembly,"Do pass, to Consent Calendar",16,0,0,1,17
500276,313972,2014-01-30,Assembly,"AB 369 PAN  Third Reading Urgency",78,0,0,2,80
500276,319932,2014-02-12,Senate,"Do pass as amended, and re-refer to the Committee on Appropriations",7,0,2,0,9
500276,327912,2014-02-24,Senate,"Do pass",5,0,2,0,7
500276,336546,2014-03-06,Senate,"Assembly 3rd Reading AB369 Pan Urgency Clause",32,0,7,0,39
500276,339814,2014-03-10,Assembly,"AB 369 PAN  Concurrence in Senate Amendments",74,0,0,6,80
500282,271718,2013-04-23,Assembly,"Do pass as amended",5,3,0,1,9
500284,261703,2013-04-09,Assembly,"Do pass",7,3,0,0,10
500284,313281,2014-01-29,Assembly,"AB 365 MULLIN  Assembly Third Reading",54,23,0,3,80
500284,374045,2014-06-23,Senate,"Do pass as amended, and re-refer to the Committee on Appropriations",7,2,2,0,11
500287,258493,2013-04-02,Assembly,"Do pass and be re-referred to the Committee on Appropriations",7,0,0,0,7
500289,271881,2013-04-24,Assembly,"Do pass",4,9,0,0,13
500290,278744,2013-05-13,Assembly,"Do pass as amended and be re-referred to the Committee on 	Appropriations",7,2,0,0,9
500290,283947,2013-05-24,Assembly,"Do pass",12,5,0,0,17
500290,284678,2013-05-28,Assembly,"AB 362 TING  Assembly Third Reading",56,19,0,4,79
500290,297501,2013-08-14,Senate,"Do pass, but re-refer to the Committee on Appropriations",6,1,0,0,7
500290,297663,2013-08-19,Senate,"Placed on Appropriations Suspense file",7,0,0,0,7
500290,298399,2013-08-30,Senate,"Do pass",6,1,0,0,7
500290,298989,2013-09-09,Senate,"Assembly 3rd Reading AB362 Ting By Liu",32,4,3,0,39
500293,257396,2013-04-02,Assembly,"Do pass as amended and be re-referred to the Committee on 	Appropriations",15,3,0,1,19
500293,283826,2013-05-24,Assembly,"Do pass as amended",12,1,0,4,17
500293,285563,2013-05-30,Assembly,"AB 361 MITCHELL  Assembly Third Reading",54,23,0,2,79
500293,296005,2013-07-03,Senate,"Do pass, but re-refer to the Committee on Appropriations",7,2,0,0,9
500293,297309,2013-08-12,Senate,"Placed on Appropriations Suspense file",6,0,1,0,7
500293,298315,2013-08-30,Senate,"Do pass as amended",5,2,0,0,7
500293,299140,2013-09-10,Senate,"Assembly 3rd Reading AB361 Mitchell By Monning",28,8,3,0,39
500293,299447,2013-09-11,Assembly,"AB 361 MITCHELL  Concurrence in Senate Amendments",56,22,0,0,78
500297,276788,2013-05-07,Assembly,"Do pass as amended",10,0,0,0,10
500297,283748,2013-05-24,Assembly,"AB 359 HOLDEN  Assembly Third Reading  By ALLEN",69,0,0,9,78
500297,295970,2013-07-02,Senate,"Do pass",6,0,1,0,7
500297,298938,2013-09-09,Senate,"Assembly 3rd Reading AB359 Holden By Hueso",38,0,1,0,39
500297,299147,2013-09-10,Assembly,"AB 359 HOLDEN  Concurrence in Senate Amendments",78,0,0,0,78
500299,267355,2013-04-16,Assembly,"Do pass and be re-referred to the Committee on Appropriations",7,0,0,0,7
500299,274315,2013-04-30,Assembly,"Do pass as amended and be re-referred to the Committee on 	Appropriations",19,0,0,0,19
500299,279678,2013-05-15,Assembly,"Do pass, to Consent Calendar",17,0,0,0,17
500299,283868,2013-05-24,Assembly,"AB 358 HOLDEN  Assembly Third Reading  By ALEJO",71,0,0,7,78
500299,296051,2013-07-03,Senate,"Do pass as amended, and re-refer to the Committee on 	Appropriations",7,1,1,0,9
500301,308986,2014-01-14,Assembly,"Do pass as amended and be re-referred to the Committee on 	Appropriations",17,0,0,2,19
500301,311101,2014-01-23,Assembly,"Do pass, to Consent Calendar",16,0,0,1,17
500301,313240,2014-01-29,Assembly,"AB 357 PAN  Consent Calendar Second Day  Regular Session",78,0,0,2,80
500301,374801,2014-06-25,Senate,"Do pass as amended, and re-refer to the Committee on 	Appropriations",8,0,1,0,9
500301,378400,2014-08-25,Senate,"Assembly 3rd Reading AB357 Pan By Mitchell",34,0,6,0,40
500301,378756,2014-08-27,Assembly,"AB 357 PAN  Concurrence in Senate Amendments",77,1,0,1,79
501839,277408,2013-05-07,Senate,"Do pass",6,0,1,0,7
501839,281595,2013-05-20,Senate,"Special Consent #5 SB315 Lieu",36,0,3,0,39
501839,370105,2014-06-05,Assembly,"Be referred to Committee on Business, Professions and Consumer 	Protection",10,0,0,1,11
501839,374101,2014-06-24,Assembly,"Do pass and be re-referred to the Committee on Appropriations",13,0,0,1,14
501839,376684,2014-08-06,Assembly,"Do pass, to Consent Calendar",17,0,0,0,17
501839,377437,2014-08-14,Assembly,"SB 315 Lieu  Consent Calendar Second Day  Regular Session",78,0,0,1,79
501839,377969,2014-08-20,Senate,"From committee:  That the Assembly Amendments be concurred in",8,0,1,0,9
501839,378191,2014-08-22,Senate,"Unfinished Business SB315 Lieu Concurrence",33,0,7,0,40
501967,261714,2013-04-09,Senate,"Do pass, but re-refer to the Committee on Judiciary",5,1,1,0,7
501967,283894,2013-05-24,Senate,"Senate 3rd Reading SB313 De Le",32,2,5,0,39
501967,291634,2013-06-25,Assembly,"Do pass",3,1,0,3,7
501967,291635,2013-06-25,Assembly,"Set first hearing.  Failed passage.  Reconsideration granted",7,0,0,0,7
501967,295845,2013-07-02,Assembly,"Do pass",4,1,0,2,7
501967,297790,2013-08-19,Assembly,"SB 313 De Leon  Senate Third Reading  By ALEJO",72,3,0,3,78
501967,299390,2013-09-11,Assembly,"SB 313 De Leon  Senate Third Reading  By ALEJO",75,2,0,1,78
501967,299648,2013-09-12,Senate,"Unfinished Business SB313 De Le",33,3,3,0,39
502032,272481,2013-04-24,Senate,"Do pass, but re-refer to the Committee on Appropriations",3,5,1,0,9
502032,272482,2013-04-24,Senate,"Set, second hearing.  Failed passage in Committee. 	Reconsideration granted",9,0,0,0,9
502098,267477,2013-04-17,Senate,"Do pass as amended",5,1,1,0,7
502098,276260,2013-05-06,Senate,"Senate 3rd Reading SB311 Padilla",25,9,4,0,38
502098,288470,2013-06-12,Assembly,"Do pass and be re-referred to the Committee on Elections and 	Redistricting",6,2,0,1,9
502098,291526,2013-06-25,Assembly,"Do pass as amended",5,2,0,0,7
502098,297109,2013-08-08,Assembly,"SB 311 Padilla  Senate Third Reading  By PEREA",45,27,0,6,78
502098,297542,2013-08-15,Senate,"Unfinished Business SB311 Padilla Concurrence",26,11,2,0,39
502164,268945,2013-04-17,Senate,"Do pass as amended, and re-refer to the Committee on Judiciary",9,0,0,0,9
502164,277500,2013-05-07,Senate,"Do pass as amended. To Consent Calendar",6,0,1,0,7
502164,280390,2013-05-16,Senate,"Consent Calendar 2nd SB310 Calderon",37,0,1,0,38
502164,288322,2013-06-10,Assembly,"Do pass and be re-referred to the Committee on Judiciary to Consent 	Calendar",11,0,0,0,11
502164,297386,2013-08-13,Assembly,"Do pass, to Consent Calendar",10,0,0,0,10
502164,297953,2013-08-22,Assembly,"SB 310 Calderon  Consent Calendar Second Day  Regular Session",78,0,0,0,78
502230,273731,2013-04-29,Senate,"Do pass, but re-refer to the Committee on Appropriations",9,1,0,0,10
502230,278549,2013-05-13,Senate,"Placed on Appropriations Suspense file",5,0,2,0,7
502230,283161,2013-05-23,Senate,"Do pass",7,0,0,0,7
502230,284513,2013-05-28,Senate,"Senate 3rd Reading SB309 Price",36,3,0,0,39
502230,291554,2013-06-25,Assembly,"Do pass and be re-referred to the Committee on Business, 	Professions and Consumer Protection",6,0,0,1,7
502230,297270,2013-08-13,Assembly,"Do pass and be re-referred to the Committee on Appropriations",14,0,0,0,14
502230,298398,2013-08-30,Assembly,"Do pass as amended",16,0,0,1,17
502230,298820,2013-09-06,Assembly,"SB 309 Lieu  Senate Third Reading  By BONTA  Amend By BONTA  Set #1",52,25,0,1,78
502230,299524,2013-09-11,Senate,"Unfinished Supp 1 SB309 Lieu Concurrence",36,3,0,0,39
502230,299525,2013-09-11,Assembly,"SB 309 Lieu  Senate Third Reading  By BONTA",76,0,0,2,78
502295,273541,2013-04-29,Senate,"Do pass as amended, and re-refer to the Committee on Appropriations",10,0,0,0,10
502295,281407,2013-05-20,Senate,"Placed on Appropriations Suspense file",6,0,1,0,7
502295,283210,2013-05-23,Senate,"Do pass",7,0,0,0,7
502295,284581,2013-05-28,Senate,"Senate 3rd Reading SB308 Price",38,0,1,0,39
502295,291556,2013-06-25,Assembly,"Do pass and be re-referred to the Committee on Governmental 	Organization",13,0,0,0,13
502295,297088,2013-08-07,Assembly,"Do pass and re-refer to Committee on Appropriations with 	recommendation:  To Consent Calendar",16,0,0,1,17
502295,298272,2013-08-30,Assembly,"Do pass",16,0,0,1,17
502295,299011,2013-09-09,Assembly,"SB 308 Lieu  Senate Third Reading  By EGGMAN",77,0,0,1,78
502295,299189,2013-09-10,Senate,"Unfinished Business SB308 Lieu Concurrence",36,0,3,0,39
502361,273546,2013-04-29,Senate,"Do pass, but re-refer to the Committee on Appropriations",10,0,0,0,10
502361,278712,2013-05-13,Senate,"Placed on Appropriations Suspense file",5,0,2,0,7
502361,283173,2013-05-23,Senate,"Do pass",7,0,0,0,7
502426,273493,2013-04-29,Senate,"Do pass as amended, and re-refer to the Committee on Appropriations",10,0,0,0,10
502426,281310,2013-05-20,Senate,"Placed on Appropriations Suspense file",6,0,1,0,7
502426,283067,2013-05-23,Senate,"Do pass",7,0,0,0,7
502426,284560,2013-05-28,Senate,"Senate 3rd Reading SB306 Price",38,0,1,0,39
502426,297138,2013-08-08,Assembly,"Be referred to Committee on Business, Professions and Consumer 	Protection",9,0,0,2,11
502493,273676,2013-04-29,Senate,"Do pass, but re-refer to the Committee on Appropriations",10,0,0,0,10
502493,278842,2013-05-13,Senate,"Placed on Appropriations Suspense file",5,0,2,0,7
502493,283378,2013-05-23,Senate,"Do pass",7,0,0,0,7
502493,284597,2013-05-28,Senate,"Senate 3rd Reading SB305 Price",37,0,2,0,39
502493,291545,2013-06-25,Assembly,"Do pass and be re-referred to the Committee on Appropriations",13,0,0,0,13
502493,298456,2013-08-30,Assembly,"Do pass as amended",16,0,0,1,17
502493,298993,2013-09-09,Assembly,"SB 305 Lieu  Senate Third Reading  By GORDON",75,0,0,3,78
502493,299227,2013-09-10,Senate,"Unfinished Business SB305 Lieu Concurrence",36,0,3,0,39
502556,273562,2013-04-29,Senate,"Do pass, but re-refer to the Committee on Appropriations",9,0,1,0,10
502556,278677,2013-05-13,Senate,"Placed on Appropriations Suspense file",5,0,2,0,7
502556,283167,2013-05-23,Senate,"Do pass",5,0,2,0,7
502556,284573,2013-05-28,Senate,"Senate 3rd Reading SB304 Price",35,2,2,0,39
502556,297313,2013-08-13,Assembly,"Do pass and be re-referred to the Committee on Appropriations",11,2,0,1,14
502556,298190,2013-08-30,Assembly,"Do pass as amended",12,4,0,1,17
502556,299382,2013-09-11,Senate,"Unfinished Supp 1 SB304 Lieu Concurrence",38,1,0,0,39
502556,299383,2013-09-11,Assembly,"SB 304 Lieu  Senate Third Reading  By GORDON",54,20,0,4,78
502621,261715,2013-04-09,Senate,"Do pass, but re-refer to the Committee on Appropriations",7,0,0,0,7
502621,273505,2013-04-29,Senate,"Special Consent #2 SB303 Knight",37,0,1,0,38
502621,288025,2013-06-11,Assembly,"Do pass and re-refer to Committee on Appropriations with 	recommendation:  To Consent Calendar",7,0,0,0,7
502621,295977,2013-07-03,Assembly,"Do pass, to Consent Calendar",17,0,0,0,17
502621,297139,2013-08-08,Assembly,"SB 303 Knight  Consent Calendar Second Day  Regular Session",77,0,0,1,78
502687,275644,2013-05-01,Senate,"Do pass as amended, but re-refer to the Committee on Appropriations 	Recommend Consent",9,0,0,0,9
502687,281359,2013-05-20,Senate,"Placed on Appropriations Suspense file",6,0,1,0,7
502687,283137,2013-05-23,Senate,"Do pass as amended",7,0,0,0,7
502687,285671,2013-05-30,Senate,"Special Consent #8 SB302 Cannella",38,0,1,0,39
502687,288538,2013-06-12,Assembly,"Do pass as amended and re-refer to Committee on Appropriations 	with recommendation:  To Consent Calendar",7,0,0,0,7
502819,263207,2013-04-10,Senate,"Do pass, but re-refer to the Committee on Appropriations",9,0,0,0,9
502819,270173,2013-04-22,Senate,"Placed on Appropriations Suspense file",7,0,0,0,7
502819,283336,2013-05-23,Senate,"Do pass",7,0,0,0,7
502819,284638,2013-05-28,Senate,"Senate 3rd Reading SB300 Hancock",37,1,1,0,39
502819,291901,2013-06-26,Assembly,"Do pass and be re-referred to the Committee on Appropriations",7,0,0,0,7
502819,298467,2013-08-30,Assembly,"Do pass as amended",13,2,0,2,17
502819,299055,2013-09-09,Assembly,"SB 300 Hancock  Senate Third Reading  By QUIRK",60,15,0,3,78
502819,299222,2013-09-10,Senate,"Unfinished Business SB300 Hancock",35,3,1,0,39
502884,267240,2013-04-16,Senate,"Do pass, but re-refer to the Committee on Appropriations",5,2,0,0,7
502884,273534,2013-04-29,Senate,"Do pass",5,2,0,0,7
502884,285025,2013-05-29,Senate,"Senate 3rd Reading SB299 DeSaulnier",24,15,0,0,39
502884,291530,2013-06-25,Assembly,"Do pass as amended and be re-referred to the Committee on 	Appropriations",5,2,0,0,7
502884,298221,2013-08-30,Assembly,"Do pass as amended",12,5,0,0,17
502884,298959,2013-09-09,Assembly,"SB 299 DeSaulnier  Senate Third Reading  By ALEJO",42,32,0,4,78
502884,299169,2013-09-10,Senate,"Unfinished Business SB299 DeSaulnier Concurrence",23,14,2,0,39
502884,299170,2013-09-10,Senate,"Unfinished Business SB299 DeSaulnier Reconsider",37,0,2,0,39
502884,299171,2013-09-10,Senate,"Unfinished Business SB299 DeSaulnier Concurrence",23,14,2,0,39
502950,275335,2013-04-30,Senate,"Do pass as amended",7,0,0,0,7
502950,281185,2013-05-20,Senate,"Placed on Appropriations Suspense file",6,0,1,0,7
502950,283267,2013-05-23,Senate,"Do pass as amended",7,0,0,0,7
502950,285038,2013-05-29,Senate,"Senate 3rd Reading SB298 Wyland",37,0,2,0,39
502950,297532,2013-08-14,Assembly,"Do pass and be re-referred to the Committee on Appropriations",9,0,0,0,9
502950,298238,2013-08-30,Assembly,"Do pass",16,1,0,0,17
502950,299194,2013-09-10,Assembly,"SB 298 Wyland  Senate Third Reading  By HARKEY",77,0,0,1,78
502950,299393,2013-09-11,Senate,"Unfinished Business SB298 Wyland Concurrence",39,0,0,0,39
503015,261848,2013-04-09,Senate,"Do pass, but re-refer to the Committee on Appropriations Recommend 	Consent",11,0,0,0,11
503015,270363,2013-04-22,Senate,"Placed on Appropriations Suspense file",7,0,0,0,7
503015,283304,2013-05-23,Senate,"Do pass",7,0,0,0,7
503015,284640,2013-05-28,Senate,"Senate 3rd Reading SB297 Roth",39,0,0,0,39
503082,262578,2013-04-09,Senate,"Do pass, but re-refer to the Committee on Appropriations",5,0,2,0,7
503082,276548,2013-05-06,Senate,"Placed on Appropriations Suspense file",7,0,0,0,7
503144,274820,2013-04-30,Senate,"Do pass as amended, and re-refer to the Committee on Appropriations",7,0,0,0,7
503144,281381,2013-05-20,Senate,"Do pass as amended",6,0,1,0,7
503144,284606,2013-05-28,Senate,"Senate 3rd Reading SB295 Emmerson",39,0,0,0,39
503144,291588,2013-06-25,Assembly,"Do pass and be re-referred to the Committee on Appropriations",7,0,0,0,7
503144,296064,2013-07-03,Assembly,"Do pass, to Consent Calendar",17,0,0,0,17
503144,297148,2013-08-08,Assembly,"SB 295 Emmerson  Consent Calendar Second Day  Regular Session",77,0,0,1,78
503144,297565,2013-08-15,Senate,"Unfinished Business SB295 Emmerson Concurrence",38,0,1,0,39
503210,257095,2013-04-01,Senate,"Do pass, but re-refer to the Committee on Appropriations",10,0,0,0,10
503210,270302,2013-04-22,Senate,"Placed on Appropriations Suspense file",7,0,0,0,7
503210,283388,2013-05-23,Senate,"Do pass as amended",7,0,0,0,7
503210,285045,2013-05-29,Senate,"Senate 3rd Reading SB294 Emmerson",39,0,0,0,39
503210,295861,2013-07-02,Assembly,"Do pass as amended and be re-referred to the Committee on Health",10,3,0,0,13
503210,297369,2013-08-13,Assembly,"Do pass and be re-referred to the Committee on Appropriations",17,2,0,0,19
503210,298260,2013-08-30,Assembly,"Do pass as amended",13,0,0,4,17
503210,299043,2013-09-09,Assembly,"SB 294 Emmerson  Senate Third Reading  By QUIRK-SILVA",65,9,0,4,78
503210,299267,2013-09-10,Senate,"Unfinished Business SB294 Emmerson Concurrence",36,0,3,0,39
503276,267509,2013-04-16,Assembly,"Do pass and be re-referred to the Committee on Local Government",6,1,0,0,7
503276,275336,2013-05-01,Assembly,"Do pass and be re-referred to the Committee on Appropriations",9,0,0,0,9
503276,283970,2013-05-24,Assembly,"Do pass as amended",16,1,0,0,17
503276,285241,2013-05-29,Assembly,"AB 440 GATTO  Assembly Third Reading",75,1,0,3,79
503276,295972,2013-07-03,Senate,"Do pass, but re-refer to the Committee on Appropriations",7,0,2,0,9
503276,297399,2013-08-12,Senate,"Placed on Appropriations Suspense file",6,0,1,0,7
503276,298367,2013-08-30,Senate,"Do pass",6,0,1,0,7
503276,299728,2013-09-12,Senate,"From Committee:  Amendments returned with further amendements to 	Senate floor for consideration",8,0,1,0,9
503276,299729,2013-09-12,Senate,"Assembly 3rd Supp 3 AB440 Gatto",39,0,0,0,39
503276,299730,2013-09-12,Assembly,"AB 440 GATTO  Concurrence in Senate Amendments",70,1,0,7,78
503539,276872,2013-05-07,Assembly,"Do pass as amended",7,1,0,2,10
503539,284699,2013-05-28,Assembly,"AB 436 JONES-SAWYER  Assembly Third Reading",51,26,0,2,79
503671,274109,2013-04-29,Assembly,"Do pass, to Consent Calendar",12,0,0,0,12
503671,276247,2013-05-06,Assembly,"AB 434 HAGMAN  Consent Calendar Second Day",77,0,0,2,79
503671,287189,2013-06-05,Senate,"Do pass and be placed on the Consent Calendar",8,0,1,0,9
503671,288739,2013-06-13,Senate,"Consent Calendar 2nd AB434 Hagman",37,0,2,0,39
503733,257464,2013-04-02,Assembly,"Do pass",12,1,0,0,13
503733,263444,2013-04-11,Assembly,"AB 433 GORDON  Assembly Third Reading",73,0,0,6,79
503733,295277,2013-07-01,Senate,"Do pass, but re-refer to the Committee on Appropriations",10,0,0,0,10
503733,297997,2013-08-26,Senate,"Do pass",5,2,0,0,7
503733,298601,2013-09-03,Senate,"Assembly 3rd Reading AB433 Gordon By Hueso",31,6,2,0,39
503733,298779,2013-09-06,Assembly,"AB 433 GORDON  Concurrence in Senate Amendments",68,10,0,0,78
503799,272714,2013-04-24,Assembly,"Do pass and be re-referred to the Committee on Appropriations",17,0,0,0,17
503799,277389,2013-05-08,Assembly,"Do pass, to Consent Calendar",17,0,0,0,17
503799,281314,2013-05-20,Assembly,"AB 432 PEREZ, V.M.  Assembly Third Reading",73,0,0,5,78
503799,288281,2013-06-11,Senate,"Do pass, but re-refer to the Committee on Appropriations",11,0,0,0,11
503799,297579,2013-08-15,Senate,"Assembly 3rd Reading AB432 V. Manuel P",38,0,1,0,39
503799,297950,2013-08-22,Assembly,"AB 432 PEREZ, V.M.  Concurrence in Senate Amendments",77,0,0,1,78
503864,252222,2013-03-21,Assembly,"Be referred to Committee on Local Government",11,0,0,0,11
503864,262811,2013-04-10,Assembly,"Do pass as amended and be re-referred to the Committee on 	Transportation",7,2,0,0,9
504062,266720,2013-04-16,Assembly,"Do pass and be re-referred to the Committee on Appropriations",12,0,0,1,13
504062,274964,2013-05-01,Assembly,"Do pass",17,0,0,0,17
504062,278027,2013-05-09,Assembly,"AB 428 EGGMAN  Assembly Third Reading",76,0,0,3,79
504062,286517,2013-06-03,Senate,"Do pass, but re-refer to the Committee on Appropriations",10,0,0,0,10
504062,298118,2013-08-26,Senate,"Assembly 3rd Reading AB428 Eggman By Yee",39,0,0,0,39
504128,272385,2013-04-25,Assembly,"Be referred to Committee on Utilities and Commerce",8,0,0,3,11
504128,276390,2013-05-06,Assembly,"Do pass as amended and be re-referred to the Committee on 	Appropriations",6,3,0,6,15
504128,276391,2013-05-06,Assembly,"Set first hearing.  Failed passage.  Reconsideration granted",14,0,0,1,15
504193,274266,2013-04-30,Assembly,"Do pass and be re-referred to the Committee on Appropriations",10,5,0,0,15
504193,279830,2013-05-15,Assembly,"Do pass",12,5,0,0,17
504193,283406,2013-05-23,Assembly,"AB 426 SALAS  Assembly Third Reading",51,23,0,4,78
504193,291786,2013-06-25,Senate,"Do pass, but re-refer to the Committee on Appropriations",9,0,0,0,9
504193,298865,2013-09-06,Senate,"Assembly 3rd Reading AB426 Salas By Gaines",38,0,1,0,39
504260,267329,2013-04-16,Assembly,"Do pass and be re-referred to the Committee on Appropriations",6,0,0,1,7
504260,279888,2013-05-15,Assembly,"Do pass",16,0,0,1,17
504260,283323,2013-05-23,Assembly,"AB 425 ATKINS  Assembly Third Reading",73,0,0,5,78
504260,290049,2013-06-19,Senate,"Do pass as amended, and re-refer to the Committee on 	Appropriations",9,0,0,0,9
504260,298637,2013-09-03,Senate,"Assembly 3rd Reading AB425 Atkins By Pavley",35,2,2,0,39
504260,298809,2013-09-06,Assembly,"AB 425 ATKINS  Concurrence in Senate Amendments",77,0,0,1,78
504325,259546,2013-04-03,Assembly,"Do pass and be re-referred to the Committee on Appropriations",2,5,0,0,7
504325,275583,2013-05-01,Assembly,"Reconsideration granted",7,0,0,0,7
504325,275584,2013-05-01,Assembly,"Do pass and re-refer to Committee on Appropriations with 	recommendation:  To Consent Calendar",7,0,0,0,7
504325,279774,2013-05-15,Assembly,"Do pass as amended, to Consent Calendar",17,0,0,0,17
504325,283309,2013-05-23,Assembly,"AB 424 DONNELLY  Consent Calendar Second Day  Regular Session",74,0,0,4,78
504325,289836,2013-06-19,Senate,"Do pass, but re-refer to the Committee on Appropriations",5,1,3,0,9
504325,298807,2013-09-06,Senate,"Assembly 3rd Reading AB424 Donnelly By Wyland",38,0,1,0,39
504388,271038,2013-04-23,Assembly,"Do pass and re-refer to Committee on Appropriations with 	recommendation:  To Consent Calendar",6,0,0,1,7
504388,277331,2013-05-08,Assembly,"Do pass as amended, to Consent Calendar",17,0,0,0,17
504388,280312,2013-05-16,Assembly,"AB 423 TORRES  Consent Calendar Second Day  Regular Session",70,0,0,9,79
504388,289727,2013-06-18,Senate,"Do pass, but re-refer to the Committee on Appropriations",6,0,1,0,7
504388,298121,2013-08-27,Senate,"Do pass, but re-refer to the Committee on Appropriations",7,1,3,0,11
504388,298454,2013-08-30,Senate,"Placed on Appropriations Suspense file",7,0,0,0,7
504388,378623,2014-08-27,Senate,"Assembly 3rd Reading AB423 Brown By Torres",35,0,5,0,40
504453,277066,2013-05-07,Assembly,"Do pass",19,0,0,0,19
504453,280362,2013-05-16,Assembly,"AB 422 NAZARIAN  Assembly Third Reading",71,2,0,6,79
504453,288529,2013-06-12,Senate,"Do pass, but re-refer to the Committee on Health",9,0,0,0,9
504453,291975,2013-06-26,Senate,"Do pass as amended",9,0,0,0,9
504453,298693,2013-09-03,Senate,"Assembly 3rd Reading AB422 Nazarian By Anderson",37,0,2,0,39
504453,298815,2013-09-06,Assembly,"AB 422 NAZARIAN  Concurrence in Senate Amendments",77,1,0,0,78
504585,268523,2013-04-17,Assembly,"Do pass and be re-referred to the Committee on Appropriations",6,0,0,1,7
504585,283855,2013-05-24,Assembly,"Do pass as amended",11,6,0,0,17
504585,285486,2013-05-30,Assembly,"AB 420 DICKINSON  Assembly Third Reading",52,23,0,4,79
504585,291859,2013-06-26,Senate,"Do pass",7,1,1,0,9
504585,377809,2014-08-19,Senate,"Assembly 3rd Reading AB420 Dickinson By Block",24,8,8,0,40
504585,378107,2014-08-21,Assembly,"AB 420 DICKINSON  Concurrence in Senate Amendments",62,16,0,1,79
504651,259009,2013-04-02,Assembly,"Do pass and re-refer to Committee on Appropriations with 	recommendation:  To Consent Calendar",7,0,0,0,7
504651,268005,2013-04-17,Assembly,"Do pass, to Consent Calendar",17,0,0,0,17
504651,272433,2013-04-25,Assembly,"AB 419 LOWENTHAL  Consent Calendar Second Day  Regular Session",76,0,0,3,79
504651,288048,2013-06-11,Senate,"Do pass, but re-refer to the Committee on Appropriations Recommend 	Consent",6,0,0,0,6
504651,295255,2013-07-01,Senate,"Do pass",6,0,1,0,7
504651,297788,2013-08-19,Senate,"Assembly 3rd Reading AB419 Lowenthal By Hancock",37,0,2,0,39
504717,262457,2013-04-09,Assembly,"Do pass as amended and re-refer to Committee on Appropriations 	with recommendation:  To Consent Calendar",10,0,0,0,10
504717,274843,2013-05-01,Assembly,"Do pass, to Consent Calendar",17,0,0,0,17
504717,278243,2013-05-09,Assembly,"AB 418 MULLIN  Consent Calendar Second Day  Regular Session",75,0,0,4,79
504717,291721,2013-06-25,Senate,"Do pass, but re-refer to the Committee on Appropriations Recommend 	Consent",11,0,0,0,11
504717,309149,2014-01-15,Senate,"Do pass as amended",5,1,0,0,6
504717,325845,2014-02-20,Senate,"Assembly 3rd Reading AB418 Mullin Urgency Clause",27,8,4,0,39
504717,350950,2014-04-02,Assembly,"Senate amendments be concurred in",7,2,0,0,9
504782,257657,2013-04-01,Assembly,"Do pass and be re-referred to the Committee on Appropriations",7,1,0,1,9
504782,267360,2013-04-17,Assembly,"Do pass as amended",13,0,0,4,17
504782,272374,2013-04-25,Assembly,"AB 417 FRAZIER  Assembly Third Reading",70,2,0,7,79
504782,291972,2013-06-26,Senate,"Do pass, but re-refer to the Committee on Appropriations",9,0,0,0,9
504782,299492,2013-09-11,Senate,"Special Consent #10 AB417 Frazier By Wolk",39,0,0,0,39
504782,299732,2013-09-12,Assembly,"AB 417 FRAZIER  Concurrence in Senate Amendments",72,3,0,3,78
504849,257553,2013-04-01,Assembly,"Do pass as amended and be re-referred to the Committee on Local 	Government",6,2,0,1,9
504849,262758,2013-04-10,Assembly,"Do pass and be re-referred to the Committee on Appropriations",7,2,0,0,9
504914,273547,2013-04-29,Assembly,"Be referred to Committee on Utilities and Commerce",11,0,0,0,11
504914,274187,2013-04-29,Assembly,"Do pass and re-refer to Committee on Appropriations with 	recommendation:  To Consent Calendar",14,0,0,1,15
504914,279848,2013-05-15,Assembly,"Do pass, to Consent Calendar",17,0,0,0,17
504914,283279,2013-05-23,Assembly,"AB 415 GARCIA  Consent Calendar Second Day  Regular Session",74,0,0,4,78
504914,289461,2013-06-18,Senate,"Do pass as amended, and re-refer to the Committee on Appropriations",8,0,3,0,11
504914,298592,2013-09-03,Senate,"Assembly 3rd Reading AB415 Garcia By Fuller",37,0,2,0,39
504914,298773,2013-09-06,Assembly,"AB 415 GARCIA  Concurrence in Senate Amendments",78,0,0,0,78
504977,308565,2014-01-14,Assembly,"Do pass as amended, to Consent Calendar",9,0,0,1,10
504977,310317,2014-01-21,Assembly,"AB 414 FOX  Consent Calendar Second Day",75,0,0,5,80
504977,370843,2014-06-10,Senate,"Do pass as amended",7,0,0,0,7
504977,376793,2014-08-07,Senate,"Assembly 3rd Reading AB414 Fox Urgency Clause",34,0,6,0,40
504977,376959,2014-08-11,Assembly,"AB 414 FOX  Concurrence- Urgency Added",79,0,0,0,79
505042,267444,2013-04-16,Assembly,"Do pass, to Consent Calendar",7,0,0,0,7
505042,272417,2013-04-25,Assembly,"AB 413 CHAVEZ  Consent Calendar Second Day",76,0,0,3,79
505042,288367,2013-06-11,Senate,"Do pass and be placed on the Consent Calendar",6,0,0,0,6
505042,291311,2013-06-24,Senate,"Consent Calendar 2nd AB413 Ch",39,0,0,0,39
505109,261832,2013-04-09,Assembly,"Do pass as amended and re-refer to Committee on Appropriations 	with recommendation:  To Consent Calendar",8,0,0,1,9
505174,257487,2013-04-02,Assembly,"Do pass as amended and be re-referred to the Committee on 	Appropriations",14,0,0,5,19
505174,274970,2013-05-01,Assembly,"Do pass",12,5,0,0,17
505174,280344,2013-05-16,Assembly,"AB 411 PAN  Assembly Third Reading",54,19,0,6,79
505174,292061,2013-06-26,Senate,"Do pass as amended, and re-refer to the Committee on 	Appropriations",8,1,0,0,9
505174,297377,2013-08-12,Senate,"Placed on Appropriations Suspense file",6,0,1,0,7
505174,298498,2013-08-30,Senate,"Do pass as amended",5,2,0,0,7
505174,299799,2013-09-12,Assembly,"AB 411 PAN  Concurrence in Senate Amendments",56,22,0,0,78
505174,299800,2013-09-12,Senate,"Assembly 3rd Reading AB411 Pan By Monning",27,10,2,0,39
505240,262648,2013-04-10,Assembly,"Do pass and be re-referred to the Committee on Appropriations",7,0,0,0,7
505240,274739,2013-05-01,Assembly,"Do pass",17,0,0,0,17
505240,278604,2013-05-13,Assembly,"AB 410 JONES-SAWYER  Assembly Third Reading",72,3,0,4,79
505240,287712,2013-06-10,Senate,"Do pass, but re-refer to the Committee on Appropriations",4,0,1,0,5
505240,291228,2013-06-24,Senate,"Placed on Appropriations Suspense file",7,0,0,0,7
505240,298337,2013-08-30,Senate,"Do pass",7,0,0,0,7
505240,298936,2013-09-09,Senate,"Assembly 3rd Reading AB410 Jones-Sawyer By Block",38,0,1,0,39
505240,299148,2013-09-10,Assembly,"AB 410 JONES-SAWYER  Concurrence in Senate Amendments",75,1,0,2,78
505358,271834,2013-04-23,Assembly,"Do pass as amended and be re-referred to the Committee on 	Appropriations",13,0,0,0,13
505358,283931,2013-05-24,Assembly,"Do pass as amended",17,0,0,0,17
505358,285611,2013-05-30,Assembly,"AB 386 LEVINE  Assembly Third Reading",77,0,0,2,79
505358,296168,2013-07-03,Senate,"Do pass as amended, and re-refer to the Committee on Appropriations",9,0,0,0,9
505358,297411,2013-08-12,Senate,"Placed on Appropriations Suspense file",6,0,1,0,7
505358,298466,2013-08-30,Senate,"Do pass as amended",7,0,0,0,7
505358,299012,2013-09-09,Senate,"Assembly 3rd Reading AB386 Levine By Block",38,0,1,0,39
505358,299247,2013-09-10,Assembly,"AB 386 LEVINE  Concurrence in Senate Amendments",78,0,0,0,78
505423,271630,2013-04-23,Assembly,"Do pass as amended and be re-referred to the Committee on 	Appropriations",13,0,0,0,13
505491,271654,2013-04-23,Assembly,"Do pass as amended",13,0,0,0,13
505491,276298,2013-05-06,Assembly,"AB 388 CHESBRO  Assembly Third Reading",76,1,0,2,79
505491,370534,2014-06-10,Senate,"Do pass, but re-refer to the Committee on Public Safety",4,0,1,0,5
505491,374432,2014-06-24,Senate,"Do pass, but re-refer to the Committee on Appropriations",7,0,0,0,7
505491,376491,2014-08-04,Senate,"Placed on Appropriations Suspense file",7,0,0,0,7
505491,377192,2014-08-14,Senate,"Do pass as amended",5,0,2,0,7
505491,377787,2014-08-19,Senate,"Assembly 3rd Reading AB388 Chesbro By Mitchell",34,0,6,0,40
505491,378241,2014-08-22,Assembly,"Senate amendments be concurred in",5,0,0,2,7
505491,378344,2014-08-25,Assembly,"AB 388 CHESBRO  Concurrence in Senate Amendments",76,2,0,1,79
505560,259540,2013-04-03,Assembly,"Do pass as amended, to Consent Calendar",7,0,0,0,7
505560,268676,2013-04-18,Assembly,"AB 389 WILLIAMS  Consent Calendar Second Day  Regular Session",76,0,0,3,79
505560,291915,2013-06-26,Senate,"Do pass, but re-refer to the Committee on Appropriations Recommend 	Consent",9,0,0,0,9
505560,297303,2013-08-12,Senate,"Do pass",5,0,2,0,7
505560,297988,2013-08-26,Senate,"Assembly 3rd Reading AB389 Williams By Padilla",39,0,0,0,39
505560,298797,2013-09-06,Assembly,"AB 389 WILLIAMS  Concurrence in Senate Amendments",76,0,0,2,78
505697,268459,2013-04-17,Assembly,"Do pass and be re-referred to the Committee on Appropriations",6,0,0,1,7
505765,263117,2013-04-10,Assembly,"Do pass and be re-referred to the Committee on Appropriations",9,0,0,0,9
505765,274854,2013-05-01,Assembly,"Do pass, to Consent Calendar",17,0,0,0,17
505765,278055,2013-05-09,Assembly,"AB 392 JONES-SAWYER  Consent Calendar Second Day  Regular Session",75,0,0,4,79
505765,288912,2013-06-12,Senate,"Do pass, but re-refer to the Committee on Appropriations Recommend 	Consent",6,0,1,0,7
505765,295591,2013-07-01,Senate,"Consent Calendar 2nd AB392 Jones-Sawyer",33,0,5,0,38
505765,296035,2013-07-03,Assembly,"AB 392 JONES-SAWYER  Concurrence in Senate Amendments",74,0,0,4,78
505834,273070,2013-04-24,Assembly,"Do pass and be re-referred to the Committee on Appropriations",17,0,0,0,17
505834,283955,2013-05-24,Assembly,"Do pass as amended",17,0,0,0,17
505834,285188,2013-05-29,Assembly,"AB 393 COOLEY  Assembly Third Reading",77,0,0,2,79
505834,291256,2013-06-24,Senate,"Do pass, but re-refer to the Committee on Appropriations",9,0,1,0,10
505834,296227,2013-07-08,Senate,"Assembly 3rd Reading AB393 Cooley By Galgiani",33,0,5,0,38
505902,256762,2013-04-01,Assembly,"Do pass and be re-referred to the Committee on Appropriations",9,0,0,0,9
505902,262763,2013-04-10,Assembly,"Do pass, to Consent Calendar",17,0,0,0,17
505902,269961,2013-04-22,Assembly,"AB 394 YAMADA  Assembly Third Reading",78,0,0,1,79
505902,291953,2013-06-26,Senate,"Do pass, but re-refer to the Committee on Appropriations",7,0,0,0,7
505902,297436,2013-08-12,Senate,"Do pass",5,0,2,0,7
505902,298093,2013-08-26,Senate,"Assembly 3rd Reading AB394 Yamada By Knight",39,0,0,0,39
505971,262808,2013-04-09,Assembly,"Do pass as amended and be re-referred to the Committee on 	Appropriations",18,0,0,1,19
505971,284005,2013-05-24,Assembly,"Do pass as amended",17,0,0,0,17
505971,284960,2013-05-29,Assembly,"AB 395 FOX  Assembly Third Reading",73,1,0,5,79
505971,296109,2013-07-03,Senate,"Do pass as amended, and re-refer to the Committee on 	Appropriations",9,0,0,0,9
505971,297395,2013-08-12,Senate,"Placed on Appropriations Suspense file",6,0,1,0,7
506175,257797,2013-04-02,Assembly,"Do pass and be re-referred to the Committee on Appropriations",6,0,0,1,7
506313,261868,2013-04-09,Assembly,"Do pass and be re-referred to the Committee on Appropriations",5,2,0,0,7
506313,267182,2013-04-17,Assembly,"Do pass as amended",12,5,0,0,17
506313,273606,2013-04-29,Assembly,"AB 400 FONG  Assembly Third Reading",53,24,0,2,79
506313,286858,2013-06-04,Senate,"Do pass, but re-refer to the Committee on Appropriations",3,1,1,0,5
506313,377073,2014-08-13,Senate,"Assembly 3rd Reading AB400 Fong By Pavley",23,12,5,0,40
506313,378150,2014-08-21,Assembly,"AB 400 FONG  Concurrence in Senate Amendments",53,24,0,2,79
506383,274199,2013-04-29,Assembly,"Do pass as amended and be re-referred to the Committee on 	Appropriations",13,2,0,1,16
506383,279770,2013-05-15,Assembly,"Do pass as amended",16,1,0,0,17
506383,283957,2013-05-24,Assembly,"AB 401 DALY  Assembly Third Reading",68,3,0,7,78
506383,297818,2013-08-20,Senate,"Do pass as amended, and re-refer to the Committee on Appropriations",10,1,0,0,11
506383,297984,2013-08-26,Senate,"Placed on Appropriations Suspense file",7,0,0,0,7
506383,298235,2013-08-30,Senate,"Do pass as amended",7,0,0,0,7
506383,299196,2013-09-10,Senate,"Assembly 3rd Reading AB401 Daly By DeSaulnier",32,2,5,0,39
506383,299377,2013-09-11,Assembly,"Senate amendments be concurred in",12,3,0,1,16
506383,299641,2013-09-12,Assembly,"AB 401 DALY  Concurrence in Senate Amendments",66,8,0,4,78
506451,271719,2013-04-24,Assembly,"Do pass",12,1,0,0,13
506451,275518,2013-05-02,Assembly,"AB 402 AMMIANO  Assembly Third Reading",57,12,0,10,79
506451,291978,2013-06-26,Senate,"Do pass as amended",7,2,0,0,9
506451,298078,2013-08-26,Senate,"Assembly 3rd Reading AB402 Ammiano By Beall",30,8,1,0,39
506451,298419,2013-08-30,Assembly,"AB 402 AMMIANO  Concurrence in Senate Amendments",61,13,0,4,78
506521,267215,2013-04-16,Assembly,"Do pass as amended and be re-referred to the Committee on 	Appropriations",5,2,0,0,7
506589,257805,2013-04-02,Assembly,"Do pass and be re-referred to the Committee on Appropriations",13,0,0,0,13
506589,262698,2013-04-10,Assembly,"Do pass",16,0,0,1,17
506589,265895,2013-04-15,Assembly,"AB 404 EGGMAN  Assembly Third Reading",72,2,0,5,79
506589,286572,2013-06-03,Senate,"Do pass, but re-refer to the Committee on Appropriations",10,0,0,0,10
506589,298120,2013-08-26,Senate,"Assembly 3rd Reading AB404 Eggman By Yee",39,0,0,0,39
506656,261778,2013-04-08,Assembly,"Do pass as amended and be re-referred to the Committee on 	Appropriations",15,1,0,0,16
506656,283884,2013-05-24,Assembly,"Do pass",16,0,0,1,17
506656,285677,2013-05-30,Assembly,"AB 405 GATTO  Assembly Third Reading",72,0,0,7,79
506656,291794,2013-06-25,Senate,"Do pass, but re-refer to the Committee on Appropriations",10,0,1,0,11
506656,297731,2013-08-19,Senate,"Placed on Appropriations Suspense file",7,0,0,0,7
506656,298458,2013-08-30,Senate,"Do pass",7,0,0,0,7
506656,299063,2013-09-09,Senate,"Assembly 3rd Reading AB405 Gatto By Liu",38,0,1,0,39
506656,299198,2013-09-10,Assembly,"AB 405 GATTO  Concurrence in Senate Amendments",74,2,0,2,78
506724,257835,2013-04-02,Assembly,"Do pass, to Consent Calendar",7,0,0,0,7
506724,263467,2013-04-11,Assembly,"AB 406 TORRES  Consent Calendar Second Day  Regular Session",75,0,0,4,79
506724,279549,2013-05-14,Senate,"Do pass",7,0,0,0,7
506724,281357,2013-05-20,Senate,"Assembly 3rd Reading AB406 Torres By Torres",35,0,4,0,39
506794,267380,2013-04-16,Assembly,"Do pass and be re-referred to the Committee on Appropriations",6,0,0,1,7
506794,279716,2013-05-15,Assembly,"Do pass",16,0,0,1,17
506794,283152,2013-05-23,Assembly,"AB 407 PEREZ, V.M.  Assembly Third Reading",73,0,0,5,78
506862,268585,2013-04-17,Assembly,"Do pass and be re-referred to the Committee on Elections and 	Redistricting",9,0,0,0,9
506862,270713,2013-04-23,Assembly,"Do pass and be re-referred to the Committee on Appropriations",7,0,0,0,7
506862,277796,2013-05-08,Assembly,"Do pass, to Consent Calendar",17,0,0,0,17
506862,280216,2013-05-16,Assembly,"AB 408 BONTA  Consent Calendar Second Day  Regular Session",70,0,0,9,79
506862,288883,2013-06-12,Senate,"Do pass, but re-refer to the Committee on Appropriations",5,0,2,0,7
506862,296217,2013-07-08,Senate,"Assembly 3rd Reading AB408 Bonta By DeSaulnier",33,0,5,0,38
506930,262664,2013-04-09,Assembly,"Do pass and be re-referred to the Committee on Veterans Affairs",12,0,0,1,13
506930,267434,2013-04-16,Assembly,"Do pass and be re-referred to the Committee on Appropriations",7,1,0,2,10
506930,284007,2013-05-24,Assembly,"Do pass",13,0,0,4,17
506930,284722,2013-05-28,Assembly,"AB 409 QUIRK-SILVA  Assembly Third Reading",66,7,0,6,79
506930,297830,2013-08-20,Senate,"Do pass, but re-refer to the Committee on Appropriations",5,0,0,0,5
506930,299573,2013-09-11,Senate,"Assembly 3rd Reading AB409 Quirk-Silva Urgency Clause",37,0,2,0,39
506930,299591,2013-09-12,Assembly,"Senate amendments be concurred in",6,0,0,1,7
506930,299592,2013-09-12,Assembly,"AB 409 QUIRK-SILVA  Concurrence- Urgency Added",77,0,0,1,78
508785,263468,2013-04-10,Assembly,"Do pass and be re-referred to the Committee on Judiciary to Consent 	Calendar",7,0,0,0,7
508785,266639,2013-04-16,Assembly,"Do pass and re-refer to Committee on Appropriations with 	recommendation:  To Consent Calendar",10,0,0,0,10
508785,274994,2013-05-01,Assembly,"Do pass, to Consent Calendar",17,0,0,0,17
508785,278174,2013-05-09,Assembly,"AB 442 NAZARIAN  Consent Calendar Second Day  Regular Session",75,0,0,4,79
508785,288539,2013-06-12,Senate,"Do pass, but re-refer to the Committee on Judiciary",4,0,1,0,5
508785,291727,2013-06-25,Senate,"Do pass, but re-refer to the Committee on Appropriations",5,2,0,0,7
508785,298581,2013-09-03,Senate,"Assembly 3rd Reading AB442 Nazarian By Monning",27,11,1,0,39
508786,266328,2013-04-15,Assembly,"Do pass and be re-referred to the Committee on Local Government to 	Consent Calendar",16,0,0,0,16
508786,274712,2013-05-01,Assembly,"Do pass, to Consent Calendar",17,0,0,0,17
508786,277948,2013-05-09,Assembly,"AB 443 LOWENTHAL  Consent Calendar Second Day  Regular Session",75,0,0,4,79
508786,288035,2013-06-11,Senate,"Do pass, but re-refer to the Committee on Appropriations Recommend 	Consent",11,0,0,0,11
508786,295143,2013-07-01,Senate,"Consent Calendar 2nd AB443 Lowenthal",33,0,5,0,38
508790,274301,2013-04-30,Assembly,"Do pass and be re-referred to the Committee on Health",10,0,0,0,10
508790,276826,2013-05-07,Assembly,"Do pass as amended",18,0,0,1,19
508790,284027,2013-05-24,Assembly,"Do pass as amended",16,1,0,0,17
508790,285194,2013-05-29,Assembly,"AB 446 MITCHELL  Assembly Third Reading",72,1,0,6,79
508790,291967,2013-06-26,Senate,"Do pass, but re-refer to the Committee on Judiciary",9,0,0,0,9
508790,296054,2013-07-02,Senate,"Do pass as amended, and re-refer to the Committee on 	Appropriations",6,0,1,0,7
508790,297726,2013-08-19,Senate,"Placed on Appropriations Suspense file",7,0,0,0,7
508790,298429,2013-08-30,Senate,"Do pass",6,0,1,0,7
508790,299348,2013-09-11,Assembly,"AB 446 MITCHELL  Concurrence in Senate Amendments",76,2,0,0,78
508790,299349,2013-09-11,Senate,"Assembly 3rd Reading AB446 Mitchell By Hernandez",36,0,3,0,39
508792,262631,2013-04-09,Assembly,"Do pass and be re-referred to the Committee on Appropriations",12,0,0,1,13
508792,267234,2013-04-17,Assembly,"Do pass",14,1,0,2,17
508792,276233,2013-05-06,Assembly,"AB 447 WILLIAMS  Assembly Third Reading",77,0,0,2,79
508792,295932,2013-07-03,Senate,"Do pass as amended, but re-refer to the Committee on Appropriations 	Recommend Consent",9,0,0,0,9
508792,297678,2013-08-19,Senate,"Assembly 3rd Reading AB447 Williams By Block",37,0,2,0,39
508792,298001,2013-08-26,Assembly,"AB 447 WILLIAMS  Concurrence in Senate Amendments",77,0,0,1,78
508795,268956,2013-04-17,Assembly,"Do pass as amended and be re-referred to the Committee on 	Appropriations",7,0,0,0,7
508795,283904,2013-05-24,Assembly,"Do pass",17,0,0,0,17
508795,284648,2013-05-28,Assembly,"AB 449 MURATSUCHI  Assembly Third Reading",78,0,0,1,79
508795,289819,2013-06-19,Senate,"Do pass, but re-refer to the Committee on Appropriations Recommend 	Consent",9,0,0,0,9
508795,295516,2013-07-01,Senate,"Do pass",6,0,1,0,7
508795,297806,2013-08-19,Senate,"Assembly 3rd Reading AB449 Muratsuchi By Block",37,0,2,0,39
508795,297945,2013-08-22,Assembly,"AB 449 MURATSUCHI  Concurrence in Senate Amendments",78,0,0,0,78
508797,261871,2013-04-09,Assembly,"Do pass and be re-referred to the Committee on Appropriations",4,1,0,2,7
508798,257455,2013-04-02,Assembly,"Do pass and be re-referred to the Committee on Appropriations",13,0,0,0,13
508798,262813,2013-04-10,Assembly,"Do pass, to Consent Calendar",17,0,0,0,17
508798,268689,2013-04-18,Assembly,"AB 451 EGGMAN  Consent Calendar Second Day  Regular Session",76,0,0,3,79
508798,287775,2013-06-10,Senate,"Do pass, but re-refer to the Committee on Appropriations",10,0,0,0,10
508798,298661,2013-09-03,Senate,"Assembly 3rd Reading AB451 Eggman By Yee",37,0,2,0,39
508798,298834,2013-09-06,Assembly,"AB 451 EGGMAN  Concurrence in Senate Amendments",78,0,0,0,78
508801,259344,2013-04-03,Assembly,"Do pass and be re-referred to the Committee on Appropriations",8,1,0,0,9
508801,284003,2013-05-24,Assembly,"Do pass",16,0,0,1,17
508801,285594,2013-05-30,Assembly,"AB 453 MULLIN  Assembly Third Reading",65,11,0,3,79
508801,291637,2013-06-25,Senate,"Do pass as amended, and re-refer to the Committee on Appropriations",9,0,0,0,9
508801,297407,2013-08-12,Senate,"Placed on Appropriations Suspense file",6,0,1,0,7
508802,262674,2013-04-10,Assembly,"Do pass and be re-referred to the Committee on Appropriations",9,1,0,3,13
508802,284087,2013-05-24,Assembly,"Do pass",12,5,0,0,17
508802,284673,2013-05-28,Assembly,"AB 454 DICKINSON  Assembly Third Reading",53,23,0,3,79
508802,291965,2013-06-26,Senate,"Do pass as amended, and re-refer to the Committee on Appropriations",4,0,1,0,5
508802,297379,2013-08-12,Senate,"Placed on Appropriations Suspense file",6,0,1,0,7
508802,298504,2013-08-30,Senate,"Do pass as amended",5,2,0,0,7
508802,299035,2013-09-09,Senate,"Assembly 3rd Reading AB454 Dickinson By Monning",28,11,0,0,39
508802,299259,2013-09-10,Assembly,"AB 454 DICKINSON  Concurrence in Senate Amendments",53,25,0,0,78
508804,268519,2013-04-17,Assembly,"Do pass and re-refer to Committee on Appropriations with 	recommendation:  To Consent Calendar",7,0,0,0,7
508804,284081,2013-05-24,Assembly,"Do pass as amended",16,0,0,1,17
508804,284982,2013-05-29,Assembly,"AB 455 MEDINA  Assembly Third Reading",75,1,0,3,79
508808,261851,2013-04-08,Assembly,"Do pass",12,0,0,0,12
508808,263472,2013-04-11,Assembly,"AB 457 TORRES  Assembly Third Reading",75,0,0,4,79
508808,287182,2013-06-05,Senate,"Do pass",8,0,1,0,9
508808,296226,2013-07-08,Senate,"Assembly 3rd Reading AB457 Torres By Torres",33,0,5,0,38
508809,278595,2013-05-13,Assembly,"Do pass and be re-referred to the Committee on Appropriations",6,3,0,0,9
508809,284046,2013-05-24,Assembly,"Do pass",12,5,0,0,17
508809,292340,2013-06-27,Assembly,"AB 458 WIECKOWSKI  Assembly Third Reading",54,25,0,0,79
508809,297468,2013-08-14,Senate,"Do pass, but re-refer to the Committee on Appropriations",4,2,1,0,7
508811,270986,2013-04-23,Assembly,"Do pass and be re-referred to the Committee on Appropriations",9,3,0,1,13
508812,274337,2013-04-30,Assembly,"Do pass and be re-referred to the Committee on Appropriations",13,6,0,0,19
508812,277479,2013-05-08,Assembly,"Do pass",12,5,0,0,17
508812,281316,2013-05-20,Assembly,"AB 460 AMMIANO  Assembly Third Reading",50,24,0,4,78
508812,291941,2013-06-26,Senate,"Do pass, but re-refer to the Committee on Appropriations",7,2,0,0,9
508812,297255,2013-08-12,Senate,"Do pass",4,1,2,0,7
508812,297979,2013-08-26,Senate,"Assembly 3rd Reading AB460 Ammiano By Jackson",26,11,2,0,39
508812,298201,2013-08-30,Assembly,"AB 460 AMMIANO  Concurrence in Senate Amendments",52,25,0,1,78
508815,272381,2013-04-24,Assembly,"Do pass as amended and be re-referred to the Committee on 	Appropriations",17,0,0,0,17
508815,277399,2013-05-08,Assembly,"Do pass, to Consent Calendar",17,0,0,0,17
508815,281352,2013-05-20,Assembly,"AB 461 ACHADJIAN  Assembly Third Reading",74,0,0,4,78
508815,288295,2013-06-11,Senate,"Do pass, but re-refer to the Committee on Appropriations",11,0,0,0,11
508815,296212,2013-07-08,Senate,"Assembly 3rd Reading AB461 Achadjian By Monning",33,0,5,0,38
508816,262588,2013-04-10,Assembly,"Do pass as amended and be re-referred to the Committee on 	Appropriations",5,6,0,6,17
508816,262589,2013-04-10,Assembly,"Reconsideration granted",17,0,0,0,17
508819,267967,2013-04-16,Assembly,"Do pass and re-refer to Committee on Appropriations with 	recommendation:  To Consent Calendar",19,0,0,0,19
508819,274931,2013-05-01,Assembly,"Do pass, to Consent Calendar",17,0,0,0,17
508819,277985,2013-05-09,Assembly,"AB 464 DALY  Consent Calendar Second Day  Regular Session",75,0,0,4,79
508819,288146,2013-06-11,Senate,"Do pass, but re-refer to the Committee on Appropriations Recommend 	Consent",7,0,0,0,7
508819,295548,2013-07-01,Senate,"Consent Calendar 2nd AB464 Daly",33,0,5,0,38
508820,270727,2013-04-23,Assembly,"Do pass and be re-referred to the Committee on Appropriations",6,0,0,1,7
508820,274777,2013-05-01,Assembly,"Do pass, to Consent Calendar",17,0,0,0,17
508820,278022,2013-05-09,Assembly,"AB 465 BONILLA  Consent Calendar Second Day  Regular Session",75,0,0,4,79
508820,288044,2013-06-11,Senate,"Do pass as amended, and re-refer to the Committee on Appropriations",7,0,0,0,7
508820,296210,2013-07-08,Senate,"Assembly 3rd Reading AB465 Bonilla By DeSaulnier",32,0,6,0,38
508820,297117,2013-08-08,Assembly,"AB 465 BONILLA  Concurrence in Senate Amendments",76,0,0,2,78
508821,266563,2013-04-15,Assembly,"Do pass and re-refer to Committee on Appropriations with 	recommendation:  To Consent Calendar",16,0,0,0,16
508821,275201,2013-05-01,Assembly,"Do pass, to Consent Calendar",17,0,0,0,17
508821,278172,2013-05-09,Assembly,"AB 466 QUIRK-SILVA  Consent Calendar Second Day  Regular Session",75,0,0,4,79
508821,288116,2013-06-11,Senate,"Do pass, but re-refer to the Committee on Appropriations",11,0,0,0,11
508821,298591,2013-09-03,Senate,"Assembly 3rd Reading AB466 Quirk-Silva By Hueso",38,0,1,0,39
508821,298881,2013-09-06,Assembly,"AB 466 QUIRK-SILVA  Concurrence in Senate Amendments",77,0,0,1,78
508823,267367,2013-04-16,Assembly,"Do pass and be re-referred to the Committee on Appropriations",6,1,0,0,7
508823,283933,2013-05-24,Assembly,"Do pass",16,1,0,0,17
508823,284683,2013-05-28,Assembly,"AB 467 STONE  Assembly Third Reading",75,1,0,3,79
508823,296063,2013-07-03,Senate,"Do pass, but re-refer to the Committee on Appropriations",8,0,1,0,9
508823,308308,2014-01-13,Senate,"Do pass, but re-refer to the Committee on Appropriations",9,0,1,0,10
508823,317042,2014-02-06,Senate,"Assembly 3rd Reading AB467 Stone Urgency Clause",35,0,4,0,39
508823,341928,2014-03-13,Senate,"Assembly 3rd Reading AB467 Stone Urgency Clause",32,0,7,0,39
508823,347540,2014-03-25,Assembly,"Senate amendments be concurred in",14,0,0,0,14
508823,350275,2014-04-01,Assembly,"AB 467 STONE  Concurrence- Urgency Added",77,0,0,3,80
508825,263451,2013-04-11,Assembly,"Be referred to Committee on Natural Resources",10,0,0,1,11
508825,274162,2013-04-29,Assembly,"With amendments but without recommendation, and be re-referred to 	Committee on Natural Resources",8,0,0,1,9
508825,305727,2014-01-06,Assembly,"Be referred to Committee on Natural Resources",9,0,0,1,10
508825,308343,2014-01-13,Assembly,"Do pass and be re-referred to the Committee on Appropriations",9,0,0,0,9
508825,311180,2014-01-23,Assembly,"Do pass, to Consent Calendar",16,0,0,1,17
508825,313233,2014-01-29,Assembly,"AB 468 CHESBRO  Consent Calendar Second Day  Regular Session",78,0,0,2,80
508825,374818,2014-06-25,Senate,"Do pass, but re-refer to the Committee on Appropriations",8,0,1,0,9
508826,271404,2013-04-23,Assembly,"Do pass and re-refer to Committee on Appropriations with 	recommendation:  To Consent Calendar",11,0,0,2,13
508826,277568,2013-05-08,Assembly,"Do pass, to Consent Calendar",17,0,0,0,17
508826,280240,2013-05-16,Assembly,"AB 469 WAGNER  Consent Calendar Second Day  Regular Session",70,0,0,9,79
508826,291233,2013-06-24,Senate,"Do pass, but re-refer to the Committee on Banking and Financial 	Institution",9,0,1,0,10
508828,275593,2013-05-01,Assembly,"Do pass as amended and be re-referred to the Committee on 	Appropriations",6,0,0,1,7
508830,268092,2013-04-16,Assembly,"Do pass and re-refer to Committee on Appropriations with 	recommendation:  To Consent Calendar",19,0,0,0,19
508830,275087,2013-05-01,Assembly,"Do pass, to Consent Calendar",17,0,0,0,17
508830,278251,2013-05-09,Assembly,"AB 471 ATKINS  Consent Calendar Second Day  Regular Session",75,0,0,4,79
508830,309133,2014-01-15,Senate,"Do pass, but re-refer to the Committee on Appropriations",6,0,0,0,6
508830,310368,2014-01-21,Senate,"Placed on Appropriations Suspense file",5,0,2,0,7
508830,311208,2014-01-23,Senate,"Do pass",6,0,1,0,7
508830,316871,2014-02-06,Senate,"Assembly 3rd Reading AB471 Atkins Urgency Clause",35,0,4,0,39
508830,318135,2014-02-10,Assembly,"AB 471 ATKINS  Concurrence- Urgency Added",75,0,0,5,80
508833,270758,2013-04-23,Assembly,"Do pass and be re-referred to the Committee on Appropriations",5,2,0,0,7
508833,283757,2013-05-24,Assembly,"Do pass as amended",11,6,0,0,17
508833,285496,2013-05-30,Assembly,"AB 473 AMMIANO  Assembly Third Reading",32,36,0,11,79
508833,285966,2013-05-31,Assembly,"AB 473 AMMIANO  Motion to Reconsider  Appeal the Decision  of the 	Chair  By WAGNER",21,54,0,4,79
508833,285967,2013-05-31,Assembly,"AB 473 AMMIANO  Motion to Reconsider",55,21,0,3,79
508833,285968,2013-05-31,Assembly,"AB 473 AMMIANO  Assembly Third Reading",35,37,0,7,79
508834,308332,2014-01-13,Assembly,"Do pass and be re-referred to the Committee on Appropriations",9,0,0,0,9
508834,311324,2014-01-23,Assembly,"Do pass, to Consent Calendar",16,0,0,1,17
508834,313218,2014-01-29,Assembly,"AB 474 STONE  Consent Calendar Second Day  Regular Session",78,0,0,2,80
508834,370521,2014-06-10,Senate,"Do pass, but re-refer to the Committee on Judiciary Recommend 	Consent",9,0,0,0,9
508834,372576,2014-06-17,Senate,"Do pass, but re-refer to the Committee on Appropriations Recommend 	Consent",6,0,1,0,7
508834,375720,2014-07-03,Senate,"Consent Calendar 2nd AB474 Stone",35,0,5,0,40
508836,252306,2013-03-21,Assembly,"Be referred to Committee on Higher Education",11,0,0,0,11
508839,270833,2013-04-23,Assembly,"Do pass",6,1,0,0,7
508839,278234,2013-05-09,Assembly,"AB 477 CHAU  Assembly Third Reading",59,16,0,4,79
508839,288305,2013-06-11,Senate,"Do pass, but re-refer to the Committee on Judiciary",4,2,0,0,6
508839,296084,2013-07-02,Senate,"Do pass, but re-refer to the Committee on Appropriations",4,2,1,0,7
508839,297378,2013-08-12,Senate,"Placed on Appropriations Suspense file",6,0,1,0,7
508839,298583,2013-08-30,Senate,"Do pass as amended",5,2,0,0,7
508839,299073,2013-09-09,Senate,"Assembly 3rd Reading AB477 Chau By Corbett",30,8,1,0,39
508839,299299,2013-09-10,Assembly,"Senate amendments be concurred in",4,1,0,2,7
508839,299553,2013-09-11,Assembly,"AB 477 CHAU  Concurrence in Senate Amendments",59,17,0,2,78
508840,272205,2013-04-24,Assembly,"Do pass and be re-referred to the Committee on Appropriations",5,2,0,0,7
508840,284008,2013-05-24,Assembly,"Do pass",12,0,0,5,17
508840,285601,2013-05-30,Assembly,"AB 478 GOMEZ  Assembly Third Reading",53,21,0,5,79
508840,298846,2013-09-06,Senate,"Do pass",5,2,0,0,7
508840,298847,2013-09-06,Senate,"Do pass, but re-refer to the Committee on Appropriations",3,2,0,0,5
508840,298848,2013-09-06,Senate,"Assembly 3rd Supp 1 AB478 Gomez Lay on Table",27,8,4,0,39
508840,298849,2013-09-06,Senate,"Assembly 3rd Supp 1 AB478 Gomez By Beall",32,5,2,0,39
508840,299150,2013-09-10,Assembly,"Senate amendments be concurred in",4,2,0,1,7
508840,299460,2013-09-11,Assembly,"AB 478 GOMEZ  Concurrence- Urgency Added",69,4,0,5,78
508843,257595,2013-04-02,Assembly,"Do pass and be re-referred to the Committee on Appropriations",13,0,0,0,13
508843,283998,2013-05-24,Assembly,"Do pass",16,0,0,1,17
508843,284719,2013-05-28,Assembly,"AB 480 CALDERON  Assembly Third Reading",76,1,0,2,79
508843,289192,2013-06-17,Senate,"Do pass, but re-refer to the Committee on Appropriations",10,0,0,0,10
508843,295581,2013-07-01,Senate,"Do pass",6,0,1,0,7
508843,298683,2013-09-03,Senate,"Assembly 3rd Reading AB480 Ian Calderon By Padilla",38,0,1,0,39
508843,298829,2013-09-06,Assembly,"AB 480 CALDERON  Concurrence in Senate Amendments",77,1,0,0,78
508846,261771,2013-04-08,Assembly,"Do pass and be re-referred to the Committee on Accountability and 	Administrative Review",11,5,0,0,16
508846,275851,2013-05-01,Assembly,"Do pass and be re-referred to the Committee on Appropriations",9,2,0,2,13
508846,279947,2013-05-15,Assembly,"Do pass",12,5,0,0,17
508846,283271,2013-05-23,Assembly,"AB 481 LOWENTHAL  Assembly Third Reading",51,21,0,6,78
508846,288127,2013-06-11,Senate,"Do pass as amended, and re-refer to the Committee on Appropriations",8,2,1,0,11
508846,295544,2013-07-01,Senate,"Do pass",4,2,1,0,7
508846,296231,2013-07-08,Senate,"Assembly 3rd Reading AB481 Lowenthal By Galgiani",21,9,8,0,38
508846,297120,2013-08-08,Assembly,"AB 481 LOWENTHAL  Concurrence in Senate Amendments",52,23,0,3,78
508847,261896,2013-04-09,Assembly,"Do pass as amended and be re-referred to the Committee on 	Appropriations",4,2,0,1,7
508847,284072,2013-05-24,Assembly,"Do pass",12,5,0,0,17
508847,285514,2013-05-30,Assembly,"AB 482 ATKINS  Third Reading Urgency",57,19,0,3,79
508847,295584,2013-07-01,Senate,"Do pass, but re-refer to the Committee on Appropriations",6,1,2,0,9
508847,297718,2013-08-19,Senate,"Placed on Appropriations Suspense file",7,0,0,0,7
508847,298345,2013-08-30,Senate,"Do pass as amended",5,2,0,0,7
508847,299530,2013-09-11,Senate,"Assembly 3rd Reading AB482 Atkins Reconsider",36,0,3,0,39
508847,299531,2013-09-11,Assembly,"AB 482 ATKINS  Concurrence in Senate Amendments",57,21,0,0,78
508847,299532,2013-09-11,Senate,"Assembly 3rd Reading AB482 Atkins By De Le",26,7,6,0,39
508847,299533,2013-09-11,Senate,"Assembly 3rd Reading AB482 Atkins By De Le",26,11,2,0,39
508847,299835,2013-09-11,Senate,"Assembly 3rd Reading AB482 Atkins Reconsider",36,0,3,0,39
508847,299836,2013-09-11,Assembly,"AB 482 ATKINS  Concurrence in Senate Amendments",57,21,0,0,78
508847,299837,2013-09-11,Senate,"Assembly 3rd Reading AB482 Atkins By De Le",26,7,6,0,39
508847,299841,2013-09-11,Senate,"Assembly 3rd Reading AB482 Atkins By De Le",26,7,6,0,39
508848,266933,2013-04-15,Assembly,"Do pass, to Consent Calendar",8,0,0,1,9
508848,270062,2013-04-22,Assembly,"AB 483 TING  Consent Calendar Second Day  Regular Session",78,0,0,1,79
508848,297865,2013-08-21,Senate,"Do pass",7,0,0,0,7
508848,299036,2013-09-09,Senate,"Assembly 3rd Reading AB483 Ting Urgency Clause",34,4,1,0,39
508848,299511,2013-09-11,Assembly,"Senate amendments be concurred in",8,1,0,0,9
508848,299676,2013-09-12,Assembly,"AB 483 TING  Concurrence- Urgency Added",63,8,0,7,78
508850,275517,2013-05-01,Assembly,"Do pass and be re-referred to the Committee on Appropriations",6,0,0,1,7
508850,283835,2013-05-24,Assembly,"Do pass as amended",12,3,0,2,17
508850,284972,2013-05-29,Assembly,"AB 484 BONILLA  Third Reading Urgency",55,16,0,8,79
508850,291844,2013-06-26,Senate,"Do pass as amended, and re-refer to the Committee on Appropriations",7,1,1,0,9
508850,297282,2013-08-12,Senate,"Placed on Appropriations Suspense file",6,0,1,0,7
508850,298196,2013-08-30,Senate,"Do pass as amended",5,2,0,0,7
508850,299138,2013-09-10,Senate,"Assembly 3rd Reading AB484 Bonilla By Liu",26,7,6,0,39
508850,299442,2013-09-11,Assembly,"AB 484 BONILLA  Concurrence in Senate Amendments",54,22,0,2,78
508851,271930,2013-04-24,Assembly,"Do pass and be re-referred to the Committee on Appropriations",5,2,0,0,7
508851,284000,2013-05-24,Assembly,"Do pass",12,1,0,4,17
508851,285600,2013-05-30,Assembly,"AB 485 GOMEZ  Assembly Third Reading",53,22,0,4,79
508851,299520,2013-09-11,Senate,"Do pass, but re-refer to the Committee on Health",4,2,0,0,6
508851,309156,2014-01-15,Senate,"Do pass as amended, and re-refer to the Committee on 	Appropriations",7,0,2,0,9
508851,310400,2014-01-21,Senate,"Placed on Appropriations Suspense file",5,0,2,0,7
508851,311277,2014-01-23,Senate,"Do pass",5,1,1,0,7
508851,327604,2014-02-24,Senate,"Assembly 3rd Reading AB485 Gomez By Yee",26,7,6,0,39
508851,376585,2014-08-05,Assembly,"Senate amendments be concurred in",5,1,0,1,7
508851,376586,2014-08-05,Assembly,"Be referred to Committee on Appropriations",5,1,0,1,7
508851,377408,2014-08-14,Assembly,"Senate amendments be concurred in",12,4,0,1,17
508853,279023,2013-05-13,Assembly,"Do pass and be re-referred to the Committee on Appropriations",9,0,0,0,9
508857,266299,2013-04-15,Assembly,"Do pass as amended and be re-referred to the Committee on 	Appropriations",6,3,0,0,9
508858,257456,2013-04-01,Assembly,"Do pass and be re-referred to the Committee on Appropriations",6,2,0,1,9
508858,283885,2013-05-24,Assembly,"Do pass",12,5,0,0,17
508858,284655,2013-05-28,Assembly,"AB 489 SKINNER  Assembly Third Reading",53,25,0,1,79
508858,289448,2013-06-18,Senate,"Do pass, but re-refer to the Committee on Appropriations",6,2,3,0,11
508858,295715,2013-07-01,Senate,"Placed on Appropriations Suspense file",6,0,1,0,7
508860,257600,2013-04-02,Assembly,"Do pass as amended",9,0,0,1,10
508860,263471,2013-04-11,Assembly,"AB 490 SKINNER  Assembly Third Reading",75,0,0,4,79
508860,287107,2013-06-04,Senate,"Do pass and be placed on the Consent Calendar",6,0,1,0,7
508860,287761,2013-06-10,Senate,"Consent Calendar 2nd AB490 Skinner",32,0,7,0,39
508860,289036,2013-06-14,Assembly,"AB 490 SKINNER  Concurrence in Senate Amendments",76,0,0,3,79
508861,261793,2013-04-08,Assembly,"Do pass as amended and be re-referred to the Committee on Judiciary",12,0,0,0,12
508861,277176,2013-05-07,Assembly,"Do pass as amended, to Consent Calendar",10,0,0,0,10
508861,280410,2013-05-16,Assembly,"AB 491 TORRES  Consent Calendar Second Day  Regular Session",70,0,0,9,79
508861,287181,2013-06-05,Senate,"Do pass as amended, and re-refer to the Committee on Judiciary",8,0,1,0,9
508861,289435,2013-06-18,Senate,"Do pass and be placed on the Consent Calendar",6,0,1,0,7
508861,296281,2013-07-08,Senate,"Assembly 3rd Reading AB491 Torres By Torres",33,0,5,0,38
508861,297973,2013-08-22,Assembly,"AB 491  Concurrence in Senate Amendments By BONTA",78,0,0,0,78
508862,281938,2013-05-21,Assembly,"From committee:  Be adopted.  To third reading",10,0,0,0,10
508862,298578,2013-09-03,Senate,"Assembly 3rd Reading ACR19 Pan By Liu",37,0,2,0,39
508864,241290,2013-03-04,Assembly,"From committee:  Be adopted.  To third reading",11,0,0,0,11
508865,275607,2013-05-01,Senate,"Do pass, but re-refer to the Committee on Appropriations",9,0,0,0,9
508865,278876,2013-05-13,Senate,"Placed on Appropriations Suspense file",5,0,2,0,7
508865,283371,2013-05-23,Senate,"Do pass as amended",7,0,0,0,7
508865,285201,2013-05-29,Senate,"Senate 3rd Reading SB316 Block",39,0,0,0,39
508865,291902,2013-06-26,Assembly,"Do pass and re-refer to Committee on Appropriations with 	recommendation:  To Consent Calendar",7,0,0,0,7
508869,268989,2013-04-17,Senate,"Do pass as amended, and re-refer to the Committee on Judiciary",9,0,0,0,9
508869,274943,2013-04-30,Senate,"Do pass as amended, and re-refer to the Committee on 	Appropriations",6,1,0,0,7
508869,284576,2013-05-28,Senate,"Senate 3rd Reading SB318 Hill",36,1,2,0,39
508869,291944,2013-06-24,Assembly,"Do pass as amended and be re-referred to the Committee on Judiciary",10,0,0,1,11
508869,297533,2013-08-15,Assembly,"Do pass and be re-referred to the Committee on Appropriations",10,0,0,0,10
508869,298353,2013-08-30,Assembly,"Do pass",16,0,0,1,17
508869,299212,2013-09-10,Assembly,"SB 318 Hill  Senate Third Reading  By DICKINSON",73,0,0,5,78
508869,299469,2013-09-11,Senate,"Unfinished Business SB318 Hill Concurrence",36,1,2,0,39
508870,261794,2013-04-09,Senate,"Do pass, but re-refer to the Committee on Appropriations",4,0,2,0,6
508870,273631,2013-04-29,Senate,"Placed on Appropriations Suspense file",7,0,0,0,7
508872,275610,2013-05-01,Senate,"Do pass, but re-refer to the Committee on Appropriations",5,2,2,0,9
508872,278853,2013-05-13,Senate,"Placed on Appropriations Suspense file",5,0,2,0,7
508873,261776,2013-04-09,Senate,"Do pass, but re-refer to the Committee on Appropriations",4,0,2,0,6
508873,273850,2013-04-29,Senate,"Placed on Appropriations Suspense file",7,0,0,0,7
508874,274980,2013-05-01,Senate,"Do pass as amended, and re-refer to the Committee on 	Appropriations",9,0,0,0,9
508874,281514,2013-05-20,Senate,"Do pass as amended",6,0,1,0,7
508874,284938,2013-05-29,Senate,"Senate 3rd Reading SB322 Hueso",39,0,0,0,39
508874,295873,2013-07-02,Assembly,"Do pass as amended and be re-referred to the Committee on Water, 	Parks and Wildlife",6,0,0,1,7
508874,297422,2013-08-13,Assembly,"Do pass and re-refer to Committee on Appropriations with 	recommendation:  To Consent Calendar",15,0,0,0,15
508874,297868,2013-08-21,Assembly,"Do pass, to Consent Calendar",17,0,0,0,17
508874,299583,2013-09-11,Senate,"Unfinished Supp 1 SB322 Hueso Concurrence",39,0,0,0,39
508874,299584,2013-09-11,Assembly,"SB 322 Hueso  Senate Third Reading  By GONZALEZ",78,0,0,0,78
508878,262577,2013-04-10,Senate,"Do pass as amended, and re-refer to the Committee on Appropriations",5,2,0,0,7
508878,285024,2013-05-29,Senate,"Senate 3rd Reading SB323 Lara",27,9,3,0,39
508878,297183,2013-08-12,Assembly,"Do pass and be re-referred to the Committee on Judiciary",6,3,0,0,9
508878,297308,2013-08-13,Assembly,"Do pass and be re-referred to the Committee on Appropriations",6,3,0,1,10
508878,297852,2013-08-21,Assembly,"Do pass",12,5,0,0,17
508879,261849,2013-04-09,Senate,"Do pass, but re-refer to the Committee on Appropriations Recommend 	Consent",11,0,0,0,11
508879,272368,2013-04-25,Senate,"Consent Calendar 2nd SB324 Wright",36,0,2,0,38
508879,288388,2013-06-12,Assembly,"Do pass and be re-referred to the Committee on Appropriations",15,0,0,2,17
508879,296094,2013-07-03,Assembly,"Do pass, to Consent Calendar",17,0,0,0,17
508879,297167,2013-08-08,Assembly,"SB 324 Wright  Consent Calendar Second Day  Regular Session",77,0,0,1,78
508880,258444,2013-04-03,Senate,"Do pass, but re-refer to the Committee on Appropriations Recommend 	Consent",8,0,1,0,9
508880,268755,2013-04-18,Senate,"Consent Calendar 2nd SB325 Block",36,0,2,0,38
508880,288195,2013-06-11,Assembly,"Do pass and be re-referred to the Committee on Appropriations",12,0,0,1,13
508880,296157,2013-07-03,Assembly,"Do pass, to Consent Calendar",17,0,0,0,17
508880,297197,2013-08-12,Assembly,"SB 325 Block  Senate Third Reading  By WILLIAMS",77,0,0,1,78
508880,297520,2013-08-15,Senate,"Unfinished Business SB325 Block Concurrence",38,0,1,0,39
508882,267544,2013-04-17,Senate,"Do pass as amended, and re-refer to the Committee on Public Safety",9,0,0,0,9
508882,274835,2013-04-30,Senate,"Do pass as amended, and re-refer to the Committee on Appropriations",7,0,0,0,7
508882,281238,2013-05-20,Senate,"Placed on Appropriations Suspense file",6,0,1,0,7
508882,283296,2013-05-23,Senate,"Do pass as amended",5,0,2,0,7
508882,285015,2013-05-29,Senate,"Senate 3rd Reading SB326 Beall",37,0,2,0,39
508882,291933,2013-06-26,Assembly,"Do pass and be re-referred to the Committee on Public Safety",7,0,0,0,7
508882,297323,2013-08-13,Assembly,"Do pass",5,0,0,2,7
508882,298057,2013-08-26,Assembly,"SB 326 Beall  Senate Third Reading  By FONG",77,0,0,1,78
508883,261678,2013-04-09,Senate,"Do pass, but re-refer to the Committee on Appropriations",6,1,0,0,7
508883,269934,2013-04-22,Senate,"Placed on Appropriations Suspense file",7,0,0,0,7
508883,283238,2013-05-23,Senate,"Do pass",6,1,0,0,7
508883,284580,2013-05-28,Senate,"Senate 3rd Reading SB327 Yee",33,5,1,0,39
508883,289382,2013-06-18,Assembly,"Do pass and be re-referred to the Committee on Appropriations",5,0,0,2,7
508884,258767,2013-04-03,Senate,"Do pass as amended",6,0,1,0,7
508884,273579,2013-04-29,Senate,"Special Consent #2 SB328 Knight",37,0,1,0,38
508884,288390,2013-06-12,Assembly,"Do pass and be re-referred to the Committee on Accountability and 	Administrative Review",9,0,0,0,9
508884,289818,2013-06-19,Assembly,"Do pass and be re-referred to the Committee on Appropriations",12,0,0,1,13
508884,296007,2013-07-03,Assembly,"Do pass as amended, to Consent Calendar",17,0,0,0,17
508884,297668,2013-08-19,Assembly,"SB 328 Knight  Senate Third Reading  By GORDON",77,0,0,1,78
508884,298300,2013-08-30,Senate,"Special Consent #9 SB328 Knight",38,0,1,0,39
508888,275763,2013-05-01,Senate,"Do pass as amended, and re-refer to the Committee on Appropriations",9,0,0,0,9
508888,281300,2013-05-20,Senate,"Placed on Appropriations Suspense file",6,0,1,0,7
508888,283421,2013-05-23,Senate,"Do pass as amended",7,0,0,0,7
508888,285257,2013-05-29,Senate,"Senate 3rd Reading SB330 Padilla",39,0,0,0,39
508888,291852,2013-06-26,Assembly,"Do pass as amended and be re-referred to the Committee on 	Appropriations",7,0,0,0,7
508888,298492,2013-08-30,Assembly,"Do pass as amended",16,0,0,1,17
508888,299005,2013-09-09,Assembly,"SB 330 Padilla  Senate Third Reading  By BUCHANAN",76,0,0,2,78
508888,299215,2013-09-10,Senate,"Unfinished Business SB330 Padilla Concurrence",36,0,3,0,39
508889,258545,2013-04-03,Senate,"Do pass, but re-refer to the Committee on Appropriations Recommend 	Consent",8,0,1,0,9
508889,265327,2013-04-15,Senate,"Placed on Appropriations Suspense file",7,0,0,0,7
508891,290114,2013-06-19,Senate,"Do pass, but re-refer to the Committee on Appropriations",9,0,0,0,9
508891,296186,2013-07-08,Senate,"Senate 3rd Reading SB332 Emmerson Urgency Clause",33,0,5,0,38
508891,297572,2013-08-15,Assembly,"Do pass and be re-referred to the Committee on Health to Consent 	Calendar",10,0,0,0,10
508891,297831,2013-08-20,Assembly,"Do pass and be re-referred to the Committee on Appropriations",19,0,0,0,19
508891,298373,2013-08-30,Assembly,"Do pass, to Consent Calendar",17,0,0,0,17
508891,298883,2013-09-06,Assembly,"SB 332 Emmerson  Consent Calendar Second Day  By CONWAY",77,0,0,1,78
508892,261692,2013-04-09,Senate,"Do pass as amended, and re-refer to the Committee on Appropriations",7,0,0,0,7
508892,278003,2013-05-09,Senate,"Senate 3rd Reading SB333 Lieu",35,0,3,0,38
508892,288023,2013-06-11,Assembly,"Do pass and be re-referred to the Committee on Appropriations",7,0,0,0,7
508892,295953,2013-07-03,Assembly,"Do pass, to Consent Calendar",17,0,0,0,17
508892,297681,2013-08-19,Assembly,"SB 333 Lieu  Senate Third Reading  By BLOOM",77,0,0,1,78
508892,297908,2013-08-22,Senate,"Unfinished Business SB333 Lieu Concurrence",37,0,2,0,39
508895,261682,2013-04-09,Senate,"Do pass, but re-refer to the Committee on Appropriations",9,2,0,0,11
508895,270167,2013-04-22,Senate,"Placed on Appropriations Suspense file",7,0,0,0,7
508895,283353,2013-05-23,Senate,"Do pass as amended",5,2,0,0,7
508895,285197,2013-05-29,Senate,"Senate 3rd Reading SB335 Yee",28,10,1,0,39
508895,298163,2013-08-29,Assembly,"Do pass",14,10,0,1,25
508895,299201,2013-09-10,Assembly,"SB 335  Senate Third Reading  By SKINNER",52,24,0,2,78
508895,299396,2013-09-11,Senate,"Unfinished Business SB335 Yee Concurrence",24,11,4,0,39
510493,274088,2013-04-30,Senate,"Do pass, but re-refer to the Committee on Appropriations",11,0,0,0,11
510493,281366,2013-05-20,Senate,"Special Consent #5 SB418 Jackson",36,0,3,0,39
510493,289139,2013-06-17,Assembly,"Be referred to Committee on Utilities and Commerce",9,0,0,2,11
510493,295774,2013-07-01,Assembly,"Do pass and be re-referred to the Committee on Appropriations",3,7,0,5,15
510496,270864,2013-04-23,Senate,"Do pass, but re-refer to the Committee on Appropriations",11,0,0,0,11
510496,276358,2013-05-06,Senate,"Placed on Appropriations Suspense file",7,0,0,0,7
510496,283122,2013-05-23,Senate,"Do pass as amended",7,0,0,0,7
510496,285160,2013-05-29,Senate,"Senate 3rd Reading SB416 Liu",39,0,0,0,39
510496,296047,2013-07-03,Assembly,"Do pass and be re-referred to the Committee on Transportation",7,0,0,0,7
510496,297207,2013-08-12,Assembly,"Do pass and be re-referred to the Committee on Appropriations",16,0,0,0,16
510496,298481,2013-08-30,Assembly,"Do pass as amended",17,0,0,0,17
510496,298868,2013-09-06,Assembly,"SB 416 Liu  Senate Third Reading  By GATTO  Amend By MORRELL  Set 	#1  Motion to  Lay on the Table",51,25,0,2,78
510496,298869,2013-09-06,Assembly,"SB 416 Liu  Senate Third Reading  By GATTO",76,0,0,2,78
510496,299295,2013-09-10,Senate,"Unfinished Business SB416 Liu Concurrence",38,0,1,0,39
510498,309019,2014-01-14,Senate,"Do pass as amended",6,0,1,0,7
510498,312256,2014-01-27,Senate,"Senate 3rd Reading SB415 Knight",36,0,3,0,39
510498,370422,2014-06-10,Assembly,"Do pass, to Consent Calendar",9,0,0,1,10
510498,371704,2014-06-16,Assembly,"SB 415 Knight  Consent Calendar Second Day  Regular Session",77,0,0,2,79
510499,277892,2013-05-08,Senate,"Do pass as amended, and re-refer to the Committee on 	Appropriations",2,3,2,0,7
510499,277893,2013-05-08,Senate,"Set, first hearing.  Failed passage in Committee.  Reconsideration 	granted",7,0,0,0,7
510501,277542,2013-05-08,Senate,"Do pass as amended, and re-refer to the Committee on 	Appropriations",2,3,2,0,7
510501,277543,2013-05-08,Senate,"Set, first hearing.  Failed passage in Committee.  Reconsideration 	granted",7,0,0,0,7
510502,277682,2013-05-08,Senate,"Do pass as amended, and re-refer to the Committee on 	Appropriations",7,0,0,0,7
510502,281186,2013-05-20,Senate,"Placed on Appropriations Suspense file",6,0,1,0,7
510504,272321,2013-04-24,Senate,"Do pass, but re-refer to the Committee on Appropriations Recommend 	Consent",9,0,0,0,9
510504,277987,2013-05-09,Senate,"Consent Calendar 2nd SB411 Wolk",34,0,4,0,38
510504,373247,2014-06-18,Assembly,"Do pass and be re-referred to the Committee on Appropriations",7,0,0,0,7
510504,375523,2014-07-02,Assembly,"Do pass",16,1,0,0,17
510504,378242,2014-08-22,Assembly,"SB 411 Wolk  Senate Third Reading  Amend By PEREA  Set #1",51,20,0,8,79
510507,258518,2013-04-03,Senate,"Do pass as amended, and re-refer to the Committee on 	Appropriations",6,0,1,0,7
510507,270238,2013-04-22,Senate,"Placed on Appropriations Suspense file",7,0,0,0,7
510510,258757,2013-04-03,Senate,"Do pass, but re-refer to the Committee on Appropriations Recommend 	Consent",6,0,1,0,7
510510,265556,2013-04-15,Senate,"Placed on Appropriations Suspense file",7,0,0,0,7
510510,283409,2013-05-23,Senate,"Do pass",7,0,0,0,7
510510,284677,2013-05-28,Senate,"Senate 3rd Reading SB407 Hill",35,0,4,0,39
510510,291945,2013-06-26,Assembly,"Do pass and be re-referred to the Committee on Appropriations to 	Consent Calendar",9,0,0,0,9
510510,297516,2013-08-14,Assembly,"Do pass, to Consent Calendar",17,0,0,0,17
510510,297949,2013-08-22,Assembly,"SB 407 Hill  Consent Calendar Second Day  Regular Session",78,0,0,0,78
510511,309040,2014-01-14,Senate,"Do pass, but re-refer to the Committee on Appropriations",6,0,1,0,7
510511,311161,2014-01-23,Senate,"Senate 3rd Reading SB406 Evans",33,0,6,0,39
510511,372272,2014-06-17,Assembly,"Do pass as amended and be re-referred to the Committee on 	Appropriations",10,0,0,0,10
510511,375583,2014-07-02,Assembly,"Do pass, to Consent Calendar",17,0,0,0,17
510511,376785,2014-08-07,Assembly,"SB 406 Evans  Senate Third Reading  By STONE",78,0,0,1,79
510511,376886,2014-08-11,Senate,"Unfinished Business SB406 Evans Concurrence",36,0,4,0,40
510513,267286,2013-04-17,Senate,"Do pass, but re-refer to the Committee on Appropriations",5,3,1,0,9
510513,273531,2013-04-29,Senate,"Placed on Appropriations Suspense file",7,0,0,0,7
510513,283244,2013-05-23,Senate,"Do pass as amended",4,3,0,0,7
510513,285500,2013-05-30,Senate,"Senate 3rd Reading SB405 Padilla",18,17,4,0,39
510513,285501,2013-05-30,Senate,"Senate 3rd Reading SB405 Padilla Reconsider",38,0,1,0,39
510514,257713,2013-04-02,Senate,"Do pass, but re-refer to the Committee on Appropriations",5,2,0,0,7
510514,265733,2013-04-15,Senate,"Placed on Appropriations Suspense file",7,0,0,0,7
510514,283223,2013-05-23,Senate,"Do pass as amended",5,2,0,0,7
510514,285010,2013-05-29,Senate,"Senate 3rd Reading SB404 Jackson",26,13,0,0,39
510514,292148,2013-06-26,Assembly,"Do pass and be re-referred to the Committee on Judiciary",5,2,0,0,7
510514,295781,2013-07-02,Assembly,"Do pass as amended and be re-referred to the Committee on 	Appropriations",7,3,0,0,10
510517,259126,2013-04-03,Senate,"Do pass, but re-refer to the Committee on Appropriations",7,2,0,0,9
510517,265706,2013-04-15,Senate,"Placed on Appropriations Suspense file",7,0,0,0,7
510517,283369,2013-05-23,Senate,"Do pass as amended",5,2,0,0,7
510517,285081,2013-05-29,Senate,"Senate 3rd Reading SB402 De Le",38,0,1,0,39
510517,291657,2013-06-25,Assembly,"Do pass and be re-referred to the Committee on Appropriations",19,0,0,0,19
510517,295946,2013-07-03,Assembly,"Do pass",15,2,0,0,17
510517,297983,2013-08-26,Assembly,"SB 402 De Leon  Senate Third Reading  By PAN",70,6,0,2,78
510517,298422,2013-08-30,Senate,"Unfinished Business SB402 De Le",38,0,1,0,39
510520,274338,2013-04-30,Senate,"Do pass, but re-refer to the Committee on Appropriations Recommend 	Consent",11,0,0,0,11
510520,281281,2013-05-20,Senate,"Do pass",6,0,1,0,7
510520,284531,2013-05-28,Senate,"Special Consent #6 SB401 Hueso",39,0,0,0,39
510520,296043,2013-07-03,Assembly,"Do pass and be re-referred to the Committee on Appropriations",10,0,0,3,13
510520,297479,2013-08-14,Assembly,"Do pass, to Consent Calendar",17,0,0,0,17
510520,297956,2013-08-22,Assembly,"SB 401 Hueso  Consent Calendar Second Day  Regular Session",78,0,0,0,78
510521,262882,2013-04-10,Senate,"Do pass as amended, and re-refer to the Committee on Judiciary",4,1,0,0,5
510521,271561,2013-04-23,Senate,"Do pass, but re-refer to the Committee on Appropriations",5,1,1,0,7
510521,276543,2013-05-06,Senate,"Do pass",5,2,0,0,7
510521,278591,2013-05-13,Senate,"Senate 3rd Reading SB400 Jackson",21,12,5,0,38
510521,288773,2013-06-12,Assembly,"Do pass and be re-referred to the Committee on Judiciary",4,1,0,2,7
510521,291661,2013-06-25,Assembly,"Do pass as amended and be re-referred to the Committee on 	Appropriations",6,1,0,3,10
510521,298228,2013-08-30,Assembly,"Do pass",12,4,0,1,17
510521,298963,2013-09-09,Assembly,"SB 400 Jackson  Senate Third Reading  By GOMEZ",60,13,0,5,78
510521,299372,2013-09-11,Senate,"Unfinished Business SB400 Jackson Concurrence",35,1,3,0,39
510523,270900,2013-04-23,Senate,"Do pass, but re-refer to the Committee on Appropriations Recommend 	Consent",9,0,2,0,11
510523,281305,2013-05-20,Senate,"Do pass",6,0,1,0,7
510523,284524,2013-05-28,Senate,"Special Consent #6 SB399 Wright",39,0,0,0,39
510523,296108,2013-07-03,Assembly,"Do pass and be re-referred to the Committee on Appropriations",10,0,0,3,13
510523,297513,2013-08-14,Assembly,"Do pass, to Consent Calendar",17,0,0,0,17
510523,297955,2013-08-22,Assembly,"SB 399 Wright  Consent Calendar Second Day  Regular Session",78,0,0,0,78
510523,298215,2013-08-30,Senate,"Special Consent #9 SB399 Wright",38,0,1,0,39
510524,261846,2013-04-09,Senate,"Do pass, but re-refer to the Committee on Appropriations Recommend 	Consent",11,0,0,0,11
510524,272420,2013-04-25,Senate,"Consent Calendar 2nd SB398 Galgiani",36,0,2,0,38
510524,288446,2013-06-12,Assembly,"Do pass and re-refer to Committee on Appropriations with 	recommendation:  To Consent Calendar",16,0,0,1,17
510524,296118,2013-07-03,Assembly,"Do pass, to Consent Calendar",17,0,0,0,17
510524,297149,2013-08-08,Assembly,"SB 398 Galgiani  Consent Calendar Second Day  Regular Session",77,0,0,1,78
510524,299565,2013-09-11,Assembly,"Do pass",12,0,0,5,17
510524,299811,2013-09-12,Assembly,"SB 398 Galgiani  Senate Third Reading  By GRAY",78,0,0,0,78
510524,299812,2013-09-12,Senate,"Unfinished Supp 2 SB398 Galgiani Concurrence",38,0,1,0,39
510525,274503,2013-04-30,Senate,"Do pass, but re-refer to the Committee on Appropriations",11,0,0,0,11
510525,278891,2013-05-13,Senate,"Placed on Appropriations Suspense file",5,0,2,0,7
510525,283387,2013-05-23,Senate,"Do pass as amended",7,0,0,0,7
510525,285248,2013-05-29,Senate,"Senate 3rd Reading SB397 Hueso",39,0,0,0,39
510525,295834,2013-07-01,Assembly,"Do pass and be re-referred to the Committee on Judiciary",15,0,0,1,16
510525,297343,2013-08-13,Assembly,"Do pass and be re-referred to the Committee on Appropriations",10,0,0,0,10
510528,267250,2013-04-16,Senate,"Do pass, but re-refer to the Committee on Appropriations",5,2,0,0,7
510528,276234,2013-05-06,Senate,"Placed on Appropriations Suspense file",7,0,0,0,7
510528,283259,2013-05-23,Senate,"Do pass",5,2,0,0,7
510528,285046,2013-05-29,Senate,"Special Order SB396 Hancock",25,14,0,0,39
510528,297256,2013-08-13,Assembly,"Do pass and be re-referred to the Committee on Appropriations",4,2,0,1,7
510528,298233,2013-08-30,Assembly,"Do pass as amended",12,5,0,0,17
510528,299369,2013-09-11,Assembly,"SB 396 Hancock  Senate Third Reading  By RENDON",35,34,0,9,78
510528,371368,2014-06-12,Assembly,"Be referred to Committee on Judiciary",10,0,0,1,11
510528,374059,2014-06-24,Assembly,"Do pass",8,0,0,2,10
510528,377156,2014-08-14,Assembly,"SB 396 De Leon  Senate Third Reading  By BONTA",63,1,0,15,79
510528,377901,2014-08-20,Senate,"From committee:  That the Assembly Amendments be concurred in",5,0,2,0,7
510528,378045,2014-08-21,Senate,"Unfinished Business SB396 De Le",33,0,7,0,40
510529,274758,2013-05-01,Senate,"Do pass as amended, and re-refer to the Committee on 	Appropriations",6,3,0,0,9
510529,281207,2013-05-20,Senate,"Placed on Appropriations Suspense file",6,0,1,0,7
510529,283125,2013-05-23,Senate,"Do pass as amended",5,2,0,0,7
510534,270885,2013-04-23,Senate,"Do pass as amended, and re-refer to the Committee on Appropriations",7,0,2,0,9
510534,284591,2013-05-28,Senate,"Senate 3rd Reading SB392 Berryhill",39,0,0,0,39
510534,297233,2013-08-13,Assembly,"Do pass and be re-referred to the Committee on Appropriations",15,0,0,0,15
510534,297854,2013-08-21,Assembly,"Do pass, to Consent Calendar",17,0,0,0,17
510534,298327,2013-08-30,Assembly,"SB 392 Berryhill, T.  Consent Calendar Second Day  Regular Session",78,0,0,0,78
510534,298611,2013-09-03,Senate,"Unfinished Business SB392 Berryhill Concurrence",34,0,5,0,39
510535,262797,2013-04-09,Senate,"Do pass, but re-refer to the Committee on Governance and Finance",6,3,2,0,11
510535,271498,2013-04-24,Senate,"Do pass, but re-refer to the Committee on Appropriations",5,2,0,0,7
510535,278646,2013-05-13,Senate,"Placed on Appropriations Suspense file",5,0,2,0,7
510535,283214,2013-05-23,Senate,"Do pass",5,2,0,0,7
510535,284998,2013-05-29,Senate,"Senate 3rd Reading SB391 DeSaulnier Urgency Clause",27,12,0,0,39
510535,297188,2013-08-12,Assembly,"Do pass and be re-referred to the Committee on Labor and Employment",4,2,0,1,7
510535,297525,2013-08-14,Assembly,"Do pass and be re-referred to the Committee on Appropriations",5,2,0,0,7
510537,262781,2013-04-10,Senate,"Do pass, but re-refer to the Committee on Appropriations",5,0,0,0,5
510537,276296,2013-05-06,Senate,"Do pass",5,2,0,0,7
510537,278669,2013-05-13,Senate,"Senate 3rd Reading SB390 Wright",27,6,5,0,38
510537,288765,2013-06-12,Assembly,"Do pass and be re-referred to the Committee on Appropriations",7,0,0,0,7
510537,298406,2013-08-30,Assembly,"Do pass",17,0,0,0,17
510537,299099,2013-09-09,Assembly,"SB 390 Wright  Senate Third Reading  By HERNANDEZ",78,0,0,0,78
510537,299319,2013-09-10,Senate,"Unfinished Business SB390 Wright Concurrence",37,0,2,0,39
510538,267954,2013-04-17,Senate,"Do pass, but re-refer to the Committee on Appropriations",4,4,1,0,9
510538,267955,2013-04-17,Senate,"Set, second hearing.  Failed passage in Committee. 	Reconsideration granted",8,0,1,0,9
510538,274746,2013-05-01,Senate,"Do pass, but re-refer to the Committee on Appropriations",4,5,0,0,9
510540,308665,2014-01-14,Senate,"Do pass as amended, and re-refer to the Committee on Appropriations",6,0,1,0,7
510540,310341,2014-01-21,Senate,"Placed on Appropriations Suspense file",5,0,2,0,7
510540,311149,2014-01-23,Senate,"Do pass",5,1,1,0,7
510540,313932,2014-01-30,Senate,"Senate 3rd Reading SB388 Lieu",29,2,8,0,39
510540,372225,2014-06-17,Assembly,"Do pass and be re-referred to the Committee on Appropriations",7,0,0,0,7
510540,377381,2014-08-14,Assembly,"Do pass",17,0,0,0,17
510540,378281,2014-08-25,Assembly,"SB 388 Lieu  Senate Third Reading  By MELENDEZ",73,4,0,2,79
510544,274866,2013-04-30,Senate,"Do pass, but re-refer to the Committee on Appropriations",7,0,0,0,7
510544,278888,2013-05-13,Senate,"Placed on Appropriations Suspense file",5,0,2,0,7
510546,274678,2013-04-30,Senate,"Do pass, but re-refer to the Committee on Rules",7,0,0,0,7
510546,287400,2013-06-05,Senate,"Do pass, but re-refer to the Committee on Appropriations",9,0,0,0,9
510546,298205,2013-08-30,Senate,"Placed on Appropriations Suspense file",7,0,0,0,7
510546,298206,2013-08-30,Senate,"Do pass",7,0,0,0,7
510546,298704,2013-09-04,Senate,"Senate 3rd Reading SB384 Gaines Urgency Clause",37,0,2,0,39
510546,370566,2014-06-10,Assembly,"Do pass and be re-referred to the Committee on Appropriations",11,0,0,2,13
510546,375524,2014-07-02,Assembly,"Do pass as amended, to Consent Calendar",17,0,0,0,17
510546,376811,2014-08-07,Assembly,"SB 384 Gaines  Consent Calendar Second Day  Regular Session",77,0,0,2,79
510546,376986,2014-08-11,Senate,"Unfinished Business SB384 Gaines Concurrence",36,0,4,0,40
510547,277480,2013-05-07,Senate,"Do pass",5,1,1,0,7
510547,313919,2014-01-30,Senate,"Senate 3rd Reading SB383 Jackson",21,13,5,0,39
510551,266418,2013-04-15,Senate,"Do pass, but re-refer to the Committee on Appropriations",1,6,3,0,10
510551,266419,2013-04-15,Senate,"Set, second hearing.  Failed passage in Committee. 	Reconsideration granted",10,0,0,0,10
510553,266432,2013-04-16,Senate,"Do pass as amended, and re-refer to the Committee on Judiciary",10,0,1,0,11
510553,277823,2013-05-07,Senate,"Do pass as amended",5,1,1,0,7
510553,285090,2013-05-29,Senate,"Senate 3rd Reading SB380 Padilla",35,3,1,0,39
510553,295779,2013-07-02,Assembly,"Do pass as amended",10,0,0,0,10
510553,297878,2013-08-21,Assembly,"Do pass as amended, to Consent Calendar",17,0,0,0,17
510553,298717,2013-09-04,Assembly,"SB 380 Padilla  Senate Third Reading  By WIECKOWSKI",77,0,0,1,78
510553,298874,2013-09-06,Senate,"Unfinished Business SB380 Padilla",37,0,2,0,39
510554,272286,2013-04-24,Senate,"Do pass, but re-refer to the Committee on Appropriations",9,0,0,0,9
510554,276449,2013-05-06,Senate,"Do pass",7,0,0,0,7
510554,278661,2013-05-13,Senate,"Special Consent #4 SB379 Hancock",34,0,4,0,38
510554,291957,2013-06-26,Assembly,"Do pass as amended and be re-referred to the Committee on 	Appropriations",7,0,0,0,7
510554,297486,2013-08-14,Assembly,"Do pass",16,0,0,1,17
510554,298595,2013-09-03,Assembly,"SB 379 Hancock  Senate Third Reading  By MURATSUCHI",75,0,0,3,78
510554,298723,2013-09-04,Senate,"Unfinished Business SB379 Hancock Concurrence",38,0,1,0,39
510556,261696,2013-04-09,Senate,"Do pass, but re-refer to the Committee on Judiciary",7,0,0,0,7
510556,273533,2013-04-29,Senate,"Special Consent #2 SB378 Block",37,0,1,0,38
510556,288028,2013-06-11,Assembly,"Do pass and re-refer to Committee on Appropriations with 	recommendation:  To Consent Calendar",7,0,0,0,7
510556,295938,2013-07-03,Assembly,"Do pass, to Consent Calendar",17,0,0,0,17
510556,297127,2013-08-08,Assembly,"SB 378 Block  Consent Calendar Second Day  Regular Session",77,0,0,1,78
510557,271872,2013-04-24,Senate,"Do pass, but re-refer to the Committee on Appropriations",3,1,1,0,5
510557,281440,2013-05-20,Senate,"Placed on Appropriations Suspense file",6,0,1,0,7
510557,283321,2013-05-23,Senate,"Do pass",5,2,0,0,7
510557,284656,2013-05-28,Senate,"Senate 3rd Reading SB377 Lieu",28,10,1,0,39
510557,297606,2013-08-14,Assembly,"Do pass and be re-referred to the Committee on Appropriations",5,2,0,0,7
510557,298351,2013-08-30,Assembly,"Do pass as amended",12,5,0,0,17
510557,299031,2013-09-09,Assembly,"SB 377 Lieu  Senate Third Reading  By PAN",53,25,0,0,78
510557,299256,2013-09-10,Senate,"Unfinished Business SB377 Lieu Concurrence",26,10,3,0,39
510558,271836,2013-04-24,Senate,"Do pass as amended, and re-refer to the Committee on Appropriations",7,0,0,0,7
510558,278739,2013-05-13,Senate,"Placed on Appropriations Suspense file",5,0,2,0,7
510560,277511,2013-05-08,Senate,"Do pass",5,0,0,0,5
510560,281515,2013-05-20,Senate,"Special Consent #5 SB375 Committee on L. & I.R. (Lieu)",36,0,3,0,39
510560,297086,2013-08-07,Assembly,"Do pass, to Consent Calendar",12,0,0,0,12
510560,297552,2013-08-15,Assembly,"SB 375 L.& I.R.  Consent Calendar Second Day",76,0,0,2,78
510560,298010,2013-08-26,Senate,"Unfinished Business SB375 Committee on L. & I.R. (Monning) 	Concurrence",37,0,2,0,39
510561,267266,2013-04-16,Senate,"Do pass, but re-refer to the Committee on Appropriations",5,2,0,0,7
510561,276236,2013-05-06,Senate,"Placed on Appropriations Suspense file",7,0,0,0,7
510561,283235,2013-05-23,Senate,"Do pass as amended",5,2,0,0,7
510561,285017,2013-05-29,Senate,"Special Order SB374 Steinberg",23,15,1,0,39
510561,297288,2013-08-13,Assembly,"Do pass and be re-referred to the Committee on Appropriations",4,2,0,1,7
510561,298248,2013-08-30,Assembly,"Do pass",11,6,0,0,17
510561,299178,2013-09-10,Assembly,"SB 374 Steinberg  Senate Third Reading  By JONES-SAWYER",44,31,0,3,78
510561,299613,2013-09-12,Senate,"Unfinished Business SB374 Steinberg Concurrence",21,15,3,0,39
510567,265308,2013-04-15,Senate,"Do pass",7,0,0,0,7
510567,273587,2013-04-29,Senate,"Senate 3rd Reading SB371 De Le",34,3,1,0,38
510567,284092,2013-05-24,Assembly,"Do pass",12,5,0,0,17
510567,285692,2013-05-30,Assembly,"SB 371 De Leon  Third Reading Urgency  By GATTO",58,14,0,7,79
510570,297644,2013-08-19,Senate,"Do pass",7,0,0,0,7
510570,297930,2013-08-22,Senate,"Senate 3rd Reading SB369 De Le",37,0,2,0,39
510570,298191,2013-08-30,Assembly,"Do pass",17,0,0,0,17
510570,298705,2013-09-04,Assembly,"SB 369 De Leon  Third Reading Urgency  By GATTO",77,0,0,1,78
510571,275579,2013-05-01,Senate,"Do pass as amended, but re-refer to the Committee on Appropriations 	Recommend Consent",9,0,0,0,9
510571,284050,2013-05-24,Senate,"Consent Calendar 2nd SB368 Pavley",36,0,3,0,39
510571,288514,2013-06-12,Assembly,"Do pass and re-refer to Committee on Appropriations with 	recommendation:  To Consent Calendar",7,0,0,0,7
510571,296100,2013-07-03,Assembly,"Do pass, to Consent Calendar",17,0,0,0,17
510571,298075,2013-08-26,Assembly,"SB 368 Pavley  Senate Third Reading  By NAZARIAN",78,0,0,0,78
510571,298372,2013-08-30,Senate,"Special Consent #9 SB368 Pavley",38,0,1,0,39
510573,261781,2013-04-09,Senate,"Do pass as amended, and re-refer to the Committee on Appropriations",6,0,0,0,6
510573,269908,2013-04-22,Senate,"Placed on Appropriations Suspense file",7,0,0,0,7
510573,283199,2013-05-23,Senate,"Do pass as amended",7,0,0,0,7
510573,285596,2013-05-30,Senate,"Special Consent #8 SB367 Block",38,0,1,0,39
510573,297508,2013-08-13,Assembly,"Do pass as amended",7,0,0,0,7
510573,298074,2013-08-26,Assembly,"SB 367 Block  Senate Third Reading  By PEREZ, V.M",76,0,0,2,78
510573,298402,2013-08-30,Senate,"Special Consent #9 SB367 Block",38,0,1,0,39
510574,272201,2013-04-23,Senate,"Do pass, but re-refer to the Committee on Appropriations",7,0,0,0,7
510574,281267,2013-05-20,Senate,"Placed on Appropriations Suspense file",6,0,1,0,7
510576,262701,2013-04-10,Senate,"Do pass",5,2,0,0,7
510576,270068,2013-04-22,Senate,"Senate 3rd Reading SB365 Wolk",22,11,5,0,38
510576,291641,2013-06-24,Assembly,"Do pass",5,2,0,2,9
510576,299581,2013-09-11,Assembly,"Do pass",7,0,0,0,7
510576,299618,2013-09-12,Senate,"From committee:  That the Assembly Amendments be concurred in",14,0,2,0,16
510576,299619,2013-09-12,Assembly,"SB 365 Wolk  Senate Third Reading  By YAMADA",77,0,0,1,78
510576,299620,2013-09-12,Senate,"Unfinished Supp 2 SB365 Wolk Concurrence",38,0,1,0,39
510578,272530,2013-04-24,Senate,"Do pass, but re-refer to the Committee on Rules",7,1,1,0,9
510578,274976,2013-04-30,Senate,"Do pass as amended, and re-refer to the Committee on 	Appropriations",6,1,0,0,7
510578,281512,2013-05-20,Senate,"Do pass",6,0,1,0,7
510578,284671,2013-05-28,Senate,"Senate 3rd Reading SB364 Steinberg",39,0,0,0,39
510578,296032,2013-07-02,Assembly,"Do pass as amended and be re-referred to the Committee on 	Appropriations",19,0,0,0,19
510578,297489,2013-08-14,Assembly,"Do pass as amended, to Consent Calendar",17,0,0,0,17
510578,298607,2013-09-03,Assembly,"SB 364 Steinberg  Senate Third Reading  By CHESBRO",77,0,0,1,78
510578,298888,2013-09-06,Senate,"Unfinished Business SB364 Steinberg Concurrence",38,0,1,0,39
510580,274756,2013-04-30,Senate,"Do pass, but re-refer to the Committee on Appropriations",6,0,1,0,7
510580,278572,2013-05-13,Senate,"Do pass",5,0,2,0,7
510580,280226,2013-05-16,Senate,"Senate 3rd Reading SB363 Wright",36,0,2,0,38
510580,289358,2013-06-18,Assembly,"Do pass and be re-referred to the Committee on Appropriations",6,0,0,1,7
510580,296020,2013-07-03,Assembly,"Do pass as amended",16,1,0,0,17
510580,298615,2013-09-03,Assembly,"SB 363 Wright  Senate Third Reading  By GRAY",64,11,0,3,78
510580,298700,2013-09-04,Senate,"Unfinished Business SB363 Wright Concurrence",38,0,1,0,39
510581,274788,2013-04-30,Senate,"Do pass, but re-refer to the Committee on Appropriations",4,1,0,0,5
510581,278779,2013-05-13,Senate,"Do pass",5,0,2,0,7
510581,280301,2013-05-16,Senate,"Senate 3rd Reading SB362 Padilla",30,7,1,0,38
510581,291675,2013-06-25,Assembly,"Do pass and be re-referred to the Committee on Appropriations",5,2,0,0,7
510581,291676,2013-06-25,Assembly,"Do pass and be re-referred to the Committee on Appropriations",5,2,0,0,7
510581,297439,2013-08-14,Assembly,"Do pass",13,4,0,0,17
510581,298071,2013-08-26,Assembly,"SB 362 Padilla  Senate Third Reading  By MULLIN",57,19,0,2,78
510581,298393,2013-08-30,Senate,"Unfinished Business SB362 Padilla Concurrence",31,7,1,0,39
510583,274815,2013-04-30,Senate,"Do pass, but re-refer to the Committee on Appropriations",4,1,0,0,5
510583,278827,2013-05-13,Senate,"Placed on Appropriations Suspense file",5,0,2,0,7
510583,283110,2013-05-23,Senate,"Do pass",5,2,0,0,7
510583,284536,2013-05-28,Senate,"Senate 3rd Reading SB361 Padilla",30,9,0,0,39
510583,297324,2013-08-13,Assembly,"Do pass and be re-referred to the Committee on Appropriations",5,1,0,1,7
510584,274831,2013-04-30,Senate,"Do pass, but re-refer to the Committee on Appropriations",4,1,0,0,5
510584,278709,2013-05-13,Senate,"Do pass as amended",5,0,2,0,7
510584,283861,2013-05-24,Senate,"Senate 3rd Reading SB360 Padilla",27,9,3,0,39
510584,297367,2013-08-13,Assembly,"Do pass and be re-referred to the Committee on Appropriations",5,1,0,1,7
510584,297840,2013-08-21,Assembly,"Do pass",12,5,0,0,17
510584,298707,2013-09-04,Assembly,"SB 360 Padilla  Senate Third Reading  By PEREZ, J",53,23,0,2,78
510584,298831,2013-09-06,Senate,"Unfinished Business SB360 Padilla Concurrence",27,9,3,0,39
510586,274675,2013-05-01,Senate,"Do pass, but re-refer to the Committee on Appropriations",8,0,1,0,9
510586,280326,2013-05-16,Senate,"Senate 3rd Reading SB359 Corbett",36,0,2,0,38
510586,291728,2013-06-24,Assembly,"Do pass and be re-referred to the Committee on Housing and 	Community Development to Consent Calendar",9,0,0,0,9
510586,297216,2013-08-12,Assembly,"Do pass and re-refer to Committee on Appropriations with 	recommendation:  To Consent Calendar",7,0,0,0,7
510586,297863,2013-08-21,Assembly,"Do pass, to Consent Calendar",17,0,0,0,17
510586,298374,2013-08-30,Assembly,"SB 359 Corbett  Consent Calendar Second Day  Regular Session",78,0,0,0,78
510586,298812,2013-09-06,Assembly,"SB 359 Corbett  Senate Third Reading  By WIECKOWSKI  Amend By 	WIECKOWSKI  Set #1",52,25,0,1,78
510586,299388,2013-09-11,Assembly,"Do pass and be re-referred to the Committee on Appropriations",11,3,0,2,16
510586,299664,2013-09-12,Senate,"From committee:  That the Assembly Amendments be concurred in",8,2,1,0,11
510586,299665,2013-09-12,Assembly,"Do pass as amended",15,1,0,1,17
510586,299666,2013-09-12,Assembly,"SB 359 Corbett  Senate Third Reading  By MULLIN",62,10,0,6,78
510586,299667,2013-09-12,Assembly,"SB 359 Corbett  Senate Third Reading  By MULLIN",53,20,0,5,78
510586,299668,2013-09-12,Senate,"W/O REF. TO FILE SB359 Corbett",27,10,2,0,39
510589,267963,2013-04-17,Senate,"Do pass and be placed on the Consent Calendar",8,0,1,0,9
510589,275540,2013-05-02,Senate,"Consent Calendar 2nd SB357 Correa",35,0,3,0,38
510589,288125,2013-06-11,Assembly,"Do pass as amended and be re-referred to the Committee on 	Appropriations",17,0,0,2,19
510589,296158,2013-07-03,Assembly,"Do pass, to Consent Calendar",17,0,0,0,17
510589,297132,2013-08-08,Assembly,"SB 357 Correa  Consent Calendar Second Day  Regular Session",77,0,0,1,78
510589,297664,2013-08-19,Senate,"Unfinished Business SB357 Correa Concurrence",36,0,3,0,39
510590,270698,2013-04-23,Senate,"Do pass",7,3,1,0,11
510590,280363,2013-05-16,Senate,"Senate 3rd Reading SB356 Yee",26,5,7,0,38
510590,291880,2013-06-26,Assembly,"Do pass and be re-referred to the Committee on Appropriations",12,0,0,5,17
510592,270778,2013-04-23,Senate,"Do pass as amended, and re-refer to the Committee on Governance and 	Finance",8,1,0,0,9
510592,274963,2013-05-01,Senate,"Do pass as amended, and re-refer to the Committee on Appropriations",7,0,0,0,7
510592,281376,2013-05-20,Senate,"Placed on Appropriations Suspense file",6,0,1,0,7
510592,311181,2014-01-23,Senate,"Do pass",6,0,1,0,7
510592,312712,2014-01-28,Senate,"Senate 3rd Reading SB355 Beall",32,0,7,0,39
510592,374837,2014-06-25,Assembly,"Do pass as amended and be re-referred to the Committee on 	Appropriations",7,0,0,2,9
510592,377453,2014-08-14,Assembly,"Do pass as amended",17,0,0,0,17
510592,378355,2014-08-25,Assembly,"SB 355 Beall  Senate Third Reading  By GORDON",77,0,0,2,79
510592,378457,2014-08-26,Senate,"Unfinished Supp 1 SB355 Beall Concurrence",36,0,4,0,40
510593,263073,2013-04-09,Senate,"Do pass, but re-refer to the Committee on Appropriations",5,0,2,0,7
510593,269992,2013-04-22,Senate,"Placed on Appropriations Suspense file",7,0,0,0,7
510593,283163,2013-05-23,Senate,"Do pass",7,0,0,0,7
510593,284663,2013-05-28,Senate,"Senate 3rd Reading SB354 Roth",38,0,1,0,39
510594,262644,2013-04-10,Senate,"Do pass as amended, and re-refer to the Committee on 	Appropriations",7,2,0,0,9
510594,273763,2013-04-29,Senate,"Placed on Appropriations Suspense file",7,0,0,0,7
510594,283360,2013-05-23,Senate,"Do pass",5,2,0,0,7
510594,285647,2013-05-30,Senate,"Senate 3rd Reading SB353 Lieu",26,11,2,0,39
510594,297361,2013-08-13,Assembly,"Do pass and be re-referred to the Committee on Appropriations",13,5,0,1,19
510594,298242,2013-08-30,Assembly,"Do pass as amended",12,5,0,0,17
510594,299013,2013-09-09,Assembly,"SB 353 Lieu  Senate Third Reading  By NAZARIAN",51,25,0,2,78
510594,299245,2013-09-10,Senate,"Unfinished Business SB353 Lieu Concurrence",25,11,3,0,39
510596,261007,2013-04-08,Senate,"Do pass as amended, and re-refer to the Committee on Appropriations",9,1,0,0,10
510596,269973,2013-04-22,Senate,"Senate 3rd Reading SB352 Pavley",36,2,0,0,38
510596,291532,2013-06-25,Assembly,"Do pass",10,0,0,3,13
510596,297175,2013-08-08,Assembly,"SB 352 Pavley  Senate Third Reading  By GORDON",69,0,0,9,78
510596,297903,2013-08-22,Senate,"Unfinished Business SB352 Pavley Concurrence",36,1,2,0,39
510597,275737,2013-05-01,Senate,"Do pass, but re-refer to the Committee on Appropriations",7,2,0,0,9
510597,278898,2013-05-13,Senate,"Placed on Appropriations Suspense file",5,0,2,0,7
510602,258484,2013-04-02,Senate,"Do pass, but re-refer to the Committee on Appropriations",4,0,1,0,5
510602,265665,2013-04-15,Senate,"Do pass",7,0,0,0,7
510602,269978,2013-04-22,Senate,"Special Consent #1 SB348 Galgiani",38,0,0,0,38
510602,297498,2013-08-14,Assembly,"Do pass and be re-referred to the Committee on Appropriations",7,0,0,0,7
510602,297835,2013-08-21,Assembly,"Do pass",17,0,0,0,17
510602,298586,2013-09-03,Assembly,"SB 348 Galgiani  Senate Third Reading  By EGGMAN",76,0,0,2,78
510602,299187,2013-09-10,Senate,"Unfinished Business SB348 Galgiani Concurrence",37,0,2,0,39
510604,257475,2013-04-02,Senate,"Do pass, but re-refer to the Committee on Appropriations",7,0,0,0,7
510604,265484,2013-04-15,Senate,"Placed on Appropriations Suspense file",7,0,0,0,7
510604,283208,2013-05-23,Senate,"Do pass",7,0,0,0,7
510604,284571,2013-05-28,Senate,"Senate 3rd Reading SB347 Beall",39,0,0,0,39
510604,297446,2013-08-13,Assembly,"Do pass and be re-referred to the Committee on Appropriations",7,0,0,0,7
510604,298331,2013-08-30,Assembly,"Do pass",17,0,0,0,17
510604,298921,2013-09-09,Assembly,"SB 347 Beall  Senate Third Reading  By FONG",78,0,0,0,78
510607,261774,2013-04-09,Senate,"Do pass, but re-refer to the Committee on Judiciary",4,2,0,0,6
510607,273525,2013-04-29,Senate,"Senate 3rd Reading SB346 Beall",26,11,1,0,38
510607,289709,2013-06-18,Assembly,"Do pass",5,2,0,0,7
510607,299283,2013-09-10,Assembly,"SB 346 Beall  Senate Third Reading  By STONE",51,26,0,1,78
510607,299477,2013-09-11,Senate,"Unfinished Business SB346 Beall Concurrence",24,12,3,0,39
510608,277444,2013-05-07,Senate,"Do pass and be placed on the Consent Calendar",6,0,1,0,7
510608,280256,2013-05-16,Senate,"Consent Calendar 2nd SB345 Evans",37,0,1,0,38
510608,297589,2013-08-15,Assembly,"Do pass as amended",10,0,0,0,10
510608,298369,2013-08-30,Assembly,"Do pass as amended",16,1,0,0,17
510608,299508,2013-09-11,Assembly,"SB 345 Evans  Senate Third Reading  By WIECKOWSKI",72,1,0,5,78
510608,299751,2013-09-12,Senate,"Unfinished Business SB345 Evans Concurrence",38,0,1,0,39
510610,275713,2013-05-01,Senate,"Do pass as amended, and re-refer to the Committee on Appropriations",9,0,0,0,9
510610,281296,2013-05-20,Senate,"Placed on Appropriations Suspense file",6,0,1,0,7
510610,283415,2013-05-23,Senate,"Do pass",7,0,0,0,7
510610,285258,2013-05-29,Senate,"Senate 3rd Reading SB344 Padilla",39,0,0,0,39
510610,297469,2013-08-14,Assembly,"Do pass and be re-referred to the Committee on Appropriations",7,0,0,0,7
510610,298482,2013-08-30,Assembly,"Do pass as amended",12,0,0,5,17
510610,298863,2013-09-06,Assembly,"SB 344 Padilla  Senate Third Reading  By BUCHANAN  Amend By 	BUCHANAN  Set #1",52,24,0,2,78
510610,299687,2013-09-12,Assembly,"SB 344 Padilla  Senate Third Reading  By BUCHANAN",67,3,0,8,78
510610,299688,2013-09-12,Senate,"Unfinished Supp 2 SB344 Padilla Concurrence",38,0,1,0,39
510611,261738,2013-04-09,Senate,"Do pass, but re-refer to the Committee on Judiciary Recommend 	Consent",6,0,0,0,6
510611,274804,2013-04-30,Senate,"Do pass, but re-refer to the Committee on Appropriations Recommend 	Consent",7,0,0,0,7
510611,278772,2013-05-13,Senate,"Placed on Appropriations Suspense file",5,0,2,0,7
510611,283151,2013-05-23,Senate,"Do pass",7,0,0,0,7
510611,284694,2013-05-28,Senate,"Senate 3rd Reading SB343 Yee",39,0,0,0,39
510611,291655,2013-06-25,Assembly,"Do pass and be re-referred to the Committee on Human Services to 	Consent Calendar",10,0,0,0,10
510611,295879,2013-07-02,Assembly,"Do pass as amended and be re-referred to the Committee on 	Appropriations",7,0,0,0,7
510613,261980,2013-04-09,Senate,"Do pass, but re-refer to the Committee on Appropriations Recommend 	Consent",6,0,0,0,6
510613,269951,2013-04-22,Senate,"Placed on Appropriations Suspense file",7,0,0,0,7
510613,283200,2013-05-23,Senate,"Do pass as amended",7,0,0,0,7
510613,284570,2013-05-28,Senate,"Senate 3rd Reading SB342 Yee",39,0,0,0,39
510613,295754,2013-07-02,Assembly,"Do pass and be re-referred to the Committee on Appropriations",7,0,0,0,7
510613,298252,2013-08-30,Assembly,"Do pass as amended",17,0,0,0,17
510613,298972,2013-09-09,Assembly,"SB 342 Yee  Senate Third Reading  By STONE",78,0,0,0,78
510613,299195,2013-09-10,Senate,"Unfinished Business SB342 Yee Concurrence",36,0,3,0,39
510614,266831,2013-04-16,Senate,"Do pass, but re-refer to the Committee on Appropriations",10,0,1,0,11
510614,273653,2013-04-29,Senate,"Do pass",7,0,0,0,7
510614,276254,2013-05-06,Senate,"Senate 3rd Reading SB341 DeSaulnier",34,0,4,0,38
510614,289938,2013-06-19,Assembly,"Do pass and be re-referred to the Committee on Local Government",7,0,0,0,7
510614,291877,2013-06-26,Assembly,"Do pass and be re-referred to the Committee on Appropriations",9,0,0,0,9
510614,297470,2013-08-14,Assembly,"Do pass, to Consent Calendar",17,0,0,0,17
510614,297952,2013-08-22,Assembly,"SB 341 DeSaulnier  Consent Calendar Second Day  Regular Session",78,0,0,0,78
510614,298480,2013-08-30,Senate,"Special Consent #9 SB341 DeSaulnier",38,0,1,0,39
510616,271850,2013-04-23,Senate,"Do pass, but re-refer to the Committee on Appropriations",5,2,0,0,7
510616,276325,2013-05-06,Senate,"Do pass",5,2,0,0,7
510616,278645,2013-05-13,Senate,"Senate 3rd Reading SB340 Jackson",25,7,6,0,38
510616,288129,2013-06-11,Assembly,"Do pass and be re-referred to the Committee on Appropriations",5,2,0,0,7
510616,296091,2013-07-03,Assembly,"Do pass",12,4,0,1,17
510616,298049,2013-08-26,Assembly,"SB 340 Jackson  Senate Third Reading  By ATKINS",52,21,0,5,78
510617,277393,2013-05-08,Senate,"Do pass as amended",7,0,0,0,7
510617,281590,2013-05-20,Senate,"Special Consent #5 SB339 Cannella",36,0,3,0,39
510619,289399,2013-06-18,Senate,"Do pass as amended, and re-refer to the Committee on 	Appropriations",9,0,2,0,11
510619,295709,2013-07-01,Senate,"Do pass as amended",6,0,1,0,7
510619,296230,2013-07-08,Senate,"Senate 3rd Reading SB338 Hill Urgency Clause",32,0,6,0,38
510619,297184,2013-08-12,Assembly,"Do pass and be re-referred to the Committee on Appropriations",15,0,0,1,16
510619,298468,2013-08-30,Assembly,"Do pass as amended",13,1,0,3,17
510619,299359,2013-09-11,Assembly,"SB 338 Hill  Senate Third Reading  By MULLIN",73,1,0,4,78
510619,299649,2013-09-12,Senate,"From committee:  That the Assembly Amendments be concurred in",11,0,0,0,11
510619,299650,2013-09-12,Senate,"Unfinished Supp 2 SB338 Hill Concurrence",35,2,2,0,39
510622,248488,2013-03-13,Assembly,"From committee:  Be adopted.  To third reading",7,0,0,0,7
510623,252641,2013-03-21,Assembly,"From committee:  Be adopted.  To third reading",11,0,0,0,11
510623,263595,2013-04-11,Senate,"Special Consent Cal ACR21 Salas",36,0,2,0,38
510625,250888,2013-03-19,Assembly,"From committee:  Be adopted.  To third reading",12,0,0,1,13
510625,272268,2013-04-25,Senate,"Special Consent Cal ACR20 Logue",36,0,2,0,38
510627,268830,2013-04-17,Assembly,"Amend, and do pass as amended and be re-referred to the Committee 	on Human Services with the recommendation:  To Consent Calendar",7,0,0,0,7
510627,274673,2013-04-30,Assembly,"Do pass as amended, to Consent Calendar",6,0,0,1,7
510627,278691,2013-05-13,Assembly,"AB 643 STONE  Consent Calendar Second Day",75,0,0,4,79
510627,288457,2013-06-12,Senate,"Do pass as amended. To Consent Calendar",9,0,0,0,9
510627,291356,2013-06-24,Senate,"Consent Calendar 2nd AB643 Stone",39,0,0,0,39
510627,292154,2013-06-27,Assembly,"AB 643 STONE  Concurrence in Senate Amendments",78,0,0,1,79
510630,263445,2013-04-10,Assembly,"Do pass and be re-referred to the Committee on Appropriations",5,2,0,0,7
510630,284026,2013-05-24,Assembly,"Do pass",12,5,0,0,17
510630,285636,2013-05-30,Assembly,"AB 641 RENDON  Assembly Third Reading",51,25,0,3,79
510630,291908,2013-06-26,Senate,"Do pass, but re-refer to the Committee on Appropriations",3,1,1,0,5
510630,297737,2013-08-19,Senate,"Placed on Appropriations Suspense file",7,0,0,0,7
510630,298355,2013-08-30,Senate,"Do pass",5,2,0,0,7
510632,277345,2013-05-08,Assembly,"Do pass, to Consent Calendar",16,0,0,1,17
510632,280425,2013-05-16,Assembly,"AB 640 HALL  Consent Calendar Second Day  Regular Session",70,0,0,9,79
510632,374425,2014-06-25,Senate,"Do pass as amended, and re-refer to the Committee on Appropriations",6,0,1,0,7
510632,376623,2014-08-04,Senate,"Placed on Appropriations Suspense file",7,0,0,0,7
510633,267917,2013-04-17,Assembly,"Do pass and be re-referred to the Committee on Veterans Affairs",7,0,0,0,7
510633,274728,2013-04-30,Assembly,"Do pass and be re-referred to the Committee on Appropriations",8,0,0,2,10
510633,283899,2013-05-24,Assembly,"Do pass",16,0,0,1,17
510633,285166,2013-05-29,Assembly,"AB 639 PEREZ, J.  Third Reading Urgency",77,0,0,2,79
510633,295851,2013-07-02,Senate,"Do pass, but re-refer to the Committee on Veterans Affairs",11,0,0,0,11
510633,296326,2013-07-09,Senate,"Do pass, but re-refer to the Committee on Appropriations",7,0,0,0,7
510633,297396,2013-08-12,Senate,"Placed on Appropriations Suspense file",6,0,1,0,7
510633,298472,2013-08-30,Senate,"Do pass",7,0,0,0,7
510633,299242,2013-09-10,Senate,"Assembly 3rd Reading AB639 John A. P",36,0,3,0,39
510633,299501,2013-09-11,Assembly,"AB 639 PEREZ, J.  Concurrence in Senate Amendments",78,0,0,0,78
510636,263183,2013-04-10,Assembly,"Do pass and be re-referred to the Committee on Appropriations",13,0,0,0,13
510637,273585,2013-04-29,Assembly,"Be referred to Committee on Housing and Community Development",11,0,0,0,11
510637,274869,2013-05-01,Assembly,"Do pass",5,2,0,0,7
510637,278158,2013-05-09,Assembly,"AB 637 ATKINS  Assembly Third Reading",54,22,0,3,79
510637,289463,2013-06-18,Senate,"Do pass",9,1,1,0,11
510637,298025,2013-08-26,Senate,"Assembly 3rd Reading AB637 Atkins By Torres",29,10,0,0,39
510637,298261,2013-08-30,Assembly,"AB 637 ATKINS  Concurrence in Senate Amendments",56,22,0,0,78
510639,262757,2013-04-10,Assembly,"Do pass and re-refer to Committee on Appropriations with 	recommendation:  To Consent Calendar",16,0,0,1,17
510639,274847,2013-05-01,Assembly,"Do pass, to Consent Calendar",17,0,0,0,17
510639,278091,2013-05-09,Assembly,"AB 636 HALL  Consent Calendar Second Day  Regular Session",75,0,0,4,79
510639,288184,2013-06-11,Senate,"Do pass, but re-refer to the Committee on Appropriations",11,0,0,0,11
510639,291223,2013-06-24,Senate,"Do pass",7,0,0,0,7
510639,298084,2013-08-26,Senate,"Assembly 3rd Reading AB636 Hall By Wright",39,0,0,0,39
510639,298431,2013-08-30,Assembly,"AB 636 HALL  Concurrence in Senate Amendments",78,0,0,0,78
510640,257414,2013-04-02,Assembly,"Do pass",9,0,0,1,10
510640,265454,2013-04-15,Assembly,"AB 635 AMMIANO  Assembly Third Reading",77,0,0,2,79
510640,289423,2013-06-18,Senate,"Do pass as amended",6,0,1,0,7
510640,298845,2013-09-06,Senate,"Assembly 3rd Reading AB635 Ammiano By DeSaulnier",36,0,3,0,39
510640,299057,2013-09-09,Assembly,"AB 635 AMMIANO  Concurrence in Senate Amendments",77,0,0,1,78
510643,262782,2013-04-09,Assembly,"Do pass and be re-referred to the Committee on Business, 	Professions and Consumer Protection",11,0,0,2,13
510643,266252,2013-04-16,Assembly,"Do pass and be re-referred to the Committee on Appropriations",12,0,0,1,13
510643,274977,2013-05-01,Assembly,"Do pass",15,1,0,1,17
510643,278612,2013-05-13,Assembly,"AB 634 GOMEZ  Assembly Third Reading",73,1,0,5,79
510643,374475,2014-06-24,Senate,"Do pass",7,0,0,0,7
510643,378276,2014-08-22,Senate,"Assembly 3rd Reading AB634 Gomez By Correa",33,0,7,0,40
510643,378979,2014-08-28,Assembly,"Senate amendments be concurred in",10,0,0,0,10
510643,378980,2014-08-28,Assembly,"AB 634 GOMEZ  Concurrence in Senate Amendments",77,0,0,2,79
510644,272317,2013-04-24,Assembly,"Do pass and be re-referred to the Committee on Judiciary",7,0,0,0,7
510644,276827,2013-05-07,Assembly,"Do pass as amended",10,0,0,0,10
510644,280231,2013-05-16,Assembly,"AB 633 SALAS  Assembly Third Reading",67,1,0,11,79
510644,289849,2013-06-19,Senate,"Do pass as amended, and re-refer to the Committee on Judiciary",8,0,1,0,9
510644,296036,2013-07-02,Senate,"Do pass as amended",5,0,2,0,7
510644,298665,2013-09-03,Senate,"Assembly 3rd Reading AB633 Salas By Torres",37,0,2,0,39
510644,298842,2013-09-06,Assembly,"AB 633 SALAS  Concurrence in Senate Amendments",78,0,0,0,78
510647,278219,2013-05-08,Assembly,"Do pass as amended, to Consent Calendar",7,0,0,0,7
510647,280303,2013-05-16,Assembly,"AB 631 FOX  Consent Calendar Second Day  Regular Session",70,0,0,9,79
510647,288416,2013-06-12,Senate,"Do pass",9,0,0,0,9
510647,296193,2013-07-08,Senate,"Assembly 3rd Reading AB631 Fox By Hancock",32,0,6,0,38
510647,297110,2013-08-08,Assembly,"AB 631 FOX  Concurrence in Senate Amendments",77,0,0,1,78
510649,271243,2013-04-23,Assembly,"Do pass",12,0,0,1,13
510649,275646,2013-05-02,Assembly,"AB 630 HOLDEN  Assembly Third Reading",74,0,0,5,79
510649,289339,2013-06-17,Senate,"Do pass",10,0,0,0,10
510649,298624,2013-09-03,Senate,"Assembly 3rd Reading AB630 Holden By Galgiani",37,0,2,0,39
510649,298895,2013-09-06,Assembly,"AB 630 HOLDEN  Concurrence in Senate Amendments",78,0,0,0,78
510652,271001,2013-04-22,Assembly,"Do pass and be re-referred to the Committee on Jobs, Economic 	Development and The Economy",14,0,0,1,15
510652,274203,2013-04-30,Assembly,"Do pass as amended and be re-referred to the Committee on 	Appropriations",9,0,0,0,9
510652,283896,2013-05-24,Assembly,"Do pass, to Consent Calendar",17,0,0,0,17
510652,285140,2013-05-29,Assembly,"AB 628 GORELL  Consent Calendar Second Day  Regular Session",77,0,0,2,79
510652,295871,2013-07-02,Senate,"Do pass as amended, and re-refer to the Committee on Appropriations",8,0,3,0,11
510652,298410,2013-08-30,Senate,"Placed on Appropriations Suspense file",7,0,0,0,7
510652,298411,2013-08-30,Senate,"Do pass as amended",7,0,0,0,7
510652,299512,2013-09-11,Senate,"Assembly 3rd Reading AB628 Gorell Reconsider",38,0,1,0,39
510652,299513,2013-09-11,Senate,"Assembly 3rd Reading AB628 Gorell By Hueso",35,1,3,0,39
510652,299752,2013-09-12,Assembly,"AB 628 GORELL  Concurrence in Senate Amendments",77,0,0,1,78
510652,299753,2013-09-12,Senate,"Assembly 3rd Reading AB628 Gorell By Hueso",33,0,6,0,39
510655,268517,2013-04-17,Assembly,"Do pass as amended and be re-referred to the Committee on Health",6,0,0,1,7
510655,274070,2013-04-30,Assembly,"Do pass as amended and be re-referred to the Committee on 	Appropriations",18,1,0,0,19
510655,283808,2013-05-24,Assembly,"Do pass",15,2,0,0,17
510655,284681,2013-05-28,Assembly,"AB 626 SKINNER  Assembly Third Reading",72,3,0,4,79
510655,289824,2013-06-19,Senate,"Do pass, but re-refer to the Committee on Health",9,0,0,0,9
510655,295940,2013-07-03,Senate,"Do pass as amended, and re-refer to the Committee on 	Appropriations",9,0,0,0,9
510655,297263,2013-08-12,Senate,"Placed on Appropriations Suspense file",6,0,1,0,7
510655,298185,2013-08-30,Senate,"Do pass",7,0,0,0,7
510655,298943,2013-09-09,Senate,"Assembly 3rd Reading AB626 Skinner By Liu",39,0,0,0,39
510655,299159,2013-09-10,Assembly,"AB 626 SKINNER  Concurrence in Senate Amendments",75,1,0,2,78
510656,257401,2013-04-02,Assembly,"Do pass",9,0,0,1,10
510656,263474,2013-04-11,Assembly,"AB 625 QUIRK  Assembly Third Reading",76,0,0,3,79
510656,286838,2013-06-04,Senate,"Do pass as amended. To Consent Calendar",6,0,1,0,7
510656,288723,2013-06-13,Senate,"Consent Calendar 2nd AB625 Quirk",37,0,2,0,39
510656,296185,2013-07-08,Senate,"Assembly 3rd Reading AB625 Quirk By Evans",33,0,5,0,38
510656,297131,2013-08-08,Assembly,"AB 625 QUIRK  Concurrence in Senate Amendments",75,0,0,3,78
510658,257433,2013-04-02,Assembly,"Do pass",5,2,0,0,7
510658,265389,2013-04-15,Assembly,"AB 624 MITCHELL  Assembly Third Reading",48,22,0,9,79
510658,279340,2013-05-14,Senate,"Do pass",7,0,0,0,7
510658,297598,2013-08-15,Senate,"Assembly 3rd Reading AB624 Mitchell By De Le",32,4,3,0,39
510658,297648,2013-08-19,Assembly,"AB 624 MITCHELL  Concurrence in Senate Amendments",48,21,0,9,78
510660,259549,2013-04-03,Assembly,"Do pass as amended and be re-referred to the Committee on 	Appropriations",7,0,0,0,7
510660,283883,2013-05-24,Assembly,"Do pass",12,5,0,0,17
510660,285154,2013-05-29,Assembly,"AB 622 CAMPOS  Assembly Third Reading",62,13,0,4,79
510660,295988,2013-07-03,Senate,"Do pass, but re-refer to the Committee on Appropriations",8,1,0,0,9
510660,297331,2013-08-12,Senate,"Placed on Appropriations Suspense file",6,0,1,0,7
510660,298388,2013-08-30,Senate,"Do pass as amended",5,2,0,0,7
510660,299266,2013-09-10,Senate,"Assembly 3rd Reading AB622 Campos By Hueso",27,10,2,0,39
510660,299468,2013-09-11,Assembly,"AB 622 CAMPOS  Concurrence in Senate Amendments",59,19,0,0,78
510662,268542,2013-04-17,Assembly,"Do pass and be re-referred to the Committee on Elections and 	Redistricting",7,2,0,0,9
510662,276768,2013-05-07,Assembly,"Do pass",7,0,0,0,7
510662,278599,2013-05-13,Assembly,"AB 621 WAGNER  Assembly Third Reading",51,10,0,18,79
510664,262817,2013-04-09,Assembly,"Do pass as amended and be re-referred to the Committee on 	Appropriations",19,0,0,0,19
510664,275207,2013-05-01,Assembly,"Do pass, to Consent Calendar",17,0,0,0,17
510664,278190,2013-05-09,Assembly,"AB 620 BUCHANAN  Consent Calendar Second Day  Regular Session",75,0,0,4,79
510664,289891,2013-06-19,Senate,"Do pass, but re-refer to the Committee on Human Services",9,0,0,0,9
510664,291621,2013-06-25,Senate,"Do pass as amended, and re-refer to the Committee on Appropriations",6,0,0,0,6
510664,299004,2013-09-09,Senate,"Assembly 3rd Reading AB620 Buchanan By DeSaulnier",39,0,0,0,39
510664,299239,2013-09-10,Assembly,"AB 620 BUCHANAN  Concurrence in Senate Amendments",77,0,0,1,78
510666,257327,2013-04-02,Assembly,"Do pass, to Consent Calendar",9,0,0,1,10
510666,260931,2013-04-08,Assembly,"AB 619 GARCIA  Consent Calendar Second Day  Regular Session",75,0,0,4,79
510666,289395,2013-06-18,Senate,"Do pass, but re-refer to the Committee on Appropriations Recommend 	Consent",6,0,1,0,7
510666,297996,2013-08-26,Senate,"Assembly 3rd Reading AB619 Garcia By Monning",38,0,1,0,39
510667,257347,2013-04-01,Assembly,"Do pass and be re-referred to the Committee on Public Safety",5,3,0,1,9
510667,274822,2013-04-30,Assembly,"Do pass as amended and be re-referred to the Committee on 	Appropriations",7,0,0,0,7
510667,279863,2013-05-15,Assembly,"Do pass",16,0,0,1,17
510669,271043,2013-04-23,Assembly,"Do pass and be re-referred to the Committee on Appropriations",13,6,0,0,19
510669,284067,2013-05-24,Assembly,"Do pass",12,5,0,0,17
510669,284641,2013-05-28,Assembly,"AB 617 NAZARIAN  Assembly Third Reading",54,24,0,1,79
510669,296078,2013-07-03,Senate,"Do pass as amended, and re-refer to the Committee on 	Appropriations",9,0,0,0,9
510669,376917,2014-08-11,Senate,"Placed on Appropriations Suspense file",7,0,0,0,7
510669,377197,2014-08-14,Senate,"Do pass as amended",5,0,2,0,7
510669,378505,2014-08-26,Senate,"Assembly 3rd Reading AB617 Nazarian By Hernandez",25,9,6,0,40
510669,378743,2014-08-27,Assembly,"AB 617 NAZARIAN  Concurrence in Senate Amendments",57,21,0,1,79
510670,271636,2013-04-24,Assembly,"Do pass as amended and be re-referred to the Committee on 	Appropriations",5,2,0,0,7
510670,284073,2013-05-24,Assembly,"Do pass",12,5,0,0,17
510670,284693,2013-05-28,Assembly,"AB 616 BOCANEGRA  Assembly Third Reading",53,25,0,1,79
510670,291206,2013-06-24,Senate,"Do pass, but re-refer to the Committee on Appropriations",3,2,0,0,5
510670,297334,2013-08-12,Senate,"Placed on Appropriations Suspense file",6,0,1,0,7
510672,271554,2013-04-24,Assembly,"Do pass as amended and be re-referred to the Committee on 	Appropriations",9,4,0,0,13
510673,258708,2013-04-02,Assembly,"Do pass as amended and be re-referred to the Committee on 	Appropriations",9,0,0,1,10
510673,267447,2013-04-17,Assembly,"Do pass as amended, to Consent Calendar",17,0,0,0,17
510673,272426,2013-04-25,Assembly,"AB 614 CHAVEZ  Consent Calendar Second Day  Regular Session",76,0,0,3,79
510673,373975,2014-06-24,Senate,"Do pass, but re-refer to the Committee on Appropriations",6,0,1,0,7
510673,378337,2014-08-25,Senate,"Assembly 3rd Reading AB614 Ch",34,0,6,0,40
510673,378498,2014-08-26,Assembly,"AB 614 CHAVEZ  Concurrence in Senate Amendments",79,0,0,0,79
510676,274325,2013-04-29,Assembly,"Do pass",15,0,0,1,16
510676,278066,2013-05-09,Assembly,"AB 612 NAZARIAN  Assembly Third Reading",72,1,0,6,79
510676,372181,2014-06-17,Senate,"Do pass, but re-refer to the Committee on Insurance",8,2,1,0,11
510676,376529,2014-08-04,Senate,"Placed on Appropriations Suspense file",7,0,0,0,7
510676,377220,2014-08-14,Senate,"Do pass as amended",5,0,2,0,7
510676,378014,2014-08-21,Senate,"Assembly 3rd Reading AB612 Nazarian By Hill",21,11,8,0,40
510676,378443,2014-08-25,Assembly,"Senate amendments be concurred in",5,4,0,7,16
510676,378444,2014-08-25,Assembly,"Set first hearing.  Failed passage.  Reconsideration granted",15,0,0,1,16
510679,271891,2013-04-24,Assembly,"Do pass and re-refer to Committee on Appropriations with 	recommendation:  To Consent Calendar",7,0,0,0,7
510679,283814,2013-05-24,Assembly,"Do pass",17,0,0,0,17
510679,285662,2013-05-30,Assembly,"AB 611 BONTA  Assembly Third Reading",76,1,0,2,79
510679,373755,2014-06-23,Senate,"Do pass, but re-refer to the Committee on Appropriations Recommend 	Consent",5,0,0,0,5
510679,376762,2014-08-07,Senate,"Consent Calendar 2nd AB611 Bonta",34,0,6,0,40
510679,377023,2014-08-12,Assembly,"Senate amendments be concurred in",5,0,0,2,7
510679,377702,2014-08-18,Assembly,"AB 611 BONTA  Concurrence- Urgency Added",78,0,0,1,79
510680,272394,2013-04-24,Assembly,"Do pass and be re-referred to the Committee on Appropriations to 	Consent Calendar",9,0,0,0,9
510680,277490,2013-05-08,Assembly,"Do pass, to Consent Calendar",17,0,0,0,17
510680,280375,2013-05-16,Assembly,"AB 610 ACHADJIAN  Consent Calendar Second Day  Regular Session",70,0,0,9,79
510680,289488,2013-06-18,Senate,"Do pass as amended, and re-refer to the Committee on Appropriations",6,0,1,0,7
510680,297733,2013-08-19,Senate,"Placed on Appropriations Suspense file",7,0,0,0,7
510680,298344,2013-08-30,Senate,"Do pass as amended",7,0,0,0,7
510680,299018,2013-09-09,Senate,"Assembly 3rd Reading AB610 Achadjian By Monning",39,0,0,0,39
510680,299326,2013-09-10,Assembly,"AB 610 ACHADJIAN  Concurrence in Senate Amendments",78,0,0,0,78
510682,275597,2013-05-01,Assembly,"Do pass and be re-referred to the Committee on Appropriations",8,2,0,3,13
510682,283752,2013-05-24,Assembly,"Do pass as amended",17,0,0,0,17
510682,285625,2013-05-30,Assembly,"AB 609 NESTANDE  Assembly Third Reading",71,7,0,1,79
510682,291642,2013-06-25,Senate,"Do pass, but re-refer to the Committee on Judiciary",5,0,6,0,11
510682,291643,2013-06-25,Senate,"Set, first hearing.  Failed passage in Committee.  Reconsideration 	granted",11,0,0,0,11
510682,370396,2014-06-10,Senate,"Do pass as amended, and re-refer to the Committee on Judiciary",8,0,2,0,10
510682,374710,2014-06-24,Senate,"Do pass, but re-refer to the Committee on Appropriations",7,0,0,0,7
510682,377040,2014-08-13,Senate,"Assembly 3rd Reading AB609 Nestande By Hill",33,0,7,0,40
510682,377725,2014-08-18,Assembly,"AB 609 NESTANDE  Concurrence in Senate Amendments",76,1,0,2,79
510685,263026,2013-04-10,Assembly,"Do pass, to Consent Calendar",13,0,0,0,13
510685,268655,2013-04-18,Assembly,"AB 607 PEREA  Consent Calendar Second Day  Regular Session",76,0,0,3,79
510685,291930,2013-06-26,Senate,"Do pass, but re-refer to the Committee on Appropriations",4,0,1,0,5
510685,297427,2013-08-12,Senate,"Do pass",6,0,1,0,7
510685,298114,2013-08-26,Senate,"Assembly 3rd Reading AB607 Perea By Block",38,0,1,0,39
510686,262775,2013-04-09,Assembly,"Do pass and be re-referred to the Committee on Appropriations",12,0,0,1,13
510686,284014,2013-05-24,Assembly,"Do pass",17,0,0,0,17
510686,285542,2013-05-30,Assembly,"AB 606 WILLIAMS  Assembly Third Reading",78,0,0,1,79
510686,289840,2013-06-19,Senate,"Do pass, but re-refer to the Committee on Appropriations Recommend 	Consent",9,0,0,0,9
510686,295323,2013-07-01,Senate,"Placed on Appropriations Suspense file",6,0,1,0,7
510686,299705,2013-09-12,Senate,"Assembly 3rd Supp 2 AB606 Williams Urgency Clause",38,0,1,0,39
510686,299706,2013-09-12,Assembly,"AB 606 WILLIAMS  Concurrence- Urgency Added",76,0,0,2,78
510688,257700,2013-04-02,Assembly,"Do pass and be re-referred to the Committee on Appropriations",2,4,0,1,7
510688,257701,2013-04-02,Assembly,"Set first hearing.  Failed passage.  Reconsideration granted",7,0,0,0,7
510689,270716,2013-04-23,Assembly,"Do pass as amended",4,2,0,1,7
510689,285513,2013-05-30,Assembly,"AB 604 AMMIANO  Assembly Third Reading",41,34,0,4,79
510689,295792,2013-07-02,Senate,"Do pass as amended",5,2,0,0,7
510692,257418,2013-04-02,Assembly,"Do pass and re-refer to Committee on Appropriations with 	recommendation:  To Consent Calendar",7,0,0,0,7
510692,284057,2013-05-24,Assembly,"Do pass as amended",17,0,0,0,17
510692,285230,2013-05-29,Assembly,"AB 602 YAMADA  Assembly Third Reading",76,0,0,3,79
510692,289557,2013-06-18,Senate,"Do pass, but re-refer to the Committee on Human Services",6,0,1,0,7
510692,291674,2013-06-25,Senate,"Do pass, but re-refer to the Committee on Appropriations Recommend 	Consent",6,0,0,0,6
510692,297360,2013-08-12,Senate,"Placed on Appropriations Suspense file",6,0,1,0,7
510692,298417,2013-08-30,Senate,"Do pass",7,0,0,0,7
510692,299002,2013-09-09,Senate,"Assembly 3rd Reading AB602 Yamada By Pavley",39,0,0,0,39
510692,299238,2013-09-10,Assembly,"AB 602 YAMADA  Concurrence in Senate Amendments",78,0,0,0,78
510695,270696,2013-04-23,Assembly,"Subject matter be referred",4,1,0,2,7
510696,274290,2013-04-29,Assembly,"Do pass",11,0,0,5,16
510696,285710,2013-05-30,Assembly,"AB 600 BONTA  Assembly Third Reading",71,2,0,6,79
510696,364008,2014-05-13,Senate,"Do pass, but re-refer to the Committee on Appropriations",9,0,1,0,10
510696,370101,2014-06-05,Senate,"Special Consent #16 AB600 Bonta By Corbett",33,0,7,0,40
510696,374528,2014-06-25,Assembly,"Senate amendments be concurred in",16,0,0,3,19
510696,375298,2014-06-30,Assembly,"AB 600 BONTA  Concurrence- Urgency Added",78,0,0,1,79
510697,267923,2013-04-16,Assembly,"Do pass and be re-referred to the Committee on Judiciary",5,13,0,1,19
510703,262697,2013-04-09,Assembly,"Do pass and be re-referred to the Committee on Appropriations",12,0,0,1,13
510703,274917,2013-05-01,Assembly,"Do pass, to Consent Calendar",17,0,0,0,17
510703,280333,2013-05-16,Assembly,"AB 595 GOMEZ  Assembly Third Reading",73,0,0,6,79
510703,288567,2013-06-12,Senate,"Do pass as amended, and re-refer to the Committee on Appropriations",9,0,0,0,9
510703,299514,2013-09-11,Senate,"Assembly 3rd Reading AB595 Gomez By Block",38,1,0,0,39
510703,299614,2013-09-12,Assembly,"AB 595 GOMEZ  Concurrence in Senate Amendments",78,0,0,0,78
510705,266571,2013-04-16,Assembly,"Do pass and re-refer to Committee on Appropriations with 	recommendation:  To Consent Calendar",15,0,0,0,15
510705,283805,2013-05-24,Assembly,"Do pass as amended",17,0,0,0,17
510705,285053,2013-05-29,Assembly,"AB 594 W., P.& W.  Assembly Third Reading  By RENDON",77,0,0,2,79
510705,291629,2013-06-25,Senate,"Do pass as amended, but re-refer to the Committee on Appropriations 	Recommend Consent",9,0,0,0,9
510705,297994,2013-08-26,Senate,"Consent Calendar 2nd AB594 Committee on W.,P. & W. (Rendon)",39,0,0,0,39
510705,298207,2013-08-30,Assembly,"AB 594 W., P.& W.  Concurrence- Urgency Added  By RENDON",78,0,0,0,78
510706,272290,2013-04-24,Assembly,"Do pass and be re-referred to the Committee on Appropriations",16,0,0,1,17
510706,284030,2013-05-24,Assembly,"Do pass as amended",17,0,0,0,17
510706,284986,2013-05-29,Assembly,"AB 593 QUIRK  Assembly Third Reading",76,0,0,3,79
510706,291775,2013-06-25,Senate,"Do pass, but re-refer to the Committee on Appropriations",10,0,1,0,11
510706,297353,2013-08-12,Senate,"Do pass",5,0,2,0,7
510706,298654,2013-09-03,Senate,"Assembly 3rd Reading AB593 Quirk By Wright",37,0,2,0,39
510706,298822,2013-09-06,Assembly,"AB 593 QUIRK  Concurrence in Senate Amendments",76,1,0,1,78
510714,277963,2013-05-08,Assembly,"Do pass as amended",7,0,0,0,7
510714,280233,2013-05-16,Assembly,"AB 588 FOX  Assembly Third Reading",70,0,0,9,79
510714,288407,2013-06-12,Senate,"Do pass, but re-refer to the Committee on Appropriations",9,0,0,0,9
510714,291213,2013-06-24,Senate,"Placed on Appropriations Suspense file",7,0,0,0,7
510714,298187,2013-08-30,Senate,"Do pass as amended",7,0,0,0,7
510714,298941,2013-09-09,Senate,"Assembly 3rd Reading AB588 Fox By Liu",39,0,0,0,39
510714,299157,2013-09-10,Assembly,"AB 588 FOX  Concurrence in Senate Amendments",77,0,0,1,78
510719,305873,2014-01-06,Assembly,"Be referred to Committee on Veterans Affairs",9,0,0,1,10
510719,309002,2014-01-14,Assembly,"Do pass as amended and be re-referred to the Committee on 	Appropriations",8,1,0,1,10
510719,311175,2014-01-23,Assembly,"Do pass",16,0,0,1,17
510719,312247,2014-01-27,Assembly,"AB 585 FOX  Assembly Third Reading",72,1,0,7,80
510719,374202,2014-06-24,Senate,"Do pass, but re-refer to the Committee on Appropriations",5,0,2,0,7
510719,376610,2014-08-04,Senate,"Placed on Appropriations Suspense file",7,0,0,0,7
510719,377400,2014-08-14,Senate,"Do pass",5,0,2,0,7
510719,377994,2014-08-20,Senate,"Assembly 3rd Reading AB585 Fox By Roth",35,0,5,0,40
510719,378265,2014-08-22,Assembly,"AB 585 FOX  Concurrence in Senate Amendments",74,1,0,4,79
510721,262677,2013-04-10,Assembly,"Do pass and re-refer to Committee on Appropriations with 	recommendation:  To Consent Calendar",13,0,0,0,13
510721,274767,2013-05-01,Assembly,"Do pass, to Consent Calendar",17,0,0,0,17
510721,278081,2013-05-09,Assembly,"AB 584 PEREA  Consent Calendar Second Day  Regular Session",75,0,0,4,79
510721,291900,2013-06-26,Senate,"Do pass as amended, and re-refer to the Committee on 	Appropriations",9,0,0,0,9
510721,297653,2013-08-19,Senate,"Assembly 3rd Reading AB584 Perea By Torres",37,0,2,0,39
510721,297893,2013-08-22,Assembly,"AB 584 PEREA  Concurrence in Senate Amendments",77,0,0,1,78
510723,278358,2013-05-08,Assembly,"Do pass",7,1,0,1,9
510723,280436,2013-05-16,Assembly,"AB 583 GOMEZ  Assembly Third Reading",52,19,0,8,79
510723,289944,2013-06-19,Senate,"Do pass",4,2,1,0,7
510723,297612,2013-08-15,Senate,"Assembly 3rd Reading AB583 Gomez By Hancock",25,10,4,0,39
510725,267557,2013-04-16,Assembly,"Do pass and be re-referred to the Committee on Appropriations",19,0,0,0,19
510725,283873,2013-05-24,Assembly,"Do pass as amended",16,0,0,1,17
510725,285124,2013-05-29,Assembly,"AB 582 CHESBRO  Assembly Third Reading",76,0,0,3,79
510725,292053,2013-06-26,Senate,"Do pass as amended, and re-refer to the Committee on 	Appropriations",9,0,0,0,9
510725,345762,2014-03-19,Senate,"Do pass",7,0,0,0,7
510725,355268,2014-04-10,Senate,"Assembly 3rd Reading AB582 Levine Urgency Clause",34,0,6,0,40
510725,363176,2014-05-07,Assembly,"Senate amendments be concurred in",9,0,0,0,9
510725,368789,2014-05-29,Assembly,"AB 582 LEVINE  Concurrence- Urgency Added",65,13,0,1,79
510726,259351,2013-04-02,Assembly,"Do pass as amended and be re-referred to the Committee on Judiciary",7,0,0,0,7
510726,266300,2013-04-16,Assembly,"Do pass as amended and re-refer to Committee on Appropriations 	with recommendation:  To Consent Calendar",10,0,0,0,10
510726,274947,2013-05-01,Assembly,"Do pass, to Consent Calendar",17,0,0,0,17
510726,278121,2013-05-09,Assembly,"AB 581 AMMIANO  Consent Calendar Second Day  Regular Session",75,0,0,4,79
510726,288315,2013-06-11,Senate,"Do pass as amended, but re-refer to the Committee on Judiciary 	Recommend Consent",6,0,0,0,6
510726,291639,2013-06-25,Senate,"Do pass, but re-refer to the Committee on Appropriations Recommend 	Consent",7,0,0,0,7
510726,297544,2013-08-15,Senate,"Consent Calendar 2nd AB581 Ammiano",38,0,1,0,39
510726,297703,2013-08-19,Assembly,"AB 581 AMMIANO  Concurrence in Senate Amendments",77,0,0,1,78
510728,261803,2013-04-09,Assembly,"Do pass and be re-referred to the Committee on Appropriations",4,2,0,1,7
510729,266334,2013-04-16,Assembly,"Do pass",2,3,0,2,7
510729,266335,2013-04-16,Assembly,"Set first hearing.  Failed passage.  Reconsideration granted",7,0,0,0,7
510729,308632,2014-01-14,Assembly,"Do pass as amended, to Consent Calendar",7,0,0,0,7
510729,310335,2014-01-21,Assembly,"AB 579 MELENDEZ  Consent Calendar Second Day  Regular Session",75,0,0,5,80
510729,347560,2014-03-25,Senate,"Do pass",7,0,0,0,7
510729,352706,2014-04-07,Senate,"Assembly 3rd Reading AB579 Melendez Urgency Clause",36,0,4,0,40
510730,258116,2013-04-02,Assembly,"Do pass as amended and be re-referred to the Committee on 	Appropriations",11,6,0,2,19
510730,284045,2013-05-24,Assembly,"Do pass as amended",12,5,0,0,17
510730,284967,2013-05-29,Assembly,"AB 578 DICKINSON  Assembly Third Reading",54,23,0,2,79
510730,374387,2014-06-24,Senate,"Do pass as amended, and re-refer to the Committee on Appropriations",4,0,1,0,5
510730,376402,2014-08-04,Senate,"Placed on Appropriations Suspense file",7,0,0,0,7
510732,308674,2014-01-13,Assembly,"Do pass",15,0,0,1,16
510732,311185,2014-01-23,Assembly,"AB 577 NAZARIAN  Assembly Third Reading",73,0,0,7,80
510732,370449,2014-06-10,Senate,"Do pass and be placed on the Consent Calendar",10,0,1,0,11
510732,371715,2014-06-16,Senate,"Consent Calendar 2nd AB577 Nazarian",35,0,5,0,40
510732,374770,2014-06-26,Assembly,"AB 577 NAZARIAN  Concurrence in Senate Amendments",75,0,0,4,79
510733,261889,2013-04-09,Assembly,"Do pass and be re-referred to the Committee on Revenue and Taxation",5,2,0,0,7
510733,274278,2013-04-29,Assembly,"Do pass as amended and be re-referred to the Committee on 	Appropriations",8,0,0,1,9
510733,283907,2013-05-24,Assembly,"Do pass",17,0,0,0,17
510733,285592,2013-05-30,Assembly,"AB 576 PEREZ, V.M.  Assembly Third Reading",75,3,0,1,79
510733,291888,2013-06-26,Senate,"Do pass, but re-refer to the Committee on Governance and Finance",4,0,1,0,5
510733,296115,2013-07-03,Senate,"Do pass, but re-refer to the Committee on Appropriations Recommend 	Consent",7,0,0,0,7
510733,296116,2013-07-03,Senate,"Do pass as amended, but re-refer to the Committee on Appropriations 	Recommend Consent",7,0,0,0,7
510733,297335,2013-08-12,Senate,"Placed on Appropriations Suspense file",6,0,1,0,7
510733,298469,2013-08-30,Senate,"Do pass as amended",7,0,0,0,7
510733,299748,2013-09-12,Assembly,"AB 576 PEREZ, V.M.  Concurrence in Senate Amendments",77,1,0,0,78
510733,299749,2013-09-12,Senate,"Special Consent #10 AB576 V. Manuel P",39,0,0,0,39
510736,268481,2013-04-18,Assembly,"Be referred to Committee on Transportation",9,0,0,2,11
510736,270022,2013-04-22,Assembly,"Do pass and be re-referred to the Committee on Natural Resources",12,4,0,0,16
510736,274283,2013-04-29,Assembly,"Do pass and be re-referred to the Committee on Appropriations",6,3,0,0,9
510741,268182,2013-04-17,Assembly,"Do pass and be re-referred to the Committee on Appropriations",7,0,0,0,7
510741,283816,2013-05-24,Assembly,"Do pass",17,0,0,0,17
510741,284853,2013-05-28,Assembly,"AB 571 GATTO  Assembly Third Reading",77,0,0,2,79
510741,289510,2013-06-18,Senate,"Do pass, but re-refer to the Committee on Appropriations",3,0,2,0,5
510741,295480,2013-07-01,Senate,"Placed on Appropriations Suspense file",6,0,1,0,7
510741,298511,2013-08-30,Senate,"Do pass",7,0,0,0,7
510741,299096,2013-09-09,Senate,"Assembly 3rd Reading AB571 Gatto By Wolk",39,0,0,0,39
510742,268718,2013-04-17,Assembly,"Do pass as amended and be re-referred to the Committee on 	Appropriations",6,0,0,1,7
510742,283943,2013-05-24,Assembly,"Do pass as amended",17,0,0,0,17
510742,285157,2013-05-29,Assembly,"AB 570 JONES-SAWYER  Assembly Third Reading",76,1,0,2,79
510742,291865,2013-06-26,Senate,"Do pass as amended, and re-refer to the Committee on Appropriations",9,0,0,0,9
510742,297388,2013-08-12,Senate,"Do pass",5,0,2,0,7
510742,298079,2013-08-26,Senate,"Assembly 3rd Reading AB570 Jones-Sawyer By Lara",39,0,0,0,39
510742,298420,2013-08-30,Assembly,"AB 570 JONES-SAWYER  Concurrence in Senate Amendments",77,0,0,1,78
510744,308983,2014-01-15,Assembly,"Do pass and be re-referred to the Committee on Appropriations to 	Consent Calendar",7,0,0,0,7
510744,311214,2014-01-23,Assembly,"Do pass, to Consent Calendar",16,0,0,1,17
510744,313231,2014-01-29,Assembly,"AB 569 CHAU  Consent Calendar Second Day  Regular Session",78,0,0,2,80
510744,362780,2014-05-06,Senate,"Do pass, but re-refer to the Committee on Judiciary Recommend 	Consent",11,0,0,0,11
510744,374588,2014-06-24,Senate,"Do pass as amended, and re-refer to the Committee on 	Appropriations",6,1,0,0,7
510744,376882,2014-08-11,Senate,"Assembly 3rd Reading AB569 Chau By Torres",36,0,4,0,40
510744,377500,2014-08-14,Assembly,"AB 569 CHAU  Concurrence in Senate Amendments",78,0,0,1,79
510745,277597,2013-05-07,Assembly,"Do pass",7,0,0,0,7
510745,281302,2013-05-20,Assembly,"AB 568 MURATSUCHI  Assembly Third Reading",75,0,0,3,78
510745,288198,2013-06-11,Senate,"Do pass",7,0,0,0,7
510745,296265,2013-07-08,Senate,"Assembly 3rd Reading AB568 Muratsuchi By Lieu",33,0,5,0,38
510747,257852,2013-04-02,Assembly,"Do pass, to Consent Calendar",9,0,0,1,10
510747,260942,2013-04-08,Assembly,"AB 567 WAGNER  Consent Calendar Second Day  Regular Session",75,0,0,4,79
510747,286942,2013-06-04,Senate,"Do pass and be placed on the Consent Calendar",6,0,1,0,7
510747,287780,2013-06-10,Senate,"Consent Calendar 2nd AB567 Wagner",32,0,7,0,39
510748,261688,2013-04-09,Assembly,"Do pass as amended and be re-referred to the Committee on 	Appropriations",7,2,0,1,10
510748,283794,2013-05-24,Assembly,"Do pass as amended",12,5,0,0,17
510748,285528,2013-05-30,Assembly,"AB 566 WIECKOWSKI  Assembly Third Reading",51,25,0,3,79
510748,291581,2013-06-25,Senate,"Do pass as amended, and re-refer to the Committee on 	Appropriations",5,2,0,0,7
510748,297227,2013-08-12,Senate,"Placed on Appropriations Suspense file",6,0,1,0,7
510748,298182,2013-08-30,Senate,"Do pass as amended",5,2,0,0,7
510748,299589,2013-09-12,Senate,"Assembly 3rd Supp 2 AB566 Wieckowski By Leno",22,12,5,0,39
510748,299590,2013-09-12,Assembly,"AB 566 WIECKOWSKI  Concurrence in Senate Amendments",45,26,0,7,78
510751,267435,2013-04-16,Assembly,"Do pass as amended and be re-referred to the Committee on 	Appropriations",19,0,0,0,19
510751,277463,2013-05-08,Assembly,"Do pass, to Consent Calendar",17,0,0,0,17
510751,280302,2013-05-16,Assembly,"AB 565 SALAS  Consent Calendar Second Day  Regular Session",70,0,0,9,79
510751,292040,2013-06-26,Senate,"Do pass as amended, and re-refer to the Committee on 	Appropriations",9,0,0,0,9
510751,297419,2013-08-12,Senate,"Placed on Appropriations Suspense file",6,0,1,0,7
510751,298505,2013-08-30,Senate,"Do pass as amended",7,0,0,0,7
510751,299060,2013-09-09,Senate,"Assembly 3rd Reading AB565 Salas By Anderson",38,0,1,0,39
510751,299281,2013-09-10,Assembly,"AB 565 SALAS  Concurrence in Senate Amendments",78,0,0,0,78
510752,272924,2013-04-24,Assembly,"Do pass and be re-referred to the Committee on Housing and 	Community Development",9,0,0,0,9
510752,274932,2013-05-01,Assembly,"Do pass and be re-referred to the Committee on Appropriations",7,0,0,0,7
510752,284016,2013-05-24,Assembly,"Do pass",17,0,0,0,17
510752,285638,2013-05-30,Assembly,"AB 564 MULLIN  Assembly Third Reading",77,0,0,2,79
510752,291984,2013-06-26,Senate,"Do pass, but re-refer to the Committee on Appropriations",7,0,0,0,7
510752,297355,2013-08-12,Senate,"Placed on Appropriations Suspense file",6,0,1,0,7
510752,298473,2013-08-30,Senate,"Do pass",7,0,0,0,7
510752,299291,2013-09-10,Senate,"Assembly 3rd Reading AB564 Mullin By Roth",37,0,2,0,39
510752,299549,2013-09-11,Assembly,"AB 564 MULLIN  Concurrence in Senate Amendments",78,0,0,0,78
510756,278276,2013-05-08,Assembly,"Do pass",7,1,0,1,9
510756,283373,2013-05-23,Assembly,"AB 562 WILLIAMS  Assembly Third Reading",49,19,0,10,78
510756,291928,2013-06-26,Senate,"Do pass as amended",5,2,0,0,7
510756,298000,2013-08-26,Senate,"Assembly 3rd Reading AB562 Williams By Hueso",23,11,5,0,39
510756,298459,2013-08-30,Assembly,"AB 562 WILLIAMS  Concurrence in Senate Amendments",50,23,0,5,78
510758,277327,2013-05-08,Assembly,"Do pass and be re-referred to the Committee on Revenue and Taxation",5,2,0,2,9
510759,266356,2013-04-16,Assembly,"Do pass and be re-referred to the Committee on Appropriations",5,2,0,0,7
510762,275594,2013-05-01,Assembly,"Do pass and be re-referred to the Committee on Appropriations",7,0,0,0,7
510763,267717,2013-04-16,Assembly,"Do pass and be re-referred to the Committee on Appropriations",10,0,0,0,10
510763,275385,2013-05-01,Assembly,"Do pass, to Consent Calendar",17,0,0,0,17
510763,278701,2013-05-13,Assembly,"AB 557 YAMADA  Assembly Third Reading",75,0,0,4,79
510763,289045,2013-06-11,Senate,"Do pass, but re-refer to the Committee on Appropriations",7,0,0,0,7
510763,296201,2013-07-08,Senate,"Assembly 3rd Reading AB557 Yamada By Hueso",31,0,7,0,38
510763,297116,2013-08-08,Assembly,"AB 557 YAMADA  Concurrence in Senate Amendments",77,0,0,1,78
510765,261873,2013-04-09,Assembly,"Do pass as amended and be re-referred to the Committee on Labor and 	Employment",10,0,0,0,10
510765,272690,2013-04-24,Assembly,"Do pass and re-refer to Committee on Appropriations with 	recommendation:  To Consent Calendar",7,0,0,0,7
510765,277586,2013-05-08,Assembly,"Do pass, to Consent Calendar",17,0,0,0,17
510765,280350,2013-05-16,Assembly,"AB 556 SALAS  Consent Calendar Second Day  Regular Session",70,0,0,9,79
510765,288301,2013-06-11,Senate,"Do pass, but re-refer to the Committee on Appropriations",7,0,0,0,7
510765,299084,2013-09-09,Senate,"Assembly 3rd Reading AB556 Salas By Hueso",39,0,0,0,39
510765,299307,2013-09-10,Assembly,"AB 556 SALAS  Concurrence in Senate Amendments",78,0,0,0,78
510766,268444,2013-04-18,Assembly,"Be referred to Committee on Judiciary",9,0,0,2,11
510766,276764,2013-05-07,Assembly,"Do pass",10,0,0,0,10
510766,281247,2013-05-20,Assembly,"AB 555 SALAS  Assembly Third Reading",75,0,0,3,78
510766,288119,2013-06-11,Senate,"Do pass and be placed on the Consent Calendar",7,0,0,0,7
510766,291209,2013-06-24,Senate,"Consent Calendar 2nd AB555 Salas",39,0,0,0,39
510768,267531,2013-04-17,Assembly,"Do pass and be re-referred to the Committee on Appropriations",13,0,0,0,13
510768,275349,2013-05-01,Assembly,"Do pass, to Consent Calendar",17,0,0,0,17
510768,278264,2013-05-09,Assembly,"AB 554 MULLIN  Consent Calendar Second Day  Regular Session",75,0,0,4,79
510768,291732,2013-06-25,Senate,"Do pass, but re-refer to the Committee on Appropriations Recommend 	Consent",11,0,0,0,11
510768,297420,2013-08-12,Senate,"Do pass",5,0,2,0,7
510768,298081,2013-08-26,Senate,"Assembly 3rd Reading AB554 Mullin By Roth",39,0,0,0,39
510771,270840,2013-04-23,Assembly,"Do pass and be re-referred to the Committee on Appropriations",5,2,0,0,7
510771,277315,2013-05-08,Assembly,"Do pass",12,5,0,0,17
510771,285769,2013-05-30,Assembly,"AB 552 FONG  Assembly Third Reading",55,19,0,5,79
510771,296144,2013-07-02,Senate,"Do pass, but re-refer to the Committee on Appropriations",4,1,0,0,5
510771,298899,2013-09-06,Senate,"Assembly 3rd Reading AB552 Fong By Hill",28,10,1,0,39
510772,267295,2013-04-17,Assembly,"Do pass and be re-referred to the Committee on Local Government",7,0,0,0,7
510772,272282,2013-04-24,Assembly,"Do pass as amended and be re-referred to the Committee on 	Appropriations",7,0,0,2,9
510772,283770,2013-05-24,Assembly,"Do pass as amended",17,0,0,0,17
510772,285071,2013-05-29,Assembly,"AB 551 TING  Assembly Third Reading",75,0,0,4,79
510772,296009,2013-07-03,Senate,"Do pass as amended, and re-refer to the Committee on 	Appropriations",7,0,0,0,7
510772,297693,2013-08-19,Senate,"Placed on Appropriations Suspense file",7,0,0,0,7
510772,298241,2013-08-30,Senate,"Do pass as amended",7,0,0,0,7
510772,298975,2013-09-09,Senate,"Assembly 3rd Reading AB551 Ting By Beall",39,0,0,0,39
510772,299193,2013-09-10,Assembly,"AB 551 TING  Concurrence in Senate Amendments",69,6,0,3,78
510774,261857,2013-04-09,Assembly,"Do pass as amended and be re-referred to the Committee on 	Appropriations",6,1,0,2,9
510775,275586,2013-05-01,Assembly,"Do pass as amended and be re-referred to the Committee on 	Appropriations",7,0,0,0,7
510775,283796,2013-05-24,Assembly,"Do pass as amended",12,5,0,0,17
510775,285060,2013-05-29,Assembly,"AB 549 JONES-SAWYER  Assembly Third Reading",77,0,0,2,79
510775,295959,2013-07-03,Senate,"Do pass as amended",7,0,2,0,9
510775,297999,2013-08-26,Senate,"Assembly 3rd Reading AB549 Jones-Sawyer By Liu",36,1,2,0,39
510775,298297,2013-08-30,Assembly,"AB 549 JONES-SAWYER  Concurrence in Senate Amendments",78,0,0,0,78
510777,308683,2014-01-14,Assembly,"Do pass and be re-referred to the Committee on Appropriations",13,0,0,0,13
510777,311138,2014-01-23,Assembly,"Do pass, to Consent Calendar",16,0,0,1,17
510777,313854,2014-01-30,Assembly,"AB 548 SALAS  Assembly Third Reading",76,0,0,4,80
510777,365759,2014-05-14,Senate,"Do pass as amended, and re-refer to the Committee on Appropriations",7,0,2,0,9
510777,375691,2014-07-03,Senate,"Special Consent #18 AB548 Salas",35,0,5,0,40
510777,376370,2014-08-04,Assembly,"AB 548 SALAS  Concurrence in Senate Amendments",78,0,0,1,79
510778,259739,2013-04-03,Assembly,"Do pass as amended and re-refer to Committee on Appropriations 	with recommendation:  To Consent Calendar",7,0,0,0,7
510778,275233,2013-05-01,Assembly,"Do pass, to Consent Calendar",17,0,0,0,17
510778,277973,2013-05-09,Assembly,"AB 547 SALAS  Consent Calendar Second Day  Regular Session",75,0,0,4,79
510778,288631,2013-06-12,Senate,"Do pass as amended, but re-refer to the Committee on Appropriations 	Recommend Consent",9,0,0,0,9
510778,298854,2013-09-06,Senate,"Assembly 3rd Reading AB547 Salas By Wyland",38,0,1,0,39
510778,299064,2013-09-09,Assembly,"AB 547 SALAS  Concurrence in Senate Amendments",77,0,0,1,78
510781,268584,2013-04-17,Assembly,"Do pass",9,0,0,0,9
510781,272389,2013-04-25,Assembly,"AB 546 STONE  Assembly Third Reading",75,0,0,4,79
510781,287377,2013-06-05,Senate,"Do pass",7,0,0,0,7
510781,287789,2013-06-10,Senate,"Assembly 3rd Reading AB546 Stone By Monning",32,0,7,0,39
510782,267936,2013-04-16,Assembly,"Do pass as amended",7,0,0,0,7
510782,273530,2013-04-29,Assembly,"AB 545 MITCHELL  Assembly Third Reading",77,0,0,2,79
510782,288275,2013-06-11,Senate,"Do pass as amended, and re-refer to the Committee on Judiciary",6,0,0,0,6
510782,291653,2013-06-25,Senate,"Do pass",7,0,0,0,7
510782,297601,2013-08-15,Senate,"Assembly 3rd Reading AB545 Mitchell By Fuller",38,0,1,0,39
510782,297743,2013-08-19,Assembly,"AB 545 MITCHELL  Concurrence in Senate Amendments",76,0,0,2,78
510785,274248,2013-04-29,Assembly,"Do pass as amended and be re-referred to the Committee on 	Appropriations",6,3,0,0,9
510785,283860,2013-05-24,Assembly,"Do pass as amended",12,5,0,0,17
510785,286007,2013-05-31,Assembly,"AB 543 CAMPOS  Assembly Third Reading",52,24,0,3,79
510785,372767,2014-06-18,Senate,"Do pass as amended, and re-refer to the Committee on 	Appropriations",7,0,0,0,7
510785,376631,2014-08-04,Senate,"Placed on Appropriations Suspense file",7,0,0,0,7
510785,377236,2014-08-14,Senate,"Do pass",5,0,2,0,7
510785,378118,2014-08-21,Senate,"Assembly 3rd Reading AB543 Campos By Lara",31,3,6,0,40
510785,378292,2014-08-25,Assembly,"AB 543 CAMPOS  Concurrence in Senate Amendments",56,23,0,0,79
510788,267080,2013-04-15,Assembly,"Do pass as amended",16,0,0,0,16
510788,273693,2013-04-29,Assembly,"AB 541 DALY  Assembly Third Reading",77,0,0,2,79
510788,288043,2013-06-11,Senate,"Do pass as amended",10,1,0,0,11
510788,296191,2013-07-08,Senate,"Assembly 3rd Reading AB541 Daly By Correa",30,1,7,0,38
510788,297156,2013-08-08,Assembly,"AB 541 DALY  Concurrence in Senate Amendments",76,1,0,1,78
510790,270809,2013-04-23,Assembly,"Do pass as amended and be re-referred to the Committee on 	Appropriations",13,5,0,1,19
510790,284037,2013-05-24,Assembly,"Do pass as amended",12,0,0,5,17
510790,285016,2013-05-29,Assembly,"AB 540 PAN  Assembly Third Reading",53,23,0,3,79
510790,291894,2013-06-26,Senate,"Do pass, but re-refer to the Committee on Appropriations",7,2,0,0,9
510790,297339,2013-08-12,Senate,"Placed on Appropriations Suspense file",6,0,1,0,7
510792,270874,2013-04-23,Assembly,"Do pass as amended and be re-referred to the Committee on 	Appropriations",6,0,0,1,7
510792,283849,2013-05-24,Assembly,"Do pass",17,0,0,0,17
510792,285562,2013-05-30,Assembly,"AB 539 PAN  Assembly Third Reading",78,0,0,1,79
510792,291570,2013-06-25,Senate,"Do pass, but re-refer to the Committee on Appropriations",7,0,0,0,7
510792,297243,2013-08-12,Senate,"Placed on Appropriations Suspense file",6,0,1,0,7
510792,298197,2013-08-30,Senate,"Do pass as amended",7,0,0,0,7
510792,298945,2013-09-09,Senate,"Assembly 3rd Reading AB539 Pan By Knight",39,0,0,0,39
510792,299605,2013-09-12,Assembly,"AB 539 PAN  Concurrence in Senate Amendments",77,0,0,1,78
510792,299606,2013-09-12,Senate,"Assembly 3rd Reading AB539 Pan By Knight",35,0,4,0,39
510794,270770,2013-04-23,Assembly,"Do pass as amended and be re-referred to the Committee on 	Appropriations",4,2,0,1,7
510794,277350,2013-05-08,Assembly,"Do pass",12,5,0,0,17
510794,281256,2013-05-20,Assembly,"AB 538 PAN  Assembly Third Reading",50,23,0,5,78
510794,288029,2013-06-11,Senate,"Do pass, but re-refer to the Committee on Appropriations",5,2,0,0,7
510794,291186,2013-06-24,Senate,"Do pass",5,2,0,0,7
510794,298575,2013-09-03,Senate,"Assembly 3rd Reading AB538 Pan By De Le",22,14,3,0,39
510794,298800,2013-09-06,Assembly,"AB 538 PAN  Concurrence in Senate Amendments",52,26,0,0,78
510795,271494,2013-04-24,Assembly,"Do pass and be re-referred to the Committee on Appropriations",5,2,0,0,7
510795,283845,2013-05-24,Assembly,"Do pass",12,5,0,0,17
510795,285534,2013-05-30,Assembly,"AB 537 BONTA  Assembly Third Reading",54,24,0,1,79
510795,291211,2013-06-24,Senate,"Do pass, but re-refer to the Committee on Appropriations",3,2,0,0,5
510795,297652,2013-08-19,Senate,"Placed on Appropriations Suspense file",7,0,0,0,7
510795,298282,2013-08-30,Senate,"Do pass as amended",5,2,0,0,7
510795,299443,2013-09-11,Senate,"Assembly 3rd Reading AB537 Bonta By Beall",26,11,2,0,39
510795,299675,2013-09-12,Assembly,"AB 537 BONTA  Concurrence in Senate Amendments",53,24,0,1,78
510797,308687,2014-01-14,Assembly,"Do pass and be re-referred to the Committee on Judiciary",14,0,0,0,14
510798,257861,2013-04-02,Assembly,"Do pass as amended and re-refer to Committee on Appropriations 	with recommendation:  To Consent Calendar",7,0,0,0,7
510798,267510,2013-04-17,Assembly,"Do pass, to Consent Calendar",17,0,0,0,17
510798,272423,2013-04-25,Assembly,"AB 535 QUIRK  Consent Calendar Second Day  Regular Session",76,0,0,3,79
510798,286863,2013-06-04,Senate,"Do pass, but re-refer to the Committee on Appropriations",7,0,0,0,7
510798,291370,2013-06-24,Senate,"Do pass",7,0,0,0,7
510798,298050,2013-08-26,Senate,"Assembly 3rd Reading AB535 Quirk By Hancock",39,0,0,0,39
510798,298361,2013-08-30,Assembly,"AB 535 QUIRK  Concurrence in Senate Amendments",78,0,0,0,78
510799,271602,2013-04-23,Assembly,"Do pass as amended and be re-referred to the Committee on 	Appropriations",8,4,0,1,13
510801,271786,2013-04-23,Assembly,"Do pass and be re-referred to the Committee on Labor and Employment",6,0,0,1,7
510801,278152,2013-05-08,Assembly,"Do pass, to Consent Calendar",7,0,0,0,7
510801,280387,2013-05-16,Assembly,"AB 533 CALDERON  Consent Calendar Second Day  Regular Session",70,0,0,9,79
510801,288045,2013-06-11,Senate,"Do pass and be placed on the Consent Calendar",7,0,0,0,7
510801,291247,2013-06-24,Senate,"Consent Calendar 2nd AB533 Ian Calderon",39,0,0,0,39
510801,292181,2013-06-27,Assembly,"AB 533 CALDERON  Concurrence in Senate Amendments",76,0,0,3,79
510802,259232,2013-04-03,Assembly,"Do pass as amended and be re-referred to the Committee on 	Appropriations",7,0,0,0,7
510802,283984,2013-05-24,Assembly,"Do pass",17,0,0,0,17
510802,284701,2013-05-28,Assembly,"AB 532 GORDON  Third Reading Urgency",77,1,0,1,79
510802,295862,2013-07-02,Senate,"Do pass as amended, and re-refer to the Committee on 	Appropriations",11,0,0,0,11
510802,297366,2013-08-12,Senate,"Placed on Appropriations Suspense file",6,0,1,0,7
510802,298330,2013-08-30,Senate,"Do pass as amended",7,0,0,0,7
510802,299254,2013-09-10,Senate,"Assembly 3rd Reading AB532 Gordon Urgency Clause",36,0,3,0,39
510802,299517,2013-09-11,Assembly,"AB 532 GORDON  Concurrence in Senate Amendments",77,1,0,0,78
510804,261967,2013-04-08,Assembly,"Do pass and be re-referred to the Committee on Appropriations",16,0,0,0,16
510805,277014,2013-05-07,Assembly,"Do pass",5,1,0,1,7
510805,285445,2013-05-29,Assembly,"AB 530 QUIRK-SILVA  Assembly Third Reading  Amend By HAGMAN  Set #1 	Motion to  Lay on the Table  By ATKINS",52,25,0,2,79
510805,285669,2013-05-30,Assembly,"AB 530 QUIRK-SILVA  Assembly Third Reading",51,26,0,2,79
510805,296073,2013-07-02,Senate,"Do pass",4,1,0,0,5
510805,298111,2013-08-26,Senate,"Assembly 3rd Reading AB530 Quirk-Silva By Torres",27,12,0,0,39
510807,274330,2013-04-29,Assembly,"Do pass and be re-referred to the Committee on Appropriations",15,0,0,1,16
510807,279897,2013-05-15,Assembly,"Do pass",17,0,0,0,17
510807,283276,2013-05-23,Assembly,"AB 529 LOWENTHAL  Assembly Third Reading",73,1,0,4,78
510807,295804,2013-07-02,Senate,"Do pass, but re-refer to the Committee on Appropriations",11,0,0,0,11
510807,297732,2013-08-19,Senate,"Placed on Appropriations Suspense file",7,0,0,0,7
510807,298280,2013-08-30,Senate,"Do pass as amended",7,0,0,0,7
510807,299091,2013-09-09,Senate,"Assembly 3rd Reading AB529 Lowenthal By Gaines",39,0,0,0,39
510807,299214,2013-09-10,Assembly,"AB 529 LOWENTHAL  Concurrence in Senate Amendments",75,2,0,1,78
510809,270077,2013-04-22,Assembly,"Do pass as amended and be re-referred to the Committee on 	Appropriations",14,2,0,0,16
510809,277485,2013-05-08,Assembly,"Do pass",13,4,0,0,17
510809,281245,2013-05-20,Assembly,"AB 528 LOWENTHAL  Assembly Third Reading",53,20,0,5,78
510809,288140,2013-06-11,Senate,"Do pass, but re-refer to the Committee on Appropriations",10,0,1,0,11
510809,297771,2013-08-19,Senate,"Assembly 3rd Reading AB528 Lowenthal By DeSaulnier",29,8,2,0,39
510809,297966,2013-08-22,Assembly,"AB 528 LOWENTHAL  Concurrence in Senate Amendments",58,19,0,1,78
510811,274597,2013-04-29,Assembly,"Do pass and be re-referred to the Committee on Judiciary",8,0,0,1,9
510811,275640,2013-05-02,Assembly,"Do pass as amended and be re-referred to the Committee on 	Appropriations",10,0,0,0,10
510811,284025,2013-05-24,Assembly,"Do pass",17,0,0,0,17
510811,285603,2013-05-30,Assembly,"AB 527 GAINES  Assembly Third Reading",76,0,0,3,79
510811,291974,2013-06-26,Senate,"Do pass, but re-refer to the Committee on Appropriations",9,0,0,0,9
510811,298667,2013-09-03,Senate,"Assembly 3rd Reading AB527 Beth Gaines By Fuller",37,0,2,0,39
510812,258753,2013-04-02,Assembly,"Do pass and be re-referred to the Committee on Health",9,0,0,1,10
510812,267202,2013-04-17,Assembly,"Do pass, to Consent Calendar",17,0,0,0,17
510812,272352,2013-04-25,Assembly,"AB 526 MELENDEZ  Consent Calendar Second Day  Regular Session",76,0,0,3,79
510812,289021,2013-06-11,Senate,"Do pass, but re-refer to the Committee on Judiciary",7,0,0,0,7
510812,291795,2013-06-25,Senate,"Do pass, but re-refer to the Committee on Appropriations Recommend 	Consent",7,0,0,0,7
510812,297548,2013-08-15,Senate,"Consent Calendar 2nd AB526 Melendez",38,0,1,0,39
510812,297706,2013-08-19,Assembly,"AB 526 MELENDEZ  Concurrence in Senate Amendments",77,0,0,1,78
510814,272361,2013-04-24,Assembly,"Do pass as amended and be re-referred to the Committee on 	Appropriations",17,0,0,0,17
510814,277344,2013-05-08,Assembly,"Do pass, to Consent Calendar",17,0,0,0,17
510814,281294,2013-05-20,Assembly,"AB 525 TING  Assembly Third Reading",74,0,0,4,78
510814,291658,2013-06-25,Senate,"Do pass, but re-refer to the Committee on Appropriations",10,0,1,0,11
510814,297554,2013-08-15,Senate,"Assembly 3rd Reading AB525 Ting By Leno",38,0,1,0,39
510814,297779,2013-08-19,Assembly,"AB 525 TING  Concurrence in Senate Amendments",77,0,0,1,78
510815,257395,2013-04-02,Assembly,"Do pass and be re-referred to the Committee on Appropriations",5,2,0,0,7
510815,283792,2013-05-24,Assembly,"Do pass as amended",13,4,0,0,17
510815,284962,2013-05-29,Assembly,"AB 524 MULLIN  Assembly Third Reading",55,18,0,6,79
510815,291531,2013-06-25,Senate,"Do pass, but re-refer to the Committee on Appropriations",5,2,0,0,7
510815,297274,2013-08-12,Senate,"Placed on Appropriations Suspense file",6,0,1,0,7
510815,298251,2013-08-30,Senate,"Do pass",5,2,0,0,7
510815,298954,2013-09-09,Senate,"Assembly 3rd Reading AB524 Mullin By Correa",29,8,2,0,39
510817,259244,2013-04-03,Assembly,"Do pass and be re-referred to the Committee on Appropriations",5,1,0,1,7
510817,284080,2013-05-24,Assembly,"Do pass as amended",12,5,0,0,17
510817,285218,2013-05-29,Assembly,"AB 523 AMMIANO  Assembly Third Reading",53,24,0,2,79
510817,289422,2013-06-18,Senate,"Do pass as amended, and re-refer to the Committee on 	Appropriations",8,2,1,0,11
510817,297383,2013-08-12,Senate,"Placed on Appropriations Suspense file",6,0,1,0,7
510817,298514,2013-08-30,Senate,"Do pass as amended",5,2,0,0,7
510817,375308,2014-06-30,Senate,"Assembly 3rd Reading AB523 Ammiano By Leno",25,10,5,0,40
510817,377756,2014-08-19,Senate,"Assembly 3rd Reading AB523 Ammiano By Leno",22,10,8,0,40
510817,378012,2014-08-21,Assembly,"AB 523 AMMIANO  Concurrence in Senate Amendments",54,23,0,2,79
510818,257435,2013-04-02,Assembly,"Do pass as amended, to Consent Calendar",9,0,0,1,10
510818,265797,2013-04-15,Assembly,"AB 522 BLOOM  Consent Calendar Second Day  Regular Session",77,0,0,2,79
510818,286862,2013-06-04,Senate,"Do pass and be placed on the Consent Calendar",6,0,1,0,7
510818,287802,2013-06-10,Senate,"Consent Calendar 2nd AB522 Bloom",32,0,7,0,39
510818,289058,2013-06-14,Assembly,"AB 522 BLOOM  Concurrence in Senate Amendments",77,0,0,2,79
510820,274086,2013-04-29,Assembly,"Do pass as amended and be re-referred to the Committee on 	Appropriations",5,3,0,1,9
510821,308287,2014-01-13,Assembly,"Do pass and re-refer to Committee on Appropriations with 	recommendation:  To Consent Calendar",15,0,0,4,19
510821,311194,2014-01-23,Assembly,"Do pass, to Consent Calendar",16,0,0,1,17
510821,313241,2014-01-29,Assembly,"AB 520 CHESBRO  Consent Calendar Second Day  Regular Session",78,0,0,2,80
510821,374135,2014-06-24,Senate,"Do pass, but re-refer to the Committee on Appropriations",10,0,0,0,10
510821,377456,2014-08-14,Senate,"Assembly 3rd Reading AB520 Chesbro By Galgiani",34,0,6,0,40
510821,377704,2014-08-18,Assembly,"AB 520 CHESBRO  Concurrence in Senate Amendments",78,0,0,1,79
510824,262710,2013-04-09,Assembly,"Do pass as amended and be re-referred to the Committee on Aging and 	Long",19,0,0,0,19
510824,270952,2013-04-23,Assembly,"Do pass",7,0,0,0,7
510824,277812,2013-05-08,Assembly,"Do pass, to Consent Calendar",17,0,0,0,17
510824,281215,2013-05-20,Assembly,"AB 518 YAMADA  Assembly Third Reading",74,0,0,4,78
510826,263573,2013-04-10,Assembly,"Do pass and re-refer to Committee on Appropriations with 	recommendation:  To Consent Calendar",7,0,0,0,7
510830,305799,2014-01-06,Assembly,"Be referred to Committee on Natural Resources",9,0,0,1,10
510830,308272,2014-01-13,Assembly,"Do pass and be re-referred to the Committee on Judiciary",6,0,0,3,9
510830,308598,2014-01-14,Assembly,"Do pass and be re-referred to the Committee on Appropriations",9,0,0,1,10
510830,311205,2014-01-23,Assembly,"Do pass",15,0,0,2,17
510830,312232,2014-01-27,Assembly,"AB 515 DICKINSON  Assembly Third Reading",64,4,0,12,80
510831,275841,2013-05-01,Assembly,"Do pass as amended and re-refer to Committee on Appropriations 	with recommendation:  To Consent Calendar",7,0,0,0,7
510831,279728,2013-05-15,Assembly,"Do pass, to Consent Calendar",17,0,0,0,17
510831,283390,2013-05-23,Assembly,"AB 514 BONTA  Consent Calendar Second Day  Regular Session",74,0,0,4,78
510831,289963,2013-06-19,Senate,"Do pass as amended, and re-refer to the Committee on Appropriations",9,0,0,0,9
510831,298802,2013-09-06,Senate,"Assembly 3rd Reading AB514 Bonta By Torres",38,0,1,0,39
510831,299017,2013-09-09,Assembly,"AB 514 BONTA  Concurrence in Senate Amendments",78,0,0,0,78
510832,266384,2013-04-15,Assembly,"Do pass as amended and be re-referred to the Committee on 	Appropriations",9,0,0,0,9
510832,283747,2013-05-24,Assembly,"Do pass as amended",13,3,0,1,17
510832,285037,2013-05-29,Assembly,"AB 513 FRAZIER  Assembly Third Reading",64,12,0,3,79
510832,295980,2013-07-03,Senate,"Do pass as amended, and re-refer to the Committee on 	Appropriations",8,1,0,0,9
510832,297665,2013-08-19,Senate,"Placed on Appropriations Suspense file",7,0,0,0,7
510832,298310,2013-08-30,Senate,"Do pass as amended",6,1,0,0,7
510832,299429,2013-09-11,Assembly,"AB 513 FRAZIER  Concurrence in Senate Amendments",63,13,0,2,78
510832,299430,2013-09-11,Senate,"Assembly 3rd Reading AB513 Frazier By Cannella",32,5,2,0,39
510834,262053,2013-04-09,Assembly,"Do pass and be re-referred to the Committee on Appropriations",13,0,0,0,13
510834,267588,2013-04-17,Assembly,"Do pass",16,0,0,1,17
510834,272494,2013-04-25,Assembly,"AB 512 RENDON  Assembly Third Reading",74,0,0,5,79
510834,287779,2013-06-10,Senate,"Do pass, but re-refer to the Committee on Appropriations",10,0,0,0,10
510834,291232,2013-06-24,Senate,"Do pass",7,0,0,0,7
510834,296187,2013-07-08,Senate,"Assembly 3rd Reading AB512 Rendon By Lieu",33,0,5,0,38
510835,257107,2013-04-01,Assembly,"Do pass as amended and be re-referred to the Committee on 	Appropriations",9,0,0,0,9
510835,267572,2013-04-17,Assembly,"Do pass, to Consent Calendar",17,0,0,0,17
510835,272391,2013-04-25,Assembly,"AB 511 PAN  Consent Calendar Second Day  Regular Session",76,0,0,3,79
510835,291923,2013-06-26,Senate,"Do pass, but re-refer to the Committee on Appropriations",7,0,0,0,7
510835,297433,2013-08-12,Senate,"Do pass",5,0,2,0,7
510835,298110,2013-08-26,Senate,"Assembly 3rd Reading AB511 Pan By DeSaulnier",39,0,0,0,39
510835,298295,2013-08-30,Assembly,"AB 511 PAN  Concurrence in Senate Amendments",78,0,0,0,78
510838,309130,2014-01-15,Assembly,"Do pass and be re-referred to the Committee on Appropriations",5,1,0,1,7
510838,311148,2014-01-23,Assembly,"Do pass",12,2,0,3,17
510838,313969,2014-01-30,Assembly,"AB 510 AMMIANO  Assembly Third Reading",58,16,0,6,80
510838,372434,2014-06-17,Senate,"Do pass, but re-refer to the Committee on Appropriations",4,0,1,0,5
510838,377735,2014-08-18,Senate,"Assembly 3rd Reading AB510 Ammiano By Hill",27,9,4,0,40
510838,378025,2014-08-21,Assembly,"AB 510 AMMIANO  Concurrence in Senate Amendments",60,19,0,0,79
510841,258018,2013-04-02,Assembly,"Do pass as amended and be re-referred to the Committee on 	Appropriations",9,0,0,1,10
510841,267570,2013-04-17,Assembly,"Do pass",17,0,0,0,17
510841,270000,2013-04-22,Assembly,"AB 508 CALDERON  Assembly Third Reading",77,0,0,2,79
510841,279329,2013-05-14,Senate,"Do pass, but re-refer to the Committee on Rules",7,0,0,0,7
510841,297607,2013-08-15,Senate,"Assembly 3rd Reading AB508 Ian Calderon By Hueso",37,0,2,0,39
510841,297773,2013-08-19,Assembly,"AB 508 CALDERON  Concurrence in Senate Amendments",75,0,0,3,78
510842,262924,2013-04-10,Assembly,"Do pass and be re-referred to the Committee on Appropriations",4,2,0,1,7
510844,267524,2013-04-16,Assembly,"Do pass and be re-referred to the Committee on Judiciary",5,0,0,2,7
510844,274079,2013-04-30,Assembly,"Do pass as amended",10,0,0,0,10
510844,276268,2013-05-06,Assembly,"AB 506 MITCHELL  Assembly Third Reading",77,0,0,2,79
510844,288019,2013-06-11,Senate,"Do pass as amended, and re-refer to the Committee on Judiciary",6,0,0,0,6
510844,291596,2013-06-25,Senate,"Do pass as amended",7,0,0,0,7
510844,296203,2013-07-08,Senate,"Assembly 3rd Reading AB506 Mitchell By Liu",33,0,5,0,38
510844,297111,2013-08-08,Assembly,"AB 506 MITCHELL  Concurrence in Senate Amendments",76,0,0,2,78
510845,270967,2013-04-23,Assembly,"Do pass and re-refer to Committee on Appropriations with 	recommendation:  To Consent Calendar",18,0,0,1,19
510845,277600,2013-05-08,Assembly,"Do pass",17,0,0,0,17
510845,280337,2013-05-16,Assembly,"AB 505 NAZARIAN  Assembly Third Reading",72,0,0,7,79
510845,288429,2013-06-12,Senate,"Do pass as amended, and re-refer to the Committee on 	Appropriations",6,2,1,0,9
510845,291333,2013-06-24,Senate,"Do pass",7,0,0,0,7
510845,376385,2014-08-04,Senate,"Assembly 3rd Reading AB505 Nazarian By Hernandez",32,3,5,0,40
510845,377867,2014-08-19,Assembly,"AB 505 NAZARIAN  Concurrence in Senate Amendments",77,0,0,2,79
510847,305730,2014-01-06,Assembly,"Be referred to Committee on Water, Parks and Wildlife",9,0,0,1,10
510847,308635,2014-01-14,Assembly,"Do pass and be re-referred to the Committee on Appropriations",15,0,0,0,15
510847,311276,2014-01-23,Assembly,"Do pass, to Consent Calendar",16,0,0,1,17
510847,313217,2014-01-29,Assembly,"AB 504 CHESBRO  Assembly Third Reading",75,1,0,4,80
510847,373993,2014-06-24,Senate,"Do pass as amended, and re-refer to the Committee on Appropriations",7,2,0,0,9
510847,376449,2014-08-04,Senate,"Do pass",5,2,0,0,7
510847,378534,2014-08-26,Senate,"Assembly 3rd Reading AB504 Chesbro By Padilla",25,10,5,0,40
510847,378779,2014-08-27,Assembly,"AB 504 CHESBRO  Concurrence in Senate Amendments",58,19,0,2,79
510848,275629,2013-05-01,Assembly,"Do pass and be re-referred to the Committee on Appropriations",10,3,0,0,13
510848,283905,2013-05-24,Assembly,"Do pass as amended",17,0,0,0,17
510848,285012,2013-05-29,Assembly,"AB 503 WIECKOWSKI  Assembly Third Reading",58,18,0,3,79
510848,291563,2013-06-25,Senate,"Do pass, but re-refer to the Committee on Appropriations",7,3,1,0,11
510848,297410,2013-08-12,Senate,"Placed on Appropriations Suspense file",6,0,1,0,7
510848,374892,2014-06-25,Senate,"Do pass as amended, and re-refer to the Committee on 	Appropriations",6,2,1,0,9
510848,376588,2014-08-04,Senate,"Placed on Appropriations Suspense file",7,0,0,0,7
510850,274275,2013-04-30,Assembly,"Do pass as amended and be re-referred to the Committee on 	Appropriations",6,4,0,0,10
510850,284023,2013-05-24,Assembly,"Do pass as amended",17,0,0,0,17
510850,285120,2013-05-29,Assembly,"AB 502 WAGNER  Assembly Third Reading",77,0,0,2,79
510850,296015,2013-07-02,Senate,"Do pass, but re-refer to the Committee on Appropriations",6,0,1,0,7
510850,297248,2013-08-12,Senate,"Placed on Appropriations Suspense file",6,0,1,0,7
510850,298214,2013-08-30,Senate,"Do pass",7,0,0,0,7
510850,298947,2013-09-09,Senate,"Assembly 3rd Reading AB502 Wagner By Corbett",38,0,1,0,39
510850,299166,2013-09-10,Assembly,"AB 502 WAGNER  Concurrence in Senate Amendments",76,2,0,0,78
510851,270144,2013-04-22,Assembly,"Do pass and be re-referred to the Committee on Appropriations",16,0,0,0,16
510851,277369,2013-05-08,Assembly,"Do pass as amended, to Consent Calendar",17,0,0,0,17
510851,280316,2013-05-16,Assembly,"AB 501 NAZARIAN  Consent Calendar Second Day  Regular Session",70,0,0,9,79
510851,289466,2013-06-18,Senate,"Do pass, but re-refer to the Committee on Appropriations Recommend 	Consent",10,0,1,0,11
510851,295999,2013-07-03,Senate,"Do pass as amended, but re-refer to the Committee on 	Appropriations Recommend Consent",9,0,0,0,9
510851,299010,2013-09-09,Senate,"Assembly 3rd Reading AB501 Nazarian By Hueso",39,0,0,0,39
510851,299330,2013-09-10,Assembly,"AB 501 NAZARIAN  Concurrence in Senate Amendments",78,0,0,0,78
510853,257353,2013-04-02,Assembly,"Do pass and be re-referred to the Committee on Appropriations",5,2,0,0,7
510853,283866,2013-05-24,Assembly,"Do pass as amended",12,5,0,0,17
510853,284992,2013-05-29,Assembly,"AB 500 AMMIANO  Assembly Third Reading  Amend By MORRELL  Set #1 	Motion to  Lay on the Table  By ATKINS",50,24,0,5,79
510853,284993,2013-05-29,Assembly,"AB 500 AMMIANO  Assembly Third Reading  Amend By HAGMAN  Set #2 	Motion to  Lay on the Table  By ATKINS",50,25,0,4,79
510853,284994,2013-05-29,Assembly,"AB 500 AMMIANO  Assembly Third Reading",47,28,0,4,79
510853,295816,2013-07-02,Senate,"Do pass, but re-refer to the Committee on Appropriations",5,2,0,0,7
510853,297294,2013-08-12,Senate,"Do pass",4,1,2,0,7
510853,298977,2013-09-09,Senate,"Assembly 3rd Reading AB500 Ammiano By Hancock",24,14,1,0,39
510853,299107,2013-09-10,Assembly,"AB 500 AMMIANO  Concurrence in Senate Amendments",47,29,0,2,78
510854,261874,2013-04-09,Assembly,"Do pass as amended",10,0,0,0,10
510854,268686,2013-04-18,Assembly,"AB 499 TING  Assembly Third Reading",76,0,0,3,79
510854,286884,2013-06-04,Senate,"Do pass as amended",6,0,1,0,7
510854,296214,2013-07-08,Senate,"Assembly 3rd Reading AB499 Ting By Evans",33,0,5,0,38
510854,297147,2013-08-08,Assembly,"AB 499 TING  Concurrence in Senate Amendments",77,0,0,1,78
510856,274206,2013-04-30,Assembly,"Do pass as amended and be re-referred to the Committee on 	Appropriations",18,0,0,1,19
510856,279902,2013-05-15,Assembly,"Do pass",17,0,0,0,17
510856,283328,2013-05-23,Assembly,"AB 498 CHAVEZ  Assembly Third Reading",74,0,0,4,78
510856,296040,2013-07-03,Senate,"Do pass as amended, and re-refer to the Committee on 	Appropriations",9,0,0,0,9
510856,297738,2013-08-19,Senate,"Placed on Appropriations Suspense file",7,0,0,0,7
510856,298348,2013-08-30,Senate,"Do pass",7,0,0,0,7
510856,299519,2013-09-11,Senate,"From Committee:  That the measure be returned to the Senate floor 	for consideration",7,0,0,0,7
510856,299768,2013-09-11,Senate,"That the Assembly amendments be concurred in, but first be 	re-referred to the Committee on Appropriations",7,0,2,0,9
510856,299769,2013-09-12,Assembly,"Senate amendments be concurred in",18,0,0,1,19
510856,299770,2013-09-12,Assembly,"AB 498 CHAVEZ  Concurrence in Senate Amendments",77,0,0,1,78
510856,299771,2013-09-12,Senate,"Assembly 3rd Reading AB498 Ch",34,0,5,0,39
510857,266616,2013-04-16,Assembly,"Do pass and re-refer to Committee on Appropriations with 	recommendation:  To Consent Calendar",15,0,0,0,15
510857,279726,2013-05-15,Assembly,"Do pass, to Consent Calendar",17,0,0,0,17
510857,283239,2013-05-23,Assembly,"AB 497 CHESBRO  Consent Calendar Second Day  Regular Session",74,0,0,4,78
510857,291612,2013-06-25,Senate,"Do pass as amended, but re-refer to the Committee on Appropriations 	Recommend Consent",9,0,0,0,9
510857,297683,2013-08-19,Senate,"Consent Calendar 2nd AB497 Chesbro",37,0,2,0,39
510857,297906,2013-08-22,Assembly,"AB 497 CHESBRO  Concurrence in Senate Amendments",78,0,0,0,78
510859,266549,2013-04-16,Assembly,"Do pass and be re-referred to the Committee on Appropriations",10,1,0,2,13
510859,283921,2013-05-24,Assembly,"Do pass",12,5,0,0,17
510859,284675,2013-05-28,Assembly,"AB 496 GORDON  Assembly Third Reading",54,20,0,5,79
510859,295596,2013-07-01,Senate,"Do pass, but re-refer to the Committee on Appropriations",8,2,0,0,10
510859,376795,2014-08-07,Senate,"Assembly 3rd Reading AB496 Gordon By Lara",25,10,5,0,40
510859,377895,2014-08-20,Assembly,"Senate amendments be concurred in",11,1,0,2,14
510859,378083,2014-08-21,Assembly,"AB 496 GORDON  Concurrence in Senate Amendments",60,12,0,7,79
510860,306120,2014-01-06,Assembly,"Do pass as amended and be re-referred to the Committee on Housing 	and Community Development",9,0,0,3,12
510860,311265,2014-01-23,Assembly,"Do pass as amended",12,3,0,2,17
510860,311580,2014-01-15,Assembly,"Do pass and be re-referred to the Committee on Appropriations",6,1,0,0,7
510860,313203,2014-01-29,Assembly,"AB 495 CAMPOS  Assembly Third Reading",55,17,0,8,80
510860,374221,2014-06-23,Senate,"Do pass as amended, and re-refer to the Committee on 	Appropriations",7,1,1,0,9
510860,376486,2014-08-04,Senate,"Placed on Appropriations Suspense file",7,0,0,0,7
510862,257382,2013-04-02,Assembly,"Do pass and be re-referred to the Committee on Appropriations",7,0,0,0,7
510862,262586,2013-04-10,Assembly,"Do pass, to Consent Calendar",17,0,0,0,17
510862,268753,2013-04-18,Assembly,"AB 494 PEREZ, V.M.  Consent Calendar Second Day  Regular Session",76,0,0,3,79
510862,279336,2013-05-14,Senate,"Do pass as amended, and re-refer to the Committee on Appropriations",7,0,0,0,7
510862,298609,2013-09-03,Senate,"Assembly 3rd Reading AB494 V. Manuel P",37,0,2,0,39
510862,298832,2013-09-06,Assembly,"AB 494 PEREZ, V.M.  Concurrence in Senate Amendments",78,0,0,0,78
510863,267095,2013-04-15,Assembly,"Do pass as amended",16,0,0,0,16
510863,272386,2013-04-25,Assembly,"AB 493 DALY  Assembly Third Reading",74,1,0,4,79
510863,286973,2013-06-04,Senate,"Do pass",10,0,1,0,11
510863,295363,2013-07-01,Senate,"Assembly 3rd Reading AB493 Daly By DeSaulnier",36,0,2,0,38
510864,261750,2013-04-09,Assembly,"Do pass, to Consent Calendar",6,0,0,1,7
510864,268715,2013-04-18,Assembly,"AB 492 QUIRK  Consent Calendar Second Day",76,0,0,3,79
510864,279301,2013-05-14,Senate,"Do pass",7,0,0,0,7
510864,287752,2013-06-10,Senate,"Assembly 3rd Reading AB492 Quirk By Block",29,0,10,0,39
512062,268703,2013-04-18,Senate,"Senate 3rd Reading SJR5 Berryhill",36,0,2,0,38
512062,289379,2013-06-18,Assembly,"Be adopted, to Consent Calendar",14,0,0,1,15
512062,290215,2013-06-20,Assembly,"SJR5 Berryhill, T.  Consent Calendar Second Day  Regular Session",79,0,0,0,79
512063,249202,2013-03-14,Senate,"Senate 3rd Reading SJR4 Monning",32,0,5,0,37
512063,277510,2013-05-07,Assembly,"From committee:  Be adopted.  To third reading",6,0,0,1,7
512063,278736,2013-05-13,Assembly,"SJR4 Monning  Senate Third Reading  By YAMADA",71,0,0,8,79
512063,280369,2013-05-16,Senate,"Unfinished Business SJR4 Monning Concurrence",35,0,3,0,38
512064,237087,2013-02-25,Senate,"W/O REF. TO FILE SJR3 Knight",28,0,9,0,37
512066,257448,2013-04-02,Senate,"Be adopted, but re-refer to the Committee on Appropriations 	Recommend Consent",11,0,0,0,11
512066,268769,2013-04-18,Senate,"Consent Calendar 2nd SCR13 Nielsen",36,0,2,0,38
512066,297211,2013-08-12,Assembly,"Be adopted, and re-refer to Committee on Appropriations with 	recommendation:  To Consent Calendar",15,0,0,1,16
512066,297838,2013-08-21,Assembly,"Be adopted, to Consent Calendar",17,0,0,0,17
512066,298007,2013-08-26,Assembly,"SCR 13 Nielsen  Consent Calendar Second Day  Regular Session",77,0,0,1,78
512067,262906,2013-04-10,Senate,"Do pass as amended, and re-refer to the Committee on 	Appropriations",9,0,0,0,9
512067,285186,2013-05-29,Senate,"Senate 3rd Reading SB535 Nielsen",37,2,0,0,39
512067,296117,2013-07-02,Assembly,"Do pass and be re-referred to the Committee on Appropriations",18,0,0,1,19
512067,297484,2013-08-14,Assembly,"Do pass, to Consent Calendar",17,0,0,0,17
512067,298643,2013-09-03,Assembly,"SB 535 Nielsen  Senate Third Reading  By CHESBRO",77,0,0,1,78
512069,267456,2013-04-17,Senate,"Do pass, but re-refer to the Committee on Human Services",8,0,1,0,9
512069,270708,2013-04-23,Senate,"Do pass, but re-refer to the Committee on Appropriations",6,0,0,0,6
512069,278553,2013-05-13,Senate,"Special Consent #4 SB534 Hernandez",34,0,4,0,38
512069,296124,2013-07-02,Assembly,"Do pass and be re-referred to the Committee on Aging and Long",19,0,0,0,19
512069,297078,2013-08-06,Assembly,"Do pass and be re-referred to the Committee on Appropriations",6,0,0,1,7
512069,298522,2013-08-30,Assembly,"Do pass",17,0,0,0,17
512069,298713,2013-09-04,Assembly,"SB 534 Hernandez  Senate Third Reading  Amend By COOLEY  Set #1",54,21,0,3,78
512069,299278,2013-09-10,Assembly,"Do pass",17,0,0,2,19
512069,299777,2013-09-12,Assembly,"SB 534 Hernandez  Senate Third Reading  By COOLEY",76,0,0,2,78
512069,299778,2013-09-12,Senate,"Unfinished Supp 2 SB534 Hernandez Concurrence",38,0,1,0,39
512070,271102,2013-04-23,Senate,"Do pass, but re-refer to the Committee on Appropriations",9,0,2,0,11
512070,278559,2013-05-13,Senate,"Special Consent #4 SB533 Knight",34,0,4,0,38
512074,275609,2013-05-01,Senate,"Do pass, but re-refer to the Committee on Appropriations",2,3,4,0,9
512075,271552,2013-04-23,Senate,"Do pass, but re-refer to the Committee on Appropriations",5,2,0,0,7
512075,276284,2013-05-06,Senate,"Placed on Appropriations Suspense file",7,0,0,0,7
512075,283240,2013-05-23,Senate,"Do pass as amended",5,2,0,0,7
512075,285013,2013-05-29,Senate,"Senate 3rd Reading SB530 Wright",26,10,3,0,39
512075,291593,2013-06-25,Assembly,"Do pass and be re-referred to the Committee on Appropriations",6,3,0,1,10
512075,295942,2013-07-03,Assembly,"Do pass",12,5,0,0,17
512075,298701,2013-09-04,Assembly,"SB 530 Wright  Senate Third Reading  By BRADFORD",50,27,0,1,78
512075,298793,2013-09-06,Senate,"Unfinished Business SB530 Wright Concurrence",22,13,4,0,39
512078,267351,2013-04-17,Senate,"Do pass, but re-refer to the Committee on Appropriations",5,3,1,0,9
512078,273535,2013-04-29,Senate,"Placed on Appropriations Suspense file",7,0,0,0,7
512079,261729,2013-04-09,Senate,"Do pass as amended, and re-refer to the Committee on Judiciary",6,0,0,0,6
512079,271516,2013-04-23,Senate,"Do pass, but re-refer to the Committee on Education",6,1,0,0,7
512079,275525,2013-05-01,Senate,"Do pass as amended, and re-refer to the Committee on Appropriations",8,0,1,0,9
512079,281225,2013-05-20,Senate,"Placed on Appropriations Suspense file",6,0,1,0,7
512079,283130,2013-05-23,Senate,"Do pass as amended",6,0,1,0,7
512079,284942,2013-05-29,Senate,"Senate 3rd Reading SB528 Yee",34,2,3,0,39
512079,289381,2013-06-18,Assembly,"Do pass as amended and be re-referred to the Committee on Judiciary",6,1,0,0,7
512079,291615,2013-06-25,Assembly,"Do pass as amended and be re-referred to the Committee on 	Appropriations",10,0,0,0,10
512079,298298,2013-08-30,Assembly,"Do pass as amended",13,0,0,4,17
512079,298924,2013-09-09,Assembly,"SB 528 Yee  Senate Third Reading  By STONE",61,15,0,2,78
512079,299120,2013-09-10,Senate,"Unfinished Business SB528 Yee Concurrence",32,5,2,0,39
512080,262712,2013-04-10,Senate,"Do pass",5,0,0,0,5
512080,268573,2013-04-18,Senate,"Senate 3rd Reading SB527 Block",31,5,2,0,38
512080,291981,2013-06-26,Assembly,"Do pass",8,3,0,2,13
512080,295324,2013-07-01,Assembly,"SB 527 Block  Senate Third Reading  By CHAVEZ",51,17,0,10,78
512081,268470,2013-04-17,Senate,"Do pass as amended, and re-refer to the Committee on Judiciary",9,0,0,0,9
512081,274736,2013-04-30,Senate,"Do pass as amended, but re-refer to the Committee on 	Appropriations Recommend Consent",7,0,0,0,7
512081,281217,2013-05-20,Senate,"Placed on Appropriations Suspense file",6,0,1,0,7
512084,272445,2013-04-24,Senate,"Do pass as amended, and re-refer to the Committee on Appropriations",7,0,2,0,9
512084,278837,2013-05-13,Senate,"Placed on Appropriations Suspense file",5,0,2,0,7
512084,283438,2013-05-23,Senate,"Do pass as amended",7,0,0,0,7
512084,285097,2013-05-29,Senate,"Senate 3rd Reading SB524 Lara",38,0,1,0,39
512084,297487,2013-08-14,Assembly,"Do pass and be re-referred to the Committee on Appropriations",7,0,0,0,7
512087,269889,2013-04-22,Senate,"Do pass, but re-refer to the Committee on Appropriations",3,2,0,0,5
512087,276348,2013-05-06,Senate,"Placed on Appropriations Suspense file",7,0,0,0,7
512088,270750,2013-04-23,Senate,"Do pass as amended, but re-refer to the Committee on Appropriations 	Recommend Consent",6,0,0,0,6
512088,276504,2013-05-06,Senate,"Placed on Appropriations Suspense file",7,0,0,0,7
512088,283230,2013-05-23,Senate,"Do pass",7,0,0,0,7
512088,284607,2013-05-28,Senate,"Senate 3rd Reading SB522 Hueso",38,0,1,0,39
512088,297471,2013-08-13,Assembly,"Do pass and be re-referred to the Committee on Appropriations",7,0,0,0,7
512088,298430,2013-08-30,Assembly,"Do pass as amended",13,0,0,4,17
512088,299058,2013-09-09,Assembly,"SB 522 Hueso  Senate Third Reading  By PAN",58,15,0,5,78
512088,299570,2013-09-11,Senate,"From committee:  That the Assembly Amendments be concurred in",6,0,0,0,6
512088,299828,2013-09-12,Senate,"Unfinished Business SB522 Hueso Concurrence",38,0,1,0,39
512093,275578,2013-05-01,Senate,"Do pass, but re-refer to the Committee on Appropriations",8,0,1,0,9
512093,281199,2013-05-20,Senate,"Placed on Appropriations Suspense file",6,0,1,0,7
512093,283255,2013-05-23,Senate,"Do pass as amended",7,0,0,0,7
512093,285492,2013-05-30,Senate,"Senate 3rd Reading SB520 Steinberg",28,0,11,0,39
512094,275402,2013-04-30,Senate,"Do pass, but re-refer to the Committee on Appropriations",5,0,0,0,5
512094,278874,2013-05-13,Senate,"Placed on Appropriations Suspense file",5,0,2,0,7
512099,271534,2013-04-24,Senate,"Do pass, but re-refer to the Committee on Judiciary",4,0,1,0,5
512099,274705,2013-04-30,Senate,"Do pass as amended, and re-refer to the Committee on 	Appropriations",7,0,0,0,7
512099,281204,2013-05-20,Senate,"Placed on Appropriations Suspense file",6,0,1,0,7
512099,283077,2013-05-23,Senate,"Do pass",7,0,0,0,7
512099,284533,2013-05-28,Senate,"Senate 3rd Reading SB516 Steinberg",38,0,1,0,39
512099,292140,2013-06-26,Assembly,"Do pass and be re-referred to the Committee on Judiciary",5,0,0,2,7
512099,297276,2013-08-13,Assembly,"Do pass and be re-referred to the Committee on Appropriations",7,3,0,0,10
512099,298183,2013-08-30,Assembly,"Do pass as amended",12,5,0,0,17
512099,298933,2013-09-09,Assembly,"SB 516 Steinberg  Senate Third Reading  By WIECKOWSKI",54,24,0,0,78
512099,299149,2013-09-10,Senate,"Unfinished Business SB516 Steinberg",38,0,1,0,39
512101,268539,2013-04-17,Senate,"Do pass as amended, and re-refer to the Committee on Judiciary",3,5,1,0,9
512101,268540,2013-04-17,Senate,"Set, first hearing.  Failed passage in Committee.  Reconsideration 	granted",9,0,0,0,9
512103,274714,2013-04-30,Senate,"Do pass",7,0,0,0,7
512103,281702,2013-05-20,Senate,"Senate 3rd Reading SB514 Committee on Pub. S. (Hancock)",36,0,3,0,39
512103,289594,2013-06-18,Assembly,"Do pass, to Consent Calendar",6,0,0,1,7
512103,291238,2013-06-24,Assembly,"SB 514 PUB. S.  Consent Calendar Second Day  Regular Session",75,0,0,4,79
512105,274731,2013-04-30,Senate,"Do pass, but re-refer to the Committee on Appropriations",6,1,0,0,7
512105,278912,2013-05-13,Senate,"Placed on Appropriations Suspense file",5,0,2,0,7
512105,283164,2013-05-23,Senate,"Do pass",7,0,0,0,7
512105,284633,2013-05-28,Senate,"Senate 3rd Reading SB513 Hancock",33,5,1,0,39
512105,291654,2013-06-25,Assembly,"Do pass and be re-referred to the Committee on Appropriations",5,2,0,0,7
512105,296021,2013-07-03,Assembly,"Do pass as amended",12,5,0,0,17
512105,298045,2013-08-26,Assembly,"SB 513 Hancock  Senate Third Reading",53,23,0,2,78
512105,298341,2013-08-30,Senate,"Unfinished Business SB513 Hancock Concurrence",30,7,2,0,39
512107,270751,2013-04-23,Senate,"Do pass as amended, and re-refer to the Committee on Appropriations",8,1,0,0,9
512107,278841,2013-05-13,Senate,"Placed on Appropriations Suspense file",5,0,2,0,7
512107,308329,2014-01-13,Senate,"Do pass, but re-refer to the Committee on Appropriations",9,0,1,0,10
512107,311228,2014-01-23,Senate,"Senate 3rd Reading SB511 Lieu",31,0,8,0,39
512107,374800,2014-06-24,Assembly,"Do pass as amended and be re-referred to the Committee on 	Appropriations",7,0,0,2,9
512109,270772,2013-04-23,Senate,"Do pass as amended",7,3,1,0,11
512109,275557,2013-05-02,Senate,"Senate 3rd Reading SB510 Jackson",21,16,1,0,38
512109,289831,2013-06-19,Assembly,"Do pass and be re-referred to the Committee on Local Government",5,2,0,0,7
512109,297535,2013-08-14,Assembly,"Do pass as amended",7,0,0,2,9
512109,298593,2013-09-03,Assembly,"SB 510 Jackson  Senate Third Reading  By WILLIAMS",41,24,0,13,78
512109,299203,2013-09-10,Senate,"Unfinished Business SB510 Jackson Concurrence",21,14,4,0,39
512110,277321,2013-05-08,Senate,"Do pass, but re-refer to the Committee on Appropriations",8,0,1,0,9
512110,281273,2013-05-20,Senate,"Placed on Appropriations Suspense file",6,0,1,0,7
512110,283236,2013-05-23,Senate,"Do pass as amended",7,0,0,0,7
512110,284517,2013-05-28,Senate,"Senate 3rd Reading SB509 DeSaulnier Urgency Clause",39,0,0,0,39
512110,286823,2013-06-04,Assembly,"Do pass and be re-referred to the Committee on Appropriations",18,0,0,1,19
512110,287718,2013-06-10,Assembly,"Do pass",14,0,0,3,17
512110,289022,2013-06-14,Assembly,"SB 509 DeSaulnier  Third Reading Urgency  By COOLEY",77,1,0,1,79
512111,309024,2014-01-15,Senate,"Do pass, but re-refer to the Committee on Appropriations",7,0,2,0,9
512111,310353,2014-01-21,Senate,"Do pass",4,1,2,0,7
512111,312265,2014-01-27,Senate,"Senate 3rd Reading SB508 Hernandez",28,8,3,0,39
512111,372240,2014-06-17,Assembly,"Do pass and be re-referred to the Committee on Appropriations",13,6,0,0,19
512111,377581,2014-08-14,Assembly,"Do pass as amended",12,5,0,0,17
512111,378326,2014-08-25,Assembly,"SB 508 Hernandez  Senate Third Reading  By CHESBRO",57,22,0,0,79
512111,378572,2014-08-26,Senate,"Unfinished Supp 1 SB508 Hernandez Concurrence",25,11,4,0,40
512115,274991,2013-04-30,Senate,"Do pass as amended, and re-refer to the Committee on Appropriations",2,5,0,0,7
512115,274992,2013-04-30,Senate,"Set, first hearing.  Failed passage in Committee.  Reconsideration 	granted",7,0,0,0,7
512116,261663,2013-04-09,Senate,"Do pass, but re-refer to the Committee on Judiciary",7,0,0,0,7
512116,274879,2013-04-30,Senate,"Do pass, but re-refer to the Committee on Appropriations",4,0,3,0,7
512116,278854,2013-05-13,Senate,"Placed on Appropriations Suspense file",5,0,2,0,7
512116,311152,2014-01-23,Senate,"Do pass as amended",5,0,2,0,7
512116,312786,2014-01-28,Senate,"Senate 3rd Reading SB506 Hill",30,2,7,0,39
512116,373350,2014-06-19,Assembly,"Be referred to Committee on Transportation",7,3,0,1,11
512117,262730,2013-04-10,Senate,"Do pass as amended, and re-refer to the Committee on Appropriations",9,0,0,0,9
512117,281265,2013-05-20,Senate,"Placed on Appropriations Suspense file",6,0,1,0,7
512117,283377,2013-05-23,Senate,"Do pass as amended",5,2,0,0,7
512117,285202,2013-05-29,Senate,"Senate 3rd Reading SB505 Jackson",37,0,2,0,39
512117,371706,2014-06-16,Assembly,"Be referred to Committee on Public Safety",10,0,0,1,11
512117,374057,2014-06-24,Assembly,"Do pass and be re-referred to the Committee on Appropriations",7,0,0,0,7
512117,377267,2014-08-14,Assembly,"Do pass as amended",15,2,0,0,17
512117,377947,2014-08-20,Assembly,"SB 505 Jackson  Senate Third Reading  By MELENDEZ",78,0,0,1,79
512117,378050,2014-08-21,Senate,"From Committee:  That the measure be returned to the Senate floor 	for consideration",7,0,0,0,7
512117,378218,2014-08-22,Senate,"Unfinished Business SB505 Jackson Concurrence",32,0,8,0,40
512118,258531,2013-04-02,Senate,"Do pass, but re-refer to the Committee on Appropriations",4,0,1,0,5
512118,270012,2013-04-22,Senate,"Special Consent #1 SB504 Berryhill",38,0,0,0,38
512118,296159,2013-07-03,Assembly,"Do pass and be re-referred to the Committee on Appropriations",7,0,0,0,7
512118,297505,2013-08-14,Assembly,"Do pass, to Consent Calendar",17,0,0,0,17
512118,297921,2013-08-22,Assembly,"SB 504 Berryhill, T.  Consent Calendar Second Day  Regular Session",78,0,0,0,78
512125,275738,2013-05-01,Senate,"Do pass, but re-refer to the Committee on Appropriations Recommend 	Consent",9,0,0,0,9
512125,280283,2013-05-16,Senate,"Consent Calendar 2nd SB502 Block",37,0,1,0,38
512125,372859,2014-06-18,Assembly,"Do pass and be re-referred to the Committee on Appropriations",10,1,0,2,13
512125,375611,2014-07-02,Assembly,"Do pass",12,4,0,1,17
512125,377875,2014-08-19,Assembly,"SB 502 Block  Senate Third Reading  By SKINNER",56,19,0,4,79
512125,377979,2014-08-20,Senate,"Unfinished Business SB502 Block Concurrence",33,0,7,0,40
512127,271624,2013-04-23,Senate,"Do pass as amended",5,1,1,0,7
512127,275618,2013-05-02,Senate,"Senate 3rd Reading SB501 Corbett",23,10,5,0,38
512127,373731,2014-06-23,Assembly,"Be referred to Committee on Insurance",7,0,0,4,11
512129,308274,2014-01-13,Senate,"Do pass, but re-refer to the Committee on Appropriations",9,0,1,0,10
512129,311249,2014-01-23,Senate,"Senate 3rd Reading SB500 Lieu",33,0,6,0,39
512129,370734,2014-06-10,Assembly,"Do pass and be re-referred to the Committee on Appropriations",11,0,0,3,14
512129,372742,2014-06-18,Assembly,"Do pass",14,0,0,3,17
512129,378232,2014-08-22,Assembly,"SB 500 Lieu  Senate Third Reading  Amend By GRAY  Set #1",55,19,0,5,79
512131,274873,2013-05-01,Senate,"Do pass, but re-refer to the Committee on Appropriations Recommend 	Consent",7,0,0,0,7
512131,278721,2013-05-13,Senate,"Placed on Appropriations Suspense file",5,0,2,0,7
512132,309178,2014-01-15,Senate,"Do pass, but re-refer to the Committee on Appropriations",5,1,2,0,8
512132,310327,2014-01-21,Senate,"Placed on Appropriations Suspense file",5,0,2,0,7
512132,311169,2014-01-23,Senate,"Do pass as amended",6,0,1,0,7
512132,312798,2014-01-28,Senate,"Senate 3rd Reading SB498 Lara",34,0,5,0,39
512132,372200,2014-06-16,Assembly,"Do pass and be re-referred to the Committee on Environmental Safety 	and Toxic Materials",9,0,0,0,9
512132,374068,2014-06-24,Assembly,"Do pass as amended and be re-referred to the Committee on 	Appropriations",6,0,0,1,7
512132,376719,2014-08-06,Assembly,"Do pass",17,0,0,0,17
512132,377819,2014-08-19,Assembly,"SB 498 Lara  Senate Third Reading  By BLOOM",73,2,0,4,79
512132,377943,2014-08-20,Senate,"Unfinished Business SB498 Lara Concurrence",33,0,7,0,40
512134,274892,2013-05-01,Senate,"Do pass, but re-refer to the Committee on Appropriations",3,6,0,0,9
512134,274893,2013-05-01,Senate,"Set, second hearing.  Failed passage in Committee. 	Reconsideration granted",9,0,0,0,9
512136,269890,2013-04-22,Senate,"Do pass, but re-refer to the Committee on Appropriations",5,0,0,0,5
512136,278690,2013-05-13,Senate,"Special Consent #4 SB496 Wright",34,0,4,0,38
512136,291558,2013-06-25,Assembly,"Do pass and be re-referred to the Committee on Appropriations",10,0,0,0,10
512136,296026,2013-07-03,Assembly,"Do pass",13,2,0,2,17
512136,299249,2013-09-10,Assembly,"SB 496 Wright  Senate Third Reading  By DICKINSON",76,0,0,2,78
512136,299481,2013-09-11,Senate,"Unfinished Business SB496 Wright Concurrence",39,0,0,0,39
512137,275567,2013-05-01,Senate,"Do pass",7,2,0,0,9
512137,284690,2013-05-28,Senate,"Senate 3rd Reading SB495 Yee",29,9,1,0,39
512138,272241,2013-04-24,Senate,"Do pass, but re-refer to the Committee on Appropriations",9,0,0,0,9
512138,276469,2013-05-06,Senate,"Placed on Appropriations Suspense file",7,0,0,0,7
512138,283305,2013-05-23,Senate,"Do pass as amended",7,0,0,0,7
512138,285243,2013-05-29,Senate,"Senate 3rd Reading SB494 Monning",38,0,1,0,39
512138,297285,2013-08-13,Assembly,"Do pass as amended and be re-referred to the Committee on 	Appropriations",18,0,0,1,19
512138,298198,2013-08-30,Assembly,"Do pass as amended",17,0,0,0,17
512138,299504,2013-09-11,Assembly,"SB 494 Monning  Senate Third Reading  By MITCHELL",78,0,0,0,78
512138,299742,2013-09-12,Senate,"Unfinished Business SB494 Monning Concurrence",37,0,2,0,39
512139,273497,2013-04-29,Senate,"Do pass, but re-refer to the Committee on Appropriations",9,0,1,0,10
512139,278678,2013-05-13,Senate,"Placed on Appropriations Suspense file",5,0,2,0,7
512139,283160,2013-05-23,Senate,"Do pass as amended",7,0,0,0,7
512139,285062,2013-05-29,Senate,"Senate 3rd Reading SB493 Hernandez",34,4,1,0,39
512139,297072,2013-08-06,Assembly,"Do pass and be re-referred to the Committee on Health",14,0,0,0,14
512139,297247,2013-08-13,Assembly,"Do pass as amended and be re-referred to the Committee on 	Appropriations",18,0,0,1,19
512139,298225,2013-08-30,Assembly,"Do pass as amended",16,0,0,1,17
512139,298763,2013-09-06,Assembly,"SB 493 Hernandez  Senate Third Reading  By BONILLA  Amend By 	BONILLA  Set #1",54,24,0,0,78
512139,299374,2013-09-11,Assembly,"SB 493 Hernandez  Senate Third Reading  By BONILLA",77,0,0,1,78
512139,299622,2013-09-12,Senate,"Unfinished Business SB493 Hernandez Concurrence",37,0,2,0,39
512142,273684,2013-04-29,Senate,"Do pass as amended, and re-refer to the Committee on Appropriations",8,0,2,0,10
512142,281349,2013-05-20,Senate,"Placed on Appropriations Suspense file",6,0,1,0,7
512142,283123,2013-05-23,Senate,"Do pass",7,0,0,0,7
512142,284622,2013-05-28,Senate,"Senate 3rd Reading SB492 Hernandez",25,5,9,0,39
512142,374099,2014-06-24,Assembly,"Do pass as amended and be re-referred to the Committee on 	Appropriations",8,1,0,5,14
512142,377405,2014-08-14,Assembly,"Do pass as amended",10,1,0,6,17
512144,273518,2013-04-29,Senate,"Do pass as amended, and re-refer to the Committee on Appropriations",6,1,3,0,10
512144,278557,2013-05-13,Senate,"Do pass as amended",4,0,3,0,7
512144,284586,2013-05-28,Senate,"Senate 3rd Reading SB491 Hernandez",22,12,5,0,39
512144,297068,2013-08-06,Assembly,"Do pass as amended and be re-referred to the Committee on 	Appropriations",6,3,0,5,14
512144,297069,2013-08-06,Assembly,"Set first hearing.  Failed passage.  Reconsideration granted",14,0,0,0,14
512144,297287,2013-08-13,Assembly,"Do pass as amended and be re-referred to the Committee on 	Appropriations",8,2,0,4,14
512145,277452,2013-05-08,Senate,"Do pass as amended",8,0,1,0,9
512145,284578,2013-05-28,Senate,"Special Consent #6 SB490 Jackson",39,0,0,0,39
512145,297075,2013-08-06,Assembly,"Do pass",12,0,0,1,13
512145,299197,2013-09-10,Assembly,"SB 490 Jackson  Senate Third Reading  By BONILLA",73,1,0,4,78
512145,299441,2013-09-11,Senate,"Unfinished Business SB490 Jackson Concurrence",39,0,0,0,39
512148,275762,2013-05-01,Senate,"Do pass as amended",9,0,0,0,9
512148,278666,2013-05-13,Senate,"Special Consent #4 SB488 Hueso",34,0,4,0,38
512148,290019,2013-06-19,Assembly,"Do pass as amended",7,0,0,0,7
512148,296042,2013-07-03,Assembly,"SB 488 Hueso  Senate Third Reading  By QUIRK-SILVA",74,0,0,4,78
512148,296253,2013-07-08,Senate,"Unfinished Business SB488 Hueso Concurrence",32,0,6,0,38
512149,271593,2013-04-24,Senate,"Do pass as amended, and re-refer to the Committee on Insurance",4,0,1,0,5
512151,261764,2013-04-09,Senate,"Do pass, but re-refer to the Committee on Transportation and 	Housing",9,2,0,0,11
512151,274228,2013-04-30,Senate,"Do pass, but re-refer to the Committee on Appropriations",11,0,0,0,11
512151,281697,2013-05-20,Senate,"Placed on Appropriations Suspense file",6,0,1,0,7
512151,283425,2013-05-23,Senate,"Do pass",7,0,0,0,7
512151,284629,2013-05-28,Senate,"Senate 3rd Reading SB486 DeSaulnier",39,0,0,0,39
512151,297209,2013-08-12,Assembly,"Do pass and be re-referred to the Committee on Accountability and 	Administrative Review",15,0,0,1,16
512151,297496,2013-08-14,Assembly,"Do pass and be re-referred to the Committee on Appropriations",11,0,0,2,13
512151,298418,2013-08-30,Assembly,"Do pass as amended",17,0,0,0,17
512151,373738,2014-06-23,Assembly,"Do pass as amended and be re-referred to the Committee on 	Appropriations",14,0,0,2,16
512151,377394,2014-08-14,Assembly,"Do pass as amended",12,0,0,5,17
512151,378312,2014-08-25,Assembly,"SB 486 DeSaulnier  Senate Third Reading  By LOWENTHAL",79,0,0,0,79
512151,378663,2014-08-27,Senate,"From committee:  That the Assembly Amendments be concurred in",10,0,1,0,11
512151,378954,2014-08-28,Senate,"Unfinished Business SB486 DeSaulnier Concurrence",35,0,5,0,40
512153,270273,2013-04-22,Senate,"Do pass, but re-refer to the Committee on Appropriations",10,0,0,0,10
512153,281274,2013-05-20,Senate,"Placed on Appropriations Suspense file",6,0,1,0,7
512153,283175,2013-05-23,Senate,"Do pass as amended",7,0,0,0,7
512153,285014,2013-05-29,Senate,"Senate 3rd Reading SB485 Calderon",39,0,0,0,39
512153,297333,2013-08-13,Assembly,"Do pass and be re-referred to the Committee on Appropriations",14,0,0,0,14
512153,298193,2013-08-30,Assembly,"Do pass",16,0,0,1,17
512153,299072,2013-09-09,Assembly,"SB 485 Calderon  Senate Third Reading  By GORDON",77,1,0,0,78
512153,299136,2013-09-10,Senate,"Unfinished Business SB485 Calderon Concurrence",36,0,3,0,39
512156,273625,2013-04-29,Senate,"Do pass as amended, and re-refer to the Committee on Appropriations",10,0,0,0,10
512156,273626,2013-04-29,Senate,"Do pass as amended, and re-refer to the Committee on Appropriations",10,0,0,0,10
512156,284670,2013-05-28,Senate,"Special Consent #6 SB484 Wyland",39,0,0,0,39
512156,295865,2013-07-02,Assembly,"Do pass and be re-referred to the Committee on Appropriations",10,2,0,1,13
512156,297475,2013-08-14,Assembly,"Do pass",13,4,0,0,17
512156,298689,2013-09-03,Assembly,"SB 484 Wyland  Senate Third Reading  By LINDER",59,14,0,5,78
512157,259102,2013-04-03,Senate,"Do pass, but re-refer to the Committee on Appropriations",9,0,0,0,9
512157,284703,2013-05-28,Senate,"Senate 3rd Reading SB483 Jackson",37,0,2,0,39
512157,295866,2013-07-02,Assembly,"Do pass and be re-referred to the Committee on Appropriations",6,0,0,1,7
512157,297464,2013-08-14,Assembly,"Do pass, to Consent Calendar",17,0,0,0,17
512157,298816,2013-09-06,Assembly,"SB 483 Jackson  Senate Third Reading  By ALEJO",75,0,0,3,78
512157,299593,2013-09-12,Senate,"Special Consent #10 SB483 Jackson",39,0,0,0,39
512159,257116,2013-04-01,Senate,"Do pass, but re-refer to the Committee on Appropriations",10,0,0,0,10
512159,268498,2013-04-18,Senate,"Senate 3rd Reading SB482 Hill",36,0,2,0,38
512159,289798,2013-06-18,Assembly,"Do pass and be re-referred to the Committee on Appropriations",12,0,0,1,13
512159,296148,2013-07-03,Assembly,"Do pass, to Consent Calendar",17,0,0,0,17
512159,297193,2013-08-12,Assembly,"SB 482 Hill  Senate Third Reading  By GORDON",76,2,0,0,78
512164,270742,2013-04-23,Senate,"Do pass, but re-refer to the Committee on Appropriations Recommend 	Consent",9,0,2,0,11
512164,276281,2013-05-06,Senate,"Do pass",7,0,0,0,7
512164,278026,2013-05-09,Senate,"Senate 3rd Reading SB479 Block",34,0,4,0,38
512164,289834,2013-06-19,Assembly,"Do pass and be re-referred to the Committee on Appropriations",12,0,0,1,13
512167,310381,2014-01-21,Senate,"Placed on Appropriations Suspense file",5,0,2,0,7
512167,311252,2014-01-23,Senate,"Do pass",6,0,1,0,7
512167,313937,2014-01-30,Senate,"Senate 3rd Reading SB477 Steinberg By De Leon",35,0,4,0,39
512167,370908,2014-06-11,Assembly,"Do pass and be re-referred to the Committee on Judiciary",6,0,0,1,7
512167,374063,2014-06-24,Assembly,"Do pass and be re-referred to the Committee on Appropriations",8,0,0,2,10
512167,377567,2014-08-14,Assembly,"Do pass",13,2,0,2,17
512167,378429,2014-08-25,Assembly,"SB 477 Steinberg  Senate Third Reading  By ALEJO",66,10,0,3,79
512167,378822,2014-08-27,Senate,"Unfinished Business SB477 Steinberg Concurrence",34,0,6,0,40
512169,271608,2013-04-24,Senate,"Do pass, but re-refer to the Committee on Appropriations",9,0,0,0,9
512169,276349,2013-05-06,Senate,"Placed on Appropriations Suspense file",7,0,0,0,7
512169,283424,2013-05-23,Senate,"Do pass",7,0,0,0,7
512169,285264,2013-05-29,Senate,"Senate 3rd Reading SB476 Steinberg",38,1,0,0,39
512169,291942,2013-06-26,Assembly,"Do pass as amended and be re-referred to the Committee on 	Appropriations",11,0,0,2,13
512169,298414,2013-08-30,Assembly,"Do pass",16,0,0,1,17
512169,298741,2013-09-04,Assembly,"SB 476 Steinberg  Senate Third Reading  By MITCHELL",75,1,0,2,78
512169,298827,2013-09-06,Senate,"Unfinished Business SB476 Steinberg Concurrence",37,0,2,0,39
512170,267718,2013-04-16,Senate,"Do pass, but re-refer to the Committee on Appropriations",5,2,0,0,7
512170,275548,2013-05-02,Senate,"Senate 3rd Reading SB475 Leno",25,13,0,0,38
512170,291561,2013-06-25,Assembly,"Do pass and be re-referred to the Committee on Appropriations",5,2,0,0,7
512170,295998,2013-07-03,Assembly,"Do pass",12,5,0,0,17
512170,298798,2013-09-06,Assembly,"SB 475 Leno  Senate Third Reading  By TING",44,29,0,5,78
512174,271547,2013-04-23,Senate,"Do pass, but re-refer to the Committee on Appropriations",7,0,0,0,7
512174,278665,2013-05-13,Senate,"Placed on Appropriations Suspense file",5,0,2,0,7
512174,283108,2013-05-23,Senate,"Do pass as amended",7,0,0,0,7
512174,284944,2013-05-29,Senate,"Senate 3rd Reading SB473 Block",39,0,0,0,39
512174,291587,2013-06-25,Assembly,"Do pass as amended and be re-referred to the Committee on 	Appropriations",7,0,0,0,7
512174,298240,2013-08-30,Assembly,"Do pass as amended",17,0,0,0,17
512174,376861,2014-08-11,Assembly,"SB 473 Block  Senate Third Reading  By SKINNER",79,0,0,0,79
512174,377071,2014-08-13,Senate,"Unfinished Business SB473 Block Concurrence",34,0,6,0,40
512175,261809,2013-04-09,Senate,"Do pass",10,0,1,0,11
512175,263469,2013-04-11,Senate,"Senate 3rd Reading SB472 Hill",37,0,1,0,38
512175,297573,2013-08-14,Assembly,"Do pass and be re-referred to the Committee on Appropriations",15,0,0,2,17
512175,297844,2013-08-21,Assembly,"Do pass",15,0,0,2,17
512175,298722,2013-09-04,Assembly,"SB 472 Hill  Senate Third Reading  By JONES-SAWYER",70,1,0,7,78
512175,299320,2013-09-10,Senate,"From committee:  That the Assembly Amendments be concurred in",6,0,4,0,10
512175,299470,2013-09-11,Senate,"Unfinished Business SB472 Hill Concurrence",24,6,9,0,39
512179,258521,2013-04-03,Senate,"Do pass as amended, and re-refer to the Committee on Environmental 	Quality",6,0,1,0,7
512179,274856,2013-05-01,Senate,"Do pass as amended, and re-refer to the Committee on 	Appropriations",9,0,0,0,9
512179,283983,2013-05-24,Senate,"Senate 3rd Reading SB470 Wright",36,0,3,0,39
512179,296083,2013-07-03,Assembly,"Do pass as amended and be re-referred to the Committee on Local 	Government",5,2,0,0,7
512179,297605,2013-08-14,Assembly,"Do pass and be re-referred to the Committee on Appropriations",7,2,0,0,9
512179,298463,2013-08-30,Assembly,"Do pass as amended",16,1,0,0,17
512179,299560,2013-09-11,Assembly,"SB 470 Wright  Senate Third Reading  By LOWENTHAL",65,13,0,0,78
512179,299733,2013-09-12,Senate,"Unfinished Business SB470 Wright Concurrence",37,0,2,0,39
512181,308597,2014-01-14,Senate,"Do pass, but re-refer to the Committee on Governance and Finance 	Recommend Consent",11,0,0,0,11
512181,310359,2014-01-21,Senate,"Senate 3rd Reading SB469 Corbett",34,0,5,0,39
512181,371693,2014-06-16,Assembly,"Do pass, to Consent Calendar",15,0,0,1,16
512181,373717,2014-06-23,Assembly,"SB 469 Corbett  Consent Calendar Second Day  Regular Session",75,0,0,4,79
512181,375673,2014-07-03,Senate,"Special Consent #18 SB469 Corbett",35,0,5,0,40
512182,270719,2013-04-23,Senate,"Do pass as amended, and re-refer to the Committee on Appropriations",6,0,0,0,6
512182,278642,2013-05-13,Senate,"Placed on Appropriations Suspense file",5,0,2,0,7
512182,283187,2013-05-23,Senate,"Do pass as amended",7,0,0,0,7
512182,285572,2013-05-30,Senate,"Special Consent #8 SB468 Emmerson",38,0,1,0,39
512182,297452,2013-08-13,Assembly,"Do pass and be re-referred to the Committee on Appropriations",7,0,0,0,7
512182,298231,2013-08-30,Assembly,"Do pass",17,0,0,0,17
512182,299378,2013-09-11,Senate,"Unfinished Supp 1 SB468 Emmerson Concurrence",39,0,0,0,39
512182,299379,2013-09-11,Assembly,"SB 468 Emmerson  Senate Third Reading  By MITCHELL",78,0,0,0,78
512185,275136,2013-04-30,Senate,"Do pass, but re-refer to the Committee on Appropriations",5,1,1,0,7
512185,278801,2013-05-13,Senate,"Senate 3rd Reading SB467 Leno",33,1,4,0,38
512185,288047,2013-06-11,Assembly,"Do pass and be re-referred to the Committee on Judiciary",6,1,0,0,7
512185,295877,2013-07-02,Assembly,"Do pass as amended",9,0,0,1,10
512185,297972,2013-08-22,Assembly,"SB 467 Leno  Senate Third Reading  By WAGNER",70,3,0,5,78
512185,299030,2013-09-09,Assembly,"SB 467 Leno  Senate Third Reading  By WAGNER",73,3,0,2,78
512185,299255,2013-09-10,Senate,"Unfinished Business SB467 Leno",34,1,4,0,39
512188,271545,2013-04-23,Senate,"Do pass, but re-refer to the Committee on Appropriations",6,1,0,0,7
512188,276267,2013-05-06,Senate,"Placed on Appropriations Suspense file",7,0,0,0,7
512188,311179,2014-01-23,Senate,"Do pass as amended",5,1,1,0,7
512188,313905,2014-01-30,Senate,"Senate 3rd Reading SB466 DeSaulnier",28,6,5,0,39
512188,370579,2014-06-10,Assembly,"Do pass and be re-referred to the Committee on Higher Education",7,0,0,0,7
512188,374497,2014-06-24,Assembly,"Do pass and be re-referred to the Committee on Appropriations",13,0,0,0,13
512190,276246,2013-05-06,Senate,"Do pass",9,0,1,0,10
512190,284941,2013-05-29,Senate,"Senate 3rd Reading SB465 Correa",37,0,2,0,39
512190,295944,2013-07-03,Assembly,"Do pass and be re-referred to the Committee on Business, 	Professions and Consumer Protection",7,0,0,0,7
512190,297235,2013-08-13,Assembly,"Do pass as amended",13,0,0,1,14
512190,298960,2013-09-09,Assembly,"SB 465 Correa  Senate Third Reading  By EGGMAN",76,0,0,2,78
512190,299183,2013-09-10,Senate,"Unfinished Business SB465 Correa Concurrence",37,0,2,0,39
512193,257848,2013-04-02,Senate,"Do pass, but re-refer to the Committee on Appropriations",7,0,0,0,7
512193,265549,2013-04-15,Senate,"Placed on Appropriations Suspense file",7,0,0,0,7
512193,283196,2013-05-23,Senate,"Do pass",7,0,0,0,7
512193,285005,2013-05-29,Senate,"Senate 3rd Reading SB463 Pavley",38,0,1,0,39
512193,291679,2013-06-25,Assembly,"Do pass and be re-referred to the Committee on Appropriations",7,0,0,0,7
512193,298338,2013-08-30,Assembly,"Do pass",17,0,0,0,17
512193,299433,2013-09-11,Senate,"Unfinished Supp 1 SB463 Pavley Concurrence",39,0,0,0,39
512193,299434,2013-09-11,Assembly,"SB 463 Pavley  Senate Third Reading  By JONES-SAWYER",78,0,0,0,78
512195,271631,2013-04-23,Senate,"Do pass, but re-refer to the Committee on Appropriations",5,2,0,0,7
512195,276354,2013-05-06,Senate,"Placed on Appropriations Suspense file",7,0,0,0,7
512195,283374,2013-05-23,Senate,"Do pass",5,2,0,0,7
512195,285208,2013-05-29,Senate,"Senate 3rd Reading SB462 Monning",26,9,4,0,39
512195,292286,2013-06-26,Assembly,"Do pass and be re-referred to the Committee on Judiciary",5,2,0,0,7
512195,295836,2013-07-02,Assembly,"Do pass",7,3,0,0,10
512195,297201,2013-08-12,Assembly,"SB 462 Monning  Senate Third Reading  By DICKINSON",49,26,0,3,78
512196,270829,2013-04-23,Senate,"Do pass, but re-refer to the Committee on Appropriations",7,2,0,0,9
512196,276295,2013-05-06,Senate,"Placed on Appropriations Suspense file",7,0,0,0,7
512196,283246,2013-05-23,Senate,"Do pass as amended",5,2,0,0,7
512196,285084,2013-05-29,Senate,"Senate 3rd Reading SB461 Leno",25,13,1,0,39
512196,295830,2013-07-01,Assembly,"Do pass as amended and be re-referred to the Committee on 	Appropriations",6,3,0,0,9
512199,275587,2013-05-01,Senate,"Do pass, but re-refer to the Committee on Appropriations",8,1,0,0,9
512199,278925,2013-05-13,Senate,"Placed on Appropriations Suspense file",5,0,2,0,7
512199,283383,2013-05-23,Senate,"Do pass as amended",5,0,2,0,7
512199,285228,2013-05-29,Senate,"Senate 3rd Reading SB460 Pavley",39,0,0,0,39
512199,297340,2013-08-13,Assembly,"Do pass as amended and be re-referred to the Committee on 	Appropriations",18,0,0,1,19
512199,297874,2013-08-21,Assembly,"Do pass, to Consent Calendar",17,0,0,0,17
512199,298966,2013-09-09,Assembly,"SB 460 Pavley  Senate Third Reading  By LOWENTHAL",77,0,0,1,78
512199,299134,2013-09-10,Senate,"Unfinished Business SB460 Pavley Concurrence",37,0,2,0,39
512201,270982,2013-04-23,Senate,"Do pass as amended, and re-refer to the Committee on 	Appropriations",10,0,1,0,11
512201,281282,2013-05-20,Senate,"Placed on Appropriations Suspense file",6,0,1,0,7
512201,283070,2013-05-23,Senate,"Do pass",4,0,3,0,7
512201,285147,2013-05-29,Senate,"Senate 3rd Reading SB459 Pavley",36,0,3,0,39
512201,297199,2013-08-12,Assembly,"Do pass and be re-referred to the Committee on Appropriations",11,5,0,0,16
512201,298385,2013-08-30,Assembly,"Do pass as amended",12,5,0,0,17
512201,298859,2013-09-06,Assembly,"SB 459 Pavley  Senate Third Reading  By LOWENTHAL  Amend By 	LOWENTHAL  Set #1",53,25,0,0,78
512201,299568,2013-09-11,Assembly,"Do pass as amended",10,5,0,1,16
512201,299818,2013-09-12,Senate,"From committee:  That the Assembly Amendments be concurred in",10,0,1,0,11
512201,299819,2013-09-12,Assembly,"SB 459 Pavley  Senate Third Reading  By LOWENTHAL",52,25,0,1,78
512201,299820,2013-09-12,Senate,"Unfinished Supp 2 SB459 Pavley Concurrence",30,8,1,0,39
512202,261800,2013-04-09,Senate,"Do pass as amended, and re-refer to the Committee on Appropriations",7,0,0,0,7
512202,276310,2013-05-06,Senate,"Do pass as amended",7,0,0,0,7
512202,280323,2013-05-16,Senate,"Senate 3rd Reading SB458 Wright",37,0,1,0,38
512202,289380,2013-06-18,Assembly,"Do pass as amended",5,1,0,1,7
512202,299186,2013-09-10,Assembly,"SB 458 Wright  Senate Third Reading  By BRADFORD",66,10,0,2,78
512202,299370,2013-09-11,Senate,"Unfinished Business SB458 Wright Concurrence",35,0,4,0,39
512203,270694,2013-04-23,Senate,"Do pass as amended, and re-refer to the Committee on Appropriations",9,0,0,0,9
512203,281377,2013-05-20,Senate,"Special Consent #5 SB457 Monning",36,0,3,0,39
512203,289376,2013-06-18,Assembly,"Do pass and re-refer to Committee on Appropriations with 	recommendation:  To Consent Calendar",14,0,0,1,15
512203,296066,2013-07-03,Assembly,"Do pass, to Consent Calendar",17,0,0,0,17
512203,297123,2013-08-08,Assembly,"SB 457 Monning  Consent Calendar Second Day  Regular Session",77,0,0,1,78
512205,308580,2014-01-14,Senate,"Do pass, but re-refer to the Committee on Appropriations",8,0,3,0,11
512205,312351,2014-01-27,Senate,"Senate 3rd Reading SB456 Padilla",35,0,4,0,39
512207,262611,2013-04-10,Senate,"Do pass as amended, and re-refer to the Committee on 	Appropriations",7,1,1,0,9
512207,273656,2013-04-29,Senate,"Do pass",5,2,0,0,7
512207,278194,2013-05-09,Senate,"Senate 3rd Reading SB455 Hernandez",20,15,3,0,38
512207,278195,2013-05-09,Senate,"Senate 3rd Reading SB455 Hernandez Reconsider",35,0,3,0,38
512207,278622,2013-05-13,Senate,"Senate 3rd Reading SB455 Hernandez",23,10,5,0,38
512207,296140,2013-07-02,Assembly,"Do pass and be re-referred to the Committee on Appropriations",14,3,0,2,19
512207,377062,2014-08-13,Assembly,"Do pass",13,4,0,0,17
512207,377749,2014-08-19,Assembly,"SB 455 Hernandez  Senate Third Reading  By BOCANEGRA",49,22,0,8,79
512207,377921,2014-08-20,Senate,"From committee:  That the Assembly Amendments be concurred in",5,3,1,0,9
512207,378720,2014-08-27,Senate,"Unfinished Business SB455 Hernandez Concurrence",23,8,9,0,40
512208,262643,2013-04-09,Senate,"Do pass as amended, and re-refer to the Committee on Energy, 	Utilities and Communications",6,3,2,0,11
512208,274145,2013-04-30,Senate,"Do pass as amended, and re-refer to the Committee on Appropriations",6,4,1,0,11
512208,281406,2013-05-20,Senate,"Placed on Appropriations Suspense file",6,0,1,0,7
512208,283064,2013-05-23,Senate,"Do pass as amended",5,2,0,0,7
512208,285083,2013-05-29,Senate,"Senate 3rd Reading SB454 Corbett",28,11,0,0,39
512208,295809,2013-07-01,Assembly,"Do pass and be re-referred to the Committee on Appropriations",10,3,0,3,16
512208,298322,2013-08-30,Assembly,"Do pass as amended",12,5,0,0,17
512208,298930,2013-09-09,Assembly,"SB 454 Corbett  Senate Third Reading  By LOWENTHAL",51,25,0,2,78
512208,299139,2013-09-10,Senate,"Unfinished Business SB454 Corbett Concurrence",25,11,3,0,39
512209,272326,2013-04-24,Senate,"Do pass, but re-refer to the Committee on Appropriations",2,6,1,0,9
512209,272327,2013-04-24,Senate,"Set, first hearing.  Failed passage in Committee.  Reconsideration 	granted",9,0,0,0,9
512212,267542,2013-04-17,Senate,"Do pass, but re-refer to the Committee on Appropriations",2,0,7,0,9
512212,267543,2013-04-17,Senate,"Set, first hearing.  Failed passage in Committee.  Reconsideration 	granted",9,0,0,0,9
512213,267520,2013-04-17,Senate,"Do pass, but re-refer to the Committee on Appropriations",2,4,3,0,9
512213,267521,2013-04-17,Senate,"Set, second hearing.  Failed passage in Committee. 	Reconsideration granted",9,0,0,0,9
512218,270801,2013-04-23,Senate,"Do pass, but re-refer to the Committee on Appropriations",7,2,0,0,9
512218,278922,2013-05-13,Senate,"Placed on Appropriations Suspense file",5,0,2,0,7
512221,266587,2013-04-16,Senate,"Do pass as amended, and re-refer to the Committee on Transportation 	and Housing",6,4,1,0,11
512221,274175,2013-04-30,Senate,"Do pass as amended, and re-refer to the Committee on 	Appropriations",8,3,0,0,11
512221,278662,2013-05-13,Senate,"Placed on Appropriations Suspense file",5,0,2,0,7
512221,283330,2013-05-23,Senate,"Do pass as amended",5,2,0,0,7
512221,285192,2013-05-29,Senate,"Senate 3rd Reading SB448 Leno",25,12,2,0,39
512221,295864,2013-07-01,Assembly,"Do pass as amended and be re-referred to the Committee on 	Appropriations",10,3,0,3,16
512221,298451,2013-08-30,Assembly,"Do pass as amended",12,5,0,0,17
512221,299092,2013-09-09,Assembly,"SB 448 Leno  Senate Third Reading  By NAZARIAN",35,32,0,11,78
512221,299487,2013-09-11,Assembly,"SB 448 Leno  Senate Third Reading  By NAZARIAN",41,30,0,7,78
512221,299722,2013-09-12,Senate,"Unfinished Business SB448 Leno Concurrence",21,17,1,0,39
512222,271023,2013-04-23,Senate,"Do pass, but re-refer to the Committee on Appropriations Recommend 	Consent",9,0,0,0,9
512222,278259,2013-05-09,Senate,"Consent Calendar 2nd SB447 Lara",34,0,4,0,38
512222,297423,2013-08-12,Assembly,"Do pass as amended and be re-referred to the Committee on 	Appropriations",9,0,0,0,9
512222,298415,2013-08-30,Assembly,"Do pass, to Consent Calendar",17,0,0,0,17
512222,298828,2013-09-06,Assembly,"SB 447 Lara  Consent Calendar Second Day  Regular Session",77,0,0,1,78
512222,299796,2013-09-12,Senate,"Special Consent #10 SB447 Lara",39,0,0,0,39
512223,275317,2013-05-01,Senate,"Do pass, but re-refer to the Committee on Appropriations",7,0,0,0,7
512223,278894,2013-05-13,Senate,"Placed on Appropriations Suspense file",5,0,2,0,7
512225,266751,2013-04-15,Senate,"Do pass, but re-refer to the Committee on Appropriations",9,1,0,0,10
512225,276317,2013-05-06,Senate,"Senate 3rd Reading SB445 Price",25,9,4,0,38
512225,297161,2013-08-08,Assembly,"Be referred to Committee on Public Safety",9,0,0,2,11
512225,363364,2014-05-08,Assembly,"Be referred to Committee on Environmental Safety and Toxic 	Materials",10,0,0,1,11
512225,372172,2014-06-17,Assembly,"Do pass and be re-referred to the Committee on Appropriations",5,1,0,1,7
512225,377283,2014-08-14,Assembly,"Do pass as amended",12,5,0,0,17
512225,378522,2014-08-26,Assembly,"SB 445 Hill  Third Reading Urgency  By ACHADJIAN",64,8,0,7,79
512225,378874,2014-08-28,Senate,"From committee:  That the Assembly Amendments be concurred in",5,0,2,0,7
512225,379049,2014-08-29,Senate,"Unfinished Business SB445 Hill Concurrence",33,4,3,0,40
512228,262773,2013-04-10,Senate,"Do pass as amended, and re-refer to the Committee on 	Appropriations",9,0,0,0,9
512228,273560,2013-04-29,Senate,"Placed on Appropriations Suspense file",7,0,0,0,7
512228,283096,2013-05-23,Senate,"Do pass",7,0,0,0,7
512228,285645,2013-05-30,Senate,"Senate 3rd Reading SB443 Walters",38,0,1,0,39
512228,372344,2014-06-17,Assembly,"Do pass as amended and be re-referred to the Committee on 	Appropriations",5,1,0,1,7
512230,262927,2013-04-10,Senate,"Do pass as amended, and re-refer to the Committee on Appropriations",7,0,0,0,7
512230,276362,2013-05-06,Senate,"Special Consent #3 SB442 Wyland",32,0,6,0,38
512230,287906,2013-06-10,Assembly,"Do pass as amended and be re-referred to the Committee on 	Appropriations",9,0,0,0,9
512230,295987,2013-07-03,Assembly,"Do pass, to Consent Calendar",17,0,0,0,17
512230,297113,2013-08-08,Assembly,"SB 442 Wyland  Consent Calendar Second Day  Regular Session",77,0,0,1,78
512230,297969,2013-08-22,Senate,"Unfinished Business SB442 Wyland Concurrence",37,0,2,0,39
512232,272254,2013-04-24,Senate,"Do pass, but re-refer to the Committee on Appropriations",4,4,1,0,9
512232,272255,2013-04-24,Senate,"Set, first hearing.  Failed passage in Committee.  Reconsideration 	granted",9,0,0,0,9
512232,275516,2013-05-01,Senate,"Do pass, but re-refer to the Committee on Appropriations",3,0,6,0,9
512233,275710,2013-05-01,Senate,"Do pass, but re-refer to the Committee on Appropriations",9,0,0,0,9
512233,278923,2013-05-13,Senate,"Placed on Appropriations Suspense file",5,0,2,0,7
512233,283186,2013-05-23,Senate,"Do pass as amended",7,0,0,0,7
512233,284632,2013-05-28,Senate,"Senate 3rd Reading SB440 Padilla",39,0,0,0,39
512233,297067,2013-08-06,Assembly,"Do pass and be re-referred to the Committee on Appropriations",11,0,0,2,13
512233,298396,2013-08-30,Assembly,"Do pass as amended",17,0,0,0,17
512233,299015,2013-09-09,Assembly,"SB 440 Padilla  Senate Third Reading  By WEBER",77,0,0,1,78
512233,299182,2013-09-10,Senate,"Unfinished Business SB440 Padilla Concurrence",37,0,2,0,39
512234,274792,2013-04-30,Senate,"Do pass",5,2,0,0,7
512234,281319,2013-05-20,Senate,"Senate 3rd Reading SB439 Steinberg",22,12,5,0,39
512234,289375,2013-06-18,Assembly,"Do pass and be re-referred to the Committee on Health",5,1,0,1,7
512237,272034,2013-04-24,Senate,"Do pass, but re-refer to the Committee on Appropriations",3,1,1,0,5
512237,276363,2013-05-06,Senate,"Placed on Appropriations Suspense file",7,0,0,0,7
512237,283192,2013-05-23,Senate,"Do pass",5,2,0,0,7
512237,284564,2013-05-28,Senate,"Senate 3rd Reading SB438 Hancock",30,9,0,0,39
512237,292234,2013-06-26,Assembly,"Do pass and be re-referred to the Committee on Appropriations",6,1,0,0,7
512239,274849,2013-05-01,Senate,"Do pass, but re-refer to the Committee on Appropriations",7,1,1,0,9
512239,284561,2013-05-28,Senate,"Senate 3rd Reading SB436 Jackson",28,10,1,0,39
512239,291743,2013-06-24,Assembly,"Do pass and be re-referred to the Committee on Appropriations",6,3,0,0,9
512239,296098,2013-07-03,Assembly,"Do pass",12,5,0,0,17
512239,299551,2013-09-11,Assembly,"Do pass as amended",15,0,0,2,17
512239,299654,2013-09-12,Senate,"From committee:  That the Assembly Amendments be concurred in",5,0,4,0,9
512239,299655,2013-09-12,Assembly,"SB 436 Jackson  Third Reading Urgency  By WILLIAMS",74,1,0,3,78
512239,299656,2013-09-12,Senate,"Unfinished Supp 2 SB436 Jackson Concurrence",37,0,2,0,39
512240,262682,2013-04-10,Senate,"Do pass as amended, and re-refer to the Committee on Appropriations",4,1,0,0,5
512240,275632,2013-05-02,Senate,"Senate 3rd Reading SB435 Padilla",25,11,2,0,38
512240,297590,2013-08-14,Assembly,"Do pass and be re-referred to the Committee on Appropriations",6,1,0,0,7
512240,297871,2013-08-21,Assembly,"Do pass as amended",12,5,0,0,17
512240,298719,2013-09-04,Assembly,"SB 435 Padilla  Senate Third Reading  By HERNANDEZ",54,23,0,1,78
512240,298778,2013-09-06,Senate,"Unfinished Business SB435 Padilla Concurrence",25,12,2,0,39
512245,274734,2013-05-01,Senate,"Do pass as amended, and re-refer to the Committee on Appropriations",5,2,0,0,7
512245,281291,2013-05-20,Senate,"Do pass",4,2,1,0,7
512245,310339,2014-01-21,Senate,"Senate 3rd Reading SB434 Hill",26,2,11,0,39
512245,370178,2014-06-09,Assembly,"Do pass, to Consent Calendar",14,0,0,1,15
512245,371793,2014-06-16,Assembly,"SB 434 Hill  Consent Calendar Second Day  Regular Session",77,0,0,2,79
512245,377409,2014-08-14,Assembly,"SB 434 Hill  Senate Third Reading  By GORDON",79,0,0,0,79
512245,377650,2014-08-18,Senate,"Unfinished Business SB434 Hill Concurrence",27,0,13,0,40
512247,272383,2013-04-24,Senate,"Do pass as amended, and re-refer to the Committee on Appropriations",7,2,0,0,9
512247,278954,2013-05-13,Senate,"Placed on Appropriations Suspense file",5,0,2,0,7
512248,273489,2013-04-29,Senate,"Do pass, but re-refer to the Committee on Appropriations",10,0,0,0,10
512248,274763,2013-05-01,Senate,"Do pass, but re-refer to the Committee on Appropriations",6,1,0,0,7
512248,278673,2013-05-13,Senate,"Placed on Appropriations Suspense file",5,0,2,0,7
512250,263009,2013-04-10,Senate,"Do pass as amended, and re-refer to the Committee on Health",9,0,0,0,9
512250,275571,2013-05-01,Senate,"Do pass, but re-refer to the Committee on Appropriations",9,0,0,0,9
512250,281258,2013-05-20,Senate,"Placed on Appropriations Suspense file",6,0,1,0,7
512250,283231,2013-05-23,Senate,"Do pass",7,0,0,0,7
512250,284590,2013-05-28,Senate,"Senate 3rd Reading SB430 Wright",38,0,1,0,39
512250,291863,2013-06-26,Assembly,"Do pass and be re-referred to the Committee on Health",6,0,0,1,7
512253,259132,2013-04-03,Senate,"Do pass, but re-refer to the Committee on Appropriations Recommend 	Consent",9,0,0,0,9
512253,268618,2013-04-18,Senate,"Consent Calendar 2nd SB429 Hernandez",36,0,2,0,38
512253,289355,2013-06-18,Assembly,"Do pass and be re-referred to the Committee on Appropriations",7,0,0,0,7
512253,296131,2013-07-03,Assembly,"Do pass, to Consent Calendar",17,0,0,0,17
512253,297696,2013-08-19,Assembly,"SB 429 Hernandez  Senate Third Reading  By CHAU",76,1,0,1,78
512253,297918,2013-08-22,Senate,"Unfinished Business SB429 Hernandez Concurrence",37,0,2,0,39
512255,308982,2014-01-15,Senate,"Do pass, but re-refer to the Committee on Appropriations",4,3,2,0,9
512257,271024,2013-04-23,Senate,"Do pass, but re-refer to the Committee on Appropriations Recommend 	Consent",9,0,0,0,9
512257,278249,2013-05-09,Senate,"Consent Calendar 2nd SB427 Monning",34,0,4,0,38
512257,289326,2013-06-17,Assembly,"Do pass and be re-referred to the Committee on Water, Parks and 	Wildlife",15,0,0,1,16
512257,295906,2013-07-02,Assembly,"Do pass and re-refer to Committee on Appropriations with 	recommendation:  To Consent Calendar",15,0,0,0,15
512257,297510,2013-08-14,Assembly,"Do pass, to Consent Calendar",17,0,0,0,17
512257,297927,2013-08-22,Assembly,"SB 427 Monning  Consent Calendar Second Day  Regular Session",78,0,0,0,78
512257,298056,2013-08-26,Senate,"Unfinished Business SB427 Monning Concurrence",37,0,2,0,39
512259,271501,2013-04-23,Senate,"Do pass",5,2,0,0,7
512259,276258,2013-05-06,Senate,"Senate 3rd Reading SB426 Corbett",23,11,4,0,38
512259,289421,2013-06-18,Assembly,"Do pass",9,0,0,1,10
512259,291226,2013-06-24,Assembly,"SB 426 Corbett  Senate Third Reading  By WIECKOWSKI",74,1,0,4,79
512259,295303,2013-07-01,Senate,"Unfinished Business SB426 Corbett Concurrence",34,0,4,0,38
512260,261802,2013-04-09,Senate,"Do pass, but re-refer to the Committee on Governance and Finance",8,2,1,0,11
512260,275213,2013-05-01,Senate,"Do pass as amended, and re-refer to the Committee on Appropriations",5,2,0,0,7
512260,283919,2013-05-24,Senate,"Senate 3rd Reading SB425 DeSaulnier",35,0,4,0,39
512260,296085,2013-07-03,Assembly,"Do pass and be re-referred to the Committee on Appropriations",10,0,0,3,13
512260,297472,2013-08-14,Assembly,"Do pass, to Consent Calendar",17,0,0,0,17
512260,298072,2013-08-26,Assembly,"SB 425 DeSaulnier  Senate Third Reading  By FRAZIER",78,0,0,0,78
512266,308236,2014-01-13,Senate,"Do pass, but re-refer to the Committee on Appropriations",2,3,0,0,5
512266,308237,2014-01-13,Senate,"Set, first hearing.  Failed passage in Committee.  Reconsideration 	granted",5,0,0,0,5
512268,275694,2013-05-01,Senate,"Do pass as amended, and re-refer to the Committee on Appropriations",9,0,0,0,9
512268,281226,2013-05-20,Senate,"Placed on Appropriations Suspense file",6,0,1,0,7
512268,283111,2013-05-23,Senate,"Do pass as amended",7,0,0,0,7
512268,284946,2013-05-29,Senate,"Senate 3rd Reading SB421 Hernandez",37,0,2,0,39
512268,297441,2013-08-14,Assembly,"Do pass and be re-referred to the Committee on Appropriations",7,0,0,0,7
512271,274807,2013-04-30,Senate,"Do pass as amended",7,0,0,0,7
512271,284715,2013-05-28,Senate,"Senate 3rd Reading SB419 Block",38,0,1,0,39
512271,370658,2014-06-10,Assembly,"Do pass as amended and re-refer to Committee on Appropriations 	with recommendation:  To Consent Calendar",7,0,0,0,7
512271,375536,2014-07-02,Assembly,"Do pass as amended, to Consent Calendar",17,0,0,0,17
512271,377768,2014-08-19,Assembly,"SB 419 Block  Senate Third Reading  By MURATSUCHI",78,0,0,1,79
512271,378777,2014-08-27,Assembly,"SB 419 Block  Senate Third Reading  By MURATSUCHI",78,0,0,1,79
512271,378905,2014-08-28,Senate,"From committee:  That the Assembly Amendments be concurred in",5,0,2,0,7
512271,379115,2014-08-29,Senate,"Unfinished Supp 1 SB419 Block Concurrence",35,0,5,0,40
512272,261929,2013-04-09,Assembly,"Be adopted",8,0,0,1,9
512272,268594,2013-04-18,Assembly,"AJR 13 CAMPOS  Assembly Third Reading",75,0,0,4,79
512272,280313,2013-05-16,Senate,"Assembly 3rd Reading AJR13 Campos By Hueso",37,0,1,0,38
512272,283324,2013-05-23,Assembly,"AJR 13 CAMPOS  Concurrence in Senate Amendments",73,0,0,5,78
512275,243618,2013-03-07,Assembly,"From committee:  Be adopted.  To third reading",11,0,0,0,11
512275,256805,2013-04-01,Senate,"Special Consent Cal ACR23 Mullin",34,0,4,0,38
512277,243294,2013-03-07,Assembly,"From committee:  Be adopted.  To third reading",11,0,0,0,11
512277,250109,2013-03-18,Senate,"Special Consent Cal ACR22 Dickinson",31,0,6,0,37
512278,277207,2013-05-07,Assembly,"Be adopted and be re-referred to the Committee on Appropriations",5,1,0,1,7
512278,283980,2013-05-24,Assembly,"Be adopted",16,1,0,0,17
512278,285136,2013-05-29,Assembly,"ACA9 GORELL  Assembly Third Reading",46,19,0,14,79
512278,286013,2013-05-31,Assembly,"ACA9 GORELL  Motion to Reconsider",25,50,0,4,79
512279,271430,2013-04-23,Assembly,"Do pass and be re-referred to the Committee on Appropriations",8,2,0,0,10
512279,277603,2013-05-08,Assembly,"Do pass",12,5,0,0,17
512279,280407,2013-05-16,Assembly,"AB 868 AMMIANO  Assembly Third Reading",49,20,0,10,79
512279,288034,2013-06-11,Senate,"Do pass as amended, and re-refer to the Committee on 	Appropriations",5,2,0,0,7
512279,297798,2013-08-19,Senate,"Assembly 3rd Reading AB868 Ammiano By Lara",26,11,2,0,39
512279,297929,2013-08-22,Assembly,"AB 868 AMMIANO  Concurrence in Senate Amendments",54,23,0,1,78
512284,274317,2013-04-30,Assembly,"Do pass and be re-referred to the Committee on Appropriations",10,4,0,1,15
512284,279827,2013-05-15,Assembly,"Do pass",12,5,0,0,17
512284,284040,2013-05-24,Assembly,"AB 865 EGGMAN  Assembly Third Reading",51,17,0,10,78
512284,291789,2013-06-25,Senate,"Do pass, but re-refer to the Committee on Appropriations",7,2,0,0,9
512284,297702,2013-08-19,Senate,"Do pass as amended",5,2,0,0,7
512284,298641,2013-09-03,Senate,"Assembly 3rd Reading AB865 Eggman By Galgiani",23,11,5,0,39
512284,298810,2013-09-06,Assembly,"AB 865 EGGMAN  Concurrence in Senate Amendments",54,19,0,5,78
512287,270688,2013-04-23,Assembly,"Do pass as amended and be re-referred to the Committee on 	Appropriations",11,1,0,1,13
512294,258081,2013-04-02,Assembly,"Do pass as amended and be re-referred to the Committee on 	Appropriations",18,0,0,1,19
512298,270718,2013-04-23,Assembly,"Do pass and be re-referred to the Committee on Appropriations",5,2,0,0,7
512298,283877,2013-05-24,Assembly,"Do pass as amended",12,5,0,0,17
512298,285100,2013-05-29,Assembly,"AB 857 FONG  Assembly Third Reading",53,24,0,2,79
512298,296069,2013-07-02,Senate,"Do pass, but re-refer to the Committee on Appropriations",4,1,0,0,5
512298,297695,2013-08-19,Senate,"Placed on Appropriations Suspense file",7,0,0,0,7
512298,298413,2013-08-30,Senate,"Do pass",5,2,0,0,7
512298,299273,2013-09-10,Senate,"Assembly 3rd Reading AB857 Fong By Torres",23,11,5,0,39
512298,299527,2013-09-11,Assembly,"AB 857 FONG  Concurrence in Senate Amendments",51,25,0,2,78
512303,272199,2013-04-24,Assembly,"Do pass and be re-referred to the Committee on Appropriations",5,2,0,0,7
512303,277580,2013-05-08,Assembly,"Do pass",12,5,0,0,17
512303,281394,2013-05-20,Assembly,"AB 855 BROWN  Assembly Third Reading",46,27,0,5,78
512303,287737,2013-06-10,Senate,"Do pass, but re-refer to the Committee on Appropriations",3,2,0,0,5
512303,298577,2013-09-03,Senate,"Assembly 3rd Reading AB855 Brown By Beall",23,12,4,0,39
512303,298850,2013-09-06,Assembly,"AB 855 BROWN  Concurrence in Senate Amendments",46,30,0,2,78
512308,262676,2013-04-09,Assembly,"Do pass as amended and be re-referred to the Committee on 	Appropriations",18,1,0,0,19
512308,283862,2013-05-24,Assembly,"Do pass",17,0,0,0,17
512308,285130,2013-05-29,Assembly,"AB 852 QUIRK  Assembly Third Reading",75,2,0,2,79
512308,296068,2013-07-03,Senate,"Do pass as amended, and re-refer to the Committee on 	Appropriations",9,0,0,0,9
512308,297346,2013-08-12,Senate,"Placed on Appropriations Suspense file",6,0,1,0,7
512308,298403,2013-08-30,Senate,"Do pass as amended",7,0,0,0,7
512308,299735,2013-09-12,Senate,"W/O REF. TO FILE AB852 Dickinson By Steinberg",21,14,4,0,39
512308,299736,2013-09-13,Assembly,"AB 852 DICKINSON  Concurrence in Senate Amendments",26,35,0,17,78
512308,374136,2014-06-24,Senate,"Do pass, but re-refer to the Committee on Appropriations",11,0,0,0,11
512308,376805,2014-08-07,Senate,"Assembly 3rd Reading AB852 Dickinson By De Le",34,0,6,0,40
512308,377790,2014-08-18,Assembly,"Senate amendments be concurred in",16,0,0,0,16
512308,377791,2014-08-19,Assembly,"AB 852 DICKINSON  Concurrence in Senate Amendments",67,9,0,3,79
512311,272338,2013-04-24,Assembly,"Do pass and be re-referred to the Committee on Banking and Finance",9,0,0,0,9
512311,274225,2013-04-29,Assembly,"Do pass",12,0,0,0,12
512311,278028,2013-05-09,Assembly,"AB 850 NAZARIAN  Assembly Third Reading",72,0,0,7,79
512311,296022,2013-07-03,Senate,"Do pass as amended",7,0,0,0,7
512311,297278,2013-08-12,Senate,"Do pass",5,0,2,0,7
512311,298681,2013-09-03,Senate,"Assembly 3rd Reading AB850 Nazarian By Hernandez",38,0,1,0,39
512311,298882,2013-09-06,Assembly,"AB 850 NAZARIAN  Concurrence in Senate Amendments",76,0,0,2,78
512312,262115,2013-04-09,Assembly,"Do pass and be re-referred to the Committee on Appropriations",10,0,0,0,10
512312,284074,2013-05-24,Assembly,"Do pass as amended",17,0,0,0,17
512312,285067,2013-05-29,Assembly,"AB 849 GARCIA  Assembly Third Reading",76,0,0,3,79
512312,291804,2013-06-25,Senate,"Do pass, but re-refer to the Committee on Appropriations Recommend 	Consent",7,0,0,0,7
512312,297394,2013-08-12,Senate,"Placed on Appropriations Suspense file",6,0,1,0,7
512312,298309,2013-08-30,Senate,"Do pass",7,0,0,0,7
512312,299085,2013-09-09,Senate,"Assembly 3rd Reading AB849 Garcia By Corbett",39,0,0,0,39
512315,257548,2013-04-02,Assembly,"Do pass, to Consent Calendar",9,0,0,1,10
512315,260935,2013-04-08,Assembly,"AB 848 PATTERSON  Consent Calendar Second Day  Regular Session",75,0,0,4,79
512315,286955,2013-06-04,Senate,"Do pass and be placed on the Consent Calendar",6,0,1,0,7
512315,297424,2013-08-12,Senate,"Do pass",5,0,2,0,7
512315,298622,2013-09-03,Senate,"Assembly 3rd Reading AB848 Patterson By Cannella",38,0,1,0,39
512315,298795,2013-09-06,Assembly,"AB 848 PATTERSON  Concurrence in Senate Amendments",77,0,0,1,78
512321,274939,2013-04-30,Assembly,"Do pass and be re-referred to the Committee on Appropriations",5,0,0,2,7
512323,270909,2013-04-22,Assembly,"Do pass as amended and be re-referred to the Committee on Judiciary",8,3,0,1,12
512323,274302,2013-04-30,Assembly,"Do pass as amended and be re-referred to the Committee on 	Appropriations",7,3,0,0,10
512323,284090,2013-05-24,Assembly,"Do pass as amended",9,5,0,3,17
512323,285635,2013-05-30,Assembly,"AB 844 DICKINSON  Assembly Third Reading",47,24,0,8,79
512325,262349,2013-04-08,Assembly,"Do pass and be re-referred to the Committee on Appropriations",4,11,0,1,16
512325,262350,2013-04-08,Assembly,"Set first hearing.  Failed passage.  Reconsideration granted",16,0,0,0,16
512325,308756,2014-01-13,Assembly,"Do pass and be re-referred to the Committee on Appropriations",3,10,0,3,16
512327,266539,2013-04-16,Assembly,"Do pass",9,3,0,1,13
512327,268682,2013-04-18,Assembly,"AB 841 TORRES  Assembly Third Reading",57,16,0,6,79
512327,287774,2013-06-10,Senate,"Do pass",8,0,2,0,10
512327,298046,2013-08-26,Senate,"Assembly 3rd Reading AB841 Torres By Torres",30,6,3,0,39
512330,266810,2013-04-15,Assembly,"Do pass and be re-referred to the Committee on Appropriations",10,2,0,4,16
512330,284078,2013-05-24,Assembly,"Do pass as amended",12,5,0,0,17
512330,285958,2013-05-31,Assembly,"AB 840 AMMIANO  Assembly Third Reading",56,19,0,4,79
512335,271590,2013-04-23,Assembly,"Do pass as amended and be re-referred to the Committee on 	Appropriations",9,0,0,0,9
512335,279657,2013-05-15,Assembly,"Do pass, to Consent Calendar",17,0,0,0,17
512335,283248,2013-05-23,Assembly,"AB 837 CAMPOS  Consent Calendar Second Day  Regular Session",74,0,0,4,78
512335,289140,2013-06-17,Senate,"Do pass, but re-refer to the Committee on Appropriations",10,0,0,0,10
512335,370156,2014-06-09,Senate,"Do pass, but re-refer to the Committee on Judiciary",4,1,0,0,5
512335,372743,2014-06-17,Senate,"Do pass, but re-refer to the Committee on Appropriations",6,0,1,0,7
512335,376437,2014-08-04,Senate,"Placed on Appropriations Suspense file",7,0,0,0,7
512335,377374,2014-08-14,Senate,"Do pass",5,0,2,0,7
512335,378367,2014-08-25,Senate,"Assembly 3rd Reading AB837 Wieckowski By Wyland",31,2,7,0,40
512335,378697,2014-08-27,Assembly,"Senate amendments be concurred in",4,1,0,2,7
512335,378904,2014-08-28,Assembly,"AB 837 WIECKOWSKI  Concurrence in Senate Amendments",69,6,0,4,79
512336,257884,2013-04-02,Assembly,"Do pass as amended",13,0,0,0,13
512336,267507,2013-04-17,Assembly,"Do pass, to Consent Calendar",17,0,0,0,17
512336,272355,2013-04-25,Assembly,"AB 836 SKINNER  Consent Calendar Second Day  Regular Session",76,0,0,3,79
512336,287819,2013-06-10,Senate,"Do pass, but re-refer to the Committee on Appropriations",9,0,1,0,10
512336,291190,2013-06-24,Senate,"Do pass",7,0,0,0,7
512336,297712,2013-08-19,Senate,"Assembly 3rd Reading AB836 Skinner By Hernandez",37,0,2,0,39
512336,297924,2013-08-22,Assembly,"AB 836 SKINNER  Concurrence in Senate Amendments",78,0,0,0,78
512337,275484,2013-04-30,Assembly,"Do pass and be re-referred to the Committee on Appropriations",5,0,0,2,7
512337,279952,2013-05-15,Assembly,"Do pass",13,4,0,0,17
512337,284039,2013-05-24,Assembly,"AB 835 MURATSUCHI  Assembly Third Reading",56,15,0,7,78
512337,291555,2013-06-25,Senate,"Do pass as amended, and re-refer to the Committee on Appropriations",4,1,1,0,6
512340,265406,2013-04-15,Assembly,"Be referred to Committee on Natural Resources",11,0,0,0,11
512340,274285,2013-04-29,Assembly,"Do pass and be re-referred to the Committee on Appropriations",6,3,0,0,9
512340,280004,2013-05-15,Assembly,"Do pass",12,5,0,0,17
512340,283977,2013-05-24,Assembly,"AB 834 WILLIAMS  Assembly Third Reading",42,24,0,12,78
512340,295625,2013-07-01,Senate,"Do pass, but re-refer to the Committee on Education",10,0,0,0,10
512340,361781,2014-04-30,Senate,"Do pass as amended, but re-refer to the Committee on Appropriations 	Recommend Consent",9,0,0,0,9
512340,373231,2014-06-19,Senate,"Assembly 3rd Reading AB834 Williams Urgency Clause",34,0,6,0,40
512340,374527,2014-06-24,Assembly,"Senate amendments be concurred in",13,0,0,0,13
512340,375240,2014-06-30,Assembly,"AB 834 WILLIAMS  Concurrence- Urgency Added",78,0,0,1,79
512341,274164,2013-04-29,Assembly,"Do pass as amended and be re-referred to the Committee on 	Appropriations",8,0,0,1,9
512341,279860,2013-05-15,Assembly,"Do pass, to Consent Calendar",17,0,0,0,17
512341,283297,2013-05-23,Assembly,"AB 833 HARKEY  Consent Calendar Second Day  Regular Session",74,0,0,4,78
512341,289865,2013-06-19,Senate,"Do pass, but re-refer to the Committee on Appropriations",6,0,1,0,7
512341,295573,2013-07-01,Senate,"Placed on Appropriations Suspense file",6,0,1,0,7
512344,262665,2013-04-09,Assembly,"Do pass and be re-referred to the Committee on Appropriations",15,2,0,2,19
512348,262100,2013-04-09,Assembly,"Do pass and re-refer to Committee on Appropriations with 	recommendation:  To Consent Calendar",7,0,0,0,7
512348,267549,2013-04-17,Assembly,"Do pass, to Consent Calendar",17,0,0,0,17
512348,272263,2013-04-25,Assembly,"AB 829 FONG  Consent Calendar Second Day  Regular Session",76,0,0,3,79
512348,286907,2013-06-04,Senate,"Do pass, but re-refer to the Committee on Appropriations",4,0,1,0,5
512348,297714,2013-08-19,Senate,"Assembly 3rd Reading AB829 Fong By Anderson",37,0,2,0,39
512354,267445,2013-04-17,Assembly,"Do pass and be re-referred to the Committee on Appropriations",9,4,0,0,13
512354,279717,2013-05-15,Assembly,"Do pass",16,0,0,1,17
512354,283351,2013-05-23,Assembly,"AB 826 JONES-SAWYER  Assembly Third Reading  Amend By HAGMAN  Set 	#1  Motion to  Lay on the Table  By ATKINS",51,22,0,5,78
512354,283352,2013-05-23,Assembly,"AB 826 JONES-SAWYER  Assembly Third Reading",52,18,0,8,78
512354,291692,2013-06-25,Senate,"Do pass as amended, and re-refer to the Committee on 	Appropriations",7,4,0,0,11
512354,299251,2013-09-10,Senate,"Assembly 3rd Reading AB826 Jones-Sawyer Lay on Table",23,12,4,0,39
512354,299252,2013-09-10,Senate,"Assembly 3rd Reading AB826 Jones-Sawyer By Wright",25,12,2,0,39
512354,299509,2013-09-11,Assembly,"AB 826 JONES-SAWYER  Concurrence in Senate Amendments",49,26,0,3,78
512355,279126,2013-05-13,Assembly,"Do pass and be re-referred to the Committee on Appropriations",7,0,0,2,9
512357,277279,2013-05-07,Assembly,"Do pass, to Consent Calendar",10,0,0,0,10
512357,278650,2013-05-13,Assembly,"AB 824 JONES  Consent Calendar Second Day  Regular Session",75,0,0,4,79
512357,288109,2013-06-11,Senate,"Do pass and be placed on the Consent Calendar",7,0,0,0,7
512357,291201,2013-06-24,Senate,"Consent Calendar 2nd AB824 Jones",39,0,0,0,39
512360,274196,2013-04-29,Assembly,"Do pass and be re-referred to the Committee on Agriculture",6,3,0,0,9
512361,263139,2013-04-10,Assembly,"Do pass and be re-referred to the Committee on Elections and 	Redistricting",7,1,0,1,9
512361,271280,2013-04-23,Assembly,"Do pass as amended and be re-referred to the Committee on 	Appropriations",5,2,0,0,7
512361,279915,2013-05-15,Assembly,"Do pass",12,5,0,0,17
512361,283117,2013-05-23,Assembly,"AB 822 HALL  Assembly Third Reading",52,19,0,7,78
512361,289746,2013-06-18,Senate,"Do pass as amended, and re-refer to the Committee on Governance and 	Finance",4,0,1,0,5
512361,295990,2013-07-03,Senate,"Do pass as amended, and re-refer to the Committee on 	Appropriations",5,2,0,0,7
512361,297414,2013-08-12,Senate,"Placed on Appropriations Suspense file",6,0,1,0,7
512361,298383,2013-08-30,Senate,"Do pass",5,2,0,0,7
512361,299037,2013-09-09,Senate,"Assembly 3rd Reading AB822 Hall Lay on Table",26,11,2,0,39
512361,299038,2013-09-09,Senate,"Assembly 3rd Reading AB822 Hall",27,11,1,0,39
512361,299258,2013-09-10,Assembly,"AB 822 HALL  Concurrence in Senate Amendments",57,19,0,2,78
512363,262688,2013-04-10,Assembly,"Do pass and re-refer to Committee on Appropriations with 	recommendation:  To Consent Calendar",16,0,0,1,17
512363,274868,2013-05-01,Assembly,"Do pass",17,0,0,0,17
512363,278074,2013-05-09,Assembly,"AB 820 HALL  Assembly Third Reading",76,0,0,3,79
512370,276817,2013-05-07,Assembly,"Do pass as amended",5,2,0,0,7
512370,283333,2013-05-23,Assembly,"AB 817 BONTA  Assembly Third Reading",49,23,0,6,78
512370,289505,2013-06-18,Senate,"Do pass",4,0,1,0,5
512370,296229,2013-07-08,Senate,"Assembly 3rd Reading AB817 Bonta By Torres",22,10,6,0,38
512370,297118,2013-08-08,Assembly,"AB 817 BONTA  Concurrence in Senate Amendments",49,25,0,4,78
512371,262650,2013-04-10,Assembly,"Do pass and re-refer to Committee on Appropriations with 	recommendation:  To Consent Calendar",16,0,0,1,17
512371,275365,2013-05-01,Assembly,"Do pass, to Consent Calendar",17,0,0,0,17
512371,277991,2013-05-09,Assembly,"AB 816 HALL  Consent Calendar Second Day  Regular Session",75,0,0,4,79
512371,288208,2013-06-11,Senate,"Do pass, but re-refer to the Committee on Appropriations Recommend 	Consent",11,0,0,0,11
512374,268669,2013-04-17,Assembly,"Do pass and be re-referred to the Committee on Appropriations",2,5,0,0,7
512374,268670,2013-04-17,Assembly,"Set first hearing.  Failed passage.  Reconsideration granted",7,0,0,0,7
512374,309189,2014-01-15,Assembly,"Do pass and be re-referred to the Committee on Appropriations",2,5,0,0,7
512375,267449,2013-04-16,Assembly,"Do pass and be re-referred to the Committee on Appropriations",5,2,0,0,7
512377,261727,2013-04-09,Assembly,"Do pass as amended and be re-referred to the Committee on 	Appropriations",7,0,0,0,7
512377,274793,2013-05-01,Assembly,"Do pass, to Consent Calendar",17,0,0,0,17
512377,277974,2013-05-09,Assembly,"AB 813 MELENDEZ  Consent Calendar Second Day  Regular Session",75,0,0,4,79
512377,286827,2013-06-04,Senate,"Do pass, but re-refer to the Committee on Appropriations",4,0,1,0,5
512377,296190,2013-07-08,Senate,"Assembly 3rd Reading AB813 Melendez By Torres",33,0,5,0,38
512379,274867,2013-04-30,Assembly,"Do pass as amended and be re-referred to the Committee on 	Appropriations",5,0,0,2,7
512379,284028,2013-05-24,Assembly,"Do pass, to Consent Calendar",17,0,0,0,17
512379,284977,2013-05-29,Assembly,"AB 812 MITCHELL  Consent Calendar Second Day  Regular Session",77,0,0,2,79
512379,295960,2013-07-03,Senate,"Do pass, but re-refer to the Committee on Appropriations Recommend 	Consent",9,0,0,0,9
512379,297541,2013-08-15,Senate,"Consent Calendar 2nd AB812 Mitchell",38,0,1,0,39
512379,297699,2013-08-19,Assembly,"AB 812 MITCHELL  Concurrence in Senate Amendments",76,0,0,2,78
512380,276780,2013-05-07,Assembly,"Do pass, to Consent Calendar",12,0,0,1,13
512380,278607,2013-05-13,Assembly,"AB 811 LOWENTHAL  Consent Calendar Second Day  Regular Session",75,0,0,4,79
512380,296147,2013-07-03,Senate,"Do pass and be placed on the Consent Calendar",7,0,0,0,7
512380,297602,2013-08-15,Senate,"Consent Calendar 2nd AB811 Lowenthal",38,0,1,0,39
512380,297673,2013-08-19,Assembly,"AB 811 LOWENTHAL  Concurrence in Senate Amendments",77,0,0,1,78
512381,266221,2013-04-16,Assembly,"Do pass and re-refer to Committee on Appropriations with 	recommendation:  To Consent Calendar",7,0,0,0,7
512384,271244,2013-04-23,Assembly,"Do pass as amended and be re-referred to the Committee on Business, 	Professions and Consumer Protection",15,0,0,4,19
512384,276842,2013-05-07,Assembly,"Do pass",12,0,0,1,13
512384,278628,2013-05-13,Assembly,"AB 809 LOGUE  Third Reading Urgency",74,0,0,5,79
512384,289198,2013-06-17,Senate,"Do pass, but re-refer to the Committee on Health",10,0,0,0,10
512384,377485,2014-08-13,Senate,"Do pass",8,0,1,0,9
512384,377858,2014-08-19,Senate,"Assembly 3rd Reading AB809 Logue Urgency Clause",34,0,6,0,40
512384,377976,2014-08-20,Assembly,"AB 809 LOGUE  Concurrence in Senate Amendments",77,0,0,2,79
512387,266538,2013-04-16,Assembly,"Do pass and be re-referred to the Committee on Appropriations",10,2,0,1,13
512389,261762,2013-04-09,Assembly,"Do pass as amended and be re-referred to the Committee on 	Appropriations",6,1,0,0,7
512389,283989,2013-05-24,Assembly,"Do pass",14,3,0,0,17
512389,285270,2013-05-29,Assembly,"AB 807 AMMIANO  Assembly Third Reading  By JONES  Amend By CONWAY 	Set #1  Motion to  Lay on the Table  By ATKINS",52,25,0,2,79
512389,285271,2013-05-29,Assembly,"AB 807 AMMIANO  Assembly Third Reading",65,9,0,5,79
512389,291792,2013-06-25,Senate,"Do pass, but re-refer to the Committee on Appropriations",5,2,0,0,7
512389,297354,2013-08-12,Senate,"Placed on Appropriations Suspense file",6,0,1,0,7
512390,271657,2013-04-23,Assembly,"Do pass and be re-referred to the Committee on Appropriations",7,3,0,3,13
512390,279737,2013-05-15,Assembly,"Do pass",5,4,0,8,17
512390,279738,2013-05-15,Assembly,"Set first hearing.  Failed passage.  Reconsideration granted",17,0,0,0,17
512391,261683,2013-04-09,Assembly,"Do pass",7,0,0,0,7
512391,268437,2013-04-18,Assembly,"AB 805 JONES-SAWYER  Assembly Third Reading",77,0,0,2,79
512391,279220,2013-05-14,Senate,"Do pass",7,0,0,0,7
512391,287464,2013-06-06,Senate,"Assembly 3rd Reading AB805 Jones-Sawyer By Wright",37,0,2,0,39
512391,287733,2013-06-10,Assembly,"AB 805 JONES-SAWYER  Concurrence in Senate Amendments",73,0,0,6,79
512393,274122,2013-04-30,Assembly,"Do pass",18,0,0,1,19
512393,276237,2013-05-06,Assembly,"AB 804 LOWENTHAL  Assembly Third Reading",75,0,0,4,79
512395,266303,2013-04-16,Assembly,"Do pass as amended and be re-referred to the Committee on 	Appropriations",15,0,0,0,15
512395,275542,2013-04-30,Assembly,"Do pass and be re-referred to the Committee on Appropriations",7,0,0,0,7
512395,283755,2013-05-24,Assembly,"Do pass, to Consent Calendar",17,0,0,0,17
512395,285040,2013-05-29,Assembly,"AB 803 GOMEZ  Consent Calendar Second Day  Regular Session",77,0,0,2,79
512395,295948,2013-07-03,Senate,"Do pass as amended, but re-refer to the Committee on 	Appropriations Recommend Consent",9,0,0,0,9
512395,298018,2013-08-26,Senate,"Assembly 3rd Reading AB803 Gomez By Hueso",39,0,0,0,39
512395,298211,2013-08-30,Assembly,"AB 803 GOMEZ  Concurrence in Senate Amendments",78,0,0,0,78
512396,261862,2013-04-09,Assembly,"Do pass",7,2,0,1,10
512396,278803,2013-05-13,Assembly,"AB 802 WIECKOWSKI  Assembly Third Reading  Amend By WIECKOWSKI  Set 	#1",50,23,0,6,79
512396,313260,2014-01-29,Assembly,"AB 802 WIECKOWSKI  Assembly Third Reading",54,23,0,3,80
512396,374511,2014-06-24,Senate,"Do pass",5,2,0,0,7
512396,377709,2014-08-18,Senate,"Assembly 3rd Reading AB802 Wieckowski By Monning",21,12,7,0,40
512396,377932,2014-08-20,Assembly,"AB 802 WIECKOWSKI  Concurrence in Senate Amendments",56,21,0,2,79
512399,270943,2013-04-23,Assembly,"Do pass as amended and be re-referred to the Committee on 	Appropriations",5,2,0,0,7
512399,277521,2013-05-08,Assembly,"Do pass",12,5,0,0,17
512399,285728,2013-05-30,Assembly,"AB 800 GORDON  Assembly Third Reading",54,22,0,3,79
512399,296175,2013-07-02,Senate,"Do pass, but re-refer to the Committee on Appropriations",4,1,0,0,5
512399,299544,2013-09-11,Senate,"Assembly 3rd Reading AB800 Gordon By Lieu",26,12,1,0,39
512399,299545,2013-09-11,Senate,"Assembly 3rd Reading AB800 Gordon Reconsider",39,0,0,0,39
512399,299781,2013-09-12,Senate,"Assembly 3rd Reading AB800 Gordon By Lieu",27,12,0,0,39
512399,299782,2013-09-13,Assembly,"AB 800 GORDON  Concurrence in Senate Amendments",53,22,0,3,78
512399,325900,2014-02-20,Senate,"Assembly 3rd Reading AB800 Gordon Urgency Clause",27,9,3,0,39
512399,339774,2014-03-10,Assembly,"AB 800 GORDON  Concurrence- Urgency Added",54,19,0,7,80
512406,270128,2013-04-22,Assembly,"Do pass and be re-referred to the Committee on Appropriations",12,4,0,0,16
512406,274857,2013-05-01,Assembly,"Do pass",12,5,0,0,17
512406,278609,2013-05-13,Assembly,"AB 797 GORDON  Assembly Third Reading",53,22,0,4,79
512406,288120,2013-06-11,Senate,"Do pass, but re-refer to the Committee on Appropriations",11,0,0,0,11
512406,291465,2013-06-24,Senate,"Do pass",7,0,0,0,7
512406,298044,2013-08-26,Senate,"Assembly 3rd Reading AB797 Gordon By Beall",37,1,1,0,39
512407,260952,2013-04-08,Assembly,"Do pass as amended and be re-referred to the Committee on Natural 	Resources",12,3,0,0,15
512407,274592,2013-04-29,Assembly,"Do pass and be re-referred to the Committee on Appropriations",6,2,0,1,9
512407,279826,2013-05-15,Assembly,"Do pass",12,5,0,0,17
512407,283414,2013-05-23,Assembly,"AB 796 MURATSUCHI  Assembly Third Reading",54,20,0,4,78
512407,289492,2013-06-18,Senate,"Do pass, but re-refer to the Committee on Appropriations",6,3,2,0,11
512407,298269,2013-08-30,Senate,"Do pass, but re-refer to the Committee on Appropriations",8,0,3,0,11
512407,298890,2013-09-06,Senate,"Assembly 3rd Reading AB796 Muratsuchi Urgency Clause",38,0,1,0,39
512407,299561,2013-09-11,Assembly,"Senate amendments be concurred in",14,0,0,0,14
512407,299783,2013-09-12,Assembly,"AB 796 MURATSUCHI  Concurrence- Urgency Added",77,0,0,1,78
512408,266608,2013-04-16,Assembly,"Do pass and re-refer to Committee on Appropriations with 	recommendation:  To Consent Calendar",7,0,0,0,7
512411,265167,2013-04-15,Assembly,"Do pass as amended and be re-referred to the Committee on Natural 	Resources",12,0,0,3,15
512411,276252,2013-05-06,Assembly,"Do pass as amended",7,0,0,2,9
512411,283341,2013-05-23,Assembly,"AB 793 GRAY  Assembly Third Reading",65,4,0,9,78
512411,295854,2013-07-02,Senate,"Do pass as amended, and re-refer to the Committee on Appropriations",11,0,0,0,11
512411,297265,2013-08-12,Senate,"Placed on Appropriations Suspense file",6,0,1,0,7
512411,298510,2013-08-30,Senate,"Do pass",7,0,0,0,7
512413,258511,2013-04-03,Assembly,"Do pass",8,1,0,0,9
512413,278133,2013-05-09,Assembly,"AB 792 MULLIN  Assembly Third Reading",71,2,0,6,79
512413,296025,2013-07-03,Senate,"Do pass as amended",7,0,0,0,7
512413,298996,2013-09-09,Senate,"Assembly 3rd Reading AB792 Mullin By Hill",37,0,2,0,39
512413,299474,2013-09-11,Assembly,"Senate amendments be concurred in",8,0,0,1,9
512413,299802,2013-09-12,Assembly,"AB 792 MULLIN  Concurrence in Senate Amendments",65,1,0,12,78
512416,276761,2013-05-07,Assembly,"Do pass as amended",12,0,0,1,13
512416,283830,2013-05-24,Assembly,"Do pass, to Consent Calendar",17,0,0,0,17
512416,285107,2013-05-29,Assembly,"AB 791 HAGMAN  Consent Calendar Second Day  Regular Session",77,0,0,2,79
512416,295612,2013-07-01,Senate,"Do pass, but re-refer to the Committee on Appropriations",10,0,0,0,10
512416,297723,2013-08-19,Senate,"Do pass",7,0,0,0,7
512416,298060,2013-08-26,Senate,"Assembly 3rd Reading AB791 Hagman By Lieu",39,0,0,0,39
512416,298382,2013-08-30,Assembly,"AB 791 HAGMAN  Concurrence in Senate Amendments",78,0,0,0,78
512419,257438,2013-04-02,Assembly,"Do pass and be re-referred to the Committee on Appropriations",7,0,0,0,7
512419,262767,2013-04-10,Assembly,"Do pass",17,0,0,0,17
512419,273996,2013-04-29,Assembly,"AB 790 GOMEZ  Assembly Third Reading",78,0,0,1,79
512419,288152,2013-06-11,Senate,"Do pass, but re-refer to the Committee on Appropriations",6,1,0,0,7
512419,291229,2013-06-24,Senate,"Placed on Appropriations Suspense file",7,0,0,0,7
512420,257430,2013-04-02,Assembly,"Do pass and re-refer to Committee on Appropriations with 	recommendation:  To Consent Calendar",15,0,0,0,15
512420,267731,2013-04-17,Assembly,"Do pass, to Consent Calendar",17,0,0,0,17
512420,272349,2013-04-25,Assembly,"AB 789 WILLIAMS  Consent Calendar Second Day  Regular Session",76,0,0,3,79
512420,288155,2013-06-11,Senate,"Do pass, but re-refer to the Committee on Appropriations",9,0,0,0,9
512420,296216,2013-07-08,Senate,"Assembly 3rd Reading AB789 Williams By Hill",33,0,5,0,38
512420,297144,2013-08-08,Assembly,"AB 789 WILLIAMS  Concurrence in Senate Amendments",77,0,0,1,78
512421,266225,2013-04-16,Assembly,"Do pass as amended",10,0,0,0,10
512421,286054,2013-05-31,Assembly,"AB 788 WAGNER  Assembly Third Reading",57,11,0,11,79
512423,267671,2013-04-16,Assembly,"Do pass and be re-referred to the Committee on Judiciary to Consent 	Calendar",7,0,0,0,7
512423,270787,2013-04-23,Assembly,"Do pass and re-refer to Committee on Appropriations with 	recommendation:  To Consent Calendar",10,0,0,0,10
512423,277433,2013-05-08,Assembly,"Do pass, to Consent Calendar",17,0,0,0,17
512423,280274,2013-05-16,Assembly,"AB 787 STONE  Consent Calendar Second Day  Regular Session",70,0,0,9,79
512423,288280,2013-06-11,Senate,"Do pass, but re-refer to the Committee on Judiciary",6,0,0,0,6
512423,291625,2013-06-25,Senate,"Do pass, but re-refer to the Committee on Appropriations Recommend 	Consent",7,0,0,0,7
512423,297774,2013-08-19,Senate,"Placed on Appropriations Suspense file",7,0,0,0,7
512423,298216,2013-08-30,Senate,"Do pass",7,0,0,0,7
512423,299362,2013-09-11,Senate,"Assembly 3rd Reading AB787 Stone By Yee",39,0,0,0,39
512423,299623,2013-09-12,Assembly,"AB 787 STONE  Concurrence in Senate Amendments",78,0,0,0,78
512425,274260,2013-04-29,Assembly,"Do pass and be re-referred to the Committee on Appropriations",12,0,0,0,12
512425,279846,2013-05-15,Assembly,"Do pass",16,0,0,1,17
512425,283104,2013-05-23,Assembly,"AB 786 DICKINSON  Assembly Third Reading",72,1,0,5,78
512425,296024,2013-07-03,Senate,"Do pass, but re-refer to the Committee on Appropriations",6,0,3,0,9
512425,298616,2013-09-03,Senate,"Assembly 3rd Reading AB786 Dickinson By Correa",37,0,2,0,39
512425,298891,2013-09-06,Assembly,"AB 786 DICKINSON  Concurrence in Senate Amendments",77,0,0,1,78
512427,267450,2013-04-16,Assembly,"Do pass and be re-referred to the Committee on Human Services",13,5,0,1,19
512427,275144,2013-04-30,Assembly,"Do pass as amended and be re-referred to the Committee on 	Appropriations",4,1,0,2,7
512433,272351,2013-04-24,Assembly,"Do pass and re-refer to Committee on Appropriations with 	recommendation:  To Consent Calendar",16,0,0,1,17
512433,277391,2013-05-08,Assembly,"Do pass, to Consent Calendar",17,0,0,0,17
512433,280424,2013-05-16,Assembly,"AB 782 BOCANEGRA  Consent Calendar Second Day  Regular Session",70,0,0,9,79
512433,291622,2013-06-25,Senate,"Do pass, but re-refer to the Committee on Appropriations Recommend 	Consent",11,0,0,0,11
512433,297577,2013-08-15,Senate,"Consent Calendar 2nd AB782 Bocanegra",38,0,1,0,39
512433,297715,2013-08-19,Assembly,"AB 782 BOCANEGRA  Concurrence in Senate Amendments",77,0,0,1,78
512434,270851,2013-04-23,Assembly,"Do pass and be re-referred to the Committee on Revenue and Taxation",6,0,0,1,7
512434,274217,2013-04-29,Assembly,"Do pass and be re-referred to the Committee on Appropriations",8,0,0,1,9
512434,283799,2013-05-24,Assembly,"Do pass",16,0,0,1,17
512434,284674,2013-05-28,Assembly,"AB 781 BOCANEGRA  Assembly Third Reading",75,1,0,3,79
512434,289929,2013-06-19,Senate,"Do pass, but re-refer to the Committee on Public Safety",6,0,1,0,7
512434,295876,2013-07-02,Senate,"Do pass as amended, and re-refer to the Committee on Appropriations",7,0,0,0,7
512434,298803,2013-09-06,Senate,"Assembly 3rd Reading AB781 Bocanegra By Hancock",38,0,1,0,39
512434,299022,2013-09-09,Assembly,"AB 781 BOCANEGRA  Concurrence in Senate Amendments",75,3,0,0,78
512435,271887,2013-04-23,Assembly,"Do pass and be re-referred to the Committee on Appropriations",9,0,0,0,9
512435,283902,2013-05-24,Assembly,"Do pass",16,0,0,1,17
512435,285708,2013-05-30,Assembly,"AB 780 BOCANEGRA  Assembly Third Reading",76,0,0,3,79
512435,295577,2013-07-01,Senate,"Do pass as amended, and re-refer to the Committee on Appropriations",10,0,0,0,10
512435,297671,2013-08-19,Senate,"Placed on Appropriations Suspense file",7,0,0,0,7
512437,272599,2013-04-24,Assembly,"Do pass and be re-referred to the Committee on Appropriations",16,0,0,1,17
512437,277748,2013-05-08,Assembly,"Do pass, to Consent Calendar",17,0,0,0,17
512437,283950,2013-05-24,Assembly,"AB 779 BOCANEGRA  Assembly Third Reading",72,0,0,6,78
512437,291720,2013-06-25,Senate,"Do pass, but re-refer to the Committee on Appropriations",10,0,1,0,11
512437,298663,2013-09-03,Senate,"Assembly 3rd Reading AB779 Bocanegra By Padilla",38,0,1,0,39
512437,298837,2013-09-06,Assembly,"AB 779 BOCANEGRA  Concurrence in Senate Amendments",78,0,0,0,78
512438,305889,2014-01-06,Assembly,"Be referred to Committee on Public Employees, Retirement and Social 	Security",9,0,0,1,10
512438,309034,2014-01-15,Assembly,"Do pass and be re-referred to the Committee on Appropriations",5,2,0,0,7
512439,268700,2013-04-18,Assembly,"Be referred to Committee on Revenue and Taxation",9,0,0,2,11
512439,278902,2013-05-13,Assembly,"Do pass as amended and be re-referred to the Committee on 	Appropriations",7,0,0,2,9
512439,311495,2014-01-23,Assembly,"Do pass",16,0,0,1,17
512439,313273,2014-01-29,Assembly,"AB 777 MURATSUCHI  Assembly Third Reading",69,5,0,6,80
512439,330379,2014-02-26,Senate,"Do pass, but re-refer to the Committee on Appropriations",7,0,0,0,7
512439,352734,2014-04-07,Senate,"Do pass",7,0,0,0,7
512439,355147,2014-04-10,Senate,"Assembly 3rd Reading AB777 Muratsuchi By Roth",32,2,6,0,40
512439,359631,2014-04-24,Assembly,"AB 777 MURATSUCHI  Concurrence in Senate Amendments",70,2,0,7,79
512441,262788,2013-04-09,Assembly,"Do pass and be re-referred to the Committee on Aging and Long",18,0,0,1,19
512441,270812,2013-04-23,Assembly,"Do pass, to Consent Calendar",7,0,0,0,7
512441,277425,2013-05-08,Assembly,"Do pass, to Consent Calendar",17,0,0,0,17
512441,280393,2013-05-16,Assembly,"AB 776 YAMADA  Consent Calendar Second Day  Regular Session",70,0,0,9,79
512441,287206,2013-06-05,Senate,"Do pass, but re-refer to the Committee on Appropriations Recommend 	Consent",9,0,0,0,9
512441,297558,2013-08-15,Senate,"Assembly 3rd Reading AB776 Yamada By Leno",38,0,1,0,39
512441,297719,2013-08-19,Assembly,"AB 776 YAMADA  Concurrence in Senate Amendments",77,0,0,1,78
512445,268835,2013-04-17,Assembly,"Do pass and be re-referred to the Committee on Judiciary",6,2,0,1,9
512454,308336,2014-01-13,Assembly,"Do pass",9,0,0,0,9
512454,309866,2014-01-17,Assembly,"AB 769 SKINNER  Assembly Third Reading",72,0,0,8,80
512457,262365,2013-04-08,Assembly,"Do pass and be re-referred to the Committee on Local Government",10,6,0,0,16
512457,272301,2013-04-24,Assembly,"Do pass and be re-referred to the Committee on Appropriations",6,2,0,1,9
512457,277353,2013-05-08,Assembly,"Do pass",12,5,0,0,17
512457,280317,2013-05-16,Assembly,"AB 767 LEVINE  Assembly Third Reading",47,25,0,7,79
512457,288038,2013-06-11,Senate,"Do pass as amended, and re-refer to the Committee on 	Appropriations",8,3,0,0,11
512457,291189,2013-06-24,Senate,"Do pass",5,2,0,0,7
512457,297698,2013-08-19,Senate,"Assembly 3rd Reading AB767 Levine By DeSaulnier",25,12,2,0,39
512457,297914,2013-08-22,Assembly,"AB 767 LEVINE  Concurrence in Senate Amendments",45,30,0,3,78
512461,262314,2013-04-09,Assembly,"Do pass and be re-referred to the Committee on Appropriations",5,2,0,0,7
512463,266180,2013-04-16,Assembly,"Do pass and be re-referred to the Committee on Appropriations",12,0,0,1,13
512463,284086,2013-05-24,Assembly,"Do pass",17,0,0,0,17
512463,285569,2013-05-30,Assembly,"AB 764 LINDER  Assembly Third Reading",74,2,0,3,79
512464,266457,2013-04-16,Assembly,"Do pass and re-refer to Committee on Appropriations with 	recommendation:  To Consent Calendar",15,0,0,0,15
512464,283759,2013-05-24,Assembly,"Do pass",17,0,0,0,17
512464,285629,2013-05-30,Assembly,"AB 763 BUCHANAN  Assembly Third Reading",77,0,0,2,79
512464,291682,2013-06-25,Senate,"Do pass as amended, and re-refer to the Committee on Appropriations",9,0,0,0,9
512464,297297,2013-08-12,Senate,"Placed on Appropriations Suspense file",6,0,1,0,7
512464,298440,2013-08-30,Senate,"Do pass as amended",7,0,0,0,7
512464,299040,2013-09-09,Senate,"Assembly 3rd Reading AB763 Buchanan By Wolk",39,0,0,0,39
512464,299262,2013-09-10,Assembly,"AB 763 BUCHANAN  Concurrence in Senate Amendments",78,0,0,0,78
512465,270775,2013-04-22,Assembly,"Do pass and be re-referred to the Committee on Natural Resources",6,5,0,4,15
512465,270776,2013-04-22,Assembly,"Set first hearing.  Failed passage.  Reconsideration granted",15,0,0,0,15
512469,271535,2013-04-24,Assembly,"Do pass and be re-referred to the Committee on Appropriations",5,2,0,0,7
512472,274159,2013-04-30,Assembly,"Do pass as amended and be re-referred to the Committee on 	Appropriations",13,0,0,0,13
512472,279706,2013-05-15,Assembly,"Do pass",16,1,0,0,17
512472,283234,2013-05-23,Assembly,"AB 759 DALY  Assembly Third Reading",69,2,0,7,78
512472,308342,2014-01-13,Senate,"Do pass as amended, and re-refer to the Committee on 	Appropriations",9,0,1,0,10
512472,352635,2014-04-07,Senate,"Assembly 3rd Reading AB759 Daly Urgency Clause",33,0,7,0,40
512472,358492,2014-04-22,Assembly,"Senate amendments be concurred in",14,0,0,0,14
512472,360085,2014-04-28,Assembly,"AB 759 DALY  Concurrence- Urgency Added",75,0,0,4,79
512476,274262,2013-04-30,Assembly,"Do pass as amended and re-refer to Committee on Appropriations 	with recommendation:  To Consent Calendar",15,0,0,0,15
512476,279761,2013-05-15,Assembly,"Do pass",17,0,0,0,17
512476,283346,2013-05-23,Assembly,"AB 757 HERNANDEZ  Assembly Third Reading",72,0,0,6,78
512476,288191,2013-06-11,Senate,"Do pass, but re-refer to the Committee on Natural Resources and 	Water",11,0,0,0,11
512476,291787,2013-06-25,Senate,"Do pass as amended, and re-refer to the Committee on Appropriations",8,0,1,0,9
512476,297686,2013-08-19,Senate,"Assembly 3rd Reading AB757 Roger Hern",37,0,2,0,39
512476,297907,2013-08-22,Assembly,"AB 757 HERNANDEZ  Concurrence in Senate Amendments",78,0,0,0,78
512479,266894,2013-04-15,Assembly,"Do pass and be re-referred to the Committee on Appropriations",14,0,0,2,16
512479,274951,2013-05-01,Assembly,"Do pass",13,2,0,2,17
512479,280596,2013-05-16,Assembly,"AB 755 AMMIANO  Assembly Third Reading",57,10,0,12,79
512479,295903,2013-07-02,Senate,"Do pass as amended, and re-refer to the Committee on 	Appropriations",10,1,0,0,11
512479,299190,2013-09-10,Senate,"Assembly 3rd Reading AB755 Ammiano By DeSaulnier",33,0,6,0,39
512479,299526,2013-09-11,Assembly,"AB 755 AMMIANO  Concurrence in Senate Amendments",60,14,0,4,78
512483,270150,2013-04-22,Assembly,"Do pass as amended and be re-referred to the Committee on 	Appropriations",9,0,0,0,9
512483,277310,2013-05-08,Assembly,"Do pass, to Consent Calendar",17,0,0,0,17
512483,283329,2013-05-23,Assembly,"AB 754 MURATSUCHI  Assembly Third Reading",70,2,0,6,78
512483,291927,2013-06-26,Senate,"Do pass, but re-refer to the Committee on Appropriations",7,0,0,0,7
512483,297393,2013-08-12,Senate,"Do pass",4,0,3,0,7
512483,298041,2013-08-26,Senate,"Assembly 3rd Reading AB754 Muratsuchi By Pavley",33,3,3,0,39
512484,267333,2013-04-16,Assembly,"Amend, and do pass as amended and be re-referred to the Committee 	on Aging and Long",19,0,0,0,19
512484,270747,2013-04-23,Assembly,"Do pass, to Consent Calendar",7,0,0,0,7
512484,277382,2013-05-08,Assembly,"Do pass, to Consent Calendar",17,0,0,0,17
512484,280248,2013-05-16,Assembly,"AB 753 LOWENTHAL  Consent Calendar Second Day  Regular Session",70,0,0,9,79
512484,295928,2013-07-03,Senate,"Do pass, but re-refer to the Committee on Appropriations Recommend 	Consent",9,0,0,0,9
512484,298016,2013-08-26,Senate,"Consent Calendar 2nd AB753 Lowenthal",39,0,0,0,39
512484,298314,2013-08-30,Assembly,"AB 753 LOWENTHAL  Concurrence in Senate Amendments",78,0,0,0,78
512485,257581,2013-04-02,Assembly,"Do pass",5,2,0,0,7
512485,263501,2013-04-11,Assembly,"AB 752 JONES-SAWYER  Assembly Third Reading",45,26,0,8,79
512485,279433,2013-05-14,Senate,"Do pass",5,2,0,0,7
512485,290698,2013-06-20,Senate,"Assembly 3rd Reading AB752 Jones-Sawyer By Liu",24,12,3,0,39
512493,274184,2013-04-30,Assembly,"Do pass as amended and be re-referred to the Committee on 	Appropriations",9,0,0,1,10
512493,279710,2013-05-15,Assembly,"Do pass",12,5,0,0,17
512493,285622,2013-05-30,Assembly,"AB 748 EGGMAN  Assembly Third Reading",64,14,0,1,79
512493,295985,2013-07-02,Senate,"Do pass as amended, and re-refer to the Committee on 	Appropriations",5,1,1,0,7
512493,297717,2013-08-19,Senate,"Do pass as amended",7,0,0,0,7
512493,299076,2013-09-09,Senate,"Assembly 3rd Reading AB748 Eggman By Leno",39,0,0,0,39
512493,299300,2013-09-10,Assembly,"AB 748 EGGMAN  Concurrence in Senate Amendments",76,1,0,1,78
512494,266576,2013-04-15,Assembly,"Do pass and re-refer to Committee on Appropriations with 	recommendation:  To Consent Calendar",16,0,0,0,16
512494,274923,2013-05-01,Assembly,"Do pass",17,0,0,0,17
512494,278110,2013-05-09,Assembly,"AB 747 LEVINE  Assembly Third Reading",76,0,0,3,79
512494,286890,2013-06-04,Senate,"Do pass, but re-refer to the Committee on Appropriations Recommend 	Consent",10,0,1,0,11
512494,291249,2013-06-24,Senate,"Placed on Appropriations Suspense file",7,0,0,0,7
512494,298486,2013-08-30,Senate,"Do pass",7,0,0,0,7
512494,370075,2014-06-05,Senate,"Special Consent #16 AB747 Levine",33,0,7,0,40
512494,370177,2014-06-09,Assembly,"AB 747 LEVINE  Concurrence in Senate Amendments",77,0,0,2,79
512496,267307,2013-04-17,Assembly,"Do pass and be re-referred to the Committee on Governmental 	Organization",2,5,0,0,7
512496,274733,2013-05-01,Assembly,"Reconsideration granted",7,0,0,0,7
512496,305726,2014-01-06,Assembly,"Be referred to Committee on Housing and Community Development",9,0,0,1,10
512498,305867,2014-01-06,Assembly,"Be referred to Committee on Local Government",9,0,0,1,10
512498,309124,2014-01-15,Assembly,"Do pass, to Consent Calendar",9,0,0,0,9
512498,310376,2014-01-21,Assembly,"AB 745 LEVINE  Consent Calendar Second Day  Regular Session",75,0,0,5,80
512498,364368,2014-05-14,Senate,"Do pass as amended",6,0,1,0,7
512498,370078,2014-06-05,Senate,"Special Consent #16 AB745 Levine By Wolk",33,0,7,0,40
512498,370230,2014-06-09,Assembly,"AB 745 LEVINE  Concurrence in Senate Amendments",77,0,0,2,79
512499,266378,2013-04-15,Assembly,"Do pass and re-refer to Committee on Appropriations with 	recommendation:  To Consent Calendar",9,0,0,0,9
512499,275125,2013-05-01,Assembly,"Do pass, to Consent Calendar",17,0,0,0,17
512499,278225,2013-05-09,Assembly,"AB 744 GORDON  Consent Calendar Second Day  Regular Session",75,0,0,4,79
512499,289998,2013-06-19,Senate,"Do pass, but re-refer to the Committee on Appropriations",9,0,0,0,9
512499,299486,2013-09-11,Senate,"Do pass, but re-refer to the Committee on Appropriations",5,1,3,0,9
512499,299690,2013-09-12,Senate,"Do pass as amended",7,0,0,0,7
512499,299691,2013-09-12,Senate,"Assembly 3rd Supp 3 AB744 Dahle By Nielsen",26,5,8,0,39
512499,299692,2013-09-12,Assembly,"AB 744 DAHLE  Concurrence in Senate Amendments",75,1,0,2,78
512501,268781,2013-04-17,Assembly,"Do pass",9,0,0,0,9
512501,272269,2013-04-25,Assembly,"AB 743 LOGUE  Assembly Third Reading",77,0,0,2,79
512501,287382,2013-06-05,Senate,"Do pass as amended",7,0,0,0,7
512501,296234,2013-07-08,Senate,"Assembly 3rd Reading AB743 Logue By Nielsen",33,0,5,0,38
512501,297153,2013-08-08,Assembly,"AB 743 LOGUE  Concurrence in Senate Amendments",77,0,0,1,78
512505,274721,2013-04-30,Assembly,"Do pass and be re-referred to the Committee on Appropriations",5,2,0,0,7
512508,277384,2013-05-07,Assembly,"Do pass as amended, to Consent Calendar",7,0,0,0,7
512508,283136,2013-05-23,Assembly,"AB 739 SALAS  Consent Calendar Second Day",74,0,0,4,78
512508,374366,2014-06-24,Senate,"Do pass",7,0,0,0,7
512510,261872,2013-04-09,Assembly,"Do pass and be re-referred to the Committee on Appropriations",6,0,0,3,9
512510,262572,2013-04-10,Assembly,"Do pass",15,1,0,1,17
512510,268586,2013-04-18,Assembly,"AB 737 FOX  Third Reading Urgency",63,1,0,15,79
512511,271663,2013-04-23,Assembly,"Do pass and be re-referred to the Committee on Appropriations",11,1,0,1,13
512511,283833,2013-05-24,Assembly,"Do pass",13,4,0,0,17
512511,285655,2013-05-30,Assembly,"AB 736 FOX  Assembly Third Reading",69,7,0,3,79
512511,372794,2014-06-18,Senate,"Do pass as amended, but re-refer to the Committee on Appropriations 	Recommend Consent",7,0,0,0,7
512511,376648,2014-08-04,Senate,"Placed on Appropriations Suspense file",7,0,0,0,7
512515,274133,2013-04-30,Assembly,"Do pass and be re-referred to the Committee on Appropriations",11,3,0,1,15
512524,261706,2013-04-08,Assembly,"Do pass and be re-referred to the Committee on Local Government",10,6,0,0,16
512524,278057,2013-05-08,Assembly,"Do pass",6,2,0,1,9
512524,280379,2013-05-16,Assembly,"AB 730 ALEJO  Assembly Third Reading",49,23,0,7,79
512524,289716,2013-06-18,Senate,"Do pass, but re-refer to the Committee on Governance and Finance",8,2,1,0,11
512524,296075,2013-07-03,Senate,"Do pass",5,2,0,0,7
512524,297803,2013-08-19,Senate,"Assembly 3rd Reading AB730 Alejo By Monning",21,13,5,0,39
512524,299041,2013-09-09,Senate,"Assembly 3rd Reading AB730 Alejo By Monning",27,11,1,0,39
512524,299260,2013-09-10,Assembly,"AB 730 ALEJO  Concurrence in Senate Amendments",51,25,0,2,78
512525,274105,2013-04-30,Assembly,"Do pass as amended",7,3,0,0,10
512525,283262,2013-05-23,Assembly,"AB 729 HERNANDEZ  Assembly Third Reading  Amend By WAGNER  Set #1 	Motion to  Motion to  Lay on the Table  By ATKINS",52,22,0,4,78
512525,284679,2013-05-28,Assembly,"AB 729 HERNANDEZ  Assembly Third Reading",48,27,0,4,79
512525,296012,2013-07-02,Senate,"Do pass",4,2,1,0,7
512525,298594,2013-09-03,Senate,"Assembly 3rd Reading AB729 Roger Hern",23,10,6,0,39
512525,298774,2013-09-06,Assembly,"AB 729 HERNANDEZ  Concurrence in Senate Amendments",51,27,0,0,78
512529,257454,2013-04-01,Assembly,"Do pass and be re-referred to the Committee on Appropriations",6,1,0,2,9
512529,277402,2013-05-08,Assembly,"Do pass",17,0,0,0,17
512529,281297,2013-05-20,Assembly,"AB 727 STONE  Assembly Third Reading",74,0,0,4,78
512529,288200,2013-06-11,Senate,"Do pass, but re-refer to the Committee on Appropriations Recommend 	Consent",9,0,0,0,9
512529,295623,2013-07-01,Senate,"Consent Calendar 2nd AB727 Stone",33,0,5,0,38
512529,295931,2013-07-03,Assembly,"AB 727 STONE  Concurrence in Senate Amendments",73,0,0,5,78
512535,269954,2013-04-22,Assembly,"Do pass and be re-referred to the Committee on Appropriations",10,4,0,2,16
512536,257952,2013-04-02,Assembly,"Do pass and be re-referred to the Committee on Appropriations",7,0,0,0,7
512536,283754,2013-05-24,Assembly,"Do pass",17,0,0,0,17
512536,285557,2013-05-30,Assembly,"AB 723 QUIRK  Assembly Third Reading",66,12,0,1,79
512536,291524,2013-06-25,Senate,"Do pass as amended, and re-refer to the Committee on Appropriations",6,1,0,0,7
512536,297275,2013-08-12,Senate,"Placed on Appropriations Suspense file",6,0,1,0,7
512537,261751,2013-04-08,Assembly,"Do pass, to Consent Calendar",16,0,0,0,16
512537,265715,2013-04-15,Assembly,"AB 722 LOWENTHAL  Consent Calendar Second Day  Regular Session",77,0,0,2,79
512537,286903,2013-06-04,Senate,"Do pass",10,0,1,0,11
512537,296308,2013-07-08,Senate,"Assembly 3rd Reading AB722 Lowenthal By Galgiani",33,0,5,0,38
512537,297114,2013-08-08,Assembly,"AB 722 LOWENTHAL  Concurrence in Senate Amendments",77,0,0,1,78
512540,267014,2013-04-16,Assembly,"Do pass",5,2,0,0,7
512540,281715,2013-05-20,Assembly,"AB 721 BRADFORD  Assembly Third Reading",42,32,0,4,78
512540,288110,2013-06-11,Senate,"Do pass as amended",5,2,0,0,7
512540,298052,2013-08-26,Senate,"Assembly 3rd Reading AB721 Bradford By Wright",24,15,0,0,39
512540,298365,2013-08-30,Assembly,"AB 721 BRADFORD  Concurrence in Senate Amendments",44,33,0,1,78
512541,266344,2013-04-16,Assembly,"Do pass and be re-referred to the Committee on Appropriations",7,0,0,0,7
512541,283753,2013-05-24,Assembly,"Do pass as amended",13,4,0,0,17
512541,285044,2013-05-29,Assembly,"AB 720 SKINNER  Assembly Third Reading",56,19,0,4,79
512541,289852,2013-06-19,Senate,"Do pass, but re-refer to the Committee on Public Safety",7,2,0,0,9
512541,295758,2013-07-02,Senate,"Do pass as amended, and re-refer to the Committee on Appropriations",7,0,0,0,7
512541,297646,2013-08-19,Senate,"Placed on Appropriations Suspense file",7,0,0,0,7
512541,298600,2013-08-30,Senate,"Do pass as amended",6,1,0,0,7
512541,299431,2013-09-11,Assembly,"AB 720 SKINNER  Concurrence in Senate Amendments",59,17,0,2,78
512541,299432,2013-09-11,Senate,"Assembly 3rd Reading AB720 Skinner By Hernandez",36,0,3,0,39
512542,261431,2013-04-08,Assembly,"Do pass as amended and be re-referred to the Committee on 	Appropriations",10,3,0,2,15
512542,277577,2013-05-08,Assembly,"Do pass",12,5,0,0,17
512542,280258,2013-05-16,Assembly,"AB 719 HERNANDEZ  Assembly Third Reading",53,18,0,8,79
512542,289456,2013-06-18,Senate,"Do pass as amended, and re-refer to the Committee on Rules",6,2,3,0,11
512542,297362,2013-08-12,Senate,"Do pass",4,1,2,0,7
512542,298833,2013-09-06,Senate,"Assembly 3rd Reading AB719 Roger Hern",26,12,1,0,39
512542,299056,2013-09-09,Assembly,"AB 719 HERNANDEZ  Concurrence in Senate Amendments",54,22,0,2,78
512549,267470,2013-04-16,Assembly,"Do pass and be re-referred to the Committee on Appropriations",10,0,0,0,10
512549,274957,2013-05-01,Assembly,"Do pass, to Consent Calendar",17,0,0,0,17
512549,278156,2013-05-09,Assembly,"AB 717 CHAVEZ  Consent Calendar Second Day  Regular Session",75,0,0,4,79
512549,289039,2013-06-11,Senate,"Do pass, but re-refer to the Committee on Appropriations",7,0,0,0,7
512549,299773,2013-09-12,Assembly,"AB 717 CHAVEZ  Concurrence in Senate Amendments",77,0,0,1,78
512549,299774,2013-09-12,Senate,"Special Consent #10 AB717 Ch",39,0,0,0,39
512550,267475,2013-04-17,Assembly,"Do pass and be re-referred to the Committee on Budget",5,2,0,0,7
512550,278245,2013-05-09,Assembly,"Do pass",16,9,0,2,27
512550,280254,2013-05-16,Assembly,"AB 716 QUIRK-SILVA  Assembly Third Reading",51,20,0,8,79
512550,288017,2013-06-11,Senate,"Do pass, but re-refer to the Committee on Natural Resources and 	Water",7,4,0,0,11
512550,291574,2013-06-25,Senate,"Do pass, but re-refer to the Committee on Appropriations",7,2,0,0,9
512550,297381,2013-08-12,Senate,"Placed on Appropriations Suspense file",6,0,1,0,7
512551,277046,2013-05-07,Assembly,"Do pass as amended",7,2,0,1,10
512551,284757,2013-05-28,Assembly,"AB 715 DICKINSON  Assembly Third Reading",45,28,0,6,79
512551,296074,2013-07-02,Senate,"Do pass",4,2,1,0,7
512551,374430,2014-06-25,Senate,"Do pass and be placed on the Consent Calendar",6,0,1,0,7
512551,375705,2014-07-03,Senate,"Consent Calendar 2nd AB715 Dickinson",35,0,5,0,40
512551,377053,2014-08-13,Assembly,"Senate amendments be concurred in",8,0,0,1,9
512551,377726,2014-08-18,Assembly,"AB 715 DICKINSON  Concurrence in Senate Amendments",77,1,0,1,79
512554,267222,2013-04-16,Assembly,"Do pass and be re-referred to the Committee on Appropriations",16,2,0,1,19
512554,283776,2013-05-24,Assembly,"Do pass as amended",14,0,0,3,17
512554,285072,2013-05-29,Assembly,"AB 714 WIECKOWSKI  Assembly Third Reading",68,3,0,8,79
512554,296011,2013-07-03,Senate,"Do pass, but re-refer to the Committee on Appropriations",9,0,0,0,9
512554,297238,2013-08-12,Senate,"Placed on Appropriations Suspense file",6,0,1,0,7
512554,298329,2013-08-30,Senate,"Do pass",7,0,0,0,7
512554,298940,2013-09-09,Senate,"Assembly 3rd Reading AB714 Wieckowski By Corbett",39,0,0,0,39
512554,299152,2013-09-10,Assembly,"AB 714 WIECKOWSKI  Concurrence in Senate Amendments",75,1,0,2,78
512556,306116,2014-01-06,Assembly,"Do pass as amended and be re-referred to the Committee on 	Appropriations",12,0,0,0,12
512556,311176,2014-01-23,Assembly,"Do pass",16,0,0,1,17
512556,312208,2014-01-27,Assembly,"AB 713 WAGNER  Assembly Third Reading",73,1,0,6,80
512556,369840,2014-06-04,Senate,"Do pass, but re-refer to the Committee on Appropriations",8,0,1,0,9
512556,376441,2014-08-04,Senate,"Placed on Appropriations Suspense file",7,0,0,0,7
512558,266308,2013-04-16,Assembly,"Do pass as amended and be re-referred to the Committee on 	Appropriations",9,5,0,1,15
512558,277311,2013-05-08,Assembly,"Do pass",11,5,0,1,17
512558,280230,2013-05-16,Assembly,"AB 711 RENDON  Assembly Third Reading",44,21,0,14,79
512558,288031,2013-06-11,Senate,"Do pass as amended, and re-refer to the Committee on Appropriations",7,2,0,0,9
512558,291182,2013-06-24,Senate,"Placed on Appropriations Suspense file",7,0,0,0,7
512558,298342,2013-08-30,Senate,"Do pass as amended",5,2,0,0,7
512558,298958,2013-09-09,Senate,"Assembly 3rd Reading AB711 Rendon By Lieu",23,15,1,0,39
512558,299173,2013-09-10,Assembly,"AB 711 RENDON  Concurrence in Senate Amendments",44,29,0,5,78
512561,274565,2013-04-30,Assembly,"Do pass and be re-referred to the Committee on Appropriations",14,3,0,2,19
512562,274499,2013-04-30,Assembly,"Do pass and be re-referred to the Committee on Appropriations",6,4,0,5,15
512562,274500,2013-04-30,Assembly,"Set first hearing.  Failed passage.  Reconsideration granted",15,0,0,0,15
512565,263502,2013-04-11,Assembly,"Be referred to Committee on Transportation",10,0,0,1,11
512565,274139,2013-04-29,Assembly,"Do pass as amended and be re-referred to the Committee on 	Appropriations",16,0,0,0,16
512565,280019,2013-05-15,Assembly,"Do pass",13,4,0,0,17
512565,283911,2013-05-24,Assembly,"AB 707 TING  Assembly Third Reading",69,0,0,9,78
512565,291546,2013-06-25,Senate,"Do pass, but re-refer to the Committee on Appropriations",10,0,1,0,11
512565,297762,2013-08-19,Senate,"Assembly 3rd Reading AB707 Ting By Yee",37,0,2,0,39
512568,261799,2013-04-09,Assembly,"Do pass and be re-referred to the Committee on Veterans Affairs",13,0,0,0,13
512568,267446,2013-04-16,Assembly,"Do pass and be re-referred to the Committee on Appropriations",9,0,0,1,10
512569,262035,2013-04-09,Assembly,"Do pass and be re-referred to the Committee on Veterans Affairs",13,0,0,0,13
512569,267332,2013-04-16,Assembly,"Do pass and be re-referred to the Committee on Appropriations",10,0,0,0,10
512569,275386,2013-05-01,Assembly,"Do pass, to Consent Calendar",17,0,0,0,17
512569,278048,2013-05-09,Assembly,"AB 704 BLUMENFIELD  Consent Calendar Second Day  Regular Session",75,0,0,4,79
512569,296092,2013-07-03,Senate,"Do pass, but re-refer to the Committee on Appropriations Recommend 	Consent",9,0,0,0,9
512569,297401,2013-08-12,Senate,"Do pass",5,0,2,0,7
512569,298003,2013-08-26,Senate,"Assembly 3rd Reading AB704 Blumenfield By Lieu",39,0,0,0,39
512569,298804,2013-09-06,Assembly,"AB 704  Concurrence in Senate Amendments By FONG",78,0,0,0,78
512572,263460,2013-04-11,Assembly,"Be referred to Committee on Public Safety",10,0,0,1,11
512572,274821,2013-04-30,Assembly,"Do pass as amended and be re-referred to the Committee on 	Appropriations",6,0,0,1,7
512572,279782,2013-05-15,Assembly,"Do pass",17,0,0,0,17
512572,283089,2013-05-23,Assembly,"AB 703 HALL  Assembly Third Reading",71,0,0,7,78
512572,289457,2013-06-18,Senate,"Do pass as amended, and re-refer to the Committee on Appropriations",6,0,1,0,7
512572,297674,2013-08-19,Senate,"Assembly 3rd Reading AB703 Hall By Knight",35,0,4,0,39
512572,297886,2013-08-22,Assembly,"AB 703 HALL  Concurrence in Senate Amendments",75,0,0,3,78
512574,266233,2013-04-16,Assembly,"Do pass and be re-referred to the Committee on Appropriations",5,2,0,0,7
512575,262233,2013-04-09,Assembly,"Do pass and be re-referred to the Committee on Appropriations",6,2,0,1,9
512575,267601,2013-04-17,Assembly,"Do pass",12,5,0,0,17
512575,269983,2013-04-22,Assembly,"AB 701 PEREZ, J.  Assembly Third Reading",54,24,0,1,79
512575,288858,2013-06-12,Senate,"Do pass, but re-refer to the Committee on Appropriations",4,1,2,0,7
512575,299309,2013-09-10,Senate,"Do pass, but re-refer to the Committee on Appropriations",7,0,0,0,7
512575,299438,2013-09-11,Assembly,"Senate amendments be concurred in",9,0,0,0,9
512575,299439,2013-09-11,Senate,"Do pass",7,0,0,0,7
512575,299440,2013-09-11,Senate,"W/O REF. TO FILE AB701 Quirk-Silva By Correa",37,0,2,0,39
512575,299673,2013-09-12,Assembly,"AB 701 QUIRK-SILVA  Concurrence in Senate Amendments",77,0,0,1,78
512576,275682,2013-05-01,Assembly,"Do pass as amended and re-refer to Committee on Appropriations 	with recommendation:  To Consent Calendar",7,0,0,0,7
512576,283888,2013-05-24,Assembly,"Do pass as amended",17,0,0,0,17
512576,285689,2013-05-30,Assembly,"AB 700 GOMEZ  Assembly Third Reading",75,0,0,4,79
512576,289816,2013-06-19,Senate,"Do pass, but re-refer to the Committee on Appropriations",9,0,0,0,9
512576,298112,2013-08-26,Senate,"Assembly 3rd Reading AB700 Gomez By Wyland",39,0,0,0,39
512576,298853,2013-09-06,Assembly,"AB 700 GOMEZ  Concurrence in Senate Amendments",77,0,0,1,78
512580,275588,2013-05-01,Assembly,"Do pass and be re-referred to the Committee on Appropriations",2,4,0,1,7
512580,275589,2013-05-01,Assembly,"Set second hearing.  Failed passage.  Reconsideration granted",7,0,0,0,7
512587,277615,2013-05-07,Assembly,"Do pass, to Consent Calendar",7,0,0,0,7
512587,280319,2013-05-16,Assembly,"AB 694 BLOOM  Consent Calendar Second Day  Regular Session",70,0,0,9,79
512587,288134,2013-06-11,Senate,"Do pass",7,0,0,0,7
512587,296241,2013-07-08,Senate,"Assembly 3rd Reading AB694 Bloom By Pavley",33,0,5,0,38
512592,274886,2013-05-01,Assembly,"Do pass and be re-referred to the Committee on Appropriations",5,2,0,0,7
512592,279910,2013-05-15,Assembly,"Do pass",12,5,0,0,17
512592,285738,2013-05-30,Assembly,"AB 692  Assembly Third Reading  By PEREZ, V.M",60,13,0,6,79
512592,296337,2013-07-09,Senate,"Do pass as amended, and re-refer to the Committee on 	Appropriations",10,0,1,0,11
512592,370870,2014-06-10,Senate,"Do pass, but re-refer to the Committee on Appropriations",6,1,0,0,7
512593,274128,2013-04-29,Assembly,"Do pass and be re-referred to the Committee on Appropriations",6,2,0,1,9
512593,279700,2013-05-15,Assembly,"Do pass",12,5,0,0,17
512593,283063,2013-05-23,Assembly,"AB 691 MURATSUCHI  Assembly Third Reading",51,21,0,6,78
512593,291606,2013-06-25,Senate,"Do pass as amended, and re-refer to the Committee on Appropriations",7,2,0,0,9
512593,298770,2013-09-06,Senate,"Assembly 3rd Reading AB691 Muratsuchi By Hancock",24,13,2,0,39
512593,298974,2013-09-09,Assembly,"AB 691 MURATSUCHI  Concurrence in Senate Amendments",53,24,0,1,78
512594,305886,2014-01-06,Assembly,"Be referred to Committee on Jobs, Economic Development and The 	Economy",9,0,0,1,10
512594,309602,2014-01-15,Assembly,"Do pass as amended",9,0,0,0,9
512594,313385,2014-01-29,Assembly,"AB 690 CAMPOS  Assembly Third Reading",78,0,0,2,80
512594,374192,2014-06-23,Senate,"Do pass as amended, and re-refer to the Committee on 	Appropriations",8,0,1,0,9
512594,377112,2014-08-13,Senate,"Assembly 3rd Reading AB690 Campos By Hueso",36,0,4,0,40
512594,377849,2014-08-19,Assembly,"AB 690 CAMPOS  Concurrence in Senate Amendments",77,0,0,2,79
512595,257436,2013-04-02,Assembly,"Do pass as amended and be re-referred to the Committee on 	Appropriations",17,0,0,2,19
512598,260961,2013-04-08,Assembly,"Do pass as amended and be re-referred to the Committee on 	Environmental Safety and Toxic Materials",9,5,0,1,15
512598,275749,2013-04-30,Assembly,"Do pass and be re-referred to the Committee on Appropriations",5,1,0,1,7
512598,283787,2013-05-24,Assembly,"Do pass as amended",12,5,0,0,17
512598,285055,2013-05-29,Assembly,"AB 687 HERNANDEZ  Assembly Third Reading",51,22,0,6,79
512598,289465,2013-06-18,Senate,"Do pass, but re-refer to the Committee on Environmental Quality",6,2,3,0,11
512598,296138,2013-07-03,Senate,"Do pass as amended, and re-refer to the Committee on 	Appropriations",6,1,2,0,9
512598,297295,2013-08-12,Senate,"Placed on Appropriations Suspense file",6,0,1,0,7
512600,275613,2013-04-30,Assembly,"Do pass as amended and be re-referred to the Committee on 	Appropriations",7,0,0,0,7
512600,283872,2013-05-24,Assembly,"Do pass as amended",16,0,0,1,17
512600,285075,2013-05-29,Assembly,"AB 686 QUIRK  Assembly Third Reading",76,0,0,3,79
512602,261687,2013-04-09,Assembly,"Do pass, to Consent Calendar",6,0,0,1,7
512602,268562,2013-04-18,Assembly,"AB 685 ACHADJIAN  Consent Calendar Second Day  Regular Session",76,0,0,3,79
512602,279263,2013-05-14,Senate,"Do pass",7,0,0,0,7
512602,287710,2013-06-10,Senate,"Assembly 3rd Reading AB685 Achadjian By Knight",30,0,9,0,39
512604,262798,2013-04-09,Assembly,"Do pass and be re-referred to the Committee on Appropriations",12,0,0,1,13
512604,283819,2013-05-24,Assembly,"Do pass as amended",17,0,0,0,17
512604,285661,2013-05-30,Assembly,"AB 684 MEDINA  Assembly Third Reading",77,0,0,2,79
512604,291992,2013-06-26,Senate,"Do pass, but re-refer to the Committee on Education",4,0,1,0,5
512604,295962,2013-07-03,Senate,"Do pass, but re-refer to the Committee on Appropriations Recommend 	Consent",9,0,0,0,9
512604,297306,2013-08-12,Senate,"Placed on Appropriations Suspense file",6,0,1,0,7
512605,258462,2013-04-03,Assembly,"Do pass",7,2,0,0,9
512605,276327,2013-05-06,Assembly,"AB 683 MULLIN  Assembly Third Reading  Amend By MULLIN  Set #1",51,23,0,5,79
512605,278109,2013-05-09,Assembly,"AB 683 MULLIN  Assembly Third Reading",54,22,0,3,79
512605,295975,2013-07-03,Senate,"Do pass as amended",5,2,0,0,7
512605,298582,2013-09-03,Senate,"Assembly 3rd Reading AB683 Mullin By Beall",23,12,4,0,39
512605,298759,2013-09-06,Assembly,"AB 683 MULLIN  Concurrence in Senate Amendments",56,22,0,0,78
512606,275585,2013-05-01,Assembly,"Do pass and be re-referred to the Committee on Education",10,0,0,3,13
512606,309014,2014-01-15,Assembly,"Do pass and be re-referred to the Committee on Appropriations",7,0,0,0,7
512612,257459,2013-04-02,Assembly,"Do pass as amended",4,1,0,2,7
512612,263519,2013-04-11,Assembly,"AB 681 MELENDEZ  Assembly Third Reading",58,11,0,10,79
512612,296070,2013-07-02,Senate,"Do pass as amended",6,0,1,0,7
512612,297784,2013-08-19,Senate,"Assembly 3rd Reading AB681 Melendez By Walters",37,0,2,0,39
512612,298128,2013-08-27,Assembly,"Senate amendments be concurred in",10,0,0,0,10
512612,298412,2013-08-30,Assembly,"AB 681 MELENDEZ  Concurrence in Senate Amendments",78,0,0,0,78
512614,266515,2013-04-15,Assembly,"Do pass and be re-referred to the Committee on Appropriations",12,4,0,0,16
512614,274864,2013-05-01,Assembly,"Do pass",12,5,0,0,17
512614,277966,2013-05-09,Assembly,"AB 680 SALAS  Assembly Third Reading",54,18,0,7,79
512614,289431,2013-06-18,Senate,"Do pass, but re-refer to the Committee on Appropriations",8,2,1,0,11
512614,295711,2013-07-01,Senate,"Placed on Appropriations Suspense file",6,0,1,0,7
512616,272431,2013-04-24,Assembly,"Do pass and be re-referred to the Committee on Health",9,0,0,0,9
512616,274272,2013-04-30,Assembly,"Do pass and be re-referred to the Committee on Appropriations",19,0,0,0,19
512616,279974,2013-05-15,Assembly,"Do pass, to Consent Calendar",17,0,0,0,17
512616,283170,2013-05-23,Assembly,"AB 678 GORDON  Consent Calendar Second Day  Regular Session",74,0,0,4,78
512616,290039,2013-06-19,Senate,"Do pass, but re-refer to the Committee on Health",6,0,1,0,7
512616,296153,2013-07-03,Senate,"Do pass, but re-refer to the Committee on Appropriations Recommend 	Consent",9,0,0,0,9
512616,297382,2013-08-12,Senate,"Placed on Appropriations Suspense file",6,0,1,0,7
512621,267591,2013-04-16,Assembly,"Do pass and be re-referred to the Committee on Appropriations",11,6,0,2,19
512622,306257,2014-01-07,Assembly,"Do pass",12,0,0,1,13
512622,311229,2014-01-23,Assembly,"AB 675 FONG  Assembly Third Reading",70,0,0,10,80
512622,369888,2014-06-04,Senate,"Do pass as amended",6,0,1,0,7
512622,374845,2014-06-26,Senate,"Special Consent #17 AB675 Fong",32,0,8,0,40
512622,376394,2014-08-04,Assembly,"AB 675 FONG  Concurrence in Senate Amendments",73,1,0,5,79
512624,305954,2014-01-07,Assembly,"Do pass",8,0,0,1,9
512624,310356,2014-01-21,Assembly,"AB 674 QUIRK-SILVA  Assembly Third Reading",75,0,0,5,80
512624,371772,2014-06-16,Senate,"Do pass and be placed on the Consent Calendar",9,0,0,0,9
512624,374880,2014-06-26,Senate,"Consent Calendar 2nd AB674 Quirk-Silva",32,0,8,0,40
512626,256803,2013-04-01,Assembly,"Do pass and be re-referred to the Committee on Appropriations",9,0,0,0,9
512626,262723,2013-04-10,Assembly,"Do pass, to Consent Calendar",17,0,0,0,17
512626,268760,2013-04-18,Assembly,"AB 672 HARKEY  Consent Calendar Second Day  Regular Session",76,0,0,3,79
512626,287236,2013-06-05,Senate,"Do pass as amended, and re-refer to the Committee on Appropriations",7,0,0,0,7
512626,297603,2013-08-15,Senate,"Assembly 3rd Reading AB672 Harkey By Walters",38,0,1,0,39
512626,297685,2013-08-19,Assembly,"AB 672 HARKEY  Concurrence in Senate Amendments",76,0,0,2,78
512630,270701,2013-04-23,Assembly,"Do pass as amended and be re-referred to the Committee on 	Appropriations",8,2,0,3,13
512632,266870,2013-04-15,Assembly,"Do pass as amended and be re-referred to the Committee on 	Appropriations",6,3,0,0,9
512632,283999,2013-05-24,Assembly,"Do pass as amended",12,5,0,0,17
512632,285587,2013-05-30,Assembly,"AB 669 STONE  Assembly Third Reading",32,32,0,15,79
512634,274890,2013-05-01,Assembly,"Do pass and be re-referred to the Committee on Appropriations",5,4,0,0,9
512634,283912,2013-05-24,Assembly,"Do pass",11,5,0,1,17
512634,284717,2013-05-28,Assembly,"AB 667 HERNANDEZ  Assembly Third Reading",41,31,0,7,79
512634,291961,2013-06-26,Senate,"Do pass, but re-refer to the Committee on Appropriations",3,2,2,0,7
512634,291962,2013-06-26,Senate,"Set, first hearing.  Failed passage in Committee.  Reconsideration 	granted",7,0,0,0,7
512639,261797,2013-04-08,Assembly,"Amend, and do pass as amended and be re-referred to the Committee 	on Local Government with the recommendation:  To Consent Calendar",16,0,0,0,16
512639,272373,2013-04-24,Assembly,"Do pass and be re-referred to the Committee on Appropriations to 	Consent Calendar",9,0,0,0,9
512639,277334,2013-05-08,Assembly,"Do pass, to Consent Calendar",17,0,0,0,17
512639,280412,2013-05-16,Assembly,"AB 664 WILLIAMS  Consent Calendar Second Day  Regular Session",70,0,0,9,79
512639,295853,2013-07-02,Senate,"Do pass, but re-refer to the Committee on Appropriations",11,0,0,0,11
512639,298841,2013-09-06,Senate,"Assembly 3rd Reading AB664 Williams By Jackson",38,0,1,0,39
512643,267806,2013-04-16,Assembly,"Do pass as amended and be re-referred to the Committee on Aging and 	Long",5,2,0,0,7
512643,270720,2013-04-23,Assembly,"Do pass as amended",5,2,0,0,7
512643,279954,2013-05-15,Assembly,"Do pass",12,5,0,0,17
512643,283334,2013-05-23,Assembly,"AB 663 GOMEZ  Assembly Third Reading",52,21,0,5,78
512643,291805,2013-06-25,Senate,"Do pass, but re-refer to the Committee on Appropriations",4,2,0,0,6
512643,298687,2013-09-03,Senate,"Assembly 3rd Reading AB663 Gomez By Correa",26,11,2,0,39
512644,268717,2013-04-17,Assembly,"Do pass, to Consent Calendar",9,0,0,0,9
512644,272365,2013-04-25,Assembly,"AB 662 ATKINS  Consent Calendar Second Day  Regular Session",76,0,0,3,79
512644,287208,2013-06-05,Senate,"Do pass as amended, and re-refer to the Committee on Appropriations",7,0,0,0,7
512644,297777,2013-08-19,Senate,"Placed on Appropriations Suspense file",7,0,0,0,7
512644,298493,2013-08-30,Senate,"Do pass as amended",7,0,0,0,7
512644,299578,2013-09-11,Assembly,"Senate amendments be concurred in",9,0,0,0,9
512644,299579,2013-09-11,Senate,"Assembly 3rd Reading AB662 Atkins By DeSaulnier",36,0,3,0,39
512644,299611,2013-09-12,Assembly,"AB 662 ATKINS  Concurrence in Senate Amendments",78,0,0,0,78
512645,258750,2013-04-03,Assembly,"Do pass as amended and be re-referred to the Committee on 	Appropriations",9,3,0,1,13
512650,309006,2014-01-15,Assembly,"Do pass and be re-referred to the Committee on Appropriations",7,0,0,0,7
512650,311159,2014-01-23,Assembly,"Do pass as amended",16,0,0,1,17
512650,313227,2014-01-29,Assembly,"AB 659 NAZARIAN  Assembly Third Reading",78,0,0,2,80
512651,266489,2013-04-16,Assembly,"Do pass as amended and be re-referred to the Committee on 	Appropriations",10,0,0,0,10
512651,274702,2013-05-01,Assembly,"Do pass",17,0,0,0,17
512651,278120,2013-05-09,Assembly,"AB 658 CALDERON  Assembly Third Reading",76,0,0,3,79
512651,286935,2013-06-04,Senate,"Do pass, but re-refer to the Committee on Appropriations Recommend 	Consent",6,0,1,0,7
512651,297767,2013-08-19,Senate,"Assembly 3rd Reading AB658 Ian Calderon By Evans",37,0,2,0,39
512651,297965,2013-08-22,Assembly,"AB 658 CALDERON  Concurrence in Senate Amendments",78,0,0,0,78
512656,261704,2013-04-09,Assembly,"Do pass and be re-referred to the Committee on Appropriations",10,0,0,0,10
512656,279699,2013-05-15,Assembly,"Do pass",16,0,0,1,17
512656,283135,2013-05-23,Assembly,"AB 655 QUIRK-SILVA  Assembly Third Reading",71,1,0,6,78
512656,291605,2013-06-25,Senate,"Do pass, but re-refer to the Committee on Appropriations",6,1,0,0,7
512657,262921,2013-04-10,Assembly,"Do pass and be re-referred to the Committee on Appropriations",17,0,0,0,17
512657,275020,2013-05-01,Assembly,"Do pass",17,0,0,0,17
512657,278221,2013-05-09,Assembly,"AB 654 HALL  Assembly Third Reading",76,0,0,3,79
512657,295841,2013-07-02,Senate,"Do pass, but re-refer to the Committee on Appropriations",4,0,1,0,5
512657,297344,2013-08-12,Senate,"Do pass",5,0,2,0,7
512657,298910,2013-09-06,Senate,"Assembly 3rd Reading AB654 Hall By Evans",37,0,2,0,39
512657,299315,2013-09-10,Assembly,"Senate amendments be concurred in",4,0,0,3,7
512657,299567,2013-09-11,Assembly,"AB 654 HALL  Concurrence in Senate Amendments",76,0,0,2,78
512658,271674,2013-04-23,Assembly,"Do pass as amended and be re-referred to the Committee on Revenue 	and Taxation",9,0,0,0,9
512658,297182,2013-08-12,Assembly,"Do pass and be re-referred to the Committee on Appropriations",9,0,0,0,9
512660,277385,2013-05-07,Assembly,"Do pass",5,2,0,0,7
512660,281214,2013-05-20,Assembly,"AB 652 AMMIANO  Assembly Third Reading",51,23,0,4,78
512660,286847,2013-06-04,Senate,"Do pass",5,2,0,0,7
512660,298610,2013-09-03,Senate,"Assembly 3rd Reading AB652 Ammiano By Liu",24,12,3,0,39
512660,298788,2013-09-06,Assembly,"AB 652 AMMIANO  Concurrence in Senate Amendments",58,16,0,4,78
512661,257758,2013-04-02,Assembly,"Do pass",4,2,0,1,7
512661,278231,2013-05-09,Assembly,"AB 651 BRADFORD  Assembly Third Reading",42,32,0,5,79
512661,288159,2013-06-11,Senate,"Do pass, but re-refer to the Committee on Appropriations",5,2,0,0,7
512661,291214,2013-06-24,Senate,"Placed on Appropriations Suspense file",7,0,0,0,7
512661,298291,2013-08-30,Senate,"Do pass as amended",5,2,0,0,7
512661,298923,2013-09-09,Senate,"Assembly 3rd Reading AB651 Bradford By Wright",21,16,2,0,39
512661,299128,2013-09-10,Assembly,"AB 651 BRADFORD  Concurrence in Senate Amendments",46,32,0,0,78
512662,268040,2013-04-17,Assembly,"Do pass and be re-referred to the Committee on Appropriations",12,1,0,0,13
512662,277373,2013-05-08,Assembly,"Do pass",16,0,0,1,17
512662,280304,2013-05-16,Assembly,"AB 650 NAZARIAN  Assembly Third Reading",72,0,0,7,79
512662,288054,2013-06-11,Senate,"Do pass, but re-refer to the Committee on Appropriations",11,0,0,0,11
512662,295642,2013-07-01,Senate,"Do pass",6,0,1,0,7
512662,298659,2013-09-03,Senate,"Assembly 3rd Reading AB650 Nazarian By Wright",37,0,2,0,39
512662,298830,2013-09-06,Assembly,"AB 650 NAZARIAN  Concurrence in Senate Amendments",75,1,0,2,78
512664,274119,2013-04-29,Assembly,"Do pass as amended and be re-referred to the Committee on 	Appropriations",5,3,0,1,9
512666,270735,2013-04-23,Assembly,"Do pass as amended",8,1,0,1,10
512666,278682,2013-05-13,Assembly,"AB 648 JONES-SAWYER  Assembly Third Reading",49,24,0,6,79
512666,289387,2013-06-18,Senate,"Do pass as amended",5,1,1,0,7
512666,299211,2013-09-10,Senate,"Assembly 3rd Reading AB648 Jones-Sawyer By Corbett",25,11,3,0,39
512666,299394,2013-09-11,Assembly,"AB 648 JONES-SAWYER  Concurrence in Senate Amendments",54,23,0,1,78
512667,262771,2013-04-10,Assembly,"Do pass and be re-referred to the Committee on Appropriations",16,0,0,1,17
512667,274794,2013-05-01,Assembly,"Do pass, to Consent Calendar",17,0,0,0,17
512667,278042,2013-05-09,Assembly,"AB 647 CHESBRO  Consent Calendar Second Day  Regular Session",75,0,0,4,79
512667,288124,2013-06-11,Senate,"Do pass, but re-refer to the Committee on Appropriations",11,0,0,0,11
512667,298077,2013-08-26,Senate,"Assembly 3rd Reading AB647 Chesbro By Knight",39,0,0,0,39
512667,298441,2013-08-30,Assembly,"AB 647 CHESBRO  Concurrence in Senate Amendments",78,0,0,0,78
512668,309021,2014-01-15,Assembly,"Do pass and be re-referred to the Committee on Appropriations",6,0,0,1,7
513461,257630,2013-04-02,Assembly,"Do pass as amended and be re-referred to the Committee on 	Appropriations",6,3,0,1,10
513462,266391,2013-04-16,Assembly,"Do pass and be re-referred to the Committee on Appropriations",2,5,0,0,7
513463,271842,2013-04-24,Assembly,"Do pass and be re-referred to the Committee on Appropriations",5,1,0,1,7
513464,267408,2013-04-17,Assembly,"Do pass and be re-referred to the Committee on Local Government to 	Consent Calendar",7,0,0,0,7
513464,278193,2013-05-08,Assembly,"Do pass, to Consent Calendar",8,0,0,1,9
513464,280257,2013-05-16,Assembly,"AB 873 TORRES  Consent Calendar Second Day  Regular Session",70,0,0,9,79
513464,296336,2013-07-09,Senate,"Do pass, but re-refer to the Committee on Appropriations",10,0,1,0,11
513464,297722,2013-08-19,Senate,"Placed on Appropriations Suspense file",7,0,0,0,7
513464,298448,2013-08-30,Senate,"Do pass as amended",7,0,0,0,7
513464,299803,2013-09-12,Assembly,"Senate amendments be concurred in",6,0,0,0,6
513464,299804,2013-09-12,Assembly,"AB 873 CHAU  Concurrence in Senate Amendments",76,0,0,2,78
513464,299805,2013-09-12,Senate,"Special Consent #10 AB873 Chau By Torres",39,0,0,0,39
513466,265381,2013-04-15,Assembly,"Do pass and be re-referred to the Committee on Labor and Employment",11,4,0,0,15
513466,272437,2013-04-24,Assembly,"Do pass and be re-referred to the Committee on Appropriations",6,1,0,0,7
513466,277756,2013-05-08,Assembly,"Do pass",12,5,0,0,17
513467,274238,2013-04-29,Assembly,"Do pass and be re-referred to the Committee on Appropriations",9,0,0,0,9
513468,308609,2014-01-13,Assembly,"Do pass as amended and be re-referred to the Committee on 	Appropriations",14,0,0,1,15
513468,311220,2014-01-23,Assembly,"Do pass",16,0,0,1,17
513468,312230,2014-01-27,Assembly,"AB 876 BONTA  Assembly Third Reading",75,0,0,5,80
513468,374102,2014-06-23,Senate,"Do pass as amended, and re-refer to the Committee on Appropriations",10,0,1,0,11
513468,376630,2014-08-04,Senate,"Placed on Appropriations Suspense file",7,0,0,0,7
513469,309026,2014-01-15,Assembly,"Do pass",4,2,0,1,7
513469,312241,2014-01-27,Assembly,"AB 877 BOCANEGRA  Assembly Third Reading",50,24,0,6,80
513469,371112,2014-06-11,Senate,"Do pass, but re-refer to the Committee on Appropriations",5,1,1,0,7
513469,376887,2014-08-11,Senate,"Assembly 3rd Reading AB877 Bocanegra By Padilla",27,9,4,0,40
513469,378718,2014-08-27,Assembly,"Senate amendments be concurred in",7,1,0,1,9
513469,378916,2014-08-28,Assembly,"AB 877 BOCANEGRA  Concurrence in Senate Amendments",61,17,0,1,79
513472,274223,2013-04-29,Assembly,"Do pass and be re-referred to the Committee on Appropriations",8,0,0,1,9
513473,265231,2013-04-15,Assembly,"Be referred to Committee on Health",11,0,0,0,11
513473,274336,2013-04-30,Assembly,"Do pass and be re-referred to the Committee on Appropriations",13,5,0,1,19
513473,283760,2013-05-24,Assembly,"Do pass as amended",12,5,0,0,17
513473,292166,2013-06-27,Assembly,"AB 880 GOMEZ  Third Reading Urgency",46,27,0,6,79
513474,257444,2013-04-01,Assembly,"Do pass and be re-referred to the Committee on Water, Parks and 	Wildlife",6,2,0,1,9
513474,266415,2013-04-16,Assembly,"Do pass as amended and be re-referred to the Committee on 	Appropriations",8,4,0,3,15
513474,283790,2013-05-24,Assembly,"Do pass as amended",12,5,0,0,17
513474,285633,2013-05-30,Assembly,"AB 881 CHESBRO  Assembly Third Reading",43,30,0,6,79
513474,291579,2013-06-25,Senate,"Do pass, but re-refer to the Committee on Environmental Quality",7,2,0,0,9
513474,296053,2013-07-03,Senate,"Do pass, but re-refer to the Committee on Appropriations",8,1,0,0,9
513474,297373,2013-08-12,Senate,"Placed on Appropriations Suspense file",6,0,1,0,7
513474,298517,2013-08-30,Senate,"Do pass as amended",5,0,2,0,7
513475,261728,2013-04-09,Assembly,"Do pass and re-refer to Committee on Appropriations with 	recommendation:  To Consent Calendar",7,0,0,0,7
513475,267489,2013-04-17,Assembly,"Do pass, to Consent Calendar",17,0,0,0,17
513475,272454,2013-04-25,Assembly,"AB 882 GORDON  Consent Calendar Second Day  Regular Session",76,0,0,3,79
513475,286915,2013-06-04,Senate,"Do pass, but re-refer to the Committee on Appropriations Recommend 	Consent",4,0,1,0,5
513475,374383,2014-06-24,Senate,"From Committee:  That the measure be returned to the Senate floor 	for consideration",5,0,0,0,5
513475,377720,2014-08-18,Senate,"Assembly 3rd Reading AB882 Gordon By Torres",35,0,5,0,40
513475,377847,2014-08-19,Assembly,"AB 882 GORDON  Concurrence in Senate Amendments",78,0,0,1,79
513476,308651,2014-01-14,Assembly,"Do pass and be re-referred to the Committee on Appropriations",5,0,0,2,7
513476,311200,2014-01-23,Assembly,"Do pass as amended",16,0,0,1,17
513476,313216,2014-01-29,Assembly,"AB 883 COOLEY  Assembly Third Reading",77,0,0,3,80
513476,370427,2014-06-10,Senate,"Do pass as amended, but re-refer to the Committee on Appropriations 	Recommend Consent",4,0,1,0,5
513476,373725,2014-06-23,Senate,"Placed on Appropriations Suspense file",7,0,0,0,7
513476,377245,2014-08-14,Senate,"Do pass",5,0,2,0,7
513476,378562,2014-08-26,Senate,"Assembly 3rd Reading AB883 Cooley By Torres",33,0,7,0,40
513476,378650,2014-08-27,Assembly,"AB 883 COOLEY  Concurrence in Senate Amendments",78,0,0,1,79
513478,277708,2013-05-07,Assembly,"Do pass as amended",7,0,0,0,7
513478,281285,2013-05-20,Assembly,"AB 884 BONILLA  Assembly Third Reading",74,0,0,4,78
513478,288162,2013-06-11,Senate,"Do pass",7,0,0,0,7
513478,298115,2013-08-26,Senate,"Assembly 3rd Reading AB884 Bonilla By Hancock",39,0,0,0,39
513479,277481,2013-05-07,Assembly,"Do pass",5,2,0,0,7
513479,312309,2014-01-27,Assembly,"AB 885 AMMIANO  Assembly Third Reading",41,27,0,12,80
513479,374507,2014-06-24,Senate,"Do pass",5,2,0,0,7
513479,378947,2014-08-28,Senate,"Assembly 3rd Reading AB885 Ammiano By Leno",21,14,5,0,40
513479,379004,2014-08-29,Assembly,"AB 885 AMMIANO  Concurrence in Senate Amendments",47,28,0,4,79
513480,261931,2013-04-09,Assembly,"Do pass as amended and be re-referred to the Committee on Revenue 	and Taxation",8,0,0,1,9
513480,278724,2013-05-13,Assembly,"Do pass and be re-referred to the Committee on Appropriations",7,0,0,2,9
513482,276895,2013-05-07,Assembly,"Do pass as amended",10,0,0,0,10
513482,278775,2013-05-13,Assembly,"AB 888 DICKINSON  Assembly Third Reading",74,0,0,5,79
513482,291690,2013-06-25,Senate,"Do pass as amended",6,1,0,0,7
513482,299263,2013-09-10,Senate,"Assembly 3rd Reading AB888 Dickinson By Evans",36,1,2,0,39
513482,299386,2013-09-11,Assembly,"AB 888 DICKINSON  Concurrence- Urgency Added",77,1,0,0,78
513484,274286,2013-04-30,Assembly,"Do pass as amended and be re-referred to the Committee on 	Appropriations",15,4,0,0,19
513484,283964,2013-05-24,Assembly,"Do pass",13,4,0,0,17
513484,285139,2013-05-29,Assembly,"AB 889 FRAZIER  Assembly Third Reading",59,17,0,3,79
513484,291889,2013-06-26,Senate,"Do pass, but re-refer to the Committee on Appropriations",7,2,0,0,9
513484,297350,2013-08-12,Senate,"Placed on Appropriations Suspense file",6,0,1,0,7
513485,276893,2013-05-07,Assembly,"Do pass",7,1,0,5,13
513485,285726,2013-05-30,Assembly,"AB 890 JONES  Assembly Third Reading",50,18,0,11,79
513485,291599,2013-06-25,Senate,"Do pass",2,5,0,0,7
513485,291600,2013-06-25,Senate,"Set, first hearing.  Failed passage in Committee.  Reconsideration 	granted",7,0,0,0,7
513487,274823,2013-05-01,Assembly,"Do pass and be re-referred to the Committee on Appropriations",9,0,0,0,9
513491,271520,2013-04-23,Assembly,"Do pass and be re-referred to the Committee on Appropriations",10,3,0,0,13
513492,274353,2013-04-30,Assembly,"Do pass and re-refer to Committee on Appropriations with 	recommendation:  To Consent Calendar",15,0,0,0,15
513492,311256,2014-01-23,Assembly,"Do pass, to Consent Calendar",16,0,0,1,17
513492,313330,2014-01-29,Assembly,"AB 896 EGGMAN  Consent Calendar Second Day  Regular Session",78,0,0,2,80
513492,370561,2014-06-10,Senate,"Do pass, but re-refer to the Committee on Appropriations",8,1,0,0,9
513492,373880,2014-06-23,Senate,"Placed on Appropriations Suspense file",7,0,0,0,7
513492,377443,2014-08-14,Senate,"Do pass as amended",5,0,2,0,7
513492,378264,2014-08-22,Senate,"Assembly 3rd Reading AB896 Eggman By Wolk",28,3,9,0,40
513492,378449,2014-08-26,Assembly,"AB 896 EGGMAN  Concurrence in Senate Amendments",78,1,0,0,79
513496,275667,2013-05-01,Assembly,"Do pass as amended and be re-referred to the Committee on 	Appropriations",7,0,0,0,7
513496,283996,2013-05-24,Assembly,"Do pass as amended",17,0,0,0,17
513496,284947,2013-05-29,Assembly,"AB 899 WEBER  Assembly Third Reading",72,5,0,2,79
513496,296031,2013-07-03,Senate,"Do pass as amended, and re-refer to the Committee on Appropriations",9,0,0,0,9
513496,297310,2013-08-12,Senate,"Placed on Appropriations Suspense file",6,0,1,0,7
513496,298630,2013-08-30,Senate,"Do pass as amended",7,0,0,0,7
513496,299510,2013-09-11,Senate,"Assembly 3rd Reading AB899 Weber By Padilla",37,1,1,0,39
513496,299713,2013-09-12,Assembly,"AB 899 WEBER  Concurrence in Senate Amendments",77,1,0,0,78
513497,274073,2013-04-30,Assembly,"Do pass and be re-referred to the Committee on Appropriations",19,0,0,0,19
513497,283841,2013-05-24,Assembly,"Do pass as amended",17,0,0,0,17
513497,284991,2013-05-29,Assembly,"AB 900 ALEJO  Third Reading Urgency",76,0,0,3,79
513497,289854,2013-06-19,Senate,"Do pass as amended, and re-refer to the Committee on 	Appropriations",9,0,0,0,9
513497,297258,2013-08-12,Senate,"Placed on Appropriations Suspense file",6,0,1,0,7
513499,267015,2013-04-15,Assembly,"Do pass and be re-referred to the Committee on Appropriations",16,0,0,0,16
513499,274884,2013-05-01,Assembly,"Do pass, to Consent Calendar",17,0,0,0,17
513499,278082,2013-05-09,Assembly,"AB 902 GAINES  Consent Calendar Second Day  Regular Session",75,0,0,4,79
513499,288278,2013-06-11,Senate,"Do pass, but re-refer to the Committee on Appropriations",11,0,0,0,11
513499,291267,2013-06-24,Senate,"Do pass",7,0,0,0,7
513499,297711,2013-08-19,Senate,"Assembly 3rd Reading AB902 Beth Gaines By DeSaulnier",37,0,2,0,39
513502,274289,2013-04-29,Assembly,"Do pass and be re-referred to the Committee on Appropriations",8,0,0,1,9
513502,284064,2013-05-24,Assembly,"Do pass",17,0,0,0,17
513502,285118,2013-05-29,Assembly,"AB 904 CHESBRO  Assembly Third Reading",71,2,0,6,79
513502,291602,2013-06-25,Senate,"Do pass as amended, and re-refer to the Committee on Appropriations",7,0,2,0,9
513502,297759,2013-08-19,Senate,"Placed on Appropriations Suspense file",7,0,0,0,7
513502,298424,2013-08-30,Senate,"Do pass as amended",7,0,0,0,7
513502,298903,2013-09-06,Senate,"Assembly 3rd Reading AB904 Chesbro By Wolk",35,1,3,0,39
513502,299033,2013-09-09,Assembly,"AB 904 CHESBRO  Concurrence in Senate Amendments",76,0,0,2,78
513504,271759,2013-04-24,Assembly,"Do pass as amended and be re-referred to the Committee on 	Appropriations",5,2,0,0,7
513504,283893,2013-05-24,Assembly,"Do pass as amended",12,5,0,0,17
513504,285137,2013-05-29,Assembly,"AB 906 PAN  Assembly Third Reading",49,27,0,3,79
513504,297708,2013-08-19,Senate,"Do pass, but re-refer to the Committee on Governmental Organization",3,1,1,0,5
513504,297823,2013-08-20,Senate,"Do pass as amended, and re-refer to the Committee on 	Appropriations",7,0,3,0,10
513504,298073,2013-08-26,Senate,"Placed on Appropriations Suspense file",7,0,0,0,7
513504,298401,2013-08-30,Senate,"Do pass as amended",5,2,0,0,7
513504,299762,2013-09-12,Senate,"Assembly 3rd Supp 2 AB906 Pan By Yee",27,11,1,0,39
513504,299763,2013-09-12,Assembly,"AB 906 PAN  Concurrence in Senate Amendments",51,26,0,1,78
513505,306467,2014-01-08,Assembly,"Do pass and be re-referred to the Committee on Appropriations",2,5,0,0,7
513507,263150,2013-04-10,Assembly,"Do pass and re-refer to Committee on Appropriations with 	recommendation:  To Consent Calendar",13,0,0,0,13
513507,274830,2013-05-01,Assembly,"Do pass, to Consent Calendar",17,0,0,0,17
513507,277996,2013-05-09,Assembly,"AB 908 BONILLA  Consent Calendar Second Day  Regular Session",75,0,0,4,79
513507,288542,2013-06-12,Senate,"Do pass as amended, and re-refer to the Committee on Appropriations",5,0,0,0,5
513507,297911,2013-08-22,Senate,"Assembly 3rd Reading AB908 Bonilla By Padilla",37,0,2,0,39
513507,298030,2013-08-26,Assembly,"AB 908 BONILLA  Concurrence in Senate Amendments",78,0,0,0,78
513508,261763,2013-04-09,Assembly,"Do pass and re-refer to Committee on Appropriations with 	recommendation:  To Consent Calendar",6,0,0,1,7
513508,283892,2013-05-24,Assembly,"Do pass as amended",17,0,0,0,17
513508,285696,2013-05-30,Assembly,"AB 909 GRAY  Assembly Third Reading",77,1,0,1,79
513508,291776,2013-06-25,Senate,"Do pass as amended, and re-refer to the Committee on Appropriations",7,0,0,0,7
513508,297425,2013-08-12,Senate,"Placed on Appropriations Suspense file",6,0,1,0,7
513508,298416,2013-08-30,Senate,"Do pass as amended",7,0,0,0,7
513508,299054,2013-09-09,Senate,"Assembly 3rd Reading AB909 Gray By Berryhill",39,0,0,0,39
513508,299276,2013-09-10,Assembly,"AB 909 GRAY  Concurrence in Senate Amendments",77,1,0,0,78
513510,274137,2013-04-29,Assembly,"Do pass as amended and be re-referred to the Committee on 	Appropriations",15,0,0,0,15
513510,283840,2013-05-24,Assembly,"Do pass, to Consent Calendar",17,0,0,0,17
513510,285566,2013-05-30,Assembly,"AB 911 BLOOM  Assembly Third Reading",78,0,0,1,79
513510,295795,2013-07-02,Senate,"Do pass as amended, and re-refer to the Committee on Appropriations",10,0,1,0,11
513510,297694,2013-08-19,Senate,"Placed on Appropriations Suspense file",7,0,0,0,7
513511,274209,2013-04-30,Assembly,"Do pass and be re-referred to the Committee on Appropriations",13,6,0,0,19
513511,283962,2013-05-24,Assembly,"Do pass",12,5,0,0,17
513511,285099,2013-05-29,Assembly,"AB 912 QUIRK-SILVA  Assembly Third Reading",52,26,0,1,79
513511,292026,2013-06-26,Senate,"Do pass as amended, and re-refer to the Committee on 	Appropriations",7,2,0,0,9
513511,297356,2013-08-12,Senate,"Placed on Appropriations Suspense file",6,0,1,0,7
513511,298666,2013-08-30,Senate,"Do pass as amended",5,2,0,0,7
513511,298844,2013-09-06,Senate,"Assembly 3rd Reading AB912 Quirk-Silva By Jackson",24,12,3,0,39
513511,299282,2013-09-10,Assembly,"AB 912 QUIRK-SILVA  Concurrence in Senate Amendments",51,26,0,1,78
513513,272590,2013-04-24,Assembly,"Do pass and be re-referred to the Committee on Education",6,3,0,0,9
513513,278175,2013-05-08,Assembly,"Do pass and be re-referred to the Committee on Appropriations",5,0,0,2,7
513513,283774,2013-05-24,Assembly,"Do pass",12,5,0,0,17
513513,285263,2013-05-29,Assembly,"AB 913 CHAU  Assembly Third Reading  Amend By CHAU  Set #1",53,24,0,2,79
513513,285573,2013-05-30,Assembly,"AB 913 CHAU  Assembly Third Reading",53,23,0,3,79
513513,372716,2014-06-18,Senate,"Do pass as amended",4,2,1,0,7
513513,378833,2014-08-27,Senate,"Assembly 3rd Reading AB913 Chau By Monning",23,12,5,0,40
513513,378894,2014-08-28,Assembly,"AB 913 CHAU  Concurrence in Senate Amendments",55,24,0,0,79
513514,270790,2013-04-23,Assembly,"Do pass and be re-referred to the Committee on Judiciary",5,2,0,0,7
513514,274216,2013-04-30,Assembly,"Do pass and be re-referred to the Committee on Appropriations",8,2,0,0,10
513514,283854,2013-05-24,Assembly,"Do pass",12,5,0,0,17
513514,284955,2013-05-29,Assembly,"AB 914 GORDON  Assembly Third Reading",55,18,0,6,79
513514,295937,2013-07-02,Senate,"Do pass, but re-refer to the Committee on Appropriations",4,1,0,0,5
513515,270697,2013-04-23,Assembly,"Do pass and be re-referred to the Committee on Appropriations",5,2,0,0,7
513516,274141,2013-04-30,Assembly,"Do pass, to Consent Calendar",13,0,0,0,13
513516,276251,2013-05-06,Assembly,"AB 916 EGGMAN  Consent Calendar Second Day  Regular Session",77,0,0,2,79
513517,259708,2013-04-03,Assembly,"Do pass and be re-referred to the Committee on Appropriations",6,1,0,0,7
513517,262675,2013-04-10,Assembly,"Do pass",12,5,0,0,17
513517,273570,2013-04-29,Assembly,"AB 917 BRADFORD  Assembly Third Reading",53,23,0,3,79
513517,287190,2013-06-05,Senate,"Do pass, but re-refer to the Committee on Appropriations",6,2,1,0,9
513517,298104,2013-08-26,Senate,"Assembly 3rd Reading AB917 Bradford By De Le",26,11,2,0,39
513517,298457,2013-08-30,Assembly,"AB 917 BRADFORD  Concurrence in Senate Amendments",53,24,0,1,78
513519,272432,2013-04-24,Assembly,"Do pass as amended and be re-referred to the Committee on 	Appropriations",16,1,0,0,17
513519,277495,2013-05-08,Assembly,"Do pass",16,0,0,1,17
513519,280255,2013-05-16,Assembly,"AB 918 COOLEY  Assembly Third Reading",71,0,0,8,79
513519,291630,2013-06-25,Senate,"Do pass, but re-refer to the Committee on Appropriations Recommend 	Consent",11,0,0,0,11
513519,297561,2013-08-15,Senate,"Consent Calendar 2nd AB918 Cooley",38,0,1,0,39
513520,308358,2014-01-13,Assembly,"Do pass and be re-referred to the Committee on Appropriations",9,0,0,0,9
513520,311187,2014-01-23,Assembly,"Do pass",16,0,0,1,17
513520,313907,2014-01-30,Assembly,"AB 919 WILLIAMS  Assembly Third Reading",78,0,0,2,80
513520,370950,2014-06-11,Senate,"Do pass, but re-refer to the Committee on Appropriations",6,1,0,0,7
513520,375294,2014-06-30,Senate,"Placed on Appropriations Suspense file",6,0,1,0,7
513520,377223,2014-08-14,Senate,"Do pass",5,0,2,0,7
513520,378130,2014-08-21,Senate,"Assembly 3rd Reading AB919 Williams By Jackson",35,0,5,0,40
513520,378257,2014-08-22,Assembly,"AB 919 WILLIAMS  Concurrence in Senate Amendments",76,0,0,3,79
513521,268588,2013-04-17,Assembly,"Do pass and be re-referred to the Committee on Revenue and Taxation",7,0,0,2,9
513521,274355,2013-04-29,Assembly,"Do pass as amended and be re-referred to the Committee on 	Appropriations",6,2,0,1,9
513522,270873,2013-04-23,Assembly,"Do pass as amended and be re-referred to the Committee on 	Appropriations",5,2,0,0,7
513522,279762,2013-05-15,Assembly,"Do pass",12,5,0,0,17
513522,283922,2013-05-24,Assembly,"AB 921 JONES-SAWYER  Assembly Third Reading",49,22,0,7,78
513522,288179,2013-06-11,Senate,"Do pass, but re-refer to the Committee on Judiciary",5,2,0,0,7
513522,291667,2013-06-25,Senate,"Do pass, but re-refer to the Committee on Appropriations",5,2,0,0,7
513522,297342,2013-08-12,Senate,"Placed on Appropriations Suspense file",6,0,1,0,7
513522,298509,2013-08-30,Senate,"Do pass as amended",6,1,0,0,7
513522,299397,2013-09-11,Assembly,"AB 921 JONES-SAWYER  Concurrence in Senate Amendments",77,1,0,0,78
513522,299398,2013-09-11,Senate,"Assembly 3rd Reading AB921 Jones-Sawyer By De Le",32,7,0,0,39
513523,274202,2013-04-29,Assembly,"Do pass as amended and be re-referred to the Committee on 	Appropriations",15,0,0,0,15
513523,283944,2013-05-24,Assembly,"Do pass as amended",16,0,0,1,17
513523,285061,2013-05-29,Assembly,"AB 922 PATTERSON  Assembly Third Reading",70,4,0,5,79
513523,372945,2014-06-18,Senate,"Do pass as amended, and re-refer to the Committee on Appropriations",7,0,0,0,7
513523,376907,2014-08-11,Senate,"Assembly 3rd Reading AB922 Maienschein By Hueso",36,0,4,0,40
513523,378823,2014-08-27,Assembly,"Senate amendments be concurred in",8,0,0,1,9
513523,378982,2014-08-28,Assembly,"AB 922 MAIENSCHEIN  Concurrence in Senate Amendments",79,0,0,0,79
513527,274863,2013-04-30,Assembly,"Do pass",7,0,0,0,7
513527,285782,2013-05-30,Assembly,"AB 924 BIGELOW  Assembly Third Reading",77,0,0,2,79
513527,295888,2013-07-02,Senate,"Do pass as amended",7,0,0,0,7
513527,298696,2013-09-03,Senate,"Assembly 3rd Reading AB924 Bigelow By Berryhill",37,0,2,0,39
513527,298825,2013-09-06,Assembly,"AB 924 BIGELOW  Concurrence in Senate Amendments",78,0,0,0,78
513528,270960,2013-04-23,Assembly,"Do pass and be re-referred to the Committee on Appropriations",4,5,0,1,10
513528,270961,2013-04-23,Assembly,"Set first hearing.  Failed passage.  Reconsideration granted",10,0,0,0,10
513529,267756,2013-04-16,Assembly,"Do pass as amended and be re-referred to the Committee on 	Appropriations",14,5,0,0,19
513529,275626,2013-05-02,Assembly,"AB 926 BONILLA  Assembly Third Reading",54,20,0,5,79
513529,288408,2013-06-12,Senate,"Do pass",6,1,2,0,9
513529,295302,2013-07-01,Senate,"Assembly 3rd Reading AB926 Bonilla By DeSaulnier",24,9,5,0,38
513532,278272,2013-05-08,Assembly,"Do pass as amended and re-refer to Committee on Appropriations 	with recommendation:  To Consent Calendar",7,0,0,0,7
513532,283951,2013-05-24,Assembly,"Do pass, to Consent Calendar",17,0,0,0,17
513532,285221,2013-05-29,Assembly,"AB 928 OLSEN  Consent Calendar Second Day  Regular Session",77,0,0,2,79
513532,296156,2013-07-03,Senate,"Do pass as amended, and re-refer to the Committee on Appropriations",9,0,0,0,9
513532,370937,2014-06-10,Senate,"Do pass as amended, and re-refer to the Committee on 	Appropriations",6,0,1,0,7
513532,376853,2014-08-07,Senate,"Assembly 3rd Reading AB928 Olsen By Vidak",36,0,4,0,40
513532,377854,2014-08-19,Assembly,"Senate amendments be concurred in",10,0,0,0,10
513532,377988,2014-08-20,Assembly,"AB 928 OLSEN  Concurrence in Senate Amendments",78,0,0,1,79
513538,272409,2013-04-24,Assembly,"Do pass and be re-referred to the Committee on Appropriations",17,0,0,0,17
513538,283991,2013-05-24,Assembly,"Do pass, to Consent Calendar",17,0,0,0,17
513538,285672,2013-05-30,Assembly,"AB 933 SKINNER  Assembly Third Reading",76,0,0,3,79
513538,291527,2013-06-25,Senate,"Do pass, but re-refer to the Committee on Appropriations",10,0,1,0,11
513538,298942,2013-09-09,Senate,"Assembly 3rd Reading AB933 Skinner By Hancock",39,0,0,0,39
513538,299158,2013-09-10,Assembly,"AB 933 SKINNER  Concurrence in Senate Amendments",78,0,0,0,78
513539,272324,2013-04-24,Assembly,"Do pass and be re-referred to the Committee on Appropriations",9,0,0,0,9
513539,277448,2013-05-08,Assembly,"Do pass, to Consent Calendar",17,0,0,0,17
513539,280349,2013-05-16,Assembly,"AB 934 COOLEY  Consent Calendar Second Day  Regular Session",70,0,0,9,79
513539,288761,2013-06-12,Senate,"Do pass, but re-refer to the Committee on Appropriations",6,0,1,0,7
513539,298608,2013-09-03,Senate,"Assembly 3rd Reading AB934 Cooley By Lieu",37,0,2,0,39
513539,298887,2013-09-06,Assembly,"AB 934 COOLEY  Concurrence in Senate Amendments",77,0,0,1,78
513540,262832,2013-04-10,Assembly,"Do pass and be re-referred to the Committee on Appropriations",7,2,0,0,9
513540,274809,2013-05-01,Assembly,"Do pass",12,5,0,0,17
513540,277983,2013-05-09,Assembly,"AB 935 FRAZIER  Assembly Third Reading",48,22,0,9,79
513540,374965,2014-06-26,Senate,"Do pass, but re-refer to the Committee on Appropriations",10,0,1,0,11
513540,376411,2014-08-04,Senate,"Placed on Appropriations Suspense file",7,0,0,0,7
513540,377207,2014-08-14,Senate,"Do pass",5,0,2,0,7
513540,378290,2014-08-25,Senate,"Assembly 3rd Reading AB935 Frazier By Roth",32,0,8,0,40
513540,378598,2014-08-26,Assembly,"AB 935 FRAZIER  Concurrence in Senate Amendments",78,0,0,1,79
513543,276766,2013-05-07,Assembly,"Do pass as amended",8,1,0,1,10
513543,280385,2013-05-16,Assembly,"AB 937 WIECKOWSKI  Assembly Third Reading",68,3,0,8,79
513543,288202,2013-06-11,Senate,"Do pass",6,1,0,0,7
513543,296255,2013-07-08,Senate,"Assembly 3rd Reading AB937 Wieckowski By Wolk",32,1,5,0,38
513544,276765,2013-05-07,Assembly,"Do pass",5,1,0,1,7
513544,285681,2013-05-30,Assembly,"AB 938 WEBER  Assembly Third Reading",50,27,0,2,79
513544,374275,2014-06-25,Senate,"Do pass as amended, and re-refer to the Committee on Appropriations",6,0,1,0,7
513544,376632,2014-08-04,Senate,"Placed on Appropriations Suspense file",7,0,0,0,7
513544,377371,2014-08-14,Senate,"Do pass",5,0,2,0,7
513544,377945,2014-08-20,Senate,"Assembly 3rd Reading AB938 Weber By Block",25,7,8,0,40
513545,268446,2013-04-17,Assembly,"Do pass as amended and be re-referred to the Committee on Judiciary",5,0,0,2,7
513545,276807,2013-05-07,Assembly,"Do pass and be re-referred to the Committee on Appropriations",10,0,0,0,10
513545,283751,2013-05-24,Assembly,"Do pass as amended",17,0,0,0,17
513545,285032,2013-05-29,Assembly,"AB 939 MELENDEZ  Assembly Third Reading",76,0,0,3,79
513545,291849,2013-06-26,Senate,"Do pass, but re-refer to the Committee on Judiciary",9,0,0,0,9
513545,295978,2013-07-02,Senate,"Do pass as amended, and re-refer to the Committee on 	Appropriations",6,0,1,0,7
513545,297261,2013-08-12,Senate,"Placed on Appropriations Suspense file",6,0,1,0,7
513547,274966,2013-05-01,Assembly,"Do pass and be re-referred to the Committee on Appropriations",9,0,0,0,9
513551,271913,2013-04-23,Assembly,"Do pass and be re-referred to the Committee on Appropriations",13,0,0,0,13
513553,262776,2013-04-10,Assembly,"Do pass and be re-referred to the Committee on Transportation",9,0,0,0,9
513553,274140,2013-04-29,Assembly,"Do pass and be re-referred to the Committee on Appropriations",15,0,0,1,16
513553,279905,2013-05-15,Assembly,"Do pass, to Consent Calendar",17,0,0,0,17
513553,283356,2013-05-23,Assembly,"AB 946 STONE  Consent Calendar Second Day  Regular Session",74,0,0,4,78
513553,291619,2013-06-25,Senate,"Do pass as amended, and re-refer to the Committee on 	Appropriations",11,0,0,0,11
513553,298677,2013-09-03,Senate,"Assembly 3rd Reading AB946 Stone By Monning",35,0,4,0,39
513553,298864,2013-09-06,Assembly,"AB 946 STONE  Concurrence in Senate Amendments",77,0,0,1,78
513556,275663,2013-05-01,Assembly,"Do pass as amended and be re-referred to the Committee on 	Appropriations",6,0,0,1,7
513556,284041,2013-05-24,Assembly,"Do pass as amended",17,0,0,0,17
513556,285171,2013-05-29,Assembly,"AB 948 OLSEN  Assembly Third Reading",75,1,0,3,79
513556,292028,2013-06-26,Senate,"Do pass, but re-refer to the Committee on Appropriations Recommend 	Consent",9,0,0,0,9
513556,297431,2013-08-12,Senate,"Placed on Appropriations Suspense file",6,0,1,0,7
513556,377208,2014-08-14,Senate,"Do pass as amended",5,0,2,0,7
513556,378164,2014-08-21,Senate,"Assembly 3rd Reading AB948 Olsen By Liu",33,0,7,0,40
513556,378254,2014-08-22,Assembly,"AB 948 OLSEN  Concurrence in Senate Amendments",76,0,0,3,79
513558,263158,2013-04-09,Assembly,"Do pass and be re-referred to the Committee on Appropriations",8,4,0,1,13
513558,267538,2013-04-17,Assembly,"Do pass",12,5,0,0,17
513558,272419,2013-04-25,Assembly,"AB 950 CHAU  Assembly Third Reading",51,24,0,4,79
513558,296065,2013-07-03,Senate,"Do pass, but re-refer to the Committee on Appropriations",5,3,1,0,9
513558,297398,2013-08-12,Senate,"Placed on Appropriations Suspense file",6,0,1,0,7
513559,275811,2013-05-01,Assembly,"Do pass and re-refer to Committee on Appropriations with 	recommendation:  To Consent Calendar",7,0,0,0,7
513561,258752,2013-04-03,Assembly,"Do pass and be re-referred to the Committee on Revenue and Taxation",7,0,0,0,7
513561,278564,2013-05-13,Assembly,"Do pass and be re-referred to the Committee on Appropriations",9,0,0,0,9
513561,283779,2013-05-24,Assembly,"Do pass",17,0,0,0,17
513561,284945,2013-05-29,Assembly,"AB 952 ATKINS  Assembly Third Reading",78,0,0,1,79
513561,291656,2013-06-25,Senate,"Do pass as amended, but re-refer to the Committee on Governance and 	Finance Recommend Consent",9,0,2,0,11
513561,297517,2013-08-14,Senate,"Do pass, but re-refer to the Committee on Appropriations Recommend 	Consent",7,0,0,0,7
513561,298054,2013-08-26,Senate,"Placed on Appropriations Suspense file",7,0,0,0,7
513561,298368,2013-08-30,Senate,"Do pass",7,0,0,0,7
513561,299766,2013-09-12,Assembly,"AB 952 ATKINS  Concurrence in Senate Amendments",78,0,0,0,78
513561,299767,2013-09-12,Senate,"Special Consent #10 AB952 Atkins By DeSaulnier",39,0,0,0,39
513562,266678,2013-04-15,Assembly,"Do pass and be re-referred to the Committee on Appropriations",5,3,0,1,9
513562,277417,2013-05-08,Assembly,"Do pass",11,5,0,1,17
513563,267265,2013-04-16,Assembly,"Do pass and be re-referred to the Committee on Appropriations",7,0,0,0,7
513564,262737,2013-04-09,Assembly,"Do pass and be re-referred to the Committee on Appropriations",10,2,0,1,13
513564,274929,2013-05-01,Assembly,"Do pass",13,1,0,3,17
513564,281255,2013-05-20,Assembly,"AB 955 WILLIAMS  Assembly Third Reading",50,16,0,12,78
513564,288404,2013-06-12,Senate,"Do pass as amended, and re-refer to the Committee on Appropriations",5,2,2,0,9
513564,295293,2013-07-01,Senate,"Placed on Appropriations Suspense file",6,0,1,0,7
513564,298304,2013-08-30,Senate,"Do pass as amended",5,0,2,0,7
513564,298927,2013-09-09,Senate,"Assembly 3rd Reading AB955 Williams By Liu",26,12,1,0,39
513564,299132,2013-09-10,Assembly,"AB 955 WILLIAMS  Concurrence in Senate Amendments",57,14,0,7,78
513565,308938,2014-01-14,Assembly,"Do pass and be re-referred to the Committee on Appropriations",2,5,0,0,7
513567,261735,2013-04-09,Assembly,"Do pass as amended, to Consent Calendar",10,0,0,0,10
513567,270004,2013-04-22,Assembly,"AB 957 WAGNER  Consent Calendar Second Day",78,0,0,1,79
513567,286956,2013-06-04,Senate,"Do pass as amended. To Consent Calendar",6,0,1,0,7
513567,288889,2013-06-13,Senate,"Consent Calendar 2nd AB957 Wagner",37,0,2,0,39
513567,290397,2013-06-20,Assembly,"AB 957 WAGNER  Concurrence in Senate Amendments",77,0,0,2,79
513569,268612,2013-04-17,Assembly,"Do pass as amended and be re-referred to the Committee on 	Appropriations",6,0,0,1,7
513570,272572,2013-04-24,Assembly,"Do pass and be re-referred to the Committee on Appropriations",17,0,0,0,17
513570,277783,2013-05-08,Assembly,"Do pass, to Consent Calendar",17,0,0,0,17
513570,284667,2013-05-28,Assembly,"AB 960 CAMPOS  Assembly Third Reading",78,0,0,1,79
513570,291750,2013-06-25,Senate,"Do pass, but re-refer to the Committee on Appropriations Recommend 	Consent",11,0,0,0,11
513570,297600,2013-08-15,Senate,"Consent Calendar 2nd AB960 Campos",38,0,1,0,39
513572,257819,2013-04-02,Assembly,"Do pass and be re-referred to the Committee on Judiciary",17,0,0,2,19
513572,266313,2013-04-16,Assembly,"Do pass and re-refer to Committee on Appropriations with 	recommendation:  To Consent Calendar",10,0,0,0,10
513574,258951,2013-04-03,Assembly,"Do pass and be re-referred to the Committee on Appropriations",12,1,0,0,13
513575,270869,2013-04-23,Assembly,"Do pass as amended and be re-referred to the Committee on Business, 	Professions and Consumer Protection",7,3,0,0,10
513575,274227,2013-04-30,Assembly,"Do pass as amended and be re-referred to the Committee on 	Appropriations",7,4,0,2,13
513575,279667,2013-05-15,Assembly,"Do pass as amended",10,5,0,2,17
513578,308643,2014-01-14,Assembly,"Do pass and be re-referred to the Committee on Appropriations",6,1,0,0,7
513578,311262,2014-01-23,Assembly,"Do pass",12,4,0,1,17
513578,312281,2014-01-27,Assembly,"AB 966 BONTA  Assembly Third Reading",48,26,0,6,80
513578,364015,2014-05-13,Senate,"Do pass, but re-refer to the Committee on Appropriations",5,1,1,0,7
513578,373776,2014-06-23,Senate,"Placed on Appropriations Suspense file",7,0,0,0,7
513578,377523,2014-08-14,Senate,"Do pass",5,0,2,0,7
513578,378061,2014-08-21,Senate,"Assembly 3rd Reading AB966 Bonta By Hancock",22,12,6,0,40
513580,274787,2013-05-01,Assembly,"Do pass as amended",7,0,0,0,7
513580,277969,2013-05-09,Assembly,"AB 968 GORDON  Assembly Third Reading",73,1,0,5,79
513580,372161,2014-06-17,Senate,"Do pass as amended",10,0,1,0,11
513580,378778,2014-08-27,Senate,"Assembly 3rd Reading AB968 Gordon By Gaines",30,5,5,0,40
513580,378955,2014-08-28,Assembly,"Senate amendments be concurred in",6,0,0,1,7
513580,378956,2014-08-28,Assembly,"AB 968 GORDON  Concurrence in Senate Amendments",74,1,0,4,79
513584,272500,2013-04-24,Assembly,"Do pass and be re-referred to the Committee on Public Safety to 	Consent Calendar",7,0,0,0,7
513584,274870,2013-04-30,Assembly,"Do pass and re-refer to Committee on Appropriations with 	recommendation:  To Consent Calendar",7,0,0,0,7
513584,279784,2013-05-15,Assembly,"Do pass, to Consent Calendar",17,0,0,0,17
513584,283319,2013-05-23,Assembly,"AB 971 GARCIA  Consent Calendar Second Day  Regular Session",74,0,0,4,78
513584,291733,2013-06-25,Senate,"Do pass, but re-refer to the Committee on Appropriations",7,0,0,0,7
513584,297325,2013-08-12,Senate,"Do pass",5,0,2,0,7
513584,298964,2013-09-09,Senate,"Assembly 3rd Reading AB971 Garcia By De Le",39,0,0,0,39
513584,299185,2013-09-10,Assembly,"AB 971 GARCIA  Concurrence in Senate Amendments",78,0,0,0,78
513585,272295,2013-04-24,Assembly,"Do pass as amended and be re-referred to the Committee on 	Appropriations",5,1,0,1,7
513585,283982,2013-05-24,Assembly,"Do pass",12,5,0,0,17
513585,285101,2013-05-29,Assembly,"AB 972 CALDERON  Assembly Third Reading",53,24,0,2,79
513586,270779,2013-04-23,Assembly,"Do pass as amended and be re-referred to the Committee on 	Appropriations",12,6,0,1,19
513586,283869,2013-05-24,Assembly,"Do pass",12,5,0,0,17
513587,262653,2013-04-09,Assembly,"Do pass as amended and be re-referred to the Committee on 	Appropriations",19,0,0,0,19
513587,275433,2013-05-01,Assembly,"Do pass, to Consent Calendar",17,0,0,0,17
513587,277984,2013-05-09,Assembly,"AB 974 HALL  Consent Calendar Second Day  Regular Session",75,0,0,4,79
513587,291939,2013-06-26,Senate,"Do pass as amended, and re-refer to the Committee on 	Appropriations",9,0,0,0,9
513587,297349,2013-08-12,Senate,"Do pass",5,0,2,0,7
513587,298017,2013-08-26,Senate,"Assembly 3rd Reading AB974 Hall By Beall",39,0,0,0,39
513587,298449,2013-08-30,Assembly,"AB 974 HALL  Concurrence in Senate Amendments",78,0,0,0,78
513588,257506,2013-04-02,Assembly,"Do pass as amended and be re-referred to the Committee on Revenue 	and Taxation",12,7,0,0,19
513588,284066,2013-05-24,Assembly,"Do pass as amended",11,5,0,1,17
513588,285543,2013-05-30,Assembly,"AB 975 WIECKOWSKI  Assembly Third Reading",28,38,0,13,79
513591,257591,2013-04-01,Assembly,"Do pass as amended and be re-referred to the Committee on Judiciary",6,3,0,0,9
513591,266317,2013-04-16,Assembly,"Do pass and be re-referred to the Committee on Appropriations",6,2,0,2,10
513591,277632,2013-05-08,Assembly,"Do pass as amended",12,5,0,0,17
513591,285495,2013-05-30,Assembly,"AB 976 ATKINS  Assembly Third Reading",42,32,0,5,79
513591,291774,2013-06-25,Senate,"Do pass, but re-refer to the Committee on Judiciary",6,2,1,0,9
513591,296049,2013-07-02,Senate,"Do pass as amended, and re-refer to the Committee on 	Appropriations",4,2,1,0,7
513591,298781,2013-09-06,Senate,"Assembly 3rd Reading AB976 Atkins Lay on Table",23,13,3,0,39
513591,298782,2013-09-06,Senate,"Assembly 3rd Reading AB976 Atkins Lay on Table",23,13,3,0,39
513591,298783,2013-09-06,Senate,"Assembly 3rd Reading AB976 Atkins Lay on Table",25,12,2,0,39
513591,298784,2013-09-06,Senate,"Assembly 3rd Reading AB976 Atkins Lay on Table",25,12,2,0,39
513591,298785,2013-09-06,Senate,"Assembly 3rd Reading AB976 Atkins By De Le",21,17,1,0,39
513591,298912,2013-09-09,Assembly,"AB 976 ATKINS  Concurrence in Senate Amendments",36,32,0,10,78
513591,299116,2013-09-10,Assembly,"AB 976 ATKINS  Concurrence in Senate Amendments",34,30,0,14,78
513591,299117,2013-09-10,Assembly,"AB 976 ATKINS  Motion to Reconsider",48,23,0,7,78
513592,308663,2014-01-14,Assembly,"Do pass and be re-referred to the Committee on Appropriations",13,0,0,0,13
513593,262097,2013-04-09,Assembly,"Do pass as amended and be re-referred to the Committee on Banking 	and Finance",8,0,0,1,9
513593,270844,2013-04-22,Assembly,"Do pass as amended and be re-referred to the Committee on 	Appropriations",11,0,0,1,12
513593,277414,2013-05-08,Assembly,"Do pass",16,1,0,0,17
513593,280314,2013-05-16,Assembly,"AB 978 BLUMENFIELD  Assembly Third Reading",72,1,0,6,79
513593,287204,2013-06-05,Senate,"Do pass as amended, and re-refer to the Committee on 	Appropriations",8,0,1,0,9
513593,296243,2013-07-08,Senate,"Assembly 3rd Reading AB978 Blumenfield By Correa",33,0,5,0,38
513593,297143,2013-08-08,Assembly,"AB 978  Concurrence in Senate Amendments By FOX",74,1,0,3,78
513594,257450,2013-04-02,Assembly,"Do pass and re-refer to Committee on Appropriations with 	recommendation:  To Consent Calendar",7,0,0,0,7
513594,283756,2013-05-24,Assembly,"Do pass as amended",17,0,0,0,17
513594,285571,2013-05-30,Assembly,"AB 979 WEBER  Assembly Third Reading",77,0,0,2,79
513594,291597,2013-06-25,Senate,"Do pass",7,0,0,0,7
513594,298576,2013-09-03,Senate,"Assembly 3rd Reading AB979 Weber By Anderson",37,0,2,0,39
513595,274198,2013-04-30,Assembly,"Do pass and be re-referred to the Committee on Appropriations",8,4,0,1,13
513595,280095,2013-05-15,Assembly,"Do pass",12,5,0,0,17
513595,283772,2013-05-24,Assembly,"AB 980 PAN  Assembly Third Reading",47,21,0,10,78
513595,296058,2013-07-03,Senate,"Do pass as amended, and re-refer to the Committee on 	Appropriations",7,2,0,0,9
513595,298031,2013-08-26,Senate,"Do pass",5,2,0,0,7
513595,299034,2013-09-09,Senate,"Assembly 3rd Reading AB980 Pan By De Le",25,12,2,0,39
513595,299448,2013-09-11,Assembly,"AB 980 PAN  Concurrence in Senate Amendments",50,25,0,3,78
513595,299775,2013-09-12,Senate,"W/O REF. TO FILE AB980 Pan By De Le",24,13,2,0,39
513595,299776,2013-09-12,Assembly,"AB 980 PAN  Concurrence in Senate Amendments",50,25,0,3,78
513597,272305,2013-04-24,Assembly,"Do pass and be re-referred to the Committee on Housing and 	Community Development",9,0,0,0,9
513597,274692,2013-05-01,Assembly,"Do pass and be re-referred to the Committee on Appropriations",7,0,0,0,7
513598,266286,2013-04-15,Assembly,"Do pass and be re-referred to the Committee on Appropriations",6,3,0,0,9
513599,261863,2013-04-09,Assembly,"Do pass as amended and be re-referred to the Committee on Business, 	Professions and Consumer Protection",9,0,0,1,10
513599,276812,2013-05-07,Assembly,"Do pass",11,1,0,1,13
513599,277944,2013-05-09,Assembly,"AB 983 MELENDEZ  Assembly Third Reading",72,3,0,4,79
513599,287726,2013-06-10,Senate,"Do pass, but re-refer to the Committee on Judiciary",10,0,0,0,10
513599,295956,2013-07-02,Senate,"Do pass",2,3,2,0,7
513599,295957,2013-07-02,Senate,"Set, first hearing.  Failed passage in Committee.  Reconsideration 	granted",6,0,1,0,7
513599,374467,2014-06-24,Senate,"Do pass as amended",7,0,0,0,7
513599,378553,2014-08-26,Senate,"Assembly 3rd Reading AB983 Melendez By Cannella",36,0,4,0,40
513599,378617,2014-08-27,Assembly,"AB 983 MELENDEZ  Concurrence in Senate Amendments",76,1,0,2,79
513600,258867,2013-04-03,Assembly,"Do pass as amended and be re-referred to the Committee on 	Appropriations",7,0,0,0,7
513600,267218,2013-04-17,Assembly,"Do pass, to Consent Calendar",17,0,0,0,17
513600,272320,2013-04-25,Assembly,"AB 984 CHAU  Consent Calendar Second Day  Regular Session",76,0,0,3,79
513600,286961,2013-06-04,Senate,"Do pass, but re-refer to the Committee on Appropriations",10,0,1,0,11
513600,291187,2013-06-24,Senate,"Do pass",7,0,0,0,7
513600,292284,2013-06-27,Senate,"Assembly 3rd Reading AB984 Chau Urgency Clause",38,0,1,0,39
513600,295449,2013-07-01,Assembly,"AB 984 CHAU  Concurrence- Urgency Added",71,0,0,7,78
513601,274688,2013-04-30,Assembly,"Do pass and be re-referred to the Committee on Appropriations",5,0,0,2,7
513601,284017,2013-05-24,Assembly,"Do pass as amended",16,1,0,0,17
513601,285604,2013-05-30,Assembly,"AB 985 COOLEY  Assembly Third Reading",75,1,0,3,79
513601,291813,2013-06-25,Senate,"Do pass, but re-refer to the Committee on Appropriations",6,0,0,0,6
513601,297279,2013-08-12,Senate,"Placed on Appropriations Suspense file",6,0,1,0,7
513603,277522,2013-05-07,Assembly,"Do pass as amended, to Consent Calendar",7,0,0,0,7
513603,283094,2013-05-23,Assembly,"AB 986 BRADFORD  Consent Calendar Second Day  Regular Session",74,0,0,4,78
513603,289782,2013-06-18,Senate,"Do pass",6,0,1,0,7
513603,299507,2013-09-11,Senate,"Assembly 3rd Reading AB986 Bradford By Lieu",39,0,0,0,39
513603,299640,2013-09-12,Assembly,"AB 986 BRADFORD  Concurrence in Senate Amendments",78,0,0,0,78
513604,305904,2014-01-06,Assembly,"Be referred to Committee on Health",9,0,0,1,10
513605,266886,2013-04-15,Assembly,"Do pass and be re-referred to the Committee on Appropriations",16,0,0,0,16
513605,283800,2013-05-24,Assembly,"Do pass as amended",16,0,0,1,17
513605,285033,2013-05-29,Assembly,"AB 988 JONES  Assembly Third Reading",75,1,0,3,79
513605,295847,2013-07-02,Senate,"Do pass, but re-refer to the Committee on Appropriations",11,0,0,0,11
513605,376847,2014-08-07,Senate,"Assembly 3rd Reading AB988 Jones By Huff",34,2,4,0,40
513605,376874,2014-08-11,Assembly,"AB 988 JONES  Concurrence in Senate Amendments",75,1,0,3,79
513606,262785,2013-04-10,Assembly,"Do pass and re-refer to Committee on Appropriations with 	recommendation:  To Consent Calendar",7,0,0,0,7
513606,267284,2013-04-17,Assembly,"Do pass, to Consent Calendar",17,0,0,0,17
513606,272350,2013-04-25,Assembly,"AB 989 MULLIN  Consent Calendar Second Day  Regular Session",76,0,0,3,79
513606,287912,2013-06-10,Senate,"Do pass, but re-refer to the Committee on Appropriations Recommend 	Consent",5,0,0,0,5
513606,291312,2013-06-24,Senate,"Do pass",7,0,0,0,7
513606,297780,2013-08-19,Senate,"Assembly 3rd Reading AB989 Mullin By Gaines",37,0,2,0,39
513606,298376,2013-08-30,Assembly,"AB 989 MULLIN  Concurrence in Senate Amendments",78,0,0,0,78
513611,271384,2013-04-23,Assembly,"Do pass as amended and be re-referred to the Committee on Business, 	Professions and Consumer Protection",10,0,0,0,10
513611,274310,2013-04-30,Assembly,"Do pass and re-refer to Committee on Appropriations with 	recommendation:  To Consent Calendar",13,0,0,0,13
513611,279867,2013-05-15,Assembly,"Do pass, to Consent Calendar",17,0,0,0,17
513611,283081,2013-05-23,Assembly,"AB 993 LINDER  Consent Calendar Second Day  Regular Session",74,0,0,4,78
513611,289219,2013-06-17,Senate,"Do pass, but re-refer to the Committee on Judiciary",10,0,0,0,10
513612,270745,2013-04-23,Assembly,"Do pass as amended and be re-referred to the Committee on 	Appropriations",4,2,0,1,7
513612,283762,2013-05-24,Assembly,"Do pass as amended",12,5,0,0,17
513612,285487,2013-05-30,Assembly,"AB 994 LOWENTHAL  Assembly Third Reading",47,29,0,3,79
513612,295803,2013-07-02,Senate,"Do pass, but re-refer to the Committee on Appropriations",5,2,0,0,7
513612,297311,2013-08-12,Senate,"Placed on Appropriations Suspense file",6,0,1,0,7
513612,298247,2013-08-30,Senate,"Do pass as amended",5,2,0,0,7
513612,299426,2013-09-11,Assembly,"AB 994 LOWENTHAL  Concurrence in Senate Amendments",46,30,0,2,78
513612,299427,2013-09-11,Senate,"Assembly 3rd Reading AB994 Lowenthal By Hancock",25,11,3,0,39
513615,275559,2013-05-01,Assembly,"Do pass as amended and be re-referred to the Committee on 	Appropriations",4,0,0,3,7
513616,257608,2013-04-01,Assembly,"Do pass and re-refer to Committee on Appropriations with 	recommendation:  To Consent Calendar",9,0,0,0,9
513616,267512,2013-04-17,Assembly,"Do pass",17,0,0,0,17
513616,275773,2013-05-02,Assembly,"AB 997 CHESBRO  Assembly Third Reading",75,0,0,4,79
513616,296133,2013-07-03,Senate,"Do pass, but re-refer to the Committee on Appropriations",8,0,1,0,9
513617,267578,2013-04-17,Assembly,"Do pass and be re-referred to the Committee on Appropriations",6,1,0,0,7
513618,261701,2013-04-09,Assembly,"Do pass and be re-referred to the Committee on Appropriations",5,2,0,0,7
513618,284059,2013-05-24,Assembly,"Do pass as amended",12,0,0,5,17
513618,285087,2013-05-29,Assembly,"AB 999 BONTA  Assembly Third Reading",48,27,0,4,79
513618,291666,2013-06-25,Senate,"Do pass, but re-refer to the Committee on Appropriations",5,2,0,0,7
513618,297402,2013-08-12,Senate,"Placed on Appropriations Suspense file",6,0,1,0,7
513618,298284,2013-08-30,Senate,"Do pass as amended",5,2,0,0,7
513618,298982,2013-09-09,Senate,"Assembly 3rd Reading AB999 Bonta By Wright",22,13,4,0,39
513618,299220,2013-09-10,Assembly,"AB 999 BONTA  Concurrence in Senate Amendments",47,29,0,2,78
513620,274135,2013-04-30,Assembly,"Do pass as amended and be re-referred to the Committee on 	Appropriations",12,0,0,1,13
513620,283763,2013-05-24,Assembly,"Do pass",16,0,0,1,17
513620,285047,2013-05-29,Assembly,"AB 1000 WIECKOWSKI  Assembly Third Reading",77,0,0,2,79
513620,296197,2013-07-08,Senate,"Do pass as amended, and re-refer to the Committee on Appropriations",8,0,2,0,10
513620,297240,2013-08-12,Senate,"Placed on Appropriations Suspense file",6,0,1,0,7
513620,298619,2013-08-30,Senate,"Do pass as amended",6,0,1,0,7
513620,299141,2013-09-10,Senate,"Assembly 3rd Reading AB1000 Wieckowski By Lieu",33,0,6,0,39
513620,299449,2013-09-11,Assembly,"AB 1000 WIECKOWSKI  Concurrence in Senate Amendments",77,0,0,1,78
513621,274100,2013-04-29,Assembly,"Do pass as amended and be re-referred to the Committee on 	Appropriations",6,3,0,0,9
513621,283856,2013-05-24,Assembly,"Do pass as amended",12,0,0,5,17
513621,285550,2013-05-30,Assembly,"AB 1001 GORDON  Assembly Third Reading",77,0,0,2,79
513621,295955,2013-07-03,Senate,"Do pass as amended, and re-refer to the Committee on 	Appropriations",8,1,0,0,9
513622,270065,2013-04-22,Assembly,"Do pass and be re-referred to the Committee on Local Government",9,6,0,1,16
513624,277370,2013-05-07,Assembly,"Do pass as amended, to Consent Calendar",7,0,0,0,7
513624,283399,2013-05-23,Assembly,"AB 1004 GRAY  Consent Calendar Second Day  Regular Session",74,0,0,4,78
513624,289432,2013-06-18,Senate,"Do pass",6,0,1,0,7
513624,299103,2013-09-09,Senate,"Assembly 3rd Reading AB1004 Gray By Galgiani",38,0,1,0,39
513626,270831,2013-04-23,Assembly,"Do pass and be re-referred to the Committee on Appropriations",10,0,0,0,10
513626,277512,2013-05-08,Assembly,"Do pass as amended",16,0,0,1,17
513626,281380,2013-05-20,Assembly,"AB 1005 ALEJO  Assembly Third Reading",74,0,0,4,78
513626,288115,2013-06-11,Senate,"Do pass, but re-refer to the Committee on Appropriations",7,0,0,0,7
513626,291208,2013-06-24,Senate,"Do pass",7,0,0,0,7
513626,295245,2013-07-01,Senate,"Assembly 3rd Reading AB1005 Alejo By Corbett",35,0,3,0,38
513626,297064,2013-08-05,Assembly,"AB 1005 ALEJO  Concurrence in Senate Amendments",72,0,0,6,78
513627,257432,2013-04-02,Assembly,"Do pass and be re-referred to the Committee on Appropriations",6,0,0,1,7
513627,262619,2013-04-10,Assembly,"Do pass",17,0,0,0,17
513627,265435,2013-04-15,Assembly,"AB 1006 YAMADA  Assembly Third Reading",77,0,0,2,79
513627,286859,2013-06-04,Senate,"Do pass, but re-refer to the Committee on Appropriations",5,2,0,0,7
513627,291368,2013-06-24,Senate,"Do pass",5,1,1,0,7
513627,297802,2013-08-19,Senate,"Assembly 3rd Reading AB1006 Yamada By Torres",25,11,3,0,39
513627,297941,2013-08-22,Assembly,"AB 1006 YAMADA  Concurrence in Senate Amendments",78,0,0,0,78
513628,274510,2013-04-30,Assembly,"Do pass and be re-referred to the Committee on Appropriations",3,7,0,0,10
513629,274230,2013-04-30,Assembly,"Do pass",6,4,0,0,10
513629,280570,2013-05-16,Assembly,"AB 1008 TORRES  Assembly Third Reading",47,23,0,9,79
513629,297877,2013-08-21,Senate,"Do pass as amended",6,2,1,0,9
513629,298839,2013-09-06,Senate,"From Committee:  That the measure be returned to the Senate floor 	for consideration",5,0,0,0,5
513629,298840,2013-09-06,Senate,"W/O REF. TO FILE AB1008 Buchanan Urgency Clause",35,2,2,0,39
513629,298983,2013-09-09,Assembly,"Senate amendments be concurred in",9,0,0,0,9
513629,299234,2013-09-10,Assembly,"AB 1008 BUCHANAN  Concurrence- Urgency Added",75,0,0,3,78
513633,274151,2013-04-30,Assembly,"Do pass as amended and be re-referred to the Committee on 	Appropriations",8,1,0,1,10
513634,274445,2013-04-29,Assembly,"Do pass as amended and be re-referred to the Committee on 	Appropriations",9,0,0,0,9
513634,279834,2013-05-15,Assembly,"Do pass, to Consent Calendar",17,0,0,0,17
513634,283405,2013-05-23,Assembly,"AB 1012 GOMEZ  Consent Calendar Second Day  Regular Session",74,0,0,4,78
513634,289862,2013-06-19,Senate,"Do pass, but re-refer to the Committee on Appropriations Recommend 	Consent",7,0,0,0,7
513636,274072,2013-04-29,Assembly,"Do pass as amended and be re-referred to the Committee on 	Appropriations",11,0,0,4,15
513636,283867,2013-05-24,Assembly,"Do pass",13,4,0,0,17
513636,285957,2013-05-31,Assembly,"AB 1014 WILLIAMS  Assembly Third Reading",55,17,0,7,79
513636,374446,2014-06-24,Senate,"Do pass as amended, and re-refer to the Committee on Appropriations",5,2,0,0,7
513636,376444,2014-08-04,Senate,"Placed on Appropriations Suspense file",7,0,0,0,7
513636,377198,2014-08-14,Senate,"Do pass as amended",5,0,2,0,7
513636,378692,2014-08-27,Senate,"Assembly 3rd Reading AB1014 Skinner By Jackson",23,8,9,0,40
513636,379008,2014-08-29,Assembly,"Senate amendments be concurred in",5,2,0,0,7
513636,379009,2014-08-29,Assembly,"AB 1014 SKINNER  Concurrence in Senate Amendments",48,28,0,3,79
513643,266250,2013-04-16,Assembly,"Do pass and re-refer to Committee on Appropriations with 	recommendation:  To Consent Calendar",7,0,0,0,7
513643,275080,2013-05-01,Assembly,"Do pass as amended, to Consent Calendar",17,0,0,0,17
513643,278157,2013-05-09,Assembly,"AB 1019 AMMIANO  Consent Calendar Second Day  Regular Session",75,0,0,4,79
513643,288188,2013-06-11,Senate,"Do pass, but re-refer to the Committee on Appropriations",7,0,0,0,7
513643,298657,2013-09-03,Senate,"Assembly 3rd Reading AB1019 Ammiano By Hancock",37,0,2,0,39
513643,298824,2013-09-06,Assembly,"AB 1019 AMMIANO  Concurrence in Senate Amendments",78,0,0,0,78
513644,266527,2013-04-16,Assembly,"Do pass as amended and re-refer to Committee on Appropriations 	with recommendation:  To Consent Calendar",7,0,0,0,7
513645,274154,2013-04-29,Assembly,"Do pass as amended and be re-referred to the Committee on 	Appropriations",9,0,0,0,9
513645,283974,2013-05-24,Assembly,"Do pass",17,0,0,0,17
513645,285247,2013-05-29,Assembly,"AB 1021 EGGMAN  Assembly Third Reading",78,0,0,1,79
513645,291924,2013-06-26,Senate,"Do pass, but re-refer to the Committee on Environmental Quality",7,0,0,0,7
513645,296114,2013-07-03,Senate,"Do pass as amended, but re-refer to the Committee on 	Appropriations Recommend Consent",9,0,0,0,9
513645,297329,2013-08-12,Senate,"Placed on Appropriations Suspense file",6,0,1,0,7
513646,266404,2013-04-15,Assembly,"Do pass as amended and be re-referred to the Committee on 	Appropriations",9,0,0,0,9
513646,283812,2013-05-24,Assembly,"Do pass",17,0,0,0,17
513646,284939,2013-05-29,Assembly,"AB 1022 EGGMAN  Assembly Third Reading",76,2,0,1,79
513646,291890,2013-06-26,Senate,"Do pass as amended, and re-refer to the Committee on 	Appropriations",8,1,0,0,9
513646,297253,2013-08-12,Senate,"Placed on Appropriations Suspense file",6,0,1,0,7
513647,274583,2013-04-29,Assembly,"Do pass as amended and be re-referred to the Committee on 	Appropriations",6,3,0,0,9
513649,267405,2013-04-17,Assembly,"Do pass and be re-referred to the Committee on Judiciary",7,0,0,0,7
513649,270773,2013-04-23,Assembly,"Do pass and re-refer to Committee on Appropriations with 	recommendation:  To Consent Calendar",10,0,0,0,10
513649,274829,2013-05-01,Assembly,"Do pass, to Consent Calendar",17,0,0,0,17
513649,280368,2013-05-16,Assembly,"AB 1024 TORRES  Assembly Third Reading",73,0,0,6,79
513649,289678,2013-06-18,Senate,"Do pass as amended, and re-refer to the Committee on Judiciary",10,0,1,0,11
513649,296050,2013-07-02,Senate,"Do pass as amended, and re-refer to the Committee on 	Appropriations",5,1,1,0,7
513649,299436,2013-09-11,Senate,"Do pass, but re-refer to the Committee on Appropriations",5,1,1,0,7
513649,299437,2013-09-11,Senate,"W/O REF. TO FILE AB1024 Gonzalez By Lara",29,5,5,0,39
513649,299670,2013-09-12,Assembly,"Senate amendments be concurred in",9,1,0,0,10
513649,299671,2013-09-12,Assembly,"AB 1024 GONZALEZ  Concurrence in Senate Amendments",62,4,0,12,78
513650,262559,2013-04-09,Assembly,"Do pass and be re-referred to the Committee on Appropriations",13,0,0,0,13
513650,267431,2013-04-17,Assembly,"Do pass",16,1,0,0,17
513650,272411,2013-04-25,Assembly,"AB 1025 GARCIA  Assembly Third Reading",70,5,0,4,79
513650,287220,2013-06-05,Senate,"Do pass, but re-refer to the Committee on Appropriations",9,0,0,0,9
513650,291383,2013-06-24,Senate,"Do pass",7,0,0,0,7
513650,298116,2013-08-26,Senate,"Assembly 3rd Reading AB1025 Garcia By Wyland",38,0,1,0,39
513653,266557,2013-04-16,Assembly,"Do pass and be re-referred to the Committee on Appropriations",13,0,0,0,13
513653,274925,2013-05-01,Assembly,"Do pass, to Consent Calendar",17,0,0,0,17
513653,278094,2013-05-09,Assembly,"AB 1028 PATTERSON  Consent Calendar Second Day  Regular Session",75,0,0,4,79
513653,289226,2013-06-17,Senate,"Do pass, but re-refer to the Committee on Appropriations",10,0,0,0,10
513653,295723,2013-07-01,Senate,"Do pass",6,0,1,0,7
513653,297804,2013-08-19,Senate,"Assembly 3rd Reading AB1028 Patterson By Emmerson",37,0,2,0,39
513653,297915,2013-08-22,Assembly,"AB 1028 PATTERSON  Concurrence in Senate Amendments",78,0,0,0,78
513656,270875,2013-04-23,Assembly,"Do pass, to Consent Calendar",10,0,0,0,10
513656,273630,2013-04-29,Assembly,"AB 1029 MAIENSCHEIN  Consent Calendar Second Day",77,0,0,2,79
513656,286848,2013-06-04,Senate,"Do pass",6,0,1,0,7
513656,295640,2013-07-01,Senate,"Assembly 3rd Reading AB1029 Maienschein By Anderson",36,0,2,0,38
513656,295954,2013-07-03,Assembly,"AB 1029 MAIENSCHEIN  Concurrence in Senate Amendments",74,0,0,4,78
513657,262816,2013-04-09,Assembly,"Do pass",13,0,0,0,13
513657,269935,2013-04-22,Assembly,"AB 1030 COOLEY  Assembly Third Reading",77,0,0,2,79
513657,287198,2013-06-05,Senate,"Do pass and be placed on the Consent Calendar",9,0,0,0,9
513657,297557,2013-08-15,Senate,"Assembly 3rd Reading AB1030 Cooley By Berryhill",36,0,3,0,39
513659,268754,2013-04-17,Assembly,"Do pass as amended and be re-referred to the Committee on 	Appropriations",4,3,0,0,7
513660,270702,2013-04-23,Assembly,"Do pass and be re-referred to the Committee on Appropriations",6,0,0,1,7
513663,262583,2013-04-10,Assembly,"Do pass and be re-referred to the Committee on Appropriations",8,0,0,1,9
513663,274704,2013-05-01,Assembly,"Do pass",16,1,0,0,17
513663,281160,2013-05-20,Assembly,"AB 1035 MURATSUCHI  Assembly Third Reading",69,5,0,4,78
513663,354488,2014-04-09,Senate,"Do pass",4,0,0,0,4
513663,357951,2014-04-21,Senate,"Do pass as amended",6,0,1,0,7
513663,360044,2014-04-28,Senate,"Assembly 3rd Reading AB1035 John A. P",35,0,5,0,40
513663,361574,2014-05-01,Assembly,"AB 1035 PEREZ, J.  Concurrence in Senate Amendments",72,1,0,6,79
513666,262147,2013-04-09,Assembly,"Do pass and be re-referred to the Committee on Appropriations",5,2,0,0,7
513666,267382,2013-04-17,Assembly,"Do pass",12,5,0,0,17
513666,283512,2013-05-23,Assembly,"AB 1038 PAN  Assembly Third Reading",47,23,0,8,78
513666,296523,2013-07-11,Senate,"Do pass as amended, and re-refer to the Committee on 	Appropriations",3,0,2,0,5
513666,298108,2013-08-26,Senate,"Placed on Appropriations Suspense file",7,0,0,0,7
513666,299707,2013-09-12,Senate,"Assembly 3rd Supp 2 AB1038 Gray By Galgiani",38,0,1,0,39
513668,272898,2013-04-24,Assembly,"Do pass and be re-referred to the Committee on Appropriations",17,0,0,0,17
513668,277670,2013-05-08,Assembly,"Do pass",17,0,0,0,17
513668,280281,2013-05-16,Assembly,"AB 1039 HALL  Assembly Third Reading",68,1,0,10,79
513668,291687,2013-06-25,Senate,"Do pass, but re-refer to the Committee on Appropriations",10,0,1,0,11
513668,298686,2013-09-03,Senate,"Assembly 3rd Reading AB1039 Hall By Wright",36,0,3,0,39
513670,267297,2013-04-16,Assembly,"Do pass and be re-referred to the Committee on Appropriations",7,0,0,0,7
513670,283827,2013-05-24,Assembly,"Do pass",13,4,0,0,17
513670,285002,2013-05-29,Assembly,"AB 1041 CHESBRO  Assembly Third Reading",68,7,0,4,79
513670,291604,2013-06-25,Senate,"Do pass as amended, and re-refer to the Committee on Appropriations",5,1,0,0,6
513670,297296,2013-08-12,Senate,"Placed on Appropriations Suspense file",6,0,1,0,7
513670,298317,2013-08-30,Senate,"Do pass as amended",6,1,0,0,7
513670,298939,2013-09-09,Senate,"Assembly 3rd Reading AB1041 Chesbro By Beall",29,7,3,0,39
513670,299144,2013-09-10,Assembly,"AB 1041 CHESBRO  Concurrence in Senate Amendments",66,10,0,2,78
513671,263182,2013-04-10,Assembly,"Do pass and re-refer to Committee on Appropriations with 	recommendation:  To Consent Calendar",16,0,0,1,17
513671,283981,2013-05-24,Assembly,"Do pass",17,0,0,0,17
513671,285135,2013-05-29,Assembly,"AB 1042 HALL  Assembly Third Reading",78,0,0,1,79
513671,291560,2013-06-25,Senate,"Do pass, but re-refer to the Committee on Appropriations Recommend 	Consent",11,0,0,0,11
513671,297736,2013-08-19,Senate,"Placed on Appropriations Suspense file",7,0,0,0,7
513671,298518,2013-08-30,Senate,"Do pass",7,0,0,0,7
513671,299049,2013-09-09,Senate,"Assembly 3rd Reading AB1042 Hall By Wright",39,0,0,0,39
513671,299493,2013-09-11,Assembly,"Senate amendments be concurred in",12,0,0,5,17
513671,299738,2013-09-12,Assembly,"AB 1042 HALL  Concurrence in Senate Amendments",78,0,0,0,78
513672,275603,2013-04-30,Assembly,"Do pass and re-refer to Committee on Appropriations with 	recommendation:  To Consent Calendar",7,0,0,0,7
513672,283882,2013-05-24,Assembly,"Do pass",17,0,0,0,17
513672,285115,2013-05-29,Assembly,"AB 1043 CHAU  Assembly Third Reading",78,0,0,1,79
513672,372889,2014-06-18,Senate,"Do pass, but re-refer to the Committee on Rules",7,0,0,0,7
513672,376577,2014-08-04,Senate,"Placed on Appropriations Suspense file",7,0,0,0,7
513672,377552,2014-08-14,Senate,"Do pass as amended",5,0,2,0,7
513672,378640,2014-08-27,Senate,"Assembly 3rd Reading AB1043 Chau By Hernandez",32,0,8,0,40
513672,378983,2014-08-28,Assembly,"AB 1043 CHAU  Concurrence in Senate Amendments",79,0,0,0,79
513675,272384,2013-04-25,Assembly,"Be referred to Committee on Business, Professions and Consumer 	Protection",8,0,0,3,11
513675,274259,2013-04-30,Assembly,"Do pass and be re-referred to the Committee on Appropriations",13,0,0,0,13
513675,279852,2013-05-15,Assembly,"Do pass, to Consent Calendar",17,0,0,0,17
513675,283344,2013-05-23,Assembly,"AB 1045 QUIRK-SILVA  Consent Calendar Second Day  Regular Session",74,0,0,4,78
513675,289163,2013-06-17,Senate,"Do pass as amended, and re-refer to the Committee on Appropriations",10,0,0,0,10
513675,297700,2013-08-19,Senate,"Assembly 3rd Reading AB1045 Quirk-Silva By Emmerson",37,0,2,0,39
513675,297919,2013-08-22,Assembly,"AB 1045 QUIRK-SILVA  Concurrence in Senate Amendments",78,0,0,0,78
513676,269984,2013-04-22,Assembly,"Do pass and be re-referred to the Committee on Appropriations",16,0,0,0,16
513676,274912,2013-05-01,Assembly,"Do pass",17,0,0,0,17
513676,278163,2013-05-09,Assembly,"AB 1046 GORDON  Assembly Third Reading",76,0,0,3,79
513676,296327,2013-07-09,Senate,"Do pass, but re-refer to the Committee on Appropriations Recommend 	Consent",10,0,1,0,11
513677,274307,2013-04-29,Assembly,"Do pass and be re-referred to the Committee on Appropriations",15,0,0,1,16
513677,279821,2013-05-15,Assembly,"Do pass",16,1,0,0,17
513677,283972,2013-05-24,Assembly,"AB 1047 LINDER  Assembly Third Reading",69,1,0,8,78
513677,291566,2013-06-25,Senate,"Do pass, but re-refer to the Committee on Appropriations",11,0,0,0,11
513677,298896,2013-09-06,Senate,"Assembly 3rd Reading AB1047 Linder By Roth",37,0,2,0,39
513677,299086,2013-09-09,Assembly,"AB 1047 LINDER  Concurrence in Senate Amendments",76,1,0,1,78
513679,274215,2013-04-29,Assembly,"Do pass and be re-referred to the Committee on Appropriations",13,0,0,3,16
513681,261724,2013-04-09,Assembly,"Do pass as amended and be re-referred to the Committee on 	Appropriations",7,0,0,0,7
513681,274711,2013-05-01,Assembly,"Do pass, to Consent Calendar",17,0,0,0,17
513681,278206,2013-05-09,Assembly,"AB 1050 DICKINSON  Consent Calendar Second Day  Regular Session",75,0,0,4,79
513681,291580,2013-06-25,Senate,"Do pass as amended, and re-refer to the Committee on Appropriations",7,0,0,0,7
513681,297742,2013-08-19,Senate,"Assembly 3rd Reading AB1050 Dickinson By Hancock",37,0,2,0,39
513681,297944,2013-08-22,Assembly,"AB 1050 DICKINSON  Concurrence in Senate Amendments",77,0,0,1,78
513682,267562,2013-04-17,Assembly,"Do pass and be re-referred to the Committee on Transportation",4,2,0,1,7
513682,274449,2013-04-29,Assembly,"Do pass and be re-referred to the Committee on Appropriations",11,4,0,1,16
513685,271992,2013-04-24,Assembly,"Do pass and re-refer to Committee on Appropriations with 	recommendation:  To Consent Calendar",13,0,0,0,13
513685,277705,2013-05-08,Assembly,"Do pass, to Consent Calendar",17,0,0,0,17
513685,280298,2013-05-16,Assembly,"AB 1053 COOLEY  Consent Calendar Second Day  Regular Session",70,0,0,9,79
513685,361069,2014-04-30,Senate,"Do pass as amended",6,0,1,0,7
513685,362220,2014-05-05,Senate,"Assembly 3rd Reading AB1053 Cooley Urgency Clause",37,0,3,0,40
513685,364823,2014-05-15,Assembly,"Senate amendments be concurred in",8,0,0,1,9
513685,365410,2014-05-19,Assembly,"AB 1053 COOLEY  Concurrence- Urgency Added",76,0,0,3,79
513686,257491,2013-04-02,Assembly,"Do pass as amended and be re-referred to the Committee on 	Appropriations",18,0,0,1,19
513686,274984,2013-05-01,Assembly,"Do pass, to Consent Calendar",17,0,0,0,17
513686,278056,2013-05-09,Assembly,"AB 1054 CHESBRO  Consent Calendar Second Day  Regular Session",75,0,0,4,79
513686,287187,2013-06-05,Senate,"Do pass, but re-refer to the Committee on Appropriations",9,0,0,0,9
513686,297710,2013-08-19,Senate,"Assembly 3rd Reading AB1054 Chesbro By Liu",37,0,2,0,39
513689,257471,2013-04-02,Assembly,"Do pass as amended and be re-referred to the Committee on 	Appropriations",13,0,0,0,13
513689,267217,2013-04-17,Assembly,"Do pass, to Consent Calendar",17,0,0,0,17
513689,273638,2013-04-29,Assembly,"AB 1057 MEDINA  Assembly Third Reading",77,0,0,2,79
513689,287793,2013-06-10,Senate,"Do pass, but re-refer to the Committee on Appropriations",10,0,0,0,10
513689,298113,2013-08-26,Senate,"Assembly 3rd Reading AB1057 Medina By Lieu",39,0,0,0,39
513689,298350,2013-08-30,Assembly,"AB 1057 MEDINA  Concurrence in Senate Amendments",78,0,0,0,78
513691,272883,2013-04-24,Assembly,"Do pass and be re-referred to the Committee on Appropriations",9,0,0,0,9
513691,277622,2013-05-08,Assembly,"Do pass, to Consent Calendar",17,0,0,0,17
513691,281243,2013-05-20,Assembly,"AB 1058 CHAVEZ  Assembly Third Reading",74,0,0,4,78
513691,288735,2013-06-12,Senate,"Do pass, but re-refer to the Committee on Appropriations Recommend 	Consent",6,0,1,0,7
513691,295613,2013-07-01,Senate,"Consent Calendar 2nd AB1058 Ch",33,0,5,0,38
513693,267164,2013-04-15,Assembly,"Do pass and re-refer to Committee on Appropriations with 	recommendation:  To Consent Calendar",9,0,0,0,9
513693,274965,2013-05-01,Assembly,"Do pass, to Consent Calendar",17,0,0,0,17
513693,278214,2013-05-09,Assembly,"AB 1060 FOX  Consent Calendar Second Day  Regular Session",75,0,0,4,79
513693,291584,2013-06-25,Senate,"Do pass, but re-refer to the Committee on Environmental Quality",7,0,2,0,9
513693,296010,2013-07-03,Senate,"Do pass as amended, and re-refer to the Committee on 	Appropriations",9,0,0,0,9
513693,299715,2013-09-12,Senate,"Do pass",12,0,4,0,16
513693,299716,2013-09-12,Senate,"Assembly 3rd Supp 2 AB1060 Fox By Hueso",38,0,1,0,39
513693,299717,2013-09-12,Assembly,"AB 1060 FOX  Concurrence in Senate Amendments",72,2,0,4,78
513695,263153,2013-04-10,Assembly,"Amend, and do pass as amended and be re-referred to the Committee 	on Judiciary with the recommendation:  To Consent Calendar",7,0,0,0,7
513695,274579,2013-04-30,Assembly,"Do pass and re-refer to Committee on Appropriations with 	recommendation:  To Consent Calendar",10,0,0,0,10
513695,279878,2013-05-15,Assembly,"Do pass, to Consent Calendar",17,0,0,0,17
513695,283301,2013-05-23,Assembly,"AB 1062 JONES-SAWYER  Consent Calendar Second Day  Regular Session",74,0,0,4,78
513695,291217,2013-06-24,Senate,"Do pass as amended, and re-refer to the Committee on 	Appropriations",5,0,0,0,5
513695,298094,2013-08-26,Senate,"Assembly 3rd Reading AB1062 Jones-Sawyer By Galgiani",39,0,0,0,39
513695,298443,2013-08-30,Assembly,"AB 1062 JONES-SAWYER  Concurrence in Senate Amendments",77,0,0,1,78
513697,274075,2013-04-30,Assembly,"Do pass as amended and be re-referred to the Committee on 	Appropriations",10,3,0,0,13
513699,274850,2013-04-30,Assembly,"Do pass and be re-referred to the Committee on Appropriations",3,1,0,3,7
513699,274851,2013-04-30,Assembly,"Set second hearing.  Failed passage.  Reconsideration granted",7,0,0,0,7
513699,308688,2014-01-14,Assembly,"Do pass and be re-referred to the Committee on Appropriations",7,0,0,0,7
513701,261842,2013-04-09,Assembly,"Do pass as amended and be re-referred to the Committee on 	Appropriations",7,0,0,2,9
513701,274722,2013-05-01,Assembly,"Do pass",17,0,0,0,17
513701,278224,2013-05-09,Assembly,"AB 1067 MEDINA  Assembly Third Reading",73,0,0,6,79
513701,289189,2013-06-17,Senate,"Do pass as amended, and re-refer to the Committee on Appropriations",10,0,0,0,10
513701,298694,2013-09-03,Senate,"Assembly 3rd Reading AB1067 Medina By Lieu",38,0,1,0,39
513701,298873,2013-09-06,Assembly,"AB 1067 MEDINA  Concurrence in Senate Amendments",77,0,0,1,78
513703,259666,2013-04-03,Assembly,"Do pass and be re-referred to the Committee on Appropriations",7,0,0,0,7
513703,284015,2013-05-24,Assembly,"Do pass",17,0,0,0,17
513703,284984,2013-05-29,Assembly,"AB 1068 BLOOM  Assembly Third Reading",78,0,0,1,79
513703,291848,2013-06-26,Senate,"Do pass, but re-refer to the Committee on Appropriations Recommend 	Consent",9,0,0,0,9
513703,297404,2013-08-12,Senate,"Placed on Appropriations Suspense file",6,0,1,0,7
513703,298346,2013-08-30,Senate,"Do pass",7,0,0,0,7
513703,299095,2013-09-09,Senate,"Assembly 3rd Reading AB1068 Bloom By Pavley",39,0,0,0,39
513703,299314,2013-09-10,Assembly,"AB 1068 BLOOM  Concurrence in Senate Amendments",78,0,0,0,78
513704,267319,2013-04-17,Assembly,"Do pass and be re-referred to the Committee on Appropriations",7,0,0,0,7
513705,270464,2013-04-22,Assembly,"Do pass and re-refer to Committee on Appropriations with 	recommendation:  To Consent Calendar",16,0,0,0,16
513705,274808,2013-05-01,Assembly,"Do pass, to Consent Calendar",17,0,0,0,17
513705,278065,2013-05-09,Assembly,"AB 1070 FRAZIER  Consent Calendar Second Day  Regular Session",75,0,0,4,79
513705,289574,2013-06-18,Senate,"Do pass, but re-refer to the Committee on Governance and Finance",10,0,1,0,11
513705,296166,2013-07-03,Senate,"Do pass, but re-refer to the Committee on Appropriations Recommend 	Consent",7,0,0,0,7
513705,297569,2013-08-15,Senate,"Consent Calendar 2nd AB1070 Frazier",38,0,1,0,39
513707,274744,2013-04-30,Assembly,"Do pass and be re-referred to the Committee on Appropriations",3,0,0,4,7
513707,274745,2013-04-30,Assembly,"Set second hearing.  Failed passage.  Reconsideration granted",7,0,0,0,7
513707,305724,2014-01-06,Assembly,"Be referred to Committee on Judiciary",9,0,0,1,10
513709,262766,2013-04-10,Assembly,"Do pass as amended and be re-referred to the Committee on Utilities 	and Commerce",12,4,0,1,17
513709,270736,2013-04-22,Assembly,"Do pass and be re-referred to the Committee on Appropriations",11,4,0,0,15
513709,277544,2013-05-08,Assembly,"Do pass",12,5,0,0,17
513709,280236,2013-05-16,Assembly,"AB 1073 TORRES  Assembly Third Reading",56,17,0,6,79
513710,262745,2013-04-10,Assembly,"Do pass and re-refer to Committee on Appropriations with 	recommendation:  To Consent Calendar",16,0,0,1,17
513710,284088,2013-05-24,Assembly,"Do pass as amended",17,0,0,0,17
513710,285170,2013-05-29,Assembly,"AB 1074 ATKINS  Assembly Third Reading",77,0,0,2,79
513710,291686,2013-06-25,Senate,"Do pass, but re-refer to the Committee on Appropriations",10,0,1,0,11
513710,298628,2013-09-03,Senate,"Assembly 3rd Reading AB1074 Atkins By Wright",37,0,2,0,39
513710,298906,2013-09-06,Assembly,"AB 1074 ATKINS  Concurrence in Senate Amendments",78,0,0,0,78
513711,271171,2013-04-23,Assembly,"Do pass and be re-referred to the Committee on Appropriations",2,4,0,1,7
513711,271172,2013-04-23,Assembly,"Set first hearing.  Failed passage.  Reconsideration granted",7,0,0,0,7
513712,259554,2013-04-03,Assembly,"Do pass as amended and be re-referred to the Committee on 	Appropriations",7,0,0,0,7
513714,287731,2013-06-10,Assembly,"Do pass as amended and be re-referred to the Committee on 	Appropriations",9,0,0,0,9
513716,274218,2013-04-30,Assembly,"Do pass as amended and be re-referred to the Committee on 	Appropriations",9,0,0,0,9
513716,283959,2013-05-24,Assembly,"Do pass, to Consent Calendar",17,0,0,0,17
513716,285049,2013-05-29,Assembly,"AB 1079 BRADFORD  Consent Calendar Second Day  Regular Session",77,0,0,2,79
513716,295778,2013-07-02,Senate,"Do pass as amended, and re-refer to the Committee on Appropriations",9,0,2,0,11
513716,298308,2013-08-30,Senate,"Placed on Appropriations Suspense file",7,0,0,0,7
513717,267488,2013-04-17,Assembly,"Do pass as amended and be re-referred to the Committee on Local 	Government",5,2,0,0,7
513717,274786,2013-05-01,Assembly,"Do pass as amended and be re-referred to the Committee on 	Appropriations",8,0,0,1,9
513717,279698,2013-05-15,Assembly,"Do pass as amended",12,5,0,0,17
513717,283963,2013-05-24,Assembly,"AB 1080 ALEJO  Assembly Third Reading",54,16,0,8,78
513717,289940,2013-06-19,Senate,"Do pass as amended, and re-refer to the Committee on Transportation 	and Housing",4,1,2,0,7
513717,296333,2013-07-09,Senate,"Do pass as amended, and re-refer to the Committee on 	Appropriations",8,2,1,0,11
513717,297981,2013-08-26,Senate,"Placed on Appropriations Suspense file",7,0,0,0,7
513719,261733,2013-04-09,Assembly,"Do pass and be re-referred to the Committee on Transportation",8,0,0,1,9
513719,274118,2013-04-29,Assembly,"Do pass and be re-referred to the Committee on Appropriations",15,0,0,1,16
513719,283915,2013-05-24,Assembly,"Do pass as amended",17,0,0,0,17
513719,285679,2013-05-30,Assembly,"AB 1081 MEDINA  Assembly Third Reading",78,0,0,1,79
513719,295889,2013-07-02,Senate,"Do pass as amended, and re-refer to the Committee on 	Appropriations",11,0,0,0,11
513719,297347,2013-08-12,Senate,"Placed on Appropriations Suspense file",6,0,1,0,7
513721,272285,2013-04-24,Assembly,"Do pass and be re-referred to the Committee on Appropriations",5,2,0,0,7
513723,274717,2013-04-30,Assembly,"Do pass and be re-referred to the Committee on Appropriations",2,5,0,0,7
513724,262877,2013-04-09,Assembly,"Do pass as amended and be re-referred to the Committee on 	Appropriations",11,0,0,2,13
513729,274707,2013-04-30,Assembly,"Do pass and be re-referred to the Committee on Appropriations",5,0,0,2,7
513729,279651,2013-05-15,Assembly,"Do pass",17,0,0,0,17
513729,283769,2013-05-24,Assembly,"AB 1089 CALDERON  Assembly Third Reading",72,0,0,6,78
513729,370538,2014-06-10,Senate,"Do pass as amended, and re-refer to the Committee on Judiciary",4,0,1,0,5
513729,376526,2014-08-04,Senate,"Placed on Appropriations Suspense file",7,0,0,0,7
513729,377233,2014-08-14,Senate,"Do pass",5,0,2,0,7
513729,377812,2014-08-19,Senate,"Assembly 3rd Reading AB1089 Ian Calderon By Beall",34,0,6,0,40
513729,378022,2014-08-21,Assembly,"AB 1089 CALDERON  Concurrence in Senate Amendments",78,0,0,1,79
513730,270852,2013-04-23,Assembly,"Do pass and be re-referred to the Committee on Appropriations",4,2,0,1,7
513730,277488,2013-05-08,Assembly,"Do pass",12,5,0,0,17
513730,286063,2013-05-31,Assembly,"AB 1090 FONG  Assembly Third Reading",58,13,0,8,79
513730,296044,2013-07-02,Senate,"Do pass, but re-refer to the Committee on Appropriations",4,1,0,0,5
513730,299435,2013-09-11,Senate,"Assembly 3rd Reading AB1090 Fong By Torres",39,0,0,0,39
513730,299674,2013-09-12,Assembly,"AB 1090 FONG  Concurrence in Senate Amendments",71,4,0,3,78
513731,273545,2013-04-29,Assembly,"Be referred to Committee on Banking and Finance",11,0,0,0,11
513731,274108,2013-04-29,Assembly,"Do pass as amended and be re-referred to the Committee on 	Appropriations",11,1,0,0,12
513731,283767,2013-05-24,Assembly,"Do pass",16,0,0,1,17
513731,285022,2013-05-29,Assembly,"AB 1091 SKINNER  Assembly Third Reading",76,0,0,3,79
513731,289856,2013-06-19,Senate,"Do pass as amended, and re-refer to the Committee on 	Appropriations",9,0,0,0,9
513731,297655,2013-08-19,Senate,"Assembly 3rd Reading AB1091 Skinner By Hill",37,0,2,0,39
513731,297888,2013-08-22,Assembly,"AB 1091 SKINNER  Concurrence in Senate Amendments",77,0,0,1,78
513733,266625,2013-04-15,Assembly,"Do pass and be re-referred to the Committee on Housing and 	Community Development",12,3,0,1,16
513733,274973,2013-05-01,Assembly,"Do pass as amended and be re-referred to the Committee on 	Appropriations",5,2,0,0,7
513733,279704,2013-05-15,Assembly,"Do pass",12,5,0,0,17
513733,283934,2013-05-24,Assembly,"AB 1092 LEVINE  Assembly Third Reading",48,21,0,9,78
513733,289436,2013-06-18,Senate,"Do pass, but re-refer to the Committee on Environmental Quality",8,0,3,0,11
513733,295949,2013-07-03,Senate,"Do pass, but re-refer to the Committee on Appropriations",7,2,0,0,9
513733,297277,2013-08-12,Senate,"Do pass",4,1,2,0,7
513733,298069,2013-08-26,Senate,"Assembly 3rd Reading AB1092 Levine By Hill",29,9,1,0,39
513733,298390,2013-08-30,Assembly,"AB 1092 LEVINE  Concurrence in Senate Amendments",53,22,0,3,78
513735,268063,2013-04-16,Assembly,"Do pass and be re-referred to the Committee on Appropriations",7,0,0,0,7
513735,284085,2013-05-24,Assembly,"Do pass as amended",17,0,0,0,17
513735,285564,2013-05-30,Assembly,"AB 1094 BROWN  Assembly Third Reading",77,0,0,2,79
513735,291618,2013-06-25,Senate,"Do pass, but re-refer to the Committee on Appropriations Recommend 	Consent",6,0,0,0,6
513735,297435,2013-08-12,Senate,"Placed on Appropriations Suspense file",6,0,1,0,7
513735,298362,2013-08-30,Senate,"Do pass",7,0,0,0,7
513735,299698,2013-09-12,Senate,"Special Consent #10 AB1094 Brown By Yee",39,0,0,0,39
513737,274173,2013-04-29,Assembly,"Do pass as amended and be re-referred to the Committee on 	Appropriations",14,0,0,2,16
513737,283903,2013-05-24,Assembly,"Do pass",17,0,0,0,17
513737,285095,2013-05-29,Assembly,"AB 1096 NESTANDE  Assembly Third Reading",77,0,0,2,79
513737,374752,2014-06-26,Senate,"Do pass, but re-refer to the Committee on Appropriations Recommend 	Consent",10,0,1,0,11
513737,376532,2014-08-04,Senate,"Placed on Appropriations Suspense file",7,0,0,0,7
513737,377467,2014-08-14,Senate,"Do pass",5,0,2,0,7
513737,378487,2014-08-26,Senate,"Assembly 3rd Reading AB1096 Nestande By Morrell",35,0,5,0,40
513737,378721,2014-08-27,Assembly,"AB 1096 NESTANDE  Concurrence in Senate Amendments",77,0,0,2,79
513739,274494,2013-04-30,Assembly,"Do pass as amended",15,0,0,0,15
513739,278232,2013-05-09,Assembly,"AB 1097 NESTANDE  Assembly Third Reading",75,0,0,4,79
513739,288265,2013-06-11,Senate,"Do pass as amended. To Consent Calendar",9,0,0,0,9
513739,297701,2013-08-19,Senate,"Placed on Appropriations Suspense file",7,0,0,0,7
513739,298426,2013-08-30,Senate,"Do pass as amended",5,0,2,0,7
513739,299529,2013-09-11,Senate,"Special Consent #10 AB1097 Nestande By Emmerson",39,0,0,0,39
513739,299780,2013-09-12,Assembly,"AB 1097 NESTANDE  Concurrence in Senate Amendments",78,0,0,0,78
513740,271591,2013-04-23,Assembly,"Do pass as amended and be re-referred to the Committee on 	Appropriations",9,0,0,0,9
513740,284034,2013-05-24,Assembly,"Do pass",17,0,0,0,17
513740,284989,2013-05-29,Assembly,"AB 1098 QUIRK-SILVA  Assembly Third Reading",78,0,0,1,79
513740,291365,2013-06-24,Senate,"Do pass, but re-refer to the Committee on Environmental Quality",9,0,1,0,10
513740,296014,2013-07-03,Senate,"Do pass as amended, and re-refer to the Committee on 	Appropriations",9,0,0,0,9
513740,297387,2013-08-12,Senate,"Placed on Appropriations Suspense file",6,0,1,0,7
513742,265324,2013-04-15,Assembly,"Do pass as amended and be re-referred to the Committee on 	Appropriations",13,1,0,1,15
513743,308637,2014-01-13,Assembly,"Do pass and be re-referred to the Committee on Appropriations",15,0,0,1,16
513743,311248,2014-01-23,Assembly,"Do pass, to Consent Calendar",16,0,0,1,17
513743,313274,2014-01-29,Assembly,"AB 1101 CHESBRO  Consent Calendar Second Day  Regular Session",78,0,0,2,80
513743,370625,2014-06-10,Senate,"Do pass, but re-refer to the Committee on Appropriations",10,0,1,0,11
513743,375650,2014-07-03,Senate,"Special Consent #18 AB1101 Chesbro",35,0,5,0,40
513745,308355,2014-01-13,Assembly,"Do pass as amended and be re-referred to the Committee on 	Appropriations",7,0,0,2,9
513745,311167,2014-01-23,Assembly,"Do pass",16,0,0,1,17
513745,312181,2014-01-27,Assembly,"AB 1102 ALLEN  Assembly Third Reading",68,0,0,12,80
513745,369829,2014-06-04,Senate,"Do pass as amended, and re-refer to the Committee on Natural 	Resources and Water",4,2,1,0,7
513745,374036,2014-06-24,Senate,"Do pass as amended, and re-refer to the Committee on Appropriations",7,0,2,0,9
513745,376946,2014-08-11,Senate,"Placed on Appropriations Suspense file",7,0,0,0,7
513746,272826,2013-04-24,Assembly,"Do pass and re-refer to Committee on Appropriations with 	recommendation:  To Consent Calendar",16,0,0,1,17
513746,277581,2013-05-08,Assembly,"Do pass, to Consent Calendar",17,0,0,0,17
513746,280249,2013-05-16,Assembly,"AB 1103 HALL  Consent Calendar Second Day  Regular Session",70,0,0,9,79
513747,307166,2014-01-09,Assembly,"Be referred to Committee on Natural Resources",7,4,0,0,11
513747,309443,2014-01-16,Assembly,"Do pass as amended and be re-referred to the Committee on 	Appropriations",6,1,0,2,9
513747,311099,2014-01-23,Assembly,"Do pass as amended",16,0,0,1,17
513747,313223,2014-01-29,Assembly,"AB 1104 SALAS  Assembly Third Reading",77,1,0,2,80
513747,372754,2014-06-18,Senate,"Do pass, but re-refer to the Committee on Appropriations",2,2,3,0,7
513747,372755,2014-06-18,Senate,"Set, second hearing.  Failed passage in Committee. 	Reconsideration granted",7,0,0,0,7
513747,374562,2014-06-25,Senate,"Do pass, but re-refer to the Committee on Appropriations",4,3,0,0,7
513747,377286,2014-08-14,Senate,"Assembly 3rd Reading AB1104 Salas By Lara",33,1,6,0,40
513750,274120,2013-04-30,Assembly,"Do pass and be re-referred to the Committee on Public Safety",3,7,0,0,10
513750,274121,2013-04-30,Assembly,"Set first hearing.  Failed passage.  Reconsideration granted",10,0,0,0,10
513751,274812,2013-04-30,Assembly,"Do pass and be re-referred to the Committee on Appropriations",5,0,0,2,7
513752,270903,2013-04-23,Assembly,"Do pass as amended and be re-referred to the Committee on 	Appropriations",7,0,0,0,7
513752,277451,2013-05-08,Assembly,"Do pass, to Consent Calendar",17,0,0,0,17
513752,280224,2013-05-16,Assembly,"AB 1108 PEREA  Consent Calendar Second Day  Regular Session",70,0,0,9,79
513752,288308,2013-06-11,Senate,"Do pass, but re-refer to the Committee on Appropriations",7,0,0,0,7
513752,291248,2013-06-24,Senate,"Placed on Appropriations Suspense file",7,0,0,0,7
513752,298500,2013-08-30,Senate,"Do pass",7,0,0,0,7
513752,299082,2013-09-09,Senate,"Assembly 3rd Reading AB1108 Perea By Anderson",39,0,0,0,39
513752,299305,2013-09-10,Assembly,"AB 1108 PEREA  Concurrence in Senate Amendments",78,0,0,0,78
513753,275470,2013-05-01,Assembly,"Do pass as amended and be re-referred to the Committee on 	Appropriations",7,0,0,0,7
513753,279823,2013-05-15,Assembly,"Do pass",16,0,0,1,17
513753,283815,2013-05-24,Assembly,"AB 1109 BONILLA  Assembly Third Reading",71,0,0,7,78
513753,295814,2013-07-02,Senate,"Do pass, but re-refer to the Committee on Appropriations Recommend 	Consent",11,0,0,0,11
513753,297273,2013-08-12,Senate,"Do pass",5,0,2,0,7
513753,299651,2013-09-12,Assembly,"AB 1109 BONILLA  Concurrence in Senate Amendments",77,0,0,1,78
513753,299652,2013-09-12,Senate,"Special Consent #10 AB1109 Bonilla By Hueso",39,0,0,0,39
513757,267346,2013-04-16,Assembly,"Do pass as amended and be re-referred to the Committee on 	Appropriations",7,0,0,0,7
513757,277329,2013-05-08,Assembly,"Do pass, to Consent Calendar",17,0,0,0,17
513757,280251,2013-05-16,Assembly,"AB 1112 AMMIANO  Consent Calendar Second Day  Regular Session",70,0,0,9,79
513757,288042,2013-06-11,Senate,"Do pass, but re-refer to the Committee on Appropriations",6,0,0,0,6
513757,295253,2013-07-01,Senate,"Placed on Appropriations Suspense file",6,0,1,0,7
513757,299626,2013-09-12,Senate,"Do pass",4,2,1,0,7
513757,299627,2013-09-12,Senate,"Assembly 3rd Supp 3 AB1112 Ammiano By Leno",24,11,4,0,39
513757,299628,2013-09-12,Assembly,"AB 1112 AMMIANO  Concurrence in Senate Amendments",45,26,0,7,78
513758,269997,2013-04-22,Assembly,"Do pass and be re-referred to the Committee on Appropriations",15,1,0,0,16
513758,277437,2013-05-08,Assembly,"Do pass",16,1,0,0,17
513758,280221,2013-05-16,Assembly,"AB 1113 FRAZIER  Assembly Third Reading",65,6,0,8,79
513758,291571,2013-06-25,Senate,"Do pass, but re-refer to the Committee on Appropriations",11,0,0,0,11
513758,297670,2013-08-19,Senate,"Do pass",7,0,0,0,7
513758,298573,2013-09-03,Senate,"Assembly 3rd Reading AB1113 Frazier By Gaines",34,2,3,0,39
513758,298801,2013-09-06,Assembly,"AB 1113 FRAZIER  Concurrence in Senate Amendments",69,8,0,1,78
513762,272388,2013-04-24,Assembly,"Do pass as amended and be re-referred to the Committee on 	Appropriations",17,0,0,0,17
513762,283942,2013-05-24,Assembly,"Do pass",17,0,0,0,17
513762,285041,2013-05-29,Assembly,"AB 1116 HALL  Assembly Third Reading",78,0,0,1,79
513762,291681,2013-06-25,Senate,"Do pass, but re-refer to the Committee on Appropriations",10,0,1,0,11
513762,297418,2013-08-12,Senate,"Placed on Appropriations Suspense file",6,0,1,0,7
513762,298391,2013-08-30,Senate,"Do pass as amended",7,0,0,0,7
513762,299313,2013-09-10,Senate,"Assembly 3rd Reading AB1116 Hall By Wright",38,0,1,0,39
513762,299566,2013-09-11,Assembly,"AB 1116 HALL  Concurrence in Senate Amendments",78,0,0,0,78
513763,271134,2013-04-23,Assembly,"Do pass and be re-referred to the Committee on Appropriations",5,0,0,2,7
513763,277325,2013-05-08,Assembly,"Do pass",16,1,0,0,17
513763,281320,2013-05-20,Assembly,"AB 1117 DONNELLY  Assembly Third Reading",72,1,0,5,78
513763,296110,2013-07-02,Senate,"Do pass, but re-refer to the Committee on Appropriations",4,1,0,0,5
513763,297392,2013-08-12,Senate,"Placed on Appropriations Suspense file",6,0,1,0,7
513764,266410,2013-04-16,Assembly,"Do pass and be re-referred to the Committee on Appropriations",7,0,0,0,7
513764,283811,2013-05-24,Assembly,"Do pass as amended",17,0,0,0,17
513764,285548,2013-05-30,Assembly,"AB 1118 HAGMAN  Assembly Third Reading",72,0,0,7,79
513764,295749,2013-07-02,Senate,"Do pass as amended, and re-refer to the Committee on Appropriations",2,5,0,0,7
513764,295750,2013-07-02,Senate,"Set, first hearing.  Failed passage in Committee.  Reconsideration 	granted",7,0,0,0,7
513764,374423,2014-06-24,Senate,"Do pass, but re-refer to the Committee on Appropriations",3,2,2,0,7
513766,266559,2013-04-16,Assembly,"Do pass and re-refer to Committee on Appropriations with 	recommendation:  To Consent Calendar",7,0,0,0,7
513768,266226,2013-04-16,Assembly,"Do pass as amended and be re-referred to the Committee on 	Appropriations",9,1,0,0,10
513768,274715,2013-05-01,Assembly,"Do pass",12,5,0,0,17
513768,278014,2013-05-09,Assembly,"AB 1121 ATKINS  Assembly Third Reading",57,17,0,5,79
513768,295961,2013-07-02,Senate,"Do pass as amended, and re-refer to the Committee on 	Appropriations",4,2,1,0,7
513768,298605,2013-09-03,Senate,"Assembly 3rd Reading AB1121 Atkins By Monning",25,11,3,0,39
513768,298776,2013-09-06,Assembly,"AB 1121 ATKINS  Concurrence in Senate Amendments",58,20,0,0,78
513769,261801,2013-04-09,Assembly,"Do pass and be re-referred to the Committee on Transportation",5,2,0,0,7
513769,274314,2013-04-29,Assembly,"Do pass and be re-referred to the Committee on Appropriations",12,3,0,1,16
513770,275108,2013-04-30,Assembly,"Do pass and be re-referred to the Committee on Appropriations",2,5,0,0,7
513770,277487,2013-05-07,Assembly,"Reconsideration granted",7,0,0,0,7
513771,257460,2013-04-02,Assembly,"Do pass and be re-referred to the Committee on Veterans Affairs",18,0,0,1,19
513771,267582,2013-04-16,Assembly,"Do pass and be re-referred to the Committee on Appropriations",10,0,0,0,10
513771,283879,2013-05-24,Assembly,"Do pass as amended",17,0,0,0,17
513771,285502,2013-05-30,Assembly,"AB 1124 MURATSUCHI  Assembly Third Reading",78,0,0,1,79
513771,320208,2014-02-12,Senate,"Do pass as amended, and re-refer to the Committee on Appropriations",7,0,2,0,9
513771,327771,2014-02-24,Senate,"Do pass",5,0,2,0,7
513771,332952,2014-03-03,Senate,"Assembly 3rd Reading AB1124 Muratsuchi Urgency Clause",31,0,8,0,39
513771,338625,2014-03-10,Assembly,"Senate amendments be concurred in",13,0,0,5,18
513771,343967,2014-03-17,Assembly,"Senate amendments be concurred in",17,0,0,0,17
513771,346493,2014-03-20,Assembly,"AB 1124 MURATSUCHI  Concurrence- Urgency Added",76,0,0,4,80
513774,274082,2013-04-29,Assembly,"Do pass as amended and be re-referred to the Committee on 	Appropriations",9,0,0,0,9
513774,283897,2013-05-24,Assembly,"Do pass",17,0,0,0,17
513774,285164,2013-05-29,Assembly,"AB 1126 GORDON  Assembly Third Reading",78,0,0,1,79
513774,291884,2013-06-26,Senate,"Do pass as amended, and re-refer to the Committee on 	Appropriations",9,0,0,0,9
513774,299045,2013-09-09,Senate,"Assembly 3rd Reading AB1126 Gordon By Hill",37,0,2,0,39
513774,299269,2013-09-10,Assembly,"AB 1126 GORDON  Concurrence in Senate Amendments",77,1,0,0,78
513775,274385,2013-04-30,Assembly,"Do pass as amended and be re-referred to the Committee on 	Appropriations",8,2,0,0,10
513775,283886,2013-05-24,Assembly,"Do pass as amended",12,5,0,0,17
513775,285643,2013-05-30,Assembly,"AB 1127 CHAU  Assembly Third Reading",55,23,0,1,79
513775,291673,2013-06-25,Senate,"Do pass, but re-refer to the Committee on Appropriations",5,2,0,0,7
513775,297284,2013-08-12,Senate,"Placed on Appropriations Suspense file",6,0,1,0,7
513775,298323,2013-08-30,Senate,"Do pass as amended",5,2,0,0,7
513775,299562,2013-09-11,Assembly,"AB 1127 CHAU  Concurrence in Senate Amendments",55,23,0,0,78
513775,299563,2013-09-11,Senate,"Assembly 3rd Reading AB1127 Chau By Lara",28,9,2,0,39
513776,272242,2013-04-24,Assembly,"Do pass and be re-referred to the Committee on Public Safety",15,0,0,2,17
513776,274752,2013-04-30,Assembly,"Do pass and be re-referred to the Committee on Appropriations",6,0,0,1,7
513776,283864,2013-05-24,Assembly,"Do pass",16,0,0,1,17
513776,284987,2013-05-29,Assembly,"AB 1128 SALAS  Assembly Third Reading",74,1,0,4,79
513776,295784,2013-07-02,Senate,"Do pass as amended, and re-refer to the Committee on Appropriations",7,0,0,0,7
513776,297300,2013-08-12,Senate,"Do pass",5,0,2,0,7
513776,298588,2013-09-03,Senate,"Assembly 3rd Reading AB1128 Salas By Cannella",36,0,3,0,39
513776,298767,2013-09-06,Assembly,"AB 1128 SALAS  Concurrence in Senate Amendments",75,1,0,2,78
513778,271551,2013-04-24,Assembly,"Do pass and re-refer to Committee on Appropriations with 	recommendation:  To Consent Calendar",13,0,0,0,13
513778,279898,2013-05-15,Assembly,"Do pass",17,0,0,0,17
513778,285630,2013-05-30,Assembly,"AB 1130 WILK  Assembly Third Reading",78,0,0,1,79
513778,375143,2014-06-25,Senate,"Do pass as amended, and re-refer to the Committee on 	Appropriations",10,0,1,0,11
513778,377079,2014-08-13,Senate,"Assembly 3rd Reading AB1130 Wilk By Gaines",32,0,8,0,40
513778,377960,2014-08-20,Assembly,"AB 1130 WILK  Concurrence in Senate Amendments",78,0,0,1,79
513780,274090,2013-04-29,Assembly,"Do pass and be re-referred to the Committee on Appropriations",9,0,0,0,9
513780,283832,2013-05-24,Assembly,"Do pass",16,1,0,0,17
513780,284948,2013-05-29,Assembly,"AB 1131 SKINNER  Assembly Third Reading",75,2,0,2,79
513780,295762,2013-07-02,Senate,"Do pass, but re-refer to the Committee on Appropriations",6,0,1,0,7
513780,297312,2013-08-12,Senate,"Placed on Appropriations Suspense file",6,0,1,0,7
513780,298305,2013-08-30,Senate,"Do pass as amended",6,1,0,0,7
513780,298913,2013-09-09,Senate,"Assembly 3rd Reading AB1131 Skinner By Wolk",37,0,2,0,39
513780,299114,2013-09-10,Assembly,"AB 1131 SKINNER  Concurrence in Senate Amendments",72,2,0,4,78
513781,267597,2013-04-17,Assembly,"Do pass and be re-referred to the Committee on Appropriations",7,0,0,0,7
513781,283890,2013-05-24,Assembly,"Do pass",16,0,0,1,17
513781,285167,2013-05-29,Assembly,"AB 1132 EGGMAN  Assembly Third Reading",77,0,0,2,79
513781,295882,2013-07-02,Senate,"Do pass, but re-refer to the Committee on Appropriations",4,0,1,0,5
513781,297687,2013-08-19,Senate,"Do pass",5,0,2,0,7
513781,298682,2013-09-03,Senate,"Assembly 3rd Reading AB1132 Eggman By Cannella",36,0,3,0,39
513781,298893,2013-09-06,Assembly,"AB 1132 EGGMAN  Concurrence in Senate Amendments",76,1,0,1,78
513782,274754,2013-04-30,Assembly,"Do pass as amended",5,0,0,2,7
513782,278039,2013-05-09,Assembly,"AB 1133 MITCHELL  Assembly Third Reading",74,0,0,5,79
513782,291649,2013-06-25,Senate,"Do pass as amended",6,0,0,0,6
513782,299065,2013-09-09,Senate,"Assembly 3rd Reading AB1133 Mitchell By Beall",39,0,0,0,39
513782,299287,2013-09-10,Assembly,"AB 1133 MITCHELL  Concurrence in Senate Amendments",77,0,0,1,78
513786,261847,2013-04-09,Assembly,"Do pass",5,2,0,0,7
513786,265400,2013-04-15,Assembly,"AB 1135 MULLIN  Assembly Third Reading",52,25,0,2,79
513786,296072,2013-07-02,Senate,"Do pass",4,1,0,0,5
513786,297756,2013-08-19,Senate,"Assembly 3rd Reading AB1135 Mullin By Hill",24,11,4,0,39
513786,297959,2013-08-22,Assembly,"AB 1135 MULLIN  Concurrence in Senate Amendments",52,26,0,0,78
513787,257440,2013-04-02,Assembly,"Do pass as amended and be re-referred to the Committee on Business, 	Professions and Consumer Protection",11,1,0,7,19
513787,270978,2013-04-23,Assembly,"Do pass and be re-referred to the Committee on Appropriations",12,0,0,1,13
513787,277497,2013-05-08,Assembly,"Do pass",14,1,0,2,17
513787,280391,2013-05-16,Assembly,"AB 1136 LEVINE  Assembly Third Reading",70,1,0,8,79
513787,289346,2013-06-17,Senate,"Do pass, but re-refer to the Committee on Appropriations",10,0,0,0,10
513787,295256,2013-07-01,Senate,"Do pass",6,0,1,0,7
513787,297778,2013-08-19,Senate,"Assembly 3rd Reading AB1136 Levine By Emmerson",37,0,2,0,39
513792,263449,2013-04-10,Assembly,"Do pass and be re-referred to the Committee on Appropriations",5,1,0,1,7
513792,284077,2013-05-24,Assembly,"Do pass as amended",12,5,0,0,17
513792,285525,2013-05-30,Assembly,"AB 1140 DALY  Assembly Third Reading",54,24,0,1,79
513792,292054,2013-06-26,Senate,"Do pass, but re-refer to the Committee on Appropriations",3,1,1,0,5
513792,297351,2013-08-12,Senate,"Do pass",4,1,2,0,7
513792,298117,2013-08-26,Senate,"Assembly 3rd Reading AB1140 Daly By Monning",26,13,0,0,39
513794,266590,2013-04-16,Assembly,"Do pass and be re-referred to the Committee on Governmental 	Organization",9,6,0,0,15
513794,272283,2013-04-24,Assembly,"Do pass as amended and be re-referred to the Committee on 	Appropriations",6,8,0,3,17
513794,272284,2013-04-24,Assembly,"Set first hearing.  Failed passage.  Reconsideration granted",17,0,0,0,17
513795,266970,2013-04-15,Assembly,"Do pass as amended and be re-referred to the Committee on 	Appropriations",8,0,0,1,9
513795,274934,2013-05-01,Assembly,"Do pass, to Consent Calendar",17,0,0,0,17
513795,278800,2013-05-13,Assembly,"AB 1143 SKINNER  Third Reading Urgency",73,0,0,6,79
513795,287168,2013-06-05,Senate,"Do pass, but re-refer to the Committee on Appropriations Recommend 	Consent",7,0,0,0,7
513795,372734,2014-06-18,Senate,"From Committee:  That the measure be returned to the Senate floor 	for consideration",7,0,0,0,7
513795,376371,2014-08-04,Senate,"Assembly 3rd Reading AB1143 Skinner Urgency Clause",36,0,4,0,40
513795,377519,2014-08-14,Assembly,"AB 1143 SKINNER  Concurrence in Senate Amendments",79,0,0,0,79
513796,271827,2013-04-24,Assembly,"Do pass as amended and be re-referred to the Committee on 	Appropriations",5,2,0,0,7
513796,277328,2013-05-08,Assembly,"Do pass",12,5,0,0,17
513796,280237,2013-05-16,Assembly,"AB 1144 HALL  Assembly Third Reading",51,19,0,9,79
513796,287716,2013-06-10,Senate,"Do pass, but re-refer to the Committee on Appropriations",4,0,1,0,5
513796,291191,2013-06-24,Senate,"Do pass",6,1,0,0,7
513796,297684,2013-08-19,Senate,"Assembly 3rd Reading AB1144 Hall By Wright",32,4,3,0,39
513796,297905,2013-08-22,Assembly,"AB 1144 HALL  Concurrence in Senate Amendments",53,23,0,2,78
513799,268587,2013-04-17,Assembly,"Do pass and be re-referred to the Committee on Higher Education to 	Consent Calendar",7,0,0,0,7
513799,271583,2013-04-23,Assembly,"Do pass and re-refer to Committee on Appropriations with 	recommendation:  To Consent Calendar",12,0,0,1,13
513799,283878,2013-05-24,Assembly,"Do pass",17,0,0,0,17
513799,285145,2013-05-29,Assembly,"AB 1146 MORRELL  Assembly Third Reading",78,0,0,1,79
513799,296143,2013-07-03,Senate,"Do pass, but re-refer to the Committee on Appropriations",9,0,0,0,9
513799,297391,2013-08-12,Senate,"Placed on Appropriations Suspense file",6,0,1,0,7
513800,276797,2013-05-07,Assembly,"Do pass as amended",8,4,0,1,13
513800,285962,2013-05-31,Assembly,"AB 1147 GOMEZ  Assembly Third Reading  Amend By GOMEZ  Set #1",52,24,0,3,79
513800,310349,2014-01-21,Assembly,"Do pass",11,0,0,3,14
513800,312271,2014-01-27,Assembly,"AB 1147 GOMEZ  Assembly Third Reading",68,1,0,11,80
513800,373976,2014-06-23,Senate,"Do pass as amended, and re-refer to the Committee on 	Appropriations",8,0,1,0,9
513800,378535,2014-08-26,Senate,"Assembly 3rd Reading AB1147 Bonilla By Liu",34,0,6,0,40
513800,378876,2014-08-28,Assembly,"Senate amendments be concurred in",16,0,0,1,17
513800,378877,2014-08-28,Assembly,"Senate amendments be concurred in",12,1,0,1,14
513800,378878,2014-08-28,Assembly,"Be referred to Committee on Appropriations",12,1,0,1,14
513800,379121,2014-08-29,Assembly,"AB 1147 BONILLA  Concurrence in Senate Amendments",77,0,0,2,79
513802,268658,2013-04-17,Assembly,"Do pass and be re-referred to the Committee on Judiciary",9,0,0,0,9
513802,274585,2013-04-30,Assembly,"Do pass and re-refer to Committee on Appropriations with 	recommendation:  To Consent Calendar",10,0,0,0,10
513802,283986,2013-05-24,Assembly,"Do pass",17,0,0,0,17
513802,285262,2013-05-29,Assembly,"AB 1149 CAMPOS  Assembly Third Reading",78,0,0,1,79
513802,291638,2013-06-25,Senate,"Do pass, but re-refer to the Committee on Appropriations",7,0,0,0,7
513802,297429,2013-08-12,Senate,"Placed on Appropriations Suspense file",6,0,1,0,7
513802,298512,2013-08-30,Senate,"Do pass",7,0,0,0,7
513802,299028,2013-09-09,Senate,"Assembly 3rd Reading AB1149 Campos By Corbett",39,0,0,0,39
513802,299250,2013-09-10,Assembly,"AB 1149 CAMPOS  Concurrence in Senate Amendments",78,0,0,0,78
513805,272362,2013-04-24,Assembly,"Do pass and be re-referred to the Committee on Revenue and Taxation",6,2,0,1,9
513805,274200,2013-04-29,Assembly,"Do pass as amended and be re-referred to the Committee on 	Appropriations",6,1,0,2,9
513806,275560,2013-05-01,Assembly,"Do pass and be re-referred to the Committee on Appropriations",6,1,0,0,7
513807,308729,2014-01-14,Assembly,"Do pass and be re-referred to the Committee on Appropriations",14,0,0,0,14
513807,311218,2014-01-23,Assembly,"Do pass",16,0,0,1,17
513807,312203,2014-01-27,Assembly,"AB 1153 EGGMAN  Assembly Third Reading",72,2,0,6,80
513807,374126,2014-06-23,Senate,"Do pass as amended, and re-refer to the Committee on 	Appropriations",6,1,2,0,9
513807,376904,2014-08-11,Senate,"Do pass",7,0,0,0,7
513808,272421,2013-04-24,Assembly,"Do pass as amended and be re-referred to the Committee on 	Appropriations",14,1,0,2,17
513811,278354,2013-05-08,Assembly,"Do pass as amended",7,1,0,1,9
513811,283838,2013-05-24,Assembly,"Do pass",12,5,0,0,17
513811,285668,2013-05-30,Assembly,"AB 1156 PEREZ, V.M.  Assembly Third Reading",66,8,0,5,79
513811,291904,2013-06-26,Senate,"Do pass as amended, and re-refer to the Committee on 	Appropriations",7,0,0,0,7
513811,297679,2013-08-19,Senate,"Assembly 3rd Reading AB1156 V. Manuel P",37,0,2,0,39
513811,297912,2013-08-22,Assembly,"AB 1156 PEREZ, V.M.  Concurrence in Senate Amendments",67,10,0,1,78
513812,271027,2013-04-23,Assembly,"Do pass and be re-referred to the Committee on Appropriations",2,4,0,1,7
513812,271028,2013-04-23,Assembly,"Set second hearing.  Failed passage.  Reconsideration granted",7,0,0,0,7
513814,259632,2013-04-03,Assembly,"Do pass and be re-referred to the Committee on Appropriations",6,0,0,1,7
513814,262576,2013-04-10,Assembly,"Do pass",12,5,0,0,17
513814,278029,2013-05-09,Assembly,"AB 1159 BLUMENFIELD  Assembly Third Reading",54,22,0,3,79
513814,288559,2013-06-12,Senate,"Do pass, but re-refer to the Committee on Appropriations",7,1,1,0,9
513814,291245,2013-06-24,Senate,"Placed on Appropriations Suspense file",7,0,0,0,7
513814,297744,2013-08-19,Senate,"Do pass, but re-refer to the Committee on Judiciary",9,0,1,0,10
513814,297745,2013-08-19,Senate,"Do pass, but re-refer to the Committee on Appropriations",10,0,0,0,10
513814,298125,2013-08-26,Senate,"Do pass, but re-refer to the Committee on Appropriations",7,0,0,0,7
513814,298339,2013-08-30,Senate,"Do pass as amended",7,0,0,0,7
513814,299155,2013-09-10,Senate,"From Committee:  That the measure be returned to the Senate floor 	for consideration",7,0,0,0,7
513814,299598,2013-09-12,Assembly,"Senate amendments be concurred in",9,0,0,1,10
513814,299599,2013-09-12,Assembly,"AB 1159 GONZALEZ  Concurrence- Urgency Added",76,0,0,2,78
513814,299600,2013-09-12,Senate,"Assembly 3rd Supp 1 AB1159 Gonzalez Urgency Clause",39,0,0,0,39
513816,261749,2013-04-09,Assembly,"Do pass",10,0,0,0,10
513816,263587,2013-04-11,Assembly,"AB 1160 WAGNER  Assembly Third Reading",74,0,0,5,79
513816,288083,2013-06-11,Senate,"Do pass and be placed on the Consent Calendar",7,0,0,0,7
513816,291494,2013-06-24,Senate,"Consent Calendar 2nd AB1160 Wagner",39,0,0,0,39
513816,292150,2013-06-27,Assembly,"AB 1160 WAGNER  Concurrence in Senate Amendments",78,0,0,1,79
513818,262734,2013-04-09,Assembly,"Do pass as amended and be re-referred to the Committee on 	Appropriations",9,3,0,1,13
513818,277520,2013-05-08,Assembly,"Do pass",12,5,0,0,17
513818,280265,2013-05-16,Assembly,"AB 1162 FRAZIER  Assembly Third Reading",51,20,0,8,79
513818,288462,2013-06-12,Senate,"Do pass, but re-refer to the Committee on Banking and Financial 	Institution",6,2,1,0,9
513818,296142,2013-07-03,Senate,"Reconsideration granted",6,0,3,0,9
513818,296240,2013-07-03,Senate,"Set, first hearing.  Failed passage in Committee.  Reconsideration 	granted",5,0,4,0,9
513819,309054,2014-01-08,Assembly,"Do pass and be re-referred to the Committee on Appropriations",6,0,0,1,7
513819,311174,2014-01-23,Assembly,"Do pass, to Consent Calendar",16,0,0,1,17
513819,313270,2014-01-29,Assembly,"AB 1163 LEVINE  Assembly Third Reading",70,1,0,9,80
513819,370164,2014-06-09,Senate,"Do pass, but re-refer to the Committee on Appropriations",5,0,0,0,5
513819,375346,2014-06-30,Senate,"Assembly 3rd Reading AB1163 Levine By Lieu",36,0,4,0,40
513821,270824,2013-04-23,Assembly,"Do pass as amended and be re-referred to the Committee on Labor and 	Employment",6,3,0,1,10
513821,275634,2013-05-01,Assembly,"Do pass as amended and be re-referred to the Committee on 	Appropriations",4,2,0,1,7
513821,311414,2014-01-23,Assembly,"Do pass as amended",12,4,0,1,17
513822,277986,2013-05-08,Assembly,"Do pass",5,2,0,0,7
513822,280289,2013-05-16,Assembly,"AB 1165 SKINNER  Assembly Third Reading",47,19,0,13,79
513822,288405,2013-06-12,Senate,"Do pass as amended, and re-refer to the Committee on Appropriations",4,0,1,0,5
513822,297224,2013-08-12,Senate,"Placed on Appropriations Suspense file",6,0,1,0,7
513822,298306,2013-08-30,Senate,"Do pass as amended",5,2,0,0,7
513822,299339,2013-09-11,Assembly,"AB 1165 SKINNER  Concurrence in Senate Amendments",47,27,0,4,78
513822,299340,2013-09-11,Senate,"Assembly 3rd Reading AB1165 Skinner By Hernandez",23,13,3,0,39
513824,261917,2013-04-09,Assembly,"Do pass, to Consent Calendar",10,0,0,0,10
513824,265462,2013-04-15,Assembly,"AB 1167 DICKINSON  Consent Calendar Second Day  Regular Session",77,0,0,2,79
513824,287109,2013-06-04,Senate,"Do pass as amended. To Consent Calendar",6,0,1,0,7
513824,296225,2013-07-08,Senate,"Assembly 3rd Reading AB1167 Dickinson By Corbett",32,0,6,0,38
513824,297163,2013-08-08,Assembly,"AB 1167 DICKINSON  Concurrence in Senate Amendments",77,0,0,1,78
513825,257346,2013-04-02,Assembly,"Do pass",16,0,0,3,19
513825,260944,2013-04-08,Assembly,"AB 1168 PAN  Assembly Third Reading",74,0,0,5,79
513825,289851,2013-06-19,Senate,"Do pass as amended, and re-refer to the Committee on 	Appropriations",9,0,0,0,9
513825,298760,2013-09-06,Senate,"Assembly 3rd Reading AB1168 Pan By Leno",38,0,1,0,39
513825,298952,2013-09-09,Assembly,"AB 1168 PAN  Concurrence in Senate Amendments",74,0,0,4,78
513827,270678,2013-04-22,Assembly,"Do pass",11,0,0,1,12
513827,272323,2013-04-25,Assembly,"AB 1169 DALY  Assembly Third Reading",75,0,0,4,79
513827,289911,2013-06-19,Senate,"Do pass as amended, and re-refer to the Committee on Judiciary",9,0,0,0,9
513827,296037,2013-07-02,Senate,"Do pass",6,0,1,0,7
513827,299074,2013-09-09,Senate,"Assembly 3rd Reading AB1169 Daly By Evans",37,0,2,0,39
513827,299176,2013-09-10,Assembly,"AB 1169 DALY  Concurrence in Senate Amendments",77,0,0,1,78
513828,305731,2014-01-06,Assembly,"Be referred to Committee on Elections and Redistricting",9,0,0,1,10
513828,309177,2014-01-15,Assembly,"Do pass",1,5,0,1,7
513829,274780,2013-04-30,Assembly,"Do pass as amended and be re-referred to the Committee on 	Appropriations",5,1,0,1,7
513829,283788,2013-05-24,Assembly,"Do pass as amended",16,0,0,1,17
513829,285508,2013-05-30,Assembly,"AB 1171 LEVINE  Assembly Third Reading",76,0,0,3,79
513829,291610,2013-06-25,Senate,"Do pass, but re-refer to the Committee on Appropriations",6,0,0,0,6
513829,297222,2013-08-12,Senate,"Placed on Appropriations Suspense file",6,0,1,0,7
513830,309122,2014-01-15,Assembly,"Do pass and be re-referred to the Committee on Revenue and Taxation",9,0,0,0,9
513830,309546,2014-01-16,Assembly,"Do pass and be re-referred to the Committee on Appropriations",8,0,0,1,9
513830,311150,2014-01-23,Assembly,"Do pass",16,0,0,1,17
513830,312233,2014-01-27,Assembly,"AB 1172 BOCANEGRA  Assembly Third Reading",73,0,0,7,80
513830,374463,2014-06-25,Senate,"Do pass, but re-refer to the Committee on Appropriations",7,0,0,0,7
513830,376615,2014-08-04,Senate,"Placed on Appropriations Suspense file",7,0,0,0,7
513830,377378,2014-08-14,Senate,"Do pass",6,0,1,0,7
513831,278806,2013-05-13,Assembly,"Do pass and be re-referred to the Committee on Appropriations",9,0,0,0,9
513831,283952,2013-05-24,Assembly,"Do pass",17,0,0,0,17
513831,285123,2013-05-29,Assembly,"AB 1173 BOCANEGRA  Assembly Third Reading",78,0,0,1,79
513831,297503,2013-08-14,Senate,"Do pass, but re-refer to the Committee on Appropriations Recommend 	Consent",7,0,0,0,7
513831,297661,2013-08-19,Senate,"Placed on Appropriations Suspense file",7,0,0,0,7
513831,298378,2013-08-30,Senate,"Do pass",7,0,0,0,7
513831,299764,2013-09-12,Senate,"W/O REF. TO FILE AB1173 Bocanegra By De Le",35,0,4,0,39
513831,299765,2013-09-12,Assembly,"AB 1173 BOCANEGRA  Concurrence in Senate Amendments",78,0,0,0,78
513833,266215,2013-04-16,Assembly,"Do pass and be re-referred to the Committee on Health",12,0,0,1,13
513833,309055,2014-01-14,Assembly,"Do pass and be re-referred to the Committee on Appropriations",17,0,0,2,19
513833,311107,2014-01-23,Assembly,"Do pass",16,0,0,1,17
513833,312245,2014-01-27,Assembly,"AB 1174 BOCANEGRA  Assembly Third Reading",76,0,0,4,80
513833,371755,2014-06-16,Senate,"Do pass, but re-refer to the Committee on Rules",8,0,1,0,9
513833,374879,2014-06-25,Senate,"Do pass as amended, and re-refer to the Committee on 	Appropriations",8,0,1,0,9
513833,376413,2014-08-04,Senate,"Placed on Appropriations Suspense file",7,0,0,0,7
513833,377376,2014-08-14,Senate,"Do pass",6,0,1,0,7
513833,378802,2014-08-27,Senate,"Special Consent #19 AB1174 Bocanegra By Galgiani",36,0,4,0,40
513833,378964,2014-08-28,Assembly,"AB 1174 BOCANEGRA  Concurrence in Senate Amendments",79,0,0,0,79
513834,267381,2013-04-17,Assembly,"Do pass and be re-referred to the Committee on Local Government",5,2,0,0,7
513834,274844,2013-05-01,Assembly,"Do pass and be re-referred to the Committee on Appropriations",7,2,0,0,9
513834,280082,2013-05-15,Assembly,"Do pass",12,5,0,0,17
513834,283928,2013-05-24,Assembly,"AB 1175 BOCANEGRA  Assembly Third Reading",52,19,0,7,78
513834,372480,2014-06-17,Senate,"Do pass, but re-refer to the Committee on Appropriations",4,0,1,0,5
513834,376578,2014-08-04,Senate,"Placed on Appropriations Suspense file",7,0,0,0,7
513834,377515,2014-08-14,Senate,"Do pass as amended",5,1,1,0,7
513834,378172,2014-08-21,Senate,"Assembly 3rd Reading AB1175 Bocanegra By Lieu",25,10,5,0,40
513834,378825,2014-08-27,Assembly,"Senate amendments be concurred in",3,2,0,2,7
513834,379015,2014-08-29,Assembly,"Set second hearing.  Failed passage.  Reconsideration granted",7,0,0,0,7
513834,379016,2014-08-29,Assembly,"Senate amendments be concurred in",4,2,0,1,7
513834,379017,2014-08-29,Assembly,"AB 1175 BOCANEGRA  Concurrence in Senate Amendments By BOCANEGRA",54,23,0,2,79
513835,267339,2013-04-16,Assembly,"Do pass as amended and be re-referred to the Committee on 	Appropriations",12,6,0,1,19
513836,271155,2013-04-23,Assembly,"Do pass and be re-referred to the Committee on Appropriations",12,0,0,1,13
513836,277643,2013-05-08,Assembly,"Do pass",16,1,0,0,17
513836,284079,2013-05-24,Assembly,"AB 1177 BOCANEGRA  Assembly Third Reading",71,1,0,6,78
513836,295485,2013-07-01,Senate,"Do pass, but re-refer to the Committee on Appropriations",10,0,0,0,10
513836,298086,2013-08-26,Senate,"Do pass",5,2,0,0,7
513836,299536,2013-09-11,Assembly,"AB 1177 BOCANEGRA  Concurrence in Senate Amendments",69,5,0,4,78
513836,299537,2013-09-11,Senate,"Assembly 3rd Reading AB1177 Bocanegra By Lieu",34,3,2,0,39
513837,275636,2013-05-01,Assembly,"Do pass and be re-referred to the Committee on Appropriations",4,2,0,1,7
513839,309020,2014-01-15,Assembly,"Do pass and be re-referred to the Committee on Appropriations",7,2,0,0,9
513839,311259,2014-01-23,Assembly,"Do pass",12,4,0,1,17
513839,312215,2014-01-27,Assembly,"AB 1179 BOCANEGRA  Assembly Third Reading",58,18,0,4,80
513839,370505,2014-06-10,Senate,"Do pass as amended, and re-refer to the Committee on Appropriations",8,1,0,0,9
513839,378336,2014-08-25,Senate,"Assembly 3rd Reading AB1179 Bocanegra By Pavley",30,3,7,0,40
513839,378589,2014-08-26,Assembly,"AB 1179 BOCANEGRA  Concurrence in Senate Amendments",79,0,0,0,79
513840,270901,2013-04-23,Assembly,"Do pass as amended and be re-referred to the Committee on 	Appropriations",18,0,0,1,19
513840,279666,2013-05-15,Assembly,"Do pass",16,1,0,0,17
513840,284024,2013-05-24,Assembly,"AB 1180 PAN  Third Reading Urgency",69,1,0,8,78
513840,296061,2013-07-03,Senate,"Do pass, but re-refer to the Committee on Appropriations Recommend 	Consent",9,0,0,0,9
513840,297338,2013-08-12,Senate,"Placed on Appropriations Suspense file",6,0,1,0,7
513840,298200,2013-08-30,Senate,"Do pass as amended",7,0,0,0,7
513840,299071,2013-09-09,Senate,"Assembly 3rd Reading AB1180 Pan Urgency Clause",39,0,0,0,39
513840,299294,2013-09-10,Assembly,"AB 1180 PAN  Concurrence in Senate Amendments",75,1,0,2,78
513841,277853,2013-05-08,Assembly,"Do pass",5,2,0,0,7
513841,280244,2013-05-16,Assembly,"AB 1181 GRAY  Assembly Third Reading  Amend By GRAY  Set #1",53,19,0,7,79
513841,283079,2013-05-23,Assembly,"AB 1181 GRAY  Assembly Third Reading",51,20,0,7,78
513841,291220,2013-06-24,Senate,"Do pass",3,2,0,0,5
513841,297734,2013-08-19,Senate,"Assembly 3rd Reading AB1181 Gray By Yee",26,11,2,0,39
513843,261991,2013-04-09,Assembly,"Do pass, to Consent Calendar",10,0,0,0,10
513843,265789,2013-04-15,Assembly,"AB 1183 JONES  Consent Calendar Second Day  Regular Session",77,0,0,2,79
513843,286952,2013-06-04,Senate,"Do pass and be placed on the Consent Calendar",6,0,1,0,7
513843,287797,2013-06-10,Senate,"Consent Calendar 2nd AB1183 Jones",32,0,7,0,39
513847,275649,2013-05-01,Assembly,"Do pass as amended and be re-referred to the Committee on 	Appropriations",7,0,0,0,7
513847,283831,2013-05-24,Assembly,"Do pass as amended",12,0,0,5,17
513847,285540,2013-05-30,Assembly,"AB 1186 BONILLA  Assembly Third Reading",61,15,0,3,79
513847,297658,2013-08-19,Senate,"Do pass, but re-refer to the Committee on Appropriations",10,0,0,0,10
513847,299454,2013-09-11,Senate,"Assembly 3rd Reading AB1186 Bonilla By Lieu",36,0,3,0,39
513847,299682,2013-09-12,Assembly,"Senate amendments be concurred in",5,0,0,2,7
513847,299683,2013-09-12,Assembly,"AB 1186 BONILLA  Concurrence- Urgency Added",75,0,0,3,78
513850,278278,2013-05-08,Assembly,"Do pass",6,2,0,1,9
513850,280418,2013-05-16,Assembly,"AB 1188 BRADFORD  Assembly Third Reading",45,24,0,10,79
513853,275631,2013-04-30,Assembly,"Do pass as amended and be re-referred to the Committee on 	Appropriations",5,1,0,1,7
513853,283901,2013-05-24,Assembly,"Do pass",17,0,0,0,17
513853,285109,2013-05-29,Assembly,"AB 1190 BLOOM  Assembly Third Reading",69,3,0,7,79
513853,291976,2013-06-26,Senate,"Do pass as amended, and re-refer to the Committee on 	Appropriations",4,2,3,0,9
513853,291977,2013-06-26,Senate,"Set, first hearing.  Failed passage in Committee.  Reconsideration 	granted",9,0,0,0,9
513853,372727,2014-06-18,Senate,"Do pass, but re-refer to the Committee on Appropriations",7,0,0,0,7
513853,377734,2014-08-18,Senate,"Assembly 3rd Reading AB1190 Bloom By Gaines",36,0,4,0,40
513853,377762,2014-08-19,Assembly,"AB 1190 BLOOM  Concurrence in Senate Amendments",76,0,0,3,79
513854,266398,2013-04-15,Assembly,"Do pass and be re-referred to the Committee on Transportation",9,0,0,0,9
513854,274130,2013-04-29,Assembly,"Do pass and re-refer to Committee on Appropriations with 	recommendation:  To Consent Calendar",16,0,0,0,16
513857,305927,2014-01-06,Assembly,"Be referred to Committee on Transportation",9,0,0,1,10
513857,308604,2014-01-13,Assembly,"Do pass and be re-referred to the Committee on Appropriations",11,3,0,2,16
513857,311222,2014-01-23,Assembly,"Do pass as amended",12,4,0,1,17
513857,313311,2014-01-29,Assembly,"AB 1193 TING  Assembly Third Reading",58,16,0,6,80
513857,374816,2014-06-26,Senate,"Do pass as amended, and re-refer to the Committee on 	Appropriations",10,0,1,0,11
513857,377091,2014-08-13,Senate,"Assembly 3rd Reading AB1193 Ting By Beall",31,3,6,0,40
513857,377092,2014-08-13,Senate,"Assembly 3rd Reading AB1193 Ting Reconsider",37,0,3,0,40
513857,378304,2014-08-25,Senate,"Assembly 3rd Reading AB1193 Ting By Beall",29,5,6,0,40
513857,378684,2014-08-27,Assembly,"Senate amendments be concurred in",11,5,0,0,16
513857,378852,2014-08-28,Assembly,"AB 1193 TING  Concurrence in Senate Amendments",60,18,0,1,79
513858,266512,2013-04-15,Assembly,"Do pass and be re-referred to the Committee on Appropriations",12,0,0,4,16
513858,283801,2013-05-24,Assembly,"Do pass as amended",13,0,0,4,17
513858,285524,2013-05-30,Assembly,"AB 1194 AMMIANO  Assembly Third Reading",76,2,0,1,79
513858,374448,2014-06-24,Senate,"Do pass as amended, and re-refer to the Committee on Appropriations",6,1,0,0,7
513858,376473,2014-08-04,Senate,"Placed on Appropriations Suspense file",7,0,0,0,7
513859,257408,2013-04-02,Assembly,"Do pass as amended and be re-referred to the Committee on 	Appropriations",9,0,0,1,10
513859,267326,2013-04-17,Assembly,"Do pass",16,0,0,1,17
513859,269920,2013-04-22,Assembly,"AB 1195 EGGMAN  Assembly Third Reading",73,0,0,6,79
513859,286857,2013-06-04,Senate,"Do pass, but re-refer to the Committee on Appropriations",6,1,0,0,7
513859,297672,2013-08-19,Senate,"Assembly 3rd Reading AB1195 Eggman By Lara",32,2,5,0,39
513859,297899,2013-08-22,Assembly,"AB 1195 EGGMAN  Concurrence in Senate Amendments",75,0,0,3,78
513863,308603,2014-01-14,Assembly,"Do pass and be re-referred to the Committee on Accountability and 	Administrative Review",6,3,0,1,10
513864,271645,2013-04-23,Assembly,"Do pass as amended and be re-referred to the Committee on 	Appropriations",10,1,0,2,13
513864,283876,2013-05-24,Assembly,"Do pass as amended",12,5,0,0,17
513864,285985,2013-05-31,Assembly,"AB 1199 FONG  Third Reading Urgency",53,22,0,4,79
513864,289041,2013-06-14,Assembly,"AB 1199 FONG  Motion to Reconsider",54,24,0,1,79
513864,289042,2013-06-14,Assembly,"AB 1199 FONG  Third Reading Urgency",55,22,0,2,79
513865,266201,2013-04-16,Assembly,"Do pass and be re-referred to the Committee on Environmental Safety 	and Toxic Materials to Consent Calendar",15,0,0,0,15
513865,275681,2013-04-30,Assembly,"Do pass as amended and re-refer to Committee on Appropriations 	with recommendation:  To Consent Calendar",7,0,0,0,7
513865,279882,2013-05-15,Assembly,"Do pass as amended",17,0,0,0,17
513865,283958,2013-05-24,Assembly,"AB 1200 LEVINE  Assembly Third Reading",72,0,0,6,78
513865,291946,2013-06-26,Senate,"Do pass as amended, and re-refer to the Committee on 	Appropriations",9,0,0,0,9
513865,297415,2013-08-12,Senate,"Do pass as amended",5,0,2,0,7
513865,298652,2013-09-03,Senate,"Assembly 3rd Reading AB1200 Levine By Gaines",36,0,3,0,39
513865,298818,2013-09-06,Assembly,"AB 1200 LEVINE  Concurrence in Senate Amendments",78,0,0,0,78
513867,272246,2013-04-24,Assembly,"Do pass and re-refer to Committee on Appropriations with 	recommendation:  To Consent Calendar",7,0,0,0,7
513867,283940,2013-05-24,Assembly,"Do pass as amended",17,0,0,0,17
513867,285612,2013-05-30,Assembly,"AB 1202 SKINNER  Assembly Third Reading",78,0,0,1,79
513867,292022,2013-06-26,Senate,"Do pass, but re-refer to the Committee on Appropriations",4,0,1,0,5
513867,297430,2013-08-12,Senate,"Do pass",6,0,1,0,7
513867,298004,2013-08-26,Senate,"Assembly 3rd Reading AB1202 Skinner By Monning",39,0,0,0,39
513875,267499,2013-04-16,Assembly,"Do pass as amended",17,2,0,0,19
513875,278858,2013-05-13,Assembly,"AB 1208 PAN  Assembly Third Reading",62,12,0,5,79
513875,291869,2013-06-26,Senate,"Do pass as amended",8,1,0,0,9
513875,299636,2013-09-12,Senate,"Do pass",5,1,1,0,7
513875,299637,2013-09-12,Senate,"Do pass, but re-refer to the Committee on Appropriations",6,2,1,0,9
513875,299638,2013-09-12,Senate,"Assembly 3rd Supp 3 AB1208 Pan By Leno",28,5,6,0,39
513875,299639,2013-09-12,Assembly,"AB 1208 PAN  Concurrence in Senate Amendments",51,26,0,1,78
513881,274078,2013-04-30,Assembly,"Do pass as amended and be re-referred to the Committee on 	Appropriations",9,5,0,1,15
513881,283784,2013-05-24,Assembly,"Do pass as amended",12,5,0,0,17
513881,285530,2013-05-30,Assembly,"AB 1213 BLOOM  Assembly Third Reading",51,24,0,4,79
513881,291592,2013-06-25,Senate,"Do pass, but re-refer to the Committee on Appropriations",6,2,1,0,9
513881,297231,2013-08-12,Senate,"Placed on Appropriations Suspense file",6,0,1,0,7
513881,298274,2013-08-30,Senate,"Do pass as amended",5,2,0,0,7
513881,298978,2013-09-09,Senate,"Assembly 3rd Reading AB1213 Bloom By Jackson",27,12,0,0,39
513881,299108,2013-09-10,Assembly,"AB 1213 BLOOM  Concurrence in Senate Amendments",48,25,0,5,78
513882,275719,2013-05-01,Assembly,"Do pass as amended and be re-referred to the Committee on 	Appropriations",5,0,0,2,7
513883,266572,2013-04-16,Assembly,"Do pass, to Consent Calendar",13,0,0,0,13
513883,274321,2013-04-30,Assembly,"Do pass",19,0,0,0,19
513883,276240,2013-05-06,Assembly,"AB 1215 HAGMAN  Assembly Third Reading",76,0,0,3,79
513883,289133,2013-06-17,Senate,"Do pass, but re-refer to the Committee on Health",10,0,0,0,10
513883,295982,2013-07-03,Senate,"Do pass and be placed on the Consent Calendar",9,0,0,0,9
513883,297528,2013-08-15,Senate,"Consent Calendar 2nd AB1215 Hagman",38,0,1,0,39
513885,274938,2013-04-30,Assembly,"Do pass as amended and be re-referred to the Committee on 	Appropriations",4,2,0,1,7
513885,283961,2013-05-24,Assembly,"Do pass",12,5,0,0,17
513885,285632,2013-05-30,Assembly,"AB 1217 LOWENTHAL  Assembly Third Reading",52,26,0,1,79
513885,291567,2013-06-25,Senate,"Do pass, but re-refer to the Committee on Appropriations",4,2,0,0,6
513885,297289,2013-08-12,Senate,"Placed on Appropriations Suspense file",6,0,1,0,7
513885,298277,2013-08-30,Senate,"Do pass as amended",5,2,0,0,7
513885,299444,2013-09-11,Senate,"From Committee:  Amendments returned with further amendements to 	Senate floor for consideration",4,2,0,0,6
513885,299680,2013-09-12,Assembly,"AB 1217 LOWENTHAL  Concurrence in Senate Amendments",52,25,0,1,78
513885,299681,2013-09-12,Senate,"Assembly 3rd Reading AB1217 Lowenthal By De Le",25,11,3,0,39
513887,275688,2013-05-01,Assembly,"Do pass and be re-referred to the Committee on Appropriations",12,1,0,0,13
513887,279725,2013-05-15,Assembly,"Do pass",17,0,0,0,17
513887,283918,2013-05-24,Assembly,"AB 1218 GRAY  Assembly Third Reading",72,0,0,6,78
513887,291718,2013-06-25,Senate,"Do pass, but re-refer to the Committee on Appropriations Recommend 	Consent",11,0,0,0,11
513887,297570,2013-08-15,Senate,"Consent Calendar 2nd AB1218 Gray",38,0,1,0,39
513889,274134,2013-04-29,Assembly,"Do pass as amended and be re-referred to the Committee on 	Appropriations",7,2,0,3,12
513889,279711,2013-05-15,Assembly,"Do pass as amended",12,0,0,5,17
513889,284680,2013-05-28,Assembly,"AB 1220 SKINNER  Assembly Third Reading",55,21,0,3,79
513889,289388,2013-06-18,Senate,"Do pass, but re-refer to the Committee on Appropriations",5,1,1,0,7
513889,299403,2013-09-11,Senate,"Assembly 3rd Reading AB1220 Skinner By Roth",32,6,1,0,39
513892,266562,2013-04-15,Assembly,"Do pass and be re-referred to the Committee on Appropriations",8,0,0,1,9
513892,274876,2013-05-01,Assembly,"Do pass, to Consent Calendar",17,0,0,0,17
513892,278073,2013-05-09,Assembly,"AB 1222 BLOOM  Consent Calendar Second Day  Regular Session",75,0,0,4,79
513892,298856,2013-09-06,Senate,"Do pass",6,1,0,0,7
513892,298857,2013-09-06,Senate,"Assembly 3rd Supp 1 AB1222 Bloom Urgency Clause",32,6,1,0,39
513892,299119,2013-09-10,Assembly,"Senate amendments be concurred in",6,0,0,1,7
513892,299409,2013-09-11,Assembly,"AB 1222 BLOOM  Concurrence- Urgency Added",74,3,0,1,78
513896,262695,2013-04-10,Assembly,"Do pass and be re-referred to the Committee on Appropriations",17,0,0,0,17
513896,274814,2013-05-01,Assembly,"Do pass, to Consent Calendar",17,0,0,0,17
513896,278123,2013-05-09,Assembly,"AB 1226 HALL  Consent Calendar Second Day  Regular Session",75,0,0,4,79
513896,291691,2013-06-25,Senate,"Do pass, but re-refer to the Committee on Appropriations",10,0,1,0,11
513896,298653,2013-09-03,Senate,"Assembly 3rd Reading AB1226 Hall Urgency Clause",37,0,2,0,39
513896,298819,2013-09-06,Assembly,"AB 1226 HALL  Concurrence- Urgency Added",78,0,0,0,78
513900,274671,2013-05-01,Assembly,"Do pass and be re-referred to the Committee on Local Government",5,2,0,0,7
513900,277945,2013-05-08,Assembly,"Do pass",6,1,0,2,9
513900,285579,2013-05-30,Assembly,"AB 1229 ATKINS  Assembly Third Reading",41,31,0,7,79
513900,295760,2013-07-02,Senate,"Do pass",6,5,0,0,11
513900,298602,2013-09-03,Senate,"Assembly 3rd Reading AB1229 Atkins By Hueso",21,16,2,0,39
513902,267383,2013-04-16,Assembly,"Do pass as amended and be re-referred to the Committee on Health",7,0,0,0,7
513902,274102,2013-04-30,Assembly,"Do pass as amended and be re-referred to the Committee on 	Appropriations",19,0,0,0,19
513902,279875,2013-05-15,Assembly,"Do pass, to Consent Calendar",17,0,0,0,17
513902,283302,2013-05-23,Assembly,"AB 1231 PEREZ, V.M.  Consent Calendar Second Day  Regular Session",74,0,0,4,78
513902,291670,2013-06-25,Senate,"Do pass as amended, and re-refer to the Committee on Health",6,0,0,0,6
513902,295965,2013-07-03,Senate,"Do pass, but re-refer to the Committee on Appropriations",9,0,0,0,9
513902,297721,2013-08-19,Senate,"Placed on Appropriations Suspense file",7,0,0,0,7
513902,298285,2013-08-30,Senate,"Do pass",7,0,0,0,7
513902,299081,2013-09-09,Senate,"Assembly 3rd Reading AB1231 V. Manuel P",39,0,0,0,39
513902,299308,2013-09-10,Assembly,"AB 1231 PEREZ, V.M.  Concurrence in Senate Amendments",78,0,0,0,78
513904,267968,2013-04-16,Assembly,"Do pass and be re-referred to the Committee on Appropriations",7,0,0,0,7
513904,274927,2013-05-01,Assembly,"Do pass",16,0,0,1,17
513904,278135,2013-05-09,Assembly,"AB 1232 PEREZ, V.M.  Assembly Third Reading",73,0,0,6,79
513904,288271,2013-06-11,Senate,"Do pass as amended, but re-refer to the Committee on Appropriations 	Recommend Consent",6,0,0,0,6
513904,295587,2013-07-01,Senate,"Consent Calendar 2nd AB1232 V. Manuel P",33,0,5,0,38
513904,296099,2013-07-03,Assembly,"AB 1232 PEREZ, V.M.  Concurrence in Senate Amendments",71,0,0,7,78
513904,298664,2013-09-03,Senate,"Assembly 3rd Reading AB1232 V. Manuel P",37,0,2,0,39
513904,298843,2013-09-06,Assembly,"AB 1232 PEREZ, V.M.  Concurrence in Senate Amendments",75,0,0,3,78
513905,267483,2013-04-16,Assembly,"Do pass as amended and be re-referred to the Committee on 	Appropriations",19,0,0,0,19
513905,279780,2013-05-15,Assembly,"Do pass",17,0,0,0,17
513905,284689,2013-05-28,Assembly,"AB 1233 CHESBRO  Third Reading Urgency",77,0,0,2,79
513905,291949,2013-06-26,Senate,"Do pass as amended, but re-refer to the Committee on 	Appropriations Recommend Consent",9,0,0,0,9
513905,297597,2013-08-15,Senate,"Consent Calendar 2nd AB1233 Chesbro",38,0,1,0,39
513905,297720,2013-08-19,Assembly,"AB 1233 CHESBRO  Concurrence in Senate Amendments",76,0,0,2,78
513906,305735,2014-01-06,Assembly,"Be referred to Committee on Insurance",9,0,0,1,10
513906,306345,2014-01-08,Assembly,"Do pass and be re-referred to the Committee on Judiciary",12,0,0,1,13
513906,308652,2014-01-14,Assembly,"Do pass as amended, to Consent Calendar",9,0,0,1,10
513906,311193,2014-01-23,Assembly,"AB 1234 LEVINE  Consent Calendar Second Day",72,0,0,8,80
513906,370914,2014-06-11,Senate,"Do pass, but re-refer to the Committee on Judiciary Recommend 	Consent",10,0,1,0,11
513906,374433,2014-06-24,Senate,"Do pass as amended",7,0,0,0,7
513906,377848,2014-08-19,Senate,"Assembly 3rd Reading AB1234 Levine By Monning",34,0,6,0,40
513906,378517,2014-08-26,Assembly,"AB 1234 LEVINE  Concurrence in Senate Amendments",79,0,0,0,79
513907,274871,2013-05-01,Assembly,"Do pass and be re-referred to the Committee on Appropriations",7,2,0,0,9
513907,283920,2013-05-24,Assembly,"Do pass as amended",12,5,0,0,17
513907,285503,2013-05-30,Assembly,"AB 1235 GORDON  Assembly Third Reading",56,19,0,4,79
513907,291905,2013-06-26,Senate,"Do pass as amended, and re-refer to the Committee on 	Appropriations",4,2,1,0,7
513907,297421,2013-08-12,Senate,"Placed on Appropriations Suspense file",6,0,1,0,7
513907,298380,2013-08-30,Senate,"Do pass",5,2,0,0,7
513907,299219,2013-09-10,Senate,"Assembly 3rd Reading AB1235 Gordon By Beall",24,10,5,0,39
513907,299354,2013-09-11,Assembly,"AB 1235 GORDON  Concurrence in Senate Amendments",55,21,0,2,78
513908,266643,2013-04-16,Assembly,"Do pass and be re-referred to the Committee on Insurance",11,0,0,2,13
513908,271565,2013-04-24,Assembly,"Do pass, to Consent Calendar",13,0,0,0,13
513908,275703,2013-05-02,Assembly,"AB 1236 HAGMAN  Consent Calendar Second Day",75,0,0,4,79
513908,287766,2013-06-10,Senate,"Do pass, but re-refer to the Committee on Insurance",10,0,0,0,10
513908,291895,2013-06-26,Senate,"Do pass and be placed on the Consent Calendar",9,0,0,0,9
513908,296189,2013-07-08,Senate,"Consent Calendar 2nd AB1236 Hagman",29,0,9,0,38
513911,266690,2013-04-16,Assembly,"Do pass as amended and re-refer to Committee on Appropriations 	with recommendation:  To Consent Calendar",7,0,0,0,7
513915,263110,2013-04-09,Assembly,"Do pass and be re-referred to the Committee on Appropriations",12,0,0,1,13
513915,283824,2013-05-24,Assembly,"Do pass as amended",13,0,0,4,17
513915,285552,2013-05-30,Assembly,"AB 1241 WEBER  Assembly Third Reading",66,9,0,4,79
513915,291854,2013-06-26,Senate,"Do pass as amended, and re-refer to the Committee on Appropriations",8,0,1,0,9
513915,297413,2013-08-12,Senate,"Placed on Appropriations Suspense file",6,0,1,0,7
513920,297176,2013-08-08,Assembly,"AB 1245 PEREZ, V.M.  Third Reading Urgency",73,0,0,5,78
513920,298675,2013-09-03,Senate,"Assembly 3rd Reading AB1245 V. Manuel P",37,0,2,0,39
513921,309849,2014-01-17,Assembly,"Do pass and be re-referred to the Committee on Appropriations",4,7,0,0,11
513923,271644,2013-04-23,Assembly,"Do pass and be re-referred to the Committee on Appropriations to 	Consent Calendar",9,0,0,0,9
513923,277651,2013-05-08,Assembly,"Do pass, to Consent Calendar",17,0,0,0,17
513923,280285,2013-05-16,Assembly,"AB 1247 MEDINA  Consent Calendar Second Day  Regular Session",70,0,0,9,79
513923,291594,2013-06-25,Senate,"Do pass, but re-refer to the Committee on Governance and Finance",11,0,0,0,11
513923,295994,2013-07-03,Senate,"Do pass as amended, but re-refer to the Committee on Appropriations 	Recommend Consent",7,0,0,0,7
513923,297551,2013-08-15,Senate,"Consent Calendar 2nd AB1247 Medina",38,0,1,0,39
513923,299574,2013-09-11,Senate,"Special Consent #10 AB1247 Medina Urgency Clause",39,0,0,0,39
513923,299595,2013-09-12,Assembly,"AB 1247 MEDINA  Concurrence- Urgency Added",78,0,0,0,78
513924,272688,2013-04-24,Assembly,"Do pass and be re-referred to the Committee on Appropriations",9,0,0,0,9
513924,283847,2013-05-24,Assembly,"Do pass as amended",17,0,0,0,17
513924,285659,2013-05-30,Assembly,"AB 1248 COOLEY  Assembly Third Reading",78,0,0,1,79
513924,291623,2013-06-25,Senate,"Do pass, but re-refer to the Committee on Appropriations Recommend 	Consent",11,0,0,0,11
513924,297527,2013-08-15,Senate,"Consent Calendar 2nd AB1248 Cooley",38,0,1,0,39
513925,309007,2014-01-14,Assembly,"Do pass and be re-referred to the Committee on Appropriations",5,0,0,1,6
513925,311130,2014-01-23,Assembly,"Do pass",13,3,0,1,17
513925,312223,2014-01-27,Assembly,"AB 1249 SALAS  Assembly Third Reading",58,17,0,5,80
513925,374537,2014-06-25,Senate,"Do pass as amended, and re-refer to the Committee on 	Appropriations",7,0,0,0,7
513925,376640,2014-08-04,Senate,"Placed on Appropriations Suspense file",7,0,0,0,7
513925,377426,2014-08-14,Senate,"Do pass",5,0,2,0,7
513925,378185,2014-08-21,Senate,"Assembly 3rd Reading AB1249 Salas",34,2,4,0,40
513925,378335,2014-08-25,Assembly,"AB 1249 SALAS  Concurrence in Senate Amendments",64,15,0,0,79
513926,261756,2013-04-09,Assembly,"Do pass as amended and be re-referred to the Committee on 	Appropriations",7,0,0,0,7
513926,272378,2013-04-25,Assembly,"AB 1250 PEREA  Assembly Third Reading",77,0,0,2,79
513926,286880,2013-06-04,Senate,"Do pass",7,0,0,0,7
513926,287743,2013-06-10,Senate,"Assembly 3rd Reading AB1250 Perea By Cannella",32,0,7,0,39
513928,275707,2013-04-30,Assembly,"Do pass and be re-referred to the Committee on Appropriations",7,0,0,0,7
513929,257419,2013-04-02,Assembly,"Do pass as amended and re-refer to Committee on Appropriations 	with recommendation:  To Consent Calendar",18,0,0,1,19
513929,267388,2013-04-17,Assembly,"Do pass, to Consent Calendar",17,0,0,0,17
513929,272288,2013-04-25,Assembly,"AB 1252 HEALTH  Consent Calendar Second Day  Regular Session",76,0,0,3,79
513929,291943,2013-06-26,Senate,"Do pass as amended, but re-refer to the Committee on 	Appropriations Recommend Consent",9,0,0,0,9
513929,298866,2013-09-06,Senate,"Assembly 3rd Reading AB1252 Committee on HEALTH (Pan) By Monning",39,0,0,0,39
513929,299067,2013-09-09,Assembly,"AB 1252 HEALTH  Concurrence in Senate Amendments By PAN",76,0,0,2,78
513930,278357,2013-05-08,Assembly,"Do pass",7,1,0,1,9
513930,280428,2013-05-16,Assembly,"AB 1253 BLUMENFIELD  Assembly Third Reading",57,15,0,7,79
513930,288209,2013-06-11,Senate,"Do pass as amended",11,0,0,0,11
513930,297794,2013-08-19,Senate,"Assembly 3rd Reading AB1253 Blumenfield By Lara",37,0,2,0,39
513930,298805,2013-09-06,Assembly,"AB 1253  Concurrence in Senate Amendments By NAZARIAN",55,21,0,2,78
513932,274147,2013-04-29,Assembly,"Do pass",12,0,0,0,12
513932,280380,2013-05-16,Assembly,"AB 1255 PAN  Assembly Third Reading",72,0,0,7,79
513932,296057,2013-07-03,Senate,"Do pass as amended",6,0,3,0,9
513932,298119,2013-08-26,Senate,"Assembly 3rd Reading AB1255 Pan By Wolk",39,0,0,0,39
513932,298464,2013-08-30,Assembly,"AB 1255 PAN  Concurrence in Senate Amendments",77,0,0,1,78
513934,308596,2014-01-14,Assembly,"Do pass and be re-referred to the Committee on Appropriations",8,1,0,1,10
513934,311215,2014-01-23,Assembly,"Do pass",12,4,0,1,17
513934,313265,2014-01-29,Assembly,"AB 1256 BLOOM  Assembly Third Reading",53,19,0,8,80
513934,373025,2014-06-17,Senate,"Do pass as amended, and re-refer to the Committee on 	Appropriations",5,1,1,0,7
513934,376498,2014-08-04,Senate,"Placed on Appropriations Suspense file",7,0,0,0,7
513934,377569,2014-08-14,Senate,"Do pass",5,1,1,0,7
513934,378712,2014-08-27,Senate,"Assembly 3rd Reading AB1256 Bloom By Evans",24,11,5,0,40
513934,378913,2014-08-28,Assembly,"AB 1256 BLOOM  Concurrence in Senate Amendments",58,19,0,2,79
513935,274112,2013-04-29,Assembly,"Do pass as amended and be re-referred to the Committee on 	Appropriations",9,0,0,0,9
513935,283853,2013-05-24,Assembly,"Do pass",17,0,0,0,17
513935,285030,2013-05-29,Assembly,"AB 1257 BOCANEGRA  Assembly Third Reading",77,0,0,2,79
513935,295817,2013-07-02,Senate,"Do pass, but re-refer to the Committee on Appropriations",8,0,3,0,11
513935,297272,2013-08-12,Senate,"Placed on Appropriations Suspense file",6,0,1,0,7
513935,298279,2013-08-30,Senate,"Do pass",7,0,0,0,7
513935,299423,2013-09-11,Senate,"Assembly 2nd Reading AB1257 Bocanegra By Padilla",37,2,0,0,39
513935,299663,2013-09-12,Assembly,"AB 1257 BOCANEGRA  Concurrence in Senate Amendments",75,0,0,3,78
513936,265189,2013-04-15,Assembly,"Do pass as amended and be re-referred to the Committee on 	Appropriations",15,0,0,0,15
513937,266583,2013-04-16,Assembly,"Do pass and be re-referred to the Committee on Local Government to 	Consent Calendar",15,0,0,0,15
513937,272339,2013-04-24,Assembly,"Do pass, to Consent Calendar",9,0,0,0,9
513937,275671,2013-05-02,Assembly,"AB 1259 OLSEN  Consent Calendar Second Day  Regular Session",75,0,0,4,79
513937,291645,2013-06-25,Senate,"Do pass and be placed on the Consent Calendar",9,0,0,0,9
513937,291646,2013-06-25,Senate,"Do pass, but re-refer to the Committee on Governance and Finance 	Recommend Consent",9,0,0,0,9
513937,296090,2013-07-03,Senate,"Do pass and be placed on the Consent Calendar",7,0,0,0,7
513937,297795,2013-08-19,Senate,"Assembly 3rd Reading AB1259 Olsen By Berryhill",37,0,2,0,39
513938,308693,2014-01-14,Assembly,"Do pass as amended",12,0,0,2,14
513938,314013,2014-01-30,Assembly,"AB 1260 MEDINA  Assembly Third Reading",76,0,0,4,80
513938,371780,2014-06-16,Senate,"Do pass as amended",9,0,0,0,9
513938,376965,2014-08-11,Senate,"Assembly 3rd Reading AB1260 Medina By Lieu",34,0,6,0,40
513938,377674,2014-08-18,Assembly,"AB 1260 MEDINA  Concurrence in Senate Amendments",74,0,0,5,79
513940,275845,2013-05-01,Assembly,"Do pass as amended and be re-referred to the Committee on 	Appropriations",5,0,0,2,7
513940,279719,2013-05-15,Assembly,"Do pass, to Consent Calendar",17,0,0,0,17
513940,283298,2013-05-23,Assembly,"AB 1261 GORELL  Consent Calendar Second Day  Regular Session",74,0,0,4,78
513942,257474,2013-04-02,Assembly,"Do pass and be re-referred to the Committee on Public Employees, 	Retirement and Social Security",13,5,0,1,19
513942,262746,2013-04-10,Assembly,"Do pass as amended and be re-referred to the Committee on 	Appropriations",5,2,0,0,7
513942,283858,2013-05-24,Assembly,"Do pass",12,5,0,0,17
513942,284990,2013-05-29,Assembly,"AB 1263 PEREZ, J.  Assembly Third Reading",55,23,0,1,79
513942,291216,2013-06-24,Senate,"Do pass, but re-refer to the Committee on Health",3,2,0,0,5
513942,296029,2013-07-03,Senate,"Do pass as amended, and re-refer to the Committee on 	Appropriations",7,2,0,0,9
513942,297375,2013-08-12,Senate,"Placed on Appropriations Suspense file",6,0,1,0,7
513942,298254,2013-08-30,Senate,"Do pass",5,2,0,0,7
513942,299571,2013-09-11,Assembly,"AB 1263 PEREZ, J.  Concurrence in Senate Amendments",53,24,0,1,78
513942,299572,2013-09-11,Senate,"Assembly 3rd Reading AB1263 John A. P",25,9,5,0,39
513943,309022,2014-01-15,Assembly,"Do pass and re-refer to Committee on Appropriations with 	recommendation:  To Consent Calendar",7,0,0,0,7
513943,311151,2014-01-23,Assembly,"Do pass",16,0,0,1,17
513943,312228,2014-01-27,Assembly,"AB 1264 CONWAY  Assembly Third Reading",77,0,0,3,80
513944,266659,2013-04-16,Assembly,"Do pass and be re-referred to the Committee on Health",3,6,0,1,10
513944,266660,2013-04-16,Assembly,"Set first hearing.  Failed passage.  Reconsideration granted",10,0,0,0,10
513944,308682,2014-01-14,Assembly,"Do pass and be re-referred to the Committee on Health",2,6,0,2,10
513946,268659,2013-04-17,Assembly,"Do pass as amended",5,2,0,0,7
513946,277971,2013-05-09,Assembly,"AB 1266 AMMIANO  Assembly Third Reading",46,25,0,8,79
513946,288398,2013-06-12,Senate,"Do pass",5,2,2,0,9
513946,295971,2013-07-03,Senate,"Assembly 3rd Reading AB1266 Ammiano By Leno",21,9,8,0,38
513947,275513,2013-05-02,Assembly,"AB 1267 HALL  Third Reading Urgency",69,0,0,10,79
513947,280286,2013-05-16,Senate,"Assembly 3rd Reading AB1267 Hall Urgency Clause",37,0,1,0,38
513948,272404,2013-04-24,Assembly,"Do pass and be re-referred to the Committee on Veterans Affairs",7,0,0,0,7
513948,274810,2013-04-30,Assembly,"Do pass and be re-referred to the Committee on Appropriations",8,0,0,2,10
513948,283973,2013-05-24,Assembly,"Do pass",13,0,0,4,17
513948,285245,2013-05-29,Assembly,"AB 1268 PEREZ, J.  Assembly Third Reading",77,1,0,1,79
513948,291868,2013-06-26,Senate,"Do pass, but re-refer to the Committee on Appropriations",4,0,1,0,5
513948,297368,2013-08-12,Senate,"Placed on Appropriations Suspense file",6,0,1,0,7
513948,298343,2013-08-30,Senate,"Do pass",7,0,0,0,7
513950,270252,2013-04-22,Assembly,"Do pass and be re-referred to the Committee on Appropriations",14,1,0,1,16
513952,305750,2014-01-06,Assembly,"Be referred to Committee on Higher Education",9,0,0,1,10
513952,308621,2014-01-14,Assembly,"Do pass and be re-referred to the Committee on Appropriations",12,1,0,0,13
513952,311121,2014-01-23,Assembly,"Do pass as amended",16,0,0,1,17
513952,313259,2014-01-29,Assembly,"AB 1271 BONTA  Assembly Third Reading",76,1,0,3,80
513952,374332,2014-06-25,Senate,"Do pass as amended, and re-refer to the Committee on Appropriations",6,0,1,0,7
513952,376931,2014-08-11,Senate,"Placed on Appropriations Suspense file",7,0,0,0,7
513952,377353,2014-08-14,Senate,"Do pass as amended",5,0,2,0,7
513952,378142,2014-08-21,Senate,"Assembly 3rd Reading AB1271 Bonta By Lara",35,0,5,0,40
513952,378456,2014-08-26,Assembly,"Senate amendments be concurred in",5,0,0,2,7
513952,378678,2014-08-27,Assembly,"AB 1271 BONTA  Concurrence in Senate Amendments",78,0,0,1,79
513953,261817,2013-04-09,Assembly,"Do pass and be re-referred to the Committee on Appropriations",8,0,0,1,9
513954,266642,2013-04-15,Assembly,"Do pass as amended and be re-referred to the Committee on Local 	Government",7,2,0,0,9
513954,274924,2013-05-01,Assembly,"Do pass and be re-referred to the Committee on Appropriations",9,0,0,0,9
513954,283997,2013-05-24,Assembly,"Do pass",15,1,0,1,17
513954,285665,2013-05-30,Assembly,"AB 1273 TING  Assembly Third Reading",59,10,0,10,79
513954,291578,2013-06-25,Senate,"Do pass as amended, and re-refer to the Committee on Governance and 	Finance",7,0,2,0,9
513954,298091,2013-08-26,Senate,"Do pass as amended, and re-refer to the Committee on Rules",7,0,0,0,7
513954,298851,2013-09-06,Senate,"Assembly 3rd Reading AB1273 Ting By Leno",22,6,11,0,39
513954,299231,2013-09-10,Assembly,"AB 1273 TING  Concurrence in Senate Amendments",57,9,0,12,78
513955,272495,2013-04-25,Assembly,"Be referred to Committee on Judiciary",8,0,0,3,11
513955,276908,2013-05-07,Assembly,"Do pass",10,0,0,0,10
513955,278233,2013-05-09,Assembly,"AB 1274 BRADFORD  Assembly Third Reading",75,0,0,4,79
513955,289359,2013-06-18,Senate,"Do pass as amended, and re-refer to the Committee on Judiciary",8,0,3,0,11
513955,296028,2013-07-02,Senate,"Do pass as amended",6,0,1,0,7
513955,298613,2013-09-03,Senate,"Assembly 3rd Reading AB1274 Bradford By Monning",37,0,2,0,39
513955,298889,2013-09-06,Assembly,"AB 1274 BRADFORD  Concurrence in Senate Amendments",78,0,0,0,78
513956,277215,2013-05-07,Assembly,"Do pass",10,0,0,0,10
513956,278162,2013-05-09,Assembly,"AB 1275 CHAU  Assembly Third Reading",75,0,0,4,79
513956,288148,2013-06-11,Senate,"Do pass",7,0,0,0,7
513956,296254,2013-07-08,Senate,"Assembly 3rd Reading AB1275 Chau By Evans",33,0,5,0,38
513958,275286,2013-04-30,Assembly,"Do pass and be re-referred to the Committee on Appropriations",5,2,0,0,7
513958,283870,2013-05-24,Assembly,"Do pass as amended",12,5,0,0,17
513958,285678,2013-05-30,Assembly,"AB 1276 BLOOM  Assembly Third Reading",47,27,0,5,79
513958,370584,2014-06-10,Senate,"Do pass, but re-refer to the Committee on Appropriations",4,2,1,0,7
513958,373929,2014-06-23,Senate,"Placed on Appropriations Suspense file",7,0,0,0,7
513958,377176,2014-08-14,Senate,"Do pass as amended",5,1,1,0,7
513958,377915,2014-08-20,Senate,"Assembly 3rd Reading AB1276 Bloom By Lara",22,10,8,0,40
513958,378502,2014-08-26,Assembly,"Senate amendments be concurred in",6,1,0,0,7
513958,378828,2014-08-27,Assembly,"AB 1276 BLOOM  Concurrence in Senate Amendments",59,16,0,4,79
513959,272448,2013-04-24,Assembly,"Do pass and be re-referred to the Committee on Appropriations",5,2,0,0,7
513961,268991,2013-04-17,Assembly,"Do pass and be re-referred to the Committee on Appropriations",2,5,0,0,7
513961,268992,2013-04-17,Assembly,"Set first hearing.  Failed passage.  Reconsideration granted",7,0,0,0,7
513961,309003,2014-01-15,Assembly,"Do pass and be re-referred to the Committee on Appropriations",2,5,0,0,7
513962,274859,2013-04-30,Assembly,"Do pass and be re-referred to the Committee on Appropriations",5,0,0,2,7
513962,279896,2013-05-15,Assembly,"Do pass, to Consent Calendar",17,0,0,0,17
513962,283314,2013-05-23,Assembly,"AB 1280 PEREZ, J.  Consent Calendar Second Day  Regular Session",74,0,0,4,78
513962,288078,2013-06-11,Senate,"Do pass as amended, but re-refer to the Committee on Appropriations 	Recommend Consent",6,0,0,0,6
513962,297555,2013-08-15,Senate,"Consent Calendar 2nd AB1280 John A. P",38,0,1,0,39
513962,297958,2013-08-22,Senate,"Assembly 3rd Reading AB1280 John A. P",37,0,2,0,39
513962,298105,2013-08-26,Assembly,"AB 1280 PEREZ, J.  Concurrence in Senate Amendments",78,0,0,0,78
513965,270692,2013-04-22,Assembly,"Do pass and be re-referred to the Committee on Appropriations",11,0,0,1,12
513965,274782,2013-05-01,Assembly,"Do pass, to Consent Calendar",17,0,0,0,17
513965,278252,2013-05-09,Assembly,"AB 1282 BONTA  Consent Calendar Second Day  Regular Session",75,0,0,4,79
513965,287180,2013-06-05,Senate,"Do pass, but re-refer to the Committee on Appropriations",8,0,1,0,9
513965,291389,2013-06-24,Senate,"Do pass",7,0,0,0,7
513965,296242,2013-07-08,Senate,"Assembly 3rd Reading AB1282 Bonta By Correa",33,0,5,0,38
513969,262655,2013-04-09,Assembly,"Do pass and be re-referred to the Committee on Appropriations",10,3,0,0,13
513969,283834,2013-05-24,Assembly,"Do pass as amended",12,0,0,5,17
513969,285670,2013-05-30,Assembly,"AB 1285 FONG  Assembly Third Reading",55,21,0,3,79
513969,372705,2014-06-18,Senate,"Do pass as amended, and re-refer to the Committee on Appropriations",6,1,0,0,7
513969,376427,2014-08-04,Senate,"Placed on Appropriations Suspense file",7,0,0,0,7
513970,276323,2013-05-06,Assembly,"Do pass as amended",8,0,0,1,9
513970,280243,2013-05-16,Assembly,"AB 1286 SKINNER  Assembly Third Reading",72,1,0,6,79
513970,291922,2013-06-26,Senate,"Do pass",7,0,0,0,7
513970,297805,2013-08-19,Senate,"Assembly 3rd Reading AB1286 Skinner By Jackson",35,1,3,0,39
513971,262629,2013-04-09,Assembly,"Do pass and be re-referred to the Committee on Appropriations",12,0,0,1,13
513971,283778,2013-05-24,Assembly,"Do pass",17,0,0,0,17
513971,285593,2013-05-30,Assembly,"AB 1287 QUIRK-SILVA  Assembly Third Reading",78,0,0,1,79
513971,291916,2013-06-26,Senate,"Do pass as amended, and re-refer to the Committee on Appropriations",9,0,0,0,9
513971,297317,2013-08-12,Senate,"Placed on Appropriations Suspense file",6,0,1,0,7
513971,298318,2013-08-30,Senate,"Do pass",7,0,0,0,7
513971,298926,2013-09-09,Senate,"Assembly 3rd Reading AB1287 Quirk-Silva By Correa",39,0,0,0,39
513971,299145,2013-09-10,Assembly,"AB 1287 QUIRK-SILVA  Concurrence in Senate Amendments",77,0,0,1,78
513972,265341,2013-04-15,Assembly,"Be referred to Committee on Business, Professions and Consumer 	Protection",11,0,0,0,11
513972,274126,2013-04-30,Assembly,"Do pass and be re-referred to the Committee on Appropriations",12,1,0,0,13
513972,279865,2013-05-15,Assembly,"Do pass",16,1,0,0,17
513972,283995,2013-05-24,Assembly,"AB 1288 PEREZ, V.M.  Assembly Third Reading",67,4,0,7,78
513972,289146,2013-06-17,Senate,"Do pass, but re-refer to the Committee on Appropriations",10,0,0,0,10
513972,296218,2013-07-08,Senate,"Assembly 3rd Reading AB1288 V. Manuel P",32,0,6,0,38
513972,297900,2013-08-22,Assembly,"AB 1288 PEREZ, V.M.  Concurrence in Senate Amendments",74,2,0,2,78
513973,277461,2013-05-08,Assembly,"Do pass as amended",16,0,0,1,17
513973,281392,2013-05-20,Assembly,"AB 1289 COOLEY  Assembly Third Reading",74,0,0,4,78
513973,288114,2013-06-11,Senate,"Do pass",10,0,1,0,11
513973,297604,2013-08-15,Senate,"Assembly 3rd Reading AB1289 Cooley By Anderson",38,0,1,0,39
513975,274161,2013-04-29,Assembly,"Do pass and be re-referred to the Committee on Appropriations",11,4,0,1,16
513975,283985,2013-05-24,Assembly,"Do pass",12,5,0,0,17
513975,285260,2013-05-29,Assembly,"AB 1290 PEREZ, J.  Assembly Third Reading",53,25,0,1,79
513975,296328,2013-07-09,Senate,"Do pass, but re-refer to the Committee on Appropriations",7,3,1,0,11
513975,297727,2013-08-19,Senate,"Placed on Appropriations Suspense file",7,0,0,0,7
513975,298377,2013-08-30,Senate,"Do pass as amended",5,2,0,0,7
513975,299080,2013-09-09,Senate,"Assembly 3rd Reading AB1290 John A. P",27,12,0,0,39
513975,299286,2013-09-10,Assembly,"AB 1290 PEREZ, J.  Concurrence in Senate Amendments",54,24,0,0,78
513979,274101,2013-04-30,Assembly,"Do pass",6,3,0,1,10
513979,285581,2013-05-30,Assembly,"AB 1293 BLOOM  Assembly Third Reading",46,30,0,3,79
513979,291568,2013-06-25,Senate,"Do pass as amended",5,2,0,0,7
513979,298572,2013-09-03,Senate,"Assembly 3rd Reading AB1293 Bloom By Lieu",24,13,2,0,39
513979,298962,2013-09-09,Assembly,"AB 1293 BLOOM  Concurrence in Senate Amendments",46,32,0,0,78
513982,265151,2013-04-15,Assembly,"Do pass as amended and be re-referred to the Committee on 	Appropriations",14,0,0,1,15
513982,283765,2013-05-24,Assembly,"Do pass as amended",17,0,0,0,17
513982,285570,2013-05-30,Assembly,"AB 1295 HERNANDEZ  Assembly Third Reading",72,3,0,4,79
513983,270674,2013-04-23,Assembly,"Do pass and be re-referred to the Committee on Appropriations",7,0,0,0,7
513984,267361,2013-04-16,Assembly,"Do pass and re-refer to Committee on Appropriations with 	recommendation:  To Consent Calendar",19,0,0,0,19
513984,275432,2013-05-01,Assembly,"Do pass, to Consent Calendar",17,0,0,0,17
513984,277967,2013-05-09,Assembly,"AB 1297 PEREZ, J.  Consent Calendar Second Day  Regular Session",75,0,0,4,79
513984,288504,2013-06-12,Senate,"Do pass, but re-refer to the Committee on Appropriations",9,0,0,0,9
513984,297954,2013-08-22,Senate,"Assembly 3rd Reading AB1297 John A. P",37,0,2,0,39
513984,298100,2013-08-26,Assembly,"AB 1297 PEREZ, J.  Concurrence in Senate Amendments",78,0,0,0,78
513986,274178,2013-04-29,Assembly,"Do pass and be re-referred to the Committee on Appropriations",13,1,0,1,15
513986,284089,2013-05-24,Assembly,"Do pass",13,4,0,0,17
513986,285256,2013-05-29,Assembly,"AB 1299 BRADFORD  Assembly Third Reading",58,17,0,4,79
513986,295883,2013-07-02,Senate,"Do pass as amended, and re-refer to the Committee on Appropriations",8,2,1,0,11
513986,297428,2013-08-12,Senate,"Placed on Appropriations Suspense file",6,0,1,0,7
513986,298357,2013-08-30,Senate,"Do pass as amended",5,2,0,0,7
513986,299506,2013-09-11,Senate,"Assembly 3rd Reading AB1299 Bradford By Torres",26,11,2,0,39
513986,299702,2013-09-12,Assembly,"AB 1299 BRADFORD  Concurrence in Senate Amendments",55,18,0,5,78
513988,271258,2013-04-22,Assembly,"Do pass and be re-referred to the Committee on Judiciary",0,8,0,4,12
513988,271259,2013-04-22,Assembly,"Set second hearing.  Failed passage.  Reconsideration granted",12,0,0,0,12
513989,274083,2013-04-29,Assembly,"Do pass and be re-referred to the Committee on Appropriations",5,3,0,1,9
513990,274127,2013-04-29,Assembly,"Do pass and be re-referred to the Committee on Appropriations",3,6,0,0,9
513991,262915,2013-04-10,Assembly,"Do pass and re-refer to Committee on Appropriations with 	recommendation:  To Consent Calendar",16,0,0,1,17
513991,274975,2013-05-01,Assembly,"Do pass, to Consent Calendar",17,0,0,0,17
513991,277989,2013-05-09,Assembly,"AB 1303 HALL  Consent Calendar Second Day  Regular Session",75,0,0,4,79
513991,288190,2013-06-11,Senate,"Do pass, but re-refer to the Committee on Appropriations Recommend 	Consent",11,0,0,0,11
513991,334060,2014-03-04,Senate,"Do pass, but re-refer to the Committee on Appropriations",8,0,2,0,10
513991,336502,2014-03-06,Senate,"Assembly 3rd Reading AB1303 Hall Urgency Clause",32,0,7,0,39
513991,341997,2014-03-13,Assembly,"Senate amendments be concurred in",16,0,0,3,19
513991,344023,2014-03-17,Assembly,"AB 1303 HALL  Concurrence in Senate Amendments",72,0,0,8,80
513997,270836,2013-04-23,Assembly,"Do pass and be re-referred to the Committee on Appropriations",11,0,0,2,13
513997,277352,2013-05-08,Assembly,"Do pass",17,0,0,0,17
513997,280422,2013-05-16,Assembly,"AB 1308 BONILLA  Assembly Third Reading",72,0,0,7,79
513997,295358,2013-07-01,Senate,"Do pass as amended, and re-refer to the Committee on Appropriations",10,0,0,0,10
513997,299164,2013-09-10,Senate,"From committee:  That the Assembly Amendments be concurred in",10,0,0,0,10
513997,299351,2013-09-11,Senate,"Assembly 3rd Reading AB1308 Bonilla By Corbett",39,0,0,0,39
513997,299603,2013-09-12,Assembly,"Senate amendments be concurred in",13,0,0,1,14
513997,299604,2013-09-12,Assembly,"AB 1308 BONILLA  Concurrence in Senate Amendments",75,0,0,3,78
513998,271528,2013-04-24,Assembly,"Do pass as amended",11,0,0,2,13
513998,275604,2013-05-02,Assembly,"AB 1309 PEREA  Assembly Third Reading",61,4,0,14,79
513998,296380,2013-07-10,Senate,"Do pass as amended, and re-refer to the Committee on Rules",5,0,0,0,5
513998,298752,2013-09-06,Senate,"Assembly 3rd Reading AB1309 Perea By Hill",34,2,3,0,39
513998,298946,2013-09-09,Assembly,"AB 1309 PEREA  Concurrence in Senate Amendments",66,3,0,9,78
514000,271192,2013-04-23,Assembly,"Do pass and be re-referred to the Committee on Appropriations",19,0,0,0,19
514000,284076,2013-05-24,Assembly,"Do pass as amended",17,0,0,0,17
514000,285533,2013-05-30,Assembly,"AB 1310 BROWN  Assembly Third Reading",78,0,0,1,79
514000,296162,2013-07-03,Senate,"Do pass, but re-refer to the Committee on Appropriations Recommend 	Consent",9,0,0,0,9
514000,297320,2013-08-12,Senate,"Placed on Appropriations Suspense file",6,0,1,0,7
514000,374744,2014-06-25,Senate,"Do pass as amended, and re-refer to the Committee on 	Appropriations",8,0,1,0,9
514000,376580,2014-08-04,Senate,"Placed on Appropriations Suspense file",7,0,0,0,7
514000,377473,2014-08-14,Senate,"Do pass",5,0,2,0,7
514000,378503,2014-08-26,Senate,"Assembly 3rd Reading AB1310 Bonta By Hernandez",36,0,4,0,40
514000,379123,2014-08-29,Assembly,"Senate amendments be concurred in",9,8,0,2,19
514000,379124,2014-08-29,Assembly,"Set first hearing.  Failed passage.  Reconsideration granted",18,0,0,1,19
514001,276870,2013-05-07,Assembly,"Do pass",5,1,0,1,7
514001,278637,2013-05-13,Assembly,"AB 1311 BRADFORD  Assembly Third Reading",57,14,0,8,79
514001,296174,2013-07-02,Senate,"Do pass",5,0,0,0,5
514001,377963,2014-08-20,Senate,"From Committee:  That the measure be returned to the Senate floor 	for consideration",3,0,2,0,5
514001,378113,2014-08-21,Senate,"Assembly 3rd Reading AB1311 Bradford By Padilla",34,2,4,0,40
514001,378773,2014-08-27,Assembly,"Senate amendments be concurred in",5,1,0,1,7
514001,378935,2014-08-28,Assembly,"AB 1311 BRADFORD  Concurrence in Senate Amendments",63,12,0,4,79
514003,308745,2014-01-14,Assembly,"Do pass",2,7,0,1,10
514006,278268,2013-05-08,Assembly,"Do pass, to Consent Calendar",7,0,0,0,7
514006,280321,2013-05-16,Assembly,"AB 1315 PEREZ, J.  Consent Calendar Second Day  Regular Session",70,0,0,9,79
514006,291988,2013-06-26,Senate,"Do pass as amended",4,0,1,0,5
514006,299016,2013-09-09,Senate,"Assembly 3rd Reading AB1315 John A. P",30,8,1,0,39
514007,262352,2013-04-09,Assembly,"Do pass as amended and re-refer to Committee on Appropriations 	with recommendation:  To Consent Calendar",7,0,0,0,7
514007,274968,2013-05-01,Assembly,"Do pass, to Consent Calendar",17,0,0,0,17
514007,278165,2013-05-09,Assembly,"AB 1316 HARKEY  Consent Calendar Second Day  Regular Session",75,0,0,4,79
514007,286922,2013-06-04,Senate,"Do pass, but re-refer to the Committee on Appropriations Recommend 	Consent",4,0,1,0,5
514007,295599,2013-07-01,Senate,"Consent Calendar 2nd AB1316 Harkey",33,0,5,0,38
514008,258446,2013-04-03,Assembly,"Do pass and be re-referred to the Committee on Appropriations",13,0,0,0,13
514008,267348,2013-04-17,Assembly,"Do pass, to Consent Calendar",17,0,0,0,17
514008,272312,2013-04-25,Assembly,"AB 1317 FRAZIER  Consent Calendar Second Day  Regular Session",76,0,0,3,79
514008,288022,2013-06-11,Senate,"Do pass, but re-refer to the Committee on Appropriations Recommend 	Consent",11,0,0,0,11
514008,299420,2013-09-11,Assembly,"AB 1317 FRAZIER  Concurrence in Senate Amendments",78,0,0,0,78
514008,299421,2013-09-11,Senate,"Assembly 3rd Reading AB1317 Frazier Lay on Table",24,11,4,0,39
514008,299422,2013-09-11,Senate,"Assembly 3rd Reading AB1317 Frazier Urgency Clause",36,1,2,0,39
514009,262687,2013-04-09,Assembly,"Do pass as amended and be re-referred to the Committee on 	Appropriations",13,0,0,0,13
514009,283914,2013-05-24,Assembly,"Do pass as amended",17,0,0,0,17
514009,285267,2013-05-29,Assembly,"AB 1318 BONILLA  Assembly Third Reading  Amend By HAGMAN  Set #1 	Motion to  Lay on the Table  By ATKINS",50,24,0,5,79
514009,285268,2013-05-29,Assembly,"AB 1318 BONILLA  Assembly Third Reading",77,0,0,2,79
514009,372739,2014-06-18,Senate,"Do pass as amended, and re-refer to the Committee on Appropriations",7,0,0,0,7
514009,376551,2014-08-04,Senate,"Placed on Appropriations Suspense file",7,0,0,0,7
514009,377130,2014-08-14,Senate,"Do pass",6,0,1,0,7
514011,275761,2013-05-01,Assembly,"Do pass and re-refer to Committee on Appropriations with 	recommendation:  To Consent Calendar",7,0,0,0,7
514011,280015,2013-05-15,Assembly,"Do pass, to Consent Calendar",17,0,0,0,17
514011,283316,2013-05-23,Assembly,"AB 1319 EGGMAN  Consent Calendar Second Day  Regular Session",74,0,0,4,78
514011,295846,2013-07-02,Senate,"Do pass, but re-refer to the Committee on Appropriations",4,0,1,0,5
514011,299540,2013-09-11,Senate,"Assembly 3rd Reading AB1319 Eggman By Galgiani",39,0,0,0,39
514011,299784,2013-09-12,Assembly,"AB 1319 EGGMAN  Concurrence in Senate Amendments",78,0,0,0,78
514012,267492,2013-04-17,Assembly,"Do pass and be re-referred to the Committee on Local Government",7,0,0,0,7
514013,261731,2013-04-09,Assembly,"Reconsideration granted",6,0,0,1,7
514013,308656,2014-01-14,Assembly,"Do pass and be re-referred to the Committee on Appropriations",2,5,0,0,7
514014,274181,2013-04-29,Assembly,"Do pass as amended and be re-referred to the Committee on 	Appropriations",8,0,0,1,9
514015,274165,2013-04-29,Assembly,"Do pass as amended and be re-referred to the Committee on 	Appropriations",5,3,0,1,9
514015,283798,2013-05-24,Assembly,"Do pass as amended",12,5,0,0,17
514015,285498,2013-05-30,Assembly,"AB 1323 MITCHELL  Assembly Third Reading",24,37,0,18,79
514017,266567,2013-04-15,Assembly,"Do pass and be re-referred to the Committee on Local Government",10,5,0,1,16
514017,272337,2013-04-24,Assembly,"Do pass and be re-referred to the Committee on Appropriations",6,2,0,1,9
514017,277361,2013-05-08,Assembly,"Do pass",12,5,0,0,17
514017,280238,2013-05-16,Assembly,"AB 1324 SKINNER  Assembly Third Reading",46,24,0,9,79
514017,372831,2014-06-18,Senate,"Do pass",5,2,0,0,7
514017,378117,2014-08-21,Senate,"Assembly 3rd Reading AB1324 Skinner By Hancock",22,12,6,0,40
514017,378800,2014-08-27,Assembly,"Senate amendments be concurred in",5,2,0,2,9
514017,378940,2014-08-28,Assembly,"AB 1324 SKINNER  Concurrence in Senate Amendments",49,28,0,2,79
514018,274797,2013-04-30,Assembly,"Do pass, to Consent Calendar",7,0,0,0,7
514018,278058,2013-05-09,Assembly,"AB 1325 PEREZ, J.  Consent Calendar Second Day",75,0,0,4,79
514018,288137,2013-06-11,Senate,"Do pass",7,0,0,0,7
514018,298886,2013-09-06,Senate,"Assembly 3rd Reading AB1325 John A. P",38,0,1,0,39
514019,278802,2013-05-13,Assembly,"Do pass and be re-referred to the Committee on Appropriations",7,2,0,0,9
514020,270803,2013-04-23,Assembly,"Do pass as amended and be re-referred to the Committee on Local 	Government",4,2,0,1,7
514020,274768,2013-05-01,Assembly,"Do pass and be re-referred to the Committee on Appropriations",8,0,0,1,9
514020,311178,2014-01-23,Assembly,"Do pass as amended",16,0,0,1,17
514020,313224,2014-01-29,Assembly,"AB 1327 GORELL  Assembly Third Reading",63,6,0,11,80
514020,364040,2014-05-13,Senate,"Do pass, but re-refer to the Committee on Appropriations",5,1,1,0,7
514020,378458,2014-08-26,Senate,"Assembly 3rd Reading AB1327 Gorell By Lieu",26,8,6,0,40
514020,378661,2014-08-27,Assembly,"AB 1327 GORELL  Concurrence in Senate Amendments",68,4,0,7,79
514023,275608,2013-04-30,Assembly,"Do pass as amended and be re-referred to the Committee on 	Appropriations",5,2,0,0,7
514023,283889,2013-05-24,Assembly,"Do pass",12,5,0,0,17
514023,285697,2013-05-30,Assembly,"AB 1329 PEREZ, V.M.  Assembly Third Reading",53,24,0,2,79
514023,295996,2013-07-03,Senate,"Do pass, but re-refer to the Committee on Appropriations",8,1,0,0,9
514023,298585,2013-09-03,Senate,"Assembly 3rd Reading AB1329 V. Manuel P",27,10,2,0,39
514023,298766,2013-09-06,Assembly,"AB 1329 PEREZ, V.M.  Concurrence in Senate Amendments",53,25,0,0,78
514024,257415,2013-04-01,Assembly,"Do pass as amended and be re-referred to the Committee on 	Appropriations",8,0,0,1,9
514024,283766,2013-05-24,Assembly,"Do pass",16,1,0,0,17
514024,285034,2013-05-29,Assembly,"AB 1330 PEREZ, J.  Assembly Third Reading",74,2,0,3,79
514024,291853,2013-06-26,Senate,"Do pass, but re-refer to the Committee on Governance and Finance",8,1,0,0,9
514024,295936,2013-07-03,Senate,"Do pass, but re-refer to the Committee on Appropriations",6,1,0,0,7
514024,297281,2013-08-12,Senate,"Placed on Appropriations Suspense file",6,0,1,0,7
514024,298288,2013-08-30,Senate,"Do pass",6,1,0,0,7
514025,273495,2013-04-29,Assembly,"Be referred to Committee on Water, Parks and Wildlife",11,0,0,0,11
514025,274244,2013-04-30,Assembly,"Do pass and be re-referred to the Committee on Appropriations",10,0,0,5,15
514025,283966,2013-05-24,Assembly,"Do pass",12,0,0,5,17
514025,284978,2013-05-29,Assembly,"AB 1331 W., P.& W.  Assembly Third Reading  By RENDON",60,0,0,19,79
514025,347556,2014-03-25,Senate,"Do pass as amended, and re-refer to the Committee on Environmental 	Quality",7,2,0,0,9
514025,362967,2014-05-07,Senate,"Do pass as amended, and re-refer to the Committee on Rules",5,2,0,0,7
514026,277851,2013-05-08,Assembly,"Do pass",16,0,0,1,17
514026,280373,2013-05-16,Assembly,"AB 1332 HAGMAN  Assembly Third Reading",70,0,0,9,79
514026,288061,2013-06-11,Senate,"Do pass",10,0,1,0,11
514026,298022,2013-08-26,Senate,"Assembly 3rd Reading AB1332 Hagman Urgency Clause",39,0,0,0,39
514026,298202,2013-08-30,Assembly,"AB 1332 HAGMAN  Concurrence- Urgency Added",77,0,0,1,78
514027,277975,2013-05-08,Assembly,"Do pass",5,3,0,1,9
514027,281242,2013-05-20,Assembly,"AB 1333 HERNANDEZ  Assembly Third Reading  Amend By HERNANDEZ  Set 	#1",46,23,0,9,78
514027,284995,2013-05-29,Assembly,"AB 1333 HERNANDEZ  Assembly Third Reading",43,29,0,7,79
514029,274825,2013-04-30,Assembly,"Do pass and be re-referred to the Committee on Appropriations",2,3,0,2,7
514029,274826,2013-04-30,Assembly,"Set third hearing.  Failed passage.  Reconsideration granted",7,0,0,0,7
514029,308854,2014-01-14,Assembly,"Do pass and be re-referred to the Committee on Appropriations",3,4,0,0,7
514030,305916,2014-01-06,Assembly,"Be referred to Committee on Public Safety",9,0,0,1,10
514030,308645,2014-01-14,Assembly,"Do pass and be re-referred to the Committee on Appropriations",7,0,0,0,7
514030,311146,2014-01-23,Assembly,"Do pass",16,0,0,1,17
514030,312227,2014-01-27,Assembly,"AB 1335 MAIENSCHEIN  Assembly Third Reading",77,0,0,3,80
514030,364141,2014-05-13,Senate,"Do pass as amended, and re-refer to the Committee on Appropriations",6,0,1,0,7
514030,373730,2014-06-23,Senate,"Placed on Appropriations Suspense file",7,0,0,0,7
514031,272380,2013-04-24,Assembly,"Do pass and be re-referred to the Committee on Judiciary",5,2,0,0,7
514031,274264,2013-04-30,Assembly,"Do pass and be re-referred to the Committee on Appropriations",7,3,0,0,10
514031,279731,2013-05-15,Assembly,"Do pass",12,5,0,0,17
514031,283913,2013-05-24,Assembly,"AB 1336 FRAZIER  Assembly Third Reading",49,21,0,8,78
514031,288444,2013-06-12,Senate,"Do pass, but re-refer to the Committee on Judiciary",4,1,0,0,5
514031,295997,2013-07-02,Senate,"Do pass, but re-refer to the Committee on Appropriations",4,2,1,0,7
514031,298598,2013-09-03,Senate,"Assembly 3rd Reading AB1336 Frazier By Padilla",25,11,3,0,39
514031,298885,2013-09-06,Assembly,"AB 1336 FRAZIER  Concurrence in Senate Amendments",53,23,0,2,78
514032,274123,2013-04-29,Assembly,"Do pass and be re-referred to the Committee on Local Government",0,9,0,0,9
514033,259768,2013-04-03,Assembly,"Do pass as amended and be re-referred to the Committee on 	Appropriations",7,0,0,0,7
514035,276779,2013-05-07,Assembly,"Do pass, to Consent Calendar",10,0,0,0,10
514035,278589,2013-05-13,Assembly,"AB 1339 MAIENSCHEIN  Consent Calendar Second Day  Regular Session",75,0,0,4,79
514035,289378,2013-06-18,Senate,"Do pass as amended",5,0,2,0,7
514035,297725,2013-08-19,Senate,"Assembly 3rd Reading AB1339 Maienschein By Walters",37,0,2,0,39
514035,297931,2013-08-22,Assembly,"AB 1339 MAIENSCHEIN  Concurrence in Senate Amendments",78,0,0,0,78
514036,267305,2013-04-16,Assembly,"Do pass and be re-referred to the Committee on Public Safety",17,0,0,2,19
514036,275340,2013-04-30,Assembly,"Do pass and be re-referred to the Committee on Appropriations",6,0,0,1,7
514036,283946,2013-05-24,Assembly,"Do pass as amended",17,0,0,0,17
514036,285654,2013-05-30,Assembly,"AB 1340 ACHADJIAN  Assembly Third Reading",77,0,0,2,79
514036,370859,2014-06-11,Senate,"Do pass as amended, and re-refer to the Committee on Public Safety",8,0,1,0,9
514036,374453,2014-06-24,Senate,"Do pass as amended, and re-refer to the Committee on Appropriations",7,0,0,0,7
514036,376468,2014-08-04,Senate,"Placed on Appropriations Suspense file",7,0,0,0,7
514036,377419,2014-08-14,Senate,"Do pass as amended",6,0,1,0,7
514036,378037,2014-08-21,Senate,"Assembly 3rd Reading AB1340 Achadjian By Beall",36,0,4,0,40
514036,378512,2014-08-26,Assembly,"Senate amendments be concurred in",16,0,0,3,19
514036,378741,2014-08-27,Assembly,"AB 1340 ACHADJIAN  Concurrence in Senate Amendments",78,0,0,1,79
514044,271609,2013-04-24,Assembly,"Do pass as amended and be re-referred to the Committee on 	Appropriations",5,2,0,0,7
514044,277484,2013-05-08,Assembly,"Do pass",12,5,0,0,17
514044,281253,2013-05-20,Assembly,"AB 1346 PAN  Assembly Third Reading",50,21,0,7,78
514044,287760,2013-06-10,Senate,"Do pass, but re-refer to the Committee on Appropriations",3,1,1,0,5
514044,291338,2013-06-24,Senate,"Do pass",5,2,0,0,7
514044,298644,2013-09-03,Senate,"Assembly 3rd Reading AB1346 Pan By Galgiani",26,11,2,0,39
514044,298813,2013-09-06,Assembly,"AB 1346 PAN  Concurrence in Senate Amendments",55,20,0,3,78
514045,272369,2013-04-24,Assembly,"Do pass and re-refer to Committee on Appropriations with 	recommendation:  To Consent Calendar",16,0,0,1,17
514045,283930,2013-05-24,Assembly,"Do pass as amended",17,0,0,0,17
514045,285626,2013-05-30,Assembly,"AB 1347 GRAY  Assembly Third Reading",77,0,0,2,79
514045,291785,2013-06-25,Senate,"Do pass and be placed on the Consent Calendar",11,0,0,0,11
514047,271958,2013-04-23,Assembly,"Do pass and be re-referred to the Committee on Appropriations",13,0,0,0,13
514047,283768,2013-05-24,Assembly,"Do pass as amended",16,1,0,0,17
514047,285658,2013-05-30,Assembly,"AB 1348 PEREZ, J.  Assembly Third Reading",77,1,0,1,79
514047,374337,2014-06-25,Senate,"Do pass as amended, and re-refer to the Committee on Appropriations",6,0,1,0,7
514047,376654,2014-08-04,Senate,"Placed on Appropriations Suspense file",7,0,0,0,7
514048,266750,2013-04-16,Assembly,"Do pass and be re-referred to the Committee on Appropriations",14,0,0,1,15
514051,271385,2013-04-23,Assembly,"Do pass and be re-referred to the Committee on Appropriations",10,0,0,0,10
514051,277744,2013-05-08,Assembly,"Do pass, to Consent Calendar",17,0,0,0,17
514051,280311,2013-05-16,Assembly,"AB 1352 LEVINE  Consent Calendar Second Day  Regular Session",70,0,0,9,79
514051,288267,2013-06-11,Senate,"Do pass as amended, and re-refer to the Committee on 	Appropriations",7,0,0,0,7
514051,297724,2013-08-19,Senate,"Assembly 3rd Reading AB1352 Levine By Evans",37,0,2,0,39
514051,297932,2013-08-22,Assembly,"AB 1352 LEVINE  Concurrence in Senate Amendments",78,0,0,0,78
514056,308686,2014-01-14,Assembly,"Do pass as amended",8,1,0,1,10
514056,313222,2014-01-29,Assembly,"AB 1356 BLOOM  Assembly Third Reading",53,19,0,8,80
514056,372747,2014-06-17,Senate,"Do pass as amended",5,1,1,0,7
514056,378436,2014-08-25,Senate,"Assembly 3rd Reading AB1356 Bloom By Evans",21,10,9,0,40
514056,378608,2014-08-27,Assembly,"AB 1356 BLOOM  Concurrence in Senate Amendments",56,19,0,4,79
514059,271857,2013-04-23,Assembly,"Do pass and be re-referred to the Committee on Appropriations",7,4,0,2,13
514059,277365,2013-05-08,Assembly,"Do pass",12,5,0,0,17
514059,283256,2013-05-23,Assembly,"AB 1358 FONG  Assembly Third Reading",46,25,0,7,78
514059,295927,2013-07-03,Senate,"Do pass as amended, and re-refer to the Committee on Appropriations",7,2,0,0,9
514059,297254,2013-08-12,Senate,"Do pass",4,1,2,0,7
514059,298955,2013-09-09,Senate,"Assembly 3rd Reading AB1358 Fong By Lara",28,11,0,0,39
514059,299175,2013-09-10,Assembly,"AB 1358 FONG  Concurrence in Senate Amendments",48,29,0,1,78
514060,277947,2013-05-08,Assembly,"Do pass",5,0,0,4,9
514060,285506,2013-05-30,Assembly,"AB 1359 HERNANDEZ  Assembly Third Reading",47,26,0,6,79
514060,296016,2013-07-03,Senate,"Do pass as amended",5,2,0,0,7
514060,298011,2013-08-26,Senate,"Assembly 3rd Reading AB1359 Roger Hern",26,13,0,0,39
514060,298203,2013-08-30,Assembly,"AB 1359 HERNANDEZ  Concurrence in Senate Amendments",48,26,0,4,78
514061,274735,2013-05-01,Assembly,"Do pass as amended",7,0,0,0,7
514061,277960,2013-05-09,Assembly,"AB 1360 TORRES  Assembly Third Reading",69,3,0,7,79
514061,374435,2014-06-24,Senate,"Do pass, but re-refer to the Committee on Appropriations",2,3,2,0,7
514066,262647,2013-04-09,Assembly,"Do pass and be re-referred to the Committee on Appropriations",9,3,0,1,13
514066,283851,2013-05-24,Assembly,"Do pass as amended",12,0,0,5,17
514066,285567,2013-05-30,Assembly,"AB 1364 TING  Assembly Third Reading",53,21,0,5,79
514066,291867,2013-06-26,Senate,"Do pass, but re-refer to the Committee on Appropriations",7,1,1,0,9
514066,297259,2013-08-12,Senate,"Placed on Appropriations Suspense file",6,0,1,0,7
514067,275711,2013-05-01,Assembly,"Do pass and be re-referred to the Committee on Appropriations",12,1,0,0,13
514067,280111,2013-05-15,Assembly,"Do pass",17,0,0,0,17
514067,283948,2013-05-24,Assembly,"AB 1365 PEREZ, J.  Assembly Third Reading",70,0,0,8,78
514067,291796,2013-06-25,Senate,"Do pass, but re-refer to the Committee on Appropriations Recommend 	Consent",11,0,0,0,11
514067,297591,2013-08-15,Senate,"Consent Calendar 2nd AB1365 John A. P",38,0,1,0,39
514068,270887,2013-04-22,Assembly,"Do pass as amended and be re-referred to the Committee on 	Appropriations",15,0,0,0,15
514074,269956,2013-04-22,Assembly,"Do pass as amended and be re-referred to the Committee on 	Appropriations",12,3,0,1,16
514074,277335,2013-05-08,Assembly,"Do pass",12,5,0,0,17
514074,280294,2013-05-16,Assembly,"AB 1371 BRADFORD  Assembly Third Reading",52,20,0,7,79
514074,291598,2013-06-25,Senate,"Do pass as amended, and re-refer to the Committee on 	Appropriations",10,0,1,0,11
514074,298009,2013-08-26,Senate,"Assembly 3rd Reading AB1371 Bradford By DeSaulnier",31,7,1,0,39
514074,298192,2013-08-30,Assembly,"AB 1371 BRADFORD  Concurrence in Senate Amendments",54,24,0,0,78
514077,271589,2013-04-24,Assembly,"Do pass",9,4,0,0,13
514077,275702,2013-05-02,Assembly,"AB 1373 PEREZ, J.  Assembly Third Reading",60,12,0,7,79
514077,292075,2013-06-26,Senate,"Do pass as amended, and re-refer to the Committee on Appropriations",4,0,1,0,5
514077,297680,2013-08-19,Senate,"Placed on Appropriations Suspense file",7,0,0,0,7
514077,298455,2013-08-30,Senate,"Do pass",5,2,0,0,7
514077,299021,2013-09-09,Senate,"Assembly 3rd Reading AB1373 John A. P",36,0,3,0,39
514077,299248,2013-09-10,Assembly,"AB 1373 PEREZ, J.  Concurrence in Senate Amendments",66,11,0,1,78
514079,274146,2013-04-29,Assembly,"Do pass as amended and be re-referred to the Committee on 	Appropriations",6,3,0,0,9
514080,266229,2013-04-16,Assembly,"Do pass as amended and be re-referred to the Committee on Insurance",10,0,0,0,10
514080,271613,2013-04-24,Assembly,"Do pass as amended and be re-referred to the Committee on 	Appropriations",13,0,0,0,13
514080,277431,2013-05-08,Assembly,"Do pass, to Consent Calendar",17,0,0,0,17
514080,280336,2013-05-16,Assembly,"AB 1376 HERNANDEZ  Consent Calendar Second Day  Regular Session",70,0,0,9,79
514080,288377,2013-06-12,Senate,"Do pass, but re-refer to the Committee on Appropriations",4,0,1,0,5
514080,291250,2013-06-24,Senate,"Placed on Appropriations Suspense file",7,0,0,0,7
514080,298491,2013-08-30,Senate,"Do pass",7,0,0,0,7
514080,299499,2013-09-11,Senate,"From Committee:  That the measure be returned to the Senate floor 	for consideration",5,0,0,0,5
514080,299822,2013-09-12,Assembly,"Senate amendments be concurred in",9,0,0,3,12
514080,299823,2013-09-12,Assembly,"AB 1376 HERNANDEZ  Concurrence- Urgency Added",77,0,0,1,78
514080,299824,2013-09-12,Senate,"Assembly 3rd Reading AB1376 Roger Hern",32,1,6,0,39
514082,271055,2013-04-23,Assembly,"Be adopted and be re-referred to the Committee on Appropriations",2,4,0,1,7
514082,271056,2013-04-23,Assembly,"Set first hearing.  Failed passage.  Reconsideration granted",7,0,0,0,7
514083,278323,2013-05-09,Assembly,"From committee:  Be adopted.  To third reading",11,0,0,0,11
514083,283971,2013-05-24,Senate,"Special Consent Cal ACR24 Nestande",36,0,3,0,39
514084,292359,2013-06-27,Assembly,"From committee:  Be adopted.  To third reading",10,0,0,1,11
514084,298584,2013-09-03,Senate,"Assembly 3rd Reading ACR25 Wieckowski By Corbett",37,0,2,0,39
514085,243408,2013-03-07,Assembly,"From committee:  Be adopted.  To third reading",11,0,0,0,11
514086,277411,2013-05-08,Senate,"Do pass",7,0,0,0,7
514086,285212,2013-05-29,Senate,"Senate 3rd Reading SB536 Berryhill",39,0,0,0,39
514088,258452,2013-04-03,Senate,"Do pass, but re-refer to the Committee on Appropriations Recommend 	Consent",8,0,1,0,9
514088,268419,2013-04-18,Senate,"Consent Calendar 2nd SB537 Committee on B. & F.I. (Hill)",36,0,2,0,38
514088,288020,2013-06-10,Assembly,"Do pass and be re-referred to the Committee on Appropriations to 	Consent Calendar",11,0,0,0,11
514088,295979,2013-07-03,Assembly,"Do pass, to Consent Calendar",17,0,0,0,17
514088,297666,2013-08-19,Assembly,"SB 537 B.&.F.I.  Senate Third Reading  By DICKINSON",77,0,0,1,78
514088,297998,2013-08-26,Senate,"Unfinished Business SB537 Committee on B. & F.I. (Correa) 	Concurrence",37,0,2,0,39
514089,258699,2013-04-03,Senate,"Do pass, but re-refer to the Committee on Appropriations",8,0,1,0,9
514089,265233,2013-04-15,Senate,"Do pass",5,1,1,0,7
514089,272377,2013-04-25,Senate,"Senate 3rd Reading SB538 Hill",27,6,5,0,38
514089,288057,2013-06-10,Assembly,"Do pass and be re-referred to the Committee on Appropriations",9,1,0,1,11
514089,298516,2013-08-30,Assembly,"Do pass",13,0,0,4,17
514089,298738,2013-09-04,Assembly,"SB 538 Hill  Senate Third Reading  By CHAU",68,1,0,9,78
514091,275764,2013-05-01,Senate,"Do pass and be placed on the Consent Calendar",9,0,0,0,9
514091,278256,2013-05-09,Senate,"Consent Calendar 2nd SB540 Wyland",34,0,4,0,38
514091,288557,2013-06-12,Assembly,"Do pass, to Consent Calendar",7,0,0,0,7
514091,290217,2013-06-20,Assembly,"SB 540 Wyland  Consent Calendar Second Day  Regular Session",79,0,0,0,79
514091,296224,2013-07-08,Senate,"Unfinished Business SB540 Wyland Concurrence",29,0,9,0,38
514095,257860,2013-04-02,Senate,"Do pass as amended, and re-refer to the Committee on Appropriations",7,0,0,0,7
514095,270035,2013-04-22,Senate,"Placed on Appropriations Suspense file",7,0,0,0,7
514095,283365,2013-05-23,Senate,"Do pass",7,0,0,0,7
514095,285098,2013-05-29,Senate,"Special Consent #7 SB543 Block",38,0,1,0,39
514095,295855,2013-07-02,Assembly,"Do pass and re-refer to Committee on Appropriations with 	recommendation:  To Consent Calendar",7,0,0,0,7
514095,298404,2013-08-30,Assembly,"Do pass",17,0,0,0,17
514095,299008,2013-09-09,Assembly,"SB 543 Block  Senate Third Reading  By WALDRON",78,0,0,0,78
514096,261754,2013-04-09,Senate,"Do pass, but re-refer to the Committee on Appropriations",7,0,0,0,7
514096,270407,2013-04-22,Senate,"Placed on Appropriations Suspense file",7,0,0,0,7
514096,311207,2014-01-23,Senate,"Do pass",5,0,2,0,7
514096,312658,2014-01-28,Senate,"Senate 3rd Reading SB544 DeSaulnier",34,0,5,0,39
514096,371289,2014-06-12,Assembly,"Be referred to Committee on Education",10,0,0,1,11
514096,373702,2014-06-23,Assembly,"Do pass and be re-referred to the Committee on Education",10,3,0,3,16
514097,309004,2014-01-14,Senate,"Do pass as amended",6,0,1,0,7
514097,311118,2014-01-23,Senate,"Senate 3rd Reading SB545 Anderson",33,0,6,0,39
514097,370479,2014-06-10,Assembly,"Do pass, to Consent Calendar",9,0,0,1,10
514097,371773,2014-06-16,Assembly,"SB 545 Anderson  Consent Calendar Second Day  Regular Session",77,0,0,2,79
514098,277438,2013-05-08,Senate,"Do pass and be placed on the Consent Calendar",8,0,1,0,9
514098,280245,2013-05-16,Senate,"Consent Calendar 2nd SB546 Wright",37,0,1,0,38
514098,288417,2013-06-12,Assembly,"Do pass as amended, to Consent Calendar",7,0,0,0,7
514098,291626,2013-06-25,Assembly,"SB 546 Wright  Consent Calendar Second Day",74,0,0,5,79
514098,296277,2013-07-08,Senate,"Unfinished Business SB546 Wright Concurrence",29,0,9,0,38
514100,272412,2013-04-24,Senate,"Do pass as amended, and re-refer to the Committee on Appropriations",9,0,0,0,9
514100,278754,2013-05-13,Senate,"Placed on Appropriations Suspense file",5,0,2,0,7
514103,274194,2013-04-30,Senate,"Do pass as amended, and re-refer to the Committee on 	Appropriations",11,0,0,0,11
514103,281278,2013-05-20,Senate,"Placed on Appropriations Suspense file",6,0,1,0,7
514104,277454,2013-05-07,Senate,"Do pass",6,0,1,0,7
514104,281371,2013-05-20,Senate,"Special Consent #5 SB551 Gaines",36,0,3,0,39
514104,295915,2013-07-02,Assembly,"Do pass as amended, to Consent Calendar",10,0,0,0,10
514104,297166,2013-08-08,Assembly,"SB 551 Gaines  Consent Calendar Second Day  Regular Session",77,0,0,1,78
514104,297523,2013-08-15,Senate,"Unfinished Business SB551 Gaines Concurrence",38,0,1,0,39
514106,275572,2013-05-01,Senate,"Do pass",8,1,0,0,9
514106,280284,2013-05-16,Senate,"Senate 3rd Reading SB552 Calderon",29,7,2,0,38
514106,297483,2013-08-14,Assembly,"Do pass",7,0,0,0,7
514106,298008,2013-08-26,Assembly,"SB 552 Calderon  Senate Third Reading  By BUCHANAN",72,3,0,3,78
514106,298453,2013-08-30,Senate,"Unfinished Business SB552 Calderon Concurrence",26,10,3,0,39
514108,274811,2013-05-01,Senate,"Do pass, but re-refer to the Committee on Appropriations Recommend 	Consent",7,0,0,0,7
514108,279000,2013-05-13,Senate,"Placed on Appropriations Suspense file",5,0,2,0,7
514108,283290,2013-05-23,Senate,"Do pass",7,0,0,0,7
514108,285144,2013-05-29,Senate,"Senate 3rd Reading SB553 Yee",39,0,0,0,39
514108,291968,2013-06-26,Assembly,"Do pass and be re-referred to the Committee on Appropriations",9,0,0,0,9
514108,297497,2013-08-14,Assembly,"Do pass, to Consent Calendar",17,0,0,0,17
514108,297894,2013-08-22,Assembly,"SB 553  Consent Calendar Second Day  Regular Session",78,0,0,0,78
514108,298103,2013-08-26,Senate,"Unfinished Business SB553 Yee Concurrence",37,0,2,0,39
514110,261757,2013-04-09,Senate,"Do pass, but re-refer to the Committee on Appropriations",4,0,2,0,6
514110,273571,2013-04-29,Senate,"Placed on Appropriations Suspense file",7,0,0,0,7
514110,283417,2013-05-23,Senate,"Do pass as amended",7,0,0,0,7
514110,285213,2013-05-29,Senate,"Senate 3rd Reading SB555 Correa",37,0,2,0,39
514110,297465,2013-08-13,Assembly,"Do pass as amended",7,0,0,0,7
514110,298651,2013-09-03,Assembly,"SB 555 Correa  Senate Third Reading  By GARCIA",71,0,0,7,78
514110,298737,2013-09-04,Senate,"Unfinished Business SB555 Correa",34,2,3,0,39
514112,277429,2013-05-07,Senate,"Do pass, but re-refer to the Committee on Labor and Industrial 	Relations",5,1,1,0,7
514112,277430,2013-05-08,Senate,"Do pass as amended",4,0,1,0,5
514112,285608,2013-05-30,Senate,"Senate 3rd Reading SB556 Corbett",24,13,2,0,39
514112,291533,2013-06-25,Assembly,"Do pass as amended",7,3,0,0,10
514112,378395,2014-08-25,Assembly,"SB 556 Padilla  Senate Third Reading  By BOCANEGRA",43,24,0,12,79
514112,378897,2014-08-28,Senate,"From committee:  That the Assembly Amendments be concurred in",4,2,1,0,7
514112,378996,2014-08-29,Senate,"Unfinished Business SB556 Padilla Concurrence",24,11,5,0,40
514113,274208,2013-04-30,Senate,"Do pass as amended, and re-refer to the Committee on 	Appropriations",9,1,1,0,11
514113,284009,2013-05-24,Senate,"Senate 3rd Reading SB557 Hill",30,5,4,0,39
514113,295859,2013-07-01,Assembly,"Do pass and be re-referred to the Committee on Appropriations",13,2,0,1,16
514113,297515,2013-08-14,Assembly,"Do pass",13,4,0,0,17
514113,298106,2013-08-26,Assembly,"SB 557 Hill  Senate Third Reading  By MULLIN",54,24,0,0,78
514114,277405,2013-05-08,Senate,"Do pass",5,0,0,0,5
514114,278699,2013-05-13,Senate,"Senate 3rd Reading SB558 Lieu",34,0,4,0,38
514114,289231,2013-06-17,Assembly,"Be referred to Committee on Judiciary",9,0,0,2,11
514114,291707,2013-06-25,Assembly,"Do pass and be re-referred to the Committee on Appropriations",10,0,0,0,10
514114,296008,2013-07-03,Assembly,"Do pass, to Consent Calendar",17,0,0,0,17
514114,298109,2013-08-26,Assembly,"SB 558 Lieu  Senate Third Reading  By WAGNER",78,0,0,0,78
514114,298612,2013-09-03,Senate,"From committee:  That the Assembly Amendments be concurred in",6,0,1,0,7
514114,298739,2013-09-04,Senate,"Unfinished Business SB558 Lieu Concurrence",37,0,2,0,39
514115,309092,2014-01-15,Senate,"Do pass as amended",4,3,2,0,9
514116,306139,2014-01-08,Senate,"Do pass as amended, and re-refer to the Committee on Appropriations",5,0,1,0,6
514116,310439,2014-01-21,Senate,"Placed on Appropriations Suspense file",5,0,2,0,7
514119,269989,2013-04-22,Senate,"Do pass, but re-refer to the Committee on Appropriations",10,0,0,0,10
514119,273517,2013-04-29,Senate,"Do pass as amended",7,0,0,0,7
514119,276291,2013-05-06,Senate,"Special Consent #3 SB562 Galgiani",32,0,6,0,38
514119,291702,2013-06-25,Assembly,"Do pass and re-refer to Committee on Appropriations with 	recommendation:  To Consent Calendar",13,0,0,0,13
514119,296082,2013-07-03,Assembly,"Do pass, to Consent Calendar",17,0,0,0,17
514119,299111,2013-09-10,Assembly,"SB 562 Galgiani  Senate Third Reading  By BONILLA",76,0,0,2,78
514119,299557,2013-09-11,Senate,"Unfinished Business SB562 Galgiani Concurrence",39,0,0,0,39
514120,272330,2013-04-24,Senate,"Do pass, but re-refer to the Committee on Appropriations Recommend 	Consent",9,0,0,0,9
514120,278016,2013-05-09,Senate,"Consent Calendar 2nd SB563 Galgiani",34,0,4,0,38
514120,297321,2013-08-13,Assembly,"Do pass and be re-referred to the Committee on Appropriations",18,0,0,1,19
514120,297853,2013-08-21,Assembly,"Do pass",16,0,0,1,17
514120,298606,2013-09-03,Assembly,"SB 563 Galgiani  Senate Third Reading  By EGGMAN",75,0,0,3,78
514120,299130,2013-09-10,Senate,"Unfinished Business SB563 Galgiani Concurrence",38,0,1,0,39
514121,272272,2013-04-24,Senate,"Do pass, but re-refer to the Committee on Judiciary",7,2,0,0,9
514121,277446,2013-05-07,Senate,"Do pass",5,1,1,0,7
514121,278825,2013-05-13,Senate,"Senate 3rd Reading SB564 Monning",24,8,6,0,38
514121,372326,2014-06-17,Assembly,"Do pass as amended and be re-referred to the Committee on 	Appropriations",11,7,0,1,19
514124,258548,2013-04-02,Senate,"Do pass as amended, and re-refer to the Committee on Public Safety",5,0,0,0,5
514124,274894,2013-04-30,Senate,"Do pass, but re-refer to the Committee on Appropriations",7,0,0,0,7
514124,278840,2013-05-13,Senate,"Placed on Appropriations Suspense file",5,0,2,0,7
514124,283060,2013-05-23,Senate,"Do pass as amended",7,0,0,0,7
514124,285093,2013-05-29,Senate,"Senate 3rd Reading SB566 Leno",39,0,0,0,39
514124,291672,2013-06-25,Assembly,"Do pass and be re-referred to the Committee on Agriculture",7,0,0,0,7
514124,297477,2013-08-14,Assembly,"Do pass and be re-referred to the Committee on Appropriations",7,0,0,0,7
514124,297847,2013-08-21,Assembly,"Do pass as amended",16,1,0,0,17
514124,299113,2013-09-10,Assembly,"SB 566 Leno  Senate Third Reading  By MANSOOR",70,5,0,3,78
514124,299463,2013-09-11,Senate,"Unfinished Business SB566 Leno Concurrence",39,0,0,0,39
514125,267352,2013-04-16,Senate,"Do pass, but re-refer to the Committee on Appropriations",5,2,0,0,7
514125,276277,2013-05-06,Senate,"Placed on Appropriations Suspense file",7,0,0,0,7
514125,283147,2013-05-23,Senate,"Do pass as amended",5,2,0,0,7
514125,284975,2013-05-29,Senate,"Special Order SB567 Jackson",22,15,2,0,39
514125,297301,2013-08-13,Assembly,"Do pass and be re-referred to the Committee on Appropriations",4,2,0,1,7
514125,298289,2013-08-30,Assembly,"Do pass",12,5,0,0,17
514125,299457,2013-09-11,Senate,"Unfinished Supp 1 SB567 Jackson Concurrence",22,16,1,0,39
514125,299458,2013-09-11,Assembly,"SB 567 Jackson  Senate Third Reading  By DICKINSON",42,33,0,3,78
514126,271638,2013-04-23,Senate,"Do pass",6,0,1,0,7
514126,273491,2013-04-29,Senate,"Senate 3rd Reading SB568 Steinberg",37,0,1,0,38
514126,291663,2013-06-25,Assembly,"Do pass and be re-referred to the Committee on Judiciary",5,1,0,1,7
514126,297330,2013-08-13,Assembly,"Do pass as amended",10,0,0,0,10
514126,297980,2013-08-26,Assembly,"SB 568 Steinberg  Senate Third Reading  By DICKINSON",62,12,0,4,78
514126,298478,2013-08-30,Senate,"Unfinished Business SB568 Steinberg Concurrence",38,0,1,0,39
514127,261777,2013-04-09,Senate,"Do pass, but re-refer to the Committee on Appropriations",7,0,0,0,7
514127,273730,2013-04-29,Senate,"Placed on Appropriations Suspense file",7,0,0,0,7
514127,283227,2013-05-23,Senate,"Do pass as amended",7,0,0,0,7
514127,285023,2013-05-29,Senate,"Senate 3rd Reading SB569 Lieu",36,0,3,0,39
514127,297405,2013-08-13,Assembly,"Do pass and be re-referred to the Committee on Appropriations",6,0,0,1,7
514127,298409,2013-08-30,Assembly,"Do pass as amended",17,0,0,0,17
514127,299490,2013-09-11,Assembly,"SB 569 Lieu  Senate Third Reading  By MITCHELL",76,1,0,1,78
514127,299594,2013-09-12,Senate,"Unfinished Business SB569 Lieu Concurrence",37,0,2,0,39
514128,270907,2013-04-23,Senate,"Do pass, but re-refer to the Committee on Appropriations",11,0,0,0,11
514128,276448,2013-05-06,Senate,"Placed on Appropriations Suspense file",7,0,0,0,7
514128,283389,2013-05-23,Senate,"Do pass as amended",7,0,0,0,7
514128,285227,2013-05-29,Senate,"Senate 3rd Reading SB570 DeSaulnier",39,0,0,0,39
514128,297291,2013-08-13,Assembly,"Do pass as amended and be re-referred to the Committee on 	Appropriations",18,0,0,1,19
514128,298433,2013-08-30,Assembly,"Do pass as amended",17,0,0,0,17
514128,367062,2014-05-23,Assembly,"SB 570 DeSaulnier  Senate Third Reading  Amend By CHESBRO  Set #1",53,20,0,6,79
514128,370350,2014-06-09,Assembly,"Be referred to Committee on Health",10,0,0,1,11
514128,374480,2014-06-24,Assembly,"Do pass as amended and be re-referred to the Committee on Business, 	Professions and Consumer Protection",10,2,0,7,19
514128,374878,2014-06-26,Assembly,"Do pass as amended and be re-referred to the Committee on 	Appropriations",8,5,0,1,14
514130,275333,2013-05-01,Senate,"Do pass as amended, and re-refer to the Committee on Appropriations",6,1,0,0,7
514130,281370,2013-05-20,Senate,"Do pass",6,0,1,0,7
514130,284621,2013-05-28,Senate,"Senate 3rd Reading SB571 Price",35,2,2,0,39
514130,291812,2013-06-24,Assembly,"Do pass and be re-referred to the Committee on Arts, Entertain, 	Sports, Tourism, & Internet Media",5,0,0,4,9
514130,297434,2013-08-13,Assembly,"Do pass and be re-referred to the Committee on Appropriations",7,0,0,0,7
514130,297881,2013-08-21,Assembly,"Do pass as amended",17,0,0,0,17
514130,298632,2013-09-03,Assembly,"SB 571 Liu  Senate Third Reading  By GATTO",74,1,0,3,78
514130,298731,2013-09-04,Senate,"Unfinished Business SB571 Liu Concurrence",35,2,2,0,39
514132,308571,2014-01-14,Senate,"Do pass as amended, and re-refer to the Committee on 	Appropriations",11,0,0,0,11
514132,311114,2014-01-23,Senate,"Senate 3rd Reading SB573 Lieu",33,0,6,0,39
514132,373772,2014-06-23,Assembly,"Do pass and be re-referred to the Committee on Appropriations",2,1,0,13,16
514133,258514,2013-04-03,Senate,"Do pass as amended, and re-refer to the Committee on 	Appropriations",9,0,0,0,9
514133,269917,2013-04-22,Senate,"Placed on Appropriations Suspense file",7,0,0,0,7
514136,272364,2013-04-24,Senate,"Do pass as amended, but re-refer to the Committee on Appropriations 	Recommend Consent",9,0,0,0,9
514136,280253,2013-05-16,Senate,"Consent Calendar 2nd SB576 Block",37,0,1,0,38
514136,288051,2013-06-11,Assembly,"Do pass and be re-referred to the Committee on Appropriations",12,0,0,1,13
514136,296139,2013-07-03,Assembly,"Do pass, to Consent Calendar",17,0,0,0,17
514136,297697,2013-08-19,Assembly,"SB 576 Block  Senate Third Reading  By WILLIAMS",77,0,0,1,78
514137,270810,2013-04-23,Senate,"Do pass, but re-refer to the Committee on Appropriations",6,0,0,0,6
514137,278758,2013-05-13,Senate,"Placed on Appropriations Suspense file",5,0,2,0,7
514137,311242,2014-01-23,Senate,"Do pass",6,0,1,0,7
514137,312711,2014-01-28,Senate,"Senate 3rd Reading SB577 Pavley",32,0,7,0,39
514137,372130,2014-06-17,Assembly,"Do pass as amended",7,0,0,0,7
514137,376701,2014-08-06,Assembly,"Do pass as amended",16,1,0,0,17
514137,378351,2014-08-25,Assembly,"SB 577 Pavley  Senate Third Reading  By CHESBRO",78,1,0,0,79
514137,378510,2014-08-26,Senate,"Unfinished Supp 1 SB577 Pavley Concurrence",35,1,4,0,40
514138,270043,2013-04-22,Senate,"Do pass as amended",10,0,0,0,10
514138,276297,2013-05-06,Senate,"Special Consent #3 SB578 Wyland",32,0,6,0,38
514138,370080,2014-06-05,Assembly,"Be referred to Committee on Business, Professions and Consumer 	Protection",10,0,0,1,11
514138,372152,2014-06-17,Assembly,"Do pass as amended and re-refer to Committee on Appropriations 	with recommendation:  To Consent Calendar",14,0,0,0,14
514138,375567,2014-07-02,Assembly,"Do pass, to Consent Calendar",17,0,0,0,17
514138,376840,2014-08-07,Assembly,"SB 578 Wyland  Consent Calendar Second Day",77,0,0,2,79
514138,377039,2014-08-13,Senate,"From committee:  That the Assembly Amendments be concurred in",9,0,0,0,9
514138,377499,2014-08-14,Senate,"Unfinished Business SB578 Wyland Concurrence",33,0,7,0,40
514139,308644,2014-01-14,Senate,"Do pass as amended, and re-refer to the Committee on Appropriations",4,0,2,0,6
514139,310319,2014-01-21,Senate,"Placed on Appropriations Suspense file",5,0,2,0,7
514139,311191,2014-01-23,Senate,"Do pass as amended",6,0,1,0,7
514139,313868,2014-01-30,Senate,"Senate 3rd Reading SB579 Berryhill",35,0,4,0,39
514140,271530,2013-04-23,Senate,"Do pass, but re-refer to the Committee on Appropriations",7,0,0,0,7
514140,278960,2013-05-13,Senate,"Placed on Appropriations Suspense file",5,0,2,0,7
514140,283355,2013-05-23,Senate,"Do pass",7,0,0,0,7
514140,284691,2013-05-28,Senate,"Senate 3rd Reading SB580 Leno",39,0,0,0,39
514140,371768,2014-06-16,Assembly,"Be referred to Committee on Public Safety",10,0,0,1,11
514140,374071,2014-06-24,Assembly,"Do pass and be re-referred to the Committee on Appropriations",5,0,0,2,7
514142,267566,2013-04-17,Senate,"Do pass",9,0,0,0,9
514142,273549,2013-04-29,Senate,"Special Consent #2 SB581 Wyland",37,0,1,0,38
514142,288553,2013-06-12,Assembly,"Do pass as amended",7,0,0,0,7
514142,291197,2013-06-24,Assembly,"SB 581 Wyland  Senate Third Reading  By WEBER",75,0,0,4,79
514142,296307,2013-07-08,Senate,"Unfinished Business SB581 Wyland Concurrence",29,0,9,0,38
514143,274706,2013-05-01,Senate,"Do pass, but re-refer to the Committee on Appropriations",7,0,0,0,7
514143,278717,2013-05-13,Senate,"Placed on Appropriations Suspense file",5,0,2,0,7
514143,283363,2013-05-23,Senate,"Do pass",7,0,0,0,7
514143,284616,2013-05-28,Senate,"Senate 3rd Reading SB582 Knight",38,0,1,0,39
514143,297219,2013-08-12,Assembly,"Do pass as amended and be re-referred to the Committee on 	Appropriations",9,0,0,0,9
514143,298450,2013-08-30,Assembly,"Do pass",17,0,0,0,17
514143,298748,2013-09-04,Assembly,"SB 582 Knight  Senate Third Reading  By HARKEY",77,0,0,1,78
514143,299734,2013-09-12,Senate,"Special Consent #10 SB582 Knight",39,0,0,0,39
514144,271093,2013-04-23,Senate,"Do pass as amended, and re-refer to the Committee on Appropriations",9,0,0,0,9
514144,310406,2014-01-21,Senate,"Placed on Appropriations Suspense file",5,0,2,0,7
514145,259249,2013-04-03,Senate,"Do pass as amended, and re-refer to the Committee on Rules",5,0,4,0,9
514145,276278,2013-05-06,Senate,"Special Consent #3 SB584 Wyland",32,0,6,0,38
514145,288531,2013-06-12,Assembly,"Do pass and be re-referred to the Committee on Appropriations",7,0,0,0,7
514145,296111,2013-07-03,Assembly,"Do pass, to Consent Calendar",17,0,0,0,17
514145,297141,2013-08-08,Assembly,"SB 584 Wyland  Consent Calendar Second Day  Regular Session",77,0,0,1,78
514147,272372,2013-04-24,Senate,"Do pass, but re-refer to the Committee on Appropriations",9,0,0,0,9
514147,281662,2013-05-20,Senate,"Special Consent #5 SB585 Steinberg",36,0,3,0,39
514147,289715,2013-06-18,Assembly,"Do pass and be re-referred to the Committee on Appropriations",15,3,0,1,19
514147,297518,2013-08-14,Assembly,"Do pass",17,0,0,0,17
514147,298107,2013-08-26,Assembly,"SB 585 Steinberg  Senate Third Reading  By LOWENTHAL",73,4,0,1,78
514150,267369,2013-04-17,Senate,"Do pass, but re-refer to the Committee on Judiciary",8,0,1,0,9
514151,257580,2013-04-02,Senate,"Do pass, but re-refer to the Committee on Appropriations",4,1,0,0,5
514151,265444,2013-04-15,Senate,"Do pass",5,2,0,0,7
514151,268471,2013-04-18,Senate,"Senate 3rd Reading SB589 Hill",25,10,3,0,38
514151,288185,2013-06-11,Assembly,"Do pass and be re-referred to the Committee on Appropriations",6,0,0,1,7
514151,296165,2013-07-03,Assembly,"Do pass, to Consent Calendar",17,0,0,0,17
514151,297741,2013-08-19,Assembly,"SB 589 Hill  Senate Third Reading  By MULLIN",76,0,0,2,78
514151,297913,2013-08-22,Senate,"Unfinished Business SB589 Hill Concurrence",36,0,3,0,39
514153,262979,2013-04-10,Senate,"Do pass as amended, and re-refer to the Committee on Appropriations",7,2,0,0,9
514153,276353,2013-05-06,Senate,"Placed on Appropriations Suspense file",7,0,0,0,7
514153,283275,2013-05-23,Senate,"Do pass as amended",5,2,0,0,7
514153,285080,2013-05-29,Senate,"Senate 3rd Reading SB590 De Le",28,9,2,0,39
514153,291936,2013-06-26,Assembly,"Do pass as amended and be re-referred to the Committee on 	Appropriations",5,2,0,0,7
514153,297858,2013-08-21,Assembly,"Do pass",12,5,0,0,17
514153,298721,2013-09-04,Assembly,"SB 590 De Leon  Senate Third Reading  By GONZALEZ",51,24,0,3,78
514153,298875,2013-09-06,Senate,"Unfinished Business SB590 De Le",27,10,2,0,39
514154,257416,2013-04-02,Senate,"Do pass as amended",8,1,2,0,11
514154,270157,2013-04-22,Senate,"Placed on Appropriations Suspense file",7,0,0,0,7
514154,283155,2013-05-23,Senate,"Do pass as amended",7,0,0,0,7
514154,285021,2013-05-29,Senate,"Senate 3rd Reading SB591 Cannella",39,0,0,0,39
514154,295857,2013-07-01,Assembly,"Do pass as amended and be re-referred to the Committee on Natural 	Resources",11,0,0,4,15
514154,297364,2013-08-12,Assembly,"Do pass as amended",8,0,0,1,9
514154,298070,2013-08-26,Assembly,"SB 591 Cannella  Senate Third Reading  By GRAY",68,0,0,10,78
514154,298395,2013-08-30,Senate,"Unfinished Business SB591 Cannella Concurrence",37,0,2,0,39
514155,257056,2013-04-01,Senate,"Do pass, but re-refer to the Committee on Appropriations",10,0,0,0,10
514155,265272,2013-04-15,Senate,"Placed on Appropriations Suspense file",7,0,0,0,7
514155,283364,2013-05-23,Senate,"Do pass",7,0,0,0,7
514155,284692,2013-05-28,Senate,"Senate 3rd Reading SB592 Price Urgency Clause",38,0,1,0,39
514155,297449,2013-08-12,Assembly,"Do pass as amended and be re-referred to the Committee on 	Appropriations",8,0,0,1,9
514156,308704,2014-01-14,Senate,"Do pass, but re-refer to the Committee on Appropriations",6,0,4,0,10
514156,310302,2014-01-21,Senate,"Placed on Appropriations Suspense file",5,0,2,0,7
514156,311097,2014-01-23,Senate,"Do pass as amended",6,0,1,0,7
514156,314052,2014-01-30,Senate,"Senate 3rd Reading SB593 Lieu",35,0,4,0,39
514156,375100,2014-06-24,Assembly,"Do pass as amended and be re-referred to the Committee on 	Appropriations",7,0,0,2,9
514156,377323,2014-08-14,Assembly,"Do pass as amended",17,0,0,0,17
514156,378446,2014-08-26,Assembly,"SB 593 Lieu  Senate Third Reading  By MEDINA",75,1,0,3,79
514156,378844,2014-08-28,Senate,"Unfinished Business SB593 Lieu Concurrence",36,0,4,0,40
514157,271563,2013-04-24,Senate,"Do pass, but re-refer to the Committee on Education",5,0,2,0,7
514157,275555,2013-05-01,Senate,"Do pass, but re-refer to the Committee on Appropriations",8,0,1,0,9
514157,278664,2013-05-13,Senate,"Placed on Appropriations Suspense file",5,0,2,0,7
514157,283120,2013-05-23,Senate,"Do pass as amended",7,0,0,0,7
514157,284963,2013-05-29,Senate,"Senate 3rd Reading SB594 Steinberg",39,0,0,0,39
514157,297124,2013-08-08,Assembly,"Be referred to Committee on Elections and Redistricting",9,0,0,2,11
514157,297242,2013-08-13,Assembly,"Do pass and be re-referred to the Committee on Judiciary",5,0,0,2,7
514157,297524,2013-08-15,Assembly,"Do pass and be re-referred to the Committee on Appropriations",9,0,0,1,10
514157,298294,2013-08-30,Assembly,"Do pass as amended",12,1,0,4,17
514157,298934,2013-09-09,Assembly,"SB 594 Hill  Senate Third Reading  By BONILLA",72,3,0,3,78
514157,299338,2013-09-11,Senate,"From committee:  That the Assembly Amendments be concurred in",5,0,0,0,5
514157,299596,2013-09-12,Senate,"Unfinished Business SB594 Hill Concurrence",35,0,4,0,39
514159,275554,2013-05-01,Senate,"Do pass, but re-refer to the Committee on Rules",9,0,0,0,9
514159,284537,2013-05-28,Senate,"Special Consent #6 SB595 Calderon",39,0,0,0,39
514159,297079,2013-08-06,Assembly,"Do pass and be re-referred to the Committee on Appropriations",12,0,0,1,13
514159,297482,2013-08-14,Assembly,"Do pass, to Consent Calendar",17,0,0,0,17
514159,297933,2013-08-22,Assembly,"SB 595 Calderon  Consent Calendar Second Day  Regular Session",78,0,0,0,78
514160,309107,2014-01-15,Senate,"Do pass as amended, and re-refer to the Committee on 	Appropriations",7,0,2,0,9
514160,309108,2014-01-15,Senate,"Do pass, but re-refer to the Committee on Health",8,0,1,0,9
514160,310295,2014-01-21,Senate,"Placed on Appropriations Suspense file",5,0,2,0,7
514160,311141,2014-01-23,Senate,"Do pass as amended",6,0,1,0,7
514160,312637,2014-01-28,Senate,"Senate 3rd Reading SB596 Yee",34,0,5,0,39
514161,271513,2013-04-23,Senate,"Do pass as amended, and re-refer to the Committee on 	Appropriations",6,1,0,0,7
514161,278969,2013-05-13,Senate,"Placed on Appropriations Suspense file",5,0,2,0,7
514162,260995,2013-04-08,Senate,"Do pass as amended, and re-refer to the Committee on Appropriations",10,0,0,0,10
514162,275538,2013-05-01,Senate,"Do pass, but re-refer to the Committee on Appropriations",6,1,2,0,9
514162,283880,2013-05-24,Senate,"Senate 3rd Reading SB598 Hill",29,4,6,0,39
514162,291624,2013-06-25,Assembly,"Do pass and be re-referred to the Committee on Health",12,0,0,1,13
514162,296106,2013-07-02,Assembly,"Do pass as amended and be re-referred to the Committee on 	Appropriations",14,2,0,3,19
514162,297862,2013-08-21,Assembly,"Do pass",15,0,0,2,17
514162,298014,2013-08-26,Assembly,"SB 598 Hill  Senate Third Reading  By PAN",60,4,0,14,78
514162,298732,2013-09-04,Senate,"Unfinished Business SB598 Hill Concurrence",30,2,7,0,39
514163,266523,2013-04-16,Senate,"Do pass, but re-refer to the Committee on Appropriations",5,0,0,0,5
514163,273652,2013-04-29,Senate,"Do pass",7,0,0,0,7
514163,276343,2013-05-06,Senate,"Senate 3rd Reading SB599 Evans",34,0,4,0,38
514163,289143,2013-06-17,Assembly,"Be referred to Committee on Water, Parks and Wildlife",9,0,0,2,11
514163,295908,2013-07-02,Assembly,"Do pass as amended and be re-referred to the Committee on 	Appropriations",14,0,0,1,15
514165,274282,2013-04-30,Senate,"Do pass, but re-refer to the Committee on Appropriations",11,0,0,0,11
514165,278979,2013-05-13,Senate,"Placed on Appropriations Suspense file",5,0,2,0,7
514165,283340,2013-05-23,Senate,"Do pass as amended",7,0,0,0,7
514165,285149,2013-05-29,Senate,"Senate 3rd Reading SB600 Lieu",39,0,0,0,39
514165,371299,2014-06-12,Assembly,"Be referred to Committee on Business, Professions and Consumer 	Protection",10,0,0,1,11
514165,374157,2014-06-24,Assembly,"Do pass as amended and be re-referred to the Committee on 	Appropriations",12,0,0,2,14
514165,376707,2014-08-06,Assembly,"Do pass, to Consent Calendar",17,0,0,0,17
514165,378577,2014-08-26,Assembly,"SB 600 Lieu  Senate Third Reading  By GRAY",77,0,0,2,79
514165,378841,2014-08-28,Senate,"From committee:  That the Assembly Amendments be concurred in",9,0,0,0,9
514165,379020,2014-08-29,Senate,"Unfinished Supp 1 SB600 Lieu Concurrence",35,0,5,0,40
514166,308661,2014-01-14,Senate,"Do pass, but re-refer to the Committee on Appropriations",6,0,4,0,10
514166,312242,2014-01-27,Senate,"Senate 3rd Reading SB601 Yee",32,0,7,0,39
514167,261919,2013-04-09,Senate,"Do pass as amended. To Consent Calendar",6,0,0,0,6
514167,268528,2013-04-18,Senate,"Consent Calendar 2nd SB602 Committee on HUMAN S. (Yee)",36,0,2,0,38
514167,289696,2013-06-18,Assembly,"Do pass, to Consent Calendar",7,0,0,0,7
514167,291685,2013-06-25,Assembly,"SB 602 HUMAN. S.  Consent Calendar Second Day  Regular Session",74,0,0,5,79
514168,277338,2013-05-07,Senate,"Do pass",4,1,2,0,7
514168,285000,2013-05-29,Senate,"Senate 3rd Reading SB603 Leno",13,18,8,0,39
514168,285001,2013-05-29,Senate,"Senate 3rd Reading SB603 Leno Reconsider",38,0,1,0,39
514169,266486,2013-04-16,Senate,"Do pass, but re-refer to the Committee on Appropriations",8,0,3,0,11
514169,285026,2013-05-29,Senate,"Senate 3rd Reading SB604 Anderson",38,1,0,0,39
514169,297195,2013-08-12,Assembly,"Do pass and be re-referred to the Committee on Appropriations",7,2,0,7,16
514171,275380,2013-05-01,Senate,"Do pass as amended, and re-refer to the Committee on 	Appropriations",7,2,0,0,9
514171,281290,2013-05-20,Senate,"Placed on Appropriations Suspense file",6,0,1,0,7
514171,283422,2013-05-23,Senate,"Do pass as amended",5,2,0,0,7
514171,285094,2013-05-29,Senate,"Senate 3rd Reading SB605 Lara",27,11,1,0,39
514171,297372,2013-08-12,Assembly,"Do pass and be re-referred to the Committee on Appropriations",6,3,0,0,9
514171,377302,2014-08-14,Assembly,"Do pass as amended",12,0,0,5,17
514171,377939,2014-08-20,Assembly,"SB 605 Lara  Senate Third Reading  By GARCIA",42,29,0,8,79
514171,379006,2014-08-29,Assembly,"SB 605 Lara  Senate Third Reading  By GARCIA",53,24,0,2,79
514171,379007,2014-08-29,Senate,"Unfinished Supp 3 SB605 Lara et al. Concurrence",23,12,5,0,40
514173,274737,2013-04-30,Senate,"Do pass as amended, and re-refer to the Committee on Appropriations",7,0,0,0,7
514173,283836,2013-05-24,Senate,"Senate 3rd Reading SB606 De Le",35,0,4,0,39
514173,291572,2013-06-25,Assembly,"Do pass as amended and be re-referred to the Committee on Judiciary",5,0,0,2,7
514173,297304,2013-08-13,Assembly,"Do pass and be re-referred to the Committee on Appropriations",10,0,0,0,10
514173,297845,2013-08-21,Assembly,"Do pass",14,0,0,3,17
514173,298580,2013-09-03,Assembly,"SB 606 De Leon  Senate Third Reading  By PEREZ, J",73,0,0,5,78
514173,298757,2013-09-06,Senate,"Unfinished Business SB606 De Le",36,0,3,0,39
514174,272177,2013-04-24,Senate,"Do pass, but re-refer to the Committee on Appropriations",1,3,1,0,5
514174,272178,2013-04-24,Senate,"Set, first hearing.  Failed passage in Committee.  Reconsideration 	granted",4,0,1,0,5
514176,261820,2013-04-09,Senate,"Do pass as amended, and re-refer to the Committee on Appropriations",6,0,0,0,6
514176,270074,2013-04-22,Senate,"Do pass",6,0,1,0,7
514176,273580,2013-04-29,Senate,"Special Consent #2 SB609 Wolk",37,0,1,0,38
514176,292128,2013-06-25,Assembly,"Do pass as amended and be re-referred to the Committee on 	Appropriations",7,0,0,0,7
514176,297455,2013-08-14,Assembly,"Do pass, to Consent Calendar",17,0,0,0,17
514176,298692,2013-09-03,Assembly,"SB 609 Wolk  Senate Third Reading  By BROWN",76,0,0,2,78
514176,298735,2013-09-04,Senate,"Unfinished Business SB609 Wolk Concurrence",38,0,1,0,39
514178,267526,2013-04-16,Senate,"Do pass",5,2,0,0,7
514178,284574,2013-05-28,Senate,"Senate 3rd Reading SB610 Jackson",22,12,5,0,39
514178,289419,2013-06-18,Assembly,"Do pass as amended and be re-referred to the Committee on Business, 	Professions and Consumer Protection",7,2,0,1,10
514178,374125,2014-06-24,Assembly,"Do pass as amended",10,2,0,2,14
514178,377228,2014-08-14,Assembly,"SB 610 Jackson  Senate Third Reading  By HOLDEN",41,28,0,10,79
514178,378036,2014-08-21,Senate,"Unfinished Business SB610 Jackson",23,9,8,0,40
514179,274292,2013-04-30,Senate,"Do pass, but re-refer to the Committee on Appropriations",3,1,7,0,11
514179,274293,2013-04-30,Senate,"Set, first hearing.  Failed passage in Committee.  Reconsideration 	granted",11,0,0,0,11
514179,275619,2013-05-02,Senate,"Do pass as amended, and re-refer to the Committee on Appropriations",9,0,2,0,11
514179,281269,2013-05-20,Senate,"Placed on Appropriations Suspense file",6,0,1,0,7
514179,283391,2013-05-23,Senate,"Do pass as amended",7,0,0,0,7
514179,285225,2013-05-29,Senate,"Senate 3rd Reading SB611 Hill",38,0,1,0,39
514179,291196,2013-06-24,Assembly,"Do pass as amended and be re-referred to the Committee on 	Appropriations",14,1,0,0,15
514179,298483,2013-08-30,Assembly,"Do pass as amended",16,1,0,0,17
514179,363402,2014-05-08,Assembly,"Be referred to Committee on Transportation",10,0,0,1,11
514179,370227,2014-06-09,Assembly,"Do pass and be re-referred to the Committee on Utilities and 	Commerce",16,0,0,0,16
514179,374062,2014-06-23,Assembly,"Do pass as amended and be re-referred to the Committee on 	Appropriations",15,0,0,0,15
514179,377319,2014-08-14,Assembly,"Do pass",16,1,0,0,17
514179,377885,2014-08-20,Assembly,"SB 611 Hill  Third Reading Urgency  By MULLIN",75,1,0,3,79
514179,378401,2014-08-25,Senate,"From committee:  That the Assembly Amendments be concurred in",8,0,3,0,11
514179,378593,2014-08-26,Senate,"Unfinished Business SB611 Hill Concurrence",34,0,6,0,40
514180,267308,2013-04-16,Senate,"Do pass as amended",7,0,0,0,7
514180,275527,2013-05-02,Senate,"Senate 3rd Reading SB612 Leno",38,0,0,0,38
514180,289361,2013-06-18,Assembly,"Do pass",9,0,0,1,10
514180,295465,2013-07-01,Assembly,"SB 612 Leno  Senate Third Reading  By WAGNER",72,0,0,6,78
514180,296205,2013-07-08,Senate,"Unfinished Business SB612 Leno Concurrence",29,0,9,0,38
514181,274087,2013-04-30,Senate,"Do pass",11,0,0,0,11
514181,276371,2013-05-06,Senate,"Senate 3rd Reading SB613 DeSaulnier",35,0,3,0,38
514181,295880,2013-07-01,Assembly,"Do pass",14,0,0,2,16
514181,297174,2013-08-08,Assembly,"SB 613 DeSaulnier  Senate Third Reading  By AMMIANO",75,0,0,3,78
514181,298676,2013-09-03,Assembly,"SB 613 DeSaulnier  Senate Third Reading  By AMMIANO",76,0,0,2,78
514181,298706,2013-09-04,Senate,"Unfinished Business SB613 DeSaulnier Concurrence",38,0,1,0,39
514183,259170,2013-04-03,Senate,"Do pass",4,2,1,0,7
514183,261001,2013-04-08,Senate,"Senate 3rd Reading SB614 Wolk",25,12,1,0,38
514183,371372,2014-06-12,Assembly,"Be referred to Committee on Local Government",10,0,0,1,11
514183,374573,2014-06-25,Assembly,"Do pass",7,2,0,0,9
514183,377991,2014-08-20,Assembly,"SB 614 Wolk  Senate Third Reading  By ALEJO",55,23,0,1,79
514183,378138,2014-08-21,Senate,"From committee:  That the Assembly Amendments be concurred in",5,0,2,0,7
514183,378408,2014-08-25,Senate,"Unfinished Business SB614 Wolk Concurrence",22,13,5,0,40
514184,272032,2013-04-24,Senate,"Do pass, but re-refer to the Committee on Appropriations",3,1,1,0,5
514184,276311,2013-05-06,Senate,"Placed on Appropriations Suspense file",7,0,0,0,7
514184,283273,2013-05-23,Senate,"Do pass",5,2,0,0,7
514184,285640,2013-05-30,Senate,"Senate 3rd Reading SB615 Galgiani",30,9,0,0,39
514184,292184,2013-06-26,Assembly,"Do pass and be re-referred to the Committee on Appropriations",6,1,0,0,7
514184,298356,2013-08-30,Assembly,"Do pass as amended",12,5,0,0,17
514184,299402,2013-09-11,Assembly,"SB 615 Galgiani  Senate Third Reading  By PAN",52,22,0,4,78
514184,299723,2013-09-12,Senate,"Unfinished Business SB615 Galgiani Concurrence",23,11,5,0,39
514185,308591,2014-01-14,Senate,"Do pass, but re-refer to the Committee on Appropriations",11,0,0,0,11
514185,310303,2014-01-21,Senate,"Placed on Appropriations Suspense file",5,0,2,0,7
514185,311155,2014-01-23,Senate,"Do pass as amended",6,0,1,0,7
514185,312698,2014-01-28,Senate,"Senate 3rd Reading SB616 Wright By Roth",34,0,5,0,39
514185,373778,2014-06-23,Assembly,"Do pass and re-refer to Committee on Appropriations with 	recommendation:  To Consent Calendar",13,0,0,3,16
514185,376676,2014-08-06,Assembly,"Do pass, to Consent Calendar",17,0,0,0,17
514185,377298,2014-08-14,Assembly,"SB 616 Roth  Consent Calendar Second Day  Regular Session",78,0,0,1,79
514185,377718,2014-08-18,Senate,"Unfinished Business SB616 Roth Concurrence",33,0,7,0,40
514186,274769,2013-05-01,Senate,"Do pass, but re-refer to the Committee on Appropriations",7,2,0,0,9
514186,278832,2013-05-13,Senate,"Placed on Appropriations Suspense file",5,0,2,0,7
514186,283181,2013-05-23,Senate,"Do pass as amended",5,2,0,0,7
514187,271544,2013-04-23,Senate,"Do pass, but re-refer to the Committee on Appropriations",6,1,0,0,7
514187,278971,2013-05-13,Senate,"Placed on Appropriations Suspense file",5,0,2,0,7
514187,283376,2013-05-23,Senate,"Do pass",5,2,0,0,7
514187,284966,2013-05-29,Senate,"Senate 3rd Reading SB618 Leno",28,10,1,0,39
514187,295824,2013-07-02,Assembly,"Do pass and be re-referred to the Committee on Appropriations",7,0,0,0,7
514187,298488,2013-08-30,Assembly,"Do pass as amended",12,0,0,5,17
514187,299552,2013-09-11,Assembly,"SB 618 Leno  Senate Third Reading  By DONNELLY",77,0,0,1,78
514187,299727,2013-09-12,Senate,"Unfinished Business SB618 Leno Concurrence",30,3,6,0,39
514189,259120,2013-04-03,Senate,"Do pass as amended, and re-refer to the Committee on Public 	Employment and Retirement",9,0,0,0,9
514189,270049,2013-04-22,Senate,"Do pass, but re-refer to the Committee on Appropriations",3,0,2,0,5
514189,278653,2013-05-13,Senate,"Placed on Appropriations Suspense file",5,0,2,0,7
514189,311139,2014-01-23,Senate,"Do pass",6,0,1,0,7
514189,312620,2014-01-28,Senate,"Senate 3rd Reading SB619 Yee",34,0,5,0,39
514190,267306,2013-04-17,Senate,"Do pass as amended",4,0,3,0,7
514190,285138,2013-05-29,Senate,"Senate 3rd Reading SB620 Wright",31,4,4,0,39
514190,291932,2013-06-26,Assembly,"Do pass as amended and be re-referred to the Committee on Water, 	Parks and Wildlife",9,0,0,0,9
514190,297400,2013-08-13,Assembly,"Do pass and be re-referred to the Committee on Appropriations",14,1,0,0,15
514190,297857,2013-08-21,Assembly,"Do pass",15,0,0,2,17
514190,299464,2013-09-11,Assembly,"Do pass as amended",9,0,0,0,9
514190,299695,2013-09-12,Assembly,"SB 620 Wright  Senate Third Reading  By RENDON",65,13,0,0,78
514190,299696,2013-09-12,Senate,"Unfinished Supp 2 SB620 Wright Concurrence",36,0,3,0,39
514191,262725,2013-04-09,Senate,"Do pass, but re-refer to the Committee on Rules",3,4,4,0,11
514191,262726,2013-04-09,Senate,"Set, first hearing.  Failed passage in Committee.  Reconsideration 	granted",10,0,1,0,11
514192,271533,2013-04-24,Senate,"Do pass, but re-refer to the Committee on Health",5,2,0,0,7
514192,275543,2013-05-01,Senate,"Do pass as amended, and re-refer to the Committee on 	Appropriations",7,2,0,0,9
514192,281283,2013-05-20,Senate,"Placed on Appropriations Suspense file",6,0,1,0,7
514199,267537,2013-04-17,Senate,"Do pass, but re-refer to the Committee on Transportation and 	Housing",5,2,0,0,7
514199,276796,2013-05-07,Senate,"Do pass as amended",7,3,1,0,11
514199,281350,2013-05-20,Senate,"Senate 3rd Reading SB628 Beall",24,11,4,0,39
514199,291874,2013-06-26,Assembly,"Do pass and be re-referred to the Committee on Housing and 	Community Development",6,3,0,0,9
514199,295947,2013-07-03,Assembly,"Do pass as amended",4,2,0,1,7
514199,297155,2013-08-08,Assembly,"SB 628 Beall  Senate Third Reading  By ALEJO",46,29,0,3,78
514199,297586,2013-08-15,Senate,"Unfinished Business SB628 Beall Concurrence",26,12,1,0,39
514199,376806,2014-08-07,Assembly,"SB 628 Beall  Senate Third Reading  By CHESBRO  Amend By CHESBRO 	Set #1",50,24,0,5,79
514199,378708,2014-08-27,Assembly,"Do pass",5,2,0,2,9
514199,379097,2014-08-29,Senate,"From committee:  That the Assembly Amendments be concurred in",4,2,1,0,7
514199,379098,2014-08-29,Assembly,"SB 628 Beall  Senate Third Reading  By DICKINSON",44,31,0,4,79
514199,379099,2014-08-30,Senate,"Unfinished Supp 4 SB628 Beall Concurrence",21,13,6,0,40
514201,259298,2013-04-03,Senate,"Do pass, but re-refer to the Committee on Appropriations",6,0,1,0,7
514201,265320,2013-04-15,Senate,"Placed on Appropriations Suspense file",7,0,0,0,7
514202,261673,2013-04-09,Senate,"Do pass, but re-refer to the Committee on Appropriations",7,2,0,0,9
514202,269957,2013-04-22,Senate,"Placed on Appropriations Suspense file",7,0,0,0,7
514202,283241,2013-05-23,Senate,"Do pass as amended",4,1,2,0,7
514202,285050,2013-05-29,Senate,"Senate 3rd Reading SB630 Pavley",39,0,0,0,39
514202,297280,2013-08-12,Assembly,"Do pass as amended and be re-referred to the Committee on 	Appropriations",9,0,0,0,9
514202,298232,2013-08-30,Assembly,"Do pass as amended",17,0,0,0,17
514202,298970,2013-09-09,Assembly,"SB 630 Pavley  Senate Third Reading  By PEREZ, J",74,0,0,4,78
514202,299188,2013-09-10,Senate,"Unfinished Business SB630 Pavley Concurrence",37,0,2,0,39
514205,274798,2013-05-01,Senate,"Do pass as amended, and re-refer to the Committee on 	Appropriations",8,0,1,0,9
514205,281582,2013-05-20,Senate,"Placed on Appropriations Suspense file",6,0,1,0,7
514205,283261,2013-05-23,Senate,"Do pass",7,0,0,0,7
514205,285555,2013-05-30,Senate,"Senate 3rd Reading SB633 Pavley",39,0,0,0,39
514205,295852,2013-07-01,Assembly,"Do pass as amended and be re-referred to the Committee on 	Appropriations",9,0,0,0,9
514205,377234,2014-08-14,Assembly,"Do pass",13,0,0,4,17
514205,377769,2014-08-19,Assembly,"SB 633 Pavley  Senate Third Reading  By RENDON",75,0,0,4,79
514205,378183,2014-08-21,Senate,"From committee:  That the Assembly Amendments be concurred in",7,0,2,0,9
514205,378268,2014-08-22,Senate,"Unfinished Business SB633 Pavley Concurrence",31,0,9,0,40
514207,272408,2013-04-24,Senate,"Do pass as amended, and re-refer to the Committee on Appropriations",8,0,1,0,9
514207,278976,2013-05-13,Senate,"Placed on Appropriations Suspense file",5,0,2,0,7
514208,270721,2013-04-23,Senate,"Do pass, but re-refer to the Committee on Appropriations",4,6,1,0,11
514208,270722,2013-04-23,Senate,"Set, second hearing.  Failed passage in Committee. 	Reconsideration granted",10,0,1,0,11
514209,258509,2013-04-03,Senate,"Do pass, but re-refer to the Committee on Appropriations",6,0,1,0,7
514209,281369,2013-05-20,Senate,"Placed on Appropriations Suspense file",6,0,1,0,7
514209,308587,2014-01-14,Senate,"Do pass, but re-refer to the Committee on Appropriations",8,0,3,0,11
514209,311142,2014-01-23,Senate,"Senate 3rd Reading SB636 Hill",33,0,6,0,39
514209,370159,2014-06-09,Assembly,"Do pass as amended and re-refer to Committee on Appropriations 	with recommendation:  To Consent Calendar",14,0,0,1,15
514209,376725,2014-08-06,Assembly,"Do pass, to Consent Calendar",17,0,0,0,17
514209,378226,2014-08-22,Assembly,"SB 636 Hill  Senate Third Reading  By DAHLE",76,0,0,3,79
514209,378396,2014-08-25,Senate,"Unfinished Business SB636 Hill Concurrence",30,0,10,0,40
514210,296006,2013-07-02,Senate,"Do pass, but re-refer to the Committee on Appropriations",4,1,0,0,5
514210,310375,2014-01-21,Senate,"Placed on Appropriations Suspense file",5,0,2,0,7
514213,267448,2013-04-17,Senate,"Do pass, but re-refer to the Committee on Appropriations",6,2,1,0,9
514213,276304,2013-05-06,Senate,"Placed on Appropriations Suspense file",7,0,0,0,7
514213,283112,2013-05-23,Senate,"Do pass as amended",5,2,0,0,7
514213,284973,2013-05-29,Senate,"Senate 3rd Reading SB639 Hernandez",28,11,0,0,39
514213,297348,2013-08-13,Assembly,"Do pass and be re-referred to the Committee on Appropriations",13,5,0,1,19
514213,298389,2013-08-30,Assembly,"Do pass as amended",12,5,0,0,17
514213,299236,2013-09-10,Assembly,"Do pass",12,3,0,4,19
514213,299725,2013-09-12,Assembly,"SB 639 Hernandez  Senate Third Reading  By ATKINS",52,26,0,0,78
514213,299726,2013-09-12,Senate,"Unfinished Supp 2 SB639 Hernandez Concurrence",26,12,1,0,39
514214,272243,2013-04-24,Senate,"Do pass as amended, and re-refer to the Committee on 	Appropriations",8,0,1,0,9
514214,278720,2013-05-13,Senate,"Placed on Appropriations Suspense file",5,0,2,0,7
514215,271495,2013-04-24,Senate,"Do pass, but re-refer to the Committee on Appropriations",6,0,1,0,7
514215,310443,2014-01-21,Senate,"Placed on Appropriations Suspense file",5,0,2,0,7
514219,274750,2013-04-30,Senate,"Do pass as amended, and re-refer to the Committee on Appropriations",7,0,0,0,7
514219,281163,2013-05-20,Senate,"Placed on Appropriations Suspense file",6,0,1,0,7
514220,267569,2013-04-17,Senate,"Do pass, but re-refer to the Committee on Appropriations",7,0,2,0,9
514220,276329,2013-05-06,Senate,"Placed on Appropriations Suspense file",7,0,0,0,7
514221,272397,2013-04-24,Senate,"Do pass as amended, and re-refer to the Committee on 	Appropriations",8,0,1,0,9
514221,279032,2013-05-13,Senate,"Placed on Appropriations Suspense file",5,0,2,0,7
514224,267245,2013-04-17,Senate,"Do pass, but re-refer to the Committee on Judiciary",6,2,1,0,9
514224,274684,2013-04-30,Senate,"Do pass as amended, and re-refer to the Committee on 	Appropriations",4,2,1,0,7
514224,283863,2013-05-24,Senate,"Senate 3rd Reading SB648 Corbett",21,10,8,0,39
514224,374399,2014-06-25,Assembly,"Do pass as amended and be re-referred to the Committee on 	Appropriations",16,0,0,3,19
514224,376665,2014-08-06,Assembly,"Do pass",3,2,0,12,17
514224,376666,2014-08-06,Assembly,"Set first hearing.  Failed passage.  Reconsideration granted",17,0,0,0,17
514225,271536,2013-04-23,Senate,"Do pass",5,2,0,0,7
514225,275564,2013-05-02,Senate,"Senate 3rd Reading SB649 Leno",23,14,1,0,38
514225,288041,2013-06-11,Assembly,"Do pass",5,2,0,0,7
514225,298699,2013-09-04,Assembly,"SB 649 Leno  Senate Third Reading  By ATKINS",41,31,0,6,78
514225,299153,2013-09-10,Senate,"Unfinished Business SB649 Leno Concurrence",24,14,1,0,39
514226,309017,2014-01-14,Senate,"Do pass as amended. To Consent Calendar",6,0,1,0,7
514226,311117,2014-01-23,Senate,"Consent Calendar 2nd SB650 Lieu",33,0,6,0,39
514226,370428,2014-06-10,Assembly,"Do pass and be re-referred to the Committee on Arts, Entertain, 	Sports, Tourism, & Internet Media to Consent Calendar",9,0,0,1,10
514226,374185,2014-06-24,Assembly,"Do pass, to Consent Calendar",7,0,0,0,7
514226,375310,2014-06-30,Assembly,"SB 650 Lieu  Consent Calendar Second Day",78,0,0,1,79
514227,261707,2013-04-09,Senate,"Do pass as amended, but re-refer to the Committee on Health 	Recommend Consent",6,0,0,0,6
514227,275770,2013-05-01,Senate,"Do pass, but re-refer to the Committee on Appropriations Recommend 	Consent",9,0,0,0,9
514227,280252,2013-05-16,Senate,"Consent Calendar 2nd SB651 Pavley",37,0,1,0,38
514227,289619,2013-06-18,Assembly,"Do pass and be re-referred to the Committee on Health",7,0,0,0,7
514227,296167,2013-07-02,Assembly,"Do pass as amended and be re-referred to the Committee on 	Appropriations",19,0,0,0,19
514227,297453,2013-08-14,Assembly,"Do pass, to Consent Calendar",17,0,0,0,17
514227,299233,2013-09-10,Assembly,"SB 651 Pavley  Senate Third Reading  By YAMADA",78,0,0,0,78
514227,299363,2013-09-11,Senate,"Unfinished Business SB651 Pavley Concurrence",39,0,0,0,39
514228,277396,2013-05-07,Senate,"Do pass",6,0,1,0,7
514228,281327,2013-05-20,Senate,"Special Consent #5 SB652 DeSaulnier",36,0,3,0,39
514228,291607,2013-06-25,Assembly,"Do pass as amended, to Consent Calendar",10,0,0,0,10
514228,298670,2013-09-03,Assembly,"SB 652 DeSaulnier  Senate Third Reading  By WIECKOWSKI",76,0,0,2,78
514228,298749,2013-09-04,Senate,"Unfinished Business SB652 DeSaulnier Concurrence",38,0,1,0,39
514230,258185,2013-04-02,Senate,"Do pass",2,3,2,0,7
514231,274819,2013-04-30,Senate,"Do pass, but re-refer to the Committee on Appropriations",4,1,0,0,5
514231,279042,2013-05-13,Senate,"Placed on Appropriations Suspense file",5,0,2,0,7
514231,283322,2013-05-23,Senate,"Do pass as amended",5,2,0,0,7
514231,285169,2013-05-29,Senate,"Senate 3rd Reading SB654 Leno",28,9,2,0,39
514231,291652,2013-06-25,Assembly,"Do pass and be re-referred to the Committee on Appropriations",5,2,0,0,7
514231,298394,2013-08-30,Assembly,"Do pass as amended",12,5,0,0,17
514231,299475,2013-09-11,Assembly,"SB 654 Leno  Senate Third Reading  By BOCANEGRA",52,25,0,1,78
514231,299704,2013-09-12,Senate,"Unfinished Business SB654 Leno Concurrence",24,12,3,0,39
514232,271506,2013-04-23,Senate,"Do pass",5,1,1,0,7
514232,285823,2013-05-30,Senate,"Senate 3rd Reading SB655 Wright",21,13,5,0,39
514232,297315,2013-08-13,Assembly,"Do pass",7,3,0,0,10
514232,299473,2013-09-11,Assembly,"SB 655 Wright  Senate Third Reading  By BONTA",52,26,0,0,78
514232,299677,2013-09-12,Senate,"Unfinished Business SB655 Wright Concurrence",22,11,6,0,39
514233,274243,2013-04-30,Senate,"Do pass, but re-refer to the Committee on Appropriations",11,0,0,0,11
514233,280259,2013-05-16,Senate,"Senate 3rd Reading SB656 Wright",37,0,1,0,38
514233,295849,2013-07-01,Assembly,"Do pass as amended and be re-referred to the Committee on 	Appropriations",13,0,0,2,15
514233,298495,2013-08-30,Assembly,"Do pass as amended",15,0,0,2,17
514233,299357,2013-09-11,Assembly,"SB 656 Wright  Senate Third Reading  By BRADFORD",75,0,0,3,78
514233,299720,2013-09-12,Senate,"From committee:  That the Assembly Amendments be concurred in",7,0,4,0,11
514233,299721,2013-09-12,Senate,"Unfinished Business SB656 Wright Concurrence",33,0,6,0,39
514237,274832,2013-05-01,Senate,"Do pass",6,2,1,0,9
514238,274725,2013-05-01,Senate,"Do pass as amended, and re-refer to the Committee on 	Appropriations",8,1,0,0,9
514238,281271,2013-05-20,Senate,"Placed on Appropriations Suspense file",6,0,1,0,7
514239,275533,2013-05-01,Senate,"Do pass, but re-refer to the Committee on Appropriations",8,1,0,0,9
514239,278776,2013-05-13,Senate,"Placed on Appropriations Suspense file",5,0,2,0,7
514239,283268,2013-05-23,Senate,"Do pass as amended",5,2,0,0,7
514239,285077,2013-05-29,Senate,"Senate 3rd Reading SB660 Hancock",36,2,1,0,39
514240,309041,2014-01-14,Senate,"Do pass",1,4,2,0,7
514241,270051,2013-04-22,Senate,"Do pass, but re-refer to the Committee on Appropriations",8,0,2,0,10
514241,278075,2013-05-09,Senate,"Senate 3rd Reading SB662 Galgiani",27,8,3,0,38
514241,288032,2013-06-11,Assembly,"Do pass and be re-referred to the Committee on Appropriations",9,3,0,1,13
514241,296119,2013-07-03,Assembly,"Do pass",13,3,0,1,17
514241,297938,2013-08-22,Assembly,"SB 662 Galgiani  Senate Third Reading  By GORDON",53,22,0,3,78
514243,308692,2014-01-14,Senate,"Do pass as amended, and re-refer to the Committee on Appropriations",6,0,1,0,7
514243,311143,2014-01-23,Senate,"Placed on Appropriations Suspense file",6,0,1,0,7
514243,311144,2014-01-23,Senate,"Do pass as amended",6,0,1,0,7
514243,312727,2014-01-28,Senate,"Senate 3rd Reading SB663 Lara",34,0,5,0,39
514243,373770,2014-06-23,Assembly,"Be referred to Committee on Local Government",7,0,0,4,11
514243,374276,2014-06-25,Assembly,"Do pass as amended and be re-referred to the Committee on 	Appropriations",9,0,0,0,9
514244,272371,2013-04-24,Senate,"Do pass",7,2,0,0,9
514245,270784,2013-04-23,Senate,"Do pass as amended, and re-refer to the Committee on Appropriations",7,2,0,0,9
514245,284515,2013-05-28,Senate,"Senate 3rd Reading SB665 Wolk",26,12,1,0,39
514245,297307,2013-08-12,Assembly,"Do pass and be re-referred to the Committee on Appropriations",6,3,0,0,9
514245,297849,2013-08-21,Assembly,"Do pass",12,5,0,0,17
514245,298590,2013-09-03,Assembly,"SB 665 Wolk  Senate Third Reading  By CHESBRO",32,30,0,16,78
514245,298769,2013-09-06,Assembly,"SB 665 Wolk  Senate Third Reading  By CHESBRO",51,25,0,2,78
514245,299209,2013-09-10,Senate,"Unfinished Business SB665 Wolk Concurrence",32,6,1,0,39
514246,272126,2013-04-24,Senate,"Do pass, but re-refer to the Committee on Judiciary",4,0,1,0,5
514246,274836,2013-04-30,Senate,"Do pass as amended, and re-refer to the Committee on 	Appropriations",6,1,0,0,7
514246,281414,2013-05-20,Senate,"Placed on Appropriations Suspense file",6,0,1,0,7
514246,283384,2013-05-23,Senate,"Do pass",5,2,0,0,7
514246,284609,2013-05-28,Senate,"Senate 3rd Reading SB666 Steinberg",31,7,1,0,39
514246,289482,2013-06-18,Assembly,"Do pass and be re-referred to the Committee on Labor and Employment",7,0,0,3,10
514246,292236,2013-06-26,Assembly,"Do pass and be re-referred to the Committee on Appropriations",7,0,0,0,7
514246,297839,2013-08-21,Assembly,"Do pass as amended",12,1,0,4,17
514246,299090,2013-09-09,Assembly,"SB 666 Steinberg  Senate Third Reading  By HERNANDEZ",52,17,0,9,78
514246,299241,2013-09-10,Senate,"Unfinished Business SB666 Steinberg",32,2,5,0,39
514247,267211,2013-04-17,Senate,"Do pass, but re-refer to the Committee on Appropriations",7,1,1,0,9
514247,275727,2013-05-02,Senate,"Senate 3rd Reading SB667 Roth",32,3,3,0,38
514247,296086,2013-07-03,Assembly,"Be referred to Committee on Agriculture",10,0,0,1,11
514247,297502,2013-08-14,Assembly,"Do pass",7,0,0,0,7
514247,298059,2013-08-26,Assembly,"SB 667 Roth  Senate Third Reading  By EGGMAN",76,1,0,1,78
514247,298734,2013-09-04,Senate,"From committee:  That the Assembly Amendments be concurred in",9,0,1,0,10
514247,298811,2013-09-06,Senate,"Unfinished Business SB667 Roth Concurrence",37,0,2,0,39
514249,273567,2013-04-29,Senate,"Senate 3rd Reading SB668 Fuller",37,0,1,0,38
514249,295502,2013-07-01,Assembly,"SB 668 Fuller  Third Reading Urgency  By CONWAY",70,0,0,8,78
514249,295969,2013-07-03,Senate,"Unfinished Business SB668 Fuller Urgency Clause",37,0,1,0,38
514250,267330,2013-04-17,Senate,"Do pass as amended, and re-refer to the Committee on Judiciary",8,0,1,0,9
514250,274757,2013-04-30,Senate,"Do pass as amended, and re-refer to the Committee on 	Appropriations",7,0,0,0,7
514250,281180,2013-05-20,Senate,"Placed on Appropriations Suspense file",6,0,1,0,7
514250,283075,2013-05-23,Senate,"Do pass as amended",7,0,0,0,7
514250,285069,2013-05-29,Senate,"Senate 3rd Reading SB669 Huff",38,0,1,0,39
514250,295805,2013-07-02,Assembly,"Do pass as amended and be re-referred to the Committee on Judiciary",13,0,0,0,13
514250,297234,2013-08-13,Assembly,"Do pass and re-refer to Committee on Appropriations with 	recommendation:  To Consent Calendar",10,0,0,0,10
514250,298320,2013-08-30,Assembly,"Do pass as amended",17,0,0,0,17
514250,298916,2013-09-09,Assembly,"SB 669 Huff  Senate Third Reading  By MAIENSCHEIN",77,0,0,1,78
514250,299121,2013-09-10,Senate,"Unfinished Business SB669 Huff Concurrence",37,0,2,0,39
514251,266427,2013-04-15,Senate,"Do pass, but re-refer to the Committee on Appropriations",8,0,2,0,10
514251,273608,2013-04-29,Senate,"Do pass",7,0,0,0,7
514251,285151,2013-05-29,Senate,"Senate 3rd Reading SB670 Steinberg",35,3,1,0,39
514251,297376,2013-08-13,Assembly,"Do pass and be re-referred to the Committee on Appropriations",8,4,0,2,14
514251,297867,2013-08-21,Assembly,"Do pass",11,5,0,1,17
514251,299264,2013-09-10,Assembly,"SB 670 Steinberg  Senate Third Reading  By DICKINSON",12,44,0,22,78
514251,299485,2013-09-11,Assembly,"Do pass as amended",11,0,0,3,14
514251,299710,2013-09-12,Senate,"Unfinished Supp 2 SB670 Steinberg Concurrence",38,0,1,0,39
514251,299711,2013-09-12,Assembly,"SB 670 Steinberg  Senate Third Reading  By DICKINSON",77,0,0,1,78
514254,261831,2013-04-09,Senate,"Do pass as amended, and re-refer to the Committee on Appropriations",6,0,0,0,6
514254,270056,2013-04-22,Senate,"Placed on Appropriations Suspense file",7,0,0,0,7
514254,283370,2013-05-23,Senate,"Do pass as amended",5,2,0,0,7
514254,285141,2013-05-29,Senate,"Senate 3rd Reading SB672 Leno",33,6,0,0,39
514254,297474,2013-08-13,Assembly,"Do pass and be re-referred to the Committee on Appropriations",5,2,0,0,7
514254,297882,2013-08-21,Assembly,"Do pass",12,5,0,0,17
514254,298697,2013-09-03,Assembly,"SB 672 Leno  Senate Third Reading  By STONE",54,23,0,1,78
514254,298742,2013-09-04,Senate,"Unfinished Business SB672 Leno Concurrence",30,8,1,0,39
514255,271507,2013-04-24,Senate,"Do pass, but re-refer to the Committee on Appropriations",4,2,1,0,7
514255,285234,2013-05-29,Senate,"Senate 3rd Reading SB673 DeSaulnier",18,18,3,0,39
514255,285235,2013-05-29,Senate,"Senate 3rd Reading SB673 DeSaulnier Reconsider",38,0,1,0,39
514255,308316,2014-01-13,Senate,"Do pass",5,0,0,0,5
514255,312684,2014-01-28,Senate,"Senate 3rd Reading SB673 DeSaulnier",34,0,5,0,39
514255,374737,2014-06-25,Assembly,"Do pass",7,0,0,0,7
514255,376837,2014-08-07,Assembly,"SB 673 DeSaulnier  Senate Third Reading  By BONILLA",75,1,0,3,79
514256,308980,2014-01-15,Senate,"Do pass, but re-refer to the Committee on Appropriations Recommend 	Consent",7,0,1,0,8
514256,311260,2014-01-23,Senate,"Senate 3rd Reading SB674 Corbett",33,0,6,0,39
514256,372162,2014-06-16,Assembly,"Do pass and be re-referred to the Committee on Local Government",9,0,0,0,9
514256,374581,2014-06-25,Assembly,"Do pass and be re-referred to the Committee on Appropriations",9,0,0,0,9
514256,376733,2014-08-06,Assembly,"Do pass, to Consent Calendar",17,0,0,0,17
514256,377230,2014-08-14,Assembly,"SB 674 Corbett  Consent Calendar Second Day  Regular Session",78,0,0,1,79
514258,260939,2013-04-08,Senate,"Do pass, but re-refer to the Committee on Appropriations",10,0,0,0,10
514258,273569,2013-04-29,Senate,"Do pass as amended, and re-refer to the Committee on Appropriations",10,0,0,0,10
514258,284611,2013-05-28,Senate,"Special Consent #6 SB676 Block",39,0,0,0,39
514258,291559,2013-06-25,Assembly,"Do pass and be re-referred to the Committee on Banking and Finance 	to Consent Calendar",13,0,0,0,13
514258,297070,2013-08-05,Assembly,"Do pass and be re-referred to the Committee on Appropriations",9,0,0,1,10
514258,297876,2013-08-21,Assembly,"Do pass, to Consent Calendar",17,0,0,0,17
514258,298669,2013-09-03,Assembly,"SB 676 Block  Senate Third Reading  By DICKINSON",76,0,0,2,78
514258,298746,2013-09-04,Senate,"Unfinished Business SB676 Block Concurrence",38,0,1,0,39
514262,266586,2013-04-15,Senate,"Do pass, but re-refer to the Committee on Appropriations",10,0,0,0,10
514262,276314,2013-05-06,Senate,"Special Consent #3 SB679 Berryhill",32,0,6,0,38
514262,288072,2013-06-11,Assembly,"Do pass as amended and be re-referred to the Committee on Judiciary",11,0,0,2,13
514262,295858,2013-07-02,Assembly,"Do pass and re-refer to Committee on Appropriations with 	recommendation:  To Consent Calendar",10,0,0,0,10
514262,297500,2013-08-14,Assembly,"Do pass, to Consent Calendar",17,0,0,0,17
514262,297968,2013-08-22,Assembly,"SB 679 Berryhill, T.  Consent Calendar Second Day  Regular Session",78,0,0,0,78
514262,298476,2013-08-30,Senate,"Special Consent #9 SB679 Berryhill",38,0,1,0,39
514263,277830,2013-05-07,Senate,"Do pass as amended",6,0,1,0,7
514263,281399,2013-05-20,Senate,"Special Consent #5 SB680 Wolk",36,0,3,0,39
514263,291684,2013-06-25,Assembly,"Do pass",10,0,0,0,10
514263,297062,2013-08-05,Assembly,"SB 680 Wolk  Senate Third Reading  By WIECKOWSKI",72,0,0,6,78
514264,275642,2013-05-01,Senate,"Do pass and be placed on the Consent Calendar",9,0,0,0,9
514264,277997,2013-05-09,Senate,"Consent Calendar 2nd SB681 Hernandez",34,0,4,0,38
514264,297076,2013-08-06,Assembly,"Do pass",11,1,0,1,13
514264,298645,2013-09-03,Assembly,"SB 681 Hernandez  Senate Third Reading  By CALDERON",72,4,0,2,78
514266,277465,2013-05-08,Senate,"Do pass as amended",8,0,1,0,9
514266,284004,2013-05-24,Senate,"Senate 3rd Reading SB682 Lara",36,0,3,0,39
514266,370373,2014-06-09,Assembly,"Be referred to Committee on Higher Education",10,0,0,1,11
514267,267392,2013-04-16,Senate,"Do pass, but re-refer to the Committee on Appropriations",5,2,0,0,7
514267,276243,2013-05-06,Senate,"Placed on Appropriations Suspense file",7,0,0,0,7
514267,283217,2013-05-23,Senate,"Do pass as amended",5,2,0,0,7
514267,284964,2013-05-29,Senate,"Special Order SB683 Block",28,11,0,0,39
514267,297260,2013-08-13,Assembly,"Do pass and be re-referred to the Committee on Appropriations",4,2,0,1,7
514267,298188,2013-08-30,Assembly,"Do pass as amended",11,5,0,1,17
514267,298971,2013-09-09,Assembly,"SB 683 Block  Senate Third Reading  By STONE",46,30,0,2,78
514267,299191,2013-09-10,Senate,"Unfinished Business SB683 Block Concurrence",25,11,3,0,39
514268,274129,2013-04-30,Senate,"Do pass, but re-refer to the Committee on Appropriations",10,0,1,0,11
514268,281346,2013-05-20,Senate,"Senate 3rd Reading SB684 Hill Urgency Clause",34,0,5,0,39
514268,297085,2013-08-07,Assembly,"Do pass and be re-referred to the Committee on Housing and 	Community Development",15,0,0,2,17
514268,297189,2013-08-12,Assembly,"Do pass as amended and be re-referred to the Committee on 	Appropriations",7,0,0,0,7
514268,297836,2013-08-21,Assembly,"Do pass, to Consent Calendar",17,0,0,0,17
514268,299156,2013-09-10,Assembly,"SB 684 Hill  Third Reading Urgency  By HALL",78,0,0,0,78
514268,299342,2013-09-11,Senate,"Unfinished Business SB684 Hill Concurrence",39,0,0,0,39
514270,274813,2013-04-30,Senate,"Do pass as amended, and re-refer to the Committee on 	Appropriations",4,2,1,0,7
514270,281272,2013-05-20,Senate,"Placed on Appropriations Suspense file",6,0,1,0,7
514270,283194,2013-05-23,Senate,"Do pass",4,3,0,0,7
514270,285179,2013-05-29,Senate,"Senate 3rd Reading SB686 Jackson",22,12,5,0,39
514270,372174,2014-06-17,Assembly,"Do pass and be re-referred to the Committee on Judiciary",3,4,0,7,14
514270,372175,2014-06-17,Assembly,"Set first hearing.  Failed passage.  Reconsideration granted",14,0,0,0,14
514273,277406,2013-05-08,Senate,"Do pass as amended, and re-refer to the Committee on 	Appropriations",7,0,0,0,7
514273,281280,2013-05-20,Senate,"Placed on Appropriations Suspense file",6,0,1,0,7
514276,258758,2013-04-03,Senate,"Do pass, but re-refer to the Committee on Judiciary",6,2,1,0,9
514276,277602,2013-05-07,Senate,"Do pass",5,1,1,0,7
514276,285198,2013-05-29,Senate,"Senate 3rd Reading SB691 Hancock",22,15,2,0,39
514276,297319,2013-08-12,Assembly,"Do pass",6,3,0,0,9
514278,267191,2013-04-17,Senate,"Do pass as amended",7,0,0,0,7
514278,273548,2013-04-29,Senate,"Special Consent #2 SB692 Hancock",37,0,1,0,38
514278,288556,2013-06-12,Assembly,"Do pass",9,0,0,0,9
514278,297739,2013-08-19,Assembly,"SB 692 Hancock  Senate Third Reading  By ACHADJIAN",72,3,0,3,78
514278,297946,2013-08-22,Senate,"Unfinished Business SB692 Hancock",37,0,2,0,39
514279,309071,2014-01-15,Senate,"Do pass, but re-refer to the Committee on Appropriations",6,0,0,0,6
514279,310408,2014-01-21,Senate,"Placed on Appropriations Suspense file",5,0,2,0,7
514280,274179,2013-04-30,Senate,"Do pass as amended, and re-refer to the Committee on 	Appropriations",10,1,0,0,11
514280,284653,2013-05-28,Senate,"Senate 3rd Reading SB694 Correa",34,3,2,0,39
514280,291878,2013-06-26,Assembly,"Do pass and be re-referred to the Committee on Appropriations",10,1,0,6,17
514280,297512,2013-08-14,Assembly,"Do pass",16,1,0,0,17
514280,298870,2013-09-06,Assembly,"SB 694 Correa  Senate Third Reading  By WAGNER",65,7,0,6,78
514280,299270,2013-09-10,Senate,"Unfinished Business SB694 Correa Concurrence",31,7,1,0,39
514281,261830,2013-04-09,Senate,"Do pass, but re-refer to the Committee on Natural Resources and 	Water",11,0,0,0,11
514281,270848,2013-04-23,Senate,"Do pass, but re-refer to the Committee on Appropriations",9,0,0,0,9
514281,278189,2013-05-09,Senate,"Senate 3rd Reading SB695 Wright Urgency Clause",34,0,4,0,38
514281,296132,2013-07-03,Assembly,"Do pass and be re-referred to the Committee on Arts, Entertain, 	Sports, Tourism, & Internet Media",4,0,0,3,7
514281,297384,2013-08-13,Assembly,"Do pass and be re-referred to the Committee on Appropriations",5,0,0,2,7
514281,298332,2013-08-30,Assembly,"Do pass",12,0,0,5,17
514281,298730,2013-09-04,Assembly,"SB 695 Wright  Third Reading Urgency  By JONES-SAWYER",59,2,0,17,78
514281,298904,2013-09-06,Senate,"Unfinished Business SB695 Wright Concurrence",36,1,2,0,39
514282,262761,2013-04-10,Senate,"Do pass as amended, and re-refer to the Committee on Appropriations",9,0,0,0,9
514282,276338,2013-05-06,Senate,"Placed on Appropriations Suspense file",7,0,0,0,7
514286,274205,2013-04-30,Senate,"Do pass as amended, and re-refer to the Committee on Appropriations",10,1,0,0,11
514286,284563,2013-05-28,Senate,"Senate 3rd Reading SB699 Hill",36,3,0,0,39
514286,343921,2014-03-17,Assembly,"Do pass as amended and be re-referred to the Committee on 	Appropriations",14,0,0,1,15
514286,377355,2014-08-14,Assembly,"Do pass as amended",17,0,0,0,17
514286,378546,2014-08-26,Assembly,"SB 699 Hill  Senate Third Reading  By GATTO",78,0,0,1,79
514286,378851,2014-08-28,Senate,"From committee:  That the Assembly Amendments be concurred in",7,0,4,0,11
514286,379100,2014-08-29,Senate,"Unfinished Business SB699 Hill Concurrence",37,0,3,0,40
514287,261722,2013-04-09,Senate,"Do pass as amended, and re-refer to the Committee on Environmental 	Quality",6,2,1,0,9
514287,274701,2013-05-01,Senate,"Do pass, but re-refer to the Committee on Appropriations",6,3,0,0,9
514287,278587,2013-05-13,Senate,"Placed on Appropriations Suspense file",5,0,2,0,7
514290,277809,2013-05-07,Senate,"Do pass as amended",6,0,1,0,7
514290,281312,2013-05-20,Senate,"Special Consent #5 SB702 Anderson",36,0,3,0,39
514290,371345,2014-06-12,Assembly,"Be referred to Committee on Public Safety",10,0,0,1,11
514290,374140,2014-06-24,Assembly,"Do pass as amended and be re-referred to the Committee on 	Appropriations",7,0,0,0,7
514290,376693,2014-08-06,Assembly,"Do pass, to Consent Calendar",17,0,0,0,17
514290,377297,2014-08-14,Assembly,"SB 702 Anderson  Consent Calendar Second Day  Regular Session",78,0,0,1,79
514290,377658,2014-08-18,Senate,"Unfinished Business SB702 Anderson Concurrence",35,0,5,0,40
514293,275512,2013-05-01,Senate,"Do pass, but re-refer to the Committee on Appropriations",7,0,2,0,9
514293,278857,2013-05-13,Senate,"Placed on Appropriations Suspense file",5,0,2,0,7
514295,274955,2013-04-30,Senate,"Do pass, but re-refer to the Committee on Appropriations",2,5,0,0,7
514297,271537,2013-04-23,Senate,"Do pass as amended, and re-refer to the Committee on Appropriations",2,5,0,0,7
514297,271538,2013-04-23,Senate,"Set, first hearing.  Failed passage in Committee.  Reconsideration 	granted",7,0,0,0,7
514299,272158,2013-04-23,Senate,"Do pass as amended, and re-refer to the Committee on Appropriations",2,5,0,0,7
514299,272159,2013-04-23,Senate,"Set, first hearing.  Failed passage in Committee.  Reconsideration 	granted",7,0,0,0,7
514302,308585,2014-01-14,Senate,"Do pass, but re-refer to the Committee on Appropriations",6,0,5,0,11
514302,312257,2014-01-27,Senate,"Senate 3rd Reading SB711 Padilla",32,2,5,0,39
514303,309023,2014-01-15,Senate,"Do pass as amended, and re-refer to the Committee on 	Appropriations",8,0,0,0,8
514303,310348,2014-01-21,Senate,"Do pass",5,0,2,0,7
514303,311122,2014-01-23,Senate,"Senate 3rd Reading SB712 Lara",33,0,6,0,39
514303,372289,2014-06-17,Assembly,"Do pass as amended and be re-referred to the Committee on 	Appropriations",7,0,0,0,7
514303,376671,2014-08-06,Assembly,"Do pass, to Consent Calendar",17,0,0,0,17
514303,377254,2014-08-14,Assembly,"SB 712 Lara  Consent Calendar Second Day  Regular Session",78,0,0,1,79
514303,378322,2014-08-25,Senate,"Unfinished Business SB712 Lara Concurrence",35,0,5,0,40
514305,272390,2013-04-24,Senate,"Do pass as amended, and re-refer to the Committee on Appropriations",9,0,0,0,9
514305,281339,2013-05-20,Senate,"Placed on Appropriations Suspense file",6,0,1,0,7
514305,283105,2013-05-23,Senate,"Do pass as amended",7,0,0,0,7
514305,284583,2013-05-28,Senate,"Senate 3rd Reading SB714 Block",39,0,0,0,39
514308,274771,2013-04-30,Senate,"Do pass, but re-refer to the Committee on Appropriations",7,0,0,0,7
514308,278826,2013-05-13,Senate,"Placed on Appropriations Suspense file",5,0,2,0,7
514308,283097,2013-05-23,Senate,"Do pass as amended",7,0,0,0,7
514308,284976,2013-05-29,Senate,"Senate 3rd Reading SB716 Lara",39,0,0,0,39
514308,297267,2013-08-13,Assembly,"Do pass and be re-referred to the Committee on Appropriations",4,0,0,3,7
514309,274781,2013-04-30,Senate,"Do pass, but re-refer to the Committee on Appropriations",7,0,0,0,7
514309,284518,2013-05-28,Senate,"Senate 3rd Reading SB717 DeSaulnier Urgency Clause",39,0,0,0,39
514309,291735,2013-06-25,Assembly,"Do pass",7,0,0,0,7
514309,298648,2013-09-03,Assembly,"SB 717 DeSaulnier  Third Reading Urgency  By BONTA",74,0,0,4,78
514309,298736,2013-09-04,Senate,"Unfinished Business SB717 DeSaulnier Concurrence",38,0,1,0,39
514310,267603,2013-04-17,Senate,"Do pass, but re-refer to the Committee on Labor and Industrial 	Relations",5,2,2,0,9
514310,271524,2013-04-24,Senate,"Do pass, but re-refer to the Committee on Appropriations",3,1,1,0,5
514310,278686,2013-05-13,Senate,"Do pass as amended",5,0,2,0,7
514310,281324,2013-05-20,Senate,"Senate 3rd Reading SB718 Yee",21,13,5,0,39
514310,289434,2013-06-18,Assembly,"Do pass as amended and be re-referred to the Committee on 	Appropriations",13,6,0,0,19
514310,298503,2013-08-30,Assembly,"Do pass as amended",12,5,0,0,17
514310,376924,2014-08-11,Assembly,"Do pass",7,0,0,2,9
514310,376925,2014-08-11,Assembly,"SB 718 Roth  Third Reading Urgency  By MURATSUCHI",75,0,0,4,79
514310,377019,2014-08-12,Senate,"From committee:  That the Assembly Amendments be concurred in",7,0,0,0,7
514310,377078,2014-08-13,Senate,"Unfinished Business SB718 Roth Urgency Clause",32,4,4,0,40
514311,270987,2013-04-23,Senate,"Do pass, but re-refer to the Committee on Appropriations",7,0,0,0,7
514311,276309,2013-05-06,Senate,"Placed on Appropriations Suspense file",7,0,0,0,7
514311,283088,2013-05-23,Senate,"Do pass",7,0,0,0,7
514311,284642,2013-05-28,Senate,"Senate 3rd Reading SB719 Correa",39,0,0,0,39
514311,296104,2013-07-02,Assembly,"Do pass and be re-referred to the Committee on Appropriations",9,0,0,1,10
514311,296105,2013-07-02,Assembly,"Do pass and be re-referred to the Committee on Appropriations",9,0,0,1,10
514312,270995,2013-04-23,Senate,"Do pass, but re-refer to the Committee on Judiciary",7,0,0,0,7
514312,274716,2013-04-30,Senate,"Do pass as amended, but re-refer to the Committee on 	Appropriations Recommend Consent",7,0,0,0,7
514312,284584,2013-05-28,Senate,"Senate 3rd Reading SB720 Correa",38,0,1,0,39
514312,291576,2013-06-25,Assembly,"Do pass and be re-referred to the Committee on Veterans Affairs to 	Consent Calendar",10,0,0,0,10
514312,296017,2013-07-02,Assembly,"Do pass and be re-referred to the Committee on Appropriations",9,0,0,1,10
514312,297463,2013-08-14,Assembly,"Do pass, to Consent Calendar",17,0,0,0,17
514312,297916,2013-08-22,Assembly,"SB 720 Correa  Consent Calendar Second Day  Regular Session",78,0,0,0,78
514314,261835,2013-04-09,Senate,"Do pass, but re-refer to the Committee on Appropriations",11,0,0,0,11
514314,270209,2013-04-22,Senate,"Do pass",7,0,0,0,7
514314,273727,2013-04-29,Senate,"Special Consent #2 SB721 Padilla",37,0,1,0,38
514314,297084,2013-08-07,Assembly,"Do pass and re-refer to Committee on Appropriations with 	recommendation:  To Consent Calendar",16,0,0,1,17
514314,370060,2014-06-05,Assembly,"Be referred to Committee on Governmental Organization",10,0,0,1,11
514314,370061,2014-06-05,Assembly,"Do pass as amended and be re-referred to the Committee on 	Appropriations",16,0,0,3,19
514314,371321,2014-06-12,Assembly,"Do pass",12,0,0,5,17
514314,371750,2014-06-16,Assembly,"SB 721 Padilla  Third Reading Urgency  By HALL",76,0,0,3,79
514314,373264,2014-06-19,Senate,"Special Consent #17 SB721 Padilla Concurrence",32,1,7,0,40
514315,308662,2014-01-14,Senate,"Do pass, but re-refer to the Committee on Appropriations",6,0,1,0,7
514315,310419,2014-01-21,Senate,"Do pass",5,0,2,0,7
514315,311113,2014-01-23,Senate,"Senate 3rd Reading SB722 Correa Urgency Clause",33,0,6,0,39
514315,361343,2014-04-29,Assembly,"Do pass and be re-referred to the Committee on Appropriations",8,0,0,2,10
514315,362945,2014-05-07,Assembly,"Do pass",17,0,0,0,17
514315,365366,2014-05-19,Assembly,"SB 722 Correa  Third Reading Urgency  By QUIRK-SILVA",76,0,0,3,79
514315,367060,2014-05-23,Senate,"Special Consent #15 SB722 Correa",32,0,8,0,40
514316,262793,2013-04-10,Senate,"Do pass, but re-refer to the Committee on Business, Professions and 	Economic Development",5,0,0,0,5
514316,273563,2013-04-29,Senate,"Do pass, but re-refer to the Committee on Appropriations",9,0,1,0,10
514316,281421,2013-05-20,Senate,"Special Consent #5 SB723 Correa",36,0,3,0,39
514316,288809,2013-06-12,Assembly,"Do pass and be re-referred to the Committee on Veterans Affairs to 	Consent Calendar",7,0,0,0,7
514316,289826,2013-06-18,Assembly,"Do pass and be re-referred to the Committee on Appropriations",8,0,0,2,10
514316,298502,2013-08-30,Assembly,"Do pass",17,0,0,0,17
514316,298714,2013-09-04,Assembly,"SB 723 Correa  Senate Third Reading  By DICKINSON",77,0,0,1,78
514317,277367,2013-05-07,Senate,"Do pass and be placed on the Consent Calendar",6,0,1,0,7
514317,280359,2013-05-16,Senate,"Consent Calendar 2nd SB724 Emmerson",37,0,1,0,38
514317,291632,2013-06-25,Assembly,"Do pass, to Consent Calendar",10,0,0,0,10
514317,295570,2013-07-01,Assembly,"SB 724 Emmerson  Consent Calendar Second Day",73,0,0,5,78
514318,263007,2013-04-09,Senate,"Do pass, but re-refer to the Committee on Governance and Finance",6,0,1,0,7
514318,277387,2013-05-08,Senate,"Do pass as amended",7,0,0,0,7
514318,281413,2013-05-20,Senate,"Special Consent #5 SB725 Anderson",36,0,3,0,39
514318,296123,2013-07-02,Assembly,"Do pass and be re-referred to the Committee on Local Government",8,0,0,2,10
514318,297595,2013-08-14,Assembly,"Do pass",9,0,0,0,9
514318,298678,2013-09-03,Assembly,"SB 725 Anderson  Senate Third Reading  By ACHADJIAN",76,0,0,2,78
514318,298710,2013-09-04,Senate,"Unfinished Business SB725 Anderson Concurrence",37,0,2,0,39
514320,275060,2013-05-01,Senate,"Do pass, but re-refer to the Committee on Appropriations",9,0,0,0,9
514320,278851,2013-05-13,Senate,"Placed on Appropriations Suspense file",5,0,2,0,7
514320,283404,2013-05-23,Senate,"Do pass as amended",7,0,0,0,7
514320,285196,2013-05-29,Senate,"Senate 3rd Reading SB726 Lara",39,0,0,0,39
514320,295835,2013-07-01,Assembly,"Do pass and be re-referred to the Committee on Judiciary",9,0,0,0,9
514320,297359,2013-08-13,Assembly,"Do pass and be re-referred to the Committee on Appropriations",10,0,0,0,10
514320,297883,2013-08-21,Assembly,"Do pass as amended, to Consent Calendar",17,0,0,0,17
514320,298900,2013-09-06,Assembly,"SB 726 Lara  Senate Third Reading  Amend By HERNANDEZ  Set #1",52,26,0,0,78
514320,299202,2013-09-10,Assembly,"Do pass and be re-referred to the Committee on Appropriations",5,3,0,1,9
514320,299646,2013-09-12,Senate,"Unfinished Supp 2 SB726 Lara Concurrence",25,13,1,0,39
514320,299647,2013-09-12,Assembly,"SB 726 Lara  Senate Third Reading  By HERNANDEZ",53,24,0,1,78
514326,274773,2013-05-01,Senate,"Do pass as amended, and re-refer to the Committee on 	Appropriations",8,0,1,0,9
514326,281239,2013-05-20,Senate,"Placed on Appropriations Suspense file",6,0,1,0,7
514326,283180,2013-05-23,Senate,"Do pass as amended",7,0,0,0,7
514326,284983,2013-05-29,Senate,"Senate 3rd Reading SB731 Steinberg",39,0,0,0,39
514326,295791,2013-07-01,Assembly,"Do pass as amended and be re-referred to the Committee on Local 	Government",6,1,0,2,9
514326,297526,2013-08-14,Assembly,"Do pass and be re-referred to the Committee on Appropriations",7,0,0,2,9
514326,298325,2013-08-30,Assembly,"Do pass",11,0,0,6,17
514326,298751,2013-09-06,Assembly,"SB 731 Steinberg  Senate Third Reading  Amend By CHESBRO  Set #1",53,24,0,1,78
514326,299163,2013-09-10,Assembly,"Do pass and be re-referred to the Committee on Local Government",5,1,0,3,9
514327,271587,2013-04-24,Senate,"Do pass as amended, and re-refer to the Committee on Appropriations",7,0,0,0,7
514327,281309,2013-05-20,Senate,"Placed on Appropriations Suspense file",6,0,1,0,7
514328,261712,2013-04-09,Senate,"Do pass, but re-refer to the Committee on Appropriations Recommend 	Consent",11,0,0,0,11
514328,270030,2013-04-22,Senate,"Placed on Appropriations Suspense file",7,0,0,0,7
514328,283423,2013-05-23,Senate,"Do pass",7,0,0,0,7
514328,285082,2013-05-29,Senate,"Special Consent #7 SB733 Block",38,0,1,0,39
514331,270700,2013-04-23,Senate,"Do pass as amended, and re-refer to the Committee on Appropriations",7,2,0,0,9
514331,276382,2013-05-06,Senate,"Placed on Appropriations Suspense file",7,0,0,0,7
514331,283342,2013-05-23,Senate,"Do pass as amended",5,2,0,0,7
514331,285031,2013-05-29,Senate,"Senate 3rd Reading SB735 Wolk",26,12,1,0,39
514333,275392,2013-04-30,Senate,"Do pass, but re-refer to the Committee on Appropriations",2,5,0,0,7
514333,275393,2013-04-30,Senate,"Set, first hearing.  Failed passage in Committee.  Reconsideration 	granted",7,0,0,0,7
514334,270744,2013-04-23,Senate,"Do pass as amended, and re-refer to the Committee on Appropriations",6,0,0,0,6
514334,274790,2013-04-30,Senate,"Do pass as amended, and re-refer to the Committee on 	Appropriations",7,0,0,0,7
514334,281219,2013-05-20,Senate,"Placed on Appropriations Suspense file",6,0,1,0,7
514334,283264,2013-05-23,Senate,"Do pass",7,0,0,0,7
514334,284535,2013-05-28,Senate,"Senate 3rd Reading SB738 Yee",39,0,0,0,39
514337,274352,2013-04-30,Senate,"Do pass as amended, and re-refer to the Committee on Appropriations",10,0,1,0,11
514337,281205,2013-05-20,Senate,"Placed on Appropriations Suspense file",6,0,1,0,7
514337,283065,2013-05-23,Senate,"Do pass",5,0,2,0,7
514337,284529,2013-05-28,Senate,"Senate 3rd Reading SB740 Padilla Urgency Clause",36,1,2,0,39
514337,295773,2013-07-01,Assembly,"Do pass and be re-referred to the Committee on Appropriations",5,3,0,7,15
514337,297185,2013-08-12,Assembly,"Set first hearing.  Failed passage.  Reconsideration granted",9,0,0,6,15
514337,297186,2013-08-12,Assembly,"Do pass and be re-referred to the Committee on Appropriations",11,4,0,0,15
514337,298262,2013-08-30,Assembly,"Do pass",12,4,0,1,17
514337,299410,2013-09-11,Senate,"Unfinished Supp 1 SB740 Padilla Concurrence",34,3,2,0,39
514337,299411,2013-09-11,Assembly,"SB 740 Padilla  Third Reading Urgency  By BRADFORD",59,16,0,3,78
514338,266315,2013-04-16,Senate,"Do pass, but re-refer to the Committee on Governmental Organization",5,0,0,0,5
514338,270671,2013-04-23,Senate,"Do pass as amended, and re-refer to the Committee on 	Appropriations",9,1,1,0,11
514338,276274,2013-05-06,Senate,"Placed on Appropriations Suspense file",7,0,0,0,7
514338,283225,2013-05-23,Senate,"Do pass as amended",7,0,0,0,7
514338,285018,2013-05-29,Senate,"Senate 3rd Reading SB741 Cannella Urgency Clause",35,2,2,0,39
514338,296019,2013-07-03,Assembly,"Do pass and be re-referred to the Committee on Governmental 	Organization",6,0,0,1,7
514338,297083,2013-08-07,Assembly,"Do pass and be re-referred to the Committee on Appropriations",15,0,0,2,17
514339,271658,2013-04-23,Senate,"Do pass, but re-refer to the Committee on Appropriations",2,4,1,0,7
514339,271659,2013-04-23,Senate,"Set, first hearing.  Failed passage in Committee.  Reconsideration 	granted",7,0,0,0,7
514340,257876,2013-04-02,Senate,"Do pass, but re-refer to the Committee on Appropriations",11,0,0,0,11
514340,269975,2013-04-22,Senate,"Senate 3rd Reading SB743 Steinberg",38,0,0,0,38
514340,295818,2013-07-01,Assembly,"Do pass and be re-referred to the Committee on Appropriations",15,0,0,0,15
514340,297460,2013-08-14,Assembly,"Do pass, to Consent Calendar",17,0,0,0,17
514340,298764,2013-09-06,Assembly,"SB 743 Steinberg  Senate Third Reading  Amend By DICKINSON  Set #1",52,20,0,6,78
514340,299360,2013-09-11,Assembly,"Do pass as amended",6,1,0,2,9
514340,299361,2013-09-11,Assembly,"Do pass and be re-referred to the Committee on Local Government",8,0,0,1,9
514340,299629,2013-09-12,Senate,"From committee:  That the Assembly Amendments be concurred in",6,0,3,0,9
514340,299630,2013-09-12,Assembly,"SB 743 Steinberg  Senate Third Reading  By DICKINSON",56,15,0,7,78
514340,299631,2013-09-12,Senate,"W/O REF. TO FILE SB743 Steinberg Concurrence",32,5,2,0,39
514341,275580,2013-05-01,Senate,"Do pass as amended, and re-refer to the Committee on Appropriations",7,1,1,0,9
514341,281287,2013-05-20,Senate,"Placed on Appropriations Suspense file",6,0,1,0,7
514341,283349,2013-05-23,Senate,"Do pass as amended",5,2,0,0,7
514341,285182,2013-05-29,Senate,"Senate 3rd Reading SB744 Lara",27,11,1,0,39
514341,297461,2013-08-14,Assembly,"Do pass as amended and be re-referred to the Committee on 	Appropriations",6,0,0,1,7
514341,298220,2013-08-30,Assembly,"Do pass as amended",12,4,0,1,17
514341,298953,2013-09-09,Assembly,"SB 744 Lara  Senate Third Reading  By BUCHANAN",55,20,0,3,78
514341,299174,2013-09-10,Senate,"Unfinished Business SB744 Lara Concurrence",26,11,2,0,39
514343,270738,2013-04-23,Senate,"Do pass and be placed on the Consent Calendar",11,0,0,0,11
514343,275531,2013-05-02,Senate,"Consent Calendar 2nd SB745 Committee on T. & H. (DeSaulnier)",35,0,3,0,38
514343,289839,2013-06-19,Assembly,"Do pass and re-refer to Committee on Appropriations with 	recommendation:  To Consent Calendar",7,0,0,0,7
514343,296004,2013-07-03,Assembly,"Do pass as amended, to Consent Calendar",17,0,0,0,17
514343,297119,2013-08-08,Assembly,"SB 745 T.& H.  Consent Calendar Second Day  Regular Session",77,0,0,1,78
514343,297545,2013-08-15,Senate,"Unfinished Business SB745 Committee on T. & H. (DeSaulnier) 	Concurrence",38,0,1,0,39
514344,272466,2013-04-24,Senate,"Do pass as amended, and re-refer to the Committee on 	Appropriations",7,2,0,0,9
514344,278887,2013-05-13,Senate,"Do pass",5,0,2,0,7
514344,284837,2013-05-28,Senate,"Senate 3rd Reading SB746 Leno",24,15,0,0,39
514344,296046,2013-07-02,Assembly,"Do pass as amended and be re-referred to the Committee on 	Appropriations",12,6,0,1,19
514344,298520,2013-08-30,Assembly,"Do pass",12,5,0,0,17
514344,298743,2013-09-04,Assembly,"SB 746 Leno  Senate Third Reading  By PAN  Amend By PAN  Set #1",51,24,0,3,78
514344,299052,2013-09-09,Assembly,"SB 746 Leno  Senate Third Reading  By PAN",43,33,0,2,78
514344,299181,2013-09-10,Senate,"Unfinished Business SB746 Leno Concurrence",22,14,3,0,39
514345,309067,2014-01-15,Senate,"Do pass as amended, and re-refer to the Committee on Environmental 	Quality",5,2,2,0,9
514345,310358,2014-01-21,Senate,"Placed on Appropriations Suspense file",5,0,2,0,7
514347,261850,2013-04-09,Senate,"Do pass as amended, and re-refer to the Committee on Appropriations",9,0,0,0,9
514347,273513,2013-04-29,Senate,"Placed on Appropriations Suspense file",7,0,0,0,7
514347,283254,2013-05-23,Senate,"Do pass",7,0,0,0,7
514347,284592,2013-05-28,Senate,"Senate 3rd Reading SB749 Wolk",39,0,0,0,39
514347,295780,2013-07-02,Assembly,"Do pass as amended and be re-referred to the Committee on 	Appropriations",15,0,0,0,15
514347,298340,2013-08-30,Assembly,"Do pass",17,0,0,0,17
514347,299346,2013-09-11,Senate,"Unfinished Supp 1 SB749 Wolk Concurrence",39,0,0,0,39
514347,299347,2013-09-11,Assembly,"SB 749 Wolk  Senate Third Reading  By CHESBRO",78,0,0,0,78
514349,277491,2013-05-07,Senate,"Do pass as amended",5,1,1,0,7
514349,285159,2013-05-29,Senate,"Senate 3rd Reading SB750 Wolk",27,11,1,0,39
514349,296146,2013-07-03,Assembly,"Do pass as amended and be re-referred to the Committee on Water, 	Parks and Wildlife",5,2,0,0,7
514349,297268,2013-08-13,Assembly,"Do pass",3,4,0,8,15
514349,297269,2013-08-13,Assembly,"Set first hearing.  Failed passage.  Reconsideration granted",15,0,0,0,15
514350,275428,2013-05-01,Senate,"Do pass as amended, and re-refer to the Committee on Appropriations",7,0,0,0,7
514350,284669,2013-05-28,Senate,"Special Consent #6 SB751 Yee",39,0,0,0,39
514350,291866,2013-06-26,Assembly,"Do pass and be re-referred to the Committee on Appropriations",9,0,0,0,9
514350,295943,2013-07-03,Assembly,"Do pass, to Consent Calendar",17,0,0,0,17
514350,297122,2013-08-08,Assembly,"SB 751 Yee  Consent Calendar Second Day  Regular Session",77,0,0,1,78
514350,298101,2013-08-26,Senate,"Unfinished Business SB751 Yee Concurrence",37,0,2,0,39
514351,266326,2013-04-16,Senate,"Do pass as amended, and re-refer to the Committee on Judiciary",10,0,1,0,11
514351,277314,2013-05-07,Senate,"Do pass and be placed on the Consent Calendar",6,0,1,0,7
514351,280241,2013-05-16,Senate,"Consent Calendar 2nd SB752 Roth",37,0,1,0,38
514351,289814,2013-06-19,Assembly,"Do pass and be re-referred to the Committee on Judiciary",7,0,0,0,7
514351,295755,2013-07-02,Assembly,"Do pass and re-refer to Committee on Appropriations with 	recommendation:  To Consent Calendar",10,0,0,0,10
514351,297459,2013-08-14,Assembly,"Do pass, to Consent Calendar",17,0,0,0,17
514351,298754,2013-09-06,Assembly,"SB 752 Roth  Senate Third Reading  By CHAU",77,0,0,1,78
514351,299610,2013-09-12,Senate,"Special Consent #10 SB752 Roth",39,0,0,0,39
514352,270804,2013-04-23,Senate,"Do pass as amended, and re-refer to the Committee on Appropriations",7,1,1,0,9
514352,276318,2013-05-06,Senate,"Placed on Appropriations Suspense file",7,0,0,0,7
514352,283157,2013-05-23,Senate,"Do pass as amended",5,2,0,0,7
514352,285114,2013-05-29,Senate,"Senate 3rd Reading SB753 Steinberg",29,9,1,0,39
514352,295764,2013-07-02,Assembly,"Do pass as amended and be re-referred to the Committee on 	Appropriations",10,4,0,1,15
514352,297462,2013-08-14,Assembly,"Do pass",12,5,0,0,17
514352,298019,2013-08-26,Assembly,"SB 753 Steinberg  Senate Third Reading  By DICKINSON",52,25,0,1,78
514352,298321,2013-08-30,Senate,"Unfinished Business SB753 Steinberg Concurrence",32,6,1,0,39
514353,274783,2013-05-01,Senate,"Do pass as amended, and re-refer to the Committee on 	Appropriations",6,2,1,0,9
514353,281229,2013-05-20,Senate,"Placed on Appropriations Suspense file",6,0,1,0,7
514355,267212,2013-04-16,Senate,"Do pass, but re-refer to the Committee on Appropriations",5,2,0,0,7
514355,276280,2013-05-06,Senate,"Placed on Appropriations Suspense file",7,0,0,0,7
514355,283211,2013-05-23,Senate,"Do pass",5,2,0,0,7
514355,284949,2013-05-29,Senate,"Special Order SB755 Wolk",25,12,2,0,39
514355,295756,2013-07-02,Assembly,"Do pass and be re-referred to the Committee on Appropriations",0,4,0,3,7
514355,295757,2013-07-02,Assembly,"Set first hearing.  Failed passage.  Reconsideration granted",7,0,0,0,7
514355,297244,2013-08-13,Assembly,"Do pass as amended and be re-referred to the Committee on 	Appropriations",4,2,0,1,7
514355,298326,2013-08-30,Assembly,"Do pass as amended",12,5,0,0,17
514355,299456,2013-09-11,Assembly,"SB 755 Wolk  Senate Third Reading  By ALEJO",45,28,0,5,78
514355,299585,2013-09-12,Senate,"Unfinished Business SB755 Wolk Concurrence",25,12,2,0,39
514357,269901,2013-04-22,Senate,"Do pass",10,0,0,0,10
514357,285605,2013-05-30,Senate,"Senate 3rd Reading SB757 Berryhill",36,1,2,0,39
514357,297397,2013-08-13,Assembly,"Do pass",13,0,0,1,14
514358,274909,2013-05-01,Senate,"Do pass as amended, and re-refer to the Committee on Appropriations",6,0,1,0,7
514358,284666,2013-05-28,Senate,"Senate 3rd Reading SB758 Block",38,0,1,0,39
514358,297574,2013-08-14,Assembly,"Do pass and be re-referred to the Committee on Appropriations",9,0,0,0,9
514358,297869,2013-08-21,Assembly,"Do pass, to Consent Calendar",17,0,0,0,17
514358,298405,2013-08-30,Assembly,"SB 758 Block  Consent Calendar Second Day  Regular Session",78,0,0,0,78
514358,298655,2013-09-03,Senate,"Unfinished Business SB758 Block Concurrence",37,0,2,0,39
514360,274883,2013-04-30,Senate,"Do pass, but re-refer to the Committee on Appropriations",7,0,0,0,7
514360,281375,2013-05-20,Senate,"Special Consent #5 SB759 Nielsen",36,0,3,0,39
514360,297223,2013-08-13,Assembly,"Do pass and re-refer to Committee on Appropriations with 	recommendation:  To Consent Calendar",6,0,0,1,7
514360,297855,2013-08-21,Assembly,"Do pass, to Consent Calendar",17,0,0,0,17
514360,298328,2013-08-30,Assembly,"SB 759 Nielsen  Consent Calendar Second Day  Regular Session",78,0,0,0,78
514361,267345,2013-04-17,Senate,"Do pass as amended, and re-refer to the Committee on 	Appropriations",8,0,1,0,9
514361,276286,2013-05-06,Senate,"Do pass",7,0,0,0,7
514361,284582,2013-05-28,Senate,"Senate 3rd Reading SB760 Wright",39,0,0,0,39
514361,295884,2013-07-01,Assembly,"Do pass and re-refer to Committee on Appropriations with 	recommendation:  To Consent Calendar",9,0,0,0,9
514361,297450,2013-08-14,Assembly,"Do pass as amended, to Consent Calendar",17,0,0,0,17
514361,298387,2013-08-30,Assembly,"SB 760 Wright  Senate Third Reading  By PEREZ, V.M.  Amend By 	PEREZ, V.M.  Set #1",54,24,0,0,78
514362,262685,2013-04-10,Senate,"Do pass, but re-refer to the Committee on Judiciary",4,1,0,0,5
514362,271550,2013-04-23,Senate,"Do pass",5,1,1,0,7
514362,285073,2013-05-29,Senate,"Senate 3rd Reading SB761 DeSaulnier",16,21,2,0,39
514362,285074,2013-05-29,Senate,"Senate 3rd Reading SB761 DeSaulnier Reconsider",38,0,1,0,39
514362,309073,2014-01-15,Senate,"Do pass as amended, and re-refer to the Committee on Appropriations",6,0,0,0,6
514362,311186,2014-01-23,Senate,"Senate 3rd Reading SB761 DeSaulnier",30,1,8,0,39
514362,374779,2014-06-25,Assembly,"Do pass as amended and be re-referred to the Committee on 	Appropriations",9,0,0,0,9
514362,376681,2014-08-06,Assembly,"Do pass, to Consent Calendar",17,0,0,0,17
514362,377910,2014-08-20,Assembly,"SB 761 DeSaulnier  Third Reading Urgency  By SKINNER",77,0,0,2,79
514362,378099,2014-08-21,Senate,"Unfinished Business SB761 DeSaulnier Concurrence",30,0,10,0,40
514363,271499,2013-04-23,Senate,"Do pass, but re-refer to the Committee on Judiciary",7,0,0,0,7
514363,274805,2013-04-30,Senate,"Do pass, but re-refer to the Committee on Appropriations",6,1,0,0,7
514363,281379,2013-05-20,Senate,"Senate 3rd Reading SB762 Hill",31,2,6,0,39
514363,289406,2013-06-18,Assembly,"Do pass and be re-referred to the Committee on Public Safety",12,0,0,1,13
514363,297363,2013-08-13,Assembly,"Do pass as amended and be re-referred to the Committee on 	Appropriations",6,0,0,1,7
514363,298397,2013-08-30,Assembly,"Do pass",16,0,0,1,17
514363,298729,2013-09-04,Assembly,"SB 762 Hill  Senate Third Reading  By BRADFORD",68,1,0,9,78
514363,298901,2013-09-06,Senate,"Unfinished Business SB762 Hill Concurrence",37,0,2,0,39
514364,274878,2013-05-01,Senate,"Do pass, but re-refer to the Committee on Appropriations Recommend 	Consent",9,0,0,0,9
514364,278836,2013-05-13,Senate,"Placed on Appropriations Suspense file",5,0,2,0,7
514364,283306,2013-05-23,Senate,"Do pass",7,0,0,0,7
514364,284615,2013-05-28,Senate,"Senate 3rd Reading SB763 Fuller",39,0,0,0,39
514364,295890,2013-07-02,Assembly,"Do pass as amended and be re-referred to the Committee on 	Appropriations",6,0,0,1,7
514364,298434,2013-08-30,Assembly,"Do pass",17,0,0,0,17
514364,299601,2013-09-12,Senate,"Unfinished Supp 2 SB763 Fuller Concurrence",38,0,1,0,39
514364,299602,2013-09-12,Assembly,"SB 763 Fuller  Senate Third Reading  By WIECKOWSKI",77,0,0,1,78
514367,308702,2014-01-14,Senate,"Do pass, but re-refer to the Committee on Appropriations",8,0,1,0,9
514367,311269,2014-01-23,Senate,"Senate 3rd Reading SB764 Yee",33,0,6,0,39
514368,277952,2013-05-09,Senate,"Do pass as amended",4,0,1,0,5
514368,284659,2013-05-28,Senate,"Senate 3rd Reading SB765 Block",35,4,0,0,39
514368,291969,2013-06-26,Assembly,"Do pass",5,1,0,1,7
514368,296023,2013-07-03,Assembly,"SB 765 Block  Senate Third Reading  By WIECKOWSKI",53,20,0,5,78
514368,296222,2013-07-08,Senate,"Unfinished Business SB765 Block Concurrence",27,4,7,0,38
514369,270734,2013-04-23,Senate,"Do pass as amended, and re-refer to the Committee on Appropriations",6,0,0,0,6
514369,278570,2013-05-13,Senate,"Placed on Appropriations Suspense file",5,0,2,0,7
514370,274245,2013-04-30,Senate,"Do pass, but re-refer to the Committee on Rules",7,2,2,0,11
514370,278838,2013-05-13,Senate,"Placed on Appropriations Suspense file",5,0,2,0,7
514370,283395,2013-05-23,Senate,"Do pass",7,0,0,0,7
514370,285236,2013-05-29,Senate,"Senate 3rd Reading SB767 Lieu",39,0,0,0,39
514370,297610,2013-08-15,Assembly,"Do pass",2,2,0,5,9
514370,370172,2014-06-09,Assembly,"Be referred to Committee on Transportation",10,0,0,1,11
514371,277347,2013-05-08,Senate,"Do pass as amended, and re-refer to the Committee on 	Appropriations",6,2,1,0,9
514371,277348,2013-05-08,Senate,"Do pass, but re-refer to the Committee on Health",5,2,0,0,7
514371,281218,2013-05-20,Senate,"Placed on Appropriations Suspense file",6,0,1,0,7
514373,274803,2013-04-30,Senate,"Do pass",7,0,0,0,7
514373,278072,2013-05-09,Senate,"Senate 3rd Reading SB769 Block",35,0,3,0,38
514373,288263,2013-06-11,Assembly,"Do pass",7,0,0,0,7
514373,289051,2013-06-14,Assembly,"SB 769 Block  Senate Third Reading  By QUIRK",78,0,0,1,79
514374,271637,2013-04-24,Senate,"Do pass, but re-refer to the Committee on Appropriations",3,1,1,0,5
514374,276359,2013-05-06,Senate,"Placed on Appropriations Suspense file",7,0,0,0,7
514374,283128,2013-05-23,Senate,"Do pass",5,2,0,0,7
514374,284605,2013-05-28,Senate,"Senate 3rd Reading SB770 Jackson",29,10,0,0,39
514374,297087,2013-08-07,Assembly,"Do pass and be re-referred to the Committee on Appropriations",7,2,0,3,12
514374,298281,2013-08-30,Assembly,"Do pass",12,5,0,0,17
514374,298727,2013-09-04,Assembly,"SB 770 Jackson  Senate Third Reading  By MITCHELL",51,22,0,5,78
514374,298907,2013-09-06,Senate,"Unfinished Business SB770 Jackson Concurrence",26,11,2,0,39
514375,271839,2013-04-23,Senate,"Do pass, but re-refer to the Committee on Appropriations",7,0,0,0,7
514375,276493,2013-05-06,Senate,"Do pass",7,0,0,0,7
514375,277993,2013-05-09,Senate,"Senate 3rd Reading SB771 Galgiani Urgency Clause",35,0,3,0,38
514375,288101,2013-06-11,Assembly,"Do pass and be re-referred to the Committee on Appropriations",7,0,0,0,7
514375,296067,2013-07-03,Assembly,"Do pass, to Consent Calendar",17,0,0,0,17
514375,297170,2013-08-08,Assembly,"SB 771 Galgiani  Consent Calendar Second Day  Regular Session",77,0,0,1,78
514375,297519,2013-08-15,Senate,"Unfinished Business SB771 Galgiani Urgency Clause",38,0,1,0,39
514379,270009,2013-04-22,Senate,"Do pass, but re-refer to the Committee on Appropriations",2,3,0,0,5
514379,270010,2013-04-22,Senate,"Set, first hearing.  Failed passage in Committee.  Reconsideration 	granted",5,0,0,0,5
514380,270070,2013-04-22,Senate,"Do pass, but re-refer to the Committee on Appropriations",2,3,0,0,5
514380,270071,2013-04-22,Senate,"Set, first hearing.  Failed passage in Committee.  Reconsideration 	granted",5,0,0,0,5
514381,271646,2013-04-24,Senate,"Do pass, but re-refer to the Committee on Appropriations",3,1,1,0,5
514381,278043,2013-05-09,Senate,"Senate 3rd Reading SB776 Corbett",24,10,4,0,38
514381,288847,2013-06-12,Assembly,"Do pass and be re-referred to the Committee on Appropriations",5,2,0,0,7
514381,296145,2013-07-03,Assembly,"Do pass",12,5,0,0,17
514381,297146,2013-08-08,Assembly,"SB 776 Corbett  Senate Third Reading  By ALEJO",52,23,0,3,78
514382,270898,2013-04-23,Senate,"Do pass, but re-refer to the Committee on Governance and Finance",10,0,1,0,11
514382,274740,2013-05-01,Senate,"Do pass as amended, and re-refer to the Committee on Rules",6,0,1,0,7
514382,281249,2013-05-20,Senate,"Placed on Appropriations Suspense file",6,0,1,0,7
514382,283138,2013-05-23,Senate,"Do pass as amended",5,0,2,0,7
514382,285547,2013-05-30,Senate,"Senate 3rd Reading SB777 Calderon",31,6,2,0,39
514382,321522,2014-02-14,Assembly,"Be referred to Committee on Governmental Organization",10,0,0,1,11
514382,327703,2014-02-24,Assembly,"Do pass as amended and be re-referred to the Committee on Insurance",16,0,0,3,19
514382,331512,2014-02-27,Assembly,"Do pass and be re-referred to the Committee on Appropriations",9,0,0,4,13
514382,336500,2014-03-06,Assembly,"Do pass",14,0,0,3,17
514382,341901,2014-03-13,Assembly,"SB 777 Hernandez  Third Reading Urgency  By HOLDEN",73,0,0,7,80
514382,346562,2014-03-20,Senate,"Unfinished Business SB777 Hernandez Concurrence",29,0,10,0,39
514385,274696,2013-04-30,Senate,"Do pass, but re-refer to the Committee on Appropriations",2,5,0,0,7
514385,274697,2013-04-30,Senate,"Set, first hearing.  Failed passage in Committee.  Reconsideration 	granted",7,0,0,0,7
514386,275590,2013-05-01,Senate,"Do pass as amended, and re-refer to the Committee on 	Appropriations",7,2,0,0,9
514386,281443,2013-05-20,Senate,"Placed on Appropriations Suspense file",6,0,1,0,7
514386,311127,2014-01-23,Senate,"Do pass",5,1,1,0,7
514386,312735,2014-01-28,Senate,"Senate 3rd Reading SB780 Jackson",22,8,9,0,39
514386,374392,2014-06-24,Assembly,"Do pass as amended and be re-referred to the Committee on 	Appropriations",13,6,0,0,19
514388,271820,2013-04-24,Senate,"Do pass, but re-refer to the Committee on Public Safety",5,2,0,0,7
514388,274891,2013-04-30,Senate,"Do pass as amended, and re-refer to the Committee on Appropriations",5,2,0,0,7
514388,281540,2013-05-20,Senate,"Placed on Appropriations Suspense file",6,0,1,0,7
514388,309068,2014-01-15,Senate,"Do pass as amended, and re-refer to the Committee on Appropriations",6,0,0,0,6
514388,310413,2014-01-21,Senate,"Do pass",5,0,2,0,7
514388,311110,2014-01-23,Senate,"Senate 3rd Reading SB782 DeSaulnier",33,0,6,0,39
514388,374742,2014-06-25,Assembly,"Do pass as amended and be re-referred to the Committee on 	Appropriations",9,0,0,0,9
514388,376683,2014-08-06,Assembly,"Do pass, to Consent Calendar",17,0,0,0,17
514388,377826,2014-08-19,Assembly,"SB 782 DeSaulnier  Senate Third Reading  By BOCANEGRA",78,0,0,1,79
514388,377952,2014-08-20,Senate,"Unfinished Business SB782 DeSaulnier Concurrence",34,0,6,0,40
514392,261766,2013-04-09,Senate,"Do pass, but re-refer to the Committee on Governance and Finance",10,0,1,0,11
514392,274958,2013-05-01,Senate,"Do pass as amended, and re-refer to the Committee on Appropriations",7,0,0,0,7
514392,281544,2013-05-20,Senate,"Do pass",5,0,2,0,7
514392,312314,2014-01-27,Senate,"Senate 3rd Reading SB785 Wolk",35,0,4,0,39
514392,374291,2014-06-25,Assembly,"Do pass and be re-referred to the Committee on Appropriations",7,2,0,0,9
514392,376703,2014-08-06,Assembly,"Do pass as amended",13,4,0,0,17
514392,378497,2014-08-26,Assembly,"SB 785 Wolk  Senate Third Reading  By FRAZIER",68,5,0,6,79
514392,378729,2014-08-27,Senate,"Unfinished Business SB785 Wolk Concurrence",23,11,6,0,40
514394,274795,2013-05-01,Senate,"Do pass, but re-refer to the Committee on Appropriations",2,7,0,0,9
514394,274796,2013-05-01,Senate,"Set, second hearing.  Failed passage in Committee. 	Reconsideration granted",9,0,0,0,9
514396,274596,2013-04-30,Senate,"Do pass, but re-refer to the Committee on Appropriations Recommend 	Consent",11,0,0,0,11
514396,280405,2013-05-16,Senate,"Consent Calendar 2nd SB788 Committee on T. & H. (DeSaulnier)",37,0,1,0,38
514396,289265,2013-06-17,Assembly,"Do pass and be re-referred to the Committee on Natural Resources to 	Consent Calendar",15,0,0,1,16
514396,297389,2013-08-12,Assembly,"Do pass and re-refer to Committee on Appropriations with 	recommendation:  To Consent Calendar",9,0,0,0,9
514396,298384,2013-08-30,Assembly,"Do pass",17,0,0,0,17
514396,299075,2013-09-09,Assembly,"SB 788 T.& H.  Senate Third Reading  By LOWENTHAL",77,1,0,0,78
514396,299301,2013-09-10,Senate,"Unfinished Business SB788 Committee on T. & H. (DeSaulnier)",38,0,1,0,39
514397,277044,2013-05-07,Senate,"Do pass, but re-refer to the Committee on Appropriations",9,0,2,0,11
514397,281426,2013-05-20,Senate,"Do pass",6,0,1,0,7
514397,284626,2013-05-28,Senate,"Special Consent #6 SB789 Price",39,0,0,0,39
514397,295748,2013-07-01,Assembly,"Do pass and be re-referred to the Committee on Arts, Entertain, 	Sports, Tourism, & Internet Media",15,0,0,1,16
514397,297337,2013-08-13,Assembly,"Do pass",7,0,0,0,7
514397,297746,2013-08-19,Assembly,"SB 789 Liu  Senate Third Reading  By CALDERON",75,0,0,3,78
514397,297948,2013-08-22,Senate,"Unfinished Business SB789 Liu Concurrence",37,0,2,0,39
514400,266270,2013-04-16,Senate,"Do pass, but re-refer to the Committee on Governance and Finance",10,0,1,0,11
514400,274971,2013-05-01,Senate,"Do pass, but re-refer to the Committee on Appropriations",7,0,0,0,7
514400,281177,2013-05-20,Senate,"Placed on Appropriations Suspense file",6,0,1,0,7
514400,311217,2014-01-23,Senate,"Do pass as amended",6,0,1,0,7
514400,312802,2014-01-28,Senate,"Senate 3rd Reading SB792 DeSaulnier",33,0,6,0,39
514400,374359,2014-06-25,Assembly,"Do pass as amended and be re-referred to the Committee on 	Appropriations",8,0,0,1,9
514400,376716,2014-08-06,Assembly,"Do pass",16,1,0,0,17
514400,378228,2014-08-22,Assembly,"SB 792 DeSaulnier  Senate Third Reading  By LOWENTHAL  Amend By 	LOWENTHAL  Set #1",67,3,0,9,79
514400,379052,2014-08-30,Senate,"W/O REF. TO FILE SB792 Padilla Concurrence",22,11,7,0,40
514400,379053,2014-08-30,Assembly,"SB 792 Padilla  Senate Third Reading  By PEREZ, J",53,23,0,3,79
514400,379135,2014-08-30,Assembly,"Do pass as amended",5,2,0,0,7
514402,274210,2013-04-30,Senate,"Do pass, but re-refer to the Committee on Appropriations",11,0,0,0,11
514402,279035,2013-05-13,Senate,"Placed on Appropriations Suspense file",5,0,2,0,7
514403,308780,2014-01-14,Senate,"Do pass as amended",5,1,1,0,7
514403,312622,2014-01-28,Senate,"Senate 3rd Reading SB794 Evans",21,11,7,0,39
514406,306193,2014-01-08,Senate,"Do pass, but re-refer to the Committee on Appropriations",2,4,0,0,6
514406,306194,2014-01-08,Senate,"Set, second hearing.  Failed passage in Committee. 	Reconsideration granted",6,0,0,0,6
514406,309005,2014-01-15,Senate,"Do pass",2,2,2,0,6
514408,308985,2014-01-15,Senate,"Do pass, but re-refer to the Committee on Appropriations",6,0,0,0,6
514408,310326,2014-01-21,Senate,"Placed on Appropriations Suspense file",5,0,2,0,7
514408,311198,2014-01-23,Senate,"Do pass",6,0,1,0,7
514408,312700,2014-01-28,Senate,"Senate 3rd Reading SB798 De Le",34,0,5,0,39
514408,374798,2014-06-25,Assembly,"Do pass and be re-referred to the Committee on Appropriations",9,0,0,0,9
514408,377213,2014-08-14,Assembly,"Do pass",17,0,0,0,17
514408,377883,2014-08-20,Assembly,"SB 798 De Leon  Third Reading Urgency  By QUIRK-SILVA",76,0,0,3,79
514410,275582,2013-05-01,Senate,"Do pass, but re-refer to the Committee on Appropriations",9,0,0,0,9
514410,278893,2013-05-13,Senate,"Placed on Appropriations Suspense file",5,0,2,0,7
514410,283190,2013-05-23,Senate,"Do pass as amended",7,0,0,0,7
514410,285019,2013-05-29,Senate,"Senate 3rd Reading SB800 Lara Urgency Clause",39,0,0,0,39
514410,297326,2013-08-13,Assembly,"Do pass and be re-referred to the Committee on Appropriations",13,5,0,1,19
514410,298474,2013-08-30,Assembly,"Do pass as amended",12,5,0,0,17
514410,299039,2013-09-09,Assembly,"SB 800 Lara  Senate Third Reading  By PAN",53,25,0,0,78
514410,299755,2013-09-11,Senate,"From committee:  That the Assembly Amendments be concurred in",5,2,2,0,9
514410,299756,2013-09-12,Senate,"Unfinished Business SB800 Lara Concurrence",28,11,0,0,39
514411,275117,2013-04-30,Senate,"Do pass, but re-refer to the Committee on Appropriations",7,0,0,0,7
514411,281389,2013-05-20,Senate,"Special Consent #5 SB801 Roth",36,0,3,0,39
514411,296041,2013-07-03,Assembly,"Do pass and be re-referred to the Committee on Appropriations",10,0,0,3,13
514411,297480,2013-08-14,Assembly,"Do pass, to Consent Calendar",17,0,0,0,17
514411,297892,2013-08-22,Assembly,"SB 801 Roth  Consent Calendar Second Day  Regular Session",78,0,0,0,78
514411,298098,2013-08-26,Senate,"Unfinished Business SB801 Roth Concurrence",37,0,2,0,39
514414,308981,2014-01-15,Senate,"Do pass",5,0,1,0,6
514414,310360,2014-01-21,Senate,"Senate 3rd Reading SB803 DeSaulnier",31,1,7,0,39
514414,372580,2014-06-18,Assembly,"Do pass, to Consent Calendar",9,0,0,0,9
514414,374852,2014-06-26,Assembly,"SB 803 DeSaulnier  Consent Calendar Second Day  Regular Session",76,0,0,3,79
514415,274708,2013-05-01,Senate,"Do pass as amended, and re-refer to the Committee on 	Appropriations",6,1,2,0,9
514415,285042,2013-05-29,Senate,"Senate 3rd Reading SB804 Lara",32,7,0,0,39
514415,295801,2013-07-01,Assembly,"Do pass as amended and be re-referred to the Committee on 	Environmental Safety and Toxic Materials",9,0,0,0,9
514415,297266,2013-08-13,Assembly,"Do pass as amended and be re-referred to the Committee on 	Appropriations",5,1,0,1,7
514415,298223,2013-08-30,Assembly,"Do pass as amended",12,1,0,4,17
514415,299358,2013-09-10,Assembly,"Do pass as amended",4,1,0,2,7
514415,299615,2013-09-12,Senate,"From committee:  That the Assembly Amendments be concurred in",6,2,1,0,9
514415,299616,2013-09-12,Assembly,"SB 804 Lara  Senate Third Reading  By BLOOM",44,23,0,11,78
514415,299617,2013-09-12,Senate,"Unfinished Supp 2 SB804 Lara Concurrence",29,7,3,0,39
514417,274265,2013-04-30,Senate,"Do pass, but re-refer to the Committee on Appropriations",11,0,0,0,11
514417,281624,2013-05-20,Senate,"Special Consent #5 SB806 Price",36,0,3,0,39
514417,295867,2013-07-01,Assembly,"Do pass as amended and be re-referred to the Committee on 	Appropriations",14,1,0,1,16
514417,297506,2013-08-14,Assembly,"Do pass as amended",15,2,0,0,17
514417,298626,2013-09-03,Assembly,"SB 806 Hueso  Senate Third Reading  By LOWENTHAL",73,3,0,2,78
514417,298726,2013-09-04,Senate,"Unfinished Business SB806 Hueso Concurrence",38,0,1,0,39
514418,272868,2013-04-24,Senate,"Do pass, but re-refer to the Committee on Appropriations Recommend 	Consent",9,0,0,0,9
514418,278107,2013-05-09,Senate,"Consent Calendar 2nd SB807 Price",34,0,4,0,38
514418,288085,2013-06-11,Assembly,"Do pass and be re-referred to the Committee on Appropriations",11,0,0,2,13
514418,296171,2013-07-03,Assembly,"Do pass, to Consent Calendar",17,0,0,0,17
514418,297150,2013-08-08,Assembly,"SB 807  Consent Calendar Second Day  Regular Session",77,0,0,1,78
514420,308606,2014-01-14,Senate,"Do pass as amended, and re-refer to the Committee on Appropriations",5,1,1,0,7
514420,311103,2014-01-23,Senate,"Placed on Appropriations Suspense file",6,0,1,0,7
514420,311104,2014-01-23,Senate,"Do pass",5,1,1,0,7
514420,313855,2014-01-30,Senate,"Senate 3rd Reading SB808 De Le",22,10,7,0,39
514420,374066,2014-06-24,Assembly,"Do pass and be re-referred to the Committee on Appropriations",5,2,0,0,7
514420,377126,2014-08-14,Assembly,"Do pass as amended",12,5,0,0,17
514420,379033,2014-08-29,Assembly,"SB 808 De Leon  Senate Third Reading  By SKINNER",46,30,0,3,79
514420,379034,2014-08-29,Senate,"Unfinished Supp 3 SB808 De Le",21,12,7,0,40
514421,266323,2013-04-15,Senate,"Do pass, but re-refer to the Committee on Governance and Finance",7,2,1,0,10
514421,277342,2013-05-08,Senate,"Do pass as amended, and re-refer to the Committee on 	Appropriations",5,2,0,0,7
514421,281224,2013-05-20,Senate,"Placed on Appropriations Suspense file",6,0,1,0,7
514421,283168,2013-05-23,Senate,"Do pass as amended",5,1,1,0,7
514421,284555,2013-05-28,Senate,"Senate 3rd Reading SB809 DeSaulnier",23,14,2,0,39
514421,284556,2013-05-28,Senate,"Senate 3rd Reading SB809 DeSaulnier Reconsider",39,0,0,0,39
514421,285515,2013-05-30,Senate,"Senate 3rd Reading SB809 DeSaulnier Urgency Clause",39,0,0,0,39
514421,291544,2013-06-25,Assembly,"Do pass and be re-referred to the Committee on Business, 	Professions and Consumer Protection",7,0,0,0,7
514421,297230,2013-08-13,Assembly,"Do pass and be re-referred to the Committee on Appropriations",14,0,0,0,14
514421,298301,2013-08-30,Assembly,"Do pass as amended",16,0,0,1,17
514421,298914,2013-09-09,Assembly,"SB 809 DeSaulnier  Senate Third Reading  By JONES-SAWYER",77,1,0,0,78
514421,299115,2013-09-10,Senate,"Unfinished Business SB809 DeSaulnier Concurrence",38,0,1,0,39
514423,274347,2013-04-30,Senate,"Do pass as amended, and re-refer to the Committee on Appropriations",8,0,3,0,11
514423,281203,2013-05-20,Senate,"Placed on Appropriations Suspense file",6,0,1,0,7
514423,283074,2013-05-23,Senate,"Do pass as amended",5,2,0,0,7
514423,284999,2013-05-29,Senate,"Senate 3rd Reading SB811 Lara",28,10,1,0,39
514423,297181,2013-08-12,Assembly,"Do pass and be re-referred to the Committee on Natural Resources",12,4,0,0,16
514423,297546,2013-08-15,Assembly,"Do pass as amended and be re-referred to the Committee on 	Appropriations",6,0,0,3,9
514423,298265,2013-08-30,Assembly,"Do pass as amended",12,5,0,0,17
514423,298929,2013-09-09,Assembly,"SB 811 Lara  Senate Third Reading  By RENDON",55,20,0,3,78
514423,299142,2013-09-10,Senate,"Unfinished Business SB811 Lara Concurrence",27,10,2,0,39
514424,309100,2014-01-15,Senate,"Do pass as amended, and re-refer to the Committee on 	Appropriations",6,0,2,0,8
514424,310369,2014-01-21,Senate,"Placed on Appropriations Suspense file",5,0,2,0,7
514424,311226,2014-01-23,Senate,"Do pass",5,1,1,0,7
514424,312706,2014-01-28,Senate,"Senate 3rd Reading SB812 De Le",27,7,5,0,39
514424,372277,2014-06-17,Assembly,"Do pass as amended and be re-referred to the Committee on 	Appropriations",5,1,0,1,7
514424,377486,2014-08-14,Assembly,"Do pass as amended",12,5,0,0,17
514424,378683,2014-08-27,Assembly,"SB 812 De Leon  Senate Third Reading  By PEREZ, J",48,23,0,8,79
514424,378952,2014-08-28,Senate,"From committee:  That the Assembly Amendments be concurred in",4,1,2,0,7
514424,379120,2014-08-29,Senate,"Unfinished Business SB812 De Le",24,12,4,0,40
514428,275099,2013-04-30,Senate,"Be adopted, but re-refer to the Committee on Elections and 	Constitutional Amendments",2,5,0,0,7
514428,275100,2013-04-30,Senate,"Set, first hearing.  Failed passage in Committee.  Reconsideration 	granted",7,0,0,0,7
514429,252715,2013-03-21,Senate,"Senate 3rd Reading SCR14 Wolk",33,0,5,0,38
514429,269998,2013-04-22,Assembly,"From committee:  Be adopted.  To third reading",11,0,0,0,11
514429,276283,2013-05-06,Senate,"Special Consent #3 SCR14 Wolk",32,0,6,0,38
515473,265892,2013-04-15,Senate,"Senate 3rd Reading SJR6 Yee",24,11,3,0,38
515473,297374,2013-08-13,Assembly,"Be adopted",5,1,0,1,7
515473,298002,2013-08-26,Assembly,"SJR6 Yee  Senate Third Reading  By WEBER",53,25,0,0,78
515566,259570,2013-04-04,Senate,"Senate 3rd Reading SCR15 Lieu",33,0,5,0,38
515566,272480,2013-04-25,Assembly,"From committee:  Be adopted.  To third reading",11,0,0,0,11
515566,275532,2013-05-02,Senate,"Unfinished Business SCR15 Lieu",38,0,0,0,38
517078,270800,2013-04-23,Senate,"Do pass, but re-refer to the Committee on Appropriations Recommend 	Consent",9,0,0,0,9
517078,278113,2013-05-09,Senate,"Consent Calendar 2nd SB814 Committee on N.R. & W. (Pavley)",34,0,4,0,38
517078,289546,2013-06-18,Assembly,"Do pass and be re-referred to the Committee on Natural Resources to 	Consent Calendar",14,0,0,1,15
517078,297336,2013-08-12,Assembly,"Do pass and re-refer to Committee on Appropriations with 	recommendation:  To Consent Calendar",9,0,0,0,9
517078,297873,2013-08-21,Assembly,"Do pass, to Consent Calendar",17,0,0,0,17
517078,298432,2013-08-30,Assembly,"SB 814 N.R.& W.  Consent Calendar Second Day  Regular Session",78,0,0,0,78
517078,298745,2013-09-04,Senate,"Unfinished Business SB814 Committee on N.R. & W. (Pavley) 	Concurrence",35,0,4,0,39
517112,251163,2013-03-19,Assembly,"From committee:  Be adopted.  To third reading",10,0,0,1,11
517112,259595,2013-04-04,Senate,"Special Consent Cal ACR26 Wilk",33,0,5,0,38
517146,262574,2013-04-10,Assembly,"Do pass and re-refer to Committee on Appropriations with 	recommendation:  To Consent Calendar",7,0,0,0,7
517146,267411,2013-04-17,Assembly,"Do pass, to Consent Calendar",17,0,0,0,17
517146,275736,2013-05-02,Assembly,"AB 1381 P.E., R.& S.S.  Assembly Third Reading  By BONTA",74,0,0,5,79
517146,291476,2013-06-24,Senate,"Do pass, but re-refer to the Committee on Appropriations Recommend 	Consent",5,0,0,0,5
517146,299048,2013-09-09,Senate,"Assembly 3rd Reading AB1381 Committee on P.E.,R.& S.S.(Bonta) By 	Beall",39,0,0,0,39
517146,299272,2013-09-10,Assembly,"AB 1381 P.E., R.& S.S.  Concurrence in Senate Amendments By BONTA",78,0,0,0,78
517180,277354,2013-05-08,Assembly,"Do pass, to Consent Calendar",7,0,0,0,7
517180,280280,2013-05-16,Assembly,"AB 1380 P.E., R.& S.S.  Consent Calendar Second Day  Regular Session",70,0,0,9,79
517180,291322,2013-06-24,Senate,"Do pass and be placed on the Consent Calendar",5,0,0,0,5
517180,295605,2013-07-01,Senate,"Consent Calendar 2nd AB1380 Committee on P.E.,R.& S.S.(Bonta)",33,0,5,0,38
517180,297775,2013-08-19,Assembly,"AB 1380 P.E., R.& S.S.  Concurrence in Senate Amendments By BONTA",77,0,0,1,78
517209,262585,2013-04-10,Assembly,"Do pass and re-refer to Committee on Appropriations with 	recommendation:  To Consent Calendar",7,0,0,0,7
517209,267598,2013-04-17,Assembly,"Do pass, to Consent Calendar",17,0,0,0,17
517209,272319,2013-04-25,Assembly,"AB 1379 P.E., R.& S.S.  Consent Calendar Second Day  Regular Session",76,0,0,3,79
517209,291473,2013-06-24,Senate,"Do pass, but re-refer to the Committee on Appropriations Recommend 	Consent",5,0,0,0,5
517209,298629,2013-09-03,Senate,"Assembly 3rd Reading AB1379 Committee on P.E.,R.& S.S.(Bonta) By 	Beall",37,0,2,0,39
517209,298908,2013-09-06,Assembly,"AB 1379 P.E., R.& S.S.  Concurrence in Senate Amendments By BONTA",78,0,0,0,78
517244,272116,2013-04-24,Assembly,"Do pass and be re-referred to the Committee on Appropriations",5,2,0,0,7
517244,283844,2013-05-24,Assembly,"Do pass",12,1,0,4,17
517278,272170,2013-04-24,Assembly,"Do pass and be re-referred to the Committee on Appropriations",5,2,0,0,7
517278,283929,2013-05-24,Assembly,"Do pass",12,1,0,4,17
517278,290206,2013-06-20,Assembly,"Do pass",6,1,0,0,7
517278,290207,2013-06-20,Assembly,"AB 1377 P.E., R.& S.S.  Third Reading Urgency  By BONTA  Amend By 	BONTA  Set #1",54,21,0,4,79
517278,291647,2013-06-25,Assembly,"AB 1377 P.E., R.& S.S.  Third Reading Urgency  By BONTA",63,9,0,7,79
517278,292206,2013-06-27,Senate,"Do pass, but re-refer to the Committee on Appropriations",3,1,1,0,5
517278,295617,2013-07-01,Senate,"Do pass",4,2,1,0,7
517278,296136,2013-07-03,Senate,"Assembly 3rd Reading AB1377 Committee on P.E.,R.& S.S.(Bonta) 	Urgency Clause",27,9,2,0,38
519462,258114,2013-04-02,Assembly,"Do pass, to Consent Calendar",18,0,0,1,19
519462,263464,2013-04-11,Assembly,"AB 1382 HEALTH  Consent Calendar Second Day  By PAN",75,0,0,4,79
519462,287241,2013-06-05,Senate,"Do pass and be placed on the Consent Calendar",9,0,0,0,9
519462,298662,2013-09-03,Senate,"Assembly 3rd Reading AB1382 Committee on HEALTH (Pan) By Hernandez",36,0,3,0,39
519475,250625,2013-03-19,Assembly,"From committee:  Be adopted.  To third reading",9,0,0,2,11
519488,263523,2013-04-11,Assembly,"From committee:  Be adopted.  To third reading",10,1,0,0,11
519488,275670,2013-05-02,Senate,"Special Consent Cal ACR28 Nazarian",35,0,3,0,38
519501,239439,2013-02-28,Assembly,"AJR 14 ATKINS  Assembly Third Reading  Amend By HAGMAN  Set #1 	Motion to  Lay on the Table  By RENDON",54,25,0,1,80
519501,239440,2013-02-28,Assembly,"AJR 14 ATKINS  Assembly Third Reading",54,13,0,13,80
519514,247428,2013-03-11,Senate,"Senate 3rd Supp 1 SCR16 Knight",32,0,5,0,37
519514,252415,2013-03-21,Assembly,"From committee:  Be adopted.  To third reading",11,0,0,0,11
519514,259573,2013-04-04,Senate,"Unfinished Business SCR16 Knight Concurrence",33,0,5,0,38
520927,250104,2013-03-18,Senate,"Special Consent Cal SCR17 Anderson",31,0,6,0,37
520927,265548,2013-04-15,Assembly,"From committee:  Be adopted.  To third reading",11,0,0,0,11
520927,275661,2013-05-02,Senate,"Unfinished Business SCR17 Anderson",37,0,1,0,38
521014,250108,2013-03-18,Senate,"Special Consent Cal SCR18 Liu",31,0,6,0,37
521014,289872,2013-06-17,Assembly,"From committee:  Be adopted.  To third reading",9,0,0,2,11
521014,295447,2013-07-01,Assembly,"SCR 18 Liu  Senate Third Reading  By NAZARIAN",72,0,0,6,78
523371,250131,2013-03-18,Senate,"Senate 3rd Reading SR12 Wyland",32,0,5,0,37
523372,250555,2013-03-18,Senate,"Special Consent Cal SCR21 Emmerson",31,0,6,0,37
523374,250005,2013-03-18,Senate,"Special Consent Cal SCR20 Yee",31,0,6,0,37
523374,292130,2013-06-27,Assembly,"From committee:  Be adopted.  To third reading",10,0,0,1,11
523374,297901,2013-08-22,Senate,"Unfinished Business SCR20 Yee Concurrence",37,0,2,0,39
523377,250130,2013-03-18,Senate,"Senate 3rd Reading SCR19 Evans",30,1,6,0,37
523377,265225,2013-04-15,Assembly,"From committee:  Be adopted.  To third reading",11,0,0,0,11
523377,275606,2013-05-02,Senate,"Unfinished Business SCR19 Evans",37,1,0,0,38
523379,262809,2013-04-09,Senate,"Do pass, but re-refer to the Committee on Appropriations",6,0,1,0,7
523379,273564,2013-04-29,Senate,"Special Consent #2 SB815 Committee on V.A. (Correa)",37,0,1,0,38
523379,287277,2013-06-04,Assembly,"Do pass and be re-referred to the Committee on Appropriations",10,0,0,0,10
523379,296155,2013-07-03,Assembly,"Do pass, to Consent Calendar",17,0,0,0,17
523379,297145,2013-08-08,Assembly,"SB 815 V. A.  Consent Calendar Second Day  Regular Session",77,0,0,1,78
523379,297709,2013-08-19,Senate,"Unfinished Business SB815 Committee on V.A. (Hueso) Concurrence",37,0,2,0,39
523382,244454,2013-03-11,Assembly,"From committee:  Be adopted.  To third reading",10,0,0,1,11
523382,276321,2013-05-06,Senate,"Special Consent #3 ACR29 Eggman By Galgiani",32,0,6,0,38
523384,262693,2013-04-10,Assembly,"Do pass and re-refer to Committee on Appropriations with 	recommendation:  To Consent Calendar",13,0,0,0,13
523384,275313,2013-05-01,Assembly,"Do pass, to Consent Calendar",17,0,0,0,17
523384,278008,2013-05-09,Assembly,"AB 1395 INS.  Consent Calendar Second Day  Regular Session",75,0,0,4,79
523384,374986,2014-06-25,Senate,"Do pass",10,0,1,0,11
523384,377727,2014-08-18,Senate,"Assembly 3rd Reading AB1395 Perea",36,0,4,0,40
523384,377993,2014-08-20,Assembly,"AB 1395 PEREA  Concurrence in Senate Amendments",74,2,0,3,79
523387,262792,2013-04-10,Assembly,"Do pass, to Consent Calendar",13,0,0,0,13
523387,268476,2013-04-18,Assembly,"AB 1394 INS.  Consent Calendar Second Day  Regular Session",76,0,0,3,79
523387,291937,2013-06-26,Senate,"Do pass",9,0,0,0,9
523387,297749,2013-08-19,Senate,"Assembly 3rd Reading AB1394 Committee on INS. (Perea) By Calderon",37,0,2,0,39
523389,263220,2013-04-10,Assembly,"Do pass, to Consent Calendar",13,0,0,0,13
523389,268770,2013-04-18,Assembly,"AB 1393 INS.  Consent Calendar Second Day  Regular Session",76,0,0,3,79
523389,288652,2013-06-12,Senate,"Do pass",4,0,1,0,5
523389,364459,2014-05-14,Senate,"Do pass as amended, and re-refer to the Committee on Appropriations",5,0,2,0,7
523389,373745,2014-06-23,Senate,"Do pass",7,0,0,0,7
523389,375277,2014-06-30,Senate,"Assembly 3rd Reading AB1393 Perea Urgency Clause",34,0,6,0,40
523389,375667,2014-07-03,Assembly,"AB 1393 PEREA  Concurrence in Senate Amendments",76,0,0,3,79
523391,262694,2013-04-10,Assembly,"Do pass and re-refer to Committee on Appropriations with 	recommendation:  To Consent Calendar",13,0,0,0,13
523391,274799,2013-05-01,Assembly,"Do pass, to Consent Calendar",17,0,0,0,17
523391,277962,2013-05-09,Assembly,"AB 1392 INS.  Consent Calendar Second Day  Regular Session",75,0,0,4,79
523391,288654,2013-06-12,Senate,"Do pass, but re-refer to the Committee on Appropriations",4,0,1,0,5
523391,296228,2013-07-08,Senate,"Assembly 3rd Reading AB1392 Committee on INS. (Perea) By Monning",33,0,5,0,38
523391,297129,2013-08-08,Assembly,"AB 1392 INS.  Concurrence in Senate Amendments By PEREA",76,0,0,2,78
523393,262720,2013-04-10,Assembly,"Do pass as amended and re-refer to Committee on Appropriations 	with recommendation:  To Consent Calendar",13,0,0,0,13
523393,274764,2013-05-01,Assembly,"Do pass, to Consent Calendar",17,0,0,0,17
523393,278255,2013-05-09,Assembly,"AB 1391 INS.  Consent Calendar Second Day  Regular Session",75,0,0,4,79
523393,291934,2013-06-26,Senate,"Do pass as amended, and re-refer to the Committee on 	Appropriations",9,0,0,0,9
523393,297943,2013-08-22,Senate,"Assembly 3rd Reading AB1391 Committee on INS. (Perea) By Calderon",36,0,3,0,39
523393,298076,2013-08-26,Assembly,"AB 1391 INS.  Concurrence in Senate Amendments By PEREA",78,0,0,0,78
523396,275660,2013-05-01,Assembly,"Do pass, to Consent Calendar",7,0,0,0,7
523396,278198,2013-05-09,Assembly,"AB 1390 AGRI.  Consent Calendar Second Day  Regular Session",75,0,0,4,79
523396,289389,2013-06-18,Senate,"Do pass and be placed on the Consent Calendar",3,0,2,0,5
523396,291231,2013-06-24,Senate,"Consent Calendar 2nd AB1390 Committee on AGRI. (Eggman)",39,0,0,0,39
523398,275628,2013-05-01,Assembly,"Do pass and re-refer to Committee on Appropriations with 	recommendation:  To Consent Calendar",7,0,0,0,7
523398,279978,2013-05-15,Assembly,"Do pass, to Consent Calendar",17,0,0,0,17
523398,283320,2013-05-23,Assembly,"AB 1389 AGRI.  Consent Calendar Second Day  Regular Session",74,0,0,4,78
523398,295753,2013-07-02,Senate,"Do pass, but re-refer to the Committee on Appropriations",4,0,1,0,5
523398,298884,2013-09-06,Senate,"Assembly 3rd Reading AB1389 Committee on AGRI. (Eggman) By Galgiani",37,0,2,0,39
523398,299303,2013-09-10,Assembly,"AB 1389 AGRI.  Concurrence in Senate Amendments By EGGMAN",78,0,0,0,78
523401,275530,2013-05-01,Assembly,"Do pass and re-refer to Committee on Appropriations with 	recommendation:  To Consent Calendar",7,0,0,0,7
523401,279680,2013-05-15,Assembly,"Do pass, to Consent Calendar",17,0,0,0,17
523401,283413,2013-05-23,Assembly,"AB 1388 AGRI.  Consent Calendar Second Day  Regular Session",74,0,0,4,78
523401,289778,2013-06-18,Senate,"Do pass, but re-refer to the Committee on Appropriations Recommend 	Consent",3,0,2,0,5
523401,296223,2013-07-08,Senate,"Consent Calendar 2nd AB1388 Committee on AGRI. (Eggman)",29,0,9,0,38
523403,272292,2013-04-24,Assembly,"Do pass and be re-referred to the Committee on Appropriations",6,1,0,0,7
523403,284082,2013-05-24,Assembly,"Do pass",12,5,0,0,17
523403,285233,2013-05-29,Assembly,"AB 1387 HERNANDEZ  Assembly Third Reading",54,23,0,2,79
523403,291851,2013-06-26,Senate,"Do pass, but re-refer to the Committee on Appropriations",3,1,1,0,5
523403,298814,2013-09-06,Senate,"Assembly 3rd Reading AB1387 Roger Hern",24,13,2,0,39
523406,272612,2013-04-24,Assembly,"Do pass and re-refer to Committee on Appropriations with 	recommendation:  To Consent Calendar",7,0,0,0,7
523406,277356,2013-05-08,Assembly,"Do pass, to Consent Calendar",17,0,0,0,17
523406,280272,2013-05-16,Assembly,"AB 1386 L.& E.  Consent Calendar Second Day  Regular Session",70,0,0,9,79
523406,288489,2013-06-12,Senate,"Do pass, but re-refer to the Committee on Appropriations",4,0,1,0,5
523406,299098,2013-09-09,Senate,"Assembly 3rd Reading AB1386 Committee on L. & E. (R.Hern",25,10,4,0,39
523406,299317,2013-09-10,Assembly,"AB 1386 L.& E.  Concurrence in Senate Amendments By HERNANDEZ",77,0,0,1,78
523409,272934,2013-04-24,Assembly,"Do pass and re-refer to Committee on Appropriations with 	recommendation:  To Consent Calendar",7,0,0,0,7
523409,277730,2013-05-08,Assembly,"Do pass",16,1,0,0,17
523409,280395,2013-05-16,Assembly,"AB 1384 L.& E.  Assembly Third Reading  By HERNANDEZ",67,3,0,9,79
523409,288638,2013-06-12,Senate,"Do pass, but re-refer to the Committee on Appropriations",4,0,1,0,5
523409,291251,2013-06-24,Senate,"Do pass",5,2,0,0,7
523409,297793,2013-08-19,Senate,"Assembly 3rd Reading AB1384 Committee on L. & E. (R.Hern",25,11,3,0,39
523412,278164,2013-05-08,Assembly,"Do pass",5,2,0,0,7
523412,280234,2013-05-16,Assembly,"AB 1383 L.& E.  Assembly Third Reading  By HERNANDEZ",48,20,0,11,79
523412,292050,2013-06-26,Senate,"Do pass",3,1,1,0,5
524906,278078,2013-05-08,Assembly,"Be adopted",5,2,0,0,7
524906,298102,2013-08-26,Senate,"Assembly 3rd Reading ACR30 V. Manuel P",29,4,6,0,39
526003,274092,2013-04-29,Assembly,"Do pass and be re-referred to the Committee on Appropriations to 	Consent Calendar",12,0,0,0,12
526003,279721,2013-05-15,Assembly,"Do pass, to Consent Calendar",17,0,0,0,17
526003,283092,2013-05-23,Assembly,"AB 1396 B.& F.  Consent Calendar Second Day  Regular Session",74,0,0,4,78
526035,275226,2013-04-30,Assembly,"Do pass",8,0,0,2,10
526035,283923,2013-05-24,Assembly,"AB 1397 V. A.  Assembly Third Reading  By MURATSUCHI",71,0,0,7,78
526035,374069,2014-06-24,Senate,"Do pass, but re-refer to the Committee on Appropriations Recommend 	Consent",6,0,1,0,7
526035,377942,2014-08-20,Senate,"Assembly 3rd Reading AB1397 Committee on V. A. (Quirk-Silva) By 	Hueso",34,0,6,0,40
526035,378761,2014-08-27,Assembly,"Senate amendments be concurred in",7,0,0,3,10
526035,378950,2014-08-28,Assembly,"AB 1397 V. A.  Concurrence in Senate Amendments By QUIRK-SILVA",78,0,0,1,79
526065,277213,2013-05-07,Assembly,"From committee:  Be adopted.  To third reading",5,1,0,1,7
526065,278148,2013-05-09,Assembly,"AJR 15 ALEJO  Assembly Third Reading",53,16,0,10,79
526065,290686,2013-06-20,Senate,"Assembly 3rd Reading AJR15 Alejo By Monning",28,8,3,0,39
527674,270038,2013-04-22,Assembly,"From committee:  Be adopted.  To third reading",11,0,0,0,11
527674,299597,2013-09-12,Senate,"Special Consent #10 ACR31 V. Manuel P",39,0,0,0,39
527696,250627,2013-03-19,Assembly,"From committee:  Be adopted.  To third reading",10,0,0,1,11
527717,248789,2013-03-14,Assembly,"From committee:  Be adopted.  To third reading",10,0,0,1,11
531151,267414,2013-04-17,Senate,"Do pass and be placed on the Consent Calendar",8,0,1,0,9
531151,275768,2013-05-02,Senate,"Consent Calendar 2nd SB816 Committee on Health (Hernandez)",35,0,3,0,38
531151,288319,2013-06-11,Assembly,"Do pass and be re-referred to the Committee on Governmental 	Organization to Consent Calendar",18,0,0,1,19
531151,292017,2013-06-26,Assembly,"Do pass and re-refer to Committee on Appropriations with 	recommendation:  To Consent Calendar",12,0,0,5,17
531151,297499,2013-08-14,Assembly,"Do pass, to Consent Calendar",17,0,0,0,17
531151,297939,2013-08-22,Assembly,"SB 816 HEALTH  Consent Calendar Second Day  Regular Session",78,0,0,0,78
531198,271509,2013-04-23,Assembly,"Do pass and be re-referred to the Committee on Appropriations",9,0,0,0,9
531198,277324,2013-05-08,Assembly,"Do pass, to Consent Calendar",17,0,0,0,17
531198,280381,2013-05-16,Assembly,"AB 1400 J., E.D.& E.  Consent Calendar Second Day  Regular Session",70,0,0,9,79
531198,288640,2013-06-12,Senate,"Do pass, but re-refer to the Committee on Appropriations Recommend 	Consent",9,0,0,0,9
531198,291361,2013-06-24,Senate,"Placed on Appropriations Suspense file",7,0,0,0,7
531198,298392,2013-08-30,Senate,"Do pass as amended",7,0,0,0,7
531198,299047,2013-09-09,Senate,"Assembly 3rd Reading AB1400 Committee on Jobs, Economic Devel By 	Hernandez",39,0,0,0,39
531198,299268,2013-09-10,Assembly,"AB 1400 J., E.D.& E.  Concurrence in Senate Amendments By PEREZ, 	V.M",77,1,0,0,78
531248,271696,2013-04-23,Assembly,"Do pass and be re-referred to the Committee on Appropriations to 	Consent Calendar",9,0,0,0,9
531248,277523,2013-05-08,Assembly,"Do pass, to Consent Calendar",17,0,0,0,17
531248,280276,2013-05-16,Assembly,"AB 1399 J., E.D.& E.  Consent Calendar Second Day  Regular Session",70,0,0,9,79
531248,291349,2013-06-24,Senate,"Do pass, but re-refer to the Committee on Appropriations",9,0,1,0,10
531248,374469,2014-06-25,Senate,"Do pass, but re-refer to the Committee on Appropriations",7,0,0,0,7
531248,376943,2014-08-11,Senate,"Placed on Appropriations Suspense file",7,0,0,0,7
531248,377199,2014-08-14,Senate,"Do pass as amended",5,0,2,0,7
531248,378758,2014-08-27,Senate,"Assembly 3rd Reading AB1399 Medina By Lara",35,0,5,0,40
531248,378992,2014-08-29,Assembly,"Senate amendments be concurred in",9,0,0,0,9
531248,378993,2014-08-29,Assembly,"AB 1399 MEDINA  Concurrence in Senate Amendments",74,2,0,3,79
531301,274271,2013-04-29,Assembly,"Do pass and re-refer to Committee on Appropriations with 	recommendation:  To Consent Calendar",9,0,0,0,9
531301,279853,2013-05-15,Assembly,"Do pass, to Consent Calendar",17,0,0,0,17
531301,283303,2013-05-23,Assembly,"AB 1398 NAT. RES.  Consent Calendar Second Day  Regular Session",74,0,0,4,78
531301,290060,2013-06-19,Senate,"Do pass, but re-refer to the Committee on Appropriations",9,0,0,0,9
531301,299079,2013-09-09,Senate,"Assembly 3rd Reading AB1398 Committee on NAT. RES. (Chesbro) By Hill",39,0,0,0,39
531301,299302,2013-09-10,Assembly,"AB 1398 NAT. RES.  Concurrence in Senate Amendments By CHESBRO",78,0,0,0,78
532074,270365,2013-04-22,Senate,"Senate 3rd Reading SCR22 Evans",37,0,1,0,38
532074,289323,2013-06-17,Assembly,"Be adopted, to Consent Calendar",9,0,0,2,11
532074,290178,2013-06-20,Assembly,"SCR 22 Evans  Consent Calendar Second Day  Regular Session",79,0,0,0,79
532091,259560,2013-04-04,Assembly,"From committee:  Be adopted.  To third reading",11,0,0,0,11
532091,263484,2013-04-11,Senate,"Special Consent Cal ACR33 John A. P",36,0,2,0,38
532108,263505,2013-04-11,Assembly,"From committee:  Be adopted.  To third reading",10,1,0,0,11
532108,284603,2013-05-28,Senate,"Assembly 3rd Reading ACR32 Lowenthal By Lara",37,0,2,0,39
532125,274160,2013-04-30,Assembly,"Do pass and be re-referred to the Committee on Appropriations",8,0,0,2,10
532125,280005,2013-05-15,Assembly,"Do pass",16,0,0,1,17
532125,283887,2013-05-24,Assembly,"AB 1405 JUD.  Assembly Third Reading  By WIECKOWSKI",69,0,0,9,78
532125,289506,2013-06-18,Senate,"Do pass, but re-refer to the Committee on Appropriations Recommend 	Consent",6,0,1,0,7
532125,296215,2013-07-08,Senate,"Consent Calendar 2nd AB1405 Committee on JUD. (Wieckowski)",29,0,9,0,38
532143,276782,2013-05-07,Assembly,"Do pass",10,0,0,0,10
532143,280275,2013-05-16,Assembly,"AB 1404 JUD.  Assembly Third Reading  By WIECKOWSKI",72,0,0,7,79
532143,288018,2013-06-11,Senate,"Do pass as amended. To Consent Calendar",7,0,0,0,7
532143,291179,2013-06-24,Senate,"Consent Calendar 2nd AB1404 Committee on JUD. (Wieckowski)",39,0,0,0,39
532143,292129,2013-06-27,Assembly,"AB 1404 JUD.  Concurrence in Senate Amendments By WIECKOWSKI",68,6,0,5,79
532161,266435,2013-04-16,Assembly,"Do pass and be re-referred to the Committee on Appropriations",10,0,0,0,10
532161,283956,2013-05-24,Assembly,"Do pass",17,0,0,0,17
532161,285092,2013-05-29,Assembly,"AB 1403 JUD.  Assembly Third Reading  By WIECKOWSKI",65,11,0,3,79
532161,291535,2013-06-25,Senate,"Do pass, but re-refer to the Committee on Appropriations",6,1,0,0,7
532161,297403,2013-08-12,Senate,"Placed on Appropriations Suspense file",6,0,1,0,7
532161,298508,2013-08-30,Senate,"Do pass",6,1,0,0,7
532161,298967,2013-09-09,Senate,"Assembly 3rd Reading AB1403 Committee on JUD. (Wieckowski) By 	Corbett",31,6,2,0,39
532161,299131,2013-09-10,Assembly,"AB 1403 JUD.  Concurrence in Senate Amendments By WIECKOWSKI",59,16,0,3,78
532178,274270,2013-04-30,Assembly,"Do pass, to Consent Calendar",10,0,0,0,10
532178,276387,2013-05-06,Assembly,"AB 1402 JUD.  Consent Calendar Second Day  Regular Session",77,0,0,2,79
532195,271046,2013-04-23,Assembly,"Do pass",7,3,0,0,10
532195,272335,2013-04-25,Assembly,"AB 1401 JUD.  Assembly Third Reading  By WIECKOWSKI",45,26,0,8,79
532195,291668,2013-06-25,Senate,"Do pass",5,2,0,0,7
532195,297764,2013-08-19,Senate,"Assembly 3rd Reading AB1401 Committee on JUD. (Wieckowski) By De 	Le",25,11,3,0,39
532195,297889,2013-08-22,Assembly,"AB 1401 JUD.  Concurrence in Senate Amendments By WIECKOWSKI",48,28,0,2,78
533597,270693,2013-04-22,Assembly,"Do pass and be re-referred to the Committee on Natural Resources to 	Consent Calendar",15,0,0,0,15
533597,276546,2013-05-06,Assembly,"Do pass, to Consent Calendar",8,0,0,1,9
533625,270839,2013-04-22,Assembly,"Do pass and re-refer to Committee on Appropriations with 	recommendation:  To Consent Calendar",15,0,0,0,15
533625,279663,2013-05-15,Assembly,"Do pass, to Consent Calendar",17,0,0,0,17
533625,283332,2013-05-23,Assembly,"AB 1407 U.& C.  Consent Calendar Second Day  Regular Session",74,0,0,4,78
533625,296332,2013-07-08,Senate,"Do pass as amended, and re-refer to the Committee on Appropriations",6,1,4,0,11
533625,297760,2013-08-19,Senate,"Placed on Appropriations Suspense file",7,0,0,0,7
533653,270856,2013-04-22,Assembly,"Do pass and be re-referred to the Committee on Natural Resources to 	Consent Calendar",15,0,0,0,15
533653,276496,2013-05-06,Assembly,"Do pass, to Consent Calendar",8,0,0,1,9
533682,270788,2013-04-22,Assembly,"Do pass and be re-referred to the Committee on Appropriations",10,5,0,0,15
533682,277527,2013-05-08,Assembly,"Do pass",12,5,0,0,17
533682,280414,2013-05-16,Assembly,"AB 1409 U.& C.  Assembly Third Reading  By BRADFORD",50,21,0,8,79
533682,289736,2013-06-18,Senate,"Do pass, but re-refer to the Committee on Appropriations",6,1,4,0,11
533682,295239,2013-07-01,Senate,"Do pass as amended",4,2,1,0,7
533682,298649,2013-09-03,Senate,"Assembly 3rd Reading AB1409 Committee on U. & C. (Bradford) By Hill",25,10,4,0,39
533682,298650,2013-09-03,Senate,"Assembly 3rd Reading AB1409 Committee on U. & C. (Bradford) 	Reconsider",37,0,2,0,39
533682,299558,2013-09-11,Assembly,"Senate amendments be concurred in",14,0,0,0,14
533682,299559,2013-09-11,Senate,"Assembly 3rd Reading AB1409 Bradford Urgency Clause",31,0,8,0,39
533682,299806,2013-09-12,Assembly,"AB 1409 BRADFORD  Concurrence- Urgency Added",74,1,0,3,78
533710,275420,2013-04-30,Assembly,"Do pass and be re-referred to the Committee on Appropriations",8,0,0,2,10
533710,277496,2013-05-08,Assembly,"Do pass, to Consent Calendar",17,0,0,0,17
533710,280269,2013-05-16,Assembly,"AB 1410 V. A.  Consent Calendar Second Day  Regular Session",70,0,0,9,79
533710,291809,2013-06-25,Senate,"Do pass, but re-refer to the Committee on Appropriations",7,0,0,0,7
533710,298685,2013-09-03,Senate,"Assembly 3rd Reading AB1410 Committee on V. A. (Muratsuchi) By Roth",38,0,1,0,39
533738,266548,2013-04-16,Senate,"Be adopted, but re-refer to the Committee on Appropriations 	Recommend Consent",10,0,1,0,11
533738,275552,2013-05-02,Senate,"Consent Calendar 2nd SCR23 Cannella",35,0,3,0,38
533738,297213,2013-08-12,Assembly,"Be adopted, and re-refer to Committee on Appropriations with 	recommendation:  To Consent Calendar",15,0,0,1,16
533738,297872,2013-08-21,Assembly,"Be adopted, to Consent Calendar",17,0,0,0,17
533738,298090,2013-08-26,Assembly,"SCR 23 Cannella  Consent Calendar Second Day  Regular Session",77,0,0,1,78
533738,298428,2013-08-30,Senate,"Special Consent #9 SCR23 Cannella",38,0,1,0,39
533766,256779,2013-04-01,Senate,"Senate 3rd Reading SCR24 Hernandez",27,2,9,0,38
533766,297611,2013-08-15,Assembly,"Be adopted, to Consent Calendar",7,0,0,4,11
533794,266857,2013-04-16,Senate,"Be adopted",8,1,2,0,11
533794,268613,2013-04-18,Senate,"Senate 3rd Reading SJR7 Lieu",26,9,3,0,38
533794,297568,2013-08-14,Assembly,"Be adopted",7,2,0,0,9
533794,298096,2013-08-26,Assembly,"SJR7 Lieu  Senate Third Reading  By MURATSUCHI",54,19,0,5,78
533794,298427,2013-08-30,Senate,"Unfinished Business SJR7 Lieu Concurrence",28,10,1,0,39
534454,261388,2013-04-08,Senate,"Senate 3rd Reading SCR26 Correa",37,0,1,0,38
534454,279331,2013-05-14,Assembly,"Be adopted",6,0,0,1,7
534454,284628,2013-05-28,Senate,"Unfinished Business SCR26 Correa Concurrence",38,0,1,0,39
534468,279648,2013-05-15,Senate,"Be adopted",2,0,5,0,7
534468,279649,2013-05-15,Senate,"Reconsideration granted",7,0,0,0,7
534483,270980,2013-04-23,Senate,"Do pass, but re-refer to the Committee on Appropriations Recommend 	Consent",9,0,2,0,11
534483,278009,2013-05-09,Senate,"Consent Calendar 2nd SB820 Committee on G.O. (Wright)",34,0,4,0,38
534483,290111,2013-06-19,Assembly,"Do pass and be re-referred to the Committee on Appropriations",12,0,0,1,13
534483,296151,2013-07-03,Assembly,"Do pass, to Consent Calendar",17,0,0,0,17
534483,297133,2013-08-08,Assembly,"SB 820 G.O.  Consent Calendar Second Day  Regular Session",77,0,0,1,78
534483,299102,2013-09-09,Assembly,"SB 820 G.O.  Third Reading Urgency  By FRAZIER",77,0,0,1,78
534483,299235,2013-09-10,Senate,"Unfinished Business SB820 Committee on G.O. (Wright) Urgency Clause",38,0,1,0,39
534496,271135,2013-04-23,Senate,"Do pass and be placed on the Consent Calendar",9,0,2,0,11
534496,273550,2013-04-29,Senate,"Consent Calendar 2nd SB819 Committee on G.O. (Wright)",37,0,1,0,38
534496,288623,2013-06-12,Assembly,"Do pass, to Consent Calendar",16,0,0,1,17
534496,289071,2013-06-15,Assembly,"SB 819 G.O.  Consent Calendar Second Day  Regular Session",75,0,0,4,79
534496,299543,2013-09-11,Assembly,"Do pass, to Consent Calendar",16,0,0,1,17
534496,299694,2013-09-12,Senate,"Unfinished Supp 2 SB819 Committee on G.O. (Wright) Concurrence",37,0,2,0,39
534496,299840,2013-09-12,Assembly,"SB 819 G.O.  Consent Calendar First Day  Regular Session",78,0,0,0,78
534511,271129,2013-04-23,Senate,"Do pass, but re-refer to the Committee on Appropriations Recommend 	Consent",9,0,2,0,11
534511,278004,2013-05-09,Senate,"Consent Calendar 2nd SB818 Committee on G.O. (Wright)",34,0,4,0,38
534511,288461,2013-06-12,Assembly,"Do pass and re-refer to Committee on Appropriations with 	recommendation:  To Consent Calendar",16,0,0,1,17
534511,296034,2013-07-03,Assembly,"Do pass, to Consent Calendar",17,0,0,0,17
534511,298835,2013-09-06,Assembly,"SB 818 G.O.  Senate Third Reading  By HALL",77,0,0,1,78
534511,299785,2013-09-12,Senate,"Special Consent #10 SB818 Committee on G.O. (Wright)",39,0,0,0,39
534524,271150,2013-04-23,Senate,"Do pass, but re-refer to the Committee on Appropriations Recommend 	Consent",9,0,2,0,11
534524,278250,2013-05-09,Senate,"Consent Calendar 2nd SB817 Committee on G.O. (Wright)",34,0,4,0,38
534524,288499,2013-06-12,Assembly,"Do pass and be re-referred to the Committee on Appropriations",15,0,0,2,17
534524,295952,2013-07-03,Assembly,"Do pass, to Consent Calendar",17,0,0,0,17
534524,297130,2013-08-08,Assembly,"SB 817 G.O.  Consent Calendar Second Day  Regular Session",77,0,0,1,78
535782,265383,2013-04-15,Senate,"Senate 3rd Reading SJR8 Correa",32,0,6,0,38
535782,298135,2013-08-27,Assembly,"From committee:  Be adopted.  To third reading",10,0,0,0,10
535782,298627,2013-09-03,Assembly,"SJR8 Correa  Senate Third Reading  By GARCIA",70,1,0,7,78
535784,275434,2013-04-30,Assembly,"Do pass",8,0,0,2,10
535784,280263,2013-05-16,Senate,"Special Consent Cal ACR36 Atkins",37,0,1,0,38
535788,278112,2013-05-09,Assembly,"From committee:  Be adopted.  To third reading",11,0,0,0,11
535788,298023,2013-08-26,Senate,"Assembly 3rd Reading ACR35 Alejo By Hueso",39,0,0,0,39
535791,265140,2013-04-15,Assembly,"From committee:  Be adopted.  To third reading",11,0,0,0,11
535791,275662,2013-05-02,Senate,"Special Consent Cal ACR34 Cooley",35,0,3,0,38
536368,274367,2013-04-29,Assembly,"Do pass and be re-referred to the Committee on Appropriations",6,2,0,1,9
536368,277336,2013-05-08,Assembly,"Do pass",12,5,0,0,17
536368,283348,2013-05-23,Assembly,"AB 1411 REV.& TAX.  Assembly Third Reading  By BOCANEGRA  Amend By 	BOCANEGRA  Set #1",52,21,0,5,78
536368,284851,2013-05-28,Assembly,"AB 1411 REV.& TAX.  Assembly Third Reading  By BOCANEGRA",52,24,0,3,79
536368,296059,2013-07-03,Senate,"Do pass, but re-refer to the Committee on Appropriations",5,2,0,0,7
536368,297530,2013-08-15,Senate,"Assembly 3rd Reading AB1411 Committee on REV. & TAX. (Bocaneg By 	Wolk",26,12,1,0,39
536380,271532,2013-04-23,Assembly,"Do pass and be re-referred to the Committee on Revenue and Taxation 	to Consent Calendar",7,0,0,0,7
536380,274138,2013-04-29,Assembly,"Do pass and be re-referred to the Committee on Appropriations",8,0,0,1,9
536380,283764,2013-05-24,Assembly,"Do pass",17,0,0,0,17
536380,285035,2013-05-29,Assembly,"AB 1413 REV.& TAX.  Assembly Third Reading  By BOCANEGRA",76,0,0,3,79
536380,295976,2013-07-03,Senate,"Do pass, but re-refer to the Committee on Appropriations Recommend 	Consent",7,0,0,0,7
536380,297318,2013-08-12,Senate,"Placed on Appropriations Suspense file",6,0,1,0,7
536392,274212,2013-04-29,Assembly,"Do pass and be re-referred to the Committee on Appropriations",8,0,0,1,9
536392,284091,2013-05-24,Assembly,"Do pass as amended",17,0,0,0,17
536392,285682,2013-05-30,Assembly,"AB 1412 REV.& TAX.  Assembly Third Reading  By BOCANEGRA",78,0,0,1,79
536392,296062,2013-07-03,Senate,"Do pass as amended, and re-refer to the Committee on 	Appropriations",7,0,0,0,7
536392,299528,2013-09-11,Senate,"W/O REF. TO FILE AB1412 Bocanegra By Lieu",36,1,2,0,39
536392,299708,2013-09-12,Assembly,"AB 1412 BOCANEGRA  Concurrence in Senate Amendments",77,0,0,1,78
537077,273521,2013-04-29,Senate,"Do pass, but re-refer to the Committee on Appropriations",9,0,1,0,10
537077,284610,2013-05-28,Senate,"Special Consent #6 SB821 Committee on B.P. & E.D. (Price)",39,0,0,0,39
537077,291703,2013-06-25,Assembly,"Do pass as amended and be re-referred to the Committee on 	Appropriations",13,0,0,0,13
537077,297445,2013-08-14,Assembly,"Do pass",16,0,0,1,17
537077,298028,2013-08-26,Assembly,"SB 821 B. P.& E.D.  Senate Third Reading  By GORDON",77,0,0,1,78
537077,298268,2013-08-30,Senate,"Special Consent #9 SB821 Committee on B.P. & E.D. (Lieu)",38,0,1,0,39
537080,273816,2013-04-29,Senate,"Do pass",9,0,1,0,10
537080,276316,2013-05-06,Senate,"Senate 3rd Reading SB823 Committee on B.P. & E.D. (Price) Urgency 	Clause",34,0,4,0,38
537080,288123,2013-06-11,Assembly,"Do pass and re-refer to Committee on Appropriations with 	recommendation:  To Consent Calendar",12,0,0,1,13
537080,298515,2013-08-30,Assembly,"Do pass",17,0,0,0,17
537080,299471,2013-09-11,Senate,"Unfinished Supp 1 SB823 Committee on B.P. & E.D. (Lieu) Concurrence",39,0,0,0,39
537080,299472,2013-09-11,Assembly,"SB 823 B. P.& E.D.  Third Reading Urgency  By JONES-SAWYER",77,0,0,1,78
537085,275602,2013-05-01,Assembly,"Do pass and be re-referred to the Committee on Appropriations",12,1,0,0,13
537085,279940,2013-05-15,Assembly,"Do pass",17,0,0,0,17
537085,283967,2013-05-24,Assembly,"AB 1415A& A.R.  Assembly Third Reading  By FRAZIER",70,0,0,8,78
537085,291810,2013-06-25,Senate,"Do pass, but re-refer to the Committee on Appropriations Recommend 	Consent",11,0,0,0,11
537090,270849,2013-04-23,Assembly,"Do pass and re-refer to Committee on Appropriations with 	recommendation:  To Consent Calendar",7,0,0,0,7
537090,274921,2013-05-01,Assembly,"Do pass, to Consent Calendar",17,0,0,0,17
537090,278088,2013-05-09,Assembly,"AB 1417 E.& R.  Consent Calendar Second Day  Regular Session",75,0,0,4,79
537090,289502,2013-06-18,Senate,"Do pass, but re-refer to the Committee on Appropriations Recommend 	Consent",4,0,1,0,5
537090,299029,2013-09-09,Senate,"Assembly 3rd Reading AB1417 Committee on E. & R. (Fong) By Anderson",39,0,0,0,39
537090,299229,2013-09-10,Assembly,"AB 1417 E.& R.  Concurrence in Senate Amendments By FONG",78,0,0,0,78
537095,270847,2013-04-23,Assembly,"Do pass and re-refer to Committee on Appropriations with 	recommendation:  To Consent Calendar",7,0,0,0,7
537095,274710,2013-05-01,Assembly,"Do pass, to Consent Calendar",17,0,0,0,17
537095,278002,2013-05-09,Assembly,"AB 1418 E.& R.  Consent Calendar Second Day  Regular Session",75,0,0,4,79
537095,289420,2013-06-18,Senate,"Do pass, but re-refer to the Committee on Appropriations Recommend 	Consent",4,0,1,0,5
537095,299077,2013-09-09,Senate,"Assembly 3rd Reading AB1418 Committee on E. & R. (Fong) By Torres",39,0,0,0,39
537104,275282,2013-05-01,Senate,"Do pass and be placed on the Consent Calendar",7,0,0,0,7
537104,278244,2013-05-09,Senate,"Consent Calendar 2nd SB824 Committee on GOV. & F. (Wolk)",34,0,4,0,38
537104,297206,2013-08-12,Assembly,"Do pass, to Consent Calendar",9,0,0,0,9
537104,297585,2013-08-15,Assembly,"SB 824 GOV.& F.  Consent Calendar Second Day  Regular Session",76,0,0,2,78
537109,273554,2013-04-29,Senate,"Do pass, but re-refer to the Committee on Appropriations",9,0,1,0,10
537109,281362,2013-05-20,Senate,"Special Consent #5 SB822 Committee on B.P. & E.D. (Price)",36,0,3,0,39
537109,289430,2013-06-18,Assembly,"Do pass and re-refer to Committee on Appropriations with 	recommendation:  To Consent Calendar",12,0,0,1,13
537109,296112,2013-07-03,Assembly,"Do pass, to Consent Calendar",17,0,0,0,17
537109,297729,2013-08-19,Assembly,"SB 822 B. P.& E.D.  Senate Third Reading  Amend By BONILLA  Set #1",52,24,0,2,78
537109,298040,2013-08-26,Assembly,"SB 822 B. P.& E.D.  Senate Third Reading",75,1,0,2,78
537109,298407,2013-08-30,Senate,"Unfinished Business SB822 Committee on B.P. & E.D. (Lieu) 	Concurrence",37,0,2,0,39
537114,275787,2013-05-01,Assembly,"Do pass and be re-referred to the Committee on Appropriations",12,1,0,0,13
537114,279701,2013-05-15,Assembly,"Do pass",17,0,0,0,17
537114,283891,2013-05-24,Assembly,"AB 1416A& A.R.  Assembly Third Reading  By FRAZIER",71,0,0,7,78
537114,291806,2013-06-25,Senate,"Do pass, but re-refer to the Committee on Appropriations Recommend 	Consent",11,0,0,0,11
537119,275243,2013-05-01,Senate,"Do pass, but re-refer to the Committee on Appropriations Recommend 	Consent",7,0,0,0,7
537119,280419,2013-05-16,Senate,"Consent Calendar 2nd SB825 Committee on GOV. & F. (Wolk)",37,0,1,0,38
537119,291948,2013-06-26,Assembly,"Do pass and be re-referred to the Committee on Revenue and Taxation 	to Consent Calendar",9,0,0,0,9
537119,297191,2013-08-12,Assembly,"Do pass and be re-referred to the Committee on Appropriations to 	Consent Calendar",9,0,0,0,9
537119,297841,2013-08-21,Assembly,"Do pass, to Consent Calendar",17,0,0,0,17
537119,298259,2013-08-30,Assembly,"SB 825 GOV.& F.  Consent Calendar Second Day  Regular Session",78,0,0,0,78
537119,298599,2013-09-03,Senate,"Unfinished Business SB825 Committee on GOV. & F. (Wolk) Concurrence",37,0,2,0,39
537124,270886,2013-04-23,Assembly,"Do pass as amended and re-refer to Committee on Appropriations 	with recommendation:  To Consent Calendar",7,0,0,0,7
537124,277457,2013-05-08,Assembly,"Do pass, to Consent Calendar",17,0,0,0,17
537124,280214,2013-05-16,Assembly,"AB 1419 E.& R.  Consent Calendar Second Day  Regular Session",70,0,0,9,79
537124,289764,2013-06-18,Senate,"Do pass, but re-refer to the Committee on Appropriations Recommend 	Consent",4,0,1,0,5
537124,298088,2013-08-26,Senate,"Assembly 3rd Reading AB1419 Committee on E. & R. (Fong) By Torres",39,0,0,0,39
537124,298439,2013-08-30,Assembly,"AB 1419 E.& R.  Concurrence in Senate Amendments By FONG",78,0,0,0,78
537129,280376,2013-05-16,Assembly,"From committee:  Be adopted.  To third reading",10,0,0,1,11
537129,285675,2013-05-30,Senate,"Special Consent Cal ACR39 Perea",38,0,1,0,39
537133,275897,2013-05-01,Assembly,"Do pass and be re-referred to the Committee on Appropriations",12,1,0,0,13
537133,279993,2013-05-15,Assembly,"Do pass",17,0,0,0,17
537133,284032,2013-05-24,Assembly,"AB 1414A& A.R.  Assembly Third Reading  By FRAZIER",71,0,0,7,78
537133,323763,2014-02-18,Senate,"Do pass, but re-refer to the Committee on Appropriations",5,0,0,0,5
537133,341920,2014-03-13,Senate,"Assembly 3rd Reading AB1414 Committee on AGRI. (Eggman) Urgency 	Clause",31,0,8,0,39
537133,348184,2014-03-26,Assembly,"Senate amendments be concurred in",6,0,0,1,7
537133,351755,2014-04-03,Assembly,"AB 1414 AGRI.  Concurrence- Urgency Added  By EGGMAN",76,0,0,3,79
537709,276276,2013-05-06,Senate,"Senate 3rd Reading SJR9 Huff",34,0,4,0,38
537709,298127,2013-08-27,Assembly,"Be adopted as amended",10,0,0,0,10
537709,298672,2013-09-03,Assembly,"SJR9 Huff  Senate Third Reading  By WAGNER",76,0,0,2,78
537709,298855,2013-09-06,Senate,"Unfinished Business SJR9 Huff Concurrence",38,0,1,0,39
537710,272548,2013-04-24,Assembly,"Do pass and re-refer to Committee on Appropriations with 	recommendation:  To Consent Calendar",16,0,0,1,17
537710,277341,2013-05-08,Assembly,"Do pass, to Consent Calendar",17,0,0,0,17
537710,280377,2013-05-16,Assembly,"AB 1425 G.O.  Consent Calendar Second Day  Regular Session",70,0,0,9,79
537710,288203,2013-06-11,Senate,"Do pass, but re-refer to the Committee on Appropriations Recommend 	Consent",11,0,0,0,11
537710,299797,2013-09-12,Assembly,"AB 1425 G.O.  Concurrence in Senate Amendments By HALL",78,0,0,0,78
537710,299798,2013-09-12,Senate,"Special Consent #10 AB1425 Committee on G.O. (Hall) By Wright",39,0,0,0,39
537711,272239,2013-04-24,Assembly,"Do pass and re-refer to Committee on Appropriations with 	recommendation:  To Consent Calendar",16,0,0,1,17
537711,283988,2013-05-24,Assembly,"Do pass",17,0,0,0,17
537711,285273,2013-05-29,Assembly,"AB 1423 G.O.  Assembly Third Reading  By HALL",77,0,0,2,79
537711,291814,2013-06-25,Senate,"Do pass, but re-refer to the Committee on Appropriations Recommend 	Consent",11,0,0,0,11
537711,297385,2013-08-12,Senate,"Do pass",5,0,2,0,7
537711,299750,2013-09-12,Senate,"Special Consent #10 AB1423 Committee on G.O. (Hall)",39,0,0,0,39
537712,259629,2013-04-04,Assembly,"From committee:  Be adopted.  To third reading",11,0,0,0,11
537712,263453,2013-04-11,Senate,"Special Consent Cal ACR40 John A. P",36,0,2,0,38
537715,274277,2013-04-29,Assembly,"Be adopted, and re-refer to Committee on Appropriations with 	recommendation:  To Consent Calendar",16,0,0,0,16
537715,277530,2013-05-08,Assembly,"Be adopted, to Consent Calendar",17,0,0,0,17
537715,280282,2013-05-16,Assembly,"ACR 41 CHAVEZ  Consent Calendar Second Day  Regular Session",70,0,0,9,79
537715,288282,2013-06-11,Senate,"Be adopted, but re-refer to the Committee on Appropriations 	Recommend Consent",11,0,0,0,11
537715,295556,2013-07-01,Senate,"Consent Calendar 2nd ACR41 Ch",33,0,5,0,38
537716,277440,2013-05-07,Senate,"Do pass and be placed on the Consent Calendar",6,0,1,0,7
537716,280293,2013-05-16,Senate,"Consent Calendar 2nd SB826 Committee on Jud. (Evans)",37,0,1,0,38
537716,289507,2013-06-18,Assembly,"Do pass, to Consent Calendar",9,0,0,1,10
537716,291240,2013-06-24,Assembly,"SB 826 JUD.  Consent Calendar Second Day  Regular Session",75,0,0,4,79
537718,275622,2013-05-01,Assembly,"Do pass and be re-referred to the Committee on Appropriations",12,0,0,1,13
537718,279949,2013-05-15,Assembly,"Do pass, to Consent Calendar",17,0,0,0,17
537718,283357,2013-05-23,Assembly,"AB 1420A& A.R.  Consent Calendar Second Day  Regular Session",74,0,0,4,78
537718,291807,2013-06-25,Senate,"Do pass, but re-refer to the Committee on Appropriations Recommend 	Consent",11,0,0,0,11
537718,297582,2013-08-15,Senate,"Consent Calendar 2nd AB1420 Committee on ACC. & ADM. REV. (Fr",38,0,1,0,39
537718,297761,2013-08-19,Assembly,"AB 1420A& A.R.  Concurrence in Senate Amendments By FRAZIER",77,0,0,1,78
537719,271756,2013-04-23,Assembly,"Do pass and be re-referred to the Committee on Revenue and Taxation",9,0,0,0,9
537719,274149,2013-04-29,Assembly,"Do pass and be re-referred to the Committee on Appropriations",8,0,0,1,9
537719,277400,2013-05-08,Assembly,"Do pass, to Consent Calendar",17,0,0,0,17
537719,280242,2013-05-16,Assembly,"AB 1422 J., E.D.& E.  Consent Calendar Second Day  Regular Session",70,0,0,9,79
537719,296056,2013-07-03,Senate,"Do pass as amended, and re-refer to the Committee on 	Appropriations",7,0,0,0,7
537719,299003,2013-09-09,Senate,"Assembly 3rd Reading AB1422 Committee on Jobs, Economic Devel By 	Correa",38,0,1,0,39
537719,299243,2013-09-10,Assembly,"AB 1422 J., E.D.& E.  Concurrence in Senate Amendments By PEREZ, 	V.M",78,0,0,0,78
537722,277453,2013-05-08,Assembly,"Do pass, to Consent Calendar",16,0,0,1,17
537722,280262,2013-05-16,Assembly,"AB 1424 G.O.  Consent Calendar Second Day  Regular Session",70,0,0,9,79
537722,288274,2013-06-11,Senate,"Do pass and be placed on the Consent Calendar",11,0,0,0,11
537722,379087,2014-08-29,Assembly,"AB 1424 G.O.  Concurrence in Senate Amendments By HALL",78,0,0,1,79
537722,379088,2014-08-29,Senate,"Consent Calendar 2nd AB1424 Committee on G.O. (Hall)",34,0,6,0,40
537723,277585,2013-05-08,Assembly,"Do pass, to Consent Calendar",16,0,0,1,17
537723,280310,2013-05-16,Assembly,"AB 1426 G.O.  Consent Calendar Second Day  Regular Session",70,0,0,9,79
537723,288090,2013-06-11,Senate,"Do pass and be placed on the Consent Calendar",11,0,0,0,11
537724,275576,2013-05-01,Assembly,"Do pass as amended and be re-referred to the Committee on 	Appropriations",12,0,0,1,13
537724,279775,2013-05-15,Assembly,"Do pass, to Consent Calendar",17,0,0,0,17
537724,283416,2013-05-23,Assembly,"AB 1421A& A.R.  Consent Calendar Second Day  Regular Session",74,0,0,4,78
537724,288058,2013-06-11,Senate,"Do pass as amended, and re-refer to the Committee on 	Appropriations",11,0,0,0,11
537724,297783,2013-08-19,Senate,"Assembly 3rd Reading AB1421 Committee on ACC. & ADM. REV. (Fr By 	Wright",37,0,2,0,39
537724,297904,2013-08-22,Assembly,"AB 1421A& A.R.  Concurrence in Senate Amendments By FRAZIER",77,1,0,0,78
541439,278230,2013-05-08,Assembly,"Do pass, to Consent Calendar",8,0,0,1,9
541439,280290,2013-05-16,Assembly,"AB 1427 L. GOV.  Consent Calendar Second Day  Regular Session",70,0,0,9,79
541439,288731,2013-06-12,Senate,"Do pass and be placed on the Consent Calendar",6,0,1,0,7
541439,291316,2013-06-24,Senate,"Consent Calendar 2nd AB1427 Committee on L. GOV. (Achadjian)",39,0,0,0,39
541440,274077,2013-04-30,Senate,"Be adopted as amended, but re-refer to the Committee on 	Appropriations Recommend Consent",11,0,0,0,11
541440,283954,2013-05-24,Senate,"Consent Calendar 2nd SCR27 Jackson",36,0,3,0,39
541440,297214,2013-08-12,Assembly,"Be adopted, and re-refer to Committee on Appropriations with 	recommendation:  To Consent Calendar",15,0,0,1,16
541440,297870,2013-08-21,Assembly,"Be adopted, to Consent Calendar",17,0,0,0,17
541440,297990,2013-08-26,Assembly,"SCR 27 Jackson  Consent Calendar Second Day  Regular Session",77,0,0,1,78
541442,275565,2013-05-01,Assembly,"Be adopted",5,1,0,1,7
541442,276287,2013-05-06,Assembly,"AJR 16 BONILLA  Assembly Third Reading",53,15,0,11,79
541442,297614,2013-08-15,Senate,"Assembly 3rd Reading AJR16 Bonilla By Liu",25,11,3,0,39
541444,265765,2013-04-15,Senate,"Senate 3rd Reading SCR29 Liu",33,0,5,0,38
541444,295400,2013-07-01,Assembly,"From committee:  Be adopted.  To third reading",11,0,0,0,11
541444,297578,2013-08-15,Senate,"Unfinished Business SCR29 Liu Concurrence",36,2,1,0,39
541446,261082,2013-04-08,Senate,"Senate 3rd Reading SCR30 Jackson",38,0,0,0,38
541446,287472,2013-06-06,Assembly,"From committee:  Be adopted.  To third reading",10,0,0,1,11
541446,289005,2013-06-14,Assembly,"From committee:  Be adopted.  To third reading",7,1,0,3,11
541446,295626,2013-07-01,Senate,"Unfinished Business SCR30 Jackson Concurrence",35,0,3,0,38
541448,260950,2013-04-08,Assembly,"From committee:  Be adopted.  To third reading",11,0,0,0,11
541448,263465,2013-04-11,Assembly,"ACR 42 DALY  Assembly Third Reading",76,0,0,3,79
541448,273650,2013-04-29,Senate,"Assembly 3rd Reading ACR42 Daly By Correa",37,0,1,0,38
541450,259576,2013-04-04,Senate,"Special Consent Cal SCR28 Block",33,0,5,0,38
541450,276537,2013-05-06,Assembly,"From committee:  Be adopted.  To third reading",10,0,0,1,11
541450,281574,2013-05-20,Senate,"Special Consent #5 SCR28 Block",36,0,3,0,39
541998,291279,2013-06-24,Senate,"Senate 3rd Reading SCR32 Corbett",31,0,8,0,39
541998,297066,2013-08-05,Assembly,"From committee:  Be adopted.  To third reading",10,0,0,1,11
541999,263462,2013-04-11,Senate,"Special Consent Cal SCR31 Hernandez",36,0,2,0,38
542000,263604,2013-04-11,Senate,"Special Consent Cal SCR33 Gaines",36,0,2,0,38
542000,290227,2013-06-20,Assembly,"From committee:  Be adopted.  To third reading",9,0,0,2,11
542000,296285,2013-07-08,Senate,"Unfinished Business SCR33 Gaines Concurrence",29,0,9,0,38
542726,263441,2013-04-11,Assembly,"From committee:  Be adopted.  To third reading",7,1,0,3,11
542726,276380,2013-05-06,Senate,"Assembly 3rd Reading ACR44 Ammiano By Galgiani",26,1,11,0,38
542729,276330,2013-05-06,Assembly,"From committee:  Be adopted.  To third reading",10,0,0,1,11
542729,280291,2013-05-16,Senate,"Special Consent Cal ACR43 Cooley",37,0,1,0,38
542731,272274,2013-04-25,Senate,"Senate 3rd Reading SCR34 Correa",34,0,4,0,38
542731,297538,2013-08-15,Assembly,"Be adopted, to Consent Calendar",8,0,0,3,11
542731,297909,2013-08-22,Assembly,"SCR 34 Correa  Consent Calendar Second Day  Regular Session",78,0,0,0,78
542733,270177,2013-04-22,Assembly,"From committee:  Be adopted.  To third reading",11,0,0,0,11
543492,287897,2013-06-10,Assembly,"Be adopted",3,3,0,3,9
545333,278149,2013-05-08,Assembly,"Be adopted",7,0,0,0,7
545333,296233,2013-07-08,Senate,"Assembly 3rd Reading ACR45 Weber By Liu",21,11,6,0,38
546024,274346,2013-04-30,Senate,"Be adopted, but re-refer to the Committee on Appropriations 	Recommend Consent",11,0,0,0,11
546024,280220,2013-05-16,Senate,"Consent Calendar 2nd SCR35 Cannella",37,0,1,0,38
546040,268740,2013-04-18,Senate,"Senate 3rd Reading SR13 Correa",36,0,2,0,38
546073,276642,2013-05-06,Assembly,"From committee:  Be adopted.  To third reading",10,0,0,1,11
546073,284054,2013-05-24,Senate,"Special Consent Cal ACR46 Achadjian",36,0,3,0,39
546543,276877,2013-05-07,Senate,"Be adopted, but re-refer to the Committee on Appropriations 	Recommend Consent",10,0,1,0,11
546543,284029,2013-05-24,Senate,"Consent Calendar 2nd SCR36 Berryhill",36,0,3,0,39
546543,295870,2013-07-01,Assembly,"Be adopted, and re-refer to Committee on Appropriations with 	recommendation:  To Consent Calendar",15,0,0,1,16
546543,296127,2013-07-03,Assembly,"Be adopted, to Consent Calendar",17,0,0,0,17
546543,297171,2013-08-08,Assembly,"SCR 36 Berryhill, T.  Consent Calendar Second Day  Regular Session",77,0,0,1,78
546563,281876,2013-05-21,Assembly,"From committee:  Be adopted.  To third reading",8,1,0,1,10
546563,284702,2013-05-28,Assembly,"AJR 18 SKINNER  Assembly Third Reading",56,10,0,13,79
546563,289611,2013-06-18,Senate,"Be adopted",5,0,2,0,7
546563,297809,2013-08-19,Senate,"Assembly 3rd Reading AJR18 Skinner By Evans",31,6,2,0,39
546563,297951,2013-08-22,Assembly,"AJR 18 SKINNER  Concurrence in Senate Amendments",55,10,0,13,78
547044,273522,2013-04-29,Senate,"Senate 3rd Reading SCR37 Beall",37,0,1,0,38
547044,283993,2013-05-24,Assembly,"From committee:  Be adopted.  To third reading",8,0,0,3,11
547044,289341,2013-06-17,Senate,"Unfinished Business SCR37 Beall",33,0,6,0,39
547057,273529,2013-04-29,Assembly,"From committee:  Be adopted.  To third reading",11,0,0,0,11
547057,286628,2013-06-03,Senate,"Assembly 3rd Reading ACR47 Skinner By Wolk",36,0,3,0,39
547585,297833,2013-08-20,Senate,"Be adopted as amended, but re-refer to the Committee on 	Appropriations Recommend Consent",10,0,1,0,11
547585,299341,2013-09-11,Senate,"Consent Calendar 2nd SCR38 Hueso",36,0,3,0,39
547585,308834,2014-01-13,Assembly,"Be adopted, and re-refer to Committee on Appropriations with 	recommendation:  To Consent Calendar",16,0,0,0,16
547585,311275,2014-01-23,Assembly,"Be adopted, to Consent Calendar",16,0,0,1,17
547586,273787,2013-04-29,Assembly,"From committee:  Be adopted.  To third reading",11,0,0,0,11
547586,280300,2013-05-16,Senate,"Special Consent Cal ACR49 Stone",37,0,1,0,38
547906,283874,2013-05-24,Senate,"Senate 3rd Reading SJR10 Lieu",30,1,8,0,39
547906,297608,2013-08-14,Assembly,"From committee:  Be adopted.  To third reading",7,0,0,0,7
547906,298690,2013-09-03,Assembly,"SJR 10 Lieu  Senate Third Reading  By CONWAY",76,1,0,1,78
547906,299207,2013-09-10,Senate,"Unfinished Business SJR10 Lieu Concurrence",37,1,1,0,39
547908,287715,2013-06-10,Assembly,"From committee:  Be adopted.  To third reading",8,0,0,3,11
547908,296219,2013-07-08,Senate,"Assembly 3rd Reading ACR50 Gordon By Wolk",33,0,5,0,38
547911,274153,2013-04-29,Assembly,"Be adopted, and re-refer to Committee on Appropriations with 	recommendation:  To Consent Calendar",16,0,0,0,16
547911,277398,2013-05-08,Assembly,"Be adopted, to Consent Calendar",17,0,0,0,17
547911,280384,2013-05-16,Assembly,"ACR 51 JONES  Consent Calendar Second Day  Regular Session",70,0,0,9,79
547911,288016,2013-06-11,Senate,"Be adopted, but re-refer to the Committee on Appropriations 	Recommend Consent",11,0,0,0,11
547911,295592,2013-07-01,Senate,"Consent Calendar 2nd ACR51 Jones",33,0,5,0,38
548307,279218,2013-05-14,Assembly,"From committee:  Be adopted.  To third reading",9,0,0,0,9
548307,287751,2013-06-10,Senate,"Special Consent Cal ACR52 Allen",32,0,7,0,39
548340,276301,2013-05-06,Senate,"Senate 3rd Reading SCR39 Correa",34,0,4,0,38
548340,297613,2013-08-15,Assembly,"Be adopted, to Consent Calendar",8,0,0,3,11
548340,297895,2013-08-22,Assembly,"SCR 39 Correa  Consent Calendar Second Day  Regular Session",78,0,0,0,78
548760,279095,2013-05-13,Assembly,"From committee:  Be adopted.  To third reading",10,0,0,1,11
548760,291301,2013-06-24,Senate,"Special Consent Cal ACR53 Quirk-Silva",39,0,0,0,39
548761,279100,2013-05-13,Assembly,"From committee:  Be adopted.  To third reading",10,0,0,1,11
548761,287720,2013-06-10,Senate,"Special Consent Cal ACR54 Jones-Sawyer",32,0,7,0,39
549642,278743,2013-05-13,Senate,"Senate 3rd Reading SJR11 DeSaulnier",34,0,4,0,38
549642,297073,2013-08-06,Assembly,"From committee:  Be adopted.  To third reading",6,0,0,1,7
549642,297194,2013-08-12,Assembly,"SJR 11 DeSaulnier  Senate Third Reading  By CHAU",77,0,0,1,78
549642,297560,2013-08-15,Senate,"Unfinished Business SJR11 DeSaulnier Concurrence",38,0,1,0,39
550034,276376,2013-05-06,Assembly,"From committee:  Be adopted.  To third reading",10,0,0,1,11
550034,283813,2013-05-24,Senate,"Special Consent Cal ACR56 Chau",36,0,3,0,39
550036,290080,2013-06-18,Assembly,"Be adopted",8,0,0,2,10
550036,297178,2013-08-08,Assembly,"AJR 19 PAN  Assembly Third Reading  Amend By PAN  Set #1",56,19,0,3,78
550036,297212,2013-08-12,Assembly,"AJR 19 PAN  Assembly Third Reading",57,1,0,20,78
550036,299284,2013-09-10,Senate,"Assembly 3rd Reading AJR19 Pan By Leno",33,1,5,0,39
550036,299542,2013-09-11,Assembly,"AJR 19 PAN  Concurrence in Senate Amendments",60,8,0,10,78
550037,289296,2013-06-17,Assembly,"Be adopted, and re-refer to Committee on Appropriations with 	recommendation:  To Consent Calendar",15,0,0,1,16
550037,296093,2013-07-03,Assembly,"Be adopted, to Consent Calendar",17,0,0,0,17
550037,297165,2013-08-08,Assembly,"ACR 55 STONE  Consent Calendar Second Day",77,0,0,1,78
550037,297815,2013-08-20,Senate,"Be adopted, but re-refer to the Committee on Appropriations 	Recommend Consent",10,0,1,0,11
550037,299465,2013-09-11,Senate,"Consent Calendar 2nd ACR55 Stone",36,0,3,0,39
550039,276272,2013-05-06,Assembly,"From committee:  Be adopted.  To third reading",10,0,0,1,11
550040,286977,2013-06-04,Assembly,"Do pass as amended and be re-referred to the Committee on 	Appropriations",18,0,0,1,19
550040,296076,2013-07-03,Assembly,"Do pass, to Consent Calendar",17,0,0,0,17
550040,297817,2013-08-08,Assembly,"AB 1428 CONWAY  Consent Calendar Second Day  Regular Session",77,0,0,1,78
550040,297851,2013-08-21,Senate,"Do pass, but re-refer to the Committee on Appropriations",8,0,1,0,9
550040,298631,2013-09-03,Senate,"Assembly 3rd Reading AB1428 Conway Urgency Clause",37,0,2,0,39
550040,298909,2013-09-06,Assembly,"AB 1428 CONWAY  Concurrence in Senate Amendments",78,0,0,0,78
550389,289195,2013-06-17,Assembly,"Be adopted, and re-refer to Committee on Appropriations with 	recommendation:  To Consent Calendar",15,0,0,1,16
550389,296149,2013-07-03,Assembly,"Be adopted, to Consent Calendar",17,0,0,0,17
550389,297824,2013-08-08,Assembly,"ACR 57 JONES  Consent Calendar Second Day  Regular Session",77,0,0,1,78
550389,297825,2013-08-20,Senate,"Be adopted, but re-refer to the Committee on Appropriations 	Recommend Consent",10,0,1,0,11
550389,299556,2013-09-11,Senate,"Consent Calendar 2nd ACR57 Jones",36,0,3,0,39
550681,295310,2013-07-01,Assembly,"From committee:  Be adopted.  To third reading",11,0,0,0,11
550681,298902,2013-09-06,Senate,"Assembly 3rd Reading ACR58 Beth Gaines By Walters",39,0,0,0,39
551062,287468,2013-06-06,Senate,"Senate 3rd Reading SCR40 Hueso",35,0,4,0,39
551062,292254,2013-06-27,Assembly,"From committee:  Be adopted.  To third reading",10,0,0,1,11
551062,297553,2013-08-15,Senate,"Unfinished Business SCR40 Hueso Concurrence",38,0,1,0,39
551066,280307,2013-05-16,Senate,"Special Consent Cal SCR41 Huff",37,0,1,0,38
551066,287798,2013-06-10,Assembly,"From committee:  Be adopted.  To third reading",8,0,0,3,11
551804,278658,2013-05-13,Senate,"Senate 3rd Reading SJR12 Hancock",34,0,4,0,38
551804,280398,2013-05-16,Assembly,"From committee:  Be adopted.  To third reading",9,0,0,2,11
551804,281395,2013-05-20,Assembly,"SJR 12 Hancock  Senate Third Reading  By SKINNER",60,9,0,9,78
552695,284846,2013-05-28,Assembly,"From committee:  Be adopted.  To third reading",10,0,0,1,11
552695,291299,2013-06-24,Senate,"Special Consent Cal ACR59 Waldron",39,0,0,0,39
552704,287051,2013-06-04,Assembly,"From committee:  Be adopted.  To third reading",12,0,0,1,13
552704,287467,2013-06-06,Assembly,"AJR 20 PEREZ, J.  Assembly Third Reading",73,1,0,5,79
552704,291254,2013-06-24,Senate,"Assembly 3rd Reading AJR20 John A. P",35,1,3,0,39
552704,292185,2013-06-27,Assembly,"AJR 20 PEREZ, J.  Concurrence in Senate Amendments",77,1,0,1,79
552712,295647,2013-07-01,Senate,"Senate 3rd Reading SCR42 Fuller",35,0,3,0,38
552712,297135,2013-08-08,Assembly,"From committee:  Be adopted.  To third reading",9,0,0,2,11
552712,298213,2013-08-30,Senate,"Unfinished Business SCR42 Fuller Concurrence",38,0,1,0,39
553150,281363,2013-05-20,Assembly,"Be adopted, to Consent Calendar",11,0,0,0,11
553150,283286,2013-05-23,Assembly,"HR 16 CAMPOS  Consent Calendar Second Day  Regular Session",74,0,0,4,78
554740,288161,2013-06-11,Senate,"Be adopted, but re-refer to the Committee on Appropriations 	Recommend Consent",11,0,0,0,11
554740,295583,2013-07-01,Senate,"Consent Calendar 2nd SCR45 Wolk",33,0,5,0,38
554740,297220,2013-08-12,Assembly,"Be adopted, and re-refer to Committee on Appropriations with 	recommendation:  To Consent Calendar",15,0,0,1,16
554740,297837,2013-08-21,Assembly,"Be adopted, to Consent Calendar",17,0,0,0,17
554740,298033,2013-08-26,Assembly,"SCR 45 Wolk  Consent Calendar Second Day  Regular Session",77,0,0,1,78
554745,295878,2013-07-01,Assembly,"Be adopted, to Consent Calendar",15,0,0,1,16
554745,297063,2013-08-05,Assembly,"AJR 21 OLSEN  Consent Calendar Second Day",73,0,0,5,78
554745,299700,2013-09-12,Senate,"Assembly 3rd Supp 3 AJR21 Olsen By Hill",37,0,2,0,39
554745,299701,2013-09-12,Assembly,"AJR 21 OLSEN  Concurrence in Senate Amendments",77,0,0,1,78
554753,291650,2013-06-25,Senate,"Be adopted, but re-refer to the Committee on Appropriations 	Recommend Consent",9,0,2,0,11
554753,297550,2013-08-15,Senate,"Senate 3rd Reading SCR44 DeSaulnier",37,0,2,0,39
554753,299607,2013-09-11,Assembly,"Be adopted, and re-refer to Committee on Appropriations with 	recommendation:  To Consent Calendar",15,0,0,1,16
554753,299608,2013-09-12,Assembly,"Be adopted, to Consent Calendar",17,0,0,0,17
554753,299609,2013-09-12,Assembly,"SCR 44 DeSaulnier  Senate Third Reading  By SKINNER",76,0,0,2,78
554758,288186,2013-06-11,Senate,"Be adopted, but re-refer to the Committee on Appropriations 	Recommend Consent",11,0,0,0,11
554758,295586,2013-07-01,Senate,"Consent Calendar 2nd SCR43 DeSaulnier",33,0,5,0,38
554758,297198,2013-08-12,Assembly,"Be adopted, and re-refer to Committee on Appropriations with 	recommendation:  To Consent Calendar",15,0,0,1,16
554758,297866,2013-08-21,Assembly,"Be adopted, as amended, to Consent Calendar",17,0,0,0,17
554758,298286,2013-08-30,Assembly,"SCR 43 DeSaulnier  Consent Calendar Second Day  Regular Session",78,0,0,0,78
554758,298621,2013-09-03,Senate,"Unfinished Business SCR43 DeSaulnier Concurrence",37,0,2,0,39
555165,292056,2013-06-26,Assembly,"Do pass and re-refer to Committee on Appropriations with 	recommendation:  To Consent Calendar",6,0,0,1,7
555165,296126,2013-07-03,Assembly,"Be adopted, to Consent Calendar",17,0,0,0,17
555165,297821,2013-08-08,Assembly,"ACR 61 GAINES  Consent Calendar Second Day  Regular Session",77,0,0,1,78
555165,298042,2013-08-26,Senate,"Be adopted, but re-refer to the Committee on Appropriations 	Recommend Consent",5,0,0,0,5
555165,299482,2013-09-11,Senate,"Consent Calendar 2nd ACR61 Beth Gaines",37,0,2,0,39
555167,295922,2013-07-02,Assembly,"Be adopted, to Consent Calendar",10,0,0,0,10
555167,297060,2013-08-05,Assembly,"AJR 22 GORELL  Consent Calendar Second Day  Regular Session",73,0,0,5,78
555167,299336,2013-09-10,Senate,"Assembly 3rd Reading AJR22 Gorell By Corbett",38,0,1,0,39
555620,291429,2013-06-24,Senate,"Senate 3rd Reading SCR46 Hill",34,0,5,0,39
555620,297974,2013-08-22,Assembly,"Be adopted, to Consent Calendar",10,0,0,1,11
555620,298421,2013-08-30,Assembly,"SCR 46 Hill  Consent Calendar Second Day  Regular Session",78,0,0,0,78
555808,288938,2013-06-13,Senate,"Senate 3rd Reading SCR47 Corbett",36,0,3,0,39
555808,297059,2013-08-05,Assembly,"Be adopted, to Consent Calendar",10,0,0,1,11
555808,297152,2013-08-08,Assembly,"SCR 47 Corbett  Consent Calendar Second Day  Regular Session",77,0,0,1,78
556156,295325,2013-07-01,Senate,"Senate 3rd Reading SJR13 Yee",29,1,8,0,38
556156,298136,2013-08-27,Assembly,"From committee:  Be adopted.  To third reading",9,0,0,1,10
556156,298990,2013-09-09,Assembly,"SJR 13 Yee  Senate Third Reading  By ALEJO",57,7,0,14,78
556156,299466,2013-09-11,Senate,"Unfinished Business SJR13 Yee Concurrence",30,1,8,0,39
557016,287167,2013-06-04,Assembly,"From committee:  Be adopted.  To third reading",9,0,0,0,9
557016,287522,2013-06-06,Assembly,"HR 17 MEDINA  Assembly Third Reading  Amend By ALLEN  Set #1 	Motion to  Lay on the Table  By ATKINS",49,26,0,4,79
557209,290219,2013-06-20,Senate,"Senate 3rd Reading SCR48 Hueso",30,5,4,0,39
557209,295618,2013-07-01,Assembly,"From committee:  Be adopted.  To third reading",8,2,0,1,11
557209,297549,2013-08-15,Senate,"Unfinished Business SCR48 Hueso Concurrence",32,3,4,0,39
557383,289142,2013-06-17,Assembly,"Be adopted, and re-refer to Committee on Appropriations with 	recommendation:  To Consent Calendar",15,0,0,1,16
557383,296160,2013-07-03,Assembly,"Be adopted, to Consent Calendar",17,0,0,0,17
557383,297827,2013-08-08,Assembly,"ACR 62 CALDERON  Consent Calendar Second Day  Regular Session",77,0,0,1,78
557383,297828,2013-08-20,Senate,"Be adopted, but re-refer to the Committee on Appropriations 	Recommend Consent",10,0,1,0,11
557383,299554,2013-09-11,Assembly,"ACR 62 CALDERON  Concurrence in Senate Amendments",77,0,0,1,78
557383,299555,2013-09-11,Senate,"Consent Calendar 2nd ACR62 Ian Calderon",36,0,3,0,39
557540,295765,2013-07-01,Assembly,"From committee:  Be adopted.  To third reading",9,0,0,0,9
557540,296097,2013-07-03,Assembly,"AJR 24 DAHLE  Assembly Third Reading",74,0,0,4,78
557540,298646,2013-09-03,Senate,"Assembly 3rd Reading AJR24 Dahle By Nielsen",36,0,3,0,39
557542,296199,2013-07-08,Senate,"Senate 3rd Reading SCR49 Knight",15,14,9,0,38
557542,296200,2013-07-08,Senate,"Senate 3rd Reading SCR49 Knight Reconsider",33,0,5,0,38
557781,291225,2013-06-24,Senate,"Special Consent Cal SCR50 Hueso",39,0,0,0,39
557781,295569,2013-07-01,Assembly,"From committee:  Be adopted.  To third reading",11,0,0,0,11
557781,297564,2013-08-15,Senate,"Unfinished Business SCR50 Hueso Concurrence",38,0,1,0,39
558075,291183,2013-06-24,Assembly,"From committee:  Be adopted.  To third reading",9,0,0,2,11
558075,297808,2013-08-19,Senate,"Assembly 3rd Reading ACR63 Nestande By Emmerson",37,0,2,0,39
558274,289000,2013-06-14,Assembly,"From committee:  Be adopted.  To third reading",11,0,0,0,11
558274,297689,2013-08-19,Senate,"Assembly 3rd Reading ACR64 Allen By Correa",37,0,2,0,39
558502,290283,2013-06-20,Assembly,"From committee:  Be adopted.  To third reading",9,0,0,2,11
558649,291244,2013-06-24,Senate,"Senate 3rd Reading SR14 Lara",30,1,8,0,39
558668,289172,2013-06-17,Assembly,"From committee:  Be adopted.  To third reading",7,2,0,2,11
558668,291222,2013-06-24,Assembly,"HR 20 GORDON  Assembly Third Reading",55,0,0,24,79
558844,297218,2013-08-12,Assembly,"Be adopted and be re-referred to the Committee on Appropriations",12,1,0,3,16
558844,297880,2013-08-21,Assembly,"From committee:  Be adopted.  To third reading",16,0,0,1,17
558844,297963,2013-08-22,Assembly,"ACR 65 HALL  Assembly Third Reading",68,0,0,10,78
558844,298986,2013-09-09,Senate,"Be adopted, but re-refer to the Committee on Appropriations",8,1,2,0,11
558844,299697,2013-09-12,Senate,"Assembly 3rd Reading ACR65 Hall By Wright",26,7,6,0,39
558960,292283,2013-06-27,Assembly,"From committee:  Be adopted.  To third reading",10,0,0,1,11
558960,299645,2013-09-12,Senate,"Special Consent #10 ACR66 Waldron",39,0,0,0,39
558976,295826,2013-07-02,Senate,"Be adopted",10,0,1,0,11
558976,297599,2013-08-15,Senate,"Senate 3rd Reading SR15 Beall",35,1,3,0,39
558993,298140,2013-08-27,Assembly,"From committee:  Be adopted.  To third reading",3,1,0,6,10
559261,297540,2013-08-15,Senate,"Senate 3rd Reading SCR51 Lieu",38,0,1,0,39
559261,298519,2013-08-30,Assembly,"Be adopted, to Consent Calendar",11,0,0,0,11
559261,298724,2013-09-04,Assembly,"SCR 51 Lieu  Consent Calendar Second Day  Regular Session",77,0,0,1,78
559629,295370,2013-07-01,Senate,"Senate 3rd Reading SCR52 Wolk",36,0,2,0,38
559629,298872,2013-09-06,Assembly,"Be adopted, to Consent Calendar",10,0,0,1,11
559629,299298,2013-09-10,Assembly,"SCR 52 Wolk  Consent Calendar Second Day  Regular Session",78,0,0,0,78
559630,297832,2013-08-20,Senate,"Be adopted, but re-refer to the Committee on Appropriations 	Recommend Consent",10,0,1,0,11
559630,299451,2013-09-11,Senate,"Consent Calendar 2nd SCR53 Gaines",37,0,2,0,39
559630,308564,2014-01-13,Assembly,"Be adopted, and re-refer to Committee on Appropriations with 	recommendation:  To Consent Calendar",16,0,0,0,16
559630,311204,2014-01-23,Assembly,"Be adopted, to Consent Calendar",16,0,0,1,17
560712,358810,2014-04-21,Assembly,"Be adopted and be re-referred to the Committee on Appropriations",11,1,0,4,16
560712,361056,2014-04-30,Assembly,"From committee:  Be adopted.  To third reading",12,5,0,0,17
560712,362210,2014-05-05,Assembly,"ACR 67 ALEJO  Assembly Third Reading",54,3,0,22,79
560712,376534,2014-08-05,Senate,"Be adopted, but re-refer to the Committee on Appropriations",8,0,3,0,11
560712,377432,2014-08-14,Senate,"Assembly 3rd Reading ACR67 Alejo By DeSaulnier",30,2,8,0,40
560714,296027,2013-07-02,Senate,"Do pass, but re-refer to the Committee on Appropriations Recommend 	Consent",6,0,1,0,7
560714,297593,2013-08-15,Senate,"Consent Calendar 2nd SCR54 Padilla",38,0,1,0,39
560714,298122,2013-08-27,Assembly,"Be adopted, and re-refer to Committee on Appropriations with 	recommendation:  To Consent Calendar",10,0,0,0,10
560714,298199,2013-08-30,Assembly,"Be adopted, to Consent Calendar",17,0,0,0,17
560714,298715,2013-09-04,Assembly,"SCR 54 Padilla  Consent Calendar Second Day  Regular Session",77,0,0,1,78
560924,295585,2013-07-01,Assembly,"Be adopted as amended",11,0,0,0,11
560935,296209,2013-07-08,Senate,"Senate 3rd Reading SCR56 Torres",30,0,8,0,38
560935,297202,2013-08-12,Assembly,"Be adopted, to Consent Calendar",10,0,0,1,11
560935,298080,2013-08-26,Assembly,"SCR 56 Torres  Senate Third Reading  By BROWN",77,0,0,1,78
560935,298423,2013-08-30,Senate,"Special Consent #9 SCR56 Torres",38,0,1,0,39
560946,296356,2013-07-09,Senate,"Be adopted, but re-refer to the Committee on Appropriations 	Recommend Consent",10,0,1,0,11
560946,297543,2013-08-15,Senate,"Consent Calendar 2nd SCR55 Gaines",38,0,1,0,39
560946,299376,2013-09-11,Assembly,"Be adopted, and re-refer to Committee on Appropriations with 	recommendation:  To Consent Calendar",15,0,0,1,16
560946,299659,2013-09-12,Assembly,"Be adopted, to Consent Calendar",17,0,0,0,17
560946,299660,2013-09-12,Assembly,"SCR 55 Gaines  Senate Third Reading  By HAGMAN",76,0,0,2,78
560957,297192,2013-08-12,Assembly,"Be adopted, and re-refer to Committee on Appropriations with 	recommendation:  To Consent Calendar",15,0,0,1,16
560957,297861,2013-08-21,Assembly,"Be adopted, to Consent Calendar",17,0,0,0,17
560957,298053,2013-08-26,Assembly,"ACR 68 DONNELLY  Consent Calendar Second Day",77,0,0,1,78
560957,299053,2013-09-09,Senate,"Be adopted, but re-refer to the Committee on Appropriations 	Recommend Consent",10,0,1,0,11
560957,299462,2013-09-11,Senate,"Assembly 2nd Reading ACR68 Donnelly",36,0,3,0,39
561031,297200,2013-08-12,Assembly,"Be adopted, and re-refer to Committee on Appropriations with 	recommendation:  To Consent Calendar",15,0,0,1,16
561031,297860,2013-08-21,Assembly,"Be adopted, to Consent Calendar",17,0,0,0,17
561031,298067,2013-08-26,Assembly,"ACR 70 CHESBRO  Consent Calendar Second Day  Regular Session",77,0,0,1,78
561031,299001,2013-09-09,Senate,"Be adopted, but re-refer to the Committee on Appropriations 	Recommend Consent",10,0,1,0,11
561031,299497,2013-09-11,Senate,"Assembly 2nd Reading ACR70 Chesbro By Evans",36,0,3,0,39
561055,297196,2013-08-12,Assembly,"Be adopted, and re-refer to Committee on Appropriations with 	recommendation:  To Consent Calendar",15,0,0,1,16
561055,297864,2013-08-21,Assembly,"Be adopted, to Consent Calendar",17,0,0,0,17
561055,298066,2013-08-26,Assembly,"ACR 69 SALAS  Consent Calendar Second Day  Regular Session",77,0,0,1,78
561055,299000,2013-09-09,Senate,"Be adopted, but re-refer to the Committee on Appropriations 	Recommend Consent",10,0,1,0,11
561055,299575,2013-09-11,Senate,"Assembly 2nd Reading ACR69 Salas",36,0,3,0,39
561529,296204,2013-07-08,Senate,"Senate 3rd Reading SCR58 Beall",33,0,5,0,38
561529,297571,2013-08-15,Assembly,"From committee:  Be adopted.  To third reading",8,0,0,3,11
561529,297898,2013-08-22,Senate,"Unfinished Business SCR58 Beall Concurrence",37,0,2,0,39
561531,297813,2013-08-20,Senate,"Be adopted as amended",7,3,1,0,11
561531,299237,2013-09-10,Senate,"Senate 3rd Reading SCR59 Knight",22,7,10,0,39
561531,299495,2013-09-11,Assembly,"Be adopted, and re-refer to Committee on Appropriations with 	recommendation:  To Consent Calendar",15,0,0,1,16
561533,297814,2013-08-20,Senate,"Be adopted, but re-refer to the Committee on Appropriations 	Recommend Consent",10,0,1,0,11
561533,299491,2013-09-11,Senate,"Consent Calendar 2nd SCR57 Hernandez",36,0,3,0,39
561533,308731,2014-01-13,Assembly,"Be adopted, and re-refer to Committee on Appropriations with 	recommendation:  To Consent Calendar",16,0,0,0,16
561533,311199,2014-01-23,Assembly,"Be adopted, to Consent Calendar",16,0,0,1,17
561554,298123,2013-08-27,Assembly,"From committee:  Be adopted.  To third reading",1,1,0,8,10
561586,297160,2013-08-08,Assembly,"From committee:  Be adopted.  To third reading",9,0,0,2,11
561586,297740,2013-08-19,Assembly,"AJR 28 BROWN  Assembly Third Reading",75,0,0,3,78
561586,298633,2013-09-03,Senate,"Assembly 3rd Reading AJR28 Brown By Wright",37,0,2,0,39
561587,297454,2013-08-14,Assembly,"From committee:  Be adopted.  To third reading",13,0,0,0,13
561587,299289,2013-09-10,Senate,"Be adopted and be placed on the Consent Calendar",8,0,1,0,9
561587,299476,2013-09-11,Senate,"Assembly 2nd Reading ACR71 Weber",36,0,3,0,39
561700,297812,2013-08-20,Senate,"Be adopted, but re-refer to the Committee on Appropriations 	Recommend Consent",10,0,1,0,11
561700,299569,2013-09-11,Senate,"Consent Calendar 2nd SCR60 Knight",36,0,3,0,39
561700,308734,2014-01-13,Assembly,"Be adopted, and re-refer to Committee on Appropriations with 	recommendation:  To Consent Calendar",16,0,0,0,16
561700,311201,2014-01-23,Assembly,"Be adopted, to Consent Calendar",16,0,0,1,17
561701,299160,2013-09-10,Senate,"Senate 3rd Reading SCR61 Galgiani",38,0,1,0,39
561701,299564,2013-09-11,Assembly,"Be adopted, to Consent Calendar",9,0,0,2,11
561701,299810,2013-09-12,Assembly,"SCR 61 Galgiani  Consent Calendar First Day",78,0,0,0,78
561906,297822,2013-08-20,Senate,"Be adopted",4,1,0,0,5
561906,297967,2013-08-22,Senate,"Senate 3rd Reading SJR14 Yee",27,10,2,0,39
561906,299642,2013-09-12,Assembly,"From committee:  Be adopted.  To third reading",5,1,0,1,7
561906,299643,2013-09-12,Assembly,"SJR 14 Yee  Senate Third Reading  By ALEJO",59,2,0,17,78
562024,298058,2013-08-26,Senate,"Senate 3rd Reading SCR62 Jackson",30,6,3,0,39
562024,299500,2013-09-11,Assembly,"From committee:  Be adopted.  To third reading",9,0,0,1,10
562024,299685,2013-09-12,Assembly,"SCR 62 Jackson  Senate Third Reading  By LOWENTHAL",65,3,0,10,78
562025,297669,2013-08-19,Senate,"Senate 3rd Reading SCR63 Hernandez",37,0,2,0,39
562025,298020,2013-08-26,Assembly,"From committee:  Be adopted.  To third reading",10,0,0,1,11
562025,298892,2013-09-06,Senate,"Unfinished Business SCR63 Hernandez Concurrence",38,0,1,0,39
563403,297556,2013-08-15,Assembly,"Be adopted, to Consent Calendar",8,0,0,3,11
563403,297926,2013-08-22,Assembly,"ACR 74 SALAS  Consent Calendar Second Day",78,0,0,0,78
563403,298997,2013-09-09,Senate,"Assembly 3rd Reading ACR74 Salas By Liu",37,0,2,0,39
563406,323661,2014-02-18,Assembly,"Be adopted",5,0,0,2,7
563406,331453,2014-02-27,Assembly,"AJR 29 BROWN  Assembly Third Reading",75,0,0,5,80
563406,347023,2014-03-24,Senate,"Assembly 3rd Reading AJR29 Brown By Liu",31,0,8,0,39
563409,297970,2013-08-22,Assembly,"From committee:  Be adopted.  To third reading",10,0,0,1,11
563409,299703,2013-09-12,Senate,"Special Consent #10 ACR72 Quirk-Silva",39,0,0,0,39
563414,297925,2013-08-22,Assembly,"From committee:  Be adopted.  To third reading",10,0,0,1,11
563433,297293,2013-08-13,Assembly,"From committee:  Be adopted.  To third reading",6,0,0,1,7
563433,298671,2013-09-03,Assembly,"AJR 30 STONE  Assembly Third Reading",53,11,0,14,78
563469,298496,2013-08-30,Assembly,"From committee:  Be adopted.  To third reading",11,0,0,0,11
563469,298497,2013-08-30,Assembly,"From committee:  Be adopted.  To third reading",11,0,0,0,11
563469,299534,2013-09-11,Senate,"Assembly 3rd Reading ACR75 Bonilla By Yee",39,0,0,0,39
563470,298129,2013-08-27,Assembly,"Be adopted",5,0,0,2,7
563495,298089,2013-08-26,Senate,"Senate 3rd Reading SCR65 Fuller",37,0,2,0,39
563495,298438,2013-08-30,Assembly,"From committee:  Be adopted.  To third reading",11,0,0,0,11
563495,299027,2013-09-09,Assembly,"SCR 65 Fuller  Senate Third Reading  By SALAS",78,0,0,0,78
563498,297534,2013-08-15,Senate,"Senate 3rd Reading SJR15 Hancock",27,9,3,0,39
563498,298435,2013-08-29,Assembly,"Be adopted as amended",5,3,0,1,9
563498,298987,2013-09-09,Assembly,"SJR 15 Hancock  Senate Third Reading  By SKINNER",51,25,0,2,78
563498,299288,2013-09-10,Senate,"Unfinished Business SJR15 Hancock Concurrence",27,10,2,0,39
563503,297819,2013-08-20,Senate,"Be adopted, but re-refer to the Committee on Appropriations 	Recommend Consent",10,0,1,0,11
563503,299535,2013-09-11,Senate,"Consent Calendar 2nd SCR64 Roth",36,0,3,0,39
563503,308946,2014-01-13,Assembly,"Be adopted, and re-refer to Committee on Appropriations with 	recommendation:  To Consent Calendar",16,0,0,0,16
563503,311154,2014-01-23,Assembly,"Be adopted, to Consent Calendar",16,0,0,1,17
563503,314755,2014-02-03,Senate,"Unfinished Business SCR64 Roth Concurrence",36,0,3,0,39
563505,298861,2013-09-06,Senate,"Senate 3rd Reading SR16 Lieu",32,1,6,0,39
563507,298068,2013-08-26,Senate,"Be adopted as amended",4,1,0,0,5
563507,299297,2013-09-10,Senate,"Senate 3rd Reading SR18 Leno",30,1,8,0,39
563517,298656,2013-09-03,Senate,"Senate 3rd Reading SCR67 Liu",34,2,3,0,39
563517,299051,2013-09-09,Assembly,"Be adopted, to Consent Calendar",10,0,0,1,11
563517,299779,2013-09-12,Assembly,"SCR 67 Liu  Senate Third Reading  By BUCHANAN",75,0,0,3,78
563518,298036,2013-08-26,Senate,"Senate 3rd Reading SCR66 Yee",34,2,3,0,39
563518,298897,2013-09-06,Assembly,"Be adopted, to Consent Calendar",10,0,0,1,11
563518,299310,2013-09-10,Assembly,"SCR 66  Consent Calendar Second Day  Regular Session",78,0,0,0,78
563529,298985,2013-09-09,Assembly,"Be adopted",9,0,0,0,9
563530,298087,2013-08-26,Senate,"Senate 3rd Reading SCR68 Lieu",37,0,2,0,39
563530,298976,2013-09-09,Assembly,"Be adopted, to Consent Calendar",10,0,0,1,11
563530,299373,2013-09-11,Assembly,"SCR 68 Lieu  Consent Calendar Second Day",78,0,0,0,78
563530,299741,2013-09-12,Senate,"Unfinished Business SCR68 Lieu Concurrence",38,0,1,0,39
563540,298133,2013-08-27,Assembly,"Be adopted as amended",7,3,0,3,13
563790,298470,2013-08-30,Assembly,"From committee:  Be adopted.  To third reading",11,0,0,0,11
563790,298471,2013-08-30,Assembly,"From committee:  Be adopted.  To third reading",11,0,0,0,11
563790,299503,2013-09-11,Senate,"Assembly 3rd Reading ACR77 Bonta By Yee",37,0,2,0,39
563792,298006,2013-08-26,Assembly,"From committee:  Be adopted.  To third reading",10,0,0,1,11
563792,299825,2013-09-12,Senate,"Special Consent #10 ACR78 Logue",39,0,0,0,39
563794,298061,2013-08-26,Senate,"Senate 3rd Reading SJR16 Emmerson",29,2,8,0,39
563827,298728,2013-09-04,Senate,"Senate 3rd Reading SCR70 Galgiani et al",38,0,1,0,39
563827,299087,2013-09-09,Assembly,"From committee:  Be adopted.  To third reading",10,0,0,1,11
563827,299809,2013-09-12,Senate,"Unfinished Supp 1 SCR70 Galgiani",39,0,0,0,39
563856,298212,2013-08-30,Assembly,"Be adopted, to Consent Calendar",11,0,0,0,11
563856,298716,2013-09-04,Assembly,"HR 25 BIGELOW  Consent Calendar Second Day",77,0,0,1,78
563905,299165,2013-09-10,Senate,"Senate 3rd Reading SCR71 Torres",38,0,1,0,39
563905,299395,2013-09-11,Assembly,"Be adopted, to Consent Calendar",9,0,0,2,11
563905,299839,2013-09-12,Assembly,"SCR 71 Torres  Consent Calendar First Day  Regular Session",78,0,0,0,78
563976,348392,2014-03-26,Assembly,"Be adopted",6,0,0,1,7
563976,350362,2014-04-01,Assembly,"AJR 31 SKINNER  Assembly Third Reading",67,2,0,11,80
563976,363568,2014-05-08,Senate,"Assembly 3rd Reading AJR31 Skinner By Hancock",27,6,7,0,40
563994,299516,2013-09-11,Assembly,"From committee:  Be adopted.  To third reading",11,0,0,0,11
563994,299754,2013-09-12,Senate,"Assembly 3rd Supp 3 ACR80 Dickinson By Lara",34,2,3,0,39
564020,298860,2013-09-06,Assembly,"Be adopted, to Consent Calendar",10,0,0,1,11
564020,299228,2013-09-10,Assembly,"ACR 81 MITCHELL  Consent Calendar Second Day",78,0,0,0,78
564024,298858,2013-09-06,Senate,"Senate 3rd Reading SR19 Yee",38,0,1,0,39
564203,362623,2014-05-06,Assembly,"From committee:  Be adopted.  To third reading",11,0,0,2,13
564203,364990,2014-05-15,Assembly,"HR 26 WILLIAMS  Assembly Third Reading",59,15,0,5,79
564287,377715,2014-08-18,Senate,"Senate 3rd Reading SJR17 Anderson",34,0,6,0,40
564287,379131,2014-08-29,Assembly,"SJR 17 Anderson  Senate Third Reading  By JONES",74,0,0,5,79
564307,299502,2013-09-11,Assembly,"From committee:  Be adopted.  To third reading",11,0,0,0,11
564307,299672,2013-09-12,Assembly,"ACR 82 PAN  Assembly Third Reading",78,0,0,0,78
564307,312253,2014-01-27,Senate,"Special Consent Cal ACR82 Pan",36,0,3,0,39
564520,299669,2013-09-12,Senate,"Senate 3rd Reading SR20 Emmerson",36,0,3,0,39
564577,376422,2014-08-05,Senate,"Be adopted, but re-refer to the Committee on Appropriations 	Recommend Consent",10,0,1,0,11
564577,377070,2014-08-13,Senate,"Consent Calendar 1st SCR72 Padilla",37,0,3,0,40
564577,378463,2014-08-25,Assembly,"Be adopted, and re-refer to Committee on Appropriations with 	recommendation:  To Consent Calendar",15,0,0,1,16
564577,378693,2014-08-27,Assembly,"Be adopted, to Consent Calendar",12,0,0,5,17
564577,379101,2014-08-29,Assembly,"SCR 72 Padilla  Consent Calendar Second Day  Regular Session",78,0,0,1,79
577475,362237,2014-05-05,Assembly,"From committee:  Be adopted.  To third reading",9,1,0,1,11
577475,363398,2014-05-08,Assembly,"AJR 32 GATTO  Assembly Third Reading",72,1,0,6,79
577475,378706,2014-08-27,Senate,"Assembly 3rd Reading AJR32 Gatto By De Le",24,0,16,0,40
577481,347589,2014-03-25,Senate,"Do pass",7,0,0,0,7
577481,351894,2014-04-03,Senate,"Senate 3rd Reading SB833 Liu",35,0,5,0,40
577481,370457,2014-06-10,Assembly,"Do pass, to Consent Calendar",7,0,0,0,7
577481,371753,2014-06-16,Assembly,"SB 833 Liu  Consent Calendar Second Day  Regular Session",77,0,0,2,79
577481,374768,2014-06-26,Senate,"Special Consent #17 SB833 Liu",32,0,8,0,40
577487,348161,2014-03-26,Assembly,"Do pass and be re-referred to the Committee on Public Safety",5,0,0,2,7
577487,360459,2014-04-29,Assembly,"Do pass as amended and be re-referred to the Committee on 	Appropriations",5,0,0,2,7
577487,366789,2014-05-23,Assembly,"Do pass as amended",13,1,0,3,17
577487,368143,2014-05-28,Assembly,"AB 1432 GATTO  Assembly Third Reading",66,5,0,8,79
577487,372711,2014-06-18,Senate,"Do pass, but re-refer to the Committee on Public Safety",7,0,0,0,7
577487,374424,2014-06-24,Senate,"Do pass, but re-refer to the Committee on Appropriations",5,2,0,0,7
577487,376506,2014-08-04,Senate,"Placed on Appropriations Suspense file",7,0,0,0,7
577487,377300,2014-08-14,Senate,"Do pass",5,0,2,0,7
577487,377900,2014-08-20,Senate,"Assembly 3rd Reading AB1432 Gatto By DeSaulnier",31,3,6,0,40
577487,378209,2014-08-22,Assembly,"AB 1432 GATTO  Concurrence in Senate Amendments",61,13,0,5,79
577492,360527,2014-04-29,Senate,"Do pass, but re-refer to the Committee on Appropriations",6,0,1,0,7
577492,365300,2014-05-19,Senate,"Senate 3rd Reading SB828 Lieu",29,1,10,0,40
577492,374037,2014-06-24,Assembly,"Do pass and be re-referred to the Committee on Appropriations",7,0,0,0,7
577492,376678,2014-08-06,Assembly,"Do pass",16,0,0,1,17
577492,378031,2014-08-21,Assembly,"SB 828 Lieu  Senate Third Reading  By MELENDEZ",78,0,0,1,79
577492,378887,2014-08-28,Senate,"Unfinished Business SB828 Lieu Concurrence",37,0,3,0,40
577498,345638,2014-03-19,Senate,"Do pass, but re-refer to the Committee on Appropriations Recommend 	Consent",7,0,0,0,7
577498,355117,2014-04-10,Senate,"Consent Calendar 2nd SB829 Galgiani",34,0,6,0,40
577498,369814,2014-06-04,Assembly,"Do pass and be re-referred to the Committee on Appropriations to 	Consent Calendar",8,0,0,1,9
577498,372532,2014-06-18,Assembly,"Do pass, to Consent Calendar",15,0,0,2,17
577498,374853,2014-06-26,Assembly,"SB 829 Galgiani  Consent Calendar Second Day",76,0,0,3,79
577504,345817,2014-03-19,Senate,"Do pass as amended, and re-refer to the Committee on Judiciary",5,2,0,0,7
577504,350284,2014-04-01,Senate,"Do pass as amended",5,2,0,0,7
577504,360126,2014-04-28,Senate,"Senate 3rd Reading SB827 Liu",25,10,5,0,40
577504,369818,2014-06-04,Assembly,"Do pass and be re-referred to the Committee on Judiciary",7,1,0,1,9
577504,370447,2014-06-10,Assembly,"Do pass",8,1,0,1,10
577504,373308,2014-06-19,Assembly,"SB 827 Liu  Senate Third Reading  By RIDLEY-THOMAS",55,21,0,3,79
577509,358415,2014-04-22,Senate,"Do pass, but re-refer to the Committee on Appropriations",9,0,1,0,10
577509,362386,2014-05-05,Senate,"Placed on Appropriations Suspense file",7,0,0,0,7
577515,350285,2014-04-01,Assembly,"Do pass as amended and be re-referred to the Committee on Education",9,0,0,1,10
577515,359305,2014-04-23,Assembly,"Do pass as amended",7,0,0,0,7
577515,364957,2014-05-15,Assembly,"AB 1442 GATTO  Assembly Third Reading",78,0,0,1,79
577515,370963,2014-06-11,Senate,"Do pass, but re-refer to the Committee on Judiciary",7,0,0,0,7
577515,374297,2014-06-24,Senate,"Do pass as amended",7,0,0,0,7
577515,378569,2014-08-26,Senate,"Assembly 3rd Reading AB1442 Gatto By Liu",36,0,4,0,40
577515,378813,2014-08-27,Assembly,"AB 1442 GATTO  Concurrence in Senate Amendments",76,0,0,3,79
577521,350302,2014-04-01,Senate,"Be adopted, but re-refer to the Committee on Appropriations 	Recommend Consent",11,0,0,0,11
577521,361602,2014-05-01,Senate,"Consent Calendar 2nd SCR74 Galgiani",35,0,5,0,40
577521,370302,2014-06-09,Assembly,"Be adopted, and re-refer to Committee on Appropriations with 	recommendation:  To Consent Calendar",16,0,0,0,16
577521,372692,2014-06-18,Assembly,"Be adopted, to Consent Calendar",15,0,0,2,17
577521,373794,2014-06-23,Assembly,"SCR 74 Galgiani  Consent Calendar Second Day  Regular Session",75,0,0,4,79
577544,354503,2014-04-08,Assembly,"Do pass as amended and be re-referred to the Committee on 	Appropriations",6,0,0,1,7
577550,359116,2014-04-23,Assembly,"Do pass and be re-referred to the Committee on Business, 	Professions and Consumer Protection",18,0,0,1,19
577550,360490,2014-04-29,Assembly,"Do pass and be re-referred to the Committee on Appropriations",14,0,0,0,14
577550,366787,2014-05-23,Assembly,"Do pass",16,0,0,1,17
577550,367498,2014-05-27,Assembly,"AB 1439 SALAS  Assembly Third Reading",75,0,0,4,79
577550,373998,2014-06-24,Senate,"Do pass, but re-refer to the Committee on Appropriations",10,0,0,0,10
577550,378340,2014-08-25,Senate,"Assembly 3rd Reading AB1439 Salas By Correa",34,0,6,0,40
577550,378548,2014-08-26,Assembly,"AB 1439 SALAS  Concurrence in Senate Amendments",78,0,0,1,79
577556,350327,2014-04-01,Assembly,"Do pass and be re-referred to the Committee on Appropriations",5,0,0,2,7
577556,354614,2014-04-09,Assembly,"Do pass",12,4,0,1,17
577556,361621,2014-05-01,Assembly,"AB 1446 MULLIN  Assembly Third Reading",55,18,0,6,79
577556,372294,2014-06-17,Senate,"Do pass, but re-refer to the Committee on Appropriations",4,0,1,0,5
577556,377841,2014-08-19,Senate,"Assembly 3rd Reading AB1446 Mullin By Padilla",27,5,8,0,40
577561,346397,2014-03-19,Assembly,"Do pass and be re-referred to the Committee on Judiciary",6,0,0,1,7
577561,358804,2014-04-22,Assembly,"Do pass as amended and be re-referred to the Committee on 	Appropriations",10,0,0,0,10
577561,363186,2014-05-07,Assembly,"Do pass, to Consent Calendar",17,0,0,0,17
577561,364935,2014-05-15,Assembly,"AB 1443 SKINNER  Consent Calendar Second Day  Regular Session",78,0,0,1,79
577561,370978,2014-06-10,Senate,"Do pass as amended, but re-refer to the Committee on 	Appropriations Recommend Consent",7,0,0,0,7
577561,375704,2014-07-03,Senate,"Consent Calendar 2nd AB1443 Skinner",35,0,5,0,40
577561,377544,2014-08-14,Assembly,"AB 1443 SKINNER  Concurrence in Senate Amendments",79,0,0,0,79
577575,350390,2014-04-01,Assembly,"Do pass as amended and be re-referred to the Committee on Judiciary",5,1,0,1,7
577575,360936,2014-04-29,Assembly,"Do pass as amended and be re-referred to the Committee on 	Appropriations",8,2,0,0,10
577575,364528,2014-05-14,Assembly,"Do pass",12,4,0,1,17
577575,368165,2014-05-28,Assembly,"AB 1431 GONZALEZ  Assembly Third Reading",60,17,0,2,79
577575,374563,2014-06-24,Senate,"Do pass, but re-refer to the Committee on Appropriations",5,0,0,0,5
577575,376927,2014-08-11,Senate,"Assembly 3rd Reading AB1431 Gonzalez By Hueso",33,2,5,0,40
577575,377622,2014-08-18,Assembly,"AB 1431 GONZALEZ  Concurrence in Senate Amendments",58,19,0,2,79
577580,345085,2014-03-18,Assembly,"Do pass as amended and be re-referred to the Committee on Public 	Safety",12,0,0,1,13
577580,358412,2014-04-22,Assembly,"Do pass and re-refer to Committee on Appropriations with 	recommendation:  To Consent Calendar",6,0,0,1,7
577580,367166,2014-05-23,Assembly,"Do pass as amended",17,0,0,0,17
577580,368158,2014-05-28,Assembly,"AB 1433 GATTO  Third Reading Urgency",79,0,0,0,79
577580,372773,2014-06-18,Senate,"Do pass, but re-refer to the Committee on Appropriations Recommend 	Consent",7,0,0,0,7
577580,375297,2014-06-30,Senate,"Placed on Appropriations Suspense file",6,0,1,0,7
577580,377425,2014-08-14,Senate,"Do pass as amended",5,0,2,0,7
577580,378184,2014-08-21,Senate,"Assembly 3rd Reading AB1433 Gatto Urgency Clause",36,0,4,0,40
577580,378216,2014-08-22,Assembly,"AB 1433 GATTO  Concurrence in Senate Amendments",75,0,0,4,79
577586,353467,2014-04-07,Assembly,"Do pass as amended and be re-referred to the Committee on 	Transportation",9,0,0,0,9
577586,360653,2014-04-28,Assembly,"Do pass and be re-referred to the Committee on Appropriations",16,0,0,0,16
577586,363132,2014-05-07,Assembly,"Do pass, to Consent Calendar",17,0,0,0,17
577586,365313,2014-05-19,Assembly,"AB 1447 WALDRON  Assembly Third Reading",70,2,0,7,79
577586,370680,2014-06-10,Senate,"Do pass as amended, and re-refer to the Committee on Environmental 	Quality",10,0,1,0,11
577586,374458,2014-06-25,Senate,"Do pass as amended, and re-refer to the Committee on 	Appropriations",6,0,1,0,7
577586,376997,2014-08-11,Senate,"Placed on Appropriations Suspense file",7,0,0,0,7
577586,377483,2014-08-14,Senate,"Do pass",5,0,2,0,7
577586,377834,2014-08-19,Senate,"Assembly 3rd Reading AB1447 Waldron By Hill",34,0,6,0,40
577586,377995,2014-08-20,Assembly,"AB 1447 WALDRON  Concurrence in Senate Amendments",77,0,0,2,79
577592,341492,2014-03-11,Assembly,"Do pass and be re-referred to the Committee on Appropriations",7,0,0,0,7
577592,354579,2014-04-09,Assembly,"Do pass, to Consent Calendar",17,0,0,0,17
577592,359589,2014-04-24,Assembly,"AB 1438 LINDER  Consent Calendar Second Day  Regular Session",75,0,0,4,79
577592,370435,2014-06-10,Senate,"Do pass, but re-refer to the Committee on Appropriations",6,0,1,0,7
577592,375280,2014-06-30,Senate,"Do pass",6,0,1,0,7
577592,376752,2014-08-07,Senate,"Assembly 3rd Reading AB1438 Linder By Vidak",33,0,7,0,40
577592,376880,2014-08-11,Assembly,"AB 1438 LINDER  Concurrence in Senate Amendments",79,0,0,0,79
577597,312192,2014-01-27,Senate,"Special Consent Cal SCR75 Galgiani",36,0,3,0,39
577597,377525,2014-08-14,Assembly,"Be adopted, to Consent Calendar",8,0,0,3,11
577597,377795,2014-08-19,Assembly,"Be adopted, to Consent Calendar",13,0,0,4,17
577597,378062,2014-08-21,Assembly,"SCR 75 Galgiani  Consent Calendar Second Day  Regular Session",77,0,0,2,79
577603,354206,2014-04-09,Senate,"Do pass as amended, and re-refer to the Committee on Appropriations",6,1,2,0,9
577603,365346,2014-05-19,Senate,"Placed on Appropriations Suspense file",7,0,0,0,7
577603,366664,2014-05-23,Senate,"Do pass as amended",5,2,0,0,7
577603,368683,2014-05-29,Senate,"Senate 3rd Reading SB837 Steinberg",26,10,4,0,40
577603,374850,2014-06-25,Assembly,"Do pass as amended and be re-referred to the Committee on 	Appropriations",5,1,0,1,7
577609,360645,2014-04-29,Senate,"Do pass as amended, and re-refer to the Committee on Appropriations",6,0,1,0,7
577609,365307,2014-05-19,Senate,"Placed on Appropriations Suspense file",7,0,0,0,7
577609,367100,2014-05-23,Senate,"Do pass as amended",7,0,0,0,7
577609,368226,2014-05-28,Senate,"Senate 3rd Reading SB838 Beall",35,0,5,0,40
577609,374147,2014-06-24,Assembly,"Do pass as amended and be re-referred to the Committee on 	Appropriations",7,0,0,0,7
577609,377375,2014-08-14,Assembly,"Do pass as amended",16,1,0,0,17
577609,378361,2014-08-25,Assembly,"SB 838 Beall  Senate Third Reading  By QUIRK-SILVA",79,0,0,0,79
577609,378476,2014-08-26,Senate,"Unfinished Supp 1 SB838 Beall Concurrence",36,0,4,0,40
577614,359247,2014-04-22,Senate,"Do pass, but re-refer to the Committee on Appropriations",4,1,0,0,5
577614,362285,2014-05-05,Senate,"Placed on Appropriations Suspense file",7,0,0,0,7
577614,366914,2014-05-23,Senate,"Do pass as amended",7,0,0,0,7
577614,370273,2014-06-09,Senate,"Senate 3rd Reading SB831 Hill Urgency Clause",35,1,4,0,40
577614,374504,2014-06-24,Assembly,"Do pass as amended and be re-referred to the Committee on 	Appropriations",6,0,0,1,7
577614,377186,2014-08-14,Assembly,"Do pass as amended",17,0,0,0,17
577614,379104,2014-08-30,Senate,"W/O REF. TO FILE SB831 Hill Concurrence",35,1,4,0,40
577614,379105,2014-08-30,Assembly,"SB 831 Hill  Senate Third Reading  By GARCIA",77,0,0,2,79
577620,305728,2014-01-06,Senate,"W/O REF. TO FILE SR21 Steinberg",36,0,3,0,39
577627,350293,2014-04-01,Senate,"Do pass, but re-refer to the Committee on Appropriations",5,0,0,0,5
577627,361539,2014-05-01,Senate,"Senate 3rd Reading SB835 Hill",34,1,5,0,40
577627,373135,2014-06-18,Assembly,"Do pass and be re-referred to the Committee on Appropriations",7,0,0,0,7
577627,375601,2014-07-02,Assembly,"Do pass as amended, to Consent Calendar",17,0,0,0,17
577627,376967,2014-08-11,Assembly,"SB 835 Hill  Senate Third Reading  By PAN",71,0,0,8,79
577627,377056,2014-08-13,Senate,"Unfinished Business SB835 Hill",34,0,6,0,40
577632,361544,2014-04-30,Assembly,"Do pass and be re-referred to the Committee on Appropriations",6,1,0,0,7
577632,366891,2014-05-23,Assembly,"Do pass",12,5,0,0,17
577632,368174,2014-05-28,Assembly,"AB 1444 BUCHANAN  Assembly Third Reading",54,24,0,1,79
577632,372673,2014-06-18,Senate,"Do pass, but re-refer to the Committee on Appropriations",5,2,0,0,7
577632,375219,2014-06-30,Senate,"Placed on Appropriations Suspense file",6,0,1,0,7
577632,377137,2014-08-14,Senate,"Do pass",5,0,2,0,7
577632,377941,2014-08-20,Senate,"Assembly 3rd Reading AB1444 Buchanan By Pavley",26,8,6,0,40
577638,361531,2014-04-30,Senate,"Do pass as amended",9,0,0,0,9
577638,365430,2014-05-19,Senate,"Placed on Appropriations Suspense file",7,0,0,0,7
577638,366996,2014-05-23,Senate,"Do pass as amended",7,0,0,0,7
577638,368057,2014-05-28,Senate,"Senate 3rd Reading SB836 Corbett",37,0,3,0,40
577638,372166,2014-06-17,Assembly,"Do pass",17,0,0,2,19
577643,348102,2014-03-26,Assembly,"Do pass and re-refer to Committee on Appropriations with 	recommendation:  To Consent Calendar",6,0,0,1,7
577655,350294,2014-04-01,Assembly,"Amend, and do pass as amended and be re-referred to the Committee 	on Local Government with the recommendation:  To Consent Calendar",7,0,0,0,7
577655,361769,2014-04-30,Assembly,"Do pass and be re-referred to the Committee on Appropriations to 	Consent Calendar",9,0,0,0,9
577655,364259,2014-05-14,Assembly,"Do pass, to Consent Calendar",17,0,0,0,17
577655,367507,2014-05-27,Assembly,"AB 1440 CAMPOS  Assembly Third Reading",77,0,0,2,79
577655,372435,2014-06-17,Senate,"Do pass, but re-refer to the Committee on Appropriations",4,0,1,0,5
577655,377043,2014-08-13,Senate,"Assembly 3rd Reading AB1440 Campos By Padilla",36,0,4,0,40
577655,377659,2014-08-18,Assembly,"AB 1440 CAMPOS  Concurrence in Senate Amendments",78,0,0,1,79
577659,358678,2014-04-21,Assembly,"Do pass as amended and be re-referred to the Committee on 	Appropriations",9,5,0,1,15
577659,367118,2014-05-23,Assembly,"Do pass as amended",12,5,0,0,17
577659,368068,2014-05-28,Assembly,"AB 1434 YAMADA  Assembly Third Reading",55,23,0,1,79
577659,374086,2014-06-23,Senate,"Do pass, but re-refer to the Committee on Appropriations",8,2,1,0,11
577659,376515,2014-08-04,Senate,"Placed on Appropriations Suspense file",7,0,0,0,7
577664,312249,2014-01-27,Senate,"Special Consent Cal SR22 Huff",31,0,8,0,39
577670,359904,2014-04-24,Senate,"Do pass as amended, and re-refer to the Committee on 	Appropriations",9,0,0,0,9
577670,365407,2014-05-19,Senate,"Placed on Appropriations Suspense file",7,0,0,0,7
577675,309847,2014-01-17,Assembly,"From committee:  Be adopted.  To third reading",11,0,0,0,11
577675,309848,2014-01-17,Senate,"Senate 3rd Reading SCR73 Mitchell",25,0,14,0,39
577675,311274,2014-01-23,Senate,"Unfinished Business SCR73 Mitchell Concurrence",33,0,6,0,39
578687,345678,2014-03-19,Senate,"Do pass as amended, and re-refer to the Committee on Appropriations",7,0,2,0,9
578687,352646,2014-04-07,Senate,"Placed on Appropriations Suspense file",7,0,0,0,7
578723,345697,2014-03-19,Senate,"Do pass as amended, and re-refer to the Committee on Appropriations",7,0,2,0,9
578723,352684,2014-04-07,Senate,"Placed on Appropriations Suspense file",7,0,0,0,7
578777,353198,2014-04-08,Senate,"Do pass, but re-refer to the Committee on Appropriations",11,0,0,0,11
578777,361617,2014-05-01,Senate,"Senate 3rd Reading SB842 Knight",36,0,4,0,40
578777,373735,2014-06-23,Assembly,"Do pass as amended and re-refer to Committee on Appropriations 	with recommendation:  To Consent Calendar",13,0,0,3,16
578777,376667,2014-08-06,Assembly,"Do pass, to Consent Calendar",17,0,0,0,17
578777,377310,2014-08-14,Assembly,"SB 842 Knight  Consent Calendar Second Day  Regular Session",78,0,0,1,79
578777,377651,2014-08-18,Senate,"Unfinished Business SB842 Knight Concurrence",34,0,6,0,40
580190,348302,2014-03-26,Assembly,"Do pass",6,0,0,1,7
580190,350242,2014-04-01,Assembly,"AB 1450 GARCIA  Assembly Third Reading",73,0,0,7,80
580190,365747,2014-05-14,Senate,"Do pass",7,0,2,0,9
580190,376682,2014-08-06,Senate,"Do pass, but re-refer to the Committee on Appropriations",5,2,0,0,7
580190,378915,2014-08-28,Senate,"Do pass",6,0,1,0,7
580190,378994,2014-08-29,Senate,"Assembly 3rd Supp 1 AB1450 Garcia Urgency Clause",33,0,7,0,40
580190,378995,2014-08-29,Assembly,"AB 1450 GARCIA  Concurrence- Urgency Added",76,0,0,3,79
580192,350332,2014-04-01,Assembly,"Do pass and be re-referred to the Committee on Education",13,0,0,0,13
580192,361555,2014-04-30,Assembly,"Do pass and be re-referred to the Committee on Appropriations",7,0,0,0,7
580192,366823,2014-05-23,Assembly,"Do pass as amended",17,0,0,0,17
580192,368004,2014-05-28,Assembly,"AB 1451 HOLDEN  Assembly Third Reading",79,0,0,0,79
580192,372768,2014-06-18,Senate,"Do pass as amended, and re-refer to the Committee on Appropriations",7,0,0,0,7
580192,376618,2014-08-04,Senate,"Placed on Appropriations Suspense file",7,0,0,0,7
580195,347701,2014-03-25,Assembly,"Do pass as amended and be re-referred to the Committee on 	Appropriations",6,1,0,0,7
580195,367212,2014-05-23,Assembly,"Do pass",13,4,0,0,17
580195,367483,2014-05-27,Assembly,"AB 1452 STONE  Assembly Third Reading",58,11,0,10,79
580195,370394,2014-06-10,Senate,"Do pass as amended, and re-refer to the Committee on Appropriations",3,1,1,0,5
580195,375245,2014-06-30,Senate,"Placed on Appropriations Suspense file",6,0,1,0,7
580196,348056,2014-03-26,Senate,"Do pass as amended, and re-refer to the Committee on Banking and 	Financial Institution",9,0,0,0,9
580196,361460,2014-04-30,Senate,"Do pass as amended, and re-refer to the Committee on Appropriations",9,0,0,0,9
580196,365327,2014-05-19,Senate,"Do pass",7,0,0,0,7
580196,366871,2014-05-23,Senate,"Senate 3rd Reading SB845 Correa",31,0,9,0,40
580196,370444,2014-06-10,Assembly,"Do pass and be re-referred to the Committee on Appropriations",11,0,0,2,13
580196,372699,2014-06-18,Assembly,"Do pass, to Consent Calendar",15,0,0,2,17
580196,374750,2014-06-26,Assembly,"SB 845 Correa  Consent Calendar Second Day  Regular Session",76,0,0,3,79
580198,306788,2014-01-09,Senate,"W/O REF. TO FILE SR23 Steinberg",34,0,5,0,39
580199,344961,2014-03-18,Senate,"Do pass, but re-refer to the Committee on Appropriations",5,0,0,0,5
580199,363710,2014-05-12,Senate,"Placed on Appropriations Suspense file",7,0,0,0,7
580199,366740,2014-05-23,Senate,"Do pass as amended",6,1,0,0,7
580199,368106,2014-05-28,Senate,"Senate 3rd Reading SB844 Pavley",35,0,5,0,40
580199,374372,2014-06-24,Assembly,"Do pass and be re-referred to the Committee on Appropriations",6,0,0,1,7
580199,377136,2014-08-14,Assembly,"Do pass as amended",17,0,0,0,17
580199,378345,2014-08-25,Assembly,"SB 844 Pavley  Senate Third Reading  By FONG",78,1,0,0,79
580199,378482,2014-08-26,Senate,"Unfinished Supp 1 SB844 Pavley Concurrence",36,0,4,0,40
581693,355154,2014-04-10,Senate,"Senate 3rd Reading SB878 Committee on B. & F.R. (Leno)",22,12,6,0,40
581693,377469,2014-08-14,Assembly,"Do pass",16,10,0,1,27
581693,378239,2014-08-22,Assembly,"SB 878 B.& F. R.  Senate Third Reading  Amend By SKINNER  Set #1",53,22,0,4,79
581693,378966,2014-08-28,Assembly,"Do pass",16,10,0,1,27
581693,379046,2014-08-29,Assembly,"SB 878 B.& F. R.  Senate Third Reading  By SKINNER",56,22,0,1,79
581693,379047,2014-08-29,Senate,"Unfinished Supp 3 SB878 Committee on B. & F.R. (Leno) Concurrence",24,10,6,0,40
581694,367148,2014-05-23,Assembly,"AB 1461 BUDGET  Assembly Third Reading  By SKINNER",53,21,0,5,79
581694,371513,2014-06-15,Senate,"Do pass",13,1,2,0,16
581696,366921,2014-05-23,Assembly,"AB 1478 BUDGET  Assembly Third Reading  By SKINNER",53,21,0,5,79
581696,377594,2014-08-14,Senate,"Do pass",12,3,1,0,16
581696,379021,2014-08-30,Assembly,"AB 1478 BUDGET  Concurrence in Senate Amendments By SKINNER",53,21,0,5,79
581696,379022,2014-08-30,Senate,"Assembly 3rd Reading AB1478 Committee on BUDGET (Skinner) By Leno",23,12,5,0,40
581697,367002,2014-05-23,Assembly,"AB 1475 BUDGET  Assembly Third Reading  By SKINNER",53,21,0,5,79
581698,367149,2014-05-23,Assembly,"AB 1491 BUDGET  Assembly Third Reading  By SKINNER",53,21,0,5,79
581701,366936,2014-05-23,Assembly,"AB 1463 BUDGET  Assembly Third Reading  By SKINNER",53,21,0,5,79
581701,371517,2014-06-15,Senate,"Do pass",12,3,1,0,16
581702,366904,2014-05-23,Assembly,"AB 1471 BUDGET  Assembly Third Reading  By SKINNER",53,21,0,5,79
581702,371526,2014-06-15,Senate,"Do pass",11,3,2,0,16
581702,377074,2014-08-13,Senate,"Assembly 3rd Reading AB1471 Rendon et al. Urgency Clause",37,0,3,0,40
581702,377075,2014-08-13,Assembly,"AB 1471 RENDON  Concurrence- Urgency Added",77,2,0,0,79
581703,367195,2014-05-23,Assembly,"AB 1477 BUDGET  Assembly Third Reading  By SKINNER",53,21,0,5,79
581703,377599,2014-08-14,Senate,"Do pass",15,0,1,0,16
581703,379000,2014-08-29,Senate,"From Committee:  That the measure be returned to the Senate floor 	for consideration",9,3,4,0,16
581705,355114,2014-04-10,Senate,"Senate 3rd Reading SB873 Committee on B. & F.R. (Leno)",22,12,6,0,40
581705,377449,2014-08-14,Assembly,"Do pass",25,1,0,1,27
581705,378271,2014-08-22,Assembly,"SB 873 B.& F. R.  Senate Third Reading  Amend By SKINNER  Set #1",55,21,0,3,79
581705,378911,2014-08-28,Assembly,"Do pass",16,9,0,2,27
581705,379109,2014-08-29,Assembly,"SB 873 B.& F. R.  Senate Third Reading  Motion to  Suspend the 	Rules  By CHAVEZ",23,53,0,3,79
581705,379110,2014-08-29,Assembly,"SB 873 B.& F. R.  Senate Third Reading  By SKINNER",56,21,0,2,79
581705,379111,2014-08-29,Senate,"Unfinished Supp 3 SB873 Committee on B. & F.R. (Leno) Concurrence",27,8,5,0,40
581706,366976,2014-05-23,Assembly,"AB 1459 BUDGET  Assembly Third Reading  By SKINNER",53,21,0,5,79
581706,371511,2014-06-15,Senate,"Do pass",13,2,1,0,16
581707,355087,2014-04-10,Senate,"Senate 3rd Reading SB855 Committee on B. & F.R. (Leno)",22,12,6,0,40
581707,371529,2014-06-15,Assembly,"SB 855 B.& F. R.  Senate Third Reading  By SKINNER",61,10,0,8,79
581707,371530,2014-06-15,Senate,"Unfinished Supp 1 SB855 Committee on B. & F.R. (Leno)",29,8,3,0,40
581710,366938,2014-05-23,Assembly,"AB 1476 BUDGET  Assembly Third Reading  By SKINNER",53,21,0,5,79
581710,377598,2014-08-14,Senate,"Do pass",13,2,1,0,16
581710,379001,2014-08-29,Senate,"From Committee:  That the measure be returned to the Senate floor 	for consideration",9,3,4,0,16
581710,379002,2014-08-29,Senate,"Assembly 3rd Supp 3 AB1476 Committee on BUDGET (Skinner) By Leno",25,9,6,0,40
581710,379003,2014-08-29,Assembly,"AB 1476 BUDGET  Concurrence in Senate Amendments By SKINNER",59,16,0,4,79
581711,367145,2014-05-23,Assembly,"AB 1492 BUDGET  Assembly Third Reading  By SKINNER",53,21,0,5,79
581712,355089,2014-04-10,Senate,"Senate 3rd Reading SB860 Committee on B. & F.R. (Leno)",22,12,6,0,40
581712,371536,2014-06-15,Assembly,"SB 860 B.& F. R.  Senate Third Reading  By SKINNER",65,8,0,6,79
581712,371537,2014-06-15,Senate,"Unfinished Supp 2 SB860 Committee on B. & F.R. (Leno) Concurrence",37,0,3,0,40
581714,345328,2014-03-18,Assembly,"Do pass and be re-referred to the Committee on Appropriations",8,1,0,4,13
581714,367038,2014-05-23,Assembly,"Do pass",12,0,0,5,17
581714,368006,2014-05-28,Assembly,"AB 1456 JONES-SAWYER  Assembly Third Reading",54,17,0,8,79
581715,366842,2014-05-23,Assembly,"AB 1460 BUDGET  Assembly Third Reading  By SKINNER",53,21,0,5,79
581715,371515,2014-06-15,Senate,"Do pass",11,4,1,0,16
581717,367116,2014-05-23,Assembly,"AB 1467 BUDGET  Assembly Third Reading  By SKINNER",53,21,0,5,79
581719,367194,2014-05-23,Assembly,"AB 1483 BUDGET  Assembly Third Reading  By SKINNER",53,21,0,5,79
581720,366838,2014-05-23,Assembly,"AB 1488 BUDGET  Assembly Third Reading  By SKINNER",53,21,0,5,79
581722,353445,2014-04-08,Senate,"Do pass",7,0,0,0,7
581722,358031,2014-04-21,Senate,"Senate 3rd Reading SB846 Galgiani",34,0,6,0,40
581722,370745,2014-06-10,Assembly,"Do pass, to Consent Calendar",7,0,0,0,7
581722,371736,2014-06-16,Assembly,"SB 846 Galgiani  Consent Calendar Second Day  Regular Session",77,0,0,2,79
581722,377607,2014-08-18,Assembly,"SB 846 Galgiani  Senate Third Reading  By GRAY",77,0,0,2,79
581722,378986,2014-08-28,Senate,"Unfinished Business SB846 Galgiani Concurrence",35,0,5,0,40
581723,355088,2014-04-10,Senate,"Senate 3rd Reading SB886 Committee on B. & F.R. (Leno)",22,12,6,0,40
581724,367164,2014-05-23,Assembly,"AB 1482 BUDGET  Assembly Third Reading  By SKINNER",53,21,0,5,79
581726,355131,2014-04-10,Senate,"Senate 3rd Reading SB866 Committee on B. & F.R. (Leno)",22,12,6,0,40
581726,377060,2014-08-13,Assembly,"SB 866 Wolk  Third Reading Urgency  By RENDON",77,1,0,1,79
581726,377061,2014-08-13,Senate,"W/O REF. TO FILE SB866 Wolk Concurrence",37,0,3,0,40
581728,367151,2014-05-23,Assembly,"AB 1496 BUDGET  Assembly Third Reading  By SKINNER",53,21,0,5,79
581729,366956,2014-05-23,Assembly,"AB 1473 BUDGET  Assembly Third Reading  By SKINNER",53,21,0,5,79
581729,371514,2014-06-15,Senate,"Do pass",15,0,1,0,16
581731,355099,2014-04-10,Senate,"Senate 3rd Reading SB854 Committee on B. & F.R. (Leno)",22,12,6,0,40
581731,371542,2014-06-15,Assembly,"SB 854 B.& F. R.  Senate Third Reading  By SKINNER",55,23,0,1,79
581731,371543,2014-06-15,Senate,"Unfinished Supp 1 SB854 Committee on B. & F.R. (Leno) Concurrence",31,6,3,0,40
581732,355035,2014-04-10,Senate,"Senate 3rd Reading SB859 Committee on B. & F.R. (Leno)",22,12,6,0,40
581732,371576,2014-06-15,Assembly,"SB 859 B.& F. R.  Senate Third Reading  By SKINNER",78,0,0,1,79
581732,371577,2014-06-15,Senate,"Unfinished Supp 1 SB859 Committee on B. & F.R. (Leno) Concurrence",35,2,3,0,40
581733,355036,2014-04-10,Senate,"Senate 3rd Reading SB882 Committee on B. & F.R. (Leno)",22,12,6,0,40
581733,377504,2014-08-14,Assembly,"Do pass",14,10,0,3,27
581733,378207,2014-08-22,Assembly,"SB 882 B.& F. R.  Senate Third Reading  Amend By SKINNER  Set #1",52,23,0,4,79
581735,355081,2014-04-10,Senate,"Senate 3rd Reading SB862 Committee on B. & F.R. (Leno)",22,12,6,0,40
581735,371578,2014-06-15,Assembly,"SB 862 B.& F. R.  Senate Third Reading  By SKINNER",53,26,0,0,79
581735,371579,2014-06-15,Senate,"Unfinished Supp 1 SB862 Committee on B. & F.R. (Leno) Concurrence",22,12,6,0,40
581737,355148,2014-04-10,Senate,"Senate 3rd Reading SB885 Committee on B. & F.R. (Leno)",22,12,6,0,40
581739,355174,2014-04-10,Senate,"Senate 3rd Reading SB876 Committee on B. & F.R. (Leno)",22,12,6,0,40
581739,377450,2014-08-14,Assembly,"Do pass",23,1,0,3,27
581739,379118,2014-08-29,Assembly,"SB 876 B.& F. R.  Senate Third Reading  By SKINNER",73,3,0,3,79
581739,379119,2014-08-29,Senate,"Unfinished Supp 3 SB876 Committee on B. & F.R. (Leno) Concurrence",35,0,5,0,40
581740,359609,2014-04-24,Senate,"Do pass as amended, and re-refer to the Committee on Appropriations",8,0,1,0,9
581740,363702,2014-05-12,Senate,"Placed on Appropriations Suspense file",7,0,0,0,7
581740,366928,2014-05-23,Senate,"Do pass",7,0,0,0,7
581740,367458,2014-05-27,Senate,"Senate 3rd Reading SB850 Block",34,0,6,0,40
581740,374362,2014-06-24,Assembly,"Do pass as amended and be re-referred to the Committee on 	Appropriations",12,0,0,1,13
581740,377387,2014-08-14,Assembly,"Do pass as amended",17,0,0,0,17
581740,377951,2014-08-20,Assembly,"SB 850 Block  Senate Third Reading  By CHAVEZ",77,0,0,2,79
581740,378043,2014-08-21,Senate,"Unfinished Business SB850 Block",32,0,8,0,40
581741,355150,2014-04-10,Senate,"Senate 3rd Reading SB880 Committee on B. & F.R. (Leno)",22,12,6,0,40
581741,377484,2014-08-14,Assembly,"Do pass",14,10,0,3,27
581741,378198,2014-08-22,Assembly,"SB 880 B.& F. R.  Senate Third Reading  Amend By SKINNER  Set #1",53,23,0,3,79
581743,355161,2014-04-10,Senate,"Senate 3rd Reading SB884 Committee on B. & F.R. (Leno)",22,12,6,0,40
581746,358493,2014-04-21,Assembly,"Do pass and be re-referred to the Committee on Natural Resources",8,4,0,3,15
581746,361614,2014-05-01,Assembly,"Do pass as amended and be re-referred to the Committee on 	Appropriations",6,2,0,1,9
581748,355186,2014-04-10,Senate,"Senate 3rd Reading SB874 Committee on B. & F.R. (Leno)",22,12,6,0,40
581748,377274,2014-08-14,Assembly,"Do pass",16,10,0,1,27
581748,378270,2014-08-22,Assembly,"SB 874 B.& F. R.  Senate Third Reading  Amend By SKINNER  Set #1",51,23,0,5,79
581748,378943,2014-08-28,Assembly,"Do pass",16,10,0,1,27
581749,367006,2014-05-23,Assembly,"AB 1469 BUDGET  Assembly Third Reading  By SKINNER",53,21,0,5,79
581749,371533,2014-06-15,Senate,"Do pass",14,0,2,0,16
581749,371534,2014-06-15,Senate,"Assembly 3rd Supp 1 AB1469 Bonta By Torres",37,0,3,0,40
581749,371535,2014-06-15,Assembly,"AB 1469 BONTA  Concurrence in Senate Amendments",76,1,0,2,79
581750,366810,2014-05-23,Assembly,"AB 1458 BUDGET  Assembly Third Reading  By SKINNER",53,21,0,5,79
581750,371565,2014-06-15,Senate,"Do pass",11,4,1,0,16
581752,367170,2014-05-23,Assembly,"AB 1474 BUDGET  Assembly Third Reading  By SKINNER",53,21,0,5,79
581752,371510,2014-06-15,Senate,"Do pass",11,4,1,0,16
581753,367184,2014-05-23,Assembly,"AB 1472 BUDGET  Assembly Third Reading  By SKINNER",53,21,0,5,79
581753,371516,2014-06-15,Senate,"Do pass",11,4,1,0,16
581755,367193,2014-05-23,Assembly,"AB 1493 BUDGET  Assembly Third Reading  By SKINNER",53,21,0,5,79
581757,366901,2014-05-23,Assembly,"AB 1487 BUDGET  Assembly Third Reading  By SKINNER",53,21,0,5,79
581758,367196,2014-05-23,Assembly,"AB 1495 BUDGET  Assembly Third Reading  By SKINNER",53,21,0,5,79
581759,367169,2014-05-23,Assembly,"AB 1479 BUDGET  Assembly Third Reading  By SKINNER",53,21,0,5,79
581759,377597,2014-08-14,Senate,"Do pass",12,1,3,0,16
581762,367199,2014-05-23,Assembly,"AB 1497 BUDGET  Assembly Third Reading  By SKINNER",53,21,0,5,79
581765,355151,2014-04-10,Senate,"Senate 3rd Reading SB872 Committee on B. & F.R. (Leno)",22,12,6,0,40
581765,377494,2014-08-14,Assembly,"Do pass",22,3,0,2,27
581765,378208,2014-08-22,Assembly,"SB 872 B.& F. R.  Senate Third Reading  Amend By SKINNER  Set #1",55,21,0,3,79
581765,378965,2014-08-28,Assembly,"Do pass",18,7,0,2,27
581766,355059,2014-04-10,Senate,"Senate 3rd Reading SB853 Committee on B. & F.R. (Leno)",22,12,6,0,40
581766,371549,2014-06-15,Assembly,"SB 853 B.& F. R.  Senate Third Reading  By SKINNER",55,23,0,1,79
581766,371550,2014-06-15,Senate,"Unfinished Supp 1 SB853 Committee on B. & F.R. (Leno) Concurrence",27,10,3,0,40
581767,355055,2014-04-10,Senate,"Senate 3rd Reading SB863 Committee on B. & F.R. (Leno)",22,12,6,0,40
581767,373154,2014-06-19,Assembly,"SB 863 B.& F. R.  Senate Third Reading  By SKINNER",78,0,0,1,79
581767,373155,2014-06-19,Senate,"W/O REF. TO FILE SB863 Committee on B. & F.R. (Leno) Concurrence",32,2,6,0,40
581769,355165,2014-04-10,Senate,"Senate 3rd Reading SB869 Committee on B. & F.R. (Leno)",22,12,6,0,40
581769,371566,2014-06-15,Assembly,"SB 869 B.& F. R.  Third Reading Urgency  By SKINNER",79,0,0,0,79
581769,371567,2014-06-15,Senate,"Unfinished Supp 1 SB869 Committee on B. & F.R. (Leno) Concurrence",37,0,3,0,40
581770,366832,2014-05-23,Assembly,"AB 1464 BUDGET  Assembly Third Reading  By SKINNER",53,21,0,5,79
581770,371519,2014-06-15,Senate,"Do pass",13,0,3,0,16
581772,348317,2014-03-25,Assembly,"Do pass and be re-referred to the Committee on Appropriations",7,0,0,0,7
581772,354537,2014-04-09,Assembly,"Do pass, to Consent Calendar",17,0,0,0,17
581772,359592,2014-04-24,Assembly,"AB 1498 CAMPOS  Consent Calendar Second Day  Regular Session",75,0,0,4,79
581772,372559,2014-06-17,Senate,"Do pass, but re-refer to the Committee on Appropriations",5,0,2,0,7
581772,376812,2014-08-07,Senate,"Assembly 3rd Reading AB1498 Campos By Pavley",36,0,4,0,40
581772,377251,2014-08-14,Assembly,"AB 1498 CAMPOS  Concurrence in Senate Amendments",78,0,0,1,79
581774,367163,2014-05-23,Assembly,"AB 1466 BUDGET  Assembly Third Reading  By SKINNER",53,21,0,5,79
581774,371518,2014-06-15,Senate,"Do pass as amended",11,2,3,0,16
581775,355130,2014-04-10,Senate,"Senate 3rd Reading SB883 Committee on B. & F.R. (Leno)",22,12,6,0,40
581775,377480,2014-08-14,Assembly,"Do pass",14,10,0,3,27
581775,378199,2014-08-22,Assembly,"SB 883 B.& F. R.  Senate Third Reading  Amend By SKINNER  Set #1",51,23,0,5,79
581775,379050,2014-08-30,Senate,"W/O REF. TO FILE SB883 Hancock Concurrence",22,11,7,0,40
581775,379051,2014-08-30,Assembly,"SB 883 Hancock  Senate Third Reading  By SKINNER",59,16,0,4,79
581776,355201,2014-04-10,Senate,"Senate 3rd Reading SB857 Committee on B. & F.R. (Leno)",22,12,6,0,40
581776,371544,2014-06-15,Assembly,"SB 857 B.& F. R.  Senate Third Reading  By SKINNER  Amend By OLSEN 	Set #1  Motion to  Lay on the Table",55,24,0,0,79
581776,371545,2014-06-15,Assembly,"SB 857 B.& F. R.  Senate Third Reading  By SKINNER  Amend By GROVE 	Set #2  Motion to  Lay on the Table",54,24,0,1,79
581776,371546,2014-06-15,Assembly,"SB 857 B.& F. R.  Senate Third Reading  By SKINNER  Amend By 	WALDRON  Set #3  Motion to  Lay on the Table",54,24,0,1,79
581776,371547,2014-06-15,Assembly,"SB 857 B.& F. R.  Senate Third Reading  By SKINNER",55,24,0,0,79
581776,371548,2014-06-15,Senate,"Unfinished Supp 1 SB857 Committee on B. & F.R. (Leno) Concurrence",26,11,3,0,40
581778,355196,2014-04-10,Senate,"Senate 3rd Reading SB856 Committee on B. & F.R. (Leno)",22,12,6,0,40
581778,371568,2014-06-15,Assembly,"SB 856 B.& F. R.  Senate Third Reading  By SKINNER",78,0,0,1,79
581778,371569,2014-06-15,Senate,"Unfinished Supp 2 SB856 Committee on B. & F.R. (Leno) Concurrence",36,0,4,0,40
581779,367207,2014-05-23,Assembly,"AB 1481 BUDGET  Assembly Third Reading  By SKINNER",53,21,0,5,79
581779,377595,2014-08-14,Senate,"Do pass",13,1,2,0,16
581781,355086,2014-04-10,Senate,"Senate 3rd Reading SB890 Committee on B. & F.R. (Leno)",22,12,6,0,40
581783,367180,2014-05-23,Assembly,"AB 1490 BUDGET  Assembly Third Reading  By SKINNER",53,21,0,5,79
581784,355134,2014-04-09,Assembly,"Do pass",7,0,0,0,7
581784,359620,2014-04-24,Assembly,"AB 1455 CAMPOS  Assembly Third Reading",69,3,0,7,79
581784,370829,2014-06-11,Senate,"Do pass as amended",7,0,0,0,7
581784,375681,2014-07-03,Senate,"Special Consent #18 AB1455 Campos",35,0,5,0,40
581784,376804,2014-08-07,Assembly,"AB 1455 CAMPOS  Concurrence in Senate Amendments",72,1,0,6,79
581786,366990,2014-05-23,Assembly,"AB 1494 BUDGET  Assembly Third Reading  By SKINNER",53,21,0,5,79
581787,355101,2014-04-10,Senate,"Senate 3rd Reading SB870 Committee on B. & F.R. (Leno)",22,12,6,0,40
581787,371522,2014-06-15,Assembly,"SB 870 B.& F. R.  Senate Third Reading  By SKINNER",55,24,0,0,79
581787,371523,2014-06-15,Senate,"Unfinished Supp 1 SB870 Committee on B. & F.R. (Leno) Concurrence",26,11,3,0,40
581788,355074,2014-04-10,Senate,"Senate 3rd Reading SB879 Committee on B. & F.R. (Leno)",22,12,6,0,40
581788,377488,2014-08-14,Assembly,"Do pass",14,10,0,3,27
581788,378984,2014-08-28,Assembly,"Do pass",16,9,0,2,27
581788,379095,2014-08-29,Assembly,"SB 879 B.& F. R.  Senate Third Reading  By SKINNER",60,12,0,7,79
581788,379096,2014-08-29,Senate,"Unfinished Supp 3 SB879 Committee on B. & F.R. (Leno) Concurrence",35,0,5,0,40
581791,355079,2014-04-10,Senate,"Senate 3rd Reading SB888 Committee on B. & F.R. (Leno)",22,12,6,0,40
581792,361057,2014-04-29,Assembly,"Do pass and be re-referred to the Committee on Appropriations",9,0,0,1,10
581792,367161,2014-05-23,Assembly,"Do pass",17,0,0,0,17
581792,368805,2014-05-29,Assembly,"AB 1453 QUIRK-SILVA  Assembly Third Reading",78,0,0,1,79
581792,374108,2014-06-24,Senate,"Do pass, but re-refer to the Committee on Appropriations Recommend 	Consent",6,0,1,0,7
581792,376447,2014-08-04,Senate,"Placed on Appropriations Suspense file",7,0,0,0,7
581792,377472,2014-08-14,Senate,"Do pass as amended",5,0,2,0,7
581792,378070,2014-08-21,Senate,"Assembly 3rd Reading AB1453 Quirk-Silva By Correa",33,0,7,0,40
581792,378325,2014-08-25,Assembly,"AB 1453 QUIRK-SILVA  Concurrence in Senate Amendments",78,0,0,1,79
581793,355066,2014-04-10,Senate,"Senate 3rd Reading SB861 Committee on B. & F.R. (Leno)",22,12,6,0,40
581793,371531,2014-06-15,Assembly,"SB 861 B.& F. R.  Senate Third Reading  By SKINNER",55,23,0,1,79
581793,371532,2014-06-15,Senate,"Unfinished Supp 1 SB861 Committee on B. & F.R. (Leno)",24,12,4,0,40
581795,353419,2014-04-08,Senate,"Do pass, but re-refer to the Committee on Appropriations",7,0,0,0,7
581795,360171,2014-04-28,Senate,"Placed on Appropriations Suspense file",6,0,1,0,7
581796,355094,2014-04-10,Senate,"Senate 3rd Reading SB889 Committee on B. & F.R. (Leno)",22,12,6,0,40
581797,355118,2014-04-10,Senate,"Senate 3rd Reading SB891 Committee on B. & F.R. (Leno)",22,12,6,0,40
581800,367205,2014-05-23,Assembly,"AB 1468 BUDGET  Assembly Third Reading  By SKINNER",53,21,0,5,79
581800,371570,2014-06-15,Senate,"Assembly 3rd Supp 1 AB1468 Committee on BUDGET (Skinner) Lay on 	Table",25,12,3,0,40
581800,371571,2014-06-15,Senate,"Assembly 3rd Supp 1 AB1468 Committee on BUDGET (Skinner) Lay on 	Table",25,12,3,0,40
581800,371572,2014-06-15,Senate,"Assembly 3rd Supp 1 AB1468 Committee on BUDGET (Skinner) By Leno",24,11,5,0,40
581800,371573,2014-06-15,Assembly,"AB 1468 BUDGET  Concurrence in Senate Amendments By SKINNER",54,23,0,2,79
581801,355155,2014-04-10,Senate,"Senate 3rd Reading SB887 Committee on B. & F.R. (Leno)",22,12,6,0,40
581802,367165,2014-05-23,Assembly,"AB 1485 BUDGET  Assembly Third Reading  By SKINNER",53,21,0,5,79
581804,355169,2014-04-10,Senate,"Senate 3rd Reading SB858 Committee on B. & F.R. (Leno)",22,12,6,0,40
581804,371538,2014-06-15,Assembly,"SB 858 B.& F. R.  Senate Third Reading  By SKINNER",55,23,0,1,79
581804,371539,2014-06-15,Senate,"Unfinished Supp 2 SB858 Committee on B. & F.R. (Leno) Concurrence",26,11,3,0,40
581805,355121,2014-04-10,Senate,"Senate 3rd Reading SB871 Committee on B. & F.R. (Leno)",22,12,6,0,40
581805,371527,2014-06-15,Assembly,"SB 871 B.& F. R.  Senate Third Reading  By SKINNER",48,20,0,11,79
581805,371528,2014-06-15,Senate,"W/O REF. TO FILE SB871 Committee on B. & F.R. (Leno) Concurrence",28,8,4,0,40
581806,366880,2014-05-23,Assembly,"AB 1465 BUDGET  Assembly Third Reading  By SKINNER",53,21,0,5,79
581806,371520,2014-06-15,Senate,"Do pass",13,0,3,0,16
581809,347676,2014-03-25,Assembly,"Do pass and be re-referred to the Committee on Appropriations",7,0,0,0,7
581809,367123,2014-05-23,Assembly,"Do pass as amended",16,0,0,1,17
581809,368050,2014-05-28,Assembly,"AB 1454 CALDERON  Assembly Third Reading",79,0,0,0,79
581809,370618,2014-06-10,Senate,"Do pass, but re-refer to the Committee on Appropriations",4,0,1,0,5
581809,375218,2014-06-30,Senate,"Placed on Appropriations Suspense file",6,0,1,0,7
581812,355082,2014-04-10,Senate,"Senate 3rd Reading SB864 Committee on B. & F.R. (Leno)",22,12,6,0,40
581813,355158,2014-04-10,Senate,"Senate 3rd Reading SB877 Committee on B. & F.R. (Leno)",22,12,6,0,40
581813,377451,2014-08-14,Assembly,"Do pass",26,0,0,1,27
581813,379089,2014-08-29,Assembly,"SB 877 B.& F. R.  Senate Third Reading  By SKINNER",77,0,0,2,79
581813,379090,2014-08-29,Senate,"Unfinished Supp 3 SB877 Committee on B. & F.R. (Leno) Concurrence",34,0,6,0,40
581814,366792,2014-05-23,Assembly,"AB 1484 BUDGET  Assembly Third Reading  By SKINNER",53,21,0,5,79
581817,366822,2014-05-23,Assembly,"AB 1462 BUDGET  Assembly Third Reading  By SKINNER",53,21,0,5,79
581817,371512,2014-06-15,Senate,"Do pass",10,4,2,0,16
581818,366897,2014-05-23,Assembly,"AB 1489 BUDGET  Assembly Third Reading  By SKINNER",53,21,0,5,79
581819,355171,2014-04-10,Senate,"Senate 3rd Reading SB852 Committee on B. & F.R. (Leno)",22,12,6,0,40
581819,366820,2014-05-23,Assembly,"SB 852 B.& F. R.  Senate Third Reading",53,21,0,5,79
581819,367574,2014-05-27,Senate,"Unfinished Business SB852 Committee on B. & F.R. (Leno)",1,33,6,0,40
581819,371540,2014-06-15,Assembly,"SB 852 Leno  Conference Report  By SKINNER",55,24,0,0,79
581819,371541,2014-06-15,Senate,"Conference Reports SB852 Leno",25,11,4,0,40
581821,319135,2014-02-11,Senate,"Do pass as amended, and re-refer to the Committee on Environmental 	Quality",6,0,3,0,9
581821,324863,2014-02-19,Senate,"Do pass as amended, and re-refer to the Committee on Governance and 	Finance",6,2,0,0,8
581821,330229,2014-02-26,Senate,"Do pass, but re-refer to the Committee on Appropriations",5,2,0,0,7
581821,365239,2014-05-19,Senate,"Placed on Appropriations Suspense file",7,0,0,0,7
581821,366767,2014-05-23,Senate,"Do pass as amended, and re-refer to the Committee on Rules",5,2,0,0,7
581821,373720,2014-06-23,Senate,"W/O REF. TO FILE SB848 Wolk Urgency Clause",22,9,9,0,40
581821,373721,2014-06-23,Senate,"W/O REF. TO FILE SB848 Wolk",31,0,9,0,40
581822,355092,2014-04-10,Senate,"Senate 3rd Reading SB881 Committee on B. & F.R. (Leno)",22,12,6,0,40
581822,377477,2014-08-14,Assembly,"Do pass",14,10,0,3,27
581822,378978,2014-08-28,Assembly,"Do pass",24,1,0,2,27
581823,355202,2014-04-10,Senate,"Senate 3rd Reading SB875 Committee on B. & F.R. (Leno)",22,12,6,0,40
581823,377455,2014-08-14,Assembly,"Do pass",16,10,0,1,27
581823,379082,2014-08-29,Assembly,"SB 875 B.& F. R.  Senate Third Reading  By SKINNER",56,22,0,1,79
581823,379083,2014-08-29,Senate,"Unfinished Supp 3 SB875 Committee on B. & F.R. (Leno) Concurrence",27,8,5,0,40
581826,355120,2014-04-10,Senate,"Senate 3rd Reading SB865 Committee on B. & F.R. (Leno)",22,12,6,0,40
581826,371524,2014-06-15,Assembly,"SB 865 B.& F. R.  Senate Third Reading  By SKINNER",68,8,0,3,79
581826,371525,2014-06-15,Senate,"Unfinished Supp 1 SB865 Committee on B. & F.R. (Leno) Concurrence",29,8,3,0,40
581827,366995,2014-05-23,Assembly,"AB 1480 BUDGET  Assembly Third Reading  By SKINNER",53,21,0,5,79
581827,377596,2014-08-14,Senate,"Do pass",14,0,2,0,16
581828,367005,2014-05-23,Assembly,"AB 1486 BUDGET  Assembly Third Reading  By SKINNER",53,21,0,5,79
581830,355103,2014-04-10,Senate,"Senate 3rd Reading SB868 Committee on B. & F.R. (Leno)",22,12,6,0,40
581831,366804,2014-05-23,Assembly,"AB 1470 BUDGET  Assembly Third Reading  By SKINNER",53,21,0,5,79
581831,371521,2014-06-15,Senate,"Do pass",12,0,4,0,16
581832,355116,2014-04-10,Senate,"Senate 3rd Reading SB867 Committee on B. & F.R. (Leno)",22,12,6,0,40
581832,377000,2014-08-11,Assembly,"SB 867 B.& F. R.  Third Reading Urgency  By ATKINS",79,0,0,0,79
581832,377001,2014-08-11,Senate,"W/O REF. TO FILE SB867 Committee on B. & F.R. (Leno) Concurrence",34,1,5,0,40
583570,353199,2014-04-08,Senate,"Do pass, but re-refer to the Committee on Appropriations",5,0,0,0,5
583570,360142,2014-04-28,Senate,"Placed on Appropriations Suspense file",6,0,1,0,7
583570,366782,2014-05-23,Senate,"Do pass as amended",7,0,0,0,7
583570,368002,2014-05-28,Senate,"Senate 3rd Reading SB895 Corbett",36,0,4,0,40
583570,372260,2014-06-17,Assembly,"Do pass as amended and be re-referred to the Committee on 	Appropriations",6,0,0,1,7
583570,377235,2014-08-14,Assembly,"Do pass as amended",12,0,0,5,17
583570,378516,2014-08-26,Assembly,"SB 895 Corbett  Senate Third Reading  By WIECKOWSKI",61,11,0,7,79
583570,378753,2014-08-27,Senate,"Unfinished Business SB895 Corbett Concurrence",29,6,5,0,40
583849,359393,2014-04-22,Senate,"Do pass as amended, and re-refer to the Committee on 	Appropriations",5,2,0,0,7
583849,363778,2014-05-12,Senate,"Placed on Appropriations Suspense file",7,0,0,0,7
583849,366985,2014-05-23,Senate,"Do pass as amended",5,2,0,0,7
583849,368076,2014-05-28,Senate,"Senate 3rd Reading SB893 Hill",18,15,7,0,40
583849,368077,2014-05-28,Senate,"Senate 3rd Reading SB893 Hill Reconsider",36,0,4,0,40
584129,354527,2014-04-09,Senate,"Do pass, but re-refer to the Committee on Appropriations",9,0,0,0,9
584129,360067,2014-04-28,Senate,"Do pass",6,0,1,0,7
584129,365244,2014-05-19,Senate,"Senate 3rd Reading SB896 Correa",33,0,7,0,40
584129,374181,2014-06-23,Assembly,"Do pass and be re-referred to the Committee on Appropriations",12,0,0,0,12
584129,375600,2014-07-02,Assembly,"Do pass",16,0,0,1,17
584129,376359,2014-08-04,Assembly,"SB 896 Correa  Senate Third Reading  By DICKINSON",75,0,0,4,79
584407,347025,2014-03-24,Assembly,"Do pass and be re-referred to the Committee on Appropriations",4,11,0,1,16
584407,358708,2014-04-21,Assembly,"Reconsideration granted",16,0,0,0,16
584729,353312,2014-04-08,Senate,"Do pass, but re-refer to the Committee on Judiciary",3,2,0,0,5
584729,359260,2014-04-22,Senate,"Do pass as amended, and re-refer to the Committee on 	Appropriations",6,0,1,0,7
584729,363762,2014-05-12,Senate,"Placed on Appropriations Suspense file",7,0,0,0,7
584729,366746,2014-05-23,Senate,"Do pass as amended",5,2,0,0,7
584729,368213,2014-05-28,Senate,"Senate 3rd Reading SB894 Corbett",27,8,5,0,40
584729,372248,2014-06-17,Assembly,"Do pass as amended and be re-referred to the Committee on Aging and 	Long",5,0,0,2,7
584729,374536,2014-06-24,Assembly,"Do pass and be re-referred to the Committee on Appropriations",5,0,0,2,7
584729,376724,2014-08-06,Assembly,"Do pass",15,0,0,2,17
585093,358758,2014-04-22,Senate,"Do pass, but re-refer to the Committee on Appropriations Recommend 	Consent",10,0,0,0,10
585093,363439,2014-05-08,Senate,"Consent Calendar 2nd SB898 Cannella",35,0,5,0,40
585093,374171,2014-06-23,Assembly,"Do pass as amended and be re-referred to the Committee on 	Appropriations",12,0,0,0,12
585093,375612,2014-07-02,Assembly,"Do pass, to Consent Calendar",17,0,0,0,17
585093,377305,2014-08-14,Assembly,"Do pass as amended",12,0,0,0,12
585093,377975,2014-08-20,Assembly,"SB 898 Cannella  Senate Third Reading  By GRAY",74,0,0,5,79
585093,378157,2014-08-21,Senate,"Unfinished Business SB898 Cannella Concurrence",32,0,8,0,40
585355,361059,2014-04-30,Assembly,"Do pass and be re-referred to the Committee on Appropriations",19,0,0,0,19
585355,366148,2014-05-21,Assembly,"Do pass",6,1,0,10,17
585355,366149,2014-05-21,Assembly,"Set second hearing.  Failed passage.  Reconsideration granted",17,0,0,0,17
585615,354531,2014-04-08,Assembly,"Do pass",5,1,0,1,7
585615,361846,2014-05-01,Assembly,"AB 1502 MULLIN  Assembly Third Reading",49,23,0,7,79
585615,370632,2014-06-10,Senate,"Do pass, but re-refer to the Committee on Appropriations",3,1,1,0,5
585615,376536,2014-08-04,Senate,"Placed on Appropriations Suspense file",7,0,0,0,7
585874,353449,2014-04-08,Senate,"Do pass, but re-refer to the Committee on Appropriations",6,1,0,0,7
585874,360249,2014-04-28,Senate,"Placed on Appropriations Suspense file",6,0,1,0,7
585874,366951,2014-05-23,Senate,"Do pass as amended",5,2,0,0,7
585874,368083,2014-05-28,Senate,"Senate 3rd Reading SB892 Hancock",25,11,4,0,40
585874,374217,2014-06-24,Assembly,"Do pass and be re-referred to the Committee on Appropriations",5,2,0,0,7
585874,377461,2014-08-14,Assembly,"Do pass as amended",12,5,0,0,17
586132,348164,2014-03-26,Senate,"Do pass as amended, and re-refer to the Committee on Appropriations",9,0,0,0,9
586132,360308,2014-04-28,Senate,"Placed on Appropriations Suspense file",6,0,1,0,7
586132,367030,2014-05-23,Senate,"Do pass",7,0,0,0,7
586132,367439,2014-05-27,Senate,"Senate 3rd Reading SB897 Steinberg",33,0,7,0,40
586132,375066,2014-06-25,Assembly,"Do pass as amended and be re-referred to the Committee on 	Appropriations",7,0,0,0,7
586132,377329,2014-08-14,Assembly,"Do pass as amended",13,0,0,4,17
586132,378687,2014-08-27,Assembly,"SB 897 Steinberg  Senate Third Reading  By DICKINSON",77,0,0,2,79
586132,379048,2014-08-29,Senate,"Unfinished Business SB897 Steinberg Concurrence",37,0,3,0,40
586391,341021,2014-03-12,Assembly,"Do pass as amended and be re-referred to the Committee on 	Appropriations",11,0,0,1,12
586391,354861,2014-04-09,Assembly,"Do pass as amended, to Consent Calendar",17,0,0,0,17
586391,360097,2014-04-28,Assembly,"AB 1503 GAINES  Consent Calendar Second Day  Regular Session",78,0,0,1,79
586391,370406,2014-06-10,Senate,"Do pass, but re-refer to the Committee on Appropriations Recommend 	Consent",8,0,2,0,10
586391,374887,2014-06-26,Senate,"Consent Calendar 2nd AB1503 Beth Gaines",32,0,8,0,40
586391,375329,2014-06-30,Assembly,"AB 1503 GAINES  Concurrence in Senate Amendments",78,0,0,1,79
588694,363301,2014-05-07,Assembly,"Do pass",2,13,0,4,19
588858,355065,2014-04-10,Assembly,"From committee:  Be adopted.  To third reading",7,0,0,4,11
588858,366987,2014-05-23,Senate,"Special Consent #15 ACR83 Buchanan",32,0,8,0,40
588940,353626,2014-04-07,Assembly,"Do pass and be re-referred to the Committee on Appropriations",9,0,0,0,9
588940,361481,2014-04-30,Assembly,"Do pass",16,0,0,1,17
588940,362308,2014-05-05,Assembly,"AB 1506 PEREA  Assembly Third Reading",75,0,0,4,79
588940,370742,2014-06-10,Senate,"Do pass, but re-refer to the Committee on Appropriations Recommend 	Consent",9,0,0,0,9
588940,374740,2014-06-26,Senate,"Consent Calendar 2nd AB1506 Perea",32,0,8,0,40
589022,354611,2014-04-08,Assembly,"Do pass and be re-referred to the Committee on Appropriations",7,1,0,2,10
589022,367022,2014-05-23,Assembly,"Do pass",12,0,0,5,17
589022,367993,2014-05-28,Assembly,"AB 1509 FOX  Assembly Third Reading",64,5,0,10,79
589022,374154,2014-06-24,Senate,"Do pass, but re-refer to the Committee on Appropriations",6,0,1,0,7
589022,376603,2014-08-04,Senate,"Placed on Appropriations Suspense file",7,0,0,0,7
589022,377410,2014-08-14,Senate,"Do pass as amended",5,0,2,0,7
589022,378132,2014-08-21,Senate,"Assembly 3rd Reading AB1509 Fox By Roth",36,0,4,0,40
589022,378285,2014-08-25,Assembly,"AB 1509 FOX  Concurrence in Senate Amendments",73,2,0,4,79
589104,341239,2014-03-11,Assembly,"Do pass as amended and be re-referred to the Committee on 	Appropriations",6,0,0,1,7
589104,354526,2014-04-09,Assembly,"Do pass",17,0,0,0,17
589104,357965,2014-04-21,Assembly,"AB 1511 GAINES  Assembly Third Reading",78,0,0,1,79
589104,370609,2014-06-10,Senate,"Do pass, but re-refer to the Committee on Appropriations",6,0,1,0,7
589104,376991,2014-08-11,Senate,"Assembly 3rd Reading AB1511 Beth Gaines By Leno",36,0,4,0,40
589104,377238,2014-08-14,Assembly,"AB 1511 GAINES  Concurrence in Senate Amendments",79,0,0,0,79
589186,360664,2014-04-29,Assembly,"Do pass and be re-referred to the Committee on Appropriations",4,2,0,1,7
589268,358602,2014-04-22,Assembly,"Do pass and be re-referred to the Committee on Appropriations",2,2,0,3,7
589268,358603,2014-04-22,Assembly,"Set first hearing.  Failed passage.  Reconsideration granted",7,0,0,0,7
589351,340811,2014-03-11,Assembly,"Do pass as amended",7,0,0,0,7
589351,346515,2014-03-20,Assembly,"AB 1512 STONE  Assembly Third Reading",76,0,0,4,80
589351,364055,2014-05-13,Senate,"Do pass",6,0,1,0,7
589351,370067,2014-06-05,Senate,"Assembly 3rd Reading AB1512 Stone By Monning",33,0,7,0,40
589351,370189,2014-06-09,Assembly,"AB 1512 STONE  Concurrence in Senate Amendments",77,0,0,2,79
589433,353332,2014-04-08,Senate,"Do pass, but re-refer to the Committee on Appropriations",3,2,0,0,5
589433,360121,2014-04-28,Senate,"Placed on Appropriations Suspense file",6,0,1,0,7
589514,364402,2014-05-13,Assembly,"Do pass as amended and be re-referred to the Committee on 	Appropriations",9,0,0,0,9
591451,348098,2014-03-25,Assembly,"Do pass and be re-referred to the Committee on Appropriations",7,0,0,0,7
591451,366753,2014-05-23,Assembly,"Do pass as amended",17,0,0,0,17
591451,368024,2014-05-28,Assembly,"AB 1517 SKINNER  Assembly Third Reading",79,0,0,0,79
591451,372123,2014-06-17,Senate,"Do pass, but re-refer to the Committee on Appropriations",5,0,2,0,7
591451,376397,2014-08-04,Senate,"Placed on Appropriations Suspense file",7,0,0,0,7
591451,377301,2014-08-14,Senate,"Do pass as amended",5,0,2,0,7
591451,378217,2014-08-22,Senate,"Assembly 3rd Reading AB1517 Skinner By De Le",33,0,7,0,40
591451,378484,2014-08-26,Assembly,"AB 1517 SKINNER  Concurrence in Senate Amendments",79,0,0,0,79
591457,352909,2014-04-07,Assembly,"Be referred to Committee on Judiciary",11,0,0,0,11
591457,360477,2014-04-29,Assembly,"Do pass as amended and be re-referred to the Committee on 	Appropriations",9,1,0,0,10
591457,364256,2014-05-14,Assembly,"Do pass",16,0,0,1,17
591457,365406,2014-05-19,Assembly,"AB 1513 FOX  Assembly Third Reading",68,3,0,8,79
591457,374662,2014-06-24,Senate,"Do pass as amended, and re-refer to the Committee on Appropriations",6,1,0,0,7
591457,376425,2014-08-04,Senate,"Do pass as amended",7,0,0,0,7
591457,378771,2014-08-27,Senate,"Assembly 3rd Reading AB1513 Fox By Correa",36,0,4,0,40
591457,378977,2014-08-28,Assembly,"AB 1513 FOX  Concurrence in Senate Amendments",75,1,0,3,79
591462,354590,2014-04-08,Assembly,"Do pass as amended and be re-referred to the Committee on 	Appropriations",4,1,0,2,7
591462,367113,2014-05-23,Assembly,"Do pass as amended",12,5,0,0,17
591462,368018,2014-05-28,Assembly,"AB 1516 GONZALEZ  Assembly Third Reading",55,23,0,1,79
591462,374464,2014-06-24,Senate,"Do pass as amended, and re-refer to the Committee on Appropriations",3,1,1,0,5
591462,376416,2014-08-04,Senate,"Placed on Appropriations Suspense file",7,0,0,0,7
591467,362758,2014-05-06,Assembly,"Do pass as amended",10,0,0,0,10
591467,366902,2014-05-23,Assembly,"AB 1515 GONZALEZ  Assembly Third Reading",73,1,0,5,79
591471,318214,2014-02-10,Senate,"Senate 3rd Reading SCR76 Mitchell",34,0,5,0,39
591475,350336,2014-04-01,Senate,"Do pass as amended, and re-refer to the Committee on Appropriations",9,0,2,0,11
591475,360177,2014-04-28,Senate,"Placed on Appropriations Suspense file",6,0,1,0,7
591475,366721,2014-05-23,Senate,"Do pass as amended",7,0,0,0,7
591475,368119,2014-05-28,Senate,"Senate 3rd Reading SB900 Hill",35,0,5,0,40
591475,374008,2014-06-23,Assembly,"Do pass and be re-referred to the Committee on Appropriations",15,0,0,0,15
591475,376672,2014-08-06,Assembly,"Do pass, to Consent Calendar",17,0,0,0,17
591475,377160,2014-08-14,Assembly,"SB 900 Hill  Consent Calendar Second Day  Regular Session",78,0,0,1,79
591475,377661,2014-08-18,Senate,"Unfinished Business SB900 Hill Concurrence",35,0,5,0,40
593455,359270,2014-04-22,Senate,"Do pass, but re-refer to the Committee on Governance and Finance",1,6,4,0,11
593455,359271,2014-04-22,Senate,"Set, first hearing.  Failed passage in Committee.  Reconsideration 	granted",10,0,1,0,11
593537,361826,2014-04-30,Assembly,"Do pass and be re-referred to the Committee on Appropriations",9,0,0,0,9
593537,367114,2014-05-23,Assembly,"Do pass",16,0,0,1,17
593537,367447,2014-05-27,Assembly,"AB 1521 FOX  Third Reading Urgency",75,0,0,4,79
593537,374461,2014-06-25,Senate,"Do pass, but re-refer to the Committee on Appropriations",7,0,0,0,7
593537,376575,2014-08-04,Senate,"Placed on Appropriations Suspense file",7,0,0,0,7
593537,377158,2014-08-14,Senate,"Do pass",5,0,2,0,7
593537,377961,2014-08-20,Senate,"Assembly 3rd Reading AB1521 Fox Urgency Clause",35,0,5,0,40
593537,378261,2014-08-22,Assembly,"AB 1521 FOX  Concurrence in Senate Amendments",75,0,0,4,79
593622,359277,2014-04-22,Senate,"Do pass, but re-refer to the Committee on Judiciary",1,7,3,0,11
593622,359278,2014-04-22,Senate,"Set, first hearing.  Failed passage in Committee.  Reconsideration 	granted",10,0,1,0,11
593706,359255,2014-04-22,Senate,"Do pass, but re-refer to the Committee on Judiciary",1,7,3,0,11
593706,359256,2014-04-22,Senate,"Set, first hearing.  Failed passage in Committee.  Reconsideration 	granted",10,0,1,0,11
593789,358466,2014-04-22,Assembly,"Do pass as amended",10,0,0,0,10
593789,361695,2014-05-01,Assembly,"AB 1520 GATTO  Assembly Third Reading",72,0,0,7,79
593789,371172,2014-06-10,Senate,"Do pass as amended",5,2,0,0,7
593789,378005,2014-08-20,Senate,"Assembly 3rd Reading AB1520 Gatto By Lieu",24,7,9,0,40
593789,378267,2014-08-22,Assembly,"AB 1520 GATTO  Concurrence in Senate Amendments",73,0,0,6,79
593873,359358,2014-04-22,Senate,"Do pass, but re-refer to the Committee on Appropriations",1,7,3,0,11
593873,359359,2014-04-22,Senate,"Set, first hearing.  Failed passage in Committee.  Reconsideration 	granted",10,0,1,0,11
593959,354495,2014-04-08,Assembly,"Do pass and be re-referred to the Committee on Education",9,0,0,1,10
593959,363266,2014-05-07,Assembly,"Do pass and re-refer to Committee on Appropriations with 	recommendation:  To Consent Calendar",7,0,0,0,7
593959,367070,2014-05-23,Assembly,"Do pass as amended",17,0,0,0,17
593959,368782,2014-05-29,Assembly,"AB 1518 EGGMAN  Assembly Third Reading",79,0,0,0,79
593959,372865,2014-06-18,Senate,"Do pass, but re-refer to the Committee on Veterans Affairs 	Recommend Consent",7,0,0,0,7
593959,373996,2014-06-24,Senate,"Do pass and be placed on the Consent Calendar",6,0,1,0,7
593959,376658,2014-08-04,Senate,"Placed on Appropriations Suspense file",7,0,0,0,7
593959,377299,2014-08-14,Senate,"Do pass",5,0,2,0,7
593959,378102,2014-08-21,Senate,"Assembly 3rd Reading AB1518 Eggman By Galgiani",36,0,4,0,40
594043,313853,2014-01-30,Senate,"Senate 3rd Reading SJR18 Beall",29,3,7,0,39
594043,350957,2014-04-02,Assembly,"From committee:  Be adopted.  To third reading",9,2,0,2,13
594043,352659,2014-04-07,Assembly,"SJR 18 Beall  Senate Third Reading  By SKINNER",52,14,0,13,79
594043,355105,2014-04-10,Senate,"Unfinished Business SJR18 Beall Concurrence",27,5,8,0,40
594126,346521,2014-03-19,Assembly,"Do pass and be re-referred to the Committee on Judiciary",5,1,0,1,7
594126,347608,2014-03-25,Assembly,"Do pass as amended and be re-referred to the Committee on 	Appropriations",6,3,0,1,10
594126,366896,2014-05-23,Assembly,"Do pass as amended",12,5,0,0,17
594126,368630,2014-05-29,Assembly,"AB 1522 GONZALEZ  Assembly Third Reading",52,23,0,4,79
594126,370817,2014-06-11,Senate,"Do pass, but re-refer to the Committee on Judiciary",3,1,1,0,5
594126,374466,2014-06-24,Senate,"Do pass, but re-refer to the Committee on Appropriations",5,2,0,0,7
594126,376558,2014-08-04,Senate,"Placed on Appropriations Suspense file",7,0,0,0,7
594126,377203,2014-08-14,Senate,"Do pass as amended",5,0,2,0,7
594126,379035,2014-08-29,Senate,"Assembly 3rd Reading AB1522 Gonzalez By Lara",22,8,10,0,40
594126,379130,2014-08-30,Assembly,"AB 1522 GONZALEZ  Concurrence in Senate Amendments",52,25,0,2,79
594211,353852,2014-04-07,Assembly,"Do pass and be re-referred to the Committee on Appropriations",4,1,0,4,9
594211,353853,2014-04-07,Assembly,"Set first hearing.  Failed passage.  Reconsideration granted",9,0,0,0,9
597738,360935,2014-04-28,Assembly,"Do pass as amended and be re-referred to the Committee on 	Appropriations",11,0,0,1,12
597738,367102,2014-05-23,Assembly,"Do pass",16,0,0,1,17
597738,367449,2014-05-27,Assembly,"AB 1529 PEREZ, J.  Assembly Third Reading",76,0,0,3,79
597738,374292,2014-06-25,Senate,"Do pass and be placed on the Consent Calendar",6,0,1,0,7
597738,376451,2014-08-04,Senate,"Placed on Appropriations Suspense file",7,0,0,0,7
597738,377506,2014-08-14,Senate,"Do pass",5,0,2,0,7
597738,377866,2014-08-19,Senate,"Assembly 3rd Reading AB1529 John A. P",33,0,7,0,40
597738,377992,2014-08-20,Assembly,"AB 1529 PEREZ, J.  Concurrence in Senate Amendments",76,1,0,2,79
597814,340768,2014-03-11,Assembly,"Do pass and re-refer to Committee on Appropriations with 	recommendation:  To Consent Calendar",7,0,0,0,7
597814,367089,2014-05-23,Assembly,"Do pass",16,0,0,1,17
597814,367613,2014-05-27,Assembly,"AB 1526 HOLDEN  Assembly Third Reading",76,0,0,3,79
597814,372235,2014-06-17,Senate,"Do pass, but re-refer to the Committee on Appropriations",5,0,2,0,7
597814,375457,2014-06-30,Senate,"Placed on Appropriations Suspense file",6,0,1,0,7
597814,377270,2014-08-14,Senate,"Do pass",5,0,2,0,7
597853,359143,2014-04-23,Assembly,"Do pass as amended and re-refer to Committee on Appropriations 	with recommendation:  To Consent Calendar",7,0,0,0,7
597853,366893,2014-05-23,Assembly,"Do pass",17,0,0,0,17
597853,367578,2014-05-27,Assembly,"AB 1530 CHAU  Assembly Third Reading",77,0,0,2,79
597853,374345,2014-06-25,Senate,"Do pass as amended, and re-refer to the Committee on Appropriations",6,0,1,0,7
597853,376488,2014-08-04,Senate,"Placed on Appropriations Suspense file",7,0,0,0,7
597892,352874,2014-04-07,Assembly,"Be referred to Committee on Local Government",11,0,0,0,11
597892,359463,2014-04-23,Assembly,"Do pass and be re-referred to the Committee on Environmental Safety 	and Toxic Materials",6,2,0,1,9
597892,361082,2014-04-29,Assembly,"Do pass and be re-referred to the Committee on Appropriations",5,2,0,0,7
597892,367059,2014-05-23,Assembly,"Do pass",12,5,0,0,17
597892,367973,2014-05-28,Assembly,"AB 1527 PEREA  Assembly Third Reading",54,24,0,1,79
597892,374502,2014-06-25,Senate,"Do pass as amended, and re-refer to the Committee on Natural 	Resources and Water",6,0,1,0,7
597892,378424,2014-08-25,Senate,"Assembly 3rd Reading AB1527 Perea By Cannella",31,0,9,0,40
597892,378442,2014-08-26,Assembly,"AB 1527 PEREA  Concurrence in Senate Amendments",79,0,0,0,79
597930,346551,2014-03-20,Assembly,"From committee:  Be adopted.  To third reading",9,0,0,2,11
597930,370093,2014-06-05,Senate,"Special Consent #16 ACR84 Rodriguez",33,0,7,0,40
597970,347629,2014-03-25,Assembly,"Do pass",10,0,0,0,10
597970,348883,2014-03-28,Assembly,"AB 1525 LOWENTHAL  Assembly Third Reading",64,0,0,16,80
597970,370860,2014-06-10,Senate,"Do pass as amended",6,1,0,0,7
597970,377600,2014-08-18,Senate,"Assembly 3rd Reading AB1525 Lowenthal By Lara",28,8,4,0,40
597970,377816,2014-08-19,Assembly,"AB 1525 LOWENTHAL  Concurrence in Senate Amendments",74,1,0,4,79
598048,347801,2014-03-25,Senate,"Do pass",7,0,0,0,7
598048,351817,2014-04-03,Senate,"Senate 3rd Reading SB905 Knight",35,0,5,0,40
598048,370698,2014-06-10,Assembly,"Do pass, to Consent Calendar",7,0,0,0,7
598048,371699,2014-06-16,Assembly,"SB 905 Knight  Consent Calendar Second Day  Regular Session",77,0,0,2,79
598087,354507,2014-04-08,Assembly,"Do pass and be re-referred to the Committee on Appropriations",6,0,0,1,7
598087,363041,2014-05-07,Assembly,"Do pass",16,0,0,1,17
598087,364969,2014-05-15,Assembly,"AB 1523 ATKINS  Assembly Third Reading",77,0,0,2,79
598087,370462,2014-06-10,Senate,"Do pass as amended, but re-refer to the Committee on Appropriations 	Recommend Consent",4,0,1,0,5
598087,374858,2014-06-26,Senate,"Consent Calendar 2nd AB1523 Atkins",32,0,8,0,40
598087,376348,2014-08-04,Assembly,"AB 1523 ATKINS  Concurrence in Senate Amendments",72,2,0,5,79
600552,340958,2014-03-11,Assembly,"Do pass and be re-referred to the Committee on Transportation",7,0,0,0,7
600552,347341,2014-03-24,Assembly,"Do pass and be re-referred to the Committee on Appropriations",13,1,0,2,16
600552,366885,2014-05-23,Assembly,"Do pass as amended",15,1,0,1,17
600552,368015,2014-05-28,Assembly,"AB 1532 GATTO  Assembly Third Reading",74,4,0,1,79
600552,373991,2014-06-24,Senate,"Do pass as amended, and re-refer to the Committee on 	Appropriations",11,0,0,0,11
600552,376490,2014-08-04,Senate,"Placed on Appropriations Suspense file",7,0,0,0,7
600552,377325,2014-08-14,Senate,"Do pass",5,0,2,0,7
600552,377877,2014-08-20,Senate,"Assembly 3rd Reading AB1532 Gatto By Leno",35,0,5,0,40
600552,378224,2014-08-22,Assembly,"AB 1532 GATTO  Concurrence in Senate Amendments",72,2,0,5,79
600566,355137,2014-04-09,Assembly,"Do pass and be re-referred to the Committee on Appropriations",4,3,0,0,7
600593,361711,2014-04-30,Senate,"Do pass, but re-refer to the Committee on Appropriations Recommend 	Consent",7,0,2,0,9
600593,363760,2014-05-12,Senate,"Do pass",5,0,2,0,7
600593,364837,2014-05-15,Senate,"Special Consent #14 SB906 Correa",36,0,4,0,40
600593,370453,2014-06-10,Assembly,"Do pass and be re-referred to the Committee on Appropriations",18,0,0,1,19
600593,377275,2014-08-14,Assembly,"Do pass as amended",17,0,0,0,17
600593,377925,2014-08-20,Assembly,"SB 906 Correa  Senate Third Reading  By PAN",77,0,0,2,79
600593,378084,2014-08-21,Senate,"Unfinished Business SB906 Correa Concurrence",31,0,9,0,40
600620,353320,2014-04-08,Assembly,"Do pass and re-refer to Committee on Appropriations with 	recommendation:  To Consent Calendar",14,0,0,0,14
600620,361272,2014-04-30,Assembly,"Do pass, to Consent Calendar",17,0,0,0,17
600620,363394,2014-05-08,Assembly,"AB 1535 BLOOM  Consent Calendar Second Day",73,0,0,6,79
600620,371916,2014-06-16,Senate,"Do pass, but re-refer to the Committee on Appropriations Recommend 	Consent",9,0,0,0,9
600620,375306,2014-06-30,Senate,"Do pass",6,0,1,0,7
600620,376744,2014-08-07,Senate,"Assembly 3rd Reading AB1535 Bloom By Pavley",35,0,5,0,40
600620,377366,2014-08-14,Assembly,"AB 1535 BLOOM  Concurrence in Senate Amendments",79,0,0,0,79
600632,335328,2014-03-04,Assembly,"Do pass and be re-referred to the Committee on Human Services",5,0,0,2,7
600632,361399,2014-04-29,Assembly,"Do pass and re-refer to Committee on Appropriations with 	recommendation:  To Consent Calendar",7,0,0,0,7
602134,312226,2014-01-27,Assembly,"From committee:  Be adopted.  To third reading",11,0,0,0,11
602146,350206,2014-04-01,Assembly,"Do pass and be re-referred to the Committee on Appropriations",13,0,0,0,13
602158,316944,2014-02-06,Assembly,"From committee:  Be adopted.  To third reading",8,0,0,3,11
602158,336460,2014-03-06,Senate,"Special Consent #11 ACR85 Muratsuchi",32,0,7,0,39
602171,361165,2014-04-30,Assembly,"Do pass and be re-referred to the Committee on Local Government",7,0,0,0,7
602171,361641,2014-04-30,Assembly,"Do pass and be re-referred to the Committee on Appropriations",8,0,0,1,9
602171,364378,2014-05-14,Assembly,"Do pass",17,0,0,0,17
602171,365290,2014-05-19,Assembly,"AB 1537 LEVINE  Assembly Third Reading",62,4,0,13,79
602171,374061,2014-06-24,Senate,"Do pass, but re-refer to the Committee on Appropriations",8,1,2,0,11
602171,378042,2014-08-21,Senate,"Assembly 3rd Reading AB1537 Levine By Evans",29,1,10,0,40
602171,378215,2014-08-22,Assembly,"AB 1537 LEVINE  Concurrence in Senate Amendments",69,0,0,10,79
602185,355053,2014-04-09,Assembly,"Do pass as amended and be re-referred to the Committee on 	Appropriations",7,0,0,0,7
602185,367009,2014-05-23,Assembly,"Do pass as amended",17,0,0,0,17
602185,368687,2014-05-29,Assembly,"AB 1539 HAGMAN  Assembly Third Reading",78,0,0,1,79
602185,374397,2014-06-25,Senate,"Do pass as amended, and re-refer to the Committee on Appropriations",6,0,1,0,7
602185,376467,2014-08-04,Senate,"Placed on Appropriations Suspense file",7,0,0,0,7
602185,377328,2014-08-14,Senate,"Do pass as amended",5,0,2,0,7
602185,378028,2014-08-21,Senate,"Assembly 3rd Reading AB1539 Hagman By Huff",30,0,10,0,40
602185,378260,2014-08-22,Assembly,"AB 1539 HAGMAN  Concurrence in Senate Amendments",76,0,0,3,79
602195,350427,2014-04-01,Senate,"Do pass as amended",7,0,0,0,7
602195,355029,2014-04-10,Senate,"Senate 3rd Reading SB907 Monning",34,0,6,0,40
602208,311136,2014-01-23,Senate,"W/O REF. TO FILE SR24 Steinberg",33,0,6,0,39
604345,346733,2014-03-19,Assembly,"Do pass and be re-referred to the Committee on Appropriations",6,0,0,1,7
604345,361257,2014-04-30,Assembly,"Do pass",17,0,0,0,17
604345,362315,2014-05-05,Assembly,"AB 1543 HOLDEN  Assembly Third Reading",75,0,0,4,79
604345,370906,2014-06-11,Senate,"Do pass, but re-refer to the Committee on Appropriations",5,0,0,0,5
604350,350228,2014-04-01,Senate,"Do pass, but re-refer to the Committee on Appropriations",11,0,0,0,11
604350,362248,2014-05-05,Senate,"Placed on Appropriations Suspense file",7,0,0,0,7
604350,366754,2014-05-23,Senate,"Do pass",7,0,0,0,7
604350,367456,2014-05-27,Senate,"Senate 3rd Reading SB913 DeSaulnier",34,0,6,0,40
604350,373790,2014-06-23,Assembly,"Do pass and be re-referred to the Committee on Appropriations",7,3,0,6,16
604359,344928,2014-03-18,Assembly,"Do pass and be re-referred to the Committee on Education",12,0,0,1,13
604359,355193,2014-04-09,Assembly,"Do pass as amended and be re-referred to the Committee on 	Appropriations",7,0,0,0,7
604364,340809,2014-03-11,Assembly,"Do pass and re-refer to Committee on Appropriations with 	recommendation:  To Consent Calendar",7,0,0,0,7
604364,354672,2014-04-09,Assembly,"Do pass, to Consent Calendar",17,0,0,0,17
604364,359526,2014-04-24,Assembly,"AB 1547 GOMEZ  Consent Calendar Second Day  Regular Session",75,0,0,4,79
604364,370467,2014-06-10,Senate,"Do pass, but re-refer to the Committee on Appropriations",6,0,1,0,7
604364,373706,2014-06-23,Senate,"Do pass",7,0,0,0,7
604364,375638,2014-07-03,Senate,"Special Consent #18 AB1547 Gomez",35,0,5,0,40
604378,353825,2014-04-08,Senate,"Do pass as amended, and re-refer to the Committee on 	Appropriations",8,1,1,0,10
604378,360072,2014-04-28,Senate,"Do pass",6,0,1,0,7
604378,363442,2014-05-08,Senate,"Senate 3rd Reading SB912 Mitchell",28,6,6,0,40
604378,374026,2014-06-24,Assembly,"Do pass and be re-referred to the Committee on Appropriations",11,1,0,2,14
604378,376729,2014-08-06,Assembly,"Do pass",12,5,0,0,17
604378,377638,2014-08-18,Assembly,"SB 912 Mitchell  Senate Third Reading  By WEBER",59,13,0,7,79
604383,353364,2014-04-08,Senate,"Do pass, but re-refer to the Committee on Appropriations",3,2,0,0,5
604383,360118,2014-04-28,Senate,"Placed on Appropriations Suspense file",6,0,1,0,7
604383,366958,2014-05-23,Senate,"Do pass as amended",5,2,0,0,7
604383,368156,2014-05-28,Senate,"Senate 3rd Reading SB911 Block",25,11,4,0,40
604383,372383,2014-06-17,Assembly,"Do pass as amended and be re-referred to the Committee on Aging and 	Long",6,1,0,0,7
604383,374369,2014-06-24,Assembly,"Do pass and be re-referred to the Committee on Appropriations",5,0,0,2,7
604383,377406,2014-08-14,Assembly,"Do pass as amended",12,0,0,5,17
604383,378735,2014-08-27,Assembly,"SB 911 Block  Senate Third Reading  By CHESBRO",68,6,0,5,79
604383,378929,2014-08-28,Senate,"Unfinished Business SB911 Block Concurrence",34,0,6,0,40
604393,353267,2014-04-08,Senate,"Do pass as amended, and re-refer to the Committee on Judiciary",5,0,0,0,5
604393,363036,2014-05-06,Senate,"Do pass as amended, and re-refer to the Committee on 	Appropriations",7,0,0,0,7
604393,365324,2014-05-19,Senate,"Placed on Appropriations Suspense file",7,0,0,0,7
604403,350350,2014-04-01,Senate,"Do pass, but re-refer to the Committee on Appropriations",6,0,1,0,7
604403,361626,2014-05-01,Senate,"Senate 3rd Reading SB910 Pavley",36,0,4,0,40
604403,370749,2014-06-10,Assembly,"Do pass and be re-referred to the Committee on Appropriations",7,0,0,0,7
604403,372737,2014-06-18,Assembly,"Do pass, to Consent Calendar",15,0,0,2,17
604403,377889,2014-08-20,Assembly,"SB 910 Pavley  Senate Third Reading  By WALDRON",78,0,0,1,79
604403,378127,2014-08-21,Senate,"Unfinished Business SB910 Pavley Concurrence",31,0,9,0,40
604406,358447,2014-04-22,Assembly,"Do pass and be re-referred to the Committee on Appropriations",2,4,0,1,7
606204,313931,2014-01-30,Assembly,"From committee:  Be adopted.  To third reading",11,0,0,0,11
606204,336512,2014-03-06,Senate,"Special Consent #11 ACR86 Buchanan",32,0,7,0,39
606209,354643,2014-04-08,Assembly,"Do pass as amended and be re-referred to the Committee on Aging and 	Long",6,0,0,1,7
606209,360587,2014-04-29,Assembly,"Do pass and be re-referred to the Committee on Appropriations",7,0,0,0,7
606209,366961,2014-05-23,Assembly,"Do pass as amended",16,0,0,1,17
606209,368060,2014-05-28,Assembly,"AB 1554 SKINNER  Assembly Third Reading",78,0,0,1,79
606209,374438,2014-06-24,Senate,"Do pass as amended, but re-refer to the Committee on Appropriations 	Recommend Consent",4,0,1,0,5
606209,376485,2014-08-04,Senate,"Placed on Appropriations Suspense file",7,0,0,0,7
606213,351459,2014-04-02,Assembly,"Do pass and be re-referred to the Committee on Appropriations",5,1,0,1,7
606213,366857,2014-05-23,Assembly,"Do pass as amended",12,5,0,0,17
606213,368052,2014-05-28,Assembly,"AB 1550 RENDON  Assembly Third Reading",53,24,0,2,79
606213,373787,2014-06-23,Senate,"Do pass as amended, and re-refer to the Committee on 	Appropriations",3,2,0,0,5
606213,376573,2014-08-04,Senate,"Placed on Appropriations Suspense file",7,0,0,0,7
606213,377562,2014-08-14,Senate,"Do pass as amended",5,0,2,0,7
606213,378104,2014-08-21,Senate,"Assembly 3rd Reading AB1550 Rendon By Torres",24,11,5,0,40
606213,378406,2014-08-25,Assembly,"AB 1550 RENDON  Concurrence in Senate Amendments",54,24,0,1,79
606223,354600,2014-04-08,Assembly,"Amend, and do pass as amended and be re-referred to the Committee 	on Aging and Long",18,0,0,1,19
606223,358452,2014-04-22,Assembly,"Do pass and be re-referred to the Committee on Appropriations",6,0,0,1,7
606223,367198,2014-05-23,Assembly,"Do pass as amended",16,0,0,1,17
606223,368034,2014-05-28,Assembly,"AB 1552 LOWENTHAL  Third Reading Urgency",77,0,0,2,79
606223,373305,2014-06-18,Senate,"Do pass, but re-refer to the Committee on Appropriations",8,0,1,0,9
606223,376487,2014-08-04,Senate,"Placed on Appropriations Suspense file",7,0,0,0,7
606223,377210,2014-08-14,Senate,"Do pass",5,0,2,0,7
606223,378091,2014-08-21,Senate,"Assembly 3rd Reading AB1552 Lowenthal Urgency Clause",36,0,4,0,40
606223,378230,2014-08-22,Assembly,"AB 1552 LOWENTHAL  Concurrence in Senate Amendments",74,0,0,5,79
606229,361312,2014-04-29,Senate,"Do pass as amended, and re-refer to the Committee on 	Appropriations",11,0,0,0,11
606229,365377,2014-05-19,Senate,"Placed on Appropriations Suspense file",7,0,0,0,7
606234,353251,2014-04-08,Assembly,"Do pass and be re-referred to the Committee on Appropriations",2,2,0,3,7
606243,359522,2014-04-24,Senate,"Do pass and be placed on the Consent Calendar",8,0,1,0,9
606243,361675,2014-05-01,Senate,"Consent Calendar 2nd SB915 Hill",35,0,5,0,40
606243,370996,2014-06-11,Assembly,"Do pass as amended, to Consent Calendar",6,0,0,1,7
606243,376817,2014-08-07,Assembly,"SB 915 Hill  Senate Third Reading  By MULLIN",78,0,0,1,79
606243,376896,2014-08-11,Senate,"Unfinished Business SB915 Hill Concurrence",36,0,4,0,40
606249,345391,2014-03-18,Assembly,"Do pass and be re-referred to the Committee on Appropriations",12,0,0,1,13
606249,354650,2014-04-09,Assembly,"Do pass, to Consent Calendar",17,0,0,0,17
606249,359809,2014-04-24,Assembly,"AB 1549 RENDON  Consent Calendar Second Day  Regular Session",75,0,0,4,79
606249,374476,2014-06-25,Senate,"Do pass, but re-refer to the Committee on Appropriations Recommend 	Consent",6,0,1,0,7
606254,362729,2014-05-06,Assembly,"Do pass as amended",9,2,0,2,13
606254,366232,2014-05-21,Assembly,"Do pass",12,4,0,1,17
606254,367128,2014-05-23,Assembly,"AB 1548 MULLIN  Assembly Third Reading",57,12,0,10,79
606254,374501,2014-06-25,Senate,"Do pass as amended, and re-refer to the Committee on Appropriations",4,2,1,0,7
606254,376626,2014-08-04,Senate,"Placed on Appropriations Suspense file",7,0,0,0,7
606259,350925,2014-04-02,Assembly,"Do pass and be re-referred to the Committee on Appropriations",8,2,0,3,13
606259,354592,2014-04-09,Assembly,"Do pass",12,4,0,1,17
606259,358319,2014-04-21,Assembly,"AB 1556 PEREA  Assembly Third Reading",54,21,0,4,79
606259,371041,2014-06-11,Senate,"Do pass, but re-refer to the Committee on Appropriations",4,1,0,0,5
606259,377869,2014-08-19,Senate,"Assembly 3rd Reading AB1556 Perea By Hueso",22,10,8,0,40
606259,378010,2014-08-21,Assembly,"AB 1556 PEREA  Concurrence in Senate Amendments",54,22,0,3,79
606269,360637,2014-04-29,Senate,"Do pass, but re-refer to the Committee on Appropriations",2,4,1,0,7
606277,344790,2014-03-18,Assembly,"Do pass as amended and be re-referred to the Committee on 	Appropriations",11,0,0,2,13
606277,354647,2014-04-09,Assembly,"Do pass",13,0,0,4,17
606277,359556,2014-04-24,Assembly,"AB 1557 HOLDEN  Assembly Third Reading",72,1,0,6,79
606277,372706,2014-06-18,Senate,"Do pass as amended, and re-refer to the Committee on Appropriations",5,0,2,0,7
606277,376773,2014-08-07,Senate,"Assembly 3rd Reading AB1557 Holden By Liu",33,0,7,0,40
606277,377733,2014-08-18,Assembly,"AB 1557 HOLDEN  Concurrence in Senate Amendments",75,0,0,4,79
607262,350331,2014-04-01,Assembly,"Do pass and be re-referred to the Committee on Appropriations",19,0,0,0,19
607262,367210,2014-05-23,Assembly,"Do pass as amended",17,0,0,0,17
607262,368163,2014-05-28,Assembly,"AB 1559 PAN  Assembly Third Reading",79,0,0,0,79
607262,373421,2014-06-18,Senate,"Do pass, but re-refer to the Committee on Appropriations",8,0,1,0,9
607262,375262,2014-06-30,Senate,"Placed on Appropriations Suspense file",6,0,1,0,7
607262,377447,2014-08-14,Senate,"Do pass as amended",5,0,2,0,7
607262,378313,2014-08-25,Senate,"Assembly 3rd Reading AB1559 Pan By Nielsen",34,0,6,0,40
607262,378575,2014-08-26,Assembly,"AB 1559 PAN  Concurrence in Senate Amendments",79,0,0,0,79
607263,360860,2014-04-29,Assembly,"Do pass and be re-referred to the Committee on Appropriations",19,0,0,0,19
607263,367185,2014-05-23,Assembly,"Do pass",16,0,0,1,17
607263,367481,2014-05-27,Assembly,"AB 1558 HERNANDEZ  Assembly Third Reading",72,0,0,7,79
607263,375047,2014-06-25,Senate,"Do pass, but re-refer to the Committee on Appropriations",6,1,2,0,9
607263,376557,2014-08-04,Senate,"Placed on Appropriations Suspense file",7,0,0,0,7
607267,316946,2014-02-06,Assembly,"From committee:  Be adopted.  To third reading",8,0,0,3,11
607271,350183,2014-04-01,Senate,"Be adopted, but re-refer to the Committee on Appropriations 	Recommend Consent",11,0,0,0,11
607271,361551,2014-05-01,Senate,"Consent Calendar 2nd SCR77 Cannella",35,0,5,0,40
607271,370311,2014-06-09,Assembly,"Be adopted, and re-refer to Committee on Appropriations with 	recommendation:  To Consent Calendar",16,0,0,0,16
607271,372770,2014-06-18,Assembly,"Be adopted, to Consent Calendar",15,0,0,2,17
607271,373786,2014-06-23,Assembly,"SCR 77 Cannella  Consent Calendar Second Day  Regular Session",75,0,0,4,79
608331,314728,2014-02-03,Assembly,"From committee:  Be adopted.  To third reading",10,0,0,1,11
608331,338598,2014-03-10,Senate,"Assembly 3rd Reading ACR87 Wilk By Gaines",35,0,4,0,39
608332,347095,2014-03-24,Assembly,"Do pass and be re-referred to the Committee on Agriculture",15,0,0,1,16
608332,361131,2014-04-30,Assembly,"Do pass and re-refer to Committee on Appropriations with 	recommendation:  To Consent Calendar",7,0,0,0,7
608332,364262,2014-05-14,Assembly,"Do pass, to Consent Calendar",17,0,0,0,17
608332,367025,2014-05-23,Assembly,"AB 1566 HOLDEN  Consent Calendar Second Day",73,0,0,6,79
608332,372327,2014-06-17,Senate,"Do pass, but re-refer to the Committee on Transportation and 	Housing",5,0,0,0,5
608332,374131,2014-06-24,Senate,"Do pass as amended, and re-refer to the Committee on 	Appropriations",11,0,0,0,11
608332,376590,2014-08-04,Senate,"Do pass",7,0,0,0,7
608332,376966,2014-08-11,Senate,"Assembly 3rd Reading AB1566 Holden By Cannella",35,0,5,0,40
608332,377707,2014-08-18,Assembly,"AB 1566 HOLDEN  Concurrence in Senate Amendments",75,1,0,3,79
608333,346418,2014-03-19,Assembly,"Do pass and be re-referred to the Committee on Appropriations",5,1,0,1,7
608333,366960,2014-05-23,Assembly,"Do pass",12,5,0,0,17
608333,368170,2014-05-28,Assembly,"AB 1562 GOMEZ  Assembly Third Reading",53,24,0,2,79
608333,370877,2014-06-11,Senate,"Do pass, but re-refer to the Committee on Appropriations",4,1,0,0,5
608333,375211,2014-06-30,Senate,"Placed on Appropriations Suspense file",6,0,1,0,7
608334,360630,2014-04-28,Assembly,"Do pass and be re-referred to the Committee on Jobs, Economic 	Development and The Economy",9,0,0,0,9
608334,361202,2014-04-30,Assembly,"Do pass as amended and be re-referred to the Committee on 	Appropriations",8,0,0,1,9
608335,360602,2014-04-29,Senate,"Do pass as amended, and re-refer to the Committee on Appropriations",6,0,1,0,7
608335,365501,2014-05-19,Senate,"Placed on Appropriations Suspense file",7,0,0,0,7
608335,367080,2014-05-23,Senate,"Do pass",7,0,0,0,7
608335,367621,2014-05-27,Senate,"Senate 3rd Reading SB922 Knight",34,0,6,0,40
608335,374110,2014-06-24,Assembly,"Do pass and be re-referred to the Committee on Appropriations",2,4,0,1,7
608337,360455,2014-04-29,Assembly,"Do pass and be re-referred to the Committee on Appropriations",2,5,0,0,7
608338,358619,2014-04-21,Senate,"Do pass, but re-refer to the Committee on Appropriations",9,0,0,0,9
608338,362422,2014-05-05,Senate,"Placed on Appropriations Suspense file",7,0,0,0,7
608338,366983,2014-05-23,Senate,"Do pass",7,0,0,0,7
608338,367553,2014-05-27,Senate,"Senate 3rd Reading SB928 Correa",32,0,8,0,40
608338,374846,2014-06-24,Assembly,"Do pass as amended and be re-referred to the Committee on 	Appropriations",8,0,0,1,9
608338,377478,2014-08-14,Assembly,"Do pass",17,0,0,0,17
608338,377820,2014-08-19,Assembly,"SB 928 Correa  Senate Third Reading  By MEDINA",78,0,0,1,79
608338,377949,2014-08-20,Senate,"Unfinished Business SB928 Correa Concurrence",33,0,7,0,40
608339,376989,2014-08-11,Assembly,"Do pass and be re-referred to the Committee on Appropriations",7,0,0,2,9
608339,377138,2014-08-14,Assembly,"Do pass as amended",17,0,0,0,17
608339,377811,2014-08-19,Assembly,"AB 1560 QUIRK-SILVA  Assembly Third Reading",74,2,0,3,79
608339,379127,2014-08-29,Senate,"Do pass",6,0,1,0,7
608339,379128,2014-08-29,Senate,"Assembly 3rd Supp 3 AB1560 Quirk-Silva Urgency Clause",33,0,7,0,40
608339,379129,2014-08-29,Assembly,"AB 1560 QUIRK-SILVA  Concurrence- Urgency Added",73,2,0,4,79
608340,347080,2014-03-24,Assembly,"Do pass as amended and be re-referred to the Committee on 	Appropriations",8,0,0,1,9
608340,354512,2014-04-09,Assembly,"Do pass, to Consent Calendar",17,0,0,0,17
608340,359616,2014-04-24,Assembly,"AB 1561 RODRIGUEZ  Assembly Third Reading",75,0,0,4,79
608340,371128,2014-06-11,Senate,"Do pass, but re-refer to the Committee on Appropriations",7,0,0,0,7
608340,375669,2014-07-03,Senate,"Special Consent #18 AB1561 Rodriguez",35,0,5,0,40
608342,314782,2014-02-03,Senate,"Senate 3rd Reading SR26 Steinberg",35,1,3,0,39
608343,350954,2014-04-02,Senate,"Do pass as amended, and re-refer to the Committee on Appropriations",8,0,1,0,9
608343,360431,2014-04-28,Senate,"Placed on Appropriations Suspense file",6,0,1,0,7
608343,366859,2014-05-23,Senate,"Do pass as amended",7,0,0,0,7
608343,368056,2014-05-28,Senate,"Senate 3rd Reading SB923 Pavley",37,0,3,0,40
608343,374780,2014-06-25,Assembly,"Do pass and be re-referred to the Committee on Appropriations",6,0,0,1,7
608343,377154,2014-08-14,Assembly,"Do pass as amended",12,0,0,5,17
608343,378807,2014-08-27,Assembly,"SB 923 Pavley  Senate Third Reading  By WEBER",77,0,0,2,79
608343,378970,2014-08-28,Senate,"Unfinished Business SB923 Pavley Concurrence",36,0,4,0,40
608344,358516,2014-04-22,Senate,"Do pass, but re-refer to the Committee on Environmental Quality",3,6,0,0,9
608344,358517,2014-04-22,Senate,"Set, second hearing.  Failed passage in Committee. 	Reconsideration granted",9,0,0,0,9
608345,360493,2014-04-29,Senate,"Do pass, but re-refer to the Committee on Appropriations",6,0,1,0,7
608345,363767,2014-05-12,Senate,"Placed on Appropriations Suspense file",7,0,0,0,7
608345,366717,2014-05-23,Senate,"Do pass",7,0,0,0,7
608345,367488,2014-05-27,Senate,"Senate 3rd Reading SB926 Beall",33,0,7,0,40
608345,374047,2014-06-24,Assembly,"Do pass and be re-referred to the Committee on Appropriations",7,0,0,0,7
608345,374048,2014-06-24,Assembly,"Do pass and be re-referred to the Committee on Appropriations",6,0,0,1,7
608345,377315,2014-08-14,Assembly,"Do pass",17,0,0,0,17
608345,378017,2014-08-21,Assembly,"SB 926 Beall  Senate Third Reading  By HALL",77,0,0,2,79
608348,363243,2014-05-06,Senate,"Do pass as amended, and re-refer to the Committee on 	Appropriations",5,2,0,0,7
608348,365394,2014-05-19,Senate,"Placed on Appropriations Suspense file",7,0,0,0,7
608348,366714,2014-05-23,Senate,"Do pass as amended",5,2,0,0,7
608348,368019,2014-05-28,Senate,"Senate 3rd Reading SB924 Beall",23,11,6,0,40
608348,372127,2014-06-17,Assembly,"Do pass and be re-referred to the Committee on Appropriations",7,1,0,2,10
608348,377306,2014-08-14,Assembly,"Do pass",13,4,0,0,17
608348,378386,2014-08-25,Assembly,"SB 924 Beall  Senate Third Reading  By SKINNER",55,19,0,5,79
608348,378760,2014-08-27,Senate,"Unfinished Business SB924 Beall Concurrence",22,11,7,0,40
608349,361110,2014-04-29,Assembly,"Do pass and be re-referred to the Committee on Appropriations",7,1,0,2,10
608349,364506,2014-05-14,Assembly,"Do pass",12,3,0,2,17
608349,365413,2014-05-19,Assembly,"AB 1565 PEREZ, V.M.  Assembly Third Reading",57,14,0,8,79
608349,373990,2014-06-24,Senate,"Do pass, but re-refer to the Committee on Appropriations",4,2,1,0,7
608349,376985,2014-08-11,Senate,"Placed on Appropriations Suspense file",7,0,0,0,7
608349,377261,2014-08-14,Senate,"Do pass",5,0,2,0,7
608349,377958,2014-08-20,Senate,"Assembly 3rd Reading AB1565 V. Manuel P",26,9,5,0,40
608349,378397,2014-08-25,Assembly,"Senate amendments be concurred in",5,1,0,1,7
608349,378587,2014-08-26,Assembly,"AB 1565 PEREZ, V.M.  Concurrence in Senate Amendments",59,17,0,3,79
609576,361130,2014-04-29,Assembly,"Do pass and be re-referred to the Committee on Appropriations",6,0,0,1,7
609576,366877,2014-05-23,Assembly,"Do pass as amended",13,0,0,4,17
609576,368051,2014-05-28,Assembly,"AB 1571 EGGMAN  Assembly Third Reading",72,1,0,6,79
609576,374443,2014-06-24,Senate,"Do pass as amended, and re-refer to the Committee on Appropriations",4,0,1,0,5
609576,376398,2014-08-04,Senate,"Placed on Appropriations Suspense file",7,0,0,0,7
609578,340987,2014-03-12,Assembly,"Do pass as amended and be re-referred to the Committee on 	Appropriations",10,0,0,2,12
609578,354536,2014-04-09,Assembly,"Do pass",14,1,0,2,17
609578,357969,2014-04-21,Assembly,"AB 1575 PAN  Assembly Third Reading",70,2,0,7,79
609578,374269,2014-06-24,Senate,"Do pass, but re-refer to the Committee on Appropriations",9,1,0,0,10
609578,377736,2014-08-18,Senate,"Assembly 3rd Reading AB1575 Pan By Cannella",30,4,6,0,40
609578,377924,2014-08-20,Assembly,"AB 1575 PAN  Concurrence in Senate Amendments",72,5,0,2,79
609580,350964,2014-04-01,Assembly,"Do pass as amended and be re-referred to the Committee on 	Appropriations",7,0,0,0,7
609580,361474,2014-04-30,Assembly,"Do pass",16,1,0,0,17
609580,362213,2014-05-05,Assembly,"AB 1572 EGGMAN  Assembly Third Reading",72,1,0,6,79
609580,370667,2014-06-10,Senate,"Do pass, but re-refer to the Committee on Appropriations",4,0,1,0,5
609580,375684,2014-07-03,Senate,"Special Consent #18 AB1572 Eggman",35,0,5,0,40
609585,347825,2014-03-25,Assembly,"Do pass as amended and be re-referred to the Committee on 	Appropriations",6,0,0,1,7
609585,366984,2014-05-23,Assembly,"Do pass as amended",13,4,0,0,17
609585,368622,2014-05-29,Assembly,"AB 1579 STONE  Assembly Third Reading",59,15,0,5,79
609585,370448,2014-06-10,Senate,"Do pass, but re-refer to the Committee on Appropriations",3,0,2,0,5
609585,373758,2014-06-23,Senate,"Placed on Appropriations Suspense file",7,0,0,0,7
609585,377343,2014-08-14,Senate,"Do pass as amended",5,0,2,0,7
609585,378068,2014-08-21,Senate,"Assembly 3rd Reading AB1579 Stone By Mitchell",27,3,10,0,40
609585,378362,2014-08-25,Assembly,"AB 1579 STONE  Concurrence in Senate Amendments",62,17,0,0,79
609589,361742,2014-04-30,Assembly,"Do pass and be re-referred to the Committee on Appropriations",7,0,0,0,7
609592,354765,2014-04-08,Assembly,"Do pass as amended and be re-referred to the Committee on 	Appropriations",6,0,0,1,7
609592,366752,2014-05-23,Assembly,"Do pass as amended",17,0,0,0,17
609592,368172,2014-05-28,Assembly,"AB 1570 CHESBRO  Assembly Third Reading",79,0,0,0,79
609592,374698,2014-06-24,Senate,"Do pass as amended, and re-refer to the Committee on Appropriations",4,0,1,0,5
609592,376547,2014-08-04,Senate,"Placed on Appropriations Suspense file",7,0,0,0,7
609592,377508,2014-08-14,Senate,"Do pass as amended",5,0,2,0,7
609592,378590,2014-08-26,Senate,"Assembly 3rd Reading AB1570 Chesbro By Block",33,2,5,0,40
609592,378624,2014-08-27,Assembly,"AB 1570 CHESBRO  Concurrence in Senate Amendments",74,2,0,3,79
609597,316923,2014-02-06,Assembly,"From committee:  Be adopted.  To third reading",8,0,0,3,11
609597,336571,2014-03-06,Senate,"Special Consent #11 ACR88 Linder",32,0,7,0,39
609600,341529,2014-03-12,Assembly,"Do pass",11,0,0,1,12
609600,344062,2014-03-17,Assembly,"AB 1574 PAN  Assembly Third Reading",71,0,0,9,80
609600,364035,2014-05-13,Senate,"Do pass, but re-refer to the Committee on Appropriations",7,1,2,0,10
609600,377610,2014-08-18,Senate,"Assembly 3rd Reading AB1574 Pan",25,11,4,0,40
609600,377936,2014-08-20,Assembly,"AB 1574 PAN  Concurrence in Senate Amendments",68,9,0,2,79
609603,354297,2014-04-08,Assembly,"From committee:  Be adopted.  To third reading",9,0,0,1,10
609603,359732,2014-04-24,Assembly,"AJR 33 HOLDEN  Assembly Third Reading",75,0,0,4,79
609603,366989,2014-05-23,Senate,"Special Consent #15 AJR33 Holden By Liu",32,0,8,0,40
609605,364449,2014-05-13,Assembly,"Do pass as amended and be re-referred to the Committee on 	Appropriations",7,0,0,2,9
609608,348159,2014-03-26,Assembly,"Do pass and be re-referred to the Committee on Appropriations",11,0,0,1,12
609608,367173,2014-05-23,Assembly,"Do pass as amended",17,0,0,0,17
609608,368189,2014-05-28,Assembly,"AB 1568 GROVE  Assembly Third Reading",79,0,0,0,79
609608,374165,2014-06-24,Senate,"Do pass, but re-refer to the Committee on Appropriations",10,0,0,0,10
609608,376870,2014-08-11,Senate,"Placed on Appropriations Suspense file",7,0,0,0,7
609611,361129,2014-04-30,Assembly,"Do pass and be re-referred to the Committee on Appropriations",7,4,0,2,13
609611,367103,2014-05-23,Assembly,"Do pass as amended",12,0,0,5,17
609611,368615,2014-05-29,Assembly,"AB 1578 PAN  Assembly Third Reading",55,23,0,1,79
609611,374178,2014-06-24,Senate,"Do pass, but re-refer to the Committee on Appropriations",6,2,2,0,10
609611,376605,2014-08-04,Senate,"Placed on Appropriations Suspense file",7,0,0,0,7
609611,379080,2014-08-30,Senate,"Assembly 3rd Supp 7 AB1578 Pan Urgency Clause",33,1,6,0,40
609614,354454,2014-04-08,Assembly,"Do pass and be re-referred to the Committee on Appropriations",7,2,0,1,10
609614,367201,2014-05-23,Assembly,"Do pass",12,0,0,5,17
609614,368187,2014-05-28,Assembly,"AB 1580 YAMADA  Assembly Third Reading",53,18,0,8,79
609614,374222,2014-06-24,Senate,"Do pass as amended, but re-refer to the Committee on Appropriations 	Recommend Consent",4,1,2,0,7
609614,376593,2014-08-04,Senate,"Placed on Appropriations Suspense file",7,0,0,0,7
609614,377415,2014-08-14,Senate,"Do pass",5,0,2,0,7
609616,347511,2014-03-25,Assembly,"Do pass and be re-referred to the Committee on Appropriations",17,1,0,1,19
609616,363218,2014-05-07,Assembly,"Do pass",14,3,0,0,17
609616,364991,2014-05-15,Assembly,"AB 1577 ATKINS  Assembly Third Reading",62,5,0,12,79
609616,370848,2014-06-11,Senate,"Do pass, but re-refer to the Committee on Judiciary",7,1,1,0,9
609616,374293,2014-06-24,Senate,"Do pass, but re-refer to the Committee on Appropriations",6,1,0,0,7
609616,378633,2014-08-27,Senate,"Assembly 3rd Reading AB1577 Atkins By Leno",26,6,8,0,40
609616,378862,2014-08-28,Assembly,"AB 1577 ATKINS  Concurrence in Senate Amendments",67,4,0,8,79
609619,351769,2014-04-02,Assembly,"Do pass and be re-referred to the Committee on Arts, Entertain, 	Sports, Tourism, & Internet Media",5,0,0,2,7
609619,360695,2014-04-29,Assembly,"Do pass and be re-referred to the Committee on Appropriations",4,1,0,2,7
609619,366227,2014-05-21,Assembly,"Do pass",9,3,0,5,17
609619,367629,2014-05-27,Assembly,"AB 1576 HALL  Assembly Third Reading",48,13,0,18,79
609619,374454,2014-06-25,Senate,"Do pass, but re-refer to the Committee on Appropriations",3,1,1,0,5
609619,376453,2014-08-04,Senate,"Placed on Appropriations Suspense file",7,0,0,0,7
611537,340762,2014-03-11,Assembly,"Do pass",7,0,0,0,7
611537,346413,2014-03-20,Assembly,"AB 1591 ACHADJIAN  Assembly Third Reading",76,0,0,4,80
611537,364039,2014-05-13,Senate,"Do pass as amended, and re-refer to the Committee on Rules",6,0,1,0,7
611537,374889,2014-06-26,Senate,"Special Consent #17 AB1591 Achadjian By Anderson",32,0,8,0,40
611537,375264,2014-06-30,Assembly,"AB 1591 ACHADJIAN  Concurrence in Senate Amendments",78,0,0,1,79
611541,350984,2014-04-02,Senate,"Do pass as amended, and re-refer to the Committee on Energy, 	Utilities and Communications",7,0,0,0,7
611541,360665,2014-04-29,Senate,"Do pass as amended, and re-refer to the Committee on Appropriations",10,0,1,0,11
611541,366762,2014-05-23,Senate,"Senate 3rd Reading SB936 Monning",32,0,8,0,40
611541,374130,2014-06-23,Assembly,"Do pass as amended and be re-referred to the Committee on 	Appropriations",14,0,0,1,15
611541,377098,2014-08-13,Assembly,"Do pass as amended",17,0,0,0,17
611541,377786,2014-08-19,Assembly,"SB 936 Monning  Senate Third Reading  By STONE",78,0,0,1,79
611541,377916,2014-08-20,Senate,"Unfinished Business SB936 Monning Concurrence",33,0,7,0,40
611547,347945,2014-03-25,Senate,"Do pass as amended, and re-refer to the Committee on Appropriations",7,0,0,0,7
611547,360303,2014-04-28,Senate,"Placed on Appropriations Suspense file",6,0,1,0,7
611547,366912,2014-05-23,Senate,"Do pass",7,0,0,0,7
611547,368021,2014-05-28,Senate,"Senate 3rd Reading SB930 Berryhill Urgency Clause",35,0,5,0,40
611547,372256,2014-06-17,Assembly,"Do pass and re-refer to Committee on Appropriations with 	recommendation:  To Consent Calendar",7,0,0,0,7
611547,377577,2014-08-14,Assembly,"Do pass",17,0,0,0,17
611547,377859,2014-08-19,Assembly,"SB 930 Berryhill, T.  Third Reading Urgency  By BIGELOW",77,0,0,2,79
611553,361268,2014-04-29,Assembly,"Do pass and re-refer to Committee on Appropriations with 	recommendation:  To Consent Calendar",7,0,0,0,7
611553,364654,2014-05-14,Assembly,"Do pass, to Consent Calendar",17,0,0,0,17
611553,366811,2014-05-23,Assembly,"AB 1595 CHESBRO  Consent Calendar Second Day  Regular Session",73,0,0,6,79
611553,374377,2014-06-24,Senate,"Do pass, but re-refer to the Committee on Appropriations",4,0,1,0,5
611553,378596,2014-08-26,Senate,"Assembly 3rd Reading AB1595 Chesbro By Beall",35,0,5,0,40
611553,378632,2014-08-27,Assembly,"AB 1595 CHESBRO  Concurrence in Senate Amendments",78,0,0,1,79
611555,345003,2014-03-18,Assembly,"Do pass as amended and be re-referred to the Committee on 	Appropriations",12,0,0,1,13
611555,354522,2014-04-09,Assembly,"Do pass, to Consent Calendar",17,0,0,0,17
611555,359820,2014-04-24,Assembly,"AB 1590 WIECKOWSKI  Consent Calendar Second Day  Regular Session",75,0,0,4,79
611555,369873,2014-06-04,Senate,"Do pass, but re-refer to the Committee on Appropriations Recommend 	Consent",6,0,1,0,7
611555,377606,2014-08-18,Senate,"Assembly 3rd Reading AB1590 Wieckowski By Block",36,0,4,0,40
611555,377948,2014-08-20,Assembly,"AB 1590 WIECKOWSKI  Concurrence in Senate Amendments",78,0,0,1,79
611557,352083,2014-04-03,Assembly,"From committee:  Be adopted.  To third reading",9,0,0,2,11
611557,374781,2014-06-26,Senate,"Special Consent #17 ACR89 Salas",32,0,8,0,40
611561,360597,2014-04-28,Assembly,"Do pass as amended and be re-referred to the Committee on 	Appropriations",5,3,0,1,9
611561,366944,2014-05-23,Assembly,"Do pass as amended",12,5,0,0,17
611561,368607,2014-05-29,Assembly,"AB 1594 WILLIAMS  Assembly Third Reading",57,21,0,1,79
611561,374437,2014-06-25,Senate,"Do pass as amended, and re-refer to the Committee on 	Appropriations",5,1,1,0,7
611561,376426,2014-08-04,Senate,"Placed on Appropriations Suspense file",7,0,0,0,7
611561,377134,2014-08-14,Senate,"Do pass",5,0,2,0,7
611561,378634,2014-08-27,Senate,"Assembly 3rd Reading AB1594 Williams By Hill",23,12,5,0,40
611561,378864,2014-08-28,Assembly,"AB 1594 WILLIAMS  Concurrence in Senate Amendments",58,21,0,0,79
611563,371837,2014-06-16,Senate,"Senate 3rd Reading SCR78 Corbett",36,0,4,0,40
611563,376366,2014-08-04,Assembly,"Be adopted, to Consent Calendar",9,0,0,2,11
611563,376759,2014-08-07,Assembly,"SCR 78 Corbett  Consent Calendar Second Day  Regular Session",77,0,0,2,79
611565,354317,2014-04-09,Assembly,"Do pass and be re-referred to the Committee on Appropriations",9,0,0,0,9
611565,361128,2014-04-30,Assembly,"Do pass",16,1,0,0,17
611565,364876,2014-05-15,Assembly,"AB 1582 MULLIN  Assembly Third Reading",74,2,0,3,79
611565,370929,2014-06-11,Senate,"Do pass as amended",6,1,0,0,7
611569,360579,2014-04-29,Senate,"Do pass, but re-refer to the Committee on Appropriations",6,0,1,0,7
611569,365403,2014-05-19,Senate,"Placed on Appropriations Suspense file",7,0,0,0,7
611571,354315,2014-04-09,Assembly,"Do pass and be re-referred to the Committee on Appropriations",13,0,0,0,13
611571,366743,2014-05-23,Assembly,"Do pass as amended",17,0,0,0,17
611571,368606,2014-05-29,Assembly,"AB 1583 ALLEN  Assembly Third Reading",75,2,0,2,79
611571,370475,2014-06-10,Senate,"Do pass, but re-refer to the Committee on Appropriations Recommend 	Consent",8,0,2,0,10
611571,375677,2014-07-03,Senate,"Consent Calendar 2nd AB1583 Allen",35,0,5,0,40
611571,376765,2014-08-07,Assembly,"AB 1583 ALLEN  Concurrence in Senate Amendments",77,0,0,2,79
611579,361494,2014-04-30,Assembly,"Do pass as amended and be re-referred to the Committee on 	Appropriations",10,3,0,0,13
611579,364432,2014-05-14,Assembly,"Do pass",12,5,0,0,17
611579,367515,2014-05-27,Assembly,"AB 1586 HOLDEN  Assembly Third Reading",52,23,0,4,79
611579,370450,2014-06-10,Senate,"Do pass, but re-refer to the Committee on Appropriations",6,2,2,0,10
611579,375358,2014-06-30,Senate,"Placed on Appropriations Suspense file",6,0,1,0,7
611579,377555,2014-08-14,Senate,"Do pass as amended",5,0,2,0,7
611579,377977,2014-08-20,Senate,"Assembly 3rd Reading AB1586 Holden By Lara",23,11,6,0,40
611579,378256,2014-08-22,Assembly,"AB 1586 HOLDEN  Concurrence in Senate Amendments",50,25,0,4,79
611581,336599,2014-03-06,Senate,"Senate 3rd Reading SCR79 Galgiani",29,0,10,0,39
611581,370888,2014-06-11,Assembly,"Be adopted as amended and be re-referred to the Committee on 	Appropriations",6,0,0,1,7
611581,375579,2014-07-02,Assembly,"From committee:  Be adopted.  To third reading",16,1,0,0,17
611581,378018,2014-08-21,Assembly,"SCR 79 Galgiani  Senate Third Reading  By WILLIAMS",78,1,0,0,79
611581,378206,2014-08-22,Senate,"Unfinished Business SCR79 Galgiani Concurrence",33,0,7,0,40
611585,359315,2014-04-23,Assembly,"Do pass and be re-referred to the Committee on Appropriations",7,0,0,0,7
611585,366875,2014-05-23,Assembly,"Do pass",12,5,0,0,17
611585,368128,2014-05-28,Assembly,"AB 1581 BUCHANAN  Assembly Third Reading",60,16,0,3,79
611585,372783,2014-06-18,Senate,"Do pass, but re-refer to the Committee on Appropriations",5,1,1,0,7
611585,375258,2014-06-30,Senate,"Placed on Appropriations Suspense file",6,0,1,0,7
611585,377193,2014-08-14,Senate,"Do pass",5,0,2,0,7
611585,377955,2014-08-20,Senate,"Assembly 3rd Reading AB1581 Buchanan By Padilla",24,11,5,0,40
611587,353246,2014-04-08,Senate,"Do pass",7,0,0,0,7
611587,357936,2014-04-21,Senate,"Senate 3rd Reading SB939 Block",33,0,7,0,40
611587,372118,2014-06-17,Assembly,"Do pass as amended, to Consent Calendar",7,0,0,0,7
611587,374883,2014-06-26,Assembly,"SB 939 Block  Consent Calendar Second Day  Regular Session",76,0,0,3,79
611587,376945,2014-08-11,Senate,"Unfinished Business SB939 Block Concurrence",35,0,5,0,40
611589,350283,2014-04-01,Assembly,"Do pass and be re-referred to the Committee on Appropriations",7,0,0,0,7
611589,354400,2014-04-09,Assembly,"Do pass",17,0,0,0,17
611589,362212,2014-05-05,Assembly,"AB 1589 FRAZIER  Assembly Third Reading",72,0,0,7,79
611589,372493,2014-06-17,Senate,"Do pass, but re-refer to the Committee on Appropriations",4,0,1,0,5
611589,378006,2014-08-20,Senate,"Assembly 3rd Reading AB1589 Frazier By Padilla",34,0,6,0,40
611593,355044,2014-04-09,Assembly,"Do pass as amended and be re-referred to the Committee on Judiciary",7,0,0,0,7
611593,360723,2014-04-29,Assembly,"Do pass, to Consent Calendar",10,0,0,0,10
611593,362294,2014-05-05,Assembly,"AB 1584 BUCHANAN  Consent Calendar Second Day  Regular Session",75,0,0,4,79
611593,371000,2014-06-11,Senate,"Do pass, but re-refer to the Committee on Judiciary",7,0,0,0,7
611593,374677,2014-06-24,Senate,"Do pass as amended",7,0,0,0,7
611593,378328,2014-08-25,Senate,"Assembly 3rd Reading AB1584 Buchanan By Jackson",35,0,5,0,40
611593,378539,2014-08-26,Assembly,"AB 1584 BUCHANAN  Concurrence in Senate Amendments",79,0,0,0,79
611595,360563,2014-04-29,Assembly,"Do pass as amended and be re-referred to the Committee on 	Appropriations",19,0,0,0,19
611595,366736,2014-05-23,Assembly,"Do pass as amended",17,0,0,0,17
611595,368711,2014-05-29,Assembly,"AB 1592 GAINES  Assembly Third Reading",79,0,0,0,79
611595,375697,2014-07-02,Senate,"Do pass, but re-refer to the Committee on Appropriations",6,0,3,0,9
611595,376641,2014-08-04,Senate,"Placed on Appropriations Suspense file",7,0,0,0,7
611595,377487,2014-08-14,Senate,"Do pass as amended",6,0,1,0,7
611595,378323,2014-08-25,Senate,"Assembly 3rd Reading AB1592 Beth Gaines Urgency Clause",35,0,5,0,40
611595,378478,2014-08-26,Assembly,"AB 1592 GAINES  Concurrence- Urgency Added",79,0,0,0,79
611600,340812,2014-03-11,Assembly,"Do pass and re-refer to Committee on Appropriations with 	recommendation:  To Consent Calendar",7,0,0,0,7
611600,367156,2014-05-23,Assembly,"Do pass as amended",17,0,0,0,17
611600,368114,2014-05-28,Assembly,"AB 1585 ALEJO  Assembly Third Reading",79,0,0,0,79
611600,372167,2014-06-17,Senate,"Do pass, but re-refer to the Committee on Appropriations",5,0,2,0,7
611600,375246,2014-06-30,Senate,"Placed on Appropriations Suspense file",6,0,1,0,7
611600,377541,2014-08-14,Senate,"Do pass",6,0,1,0,7
611600,378378,2014-08-25,Senate,"Assembly 3rd Reading AB1585 Alejo By Block",35,0,5,0,40
611600,378440,2014-08-26,Assembly,"AB 1585 ALEJO  Concurrence in Senate Amendments",79,0,0,0,79
611604,340943,2014-03-11,Assembly,"Do pass and be re-referred to the Committee on Appropriations",2,5,0,0,7
611605,348136,2014-03-26,Senate,"Do pass, but re-refer to the Committee on Appropriations",3,1,1,0,5
611605,352671,2014-04-07,Senate,"Placed on Appropriations Suspense file",7,0,0,0,7
611605,366826,2014-05-23,Senate,"Do pass as amended",5,2,0,0,7
611605,368680,2014-05-29,Senate,"Senate 3rd Reading SB935 Leno",21,12,7,0,40
611605,374787,2014-06-25,Assembly,"Do pass and be re-referred to the Committee on Appropriations",3,1,0,3,7
611605,374788,2014-06-25,Assembly,"Set first hearing.  Failed passage.  Reconsideration granted",6,0,0,1,7
612962,362853,2014-05-06,Assembly,"Do pass, to Consent Calendar",6,0,0,1,7
612962,364841,2014-05-15,Assembly,"AB 1596 GARCIA  Consent Calendar Second Day  Regular Session",78,0,0,1,79
612962,374617,2014-06-24,Senate,"Do pass",5,0,0,0,5
612962,376941,2014-08-11,Senate,"Assembly 3rd Reading AB1596 Garcia By Correa",36,0,4,0,40
612974,336544,2014-03-06,Assembly,"From committee:  Be adopted.  To third reading",11,0,0,0,11
612974,359608,2014-04-24,Senate,"Special Consent #12 ACR91 Nazarian",37,0,3,0,40
612986,343997,2014-03-17,Senate,"Senate 3rd Reading SCR80 Corbett",33,0,6,0,39
612986,351890,2014-04-03,Assembly,"Be adopted, to Consent Calendar",9,0,0,2,11
612986,355119,2014-04-10,Assembly,"SCR 80 Corbett  Consent Calendar Second Day  Regular Session",74,0,0,5,79
612999,348390,2014-03-26,Assembly,"Do pass and be re-referred to the Committee on Appropriations",6,0,0,1,7
612999,354279,2014-04-09,Assembly,"Do pass, to Consent Calendar",17,0,0,0,17
612999,359627,2014-04-24,Assembly,"AB 1597 AGRI.  Assembly Third Reading  By EGGMAN",75,0,0,4,79
612999,372311,2014-06-17,Senate,"Do pass, but re-refer to the Committee on Appropriations Recommend 	Consent",5,0,0,0,5
612999,375231,2014-06-30,Senate,"Do pass",6,0,1,0,7
612999,376839,2014-08-07,Senate,"Assembly 3rd Reading AB1597 Committee on AGRI. (Eggman) By Wolk",34,0,6,0,40
612999,377011,2014-08-11,Assembly,"AB 1597 AGRI.  Concurrence in Senate Amendments By EGGMAN",79,0,0,0,79
613011,355100,2014-04-10,Assembly,"Be adopted, to Consent Calendar",7,0,0,4,11
613011,359590,2014-04-24,Assembly,"ACR 90 RENDON  Consent Calendar Second Day  Regular Session",75,0,0,4,79
613011,370124,2014-06-05,Senate,"Assembly 3rd Reading ACR90 Rendon By Wolk",31,0,9,0,40
613024,354287,2014-04-09,Assembly,"Do pass and be re-referred to the Committee on Public Safety",19,0,0,0,19
613024,360568,2014-04-29,Assembly,"Do pass and re-refer to Committee on Appropriations with 	recommendation:  To Consent Calendar",7,0,0,0,7
613024,366863,2014-05-23,Assembly,"Do pass as amended",17,0,0,0,17
613024,368011,2014-05-28,Assembly,"AB 1598 RODRIGUEZ  Assembly Third Reading",79,0,0,0,79
613024,372288,2014-06-17,Senate,"Do pass, but re-refer to the Committee on Appropriations",5,0,2,0,7
613024,377616,2014-08-18,Senate,"Assembly 3rd Reading AB1598 Rodriguez By Torres",35,0,5,0,40
613024,377763,2014-08-19,Assembly,"AB 1598 RODRIGUEZ  Concurrence in Senate Amendments",78,0,0,1,79
613036,351077,2014-04-02,Assembly,"From committee:  Be adopted.  To third reading",5,1,0,1,7
613036,351691,2014-04-03,Assembly,"HR 29 GOMEZ  Assembly Third Reading",44,22,0,13,79
613049,350330,2014-04-01,Senate,"Do pass, but re-refer to the Committee on Appropriations",7,0,0,0,7
613049,360388,2014-04-28,Senate,"Do pass as amended",5,0,2,0,7
613049,363403,2014-05-08,Senate,"Special Consent #13 SB940 Jackson",35,0,5,0,40
613049,370531,2014-06-10,Assembly,"Do pass as amended and be re-referred to the Committee on 	Appropriations",9,0,0,1,10
613049,375593,2014-07-02,Assembly,"Do pass, to Consent Calendar",17,0,0,0,17
613049,376940,2014-08-11,Assembly,"SB 940 Jackson  Senate Third Reading  By DICKINSON",78,0,0,1,79
613049,377036,2014-08-13,Senate,"Unfinished Business SB940 Jackson Concurrence",36,0,4,0,40
613061,353316,2014-04-08,Senate,"Do pass as amended, and re-refer to the Committee on Appropriations",7,1,1,0,9
613061,362282,2014-05-05,Senate,"Placed on Appropriations Suspense file",7,0,0,0,7
613061,366939,2014-05-23,Senate,"Do pass as amended",5,2,0,0,7
613061,368066,2014-05-28,Senate,"Senate 3rd Reading SB941 Monning",24,10,6,0,40
613061,371823,2014-06-16,Assembly,"Do pass as amended and be re-referred to the Committee on 	Appropriations",9,3,0,4,16
613061,377528,2014-08-14,Assembly,"Do pass as amended",12,5,0,0,17
613061,377928,2014-08-20,Assembly,"SB 941 Monning  Senate Third Reading  By BUCHANAN",51,25,0,3,79
613061,378013,2014-08-21,Senate,"Unfinished Business SB941 Monning Concurrence",23,7,10,0,40
613073,345150,2014-03-18,Senate,"Do pass, but re-refer to the Committee on Appropriations Recommend 	Consent",5,0,0,0,5
613073,352821,2014-04-07,Senate,"Placed on Appropriations Suspense file",7,0,0,0,7
613084,361546,2014-04-30,Senate,"Do pass, but re-refer to the Committee on Appropriations",2,2,5,0,9
614364,353187,2014-04-08,Assembly,"Do pass and be re-referred to the Committee on Judiciary",14,0,0,0,14
614364,360634,2014-04-29,Assembly,"Do pass and be re-referred to the Committee on Appropriations",10,0,0,0,10
614364,363091,2014-05-07,Assembly,"Do pass, to Consent Calendar",17,0,0,0,17
614364,364953,2014-05-15,Assembly,"AB 1608 OLSEN  Consent Calendar Second Day  Regular Session",78,0,0,1,79
614364,371810,2014-06-16,Senate,"Do pass, but re-refer to the Committee on Judiciary",8,0,1,0,9
614364,374338,2014-06-24,Senate,"Do pass as amended, and re-refer to the Committee on 	Appropriations",5,2,0,0,7
614364,378306,2014-08-25,Senate,"Assembly 3rd Reading AB1608 Olsen By Vidak",31,1,8,0,40
614364,378703,2014-08-27,Assembly,"AB 1608 OLSEN  Concurrence in Senate Amendments",77,0,0,2,79
614379,355115,2014-04-10,Assembly,"Be referred to Committee on Public Employees, Retirement and Social 	Security",7,0,0,4,11
614394,361629,2014-04-30,Assembly,"Do pass and re-refer to Committee on Appropriations with 	recommendation:  To Consent Calendar",7,0,0,0,7
614394,363049,2014-05-07,Assembly,"Do pass, to Consent Calendar",17,0,0,0,17
614394,364877,2014-05-15,Assembly,"AB 1599 ED.  Consent Calendar Second Day  Regular Session",78,0,0,1,79
614394,374417,2014-06-25,Senate,"Do pass as amended, but re-refer to the Committee on Appropriations 	Recommend Consent",6,0,1,0,7
614394,378450,2014-08-26,Senate,"Assembly 3rd Reading AB1599 Committee on ED. (Buchanan) By Liu",34,0,6,0,40
614394,378671,2014-08-27,Assembly,"AB 1599 ED.  Concurrence in Senate Amendments By BUCHANAN",78,0,0,1,79
614426,345001,2014-03-18,Assembly,"Do pass",12,0,0,1,13
614426,348880,2014-03-28,Assembly,"AB 1606 CHAVEZ  Assembly Third Reading",70,0,0,10,80
614426,365728,2014-05-14,Senate,"Do pass",7,0,2,0,9
614426,371846,2014-06-16,Senate,"Assembly 3rd Reading AB1606 Ch",35,0,5,0,40
614457,347075,2014-03-24,Assembly,"Do pass and be re-referred to the Committee on Appropriations",15,0,0,1,16
614457,367143,2014-05-23,Assembly,"Do pass",17,0,0,0,17
614457,368692,2014-05-29,Assembly,"AB 1602 PATTERSON  Assembly Third Reading",79,0,0,0,79
614457,372265,2014-06-17,Senate,"Do pass, but re-refer to the Committee on Appropriations Recommend 	Consent",11,0,0,0,11
614457,375479,2014-06-30,Senate,"Placed on Appropriations Suspense file",6,0,1,0,7
614472,354508,2014-04-09,Senate,"Do pass",7,0,0,0,7
614472,359655,2014-04-24,Senate,"Special Consent #12 SB946 Huff",37,0,3,0,40
614472,369824,2014-06-04,Assembly,"Do pass as amended",8,0,0,1,9
614472,373450,2014-06-19,Assembly,"SB 946 Huff  Senate Third Reading  By QUIRK-SILVA",78,0,0,1,79
614472,375708,2014-07-03,Senate,"Special Consent #18 SB946 Huff",35,0,5,0,40
614487,360757,2014-04-29,Assembly,"Do pass as amended",7,0,0,0,7
614487,364438,2014-05-14,Assembly,"Do pass",17,0,0,0,17
614487,367021,2014-05-23,Assembly,"AB 1607 FOX  Assembly Third Reading",75,0,0,4,79
614487,374431,2014-06-24,Senate,"Do pass as amended, and re-refer to the Committee on Appropriations",7,0,0,0,7
614487,376627,2014-08-04,Senate,"Placed on Appropriations Suspense file",7,0,0,0,7
614487,377407,2014-08-14,Senate,"Do pass as amended",5,0,2,0,7
614487,378501,2014-08-26,Senate,"Assembly 3rd Reading AB1607 Fox By Lieu",35,0,5,0,40
614487,378667,2014-08-27,Assembly,"AB 1607 FOX  Concurrence in Senate Amendments",77,0,0,2,79
614503,353678,2014-04-08,Senate,"Do pass, but re-refer to the Committee on Appropriations",9,0,1,0,10
614503,363360,2014-05-08,Senate,"Special Consent #13 SB944 Torres",35,0,5,0,40
614503,372781,2014-06-18,Assembly,"Do pass and be re-referred to the Committee on Local Government",12,1,0,0,13
614503,374389,2014-06-25,Assembly,"Do pass and be re-referred to the Committee on Appropriations",6,1,0,2,9
614503,377321,2014-08-14,Assembly,"Do pass as amended",15,2,0,0,17
614503,378305,2014-08-25,Assembly,"SB 944 Torres  Senate Third Reading  By RODRIGUEZ",69,6,0,4,79
614503,378467,2014-08-26,Senate,"Unfinished Supp 1 SB944 Torres Concurrence",35,1,4,0,40
614519,353591,2014-04-08,Assembly,"Do pass and be re-referred to the Committee on Appropriations",10,5,0,0,15
614549,347031,2014-03-24,Assembly,"Be adopted, and re-refer to Committee on Appropriations with 	recommendation:  To Consent Calendar",14,0,0,2,16
614549,354890,2014-04-09,Assembly,"Be adopted, to Consent Calendar",17,0,0,0,17
614549,358284,2014-04-21,Assembly,"ACR 92 HALL  Consent Calendar Second Day  Regular Session",77,0,0,2,79
614549,362766,2014-05-06,Senate,"Be adopted, but re-refer to the Committee on Appropriations 	Recommend Consent",11,0,0,0,11
615798,353289,2014-04-08,Senate,"Do pass, but re-refer to the Committee on Appropriations",7,0,0,0,7
615798,360083,2014-04-28,Senate,"Placed on Appropriations Suspense file",6,0,1,0,7
615798,366910,2014-05-23,Senate,"Do pass",7,0,0,0,7
615798,367485,2014-05-27,Senate,"Senate 3rd Reading SB955 Mitchell",32,0,8,0,40
615798,372310,2014-06-17,Assembly,"Do pass and be re-referred to the Committee on Appropriations",7,0,0,0,7
615798,377422,2014-08-14,Assembly,"Do pass as amended",17,0,0,0,17
615798,377904,2014-08-20,Assembly,"SB 955 Mitchell  Senate Third Reading  By HOLDEN",78,0,0,1,79
615798,378079,2014-08-21,Senate,"Unfinished Business SB955 Mitchell Concurrence",33,0,7,0,40
615809,354260,2014-04-08,Assembly,"Do pass as amended and be re-referred to the Committee on 	Appropriations",5,0,0,2,7
615809,363157,2014-05-07,Assembly,"Do pass",17,0,0,0,17
615809,364852,2014-05-15,Assembly,"AB 1614 STONE  Assembly Third Reading",77,0,0,2,79
615809,370712,2014-06-10,Senate,"Do pass, but re-refer to the Committee on Appropriations",4,0,1,0,5
615809,376572,2014-08-04,Senate,"Placed on Appropriations Suspense file",7,0,0,0,7
615809,377542,2014-08-14,Senate,"Do pass as amended",5,0,2,0,7
615809,378591,2014-08-26,Senate,"Assembly 3rd Reading AB1614 Stone By Liu",35,0,5,0,40
615809,378627,2014-08-27,Assembly,"AB 1614 STONE  Concurrence in Senate Amendments",78,0,0,1,79
615821,354459,2014-04-09,Assembly,"Do pass as amended and be re-referred to the Committee on 	Appropriations",13,3,0,3,19
615821,367099,2014-05-23,Assembly,"Do pass",12,5,0,0,17
615821,368049,2014-05-28,Assembly,"AB 1620 RODRIGUEZ  Assembly Third Reading",55,23,0,1,79
615821,374174,2014-06-24,Senate,"Do pass, but re-refer to the Committee on Appropriations",7,3,0,0,10
615821,376918,2014-08-11,Senate,"Placed on Appropriations Suspense file",7,0,0,0,7
615821,377304,2014-08-14,Senate,"Do pass",5,0,2,0,7
615821,378159,2014-08-21,Senate,"Assembly 3rd Reading AB1620 Rodriguez By Jackson",25,11,4,0,40
615833,348084,2014-03-25,Assembly,"Do pass and be re-referred to the Committee on Appropriations",7,0,0,0,7
615833,354387,2014-04-09,Assembly,"Do pass, to Consent Calendar",17,0,0,0,17
615833,359598,2014-04-24,Assembly,"AB 1610 BONTA  Assembly Third Reading",75,0,0,4,79
615833,370403,2014-06-10,Senate,"Do pass, but re-refer to the Committee on Appropriations",6,0,1,0,7
615833,378110,2014-08-21,Senate,"Assembly 3rd Reading AB1610 Bonta By Mitchell",32,0,8,0,40
615833,378248,2014-08-22,Assembly,"AB 1610 BONTA  Concurrence in Senate Amendments",76,0,0,3,79
615845,358584,2014-04-22,Senate,"Do pass, but re-refer to the Committee on Appropriations",7,0,0,0,7
615845,362281,2014-05-05,Senate,"Placed on Appropriations Suspense file",7,0,0,0,7
615857,366252,2014-05-21,Assembly,"Do pass",12,0,0,5,17
615857,367633,2014-05-27,Assembly,"AB 1615 GATTO  Third Reading Urgency",66,0,0,13,79
615857,373704,2014-06-23,Senate,"Do pass",7,0,0,0,7
615857,375279,2014-06-30,Senate,"Assembly 3rd Reading AB1615 Gatto Urgency Clause",30,3,7,0,40
615868,345511,2014-03-18,Senate,"Do pass, but re-refer to the Committee on Appropriations Recommend 	Consent",5,0,0,0,5
615868,353024,2014-04-07,Senate,"Placed on Appropriations Suspense file",7,0,0,0,7
615880,350861,2014-04-02,Assembly,"Do pass and be re-referred to the Committee on Appropriations",5,1,0,1,7
615880,361181,2014-04-30,Assembly,"Do pass",12,5,0,0,17
615880,364822,2014-05-15,Assembly,"AB 1611 BONTA  Assembly Third Reading",58,19,0,2,79
615880,373750,2014-06-23,Senate,"Do pass, but re-refer to the Committee on Appropriations",3,2,0,0,5
615880,376645,2014-08-04,Senate,"Do pass",5,2,0,0,7
615880,377239,2014-08-14,Senate,"Assembly 3rd Reading AB1611 Bonta By Torres",23,9,8,0,40
615892,347615,2014-03-25,Assembly,"Do pass, to Consent Calendar",10,0,0,0,10
615892,348879,2014-03-28,Assembly,"AB 1618 CHESBRO  Consent Calendar Second Day",68,0,0,12,80
615892,371076,2014-06-10,Senate,"Do pass and be placed on the Consent Calendar",7,0,0,0,7
615892,371739,2014-06-16,Senate,"Consent Calendar 2nd AB1618 Chesbro",35,0,5,0,40
615916,361168,2014-04-29,Assembly,"Do pass as amended and be re-referred to the Committee on 	Appropriations",5,0,0,2,7
615916,366343,2014-05-21,Assembly,"Do pass",12,5,0,0,17
615916,366829,2014-05-23,Assembly,"AB 1613 STONE  Assembly Third Reading",49,24,0,6,79
615916,370420,2014-06-10,Senate,"Do pass, but re-refer to the Committee on Appropriations",3,1,1,0,5
615916,375242,2014-06-30,Senate,"Placed on Appropriations Suspense file",6,0,1,0,7
615927,375581,2014-07-02,Assembly,"Do pass",17,0,0,0,17
615927,376389,2014-08-04,Assembly,"AB 1617 GATTO  Third Reading Urgency",76,0,0,3,79
615927,377368,2014-08-14,Senate,"Do pass",6,0,1,0,7
615927,377989,2014-08-20,Senate,"Assembly 3rd Reading AB1617 Gatto Urgency Clause",35,0,5,0,40
615939,350351,2014-04-01,Senate,"Do pass, but re-refer to the Committee on Appropriations",6,0,1,0,7
615939,360045,2014-04-28,Senate,"Placed on Appropriations Suspense file",6,0,1,0,7
615939,366948,2014-05-23,Senate,"Do pass",7,0,0,0,7
615939,368779,2014-05-29,Senate,"Senate 3rd Reading SB952 Torres",37,0,3,0,40
615939,374380,2014-06-24,Assembly,"Do pass and be re-referred to the Committee on Appropriations",6,0,0,1,7
615939,376661,2014-08-06,Assembly,"Do pass, to Consent Calendar",17,0,0,0,17
615939,377165,2014-08-14,Assembly,"SB 952 Torres  Consent Calendar Second Day  Regular Session",78,0,0,1,79
615939,378247,2014-08-22,Senate,"Unfinished Business SB952 Torres Concurrence",27,0,13,0,40
615951,348096,2014-03-25,Assembly,"Do pass and be re-referred to the Committee on Appropriations",5,2,0,0,7
615951,354423,2014-04-09,Assembly,"Do pass",12,5,0,0,17
615951,368093,2014-05-28,Assembly,"AB 1609 ALEJO  Assembly Third Reading",49,25,0,5,79
615951,374364,2014-06-24,Senate,"Do pass, but re-refer to the Committee on Appropriations",5,2,0,0,7
615951,376478,2014-08-04,Senate,"Do pass",5,2,0,0,7
615951,378714,2014-08-27,Senate,"Assembly 3rd Reading AB1609 Alejo By Wolk",22,11,7,0,40
615951,378846,2014-08-28,Assembly,"AB 1609 ALEJO  Concurrence in Senate Amendments",49,27,0,3,79
615975,361284,2014-04-30,Assembly,"Do pass and be re-referred to the Committee on Appropriations",13,0,0,0,13
615975,366799,2014-05-23,Assembly,"Do pass as amended",17,0,0,0,17
615975,368624,2014-05-29,Assembly,"AB 1612 DONNELLY  Assembly Third Reading",74,0,0,5,79
615975,374058,2014-06-24,Senate,"Do pass, but re-refer to the Committee on Appropriations Recommend 	Consent",10,0,0,0,10
615975,376923,2014-08-11,Senate,"Assembly 3rd Reading AB1612 Donnelly By Anderson",36,0,4,0,40
615986,348144,2014-03-26,Assembly,"Do pass as amended and be re-referred to the Committee on 	Appropriations",4,1,0,2,7
615986,367101,2014-05-23,Assembly,"Do pass",12,5,0,0,17
615986,368168,2014-05-28,Assembly,"AB 1619 GONZALEZ  Assembly Third Reading",52,24,0,3,79
615986,372759,2014-06-18,Senate,"Do pass as amended, and re-refer to the Committee on Appropriations",3,2,2,0,7
615986,372760,2014-06-18,Senate,"Set, first hearing.  Failed passage in Committee.  Reconsideration 	granted",7,0,0,0,7
616010,360136,2014-04-28,Senate,"Do pass, but re-refer to the Committee on Appropriations Recommend 	Consent",9,0,0,0,9
616010,368628,2014-05-29,Senate,"Senate 3rd Reading SB960 Morrell",36,0,4,0,40
616010,372134,2014-06-17,Assembly,"Do pass as amended and re-refer to Committee on Appropriations 	with recommendation:  To Consent Calendar",14,0,0,0,14
616010,375535,2014-07-02,Assembly,"Do pass, to Consent Calendar",17,0,0,0,17
616010,376754,2014-08-07,Assembly,"SB 960 Morrell  Consent Calendar Second Day  Regular Session",77,0,0,2,79
616010,376988,2014-08-11,Senate,"Unfinished Business SB960 Morrell",36,0,4,0,40
616022,348451,2014-03-26,Senate,"Do pass, but re-refer to the Committee on Appropriations",7,0,2,0,9
616022,360165,2014-04-28,Senate,"Placed on Appropriations Suspense file",6,0,1,0,7
616022,366739,2014-05-23,Senate,"Do pass",5,2,0,0,7
616022,367653,2014-05-27,Senate,"Senate 3rd Reading SB959 Hernandez",24,7,9,0,40
616022,372345,2014-06-17,Assembly,"Do pass and be re-referred to the Committee on Appropriations",19,0,0,0,19
616022,376674,2014-08-06,Assembly,"Do pass, to Consent Calendar",17,0,0,0,17
616022,378114,2014-08-21,Assembly,"SB 959 Hernandez  Senate Third Reading  By GORDON",79,0,0,0,79
616022,378237,2014-08-22,Senate,"Unfinished Business SB959 Hernandez Concurrence",33,0,7,0,40
616034,350289,2014-04-01,Senate,"Do pass as amended",6,2,3,0,11
616034,359612,2014-04-24,Senate,"Senate 3rd Reading SB962 Leno",19,17,4,0,40
616034,359613,2014-04-24,Senate,"Senate 3rd Reading SB962 Leno Reconsider",37,0,3,0,40
616034,363361,2014-05-08,Senate,"Senate 3rd Reading SB962 Leno",26,8,6,0,40
616034,372376,2014-06-17,Assembly,"Do pass and be re-referred to the Committee on Utilities and 	Commerce",11,3,0,0,14
616034,374164,2014-06-23,Assembly,"Do pass as amended",9,5,0,1,15
616034,376743,2014-08-07,Assembly,"SB 962 Leno  Senate Third Reading  By BRADFORD",53,20,0,6,79
616034,376944,2014-08-11,Senate,"Unfinished Business SB962 Leno Concurrence",28,8,4,0,40
616045,360799,2014-04-29,Senate,"Do pass, but re-refer to the Committee on Appropriations",2,4,1,0,7
616057,353426,2014-04-08,Senate,"Do pass, but re-refer to the Committee on Appropriations Recommend 	Consent",6,0,1,0,7
616057,361791,2014-05-01,Senate,"Consent Calendar 2nd SB948 Committee on V.A. (Hueso)",35,0,5,0,40
616057,372682,2014-06-17,Assembly,"Do pass and be re-referred to the Committee on Appropriations",9,0,0,1,10
616057,375631,2014-07-02,Assembly,"Do pass, to Consent Calendar",17,0,0,0,17
616057,376830,2014-08-07,Assembly,"SB 948 V. A.  Consent Calendar Second Day  Regular Session",77,0,0,2,79
616081,359320,2014-04-22,Senate,"Do pass as amended",10,0,1,0,11
616081,366940,2014-05-23,Senate,"Special Consent #15 SB953 Roth",32,0,8,0,40
616081,371816,2014-06-16,Assembly,"Do pass and re-refer to Committee on Appropriations with 	recommendation:  To Consent Calendar",15,0,0,1,16
616081,375588,2014-07-02,Assembly,"Do pass, to Consent Calendar",17,0,0,0,17
616081,376851,2014-08-07,Assembly,"SB 953 Roth  Consent Calendar Second Day  Regular Session",77,0,0,2,79
616104,350193,2014-04-01,Senate,"Do pass, but re-refer to the Committee on Appropriations",6,0,1,0,7
616104,360415,2014-04-28,Senate,"Placed on Appropriations Suspense file",6,0,1,0,7
616104,366785,2014-05-23,Senate,"Do pass",7,0,0,0,7
616104,368640,2014-05-29,Senate,"Senate 3rd Reading SB950 Torres",37,0,3,0,40
616104,374015,2014-06-24,Assembly,"Do pass, to Consent Calendar",7,0,0,0,7
616104,375675,2014-07-03,Assembly,"SB 950 Torres  Consent Calendar Second Day  Regular Session",76,0,0,3,79
616104,376421,2014-08-04,Senate,"Unfinished Business SB950 Torres Concurrence",36,0,4,0,40
616128,351498,2014-04-02,Senate,"Do pass as amended, and re-refer to the Committee on Education",9,0,0,0,9
616128,361698,2014-04-30,Senate,"Do pass as amended, and re-refer to the Committee on Appropriations",9,0,0,0,9
616128,365416,2014-05-19,Senate,"Placed on Appropriations Suspense file",7,0,0,0,7
616128,367087,2014-05-23,Senate,"Do pass",7,0,0,0,7
616128,367626,2014-05-27,Senate,"Senate 3rd Reading SB949 Jackson",36,0,4,0,40
616128,374416,2014-06-24,Assembly,"Do pass as amended and be re-referred to the Committee on 	Appropriations",15,3,0,1,19
616128,377184,2014-08-14,Assembly,"Do pass",13,4,0,0,17
616128,377935,2014-08-20,Assembly,"SB 949 Jackson  Senate Third Reading  By WIECKOWSKI  Amend By 	WIECKOWSKI  Set #1",56,21,0,2,79
616128,378289,2014-08-25,Assembly,"SB 949 Jackson  Senate Third Reading  By WIECKOWSKI",69,6,0,4,79
616128,378531,2014-08-26,Senate,"Unfinished Supp 1 SB949 Jackson Concurrence",36,0,4,0,40
616140,360600,2014-04-29,Assembly,"Do pass and be re-referred to the Committee on Appropriations",19,0,0,0,19
616140,366994,2014-05-23,Assembly,"Do pass as amended",17,0,0,0,17
616140,368175,2014-05-28,Assembly,"AB 1621 LOWENTHAL  Assembly Third Reading",79,0,0,0,79
616140,373311,2014-06-18,Senate,"Do pass as amended, and re-refer to the Committee on 	Appropriations",8,0,1,0,9
616140,376656,2014-08-04,Senate,"Placed on Appropriations Suspense file",7,0,0,0,7
617788,347522,2014-03-25,Assembly,"Do pass and be re-referred to the Committee on Appropriations",5,0,0,1,6
617788,367187,2014-05-23,Assembly,"Do pass as amended",13,0,0,4,17
617788,368616,2014-05-29,Assembly,"AB 1630 ALEJO  Assembly Third Reading",74,1,0,4,79
617790,347768,2014-03-25,Assembly,"Do pass and be re-referred to the Committee on Appropriations",7,0,0,0,7
617790,367023,2014-05-23,Assembly,"Do pass",17,0,0,0,17
617790,367579,2014-05-27,Assembly,"AB 1626 MAIENSCHEIN  Assembly Third Reading",77,0,0,2,79
617790,370525,2014-06-10,Senate,"Do pass, but re-refer to the Committee on Appropriations",4,0,1,0,5
617790,375443,2014-06-30,Senate,"Placed on Appropriations Suspense file",6,0,1,0,7
617793,358425,2014-04-21,Assembly,"Do pass as amended and be re-referred to the Committee on Natural 	Resources",11,0,0,4,15
617793,361570,2014-05-01,Assembly,"Do pass as amended and be re-referred to the Committee on 	Appropriations",9,0,0,0,9
617793,366819,2014-05-23,Assembly,"Do pass",16,0,0,1,17
617793,368676,2014-05-29,Assembly,"AB 1624 GORDON  Assembly Third Reading",76,0,0,3,79
617799,353396,2014-04-08,Senate,"Do pass, but re-refer to the Committee on Judiciary",7,2,0,0,9
617799,359117,2014-04-22,Senate,"Do pass, but re-refer to the Committee on Appropriations",5,2,0,0,7
617799,362367,2014-05-05,Senate,"Placed on Appropriations Suspense file",7,0,0,0,7
617799,367044,2014-05-23,Senate,"Do pass as amended",5,2,0,0,7
617799,367996,2014-05-28,Senate,"Senate 3rd Reading SB968 Hill",22,11,7,0,40
617799,372321,2014-06-16,Assembly,"Do pass as amended and be re-referred to the Committee on Judiciary",3,4,0,2,9
617799,372322,2014-06-16,Assembly,"Reconsideration granted",9,0,0,0,9
617799,372323,2014-06-16,Assembly,"Do pass and be re-referred to the Committee on Judiciary",6,3,0,0,9
617799,374030,2014-06-24,Assembly,"Do pass as amended and be re-referred to the Committee on 	Appropriations",7,1,0,2,10
617799,377445,2014-08-14,Assembly,"Do pass as amended",9,5,0,3,17
617799,377878,2014-08-20,Assembly,"SB 968 Hill  Senate Third Reading  By STONE",42,25,0,12,79
617799,378109,2014-08-21,Senate,"Unfinished Business SB968 Hill Concurrence",23,9,8,0,40
617801,361572,2014-04-30,Senate,"Do pass as amended, and re-refer to the Committee on 	Appropriations",6,1,2,0,9
617801,364860,2014-05-15,Senate,"Senate 3rd Reading SB972 Torres",33,0,7,0,40
617801,370562,2014-06-10,Assembly,"Do pass",16,0,0,3,19
617801,373248,2014-06-19,Assembly,"SB 972 Torres  Senate Third Reading  By GOMEZ",73,3,0,3,79
617801,375658,2014-07-03,Senate,"Special Consent #18 SB972 Torres",35,0,5,0,40
617803,361493,2014-04-29,Senate,"Do pass as amended, and re-refer to the Committee on 	Appropriations",11,0,0,0,11
617803,365381,2014-05-19,Senate,"Placed on Appropriations Suspense file",7,0,0,0,7
617803,367105,2014-05-23,Senate,"Do pass as amended",7,0,0,0,7
617803,368089,2014-05-28,Senate,"Senate 3rd Reading SB969 DeSaulnier",35,0,5,0,40
617803,372861,2014-06-18,Assembly,"Do pass and be re-referred to the Committee on Appropriations",11,1,0,1,13
617803,377145,2014-08-14,Assembly,"Do pass",17,0,0,0,17
617803,378063,2014-08-21,Assembly,"SB 969 DeSaulnier  Senate Third Reading  By LOWENTHAL",76,0,0,3,79
617803,378212,2014-08-22,Senate,"Unfinished Business SB969 DeSaulnier Concurrence",33,0,7,0,40
617807,321514,2014-02-14,Senate,"Senate 3rd Reading SR27 Cannella",32,0,7,0,39
617811,348059,2014-03-25,Assembly,"Do pass and be re-referred to the Committee on Judiciary",7,0,0,0,7
617811,358374,2014-04-22,Assembly,"Do pass, to Consent Calendar",10,0,0,0,10
617811,360077,2014-04-28,Assembly,"AB 1623 ATKINS  Consent Calendar Second Day  Regular Session",78,0,0,1,79
617811,370459,2014-06-10,Senate,"Do pass",6,0,1,0,7
617811,374749,2014-06-26,Senate,"Special Consent #17 AB1623 Atkins",32,0,8,0,40
617813,359898,2014-04-24,Senate,"Do pass as amended, but re-refer to the Committee on Appropriations 	Recommend Consent",8,0,1,0,9
617813,363929,2014-05-12,Senate,"Do pass",7,0,0,0,7
617813,364855,2014-05-15,Senate,"Special Consent #14 SB973 Hernandez",36,0,4,0,40
617813,372281,2014-06-17,Assembly,"Do pass and re-refer to Committee on Appropriations with 	recommendation:  To Consent Calendar",17,0,0,2,19
617813,375597,2014-07-02,Assembly,"Do pass, to Consent Calendar",17,0,0,0,17
617813,377631,2014-08-18,Assembly,"SB 973 Hernandez  Senate Third Reading  By NESTANDE",77,0,0,2,79
617813,377761,2014-08-19,Senate,"Unfinished Business SB973 Hernandez Concurrence",34,0,6,0,40
617814,345722,2014-03-19,Senate,"Do pass as amended, and re-refer to the Committee on Appropriations",6,0,3,0,9
617814,352627,2014-04-07,Senate,"Placed on Appropriations Suspense file",7,0,0,0,7
617814,367010,2014-05-23,Senate,"Do pass as amended",5,2,0,0,7
617814,368735,2014-05-29,Senate,"Senate 3rd Reading SB967 De Le",27,9,4,0,40
617814,372177,2014-06-17,Assembly,"Do pass as amended and be re-referred to the Committee on Higher 	Education",9,1,0,0,10
617814,374360,2014-06-24,Assembly,"Do pass and be re-referred to the Committee on Appropriations",11,1,0,1,13
617814,377436,2014-08-14,Assembly,"Do pass",13,4,0,0,17
617814,378359,2014-08-25,Assembly,"SB 967 De Leon  Senate Third Reading  By GOMEZ",57,20,0,2,79
617814,378885,2014-08-28,Senate,"Unfinished Business SB967 De Le",36,0,4,0,40
617817,346605,2014-03-19,Assembly,"Do pass and be re-referred to the Committee on Appropriations",5,1,0,1,7
617817,366794,2014-05-23,Assembly,"Do pass",12,5,0,0,17
617817,368001,2014-05-28,Assembly,"AB 1634 SKINNER  Assembly Third Reading",45,28,0,6,79
617817,370983,2014-06-11,Senate,"Do pass, but re-refer to the Committee on Appropriations",3,1,1,0,5
617817,373715,2014-06-23,Senate,"Placed on Appropriations Suspense file",7,0,0,0,7
617817,377150,2014-08-14,Senate,"Do pass as amended",5,0,2,0,7
617817,378826,2014-08-27,Senate,"Assembly 3rd Reading AB1634 Skinner By Hernandez",25,10,5,0,40
617817,378985,2014-08-28,Assembly,"AB 1634 SKINNER  Concurrence in Senate Amendments",54,25,0,0,79
617820,361545,2014-05-01,Assembly,"Do pass as amended and be re-referred to the Committee on 	Appropriations",16,0,0,0,16
617820,364381,2014-05-14,Assembly,"Do pass, to Consent Calendar",17,0,0,0,17
617820,366669,2014-05-23,Assembly,"AB 1627 GOMEZ  Consent Calendar Second Day  Regular Session",73,0,0,6,79
617820,370558,2014-06-10,Senate,"Do pass, but re-refer to the Committee on Appropriations",10,0,1,0,11
617820,375715,2014-07-03,Senate,"Special Consent #18 AB1627 Gomez",35,0,5,0,40
617821,348194,2014-03-25,Assembly,"Do pass and re-refer to Committee on Appropriations with 	recommendation:  To Consent Calendar",7,0,0,0,7
617821,354820,2014-04-09,Assembly,"Do pass, to Consent Calendar",17,0,0,0,17
617821,359668,2014-04-24,Assembly,"AB 1625 NAZARIAN  Consent Calendar Second Day  Regular Session",75,0,0,4,79
617821,364045,2014-05-13,Senate,"Do pass, but re-refer to the Committee on Appropriations Recommend 	Consent",9,0,1,0,10
617821,374951,2014-06-26,Senate,"Consent Calendar 2nd AB1625 Nazarian",32,0,8,0,40
617823,348386,2014-03-25,Assembly,"Do pass and be re-referred to the Committee on Appropriations",7,0,0,0,7
617823,367206,2014-05-23,Assembly,"Do pass as amended",17,0,0,0,17
617823,368157,2014-05-28,Assembly,"AB 1629 BONTA  Assembly Third Reading",79,0,0,0,79
617823,372157,2014-06-17,Senate,"Do pass, but re-refer to the Committee on Appropriations",5,0,2,0,7
617823,376497,2014-08-04,Senate,"Placed on Appropriations Suspense file",7,0,0,0,7
617823,377369,2014-08-14,Senate,"Do pass as amended",5,0,2,0,7
617823,378688,2014-08-27,Senate,"Assembly 3rd Reading AB1629 Bonta By Liu",36,0,4,0,40
617823,378917,2014-08-28,Assembly,"AB 1629 BONTA  Concurrence in Senate Amendments",79,0,0,0,79
617831,347719,2014-03-25,Assembly,"Do pass",10,0,0,0,10
617831,348877,2014-03-28,Assembly,"AB 1628 FOX  Assembly Third Reading",70,0,0,10,80
617831,371135,2014-06-10,Senate,"Do pass",7,0,0,0,7
617831,376954,2014-08-11,Senate,"Assembly 3rd Reading AB1628 Fox By Jackson",36,0,4,0,40
617833,360489,2014-04-29,Assembly,"Do pass and be re-referred to the Committee on Appropriations",5,2,0,0,7
617835,345803,2014-03-19,Senate,"Do pass as amended, and re-refer to the Committee on Appropriations",7,0,2,0,9
617835,355140,2014-04-10,Senate,"Senate 3rd Reading SB971 Huff",34,0,6,0,40
617835,371120,2014-06-11,Assembly,"Do pass as amended and re-refer to Committee on Appropriations 	with recommendation:  To Consent Calendar",6,0,0,1,7
617835,375630,2014-07-02,Assembly,"Do pass, to Consent Calendar",17,0,0,0,17
617835,377621,2014-08-18,Assembly,"SB 971 Huff  Senate Third Reading  By OLSEN",75,0,0,4,79
617835,377753,2014-08-19,Senate,"Unfinished Business SB971 Huff Concurrence",34,0,6,0,40
617840,359829,2014-04-24,Senate,"Do pass as amended, and re-refer to the Committee on Appropriations",7,2,0,0,9
617840,363696,2014-05-12,Senate,"Placed on Appropriations Suspense file",7,0,0,0,7
617841,361650,2014-04-30,Senate,"Do pass, but re-refer to the Committee on Appropriations",5,1,3,0,9
617841,365395,2014-05-19,Senate,"Placed on Appropriations Suspense file",7,0,0,0,7
617841,367047,2014-05-23,Senate,"Do pass",5,2,0,0,7
617841,367645,2014-05-27,Senate,"Senate 3rd Reading SB964 Hernandez",22,10,8,0,40
617841,374325,2014-06-24,Assembly,"Do pass as amended and be re-referred to the Committee on 	Appropriations",14,5,0,0,19
617841,377491,2014-08-14,Assembly,"Do pass as amended",12,3,0,2,17
617841,378506,2014-08-26,Assembly,"SB 964 Hernandez  Senate Third Reading  By BONTA",54,22,0,3,79
617841,378679,2014-08-27,Senate,"Unfinished Business SB964 Hernandez Concurrence",23,12,5,0,40
618767,358088,2014-04-21,Senate,"Do pass, but re-refer to the Committee on Appropriations",2,2,1,0,5
618767,358089,2014-04-21,Senate,"Set, first hearing.  Failed passage in Committee.  Reconsideration 	granted",4,0,1,0,5
618770,360588,2014-04-28,Assembly,"Do pass and be re-referred to the Committee on Appropriations",13,1,0,2,16
618770,363011,2014-05-07,Assembly,"Do pass as amended",16,1,0,0,17
618770,364873,2014-05-15,Assembly,"AB 1646 FRAZIER  Assembly Third Reading",68,9,0,2,79
618770,372126,2014-06-17,Senate,"Do pass, but re-refer to the Committee on Appropriations",8,0,3,0,11
618770,376895,2014-08-11,Senate,"Do pass",7,0,0,0,7
618770,378026,2014-08-21,Senate,"Assembly 3rd Reading AB1646 Frazier By Galgiani",32,3,5,0,40
618770,378332,2014-08-25,Assembly,"AB 1646 FRAZIER  Concurrence in Senate Amendments",66,13,0,0,79
618774,358409,2014-04-22,Senate,"Do pass, but re-refer to the Committee on Judiciary",3,1,1,0,5
618774,362956,2014-05-06,Senate,"Do pass as amended",7,0,0,0,7
618774,365358,2014-05-19,Senate,"Placed on Appropriations Suspense file",7,0,0,0,7
618774,366982,2014-05-23,Senate,"Do pass",5,1,1,0,7
618774,368776,2014-05-29,Senate,"Senate 3rd Reading SB977 Liu",29,5,6,0,40
618774,374161,2014-06-24,Assembly,"Do pass and be re-referred to the Committee on Appropriations",9,0,0,1,10
618774,375608,2014-07-02,Assembly,"Do pass",17,0,0,0,17
618774,376824,2014-08-07,Assembly,"SB 977 Liu  Senate Third Reading  By WIECKOWSKI",77,0,0,2,79
618774,376969,2014-08-11,Senate,"Unfinished Business SB977 Liu Concurrence",33,3,4,0,40
618779,358521,2014-04-22,Senate,"Do pass, but re-refer to the Committee on Appropriations",5,2,0,0,7
618779,363744,2014-05-12,Senate,"Placed on Appropriations Suspense file",7,0,0,0,7
618779,366751,2014-05-23,Senate,"Do pass as amended",5,2,0,0,7
618779,368617,2014-05-29,Senate,"Senate 3rd Reading SB980 Lieu",23,11,6,0,40
618779,374112,2014-06-24,Assembly,"Do pass and be re-referred to the Committee on Appropriations",5,0,0,2,7
618779,377252,2014-08-14,Assembly,"Do pass as amended",13,0,0,4,17
618779,378690,2014-08-27,Assembly,"SB 980 Lieu  Senate Third Reading  By GORELL",77,1,0,1,79
618779,379065,2014-08-29,Senate,"Unfinished Business SB980 Lieu Concurrence",32,3,5,0,40
618788,361070,2014-04-30,Senate,"Do pass, but re-refer to the Committee on Appropriations",4,2,1,0,7
618788,368113,2014-05-28,Senate,"From Committee:  That the measure be returned to the Senate floor 	for consideration",5,2,0,0,7
618788,368646,2014-05-29,Senate,"Senate 3rd Reading SB983 Hernandez",22,13,5,0,40
618788,371764,2014-06-16,Assembly,"Be referred to Committee on Transportation",10,0,0,1,11
618788,373705,2014-06-23,Assembly,"Do pass as amended and be re-referred to the Committee on 	Appropriations",12,1,0,3,16
618792,364366,2014-05-13,Assembly,"Do pass and be re-referred to the Committee on Appropriations",7,1,0,1,9
618797,347489,2014-03-25,Assembly,"Do pass as amended and be re-referred to the Committee on 	Appropriations",10,0,0,0,10
618797,367052,2014-05-23,Assembly,"Do pass as amended",13,0,0,4,17
618797,368785,2014-05-29,Assembly,"AB 1650 JONES-SAWYER  Assembly Third Reading",58,16,0,5,79
618797,370620,2014-06-10,Senate,"Do pass, but re-refer to the Committee on Judiciary",7,1,2,0,10
618797,372817,2014-06-17,Senate,"Do pass, but re-refer to the Committee on Appropriations",5,1,1,0,7
618797,376465,2014-08-04,Senate,"Placed on Appropriations Suspense file",7,0,0,0,7
618797,377566,2014-08-14,Senate,"Do pass as amended",5,0,2,0,7
618797,378169,2014-08-21,Senate,"Assembly 3rd Reading AB1650 Jones-Sawyer By Jackson",23,10,7,0,40
618797,378473,2014-08-26,Assembly,"AB 1650 JONES-SAWYER  Concurrence in Senate Amendments",56,21,0,2,79
618801,353259,2014-04-08,Senate,"Do pass, but re-refer to the Committee on Public Safety",7,2,1,0,10
618801,362275,2014-05-05,Senate,"Placed on Appropriations Suspense file",7,0,0,0,7
618801,366868,2014-05-23,Senate,"Do pass as amended",5,2,0,0,7
618801,368184,2014-05-28,Senate,"Senate 3rd Reading SB975 Lieu",23,10,7,0,40
618801,372908,2014-06-18,Assembly,"Do pass as amended and be re-referred to the Committee on 	Appropriations",10,1,0,2,13
618801,377201,2014-08-14,Assembly,"Do pass",12,5,0,0,17
618801,378197,2014-08-22,Assembly,"SB 975 Lieu  Senate Third Reading  Amend By PAN  Set #1",53,21,0,5,79
618801,378645,2014-08-27,Assembly,"SB 975 Lieu  Senate Third Reading  By PAN",56,22,0,1,79
618801,378842,2014-08-28,Senate,"Unfinished Business SB975 Lieu Concurrence",23,11,6,0,40
618805,353486,2014-04-08,Assembly,"Do pass and be re-referred to the Committee on Appropriations",4,2,0,1,7
618805,367031,2014-05-23,Assembly,"Do pass as amended",12,5,0,0,17
618805,368000,2014-05-28,Assembly,"AB 1652 AMMIANO  Assembly Third Reading",23,38,0,18,79
618810,362626,2014-05-06,Assembly,"From committee:  Be adopted.  To third reading",9,3,0,1,13
618810,364821,2014-05-15,Assembly,"ACR 95 GOMEZ  Assembly Third Reading",55,23,0,1,79
618810,369804,2014-06-04,Senate,"Be adopted",4,2,1,0,7
618810,373340,2014-06-19,Senate,"Assembly 3rd Reading ACR95 Gomez By Monning",23,10,7,0,40
618819,347271,2014-03-24,Assembly,"Do pass and be re-referred to the Committee on Veterans Affairs",15,0,0,1,16
618819,361348,2014-04-29,Assembly,"Do pass as amended and be re-referred to the Committee on 	Appropriations",9,0,0,1,10
618823,348086,2014-03-26,Assembly,"Do pass and be re-referred to the Committee on Appropriations",6,0,0,1,7
618823,367162,2014-05-23,Assembly,"Do pass",16,0,0,1,17
618823,367546,2014-05-27,Assembly,"AB 1642 CHESBRO  Assembly Third Reading",76,0,0,3,79
618823,372455,2014-06-17,Senate,"Do pass, but re-refer to the Committee on Appropriations",5,0,0,0,5
618823,375343,2014-06-30,Senate,"Do pass",6,0,1,0,7
618823,376788,2014-08-07,Senate,"Assembly 3rd Reading AB1642 Chesbro By Berryhill",33,0,7,0,40
618828,331456,2014-02-27,Assembly,"From committee:  Be adopted.  To third reading",11,0,0,0,11
618832,361246,2014-04-30,Assembly,"Do pass and re-refer to Committee on Appropriations with 	recommendation:  To Consent Calendar",7,0,0,0,7
618832,363045,2014-05-07,Assembly,"Do pass, to Consent Calendar",17,0,0,0,17
618832,364893,2014-05-15,Assembly,"AB 1647 BIGELOW  Consent Calendar Second Day  Regular Session",78,0,0,1,79
618832,372504,2014-06-17,Senate,"Do pass, but re-refer to the Committee on Appropriations Recommend 	Consent",5,0,0,0,5
618837,350300,2014-04-01,Assembly,"Do pass as amended and be re-referred to the Committee on 	Appropriations",18,0,0,1,19
618841,347803,2014-03-25,Assembly,"Do pass and be re-referred to the Committee on Judiciary",7,0,0,0,7
618841,350393,2014-04-01,Assembly,"Do pass and re-refer to Committee on Appropriations with 	recommendation:  To Consent Calendar",9,0,0,1,10
618841,367181,2014-05-23,Assembly,"Do pass",16,0,0,1,17
618841,367616,2014-05-27,Assembly,"AB 1654 BONILLA  Assembly Third Reading",76,0,0,3,79
618841,372751,2014-06-17,Senate,"Do pass as amended, and re-refer to the Committee on 	Appropriations",6,0,1,0,7
618841,376502,2014-08-04,Senate,"Placed on Appropriations Suspense file",7,0,0,0,7
618849,358431,2014-04-22,Senate,"Do pass, but re-refer to the Committee on Environmental Quality",8,0,1,0,9
618849,361305,2014-04-30,Senate,"Do pass as amended",6,0,1,0,7
618849,365426,2014-05-19,Senate,"Placed on Appropriations Suspense file",7,0,0,0,7
618849,366734,2014-05-23,Senate,"Do pass",7,0,0,0,7
618849,367632,2014-05-27,Senate,"Senate 3rd Reading SB985 Pavley",31,3,6,0,40
618849,372121,2014-06-17,Assembly,"Do pass as amended and be re-referred to the Committee on 	Appropriations",8,6,0,1,15
618849,377135,2014-08-14,Assembly,"Do pass as amended",12,5,0,0,17
618849,378664,2014-08-27,Assembly,"SB 985 Pavley  Senate Third Reading  By RENDON",54,22,0,3,79
618849,378975,2014-08-28,Senate,"Unfinished Business SB985 Pavley Concurrence",23,11,6,0,40
618856,358498,2014-04-22,Senate,"Do pass as amended, and re-refer to the Committee on Appropriations",7,0,0,0,7
618856,363769,2014-05-12,Senate,"Placed on Appropriations Suspense file",7,0,0,0,7
618861,341245,2014-03-11,Assembly,"Be adopted, to Consent Calendar",7,0,0,0,7
618861,361841,2014-05-01,Senate,"Assembly 3rd Reading ACR94 Rodriguez By Torres",35,0,5,0,40
618865,361301,2014-04-30,Assembly,"Do pass and be re-referred to the Committee on Appropriations",13,0,0,0,13
618865,366778,2014-05-23,Assembly,"Do pass as amended",12,0,0,5,17
618865,368704,2014-05-29,Assembly,"AB 1656 DICKINSON  Assembly Third Reading",79,0,0,0,79
618865,374098,2014-06-24,Senate,"Do pass, but re-refer to the Committee on Appropriations",10,0,0,0,10
618865,376933,2014-08-11,Senate,"Placed on Appropriations Suspense file",7,0,0,0,7
618865,377216,2014-08-14,Senate,"Do pass",5,0,2,0,7
618865,378960,2014-08-28,Senate,"Assembly 3rd Reading AB1656 Dickinson By Leno",27,2,11,0,40
618865,379084,2014-08-29,Assembly,"AB 1656 DICKINSON  Concurrence in Senate Amendments",77,1,0,1,79
618870,358796,2014-04-22,Assembly,"Do pass as amended and be re-referred to the Committee on 	Appropriations",10,0,0,0,10
618870,363054,2014-05-07,Assembly,"Do pass, to Consent Calendar",17,0,0,0,17
618870,365299,2014-05-19,Assembly,"AB 1657 GOMEZ  Assembly Third Reading",75,0,0,4,79
618870,374523,2014-06-24,Senate,"Do pass, but re-refer to the Committee on Appropriations Recommend 	Consent",7,0,0,0,7
618870,376482,2014-08-04,Senate,"Placed on Appropriations Suspense file",7,0,0,0,7
618870,377316,2014-08-14,Senate,"Do pass",5,0,2,0,7
618870,378639,2014-08-27,Senate,"Special Consent #19 AB1657 Gomez By Correa",36,0,4,0,40
618870,378951,2014-08-28,Assembly,"AB 1657 GOMEZ  Concurrence in Senate Amendments",78,0,0,1,79
618874,355056,2014-04-09,Assembly,"Do pass as amended and be re-referred to the Committee on 	Appropriations",6,0,0,1,7
618874,367160,2014-05-23,Assembly,"Do pass as amended",13,0,0,4,17
618874,368760,2014-05-29,Assembly,"AB 1643 BUCHANAN  Assembly Third Reading",60,9,0,10,79
618874,372701,2014-06-18,Senate,"Do pass, but re-refer to the Committee on Appropriations",7,0,0,0,7
618874,376581,2014-08-04,Senate,"Placed on Appropriations Suspense file",7,0,0,0,7
618874,377575,2014-08-14,Senate,"Do pass as amended",5,0,2,0,7
618874,378308,2014-08-25,Senate,"Assembly 3rd Reading AB1643 Buchanan By Huff",35,0,5,0,40
618874,378545,2014-08-26,Assembly,"AB 1643 BUCHANAN  Concurrence in Senate Amendments",79,0,0,0,79
618879,348528,2014-03-26,Senate,"Do pass, but re-refer to the Committee on Appropriations",7,0,2,0,9
618879,355129,2014-04-09,Senate,"Do pass as amended, and re-refer to the Committee on Judiciary",8,0,1,0,9
618879,361174,2014-04-29,Senate,"Do pass as amended, and re-refer to the Committee on 	Appropriations",7,0,0,0,7
618879,365562,2014-05-19,Senate,"Placed on Appropriations Suspense file",7,0,0,0,7
618879,367133,2014-05-23,Senate,"Do pass",7,0,0,0,7
618879,367642,2014-05-27,Senate,"Senate 3rd Reading SB974 Anderson Urgency Clause",34,0,6,0,40
618879,374384,2014-06-24,Assembly,"Do pass as amended and be re-referred to the Committee on 	Appropriations",19,0,0,0,19
618883,348091,2014-03-25,Assembly,"Do pass as amended",5,0,0,2,7
618883,368715,2014-05-29,Assembly,"AB 1640 JONES-SAWYER  Assembly Third Reading",29,37,0,13,79
618892,358748,2014-04-22,Senate,"Do pass as amended, and re-refer to the Committee on 	Appropriations",5,5,0,0,10
618892,358749,2014-04-22,Senate,"Set, first hearing.  Failed passage in Committee.  Reconsideration 	granted",10,0,0,0,10
618896,361569,2014-04-30,Senate,"Do pass, but re-refer to the Committee on Appropriations",7,0,2,0,9
618896,363734,2014-05-12,Senate,"Placed on Appropriations Suspense file",7,0,0,0,7
618896,366765,2014-05-23,Senate,"Do pass as amended",7,0,0,0,7
618896,368251,2014-05-28,Senate,"Senate 3rd Reading SB986 Hernandez",34,0,6,0,40
618896,372370,2014-06-17,Assembly,"Do pass and re-refer to Committee on Appropriations with 	recommendation:  To Consent Calendar",17,0,0,2,19
618905,358757,2014-04-22,Senate,"Do pass",6,0,1,0,7
618905,361556,2014-05-01,Senate,"Senate 3rd Reading SB978 DeSaulnier",36,0,4,0,40
618905,370563,2014-06-10,Assembly,"Do pass",7,0,0,0,7
618905,375722,2014-07-03,Assembly,"SB 978 DeSaulnier  Senate Third Reading  By SKINNER",77,0,0,2,79
618910,346423,2014-03-20,Assembly,"From committee:  Be adopted.  To third reading",9,0,0,2,11
618910,359594,2014-04-24,Senate,"Special Consent #12 ACR93 Buchanan",37,0,3,0,40
618914,359204,2014-04-23,Assembly,"Do pass and be re-referred to the Committee on Appropriations",9,3,0,1,13
618919,360647,2014-04-28,Assembly,"Do pass and be re-referred to the Committee on Appropriations",3,4,0,2,9
618923,361319,2014-04-29,Assembly,"Do pass as amended and be re-referred to the Committee on 	Appropriations",5,0,0,2,7
618923,366475,2014-05-21,Assembly,"Do pass, to Consent Calendar",17,0,0,0,17
618923,367544,2014-05-27,Assembly,"AB 1653 GARCIA  Consent Calendar Second Day",77,0,0,2,79
618923,374285,2014-06-24,Senate,"Do pass, but re-refer to the Committee on Appropriations Recommend 	Consent",4,0,1,0,5
618923,376419,2014-08-04,Senate,"Placed on Appropriations Suspense file",7,0,0,0,7
618928,348216,2014-03-25,Assembly,"Do pass as amended and be re-referred to the Committee on 	Appropriations",7,0,0,0,7
618928,361320,2014-04-30,Assembly,"Do pass",17,0,0,0,17
618928,362254,2014-05-05,Assembly,"AB 1649 WALDRON  Assembly Third Reading",76,0,0,3,79
618928,370654,2014-06-10,Senate,"Do pass, but re-refer to the Committee on Appropriations",6,0,1,0,7
618928,377730,2014-08-18,Senate,"Assembly 3rd Reading AB1649 Waldron By Knight",36,0,4,0,40
619485,359234,2014-04-22,Senate,"Do pass, but re-refer to the Committee on Judiciary",3,1,7,0,11
619485,359235,2014-04-22,Senate,"Set, second hearing.  Failed passage in Committee. 	Reconsideration granted",10,0,1,0,11
619487,348200,2014-03-26,Assembly,"Do pass as amended and be re-referred to the Committee on 	Appropriations",5,0,0,2,7
619487,366788,2014-05-23,Assembly,"Do pass",12,0,0,5,17
619487,368144,2014-05-28,Assembly,"AB 1672 HOLDEN  Assembly Third Reading",54,17,0,8,79
619487,374381,2014-06-25,Senate,"Do pass, but re-refer to the Committee on Appropriations",5,1,1,0,7
619487,376655,2014-08-04,Senate,"Placed on Appropriations Suspense file",7,0,0,0,7
619487,377547,2014-08-14,Senate,"Do pass as amended",5,0,2,0,7
619487,378786,2014-08-27,Senate,"Assembly 3rd Reading AB1672 Holden By Leno",30,5,5,0,40
619487,378961,2014-08-28,Assembly,"AB 1672 HOLDEN  Concurrence in Senate Amendments",59,17,0,3,79
619490,361160,2014-04-29,Senate,"Do pass, but re-refer to the Committee on Appropriations",3,8,0,0,11
619490,361161,2014-04-29,Senate,"Set, second hearing.  Failed passage in Committee. 	Reconsideration granted",11,0,0,0,11
619492,354425,2014-04-08,Assembly,"Do pass as amended and be re-referred to the Committee on Banking 	and Finance",7,0,0,0,7
619492,360621,2014-04-28,Assembly,"Do pass and be re-referred to the Committee on Appropriations",11,0,0,1,12
619492,366713,2014-05-23,Assembly,"Do pass as amended",17,0,0,0,17
619492,368033,2014-05-28,Assembly,"AB 1658 JONES-SAWYER  Assembly Third Reading",78,0,0,1,79
619492,370533,2014-06-10,Senate,"Do pass, but re-refer to the Committee on Judiciary",4,0,1,0,5
619492,377090,2014-08-13,Senate,"Assembly 3rd Reading AB1658 Jones-Sawyer By Beall",36,0,4,0,40
619492,377620,2014-08-18,Assembly,"AB 1658 JONES-SAWYER  Concurrence in Senate Amendments",78,0,0,1,79
619496,350399,2014-04-01,Assembly,"Do pass and be re-referred to the Committee on Education",18,0,0,1,19
619496,355205,2014-04-09,Assembly,"Do pass and re-refer to Committee on Appropriations with 	recommendation:  To Consent Calendar",7,0,0,0,7
619496,367015,2014-05-23,Assembly,"Do pass as amended",16,0,0,1,17
619496,368142,2014-05-28,Assembly,"AB 1667 WILLIAMS  Assembly Third Reading",76,1,0,2,79
619496,373291,2014-06-18,Senate,"Do pass as amended, and re-refer to the Committee on 	Appropriations",8,0,1,0,9
619496,376592,2014-08-04,Senate,"Do pass as amended",7,0,0,0,7
619496,378001,2014-08-20,Senate,"Assembly 3rd Reading AB1667 Williams By DeSaulnier",35,0,5,0,40
619496,378049,2014-08-21,Assembly,"AB 1667 WILLIAMS  Concurrence in Senate Amendments",76,0,0,3,79
619505,345688,2014-03-19,Senate,"Do pass, but re-refer to the Committee on Appropriations",5,2,0,0,7
619505,363469,2014-05-08,Senate,"Senate 3rd Reading SB988 Jackson",27,8,5,0,40
619505,369985,2014-06-04,Assembly,"Do pass and be re-referred to the Committee on Appropriations",8,0,0,1,9
619505,372564,2014-06-18,Assembly,"Do pass",11,4,0,2,17
619505,374754,2014-06-26,Assembly,"SB 988 Jackson  Senate Third Reading  By WILLIAMS",56,18,0,5,79
619511,353413,2014-04-07,Assembly,"Do pass and be re-referred to the Committee on Appropriations",10,3,0,2,15
619511,361240,2014-04-30,Assembly,"Do pass as amended",12,5,0,0,17
619511,364976,2014-05-15,Assembly,"AB 1678 GORDON  Assembly Third Reading",54,20,0,5,79
619511,372431,2014-06-17,Senate,"Do pass, but re-refer to the Committee on Appropriations",9,1,1,0,11
619511,378410,2014-08-25,Senate,"Assembly 3rd Reading AB1678 Gordon By Leno",22,9,9,0,40
619511,378763,2014-08-27,Assembly,"AB 1678 GORDON  Concurrence in Senate Amendments",54,22,0,3,79
619513,359302,2014-04-22,Assembly,"Do pass as amended and be re-referred to the Committee on 	Appropriations",7,0,0,2,9
619513,367183,2014-05-23,Assembly,"Do pass",13,4,0,0,17
619513,367490,2014-05-27,Assembly,"AB 1675 CALDERON  Assembly Third Reading",70,7,0,2,79
619513,371722,2014-06-16,Senate,"Do pass as amended, and re-refer to the Committee on 	Appropriations",8,0,1,0,9
619513,375271,2014-06-30,Senate,"Placed on Appropriations Suspense file",6,0,1,0,7
619516,350282,2014-04-01,Assembly,"Do pass as amended and be re-referred to the Committee on 	Appropriations",6,0,0,1,7
619516,361097,2014-04-30,Assembly,"Do pass as amended, to Consent Calendar",17,0,0,0,17
619516,364943,2014-05-15,Assembly,"AB 1666 GARCIA  Consent Calendar Second Day  Regular Session",78,0,0,1,79
619516,374664,2014-06-24,Senate,"Do pass, but re-refer to the Committee on Appropriations",4,1,0,0,5
619516,378565,2014-08-26,Senate,"Assembly 3rd Reading AB1666 Garcia By Padilla",31,1,8,0,40
619516,378809,2014-08-27,Assembly,"AB 1666 GARCIA  Concurrence in Senate Amendments",78,0,0,1,79
619520,363033,2014-05-07,Assembly,"Do pass",1,5,0,1,7
619523,358398,2014-04-22,Senate,"Do pass, but re-refer to the Committee on Judiciary Recommend 	Consent",4,0,1,0,5
619523,361135,2014-04-29,Senate,"Do pass, but re-refer to the Committee on Appropriations Recommend 	Consent",7,0,0,0,7
619523,363787,2014-05-12,Senate,"Placed on Appropriations Suspense file",7,0,0,0,7
619523,367003,2014-05-23,Senate,"Do pass",7,0,0,0,7
619523,367535,2014-05-27,Senate,"Senate 3rd Reading SB996 Evans",34,0,6,0,40
619523,372187,2014-06-17,Assembly,"Do pass and be re-referred to the Committee on Judiciary to Consent 	Calendar",6,0,0,1,7
619523,374123,2014-06-24,Assembly,"Do pass and re-refer to Committee on Appropriations with 	recommendation:  To Consent Calendar",9,0,0,1,10
619523,377231,2014-08-14,Assembly,"Do pass",17,0,0,0,17
619523,377837,2014-08-19,Assembly,"SB 996 Evans  Senate Third Reading  By STONE",78,0,0,1,79
619526,348089,2014-03-25,Assembly,"Do pass and be re-referred to the Committee on Appropriations",6,0,0,1,7
619530,345259,2014-03-18,Assembly,"Do pass and be re-referred to the Committee on Appropriations",12,0,0,1,13
619530,354586,2014-04-09,Assembly,"Do pass, to Consent Calendar",17,0,0,0,17
619530,359554,2014-04-24,Assembly,"AB 1668 WIECKOWSKI  Consent Calendar Second Day  Regular Session",75,0,0,4,79
619530,370820,2014-06-11,Senate,"Do pass, but re-refer to the Committee on Appropriations",7,0,0,0,7
619530,375717,2014-07-03,Senate,"Special Consent #18 AB1668 Wieckowski",35,0,5,0,40
619532,358432,2014-04-21,Senate,"Do pass, but re-refer to the Committee on Appropriations",5,0,4,0,9
619532,365272,2014-05-19,Senate,"Senate 3rd Reading SB993 Mitchell",32,0,8,0,40
619532,374050,2014-06-24,Assembly,"Do pass as amended and re-refer to Committee on Appropriations 	with recommendation:  To Consent Calendar",14,0,0,0,14
619532,376663,2014-08-06,Assembly,"Do pass, to Consent Calendar",17,0,0,0,17
619532,377806,2014-08-19,Assembly,"SB 993 Mitchell  Senate Third Reading  By BONILLA",78,0,0,1,79
619532,377957,2014-08-20,Senate,"Unfinished Business SB993 Mitchell Concurrence",33,0,7,0,40
619535,354323,2014-04-09,Assembly,"Do pass and be re-referred to the Committee on Revenue and Taxation",9,0,0,0,9
619535,360454,2014-04-28,Assembly,"Do pass as amended and be re-referred to the Committee on 	Appropriations",8,0,0,1,9
619537,359146,2014-04-23,Assembly,"Do pass and be re-referred to the Committee on Appropriations",4,6,0,3,13
619537,359147,2014-04-23,Assembly,"Reconsideration granted",13,0,0,0,13
619542,370090,2014-06-05,Assembly,"From committee:  Be adopted.  To third reading",10,0,0,1,11
619542,377745,2014-08-19,Senate,"Assembly 3rd Reading ACR96 Olsen By Padilla",33,0,7,0,40
619544,353277,2014-04-08,Assembly,"Do pass, to Consent Calendar",10,0,0,0,10
619544,357964,2014-04-21,Assembly,"AB 1659 CHAU  Consent Calendar Second Day  Regular Session",77,0,0,2,79
619544,372989,2014-06-17,Senate,"Do pass and be placed on the Consent Calendar",6,0,1,0,7
619544,374875,2014-06-26,Senate,"Consent Calendar 2nd AB1659 Chau",32,0,8,0,40
619547,350196,2014-04-01,Senate,"Do pass",11,0,0,0,11
619547,352713,2014-04-07,Senate,"Senate 3rd Reading SB992 Nielsen Urgency Clause",36,0,4,0,40
619547,372538,2014-06-18,Assembly,"Do pass",6,0,0,1,7
619547,378526,2014-08-26,Assembly,"SB 992 Nielsen  Third Reading Urgency  By GONZALEZ",79,0,0,0,79
619547,378781,2014-08-27,Senate,"Unfinished Business SB992 Nielsen Concurrence",36,0,4,0,40
619549,353232,2014-04-08,Senate,"Do pass, but re-refer to the Committee on Transportation and 	Housing",6,0,1,0,7
619549,362233,2014-05-05,Senate,"Placed on Appropriations Suspense file",7,0,0,0,7
619553,346573,2014-03-19,Assembly,"Do pass and be re-referred to the Committee on Arts, Entertain, 	Sports, Tourism, & Internet Media to Consent Calendar",6,0,0,1,7
619553,360747,2014-04-29,Assembly,"Do pass and be re-referred to the Committee on Appropriations",7,0,0,0,7
619553,364588,2014-05-14,Assembly,"Do pass, to Consent Calendar",17,0,0,0,17
619553,366969,2014-05-23,Assembly,"AB 1680 WILK  Consent Calendar Second Day  Regular Session",73,0,0,6,79
619553,370916,2014-06-11,Senate,"Do pass, but re-refer to the Committee on Appropriations",5,0,0,0,5
619553,375649,2014-07-03,Senate,"Special Consent #18 AB1680 Wilk",35,0,5,0,40
619553,376756,2014-08-07,Assembly,"AB 1680 WILK  Concurrence in Senate Amendments",76,0,0,3,79
619556,359282,2014-04-23,Assembly,"Do pass",1,5,0,1,7
619559,350377,2014-04-01,Assembly,"Do pass and be re-referred to the Committee on Appropriations",13,0,0,0,13
619563,355327,2014-04-09,Assembly,"Do pass as amended and be re-referred to the Committee on 	Appropriations",7,0,0,0,7
619563,367209,2014-05-23,Assembly,"Do pass",17,0,0,0,17
619563,367436,2014-05-27,Assembly,"AB 1664 HAGMAN  Assembly Third Reading",76,0,0,3,79
619563,372999,2014-06-18,Senate,"Do pass, but re-refer to the Committee on Appropriations",7,0,0,0,7
619563,376768,2014-08-07,Senate,"Assembly 3rd Reading AB1664 Hagman By Huff",36,0,4,0,40
619568,353237,2014-04-07,Assembly,"Do pass, to Consent Calendar",12,0,0,0,12
619568,358035,2014-04-21,Assembly,"AB 1679 HARKEY  Consent Calendar Second Day",77,0,0,2,79
619571,358932,2014-04-22,Assembly,"Do pass as amended and be re-referred to the Committee on 	Appropriations",14,0,0,0,14
619571,366993,2014-05-23,Assembly,"Do pass as amended",16,0,0,1,17
619571,368256,2014-05-28,Assembly,"AB 1665 JONES  Assembly Third Reading",77,1,0,1,79
619571,374124,2014-06-23,Senate,"Do pass as amended, and re-refer to the Committee on 	Appropriations",8,0,1,0,9
619571,376604,2014-08-04,Senate,"Do pass",7,0,0,0,7
619571,377737,2014-08-18,Senate,"Assembly 3rd Reading AB1665 Jones By Lieu",36,0,4,0,40
619571,377937,2014-08-20,Assembly,"AB 1665 JONES  Concurrence in Senate Amendments",75,2,0,2,79
619574,350273,2014-04-01,Assembly,"Do pass as amended and be re-referred to the Committee on 	Appropriations",6,0,0,1,7
619574,361314,2014-04-30,Assembly,"Do pass",17,0,0,0,17
619574,363419,2014-05-08,Assembly,"AB 1673 GARCIA  Assembly Third Reading",75,0,0,4,79
619574,374419,2014-06-24,Senate,"Do pass, but re-refer to the Committee on Appropriations Recommend 	Consent",5,0,0,0,5
619574,378607,2014-08-26,Senate,"Assembly 3rd Reading AB1673 Garcia By Lara",35,0,5,0,40
619574,378774,2014-08-27,Assembly,"AB 1673 GARCIA  Concurrence in Senate Amendments",78,0,0,1,79
619578,347156,2014-03-24,Assembly,"Do pass as amended",15,0,0,1,16
619578,352701,2014-04-07,Assembly,"AB 1669 WAGNER  Assembly Third Reading",74,0,0,5,79
619578,374143,2014-06-24,Senate,"Do pass",9,1,1,0,11
619578,376857,2014-08-07,Senate,"Assembly 3rd Reading AB1669 Wagner By Walters",36,0,4,0,40
619578,376912,2014-08-11,Assembly,"AB 1669 WAGNER  Concurrence in Senate Amendments",79,0,0,0,79
619583,331449,2014-02-27,Assembly,"From committee:  Be adopted.  To third reading",11,0,0,0,11
619587,360710,2014-04-29,Assembly,"Do pass",7,3,0,0,10
619587,361630,2014-05-01,Assembly,"AB 1660 ALEJO  Assembly Third Reading",50,17,0,12,79
619587,370943,2014-06-10,Senate,"Do pass",6,1,0,0,7
619587,378507,2014-08-26,Senate,"Assembly 3rd Reading AB1660 Alejo By Lara",27,3,10,0,40
619587,378725,2014-08-27,Assembly,"AB 1660 ALEJO  Concurrence in Senate Amendments",57,19,0,3,79
619589,360719,2014-04-29,Assembly,"Do pass and be re-referred to the Committee on Appropriations",1,0,0,6,7
619592,358485,2014-04-22,Senate,"Do pass, but re-refer to the Committee on Appropriations",8,1,0,0,9
619592,362321,2014-05-05,Senate,"Do pass as amended",5,2,0,0,7
619592,364931,2014-05-15,Senate,"Senate 3rd Reading SB987 Monning",27,9,4,0,40
619592,372382,2014-06-17,Assembly,"Do pass and be re-referred to the Committee on Revenue and Taxation",12,0,0,3,15
619592,374773,2014-06-25,Assembly,"Do pass and be re-referred to the Committee on Appropriations",7,0,0,2,9
619592,376711,2014-08-06,Assembly,"Do pass",17,0,0,0,17
619592,377253,2014-08-14,Assembly,"SB 987 Monning  Senate Third Reading  By STONE",74,0,0,5,79
620338,360816,2014-04-29,Assembly,"Do pass as amended and be re-referred to the Committee on 	Appropriations",7,0,0,0,7
620338,364460,2014-05-14,Assembly,"Do pass, to Consent Calendar",17,0,0,0,17
620338,366866,2014-05-23,Assembly,"AB 1707 WILK  Consent Calendar Second Day  Regular Session",73,0,0,6,79
620338,373033,2014-06-18,Senate,"Do pass, but re-refer to the Committee on Appropriations",7,0,0,0,7
620338,377111,2014-08-13,Senate,"Assembly 3rd Reading AB1707 Wilk By Knight",36,0,4,0,40
620338,377780,2014-08-19,Assembly,"AB 1707 WILK  Concurrence in Senate Amendments",78,0,0,1,79
620341,360550,2014-04-28,Assembly,"Do pass",12,4,0,0,16
620341,361707,2014-05-01,Assembly,"AB 1696 WIECKOWSKI  Assembly Third Reading",53,21,0,5,79
620341,374186,2014-06-24,Senate,"Do pass",8,2,0,0,10
620344,348082,2014-03-26,Assembly,"Do pass and be re-referred to the Committee on Appropriations",6,0,0,1,7
620344,354290,2014-04-09,Assembly,"Do pass, to Consent Calendar",17,0,0,0,17
620344,359559,2014-04-24,Assembly,"AB 1722 BIGELOW  Consent Calendar Second Day  Regular Session",75,0,0,4,79
620344,372251,2014-06-17,Senate,"Do pass, but re-refer to the Committee on Appropriations Recommend 	Consent",5,0,0,0,5
620344,375700,2014-07-03,Senate,"Consent Calendar 2nd AB1722 Bigelow",35,0,5,0,40
620345,348233,2014-03-25,Assembly,"Do pass and be re-referred to the Committee on Appropriations",2,5,0,0,7
620345,348234,2014-03-25,Assembly,"Reconsideration granted",7,0,0,0,7
620345,360671,2014-04-29,Assembly,"Do pass and be re-referred to the Committee on Appropriations",2,5,0,0,7
620347,360857,2014-04-28,Assembly,"Do pass",15,0,0,1,16
620347,363375,2014-05-08,Assembly,"AB 1720 BLOOM  Assembly Third Reading",71,0,0,8,79
620347,372120,2014-06-17,Senate,"Do pass",11,0,0,0,11
620347,375699,2014-07-03,Senate,"Special Consent #18 AB1720 Bloom",35,0,5,0,40
620347,376854,2014-08-07,Assembly,"AB 1720 BLOOM  Concurrence in Senate Amendments",76,0,0,3,79
620348,347602,2014-03-24,Assembly,"Do pass as amended and be re-referred to the Committee on 	Appropriations",15,0,0,0,15
620348,354235,2014-04-09,Assembly,"Do pass",16,0,0,1,17
620348,357938,2014-04-21,Assembly,"AB 1693 PEREA  Assembly Third Reading",75,1,0,3,79
620348,372509,2014-06-17,Senate,"Do pass as amended, and re-refer to the Committee on Appropriations",10,0,1,0,11
620348,376647,2014-08-04,Senate,"Placed on Appropriations Suspense file",7,0,0,0,7
620348,377535,2014-08-14,Senate,"Do pass as amended",5,0,2,0,7
620348,378047,2014-08-21,Senate,"Assembly 3rd Reading AB1693 Perea By Hill",29,0,11,0,40
620348,378204,2014-08-22,Assembly,"AB 1693 PEREA  Concurrence in Senate Amendments",72,1,0,6,79
620350,351434,2014-04-02,Assembly,"Be adopted, to Consent Calendar",12,0,0,1,13
620350,352775,2014-04-07,Assembly,"AJR 34 COOLEY  Consent Calendar Second Day  Regular Session",76,0,0,3,79
620350,359654,2014-04-24,Senate,"Special Consent #12 AJR34 Cooley",37,0,3,0,40
620352,361784,2014-04-30,Assembly,"Do pass and be re-referred to the Committee on Appropriations",5,1,0,1,7
620352,366903,2014-05-23,Assembly,"Do pass as amended",12,0,0,5,17
620352,368212,2014-05-28,Assembly,"AB 1719 WEBER  Assembly Third Reading",56,18,0,5,79
620352,374514,2014-06-25,Senate,"Do pass as amended, and re-refer to the Committee on Appropriations",4,2,1,0,7
620352,376477,2014-08-04,Senate,"Placed on Appropriations Suspense file",7,0,0,0,7
620352,377295,2014-08-14,Senate,"Do pass as amended",5,0,2,0,7
620352,378181,2014-08-21,Senate,"Assembly 3rd Reading AB1719 Weber By Liu",25,11,4,0,40
620352,378551,2014-08-26,Assembly,"AB 1719 WEBER  Concurrence in Senate Amendments",56,20,0,3,79
620354,347210,2014-03-24,Assembly,"Be adopted, and re-refer to Committee on Appropriations with 	recommendation:  To Consent Calendar",14,0,0,2,16
620354,354837,2014-04-09,Assembly,"Be adopted, to Consent Calendar",17,0,0,0,17
620354,358306,2014-04-21,Assembly,"ACR 97 BIGELOW  Consent Calendar Second Day  Regular Session",77,0,0,2,79
620354,362613,2014-05-06,Senate,"Be adopted, but re-refer to the Committee on Appropriations 	Recommend Consent",11,0,0,0,11
620354,366761,2014-05-23,Senate,"Consent Calendar 2nd ACR97 Bigelow",32,0,8,0,40
620357,353204,2014-04-07,Assembly,"Do pass as amended and be re-referred to the Committee on 	Environmental Safety and Toxic Materials",6,3,0,0,9
620357,361200,2014-04-29,Assembly,"Do pass and be re-referred to the Committee on Appropriations",5,2,0,0,7
620357,364241,2014-05-14,Assembly,"Do pass as amended",12,5,0,0,17
620357,366816,2014-05-23,Assembly,"AB 1699 BLOOM  Assembly Third Reading",47,13,0,19,79
620357,372591,2014-06-18,Senate,"Do pass as amended, and re-refer to the Committee on Judiciary",5,2,0,0,7
620357,374382,2014-06-24,Senate,"Do pass, but re-refer to the Committee on Appropriations",5,2,0,0,7
620357,378121,2014-08-21,Senate,"Assembly 3rd Reading AB1699 Bloom By Jackson",20,14,6,0,40
620357,378122,2014-08-21,Senate,"Assembly 3rd Reading AB1699 Bloom Reconsider",36,0,4,0,40
620358,358456,2014-04-21,Assembly,"Do pass and be re-referred to the Committee on Revenue and Taxation",9,0,0,6,15
620358,364386,2014-05-13,Assembly,"Do pass and be re-referred to the Committee on Appropriations",9,0,0,0,9
620358,366963,2014-05-23,Assembly,"Do pass",15,0,0,2,17
620358,368728,2014-05-29,Assembly,"AB 1717 PEREA  Third Reading Urgency",71,2,0,6,79
620358,372128,2014-06-17,Senate,"Do pass, but re-refer to the Committee on Governance and Finance",9,0,2,0,11
620358,374420,2014-06-25,Senate,"Do pass as amended, and re-refer to the Committee on Appropriations",6,0,1,0,7
620358,376951,2014-08-11,Senate,"Placed on Appropriations Suspense file",7,0,0,0,7
620358,377183,2014-08-14,Senate,"Do pass",5,0,2,0,7
620358,378504,2014-08-26,Senate,"Assembly 3rd Reading AB1717 Perea Urgency Clause",29,2,9,0,40
620358,378766,2014-08-27,Assembly,"AB 1717 PEREA  Concurrence in Senate Amendments",70,5,0,4,79
620360,353210,2014-04-08,Assembly,"Do pass and be re-referred to the Committee on Appropriations",14,0,0,0,14
620360,361100,2014-04-30,Assembly,"Do pass",16,0,0,1,17
620360,363380,2014-05-08,Assembly,"AB 1685 WILLIAMS  Assembly Third Reading",72,0,0,7,79
620360,371946,2014-06-16,Senate,"Do pass, but re-refer to the Committee on Appropriations",8,0,1,0,9
620360,375230,2014-06-30,Senate,"Do pass",6,0,1,0,7
620360,376888,2014-08-11,Senate,"Assembly 3rd Reading AB1685 Williams By Lieu",36,0,4,0,40
620363,354214,2014-04-08,Assembly,"Do pass as amended and be re-referred to the Committee on 	Appropriations",19,0,0,0,19
620364,361375,2014-04-30,Assembly,"Do pass as amended and be re-referred to the Committee on 	Appropriations",11,2,0,6,19
620367,347870,2014-03-25,Assembly,"Do pass and be re-referred to the Committee on Appropriations",6,0,0,1,7
620367,367168,2014-05-23,Assembly,"Do pass as amended",14,0,0,3,17
620367,368073,2014-05-28,Assembly,"AB 1703 HALL  Assembly Third Reading",71,2,0,6,79
620367,374465,2014-06-24,Senate,"Do pass, but re-refer to the Committee on Appropriations",4,0,1,0,5
620367,376599,2014-08-04,Senate,"Placed on Appropriations Suspense file",7,0,0,0,7
620370,348155,2014-03-25,Assembly,"Do pass and be re-referred to the Committee on Appropriations",7,0,0,0,7
620370,354788,2014-04-09,Assembly,"Do pass as amended, to Consent Calendar",17,0,0,0,17
620370,360114,2014-04-28,Assembly,"AB 1697 DONNELLY  Consent Calendar Second Day",78,0,0,1,79
620370,372230,2014-06-17,Senate,"Do pass",5,0,2,0,7
620370,377059,2014-08-13,Senate,"Assembly 3rd Reading AB1697 Donnelly By Hernandez",33,0,7,0,40
620371,360654,2014-04-29,Assembly,"Do pass and be re-referred to the Committee on Banking and Finance",6,3,0,1,10
620371,362662,2014-05-05,Assembly,"Do pass as amended",8,3,0,1,12
620371,367454,2014-05-27,Assembly,"AB 1710 DICKINSON  Assembly Third Reading",43,25,0,11,79
620371,374671,2014-06-24,Senate,"Do pass as amended",5,2,0,0,7
620371,378145,2014-08-21,Senate,"Assembly 3rd Reading AB1710 Dickinson By Monning",24,10,6,0,40
620371,378369,2014-08-25,Assembly,"AB 1710 DICKINSON  Concurrence in Senate Amendments",50,25,0,4,79
620373,350385,2014-04-01,Assembly,"Do pass as amended and be re-referred to the Committee on 	Appropriations",9,0,0,1,10
620373,361473,2014-04-30,Assembly,"Do pass, to Consent Calendar",17,0,0,0,17
620373,363490,2014-05-08,Assembly,"AB 1712 GOMEZ  Consent Calendar Second Day  Regular Session",73,0,0,6,79
620373,370926,2014-06-10,Senate,"Do pass as amended, and re-refer to the Committee on 	Appropriations",7,0,0,0,7
620373,375442,2014-06-30,Senate,"Placed on Appropriations Suspense file",6,0,1,0,7
620373,377563,2014-08-14,Senate,"Do pass",5,0,2,0,7
620373,378259,2014-08-22,Senate,"Assembly 3rd Reading AB1712 Gomez By Evans",33,0,7,0,40
620373,378474,2014-08-26,Assembly,"AB 1712 GOMEZ  Concurrence in Senate Amendments",79,0,0,0,79
620375,348419,2014-03-25,Assembly,"Do pass",7,0,0,0,7
620375,350265,2014-04-01,Assembly,"AB 1686 MEDINA  Assembly Third Reading",77,0,0,3,80
620375,364041,2014-05-13,Senate,"Do pass",6,0,1,0,7
620375,376938,2014-08-11,Senate,"Assembly 3rd Reading AB1686 Medina By Block",35,0,5,0,40
620375,377173,2014-08-14,Assembly,"AB 1686 MEDINA  Concurrence in Senate Amendments",79,0,0,0,79
620376,361108,2014-04-30,Assembly,"Do pass and be re-referred to the Committee on Local Government",7,0,0,0,7
620376,362960,2014-05-07,Assembly,"Do pass",8,0,0,1,9
620376,364805,2014-05-15,Assembly,"AB 1690 GORDON  Assembly Third Reading",76,0,0,3,79
620376,374103,2014-06-24,Senate,"Do pass as amended",11,0,0,0,11
620376,378141,2014-08-21,Senate,"Assembly 3rd Reading AB1690 Gordon By Beall",30,0,10,0,40
620376,378193,2014-08-22,Assembly,"AB 1690 GORDON  Concurrence in Senate Amendments",74,1,0,4,79
620378,358462,2014-04-22,Assembly,"Do pass as amended and be re-referred to the Committee on 	Appropriations",9,0,0,1,10
620378,363307,2014-05-07,Assembly,"Do pass, to Consent Calendar",17,0,0,0,17
620378,364864,2014-05-15,Assembly,"AB 1701 PATTERSON  Consent Calendar Second Day  Regular Session",78,0,0,1,79
620378,374488,2014-06-24,Senate,"Do pass as amended, and re-refer to the Committee on 	Appropriations",7,0,0,0,7
620378,376970,2014-08-11,Senate,"Assembly 3rd Reading AB1701 Patterson By Cannella",35,0,5,0,40
620378,377390,2014-08-14,Assembly,"AB 1701 PATTERSON  Concurrence in Senate Amendments",79,0,0,0,79
620378,378530,2014-08-26,Senate,"Assembly 3rd Reading AB1701 Patterson By Cannella",33,0,7,0,40
620378,378734,2014-08-27,Assembly,"AB 1701 PATTERSON  Concurrence in Senate Amendments",77,0,0,2,79
620382,361491,2014-04-30,Assembly,"Do pass",12,0,0,1,13
620382,362286,2014-05-05,Assembly,"AB 1705 WILLIAMS  Assembly Third Reading",74,0,0,5,79
620382,370545,2014-06-10,Senate,"Do pass as amended",8,0,2,0,10
620382,377474,2014-08-14,Senate,"Assembly 3rd Reading AB1705 Williams By Leno",35,0,5,0,40
620382,377637,2014-08-18,Assembly,"AB 1705 WILLIAMS  Concurrence in Senate Amendments",78,0,0,1,79
620383,350574,2014-04-01,Assembly,"Do pass as amended and be re-referred to the Committee on 	Appropriations",6,0,0,1,7
620383,361344,2014-04-30,Assembly,"Do pass, to Consent Calendar",17,0,0,0,17
620383,364811,2014-05-15,Assembly,"AB 1692 GARCIA  Assembly Third Reading",77,0,0,2,79
620383,374660,2014-06-24,Senate,"Do pass, but re-refer to the Committee on Appropriations",4,1,0,0,5
620383,378834,2014-08-27,Senate,"Assembly 3rd Reading AB1692 Garcia By Jackson",31,1,8,0,40
620383,378907,2014-08-28,Assembly,"AB 1692 GARCIA  Concurrence in Senate Amendments",79,0,0,0,79
620385,358734,2014-04-21,Assembly,"Do pass as amended",15,0,0,1,16
620385,361640,2014-05-01,Assembly,"AB 1721 LINDER  Assembly Third Reading",72,2,0,5,79
620385,370398,2014-06-10,Senate,"Do pass",10,0,1,0,11
620385,376987,2014-08-11,Senate,"Assembly 3rd Reading AB1721 Linder By Roth",36,0,4,0,40
620385,377244,2014-08-14,Assembly,"AB 1721 LINDER  Concurrence in Senate Amendments",76,2,0,1,79
620386,348128,2014-03-26,Assembly,"Do pass and be re-referred to the Committee on Appropriations",11,0,0,1,12
620386,354360,2014-04-09,Assembly,"Do pass, to Consent Calendar",17,0,0,0,17
620386,359636,2014-04-24,Assembly,"AB 1711 COOLEY  Consent Calendar Second Day  Regular Session",75,0,0,4,79
620386,370443,2014-06-10,Senate,"Do pass, but re-refer to the Committee on Environmental Quality 	Recommend Consent",8,0,2,0,10
620386,374691,2014-06-25,Senate,"Do pass, but re-refer to the Committee on Appropriations Recommend 	Consent",6,0,1,0,7
620386,378370,2014-08-25,Senate,"Assembly 3rd Reading AB1711 Cooley By DeSaulnier",34,0,6,0,40
620386,378454,2014-08-26,Assembly,"AB 1711 COOLEY  Concurrence in Senate Amendments",79,0,0,0,79
620388,350266,2014-04-01,Assembly,"Do pass as amended and be re-referred to the Committee on Public 	Safety",7,2,0,1,10
620389,358971,2014-04-21,Assembly,"Do pass",11,1,0,0,12
620389,359656,2014-04-24,Assembly,"AB 1700 MEDINA  Assembly Third Reading",73,1,0,5,79
620389,369821,2014-06-04,Senate,"Do pass as amended, and re-refer to the Committee on Judiciary",7,0,2,0,9
620389,372545,2014-06-17,Senate,"Do pass",6,0,1,0,7
620389,377054,2014-08-13,Senate,"Assembly 3rd Reading AB1700 Medina By Correa",35,0,5,0,40
620389,377627,2014-08-18,Assembly,"AB 1700 MEDINA  Concurrence in Senate Amendments",77,1,0,1,79
620392,350337,2014-04-01,Assembly,"Do pass",4,0,0,3,7
620392,368707,2014-05-29,Assembly,"AB 1698 WAGNER  Assembly Third Reading",74,2,0,3,79
620392,374320,2014-06-24,Senate,"Do pass",7,0,0,0,7
620392,376995,2014-08-11,Senate,"Assembly 3rd Reading AB1698 Wagner By Berryhill",36,0,4,0,40
620392,377464,2014-08-14,Assembly,"AB 1698 WAGNER  Concurrence in Senate Amendments",79,0,0,0,79
620394,353337,2014-04-08,Assembly,"Do pass as amended and be re-referred to the Committee on 	Appropriations",14,0,0,1,15
620394,366970,2014-05-23,Assembly,"Do pass",17,0,0,0,17
620394,367625,2014-05-27,Assembly,"AB 1709 FRAZIER  Assembly Third Reading",76,0,0,3,79
620394,374002,2014-06-24,Senate,"Do pass as amended, and re-refer to the Committee on Appropriations",9,0,0,0,9
620394,376494,2014-08-04,Senate,"Placed on Appropriations Suspense file",7,0,0,0,7
620394,377568,2014-08-14,Senate,"Do pass",5,0,2,0,7
620394,377983,2014-08-20,Senate,"Assembly 3rd Reading AB1709 Frazier By Berryhill",35,0,5,0,40
620394,378168,2014-08-21,Assembly,"AB 1709 FRAZIER  Concurrence in Senate Amendments",77,0,0,2,79
620398,350305,2014-04-01,Assembly,"Do pass and be re-referred to the Committee on Appropriations",6,0,0,1,7
620398,354483,2014-04-09,Assembly,"Do pass",15,1,0,1,17
620398,359822,2014-04-24,Assembly,"AB 1716 GARCIA  Assembly Third Reading",73,1,0,5,79
620398,372468,2014-06-17,Senate,"Do pass, but re-refer to the Committee on Appropriations",4,0,1,0,5
620398,375470,2014-06-30,Senate,"Placed on Appropriations Suspense file",6,0,1,0,7
620398,377536,2014-08-14,Senate,"Do pass",5,0,2,0,7
620398,377782,2014-08-19,Senate,"Assembly 3rd Reading AB1716 Garcia By Hill",29,1,10,0,40
620399,354677,2014-04-08,Assembly,"Do pass as amended and be re-referred to the Committee on 	Appropriations",7,0,0,0,7
620401,358735,2014-04-22,Assembly,"Do pass as amended and be re-referred to the Committee on 	Appropriations",14,0,0,0,14
620401,362976,2014-05-07,Assembly,"Do pass, to Consent Calendar",17,0,0,0,17
620401,364857,2014-05-15,Assembly,"AB 1702 MAIENSCHEIN  Consent Calendar Second Day  Regular Session",78,0,0,1,79
620401,371759,2014-06-16,Senate,"Do pass, but re-refer to the Committee on Appropriations",9,0,0,0,9
620401,377067,2014-08-13,Senate,"Assembly 3rd Reading AB1702 Maienschein By Mitchell",32,0,8,0,40
620404,354945,2014-04-08,Assembly,"Do pass",6,0,0,1,7
620404,362225,2014-05-05,Assembly,"AB 1687 CONWAY  Assembly Third Reading",76,0,0,3,79
620404,374596,2014-06-24,Senate,"Do pass and be placed on the Consent Calendar",4,0,1,0,5
620404,375651,2014-07-03,Senate,"Consent Calendar 2nd AB1687 Conway",35,0,5,0,40
620409,355123,2014-04-09,Senate,"Do pass, but re-refer to the Committee on Appropriations",5,2,2,0,9
620409,360054,2014-04-28,Senate,"Placed on Appropriations Suspense file",6,0,1,0,7
620409,366955,2014-05-23,Senate,"Do pass as amended",5,2,0,0,7
620409,368682,2014-05-29,Senate,"Senate 3rd Reading SB1000 Monning",21,13,6,0,40
620409,372254,2014-06-17,Assembly,"Do pass and be re-referred to the Committee on Business, 	Professions and Consumer Protection",7,8,0,4,19
620409,372255,2014-06-17,Assembly,"Set first hearing.  Failed passage.  Reconsideration granted",19,0,0,0,19
620410,361585,2014-04-30,Senate,"Do pass, but re-refer to the Committee on Appropriations",6,1,2,0,9
620410,365277,2014-05-19,Senate,"Placed on Appropriations Suspense file",7,0,0,0,7
620412,358419,2014-04-22,Senate,"Do pass, but re-refer to the Committee on Appropriations",7,0,0,0,7
620412,360057,2014-04-28,Senate,"Do pass",5,0,2,0,7
620412,361643,2014-05-01,Senate,"Senate 3rd Reading SB1015 Galgiani Urgency Clause",35,0,5,0,40
620412,370710,2014-06-10,Assembly,"Do pass and be re-referred to the Committee on Appropriations",7,0,0,0,7
620412,372801,2014-06-18,Assembly,"Do pass, to Consent Calendar",15,0,0,2,17
620412,374833,2014-06-26,Assembly,"SB 1015 Galgiani  Consent Calendar Second Day  Regular Session",76,0,0,3,79
620412,376372,2014-08-04,Senate,"Unfinished Business SB1015 Galgiani Concurrence",36,0,4,0,40
620413,348148,2014-03-26,Senate,"Do pass as amended, and re-refer to the Committee on Business, 	Professions and Economic Development",5,1,1,0,7
620413,358379,2014-04-21,Senate,"Do pass, but re-refer to the Committee on Appropriations",6,0,3,0,9
620413,363704,2014-05-12,Senate,"Placed on Appropriations Suspense file",7,0,0,0,7
620413,366719,2014-05-23,Senate,"Do pass as amended",5,1,1,0,7
620413,368678,2014-05-29,Senate,"Senate 3rd Reading SB1014 Jackson",33,3,4,0,40
620413,372119,2014-06-17,Assembly,"Do pass and be re-referred to the Committee on Business, 	Professions and Consumer Protection",6,1,0,0,7
620413,374010,2014-06-24,Assembly,"Do pass as amended and be re-referred to the Committee on 	Appropriations",13,0,0,1,14
620414,358519,2014-04-21,Senate,"Do pass",9,0,0,0,9
620414,362221,2014-05-05,Senate,"Senate 3rd Reading SB1012 Wyland",37,0,3,0,40
620414,372325,2014-06-17,Assembly,"Do pass",14,0,0,0,14
620414,377497,2014-08-14,Assembly,"SB 1012 Wyland  Senate Third Reading  By JONES",78,0,0,1,79
620414,377643,2014-08-18,Senate,"Unfinished Business SB1012 Wyland Concurrence",35,0,5,0,40
620417,363012,2014-05-07,Senate,"Do pass, but re-refer to the Committee on Appropriations",9,0,0,0,9
620417,365375,2014-05-19,Senate,"Placed on Appropriations Suspense file",7,0,0,0,7
620417,366699,2014-05-23,Senate,"Do pass",7,0,0,0,7
620417,367518,2014-05-27,Senate,"Senate 3rd Reading SB1004 Hernandez",34,0,6,0,40
620417,372279,2014-06-17,Assembly,"Do pass and be re-referred to the Committee on Appropriations",18,0,0,1,19
620417,377537,2014-08-14,Assembly,"Do pass as amended",12,0,0,5,17
620417,378471,2014-08-26,Assembly,"SB 1004 Hernandez  Senate Third Reading  By EGGMAN",77,0,0,2,79
620417,378612,2014-08-27,Senate,"Unfinished Business SB1004 Hernandez Concurrence",36,0,4,0,40
620418,360642,2014-04-29,Senate,"Do pass, but re-refer to the Committee on Appropriations",4,2,1,0,7
620418,363755,2014-05-12,Senate,"Do pass",5,2,0,0,7
620418,368045,2014-05-28,Senate,"Senate 3rd Reading SB1010 Mitchell",21,12,7,0,40
620418,372143,2014-06-17,Assembly,"Do pass and be re-referred to the Committee on Appropriations",5,2,0,0,7
620418,372144,2014-06-17,Assembly,"Do pass and be re-referred to the Committee on Appropriations",5,1,0,1,7
620418,375534,2014-07-02,Assembly,"Do pass",12,3,0,2,17
620418,377205,2014-08-14,Assembly,"SB 1010 Mitchell  Senate Third Reading  By BRADFORD",50,19,0,10,79
620418,378126,2014-08-21,Senate,"Unfinished Business SB1010 Mitchell Concurrence",21,13,6,0,40
620421,353328,2014-04-08,Senate,"Do pass and be placed on the Consent Calendar",9,0,1,0,10
620421,359667,2014-04-24,Senate,"Consent Calendar 2nd SB1003 Evans",37,0,3,0,40
620423,359550,2014-04-24,Senate,"Do pass, but re-refer to the Committee on Appropriations",7,0,0,0,7
620423,363351,2014-05-08,Senate,"Special Consent #13 SB997 Morrell",35,0,5,0,40
620423,374863,2014-06-25,Assembly,"Do pass and be re-referred to the Committee on Appropriations",9,0,0,0,9
620423,375599,2014-07-02,Assembly,"Do pass, to Consent Calendar",17,0,0,0,17
620423,376740,2014-08-07,Assembly,"SB 997 Morrell  Senate Third Reading  By ALEJO",78,0,0,1,79
620423,376934,2014-08-11,Senate,"Unfinished Business SB997 Morrell Concurrence",36,0,4,0,40
620425,355110,2014-04-09,Senate,"Do pass as amended",11,0,0,0,11
620425,361577,2014-05-01,Senate,"Senate 3rd Reading SB1011 Monning",36,0,4,0,40
620425,374732,2014-06-25,Assembly,"Do pass as amended, to Consent Calendar",13,0,0,0,13
620425,375712,2014-07-03,Assembly,"SB 1011 Monning  Consent Calendar Second Day  Regular Session",76,0,0,3,79
620425,376962,2014-08-11,Assembly,"SB 1011 Monning  Senate Third Reading  By GAINES  Amend By GAINES 	Set #1",78,0,0,1,79
620425,377389,2014-08-14,Assembly,"SB 1011 Monning  Senate Third Reading  By GAINES",79,0,0,0,79
620425,377855,2014-08-19,Senate,"Unfinished Business SB1011 Monning",28,0,12,0,40
620429,347694,2014-03-25,Senate,"Do pass, but re-refer to the Committee on Appropriations",8,0,2,0,10
620429,359579,2014-04-24,Senate,"Special Consent #12 SB1009 Liu",37,0,3,0,40
620429,372593,2014-06-18,Assembly,"Do pass and be re-referred to the Committee on Appropriations",13,0,0,0,13
620429,375627,2014-07-02,Assembly,"Do pass, to Consent Calendar",17,0,0,0,17
620429,376774,2014-08-07,Assembly,"SB 1009 Liu  Consent Calendar Second Day  Regular Session",77,0,0,2,79
620431,358928,2014-04-22,Senate,"Do pass, but re-refer to the Committee on Education",4,0,1,0,5
620431,361578,2014-04-30,Senate,"Do pass as amended, but re-refer to the Committee on Appropriations 	Recommend Consent",9,0,0,0,9
620431,365442,2014-05-19,Senate,"Placed on Appropriations Suspense file",7,0,0,0,7
620432,348461,2014-03-26,Senate,"Do pass as amended, and re-refer to the Committee on Human Services",8,0,1,0,9
620432,353345,2014-04-08,Senate,"Do pass, but re-refer to the Committee on Appropriations Recommend 	Consent",5,0,0,0,5
620432,360110,2014-04-28,Senate,"Placed on Appropriations Suspense file",6,0,1,0,7
620432,367125,2014-05-23,Senate,"Do pass",7,0,0,0,7
620432,367432,2014-05-27,Senate,"Senate 3rd Reading SB1002 De Le",34,0,6,0,40
620432,370517,2014-06-10,Assembly,"Do pass and re-refer to Committee on Appropriations with 	recommendation:  To Consent Calendar",17,0,0,2,19
620432,377482,2014-08-14,Assembly,"Do pass as amended",12,0,0,5,17
620432,377982,2014-08-20,Assembly,"SB 1002 De Leon  Senate Third Reading  By NESTANDE",77,0,0,2,79
620432,378255,2014-08-22,Senate,"From committee:  That the Assembly Amendments be concurred in",4,0,1,0,5
620432,378414,2014-08-25,Senate,"Unfinished Business SB1002 De Le",34,0,6,0,40
620433,364401,2014-05-14,Senate,"Do pass as amended, and re-refer to the Committee on Appropriations",6,0,1,0,7
620433,373850,2014-06-23,Senate,"Placed on Appropriations Suspense file",7,0,0,0,7
621507,327575,2014-02-24,Assembly,"From committee:  Be adopted.  To third reading",10,0,0,1,11
621507,331439,2014-02-27,Assembly,"HR 32 MULLIN  Assembly Third Reading",78,0,0,2,80
621508,358401,2014-04-22,Assembly,"Do pass as amended and be re-referred to the Committee on 	Accountability and Administrative Review",6,0,0,3,9
621508,361340,2014-04-30,Assembly,"Do pass and be re-referred to the Committee on Appropriations",11,0,0,2,13
621511,350503,2014-04-01,Assembly,"Do pass as amended and be re-referred to the Committee on Local 	Government",5,0,0,2,7
621511,359421,2014-04-23,Assembly,"Do pass and be re-referred to the Committee on Appropriations",8,1,0,0,9
621511,363035,2014-05-07,Assembly,"Do pass",12,4,0,1,17
621511,364868,2014-05-15,Assembly,"AB 1728 GARCIA  Assembly Third Reading",56,16,0,7,79
621511,374618,2014-06-24,Senate,"Do pass, but re-refer to the Committee on Appropriations",5,0,0,0,5
621511,376432,2014-08-04,Senate,"Placed on Appropriations Suspense file",7,0,0,0,7
621511,377583,2014-08-14,Senate,"Do pass",5,0,2,0,7
621511,377997,2014-08-20,Senate,"Assembly 3rd Reading AB1728 Garcia By Cannella",27,7,6,0,40
621512,353498,2014-04-07,Assembly,"Do pass as amended and be re-referred to the Committee on 	Appropriations",6,3,0,0,9
621512,361103,2014-04-30,Assembly,"Do pass",12,5,0,0,17
621512,362209,2014-05-05,Assembly,"AB 1767 HOLDEN  Assembly Third Reading",55,18,0,6,79
621512,370595,2014-06-10,Senate,"Do pass as amended, and re-refer to the Committee on Appropriations",7,0,2,0,9
621512,377055,2014-08-13,Senate,"Assembly 3rd Reading AB1767 Holden By Pavley",25,6,9,0,40
621512,377634,2014-08-18,Assembly,"AB 1767 HOLDEN  Concurrence in Senate Amendments",55,19,0,5,79
621513,348127,2014-03-25,Assembly,"Do pass and be re-referred to the Committee on Appropriations",5,2,0,0,7
621513,366708,2014-05-23,Assembly,"Do pass",13,0,0,4,17
621513,368096,2014-05-28,Assembly,"AB 1756 SKINNER  Assembly Third Reading",61,13,0,5,79
621513,372244,2014-06-17,Senate,"Do pass, but re-refer to the Committee on Appropriations",5,0,2,0,7
621513,375282,2014-06-30,Senate,"Placed on Appropriations Suspense file",6,0,1,0,7
621519,353548,2014-04-08,Senate,"Do pass as amended",11,0,0,0,11
621519,361610,2014-05-01,Senate,"Senate 3rd Reading SB1025 Torres",36,0,4,0,40
621519,371732,2014-06-16,Assembly,"Do pass, to Consent Calendar",15,0,0,1,16
621519,373737,2014-06-23,Assembly,"SB 1025 Torres  Consent Calendar Second Day  Regular Session",75,0,0,4,79
621520,362882,2014-05-06,Assembly,"Do pass as amended",6,0,0,1,7
621520,365285,2014-05-19,Assembly,"AB 1752 FONG  Assembly Third Reading",74,0,0,5,79
621520,372336,2014-06-17,Senate,"Do pass and be placed on the Consent Calendar",3,0,2,0,5
621520,372337,2014-06-17,Senate,"Reconsideration granted",4,0,1,0,5
621520,372338,2014-06-17,Senate,"Do pass and be placed on the Consent Calendar",4,0,1,0,5
621520,372339,2014-06-17,Senate,"Reconsideration granted",4,0,1,0,5
621520,372803,2014-06-17,Senate,"Do pass and be placed on the Consent Calendar",4,0,1,0,5
621520,372804,2014-06-17,Senate,"Set, first hearing.  Held in Committee.  Reconsideration of 	favorable vote granted",4,0,1,0,5
621520,374277,2014-06-24,Senate,"Do pass",5,0,0,0,5
621520,377017,2014-08-11,Senate,"Assembly 3rd Reading AB1752 Fong By Anderson",36,0,4,0,40
621522,362684,2014-05-06,Assembly,"Do pass",19,0,0,0,19
621522,367012,2014-05-23,Assembly,"AB 1755 GOMEZ  Assembly Third Reading",75,0,0,4,79
621522,373111,2014-06-18,Senate,"Do pass, but re-refer to the Committee on Judiciary",8,0,1,0,9
621522,374494,2014-06-24,Senate,"Do pass as amended",7,0,0,0,7
621522,376810,2014-08-07,Senate,"Assembly 3rd Reading AB1755 Gomez By Lara",34,0,6,0,40
621522,377465,2014-08-14,Assembly,"AB 1755 GOMEZ  Concurrence in Senate Amendments",79,0,0,0,79
621523,361724,2014-04-30,Senate,"Do pass as amended, and re-refer to the Committee on Appropriations",8,1,0,0,9
621523,365476,2014-05-19,Senate,"Placed on Appropriations Suspense file",7,0,0,0,7
621523,367029,2014-05-23,Senate,"Do pass as amended",5,2,0,0,7
621523,368007,2014-05-28,Senate,"Senate 3rd Reading SB1028 Jackson",28,9,3,0,40
621523,374311,2014-06-24,Assembly,"Do pass as amended and be re-referred to the Committee on 	Appropriations",13,0,0,0,13
621523,376714,2014-08-06,Assembly,"Do pass",13,3,0,1,17
621523,378511,2014-08-26,Assembly,"SB 1028 Jackson  Senate Third Reading  By WILLIAMS",65,14,0,0,79
621523,378750,2014-08-27,Senate,"Unfinished Business SB1028 Jackson Concurrence",33,0,7,0,40
621524,359527,2014-04-24,Senate,"Do pass as amended, and re-refer to the Committee on Governance and 	Finance",5,3,1,0,9
621524,363050,2014-05-07,Senate,"Do pass as amended, and re-refer to the Committee on Appropriations",5,2,0,0,7
621524,365315,2014-05-19,Senate,"Placed on Appropriations Suspense file",7,0,0,0,7
621525,360741,2014-04-29,Assembly,"Do pass as amended and be re-referred to the Committee on 	Appropriations",18,0,0,1,19
621525,367107,2014-05-23,Assembly,"Do pass as amended",12,0,0,5,17
621525,368708,2014-05-29,Assembly,"AB 1771 PEREZ, V.M.  Assembly Third Reading",76,1,0,2,79
621525,373254,2014-06-18,Senate,"Do pass as amended, and re-refer to the Committee on 	Appropriations",7,1,1,0,9
621525,376901,2014-08-11,Senate,"Placed on Appropriations Suspense file",7,0,0,0,7
621526,336659,2014-03-06,Senate,"Special Consent #11 SCR81 Monning",32,0,7,0,39
621526,348878,2014-03-28,Assembly,"Be adopted, to Consent Calendar",10,0,0,1,11
621526,351757,2014-04-03,Assembly,"SCR 81 Monning  Consent Calendar Second Day  Regular Session",76,0,0,3,79
621526,355113,2014-04-10,Senate,"Unfinished Business SCR81 Monning Concurrence",34,0,6,0,40
621527,362849,2014-05-06,Assembly,"Do pass, to Consent Calendar",19,0,0,0,19
621527,365236,2014-05-19,Assembly,"AB 1727 RODRIGUEZ  Assembly Third Reading",76,0,0,3,79
621527,371151,2014-06-11,Senate,"Do pass as amended, and re-refer to the Committee on Business, 	Professions and Economic Development",9,0,0,0,9
621527,374004,2014-06-23,Senate,"Do pass",8,0,1,0,9
621527,375251,2014-06-30,Senate,"Assembly 3rd Reading AB1727 Rodriguez By Hill",35,0,5,0,40
621527,375660,2014-07-03,Assembly,"AB 1727 RODRIGUEZ  Concurrence in Senate Amendments",77,0,0,2,79
621528,363034,2014-05-07,Assembly,"Do pass as amended",3,0,0,4,7
621530,348231,2014-03-26,Senate,"Do pass as amended, and re-refer to the Committee on Human Services",9,0,0,0,9
621530,358532,2014-04-22,Senate,"Do pass as amended, and re-refer to the Committee on Appropriations",4,0,1,0,5
621530,363750,2014-05-12,Senate,"Placed on Appropriations Suspense file",7,0,0,0,7
621530,366737,2014-05-23,Senate,"Do pass as amended",7,0,0,0,7
621530,368620,2014-05-29,Senate,"Senate 3rd Reading SB1023 Liu",37,0,3,0,40
621530,372295,2014-06-17,Assembly,"Do pass as amended and be re-referred to the Committee on Higher 	Education",7,0,0,0,7
621530,374554,2014-06-24,Assembly,"Do pass and be re-referred to the Committee on Appropriations",13,0,0,0,13
621530,377356,2014-08-14,Assembly,"Do pass",17,0,0,0,17
621530,377830,2014-08-19,Assembly,"SB 1023 Liu  Senate Third Reading  By WILLIAMS",78,0,0,1,79
621530,377914,2014-08-20,Senate,"Unfinished Business SB1023 Liu Concurrence",33,0,7,0,40
621532,350290,2014-04-01,Assembly,"Do pass and be re-referred to the Committee on Transportation",19,0,0,0,19
621532,360461,2014-04-28,Assembly,"Do pass and be re-referred to the Committee on Appropriations",16,0,0,0,16
621532,366814,2014-05-23,Assembly,"Do pass as amended",17,0,0,0,17
621532,368150,2014-05-28,Assembly,"AB 1733 QUIRK-SILVA  Assembly Third Reading",77,0,0,2,79
621532,373377,2014-06-18,Senate,"Do pass, but re-refer to the Committee on Transportation and 	Housing",8,0,1,0,9
621532,374148,2014-06-24,Senate,"Do pass as amended, and re-refer to the Committee on 	Appropriations",11,0,0,0,11
621532,376424,2014-08-04,Senate,"Placed on Appropriations Suspense file",7,0,0,0,7
621532,377546,2014-08-14,Senate,"Do pass as amended",5,0,2,0,7
621532,378427,2014-08-25,Senate,"Assembly 3rd Reading AB1733 Quirk-Silva By DeSaulnier",34,0,6,0,40
621532,378711,2014-08-27,Assembly,"AB 1733 QUIRK-SILVA  Concurrence in Senate Amendments",78,0,0,1,79
621533,347567,2014-03-25,Assembly,"Do pass",13,6,0,0,19
621533,355184,2014-04-10,Assembly,"AB 1743 TING  Assembly Third Reading",45,28,0,6,79
621533,370955,2014-06-11,Senate,"Do pass, but re-refer to the Committee on Public Safety",7,2,0,0,9
621533,374714,2014-06-24,Senate,"Do pass",7,0,0,0,7
621533,376836,2014-08-07,Senate,"Assembly 3rd Reading AB1743 Ting By Monning",36,0,4,0,40
621533,377194,2014-08-14,Assembly,"AB 1743 TING  Concurrence in Senate Amendments",53,21,0,5,79
621534,358380,2014-04-22,Assembly,"Do pass and be re-referred to the Committee on Judiciary",16,0,0,3,19
621534,360624,2014-04-29,Assembly,"Do pass as amended and be re-referred to the Committee on 	Appropriations",9,1,0,0,10
621535,353222,2014-04-08,Senate,"Do pass as amended, and re-refer to the Committee on Appropriations",3,1,1,0,5
621535,360035,2014-04-28,Senate,"Placed on Appropriations Suspense file",6,0,1,0,7
621535,366973,2014-05-23,Senate,"Do pass as amended",5,2,0,0,7
621536,347200,2014-03-24,Assembly,"Do pass as amended and be re-referred to the Committee on 	Appropriations",8,0,0,1,9
621536,354458,2014-04-09,Assembly,"Do pass, to Consent Calendar",17,0,0,0,17
621536,359595,2014-04-24,Assembly,"AB 1765 JONES-SAWYER  Assembly Third Reading",74,0,0,5,79
621536,371016,2014-06-11,Senate,"Do pass, but re-refer to the Committee on Appropriations",7,0,0,0,7
621536,377835,2014-08-19,Senate,"Assembly 3rd Reading AB1765 Jones-Sawyer By Cannella",33,0,7,0,40
621536,378144,2014-08-21,Assembly,"AB 1765 JONES-SAWYER  Concurrence in Senate Amendments",76,0,0,3,79
621537,348240,2014-03-25,Assembly,"Do pass, to Consent Calendar",7,0,0,0,7
621537,350271,2014-04-01,Assembly,"AB 1772 WILLIAMS  Consent Calendar Second Day",78,0,0,2,80
621538,358389,2014-04-22,Assembly,"Do pass and be re-referred to the Committee on Appropriations",19,0,0,0,19
621538,366705,2014-05-23,Assembly,"Do pass as amended",12,0,0,5,17
621538,368016,2014-05-28,Assembly,"AB 1759 PAN  Assembly Third Reading",79,0,0,0,79
621538,374758,2014-06-25,Senate,"Do pass as amended, and re-refer to the Committee on 	Appropriations",8,0,1,0,9
621538,376510,2014-08-04,Senate,"Placed on Appropriations Suspense file",7,0,0,0,7
621539,358643,2014-04-21,Assembly,"Do pass and be re-referred to the Committee on Natural Resources",11,0,0,4,15
621539,360728,2014-04-28,Assembly,"Do pass as amended and be re-referred to the Committee on 	Appropriations",8,0,0,1,9
621539,364469,2014-05-14,Assembly,"Do pass",16,0,0,1,17
621539,365323,2014-05-19,Assembly,"AB 1763 PEREA  Assembly Third Reading",70,3,0,6,79
621540,360731,2014-04-29,Assembly,"Do pass and be re-referred to the Committee on Appropriations",9,5,0,1,15
621540,366908,2014-05-23,Assembly,"Do pass",12,5,0,0,17
621540,368178,2014-05-28,Assembly,"AB 1739 DICKINSON  Assembly Third Reading",48,24,0,7,79
621540,374014,2014-06-24,Senate,"Do pass, but re-refer to the Committee on Appropriations",7,1,1,0,9
621540,376868,2014-08-11,Senate,"Placed on Appropriations Suspense file",7,0,0,0,7
621540,377318,2014-08-14,Senate,"Do pass",5,0,2,0,7
621540,378752,2014-08-27,Senate,"Assembly 3rd Reading AB1739 Dickinson By Pavley",26,11,3,0,40
621540,379011,2014-08-29,Assembly,"AB 1739 DICKINSON  Concurrence in Senate Amendments",47,28,0,4,79
621541,352050,2014-04-02,Assembly,"Do pass and be re-referred to the Committee on Judiciary",5,1,0,1,7
621541,353341,2014-04-08,Assembly,"Do pass and be re-referred to the Committee on Appropriations",7,2,0,1,10
621541,367204,2014-05-23,Assembly,"Do pass",12,5,0,0,17
621541,368236,2014-05-28,Assembly,"AB 1723 NAZARIAN  Assembly Third Reading",54,24,0,1,79
621541,374701,2014-06-25,Senate,"Do pass, but re-refer to the Committee on Appropriations",4,1,0,0,5
621541,376464,2014-08-04,Senate,"Do pass",5,2,0,0,7
621541,378189,2014-08-21,Senate,"Assembly 3rd Reading AB1723 Nazarian By Hueso",22,11,7,0,40
621542,354473,2014-04-09,Senate,"Do pass",5,2,0,0,7
621542,362319,2014-05-05,Senate,"Senate 3rd Reading SB1021 Wolk",21,15,4,0,40
621542,374966,2014-06-25,Assembly,"Do pass",1,3,0,5,9
621543,359005,2014-04-22,Assembly,"Do pass and be re-referred to the Committee on Banking and Finance",10,0,0,0,10
621543,360515,2014-04-28,Assembly,"Do pass and be re-referred to the Committee on Appropriations",10,0,0,2,12
621543,364642,2014-05-14,Assembly,"Do pass, to Consent Calendar",17,0,0,0,17
621543,367124,2014-05-23,Assembly,"AB 1730 WAGNER  Consent Calendar Second Day  Regular Session",73,0,0,6,79
621543,372916,2014-06-17,Senate,"Do pass, but re-refer to the Committee on Public Safety Recommend 	Consent",6,0,1,0,7
621543,374363,2014-06-24,Senate,"Do pass, but re-refer to the Committee on Appropriations",6,1,0,0,7
621543,376544,2014-08-04,Senate,"Placed on Appropriations Suspense file",7,0,0,0,7
621543,377232,2014-08-14,Senate,"Do pass as amended",5,0,2,0,7
621543,378112,2014-08-21,Senate,"Assembly 3rd Reading AB1730 Wagner By Berryhill",33,0,7,0,40
621543,378246,2014-08-22,Assembly,"AB 1730 WAGNER  Concurrence in Senate Amendments",76,0,0,3,79
621546,354911,2014-04-09,Senate,"Do pass as amended, and re-refer to the Committee on Appropriations",6,0,3,0,9
621546,362298,2014-05-05,Senate,"Placed on Appropriations Suspense file",7,0,0,0,7
621546,367086,2014-05-23,Senate,"Do pass as amended",7,0,0,0,7
621546,368044,2014-05-28,Senate,"Senate 3rd Reading SB1022 Huff",36,0,4,0,40
621546,374492,2014-06-24,Assembly,"Do pass and be re-referred to the Committee on Appropriations",13,0,0,0,13
621546,376675,2014-08-06,Assembly,"Do pass, to Consent Calendar",17,0,0,0,17
621546,377448,2014-08-14,Assembly,"SB 1022 Huff  Consent Calendar Second Day  Regular Session",78,0,0,1,79
621546,377759,2014-08-19,Senate,"Unfinished Business SB1022 Huff Concurrence",31,0,9,0,40
621549,360130,2014-04-28,Senate,"Do pass",5,0,2,0,7
621549,375267,2014-06-30,Senate,"Senate 3rd Reading SB1031 De Le",27,3,10,0,40
621549,376718,2014-08-06,Assembly,"Do pass",12,5,0,0,17
621549,378188,2014-08-21,Assembly,"SB 1031 De Leon  Third Reading Urgency  By GATTO",61,15,0,3,79
621551,361201,2014-04-29,Assembly,"Do pass and be re-referred to the Committee on Appropriations",6,0,0,1,7
621551,364396,2014-05-14,Assembly,"Do pass, to Consent Calendar",17,0,0,0,17
621551,366932,2014-05-23,Assembly,"AB 1761 HALL  Consent Calendar Second Day  Regular Session",73,0,0,6,79
621551,370585,2014-06-10,Senate,"Do pass, but re-refer to the Committee on Judiciary Recommend 	Consent",4,0,1,0,5
621551,374394,2014-06-24,Senate,"Do pass, but re-refer to the Committee on Appropriations Recommend 	Consent",7,0,0,0,7
621551,376476,2014-08-04,Senate,"Placed on Appropriations Suspense file",7,0,0,0,7
621551,377308,2014-08-14,Senate,"Do pass",5,0,2,0,7
621551,377967,2014-08-20,Senate,"Assembly 3rd Reading AB1761 Hall By Beall",35,0,5,0,40
621552,358820,2014-04-22,Assembly,"Do pass and be re-referred to the Committee on Appropriations",14,0,0,0,14
621552,366844,2014-05-23,Assembly,"Do pass as amended",17,0,0,0,17
621552,368786,2014-05-29,Assembly,"AB 1758 PATTERSON  Assembly Third Reading",77,1,0,1,79
621552,374219,2014-06-23,Senate,"Do pass as amended, and re-refer to the Committee on 	Appropriations",8,0,1,0,9
621552,376446,2014-08-04,Senate,"Placed on Appropriations Suspense file",7,0,0,0,7
621553,348169,2014-03-25,Assembly,"Do pass as amended and be re-referred to the Committee on Business, 	Professions and Consumer Protection",7,0,0,0,7
621553,360603,2014-04-29,Assembly,"Do pass as amended and be re-referred to the Committee on 	Appropriations",14,0,0,0,14
621553,364384,2014-05-14,Assembly,"Do pass, to Consent Calendar",17,0,0,0,17
621553,367536,2014-05-27,Assembly,"AB 1735 HALL  Assembly Third Reading",76,0,0,3,79
621553,374358,2014-06-24,Senate,"Do pass as amended, and re-refer to the Committee on Appropriations",7,0,0,0,7
621553,376871,2014-08-11,Senate,"Assembly 3rd Reading AB1735 Hall By Knight",36,0,4,0,40
621553,377501,2014-08-14,Assembly,"AB 1735 HALL  Concurrence in Senate Amendments",78,0,0,1,79
621555,347066,2014-03-24,Assembly,"Be adopted, and re-refer to Committee on Appropriations with 	recommendation:  To Consent Calendar",14,0,0,2,16
621555,354438,2014-04-09,Assembly,"Be adopted, to Consent Calendar",17,0,0,0,17
621555,358285,2014-04-21,Assembly,"ACR 98 BIGELOW  Consent Calendar Second Day  Regular Session",77,0,0,2,79
621555,362770,2014-05-06,Senate,"Be adopted, but re-refer to the Committee on Appropriations 	Recommend Consent",11,0,0,0,11
621555,366929,2014-05-23,Senate,"Consent Calendar 2nd ACR98 Bigelow",32,0,8,0,40
621556,350961,2014-04-02,Senate,"Do pass, but re-refer to the Committee on Rules",6,0,1,0,7
621556,358377,2014-04-21,Senate,"Do pass, but re-refer to the Committee on Appropriations",9,0,0,0,9
621556,363748,2014-05-12,Senate,"Placed on Appropriations Suspense file",7,0,0,0,7
621556,367041,2014-05-23,Senate,"Do pass as amended",6,1,0,0,7
621556,368239,2014-05-28,Senate,"Senate 3rd Reading SB1019 Leno",29,6,5,0,40
621556,372193,2014-06-17,Assembly,"Do pass and be re-referred to the Committee on Business, 	Professions and Consumer Protection",6,1,0,0,7
621556,373989,2014-06-24,Assembly,"Do pass as amended and be re-referred to the Committee on 	Appropriations",10,2,0,2,14
621556,377159,2014-08-14,Assembly,"Do pass as amended",12,1,0,4,17
621556,378812,2014-08-27,Assembly,"SB 1019 Leno  Senate Third Reading  By GATTO",56,17,0,6,79
621556,378973,2014-08-28,Senate,"Unfinished Business SB1019 Leno Concurrence",29,5,6,0,40
621558,350204,2014-04-01,Senate,"Do pass, but re-refer to the Committee on Appropriations",5,0,0,0,5
621558,360281,2014-04-28,Senate,"Do pass",5,0,2,0,7
621558,361657,2014-05-01,Senate,"Senate 3rd Reading SB1018 De Le",35,0,5,0,40
621558,373516,2014-06-18,Assembly,"Do pass and be re-referred to the Committee on Appropriations",7,0,0,0,7
621558,377460,2014-08-14,Assembly,"Do pass as amended",17,0,0,0,17
621558,377888,2014-08-20,Assembly,"SB 1018 De Leon  Senate Third Reading  By OLSEN",78,0,0,1,79
621558,378019,2014-08-21,Senate,"Unfinished Business SB1018 De Le",36,0,4,0,40
621560,350432,2014-04-01,Assembly,"Do pass and re-refer to Committee on Appropriations with 	recommendation:  To Consent Calendar",7,0,0,0,7
621560,354306,2014-04-09,Assembly,"Do pass, to Consent Calendar",17,0,0,0,17
621560,359618,2014-04-24,Assembly,"AB 1768 FONG  Consent Calendar Second Day  Regular Session",75,0,0,4,79
621560,372347,2014-06-17,Senate,"Do pass and be placed on the Consent Calendar",4,0,1,0,5
621560,374947,2014-06-26,Senate,"Consent Calendar 2nd AB1768 Fong",32,0,8,0,40
621560,375721,2014-07-03,Assembly,"AB 1768 FONG  Concurrence in Senate Amendments",77,0,0,2,79
621561,355047,2014-04-09,Senate,"Do pass as amended, and re-refer to the Committee on 	Appropriations",8,0,1,0,9
621561,360094,2014-04-28,Senate,"Do pass",5,0,2,0,7
621561,361557,2014-05-01,Senate,"Senate 3rd Reading SB1034 Monning",35,0,5,0,40
621561,370452,2014-06-10,Assembly,"Do pass and re-refer to Committee on Appropriations with 	recommendation:  To Consent Calendar",17,0,0,2,19
621561,372780,2014-06-18,Assembly,"Do pass, to Consent Calendar",15,0,0,2,17
621561,375270,2014-06-30,Assembly,"SB 1034 Monning  Senate Third Reading  By PAN",77,0,0,2,79
621561,376354,2014-08-04,Senate,"Unfinished Business SB1034 Monning Concurrence",36,0,4,0,40
621562,348088,2014-03-26,Assembly,"Do pass as amended and be re-referred to the Committee on 	Appropriations",5,1,0,1,7
621562,367135,2014-05-23,Assembly,"Do pass as amended",13,4,0,0,17
621562,368204,2014-05-28,Assembly,"AB 1750 ALEJO  Assembly Third Reading",59,20,0,0,79
621562,372544,2014-06-18,Senate,"Do pass, but re-refer to the Committee on Appropriations",5,2,0,0,7
621562,375446,2014-06-30,Senate,"Placed on Appropriations Suspense file",6,0,1,0,7
621563,359186,2014-04-23,Assembly,"Do pass and re-refer to Committee on Appropriations with 	recommendation:  To Consent Calendar",13,0,0,0,13
621563,362964,2014-05-07,Assembly,"Do pass, to Consent Calendar",17,0,0,0,17
621563,364859,2014-05-15,Assembly,"AB 1746 ALEJO  Consent Calendar Second Day  Regular Session",78,0,0,1,79
621563,370945,2014-06-11,Senate,"Do pass, but re-refer to the Committee on Appropriations",5,0,0,0,5
621563,375646,2014-07-03,Senate,"Special Consent #18 AB1746 Alejo",35,0,5,0,40
621564,360715,2014-04-28,Assembly,"Do pass and be re-referred to the Committee on Appropriations",13,0,0,3,16
621564,363194,2014-05-07,Assembly,"Do pass",13,4,0,0,17
621564,368685,2014-05-29,Assembly,"AB 1724 FRAZIER  Assembly Third Reading",58,19,0,2,79
621566,362708,2014-05-05,Assembly,"Do pass as amended",6,1,0,2,9
621566,368720,2014-05-29,Assembly,"AB 1760 CHAU  Assembly Third Reading",55,20,0,4,79
621566,372856,2014-06-18,Senate,"Do pass",5,2,0,0,7
621566,378445,2014-08-26,Senate,"Assembly 3rd Reading AB1760 Chau By Jackson",24,8,8,0,40
621566,378657,2014-08-27,Assembly,"AB 1760 CHAU  Concurrence in Senate Amendments",57,17,0,5,79
621568,347976,2014-03-25,Assembly,"Do pass",10,1,0,4,15
621568,348881,2014-03-28,Assembly,"AB 1731 PEREA  Assembly Third Reading",52,12,0,16,80
621570,350411,2014-04-01,Senate,"Do pass and be placed on the Consent Calendar",11,0,0,0,11
621570,355041,2014-04-10,Senate,"Consent Calendar 2nd SB1033 Torres",34,0,6,0,40
621570,372718,2014-06-18,Assembly,"Do pass and be re-referred to the Committee on Local Government",6,0,0,1,7
621570,374508,2014-06-25,Assembly,"Do pass",9,0,0,0,9
621574,361067,2014-04-30,Assembly,"Do pass as amended and be re-referred to the Committee on Judiciary",7,0,0,0,7
621574,362655,2014-05-06,Assembly,"Do pass",10,0,0,0,10
621574,364806,2014-05-15,Assembly,"AB 1738 CHAU  Assembly Third Reading",77,0,0,2,79
621574,370863,2014-06-10,Senate,"Do pass as amended",7,0,0,0,7
621574,377290,2014-08-14,Senate,"Assembly 3rd Reading AB1738 Chau By Jackson",34,0,6,0,40
621574,377668,2014-08-18,Assembly,"AB 1738 CHAU  Concurrence in Senate Amendments",77,0,0,2,79
621575,351010,2014-04-01,Assembly,"Do pass and be re-referred to the Committee on Appropriations",5,2,0,0,7
621575,361385,2014-04-30,Assembly,"Do pass as amended",11,5,0,1,17
621575,368136,2014-05-28,Assembly,"AB 1751 BLOOM  Assembly Third Reading",52,23,0,4,79
621575,374580,2014-06-24,Senate,"Do pass, but re-refer to the Committee on Appropriations",3,1,1,0,5
621575,378034,2014-08-21,Senate,"Assembly 3rd Reading AB1751 Bloom By Beall",26,6,8,0,40
621575,378352,2014-08-25,Assembly,"AB 1751 BLOOM  Concurrence in Senate Amendments",55,23,0,1,79
621576,359728,2014-04-23,Assembly,"Do pass and re-refer to Committee on Appropriations with 	recommendation:  To Consent Calendar",7,0,0,0,7
621577,358495,2014-04-22,Assembly,"Do pass and re-refer to Committee on Appropriations with 	recommendation:  To Consent Calendar",14,0,0,0,14
621577,361151,2014-04-30,Assembly,"Do pass, to Consent Calendar",17,0,0,0,17
621577,363482,2014-05-08,Assembly,"AB 1732 STONE  Consent Calendar Second Day  Regular Session",73,0,0,6,79
621577,374483,2014-06-24,Senate,"Do pass as amended, and re-refer to the Committee on 	Appropriations",7,0,0,0,7
621577,377692,2014-08-18,Senate,"Assembly 3rd Reading AB1732 Stone By Lieu",36,0,4,0,40
621577,377810,2014-08-19,Assembly,"AB 1732 STONE  Concurrence in Senate Amendments",78,0,0,1,79
621578,353788,2014-04-08,Senate,"Do pass as amended, and re-refer to the Committee on 	Appropriations",7,0,0,0,7
621578,360100,2014-04-28,Senate,"Senate 3rd Reading SB1027 Hill",34,0,6,0,40
621578,370551,2014-06-10,Assembly,"Do pass and be re-referred to the Committee on Judiciary",11,0,0,3,14
621578,372173,2014-06-17,Assembly,"Do pass as amended",10,0,0,0,10
621578,375226,2014-06-30,Assembly,"SB 1027 Hill  Senate Third Reading  By DICKINSON",76,0,0,3,79
621578,376349,2014-08-04,Senate,"Unfinished Business SB1027 Hill Concurrence",36,0,4,0,40
621579,362705,2014-05-05,Assembly,"Do pass as amended",11,0,0,1,12
621579,365306,2014-05-19,Assembly,"AB 1770 DABABNEH  Assembly Third Reading",76,0,0,3,79
621579,372802,2014-06-18,Senate,"Do pass, but re-refer to the Committee on Judiciary",9,0,0,0,9
621579,374495,2014-06-24,Senate,"Do pass as amended. To Consent Calendar",7,0,0,0,7
621579,375693,2014-07-03,Senate,"Consent Calendar 2nd AB1770 Dababneh",35,0,5,0,40
621579,376373,2014-08-04,Assembly,"AB 1770 DABABNEH  Concurrence in Senate Amendments",77,1,0,1,79
621581,350917,2014-04-01,Assembly,"Do pass as amended and be re-referred to the Committee on 	Appropriations",7,0,0,0,7
621581,367132,2014-05-23,Assembly,"Do pass as amended",14,3,0,0,17
621581,368645,2014-05-29,Assembly,"AB 1744 BROWN  Assembly Third Reading",76,0,0,3,79
621581,374686,2014-06-24,Senate,"Do pass, but re-refer to the Committee on Appropriations",4,0,1,0,5
621581,376559,2014-08-04,Senate,"Placed on Appropriations Suspense file",7,0,0,0,7
621581,377513,2014-08-14,Senate,"Do pass as amended",5,0,2,0,7
621581,378425,2014-08-25,Senate,"Assembly 3rd Reading AB1744 Brown By Liu",34,0,6,0,40
621581,378816,2014-08-27,Assembly,"AB 1744 BROWN  Concurrence in Senate Amendments",77,0,0,2,79
621582,355162,2014-04-09,Assembly,"Do pass",7,0,0,0,7
621582,360073,2014-04-28,Assembly,"AB 1764 OLSEN  Assembly Third Reading",78,0,0,1,79
621582,372866,2014-06-18,Senate,"Do pass as amended. To Consent Calendar",7,0,0,0,7
621582,375212,2014-06-30,Senate,"Consent Calendar 2nd AB1764 Olsen",36,0,4,0,40
621582,378003,2014-08-20,Assembly,"AB 1764 OLSEN  Concurrence in Senate Amendments",78,0,0,1,79
622797,360612,2014-04-29,Assembly,"Do pass, to Consent Calendar",10,0,0,0,10
622797,362223,2014-05-05,Assembly,"AB 1843 JONES  Consent Calendar Second Day  Regular Session",75,0,0,4,79
622797,374301,2014-06-24,Senate,"Do pass as amended, but re-refer to the Committee on 	Appropriations Recommend Consent",7,0,0,0,7
622797,376753,2014-08-07,Senate,"Consent Calendar 2nd AB1843 Jones",34,0,6,0,40
622797,376952,2014-08-11,Assembly,"AB 1843 JONES  Concurrence in Senate Amendments",79,0,0,0,79
622800,361234,2014-04-29,Senate,"Do pass as amended, and re-refer to the Committee on Governance and 	Finance",11,0,0,0,11
622800,363198,2014-05-07,Senate,"Do pass",6,1,0,0,7
622800,363708,2014-05-12,Senate,"Senate 3rd Reading SB1037 Hernandez",31,2,7,0,40
622800,372551,2014-06-18,Assembly,"Do pass and be re-referred to the Committee on Transportation",9,0,0,0,9
622800,373719,2014-06-23,Assembly,"Do pass",14,0,0,2,16
622800,375233,2014-06-30,Assembly,"SB 1037 Hernandez  Senate Third Reading  By CHAU",76,0,0,3,79
622800,376367,2014-08-04,Senate,"Unfinished Business SB1037 Hernandez Concurrence",34,0,6,0,40
622801,360541,2014-04-28,Assembly,"Do pass and be re-referred to the Committee on Appropriations",5,2,0,2,9
622801,362938,2014-05-07,Assembly,"Do pass",12,5,0,0,17
622801,364883,2014-05-15,Assembly,"AB 1826 CHESBRO  Assembly Third Reading",54,22,0,3,79
622801,374306,2014-06-25,Senate,"Do pass as amended, and re-refer to the Committee on 	Appropriations",5,1,1,0,7
622801,376902,2014-08-11,Senate,"Assembly 3rd Reading AB1826 Chesbro By Hill",23,12,5,0,40
622801,377167,2014-08-14,Assembly,"AB 1826 CHESBRO  Concurrence in Senate Amendments",55,22,0,2,79
622802,360481,2014-04-29,Assembly,"Do pass as amended and be re-referred to the Committee on 	Appropriations",5,0,0,2,7
622802,364255,2014-05-14,Assembly,"Do pass",16,0,0,1,17
622802,365311,2014-05-19,Assembly,"AB 1791 MAIENSCHEIN  Assembly Third Reading",75,0,0,4,79
622802,374525,2014-06-24,Senate,"Do pass, but re-refer to the Committee on Appropriations",7,0,0,0,7
622802,377066,2014-08-13,Senate,"Assembly 3rd Reading AB1791 Maienschein By Cannella",36,0,4,0,40
622806,348141,2014-03-25,Assembly,"Do pass and be re-referred to the Committee on Revenue and Taxation",7,0,0,0,7
622806,364376,2014-05-13,Assembly,"Do pass and be re-referred to the Committee on Appropriations",8,0,0,1,9
622806,366835,2014-05-23,Assembly,"Do pass as amended",16,0,0,1,17
622806,368102,2014-05-28,Assembly,"AB 1839 GATTO  Assembly Third Reading",76,0,0,3,79
622806,374393,2014-06-25,Senate,"Do pass as amended, and re-refer to the Committee on Appropriations",6,0,1,0,7
622806,376859,2014-08-11,Senate,"Placed on Appropriations Suspense file",7,0,0,0,7
622806,377219,2014-08-14,Senate,"Do pass as amended",5,0,2,0,7
622806,379044,2014-08-29,Senate,"Assembly 3rd Supp 2 AB1839 Gatto By De Le",34,2,4,0,40
622806,379045,2014-08-29,Assembly,"AB 1839 GATTO  Concurrence in Senate Amendments",72,0,0,7,79
622809,359387,2014-04-22,Senate,"Do pass as amended, and re-refer to the Committee on Appropriations",4,1,0,0,5
622809,363687,2014-05-12,Senate,"Placed on Appropriations Suspense file",7,0,0,0,7
622809,366718,2014-05-23,Senate,"Do pass",5,2,0,0,7
622809,367440,2014-05-27,Senate,"Senate 3rd Reading SB1063 Block",21,12,7,0,40
622809,374308,2014-06-24,Assembly,"Do pass and be re-referred to the Committee on Appropriations",5,1,0,1,7
622809,376696,2014-08-06,Assembly,"Do pass",12,5,0,0,17
622809,377191,2014-08-14,Assembly,"SB 1063 Block  Senate Third Reading  By WEBER  Amend By WEBER  Set 	#1",54,24,0,1,79
622809,377619,2014-08-18,Assembly,"SB 1063 Block  Senate Third Reading  By WEBER",48,28,0,3,79
622809,378566,2014-08-26,Senate,"Unfinished Business SB1063 Block Concurrence",22,12,6,0,40
622810,360506,2014-04-29,Senate,"Do pass, but re-refer to the Committee on Appropriations",6,0,1,0,7
622810,363731,2014-05-12,Senate,"Placed on Appropriations Suspense file",7,0,0,0,7
622810,367068,2014-05-23,Senate,"Do pass as amended",7,0,0,0,7
622810,368022,2014-05-28,Senate,"Senate 3rd Reading SB1066 Galgiani",37,0,3,0,40
622810,372236,2014-06-17,Assembly,"Do pass and re-refer to Committee on Appropriations with 	recommendation:  To Consent Calendar",7,0,0,0,7
622810,375607,2014-07-02,Assembly,"Do pass as amended, to Consent Calendar",17,0,0,0,17
622810,377891,2014-08-20,Assembly,"SB 1066 Galgiani  Senate Third Reading  By QUIRK-SILVA",78,0,0,1,79
622810,378936,2014-08-28,Senate,"Unfinished Business SB1066 Galgiani Concurrence",35,0,5,0,40
622813,358430,2014-04-22,Assembly,"Do pass as amended and be re-referred to the Committee on 	Appropriations",14,0,0,0,14
622813,364756,2014-05-14,Assembly,"Do pass, to Consent Calendar",17,0,0,0,17
622813,367034,2014-05-23,Assembly,"AB 1809 MAIENSCHEIN  Consent Calendar Second Day  Regular Session",73,0,0,6,79
622813,374055,2014-06-23,Senate,"Do pass as amended, and re-refer to the Committee on 	Appropriations",8,0,1,0,9
622813,376998,2014-08-11,Senate,"Assembly 3rd Reading AB1809 Maienschein By Hill",35,0,5,0,40
622813,377489,2014-08-14,Assembly,"AB 1809 MAIENSCHEIN  Concurrence in Senate Amendments",79,0,0,0,79
622814,363025,2014-05-07,Senate,"Do pass as amended",9,0,0,0,9
622814,364890,2014-05-15,Senate,"Senate 3rd Reading SB1045 Beall",35,0,5,0,40
622814,370431,2014-06-10,Assembly,"Do pass as amended",17,0,0,2,19
622814,373718,2014-06-23,Assembly,"SB 1045 Beall  Senate Third Reading  By PAN",74,0,0,5,79
622814,374815,2014-06-26,Senate,"Unfinished Business SB1045 Beall Concurrence",29,0,11,0,40
622816,353213,2014-04-08,Senate,"Do pass",5,2,0,0,7
622816,362292,2014-05-05,Senate,"Senate 3rd Reading SB1038 Leno",23,13,4,0,40
622816,370458,2014-06-10,Assembly,"Do pass",5,2,0,0,7
622816,375276,2014-06-30,Assembly,"SB 1038 Leno  Senate Third Reading  By JONES-SAWYER",42,33,0,4,79
622816,376958,2014-08-11,Senate,"Unfinished Business SB1038 Leno Concurrence",22,12,6,0,40
622819,358530,2014-04-22,Senate,"Do pass, but re-refer to the Committee on Budget and Fiscal Review",6,0,1,0,7
622819,365405,2014-05-19,Senate,"Placed on Appropriations Suspense file",7,0,0,0,7
622819,366720,2014-05-23,Senate,"Do pass",7,0,0,0,7
622819,367980,2014-05-28,Senate,"Senate 3rd Reading SB1054 Steinberg",36,0,4,0,40
622819,372324,2014-06-17,Assembly,"Do pass as amended and be re-referred to the Committee on 	Appropriations",7,0,0,0,7
622819,377260,2014-08-14,Assembly,"Do pass as amended",12,0,0,5,17
622819,377894,2014-08-20,Assembly,"SB 1054 Steinberg  Senate Third Reading  By LOWENTHAL",76,0,0,3,79
622819,378133,2014-08-21,Senate,"Unfinished Business SB1054 Steinberg",34,0,6,0,40
622821,360526,2014-04-29,Assembly,"Do pass and be re-referred to the Committee on Appropriations",6,0,0,1,7
622821,361215,2014-04-29,Assembly,"Do pass and be re-referred to the Committee on Appropriations",6,0,0,1,7
622821,364561,2014-05-14,Assembly,"Do pass",16,0,0,1,17
622821,365404,2014-05-19,Assembly,"AB 1789 WILLIAMS  Assembly Third Reading",75,0,0,4,79
622821,372805,2014-06-18,Senate,"Do pass, but re-refer to the Committee on Appropriations",6,0,1,0,7
622821,375239,2014-06-30,Senate,"Placed on Appropriations Suspense file",6,0,1,0,7
622821,377364,2014-08-14,Senate,"Do pass",5,0,2,0,7
622821,378154,2014-08-21,Senate,"Assembly 3rd Reading AB1789 Williams By Hill",35,1,4,0,40
622822,359604,2014-04-24,Senate,"Do pass as amended, and re-refer to the Committee on Appropriations",7,1,1,0,9
622822,363781,2014-05-12,Senate,"Placed on Appropriations Suspense file",7,0,0,0,7
622822,366946,2014-05-23,Senate,"Do pass as amended",6,1,0,0,7
622822,368601,2014-05-29,Senate,"Senate 3rd Reading SB1057 Corbett",30,6,4,0,40
622822,374832,2014-06-25,Assembly,"Do pass as amended and be re-referred to the Committee on 	Appropriations",7,0,0,0,7
622822,377153,2014-08-14,Assembly,"Do pass",14,3,0,0,17
622822,378346,2014-08-25,Assembly,"SB 1057 Corbett  Senate Third Reading  By BUCHANAN",76,3,0,0,79
622822,378567,2014-08-26,Senate,"Unfinished Supp 1 SB1057 Corbett Concurrence",30,6,4,0,40
622824,358590,2014-04-22,Assembly,"Do pass and be re-referred to the Committee on Appropriations",6,12,0,1,19
622825,359104,2014-04-22,Assembly,"Do pass as amended and be re-referred to the Committee on 	Appropriations",8,4,0,1,13
622825,366945,2014-05-23,Assembly,"Do pass",12,5,0,0,17
622825,368062,2014-05-28,Assembly,"AB 1834 WILLIAMS  Assembly Third Reading",53,24,0,2,79
622825,373765,2014-06-23,Senate,"Do pass, but re-refer to the Committee on Appropriations",3,2,0,0,5
622825,376466,2014-08-04,Senate,"Placed on Appropriations Suspense file",7,0,0,0,7
622827,359810,2014-04-24,Senate,"Do pass as amended, and re-refer to the Committee on Appropriations",2,5,0,0,7
622827,359811,2014-04-24,Senate,"Set, first hearing.  Failed passage in Committee.  Reconsideration 	granted",7,0,0,0,7
622830,359512,2014-04-24,Senate,"Do pass, but re-refer to the Committee on Business, Professions and 	Economic Development Recommend Consent",8,0,1,0,9
622830,360135,2014-04-28,Senate,"Do pass as amended, and re-refer to the Committee on 	Appropriations",9,0,0,0,9
622830,363774,2014-05-12,Senate,"Placed on Appropriations Suspense file",7,0,0,0,7
622830,367055,2014-05-23,Senate,"Do pass",7,0,0,0,7
622832,351006,2014-04-02,Assembly,"Do pass and be re-referred to the Committee on Water, Parks and 	Wildlife",9,0,0,0,9
622832,360852,2014-04-29,Assembly,"Do pass as amended",14,0,0,1,15
622833,355175,2014-04-10,Assembly,"Be referred to Committee on Labor and Employment",7,0,0,4,11
622833,359509,2014-04-23,Assembly,"Do pass and be re-referred to the Committee on Appropriations",5,1,0,1,7
622833,366749,2014-05-23,Assembly,"Do pass as amended",12,5,0,0,17
622833,368223,2014-05-28,Assembly,"AB 1792 GOMEZ  Assembly Third Reading",52,26,0,1,79
622833,374822,2014-06-25,Senate,"Do pass as amended, and re-refer to the Committee on 	Appropriations",6,2,1,0,9
622833,376463,2014-08-04,Senate,"Placed on Appropriations Suspense file",7,0,0,0,7
622833,377380,2014-08-14,Senate,"Do pass as amended",5,0,2,0,7
622833,379063,2014-08-29,Assembly,"AB 1792 GOMEZ  Concurrence in Senate Amendments",53,24,0,2,79
622833,379064,2014-08-29,Senate,"Assembly 3rd Reading AB1792 Gomez By Hernandez",26,9,5,0,40
622835,347574,2014-03-25,Assembly,"Do pass",14,0,0,0,14
622835,348885,2014-03-28,Assembly,"AB 1810 MAIENSCHEIN  Assembly Third Reading",71,0,0,9,80
622835,370866,2014-06-10,Senate,"Do pass and be placed on the Consent Calendar",7,0,0,0,7
622835,371774,2014-06-16,Senate,"Consent Calendar 2nd AB1810 Maienschein",35,0,5,0,40
622835,373145,2014-06-19,Assembly,"AB 1810 MAIENSCHEIN  Concurrence in Senate Amendments",78,0,0,1,79
622837,361794,2014-04-30,Senate,"Do pass and be placed on the Consent Calendar",9,0,0,0,9
622837,363359,2014-05-08,Senate,"Consent Calendar 2nd SB1060 Liu",35,0,5,0,40
622837,370953,2014-06-11,Assembly,"Do pass as amended",5,0,0,2,7
622837,374790,2014-06-26,Assembly,"SB 1060 Liu  Senate Third Reading  By BUCHANAN",55,15,0,9,79
622837,376352,2014-08-04,Senate,"Unfinished Business SB1060 Liu Concurrence",34,0,6,0,40
622838,361318,2014-04-29,Assembly,"Do pass and be re-referred to the Committee on Appropriations",9,0,0,1,10
622838,366981,2014-05-23,Assembly,"Do pass as amended",16,0,0,1,17
622838,368085,2014-05-28,Assembly,"AB 1821 GORDON  Assembly Third Reading",78,0,0,1,79
622838,374074,2014-06-24,Senate,"Do pass, but re-refer to the Committee on Appropriations",6,0,1,0,7
622838,376657,2014-08-04,Senate,"Placed on Appropriations Suspense file",7,0,0,0,7
622838,377545,2014-08-14,Senate,"Do pass",5,0,2,0,7
622838,378251,2014-08-22,Senate,"Assembly 3rd Reading AB1821 Gordon By Roth",33,0,7,0,40
622838,378464,2014-08-26,Assembly,"AB 1821 GORDON  Concurrence in Senate Amendments",79,0,0,0,79
622840,359108,2014-04-23,Assembly,"Do pass and be re-referred to the Committee on Appropriations",6,0,0,1,7
622840,361179,2014-04-30,Assembly,"Do pass as amended, to Consent Calendar",17,0,0,0,17
622840,365275,2014-05-19,Assembly,"AB 1820 MULLIN  Assembly Third Reading",76,0,0,3,79
622840,373736,2014-06-23,Senate,"Do pass, but re-refer to the Committee on Appropriations Recommend 	Consent",5,0,0,0,5
622840,376750,2014-08-07,Senate,"Consent Calendar 2nd AB1820 Mullin",34,0,6,0,40
622842,350278,2014-04-01,Senate,"Do pass as amended, and re-refer to the Committee on Appropriations",9,0,2,0,11
622842,361651,2014-05-01,Senate,"Senate 3rd Reading SB1064 Hill",36,0,4,0,40
622842,370314,2014-06-09,Assembly,"Do pass and re-refer to Committee on Appropriations with 	recommendation:  To Consent Calendar",14,0,0,1,15
622842,375574,2014-07-02,Assembly,"Do pass, to Consent Calendar",17,0,0,0,17
622842,378275,2014-08-22,Assembly,"SB 1064 Hill  Senate Third Reading  By DICKINSON",76,0,0,3,79
622843,347550,2014-03-25,Assembly,"Do pass and be re-referred to the Committee on Governmental 	Organization",5,2,0,0,7
622843,354201,2014-04-02,Assembly,"Do pass and be re-referred to the Committee on Appropriations",14,0,0,5,19
622843,354202,2014-04-09,Assembly,"Do pass",12,4,0,1,17
622843,358330,2014-04-21,Assembly,"AB 1819 HALL  Assembly Third Reading",58,13,0,8,79
622843,370921,2014-06-11,Senate,"Do pass, but re-refer to the Committee on Appropriations",7,2,0,0,9
622843,377293,2014-08-14,Senate,"Assembly 3rd Reading AB1819 Hall By Hernandez",24,7,9,0,40
622843,377644,2014-08-18,Assembly,"AB 1819 HALL  Concurrence in Senate Amendments",61,11,0,7,79
622845,360753,2014-04-29,Senate,"Do pass, but re-refer to the Committee on Appropriations",9,0,0,0,9
622845,363735,2014-05-12,Senate,"Placed on Appropriations Suspense file",7,0,0,0,7
622845,366771,2014-05-23,Senate,"Do pass as amended",7,0,0,0,7
622845,368173,2014-05-28,Senate,"Senate 3rd Reading SB1036 Pavley",34,0,6,0,40
622845,372479,2014-06-17,Assembly,"Do pass and be re-referred to the Committee on Appropriations",13,0,0,2,15
622845,376726,2014-08-06,Assembly,"Do pass",13,4,0,0,17
622845,377701,2014-08-18,Assembly,"SB 1036 Pavley  Senate Third Reading  By WEBER",63,8,0,8,79
622846,350263,2014-04-01,Senate,"Do pass",7,0,0,0,7
622846,351923,2014-04-03,Senate,"Senate 3rd Reading SB1051 Galgiani",35,0,5,0,40
622846,370606,2014-06-09,Assembly,"Do pass and be re-referred to the Committee on Judiciary",12,0,0,0,12
622846,374077,2014-06-24,Assembly,"Do pass",9,0,0,1,10
622846,375661,2014-07-03,Assembly,"SB 1051 Galgiani  Senate Third Reading",77,0,0,2,79
622846,376360,2014-08-04,Senate,"Unfinished Business SB1051 Galgiani Concurrence",36,0,4,0,40
622851,360749,2014-04-28,Assembly,"Do pass and be re-referred to the Committee on Appropriations",9,0,0,0,9
622851,363023,2014-05-07,Assembly,"Do pass, to Consent Calendar",17,0,0,0,17
622851,364955,2014-05-15,Assembly,"AB 1796 LINDER  Consent Calendar Second Day  Regular Session",78,0,0,1,79
622851,372852,2014-06-18,Senate,"Do pass, but re-refer to the Committee on Appropriations Recommend 	Consent",7,0,0,0,7
622851,375668,2014-07-03,Senate,"Consent Calendar 2nd AB1796 Linder",35,0,5,0,40
622853,350761,2014-04-01,Assembly,"Do pass and be re-referred to the Committee on Appropriations",13,0,0,0,13
622853,354444,2014-04-09,Assembly,"Do pass, to Consent Calendar",17,0,0,0,17
622853,359657,2014-04-24,Assembly,"AB 1781 LINDER  Consent Calendar Second Day  Regular Session",75,0,0,4,79
622853,369834,2014-06-04,Senate,"Do pass as amended, but re-refer to the Committee on Appropriations 	Recommend Consent",6,0,1,0,7
622853,375643,2014-07-03,Senate,"Consent Calendar 2nd AB1781 Linder",35,0,5,0,40
622853,376346,2014-08-04,Assembly,"AB 1781 LINDER  Concurrence in Senate Amendments",77,0,0,2,79
622854,359878,2014-04-24,Senate,"Do pass as amended, and re-refer to the Committee on 	Appropriations",7,0,2,0,9
622854,363726,2014-05-12,Senate,"Placed on Appropriations Suspense file",7,0,0,0,7
622854,367079,2014-05-23,Senate,"Do pass as amended",6,1,0,0,7
622854,368698,2014-05-29,Senate,"Senate 3rd Reading SB1052 Torres",30,6,4,0,40
622854,374505,2014-06-24,Assembly,"Do pass as amended and be re-referred to the Committee on 	Appropriations",14,4,0,1,19
622854,377157,2014-08-14,Assembly,"Do pass as amended",12,0,0,5,17
622854,378278,2014-08-25,Assembly,"SB 1052 Torres  Senate Third Reading  By GONZALEZ",74,0,0,5,79
622854,378782,2014-08-27,Senate,"Unfinished Business SB1052 Torres Concurrence",34,0,6,0,40
622855,360510,2014-04-29,Assembly,"Do pass",14,0,0,0,14
622855,365319,2014-05-19,Assembly,"AB 1841 MULLIN  Assembly Third Reading",76,0,0,3,79
622855,373992,2014-06-23,Senate,"Do pass",8,0,1,0,9
622855,376929,2014-08-11,Senate,"Assembly 3rd Reading AB1841 Mullin By Hernandez",35,0,5,0,40
622855,377613,2014-08-18,Assembly,"AB 1841 MULLIN  Concurrence in Senate Amendments",77,0,0,2,79
622858,353254,2014-04-08,Senate,"Do pass, but re-refer to the Committee on Appropriations Recommend 	Consent",9,0,1,0,10
622858,361668,2014-05-01,Senate,"Consent Calendar 2nd SB1040 Evans",35,0,5,0,40
622859,359649,2014-04-23,Assembly,"Do pass and be re-referred to the Committee on Appropriations",7,0,0,0,7
622861,348093,2014-03-26,Assembly,"Do pass and re-refer to Committee on Appropriations with 	recommendation:  To Consent Calendar",6,0,0,1,7
622861,354207,2014-04-09,Assembly,"Do pass, to Consent Calendar",17,0,0,0,17
622861,359539,2014-04-24,Assembly,"AB 1806 BLOOM  Consent Calendar Second Day  Regular Session",75,0,0,4,79
622861,369848,2014-06-04,Senate,"Do pass, but re-refer to the Committee on Appropriations Recommend 	Consent",6,0,1,0,7
622861,373740,2014-06-23,Senate,"Placed on Appropriations Suspense file",7,0,0,0,7
622861,377190,2014-08-14,Senate,"Do pass",6,0,1,0,7
622861,378088,2014-08-21,Senate,"Assembly 3rd Reading AB1806 Bloom By DeSaulnier",36,0,4,0,40
622862,348099,2014-03-25,Assembly,"Do pass and re-refer to Committee on Appropriations with 	recommendation:  To Consent Calendar",7,0,0,0,7
622862,354505,2014-04-09,Assembly,"Do pass, to Consent Calendar",17,0,0,0,17
622862,359638,2014-04-24,Assembly,"AB 1775 MELENDEZ  Consent Calendar Second Day  Regular Session",75,0,0,4,79
622862,370572,2014-06-10,Senate,"Do pass, but re-refer to the Committee on Appropriations",6,0,1,0,7
622862,375683,2014-07-03,Senate,"Special Consent #18 AB1775 Melendez",35,0,5,0,40
622862,376783,2014-08-07,Assembly,"AB 1775 MELENDEZ  Concurrence in Senate Amendments",78,0,0,1,79
622863,348157,2014-03-26,Assembly,"Do pass and be re-referred to the Committee on Local Government",7,0,0,0,7
622863,361548,2014-04-30,Assembly,"Do pass and be re-referred to the Committee on Appropriations",9,0,0,0,9
622863,366242,2014-05-21,Assembly,"Do pass, to Consent Calendar",17,0,0,0,17
622863,367532,2014-05-27,Assembly,"AB 1793 CHAU  Consent Calendar Second Day  Regular Session",77,0,0,2,79
622863,374009,2014-06-24,Senate,"Do pass, but re-refer to the Committee on Appropriations Recommend 	Consent",11,0,0,0,11
622863,377742,2014-08-19,Senate,"Assembly 3rd Reading AB1793 Chau By DeSaulnier",32,0,8,0,40
622863,378675,2014-08-27,Assembly,"Senate amendments be concurred in",7,0,0,0,7
622863,378906,2014-08-28,Assembly,"AB 1793 CHAU  Concurrence in Senate Amendments",78,0,0,1,79
622866,359599,2014-04-24,Senate,"Do pass and be placed on the Consent Calendar",11,0,0,0,11
622866,361581,2014-05-01,Senate,"Consent Calendar 2nd SB1065 Monning",35,0,5,0,40
622866,374578,2014-06-25,Assembly,"Do pass, to Consent Calendar",13,0,0,0,13
622866,376689,2014-08-06,Assembly,"Do pass, to Consent Calendar",17,0,0,0,17
622867,361208,2014-04-29,Assembly,"Do pass and be re-referred to the Committee on Appropriations",6,0,0,1,7
622869,359181,2014-04-22,Assembly,"Do pass as amended and be re-referred to the Committee on 	Appropriations",6,0,0,3,9
622869,366888,2014-05-23,Assembly,"Do pass",13,0,0,4,17
622869,367452,2014-05-27,Assembly,"AB 1837 ATKINS  Assembly Third Reading",69,0,0,10,79
622869,374029,2014-06-23,Senate,"Do pass, but re-refer to the Committee on Appropriations",8,0,1,0,9
622869,376516,2014-08-04,Senate,"Placed on Appropriations Suspense file",7,0,0,0,7
622869,377258,2014-08-14,Senate,"Do pass",6,0,1,0,7
622869,378413,2014-08-25,Senate,"Assembly 3rd Reading AB1837 Atkins By Lieu",32,0,8,0,40
622869,378769,2014-08-27,Assembly,"AB 1837 ATKINS  Concurrence in Senate Amendments",74,0,0,5,79
622874,359449,2014-04-22,Senate,"Do pass, but re-refer to the Committee on Appropriations",4,1,0,0,5
622874,362390,2014-05-05,Senate,"Placed on Appropriations Suspense file",7,0,0,0,7
622875,353233,2014-04-08,Assembly,"Do pass as amended",7,0,0,0,7
622875,361204,2014-04-30,Assembly,"Do pass as amended, to Consent Calendar",17,0,0,0,17
622875,365258,2014-05-19,Assembly,"AB 1782 CHESBRO  Assembly Third Reading",76,0,0,3,79
622875,372275,2014-06-17,Senate,"Do pass as amended, and re-refer to the Committee on Appropriations",5,0,2,0,7
622875,376879,2014-08-11,Senate,"Assembly 3rd Reading AB1782 Chesbro By Fuller",35,0,5,0,40
622875,377349,2014-08-14,Assembly,"AB 1782 CHESBRO  Concurrence in Senate Amendments",79,0,0,0,79
622878,360531,2014-04-28,Assembly,"Do pass as amended and be re-referred to the Committee on 	Appropriations",9,0,0,0,9
622880,353493,2014-04-08,Assembly,"Set first hearing.  Failed passage.  Reconsideration granted",2,4,0,0,6
622880,359408,2014-04-08,Assembly,"Set first hearing.  Failed passage.  Reconsideration granted",6,0,0,0,6
622882,354414,2014-04-09,Assembly,"Do pass and be re-referred to the Committee on Appropriations",11,0,0,2,13
622885,348437,2014-03-26,Senate,"Do pass as amended, and re-refer to the Committee on Education",7,1,1,0,9
622885,361612,2014-04-30,Senate,"Do pass as amended, and re-refer to the Committee on Appropriations",8,1,0,0,9
622885,365336,2014-05-19,Senate,"Placed on Appropriations Suspense file",7,0,0,0,7
622885,366678,2014-05-23,Senate,"Do pass",7,0,0,0,7
622887,363328,2014-05-07,Assembly,"Do pass",7,0,0,2,9
622887,364869,2014-05-15,Assembly,"AB 1795 ALEJO  Assembly Third Reading  Amend By ALEJO  Set #1",55,21,0,3,79
622887,365286,2014-05-19,Assembly,"AB 1795 ALEJO  Assembly Third Reading",47,22,0,10,79
622887,372847,2014-06-18,Senate,"Do pass as amended",5,2,0,0,7
622887,378333,2014-08-25,Senate,"Assembly 3rd Reading AB1795 Alejo By Hueso",22,10,8,0,40
622887,378722,2014-08-27,Assembly,"AB 1795 ALEJO  Concurrence in Senate Amendments",53,19,0,7,79
622892,348133,2014-03-25,Assembly,"Do pass and be re-referred to the Committee on Business, 	Professions and Consumer Protection to Consent Calendar",7,0,0,0,7
622892,358450,2014-04-22,Assembly,"Do pass and re-refer to Committee on Appropriations with 	recommendation:  To Consent Calendar",14,0,0,0,14
622892,361220,2014-04-30,Assembly,"Do pass",16,1,0,0,17
622892,363377,2014-05-08,Assembly,"AB 1832 CALDERON  Assembly Third Reading",73,0,0,6,79
622892,371781,2014-06-16,Senate,"Do pass, but re-refer to the Committee on Appropriations Recommend 	Consent",9,0,0,0,9
622892,375666,2014-07-03,Senate,"Consent Calendar 2nd AB1832 Ian Calderon",35,0,5,0,40
622893,347590,2014-03-25,Assembly,"Do pass and be re-referred to the Committee on Appropriations",19,0,0,0,19
622893,354884,2014-04-09,Assembly,"Do pass, to Consent Calendar",17,0,0,0,17
622893,359743,2014-04-24,Assembly,"AB 1812 PAN  Consent Calendar Second Day  Regular Session",75,0,0,4,79
622893,371094,2014-06-11,Senate,"Do pass, but re-refer to the Committee on Appropriations Recommend 	Consent",9,0,0,0,9
622893,374890,2014-06-26,Senate,"Consent Calendar 2nd AB1812 Pan",32,0,8,0,40
622893,376796,2014-08-07,Assembly,"AB 1812 PAN  Concurrence in Senate Amendments",77,0,0,2,79
622895,353249,2014-04-08,Senate,"Do pass, but re-refer to the Committee on Appropriations Recommend 	Consent",7,0,0,0,7
622895,361661,2014-05-01,Senate,"Consent Calendar 2nd SB1050 Monning",35,0,5,0,40
622895,370574,2014-06-10,Assembly,"Do pass and re-refer to Committee on Appropriations with 	recommendation:  To Consent Calendar",9,0,0,1,10
622895,372762,2014-06-18,Assembly,"Do pass, to Consent Calendar",15,0,0,2,17
622895,374782,2014-06-26,Assembly,"SB 1050 Monning  Consent Calendar Second Day  Regular Session",76,0,0,3,79
622895,376361,2014-08-04,Senate,"Unfinished Business SB1050 Monning Concurrence",36,0,4,0,40
622897,358375,2014-04-21,Senate,"Do pass, but re-refer to the Committee on Health",9,0,0,0,9
622897,361655,2014-04-30,Senate,"Do pass as amended, but re-refer to the Committee on 	Appropriations Recommend Consent",7,0,2,0,9
622897,365316,2014-05-19,Senate,"Do pass",7,0,0,0,7
622897,366834,2014-05-23,Senate,"Special Consent #15 SB1039 Hernandez",32,0,8,0,40
622897,372211,2014-06-17,Assembly,"Do pass and be re-referred to the Committee on Health",14,0,0,0,14
622897,374456,2014-06-24,Assembly,"Do pass as amended and re-refer to Committee on Appropriations 	with recommendation:  To Consent Calendar",17,0,0,2,19
622897,376687,2014-08-06,Assembly,"Do pass, to Consent Calendar",17,0,0,0,17
622897,377185,2014-08-14,Assembly,"SB 1039 Hernandez  Consent Calendar Second Day  Regular Session",78,0,0,1,79
622897,377698,2014-08-18,Senate,"Unfinished Business SB1039 Hernandez Concurrence",35,0,5,0,40
622898,347330,2014-03-24,Assembly,"Do pass and be re-referred to the Committee on Appropriations",14,1,0,1,16
622900,360996,2014-04-28,Assembly,"Do pass",8,6,0,2,16
622900,360997,2014-04-28,Assembly,"Reconsideration granted",16,0,0,0,16
622900,361716,2014-05-01,Assembly,"Do pass",9,6,0,1,16
622900,367142,2014-05-23,Assembly,"AB 1835 OLSEN  Assembly Third Reading",44,23,0,12,79
622900,374169,2014-06-24,Senate,"Do pass as amended",10,0,1,0,11
622900,377363,2014-08-14,Senate,"Assembly 3rd Reading AB1835 Olsen By Berryhill",26,8,6,0,40
622900,377684,2014-08-18,Assembly,"AB 1835 OLSEN  Concurrence in Senate Amendments",49,15,0,15,79
622903,359180,2014-04-22,Senate,"Do pass, but re-refer to the Committee on Appropriations",5,0,0,0,5
622903,362276,2014-05-05,Senate,"Do pass",6,0,1,0,7
622903,364956,2014-05-15,Senate,"Special Consent #14 SB1043 Torres",36,0,4,0,40
622903,370395,2014-06-10,Assembly,"Do pass and be re-referred to the Committee on Appropriations",6,0,0,1,7
622903,372556,2014-06-18,Assembly,"Do pass, to Consent Calendar",15,0,0,2,17
622908,361849,2014-04-30,Senate,"Do pass as amended, and re-refer to the Committee on Appropriations",7,2,0,0,9
622908,365424,2014-05-19,Senate,"Placed on Appropriations Suspense file",7,0,0,0,7
622909,362865,2014-05-06,Assembly,"Do pass and be re-referred to the Committee on Revenue and Taxation",3,1,0,3,7
622911,358477,2014-04-22,Assembly,"Do pass and be re-referred to the Committee on Appropriations",19,0,0,0,19
622913,358369,2014-04-21,Assembly,"Do pass and be re-referred to the Committee on Appropriations",15,0,0,1,16
622913,366892,2014-05-23,Assembly,"Do pass as amended",13,0,0,4,17
622913,368008,2014-05-28,Assembly,"AB 1787 LOWENTHAL  Assembly Third Reading",72,5,0,2,79
622913,372305,2014-06-17,Senate,"Do pass, but re-refer to the Committee on Appropriations",11,0,0,0,11
622913,377929,2014-08-20,Senate,"Assembly 3rd Reading AB1787 Lowenthal By De Le",32,1,7,0,40
622913,378258,2014-08-22,Assembly,"AB 1787 LOWENTHAL  Concurrence in Senate Amendments",71,2,0,6,79
622914,358540,2014-04-21,Assembly,"Do pass",14,1,0,1,16
622914,361786,2014-05-01,Assembly,"AB 1811 BUCHANAN  Assembly Third Reading",71,2,0,6,79
622914,372169,2014-06-17,Senate,"Do pass",10,0,1,0,11
622914,374775,2014-06-26,Senate,"Assembly 3rd Reading AB1811 Buchanan By Corbett",30,1,9,0,40
622916,353208,2014-04-07,Assembly,"Do pass and be re-referred to the Committee on Utilities and 	Commerce",3,2,0,4,9
622916,353209,2014-04-07,Assembly,"Set first hearing.  Failed passage.  Reconsideration granted",9,0,0,0,9
622917,348190,2014-03-26,Assembly,"Do pass and re-refer to Committee on Appropriations with 	recommendation:  To Consent Calendar",6,0,0,1,7
622917,354272,2014-04-09,Assembly,"Do pass, to Consent Calendar",17,0,0,0,17
622917,359621,2014-04-24,Assembly,"AB 1825 NAZARIAN  Consent Calendar Second Day  Regular Session",75,0,0,4,79
622917,369831,2014-06-04,Senate,"Do pass as amended, but re-refer to the Committee on Appropriations 	Recommend Consent",6,0,1,0,7
622917,373766,2014-06-23,Senate,"Do pass",7,0,0,0,7
622917,375641,2014-07-03,Senate,"Special Consent #18 AB1825 Nazarian",35,0,5,0,40
622917,376363,2014-08-04,Assembly,"AB 1825 NAZARIAN  Concurrence in Senate Amendments",78,0,0,1,79
622918,336572,2014-03-06,Assembly,"From committee:  Be adopted.  To third reading",11,0,0,0,11
622922,350502,2014-04-01,Assembly,"From committee:  Be adopted.  To third reading",10,0,0,1,11
622922,352640,2014-04-07,Assembly,"AJR 35 PEREZ, J.  Assembly Third Reading",75,0,0,4,79
622922,359602,2014-04-24,Senate,"Special Consent #12 AJR35 John A. P",37,0,3,0,40
622924,361637,2014-04-30,Senate,"Do pass as amended, and re-refer to the Committee on Appropriations",7,1,1,0,9
622924,365531,2014-05-19,Senate,"Placed on Appropriations Suspense file",7,0,0,0,7
622926,353242,2014-04-08,Senate,"Do pass",6,1,0,0,7
622926,355076,2014-04-10,Senate,"Senate 3rd Reading SB1058 Leno",24,9,7,0,40
622926,370577,2014-06-10,Assembly,"Do pass",5,0,0,2,7
622926,373761,2014-06-23,Assembly,"SB 1058 Leno  Senate Third Reading  By MAIENSCHEIN",61,7,0,11,79
622926,377069,2014-08-13,Senate,"Unfinished Business SB1058 Leno Concurrence",26,9,5,0,40
622929,362694,2014-05-06,Assembly,"Do pass as amended",15,4,0,0,19
622929,366169,2014-05-21,Assembly,"Do pass",13,4,0,0,17
622929,367046,2014-05-23,Assembly,"AB 1840 CAMPOS  Assembly Third Reading",56,15,0,8,79
622929,373417,2014-06-18,Senate,"Do pass, but re-refer to the Committee on Education",7,1,1,0,9
622929,374532,2014-06-25,Senate,"Do pass as amended, and re-refer to the Committee on Appropriations",6,0,1,0,7
622929,378499,2014-08-26,Senate,"Assembly 3rd Reading AB1840 Campos By Correa",36,0,4,0,40
622929,378662,2014-08-27,Assembly,"AB 1840 CAMPOS  Concurrence in Senate Amendments",64,9,0,6,79
622930,353244,2014-04-08,Senate,"Do pass as amended, but re-refer to the Committee on 	Appropriations Recommend Consent",7,0,0,0,7
622930,361583,2014-05-01,Senate,"Consent Calendar 2nd SB1041 Jackson",35,0,5,0,40
622930,374177,2014-06-23,Assembly,"Do pass and be re-referred to the Committee on Appropriations",12,0,0,0,12
622930,375586,2014-07-02,Assembly,"Do pass, to Consent Calendar",17,0,0,0,17
622930,376903,2014-08-11,Assembly,"SB 1041 Jackson  Senate Third Reading  By ACHADJIAN",79,0,0,0,79
622930,377051,2014-08-13,Senate,"Unfinished Business SB1041 Jackson Concurrence",37,0,3,0,40
622932,363174,2014-05-07,Assembly,"Do pass",4,1,0,2,7
622932,367202,2014-05-23,Assembly,"AB 1824 RENDON  Assembly Third Reading",51,22,0,6,79
622932,373742,2014-06-23,Senate,"Do pass",3,2,0,0,5
622932,378435,2014-08-25,Senate,"Assembly 3rd Reading AB1824 Rendon By Lara",23,11,6,0,40
622933,347623,2014-03-25,Assembly,"Do pass",14,0,0,0,14
622933,348890,2014-03-28,Assembly,"AB 1838 BONILLA  Assembly Third Reading",71,0,0,9,80
622933,371698,2014-06-16,Senate,"Do pass and be placed on the Consent Calendar",9,0,0,0,9
622933,374803,2014-06-26,Senate,"Consent Calendar 2nd AB1838 Bonilla",32,0,8,0,40
622933,375232,2014-06-30,Assembly,"AB 1838 BONILLA  Concurrence in Senate Amendments",78,0,0,1,79
622935,358915,2014-04-22,Assembly,"Do pass as amended and be re-referred to the Committee on 	Appropriations",17,1,0,1,19
622935,366933,2014-05-23,Assembly,"Do pass as amended",17,0,0,0,17
622935,368151,2014-05-28,Assembly,"AB 1790 DICKINSON  Assembly Third Reading",78,0,0,1,79
622935,374784,2014-06-25,Senate,"Do pass, but re-refer to the Committee on Appropriations Recommend 	Consent",8,0,1,0,9
622935,376772,2014-08-07,Senate,"Consent Calendar 2nd AB1790 Dickinson By Beall",34,0,6,0,40
622935,377667,2014-08-18,Senate,"Assembly 3rd Reading AB1790 Dickinson By Beall",35,0,5,0,40
622935,377814,2014-08-19,Assembly,"AB 1790 DICKINSON  Concurrence in Senate Amendments",78,0,0,1,79
622938,359330,2014-04-23,Assembly,"Do pass and be re-referred to the Committee on Appropriations",5,1,0,1,7
622938,366730,2014-05-23,Assembly,"Do pass as amended",12,5,0,0,17
622938,368210,2014-05-28,Assembly,"AB 1783 JONES-SAWYER  Assembly Third Reading",56,22,0,1,79
622938,378263,2014-08-22,Senate,"Do pass as amended, and re-refer to the Committee on 	Appropriations",3,0,2,0,5
622938,378909,2014-08-28,Senate,"Do pass",6,0,1,0,7
622938,378989,2014-08-29,Assembly,"Senate amendments be concurred in",7,0,0,0,7
622938,378990,2014-08-29,Senate,"Assembly 3rd Supp 1 AB1783 Jones-Sawyer Urgency Clause",35,0,5,0,40
622938,378991,2014-08-29,Assembly,"AB 1783 JONES-SAWYER  Concurrence- Urgency Added",77,1,0,1,79
622940,358660,2014-04-22,Senate,"Do pass as amended, and re-refer to the Committee on Appropriations",8,1,0,0,9
622940,362194,2014-05-05,Senate,"Placed on Appropriations Suspense file",7,0,0,0,7
622941,358752,2014-04-22,Assembly,"Do pass, to Consent Calendar",6,0,0,1,7
622941,360036,2014-04-28,Assembly,"AB 1798 PUB. S.  Consent Calendar Second Day  Regular Session",78,0,0,1,79
622941,370664,2014-06-10,Senate,"Do pass",6,0,1,0,7
622941,374914,2014-06-26,Senate,"Special Consent #17 AB1798 Committee on PUB. S. (Ammiano)",32,0,8,0,40
622945,353236,2014-04-08,Senate,"Do pass as amended, and re-refer to the Committee on Elections and 	Constitutional Amendments",8,3,0,0,11
622945,359193,2014-04-22,Senate,"Do pass, but re-refer to the Committee on Appropriations",4,1,0,0,5
622945,362249,2014-05-05,Senate,"Placed on Appropriations Suspense file",7,0,0,0,7
622948,360730,2014-04-29,Assembly,"Do pass and be re-referred to the Committee on Appropriations",18,0,0,1,19
622951,358550,2014-04-22,Assembly,"Do pass and be re-referred to the Committee on Appropriations",2,5,0,0,7
622953,359167,2014-04-23,Assembly,"Do pass as amended",9,2,0,2,13
622953,368688,2014-05-29,Assembly,"AB 1804 PEREA  Assembly Third Reading",76,2,0,1,79
622953,374805,2014-06-25,Senate,"Do pass as amended",10,0,1,0,11
622953,377082,2014-08-13,Senate,"Assembly 3rd Reading AB1804 Perea By Monning",36,0,4,0,40
622953,377601,2014-08-18,Assembly,"AB 1804 PEREA  Concurrence in Senate Amendments",76,1,0,2,79
622954,354401,2014-04-08,Assembly,"Do pass and re-refer to Committee on Appropriations with 	recommendation:  To Consent Calendar",19,0,0,0,19
622954,361192,2014-04-30,Assembly,"Do pass, to Consent Calendar",17,0,0,0,17
622954,363407,2014-05-08,Assembly,"AB 1822 BONTA  Consent Calendar Second Day  Regular Session",73,0,0,6,79
622954,374860,2014-06-25,Senate,"Do pass, but re-refer to the Committee on Appropriations Recommend 	Consent",8,0,1,0,9
622954,376505,2014-08-04,Senate,"Do pass",7,0,0,0,7
622954,377413,2014-08-14,Senate,"Assembly 3rd Reading AB1822 Bonta By Hernandez",32,0,8,0,40
622954,377414,2014-08-14,Senate,"Assembly 3rd Reading AB1822 Bonta Reconsider",33,0,7,0,40
622954,378747,2014-08-27,Senate,"Assembly 3rd Reading AB1822 Bonta By Hernandez",36,0,4,0,40
622954,378900,2014-08-28,Assembly,"AB 1822 BONTA  Concurrence in Senate Amendments",78,0,0,1,79
622956,359716,2014-04-23,Assembly,"Do pass and be re-referred to the Committee on Appropriations",7,0,0,0,7
622956,363098,2014-05-07,Assembly,"Do pass",14,3,0,0,17
622956,364980,2014-05-15,Assembly,"AB 1797 RODRIGUEZ  Assembly Third Reading",64,12,0,3,79
622956,370923,2014-06-11,Senate,"Do pass, but re-refer to the Committee on Appropriations",5,0,0,0,5
622956,375255,2014-06-30,Senate,"Assembly 3rd Reading AB1797 Rodriguez By Hueso",29,7,4,0,40
622956,375664,2014-07-03,Assembly,"AB 1797 RODRIGUEZ  Concurrence in Senate Amendments",68,7,0,4,79
622959,358472,2014-04-22,Assembly,"Do pass and be re-referred to the Committee on Judiciary",6,12,0,1,19
622961,362819,2014-05-06,Assembly,"Do pass as amended",5,1,0,1,7
622961,365321,2014-05-19,Assembly,"AB 1817 GOMEZ  Assembly Third Reading",54,20,0,5,79
622961,371067,2014-06-11,Senate,"Do pass as amended, and re-refer to the Committee on Elections and 	Constitutional Amendments",5,2,0,0,7
622961,374518,2014-06-24,Senate,"Do pass",4,1,0,0,5
622961,375335,2014-06-30,Senate,"Assembly 3rd Reading AB1817 Gomez By Correa",26,9,5,0,40
622961,375711,2014-07-03,Assembly,"AB 1817 GOMEZ  Concurrence in Senate Amendments",55,22,0,2,79
622964,351066,2014-04-02,Senate,"Do pass as amended, and re-refer to the Committee on 	Appropriations",9,0,0,0,9
622964,362192,2014-05-05,Senate,"Senate 3rd Reading SB1046 Beall",35,0,5,0,40
622964,372122,2014-06-17,Assembly,"Do pass and be re-referred to the Committee on Insurance",16,0,0,3,19
622964,374379,2014-06-25,Assembly,"Do pass and be re-referred to the Committee on Appropriations",11,1,0,1,13
622964,375589,2014-07-02,Assembly,"Do pass",15,2,0,0,17
622964,376344,2014-08-04,Assembly,"SB 1046 Beall  Senate Third Reading  By DICKINSON",70,2,0,7,79
622966,361616,2014-04-30,Senate,"Do pass, but re-refer to the Committee on Appropriations",6,1,2,0,9
622966,363690,2014-05-12,Senate,"Placed on Appropriations Suspense file",7,0,0,0,7
622966,366954,2014-05-23,Senate,"Do pass as amended",5,2,0,0,7
622966,368681,2014-05-29,Senate,"Senate 3rd Reading SB1053 Mitchell",25,11,4,0,40
622966,374531,2014-06-24,Assembly,"Do pass and be re-referred to the Committee on Appropriations",12,6,0,1,19
622966,377240,2014-08-14,Assembly,"Do pass as amended",12,5,0,0,17
622966,377966,2014-08-20,Assembly,"SB 1053 Mitchell  Senate Third Reading  By ATKINS",54,22,0,3,79
622966,378074,2014-08-21,Senate,"Unfinished Business SB1053 Mitchell Concurrence",25,9,6,0,40
622967,350299,2014-04-01,Assembly,"Do pass as amended and be re-referred to the Committee on 	Appropriations",19,0,0,0,19
622967,366876,2014-05-23,Assembly,"Do pass as amended",16,0,0,1,17
622967,368749,2014-05-29,Assembly,"AB 1816 YAMADA  Assembly Third Reading",78,0,0,1,79
622967,374939,2014-06-25,Senate,"Do pass, but re-refer to the Committee on Appropriations",8,0,1,0,9
623641,357915,2014-04-21,Senate,"Do pass, but re-refer to the Committee on Appropriations",2,2,1,0,5
623641,357916,2014-04-21,Senate,"Set, first hearing.  Failed passage in Committee.  Reconsideration 	granted",4,0,1,0,5
623642,353783,2014-04-07,Assembly,"Do pass as amended and be re-referred to the Committee on Local 	Government",6,1,0,2,9
623642,359166,2014-04-23,Assembly,"Do pass and be re-referred to the Committee on Appropriations",8,0,0,1,9
623643,355109,2014-04-09,Assembly,"Do pass as amended and be re-referred to the Committee on Health",6,1,0,0,7
623643,360627,2014-04-29,Assembly,"Do pass as amended and be re-referred to the Committee on 	Appropriations",16,2,0,1,19
623644,353214,2014-04-08,Senate,"Do pass, but re-refer to the Committee on Governance and Finance",7,1,1,0,9
623644,359537,2014-04-24,Senate,"Do pass, but re-refer to the Committee on Appropriations",5,2,0,0,7
623644,362190,2014-05-05,Senate,"Placed on Appropriations Suspense file",7,0,0,0,7
623644,366738,2014-05-23,Senate,"Do pass as amended",5,2,0,0,7
623645,347661,2014-03-25,Senate,"Do pass, but re-refer to the Committee on Appropriations",8,0,2,0,10
623645,352891,2014-04-07,Senate,"Placed on Appropriations Suspense file",7,0,0,0,7
623646,353217,2014-04-08,Assembly,"Do pass and be re-referred to the Committee on Appropriations",14,0,0,0,14
623646,361396,2014-04-30,Assembly,"Do pass, to Consent Calendar",17,0,0,0,17
623646,363472,2014-05-08,Assembly,"AB 1972 JONES  Consent Calendar Second Day  Regular Session",73,0,0,6,79
623646,371741,2014-06-16,Senate,"Do pass, but re-refer to the Committee on Appropriations Recommend 	Consent",9,0,0,0,9
623646,375662,2014-07-03,Senate,"Consent Calendar 2nd AB1972 Jones",35,0,5,0,40
623647,360571,2014-04-29,Assembly,"Do pass and be re-referred to the Committee on Appropriations",8,6,0,1,15
623648,357966,2014-04-21,Assembly,"Do pass as amended and be re-referred to the Committee on Utilities 	and Commerce",9,0,0,0,9
623648,360601,2014-04-28,Assembly,"Do pass as amended and be re-referred to the Committee on 	Appropriations",13,0,0,2,15
623648,366697,2014-05-23,Assembly,"Do pass",17,0,0,0,17
623648,367473,2014-05-27,Assembly,"AB 1935 CAMPOS  Assembly Third Reading",77,0,0,2,79
623648,374003,2014-06-23,Senate,"Do pass as amended, and re-refer to the Committee on Appropriations",10,0,1,0,11
623648,376915,2014-08-11,Senate,"Placed on Appropriations Suspense file",7,0,0,0,7
623651,348550,2014-03-26,Senate,"Do pass, but re-refer to the Committee on Appropriations Recommend 	Consent",8,0,1,0,9
623651,355199,2014-04-10,Senate,"Consent Calendar 2nd SB1089 Mitchell",34,0,6,0,40
623651,370540,2014-06-10,Assembly,"Do pass and re-refer to Committee on Appropriations with 	recommendation:  To Consent Calendar",17,0,0,2,19
623651,376677,2014-08-06,Assembly,"Do pass, to Consent Calendar",17,0,0,0,17
623651,377195,2014-08-14,Assembly,"SB 1089 Mitchell  Consent Calendar Second Day  Regular Session",78,0,0,1,79
623652,353482,2014-04-08,Senate,"Do pass, but re-refer to the Committee on Appropriations",7,0,0,0,7
623652,362279,2014-05-05,Senate,"Placed on Appropriations Suspense file",7,0,0,0,7
623653,354283,2014-04-09,Assembly,"Do pass as amended and be re-referred to the Committee on 	Appropriations",9,0,0,0,9
623653,362946,2014-05-07,Assembly,"Do pass, to Consent Calendar",17,0,0,0,17
623653,364884,2014-05-15,Assembly,"AB 1963 ATKINS  Consent Calendar Second Day  Regular Session",78,0,0,1,79
623653,370834,2014-06-11,Senate,"Do pass, but re-refer to the Committee on Appropriations Recommend 	Consent",7,0,0,0,7
623653,374793,2014-06-26,Senate,"Consent Calendar 2nd AB1963 Atkins",32,0,8,0,40
623653,375281,2014-06-30,Assembly,"AB 1963 ATKINS  Concurrence in Senate Amendments",78,0,0,1,79
623654,363204,2014-05-07,Assembly,"Do pass as amended",7,0,0,0,7
623654,367011,2014-05-23,Assembly,"AB 1971 BOCANEGRA  Assembly Third Reading",55,17,0,7,79
623654,374331,2014-06-25,Senate,"Do pass as amended, and re-refer to the Committee on Appropriations",4,1,2,0,7
623654,376460,2014-08-04,Senate,"Do pass",5,2,0,0,7
623655,353406,2014-04-08,Assembly,"Do pass and be re-referred to the Committee on Local Government",10,3,0,2,15
623655,359344,2014-04-23,Assembly,"Do pass and be re-referred to the Committee on Appropriations",8,1,0,0,9
623655,363064,2014-05-07,Assembly,"Do pass as amended",13,4,0,0,17
623655,365312,2014-05-19,Assembly,"AB 1922 GOMEZ  Assembly Third Reading",58,17,0,4,79
623655,374371,2014-06-25,Senate,"Do pass, but re-refer to the Committee on Appropriations",5,2,0,0,7
623655,376469,2014-08-04,Senate,"Placed on Appropriations Suspense file",7,0,0,0,7
623656,351057,2014-04-02,Assembly,"Do pass as amended and be re-referred to the Committee on 	Appropriations",9,0,0,0,9
623656,361197,2014-04-30,Assembly,"Do pass, to Consent Calendar",17,0,0,0,17
623656,363363,2014-05-08,Assembly,"AB 1948 MULLIN  Consent Calendar Second Day  Regular Session",73,0,0,6,79
623656,370864,2014-06-11,Senate,"Do pass, but re-refer to the Committee on Appropriations",5,2,0,0,7
623656,373768,2014-06-23,Senate,"Do pass",5,2,0,0,7
623656,377561,2014-08-14,Senate,"Assembly 3rd Reading AB1948 Mullin By DeSaulnier",22,9,9,0,40
623657,347059,2014-03-24,Assembly,"Do pass as amended and be re-referred to the Committee on 	Appropriations",13,2,0,1,16
623657,366783,2014-05-23,Assembly,"Do pass",13,4,0,0,17
623657,367543,2014-05-27,Assembly,"AB 1857 FRAZIER  Assembly Third Reading",60,14,0,5,79
623657,374080,2014-06-24,Senate,"Do pass, but re-refer to the Committee on Appropriations",10,1,0,0,11
623657,376406,2014-08-04,Senate,"Placed on Appropriations Suspense file",7,0,0,0,7
623657,377144,2014-08-14,Senate,"Do pass",5,0,2,0,7
623657,378787,2014-08-27,Senate,"Assembly 3rd Reading AB1857 Frazier By Cannella",33,1,6,0,40
623657,378835,2014-08-28,Assembly,"AB 1857 FRAZIER  Concurrence in Senate Amendments",64,14,0,1,79
623660,348165,2014-03-26,Senate,"Do pass as amended, and re-refer to the Committee on Appropriations",9,0,0,0,9
623660,360040,2014-04-28,Senate,"Placed on Appropriations Suspense file",6,0,1,0,7
623661,359641,2014-04-23,Assembly,"From committee:  Be adopted.  To third reading",5,0,0,2,7
623661,361744,2014-05-01,Assembly,"AJR 36 GONZALEZ  Assembly Third Reading",44,11,0,24,79
623661,374451,2014-06-25,Senate,"Be adopted",3,2,0,0,5
623661,377663,2014-08-18,Senate,"Assembly 3rd Reading AJR36 Gonzalez By Hueso",2,16,22,0,40
623661,377664,2014-08-18,Senate,"Assembly 3rd Reading AJR36 Gonzalez Reconsider",34,0,6,0,40
623663,354320,2014-04-02,Assembly,"Do pass and be re-referred to the Committee on Appropriations",19,0,0,0,19
623663,361225,2014-04-30,Assembly,"Do pass",16,0,0,1,17
623663,362235,2014-05-05,Assembly,"AB 1916 HALL  Assembly Third Reading",73,0,0,6,79
623663,374175,2014-06-24,Senate,"Do pass, but re-refer to the Committee on Appropriations Recommend 	Consent",10,0,0,0,10
623663,376992,2014-08-11,Senate,"Do pass",7,0,0,0,7
623663,378818,2014-08-27,Senate,"Special Consent #19 AB1916 Hall",36,0,4,0,40
623664,358743,2014-04-22,Senate,"Do pass as amended, and re-refer to the Committee on Appropriations",4,0,1,0,5
623664,362291,2014-05-05,Senate,"Placed on Appropriations Suspense file",7,0,0,0,7
623664,367053,2014-05-23,Senate,"Do pass as amended",7,0,0,0,7
623664,368787,2014-05-29,Senate,"Senate 3rd Reading SB1093 Liu",37,0,3,0,40
623664,372214,2014-06-17,Assembly,"Do pass and be re-referred to the Committee on Appropriations",7,0,0,0,7
623664,376720,2014-08-06,Assembly,"Do pass",15,2,0,0,17
623664,377146,2014-08-14,Assembly,"SB 1093 Liu  Senate Third Reading  By WEBER",67,9,0,3,79
623664,377624,2014-08-18,Senate,"Unfinished Business SB1093 Liu Concurrence",36,0,4,0,40
623665,350758,2014-04-01,Assembly,"Do pass, to Consent Calendar",9,0,0,1,10
623665,352828,2014-04-07,Assembly,"AB 1932 JONES  Consent Calendar Second Day",76,0,0,3,79
623665,370836,2014-06-10,Senate,"Do pass and be placed on the Consent Calendar",7,0,0,0,7
623665,371771,2014-06-16,Senate,"Consent Calendar 2nd AB1932 Jones",35,0,5,0,40
623666,359328,2014-04-22,Senate,"Do pass, but re-refer to the Committee on Appropriations",5,0,0,0,5
623666,363706,2014-05-12,Senate,"Placed on Appropriations Suspense file",7,0,0,0,7
623666,367137,2014-05-23,Senate,"Do pass as amended",7,0,0,0,7
623666,370165,2014-06-09,Senate,"Senate 3rd Reading SB1103 Padilla",34,1,5,0,40
623666,374318,2014-06-24,Assembly,"Do pass as amended and be re-referred to the Committee on 	Appropriations",6,0,0,1,7
623666,377046,2014-08-13,Assembly,"Do pass as amended",16,1,0,0,17
623666,378819,2014-08-27,Assembly,"SB 1103 Padilla  Senate Third Reading  By BONTA",77,1,0,1,79
623667,358616,2014-04-22,Assembly,"Do pass",10,0,0,0,10
623667,359508,2014-04-24,Assembly,"AB 1945 WIECKOWSKI  Assembly Third Reading",72,0,0,7,79
623667,371211,2014-06-10,Senate,"Do pass",6,1,0,0,7
623667,379132,2014-08-29,Senate,"Assembly 3rd Reading AB1945 Wieckowski By Corbett",34,0,6,0,40
623668,359796,2014-04-23,Assembly,"From committee:  Be adopted.  To third reading",7,0,0,0,7
623668,363544,2014-05-08,Assembly,"AJR 38 SALAS  Assembly Third Reading",74,0,0,5,79
623668,374193,2014-06-24,Senate,"Do pass and be placed on the Consent Calendar",6,0,1,0,7
623668,375686,2014-07-03,Senate,"Consent Calendar 2nd AJR38 Salas",35,0,5,0,40
623669,359213,2014-04-23,Assembly,"Do pass and be re-referred to the Committee on Appropriations",7,0,0,0,7
623669,366800,2014-05-23,Assembly,"Do pass",13,4,0,0,17
623669,367462,2014-05-27,Assembly,"AB 1902 BONTA  Assembly Third Reading",61,16,0,2,79
623670,358387,2014-04-22,Assembly,"Do pass and be re-referred to the Committee on Revenue and Taxation",14,0,0,0,14
623670,360743,2014-04-28,Assembly,"Do pass and be re-referred to the Committee on Appropriations",9,0,0,0,9
623670,363177,2014-05-07,Assembly,"Do pass, to Consent Calendar",17,0,0,0,17
623670,364930,2014-05-15,Assembly,"AB 1907 RIDLEY-THOMAS  Consent Calendar Second Day  Regular Session",78,0,0,1,79
623670,370417,2014-06-10,Senate,"Do pass, but re-refer to the Committee on Governance and Finance",10,0,1,0,11
623670,374615,2014-06-25,Senate,"Do pass and be placed on the Consent Calendar",6,0,1,0,7
623670,376942,2014-08-11,Senate,"Placed on Appropriations Suspense file",7,0,0,0,7
623670,377337,2014-08-14,Senate,"Do pass",5,0,2,0,7
623670,378404,2014-08-25,Senate,"Assembly 3rd Reading AB1907 Ridley-Thomas By DeSaulnier",34,0,6,0,40
623671,360633,2014-04-29,Assembly,"Do pass and be re-referred to the Committee on Appropriations",6,0,0,1,7
623671,362935,2014-05-07,Assembly,"Do pass",16,0,0,1,17
623671,365451,2014-05-19,Assembly,"AB 1896 PEREZ, V.M.  Assembly Third Reading",75,0,0,4,79
623671,370440,2014-06-10,Senate,"Do pass, but re-refer to the Committee on Environmental Quality 	Recommend Consent",9,0,0,0,9
623671,374470,2014-06-25,Senate,"Do pass, but re-refer to the Committee on Appropriations Recommend 	Consent",6,0,1,0,7
623671,376738,2014-08-07,Senate,"Consent Calendar 2nd AB1896 V. Manuel P",34,0,6,0,40
623672,360616,2014-04-29,Assembly,"Do pass and be re-referred to the Committee on Appropriations",9,4,0,1,14
623672,363042,2014-05-07,Assembly,"Do pass",11,5,0,1,17
623672,368641,2014-05-29,Assembly,"AB 1886 EGGMAN  Assembly Third Reading",50,25,0,4,79
623672,374132,2014-06-23,Senate,"Do pass as amended, and re-refer to the Committee on 	Appropriations",8,0,1,0,9
623672,376767,2014-08-07,Senate,"Assembly 3rd Reading AB1886 Eggman By Hill",30,3,7,0,40
623672,376930,2014-08-11,Assembly,"AB 1886 EGGMAN  Concurrence in Senate Amendments",56,20,0,3,79
623673,359542,2014-04-24,Senate,"Do pass as amended, and re-refer to the Committee on Rules",5,2,0,0,7
623673,365459,2014-05-19,Senate,"Placed on Appropriations Suspense file",7,0,0,0,7
623673,367090,2014-05-23,Senate,"Do pass",5,2,0,0,7
623673,367540,2014-05-27,Senate,"Senate 3rd Reading SB1121 De Le",24,12,4,0,40
623673,371402,2014-06-12,Assembly,"Be referred to Committee on Natural Resources",10,0,0,1,11
623673,374145,2014-06-23,Assembly,"Do pass as amended and be re-referred to the Committee on 	Appropriations",6,3,0,0,9
623673,377330,2014-08-14,Assembly,"Do pass as amended",12,5,0,0,17
623674,370537,2014-06-10,Assembly,"From committee:  Be adopted.  To third reading",8,0,0,1,9
623674,372746,2014-06-18,Assembly,"From committee:  Be adopted.  To third reading",14,0,0,3,17
623674,373297,2014-06-19,Assembly,"ACR 100 ALEJO  Assembly Third Reading",71,1,0,7,79
623674,376975,2014-08-11,Senate,"Be adopted, but re-refer to the Committee on Appropriations",9,0,0,0,9
623674,378724,2014-08-27,Senate,"Assembly 3rd Reading ACR100 Alejo By Corbett",36,0,4,0,40
623674,378912,2014-08-28,Assembly,"ACR 100 ALEJO  Concurrence in Senate Amendments",74,1,0,4,79
623676,362573,2014-05-06,Assembly,"Do pass as amended",10,0,0,0,10
623676,367045,2014-05-23,Assembly,"AB 1981 BROWN  Assembly Third Reading",64,3,0,12,79
623676,374343,2014-06-24,Senate,"Do pass as amended",7,0,0,0,7
623676,378579,2014-08-26,Senate,"Assembly 3rd Reading AB1981 Brown By Torres",34,0,6,0,40
623676,378797,2014-08-27,Assembly,"AB 1981 BROWN  Concurrence in Senate Amendments",71,4,0,4,79
623677,348068,2014-03-25,Assembly,"Do pass and be re-referred to the Committee on Appropriations",7,0,0,0,7
623677,354276,2014-04-09,Assembly,"Do pass, to Consent Calendar",17,0,0,0,17
623677,359576,2014-04-24,Assembly,"AB 1920 CAMPOS  Consent Calendar Second Day  Regular Session",75,0,0,4,79
623677,374496,2014-06-24,Senate,"Do pass, but re-refer to the Committee on Appropriations",6,1,0,0,7
623677,376554,2014-08-04,Senate,"Placed on Appropriations Suspense file",7,0,0,0,7
623677,377421,2014-08-14,Senate,"Do pass as amended",5,0,2,0,7
623677,378094,2014-08-21,Senate,"Assembly 3rd Reading AB1920 Campos By Mitchell",31,2,7,0,40
623677,378240,2014-08-22,Assembly,"AB 1920 CAMPOS  Concurrence in Senate Amendments",76,0,0,3,79
623679,359226,2014-04-23,Assembly,"Do pass and be re-referred to the Committee on Local Government",5,1,0,1,7
623679,362965,2014-05-07,Assembly,"Do pass",10,5,0,2,17
623679,364858,2014-05-15,Assembly,"AB 1881 JONES-SAWYER  Assembly Third Reading",52,22,0,5,79
623679,373836,2014-06-23,Senate,"Do pass, but re-refer to the Committee on Appropriations",3,2,0,0,5
623679,376636,2014-08-04,Senate,"Do pass",5,2,0,0,7
623679,378272,2014-08-22,Senate,"Assembly 3rd Reading AB1881 Jones-Sawyer By Padilla",20,12,8,0,40
623679,378273,2014-08-22,Senate,"Assembly 3rd Reading AB1881 Jones-Sawyer Reconsider",27,0,13,0,40
623679,378373,2014-08-25,Senate,"Assembly 3rd Reading AB1881 Jones-Sawyer By Padilla",22,10,8,0,40
623680,354229,2014-04-08,Assembly,"Do pass as amended and be re-referred to the Committee on 	Appropriations",15,3,0,1,19
623680,366884,2014-05-23,Assembly,"Do pass as amended",13,2,0,2,17
623680,367991,2014-05-28,Assembly,"AB 1962 SKINNER  Assembly Third Reading",76,0,0,3,79
623680,370954,2014-06-11,Senate,"Do pass, but re-refer to the Committee on Appropriations",7,1,1,0,9
623680,376552,2014-08-04,Senate,"Placed on Appropriations Suspense file",7,0,0,0,7
623680,377402,2014-08-14,Senate,"Do pass",5,0,2,0,7
623680,378156,2014-08-21,Senate,"Assembly 3rd Reading AB1962 Skinner By Hernandez",32,4,4,0,40
623680,378203,2014-08-22,Assembly,"AB 1962 SKINNER  Concurrence in Senate Amendments",74,0,0,5,79
623681,348186,2014-03-26,Assembly,"Do pass as amended and be re-referred to the Committee on 	Appropriations",6,0,0,1,7
623682,360673,2014-04-29,Assembly,"Do pass and be re-referred to the Committee on Appropriations",7,3,0,0,10
623684,361079,2014-04-29,Assembly,"Do pass as amended and be re-referred to the Committee on 	Appropriations",5,0,0,2,7
623684,366339,2014-05-21,Assembly,"Do pass",14,3,0,0,17
623684,366802,2014-05-23,Assembly,"AB 1930 SKINNER  Assembly Third Reading",61,12,0,6,79
623684,370631,2014-06-10,Senate,"Do pass, but re-refer to the Committee on Appropriations",3,0,2,0,5
623684,376569,2014-08-04,Senate,"Placed on Appropriations Suspense file",7,0,0,0,7
623684,377530,2014-08-14,Senate,"Do pass as amended",5,0,2,0,7
623684,377783,2014-08-19,Senate,"Assembly 3rd Reading AB1930 Skinner By Liu",34,0,6,0,40
623684,378059,2014-08-21,Assembly,"AB 1930 SKINNER  Concurrence in Senate Amendments",73,5,0,1,79
623685,354228,2014-04-09,Senate,"Do pass as amended, and re-refer to the Committee on Appropriations",4,2,1,0,7
623685,362203,2014-05-05,Senate,"Placed on Appropriations Suspense file",7,0,0,0,7
623685,366878,2014-05-23,Senate,"Do pass as amended",5,2,0,0,7
623685,367997,2014-05-28,Senate,"Senate 3rd Reading SB1129 Steinberg",27,8,5,0,40
623685,372757,2014-06-18,Assembly,"Do pass and be re-referred to the Committee on Housing and 	Community Development",9,0,0,0,9
623685,374503,2014-06-25,Assembly,"Do pass and be re-referred to the Committee on Appropriations",5,1,0,1,7
623685,377372,2014-08-14,Assembly,"Do pass as amended",12,2,0,3,17
623685,378767,2014-08-27,Assembly,"SB 1129 Steinberg  Senate Third Reading  By DICKINSON",58,17,0,4,79
623685,379112,2014-08-29,Senate,"Unfinished Business SB1129 Steinberg Concurrence",28,8,4,0,40
623686,350983,2014-04-02,Assembly,"Do pass and be re-referred to the Committee on Agriculture",5,2,0,2,9
623686,355043,2014-04-09,Assembly,"Do pass as amended and be re-referred to the Committee on 	Appropriations",5,1,0,1,7
623687,347518,2014-03-24,Assembly,"Be adopted",12,0,0,3,15
623687,351809,2014-04-03,Assembly,"AJR 39 HERNANDEZ  Assembly Third Reading",71,1,0,7,79
623687,373365,2014-06-19,Senate,"Assembly 3rd Reading AJR39 Roger Hern",26,5,9,0,40
623687,374948,2014-06-26,Assembly,"AJR 39 HERNANDEZ  Concurrence in Senate Amendments",74,0,0,5,79
623688,360649,2014-04-29,Assembly,"Do pass and be re-referred to the Committee on Appropriations",15,0,0,0,15
623689,359679,2014-04-24,Senate,"Special Consent #12 SCR82 Hueso",37,0,3,0,40
623689,370626,2014-06-10,Assembly,"From committee:  Be adopted.  To third reading",8,0,0,1,9
623689,371785,2014-06-16,Senate,"Unfinished Business SCR82 Hueso",36,0,4,0,40
623690,359646,2014-04-24,Senate,"Do pass, but re-refer to the Committee on Appropriations",6,1,2,0,9
623690,362293,2014-05-05,Senate,"Placed on Appropriations Suspense file",7,0,0,0,7
623690,366729,2014-05-23,Senate,"Do pass",5,2,0,0,7
623690,367438,2014-05-27,Senate,"Senate 3rd Reading SB1111 Lara",24,11,5,0,40
623690,375011,2014-06-25,Assembly,"Do pass as amended and be re-referred to the Committee on 	Appropriations",5,1,0,1,7
623690,377495,2014-08-14,Assembly,"Do pass",12,5,0,0,17
623690,377779,2014-08-19,Assembly,"SB 1111 Lara  Senate Third Reading  By BUCHANAN",56,20,0,3,79
623690,377903,2014-08-20,Senate,"Unfinished Business SB1111 Lara Concurrence",24,9,7,0,40
623692,348350,2014-03-25,Assembly,"Do pass and be re-referred to the Committee on Appropriations",7,0,0,0,7
623692,354432,2014-04-09,Assembly,"Do pass",12,5,0,0,17
623692,359520,2014-04-24,Assembly,"AB 1964 DICKINSON  Assembly Third Reading",48,25,0,6,79
623692,370554,2014-06-10,Senate,"Do pass, but re-refer to the Committee on Appropriations",4,2,1,0,7
623692,375289,2014-06-30,Senate,"Assembly 3rd Reading AB1964 Dickinson By Leno",22,13,5,0,40
623693,354366,2014-04-08,Assembly,"Do pass and be re-referred to the Committee on Appropriations",11,7,0,1,19
623694,363053,2014-05-07,Assembly,"Do pass",9,0,0,0,9
623694,364952,2014-05-15,Assembly,"AB 1883 SKINNER  Assembly Third Reading",76,0,0,3,79
623694,374481,2014-06-25,Senate,"Do pass as amended",7,0,0,0,7
623694,377341,2014-08-14,Senate,"Assembly 3rd Reading AB1883 Skinner By Wolk",32,1,7,0,40
623694,377842,2014-08-19,Assembly,"AB 1883 SKINNER  Concurrence in Senate Amendments",77,0,0,2,79
623695,361136,2014-04-29,Assembly,"Do pass as amended and be re-referred to the Committee on 	Appropriations",5,0,0,2,7
623695,366294,2014-05-21,Assembly,"Do pass",14,0,0,3,17
623695,367109,2014-05-23,Assembly,"AB 1863 JONES  Assembly Third Reading",54,5,0,20,79
623695,374299,2014-06-24,Senate,"Do pass as amended, and re-refer to the Committee on Appropriations",4,0,1,0,5
623695,376523,2014-08-04,Senate,"Placed on Appropriations Suspense file",7,0,0,0,7
623696,360596,2014-04-28,Assembly,"Do pass as amended and be re-referred to the Committee on 	Appropriations",12,0,0,3,15
623696,364470,2014-05-14,Assembly,"Do pass as amended, to Consent Calendar",17,0,0,0,17
623696,366766,2014-05-23,Assembly,"AB 1937 GORDON  Consent Calendar Second Day  Regular Session",73,0,0,6,79
623696,374191,2014-06-23,Senate,"Do pass as amended, and re-refer to the Committee on Appropriations",10,0,1,0,11
623696,376784,2014-08-07,Senate,"Assembly 3rd Reading AB1937 Gordon By Hill",34,0,6,0,40
623696,376908,2014-08-11,Assembly,"AB 1937 GORDON  Concurrence in Senate Amendments",79,0,0,0,79
623697,364385,2014-05-13,Assembly,"Do pass as amended and be re-referred to the Committee on 	Appropriations",7,1,0,1,9
623698,353453,2014-04-07,Assembly,"Do pass and be re-referred to the Committee on Business, 	Professions and Consumer Protection",12,0,0,0,12
623698,358549,2014-04-22,Assembly,"Do pass and be re-referred to the Committee on Appropriations",14,0,0,0,14
623698,363031,2014-05-07,Assembly,"Do pass, to Consent Calendar",17,0,0,0,17
623698,364891,2014-05-15,Assembly,"AB 1859 MAIENSCHEIN  Consent Calendar Second Day  Regular Session",78,0,0,1,79
623699,358522,2014-04-21,Assembly,"Do pass and be re-referred to the Committee on Appropriations",16,0,0,0,16
623699,361306,2014-04-30,Assembly,"Do pass",16,1,0,0,17
623699,362288,2014-05-05,Assembly,"AB 1864 DALY  Assembly Third Reading",74,1,0,4,79
623699,374167,2014-06-24,Senate,"Do pass as amended, and re-refer to the Committee on 	Appropriations",11,0,0,0,11
623702,358862,2014-04-22,Senate,"Do pass, but re-refer to the Committee on Appropriations",5,2,3,0,10
623702,358863,2014-04-22,Senate,"Set, first hearing.  Failed passage in Committee.  Reconsideration 	granted",10,0,0,0,10
623703,360613,2014-04-29,Assembly,"Do pass and be re-referred to the Committee on Appropriations",2,5,0,0,7
623704,360636,2014-04-29,Assembly,"Do pass as amended and be re-referred to the Committee on 	Appropriations",9,4,0,0,13
623704,366856,2014-05-23,Assembly,"Do pass as amended",12,5,0,0,17
623704,368733,2014-05-29,Assembly,"AB 1942 BONTA  Assembly Third Reading",76,2,0,1,79
623704,374279,2014-06-25,Senate,"Do pass as amended, and re-refer to the Committee on Appropriations",6,0,1,0,7
623704,377084,2014-08-13,Senate,"Assembly 3rd Reading AB1942 Bonta By Beall",36,0,4,0,40
623704,377669,2014-08-18,Assembly,"AB 1942 BONTA  Concurrence in Senate Amendments",78,0,0,1,79
623705,350494,2014-04-01,Assembly,"Do pass and be re-referred to the Committee on Appropriations",13,0,0,0,13
623705,354599,2014-04-09,Assembly,"Do pass, to Consent Calendar",17,0,0,0,17
623705,359653,2014-04-24,Assembly,"AB 1906 WILK  Consent Calendar Second Day  Regular Session",75,0,0,4,79
623705,369819,2014-06-04,Senate,"Do pass as amended, but re-refer to the Committee on Appropriations 	Recommend Consent",6,0,1,0,7
623705,375696,2014-07-03,Senate,"Consent Calendar 2nd AB1906 Wilk",35,0,5,0,40
623705,376822,2014-08-07,Assembly,"AB 1906 WILK  Concurrence in Senate Amendments",78,0,0,1,79
623707,348276,2014-03-26,Assembly,"Do pass and be re-referred to the Committee on Appropriations",5,1,0,1,7
623707,367098,2014-05-23,Assembly,"Do pass",13,4,0,0,17
623707,367486,2014-05-27,Assembly,"AB 1944 GARCIA  Assembly Third Reading",58,18,0,3,79
623707,374310,2014-06-25,Senate,"Do pass, but re-refer to the Committee on Appropriations",5,1,1,0,7
623707,377096,2014-08-13,Senate,"Assembly 3rd Reading AB1944 Garcia By Monning",27,8,5,0,40
623708,348142,2014-03-26,Assembly,"Do pass and be re-referred to the Committee on Appropriations",6,0,0,1,7
623708,366894,2014-05-23,Assembly,"Do pass as amended",12,0,0,5,17
623708,368644,2014-05-29,Assembly,"AB 1871 DICKINSON  Assembly Third Reading",71,5,0,3,79
623708,372212,2014-06-17,Senate,"Do pass as amended, and re-refer to the Committee on 	Appropriations",5,0,0,0,5
623708,376503,2014-08-04,Senate,"Do pass",7,0,0,0,7
623708,378040,2014-08-21,Senate,"Assembly 3rd Reading AB1871 Dickinson By Galgiani",35,1,4,0,40
623708,378329,2014-08-25,Assembly,"AB 1871 DICKINSON  Concurrence in Senate Amendments",75,2,0,2,79
623709,362933,2014-05-07,Assembly,"Do pass as amended",7,0,0,0,7
623709,366759,2014-05-23,Assembly,"AB 1851 BRADFORD  Assembly Third Reading",74,1,0,4,79
623709,372535,2014-06-18,Senate,"Do pass and be placed on the Consent Calendar",7,0,0,0,7
623709,374962,2014-06-26,Senate,"Consent Calendar 2nd AB1851 Bradford",32,0,8,0,40
623710,347171,2014-03-24,Assembly,"Be adopted, and re-refer to Committee on Appropriations with 	recommendation:  To Consent Calendar",14,0,0,2,16
623710,354964,2014-04-09,Assembly,"Be adopted, to Consent Calendar",17,0,0,0,17
623710,357945,2014-04-21,Assembly,"ACR 99 JONES  Consent Calendar Second Day  Regular Session",77,0,0,2,79
623710,362650,2014-05-06,Senate,"Be adopted, but re-refer to the Committee on Appropriations 	Recommend Consent",11,0,0,0,11
623710,365543,2014-05-19,Senate,"Be adopted",7,0,0,0,7
623710,367115,2014-05-23,Senate,"Special Consent #15 ACR99 Jones",32,0,8,0,40
623712,358939,2014-04-21,Senate,"Do pass, but re-refer to the Committee on Appropriations",8,0,1,0,9
623712,362277,2014-05-05,Senate,"Do pass",6,0,1,0,7
623712,363722,2014-05-12,Senate,"Senate 3rd Reading SB1116 Torres",33,0,7,0,40
623712,374150,2014-06-24,Assembly,"Do pass and be re-referred to the Committee on Appropriations",12,0,0,2,14
623712,375570,2014-07-02,Assembly,"Do pass, to Consent Calendar",17,0,0,0,17
623712,378274,2014-08-22,Assembly,"SB 1116 Torres  Senate Third Reading  By SALAS",75,0,0,4,79
623712,378409,2014-08-25,Senate,"Unfinished Business SB1116 Torres Concurrence",35,0,5,0,40
623713,353620,2014-04-08,Assembly,"Do pass, to Consent Calendar",7,0,0,0,7
623713,358250,2014-04-21,Assembly,"AB 1860 PEREZ, V.M.  Consent Calendar Second Day  Regular Session",77,0,0,2,79
623713,370706,2014-06-10,Senate,"Do pass",6,0,1,0,7
623713,374912,2014-06-26,Senate,"Special Consent #17 AB1860 V. Manuel P",32,0,8,0,40
623714,359388,2014-04-22,Senate,"Do pass as amended",7,0,0,0,7
623714,361573,2014-05-01,Senate,"Senate 3rd Reading SB1072 Fuller",35,0,5,0,40
623714,370523,2014-06-10,Assembly,"Do pass, to Consent Calendar",9,0,0,1,10
623714,371728,2014-06-16,Assembly,"SB 1072 Fuller  Consent Calendar Second Day  Regular Session",77,0,0,2,79
623715,354308,2014-04-08,Assembly,"Do pass and be re-referred to the Committee on Appropriations",19,0,0,0,19
623715,366744,2014-05-23,Assembly,"Do pass as amended",16,0,0,1,17
623715,368010,2014-05-28,Assembly,"AB 1877 COOLEY  Third Reading Urgency",77,0,0,2,79
623715,374763,2014-06-25,Senate,"Do pass as amended, and re-refer to the Committee on 	Appropriations",8,0,1,0,9
623715,376537,2014-08-04,Senate,"Placed on Appropriations Suspense file",7,0,0,0,7
623715,377509,2014-08-14,Senate,"Do pass as amended",5,0,2,0,7
623715,378108,2014-08-21,Senate,"Assembly 3rd Reading AB1877 Cooley Urgency Clause",36,0,4,0,40
623715,378303,2014-08-25,Assembly,"AB 1877 COOLEY  Concurrence in Senate Amendments",78,0,0,1,79
623716,361830,2014-04-30,Assembly,"Do pass and be re-referred to the Committee on Appropriations",5,0,0,2,7
623718,350308,2014-04-01,Assembly,"Do pass as amended and be re-referred to the Committee on 	Appropriations",13,0,0,0,13
623718,359547,2014-04-24,Assembly,"AB 1862 MELENDEZ  Assembly Third Reading",74,0,0,5,79
623718,374322,2014-06-25,Senate,"Do pass, but re-refer to the Committee on Appropriations",3,4,0,0,7
623718,374323,2014-06-25,Senate,"Set, first hearing.  Failed passage in Committee.  Reconsideration 	granted",7,0,0,0,7
623721,362579,2014-05-06,Assembly,"Do pass",4,6,0,0,10
623723,348180,2014-03-26,Assembly,"Do pass as amended and re-refer to Committee on Appropriations 	with recommendation:  To Consent Calendar",6,0,0,1,7
623724,358486,2014-04-21,Senate,"Do pass and be placed on the Consent Calendar",9,0,0,0,9
623724,360093,2014-04-28,Senate,"Consent Calendar 2nd SB1083 Pavley",36,0,4,0,40
623724,372331,2014-06-17,Assembly,"Do pass, to Consent Calendar",14,0,0,0,14
623724,373792,2014-06-23,Assembly,"SB 1083 Pavley  Consent Calendar Second Day  Regular Session",75,0,0,4,79
623724,377281,2014-08-14,Assembly,"Do pass as amended",17,0,0,0,17
623724,378316,2014-08-25,Assembly,"SB 1083 Pavley  Senate Third Reading  By LOWENTHAL",79,0,0,0,79
623724,378483,2014-08-26,Senate,"Unfinished Supp 1 SB1083 Pavley Concurrence",36,0,4,0,40
623725,359544,2014-04-23,Assembly,"Do pass and be re-referred to the Committee on Appropriations",5,1,0,1,7
623725,363277,2014-05-07,Assembly,"Do pass",12,5,0,0,17
623725,364977,2014-05-15,Assembly,"AB 1870 ALEJO  Assembly Third Reading",55,22,0,2,79
623725,374685,2014-06-25,Senate,"Do pass, but re-refer to the Committee on Appropriations",4,1,0,0,5
623725,377750,2014-08-19,Senate,"Assembly 3rd Reading AB1870 Alejo By Hueso",23,10,7,0,40
623725,378131,2014-08-21,Assembly,"AB 1870 ALEJO  Concurrence in Senate Amendments",56,22,0,1,79
623727,361660,2014-04-30,Senate,"Do pass, but re-refer to the Committee on Appropriations",9,0,0,0,9
623727,363770,2014-05-12,Senate,"Placed on Appropriations Suspense file",7,0,0,0,7
623729,350401,2014-04-01,Assembly,"Do pass and be re-referred to the Committee on Appropriations",7,0,0,0,7
623729,361270,2014-04-30,Assembly,"Do pass, to Consent Calendar",17,0,0,0,17
623729,364815,2014-05-15,Assembly,"AB 1960 PEREA  Assembly Third Reading",74,2,0,3,79
623729,373235,2014-06-18,Senate,"Do pass, but re-refer to the Committee on Public Safety",8,0,1,0,9
623729,374440,2014-06-24,Senate,"Do pass, but re-refer to the Committee on Appropriations",7,0,0,0,7
623729,377068,2014-08-13,Senate,"Assembly 3rd Reading AB1960 Perea By Beall",36,0,4,0,40
623731,359439,2014-04-22,Senate,"Do pass as amended, and re-refer to the Committee on Appropriations",4,1,0,0,5
623731,363732,2014-05-12,Senate,"Placed on Appropriations Suspense file",7,0,0,0,7
623731,367078,2014-05-23,Senate,"Do pass as amended",5,2,0,0,7
623731,370199,2014-06-09,Senate,"Senate 3rd Reading SB1101 Padilla Urgency Clause",23,3,14,0,40
623731,370200,2014-06-09,Senate,"Senate 3rd Reading SB1101 Padilla Reconsider",35,0,5,0,40
623731,371769,2014-06-16,Senate,"Senate 3rd Reading SB1101 Padilla Urgency Clause",32,1,7,0,40
623731,374295,2014-06-24,Assembly,"Do pass as amended and be re-referred to the Committee on 	Appropriations",1,1,0,5,7
623731,374296,2014-06-24,Assembly,"Set first hearing.  Failed passage.  Reconsideration granted",5,0,0,2,7
623732,359703,2014-04-23,Assembly,"Do pass and be re-referred to the Committee on Appropriations",5,2,0,0,7
623732,366899,2014-05-23,Assembly,"Do pass as amended",12,5,0,0,17
623732,368134,2014-05-28,Assembly,"AB 1897 HERNANDEZ  Assembly Third Reading  Amend By HERNANDEZ  Set 	#1",51,25,0,3,79
623732,368629,2014-05-29,Assembly,"AB 1897 HERNANDEZ  Assembly Third Reading",51,23,0,5,79
623732,370850,2014-06-11,Senate,"Do pass, but re-refer to the Committee on Judiciary",4,1,0,0,5
623732,374477,2014-06-24,Senate,"Do pass as amended, and re-refer to the Committee on 	Appropriations",5,2,0,0,7
623732,376501,2014-08-04,Senate,"Placed on Appropriations Suspense file",7,0,0,0,7
623732,377303,2014-08-14,Senate,"Do pass as amended",5,0,2,0,7
623732,378647,2014-08-27,Senate,"Assembly 3rd Reading AB1897 Roger Hern",22,12,6,0,40
623732,378875,2014-08-28,Assembly,"AB 1897 HERNANDEZ  Concurrence in Senate Amendments",47,24,0,8,79
623733,350379,2014-04-01,Assembly,"Do pass as amended and be re-referred to the Committee on 	Appropriations",10,0,0,3,13
623733,367007,2014-05-23,Assembly,"Do pass as amended",13,0,0,4,17
623733,368726,2014-05-29,Assembly,"AB 1976 QUIRK-SILVA  Assembly Third Reading",74,1,0,4,79
623733,374566,2014-06-25,Senate,"Do pass, but re-refer to the Committee on Appropriations",6,0,1,0,7
623733,376613,2014-08-04,Senate,"Placed on Appropriations Suspense file",7,0,0,0,7
623733,377574,2014-08-14,Senate,"Do pass",5,0,2,0,7
623733,378171,2014-08-21,Senate,"Assembly 3rd Reading AB1976 Quirk-Silva By De Le",36,0,4,0,40
623734,350602,2014-04-01,Assembly,"Do pass and be re-referred to the Committee on Appropriations",13,0,0,0,13
623734,366998,2014-05-23,Assembly,"Do pass as amended",16,0,0,1,17
623734,368065,2014-05-28,Assembly,"AB 1953 SKINNER  Assembly Third Reading",72,3,0,4,79
623734,373984,2014-06-23,Senate,"Do pass as amended, and re-refer to the Committee on Appropriations",8,2,1,0,11
623734,376621,2014-08-04,Senate,"Placed on Appropriations Suspense file",7,0,0,0,7
623736,362601,2014-05-06,Assembly,"Do pass",2,4,0,1,7
623737,354539,2014-04-08,Assembly,"Do pass and be re-referred to the Committee on Appropriations",7,0,0,0,7
623737,367141,2014-05-23,Assembly,"Do pass as amended",16,0,0,1,17
623737,368634,2014-05-29,Assembly,"AB 1882 COOLEY  Assembly Third Reading",76,0,0,3,79
623737,374712,2014-06-24,Senate,"Do pass as amended, but re-refer to the Committee on Appropriations 	Recommend Consent",4,0,1,0,5
623737,376458,2014-08-04,Senate,"Placed on Appropriations Suspense file",7,0,0,0,7
623738,355146,2014-04-09,Assembly,"Do pass and re-refer to Committee on Appropriations with 	recommendation:  To Consent Calendar",7,0,0,0,7
623738,361089,2014-04-30,Assembly,"Do pass, to Consent Calendar",17,0,0,0,17
623738,363379,2014-05-08,Assembly,"AB 1979 NAZARIAN  Consent Calendar Second Day  Regular Session",73,0,0,6,79
623738,371001,2014-06-11,Senate,"Do pass as amended, and re-refer to the Committee on Rules",7,0,0,0,7
623738,374334,2014-06-25,Senate,"Do pass, but re-refer to the Committee on Appropriations Recommend 	Consent",6,0,1,0,7
623738,377739,2014-08-18,Senate,"Assembly 3rd Reading AB1979 Nazarian By Liu",35,0,5,0,40
623738,378485,2014-08-26,Assembly,"Senate amendments be concurred in",5,0,0,2,7
623738,378713,2014-08-27,Assembly,"AB 1979 NAZARIAN  Concurrence in Senate Amendments",78,0,0,1,79
623739,352906,2014-04-07,Assembly,"Be referred to Committee on Utilities and Commerce",11,0,0,0,11
623739,358597,2014-04-21,Assembly,"Do pass as amended and be re-referred to the Committee on 	Appropriations",10,3,0,2,15
623739,364240,2014-05-14,Assembly,"Do pass",12,5,0,0,17
623739,367975,2014-05-28,Assembly,"AB 1918 WILLIAMS  Assembly Third Reading",64,15,0,0,79
623739,372334,2014-06-17,Senate,"Do pass, but re-refer to the Committee on Appropriations",9,1,1,0,11
623739,375265,2014-06-30,Senate,"Placed on Appropriations Suspense file",6,0,1,0,7
623742,351166,2014-04-02,Senate,"Do pass as amended, and re-refer to the Committee on Agriculture",6,0,1,0,7
623742,359548,2014-04-24,Senate,"Do pass, but re-refer to the Committee on Appropriations",4,0,1,0,5
623742,363723,2014-05-12,Senate,"Senate 3rd Reading SB1117 Monning",33,0,7,0,40
623742,372348,2014-06-17,Assembly,"Do pass and be re-referred to the Committee on Appropriations",7,0,0,0,7
623742,375616,2014-07-02,Assembly,"Do pass, to Consent Calendar",17,0,0,0,17
623742,377645,2014-08-18,Assembly,"SB 1117 Monning  Senate Third Reading  By EGGMAN",76,0,0,3,79
623742,377774,2014-08-19,Senate,"Unfinished Business SB1117 Monning Concurrence",34,0,6,0,40
623744,357961,2014-04-21,Senate,"Do pass as amended, and re-refer to the Committee on 	Appropriations",3,1,1,0,5
623744,362205,2014-05-05,Senate,"Senate 3rd Reading SB1071 Beall",36,0,4,0,40
623744,374706,2014-06-25,Assembly,"Do pass",6,1,0,0,7
623744,375259,2014-06-30,Assembly,"SB 1071 Beall  Senate Third Reading  By WIECKOWSKI",60,17,0,2,79
623744,376387,2014-08-04,Senate,"Unfinished Business SB1071 Beall Concurrence",36,0,4,0,40
623744,378600,2014-08-26,Senate,"Unfinished Business SB1071 Beall Concurrence",34,0,6,0,40
623745,348065,2014-03-26,Senate,"Do pass as amended, and re-refer to the Committee on Public Safety",9,0,0,0,9
623745,360737,2014-04-29,Senate,"Do pass, but re-refer to the Committee on Appropriations",6,0,1,0,7
623745,363756,2014-05-12,Senate,"Placed on Appropriations Suspense file",7,0,0,0,7
623746,362745,2014-05-06,Assembly,"Do pass",4,6,0,0,10
623746,362746,2014-05-06,Assembly,"Set first hearing.  Failed passage.  Reconsideration granted",10,0,0,0,10
623747,355315,2014-04-09,Assembly,"Do pass as amended and be re-referred to the Committee on 	Appropriations",5,2,0,0,7
623748,353248,2014-04-08,Assembly,"Do pass and re-refer to Committee on Appropriations with 	recommendation:  To Consent Calendar",15,0,0,0,15
623748,361167,2014-04-30,Assembly,"Do pass, to Consent Calendar",17,0,0,0,17
623748,363395,2014-05-08,Assembly,"AB 1905 ALEJO  Consent Calendar Second Day  Regular Session",73,0,0,6,79
623748,374081,2014-06-24,Senate,"Do pass, but re-refer to the Committee on Appropriations Recommend 	Consent",9,0,0,0,9
623748,376803,2014-08-07,Senate,"Consent Calendar 2nd AB1905 Alejo",34,0,6,0,40
623750,348252,2014-03-25,Assembly,"Do pass as amended and re-refer to Committee on Appropriations 	with recommendation:  To Consent Calendar",7,0,0,0,7
623750,354220,2014-04-09,Assembly,"Do pass, to Consent Calendar",17,0,0,0,17
623750,359710,2014-04-24,Assembly,"AB 1900 QUIRK  Consent Calendar Second Day  Regular Session",75,0,0,4,79
623750,370482,2014-06-10,Senate,"Do pass, but re-refer to the Committee on Appropriations",6,0,1,0,7
623750,375640,2014-07-03,Senate,"Special Consent #18 AB1900 Quirk",35,0,5,0,40
623751,353258,2014-04-07,Assembly,"Do pass as amended and be re-referred to the Committee on 	Appropriations",9,0,0,0,9
623751,361297,2014-04-30,Assembly,"Do pass",16,0,0,1,17
623751,362257,2014-05-05,Assembly,"AB 1846 GORDON  Assembly Third Reading",74,0,0,5,79
623751,369847,2014-06-04,Senate,"Do pass, but re-refer to the Committee on Appropriations",5,0,2,0,7
623751,377013,2014-08-11,Senate,"Assembly 3rd Reading AB1846 Gordon By Jackson",36,0,4,0,40
623751,377673,2014-08-18,Assembly,"AB 1846 GORDON  Concurrence in Senate Amendments",76,0,0,3,79
623752,347545,2014-03-25,Assembly,"Do pass and be re-referred to the Committee on Judiciary",14,2,0,3,19
623752,360833,2014-04-29,Assembly,"Do pass as amended and be re-referred to the Committee on 	Appropriations",10,0,0,0,10
623752,365367,2014-05-19,Assembly,"AB 1898 BROWN  Assembly Third Reading",68,2,0,9,79
623752,373404,2014-06-18,Senate,"Do pass, but re-refer to the Committee on Judiciary",8,0,1,0,9
623752,374361,2014-06-24,Senate,"Do pass and be placed on the Consent Calendar",7,0,0,0,7
623752,378794,2014-08-27,Senate,"Assembly 3rd Reading AB1898 Brown By Hernandez",36,0,4,0,40
623752,378880,2014-08-28,Assembly,"AB 1898 BROWN  Concurrence in Senate Amendments",77,0,0,2,79
623753,362647,2014-05-06,Assembly,"Do pass as amended",14,0,0,0,14
623753,365283,2014-05-19,Assembly,"AB 1890 CHAU  Assembly Third Reading",72,2,0,5,79
623753,371765,2014-06-16,Senate,"Do pass",7,0,2,0,9
623753,375296,2014-06-30,Senate,"Assembly 3rd Reading AB1890 Chau By Lieu",34,0,6,0,40
623754,358473,2014-04-22,Senate,"Do pass as amended, and re-refer to the Committee on Appropriations",7,0,0,0,7
623754,358474,2014-04-22,Senate,"Do pass as amended, and re-refer to the Committee on Appropriations",7,0,0,0,7
623754,363724,2014-05-12,Senate,"Placed on Appropriations Suspense file",7,0,0,0,7
623755,361708,2014-04-30,Assembly,"Do pass and be re-referred to the Committee on Appropriations",7,0,0,0,7
623755,367120,2014-05-23,Assembly,"Do pass as amended",12,0,0,5,17
623755,368059,2014-05-28,Assembly,"AB 1892 BOCANEGRA  Assembly Third Reading",77,0,0,2,79
623755,372582,2014-06-18,Senate,"Do pass as amended, and re-refer to the Committee on Appropriations",7,0,0,0,7
623755,376457,2014-08-04,Senate,"Placed on Appropriations Suspense file",7,0,0,0,7
623755,377226,2014-08-14,Senate,"Do pass as amended",6,0,1,0,7
623757,361144,2014-04-29,Senate,"Do pass, but re-refer to the Committee on Appropriations",11,0,0,0,11
623757,363728,2014-05-12,Senate,"Placed on Appropriations Suspense file",7,0,0,0,7
623758,359095,2014-04-22,Assembly,"Do pass as amended and be re-referred to the Committee on 	Appropriations",5,0,0,4,9
623758,364527,2014-05-14,Assembly,"Do pass",15,0,0,2,17
623758,366818,2014-05-23,Assembly,"AB 1910 GRAY  Assembly Third Reading",69,2,0,8,79
623758,374506,2014-06-25,Senate,"Do pass, but re-refer to the Committee on Appropriations",5,0,0,0,5
623758,376483,2014-08-04,Senate,"Placed on Appropriations Suspense file",7,0,0,0,7
623758,377418,2014-08-14,Senate,"Do pass as amended",5,0,2,0,7
623758,377926,2014-08-20,Senate,"Assembly 3rd Reading AB1910 Gray By Cannella",32,0,8,0,40
623758,378214,2014-08-22,Assembly,"AB 1910 GRAY  Concurrence in Senate Amendments",68,1,0,10,79
623759,362576,2014-05-06,Assembly,"Do pass and be re-referred to the Committee on Appropriations",11,6,0,2,19
623760,359199,2014-04-23,Assembly,"Do pass as amended and be re-referred to the Committee on 	Appropriations",7,0,0,0,7
623761,358567,2014-04-22,Assembly,"Do pass and be re-referred to the Committee on Appropriations",5,0,0,2,7
623762,353225,2014-04-08,Senate,"Do pass, but re-refer to the Committee on Appropriations",2,2,3,0,7
623762,353226,2014-04-08,Senate,"Set, first hearing.  Failed passage in Committee.  Reconsideration 	granted",7,0,0,0,7
623763,350980,2014-04-02,Assembly,"Do pass",9,0,0,0,9
623763,359746,2014-04-24,Assembly,"AB 1888 TING  Assembly Third Reading",75,0,0,4,79
623763,364448,2014-05-14,Senate,"Do pass",6,0,1,0,7
623763,367106,2014-05-23,Senate,"Special Consent #15 AB1888 Ting",32,0,8,0,40
623764,360095,2014-04-28,Senate,"Do pass, but re-refer to the Committee on Appropriations",9,0,0,0,9
623764,364812,2014-05-15,Senate,"Special Consent #14 SB1119 Leno",36,0,4,0,40
623764,374024,2014-06-24,Assembly,"Do pass and be re-referred to the Committee on Appropriations",7,0,0,0,7
623764,377057,2014-08-13,Assembly,"Do pass",16,1,0,0,17
623764,378180,2014-08-21,Assembly,"SB 1119 Leno  Senate Third Reading  By CALDERON",78,1,0,0,79
623764,378244,2014-08-22,Senate,"Unfinished Business SB1119 Leno Concurrence",32,0,8,0,40
623766,354300,2014-04-08,Assembly,"Do pass and be re-referred to the Committee on Education",5,1,0,1,7
623766,361860,2014-04-30,Assembly,"Do pass and be re-referred to the Committee on Appropriations",7,0,0,0,7
623767,353368,2014-04-07,Assembly,"Do pass as amended and be re-referred to the Committee on 	Appropriations",7,1,0,1,9
623767,361242,2014-04-30,Assembly,"Do pass",17,0,0,0,17
623767,367032,2014-05-23,Assembly,"AB 1867 PATTERSON  Assembly Third Reading",67,2,0,10,79
623767,374128,2014-06-24,Senate,"Do pass as amended, and re-refer to the Committee on Appropriations",9,0,0,0,9
623767,378098,2014-08-21,Senate,"Assembly 3rd Reading AB1867 Patterson By Vidak",32,2,6,0,40
623767,378227,2014-08-22,Assembly,"AB 1867 PATTERSON  Concurrence in Senate Amendments",69,1,0,9,79
623768,362692,2014-05-06,Assembly,"Do pass",10,0,0,0,10
623768,365288,2014-05-19,Assembly,"AB 1847 CHESBRO  Assembly Third Reading",76,0,0,3,79
623768,373031,2014-06-17,Senate,"Do pass and be placed on the Consent Calendar",6,0,1,0,7
623768,374771,2014-06-26,Senate,"Consent Calendar 2nd AB1847 Chesbro",32,0,8,0,40
623768,375225,2014-06-30,Assembly,"AB 1847 CHESBRO  Concurrence in Senate Amendments",78,0,0,1,79
623769,354595,2014-04-08,Assembly,"Do pass and be re-referred to the Committee on Appropriations",16,1,0,2,19
623769,361280,2014-04-30,Assembly,"Do pass as amended",13,4,0,0,17
623769,363504,2014-05-08,Assembly,"AB 1951 GOMEZ  Assembly Third Reading",53,14,0,12,79
623769,372763,2014-06-17,Senate,"Do pass as amended, and re-refer to the Committee on 	Appropriations",6,0,1,0,7
623769,377125,2014-08-14,Senate,"Assembly 3rd Reading AB1951 Gomez By Block",26,4,10,0,40
623769,377909,2014-08-20,Assembly,"AB 1951 GOMEZ  Concurrence in Senate Amendments",58,15,0,6,79
623770,358464,2014-04-22,Senate,"Do pass, but re-refer to the Committee on Appropriations",4,0,1,0,5
623770,363366,2014-05-08,Senate,"Special Consent #13 SB1127 Torres",35,0,5,0,40
623770,370724,2014-06-10,Assembly,"Do pass and be re-referred to the Committee on Aging and Long",7,0,0,0,7
623770,374427,2014-06-24,Assembly,"Do pass and re-refer to Committee on Appropriations with 	recommendation:  To Consent Calendar",6,0,0,1,7
623770,376710,2014-08-06,Assembly,"Do pass, to Consent Calendar",17,0,0,0,17
623770,377221,2014-08-14,Assembly,"SB 1127 Torres  Consent Calendar Second Day  Regular Session",78,0,0,1,79
623770,377636,2014-08-18,Senate,"Unfinished Business SB1127 Torres Concurrence",36,0,4,0,40
623772,360582,2014-04-29,Assembly,"Do pass and be re-referred to the Committee on Appropriations",2,4,0,1,7
623775,362563,2014-05-06,Assembly,"Do pass",3,3,0,1,7
623775,362564,2014-05-06,Assembly,"Set first hearing.  Failed passage.  Reconsideration granted",4,0,0,3,7
623775,363386,2014-05-08,Assembly,"Do pass",4,2,0,1,7
623775,368753,2014-05-29,Assembly,"AB 1873 GONZALEZ  Assembly Third Reading",44,32,0,3,79
623775,374577,2014-06-24,Senate,"Do pass",5,0,0,0,5
623775,378698,2014-08-27,Senate,"From Committee:  That the measure be returned to the Senate floor 	for consideration",4,0,1,0,5
623775,378948,2014-08-28,Assembly,"AB 1873 GONZALEZ  Concurrence in Senate Amendments",47,29,0,3,79
623775,378949,2014-08-28,Senate,"Assembly 3rd Reading AB1873 Gonzalez By Padilla",24,8,8,0,40
623776,350304,2014-04-01,Senate,"Do pass as amended, and re-refer to the Committee on Appropriations",9,0,2,0,11
623776,360096,2014-04-28,Senate,"Placed on Appropriations Suspense file",6,0,1,0,7
623776,366957,2014-05-23,Senate,"Do pass as amended",7,0,0,0,7
623776,368003,2014-05-28,Senate,"Senate 3rd Reading SB1090 Fuller",37,0,3,0,40
623776,373997,2014-06-23,Assembly,"Do pass as amended and re-refer to Committee on Appropriations 	with recommendation:  To Consent Calendar",14,0,0,1,15
623776,376668,2014-08-06,Assembly,"Do pass, to Consent Calendar",17,0,0,0,17
623776,377946,2014-08-20,Assembly,"SB 1090 Fuller  Senate Third Reading  By PATTERSON",76,2,0,1,79
623776,378072,2014-08-21,Senate,"Unfinished Business SB1090 Fuller Concurrence",34,0,6,0,40
623777,354714,2014-04-08,Assembly,"Do pass as amended and be re-referred to the Committee on Aging and 	Long",6,0,0,1,7
623777,360594,2014-04-29,Assembly,"Do pass and be re-referred to the Committee on Appropriations",7,0,0,0,7
623777,366777,2014-05-23,Assembly,"Do pass as amended",17,0,0,0,17
623777,368072,2014-05-28,Assembly,"AB 1899 BROWN  Assembly Third Reading",77,0,0,2,79
623777,374449,2014-06-24,Senate,"Do pass as amended, but re-refer to the Committee on Appropriations 	Recommend Consent",4,0,1,0,5
623777,376779,2014-08-07,Senate,"Consent Calendar 2nd AB1899 Brown",34,0,6,0,40
623777,378582,2014-08-26,Senate,"Assembly 3rd Reading AB1899 Brown By Liu",33,0,7,0,40
623777,378614,2014-08-27,Assembly,"AB 1899 BROWN  Concurrence in Senate Amendments",78,0,0,1,79
623778,353646,2014-04-07,Assembly,"Do pass and be re-referred to the Committee on Judiciary to Consent 	Calendar",12,0,0,0,12
623778,358566,2014-04-22,Assembly,"Do pass, to Consent Calendar",10,0,0,0,10
623778,360086,2014-04-28,Assembly,"AB 1856 WILK  Consent Calendar Second Day  Regular Session",78,0,0,1,79
623778,370005,2014-06-04,Senate,"Do pass as amended, and re-refer to the Committee on Judiciary",8,0,1,0,9
623778,372712,2014-06-17,Senate,"Do pass",6,0,1,0,7
623778,375635,2014-07-03,Senate,"Special Consent #18 AB1856 Wilk",35,0,5,0,40
623778,377635,2014-08-18,Assembly,"AB 1856 WILK  Concurrence in Senate Amendments",77,0,0,2,79
623780,361111,2014-04-29,Senate,"Do pass, but re-refer to the Committee on Appropriations",9,0,2,0,11
623780,363714,2014-05-12,Senate,"Placed on Appropriations Suspense file",7,0,0,0,7
623780,366689,2014-05-23,Senate,"Do pass",6,1,0,0,7
623780,367494,2014-05-27,Senate,"Senate 3rd Reading SB1077 DeSaulnier",23,11,6,0,40
623780,373762,2014-06-23,Assembly,"Do pass as amended and be re-referred to the Committee on 	Appropriations",10,4,0,2,16
623780,377324,2014-08-14,Assembly,"Do pass",12,5,0,0,17
623780,378363,2014-08-25,Assembly,"SB 1077 DeSaulnier  Senate Third Reading  By LOWENTHAL",46,26,0,7,79
623780,378438,2014-08-26,Senate,"Unfinished Supp 1 SB1077 DeSaulnier Concurrence",23,11,6,0,40
623781,351774,2014-04-02,Assembly,"Do pass and be re-referred to the Committee on Judiciary",6,0,0,1,7
623781,360512,2014-04-29,Assembly,"Do pass, to Consent Calendar",10,0,0,0,10
623781,362196,2014-05-05,Assembly,"AB 1939 DALY  Consent Calendar Second Day  Regular Session",75,0,0,4,79
623781,371002,2014-06-10,Senate,"Do pass",6,0,1,0,7
623781,375214,2014-06-30,Senate,"Assembly 3rd Reading AB1939 Daly By Padilla",36,0,4,0,40
623781,375663,2014-07-03,Assembly,"AB 1939 DALY  Concurrence in Senate Amendments",77,0,0,2,79
623782,351027,2014-04-02,Senate,"Do pass as amended, and re-refer to the Committee on Appropriations",8,0,1,0,9
623782,360104,2014-04-28,Senate,"Placed on Appropriations Suspense file",6,0,1,0,7
623783,361102,2014-04-30,Assembly,"Do pass and be re-referred to the Committee on Appropriations",8,2,0,3,13
623783,364245,2014-05-14,Assembly,"Do pass",12,3,0,2,17
623783,367547,2014-05-27,Assembly,"AB 1921 HOLDEN  Assembly Third Reading",55,15,0,9,79
623783,370629,2014-06-10,Senate,"Do pass, but re-refer to the Committee on Appropriations",7,1,2,0,10
623783,375250,2014-06-30,Senate,"Placed on Appropriations Suspense file",6,0,1,0,7
623787,358482,2014-04-22,Assembly,"Do pass and be re-referred to the Committee on Appropriations",5,2,0,0,7
623787,366807,2014-05-23,Assembly,"Do pass as amended",9,5,0,3,17
623787,368677,2014-05-29,Assembly,"AB 1894 AMMIANO  Assembly Third Reading",26,33,0,20,79
623788,347136,2014-03-24,Assembly,"Do pass and be re-referred to the Committee on Judiciary",14,0,0,2,16
623788,353404,2014-04-08,Assembly,"Do pass and be re-referred to the Committee on Appropriations",10,0,0,0,10
623789,361639,2014-04-30,Senate,"Do pass, but re-refer to the Committee on Appropriations",5,1,3,0,9
623789,365254,2014-05-19,Senate,"Placed on Appropriations Suspense file",7,0,0,0,7
623790,354619,2014-04-02,Assembly,"Do pass and be re-referred to the Committee on Appropriations",19,0,0,0,19
623790,367175,2014-05-23,Assembly,"Do pass as amended",16,0,0,1,17
623790,368169,2014-05-28,Assembly,"AB 1973 HERNANDEZ  Assembly Third Reading",76,0,0,3,79
623790,374054,2014-06-24,Senate,"Do pass, but re-refer to the Committee on Appropriations",10,0,0,0,10
623790,376616,2014-08-04,Senate,"Placed on Appropriations Suspense file",7,0,0,0,7
623790,377587,2014-08-14,Senate,"Do pass",5,0,2,0,7
623790,377746,2014-08-19,Senate,"Assembly 3rd Reading AB1973 Roger Hern",32,0,8,0,40
623791,359112,2014-04-23,Assembly,"Do pass",7,0,0,2,9
623791,366977,2014-05-23,Assembly,"AB 1876 QUIRK  Assembly Third Reading",42,21,0,16,79
623791,372270,2014-06-17,Senate,"Do pass, but re-refer to the Committee on Appropriations",5,0,2,0,7
623791,376429,2014-08-04,Senate,"Placed on Appropriations Suspense file",7,0,0,0,7
623792,358948,2014-04-22,Senate,"Do pass, but re-refer to the Committee on Appropriations",7,1,1,0,9
623792,362313,2014-05-05,Senate,"Placed on Appropriations Suspense file",7,0,0,0,7
623792,367129,2014-05-23,Senate,"Do pass as amended",5,2,0,0,7
623792,368714,2014-05-29,Senate,"Senate 3rd Reading SB1120 Galgiani",37,0,3,0,40
623792,372149,2014-06-17,Assembly,"Do pass and be re-referred to the Committee on Appropriations",15,0,0,0,15
623792,376735,2014-08-06,Assembly,"Do pass, to Consent Calendar",17,0,0,0,17
623792,377279,2014-08-14,Assembly,"SB 1120 Galgiani  Consent Calendar Second Day  Regular Session",78,0,0,1,79
623793,360706,2014-04-28,Assembly,"Do pass as amended and be re-referred to the Committee on 	Appropriations",8,0,0,1,9
623794,362778,2014-05-06,Assembly,"Do pass",2,5,0,0,7
623796,350491,2014-04-01,Senate,"Be adopted and be placed on the Consent Calendar",11,0,0,0,11
623796,355167,2014-04-10,Senate,"Consent Calendar 2nd SR28 Committee on T. & H. (DeSaulnier)",34,0,6,0,40
623797,358536,2014-04-22,Senate,"Do pass and be placed on the Consent Calendar",9,0,0,0,9
623797,360091,2014-04-28,Senate,"Consent Calendar 2nd SB1096 Jackson",36,0,4,0,40
623797,373304,2014-06-19,Assembly,"Be referred to Committee on Natural Resources",11,0,0,0,11
623797,374777,2014-06-26,Assembly,"Do pass and be re-referred to the Committee on Appropriations",6,2,0,1,9
623797,377446,2014-08-14,Assembly,"Do pass",10,6,0,1,17
623797,378527,2014-08-26,Assembly,"SB 1096 Jackson  Senate Third Reading  By WILLIAMS",30,36,0,13,79
623798,360573,2014-04-29,Senate,"Do pass as amended, and re-refer to the Committee on Rules",7,3,1,0,11
623799,359243,2014-04-22,Senate,"Do pass, but re-refer to the Committee on Appropriations",4,1,0,0,5
623799,363771,2014-05-12,Senate,"Placed on Appropriations Suspense file",7,0,0,0,7
623800,348327,2014-03-26,Assembly,"Do pass and be re-referred to the Committee on Appropriations",6,0,0,1,7
623800,366764,2014-05-23,Assembly,"Do pass as amended",13,0,0,4,17
623800,368627,2014-05-29,Assembly,"AB 1866 BOCANEGRA  Assembly Third Reading",62,12,0,5,79
623800,372835,2014-06-18,Senate,"Do pass as amended, and re-refer to the Committee on Appropriations",7,0,0,0,7
623800,376582,2014-08-04,Senate,"Placed on Appropriations Suspense file",7,0,0,0,7
623800,377403,2014-08-14,Senate,"Do pass as amended",5,1,1,0,7
623800,378327,2014-08-25,Senate,"Assembly 3rd Reading AB1866 Bocanegra By Monning",30,4,6,0,40
623800,378626,2014-08-27,Assembly,"AB 1866 BOCANEGRA  Concurrence in Senate Amendments",63,15,0,1,79
623802,361370,2014-04-30,Assembly,"Do pass as amended and be re-referred to the Committee on 	Appropriations",7,0,0,0,7
623802,366249,2014-05-21,Assembly,"Do pass, to Consent Calendar",17,0,0,0,17
623802,367504,2014-05-27,Assembly,"AB 1929 CHAU  Consent Calendar Second Day  Regular Session",77,0,0,2,79
623802,373388,2014-06-18,Senate,"Do pass, but re-refer to the Committee on Transportation and 	Housing Recommend Consent",8,0,1,0,9
623802,374000,2014-06-24,Senate,"Do pass as amended, but re-refer to the Committee on Appropriations 	Recommend Consent",11,0,0,0,11
623802,378021,2014-08-21,Senate,"Assembly 3rd Reading AB1929 Chau By DeSaulnier",32,0,8,0,40
623802,378194,2014-08-22,Assembly,"AB 1929 CHAU  Concurrence in Senate Amendments",76,0,0,3,79
623803,350250,2014-04-01,Assembly,"Do pass and be re-referred to the Committee on Banking and Finance",9,4,0,0,13
623803,360532,2014-04-28,Assembly,"Do pass as amended and be re-referred to the Committee on 	Appropriations",7,3,0,2,12
623803,364403,2014-05-14,Assembly,"Do pass",12,5,0,0,17
623803,365238,2014-05-19,Assembly,"AB 1927 FRAZIER  Assembly Third Reading",53,22,0,4,79
623803,370831,2014-06-11,Senate,"Do pass as amended, and re-refer to the Committee on Banking and 	Financial Institution",5,2,0,0,7
623803,374348,2014-06-25,Senate,"Do pass as amended, and re-refer to the Committee on Appropriations",6,2,1,0,9
623803,376417,2014-08-04,Senate,"Placed on Appropriations Suspense file",7,0,0,0,7
623803,377412,2014-08-14,Senate,"Do pass as amended",5,0,2,0,7
623803,378673,2014-08-27,Senate,"Assembly 3rd Reading AB1927 Frazier By Evans",23,12,5,0,40
623803,378902,2014-08-28,Assembly,"AB 1927 FRAZIER  Concurrence in Senate Amendments",55,24,0,0,79
623806,360508,2014-04-29,Assembly,"Do pass",14,0,0,0,14
623806,362183,2014-05-05,Assembly,"AB 1904 BONILLA  Assembly Third Reading",75,0,0,4,79
623807,354392,2014-04-02,Assembly,"Do pass and be re-referred to the Committee on Appropriations",19,0,0,0,19
623807,361203,2014-04-30,Assembly,"Do pass",16,0,0,1,17
623807,362312,2014-05-05,Assembly,"AB 1928 BOCANEGRA  Assembly Third Reading",75,1,0,3,79
623807,370635,2014-06-10,Senate,"Do pass, but re-refer to the Committee on Appropriations",8,0,2,0,10
623807,375333,2014-06-30,Senate,"Assembly 3rd Reading AB1928 Bocanegra By Padilla",33,0,7,0,40
623807,375679,2014-07-03,Assembly,"AB 1928 BOCANEGRA  Concurrence in Senate Amendments",76,1,0,2,79
623808,353239,2014-04-08,Senate,"Do pass, but re-refer to the Committee on Governance and Finance",6,0,1,0,7
623808,359768,2014-04-24,Senate,"Do pass, but re-refer to the Committee on Appropriations",7,0,0,0,7
623808,362252,2014-05-05,Senate,"Placed on Appropriations Suspense file",7,0,0,0,7
623808,366812,2014-05-23,Senate,"Do pass",7,0,0,0,7
623808,367562,2014-05-27,Senate,"Senate 3rd Reading SB1113 Knight",36,0,4,0,40
623808,374769,2014-06-25,Assembly,"Do pass and be re-referred to the Committee on Appropriations",9,0,0,0,9
623808,377531,2014-08-14,Assembly,"Do pass",17,0,0,0,17
623808,377797,2014-08-19,Assembly,"SB 1113 Knight  Senate Third Reading  By GROVE",78,0,0,1,79
623809,348151,2014-03-26,Assembly,"Do pass and re-refer to Committee on Appropriations with 	recommendation:  To Consent Calendar",6,0,0,1,7
623809,354910,2014-04-09,Assembly,"Do pass",16,0,0,1,17
623809,359574,2014-04-24,Assembly,"AB 1912 HOLDEN  Assembly Third Reading",73,0,0,6,79
623809,370885,2014-06-11,Senate,"Do pass as amended, and re-refer to the Committee on Appropriations",7,0,0,0,7
623809,376776,2014-08-07,Senate,"Assembly 3rd Reading AB1912 Holden By Mitchell",30,1,9,0,40
623809,376916,2014-08-11,Assembly,"AB 1912 HOLDEN  Concurrence in Senate Amendments",76,1,0,2,79
623811,359422,2014-04-22,Senate,"Do pass, but re-refer to the Committee on Appropriations",4,1,0,0,5
623811,363737,2014-05-12,Senate,"Placed on Appropriations Suspense file",7,0,0,0,7
623811,366828,2014-05-23,Senate,"Do pass",5,2,0,0,7
623811,368734,2014-05-29,Senate,"Senate 3rd Reading SB1104 Padilla",28,9,3,0,40
623811,374654,2014-06-24,Assembly,"Do pass and be re-referred to the Committee on Appropriations",5,0,0,2,7
623813,358970,2014-04-21,Assembly,"Do pass and be re-referred to the Committee on Appropriations",15,0,0,1,16
623813,367186,2014-05-23,Assembly,"Do pass",17,0,0,0,17
623813,367585,2014-05-27,Assembly,"AB 1957 DICKINSON  Assembly Third Reading",77,0,0,2,79
623813,372489,2014-06-17,Senate,"Do pass, but re-refer to the Committee on Appropriations Recommend 	Consent",11,0,0,0,11
623813,375451,2014-06-30,Senate,"Placed on Appropriations Suspense file",6,0,1,0,7
623813,377543,2014-08-14,Senate,"Do pass",5,0,2,0,7
623813,378288,2014-08-25,Senate,"Assembly 3rd Reading AB1957 Dickinson By Gaines",34,0,6,0,40
623813,378597,2014-08-26,Assembly,"AB 1957 DICKINSON  Concurrence in Senate Amendments",79,0,0,0,79
623814,347796,2014-03-25,Assembly,"Be adopted and be re-referred to the Committee on Appropriations",14,0,0,0,14
623814,354692,2014-04-09,Assembly,"From committee:  Be adopted.  To third reading",15,0,0,2,17
623814,362236,2014-05-05,Assembly,"ACR 101 JONES-SAWYER  Assembly Third Reading",72,0,0,7,79
623814,370824,2014-06-10,Senate,"Be adopted as amended, and re-refer to the Committee on 	Appropriations",5,1,1,0,7
623814,375221,2014-06-30,Senate,"Placed on Appropriations Suspense file",6,0,1,0,7
623814,377981,2014-08-20,Senate,"Assembly 3rd Reading ACR101 Jones-Sawyer By Hill",34,0,6,0,40
623814,378163,2014-08-21,Assembly,"ACR 101 JONES-SAWYER  Concurrence in Senate Amendments",75,0,0,4,79
623815,350975,2014-04-02,Assembly,"Do pass and be re-referred to the Committee on Banking and Finance",9,0,0,0,9
623815,358943,2014-04-21,Assembly,"Do pass as amended",10,0,0,2,12
623815,361795,2014-05-01,Assembly,"AB 1933 LEVINE  Assembly Third Reading",75,0,0,4,79
623815,370861,2014-06-11,Senate,"Do pass and be placed on the Consent Calendar",7,0,0,0,7
623815,371734,2014-06-16,Senate,"Consent Calendar 2nd AB1933 Levine",35,0,5,0,40
623817,360713,2014-04-29,Senate,"Do pass",6,0,1,0,7
623817,363401,2014-05-08,Senate,"Special Consent #13 SB1110 Jackson",35,0,5,0,40
623817,370653,2014-06-10,Assembly,"Do pass as amended, to Consent Calendar",7,0,0,0,7
623817,376680,2014-08-06,Assembly,"Do pass, to Consent Calendar",17,0,0,0,17
623817,377475,2014-08-14,Assembly,"SB 1110 Jackson  Consent Calendar Second Day  Regular Session",78,0,0,1,79
623817,378065,2014-08-21,Senate,"Unfinished Business SB1110 Jackson Concurrence",35,0,5,0,40
623819,359169,2014-04-22,Senate,"Do pass as amended, and re-refer to the Committee on 	Appropriations",6,0,1,0,7
623819,363707,2014-05-12,Senate,"Placed on Appropriations Suspense file",7,0,0,0,7
623819,366722,2014-05-23,Senate,"Do pass",7,0,0,0,7
623819,367542,2014-05-27,Senate,"Senate 3rd Reading SB1099 Steinberg",35,0,5,0,40
623819,374079,2014-06-24,Assembly,"Do pass and re-refer to Committee on Appropriations with 	recommendation:  To Consent Calendar",9,0,0,1,10
623819,377417,2014-08-14,Assembly,"Do pass as amended",14,0,0,3,17
623819,378755,2014-08-27,Assembly,"SB 1099 Steinberg  Senate Third Reading  By WEBER",78,0,0,1,79
623819,378998,2014-08-29,Senate,"Unfinished Business SB1099 Steinberg Concurrence",37,0,3,0,40
623821,354534,2014-04-08,Assembly,"Do pass as amended and re-refer to Committee on Appropriations 	with recommendation:  To Consent Calendar",19,0,0,0,19
623821,361134,2014-04-30,Assembly,"Do pass, to Consent Calendar",17,0,0,0,17
623821,363434,2014-05-08,Assembly,"AB 1967 PAN  Consent Calendar Second Day  Regular Session",73,0,0,6,79
623821,374897,2014-06-25,Senate,"Do pass as amended, and re-refer to the Committee on 	Appropriations",8,0,1,0,9
623821,377972,2014-08-20,Senate,"Assembly 3rd Reading AB1967 Pan By Cannella",35,0,5,0,40
623821,378152,2014-08-21,Assembly,"AB 1967 PAN  Concurrence in Senate Amendments",78,0,0,1,79
623822,347653,2014-03-25,Assembly,"Do pass and be re-referred to the Committee on Appropriations",18,0,0,1,19
623822,367159,2014-05-23,Assembly,"Do pass",14,0,0,3,17
623822,367548,2014-05-27,Assembly,"AB 1868 GOMEZ  Assembly Third Reading",76,0,0,3,79
623822,374869,2014-06-25,Senate,"Do pass, but re-refer to the Committee on Appropriations",8,0,1,0,9
623822,376628,2014-08-04,Senate,"Placed on Appropriations Suspense file",7,0,0,0,7
623823,360643,2014-04-29,Assembly,"Do pass as amended",10,0,0,0,10
623823,367071,2014-05-23,Assembly,"AB 1858 PEREA  Assembly Third Reading",73,0,0,6,79
623823,374522,2014-06-24,Senate,"Do pass as amended",7,0,0,0,7
623823,376850,2014-08-07,Senate,"Assembly 3rd Reading AB1858 Perea By Cannella",35,0,5,0,40
623823,376894,2014-08-11,Assembly,"AB 1858 PEREA  Concurrence in Senate Amendments",77,0,0,2,79
623825,354419,2014-04-09,Senate,"Do pass, but re-refer to the Committee on Rules",5,1,3,0,9
623825,358451,2014-04-22,Senate,"Do pass, but re-refer to the Committee on Appropriations",3,1,1,0,5
623825,365251,2014-05-19,Senate,"Placed on Appropriations Suspense file",7,0,0,0,7
623825,366685,2014-05-23,Senate,"Do pass as amended",5,2,0,0,7
623825,368035,2014-05-28,Senate,"Senate 3rd Reading SB1123 Liu",25,11,4,0,40
623825,372257,2014-06-17,Assembly,"Do pass as amended and be re-referred to the Committee on Education",5,2,0,0,7
623825,374794,2014-06-25,Assembly,"Do pass and be re-referred to the Committee on Appropriations",5,2,0,0,7
623826,351067,2014-04-02,Senate,"Do pass as amended, and re-refer to the Committee on Rules",6,0,1,0,7
623826,361158,2014-04-29,Senate,"Do pass as amended, and re-refer to the Committee on 	Appropriations",9,1,1,0,11
623826,365417,2014-05-19,Senate,"Placed on Appropriations Suspense file",7,0,0,0,7
623827,359858,2014-04-24,Senate,"Do pass, but re-refer to the Committee on Appropriations",7,1,1,0,9
623827,362189,2014-05-05,Senate,"Placed on Appropriations Suspense file",7,0,0,0,7
623827,367056,2014-05-23,Senate,"Do pass",5,2,0,0,7
623827,367460,2014-05-27,Senate,"Senate 3rd Reading SB1100 Hernandez",25,10,5,0,40
623828,358507,2014-04-22,Senate,"Do pass, but re-refer to the Committee on Appropriations Recommend 	Consent",10,0,0,0,10
623828,364839,2014-05-15,Senate,"Consent Calendar 2nd SB1074 Knight",36,0,4,0,40
623828,372715,2014-06-18,Assembly,"Do pass as amended and be re-referred to the Committee on 	Appropriations",13,0,0,0,13
623828,375529,2014-07-02,Assembly,"Do pass, to Consent Calendar",17,0,0,0,17
623828,376855,2014-08-07,Assembly,"SB 1074 Knight  Consent Calendar Second Day  Regular Session",77,0,0,2,79
623828,376910,2014-08-11,Senate,"Unfinished Business SB1074 Knight Concurrence",36,0,4,0,40
623829,350952,2014-04-02,Assembly,"Do pass and be re-referred to the Committee on Appropriations",9,0,0,0,9
623829,361377,2014-04-30,Assembly,"Do pass",15,0,0,2,17
623829,363388,2014-05-08,Assembly,"AB 1943 CHESBRO  Assembly Third Reading",72,0,0,7,79
623829,374256,2014-06-24,Senate,"Do pass as amended, and re-refer to the Committee on Appropriations",8,1,0,0,9
623829,376595,2014-08-04,Senate,"Placed on Appropriations Suspense file",7,0,0,0,7
623829,377496,2014-08-14,Senate,"Do pass",5,0,2,0,7
623829,377767,2014-08-19,Senate,"Assembly 3rd Reading AB1943 Chesbro By Evans",32,2,6,0,40
623829,378134,2014-08-21,Assembly,"AB 1943 CHESBRO  Concurrence in Senate Amendments",72,6,0,1,79
623830,353221,2014-04-08,Assembly,"Do pass, to Consent Calendar",7,0,0,0,7
623830,357953,2014-04-21,Assembly,"AB 1919 PEREZ, V.M.  Consent Calendar Second Day  Regular Session",77,0,0,2,79
623833,359700,2014-04-24,Senate,"Do pass, but re-refer to the Committee on Appropriations",4,1,0,0,5
623833,365598,2014-05-19,Senate,"Do pass",5,2,0,0,7
623833,368752,2014-05-29,Senate,"Senate 3rd Reading SB1087 Monning",26,10,4,0,40
623833,374810,2014-06-25,Assembly,"Do pass as amended and be re-referred to the Committee on 	Appropriations",5,0,0,2,7
623833,376731,2014-08-06,Assembly,"Do pass",12,5,0,0,17
623833,377442,2014-08-14,Assembly,"SB 1087 Monning  Senate Third Reading  By MEDINA",55,23,0,1,79
623833,377836,2014-08-19,Senate,"Unfinished Business SB1087 Monning Concurrence",27,6,7,0,40
623834,355106,2014-04-09,Senate,"Do pass, but re-refer to the Committee on Appropriations",7,1,1,0,9
623834,360038,2014-04-28,Senate,"Placed on Appropriations Suspense file",6,0,1,0,7
623834,366769,2014-05-23,Senate,"Do pass",6,1,0,0,7
623834,367577,2014-05-27,Senate,"Senate 3rd Reading SB1124 Hernandez",30,5,5,0,40
623834,372148,2014-06-17,Assembly,"Do pass and be re-referred to the Committee on Appropriations",18,0,0,1,19
623834,377181,2014-08-14,Assembly,"Do pass as amended",12,0,0,5,17
623834,378324,2014-08-25,Assembly,"SB 1124 Hernandez  Senate Third Reading  By CHESBRO",78,0,0,1,79
623834,378560,2014-08-26,Senate,"Unfinished Supp 1 SB1124 Hernandez Concurrence",34,0,6,0,40
623836,348206,2014-03-25,Assembly,"Do pass and be re-referred to the Committee on Appropriations",7,0,0,0,7
623836,354913,2014-04-09,Assembly,"Do pass",16,0,0,1,17
623836,363466,2014-05-08,Assembly,"AB 1850 WALDRON  Assembly Third Reading",74,0,0,5,79
623836,370466,2014-06-10,Senate,"Do pass, but re-refer to the Committee on Appropriations",6,0,1,0,7
623836,377441,2014-08-14,Senate,"Assembly 3rd Reading AB1850 Waldron By Pavley",35,0,5,0,40
623836,377740,2014-08-19,Assembly,"AB 1850 WALDRON  Concurrence in Senate Amendments",78,0,0,1,79
623838,360586,2014-04-29,Assembly,"Do pass as amended and be re-referred to the Committee on 	Appropriations",13,5,0,1,19
623838,366992,2014-05-23,Assembly,"Do pass as amended",12,5,0,0,17
623838,368135,2014-05-28,Assembly,"AB 1917 GORDON  Assembly Third Reading",48,25,0,6,79
623838,373298,2014-06-18,Senate,"Do pass as amended, and re-refer to the Committee on 	Appropriations",6,2,1,0,9
623838,376564,2014-08-04,Senate,"Do pass",5,2,0,0,7
623840,355195,2014-04-09,Assembly,"Do pass as amended and be re-referred to the Committee on 	Appropriations",7,0,0,0,7
623840,367203,2014-05-23,Assembly,"Do pass as amended",17,0,0,0,17
623840,368263,2014-05-28,Assembly,"AB 1915 NAZARIAN  Assembly Third Reading",77,0,0,2,79
623840,372790,2014-06-18,Senate,"Do pass as amended, and re-refer to the Committee on Appropriations",7,0,0,0,7
623840,376637,2014-08-04,Senate,"Placed on Appropriations Suspense file",7,0,0,0,7
623840,377511,2014-08-14,Senate,"Do pass as amended",5,0,2,0,7
623840,378466,2014-08-26,Senate,"Assembly 3rd Reading AB1915 Nazarian By Wyland",36,0,4,0,40
623840,378699,2014-08-27,Assembly,"AB 1915 NAZARIAN  Concurrence in Senate Amendments",78,0,0,1,79
623842,361388,2014-04-30,Senate,"Do pass as amended, and re-refer to the Committee on 	Appropriations",5,2,0,0,7
623842,365356,2014-05-19,Senate,"Placed on Appropriations Suspense file",7,0,0,0,7
623843,360472,2014-04-29,Assembly,"Do pass as amended, to Consent Calendar",14,0,0,0,14
623843,363347,2014-05-08,Assembly,"AB 1852 CAMPOS  Consent Calendar Second Day  Regular Session",73,0,0,6,79
623843,372416,2014-06-17,Senate,"Do pass",5,0,2,0,7
623843,375647,2014-07-03,Senate,"Special Consent #18 AB1852 Campos",35,0,5,0,40
623844,353383,2014-04-08,Assembly,"Do pass and be re-referred to the Committee on Appropriations",7,0,0,0,7
623845,350414,2014-04-01,Assembly,"Do pass and be re-referred to the Committee on Appropriations",10,1,0,2,13
623847,360746,2014-04-28,Assembly,"Do pass and be re-referred to the Committee on Appropriations",14,0,0,2,16
623847,364522,2014-05-14,Assembly,"Do pass, to Consent Calendar",17,0,0,0,17
623847,366670,2014-05-23,Assembly,"AB 1986 LINDER  Consent Calendar Second Day  Regular Session",73,0,0,6,79
623847,375052,2014-06-26,Senate,"Do pass, but re-refer to the Committee on Appropriations",10,0,1,0,11
623847,377009,2014-08-11,Senate,"Assembly 3rd Reading AB1986 Linder By Gaines",35,0,5,0,40
623848,359887,2014-04-24,Senate,"Do pass, but re-refer to the Committee on Judiciary",6,1,2,0,9
623848,361150,2014-04-29,Senate,"Do pass, but re-refer to the Committee on Appropriations",5,2,0,0,7
623848,368026,2014-05-28,Senate,"Senate 3rd Reading SB1094 Lara",21,15,4,0,40
623848,374414,2014-06-24,Assembly,"Do pass and be re-referred to the Committee on Appropriations",11,6,0,2,19
623848,376694,2014-08-06,Assembly,"Do pass as amended",11,6,0,0,17
623848,377681,2014-08-18,Assembly,"SB 1094 Lara  Senate Third Reading  By HOLDEN",22,24,0,33,79
623848,378873,2014-08-28,Assembly,"SB 1094 Lara  Senate Third Reading  By HOLDEN",43,27,0,9,79
623848,379107,2014-08-29,Senate,"Unfinished Business SB1094 Lara Concurrence",21,13,6,0,40
623849,345952,2014-03-18,Assembly,"Be adopted",8,0,0,1,9
623849,347104,2014-03-24,Assembly,"AJR 37 MURATSUCHI  Assembly Third Reading",69,1,0,10,80
623849,373500,2014-06-19,Senate,"Assembly 3rd Reading AJR37 Muratsuchi By Lara",28,6,6,0,40
623850,347739,2014-03-25,Assembly,"Do pass as amended and be re-referred to the Committee on Local 	Government",17,1,0,1,19
623850,354510,2014-04-09,Assembly,"Do pass",8,0,0,1,9
623850,363370,2014-05-08,Assembly,"AB 1965 YAMADA  Assembly Third Reading",71,1,0,7,79
623850,375146,2014-06-25,Senate,"Do pass",8,0,1,0,9
623850,376769,2014-08-07,Senate,"Assembly 3rd Reading AB1965 Yamada By Lieu",36,0,4,0,40
623851,358439,2014-04-22,Senate,"Do pass, but re-refer to the Committee on Appropriations Recommend 	Consent",9,0,0,0,9
623851,363332,2014-05-08,Senate,"Consent Calendar 2nd SB1075 Knight",35,0,5,0,40
623851,372459,2014-06-16,Assembly,"Do pass and re-refer to Committee on Appropriations with 	recommendation:  To Consent Calendar",9,0,0,0,9
623851,375605,2014-07-02,Assembly,"Do pass, to Consent Calendar",17,0,0,0,17
623851,376792,2014-08-07,Assembly,"SB 1075 Knight  Consent Calendar Second Day  Regular Session",77,0,0,2,79
623853,360554,2014-04-29,Assembly,"Do pass and be re-referred to the Committee on Appropriations",12,1,0,0,13
623853,366978,2014-05-23,Assembly,"Do pass as amended",17,0,0,0,17
623853,368783,2014-05-29,Assembly,"AB 1969 LEVINE  Assembly Third Reading",76,1,0,2,79
623853,374599,2014-06-25,Senate,"Do pass, but re-refer to the Committee on Appropriations Recommend 	Consent",6,0,1,0,7
623853,376799,2014-08-07,Senate,"Consent Calendar 2nd AB1969 Levine",34,0,6,0,40
623853,377225,2014-08-14,Assembly,"AB 1969 LEVINE  Concurrence in Senate Amendments",79,0,0,0,79
623855,350301,2014-04-01,Assembly,"Do pass as amended",8,1,0,1,10
623855,355132,2014-04-10,Assembly,"AB 1938 HAGMAN  Assembly Third Reading",63,9,0,7,79
623856,352668,2014-04-07,Assembly,"Be referred to Committee on Health",11,0,0,0,11
623856,360592,2014-04-29,Assembly,"Do pass as amended and re-refer to Committee on Appropriations 	with recommendation:  To Consent Calendar",19,0,0,0,19
623856,364417,2014-05-14,Assembly,"Do pass, to Consent Calendar",17,0,0,0,17
623856,366917,2014-05-23,Assembly,"AB 1974 QUIRK  Consent Calendar Second Day  Regular Session",73,0,0,6,79
623856,375056,2014-06-25,Senate,"Do pass, but re-refer to the Committee on Appropriations Recommend 	Consent",8,0,1,0,9
623856,376739,2014-08-07,Senate,"Consent Calendar 2nd AB1974 Quirk",34,0,6,0,40
623856,376914,2014-08-11,Assembly,"AB 1974 QUIRK  Concurrence in Senate Amendments",79,0,0,0,79
623857,360497,2014-04-29,Assembly,"Do pass as amended and be re-referred to the Committee on 	Appropriations",11,4,0,4,19
623857,366862,2014-05-23,Assembly,"Do pass as amended",11,5,0,1,17
623858,361341,2014-04-29,Assembly,"Do pass as amended and be re-referred to the Committee on 	Appropriations",5,0,0,2,7
623858,366247,2014-05-21,Assembly,"Do pass",14,3,0,0,17
623858,367131,2014-05-23,Assembly,"AB 1978 JONES-SAWYER  Assembly Third Reading",64,9,0,6,79
623858,370591,2014-06-10,Senate,"Do pass, but re-refer to the Committee on Judiciary",3,1,1,0,5
623858,374540,2014-06-24,Senate,"Do pass, but re-refer to the Committee on Appropriations",5,2,0,0,7
623858,376634,2014-08-04,Senate,"Placed on Appropriations Suspense file",7,0,0,0,7
623858,377514,2014-08-14,Senate,"Do pass as amended",5,0,2,0,7
623858,378658,2014-08-27,Senate,"Assembly 3rd Reading AB1978 Jones-Sawyer By Beall",24,10,6,0,40
623858,378863,2014-08-28,Assembly,"AB 1978 JONES-SAWYER  Concurrence in Senate Amendments",69,10,0,0,79
624493,361126,2014-04-29,Assembly,"Do pass and be re-referred to the Committee on Appropriations",6,0,0,1,7
624493,364248,2014-05-14,Assembly,"Do pass",13,0,0,4,17
624493,365296,2014-05-19,Assembly,"AB 2044 RODRIGUEZ  Assembly Third Reading",64,1,0,14,79
624493,370673,2014-06-10,Senate,"Do pass as amended, and re-refer to the Committee on Appropriations",4,0,1,0,5
624493,378391,2014-08-25,Senate,"Assembly 3rd Reading AB2044 Rodriguez By Torres",33,0,7,0,40
624493,378830,2014-08-27,Assembly,"AB 2044 RODRIGUEZ  Concurrence in Senate Amendments",74,0,0,5,79
624494,350287,2014-04-01,Senate,"Be adopted and be placed on the Consent Calendar",7,0,0,0,7
624494,352630,2014-04-07,Senate,"Consent Calendar 2nd SCR83 Monning",36,0,4,0,40
624494,370639,2014-06-10,Assembly,"Be adopted, to Consent Calendar",9,0,0,1,10
624494,371407,2014-06-12,Assembly,"SCR 83 Monning  Consent Calendar Second Day  Regular Session",76,0,0,3,79
624495,360471,2014-04-28,Assembly,"Do pass as amended and be re-referred to the Committee on 	Appropriations",7,0,0,2,9
624496,355039,2014-04-09,Assembly,"Do pass",5,2,0,0,7
624496,364880,2014-05-15,Assembly,"AB 2127 COOLEY  Assembly Third Reading",50,22,0,7,79
624496,369822,2014-06-04,Senate,"Do pass",6,0,1,0,7
624496,373211,2014-06-19,Senate,"Assembly 3rd Reading AB2127 Cooley By Hernandez",23,5,12,0,40
624498,350168,2014-04-01,Assembly,"From committee:  Be adopted.  To third reading",10,0,0,1,11
624498,367035,2014-05-23,Senate,"Special Consent #15 ACR103 Fox",32,0,8,0,40
624499,358080,2014-04-21,Senate,"Do pass, but re-refer to the Committee on Appropriations Recommend 	Consent",4,0,1,0,5
624499,363387,2014-05-08,Senate,"Consent Calendar 2nd SB1206 Evans",35,0,5,0,40
624499,372890,2014-06-18,Assembly,"Do pass and be re-referred to the Committee on Appropriations",13,0,0,0,13
624499,375596,2014-07-02,Assembly,"Do pass, to Consent Calendar",17,0,0,0,17
624499,376838,2014-08-07,Assembly,"SB 1206 Evans  Consent Calendar Second Day  Regular Session",77,0,0,2,79
624500,347534,2014-03-25,Assembly,"Do pass and be re-referred to the Committee on Appropriations",13,1,0,5,19
624503,354408,2014-04-09,Senate,"Do pass as amended, and re-refer to the Committee on Appropriations",5,0,4,0,9
624503,363935,2014-05-12,Senate,"Placed on Appropriations Suspense file",7,0,0,0,7
624503,366949,2014-05-23,Senate,"Do pass as amended",5,2,0,0,7
624503,368094,2014-05-28,Senate,"Senate 3rd Reading SB1210 Lara",26,11,3,0,40
624503,374329,2014-06-24,Assembly,"Do pass as amended and be re-referred to the Committee on 	Appropriations",8,2,0,3,13
624503,377358,2014-08-14,Assembly,"Do pass as amended",12,4,0,1,17
624503,378371,2014-08-25,Assembly,"SB 1210 Lara  Senate Third Reading  By WILLIAMS",55,20,0,4,79
624503,378519,2014-08-26,Senate,"Unfinished Supp 1 SB1210 Lara Concurrence",25,10,5,0,40
624504,360485,2014-04-28,Assembly,"Do pass and be re-referred to the Committee on Appropriations",6,3,0,0,9
624505,359494,2014-04-23,Assembly,"Do pass as amended and be re-referred to the Committee on 	Appropriations",13,0,0,0,13
624505,363151,2014-05-07,Assembly,"Do pass, to Consent Calendar",17,0,0,0,17
624505,364838,2014-05-15,Assembly,"AB 2056 DABABNEH  Consent Calendar Second Day  Regular Session",78,0,0,1,79
624505,371152,2014-06-11,Senate,"Do pass, but re-refer to the Committee on Appropriations",10,0,1,0,11
624505,373743,2014-06-23,Senate,"Do pass",7,0,0,0,7
624505,376876,2014-08-11,Senate,"Assembly 3rd Reading AB2056 Dababneh By Lieu",36,0,4,0,40
624505,377670,2014-08-18,Assembly,"AB 2056 DABABNEH  Concurrence in Senate Amendments",78,0,0,1,79
624506,360763,2014-04-28,Assembly,"Do pass as amended and be re-referred to the Committee on 	Appropriations",11,0,0,1,12
624506,364531,2014-05-14,Assembly,"Do pass, to Consent Calendar",17,0,0,0,17
624506,366830,2014-05-23,Assembly,"AB 2209 DICKINSON  Consent Calendar Second Day  Regular Session",73,0,0,6,79
624506,372728,2014-06-18,Senate,"Do pass as amended, and re-refer to the Committee on 	Appropriations",9,0,0,0,9
624506,377064,2014-08-13,Senate,"Assembly 3rd Reading AB2209 Dickinson By Evans",36,0,4,0,40
624506,377687,2014-08-18,Assembly,"AB 2209 DICKINSON  Concurrence in Senate Amendments",78,0,0,1,79
624507,348145,2014-03-26,Senate,"Do pass, but re-refer to the Committee on Appropriations",4,0,1,0,5
624507,352720,2014-04-07,Senate,"Placed on Appropriations Suspense file",7,0,0,0,7
624508,359632,2014-04-24,Senate,"Do pass as amended, and re-refer to the Committee on Appropriations",5,0,2,0,7
624508,363730,2014-05-12,Senate,"Placed on Appropriations Suspense file",7,0,0,0,7
624509,360615,2014-04-28,Assembly,"Do pass as amended and be re-referred to the Committee on 	Appropriations",5,0,0,4,9
624509,365262,2014-05-19,Assembly,"AB 2008 QUIRK  Assembly Third Reading",68,0,0,11,79
624509,372241,2014-06-17,Senate,"Do pass and be placed on the Consent Calendar",11,0,0,0,11
624509,374834,2014-06-26,Senate,"Consent Calendar 2nd AB2008 Quirk",32,0,8,0,40
624510,360629,2014-04-29,Senate,"Do pass as amended, and re-refer to the Committee on Appropriations",6,2,3,0,11
624510,365274,2014-05-19,Senate,"Placed on Appropriations Suspense file",7,0,0,0,7
624510,366855,2014-05-23,Senate,"Do pass as amended",5,2,0,0,7
624510,368009,2014-05-28,Senate,"Senate 3rd Reading SB1139 Hueso",21,11,8,0,40
624510,373981,2014-06-23,Assembly,"Do pass and be re-referred to the Committee on Natural Resources",8,5,0,2,15
624510,374799,2014-06-26,Assembly,"Do pass as amended and be re-referred to the Committee on 	Appropriations",6,2,0,1,9
624510,377222,2014-08-14,Assembly,"Do pass as amended",9,5,0,3,17
624511,358458,2014-04-21,Assembly,"Do pass as amended and be re-referred to the Committee on 	Appropriations",10,1,0,5,16
624513,360062,2014-04-28,Senate,"Do pass, but re-refer to the Committee on Education",8,1,0,0,9
624513,361771,2014-04-30,Senate,"Do pass, but re-refer to the Committee on Appropriations",8,0,1,0,9
624513,363691,2014-05-12,Senate,"Placed on Appropriations Suspense file",7,0,0,0,7
624513,366905,2014-05-23,Senate,"Do pass",7,0,0,0,7
624513,367590,2014-05-27,Senate,"Senate 3rd Reading SB1247 Lieu",33,3,4,0,40
624513,370550,2014-06-10,Assembly,"Do pass as amended and be re-referred to the Committee on Business, 	Professions and Consumer Protection",9,2,0,2,13
624513,374031,2014-06-24,Assembly,"Do pass as amended and be re-referred to the Committee on 	Appropriations",9,3,0,2,14
624513,377457,2014-08-14,Assembly,"Do pass as amended",12,0,0,5,17
624513,378811,2014-08-27,Assembly,"SB 1247 Lieu  Senate Third Reading  By WILLIAMS",57,19,0,3,79
624513,378974,2014-08-28,Senate,"From committee:  That the Assembly Amendments be concurred in",9,0,0,0,9
624513,379085,2014-08-29,Senate,"Unfinished Supp 1 SB1247 Lieu Concurrence",27,2,11,0,40
624514,359521,2014-04-24,Senate,"Do pass as amended, and re-refer to the Committee on Appropriations",8,0,1,0,9
624514,363699,2014-05-12,Senate,"Placed on Appropriations Suspense file",7,0,0,0,7
624514,366686,2014-05-23,Senate,"Do pass",7,0,0,0,7
624514,367493,2014-05-27,Senate,"Senate 3rd Reading SB1248 Lara",36,0,4,0,40
624514,375076,2014-06-25,Assembly,"Do pass as amended and be re-referred to the Committee on 	Appropriations",7,0,0,0,7
624515,358500,2014-04-21,Assembly,"Do pass and be re-referred to the Committee on Local Government",8,4,0,3,15
624515,361623,2014-04-30,Assembly,"Do pass and be re-referred to the Committee on Appropriations",3,2,0,4,9
624515,361624,2014-04-30,Assembly,"Set first hearing.  Failed passage.  Reconsideration granted",9,0,0,0,9
624516,357960,2014-04-21,Senate,"Do pass, but re-refer to the Committee on Appropriations",4,0,1,0,5
624516,362302,2014-05-05,Senate,"Do pass",6,0,1,0,7
624516,363698,2014-05-12,Senate,"Senate 3rd Reading SB1220 Torres",33,0,7,0,40
624516,374413,2014-06-25,Assembly,"Do pass and be re-referred to the Committee on Appropriations",7,0,0,0,7
624516,376702,2014-08-06,Assembly,"Do pass as amended, to Consent Calendar",17,0,0,0,17
624516,377652,2014-08-18,Assembly,"SB 1220 Torres  Senate Third Reading  By BONTA",76,1,0,2,79
624516,377905,2014-08-20,Senate,"Unfinished Business SB1220 Torres Concurrence",34,0,6,0,40
624517,360718,2014-04-29,Senate,"Do pass as amended, and re-refer to the Committee on Appropriations",7,2,0,0,9
624517,368748,2014-05-29,Senate,"Senate 3rd Reading SB1199 Hancock",22,12,6,0,40
624517,374170,2014-06-23,Assembly,"Do pass and be re-referred to the Committee on Appropriations",6,3,0,0,9
624518,361133,2014-04-30,Assembly,"Do pass and be re-referred to the Committee on Appropriations",7,0,0,0,7
624518,366770,2014-05-23,Assembly,"Do pass",17,0,0,0,17
624518,367466,2014-05-27,Assembly,"AB 2185 EGGMAN  Assembly Third Reading",77,0,0,2,79
624518,372218,2014-06-17,Senate,"Do pass, but re-refer to the Committee on Appropriations",5,0,0,0,5
624518,376500,2014-08-04,Senate,"Placed on Appropriations Suspense file",7,0,0,0,7
624518,377384,2014-08-14,Senate,"Do pass as amended",5,0,2,0,7
624518,378075,2014-08-21,Senate,"Assembly 3rd Reading AB2185 Eggman By Wolk",32,0,8,0,40
624518,378295,2014-08-25,Assembly,"AB 2185 EGGMAN  Concurrence in Senate Amendments",71,7,0,1,79
624519,360101,2014-04-28,Senate,"Do pass, but re-refer to the Committee on Appropriations",9,0,0,0,9
624519,363816,2014-05-12,Senate,"Placed on Appropriations Suspense file",7,0,0,0,7
624519,366979,2014-05-23,Senate,"Do pass",7,0,0,0,7
624519,367523,2014-05-27,Senate,"Senate 3rd Reading SB1243 Lieu",36,0,4,0,40
624519,374075,2014-06-24,Assembly,"Do pass as amended and be re-referred to the Committee on 	Appropriations",13,0,0,1,14
624519,377339,2014-08-14,Assembly,"Do pass as amended",17,0,0,0,17
624519,378392,2014-08-25,Assembly,"SB 1243 Lieu  Senate Third Reading  By BONILLA",77,1,0,1,79
624519,378547,2014-08-26,Senate,"Unfinished Supp 1 SB1243 Lieu Concurrence",36,0,4,0,40
624520,351035,2014-04-02,Assembly,"Do pass as amended and be re-referred to the Committee on 	Appropriations",8,3,0,2,13
624520,366924,2014-05-23,Assembly,"Do pass",12,4,0,1,17
624520,368053,2014-05-28,Assembly,"AB 2052 GONZALEZ  Assembly Third Reading",53,18,0,8,79
624520,374439,2014-06-25,Senate,"Do pass, but re-refer to the Committee on Appropriations",5,0,0,0,5
624520,376553,2014-08-04,Senate,"Placed on Appropriations Suspense file",7,0,0,0,7
624520,377287,2014-08-14,Senate,"Do pass as amended",5,0,2,0,7
624520,378052,2014-08-21,Senate,"Assembly 3rd Reading AB2052 Gonzalez By Correa",27,8,5,0,40
624520,378432,2014-08-25,Assembly,"AB 2052 GONZALEZ  Concurrence in Senate Amendments",58,16,0,5,79
624523,353621,2014-04-08,Senate,"Do pass, but re-refer to the Committee on Appropriations",7,0,0,0,7
624523,360332,2014-04-28,Senate,"Placed on Appropriations Suspense file",6,0,1,0,7
624524,353250,2014-04-07,Assembly,"Do pass and re-refer to Committee on Appropriations with 	recommendation:  To Consent Calendar",9,0,0,0,9
624524,361505,2014-04-30,Assembly,"Do pass",16,0,0,1,17
624524,362179,2014-05-05,Assembly,"AB 2184 CHESBRO  Assembly Third Reading",75,0,0,4,79
624524,374168,2014-06-24,Senate,"Do pass, but re-refer to the Committee on Appropriations",9,0,0,0,9
624524,376642,2014-08-04,Senate,"Placed on Appropriations Suspense file",7,0,0,0,7
624525,360724,2014-04-29,Senate,"Do pass",5,1,1,0,7
624525,368703,2014-05-29,Senate,"Senate 3rd Reading SB1222 Block",37,0,3,0,40
624525,374088,2014-06-24,Assembly,"Do pass, to Consent Calendar",7,0,0,0,7
624525,375652,2014-07-03,Assembly,"SB 1222 Block  Consent Calendar Second Day  Regular Session",76,0,0,3,79
624526,360709,2014-04-28,Assembly,"Do pass as amended and be re-referred to the Committee on 	Appropriations",12,0,0,3,15
624526,366131,2014-05-21,Assembly,"Do pass, to Consent Calendar",17,0,0,0,17
624526,367614,2014-05-27,Assembly,"AB 2137 QUIRK  Consent Calendar Second Day  Regular Session",77,0,0,2,79
624526,372253,2014-06-17,Senate,"Do pass as amended, and re-refer to the Committee on Appropriations",10,0,1,0,11
624526,376801,2014-08-07,Senate,"Assembly 3rd Reading AB2137 Quirk By Fuller",34,0,6,0,40
624526,377005,2014-08-11,Assembly,"AB 2137 QUIRK  Concurrence in Senate Amendments",79,0,0,0,79
624527,359228,2014-04-22,Assembly,"Do pass as amended and be re-referred to the Committee on 	Appropriations",11,0,0,2,13
624527,366848,2014-05-23,Assembly,"Do pass as amended",12,1,0,4,17
624527,368025,2014-05-28,Assembly,"AB 2153 GRAY  Assembly Third Reading",74,2,0,3,79
624528,353443,2014-04-08,Assembly,"Do pass and be re-referred to the Committee on Appropriations",10,3,0,1,14
624528,361139,2014-04-30,Assembly,"Do pass",12,4,0,1,17
624528,364965,2014-05-15,Assembly,"AB 2102 TING  Assembly Third Reading",56,15,0,8,79
624528,374239,2014-06-23,Senate,"Do pass, but re-refer to the Committee on Appropriations",6,2,1,0,9
624528,376570,2014-08-04,Senate,"Do pass",5,2,0,0,7
624528,377710,2014-08-18,Senate,"Assembly 3rd Reading AB2102 Ting By Hernandez",27,9,4,0,40
624528,378149,2014-08-21,Assembly,"AB 2102 TING  Concurrence in Senate Amendments",54,21,0,4,79
624529,348097,2014-03-26,Assembly,"Do pass as amended",7,0,0,0,7
624529,351731,2014-04-03,Assembly,"AB 2104 GONZALEZ  Assembly Third Reading",75,2,0,2,79
624529,370560,2014-06-10,Senate,"Do pass",10,0,1,0,11
624529,377334,2014-08-14,Senate,"Assembly 3rd Reading AB2104 Gonzalez By Nielsen",34,0,6,0,40
624529,377623,2014-08-18,Assembly,"AB 2104 GONZALEZ  Concurrence in Senate Amendments",76,2,0,1,79
624530,353229,2014-04-08,Assembly,"Do pass, to Consent Calendar",10,0,0,0,10
624530,357970,2014-04-21,Assembly,"AB 2154 JONES  Consent Calendar Second Day  Regular Session",77,0,0,2,79
624530,370919,2014-06-10,Senate,"Do pass",6,0,1,0,7
624530,374973,2014-06-26,Senate,"Special Consent #17 AB2154 Jones",32,0,8,0,40
624531,359250,2014-04-22,Senate,"Be adopted, but re-refer to the Committee on Appropriations",3,1,1,0,5
624531,365412,2014-05-19,Senate,"Placed on Appropriations Suspense file",7,0,0,0,7
624531,367042,2014-05-23,Senate,"Be adopted, but re-refer to the Committee on Rules",5,2,0,0,7
624534,358542,2014-04-21,Assembly,"Be referred to Committee on Judiciary",9,0,0,2,11
624534,360623,2014-04-29,Assembly,"Do pass as amended and be re-referred to the Committee on Rules",10,0,0,0,10
624534,365342,2014-05-19,Assembly,"Do pass and be re-referred to the Committee on Appropriations",9,0,0,2,11
624534,366986,2014-05-23,Assembly,"Do pass",17,0,0,0,17
624534,368183,2014-05-28,Assembly,"AB 2065 MELENDEZ  Assembly Third Reading",78,0,0,1,79
624534,374447,2014-06-24,Senate,"Do pass as amended, and re-refer to the Committee on Rules",7,0,0,0,7
624534,376568,2014-08-04,Senate,"Placed on Appropriations Suspense file",7,0,0,0,7
624535,348389,2014-03-26,Senate,"Do pass and be placed on the Consent Calendar",8,0,1,0,9
624535,350221,2014-04-01,Senate,"Consent Calendar 2nd SB1229 Fuller",34,0,5,0,39
624535,370841,2014-06-11,Assembly,"Do pass, to Consent Calendar",6,0,0,1,7
624535,373359,2014-06-19,Assembly,"SB 1229 Fuller  Consent Calendar Second Day  Regular Session",77,0,0,2,79
624537,354386,2014-04-09,Assembly,"Do pass as amended and be re-referred to the Committee on Local 	Government",7,0,0,0,7
624537,361553,2014-05-01,Assembly,"AB 2100 CAMPOS  Assembly Third Reading",74,1,0,4,79
624537,372146,2014-06-17,Senate,"Do pass",10,0,1,0,11
624537,375257,2014-06-30,Senate,"Special Consent #18 AB2100 Campos Urgency Clause",33,0,7,0,40
624537,375685,2014-07-03,Assembly,"AB 2100 CAMPOS  Concurrence in Senate Amendments",76,1,0,2,79
624538,363118,2014-05-06,Senate,"Do pass",5,2,0,0,7
624538,368224,2014-05-28,Senate,"Senate 3rd Reading SB1188 Jackson",21,14,5,0,40
624540,359312,2014-04-23,Assembly,"Do pass and be re-referred to the Committee on Appropriations",13,0,0,0,13
624540,363310,2014-05-07,Assembly,"Do pass, to Consent Calendar",17,0,0,0,17
624540,364872,2014-05-15,Assembly,"AB 2064 COOLEY  Consent Calendar Second Day  Regular Session",78,0,0,1,79
624540,374855,2014-06-25,Senate,"Do pass, but re-refer to the Committee on Appropriations",10,0,1,0,11
624540,377161,2014-08-14,Senate,"Assembly 3rd Reading AB2064 Cooley By Monning",35,0,5,0,40
624540,377821,2014-08-19,Assembly,"AB 2064 COOLEY  Concurrence in Senate Amendments",78,0,0,1,79
624544,355057,2014-04-09,Senate,"Do pass, but re-refer to the Committee on Appropriations",8,0,1,0,9
624544,360088,2014-04-28,Senate,"Placed on Appropriations Suspense file",6,0,1,0,7
624544,366934,2014-05-23,Senate,"Do pass",7,0,0,0,7
624544,367618,2014-05-27,Senate,"Senate 3rd Reading SB1138 Padilla",36,0,4,0,40
624544,373294,2014-06-18,Assembly,"Do pass as amended and be re-referred to the Committee on 	Appropriations",7,0,0,0,7
624544,377466,2014-08-14,Assembly,"Do pass as amended",12,2,0,3,17
624544,378748,2014-08-27,Assembly,"Do pass as amended",6,0,0,1,7
624544,379059,2014-08-29,Assembly,"SB 1138 Padilla  Senate Third Reading  By CHESBRO",59,17,0,3,79
624544,379060,2014-08-29,Senate,"Unfinished Supp 4 SB1138 Padilla Concurrence",25,10,5,0,40
624546,362625,2014-05-06,Assembly,"Do pass as amended",13,5,0,1,19
624546,368731,2014-05-29,Assembly,"AB 2139 EGGMAN  Assembly Third Reading",46,28,0,5,79
624546,373103,2014-06-18,Senate,"Do pass, but re-refer to the Committee on Judiciary",6,2,1,0,9
624546,374515,2014-06-24,Senate,"Do pass",5,2,0,0,7
624546,378029,2014-08-21,Senate,"Assembly 3rd Reading AB2139 Eggman By Leno",29,7,4,0,40
624546,378280,2014-08-25,Assembly,"AB 2139 EGGMAN  Concurrence in Senate Amendments",57,20,0,2,79
624547,361007,2014-04-28,Assembly,"Do pass as amended and be re-referred to the Committee on 	Appropriations",11,0,0,1,12
624548,360520,2014-04-29,Assembly,"Do pass and re-refer to Committee on Appropriations with 	recommendation:  To Consent Calendar",14,0,0,0,14
624548,366801,2014-05-23,Assembly,"Do pass",17,0,0,0,17
624548,367658,2014-05-27,Assembly,"AB 2077 ALLEN  Assembly Third Reading",76,0,0,3,79
624548,372543,2014-06-17,Senate,"Do pass, but re-refer to the Committee on Appropriations",6,0,1,0,7
624548,376456,2014-08-04,Senate,"Placed on Appropriations Suspense file",7,0,0,0,7
624548,377512,2014-08-14,Senate,"Do pass",6,0,1,0,7
624548,377908,2014-08-20,Senate,"Assembly 3rd Reading AB2077 Allen By Wolk",35,0,5,0,40
624549,359299,2014-04-23,Assembly,"Do pass as amended and be re-referred to the Committee on 	Appropriations",6,1,0,0,7
624549,367112,2014-05-23,Assembly,"Do pass as amended",12,5,0,0,17
624549,368063,2014-05-28,Assembly,"AB 2125 RIDLEY-THOMAS  Assembly Third Reading",57,20,0,2,79
624549,374716,2014-06-25,Senate,"Do pass, but re-refer to the Committee on Appropriations",5,1,1,0,7
624549,376638,2014-08-04,Senate,"Placed on Appropriations Suspense file",7,0,0,0,7
624550,361533,2014-04-30,Senate,"Do pass as amended, and re-refer to the Committee on 	Appropriations",7,0,2,0,9
624550,365331,2014-05-19,Senate,"Placed on Appropriations Suspense file",7,0,0,0,7
624551,353444,2014-04-07,Assembly,"Do pass and be re-referred to the Committee on Appropriations",9,0,0,0,9
624551,361095,2014-04-30,Assembly,"Do pass, to Consent Calendar",17,0,0,0,17
624551,363337,2014-05-08,Assembly,"AB 2142 CHESBRO  Consent Calendar Second Day  Regular Session",73,0,0,6,79
624551,374149,2014-06-24,Senate,"Do pass",9,0,0,0,9
624551,378143,2014-08-21,Senate,"Assembly 3rd Reading AB2142 Chesbro Urgency Clause",34,0,6,0,40
624551,378537,2014-08-25,Assembly,"Senate amendments be concurred in",8,1,0,0,9
624551,378780,2014-08-27,Assembly,"AB 2142 CHESBRO  Concurrence- Urgency Added",78,0,0,1,79
624553,350158,2014-04-01,Assembly,"Do pass and be re-referred to the Committee on Appropriations",2,2,0,3,7
624554,350744,2014-04-01,Senate,"Do pass as amended, but re-refer to the Committee on Appropriations 	Recommend Consent",11,0,0,0,11
624554,360298,2014-04-28,Senate,"Placed on Appropriations Suspense file",6,0,1,0,7
624555,358455,2014-04-21,Senate,"Do pass, but re-refer to the Committee on Appropriations",8,1,0,0,9
624555,362246,2014-05-05,Senate,"Do pass",5,0,2,0,7
624555,363422,2014-05-08,Senate,"Senate 3rd Reading SB1159 Lara",32,0,8,0,40
624555,374144,2014-06-24,Assembly,"Do pass as amended and be re-referred to the Committee on 	Appropriations",12,2,0,0,14
624555,377276,2014-08-14,Assembly,"Do pass",13,4,0,0,17
624555,378201,2014-08-22,Assembly,"SB 1159 Lara  Senate Third Reading  By GONZALEZ  Amend By GONZALEZ 	Set #1",51,23,0,5,79
624555,378953,2014-08-28,Assembly,"Do pass",10,3,0,1,14
624555,379056,2014-08-29,Senate,"From committee:  That the Assembly Amendments be concurred in",7,1,1,0,9
624555,379057,2014-08-29,Assembly,"SB 1159 Lara  Senate Third Reading  By GONZALEZ",55,22,0,2,79
624555,379058,2014-08-29,Senate,"Unfinished Supp 3 SB1159 Lara Concurrence",30,4,6,0,40
624556,351253,2014-04-02,Assembly,"Do pass, to Consent Calendar",9,0,0,0,9
624556,355141,2014-04-10,Assembly,"AB 1995 LEVINE  Consent Calendar Second Day  Regular Session",74,0,0,5,79
624556,374298,2014-06-25,Senate,"Do pass as amended",7,0,0,0,7
624556,376845,2014-08-07,Senate,"Assembly 3rd Reading AB1995 Levine By Evans",35,0,5,0,40
624556,376872,2014-08-11,Assembly,"AB 1995 LEVINE  Concurrence in Senate Amendments",79,0,0,0,79
624557,361737,2014-04-30,Assembly,"Do pass and be re-referred to the Committee on Appropriations",7,0,0,0,7
624557,364406,2014-05-14,Assembly,"Do pass, to Consent Calendar",17,0,0,0,17
624557,366758,2014-05-23,Assembly,"AB 2007 GROVE  Consent Calendar Second Day  Regular Session",73,0,0,6,79
624557,374684,2014-06-25,Senate,"Do pass as amended, and re-refer to the Committee on Appropriations",6,0,1,0,7
624557,376474,2014-08-04,Senate,"Do pass",6,0,1,0,7
624557,376898,2014-08-11,Senate,"Assembly 3rd Reading AB2007 Grove By Fuller",35,0,5,0,40
624557,377686,2014-08-18,Assembly,"AB 2007 GROVE  Concurrence in Senate Amendments",78,0,0,1,79
624558,358612,2014-04-22,Senate,"Do pass",7,0,2,0,9
624558,362408,2014-05-05,Senate,"Senate 3rd Reading SB1162 Berryhill",37,0,3,0,40
624558,370170,2014-06-09,Assembly,"Do pass",16,0,0,0,16
624558,373113,2014-06-19,Assembly,"SB 1162 Berryhill, T.  Senate Third Reading  By LINDER",78,0,0,1,79
624559,353846,2014-04-07,Assembly,"Do pass and be re-referred to the Committee on Appropriations",4,3,0,2,9
624559,353847,2014-04-07,Assembly,"Set first hearing.  Failed passage.  Reconsideration granted",9,0,0,0,9
624560,354492,2014-04-09,Senate,"Do pass, but re-refer to the Committee on Appropriations",7,0,0,0,7
624560,362211,2014-05-05,Senate,"Placed on Appropriations Suspense file",7,0,0,0,7
624560,367126,2014-05-23,Senate,"Do pass as amended",7,0,0,0,7
624560,368078,2014-05-28,Senate,"Senate 3rd Reading SB1207 Wolk",37,0,3,0,40
624560,374840,2014-06-25,Assembly,"Do pass as amended and be re-referred to the Committee on 	Appropriations",6,1,0,2,9
624561,358879,2014-04-22,Assembly,"Do pass and be re-referred to the Committee on Business, 	Professions and Consumer Protection to Consent Calendar",19,0,0,0,19
624561,360722,2014-04-29,Assembly,"Do pass and re-refer to Committee on Appropriations with 	recommendation:  To Consent Calendar",14,0,0,0,14
624561,364484,2014-05-14,Assembly,"Do pass, to Consent Calendar",17,0,0,0,17
624561,368697,2014-05-29,Assembly,"AB 2143 WILLIAMS  Third Reading Urgency",79,0,0,0,79
624561,374184,2014-06-23,Senate,"Do pass, but re-refer to the Committee on Appropriations Recommend 	Consent",8,0,1,0,9
624561,376757,2014-08-07,Senate,"Consent Calendar 2nd AB2143 Williams",34,0,6,0,40
624563,350307,2014-04-01,Senate,"Do pass, but re-refer to the Committee on Appropriations",5,0,2,0,7
624563,360117,2014-04-28,Senate,"Do pass",5,0,2,0,7
624563,362283,2014-05-05,Senate,"Senate 3rd Reading SB1154 Hancock",37,0,3,0,40
624563,372266,2014-06-17,Assembly,"Do pass and be re-referred to the Committee on Appropriations",7,0,0,0,7
624563,375577,2014-07-02,Assembly,"Do pass, to Consent Calendar",17,0,0,0,17
624563,376919,2014-08-11,Assembly,"SB 1154 Hancock  Senate Third Reading  By SKINNER",79,0,0,0,79
624563,378085,2014-08-21,Senate,"Unfinished Business SB1154 Hancock Concurrence",34,0,6,0,40
624564,350739,2014-04-01,Assembly,"Do pass and re-refer to Committee on Appropriations with 	recommendation:  To Consent Calendar",7,0,0,0,7
624564,354499,2014-04-09,Assembly,"Do pass, to Consent Calendar",17,0,0,0,17
624564,359517,2014-04-24,Assembly,"AB 2122 BOCANEGRA  Consent Calendar Second Day  Regular Session",75,0,0,4,79
624564,372282,2014-06-17,Senate,"Do pass, but re-refer to the Committee on Appropriations",5,0,2,0,7
624564,375449,2014-06-30,Senate,"Do pass",6,0,1,0,7
624564,376999,2014-08-11,Senate,"Assembly 3rd Reading AB2122 Bocanegra By Padilla",36,0,4,0,40
624565,358497,2014-04-21,Assembly,"Do pass as amended and be re-referred to the Committee on 	Transportation",9,3,0,3,15
624566,353532,2014-04-08,Assembly,"Do pass and be re-referred to the Committee on Environmental Safety 	and Toxic Materials",15,0,0,0,15
624566,360742,2014-04-29,Assembly,"Do pass, to Consent Calendar",7,0,0,0,7
624566,366922,2014-05-23,Assembly,"Do pass as amended",17,0,0,0,17
624566,368181,2014-05-28,Assembly,"AB 2071 LEVINE  Assembly Third Reading",78,0,0,1,79
624566,374479,2014-06-25,Senate,"Do pass as amended, and re-refer to the Committee on 	Appropriations",6,0,1,0,7
624566,376579,2014-08-04,Senate,"Placed on Appropriations Suspense file",7,0,0,0,7
624566,377572,2014-08-14,Senate,"Do pass",5,0,2,0,7
624566,378170,2014-08-21,Senate,"Assembly 3rd Reading AB2071 Levine By Berryhill",36,0,4,0,40
624566,378262,2014-08-22,Assembly,"AB 2071 LEVINE  Concurrence in Senate Amendments",76,0,0,3,79
624567,352690,2014-04-07,Assembly,"Be referred to Committee on Higher Education",11,0,0,0,11
624568,361265,2014-04-30,Assembly,"Do pass and be re-referred to the Committee on Appropriations",5,2,0,0,7
624568,364560,2014-05-14,Assembly,"Do pass",12,5,0,0,17
624568,367513,2014-05-27,Assembly,"AB 2161 CHAU  Assembly Third Reading",54,23,0,2,79
624568,372469,2014-06-17,Senate,"Do pass, but re-refer to the Committee on Appropriations",9,1,1,0,11
624568,377004,2014-08-11,Senate,"Do pass",5,2,0,0,7
624568,377102,2014-08-13,Senate,"Assembly 3rd Reading AB2161 Chau By Torres",24,9,7,0,40
624568,377641,2014-08-18,Assembly,"AB 2161 CHAU  Concurrence in Senate Amendments",54,24,0,1,79
624569,358435,2014-04-22,Assembly,"Do pass as amended and be re-referred to the Committee on 	Appropriations",19,0,0,0,19
624569,361169,2014-04-30,Assembly,"Do pass",16,0,0,1,17
624569,362265,2014-05-05,Assembly,"AB 2069 MAIENSCHEIN  Assembly Third Reading",75,0,0,4,79
624569,374953,2014-06-25,Senate,"Do pass, but re-refer to the Committee on Appropriations",8,0,1,0,9
624569,377063,2014-08-13,Senate,"Assembly 3rd Reading AB2069 Maienschein By Leno",36,0,4,0,40
624570,360688,2014-04-28,Assembly,"Do pass as amended",15,0,0,1,16
624570,364881,2014-05-15,Assembly,"AB 2173 BRADFORD  Assembly Third Reading",78,0,0,1,79
624570,370718,2014-06-10,Senate,"Do pass and be placed on the Consent Calendar",10,0,1,0,11
624570,371752,2014-06-16,Senate,"Consent Calendar 2nd AB2173 Bradford",35,0,5,0,40
624573,353663,2014-04-07,Assembly,"Do pass as amended and be re-referred to the Committee on Utilities 	and Commerce",8,3,0,1,12
624573,360607,2014-04-28,Assembly,"Do pass and be re-referred to the Committee on Appropriations",10,3,0,2,15
624575,361072,2014-04-30,Assembly,"Do pass as amended and be re-referred to the Committee on 	Appropriations",4,2,0,1,7
624575,368684,2014-05-29,Assembly,"AB 2026 STONE  Assembly Third Reading",26,34,0,19,79
624576,347544,2014-03-25,Assembly,"Do pass and re-refer to Committee on Appropriations with 	recommendation:  To Consent Calendar",13,0,0,2,15
624576,354494,2014-04-09,Assembly,"Do pass, to Consent Calendar",17,0,0,0,17
624576,359731,2014-04-24,Assembly,"AB 2067 WEBER  Consent Calendar Second Day  Regular Session",75,0,0,4,79
624576,370607,2014-06-10,Senate,"Do pass, but re-refer to the Committee on Appropriations Recommend 	Consent",9,0,0,0,9
624576,374814,2014-06-26,Senate,"Consent Calendar 2nd AB2067 Weber",32,0,8,0,40
624576,377141,2014-08-14,Senate,"Assembly 3rd Reading AB2067 Weber By Wolk",35,0,5,0,40
624576,377648,2014-08-18,Assembly,"AB 2067 WEBER  Concurrence in Senate Amendments",78,0,0,1,79
624577,351043,2014-04-02,Senate,"Do pass, but re-refer to the Committee on Public Safety",9,0,0,0,9
624577,360457,2014-04-29,Senate,"Do pass, but re-refer to the Committee on Appropriations",6,0,1,0,7
624577,363798,2014-05-12,Senate,"Placed on Appropriations Suspense file",7,0,0,0,7
624577,367119,2014-05-23,Senate,"Do pass",7,0,0,0,7
624577,367594,2014-05-27,Senate,"Senate 3rd Reading SB1135 Jackson",36,0,4,0,40
624577,372150,2014-06-17,Assembly,"Do pass and be re-referred to the Committee on Health",7,0,0,0,7
624577,374418,2014-06-24,Assembly,"Do pass as amended and be re-referred to the Committee on 	Appropriations",19,0,0,0,19
624577,376700,2014-08-06,Assembly,"Do pass as amended, to Consent Calendar",17,0,0,0,17
624577,377639,2014-08-18,Assembly,"SB 1135 Jackson  Senate Third Reading  By LOWENTHAL",77,0,0,2,79
624577,377770,2014-08-19,Senate,"Unfinished Business SB1135 Jackson Concurrence",34,0,6,0,40
624579,350682,2014-04-01,Assembly,"Do pass as amended",9,0,0,1,10
624579,362420,2014-05-05,Assembly,"AB 2039 MURATSUCHI  Assembly Third Reading",74,0,0,5,79
624579,372771,2014-06-17,Senate,"Do pass as amended, and re-refer to the Committee on 	Appropriations",6,0,1,0,7
624579,378525,2014-08-26,Senate,"Assembly 3rd Reading AB2039 Muratsuchi By Jackson",34,0,6,0,40
624579,378775,2014-08-27,Assembly,"AB 2039 MURATSUCHI  Concurrence in Senate Amendments",77,0,0,2,79
624581,359214,2014-04-22,Senate,"Do pass as amended, and re-refer to the Committee on 	Appropriations",10,0,1,0,11
624581,363362,2014-05-08,Senate,"Special Consent #13 SB1236 Monning",35,0,5,0,40
624581,371831,2014-06-16,Assembly,"Do pass and re-refer to Committee on Appropriations with 	recommendation:  To Consent Calendar",15,0,0,1,16
624581,375628,2014-07-02,Assembly,"Do pass, to Consent Calendar",17,0,0,0,17
624581,376808,2014-08-07,Assembly,"SB 1236 Monning  Consent Calendar Second Day  Regular Session",77,0,0,2,79
624583,361536,2014-04-30,Assembly,"Do pass and be re-referred to the Committee on Appropriations",7,0,0,0,7
624583,366675,2014-05-23,Assembly,"Do pass",17,0,0,0,17
624583,367471,2014-05-27,Assembly,"AB 2033 SALAS  Assembly Third Reading",77,0,0,2,79
624583,372196,2014-06-17,Senate,"Do pass, but re-refer to the Committee on Education",5,0,0,0,5
624583,374280,2014-06-25,Senate,"Do pass, but re-refer to the Committee on Appropriations Recommend 	Consent",6,0,1,0,7
624583,376963,2014-08-11,Senate,"Placed on Appropriations Suspense file",7,0,0,0,7
624584,359617,2014-04-24,Assembly,"Be referred to Committee on Human Services",6,4,0,1,11
624584,361327,2014-04-29,Assembly,"Do pass and be re-referred to the Committee on Appropriations",6,0,0,1,7
624584,367096,2014-05-23,Assembly,"Do pass as amended",17,0,0,0,17
624584,368160,2014-05-28,Assembly,"AB 2035 CHESBRO  Assembly Third Reading",78,0,0,1,79
624584,370421,2014-06-10,Senate,"Do pass, but re-refer to the Committee on Judiciary",4,0,1,0,5
624584,374472,2014-06-24,Senate,"Do pass as amended, and re-refer to the Committee on 	Appropriations",7,0,0,0,7
624584,376408,2014-08-04,Senate,"Placed on Appropriations Suspense file",7,0,0,0,7
624584,377404,2014-08-14,Senate,"Do pass as amended",5,0,2,0,7
624584,378095,2014-08-21,Senate,"Assembly 3rd Reading AB2035 Chesbro By Block",32,0,8,0,40
624584,378235,2014-08-22,Assembly,"AB 2035 CHESBRO  Concurrence in Senate Amendments",76,0,0,3,79
624585,361323,2014-04-29,Assembly,"Do pass as amended and be re-referred to the Committee on 	Appropriations",7,0,0,0,7
624585,366332,2014-05-21,Assembly,"Do pass, to Consent Calendar",17,0,0,0,17
624585,367552,2014-05-27,Assembly,"AB 2228 COOLEY  Consent Calendar Second Day  Regular Session",77,0,0,2,79
624585,374639,2014-06-24,Senate,"Do pass, but re-refer to the Committee on Appropriations Recommend 	Consent",4,0,1,0,5
624585,378368,2014-08-25,Senate,"Assembly 3rd Reading AB2228 Cooley By Beall",34,0,6,0,40
624585,378529,2014-08-26,Assembly,"AB 2228 COOLEY  Concurrence in Senate Amendments",79,0,0,0,79
624588,359257,2014-04-22,Senate,"Do pass as amended, and re-refer to the Committee on 	Appropriations",6,0,1,0,7
624588,363765,2014-05-12,Senate,"Placed on Appropriations Suspense file",7,0,0,0,7
624589,350429,2014-04-01,Assembly,"Do pass and be re-referred to the Committee on Appropriations",7,0,0,0,7
624589,354584,2014-04-09,Assembly,"Do pass, to Consent Calendar",17,0,0,0,17
624589,361838,2014-05-01,Assembly,"AB 2219 FONG  Assembly Third Reading",74,0,0,5,79
624589,372399,2014-06-17,Senate,"Do pass, but re-refer to the Committee on Appropriations",4,0,1,0,5
624589,377052,2014-08-13,Senate,"Assembly 3rd Reading AB2219 Fong By Pavley",36,0,4,0,40
624589,377680,2014-08-18,Assembly,"AB 2219 FONG  Concurrence in Senate Amendments",78,0,0,1,79
624590,350364,2014-04-01,Assembly,"Do pass",7,0,0,0,7
624590,352729,2014-04-07,Assembly,"AB 2098 LEVINE  Assembly Third Reading",73,0,0,6,79
624590,370529,2014-06-10,Senate,"Do pass",6,0,1,0,7
624590,374964,2014-06-26,Senate,"Special Consent #17 AB2098 Levine By Roth",32,0,8,0,40
624590,375213,2014-06-30,Assembly,"AB 2098 LEVINE  Concurrence in Senate Amendments",78,0,0,1,79
624591,359866,2014-04-24,Senate,"Do pass, but re-refer to the Committee on Appropriations",7,1,1,0,9
624591,362215,2014-05-05,Senate,"Placed on Appropriations Suspense file",7,0,0,0,7
624591,366808,2014-05-23,Senate,"Do pass",5,2,0,0,7
624591,368126,2014-05-28,Senate,"Senate 3rd Reading SB1182 Leno",21,12,7,0,40
624591,374656,2014-06-24,Assembly,"Do pass as amended and be re-referred to the Committee on 	Appropriations",13,6,0,0,19
624591,377162,2014-08-14,Assembly,"Do pass as amended",12,5,0,0,17
624591,378541,2014-08-26,Assembly,"Do pass as amended",14,2,0,3,19
624591,379018,2014-08-29,Assembly,"SB 1182 Leno  Senate Third Reading  By BONTA",61,16,0,2,79
624591,379019,2014-08-29,Senate,"Unfinished Supp 3 SB1182 Leno Concurrence",24,11,5,0,40
624595,354324,2014-04-08,Assembly,"Do pass and be re-referred to the Committee on Appropriations",19,0,0,0,19
624597,358484,2014-04-22,Senate,"Do pass as amended, and re-refer to the Committee on Appropriations",7,2,0,0,9
624597,362264,2014-05-05,Senate,"Placed on Appropriations Suspense file",7,0,0,0,7
624597,367000,2014-05-23,Senate,"Do pass",5,2,0,0,7
624597,367479,2014-05-27,Senate,"Senate 3rd Reading SB1168 Pavley",24,12,4,0,40
624597,374013,2014-06-24,Assembly,"Do pass and be re-referred to the Committee on Appropriations",9,4,0,2,15
624597,377227,2014-08-14,Assembly,"Do pass",11,5,0,1,17
624597,378941,2014-08-28,Assembly,"Do pass as amended",11,5,0,1,17
624597,379026,2014-08-29,Senate,"Unfinished Supp 3 SB1168 Pavley Concurrence",25,10,5,0,40
624597,379027,2014-08-29,Assembly,"SB 1168 Pavley  Senate Third Reading  By DICKINSON",47,27,0,5,79
624598,350927,2014-04-02,Assembly,"Do pass and be re-referred to the Committee on Appropriations",5,1,0,1,7
624598,367176,2014-05-23,Assembly,"Do pass as amended",12,5,0,0,17
624598,368695,2014-05-29,Assembly,"AB 2126 BONTA  Assembly Third Reading",54,22,0,3,79
624598,373769,2014-06-23,Senate,"Do pass, but re-refer to the Committee on Appropriations",3,2,0,0,5
624598,376404,2014-08-04,Senate,"Placed on Appropriations Suspense file",7,0,0,0,7
624598,377526,2014-08-14,Senate,"Do pass",5,0,2,0,7
624598,378987,2014-08-28,Senate,"Assembly 3rd Reading AB2126 Bonta By Beall",24,10,6,0,40
624599,347894,2014-03-25,Assembly,"Do pass as amended and re-refer to Committee on Appropriations 	with recommendation:  To Consent Calendar",7,0,0,0,7
624599,354535,2014-04-09,Assembly,"Do pass, to Consent Calendar",17,0,0,0,17
624599,363376,2014-05-08,Assembly,"AB 2115 BRADFORD  Assembly Third Reading  Amend By BRADFORD  Set #1",73,0,0,6,79
624599,364810,2014-05-15,Assembly,"AB 2115 BRADFORD  Assembly Third Reading",78,0,0,1,79
624599,370412,2014-06-10,Senate,"Do pass, but re-refer to the Committee on Appropriations Recommend 	Consent",4,0,1,0,5
624599,376562,2014-08-04,Senate,"Placed on Appropriations Suspense file",7,0,0,0,7
624600,363244,2014-05-07,Assembly,"Do pass",9,0,0,0,9
624600,368202,2014-05-28,Assembly,"AB 2192 MELENDEZ  Assembly Third Reading",72,4,0,3,79
624601,351075,2014-04-02,Assembly,"Do pass, to Consent Calendar",9,0,0,0,9
624601,355108,2014-04-10,Assembly,"AB 2117 ACHADJIAN  Consent Calendar Second Day  Regular Session",74,0,0,5,79
624601,374328,2014-06-25,Senate,"Do pass and be placed on the Consent Calendar",6,0,1,0,7
624601,376761,2014-08-07,Senate,"Assembly 3rd Reading AB2117 Achadjian By Monning",34,0,6,0,40
624601,377097,2014-08-13,Assembly,"Senate amendments be concurred in",8,0,0,1,9
624601,377611,2014-08-18,Assembly,"AB 2117 ACHADJIAN  Concurrence in Senate Amendments",78,0,0,1,79
624605,360498,2014-04-29,Assembly,"Do pass as amended and be re-referred to the Committee on 	Appropriations",12,1,0,0,13
624606,347512,2014-03-25,Assembly,"Do pass as amended and be re-referred to the Committee on 	Appropriations",18,0,0,1,19
624606,361283,2014-04-30,Assembly,"Do pass as amended, to Consent Calendar",17,0,0,0,17
624606,363389,2014-05-08,Assembly,"AB 2130 PAN  Consent Calendar Second Day  Regular Session",73,0,0,6,79
624606,370969,2014-06-11,Senate,"Do pass, but re-refer to the Committee on Appropriations",9,0,0,0,9
624606,374872,2014-06-26,Senate,"Assembly 3rd Reading AB2130 Pan Urgency Clause",32,0,8,0,40
624607,359379,2014-04-22,Senate,"Do pass, but re-refer to the Committee on Appropriations",4,1,0,0,5
624607,362230,2014-05-05,Senate,"Placed on Appropriations Suspense file",7,0,0,0,7
624607,366913,2014-05-23,Senate,"Do pass as amended",5,2,0,0,7
624607,368621,2014-05-29,Senate,"Senate 3rd Reading SB1253 Steinberg",29,8,3,0,40
624607,374346,2014-06-24,Assembly,"Do pass as amended and be re-referred to the Committee on 	Appropriations",5,1,0,1,7
624607,377257,2014-08-14,Assembly,"Do pass as amended",12,5,0,0,17
624607,378628,2014-08-27,Assembly,"SB 1253 Steinberg  Senate Third Reading  By TING",55,23,0,1,79
624607,379116,2014-08-29,Senate,"Unfinished Business SB1253 Steinberg",28,9,3,0,40
624608,354221,2014-04-08,Assembly,"Do pass as amended and be re-referred to the Committee on Judiciary",5,0,0,2,7
624608,366727,2014-05-23,Assembly,"Do pass",17,0,0,0,17
624608,367522,2014-05-27,Assembly,"AB 2001 AMMIANO  Assembly Third Reading",77,0,0,2,79
624608,372704,2014-06-17,Senate,"Do pass, but re-refer to the Committee on Human Services",6,0,1,0,7
624608,374395,2014-06-24,Senate,"Do pass as amended, and re-refer to the Committee on Appropriations",4,0,1,0,5
624608,376533,2014-08-04,Senate,"Placed on Appropriations Suspense file",7,0,0,0,7
624609,361882,2014-04-30,Assembly,"Do pass and be re-referred to the Committee on Appropriations",7,0,0,0,7
624611,357933,2014-04-21,Senate,"Do pass, but re-refer to the Committee on Appropriations Recommend 	Consent",4,0,1,0,5
624611,363341,2014-05-08,Senate,"Consent Calendar 2nd SB1240 Anderson",35,0,5,0,40
624611,374609,2014-06-25,Assembly,"Do pass and be re-referred to the Committee on Appropriations",7,0,0,0,7
624611,375527,2014-07-02,Assembly,"Do pass, to Consent Calendar",17,0,0,0,17
624611,376842,2014-08-07,Assembly,"SB 1240 Anderson  Consent Calendar Second Day  Regular Session",77,0,0,2,79
624613,358478,2014-04-21,Assembly,"Be referred to Committee on Revenue and Taxation",9,0,0,2,11
624613,360611,2014-04-28,Assembly,"Do pass and be re-referred to the Committee on Appropriations",6,3,0,0,9
624614,357934,2014-04-21,Senate,"Do pass, but re-refer to the Committee on Appropriations",4,0,1,0,5
624614,363736,2014-05-12,Senate,"Senate 3rd Reading SB1219 Torres",33,0,7,0,40
624614,374539,2014-06-25,Assembly,"Do pass and be re-referred to the Committee on Appropriations",7,0,0,0,7
624614,376664,2014-08-06,Assembly,"Do pass, to Consent Calendar",17,0,0,0,17
624616,347700,2014-03-25,Assembly,"Do pass as amended and be re-referred to the Committee on 	Appropriations",13,0,0,2,15
624616,354498,2014-04-09,Assembly,"Do pass",16,0,0,1,17
624616,357947,2014-04-21,Assembly,"AB 2105 FRAZIER  Assembly Third Reading",77,0,0,2,79
624616,370711,2014-06-10,Senate,"Do pass as amended, and re-refer to the Committee on Appropriations",7,0,2,0,9
624616,376921,2014-08-11,Senate,"Assembly 3rd Reading AB2105 Frazier By Berryhill",35,0,5,0,40
624616,377714,2014-08-18,Assembly,"AB 2105 FRAZIER  Concurrence in Senate Amendments",77,0,0,2,79
624618,360593,2014-04-29,Assembly,"Do pass and be re-referred to the Committee on Appropriations",10,0,0,4,14
624618,364387,2014-05-14,Assembly,"Do pass",15,1,0,1,17
624618,365310,2014-05-19,Assembly,"AB 2198 LEVINE  Assembly Third Reading",47,11,0,21,79
624618,374035,2014-06-23,Senate,"Do pass, but re-refer to the Committee on Appropriations",5,0,4,0,9
624618,377174,2014-08-14,Senate,"Assembly 3rd Reading AB2198 Levine By Gaines",30,1,9,0,40
624618,377825,2014-08-19,Assembly,"AB 2198 LEVINE  Concurrence in Senate Amendments",57,13,0,9,79
624619,354715,2014-04-09,Senate,"Do pass, but re-refer to the Committee on Appropriations",3,0,6,0,9
624619,354716,2014-04-09,Senate,"Set, first hearing.  Failed passage in Committee.  Reconsideration 	granted",9,0,0,0,9
624620,360504,2014-04-29,Assembly,"Do pass and re-refer to Committee on Appropriations with 	recommendation:  To Consent Calendar",14,0,0,0,14
624620,363373,2014-05-08,Assembly,"AB 2018 BOCANEGRA  Assembly Third Reading",75,0,0,4,79
624620,371763,2014-06-16,Senate,"Do pass, but re-refer to the Committee on Appropriations Recommend 	Consent",9,0,0,0,9
624620,377332,2014-08-14,Senate,"Assembly 3rd Reading AB2018 Bocanegra By Padilla",33,0,7,0,40
624620,377980,2014-08-20,Assembly,"Senate amendments be concurred in",14,0,0,0,14
624620,378165,2014-08-21,Assembly,"AB 2018 BOCANEGRA  Concurrence in Senate Amendments",79,0,0,0,79
624621,359623,2014-04-23,Assembly,"Do pass and be re-referred to the Committee on Appropriations",7,0,0,0,7
624621,366840,2014-05-23,Assembly,"Do pass",16,0,0,1,17
624621,368133,2014-05-28,Assembly,"AB 2148 MULLIN  Assembly Third Reading",78,0,0,1,79
624621,374373,2014-06-25,Senate,"Do pass, but re-refer to the Committee on Appropriations",5,0,0,0,5
624621,376522,2014-08-04,Senate,"Placed on Appropriations Suspense file",7,0,0,0,7
624621,377151,2014-08-14,Senate,"Do pass",5,0,2,0,7
624621,378252,2014-08-22,Senate,"Assembly 3rd Reading AB2148 Mullin By Lieu",33,0,7,0,40
624621,378629,2014-08-27,Assembly,"AB 2148 MULLIN  Concurrence in Senate Amendments",77,0,0,2,79
624623,359094,2014-04-23,Assembly,"Do pass and be re-referred to the Committee on Water, Parks and 	Wildlife",8,0,0,1,9
624623,362588,2014-05-06,Assembly,"Do pass as amended",13,0,0,2,15
624623,366853,2014-05-23,Assembly,"Do pass",17,0,0,0,17
624623,367609,2014-05-27,Assembly,"AB 2108 EGGMAN  Assembly Third Reading",77,0,0,2,79
624624,353544,2014-04-07,Assembly,"Do pass and re-refer to Committee on Appropriations with 	recommendation:  To Consent Calendar",9,0,0,0,9
624624,361393,2014-04-30,Assembly,"Do pass, to Consent Calendar",17,0,0,0,17
624624,363396,2014-05-08,Assembly,"AB 2082 DAHLE  Consent Calendar Second Day  Regular Session",73,0,0,6,79
624624,370622,2014-06-10,Senate,"Do pass as amended, but re-refer to the Committee on 	Appropriations Recommend Consent",9,0,0,0,9
624624,375702,2014-07-03,Senate,"Consent Calendar 2nd AB2082 Dahle",35,0,5,0,40
624624,376395,2014-08-04,Assembly,"AB 2082 DAHLE  Concurrence in Senate Amendments",78,0,0,1,79
624625,359090,2014-04-23,Assembly,"Do pass and be re-referred to the Committee on Appropriations",5,1,0,1,7
624625,366707,2014-05-23,Assembly,"Do pass",12,5,0,0,17
624625,368120,2014-05-28,Assembly,"AB 2155 RIDLEY-THOMAS  Assembly Third Reading",53,24,0,2,79
624625,373858,2014-06-23,Senate,"Do pass, but re-refer to the Committee on Appropriations",3,2,0,0,5
624625,376493,2014-08-04,Senate,"Placed on Appropriations Suspense file",7,0,0,0,7
624625,377336,2014-08-14,Senate,"Do pass as amended",5,0,2,0,7
624625,378077,2014-08-21,Senate,"Assembly 3rd Reading AB2155 Ridley-Thomas By De Le",25,10,5,0,40
624625,378749,2014-08-27,Assembly,"AB 2155 RIDLEY-THOMAS  Concurrence in Senate Amendments",56,22,0,1,79
624626,354632,2014-04-09,Assembly,"Do pass",6,0,0,3,9
624626,363384,2014-05-08,Assembly,"AB 2046 GOMEZ  Third Reading Urgency",48,12,0,19,79
624626,368896,2014-05-29,Assembly,"AB 2046 GOMEZ  Assembly Third Reading",60,17,0,2,79
624626,374587,2014-06-25,Senate,"Do pass as amended",7,0,0,0,7
624626,376461,2014-08-04,Senate,"Placed on Appropriations Suspense file",7,0,0,0,7
624627,353281,2014-04-08,Senate,"Do pass as amended, and re-refer to the Committee on Environmental 	Quality",5,2,2,0,9
624627,361213,2014-04-30,Senate,"Do pass as amended, and re-refer to the Committee on 	Appropriations",5,2,0,0,7
624627,365259,2014-05-19,Senate,"Placed on Appropriations Suspense file",7,0,0,0,7
624627,366943,2014-05-23,Senate,"Do pass as amended",4,2,1,0,7
624627,368107,2014-05-28,Senate,"Senate 3rd Reading SB1132 Mitchell",18,16,6,0,40
624627,368108,2014-05-28,Senate,"Senate 3rd Reading SB1132 Mitchell Reconsider",36,0,4,0,40
624627,368643,2014-05-29,Senate,"Senate 3rd Reading SB1132 Mitchell",16,16,8,0,40
624628,354729,2014-04-09,Senate,"Do pass as amended, and re-refer to the Committee on Appropriations",7,0,2,0,9
624628,360068,2014-04-28,Senate,"Placed on Appropriations Suspense file",6,0,1,0,7
624628,366715,2014-05-23,Senate,"Do pass as amended",7,0,0,0,7
624628,368625,2014-05-29,Senate,"Senate 3rd Reading SB1137 Torres",37,0,3,0,40
624628,375022,2014-06-25,Assembly,"Do pass as amended and be re-referred to the Committee on 	Appropriations",7,0,0,0,7
624629,354273,2014-04-02,Assembly,"Do pass and re-refer to Committee on Appropriations with 	recommendation:  To Consent Calendar",19,0,0,0,19
624629,354274,2014-04-09,Assembly,"Do pass, to Consent Calendar",17,0,0,0,17
624629,359818,2014-04-24,Assembly,"AB 2010 GRAY  Consent Calendar Second Day  Regular Session",75,0,0,4,79
624629,374247,2014-06-24,Senate,"Do pass, but re-refer to the Committee on Appropriations",10,0,0,0,10
624629,377476,2014-08-14,Senate,"Assembly 3rd Reading AB2010 Gray Urgency Clause",35,0,5,0,40
624629,378971,2014-08-28,Assembly,"Senate amendments be concurred in",18,0,0,1,19
624629,378972,2014-08-28,Assembly,"AB 2010 GRAY  Concurrence- Urgency Added",77,0,0,2,79
624631,360137,2014-04-28,Senate,"Do pass, but re-refer to the Committee on Appropriations",9,0,0,0,9
624631,363745,2014-05-12,Senate,"Placed on Appropriations Suspense file",7,0,0,0,7
624631,366693,2014-05-23,Senate,"Do pass",7,0,0,0,7
624631,368750,2014-05-29,Senate,"Senate 3rd Reading SB1246 Lieu",33,0,7,0,40
624631,374025,2014-06-24,Assembly,"Do pass and be re-referred to the Committee on Appropriations",11,0,0,3,14
624631,377326,2014-08-14,Assembly,"Do pass as amended",17,0,0,0,17
624631,378685,2014-08-27,Assembly,"SB 1246 Lieu  Senate Third Reading  By BONILLA",75,0,0,4,79
624631,378838,2014-08-28,Senate,"Unfinished Business SB1246 Lieu Concurrence",34,0,6,0,40
624633,354784,2014-04-09,Assembly,"Do pass as amended and be re-referred to the Committee on Revenue 	and Taxation",9,0,0,0,9
624633,360732,2014-04-28,Assembly,"Do pass and be re-referred to the Committee on Appropriations",9,0,0,0,9
624633,366779,2014-05-23,Assembly,"Do pass",17,0,0,0,17
624633,367647,2014-05-27,Assembly,"AB 2231 GORDON  Assembly Third Reading",77,0,0,2,79
624633,374460,2014-06-25,Senate,"Do pass, but re-refer to the Committee on Appropriations",7,0,0,0,7
624633,376484,2014-08-04,Senate,"Placed on Appropriations Suspense file",7,0,0,0,7
624633,377314,2014-08-14,Senate,"Do pass as amended",5,0,2,0,7
624633,378301,2014-08-25,Senate,"Assembly 3rd Reading AB2231 Gordon Urgency Clause",34,0,6,0,40
624633,378808,2014-08-27,Assembly,"AB 2231 GORDON  Concurrence- Urgency Added",78,0,0,1,79
624635,358543,2014-04-22,Assembly,"Do pass and be re-referred to the Committee on Appropriations",9,0,0,1,10
624635,361334,2014-04-30,Assembly,"Do pass",17,0,0,0,17
624635,363329,2014-05-08,Assembly,"AB 2089 QUIRK  Assembly Third Reading",75,0,0,4,79
624635,370889,2014-06-10,Senate,"Do pass as amended, and re-refer to the Committee on 	Appropriations",7,0,0,0,7
624635,376535,2014-08-04,Senate,"Placed on Appropriations Suspense file",7,0,0,0,7
624635,377458,2014-08-14,Senate,"Do pass as amended",5,0,2,0,7
624635,378067,2014-08-21,Senate,"Assembly 3rd Reading AB2089 Quirk By Anderson",34,0,6,0,40
624635,378213,2014-08-22,Assembly,"AB 2089 QUIRK  Concurrence in Senate Amendments",76,0,0,3,79
624636,358818,2014-04-22,Senate,"Do pass, but re-refer to the Committee on Appropriations",4,0,1,0,5
624636,362344,2014-05-05,Senate,"Placed on Appropriations Suspense file",7,0,0,0,7
624636,366825,2014-05-23,Senate,"Do pass as amended",7,0,0,0,7
624636,368691,2014-05-29,Senate,"Senate 3rd Reading SB1252 Torres",37,0,3,0,40
624636,372245,2014-06-17,Assembly,"Do pass and be re-referred to the Committee on Appropriations",6,0,0,1,7
624636,375590,2014-07-02,Assembly,"Do pass",16,1,0,0,17
624636,378736,2014-08-27,Assembly,"SB 1252 Torres  Senate Third Reading  By MAIENSCHEIN",77,1,0,1,79
624636,378939,2014-08-28,Senate,"Unfinished Business SB1252 Torres Concurrence",33,0,7,0,40
624637,359615,2014-04-24,Senate,"Do pass as amended, and re-refer to the Committee on Appropriations",5,1,1,0,7
624639,348225,2014-03-26,Assembly,"Do pass and be re-referred to the Committee on Jobs, Economic 	Development and The Economy",9,1,0,2,12
624639,359272,2014-04-22,Assembly,"Do pass as amended and be re-referred to the Committee on 	Appropriations",5,1,0,3,9
624639,366839,2014-05-23,Assembly,"Do pass as amended",13,4,0,0,17
624639,368116,2014-05-28,Assembly,"AB 2022 MEDINA  Assembly Third Reading",55,20,0,4,79
624639,371708,2014-06-16,Senate,"Do pass, but re-refer to the Committee on Appropriations",9,0,0,0,9
624639,376438,2014-08-04,Senate,"Placed on Appropriations Suspense file",7,0,0,0,7
624639,377241,2014-08-14,Senate,"Do pass as amended",5,0,2,0,7
624639,377923,2014-08-20,Senate,"Assembly 3rd Reading AB2022 Medina By Block",29,4,7,0,40
624639,378253,2014-08-22,Assembly,"AB 2022 MEDINA  Concurrence in Senate Amendments",56,17,0,6,79
624640,347149,2014-03-24,Assembly,"Do pass as amended and be re-referred to the Committee on 	Appropriations",14,1,0,1,16
624640,354250,2014-04-09,Assembly,"Do pass",17,0,0,0,17
624640,361580,2014-05-01,Assembly,"AB 2090 FONG  Assembly Third Reading",71,2,0,6,79
624640,372201,2014-06-17,Senate,"Do pass, but re-refer to the Committee on Appropriations",10,0,1,0,11
624640,376913,2014-08-11,Senate,"Assembly 3rd Reading AB2090 Fong By Hill",32,3,5,0,40
624640,377614,2014-08-18,Assembly,"AB 2090 FONG  Concurrence in Senate Amendments",74,3,0,2,79
624641,360060,2014-04-28,Senate,"Do pass, but re-refer to the Committee on Appropriations",1,3,5,0,9
624641,360061,2014-04-28,Senate,"Set, first hearing.  Failed passage in Committee.  Reconsideration 	granted",9,0,0,0,9
624643,357975,2014-04-21,Senate,"Do pass as amended, and re-refer to the Committee on 	Appropriations",4,0,1,0,5
624643,364878,2014-05-15,Senate,"Special Consent #14 SB1251 Huff",36,0,4,0,40
624643,374559,2014-06-25,Assembly,"Do pass and be re-referred to the Committee on Appropriations",7,0,0,0,7
624643,377188,2014-08-14,Assembly,"Do pass",17,0,0,0,17
624643,378570,2014-08-26,Assembly,"SB 1251 Huff  Senate Third Reading  By CONWAY",78,0,0,1,79
624643,378817,2014-08-27,Senate,"Unfinished Business SB1251 Huff Concurrence",34,0,6,0,40
624645,377427,2014-08-14,Senate,"Senate 3rd Reading SB1224 Correa Urgency Clause",28,4,8,0,40
624645,377773,2014-08-19,Assembly,"SB 1224 Correa  Third Reading Urgency  By HALL",73,2,0,4,79
624647,360626,2014-04-29,Assembly,"Do pass as amended and be re-referred to the Committee on 	Appropriations",6,7,0,2,15
624648,353235,2014-04-08,Assembly,"Do pass",13,0,0,2,15
624648,357949,2014-04-21,Assembly,"AB 2075 ALEJO  Assembly Third Reading",65,3,0,11,79
624648,370541,2014-06-10,Senate,"Do pass as amended",8,1,0,0,9
624648,373313,2014-06-19,Senate,"Assembly 3rd Reading AB2075 Alejo By Cannella",23,7,10,0,40
624648,373724,2014-06-23,Assembly,"AB 2075 ALEJO  Concurrence in Senate Amendments",56,5,0,18,79
624648,376777,2014-08-07,Senate,"Assembly 3rd Reading AB2075 Alejo By Cannella",22,9,9,0,40
624648,377357,2014-08-14,Assembly,"AB 2075 ALEJO  Concurrence in Senate Amendments",60,5,0,14,79
624649,360693,2014-04-29,Senate,"Do pass",9,0,2,0,11
624649,362259,2014-05-05,Senate,"Senate 3rd Reading SB1195 Padilla",37,0,3,0,40
624649,374052,2014-06-23,Assembly,"Do pass and be re-referred to the Committee on Appropriations",14,0,0,1,15
624649,376730,2014-08-06,Assembly,"Do pass, to Consent Calendar",17,0,0,0,17
624649,376982,2014-08-11,Assembly,"SB 1195 Steinberg  Third Reading Urgency",66,0,0,13,79
624649,376983,2014-08-11,Senate,"W/O REF. TO FILE SB1195 Steinberg Concurrence",28,3,9,0,40
624650,354509,2014-04-08,Assembly,"Do pass as amended",6,0,0,1,7
624650,360098,2014-04-28,Assembly,"AB 2041 JONES  Assembly Third Reading",71,3,0,5,79
624650,374574,2014-06-24,Senate,"Do pass as amended, and re-refer to the Committee on Appropriations",4,0,1,0,5
624650,376649,2014-08-04,Senate,"Placed on Appropriations Suspense file",7,0,0,0,7
624651,347022,2014-03-24,Assembly,"Do pass and be re-referred to the Committee on Local Government",15,0,0,1,16
624651,354169,2014-04-09,Assembly,"Do pass",16,0,0,1,17
624651,357956,2014-04-21,Assembly,"AB 2021 GORDON  Assembly Third Reading",78,0,0,1,79
624651,370672,2014-06-10,Senate,"Do pass as amended, and re-refer to the Committee on 	Appropriations",10,0,1,0,11
624654,353185,2014-04-08,Assembly,"Do pass and be re-referred to the Committee on Appropriations",15,0,0,0,15
624654,366725,2014-05-23,Assembly,"Do pass as amended",16,0,0,1,17
624654,367974,2014-05-28,Assembly,"AB 2193 GORDON  Assembly Third Reading",77,0,0,2,79
624654,373995,2014-06-24,Senate,"Do pass, but re-refer to the Committee on Appropriations",9,0,0,0,9
624654,376434,2014-08-04,Senate,"Placed on Appropriations Suspense file",7,0,0,0,7
624654,377386,2014-08-14,Senate,"Do pass as amended",5,0,2,0,7
624654,378625,2014-08-27,Senate,"Assembly 3rd Reading AB2193 Gordon By Pavley",35,0,5,0,40
624654,378891,2014-08-28,Assembly,"AB 2193 GORDON  Concurrence in Senate Amendments",78,0,0,1,79
624655,358406,2014-04-22,Senate,"Do pass as amended, and re-refer to the Committee on Appropriations",4,0,1,0,5
624655,365345,2014-05-19,Senate,"Placed on Appropriations Suspense file",7,0,0,0,7
624655,366706,2014-05-23,Senate,"Do pass as amended",7,0,0,0,7
624655,368180,2014-05-28,Senate,"Senate 3rd Reading SB1136 Huff",37,0,3,0,40
624655,372168,2014-06-17,Assembly,"Do pass as amended and be re-referred to the Committee on 	Appropriations",6,0,0,1,7
624655,375594,2014-07-02,Assembly,"Do pass",17,0,0,0,17
624655,376764,2014-08-07,Assembly,"SB 1136 Huff  Senate Third Reading  By GORELL",78,0,0,1,79
624655,376953,2014-08-11,Senate,"Unfinished Business SB1136 Huff Concurrence",36,0,4,0,40
624656,360581,2014-04-29,Assembly,"Do pass and be re-referred to the Committee on Appropriations",5,8,0,2,15
624657,354175,2014-04-09,Assembly,"Do pass as amended and be re-referred to the Committee on Local 	Government",5,2,0,0,7
624657,361732,2014-04-30,Assembly,"Do pass as amended and be re-referred to the Committee on 	Appropriations",7,2,0,0,9
624657,364547,2014-05-14,Assembly,"Do pass",12,5,0,0,17
624657,365368,2014-05-19,Assembly,"AB 2135 TING  Assembly Third Reading",53,22,0,4,79
624657,372132,2014-06-17,Senate,"Do pass, but re-refer to the Committee on Appropriations",8,1,2,0,11
624657,376574,2014-08-04,Senate,"Do pass",5,2,0,0,7
624657,377083,2014-08-13,Senate,"Assembly 3rd Reading AB2135 Ting By DeSaulnier",22,10,8,0,40
624657,377683,2014-08-18,Assembly,"AB 2135 TING  Concurrence in Senate Amendments",54,24,0,1,79
624658,350212,2014-04-01,Assembly,"Do pass and be re-referred to the Committee on Appropriations",5,1,0,1,7
624658,366797,2014-05-23,Assembly,"Do pass as amended",12,5,0,0,17
624658,368790,2014-05-29,Assembly,"AB 2177 BROWN  Assembly Third Reading",54,23,0,2,79
624658,374302,2014-06-24,Senate,"Do pass as amended, and re-refer to the Committee on Appropriations",5,0,0,0,5
624658,376514,2014-08-04,Senate,"Placed on Appropriations Suspense file",7,0,0,0,7
624659,359224,2014-04-22,Senate,"Do pass, but re-refer to the Committee on Public Safety",10,0,1,0,11
624659,362253,2014-05-05,Senate,"Do pass",6,0,1,0,7
624659,363713,2014-05-12,Senate,"Senate 3rd Reading SB1151 Cannella",32,0,8,0,40
624659,371694,2014-06-16,Assembly,"Do pass as amended and be re-referred to the Committee on 	Appropriations",14,0,0,2,16
624659,376679,2014-08-06,Assembly,"Do pass, to Consent Calendar",17,0,0,0,17
624659,377209,2014-08-14,Assembly,"SB 1151 Cannella  Consent Calendar Second Day  Regular Session",78,0,0,1,79
624659,377705,2014-08-18,Senate,"Unfinished Business SB1151 Cannella Concurrence",36,0,4,0,40
624660,354570,2014-04-09,Senate,"Do pass as amended, and re-refer to the Committee on Appropriations",7,0,2,0,9
624660,362241,2014-05-05,Senate,"Senate 3rd Reading SB1200 Padilla",37,0,3,0,40
624660,370407,2014-06-10,Assembly,"Do pass and be re-referred to the Committee on Appropriations",11,0,0,2,13
624660,372827,2014-06-18,Assembly,"Do pass, to Consent Calendar",15,0,0,2,17
624660,374871,2014-06-26,Assembly,"SB 1200 Padilla  Consent Calendar Second Day  Regular Session",76,0,0,3,79
624660,377944,2014-08-20,Senate,"Unfinished Business SB1200 Padilla Concurrence",34,0,6,0,40
624663,358688,2014-04-22,Assembly,"Do pass as amended and be re-referred to the Committee on 	Appropriations",9,1,0,4,14
624664,358546,2014-04-21,Assembly,"Do pass and be re-referred to the Committee on Appropriations",2,6,0,8,16
624664,358547,2014-04-21,Assembly,"Reconsideration granted",16,0,0,0,16
624665,354456,2014-04-09,Assembly,"Do pass as amended and be re-referred to the Committee on 	Appropriations",17,0,0,2,19
624665,361094,2014-04-30,Assembly,"Do pass, to Consent Calendar",17,0,0,0,17
624665,363335,2014-05-08,Assembly,"AB 2073 BIGELOW  Consent Calendar Second Day  Regular Session",73,0,0,6,79
624665,374093,2014-06-24,Senate,"Do pass, but re-refer to the Committee on Appropriations",10,0,0,0,10
624665,376798,2014-08-07,Senate,"Assembly 3rd Reading AB2073 Bigelow By Berryhill",34,0,6,0,40
624668,360660,2014-04-28,Assembly,"Do pass and be re-referred to the Committee on Appropriations",3,4,0,2,9
624669,358506,2014-04-21,Assembly,"Do pass as amended and be re-referred to the Committee on 	Appropriations",10,0,0,5,15
624669,367158,2014-05-23,Assembly,"Do pass",13,0,0,4,17
624669,368712,2014-05-29,Assembly,"AB 2218 BRADFORD  Assembly Third Reading",66,1,0,12,79
624669,374203,2014-06-23,Senate,"Do pass, but re-refer to the Committee on Appropriations",9,1,1,0,11
624669,376643,2014-08-04,Senate,"Placed on Appropriations Suspense file",7,0,0,0,7
624669,377237,2014-08-14,Senate,"Do pass as amended",5,0,2,0,7
624669,378175,2014-08-21,Senate,"Assembly 3rd Reading AB2218 Bradford By Galgiani",28,4,8,0,40
624669,378176,2014-08-21,Senate,"Assembly 3rd Reading AB2218 Bradford Reconsider",36,0,4,0,40
624669,378677,2014-08-27,Senate,"Assembly 3rd Reading AB2218 Bradford By Galgiani",29,7,4,0,40
624669,378892,2014-08-28,Assembly,"AB 2218 BRADFORD  Concurrence in Senate Amendments",64,10,0,5,79
624670,358814,2014-04-22,Assembly,"Do pass and be re-referred to the Committee on Judiciary",19,0,0,0,19
624670,362639,2014-05-06,Assembly,"Do pass",10,0,0,0,10
624670,367033,2014-05-23,Assembly,"AB 2059 MURATSUCHI  Assembly Third Reading",73,0,0,6,79
624670,374533,2014-06-24,Senate,"Do pass",5,2,0,0,7
624673,361485,2014-04-30,Assembly,"Do pass and be re-referred to the Committee on Appropriations",19,0,0,0,19
624673,363075,2014-05-07,Assembly,"Do pass, to Consent Calendar",17,0,0,0,17
624673,364886,2014-05-15,Assembly,"AB 2182 GAINES  Consent Calendar Second Day  Regular Session",78,0,0,1,79
624673,370589,2014-06-10,Senate,"Do pass, but re-refer to the Committee on Appropriations",7,0,3,0,10
624673,376384,2014-08-04,Senate,"Assembly 3rd Reading AB2182 Beth Gaines By Gaines",36,0,4,0,40
624674,361714,2014-04-30,Assembly,"Do pass as amended and be re-referred to the Committee on 	Appropriations",7,0,0,2,9
624674,366182,2014-05-21,Assembly,"Do pass",14,0,0,3,17
624674,367654,2014-05-27,Assembly,"AB 2188 MURATSUCHI  Assembly Third Reading",58,8,0,13,79
624674,374282,2014-06-25,Senate,"Do pass as amended, and re-refer to the Committee on Appropriations",6,1,0,0,7
624674,377954,2014-08-20,Senate,"Assembly 3rd Reading AB2188 Muratsuchi By Wolk",22,6,12,0,40
624674,378120,2014-08-21,Assembly,"AB 2188 MURATSUCHI  Concurrence in Senate Amendments",68,3,0,8,79
624675,358490,2014-04-22,Assembly,"Do pass and be re-referred to the Committee on Appropriations",19,0,0,0,19
624675,362989,2014-05-07,Assembly,"Do pass, to Consent Calendar",17,0,0,0,17
624675,365397,2014-05-19,Assembly,"AB 2062 HERNANDEZ  Assembly Third Reading",76,0,0,3,79
624675,373363,2014-06-18,Senate,"Do pass as amended, and re-refer to the Committee on 	Appropriations",7,0,2,0,9
624675,378296,2014-08-25,Senate,"Assembly 3rd Reading AB2062 Roger Hern",31,1,8,0,40
624675,378549,2014-08-26,Assembly,"AB 2062 HERNANDEZ  Concurrence in Senate Amendments",79,0,0,0,79
624676,360694,2014-04-29,Senate,"Do pass as amended, and re-refer to the Committee on Appropriations",6,0,1,0,7
624676,367510,2014-05-27,Senate,"Senate 3rd Reading SB1255 Cannella",34,0,6,0,40
624676,373980,2014-06-24,Assembly,"Do pass as amended and be re-referred to the Committee on 	Appropriations",7,0,0,0,7
624676,376712,2014-08-06,Assembly,"Do pass, to Consent Calendar",17,0,0,0,17
624676,378147,2014-08-21,Assembly,"SB 1255 Cannella  Senate Third Reading  By WIECKOWSKI",79,0,0,0,79
624676,378283,2014-08-25,Senate,"Unfinished Business SB1255 Cannella Concurrence",35,0,5,0,40
624677,359301,2014-04-22,Senate,"Do pass, but re-refer to the Committee on Appropriations",5,0,0,0,5
624677,362278,2014-05-05,Senate,"Do pass",7,0,0,0,7
624677,367519,2014-05-27,Senate,"Senate 3rd Reading SB1226 Correa",34,0,6,0,40
624677,370547,2014-06-10,Assembly,"Do pass and be re-referred to the Committee on Local Government",6,0,0,1,7
624677,374561,2014-06-25,Assembly,"Do pass as amended and be re-referred to the Committee on 	Appropriations",9,0,0,0,9
624677,377095,2014-08-13,Assembly,"Do pass",17,0,0,0,17
624677,377907,2014-08-20,Assembly,"Do pass",14,0,0,0,14
624677,378732,2014-08-27,Assembly,"SB 1226 Correa  Senate Third Reading  By CHAVEZ",77,0,0,2,79
624677,378837,2014-08-28,Senate,"From committee:  That the Assembly Amendments be concurred in",9,0,0,0,9
624677,379122,2014-08-29,Senate,"Unfinished Supp 1 SB1226 Correa Concurrence",35,0,5,0,40
624678,354568,2014-04-02,Assembly,"Do pass and re-refer to Committee on Appropriations with 	recommendation:  To Consent Calendar",19,0,0,0,19
624678,354569,2014-04-09,Assembly,"Do pass, to Consent Calendar",17,0,0,0,17
624678,359825,2014-04-24,Assembly,"AB 2004 CHESBRO  Consent Calendar Second Day  Regular Session",75,0,0,4,79
624678,374094,2014-06-24,Senate,"Do pass as amended, and re-refer to the Committee on 	Appropriations",10,0,0,0,10
624678,377708,2014-08-18,Senate,"Assembly 3rd Reading AB2004 Chesbro By Evans",36,0,4,0,40
624678,378925,2014-08-28,Assembly,"Senate amendments be concurred in",18,0,0,1,19
624678,378926,2014-08-28,Assembly,"AB 2004 CHESBRO  Concurrence in Senate Amendments",78,0,0,1,79
624679,360670,2014-04-29,Assembly,"Do pass and be re-referred to the Committee on Appropriations",11,0,0,4,15
624680,351071,2014-04-02,Assembly,"Do pass and be re-referred to the Committee on Revenue and Taxation",9,0,0,0,9
624680,360614,2014-04-28,Assembly,"Do pass as amended and be re-referred to the Committee on 	Appropriations",9,0,0,0,9
624680,366968,2014-05-23,Assembly,"Do pass",17,0,0,0,17
624680,367437,2014-05-27,Assembly,"AB 2109 DALY  Assembly Third Reading",77,0,0,2,79
624680,372695,2014-06-18,Senate,"Do pass, but re-refer to the Committee on Appropriations",7,0,0,0,7
624680,376430,2014-08-04,Senate,"Placed on Appropriations Suspense file",7,0,0,0,7
624680,377370,2014-08-14,Senate,"Do pass",5,0,2,0,7
624680,378419,2014-08-25,Senate,"Assembly 3rd Reading AB2109 Daly By Galgiani",33,0,7,0,40
624680,378518,2014-08-26,Assembly,"AB 2109 DALY  Concurrence in Senate Amendments",79,0,0,0,79
624681,360319,2014-04-28,Senate,"Do pass, but re-refer to the Committee on Appropriations",9,0,0,0,9
624681,363753,2014-05-12,Senate,"Placed on Appropriations Suspense file",7,0,0,0,7
624681,366663,2014-05-23,Senate,"Do pass",7,0,0,0,7
624681,367559,2014-05-27,Senate,"Senate 3rd Reading SB1245 Lieu",36,0,4,0,40
624681,374043,2014-06-24,Assembly,"Do pass and be re-referred to the Committee on Appropriations",13,0,0,1,14
624681,377171,2014-08-14,Assembly,"Do pass",17,0,0,0,17
624681,378407,2014-08-25,Assembly,"SB 1245 Lieu  Senate Third Reading  By BONILLA",79,0,0,0,79
624683,359287,2014-04-23,Assembly,"Do pass as amended and be re-referred to the Committee on 	Appropriations",9,0,0,0,9
624683,367094,2014-05-23,Assembly,"Do pass as amended",17,0,0,0,17
624683,368241,2014-05-28,Assembly,"AB 2211 TING  Assembly Third Reading",78,0,0,1,79
624683,374542,2014-06-25,Senate,"Do pass, but re-refer to the Committee on Appropriations",7,0,0,0,7
624683,376600,2014-08-04,Senate,"Placed on Appropriations Suspense file",7,0,0,0,7
624683,377521,2014-08-14,Senate,"Do pass",5,0,2,0,7
624683,378584,2014-08-26,Senate,"Assembly 3rd Reading AB2211 Ting By Walters",34,0,6,0,40
624683,378610,2014-08-27,Assembly,"AB 2211 TING  Concurrence in Senate Amendments",77,0,0,2,79
624686,358537,2014-04-22,Assembly,"Do pass and be re-referred to the Committee on Appropriations",6,0,0,1,7
624686,361206,2014-04-30,Assembly,"Do pass, to Consent Calendar",17,0,0,0,17
624686,365438,2014-05-19,Assembly,"AB 2121 GRAY  Assembly Third Reading",76,0,0,3,79
624686,374478,2014-06-24,Senate,"Do pass as amended, and re-refer to the Committee on Appropriations",7,0,0,0,7
624686,377884,2014-08-20,Senate,"Assembly 3rd Reading AB2121 Gray By Block",33,0,7,0,40
624686,378073,2014-08-21,Assembly,"AB 2121 GRAY  Concurrence in Senate Amendments",78,0,0,1,79
624687,359754,2014-04-24,Senate,"Do pass",11,0,0,0,11
624687,361625,2014-05-01,Senate,"Senate 3rd Reading SB1142 Monning",36,0,4,0,40
624687,374565,2014-06-25,Assembly,"Do pass",12,1,0,0,13
624687,376856,2014-08-07,Assembly,"SB 1142 Monning  Senate Third Reading  By PEREA",74,1,0,4,79
624687,376939,2014-08-11,Senate,"Unfinished Business SB1142 Monning Concurrence",36,0,4,0,40
624688,361586,2014-04-30,Senate,"Do pass, but re-refer to the Committee on Appropriations Recommend 	Consent",7,0,2,0,9
624688,364834,2014-05-15,Senate,"Consent Calendar 2nd SB1235 Knight",36,0,4,0,40
624688,374409,2014-06-24,Assembly,"Do pass as amended and be re-referred to the Committee on 	Appropriations",17,0,0,2,19
624688,376721,2014-08-06,Assembly,"Do pass, to Consent Calendar",17,0,0,0,17
624688,377377,2014-08-14,Assembly,"SB 1235 Knight  Consent Calendar Second Day  Regular Session",78,0,0,1,79
624688,378372,2014-08-25,Assembly,"SB 1235 Knight  Senate Third Reading  By WILK",79,0,0,0,79
624688,378533,2014-08-26,Senate,"Unfinished Supp 1 SB1235 Knight Concurrence",36,0,4,0,40
624691,353342,2014-04-07,Assembly,"Do pass and re-refer to Committee on Appropriations with 	recommendation:  To Consent Calendar",9,0,0,0,9
624691,361467,2014-04-30,Assembly,"Do pass, to Consent Calendar",17,0,0,0,17
624691,363391,2014-05-08,Assembly,"AB 2112 DAHLE  Consent Calendar Second Day  Regular Session",73,0,0,6,79
624691,370660,2014-06-10,Senate,"Do pass, but re-refer to the Committee on Appropriations Recommend 	Consent",9,0,0,0,9
624691,374802,2014-06-26,Senate,"Consent Calendar 2nd AB2112 Dahle",32,0,8,0,40
624693,353437,2014-04-08,Assembly,"Do pass and be re-referred to the Committee on Appropriations",7,0,0,0,7
624694,358644,2014-04-22,Assembly,"Do pass and re-refer to Committee on Appropriations with 	recommendation:  To Consent Calendar",14,0,0,0,14
624694,361307,2014-04-30,Assembly,"Do pass, to Consent Calendar",17,0,0,0,17
624694,363506,2014-05-08,Assembly,"AB 2024 BONILLA  Consent Calendar Second Day  Regular Session",73,0,0,6,79
624694,371827,2014-06-16,Senate,"Do pass, but re-refer to the Committee on Appropriations",8,0,1,0,9
624694,375238,2014-06-30,Senate,"Do pass",6,0,1,0,7
624694,377840,2014-08-19,Senate,"Assembly 3rd Reading AB2024 Bonilla By Lieu",33,0,7,0,40
624696,361298,2014-04-29,Assembly,"Do pass as amended",7,0,0,0,7
624697,358677,2014-04-22,Assembly,"Do pass as amended and be re-referred to the Committee on 	Appropriations",6,0,0,1,7
624697,363051,2014-05-07,Assembly,"Do pass as amended",13,0,0,4,17
624697,368705,2014-05-29,Assembly,"AB 2029 COOLEY  Assembly Third Reading",64,0,0,15,79
624697,374963,2014-06-25,Senate,"Do pass as amended, and re-refer to the Committee on 	Appropriations",8,0,1,0,9
624697,378243,2014-08-22,Senate,"Assembly 3rd Reading AB2029 Cooley By Beall",33,0,7,0,40
624697,378801,2014-08-27,Assembly,"AB 2029 COOLEY  Concurrence in Senate Amendments",77,0,0,2,79
624698,361195,2014-04-30,Senate,"Do pass, but re-refer to the Committee on Appropriations",5,1,1,0,7
624698,363709,2014-05-12,Senate,"Placed on Appropriations Suspense file",7,0,0,0,7
624698,366923,2014-05-23,Senate,"Do pass as amended",4,2,1,0,7
624698,368030,2014-05-28,Senate,"Senate 3rd Reading SB1249 Hill",23,12,5,0,40
624698,372125,2014-06-17,Assembly,"Do pass as amended and be re-referred to the Committee on 	Appropriations",6,0,0,1,7
624698,377170,2014-08-14,Assembly,"Do pass",12,1,0,4,17
624698,377741,2014-08-19,Assembly,"SB 1249 Hill  Senate Third Reading  By ALEJO",67,3,0,9,79
624698,378759,2014-08-27,Assembly,"SB 1249 Hill  Senate Third Reading  By ALEJO",61,16,0,2,79
624698,378840,2014-08-28,Senate,"Unfinished Business SB1249 Hill Concurrence",23,9,8,0,40
624699,358372,2014-04-22,Senate,"Do pass, but re-refer to the Committee on Rules",8,1,0,0,9
624699,361210,2014-04-30,Senate,"Do pass as amended, and re-refer to the Committee on 	Appropriations",5,2,0,0,7
624699,365494,2014-05-19,Senate,"Placed on Appropriations Suspense file",7,0,0,0,7
624699,366886,2014-05-23,Senate,"Do pass as amended",5,2,0,0,7
624699,368064,2014-05-28,Senate,"Senate 3rd Reading SB1217 Leno",25,11,4,0,40
624699,374139,2014-06-23,Assembly,"Do pass as amended and be re-referred to the Committee on 	Appropriations",6,2,0,1,9
624704,353908,2014-04-08,Assembly,"Do pass, to Consent Calendar",10,0,0,0,10
624704,357928,2014-04-21,Assembly,"AB 2166 BONTA  Consent Calendar Second Day  Regular Session",77,0,0,2,79
624705,350940,2014-04-02,Senate,"Do pass and be placed on the Consent Calendar",7,0,0,0,7
624705,355166,2014-04-10,Senate,"Consent Calendar 2nd SB1231 Committee on GOV. & F. (Wolk)",34,0,6,0,40
624705,363308,2014-05-07,Assembly,"Do pass, to Consent Calendar",9,0,0,0,9
624705,376828,2014-08-07,Assembly,"SB 1231 GOV.& F.  Third Reading Urgency  By ACHADJIAN",78,0,0,1,79
624706,359573,2014-04-23,Assembly,"Do pass and be re-referred to the Committee on Appropriations",7,0,0,0,7
624706,367174,2014-05-23,Assembly,"Do pass",17,0,0,0,17
624706,367550,2014-05-27,Assembly,"AB 2146 SKINNER  Assembly Third Reading",77,0,0,2,79
624706,374283,2014-06-25,Senate,"Do pass, but re-refer to the Committee on Appropriations",5,0,0,0,5
624706,376442,2014-08-04,Senate,"Placed on Appropriations Suspense file",7,0,0,0,7
624706,377588,2014-08-14,Senate,"Do pass as amended",5,0,2,0,7
624706,378426,2014-08-25,Senate,"Assembly 3rd Reading AB2146 Skinner By Hueso",34,0,6,0,40
624706,378536,2014-08-26,Assembly,"AB 2146 SKINNER  Concurrence in Senate Amendments",79,0,0,0,79
624707,350942,2014-04-02,Senate,"Do pass and be placed on the Consent Calendar",7,0,0,0,7
624707,355135,2014-04-10,Senate,"Consent Calendar 2nd SB1230 Committee on GOV. & F. (Wolk)",34,0,6,0,40
624707,363074,2014-05-07,Assembly,"Do pass, to Consent Calendar",9,0,0,0,9
624707,364959,2014-05-15,Assembly,"SB 1230 GOV.& F.  Consent Calendar Second Day  Regular Session",78,0,0,1,79
624709,350272,2014-04-01,Senate,"Do pass",11,0,0,0,11
624709,359532,2014-04-24,Senate,"Special Consent #12 SB1167 Hueso",37,0,3,0,40
624709,372761,2014-06-18,Assembly,"Do pass",6,0,0,1,7
624709,374842,2014-06-26,Assembly,"SB 1167 Hueso  Senate Third Reading  By CHAU",74,0,0,5,79
624710,347563,2014-03-25,Assembly,"Do pass and be re-referred to the Committee on Appropriations",10,4,0,1,15
624710,366971,2014-05-23,Assembly,"Do pass as amended",12,4,0,1,17
624710,368637,2014-05-29,Assembly,"AB 2150 RENDON  Third Reading Urgency",56,16,0,7,79
624710,374017,2014-06-24,Senate,"Do pass, but re-refer to the Committee on Appropriations",8,0,1,0,9
624710,376545,2014-08-04,Senate,"Placed on Appropriations Suspense file",7,0,0,0,7
624710,377127,2014-08-14,Senate,"Do pass as amended",5,0,2,0,7
624710,378076,2014-08-21,Senate,"Assembly 3rd Reading AB2150 Rendon By Pavley",26,4,10,0,40
624710,378389,2014-08-25,Assembly,"AB 2150 RENDON  Concurrence in Senate Amendments",57,20,0,2,79
624712,355124,2014-04-09,Assembly,"Do pass and be re-referred to the Committee on Appropriations",6,1,0,0,7
624713,364380,2014-05-14,Senate,"Do pass, but re-refer to the Committee on Appropriations",6,0,1,0,7
624713,365325,2014-05-19,Senate,"Placed on Appropriations Suspense file",7,0,0,0,7
624713,366701,2014-05-23,Senate,"Do pass",7,0,0,0,7
624713,367474,2014-05-27,Senate,"Senate 3rd Reading SB1152 Anderson",36,0,4,0,40
624714,359452,2014-04-22,Assembly,"Do pass and be re-referred to the Committee on Appropriations",6,1,0,2,9
624715,361700,2014-04-30,Assembly,"Do pass and be re-referred to the Committee on Appropriations",5,0,0,2,7
624715,367146,2014-05-23,Assembly,"Do pass",12,0,0,5,17
624715,368086,2014-05-28,Assembly,"AB 2016 CAMPOS  Assembly Third Reading",61,2,0,16,79
624715,374570,2014-06-25,Senate,"Do pass as amended, and re-refer to the Committee on Appropriations",4,0,3,0,7
624715,376601,2014-08-04,Senate,"Placed on Appropriations Suspense file",7,0,0,0,7
624715,377571,2014-08-14,Senate,"Do pass as amended",5,0,2,0,7
624715,378039,2014-08-21,Senate,"Assembly 3rd Reading AB2016 Campos By Mitchell",28,0,12,0,40
624715,378384,2014-08-25,Assembly,"AB 2016 CAMPOS  Concurrence in Senate Amendments",65,7,0,7,79
624716,361748,2014-04-30,Senate,"Do pass",2,7,0,0,9
624716,361749,2014-04-30,Senate,"Set, final hearing.  Failed passage in Committee.  Reconsideration 	granted",9,0,0,0,9
624720,350668,2014-04-01,Senate,"Be adopted, but re-refer to the Committee on Appropriations 	Recommend Consent",11,0,0,0,11
624720,361755,2014-05-01,Senate,"Consent Calendar 2nd SCR84 Lara",35,0,5,0,40
624720,370341,2014-06-09,Assembly,"Be adopted, and re-refer to Committee on Appropriations with 	recommendation:  To Consent Calendar",16,0,0,0,16
624720,372672,2014-06-18,Assembly,"Be adopted, to Consent Calendar",15,0,0,2,17
624720,373793,2014-06-23,Assembly,"SCR 84 Lara  Consent Calendar Second Day  Regular Session",75,0,0,4,79
624720,375706,2014-07-03,Senate,"Special Consent #18 SCR84 Lara",35,0,5,0,40
624722,362645,2014-05-06,Assembly,"Do pass, to Consent Calendar",10,0,0,0,10
624722,364945,2014-05-15,Assembly,"AB 2136 DALY  Consent Calendar Second Day",78,0,0,1,79
624722,371111,2014-06-10,Senate,"Do pass",6,0,1,0,7
624722,374990,2014-06-26,Senate,"Special Consent #17 AB2136 Daly",32,0,8,0,40
624723,358553,2014-04-21,Assembly,"Do pass as amended and be re-referred to the Committee on 	Appropriations",12,0,0,0,12
624723,363135,2014-05-07,Assembly,"Do pass, to Consent Calendar",17,0,0,0,17
624723,365339,2014-05-19,Assembly,"AB 2096 MURATSUCHI  Assembly Third Reading",75,0,0,4,79
624723,372717,2014-06-18,Senate,"Do pass, but re-refer to the Committee on Judiciary",7,2,0,0,9
624723,374493,2014-06-24,Senate,"Do pass, but re-refer to the Committee on Appropriations",4,3,0,0,7
624723,376926,2014-08-11,Senate,"Placed on Appropriations Suspense file",7,0,0,0,7
624724,359625,2014-04-24,Senate,"Do pass, but re-refer to the Committee on Appropriations Recommend 	Consent",11,0,0,0,11
624724,364919,2014-05-15,Senate,"Consent Calendar 2nd SB1205 Monning",36,0,4,0,40
624724,374335,2014-06-25,Assembly,"Do pass and re-refer to Committee on Appropriations with 	recommendation:  To Consent Calendar",13,0,0,0,13
624724,375613,2014-07-02,Assembly,"Do pass, to Consent Calendar",17,0,0,0,17
624724,376821,2014-08-07,Assembly,"SB 1205 Monning  Consent Calendar Second Day  Regular Session",77,0,0,2,79
624727,362845,2014-05-06,Assembly,"Do pass",10,0,0,0,10
624727,364882,2014-05-15,Assembly,"AB 2023 WAGNER  Assembly Third Reading",78,0,0,1,79
624727,374567,2014-06-24,Senate,"Do pass",3,4,0,0,7
624729,362644,2014-05-06,Senate,"Do pass as amended",10,0,1,0,11
624729,365421,2014-05-19,Senate,"Placed on Appropriations Suspense file",7,0,0,0,7
624729,366750,2014-05-23,Senate,"Do pass",7,0,0,0,7
624729,367639,2014-05-27,Senate,"Senate 3rd Reading SB1175 Walters",36,0,4,0,40
624729,373723,2014-06-23,Assembly,"Do pass as amended and be re-referred to the Committee on 	Appropriations",13,0,0,3,16
624729,377246,2014-08-14,Assembly,"Do pass as amended",17,0,0,0,17
624729,378321,2014-08-25,Assembly,"SB 1175 Walters  Senate Third Reading  By MELENDEZ",79,0,0,0,79
624729,378491,2014-08-26,Senate,"Unfinished Supp 1 SB1175 Walters Concurrence",36,0,4,0,40
624730,348176,2014-03-26,Senate,"Do pass, but re-refer to the Committee on Judiciary",9,0,0,0,9
624730,361171,2014-04-29,Senate,"Do pass and be placed on the Consent Calendar",7,0,0,0,7
624730,363446,2014-05-08,Senate,"Consent Calendar 2nd SB1177 Steinberg",35,0,5,0,40
624730,374072,2014-06-24,Assembly,"Do pass and be re-referred to the Committee on Education",7,0,0,0,7
624730,374825,2014-06-25,Assembly,"Do pass as amended",7,0,0,0,7
624730,378380,2014-08-25,Assembly,"SB 1177 Steinberg  Senate Third Reading  By BUCHANAN",79,0,0,0,79
624730,378574,2014-08-26,Senate,"Unfinished Supp 1 SB1177 Steinberg Concurrence",36,0,4,0,40
624732,376978,2014-08-11,Assembly,"From committee:  Be adopted.  To third reading",10,0,0,1,11
624732,378770,2014-08-27,Senate,"Special Consent #19 ACR102 Fox",36,0,4,0,40
624735,361250,2014-04-29,Senate,"Do pass as amended",10,1,0,0,11
624735,364929,2014-05-15,Senate,"Senate 3rd Reading SB1134 Knight",28,7,5,0,40
624735,370191,2014-06-09,Assembly,"Do pass as amended",15,0,0,1,16
624735,373356,2014-06-19,Assembly,"SB 1134 Knight  Senate Third Reading  By WILK",73,1,0,5,79
624735,375283,2014-06-30,Senate,"Unfinished Business SB1134 Knight Concurrence",29,6,5,0,40
624737,359669,2014-04-24,Senate,"Do pass as amended, and re-refer to the Committee on Appropriations",7,0,2,0,9
624737,363768,2014-05-12,Senate,"Placed on Appropriations Suspense file",7,0,0,0,7
624737,366702,2014-05-23,Senate,"Do pass",7,0,0,0,7
624737,368751,2014-05-29,Senate,"Senate 3rd Reading SB1143 Liu",37,0,3,0,40
624737,374980,2014-06-25,Assembly,"Do pass as amended and be re-referred to the Committee on 	Appropriations",7,0,0,0,7
624737,376705,2014-08-06,Assembly,"Do pass as amended",12,5,0,0,17
624738,360618,2014-04-28,Assembly,"Do pass as amended and be re-referred to the Committee on 	Appropriations",8,1,0,0,9
624738,364249,2014-05-14,Assembly,"Do pass",17,0,0,0,17
624738,365378,2014-05-19,Assembly,"AB 2031 DAHLE  Assembly Third Reading",72,1,0,6,79
624738,374111,2014-06-24,Senate,"Do pass, but re-refer to the Committee on Appropriations Recommend 	Consent",9,0,0,0,9
624738,376809,2014-08-07,Senate,"Consent Calendar 2nd AB2031 Dahle",34,0,6,0,40
624738,377799,2014-08-19,Senate,"Assembly 3rd Reading AB2031 Dahle By Gaines",34,0,6,0,40
624738,377906,2014-08-20,Assembly,"AB 2031 DAHLE  Concurrence in Senate Amendments",75,1,0,3,79
624740,360918,2014-04-29,Assembly,"Do pass as amended and be re-referred to the Committee on 	Appropriations",13,0,0,0,13
624742,350324,2014-04-01,Assembly,"Do pass, to Consent Calendar",7,0,0,0,7
624742,355095,2014-04-10,Assembly,"AB 2195 ACHADJIAN  Consent Calendar Second Day",74,0,0,5,79
624742,372117,2014-06-17,Senate,"Do pass, but re-refer to the Committee on Appropriations",5,0,2,0,7
624742,376550,2014-08-04,Senate,"Do pass",7,0,0,0,7
624742,376890,2014-08-11,Senate,"Assembly 3rd Reading AB2195 Achadjian By Monning",35,0,5,0,40
624742,377615,2014-08-18,Assembly,"AB 2195 ACHADJIAN  Concurrence in Senate Amendments",78,0,0,1,79
624743,361804,2014-04-30,Senate,"Do pass as amended, and re-refer to the Committee on Appropriations",9,0,0,0,9
624743,365437,2014-05-19,Senate,"Placed on Appropriations Suspense file",7,0,0,0,7
624744,347079,2014-03-24,Assembly,"Do pass and be re-referred to the Committee on Appropriations",14,0,0,2,16
624744,350152,2014-04-01,Assembly,"Do pass as amended",14,1,0,2,17
624744,352632,2014-04-07,Assembly,"AB 2013 MURATSUCHI  Third Reading Urgency",43,5,0,31,79
624744,361628,2014-05-01,Assembly,"AB 2013 MURATSUCHI  Third Reading Urgency",63,4,0,12,79
624744,370463,2014-06-10,Senate,"Do pass as amended, and re-refer to the Committee on 	Appropriations",9,0,2,0,11
624744,377751,2014-08-19,Senate,"Assembly 3rd Reading AB2013 Muratsuchi By DeSaulnier",25,6,9,0,40
624744,378311,2014-08-25,Assembly,"AB 2013 MURATSUCHI  Concurrence in Senate Amendments",65,8,0,6,79
624745,358651,2014-04-22,Senate,"Do pass, but re-refer to the Committee on Appropriations",7,2,0,0,9
624745,362287,2014-05-05,Senate,"Placed on Appropriations Suspense file",7,0,0,0,7
624746,359318,2014-04-22,Assembly,"Do pass as amended and be re-referred to the Committee on 	Appropriations",10,0,0,3,13
624746,366953,2014-05-23,Assembly,"Do pass as amended",12,0,0,5,17
624746,368755,2014-05-29,Assembly,"AB 2099 FRAZIER  Assembly Third Reading",62,4,0,13,79
624746,374404,2014-06-25,Senate,"Do pass as amended, and re-refer to the Committee on Appropriations",6,0,1,0,7
624746,376565,2014-08-04,Senate,"Placed on Appropriations Suspense file",7,0,0,0,7
624746,377498,2014-08-14,Senate,"Do pass as amended",5,0,2,0,7
624746,378585,2014-08-26,Senate,"Assembly 3rd Reading AB2099 Frazier Lay on Table",15,11,14,0,40
624746,378586,2014-08-26,Senate,"Assembly 3rd Reading AB2099 Frazier By Block",35,0,5,0,40
624746,378784,2014-08-27,Assembly,"AB 2099 FRAZIER  Concurrence in Senate Amendments",78,0,0,1,79
624747,354860,2014-04-09,Assembly,"Do pass and be re-referred to the Committee on Revenue and Taxation",7,2,0,0,9
624747,362628,2014-05-05,Assembly,"Do pass as amended",6,3,0,0,9
624747,365408,2014-05-19,Assembly,"AB 2119 STONE  Assembly Third Reading",50,22,0,7,79
624747,371159,2014-06-11,Senate,"Do pass",5,2,0,0,7
624747,375406,2014-06-30,Senate,"Assembly 3rd Reading AB2119 Stone By DeSaulnier",23,12,5,0,40
624748,353378,2014-04-08,Assembly,"Do pass and be re-referred to the Committee on Jobs, Economic 	Development and The Economy",7,0,0,0,7
624748,361291,2014-04-30,Assembly,"Do pass as amended and be re-referred to the Committee on 	Appropriations",7,0,0,2,9
624748,366774,2014-05-23,Assembly,"Do pass as amended",17,0,0,0,17
624748,368137,2014-05-28,Assembly,"AB 2060 PEREZ, V.M.  Assembly Third Reading",77,0,0,2,79
624748,374597,2014-06-24,Senate,"Do pass, but re-refer to the Committee on Appropriations",7,0,0,0,7
624748,376633,2014-08-04,Senate,"Placed on Appropriations Suspense file",7,0,0,0,7
624748,377263,2014-08-14,Senate,"Do pass as amended",5,0,2,0,7
624748,378620,2014-08-27,Senate,"Special Consent #19 AB2060 V. Manuel P",36,0,4,0,40
624748,378849,2014-08-28,Assembly,"AB 2060 PEREZ, V.M.  Concurrence in Senate Amendments",77,1,0,1,79
624749,348183,2014-03-25,Assembly,"Do pass and be re-referred to the Committee on Transportation",5,0,0,2,7
624749,358381,2014-04-21,Assembly,"Do pass and be re-referred to the Committee on Appropriations",13,2,0,1,16
624750,363293,2014-05-07,Assembly,"Do pass as amended",9,0,0,0,9
624750,365432,2014-05-19,Assembly,"AB 2151 WAGNER  Assembly Third Reading",72,0,0,7,79
624750,372724,2014-06-18,Senate,"Do pass as amended",7,0,0,0,7
624750,377106,2014-08-13,Senate,"Assembly 3rd Reading AB2151 Wagner By Correa",36,0,4,0,40
624750,377649,2014-08-18,Assembly,"AB 2151 WAGNER  Concurrence in Senate Amendments",76,1,0,2,79
624752,359701,2014-04-24,Assembly,"Be referred to Committee on Revenue and Taxation",10,0,0,1,11
624752,361638,2014-05-01,Assembly,"Do pass as amended and be re-referred to the Committee on 	Appropriations",9,0,0,0,9
624753,359888,2014-04-24,Senate,"Do pass as amended, and re-refer to the Committee on 	Appropriations",7,1,1,0,9
624753,363822,2014-05-12,Senate,"Placed on Appropriations Suspense file",7,0,0,0,7
624753,366687,2014-05-23,Senate,"Do pass",5,2,0,0,7
624753,367597,2014-05-27,Senate,"Senate 3rd Reading SB1176 Steinberg",24,11,5,0,40
624753,372330,2014-06-17,Assembly,"Do pass as amended and be re-referred to the Committee on 	Appropriations",14,5,0,0,19
624753,377175,2014-08-14,Assembly,"Do pass",12,5,0,0,17
624757,358402,2014-04-22,Assembly,"Do pass and be re-referred to the Committee on Appropriations",7,0,0,0,7
624757,361331,2014-04-30,Assembly,"Do pass",16,0,0,1,17
624757,363346,2014-05-08,Assembly,"AB 2186 LOWENTHAL  Assembly Third Reading",74,0,0,5,79
624757,370644,2014-06-10,Senate,"Do pass as amended, and re-refer to the Committee on Appropriations",6,0,1,0,7
624757,378310,2014-08-25,Senate,"Assembly 3rd Reading AB2186 Lowenthal By Anderson",35,0,5,0,40
624757,378486,2014-08-26,Assembly,"AB 2186 LOWENTHAL  Concurrence in Senate Amendments",79,0,0,0,79
624760,359596,2014-04-24,Senate,"Set, second hearing.  Failed passage in Committee. 	Reconsideration granted",3,8,0,0,11
624760,359884,2014-04-24,Senate,"Set, second hearing.  Failed passage in Committee. 	Reconsideration granted",11,0,0,0,11
624762,360158,2014-04-28,Senate,"Do pass, but re-refer to the Committee on Appropriations",9,0,0,0,9
624762,363720,2014-05-12,Senate,"Placed on Appropriations Suspense file",7,0,0,0,7
624762,366975,2014-05-23,Senate,"Do pass",7,0,0,0,7
624762,367467,2014-05-27,Senate,"Senate 3rd Reading SB1242 Lieu",36,0,4,0,40
624762,374107,2014-06-24,Assembly,"Do pass and re-refer to Committee on Appropriations with 	recommendation:  To Consent Calendar",14,0,0,0,14
624762,375568,2014-07-02,Assembly,"Do pass, to Consent Calendar",17,0,0,0,17
624762,376815,2014-08-07,Assembly,"SB 1242 Lieu  Consent Calendar Second Day  Regular Session",77,0,0,2,79
624764,360690,2014-04-28,Assembly,"Do pass as amended and be re-referred to the Committee on 	Appropriations",9,0,0,0,9
624765,358483,2014-04-22,Senate,"Do pass, but re-refer to the Committee on Transportation and 	Housing",4,0,1,0,5
624765,361183,2014-04-29,Senate,"Do pass as amended, and re-refer to the Committee on 	Appropriations",11,0,0,0,11
624765,365425,2014-05-19,Senate,"Placed on Appropriations Suspense file",7,0,0,0,7
624766,359867,2014-04-24,Senate,"Do pass as amended, and re-refer to the Committee on 	Appropriations",7,0,2,0,9
624766,363729,2014-05-12,Senate,"Placed on Appropriations Suspense file",7,0,0,0,7
624766,366781,2014-05-23,Senate,"Do pass",6,1,0,0,7
624766,367554,2014-05-27,Senate,"Senate 3rd Reading SB1161 Beall",32,4,4,0,40
624766,372205,2014-06-17,Assembly,"Do pass and be re-referred to the Committee on Appropriations",17,0,0,2,19
624766,377540,2014-08-14,Assembly,"Do pass as amended",16,1,0,0,17
624766,378791,2014-08-27,Assembly,"SB 1161 Beall  Senate Third Reading  By CHESBRO",76,1,0,2,79
624766,378959,2014-08-28,Senate,"Unfinished Business SB1161 Beall Concurrence",34,0,6,0,40
624767,348149,2014-03-26,Senate,"Do pass as amended, and re-refer to the Committee on Appropriations",7,1,1,0,9
624767,352705,2014-04-07,Senate,"Placed on Appropriations Suspense file",7,0,0,0,7
624767,366851,2014-05-23,Senate,"Do pass as amended",5,2,0,0,7
624767,368138,2014-05-28,Senate,"Senate 3rd Reading SB1221 Hancock",25,10,5,0,40
624767,374933,2014-06-25,Assembly,"Do pass as amended and be re-referred to the Committee on 	Appropriations",6,1,0,0,7
624767,377347,2014-08-14,Assembly,"Do pass",12,5,0,0,17
624767,377984,2014-08-20,Assembly,"SB 1221 Hancock  Senate Third Reading  By NAZARIAN",56,22,0,1,79
624767,378162,2014-08-21,Senate,"Unfinished Business SB1221 Hancock Concurrence",22,10,8,0,40
624768,362695,2014-05-06,Assembly,"Do pass as amended",6,0,0,1,7
624768,365292,2014-05-19,Assembly,"AB 2093 GROVE  Assembly Third Reading",74,0,0,5,79
624768,372497,2014-06-17,Senate,"Do pass and be placed on the Consent Calendar",4,0,1,0,5
624768,374820,2014-06-26,Senate,"Consent Calendar 2nd AB2093 Grove",32,0,8,0,40
624769,360479,2014-04-28,Assembly,"Do pass and be re-referred to the Committee on Appropriations",9,0,0,0,9
624769,362984,2014-05-07,Assembly,"Do pass, to Consent Calendar",17,0,0,0,17
624769,364903,2014-05-15,Assembly,"AB 2009 WEBER  Consent Calendar Second Day  Regular Session",78,0,0,1,79
624769,370948,2014-06-11,Senate,"Do pass, but re-refer to the Committee on Appropriations Recommend 	Consent",7,0,0,0,7
624769,374938,2014-06-26,Senate,"Consent Calendar 2nd AB2009 Weber",32,0,8,0,40
624770,353252,2014-04-07,Assembly,"Do pass and be re-referred to the Committee on Appropriations",9,0,0,0,9
624770,367155,2014-05-23,Assembly,"Do pass",17,0,0,0,17
624770,367516,2014-05-27,Assembly,"AB 2048 DAHLE  Assembly Third Reading",77,0,0,2,79
624770,370461,2014-06-10,Senate,"Do pass, but re-refer to the Committee on Governance and Finance 	Recommend Consent",9,0,0,0,9
624770,374376,2014-06-25,Senate,"Do pass, but re-refer to the Committee on Appropriations Recommend 	Consent",6,0,1,0,7
624770,376400,2014-08-04,Senate,"Placed on Appropriations Suspense file",7,0,0,0,7
624770,377313,2014-08-14,Senate,"Do pass",5,0,2,0,7
624770,377752,2014-08-19,Senate,"Assembly 3rd Reading AB2048 Dahle By Gaines",33,0,7,0,40
624770,377962,2014-08-20,Assembly,"AB 2048 DAHLE  Concurrence in Senate Amendments",76,0,0,3,79
624773,354542,2014-04-02,Assembly,"Do pass as amended and be re-referred to the Committee on 	Appropriations",19,0,0,0,19
624773,367192,2014-05-23,Assembly,"Do pass",17,0,0,0,17
624773,367628,2014-05-27,Assembly,"AB 2058 WILK  Third Reading Urgency",77,0,0,2,79
624773,370520,2014-06-10,Senate,"Do pass, but re-refer to the Committee on Appropriations",8,0,2,0,10
624773,375286,2014-06-30,Senate,"Do pass",6,0,1,0,7
624773,377103,2014-08-13,Senate,"Assembly 3rd Reading AB2058 Wilk Urgency Clause",33,0,7,0,40
624773,377880,2014-08-20,Assembly,"AB 2058 WILK  Concurrence in Senate Amendments",78,0,0,1,79
624774,361566,2014-04-30,Senate,"Do pass as amended, and re-refer to the Committee on Appropriations",9,0,0,0,9
624774,365343,2014-05-19,Senate,"Placed on Appropriations Suspense file",7,0,0,0,7
624774,366745,2014-05-23,Senate,"Do pass",7,0,0,0,7
624774,368101,2014-05-28,Senate,"Senate 3rd Reading SB1196 Liu",36,0,4,0,40
624774,374342,2014-06-24,Assembly,"Do pass as amended and be re-referred to the Committee on 	Appropriations",12,0,0,1,13
624777,359496,2014-04-23,Assembly,"Do pass",9,0,0,0,9
624777,364867,2014-05-15,Assembly,"AB 2194 MULLIN  Assembly Third Reading",75,1,0,3,79
624777,371160,2014-06-11,Senate,"Do pass as amended",5,2,0,0,7
624778,350877,2014-04-02,Assembly,"Do pass and be re-referred to the Committee on Appropriations",9,3,0,1,13
624778,354341,2014-04-09,Assembly,"Do pass",12,5,0,0,17
624778,358167,2014-04-21,Assembly,"AB 2128 GORDON  Assembly Third Reading",55,22,0,2,79
624778,375058,2014-06-25,Senate,"Do pass as amended, and re-refer to the Committee on 	Appropriations",8,2,1,0,11
624778,376881,2014-08-11,Senate,"Do pass",5,2,0,0,7
624778,377047,2014-08-13,Senate,"Assembly 3rd Reading AB2128 Gordon By Correa",25,11,4,0,40
624778,377672,2014-08-18,Assembly,"AB 2128 GORDON  Concurrence in Senate Amendments",54,24,0,1,79
624779,348138,2014-03-26,Assembly,"Do pass as amended and be re-referred to the Committee on 	Appropriations",11,0,0,1,12
624779,363109,2014-05-07,Assembly,"Do pass",16,0,0,1,17
624779,367197,2014-05-23,Assembly,"AB 2138 GATTO  Assembly Third Reading",72,0,0,7,79
624779,370600,2014-06-10,Senate,"Do pass, but re-refer to the Committee on Appropriations",7,1,2,0,10
624779,373827,2014-06-23,Senate,"Placed on Appropriations Suspense file",7,0,0,0,7
624779,377548,2014-08-14,Senate,"Do pass",5,0,2,0,7
624779,377913,2014-08-20,Senate,"Assembly 3rd Reading AB2138 Gatto By Cannella",31,4,5,0,40
624782,361607,2014-04-30,Assembly,"Do pass and be re-referred to the Committee on Appropriations",7,0,0,0,7
624782,366735,2014-05-23,Assembly,"Do pass as amended",17,0,0,0,17
624782,368055,2014-05-28,Assembly,"AB 2216 MURATSUCHI  Assembly Third Reading",78,0,0,1,79
624782,374428,2014-06-25,Senate,"Do pass as amended, and re-refer to the Committee on Appropriations",6,0,1,0,7
624782,376481,2014-08-04,Senate,"Placed on Appropriations Suspense file",7,0,0,0,7
624783,361315,2014-04-30,Assembly,"Do pass as amended and be re-referred to the Committee on Local 	Government",7,0,0,0,7
624783,362930,2014-05-07,Assembly,"Do pass",8,0,0,1,9
624783,366869,2014-05-23,Assembly,"AB 2222 NAZARIAN  Assembly Third Reading",72,0,0,7,79
624783,374012,2014-06-24,Senate,"Do pass as amended",11,0,0,0,11
624783,378543,2014-08-26,Senate,"Assembly 3rd Reading AB2222 Nazarian By DeSaulnier",35,0,5,0,40
624783,378798,2014-08-27,Assembly,"AB 2222 NAZARIAN  Concurrence in Senate Amendments",78,0,0,1,79
624784,359354,2014-04-22,Senate,"Do pass, but re-refer to the Committee on Environmental Quality",10,0,1,0,11
624784,361086,2014-04-30,Senate,"Do pass, but re-refer to the Committee on Appropriations",7,0,0,0,7
624784,363844,2014-05-12,Senate,"Placed on Appropriations Suspense file",7,0,0,0,7
624784,367074,2014-05-23,Senate,"Do pass",7,0,0,0,7
624784,367477,2014-05-27,Senate,"Senate 3rd Reading SB1228 Hueso",35,1,4,0,40
624784,373703,2014-06-23,Assembly,"Do pass as amended and be re-referred to the Committee on 	Appropriations",12,0,0,4,16
624784,377490,2014-08-14,Assembly,"Do pass as amended",17,0,0,0,17
624784,378924,2014-08-28,Assembly,"SB 1228 Hueso  Senate Third Reading  By MEDINA",79,0,0,0,79
624784,379086,2014-08-29,Senate,"Unfinished Business SB1228 Hueso Concurrence",36,0,4,0,40
624785,359568,2014-04-24,Senate,"Do pass, but re-refer to the Committee on Appropriations",8,0,1,0,9
624785,362260,2014-05-05,Senate,"Placed on Appropriations Suspense file",7,0,0,0,7
624785,366909,2014-05-23,Senate,"Do pass as amended",7,0,0,0,7
624785,367999,2014-05-28,Senate,"Senate 3rd Reading SB1165 Mitchell",37,0,3,0,40
624785,374823,2014-06-25,Assembly,"Do pass as amended and re-refer to Committee on Appropriations 	with recommendation:  To Consent Calendar",7,0,0,0,7
624785,377361,2014-08-14,Assembly,"Do pass",16,0,0,1,17
624785,377853,2014-08-19,Assembly,"SB 1165 Mitchell  Senate Third Reading  By SKINNER",78,0,0,1,79
624785,377986,2014-08-20,Senate,"Unfinished Business SB1165 Mitchell Concurrence",35,0,5,0,40
624786,348112,2014-03-26,Senate,"Do pass, but re-refer to the Committee on Appropriations",4,0,1,0,5
624786,359523,2014-04-24,Senate,"Special Consent #12 SB1141 Hancock",37,0,3,0,40
624786,374287,2014-06-25,Assembly,"Do pass and re-refer to Committee on Appropriations with 	recommendation:  To Consent Calendar",13,0,0,0,13
624786,375573,2014-07-02,Assembly,"Do pass, to Consent Calendar",17,0,0,0,17
624786,378655,2014-08-27,Assembly,"SB 1141 Hancock  Senate Third Reading  By CALDERON",78,0,0,1,79
624786,378865,2014-08-28,Senate,"Unfinished Business SB1141 Hancock Concurrence",36,0,4,0,40
624787,359578,2014-04-23,Assembly,"Do pass and be re-referred to the Committee on Appropriations",7,0,0,0,7
624787,362950,2014-05-07,Assembly,"Do pass",14,3,0,0,17
624787,364902,2014-05-15,Assembly,"AB 2053 GONZALEZ  Assembly Third Reading",58,18,0,3,79
624787,374452,2014-06-25,Senate,"Do pass, but re-refer to the Committee on Appropriations",5,0,0,0,5
624787,377058,2014-08-13,Senate,"Assembly 3rd Reading AB2053 Gonzalez By Block",25,8,7,0,40
624789,360466,2014-04-29,Assembly,"Do pass and be re-referred to the Committee on Appropriations",11,2,0,1,14
624789,364774,2014-05-14,Assembly,"Do pass",13,4,0,0,17
624789,365402,2014-05-19,Assembly,"AB 2214 FOX  Assembly Third Reading",60,13,0,6,79
624789,374118,2014-06-23,Senate,"Do pass as amended, and re-refer to the Committee on 	Appropriations",7,1,1,0,9
624789,376863,2014-08-11,Senate,"Assembly 3rd Reading AB2214 Fox By Torres",30,6,4,0,40
624789,377666,2014-08-18,Assembly,"AB 2214 FOX  Concurrence in Senate Amendments",58,18,0,3,79
624793,359436,2014-04-22,Assembly,"Do pass and be re-referred to the Committee on Appropriations",10,0,0,3,13
624793,367024,2014-05-23,Assembly,"Do pass",13,0,0,4,17
624793,367989,2014-05-28,Assembly,"AB 2168 CAMPOS  Assembly Third Reading",67,6,0,6,79
624794,350976,2014-04-02,Senate,"Do pass and be placed on the Consent Calendar",7,0,0,0,7
624794,355170,2014-04-10,Senate,"Consent Calendar 2nd SB1232 Committee on GOV. & F. (Wolk)",34,0,6,0,40
624794,362981,2014-05-07,Assembly,"Do pass, to Consent Calendar",9,0,0,0,9
624794,376833,2014-08-07,Assembly,"SB 1232 GOV.& F.  Senate Third Reading  By ACHADJIAN",78,0,0,1,79
624795,360651,2014-04-29,Assembly,"Do pass and be re-referred to the Committee on Appropriations",10,4,0,1,15
624795,363141,2014-05-07,Assembly,"Do pass as amended",13,4,0,0,17
624795,368741,2014-05-29,Assembly,"AB 2081 DALY  Assembly Third Reading",61,18,0,0,79
624795,374229,2014-06-24,Senate,"Do pass, but re-refer to the Committee on Appropriations",8,1,0,0,9
624795,377003,2014-08-11,Senate,"Assembly 3rd Reading AB2081 Daly By Cannella",25,10,5,0,40
624795,377764,2014-08-19,Assembly,"AB 2081 DALY  Concurrence in Senate Amendments",60,15,0,4,79
624797,360736,2014-04-28,Assembly,"Do pass and be re-referred to the Committee on Appropriations",5,1,0,3,9
624797,367157,2014-05-23,Assembly,"Do pass as amended",12,4,0,1,17
624797,367994,2014-05-28,Assembly,"AB 2050 QUIRK  Assembly Third Reading",54,20,0,5,79
624797,374564,2014-06-25,Senate,"Do pass as amended, and re-refer to the Committee on 	Appropriations",5,1,1,0,7
624797,376617,2014-08-04,Senate,"Placed on Appropriations Suspense file",7,0,0,0,7
624799,363169,2014-05-07,Assembly,"Do pass",5,1,0,1,7
624799,364797,2014-05-15,Assembly,"AB 2074 HERNANDEZ  Assembly Third Reading",56,21,0,2,79
624799,371143,2014-06-11,Senate,"Do pass, but re-refer to the Committee on Judiciary",4,1,0,0,5
624799,374645,2014-06-24,Senate,"Do pass",5,2,0,0,7
624799,376392,2014-08-04,Senate,"Assembly 3rd Reading AB2074 Roger Hern",25,10,5,0,40
624800,358471,2014-04-22,Assembly,"Do pass and be re-referred to the Committee on Judiciary",5,2,0,0,7
624800,360555,2014-04-29,Assembly,"Do pass as amended and be re-referred to the Committee on 	Appropriations",8,2,0,0,10
624800,367001,2014-05-23,Assembly,"Do pass as amended",12,0,0,5,17
624800,368145,2014-05-28,Assembly,"AB 2171 WIECKOWSKI  Assembly Third Reading",42,23,0,14,79
624800,374450,2014-06-24,Senate,"Do pass, but re-refer to the Committee on Appropriations",5,2,0,0,7
624800,376567,2014-08-04,Senate,"Placed on Appropriations Suspense file",7,0,0,0,7
624800,377570,2014-08-14,Senate,"Do pass as amended",5,0,2,0,7
624800,378453,2014-08-26,Senate,"Assembly 3rd Reading AB2171 Wieckowski By Block",34,0,6,0,40
624800,378665,2014-08-27,Assembly,"AB 2171 WIECKOWSKI  Concurrence in Senate Amendments",59,18,0,2,79
624802,359081,2014-04-22,Assembly,"Do pass and be re-referred to the Committee on Education",13,0,0,0,13
624802,361662,2014-04-30,Assembly,"Do pass and be re-referred to the Committee on Appropriations",7,0,0,0,7
624802,366925,2014-05-23,Assembly,"Do pass as amended",17,0,0,0,17
624802,368020,2014-05-28,Assembly,"AB 2160 TING  Assembly Third Reading",78,0,0,1,79
624802,374400,2014-06-25,Senate,"Do pass, but re-refer to the Committee on Appropriations",6,0,1,0,7
624802,376598,2014-08-04,Senate,"Placed on Appropriations Suspense file",7,0,0,0,7
624802,377579,2014-08-14,Senate,"Do pass as amended",5,0,2,0,7
624802,377829,2014-08-19,Senate,"Assembly 3rd Reading AB2160 Ting By Hill",31,2,7,0,40
624802,378044,2014-08-21,Assembly,"AB 2160 TING  Concurrence in Senate Amendments",79,0,0,0,79
624803,353469,2014-04-08,Assembly,"Do pass and re-refer to Committee on Appropriations with 	recommendation:  To Consent Calendar",14,0,0,0,14
624803,361267,2014-04-30,Assembly,"Do pass, to Consent Calendar",17,0,0,0,17
624803,363425,2014-05-08,Assembly,"AB 2213 EGGMAN  Consent Calendar Second Day  Regular Session",73,0,0,6,79
624803,373986,2014-06-23,Senate,"Do pass, but re-refer to the Committee on Appropriations",8,0,1,0,9
624803,377618,2014-08-18,Senate,"Assembly 3rd Reading AB2213 Eggman By Block",36,0,4,0,40
624803,377813,2014-08-19,Assembly,"AB 2213 EGGMAN  Concurrence in Senate Amendments",78,0,0,1,79
624804,354145,2014-04-09,Assembly,"Do pass and be re-referred to the Committee on Appropriations to 	Consent Calendar",9,0,0,0,9
624804,361496,2014-04-30,Assembly,"Do pass, to Consent Calendar",17,0,0,0,17
624804,363508,2014-05-08,Assembly,"AB 2215 MAIENSCHEIN  Consent Calendar Second Day  Regular Session",73,0,0,6,79
624804,372741,2014-06-17,Senate,"Do pass as amended, but re-refer to the Committee on 	Appropriations Recommend Consent",6,0,1,0,7
624804,376539,2014-08-04,Senate,"Do pass",7,0,0,0,7
624804,377682,2014-08-18,Senate,"Assembly 3rd Reading AB2215 Maienschein By Jackson",36,0,4,0,40
624804,377804,2014-08-19,Assembly,"AB 2215 MAIENSCHEIN  Concurrence in Senate Amendments",78,0,0,1,79
624805,358880,2014-04-22,Assembly,"Do pass as amended and be re-referred to the Committee on 	Appropriations",19,0,0,0,19
624805,363146,2014-05-07,Assembly,"Do pass, to Consent Calendar",17,0,0,0,17
624805,364832,2014-05-15,Assembly,"AB 2051 GONZALEZ  Consent Calendar Second Day  Regular Session",78,0,0,1,79
624805,375038,2014-06-25,Senate,"Do pass, but re-refer to the Committee on Appropriations",6,2,1,0,9
624805,377846,2014-08-19,Senate,"Assembly 3rd Reading AB2051 Gonzalez By Beall",26,8,6,0,40
624805,378155,2014-08-21,Assembly,"AB 2051 GONZALEZ  Concurrence in Senate Amendments",74,0,0,5,79
624806,350586,2014-04-01,Senate,"Be adopted, but re-refer to the Committee on Appropriations 	Recommend Consent",11,0,0,0,11
624806,361693,2014-05-01,Senate,"Consent Calendar 2nd SCR85 Correa",35,0,5,0,40
624806,370185,2014-06-09,Assembly,"Be adopted, and re-refer to Committee on Appropriations with 	recommendation:  To Consent Calendar",16,0,0,0,16
624806,372778,2014-06-18,Assembly,"Be adopted, to Consent Calendar",15,0,0,2,17
624806,373748,2014-06-23,Assembly,"SCR 85 Correa  Consent Calendar Second Day  Regular Session",75,0,0,4,79
624806,375689,2014-07-03,Senate,"Special Consent #18 SCR85 Correa",35,0,5,0,40
624807,360179,2014-04-28,Senate,"Do pass, but re-refer to the Committee on Appropriations",9,0,0,0,9
624807,363747,2014-05-12,Senate,"Placed on Appropriations Suspense file",7,0,0,0,7
624807,366854,2014-05-23,Senate,"Do pass",7,0,0,0,7
624807,367568,2014-05-27,Senate,"Senate 3rd Reading SB1244 Lieu",36,0,4,0,40
624807,370539,2014-06-10,Assembly,"Do pass and be re-referred to the Committee on Environmental Safety 	and Toxic Materials",11,0,0,3,14
624807,372343,2014-06-17,Assembly,"Do pass and be re-referred to the Committee on Appropriations",6,0,0,1,7
624807,377433,2014-08-14,Assembly,"Do pass",17,0,0,0,17
624807,378843,2014-08-28,Assembly,"SB 1244 Lieu  Senate Third Reading  By BONILLA",78,0,0,1,79
624807,379079,2014-08-29,Senate,"Unfinished Business SB1244 Lieu Concurrence",37,0,3,0,40
624808,347645,2014-03-25,Assembly,"Do pass and be re-referred to the Committee on Appropriations",6,0,0,0,6
624808,354789,2014-04-09,Assembly,"Do pass, to Consent Calendar",17,0,0,0,17
624808,359593,2014-04-24,Assembly,"AB 2049 DAHLE  Consent Calendar Second Day  Regular Session",75,0,0,4,79
624809,361480,2014-04-30,Assembly,"Do pass and be re-referred to the Committee on Appropriations",13,0,0,0,13
624809,367069,2014-05-23,Assembly,"Do pass",17,0,0,0,17
624809,367470,2014-05-27,Assembly,"AB 2221 CAMPOS  Assembly Third Reading",77,0,0,2,79
624809,374158,2014-06-24,Senate,"Do pass, but re-refer to the Committee on Appropriations",9,0,1,0,10
624809,376519,2014-08-04,Senate,"Do pass as amended",7,0,0,0,7
624809,377110,2014-08-13,Senate,"Assembly 3rd Reading AB2221 Campos By Berryhill",36,0,4,0,40
624809,377653,2014-08-18,Assembly,"AB 2221 CAMPOS  Concurrence in Senate Amendments",78,0,0,1,79
624812,350410,2014-04-01,Assembly,"Do pass, to Consent Calendar",7,0,0,0,7
624812,355062,2014-04-10,Assembly,"AB 2199 MURATSUCHI  Consent Calendar Second Day  Regular Session",74,0,0,5,79
624812,364087,2014-05-13,Senate,"Do pass",6,0,1,0,7
624812,376971,2014-08-11,Senate,"Assembly 3rd Reading AB2199 Muratsuchi By Block",36,0,4,0,40
624813,361542,2014-04-30,Senate,"Do pass, but re-refer to the Committee on Appropriations",8,0,1,0,9
624813,363749,2014-05-12,Senate,"Placed on Appropriations Suspense file",7,0,0,0,7
624813,366668,2014-05-23,Senate,"Do pass",7,0,0,0,7
624813,367528,2014-05-27,Senate,"Senate 3rd Reading SB1174 Lara",27,8,5,0,40
624813,374950,2014-06-25,Assembly,"Do pass and be re-referred to the Committee on Appropriations",5,2,0,0,7
624813,377294,2014-08-14,Assembly,"Do pass as amended",12,5,0,0,17
624813,378374,2014-08-25,Assembly,"SB 1174 Lara  Senate Third Reading  By BONILLA  Motion to  Suspend 	the Rules  By HAGMAN",24,50,0,5,79
624813,378375,2014-08-25,Assembly,"SB 1174 Lara  Senate Third Reading  By BONILLA",53,26,0,0,79
624813,378524,2014-08-26,Senate,"Unfinished Supp 1 SB1174 Lara Concurrence",25,10,5,0,40
624814,361338,2014-04-29,Assembly,"Do pass",7,0,0,0,7
624814,362314,2014-05-05,Assembly,"AB 2187 COOLEY  Assembly Third Reading",76,0,0,3,79
624814,370583,2014-06-10,Senate,"Do pass and be placed on the Consent Calendar",4,0,1,0,5
624814,371815,2014-06-16,Senate,"Consent Calendar 2nd AB2187 Cooley",35,0,5,0,40
624816,354293,2014-04-09,Senate,"Do pass",8,0,1,0,9
624816,360170,2014-04-28,Senate,"Senate 3rd Reading SB1181 Correa",34,0,6,0,40
624816,370714,2014-06-09,Assembly,"Do pass",12,0,0,0,12
624816,373716,2014-06-23,Assembly,"SB 1181 Correa  Senate Third Reading  By HARKEY",75,0,0,4,79
624817,353292,2014-04-08,Senate,"Do pass as amended, and re-refer to the Committee on Appropriations",5,0,0,0,5
624817,361560,2014-05-01,Senate,"Senate 3rd Reading SB1153 Leno",36,0,4,0,40
624817,372183,2014-06-17,Assembly,"Do pass and be re-referred to the Committee on Aging and Long",6,0,0,1,7
624817,374344,2014-06-24,Assembly,"Do pass and re-refer to Committee on Appropriations with 	recommendation:  To Consent Calendar",6,0,0,1,7
624817,377345,2014-08-14,Assembly,"Do pass",17,0,0,0,17
624817,377817,2014-08-19,Assembly,"SB 1153 Leno  Senate Third Reading  By MAIENSCHEIN",76,0,0,3,79
624818,348204,2014-03-26,Assembly,"Do pass and be re-referred to the Committee on Appropriations",11,0,0,1,12
624819,348073,2014-03-26,Assembly,"Do pass and be re-referred to the Committee on Appropriations",5,1,0,1,7
624823,354268,2014-04-09,Assembly,"Do pass and be re-referred to the Committee on Appropriations",13,0,0,0,13
624823,361173,2014-04-30,Assembly,"Do pass, to Consent Calendar",17,0,0,0,17
624823,363345,2014-05-08,Assembly,"AB 2174A& A.R.  Consent Calendar Second Day  Regular Session",73,0,0,6,79
624823,370478,2014-06-10,Senate,"Do pass, but re-refer to the Committee on Appropriations",8,0,2,0,10
624823,377284,2014-08-14,Senate,"Assembly 3rd Reading AB2174 Committee on ACC. & ADM. REV. (Fr By 	Hernandez",33,0,7,0,40
624823,377654,2014-08-18,Assembly,"AB 2174A& A.R.  Concurrence in Senate Amendments By FRAZIER",78,0,0,1,79
624824,353446,2014-04-08,Assembly,"Do pass as amended and be re-referred to the Committee on 	Appropriations",6,3,0,1,10
624824,366784,2014-05-23,Assembly,"Do pass as amended",12,5,0,0,17
624824,368167,2014-05-28,Assembly,"AB 2042 LEVINE  Assembly Third Reading",62,13,0,4,79
624824,374693,2014-06-25,Senate,"Do pass, but re-refer to the Committee on Transportation and 	Housing",4,2,1,0,7
624825,360031,2014-04-28,Assembly,"Be referred to Committee on Natural Resources",9,0,0,2,11
624825,361590,2014-05-01,Assembly,"Do pass as amended and be re-referred to the Committee on 	Appropriations",9,0,0,0,9
624825,367127,2014-05-23,Assembly,"Do pass as amended",12,0,0,5,17
624825,368079,2014-05-28,Assembly,"AB 2227 QUIRK  Assembly Third Reading",77,0,0,2,79
624825,374189,2014-06-23,Senate,"Do pass as amended, and re-refer to the Committee on Appropriations",10,0,1,0,11
624825,376956,2014-08-11,Senate,"Assembly 3rd Reading AB2227 Quirk By Hill",35,0,5,0,40
624825,377679,2014-08-18,Assembly,"AB 2227 QUIRK  Concurrence in Senate Amendments",76,0,0,3,79
624826,358421,2014-04-22,Assembly,"Do pass and be re-referred to the Committee on Appropriations",6,0,0,1,7
624826,367064,2014-05-23,Assembly,"Do pass as amended",17,0,0,0,17
624826,368032,2014-05-28,Assembly,"AB 2190 MAIENSCHEIN  Assembly Third Reading",78,0,0,1,79
624826,373141,2014-06-18,Senate,"Do pass, but re-refer to the Committee on Public Safety",8,0,1,0,9
624826,374548,2014-06-24,Senate,"Do pass, but re-refer to the Committee on Appropriations",7,0,0,0,7
624826,376454,2014-08-04,Senate,"Placed on Appropriations Suspense file",7,0,0,0,7
624826,377262,2014-08-14,Senate,"Do pass",5,0,2,0,7
624826,378804,2014-08-27,Senate,"Special Consent #19 AB2190 Maienschein By Hernandez",32,2,6,0,40
624826,378967,2014-08-28,Assembly,"AB 2190 MAIENSCHEIN  Concurrence in Senate Amendments",79,0,0,0,79
624827,358650,2014-04-22,Assembly,"Do pass",5,2,0,0,7
624827,368237,2014-05-28,Assembly,"AB 2124 LOWENTHAL  Assembly Third Reading",48,25,0,6,79
624827,374374,2014-06-24,Senate,"Do pass",5,2,0,0,7
624827,378859,2014-08-28,Senate,"Assembly 3rd Reading AB2124 Lowenthal By Mitchell",23,13,4,0,40
624827,379106,2014-08-29,Assembly,"AB 2124 LOWENTHAL  Concurrence in Senate Amendments",46,31,0,2,79
624828,361598,2014-04-30,Assembly,"Do pass and be re-referred to the Committee on Appropriations",2,5,0,0,7
624829,354564,2014-04-02,Assembly,"Do pass and re-refer to Committee on Appropriations with 	recommendation:  To Consent Calendar",19,0,0,0,19
624829,354565,2014-04-09,Assembly,"Do pass, to Consent Calendar",17,0,0,0,17
624829,359737,2014-04-24,Assembly,"AB 2203 CHESBRO  Consent Calendar Second Day  Regular Session",75,0,0,4,79
624829,374152,2014-06-24,Senate,"Do pass, but re-refer to the Committee on Appropriations Recommend 	Consent",10,0,0,0,10
624829,376813,2014-08-07,Senate,"Consent Calendar 2nd AB2203 Chesbro By Padilla",34,0,6,0,40
624830,358697,2014-04-22,Senate,"Do pass as amended, and re-refer to the Committee on Appropriations",4,0,1,0,5
624830,362231,2014-05-05,Senate,"Placed on Appropriations Suspense file",7,0,0,0,7
624830,366696,2014-05-23,Senate,"Do pass as amended",7,0,0,0,7
624830,368696,2014-05-29,Senate,"Senate 3rd Reading SB1160 Beall",37,0,3,0,40
624830,372170,2014-06-17,Assembly,"Do pass as amended and be re-referred to the Committee on 	Appropriations",7,0,0,0,7
624832,354533,2014-04-08,Assembly,"Do pass as amended and be re-referred to the Committee on 	Governmental Organization",5,0,0,2,7
624832,361177,2014-04-30,Assembly,"Do pass and be re-referred to the Committee on Appropriations",4,7,0,8,19
624834,358624,2014-04-22,Assembly,"Do pass and be re-referred to the Committee on Appropriations",13,6,0,0,19
624835,353314,2014-04-08,Senate,"Do pass, but re-refer to the Committee on Appropriations",5,0,0,0,5
624835,360084,2014-04-28,Senate,"Placed on Appropriations Suspense file",6,0,1,0,7
624836,355220,2014-04-09,Assembly,"Do pass as amended and be re-referred to the Committee on 	Appropriations",7,0,0,0,7
624836,367188,2014-05-23,Assembly,"Do pass",17,0,0,0,17
624836,368191,2014-05-28,Assembly,"AB 2110 TING  Assembly Third Reading",77,0,0,2,79
624836,374549,2014-06-25,Senate,"Do pass as amended, but re-refer to the Committee on Appropriations 	Recommend Consent",6,0,1,0,7
624836,376602,2014-08-04,Senate,"Placed on Appropriations Suspense file",7,0,0,0,7
624837,350916,2014-04-02,Assembly,"Do pass, to Consent Calendar",9,0,0,0,9
624837,355139,2014-04-10,Assembly,"AB 2156 ACHADJIAN  Consent Calendar Second Day  Regular Session",74,0,0,5,79
624837,364777,2014-05-14,Senate,"Do pass and be placed on the Consent Calendar",6,0,1,0,7
624837,366873,2014-05-23,Senate,"Consent Calendar 2nd AB2156 Achadjian",32,0,8,0,40
624839,361347,2014-04-30,Senate,"Do pass as amended, and re-refer to the Committee on Appropriations",6,0,1,0,7
624839,365511,2014-05-19,Senate,"Placed on Appropriations Suspense file",7,0,0,0,7
624840,353422,2014-04-08,Assembly,"Do pass and re-refer to Committee on Appropriations with 	recommendation:  To Consent Calendar",14,0,0,0,14
624840,361397,2014-04-30,Assembly,"Do pass, to Consent Calendar",17,0,0,0,17
624840,363399,2014-05-08,Assembly,"AB 2131  Consent Calendar Second Day  Regular Session",73,0,0,6,79
624842,348182,2014-03-26,Senate,"Do pass, but re-refer to the Committee on Governance and Finance",3,0,2,0,5
624842,354307,2014-04-09,Senate,"Do pass, but re-refer to the Committee on Appropriations Recommend 	Consent",7,0,0,0,7
624842,361783,2014-05-01,Senate,"Consent Calendar 2nd SB1131 Walters",35,0,5,0,40
624842,370317,2014-06-09,Assembly,"Do pass and re-refer to Committee on Appropriations with 	recommendation:  To Consent Calendar",9,0,0,0,9
624842,372735,2014-06-18,Assembly,"Do pass, to Consent Calendar",15,0,0,2,17
624842,374952,2014-06-26,Assembly,"SB 1131 Walters  Consent Calendar Second Day  Regular Session",76,0,0,3,79
624843,348284,2014-03-26,Assembly,"Do pass as amended and be re-referred to the Committee on 	Appropriations",4,1,0,2,7
624843,367040,2014-05-23,Assembly,"Do pass as amended",12,0,0,5,17
624843,368029,2014-05-28,Assembly,"AB 2141 HALL  Assembly Third Reading",70,1,0,8,79
624843,372568,2014-06-18,Senate,"Do pass, but re-refer to the Committee on Public Safety",7,0,0,0,7
624843,374319,2014-06-24,Senate,"Do pass as amended, and re-refer to the Committee on Appropriations",7,0,0,0,7
624843,376650,2014-08-04,Senate,"Placed on Appropriations Suspense file",7,0,0,0,7
624843,377479,2014-08-14,Senate,"Do pass as amended",5,0,2,0,7
624843,378338,2014-08-25,Senate,"Assembly 3rd Reading AB2141 Hall By Monning",33,0,7,0,40
624843,378558,2014-08-26,Assembly,"AB 2141 HALL  Concurrence in Senate Amendments",79,0,0,0,79
624844,347578,2014-03-25,Assembly,"Do pass as amended and be re-referred to the Committee on 	Appropriations",10,0,0,0,10
624844,367171,2014-05-23,Assembly,"Do pass as amended",17,0,0,0,17
624844,368185,2014-05-28,Assembly,"AB 2034 GATTO  Assembly Third Reading",78,0,0,1,79
624844,374555,2014-06-24,Senate,"Do pass as amended, and re-refer to the Committee on 	Appropriations",7,0,0,0,7
624844,376608,2014-08-04,Senate,"Placed on Appropriations Suspense file",7,0,0,0,7
624844,377516,2014-08-14,Senate,"Do pass as amended",5,0,2,0,7
624845,359545,2014-04-24,Assembly,"From committee:  Be adopted.  To third reading",8,0,0,3,11
624845,367095,2014-05-23,Senate,"Special Consent #15 ACR104 Rodriguez",32,0,8,0,40
624847,364420,2014-05-13,Assembly,"Do pass as amended and be re-referred to the Committee on 	Appropriations",9,0,0,0,9
624847,366780,2014-05-23,Assembly,"Do pass",17,0,0,0,17
624847,367457,2014-05-27,Assembly,"AB 1999 ATKINS  Assembly Third Reading",75,0,0,4,79
624847,374436,2014-06-25,Senate,"Do pass as amended, and re-refer to the Committee on Appropriations",7,0,0,0,7
624847,376949,2014-08-11,Senate,"Placed on Appropriations Suspense file",7,0,0,0,7
624847,377396,2014-08-14,Senate,"Do pass as amended",6,0,1,0,7
624847,378528,2014-08-26,Senate,"Assembly 3rd Reading AB1999 Atkins By DeSaulnier",36,0,4,0,40
624847,378754,2014-08-27,Assembly,"AB 1999 ATKINS  Concurrence in Senate Amendments",78,0,0,1,79
624848,351000,2014-04-02,Senate,"Do pass, but re-refer to the Committee on Judiciary",6,0,1,0,7
624848,353399,2014-04-08,Senate,"Do pass as amended, and re-refer to the Committee on 	Appropriations",7,0,0,0,7
624848,361776,2014-05-01,Senate,"Senate 3rd Reading SB1130 Roth Urgency Clause",36,0,4,0,40
624848,370722,2014-06-10,Assembly,"Do pass and be re-referred to the Committee on Environmental Safety 	and Toxic Materials",9,0,0,1,10
624848,372140,2014-06-17,Assembly,"Do pass and be re-referred to the Committee on Appropriations",7,0,0,0,7
624848,375598,2014-07-02,Assembly,"Do pass, to Consent Calendar",17,0,0,0,17
624848,375678,2014-07-03,Assembly,"SB 1130 Roth  Third Reading Urgency  By MELENDEZ",77,0,0,2,79
624849,351245,2014-04-02,Assembly,"Do pass",9,0,0,0,9
624849,355050,2014-04-10,Assembly,"AB 2149 ATKINS  Assembly Third Reading",78,0,0,1,79
624849,364435,2014-05-14,Senate,"Do pass as amended",6,0,1,0,7
624849,370103,2014-06-05,Senate,"Special Consent #16 AB2149 Atkins",33,0,7,0,40
624849,370171,2014-06-09,Assembly,"AB 2149 ATKINS  Concurrence in Senate Amendments",77,0,0,2,79
624854,350244,2014-04-01,Senate,"Do pass, but re-refer to the Committee on Environmental Quality",11,0,0,0,11
624854,361054,2014-04-30,Senate,"Do pass as amended, and re-refer to the Committee on 	Appropriations",6,1,0,0,7
624854,365401,2014-05-19,Senate,"Placed on Appropriations Suspense file",7,0,0,0,7
624854,367081,2014-05-23,Senate,"Do pass",6,1,0,0,7
624854,367451,2014-05-27,Senate,"Senate 3rd Reading SB1204 Lara",26,10,4,0,40
624854,371864,2014-06-16,Assembly,"Do pass as amended and be re-referred to the Committee on 	Appropriations",12,2,0,2,16
624854,377280,2014-08-14,Assembly,"Do pass as amended",13,4,0,0,17
624854,378659,2014-08-27,Assembly,"SB 1204 Lara  Senate Third Reading  By BONTA",59,16,0,4,79
624854,378866,2014-08-28,Senate,"Unfinished Business SB1204 Lara Concurrence",26,9,5,0,40
624855,360473,2014-04-29,Senate,"Do pass, but re-refer to the Committee on Appropriations",6,0,1,0,7
624855,365308,2014-05-19,Senate,"Do pass as amended",7,0,0,0,7
624855,366972,2014-05-23,Senate,"Special Consent #15 SB1193 Evans",32,0,8,0,40
624855,374122,2014-06-24,Assembly,"Do pass and be re-referred to the Committee on Appropriations",5,1,0,1,7
624855,377285,2014-08-14,Assembly,"Do pass as amended",12,4,0,1,17
624856,358581,2014-04-21,Assembly,"Do pass and be re-referred to the Committee on Appropriations",9,3,0,4,16
624856,367153,2014-05-23,Assembly,"Do pass",16,0,0,1,17
624856,367526,2014-05-27,Assembly,"AB 2201 CHAVEZ  Assembly Third Reading",66,4,0,9,79
624856,373983,2014-06-24,Senate,"Do pass, but re-refer to the Committee on Appropriations",10,1,0,0,11
624856,376405,2014-08-04,Senate,"Placed on Appropriations Suspense file",7,0,0,0,7
624857,358609,2014-04-22,Senate,"Do pass as amended, and re-refer to the Committee on Appropriations",6,0,1,0,7
624857,365365,2014-05-19,Senate,"Do pass as amended",7,0,0,0,7
624857,366846,2014-05-23,Senate,"Senate 3rd Reading SB1197 Pavley",31,0,9,0,40
624857,372160,2014-06-17,Assembly,"Do pass",7,0,0,0,7
624857,378488,2014-08-26,Assembly,"SB 1197 Pavley  Senate Third Reading  By JONES-SAWYER",79,0,0,0,79
624857,378717,2014-08-27,Senate,"Unfinished Business SB1197 Pavley Concurrence",35,0,5,0,40
624858,359458,2014-04-23,Assembly,"Do pass as amended",13,0,0,0,13
624858,361615,2014-05-01,Assembly,"AB 2230 COOLEY  Assembly Third Reading",71,1,0,7,79
624858,370827,2014-06-11,Senate,"Do pass",10,0,1,0,11
624858,373102,2014-06-19,Senate,"Assembly 3rd Reading AB2230 Cooley By Roth",34,0,6,0,40
624859,360739,2014-04-28,Assembly,"Do pass and be re-referred to the Committee on Appropriations",5,3,0,1,9
624859,367208,2014-05-23,Assembly,"Do pass",12,5,0,0,17
624859,368131,2014-05-28,Assembly,"AB 1992 QUIRK  Assembly Third Reading",47,26,0,6,79
624859,372720,2014-06-18,Senate,"Do pass, but re-refer to the Committee on Transportation and 	Housing",5,2,0,0,7
624859,374829,2014-06-26,Senate,"Do pass as amended, and re-refer to the Committee on 	Appropriations",3,3,5,0,11
624859,374830,2014-06-26,Senate,"Set, second hearing.  Failed passage in Committee. 	Reconsideration granted",10,0,1,0,11
624860,359652,2014-04-24,Senate,"Do pass",5,0,2,0,7
624860,368081,2014-05-28,Senate,"Senate 3rd Reading SB1203 Jackson",33,0,7,0,40
624860,374760,2014-06-25,Assembly,"Do pass as amended",8,1,0,0,9
624860,378299,2014-08-25,Assembly,"SB 1203 Jackson  Senate Third Reading  By CHAU",75,0,0,4,79
624860,378470,2014-08-26,Senate,"Unfinished Supp 1 SB1203 Jackson Concurrence",34,1,5,0,40
624862,360697,2014-04-29,Assembly,"Do pass and be re-referred to the Committee on Insurance",10,0,0,4,14
624863,361420,2014-04-29,Assembly,"Do pass and be re-referred to the Committee on Appropriations",5,0,0,2,7
624863,366724,2014-05-23,Assembly,"Do pass as amended",12,0,0,5,17
624863,368770,2014-05-29,Assembly,"AB 2061 CHAU  Assembly Third Reading",64,6,0,9,79
624863,374612,2014-06-24,Senate,"Do pass as amended, and re-refer to the Committee on Appropriations",4,0,1,0,5
624864,360567,2014-04-29,Assembly,"Do pass and be re-referred to the Committee on Appropriations",14,0,0,0,14
624864,364639,2014-05-14,Assembly,"Do pass",16,0,0,1,17
624864,365341,2014-05-19,Assembly,"AB 2220 DALY  Assembly Third Reading",75,0,0,4,79
624864,371797,2014-06-16,Senate,"Do pass, but re-refer to the Committee on Rules",8,0,1,0,9
624864,374546,2014-06-24,Senate,"Do pass, but re-refer to the Committee on Appropriations",7,0,0,0,7
624864,376867,2014-08-11,Senate,"Placed on Appropriations Suspense file",7,0,0,0,7
624864,377379,2014-08-14,Senate,"Do pass as amended",5,0,2,0,7
624864,378347,2014-08-25,Senate,"Assembly 3rd Reading AB2220 Daly By Block",31,0,9,0,40
624864,378695,2014-08-27,Assembly,"AB 2220 DALY  Concurrence in Senate Amendments",77,0,0,2,79
624866,360682,2014-04-28,Assembly,"Do pass and be re-referred to the Committee on Appropriations",14,0,0,1,15
624866,366113,2014-05-21,Assembly,"Do pass, to Consent Calendar",17,0,0,0,17
624866,367524,2014-05-27,Assembly,"AB 2229 BRADFORD  Consent Calendar Second Day  Regular Session",77,0,0,2,79
624866,374162,2014-06-23,Senate,"Do pass, but re-refer to the Committee on Appropriations",3,6,2,0,11
624866,374163,2014-06-23,Senate,"Set, first hearing.  Failed passage in Committee.  Reconsideration 	granted",10,0,1,0,11
624867,361190,2014-04-30,Assembly,"Do pass and be re-referred to the Committee on Appropriations",13,0,0,0,13
624867,366937,2014-05-23,Assembly,"Do pass as amended",16,1,0,0,17
624867,368041,2014-05-28,Assembly,"AB 2200 PEREZ, J.  Assembly Third Reading",74,3,0,2,79
624867,374011,2014-06-24,Senate,"Do pass, but re-refer to the Committee on Appropriations",8,1,1,0,10
624867,376974,2014-08-11,Senate,"Placed on Appropriations Suspense file",7,0,0,0,7
624867,377397,2014-08-14,Senate,"Do pass",5,0,2,0,7
624867,379117,2014-08-30,Senate,"Assembly 3rd Supp 7 AB2200 John A. P",24,11,5,0,40
624869,359402,2014-04-22,Assembly,"Do pass as amended and be re-referred to the Committee on 	Appropriations",13,0,0,0,13
624869,363101,2014-05-07,Assembly,"Do pass",17,0,0,0,17
624869,364982,2014-05-15,Assembly,"AB 2087 AMMIANO  Assembly Third Reading",78,0,0,1,79
624869,371162,2014-06-11,Senate,"Do pass as amended, and re-refer to the Committee on Appropriations",7,0,0,0,7
624869,377713,2014-08-18,Senate,"Assembly 3rd Reading AB2087 Ammiano By Nielsen",34,0,6,0,40
624869,377843,2014-08-19,Assembly,"AB 2087 AMMIANO  Concurrence in Senate Amendments",78,0,0,1,79
624873,351069,2014-04-02,Senate,"Do pass, but re-refer to the Committee on Appropriations",9,0,0,0,9
624873,362191,2014-05-05,Senate,"Placed on Appropriations Suspense file",7,0,0,0,7
624874,351118,2014-04-02,Assembly,"Do pass",7,2,0,0,9
624874,360123,2014-04-28,Assembly,"AB 2170 MULLIN  Assembly Third Reading",44,26,0,9,79
624874,370910,2014-06-11,Senate,"Do pass as amended",5,2,0,0,7
624874,376976,2014-08-11,Senate,"Assembly 3rd Reading AB2170 Mullin By Beall",21,15,4,0,40
624874,377439,2014-08-14,Assembly,"AB 2170 MULLIN  Concurrence in Senate Amendments",48,29,0,2,79
624875,359745,2014-04-23,Assembly,"Do pass and be re-referred to the Committee on Judiciary",6,1,0,0,7
624875,362632,2014-05-06,Assembly,"Do pass",3,4,0,3,10
624876,359141,2014-04-23,Assembly,"Do pass and be re-referred to the Committee on Appropriations",6,0,0,1,7
624876,367051,2014-05-23,Assembly,"Do pass as amended",13,0,0,4,17
624876,368709,2014-05-29,Assembly,"AB 1993 FOX  Assembly Third Reading",57,19,0,3,79
624876,370959,2014-06-11,Senate,"Do pass, but re-refer to the Committee on Appropriations",7,0,0,0,7
624876,375301,2014-06-30,Senate,"Placed on Appropriations Suspense file",6,0,1,0,7
624876,377172,2014-08-14,Senate,"Do pass",5,0,2,0,7
624876,378129,2014-08-21,Senate,"Assembly 3rd Reading AB1993 Fox By Block",31,5,4,0,40
624878,362636,2014-05-06,Assembly,"Do pass",4,1,0,2,7
624878,364933,2014-05-15,Assembly,"AB 2028 MULLIN  Assembly Third Reading",51,23,0,5,79
624878,372292,2014-06-17,Senate,"Do pass",4,0,1,0,5
624878,376391,2014-08-04,Senate,"Assembly 3rd Reading AB2028 Mullin By Hill",25,10,5,0,40
624879,355104,2014-04-09,Assembly,"Do pass as amended and be re-referred to the Committee on 	Appropriations",6,0,0,1,7
624879,364409,2014-05-14,Assembly,"Do pass as amended, to Consent Calendar",17,0,0,0,17
624879,367529,2014-05-27,Assembly,"AB 1990 GORDON  Assembly Third Reading",73,1,0,5,79
624879,374949,2014-06-25,Senate,"Do pass as amended, and re-refer to the Committee on 	Appropriations",7,1,1,0,9
624879,378027,2014-08-21,Senate,"Assembly 3rd Reading AB1990 Gordon By Evans",26,8,6,0,40
624879,378434,2014-08-25,Assembly,"AB 1990 GORDON  Concurrence in Senate Amendments",59,17,0,3,79
624880,361697,2014-04-30,Assembly,"Do pass and be re-referred to the Committee on Appropriations",5,1,0,3,9
624882,363164,2014-05-07,Assembly,"Do pass",17,1,0,1,19
624882,364846,2014-05-15,Assembly,"AB 1989 CHESBRO  Assembly Third Reading",73,2,0,4,79
624882,374160,2014-06-24,Senate,"Do pass",10,0,0,0,10
624882,375302,2014-06-30,Senate,"Assembly 3rd Reading AB1989 Chesbro By Berryhill",36,0,4,0,40
624883,353485,2014-04-08,Senate,"Do pass, but re-refer to the Committee on Appropriations",6,0,1,0,7
624883,360047,2014-04-28,Senate,"Placed on Appropriations Suspense file",6,0,1,0,7
624883,366803,2014-05-23,Senate,"Do pass as amended",6,1,0,0,7
624883,368103,2014-05-28,Senate,"Senate 3rd Reading SB1227 Hancock",29,5,6,0,40
624883,372384,2014-06-17,Assembly,"Do pass and be re-referred to the Committee on Appropriations",5,2,0,0,7
624883,376713,2014-08-06,Assembly,"Do pass",12,4,0,1,17
624883,378179,2014-08-21,Assembly,"SB 1227 Hancock  Senate Third Reading  By AMMIANO",62,15,0,2,79
624883,378806,2014-08-27,Senate,"Unfinished Business SB1227 Hancock Concurrence",36,0,4,0,40
624884,361673,2014-04-30,Senate,"Do pass as amended, and re-refer to the Committee on Appropriations",8,0,1,0,9
624884,365558,2014-05-19,Senate,"Placed on Appropriations Suspense file",7,0,0,0,7
624885,361191,2014-04-30,Assembly,"Do pass and be re-referred to the Committee on Appropriations",18,0,0,1,19
624885,364745,2014-05-14,Assembly,"Do pass",16,1,0,0,17
624885,365379,2014-05-19,Assembly,"AB 2005 CHESBRO  Assembly Third Reading",69,5,0,5,79
624885,374172,2014-06-24,Senate,"Do pass, but re-refer to the Committee on Appropriations",7,3,0,0,10
624885,377765,2014-08-19,Senate,"Assembly 3rd Reading AB2005 Chesbro By Evans",21,12,7,0,40
624885,378140,2014-08-21,Assembly,"AB 2005 CHESBRO  Concurrence in Senate Amendments",68,5,0,6,79
624886,361143,2014-04-29,Senate,"Do pass, but re-refer to the Committee on Appropriations",6,4,1,0,11
624886,363711,2014-05-12,Senate,"Placed on Appropriations Suspense file",7,0,0,0,7
624886,366772,2014-05-23,Senate,"Do pass as amended",5,2,0,0,7
624886,368152,2014-05-28,Senate,"Senate 3rd Reading SB1183 DeSaulnier",26,9,5,0,40
624886,372553,2014-06-18,Assembly,"Do pass and be re-referred to the Committee on Transportation",7,0,0,2,9
624886,373711,2014-06-23,Assembly,"Do pass as amended and be re-referred to the Committee on 	Appropriations",10,4,0,2,16
624886,377365,2014-08-14,Assembly,"Do pass",12,5,0,0,17
624886,377876,2014-08-20,Assembly,"SB 1183 DeSaulnier  Senate Third Reading  By TING",46,29,0,4,79
624886,378066,2014-08-21,Senate,"Unfinished Business SB1183 DeSaulnier Concurrence",24,9,7,0,40
624887,350255,2014-04-01,Assembly,"Do pass and be re-referred to the Committee on Appropriations",18,1,0,0,19
624888,359424,2014-04-22,Assembly,"Do pass as amended and be re-referred to the Committee on 	Appropriations",10,1,0,2,13
624888,367172,2014-05-23,Assembly,"Do pass as amended",13,4,0,0,17
624888,368271,2014-05-28,Assembly,"AB 2000 GOMEZ  Assembly Third Reading",68,2,0,9,79
624888,370875,2014-06-11,Senate,"Do pass as amended, and re-refer to the Committee on Appropriations",7,0,0,0,7
624888,375419,2014-06-30,Senate,"Placed on Appropriations Suspense file",6,0,1,0,7
624888,377518,2014-08-14,Senate,"Do pass",5,0,2,0,7
624888,378053,2014-08-21,Senate,"Assembly 3rd Reading AB2000 Gomez Lay on Table",20,7,13,0,40
624888,378054,2014-08-21,Senate,"Assembly 3rd Reading AB2000 Gomez By Lara",27,6,7,0,40
624888,378282,2014-08-25,Assembly,"AB 2000 GOMEZ  Concurrence in Senate Amendments",70,3,0,6,79
624889,362959,2014-05-07,Assembly,"Do pass",17,0,0,2,19
624889,364840,2014-05-15,Assembly,"AB 2066 HALL  Assembly Third Reading",73,0,0,6,79
624889,374255,2014-06-24,Senate,"Do pass and be placed on the Consent Calendar",10,0,0,0,10
624890,355102,2014-04-09,Assembly,"Do pass and be re-referred to the Committee on Judiciary to Consent 	Calendar",7,0,0,0,7
624890,360476,2014-04-29,Assembly,"Do pass as amended and be re-referred to the Committee on 	Appropriations",10,0,0,0,10
624890,366681,2014-05-23,Assembly,"Do pass",17,0,0,0,17
624890,367469,2014-05-27,Assembly,"AB 2217 MELENDEZ  Assembly Third Reading",77,0,0,2,79
624890,372536,2014-06-18,Senate,"Do pass, but re-refer to the Committee on Judiciary Recommend 	Consent",7,0,0,0,7
624890,374521,2014-06-24,Senate,"Do pass as amended, and re-refer to the Committee on 	Appropriations",7,0,0,0,7
624890,376560,2014-08-04,Senate,"Placed on Appropriations Suspense file",7,0,0,0,7
624890,377149,2014-08-14,Senate,"Do pass as amended",5,0,2,0,7
624890,378196,2014-08-22,Senate,"Assembly 3rd Reading AB2217 Melendez By Jackson",33,0,7,0,40
624890,378540,2014-08-26,Assembly,"AB 2217 MELENDEZ  Concurrence in Senate Amendments",78,0,0,1,79
624892,361734,2014-04-30,Senate,"Do pass, but re-refer to the Committee on Appropriations",6,1,2,0,9
624892,361735,2014-04-30,Senate,"Do pass, but re-refer to the Committee on Health",6,1,2,0,9
624892,363792,2014-05-12,Senate,"Placed on Appropriations Suspense file",7,0,0,0,7
624893,348292,2014-03-26,Assembly,"Do pass as amended and be re-referred to the Committee on 	Appropriations",4,1,0,2,7
624893,354152,2014-04-09,Assembly,"Do pass",12,4,0,1,17
624893,362349,2014-05-05,Assembly,"AB 2057 BONILLA  Third Reading Urgency",57,9,0,13,79
624893,372542,2014-06-18,Senate,"Do pass as amended, and re-refer to the Committee on Appropriations",5,2,0,0,7
624893,377002,2014-08-11,Senate,"Placed on Appropriations Suspense file",7,0,0,0,7
624893,377503,2014-08-14,Senate,"Do pass as amended",5,1,1,0,7
624894,363192,2014-05-06,Senate,"Do pass",7,0,0,0,7
624894,363705,2014-05-12,Senate,"Senate 3rd Reading SB1171 Hueso",29,1,10,0,40
624894,372186,2014-06-17,Assembly,"Do pass as amended",9,0,0,1,10
624894,375713,2014-07-03,Assembly,"SB 1171 Hueso  Senate Third Reading  By MAIENSCHEIN",62,8,0,9,79
624894,376358,2014-08-04,Senate,"Unfinished Business SB1171 Hueso Concurrence",36,0,4,0,40
624895,354394,2014-04-08,Assembly,"Do pass and be re-referred to the Committee on Insurance",13,6,0,0,19
624895,366883,2014-05-23,Assembly,"Do pass",12,5,0,0,17
624895,368190,2014-05-28,Assembly,"AB 2088 HERNANDEZ  Assembly Third Reading",50,25,0,4,79
624895,374864,2014-06-25,Senate,"Do pass as amended, and re-refer to the Committee on 	Appropriations",6,2,1,0,9
624895,376566,2014-08-04,Senate,"Placed on Appropriations Suspense file",7,0,0,0,7
624895,377420,2014-08-14,Senate,"Do pass as amended",5,0,2,0,7
624895,378643,2014-08-27,Senate,"Assembly 3rd Reading AB2088 Roger Hern",22,12,6,0,40
624895,378957,2014-08-28,Assembly,"AB 2088 HERNANDEZ  Concurrence in Senate Amendments",54,25,0,0,79
624903,360467,2014-04-29,Assembly,"Do pass as amended and be re-referred to the Committee on 	Appropriations",10,0,0,0,10
624906,361611,2014-04-30,Senate,"Do pass, but re-refer to the Committee on Appropriations",9,0,0,0,9
624906,363739,2014-05-12,Senate,"Placed on Appropriations Suspense file",7,0,0,0,7
624906,366980,2014-05-23,Senate,"Do pass",7,0,0,0,7
624906,367652,2014-05-27,Senate,"Senate 3rd Reading SB1172 Steinberg",35,0,5,0,40
624906,370862,2014-06-11,Assembly,"Do pass and be re-referred to the Committee on Health",6,0,0,1,7
624906,374568,2014-06-24,Assembly,"Do pass and be re-referred to the Committee on Appropriations",16,0,0,3,19
624906,377493,2014-08-14,Assembly,"Do pass as amended",17,0,0,0,17
624906,378320,2014-08-25,Assembly,"SB 1172 Steinberg  Senate Third Reading  By BUCHANAN",78,0,0,1,79
624906,378621,2014-08-27,Senate,"Unfinished Business SB1172 Steinberg Concurrence",34,0,6,0,40
624908,359640,2014-04-23,Assembly,"Do pass and be re-referred to the Committee on Judiciary",2,5,0,0,7
624912,359661,2014-04-23,Assembly,"Do pass and be re-referred to the Committee on Appropriations",6,0,0,1,7
624916,360591,2014-04-28,Assembly,"Do pass and be re-referred to the Committee on Appropriations",9,0,0,6,15
624916,366966,2014-05-23,Assembly,"Do pass",12,1,0,4,17
624916,368036,2014-05-28,Assembly,"AB 2145 BRADFORD  Assembly Third Reading",51,15,0,13,79
624916,374095,2014-06-23,Senate,"Do pass as amended, and re-refer to the Committee on Environmental 	Quality",6,3,2,0,11
624916,376489,2014-08-04,Senate,"Placed on Appropriations Suspense file",7,0,0,0,7
624916,377383,2014-08-14,Senate,"Do pass as amended",5,0,2,0,7
624918,350372,2014-04-01,Senate,"Do pass, but re-refer to the Committee on Governance and Finance",9,0,2,0,11
624918,359588,2014-04-24,Senate,"Do pass as amended, and re-refer to the Committee on Appropriations",6,0,1,0,7
624918,363877,2014-05-12,Senate,"Placed on Appropriations Suspense file",7,0,0,0,7
624918,366763,2014-05-23,Senate,"Do pass as amended",7,0,0,0,7
624918,368610,2014-05-29,Senate,"Senate 3rd Reading SB1211 Padilla",37,0,3,0,40
624918,373985,2014-06-23,Assembly,"Do pass and be re-referred to the Committee on Governmental 	Organization",14,0,0,1,15
624918,374303,2014-06-25,Assembly,"Do pass and re-refer to Committee on Appropriations with 	recommendation:  To Consent Calendar",16,0,0,3,19
624918,377367,2014-08-14,Assembly,"Do pass",17,0,0,0,17
624918,378557,2014-08-26,Assembly,"SB 1211 Padilla  Senate Third Reading  By PEREA",79,0,0,0,79
624918,378636,2014-08-27,Senate,"Unfinished Business SB1211 Padilla Concurrence",36,0,4,0,40
624922,351305,2014-04-02,Assembly,"Do pass",5,0,0,2,7
624922,355090,2014-04-10,Assembly,"AB 2032 BONTA  Assembly Third Reading",59,16,0,4,79
624922,370186,2014-06-09,Senate,"Do pass, but re-refer to the Committee on Appropriations",3,2,0,0,5
624922,376778,2014-08-07,Senate,"Assembly 3rd Reading AB2032 Bonta By Block",27,7,6,0,40
624922,377431,2014-08-14,Assembly,"AB 2032 BONTA  Concurrence in Senate Amendments",62,15,0,2,79
624926,351509,2014-04-02,Assembly,"Do pass and be re-referred to the Committee on Appropriations",7,0,0,2,9
624926,366930,2014-05-23,Assembly,"Do pass as amended",17,0,0,0,17
624926,368031,2014-05-28,Assembly,"AB 2040 GARCIA  Assembly Third Reading",78,0,0,1,79
624926,372702,2014-06-18,Senate,"Do pass as amended, and re-refer to the Committee on Appropriations",7,0,0,0,7
624926,376607,2014-08-04,Senate,"Do pass as amended",7,0,0,0,7
624926,377105,2014-08-13,Senate,"Assembly 3rd Reading AB2040 Garcia By Cannella",36,0,4,0,40
624926,377655,2014-08-18,Assembly,"AB 2040 GARCIA  Concurrence in Senate Amendments",78,0,0,1,79
625384,354280,2014-04-08,Assembly,"Be adopted as amended",5,2,0,0,7
625384,362323,2014-05-05,Assembly,"AJR 40 MULLIN  Assembly Third Reading",55,20,0,4,79
625384,377676,2014-08-18,Senate,"Assembly 3rd Reading AJR40 Mullin By Mitchell",26,10,4,0,40
625384,377920,2014-08-20,Assembly,"AJR 40 MULLIN  Concurrence in Senate Amendments",55,22,0,2,79
625385,359162,2014-04-23,Assembly,"Do pass and be re-referred to the Committee on Housing and 	Community Development",8,0,0,1,9
625385,361180,2014-04-30,Assembly,"Do pass and be re-referred to the Committee on Appropriations",7,0,0,0,7
625385,366755,2014-05-23,Assembly,"Do pass",16,0,0,1,17
625385,367511,2014-05-27,Assembly,"AB 2493 BLOOM  Assembly Third Reading",75,1,0,3,79
625385,372233,2014-06-17,Senate,"Do pass, but re-refer to the Committee on Governance and Finance",9,1,1,0,11
625385,374474,2014-06-25,Senate,"Do pass as amended, and re-refer to the Committee on Appropriations",4,1,2,0,7
625385,376540,2014-08-04,Senate,"Placed on Appropriations Suspense file",7,0,0,0,7
625385,377187,2014-08-14,Senate,"Do pass as amended",5,1,1,0,7
625385,378853,2014-08-28,Assembly,"AB 2493 BLOOM  Concurrence in Senate Amendments",52,23,0,4,79
625385,378854,2014-08-28,Senate,"Assembly 3rd Reading AB2493 Bloom By DeSaulnier",21,8,11,0,40
625388,361779,2014-04-30,Senate,"Do pass as amended, and re-refer to the Committee on 	Appropriations",7,0,2,0,9
625388,365374,2014-05-19,Senate,"Placed on Appropriations Suspense file",7,0,0,0,7
625388,366728,2014-05-23,Senate,"Do pass",7,0,0,0,7
625388,368092,2014-05-28,Senate,"Senate 3rd Reading SB1341 Mitchell",35,0,5,0,40
625388,374715,2014-06-24,Assembly,"Do pass and re-refer to Committee on Appropriations with 	recommendation:  To Consent Calendar",17,0,0,2,19
625388,377166,2014-08-14,Assembly,"Do pass",17,0,0,0,17
625388,377857,2014-08-19,Assembly,"SB 1341 Mitchell  Senate Third Reading  By STONE",78,0,0,1,79
625389,354329,2014-04-09,Assembly,"Do pass as amended and be re-referred to the Committee on 	Appropriations",19,0,0,0,19
625389,361055,2014-04-30,Assembly,"Do pass, to Consent Calendar",17,0,0,0,17
625389,363390,2014-05-08,Assembly,"AB 2609 NESTANDE  Consent Calendar Second Day  Regular Session",73,0,0,6,79
625389,370536,2014-06-10,Senate,"Do pass, but re-refer to the Committee on Appropriations",8,0,2,0,10
625389,376758,2014-08-07,Senate,"Assembly 3rd Reading AB2609 Nestande By Knight",36,0,4,0,40
625389,376961,2014-08-11,Assembly,"AB 2609 NESTANDE  Concurrence in Senate Amendments",79,0,0,0,79
625390,361310,2014-04-29,Senate,"Do pass as amended, and re-refer to the Committee on 	Appropriations",11,0,0,0,11
625390,366882,2014-05-23,Senate,"Special Consent #15 SB1350 Lara",32,0,8,0,40
625390,373982,2014-06-24,Assembly,"Do pass and be re-referred to the Committee on Appropriations",12,1,0,1,14
625390,376727,2014-08-06,Assembly,"Do pass",13,4,0,0,17
625390,378433,2014-08-25,Assembly,"SB 1350 Lara  Senate Third Reading  By BONTA",67,8,0,4,79
625391,363089,2014-05-07,Assembly,"Do pass",9,0,0,0,9
625391,364923,2014-05-15,Assembly,"AB 2446 WALDRON  Assembly Third Reading",76,0,0,3,79
625391,374006,2014-06-24,Senate,"Do pass",9,0,0,0,9
625391,376897,2014-08-11,Senate,"Assembly 3rd Reading AB2446 Waldron By Anderson",35,0,5,0,40
625391,377711,2014-08-18,Assembly,"AB 2446 WALDRON  Concurrence in Senate Amendments",74,0,0,5,79
625393,358672,2014-04-21,Assembly,"Do pass as amended and be re-referred to the Committee on 	Appropriations",8,3,0,4,15
625394,362673,2014-05-06,Assembly,"Do pass as amended",9,1,0,0,10
625394,365240,2014-05-19,Assembly,"AB 2370 CHAU  Assembly Third Reading",62,12,0,5,79
625394,372806,2014-06-17,Senate,"Do pass as amended",6,0,1,0,7
625394,377585,2014-08-14,Senate,"Assembly 3rd Reading AB2370 Chau By Lara",27,7,6,0,40
625394,377712,2014-08-18,Assembly,"AB 2370 CHAU  Concurrence in Senate Amendments",63,14,0,2,79
625395,359198,2014-04-23,Assembly,"Do pass and be re-referred to the Committee on Appropriations",11,2,0,0,13
625395,366850,2014-05-23,Assembly,"Do pass as amended",13,0,0,4,17
625395,368140,2014-05-28,Assembly,"AB 2378 PEREA  Assembly Third Reading",66,8,0,5,79
625395,374349,2014-06-25,Senate,"Do pass, but re-refer to the Committee on Appropriations",5,0,0,0,5
625395,376409,2014-08-04,Senate,"Placed on Appropriations Suspense file",7,0,0,0,7
625395,377346,2014-08-14,Senate,"Do pass",5,0,2,0,7
625395,378048,2014-08-21,Senate,"Assembly 3rd Reading AB2378 Perea By Padilla",33,0,7,0,40
625396,350211,2014-04-01,Assembly,"Do pass as amended and be re-referred to the Committee on 	Appropriations",6,0,0,1,7
625396,362996,2014-05-07,Assembly,"Do pass, to Consent Calendar",17,0,0,0,17
625396,364971,2014-05-15,Assembly,"AB 2439 DONNELLY  Consent Calendar Second Day  Regular Session",78,0,0,1,79
625396,372457,2014-06-17,Senate,"Do pass and be placed on the Consent Calendar",4,0,1,0,5
625396,375637,2014-07-03,Senate,"Consent Calendar 2nd AB2439 Donnelly",35,0,5,0,40
625397,358825,2014-04-22,Assembly,"Do pass and be re-referred to the Committee on Local Government",5,2,0,0,7
625397,361793,2014-04-30,Assembly,"Do pass and be re-referred to the Committee on Appropriations",5,3,0,1,9
625398,358503,2014-04-22,Senate,"Do pass as amended, and re-refer to the Committee on Appropriations",7,0,0,0,7
625398,365265,2014-05-19,Senate,"Placed on Appropriations Suspense file",7,0,0,0,7
625398,366847,2014-05-23,Senate,"Do pass as amended",7,0,0,0,7
625398,368706,2014-05-29,Senate,"Senate 3rd Reading SB1283 Galgiani",37,0,3,0,40
625398,372284,2014-06-17,Assembly,"Do pass as amended and be re-referred to the Committee on Higher 	Education",7,0,0,0,7
625398,376699,2014-08-06,Assembly,"Do pass, to Consent Calendar",17,0,0,0,17
625398,377296,2014-08-14,Assembly,"SB 1283 Galgiani  Consent Calendar Second Day  Regular Session",78,0,0,1,79
625398,378339,2014-08-25,Senate,"Unfinished Business SB1283 Galgiani Concurrence",30,0,10,0,40
625399,347107,2014-03-24,Assembly,"From committee:  Be adopted.  To third reading",8,0,0,3,11
625399,359610,2014-04-24,Senate,"Special Consent #12 ACR109 Brown By Torres",37,0,3,0,40
625400,350979,2014-04-02,Senate,"Do pass as amended, and re-refer to the Committee on Appropriations",7,1,1,0,9
625400,360075,2014-04-28,Senate,"Placed on Appropriations Suspense file",6,0,1,0,7
625400,366895,2014-05-23,Senate,"Do pass",5,2,0,0,7
625400,367582,2014-05-27,Senate,"Senate 3rd Reading SB1396 Hancock",24,11,5,0,40
625400,370823,2014-06-11,Assembly,"Do pass and be re-referred to the Committee on Appropriations",5,0,0,2,7
625403,361646,2014-04-30,Assembly,"Do pass and be re-referred to the Committee on Appropriations",7,0,0,0,7
625403,366860,2014-05-23,Assembly,"Do pass as amended",17,0,0,0,17
625403,368129,2014-05-28,Assembly,"AB 2548 TING  Assembly Third Reading",76,0,0,3,79
625403,374541,2014-06-25,Senate,"Do pass as amended, but re-refer to the Committee on Appropriations 	Recommend Consent",6,0,1,0,7
625403,376511,2014-08-04,Senate,"Placed on Appropriations Suspense file",7,0,0,0,7
625403,377354,2014-08-14,Senate,"Do pass as amended",5,0,2,0,7
625403,377987,2014-08-20,Senate,"Assembly 3rd Reading AB2548 Ting By Liu",35,0,5,0,40
625403,378046,2014-08-21,Assembly,"AB 2548 TING  Concurrence in Senate Amendments",79,0,0,0,79
625405,361426,2014-04-29,Assembly,"Do pass as amended and be re-referred to the Committee on 	Appropriations",5,0,0,2,7
625405,366341,2014-05-21,Assembly,"Do pass, to Consent Calendar",17,0,0,0,17
625405,367561,2014-05-27,Assembly,"AB 2632 MAIENSCHEIN  Consent Calendar Second Day  Regular Session",77,0,0,2,79
625405,374552,2014-06-24,Senate,"Do pass, but re-refer to the Committee on Appropriations",4,0,1,0,5
625405,377870,2014-08-19,Senate,"Assembly 3rd Reading AB2632 Maienschein By Beall",34,0,6,0,40
625405,377899,2014-08-20,Assembly,"AB 2632 MAIENSCHEIN  Concurrence in Senate Amendments",76,0,0,3,79
625406,355237,2014-04-09,Senate,"Do pass",5,2,2,0,9
625406,367575,2014-05-27,Senate,"Senate 3rd Reading SB1276 Hernandez",23,10,7,0,40
625406,374707,2014-06-24,Assembly,"Do pass as amended",14,4,0,1,19
625406,376981,2014-08-11,Assembly,"SB 1276 Hernandez  Senate Third Reading  By WIECKOWSKI",54,22,0,3,79
625406,377087,2014-08-13,Senate,"Unfinished Business SB1276 Hernandez Concurrence",24,11,5,0,40
625409,362589,2014-05-06,Assembly,"Do pass",9,0,0,1,10
625409,364803,2014-05-15,Assembly,"AB 2646 TING  Assembly Third Reading",70,2,0,7,79
625409,374622,2014-06-24,Senate,"Do pass as amended",5,2,0,0,7
625409,377793,2014-08-19,Senate,"Assembly 3rd Reading AB2646 Ting By Lara",23,10,7,0,40
625409,378855,2014-08-28,Assembly,"Senate amendments be concurred in",9,0,0,1,10
625409,378856,2014-08-28,Assembly,"AB 2646 TING  Concurrence in Senate Amendments",59,13,0,7,79
625411,361631,2014-04-30,Assembly,"Do pass and be re-referred to the Committee on Appropriations",7,0,0,0,7
625411,362970,2014-05-07,Assembly,"Do pass",12,5,0,0,17
625411,364827,2014-05-15,Assembly,"AB 2384 BRADFORD  Assembly Third Reading",62,2,0,15,79
625411,372561,2014-06-18,Senate,"Do pass, but re-refer to the Committee on Appropriations",7,0,0,0,7
625411,375268,2014-06-30,Senate,"Placed on Appropriations Suspense file",6,0,1,0,7
625411,377564,2014-08-14,Senate,"Do pass as amended",5,0,2,0,7
625411,378493,2014-08-26,Senate,"Assembly 3rd Reading AB2384 Bradford By Block",33,0,7,0,40
625411,378805,2014-08-27,Assembly,"AB 2384 BRADFORD  Concurrence in Senate Amendments",70,5,0,4,79
625413,358576,2014-04-22,Senate,"Do pass as amended, and re-refer to the Committee on Governance and 	Finance",2,5,0,0,7
625413,358577,2014-04-22,Senate,"Set, first hearing.  Failed passage in Committee.  Reconsideration 	granted",7,0,0,0,7
625414,355168,2014-04-09,Assembly,"Do pass and be re-referred to the Committee on Appropriations",0,7,0,0,7
625418,359906,2014-04-24,Senate,"Do pass, but re-refer to the Committee on Appropriations",7,0,2,0,9
625418,362325,2014-05-05,Senate,"Placed on Appropriations Suspense file",7,0,0,0,7
625418,366776,2014-05-23,Senate,"Do pass",6,1,0,0,7
625418,367495,2014-05-27,Senate,"Senate 3rd Reading SB1322 Hernandez",25,6,9,0,40
625418,374584,2014-06-24,Assembly,"Do pass as amended and be re-referred to the Committee on 	Appropriations",13,3,0,3,19
625420,350700,2014-04-01,Assembly,"Do pass, to Consent Calendar",9,0,0,1,10
625420,352735,2014-04-07,Assembly,"AB 2727 FRAZIER  Consent Calendar Second Day  Regular Session",76,0,0,3,79
625420,371197,2014-06-10,Senate,"Do pass",7,0,0,0,7
625420,375315,2014-06-30,Senate,"Assembly 3rd Reading AB2727 Frazier By Wolk",35,0,5,0,40
625421,364433,2014-05-13,Assembly,"Do pass as amended and be re-referred to the Committee on 	Appropriations",8,0,0,1,9
625422,360583,2014-04-29,Assembly,"Do pass as amended and be re-referred to the Committee on 	Appropriations",12,6,0,1,19
625422,366974,2014-05-23,Assembly,"Do pass",12,5,0,0,17
625422,368104,2014-05-28,Assembly,"AB 2533 AMMIANO  Assembly Third Reading  Amend By HAGMAN  Set #1 	Motion to  Lay on the Table  By PEREZ, V.M",52,24,0,3,79
625422,368105,2014-05-28,Assembly,"AB 2533 AMMIANO  Assembly Third Reading",44,28,0,7,79
625422,374870,2014-06-25,Senate,"Do pass, but re-refer to the Committee on Appropriations",6,2,1,0,9
625422,376548,2014-08-04,Senate,"Placed on Appropriations Suspense file",7,0,0,0,7
625422,377395,2014-08-14,Senate,"Do pass as amended",5,1,1,0,7
625424,363002,2014-05-06,Senate,"Do pass and be placed on the Consent Calendar",7,0,0,0,7
625424,364847,2014-05-15,Senate,"Consent Calendar 2nd SB1304 Committee on Jud. (Evans)",36,0,4,0,40
625424,370575,2014-06-10,Assembly,"Do pass, to Consent Calendar",9,0,0,1,10
625424,371714,2014-06-16,Assembly,"SB 1304 JUD.  Consent Calendar Second Day  Regular Session",77,0,0,2,79
625425,358370,2014-04-22,Senate,"Do pass as amended, and re-refer to the Committee on Rules",10,0,0,0,10
625427,362940,2014-05-07,Assembly,"Do pass, to Consent Calendar",18,0,0,1,19
625427,364964,2014-05-15,Assembly,"AB 2720 TING  Consent Calendar Second Day  Regular Session",78,0,0,1,79
625427,370438,2014-06-10,Senate,"Do pass and be placed on the Consent Calendar",8,0,2,0,10
625427,371707,2014-06-16,Senate,"Consent Calendar 2nd AB2720 Ting",35,0,5,0,40
625427,377272,2014-08-14,Senate,"Assembly 3rd Reading AB2720 Ting By Berryhill",35,0,5,0,40
625427,378309,2014-08-25,Assembly,"AB 2720 TING  Concurrence in Senate Amendments",79,0,0,0,79
625428,359236,2014-04-23,Assembly,"Do pass",9,0,0,0,9
625428,363476,2014-05-08,Assembly,"AB 2395 LOWENTHAL  Assembly Third Reading  Amend By LOWENTHAL  Set 	#1",73,0,0,6,79
625428,367167,2014-05-23,Assembly,"AB 2395 LOWENTHAL  Assembly Third Reading",76,0,0,3,79
625428,370548,2014-06-10,Senate,"Do pass, but re-refer to the Committee on Governance and Finance",8,0,1,0,9
625428,374529,2014-06-25,Senate,"Do pass as amended",6,0,1,0,7
625428,376794,2014-08-07,Senate,"Assembly 3rd Reading AB2395 Lowenthal By Jackson",36,0,4,0,40
625428,376935,2014-08-11,Assembly,"AB 2395 LOWENTHAL  Concurrence in Senate Amendments",79,0,0,0,79
625429,355164,2014-04-10,Assembly,"Be referred to Committee on Insurance",7,0,0,4,11
625429,359170,2014-04-23,Assembly,"Do pass and be re-referred to the Committee on Appropriations",8,5,0,0,13
625429,367136,2014-05-23,Assembly,"Do pass",12,5,0,0,17
625429,368205,2014-05-28,Assembly,"AB 2616 SKINNER  Assembly Third Reading",48,26,0,5,79
625429,374569,2014-06-25,Senate,"Do pass, but re-refer to the Committee on Appropriations",5,0,0,0,5
625429,376606,2014-08-04,Senate,"Placed on Appropriations Suspense file",7,0,0,0,7
625429,377534,2014-08-14,Senate,"Do pass as amended",5,0,2,0,7
625429,377927,2014-08-20,Senate,"Assembly 3rd Reading AB2616 Skinner By Hill",24,9,7,0,40
625429,378269,2014-08-22,Assembly,"AB 2616 SKINNER  Concurrence in Senate Amendments",47,24,0,8,79
625430,361237,2014-04-29,Assembly,"Do pass as amended and be re-referred to the Committee on 	Appropriations",8,0,0,2,10
625430,367008,2014-05-23,Assembly,"Do pass as amended",17,0,0,0,17
625430,368700,2014-05-29,Assembly,"AB 2703 QUIRK-SILVA  Third Reading Urgency",78,0,0,1,79
625430,374073,2014-06-24,Senate,"Do pass, but re-refer to the Committee on Appropriations",5,0,2,0,7
625430,376541,2014-08-04,Senate,"Placed on Appropriations Suspense file",7,0,0,0,7
625431,359513,2014-04-24,Senate,"Do pass as amended, and re-refer to the Committee on Appropriations",5,2,0,0,7
625431,363719,2014-05-12,Senate,"Placed on Appropriations Suspense file",7,0,0,0,7
625431,366920,2014-05-23,Senate,"Do pass",5,2,0,0,7
625431,368123,2014-05-28,Senate,"Senate 3rd Reading SB1372 DeSaulnier",19,17,4,0,40
625431,368124,2014-05-28,Senate,"Senate 3rd Reading SB1372 DeSaulnier Reconsider",36,0,4,0,40
625431,378899,2014-08-28,Senate,"Senate 3rd Reading SB1372 DeSaulnier",18,17,5,0,40
625432,354484,2014-04-09,Assembly,"Do pass and be re-referred to the Committee on Jobs, Economic 	Development and The Economy",13,0,0,0,13
625432,354485,2014-04-09,Assembly,"Do pass and be re-referred to the Committee on Appropriations",9,3,0,1,13
625432,359172,2014-04-22,Assembly,"Do pass as amended and be re-referred to the Committee on 	Appropriations",6,0,0,3,9
625432,364389,2014-05-14,Assembly,"Do pass, to Consent Calendar",17,0,0,0,17
625432,366684,2014-05-23,Assembly,"AB 2723 MEDINA  Consent Calendar Second Day  Regular Session",73,0,0,6,79
625432,370405,2014-06-10,Senate,"Do pass, but re-refer to the Committee on Environmental Quality",8,0,2,0,10
625432,374281,2014-06-25,Senate,"Do pass, but re-refer to the Committee on Appropriations",6,0,1,0,7
625432,376499,2014-08-04,Senate,"Placed on Appropriations Suspense file",7,0,0,0,7
625432,377350,2014-08-14,Senate,"Do pass as amended",5,0,2,0,7
625432,378366,2014-08-25,Senate,"Assembly 3rd Reading AB2723 Medina By Correa",34,0,6,0,40
625432,378490,2014-08-26,Assembly,"AB 2723 MEDINA  Concurrence in Senate Amendments",79,0,0,0,79
625433,359451,2014-04-22,Senate,"Do pass",9,0,2,0,11
625433,365620,2014-05-19,Senate,"Senate 3rd Reading SB1312 Steinberg",32,0,8,0,40
625433,371844,2014-06-16,Assembly,"Do pass",14,0,0,2,16
625433,378836,2014-08-28,Assembly,"SB 1312 Steinberg  Senate Third Reading  By BLOOM",79,0,0,0,79
625434,351005,2014-04-02,Senate,"Do pass, but re-refer to the Committee on Appropriations Recommend 	Consent",7,0,0,0,7
625434,360087,2014-04-28,Senate,"Do pass",5,0,2,0,7
625434,361705,2014-05-01,Senate,"Senate 3rd Reading SB1353 Nielsen",35,0,5,0,40
625434,370009,2014-06-04,Assembly,"Do pass and be re-referred to the Committee on Agriculture",8,0,0,1,9
625434,373455,2014-06-18,Assembly,"Do pass and re-refer to Committee on Appropriations with 	recommendation:  To Consent Calendar",7,0,0,0,7
625434,375531,2014-07-02,Assembly,"Do pass, to Consent Calendar",17,0,0,0,17
625434,377731,2014-08-18,Assembly,"SB 1353 Nielsen  Senate Third Reading  By OLSEN",75,1,0,3,79
625434,377800,2014-08-19,Senate,"Unfinished Business SB1353 Nielsen Concurrence",34,0,6,0,40
625435,360513,2014-04-29,Senate,"Do pass as amended, and re-refer to the Committee on Appropriations",7,2,0,0,9
625435,365278,2014-05-19,Senate,"Placed on Appropriations Suspense file",7,0,0,0,7
625436,359678,2014-04-24,Assembly,"Be referred to Committee on Housing and Community Development",10,0,0,1,11
625436,361264,2014-04-30,Assembly,"Do pass and be re-referred to the Committee on Judiciary",4,2,0,1,7
625436,362701,2014-05-06,Assembly,"Do pass",7,3,0,0,10
625436,368761,2014-05-29,Assembly,"AB 2565 MURATSUCHI  Assembly Third Reading",51,26,0,2,79
625436,374370,2014-06-24,Senate,"Do pass",6,1,0,0,7
625436,378124,2014-08-21,Senate,"Assembly 3rd Reading AB2565 Muratsuchi By De Le",27,8,5,0,40
625436,378354,2014-08-25,Assembly,"AB 2565 MURATSUCHI  Concurrence in Senate Amendments",52,25,0,2,79
625437,358449,2014-04-21,Assembly,"Do pass",15,0,0,1,16
625437,359541,2014-04-24,Assembly,"AB 2337 LINDER  Assembly Third Reading",75,0,0,4,79
625437,374085,2014-06-24,Senate,"Do pass, but re-refer to the Committee on Appropriations",11,0,0,0,11
625437,376518,2014-08-04,Senate,"Placed on Appropriations Suspense file",7,0,0,0,7
625437,377391,2014-08-14,Senate,"Do pass",5,0,2,0,7
625437,378412,2014-08-25,Senate,"Assembly 3rd Reading AB2337 Linder By Cannella",34,0,6,0,40
625439,360509,2014-04-29,Assembly,"Do pass and be re-referred to the Committee on Appropriations",2,4,0,1,7
625440,361146,2014-04-29,Assembly,"Do pass and re-refer to Committee on Appropriations with 	recommendation:  To Consent Calendar",7,0,0,0,7
625440,364444,2014-05-14,Assembly,"Do pass, to Consent Calendar",17,0,0,0,17
625440,366916,2014-05-23,Assembly,"AB 2573 STONE  Consent Calendar Second Day  Regular Session",73,0,0,6,79
625440,373012,2014-06-17,Senate,"Do pass, but re-refer to the Committee on Appropriations Recommend 	Consent",6,0,1,0,7
625440,376646,2014-08-04,Senate,"Placed on Appropriations Suspense file",7,0,0,0,7
625442,359242,2014-04-23,Assembly,"Do pass",8,1,0,0,9
625442,361589,2014-05-01,Assembly,"AB 2455 WILLIAMS  Assembly Third Reading",70,3,0,6,79
625442,370853,2014-06-11,Senate,"Do pass as amended",7,0,0,0,7
625442,378481,2014-08-26,Senate,"Assembly 3rd Reading AB2455 Williams By Jackson",31,0,9,0,40
625442,378709,2014-08-27,Assembly,"AB 2455 WILLIAMS  Concurrence in Senate Amendments",71,6,0,2,79
625443,359713,2014-04-24,Senate,"Do pass, but re-refer to the Committee on Appropriations",2,4,1,0,7
625443,359714,2014-04-24,Senate,"Set, first hearing.  Failed passage in Committee.  Reconsideration 	granted",7,0,0,0,7
625444,360818,2014-04-29,Assembly,"Do pass and be re-referred to the Committee on Appropriations",14,0,0,1,15
625444,366741,2014-05-23,Assembly,"Do pass",16,0,0,1,17
625445,361184,2014-04-30,Assembly,"Do pass and re-refer to Committee on Appropriations with 	recommendation:  To Consent Calendar",7,0,0,0,7
625445,364250,2014-05-14,Assembly,"Do pass",16,0,0,1,17
625445,365354,2014-05-19,Assembly,"AB 2413 PEREZ, J.  Assembly Third Reading",75,0,0,4,79
625445,372291,2014-06-17,Senate,"Do pass, but re-refer to the Committee on Appropriations",5,0,0,0,5
625445,376878,2014-08-11,Senate,"Placed on Appropriations Suspense file",7,0,0,0,7
625445,377411,2014-08-14,Senate,"Do pass as amended",5,0,2,0,7
625445,378009,2014-08-21,Senate,"Assembly 3rd Reading AB2413 John A. P",30,1,9,0,40
625445,378234,2014-08-22,Assembly,"AB 2413 PEREZ, J.  Concurrence in Senate Amendments",74,1,0,4,79
625447,362879,2014-05-06,Assembly,"Do pass, to Consent Calendar",6,0,0,1,7
625447,364905,2014-05-15,Assembly,"AB 2551 WILK  Consent Calendar Second Day  Regular Session",78,0,0,1,79
625447,370917,2014-06-11,Senate,"Do pass, but re-refer to the Committee on Elections and 	Constitutional Amendments Recommend Consent",7,0,0,0,7
625447,374705,2014-06-24,Senate,"Do pass",5,0,0,0,5
625447,377732,2014-08-18,Senate,"Assembly 3rd Reading AB2551 Wilk By Vidak",36,0,4,0,40
625447,377757,2014-08-19,Assembly,"AB 2551 WILK  Concurrence in Senate Amendments",77,0,0,2,79
625448,361407,2014-04-30,Assembly,"Do pass and be re-referred to the Committee on Appropriations",12,0,0,1,13
625449,358469,2014-04-22,Assembly,"Do pass as amended and be re-referred to the Committee on 	Appropriations",16,2,0,1,19
625449,363046,2014-05-07,Assembly,"Do pass",13,4,0,0,17
625449,364833,2014-05-15,Assembly,"AB 2297 LEVINE  Assembly Third Reading",66,10,0,3,79
625449,373464,2014-06-18,Senate,"Do pass as amended, and re-refer to the Committee on 	Appropriations",8,0,1,0,9
625449,376512,2014-08-04,Senate,"Placed on Appropriations Suspense file",7,0,0,0,7
625451,363170,2014-05-07,Assembly,"Do pass, to Consent Calendar",7,0,0,0,7
625451,364925,2014-05-15,Assembly,"AB 2600 BONILLA  Consent Calendar Second Day  Regular Session",78,0,0,1,79
625451,369836,2014-06-04,Senate,"Do pass as amended. To Consent Calendar",6,0,1,0,7
625451,371812,2014-06-16,Senate,"Consent Calendar 2nd AB2600 Bonilla",35,0,5,0,40
625452,362846,2014-05-06,Assembly,"Be adopted, to Consent Calendar",19,0,0,0,19
625452,364948,2014-05-15,Assembly,"ACR 107 BLOOM  Consent Calendar Second Day  Regular Session",78,0,0,1,79
625452,374746,2014-06-26,Senate,"Special Consent #17 ACR107 Bloom",32,0,8,0,40
625453,359187,2014-04-22,Senate,"Do pass, but re-refer to the Committee on Appropriations",4,1,0,0,5
625453,362234,2014-05-05,Senate,"Placed on Appropriations Suspense file",7,0,0,0,7
625453,366926,2014-05-23,Senate,"Do pass as amended",5,2,0,0,7
625453,368121,2014-05-28,Senate,"Senate 3rd Reading SB1272 Lieu",23,12,5,0,40
625453,370413,2014-06-10,Assembly,"Do pass and be re-referred to the Committee on Appropriations",5,0,0,2,7
625453,372687,2014-06-18,Assembly,"Do pass",11,4,0,2,17
625453,374874,2014-06-26,Assembly,"SB 1272 Lieu  Senate Third Reading  By WILLIAMS  Amend By WILLIAMS 	Set #1",54,21,0,4,79
625453,375241,2014-06-30,Assembly,"SB 1272 Lieu  Senate Third Reading  By WILLIAMS",52,23,0,4,79
625453,375672,2014-07-03,Senate,"Unfinished Business SB1272 Lieu",24,11,5,0,40
625455,363024,2014-05-07,Assembly,"Do pass, to Consent Calendar",5,0,0,2,7
625455,364950,2014-05-15,Assembly,"AB 2474 P.E., R.& S.S.  Consent Calendar Second Day  Regular Session",78,0,0,1,79
625455,370169,2014-06-09,Senate,"Do pass and be placed on the Consent Calendar",5,0,0,0,5
625455,371787,2014-06-16,Senate,"Consent Calendar 2nd AB2474 Committee on P.E.,R.& S.S.(Bonta)",35,0,5,0,40
625455,377852,2014-08-19,Senate,"Assembly 3rd Reading AB2474 Committee on P.E.,R.& S.S.(Bonta) By 	Torres",33,0,7,0,40
625455,377985,2014-08-20,Assembly,"AB 2474 P.E., R.& S.S.  Concurrence in Senate Amendments By BONTA",77,0,0,2,79
625456,350888,2014-04-02,Senate,"Do pass as amended, and re-refer to the Committee on Appropriations",7,1,1,0,9
625456,360050,2014-04-28,Senate,"Placed on Appropriations Suspense file",6,0,1,0,7
625456,366671,2014-05-23,Senate,"Do pass as amended",5,2,0,0,7
625456,368702,2014-05-29,Senate,"Senate 3rd Reading SB1349 Jackson",29,7,4,0,40
625456,373999,2014-06-24,Assembly,"Do pass and be re-referred to the Committee on Education",5,1,0,1,7
625456,374791,2014-06-25,Assembly,"Do pass as amended",7,0,0,0,7
625456,376747,2014-08-07,Assembly,"SB 1349 Jackson  Senate Third Reading  By BONILLA",63,10,0,6,79
625456,376955,2014-08-11,Senate,"Unfinished Business SB1349 Jackson Concurrence",29,7,4,0,40
625457,364382,2014-05-13,Assembly,"Do pass as amended and be re-referred to the Committee on 	Appropriations",7,1,0,1,9
625459,360470,2014-04-29,Assembly,"Do pass as amended, to Consent Calendar",10,0,0,0,10
625459,366889,2014-05-23,Assembly,"Do pass as amended",17,0,0,0,17
625459,368095,2014-05-28,Assembly,"AB 2494 COOLEY  Assembly Third Reading",78,0,0,1,79
625459,374412,2014-06-24,Senate,"Do pass as amended, and re-refer to the Committee on 	Appropriations",7,0,0,0,7
625459,376433,2014-08-04,Senate,"Placed on Appropriations Suspense file",7,0,0,0,7
625459,377338,2014-08-14,Senate,"Do pass as amended",5,0,2,0,7
625459,378411,2014-08-25,Senate,"Assembly 3rd Reading AB2494 Cooley By Lieu",35,0,5,0,40
625459,378509,2014-08-26,Assembly,"AB 2494 COOLEY  Concurrence in Senate Amendments",79,0,0,0,79
625460,359111,2014-04-22,Senate,"Do pass, but re-refer to the Committee on Appropriations",5,0,0,0,5
625460,363481,2014-05-08,Senate,"Special Consent #13 SB1402 De Le",35,0,5,0,40
625462,359535,2014-04-24,Senate,"Do pass, but re-refer to the Committee on Environmental Quality",1,4,0,0,5
625463,359487,2014-04-23,Assembly,"Do pass as amended",9,0,0,0,9
625463,361709,2014-05-01,Assembly,"AB 2381 BONILLA  Assembly Third Reading",75,0,0,4,79
625464,350592,2014-04-01,Assembly,"Do pass and be re-referred to the Committee on Appropriations",7,0,0,0,7
625464,354318,2014-04-09,Assembly,"Do pass, to Consent Calendar",17,0,0,0,17
625464,359722,2014-04-24,Assembly,"AB 2309 BROWN  Consent Calendar Second Day  Regular Session",75,0,0,4,79
625464,370637,2014-06-10,Senate,"Do pass, but re-refer to the Committee on Appropriations",6,0,1,0,7
625464,377010,2014-08-11,Senate,"Assembly 3rd Reading AB2309 Brown By Anderson",35,0,5,0,40
625466,358410,2014-04-21,Assembly,"Do pass and be re-referred to the Committee on Local Government",9,6,0,1,16
625466,361659,2014-04-30,Assembly,"Do pass and be re-referred to the Committee on Appropriations",6,3,0,0,9
625466,364370,2014-05-14,Assembly,"Do pass",12,5,0,0,17
625466,367580,2014-05-27,Assembly,"AB 2393 LEVINE  Assembly Third Reading",42,31,0,6,79
625466,372293,2014-06-17,Senate,"Do pass, but re-refer to the Committee on Appropriations",7,3,1,0,11
625466,375293,2014-06-30,Senate,"Do pass as amended",5,1,1,0,7
625466,376786,2014-08-07,Senate,"Assembly 3rd Reading AB2393 Levine By DeSaulnier",21,13,6,0,40
625466,376905,2014-08-11,Assembly,"AB 2393 LEVINE  Concurrence in Senate Amendments",42,32,0,5,79
625468,355138,2014-04-09,Assembly,"Do pass and be re-referred to the Committee on Agriculture",6,0,0,1,7
625468,361207,2014-04-30,Assembly,"Do pass and be re-referred to the Committee on Appropriations",7,0,0,0,7
625469,360548,2014-04-29,Senate,"Do pass as amended, and re-refer to the Committee on Appropriations",6,0,1,0,7
625469,365447,2014-05-19,Senate,"Placed on Appropriations Suspense file",7,0,0,0,7
625469,366795,2014-05-23,Senate,"Do pass",7,0,0,0,7
625469,367648,2014-05-27,Senate,"Senate 3rd Reading SB1412 Nielsen",34,0,6,0,40
625469,372373,2014-06-17,Assembly,"Do pass as amended and re-refer to Committee on Appropriations 	with recommendation:  To Consent Calendar",7,0,0,0,7
625469,375571,2014-07-02,Assembly,"Do pass, to Consent Calendar",17,0,0,0,17
625469,378087,2014-08-21,Assembly,"SB 1412 Nielsen  Senate Third Reading  By PATTERSON",78,0,0,1,79
625469,378223,2014-08-22,Senate,"Unfinished Business SB1412 Nielsen Concurrence",33,0,7,0,40
625470,362844,2014-05-06,Assembly,"Do pass as amended",5,0,0,2,7
625470,367558,2014-05-27,Assembly,"AB 2233 DONNELLY  Assembly Third Reading",70,3,0,6,79
625470,374560,2014-06-24,Senate,"Do pass",5,0,0,0,5
625470,376849,2014-08-07,Senate,"Assembly 3rd Reading AB2233 Donnelly By Anderson",30,3,7,0,40
625471,363173,2014-05-07,Assembly,"Do pass, to Consent Calendar",5,0,0,2,7
625471,364986,2014-05-15,Assembly,"AB 2473 P.E., R.& S.S.  Consent Calendar Second Day  Regular Session",78,0,0,1,79
625471,370201,2014-06-09,Senate,"Do pass",5,0,0,0,5
625471,376376,2014-08-04,Senate,"Assembly 3rd Reading AB2473 Committee on P.E.,R.& S.S.(Bonta) By 	Torres",36,0,4,0,40
625471,377758,2014-08-19,Senate,"Assembly 3rd Reading AB2473 Committee on P.E.,R.& S.S.(Bonta) By 	Torres",34,0,6,0,40
625471,377882,2014-08-20,Assembly,"AB 2473 P.E., R.& S.S.  Concurrence in Senate Amendments By BONTA",77,0,0,2,79
625472,358408,2014-04-22,Senate,"Do pass, but re-refer to the Committee on Appropriations Recommend 	Consent",9,0,0,0,9
625472,362461,2014-05-05,Senate,"Placed on Appropriations Suspense file",7,0,0,0,7
625472,366988,2014-05-23,Senate,"Do pass as amended",7,0,0,0,7
625472,368721,2014-05-29,Senate,"Senate 3rd Reading SB1424 Wolk",37,0,3,0,40
625472,372315,2014-06-16,Assembly,"Do pass as amended and be re-referred to the Committee on Local 	Government",9,0,0,0,9
625472,374353,2014-06-25,Assembly,"Do pass and be re-referred to the Committee on Appropriations",8,0,0,1,9
625472,376670,2014-08-06,Assembly,"Do pass, to Consent Calendar",17,0,0,0,17
625472,377312,2014-08-14,Assembly,"SB 1424 Wolk  Consent Calendar Second Day  Regular Session",78,0,0,1,79
625472,377978,2014-08-20,Senate,"Unfinished Business SB1424 Wolk Concurrence",34,0,6,0,40
625473,360535,2014-04-28,Assembly,"Do pass as amended and be re-referred to the Committee on 	Appropriations",10,2,0,3,15
625473,366890,2014-05-23,Assembly,"Do pass",16,0,0,1,17
625473,368701,2014-05-29,Assembly,"AB 2649 MULLIN  Assembly Third Reading",75,1,0,3,79
625473,374134,2014-06-23,Senate,"Do pass as amended, and re-refer to the Committee on Appropriations",10,0,1,0,11
625473,376475,2014-08-04,Senate,"Placed on Appropriations Suspense file",7,0,0,0,7
625474,361703,2014-04-30,Senate,"Do pass as amended, and re-refer to the Committee on Appropriations",8,0,1,0,9
625474,365411,2014-05-19,Senate,"Placed on Appropriations Suspense file",7,0,0,0,7
625477,358426,2014-04-21,Assembly,"Be referred to Committee on Judiciary",9,0,0,2,11
625477,360533,2014-04-29,Assembly,"Do pass and be re-referred to the Committee on Appropriations",1,6,0,3,10
625478,353195,2014-04-08,Senate,"Do pass as amended, and re-refer to the Committee on Environmental 	Quality",7,1,1,0,9
625478,361342,2014-04-30,Senate,"Do pass as amended, and re-refer to the Committee on 	Appropriations",6,1,0,0,7
625478,365594,2014-05-19,Senate,"Placed on Appropriations Suspense file",7,0,0,0,7
625479,353219,2014-04-08,Senate,"Do pass, but re-refer to the Committee on Budget and Fiscal Review",7,0,2,0,9
625480,359571,2014-04-23,Assembly,"Do pass and be re-referred to the Committee on Judiciary",5,2,0,0,7
625480,360557,2014-04-29,Assembly,"Do pass and be re-referred to the Committee on Appropriations",7,3,0,0,10
625480,366704,2014-05-23,Assembly,"Do pass as amended",12,5,0,0,17
625480,368075,2014-05-28,Assembly,"AB 2416 STONE  Assembly Third Reading",43,27,0,9,79
625480,374304,2014-06-24,Senate,"Do pass, but re-refer to the Committee on Labor and Industrial 	Relations",5,2,0,0,7
625480,374305,2014-06-25,Senate,"Do pass as amended, and re-refer to the Committee on Appropriations",4,1,0,0,5
625480,376563,2014-08-04,Senate,"Placed on Appropriations Suspense file",7,0,0,0,7
625480,377250,2014-08-14,Senate,"Do pass as amended",5,0,2,0,7
625480,378847,2014-08-28,Senate,"Assembly 3rd Reading AB2416 Stone By Lara",13,15,12,0,40
625480,378848,2014-08-28,Senate,"Assembly 3rd Reading AB2416 Stone Reconsider",37,0,3,0,40
625481,354808,2014-04-09,Senate,"Do pass",7,0,0,0,7
625481,357927,2014-04-21,Senate,"Senate 3rd Reading SB1271 Leno",33,0,7,0,40
625481,374224,2014-06-23,Assembly,"Do pass",14,0,0,1,15
625481,379071,2014-08-29,Assembly,"Do pass",9,0,0,0,9
625481,379072,2014-08-29,Senate,"From committee:  That the Assembly Amendments be concurred in",6,0,1,0,7
625481,379073,2014-08-29,Assembly,"SB 1271 Evans  Senate Third Reading  By YAMADA",77,1,0,1,79
625481,379074,2014-08-29,Senate,"Unfinished Supp 6 SB1271 Evans Concurrence",32,0,8,0,40
625482,359114,2014-04-23,Assembly,"Do pass and be re-referred to the Committee on Appropriations",9,0,0,0,9
625482,363086,2014-05-07,Assembly,"Do pass as amended, to Consent Calendar",17,0,0,0,17
625482,364979,2014-05-15,Assembly,"AB 2451 DALY  Consent Calendar Second Day  Regular Session",78,0,0,1,79
625482,371688,2014-06-16,Senate,"Do pass, but re-refer to the Committee on Appropriations",8,0,1,0,9
625482,377630,2014-08-18,Senate,"Assembly 3rd Reading AB2451 Daly By Correa",36,0,4,0,40
625482,377856,2014-08-19,Assembly,"AB 2451 DALY  Concurrence in Senate Amendments",77,0,0,2,79
625483,364398,2014-05-13,Assembly,"Do pass as amended and be re-referred to the Committee on 	Appropriations",6,2,0,1,9
625483,366731,2014-05-23,Assembly,"Do pass",12,3,0,2,17
625483,368689,2014-05-29,Assembly,"AB 2372 AMMIANO  Assembly Third Reading",57,13,0,9,79
625483,374324,2014-06-25,Senate,"Do pass as amended, and re-refer to the Committee on Appropriations",5,2,0,0,7
625483,376495,2014-08-04,Senate,"Placed on Appropriations Suspense file",7,0,0,0,7
625484,358711,2014-04-22,Assembly,"Do pass and be re-referred to the Committee on Appropriations",6,12,0,1,19
625485,361701,2014-04-30,Senate,"Do pass as amended",9,0,0,0,9
625485,367573,2014-05-27,Senate,"Senate 3rd Reading SB1400 Hancock",34,0,6,0,40
625485,374517,2014-06-24,Assembly,"Do pass",13,0,0,0,13
625485,376990,2014-08-11,Assembly,"SB 1400 Hancock  Senate Third Reading  By BONTA",78,0,0,1,79
625490,355133,2014-04-09,Senate,"Do pass as amended, and re-refer to the Committee on Appropriations",9,1,1,0,11
625490,362247,2014-05-05,Senate,"Do pass",4,1,2,0,7
625490,363693,2014-05-12,Senate,"Senate 3rd Reading SB1273 Lara",26,7,7,0,40
625490,374459,2014-06-25,Assembly,"Do pass as amended and be re-referred to the Committee on 	Appropriations",10,1,0,2,13
625490,376662,2014-08-06,Assembly,"Do pass",13,4,0,0,17
625490,377266,2014-08-14,Assembly,"SB 1273 Lara  Senate Third Reading  By ALEJO",60,15,0,4,79
625490,377605,2014-08-18,Senate,"Unfinished Business SB1273 Lara Concurrence",26,10,4,0,40
625491,354760,2014-04-09,Assembly,"Do pass and be re-referred to the Committee on Revenue and Taxation",9,0,0,0,9
625491,360584,2014-04-28,Assembly,"Do pass as amended and be re-referred to the Committee on 	Appropriations",9,0,0,0,9
625491,364421,2014-05-14,Assembly,"Do pass, to Consent Calendar",17,0,0,0,17
625491,366815,2014-05-23,Assembly,"AB 2257 COOLEY  Consent Calendar Second Day  Regular Session",73,0,0,6,79
625491,374314,2014-06-25,Senate,"Do pass, but re-refer to the Committee on Appropriations Recommend 	Consent",6,0,1,0,7
625491,376530,2014-08-04,Senate,"Do pass",7,0,0,0,7
625491,378173,2014-08-21,Senate,"Assembly 3rd Reading AB2257 Cooley By Correa",36,0,4,0,40
625492,360528,2014-04-29,Senate,"Do pass as amended, and re-refer to the Committee on Appropriations",6,3,2,0,11
625492,365314,2014-05-19,Senate,"Placed on Appropriations Suspense file",7,0,0,0,7
625493,360049,2014-04-28,Assembly,"Be referred to Committee on Judiciary",9,0,0,2,11
625494,353245,2014-04-07,Assembly,"Do pass as amended and be re-referred to the Committee on 	Appropriations",9,0,0,0,9
625494,361245,2014-04-30,Assembly,"Do pass",17,0,0,0,17
625494,362303,2014-05-05,Assembly,"AB 2251 YAMADA  Assembly Third Reading",76,0,0,3,79
625494,372814,2014-06-18,Senate,"Do pass, but re-refer to the Committee on Appropriations",5,1,1,0,7
625494,376835,2014-08-07,Senate,"Assembly 3rd Reading AB2251 Yamada By Pavley",36,0,4,0,40
625494,377331,2014-08-14,Assembly,"AB 2251 YAMADA  Concurrence in Senate Amendments",79,0,0,0,79
625495,361185,2014-04-29,Assembly,"Do pass and be re-referred to the Committee on Appropriations",2,2,0,3,7
625496,359165,2014-04-23,Assembly,"Do pass and re-refer to Committee on Appropriations with 	recommendation:  To Consent Calendar",6,0,0,1,7
625496,361122,2014-04-30,Assembly,"Do pass, to Consent Calendar",17,0,0,0,17
625496,363468,2014-05-08,Assembly,"AB 2387 PAN  Consent Calendar Second Day  Regular Session",73,0,0,6,79
625496,370414,2014-06-10,Senate,"Do pass, but re-refer to the Committee on Appropriations",6,0,1,0,7
625496,377015,2014-08-11,Senate,"Assembly 3rd Reading AB2387 Pan By Knight",36,0,4,0,40
625496,378479,2014-08-26,Senate,"Assembly 3rd Reading AB2387 Pan By Knight",36,0,4,0,40
625496,378644,2014-08-27,Assembly,"AB 2387 PAN  Concurrence in Senate Amendments",78,0,0,1,79
625497,359322,2014-04-23,Assembly,"Do pass and be re-referred to the Committee on Appropriations",7,0,0,0,7
625497,367150,2014-05-23,Assembly,"Do pass",17,0,0,0,17
625497,368229,2014-05-28,Assembly,"AB 2341 QUIRK-SILVA  Assembly Third Reading",79,0,0,0,79
625497,372548,2014-06-18,Senate,"Do pass as amended, but re-refer to the Committee on Appropriations 	Recommend Consent",7,0,0,0,7
625497,376549,2014-08-04,Senate,"Placed on Appropriations Suspense file",7,0,0,0,7
625498,350296,2014-04-01,Assembly,"Do pass and be re-referred to the Committee on Appropriations",13,0,0,0,13
625498,354222,2014-04-09,Assembly,"Do pass, to Consent Calendar",17,0,0,0,17
625498,359807,2014-04-24,Assembly,"AB 2324 WILLIAMS  Consent Calendar Second Day  Regular Session",75,0,0,4,79
625498,370957,2014-06-11,Senate,"Do pass, but re-refer to the Committee on Appropriations",6,1,0,0,7
625498,375243,2014-06-30,Senate,"Do pass",5,1,1,0,7
625498,378318,2014-08-25,Senate,"Assembly 3rd Reading AB2324 Williams By Liu",28,6,6,0,40
625498,378559,2014-08-26,Assembly,"AB 2324 WILLIAMS  Concurrence in Senate Amendments",79,0,0,0,79
625499,358771,2014-04-22,Assembly,"Do pass and be re-referred to the Committee on Appropriations",3,7,0,0,10
625499,358772,2014-04-22,Assembly,"Set third hearing.  Failed passage.  Reconsideration granted",10,0,0,0,10
625502,360689,2014-04-29,Assembly,"Do pass and be re-referred to the Committee on Appropriations",6,13,0,0,19
625507,361733,2014-04-30,Assembly,"Do pass and be re-referred to the Committee on Appropriations",7,0,0,0,7
625507,367104,2014-05-23,Assembly,"Do pass as amended",16,0,0,1,17
625507,368061,2014-05-28,Assembly,"AB 2380 WEBER  Assembly Third Reading",77,0,0,2,79
625507,374550,2014-06-25,Senate,"Do pass, but re-refer to the Committee on Appropriations Recommend 	Consent",6,0,1,0,7
625507,376612,2014-08-04,Senate,"Placed on Appropriations Suspense file",7,0,0,0,7
625507,377573,2014-08-14,Senate,"Do pass as amended",5,0,2,0,7
625507,378576,2014-08-26,Senate,"Assembly 3rd Reading AB2380 Weber By Wyland",33,0,7,0,40
625507,378827,2014-08-27,Assembly,"AB 2380 WEBER  Concurrence in Senate Amendments",77,0,0,2,79
625508,353465,2014-04-08,Assembly,"Do pass and be re-referred to the Committee on Appropriations",7,0,0,0,7
625508,361084,2014-04-30,Assembly,"Do pass",16,0,0,1,17
625508,362218,2014-05-05,Assembly,"AB 2300 RIDLEY-THOMAS  Assembly Third Reading",75,0,0,4,79
625508,370528,2014-06-10,Senate,"Do pass, but re-refer to the Committee on Appropriations",6,0,1,0,7
625508,375636,2014-07-03,Senate,"Special Consent #18 AB2300 Ridley-Thomas",35,0,5,0,40
625514,359154,2014-04-22,Assembly,"Do pass",12,0,0,1,13
625514,362222,2014-05-05,Assembly,"AB 2558 WILLIAMS  Assembly Third Reading",76,0,0,3,79
625514,370905,2014-06-11,Senate,"Do pass as amended, but re-refer to the Committee on Appropriations 	Recommend Consent",6,0,1,0,7
625514,375295,2014-06-30,Senate,"Placed on Appropriations Suspense file",6,0,1,0,7
625514,377311,2014-08-14,Senate,"Do pass",5,0,2,0,7
625514,378056,2014-08-21,Senate,"Assembly 3rd Reading AB2558 Williams By Block",36,0,4,0,40
625514,378350,2014-08-25,Assembly,"AB 2558 WILLIAMS  Concurrence in Senate Amendments",79,0,0,0,79
625515,360544,2014-04-28,Assembly,"Do pass and be re-referred to the Committee on Appropriations",5,8,0,3,16
625515,360545,2014-04-28,Assembly,"Reconsideration granted",16,0,0,0,16
625515,361600,2014-05-01,Assembly,"Do pass and be re-referred to the Committee on Appropriations",8,6,0,2,16
625516,332933,2014-03-03,Senate,"Senate 3rd Reading SCR88 Evans",31,0,8,0,39
625516,358631,2014-04-21,Assembly,"Be adopted, to Consent Calendar",9,0,0,2,11
625516,359614,2014-04-24,Assembly,"SCR 88 Evans  Consent Calendar Second Day  Regular Session",75,0,0,4,79
625517,360565,2014-04-29,Senate,"Do pass, but re-refer to the Committee on Appropriations",9,0,0,0,9
625517,363697,2014-05-12,Senate,"Placed on Appropriations Suspense file",7,0,0,0,7
625517,367057,2014-05-23,Senate,"Do pass",7,0,0,0,7
625517,367646,2014-05-27,Senate,"Senate 3rd Reading SB1420 Wolk",34,0,6,0,40
625517,372319,2014-06-17,Assembly,"Do pass and re-refer to Committee on Appropriations with 	recommendation:  To Consent Calendar",15,0,0,0,15
625517,376722,2014-08-06,Assembly,"Do pass, to Consent Calendar",17,0,0,0,17
625517,377719,2014-08-18,Assembly,"SB 1420 Wolk  Senate Third Reading  By WEBER",77,0,0,2,79
625517,377775,2014-08-19,Senate,"Unfinished Business SB1420 Wolk Concurrence",34,0,6,0,40
625519,361392,2014-04-29,Assembly,"Do pass and be re-referred to the Committee on Appropriations",8,0,0,2,10
625519,366733,2014-05-23,Assembly,"Do pass",17,0,0,0,17
625519,368723,2014-05-29,Assembly,"AB 2664 QUIRK-SILVA  Assembly Third Reading",79,0,0,0,79
625519,374067,2014-06-24,Senate,"Do pass, but re-refer to the Committee on Appropriations Recommend 	Consent",6,0,1,0,7
625519,376635,2014-08-04,Senate,"Placed on Appropriations Suspense file",7,0,0,0,7
625519,377589,2014-08-14,Senate,"Do pass",5,0,2,0,7
625519,378364,2014-08-25,Senate,"Assembly 3rd Reading AB2664 Quirk-Silva By Nielsen",34,0,6,0,40
625521,353307,2014-04-08,Assembly,"Do pass as amended and be re-referred to the Committee on 	Appropriations",5,2,0,0,7
625523,359182,2014-04-22,Senate,"Do pass as amended",4,2,1,0,7
625523,363410,2014-05-08,Senate,"Senate 3rd Reading SB1348 DeSaulnier",24,8,8,0,40
625523,374105,2014-06-24,Assembly,"Do pass and be re-referred to the Committee on Arts, Entertain, 	Sports, Tourism, & Internet Media",7,2,0,1,10
625524,361187,2014-04-30,Assembly,"Do pass and be re-referred to the Committee on Appropriations",19,0,0,0,19
625524,364632,2014-05-14,Assembly,"Do pass, to Consent Calendar",17,0,0,0,17
625524,367043,2014-05-23,Assembly,"AB 2592 CHESBRO  Consent Calendar Second Day  Regular Session",73,0,0,6,79
625524,374032,2014-06-24,Senate,"Do pass, but re-refer to the Committee on Appropriations",6,3,1,0,10
625524,376521,2014-08-04,Senate,"Placed on Appropriations Suspense file",7,0,0,0,7
625524,377559,2014-08-14,Senate,"Do pass",5,0,2,0,7
625524,377850,2014-08-19,Senate,"Assembly 3rd Reading AB2592 Chesbro By Evans",21,13,6,0,40
625525,358572,2014-04-22,Assembly,"Do pass and be re-referred to the Committee on Appropriations",19,0,0,0,19
625526,352641,2014-04-07,Assembly,"Be referred to Committee on Transportation",11,0,0,0,11
625526,358604,2014-04-21,Assembly,"Do pass as amended and be re-referred to the Committee on 	Appropriations",15,0,0,1,16
625527,364423,2014-05-13,Assembly,"Do pass as amended and be re-referred to the Committee on 	Appropriations",9,0,0,0,9
625528,350495,2014-04-01,Senate,"Do pass",6,0,1,0,7
625528,351981,2014-04-03,Senate,"Senate 3rd Reading SB1310 Lara",31,4,5,0,40
625528,370568,2014-06-10,Assembly,"Do pass",5,0,0,2,7
625528,375642,2014-07-03,Assembly,"SB 1310 Lara  Senate Third Reading  By GONZALEZ",68,1,0,10,79
625529,358416,2014-04-22,Assembly,"Do pass as amended and re-refer to Committee on Appropriations 	with recommendation:  To Consent Calendar",14,0,0,0,14
625529,363226,2014-05-07,Assembly,"Do pass as amended, to Consent Calendar",17,0,0,0,17
625529,364892,2014-05-15,Assembly,"AB 2540 DABABNEH  Consent Calendar Second Day  Regular Session",78,0,0,1,79
625529,374127,2014-06-23,Senate,"Do pass, but re-refer to the Committee on Appropriations Recommend 	Consent",8,0,1,0,9
625529,376797,2014-08-07,Senate,"Consent Calendar 2nd AB2540 Dababneh",34,0,6,0,40
625529,376865,2014-08-11,Assembly,"AB 2540 DABABNEH  Concurrence in Senate Amendments",79,0,0,0,79
625530,352814,2014-04-07,Assembly,"Be referred to Committee on Transportation",11,0,0,0,11
625534,364414,2014-05-13,Assembly,"Do pass as amended and be re-referred to the Committee on 	Appropriations",7,1,0,1,9
625536,353212,2014-04-08,Assembly,"Do pass and re-refer to Committee on Appropriations with 	recommendation:  To Consent Calendar",7,0,0,0,7
625536,361176,2014-04-30,Assembly,"Do pass, to Consent Calendar",17,0,0,0,17
625536,363336,2014-05-08,Assembly,"AB 2545 LOWENTHAL  Consent Calendar Second Day  Regular Session",73,0,0,6,79
625536,372298,2014-06-17,Senate,"Do pass, but re-refer to the Committee on Appropriations",5,0,2,0,7
625536,377617,2014-08-18,Senate,"Assembly 3rd Reading AB2545 Lowenthal By Jackson",36,0,4,0,40
625536,377931,2014-08-20,Assembly,"AB 2545 LOWENTHAL  Concurrence in Senate Amendments",78,0,0,1,79
625539,355209,2014-04-09,Assembly,"Do pass and be re-referred to the Committee on Appropriations",7,0,0,0,7
625539,366836,2014-05-23,Assembly,"Do pass as amended",16,0,0,1,17
625539,368048,2014-05-28,Assembly,"AB 2402 BUCHANAN  Assembly Third Reading",78,0,0,1,79
625539,372226,2014-06-17,Senate,"Do pass, but re-refer to the Committee on Appropriations",5,0,0,0,5
625539,376802,2014-08-07,Senate,"Assembly 3rd Reading AB2402 Buchanan By Galgiani",36,0,4,0,40
625541,358659,2014-04-22,Assembly,"Do pass and be re-referred to the Committee on Business, 	Professions and Consumer Protection",10,0,0,0,10
625541,360562,2014-04-29,Assembly,"Do pass and be re-referred to the Committee on Appropriations",14,0,0,0,14
625541,364243,2014-05-14,Assembly,"Do pass",17,0,0,0,17
625541,367014,2014-05-23,Assembly,"AB 2667 BLOOM  Assembly Third Reading",75,0,0,4,79
625541,374640,2014-06-24,Senate,"Do pass, but re-refer to the Committee on Appropriations",6,1,0,0,7
625541,377612,2014-08-18,Senate,"Assembly 3rd Reading AB2667 Bloom By Leno",36,0,4,0,40
625541,377744,2014-08-19,Assembly,"AB 2667 BLOOM  Concurrence in Senate Amendments",78,0,0,1,79
625542,360572,2014-04-28,Assembly,"Do pass and be re-referred to the Committee on Appropriations",3,4,0,2,9
625543,359566,2014-04-24,Assembly,"Be referred to Committee on Utilities and Commerce",10,0,0,1,11
625543,360599,2014-04-28,Assembly,"Do pass as amended and be re-referred to the Committee on 	Appropriations",13,0,0,2,15
625543,367082,2014-05-23,Assembly,"Do pass",17,0,0,0,17
625543,367563,2014-05-27,Assembly,"AB 2363 DAHLE  Assembly Third Reading",76,0,0,3,79
625543,374060,2014-06-23,Senate,"Do pass, but re-refer to the Committee on Appropriations",10,0,1,0,11
625543,376414,2014-08-04,Senate,"Placed on Appropriations Suspense file",7,0,0,0,7
625543,377510,2014-08-14,Senate,"Do pass as amended",5,0,2,0,7
625543,377953,2014-08-20,Senate,"Assembly 3rd Reading AB2363 Dahle By Fuller",33,0,7,0,40
625543,378116,2014-08-21,Assembly,"AB 2363 DAHLE  Concurrence in Senate Amendments",79,0,0,0,79
625546,361552,2014-04-30,Assembly,"Do pass and be re-referred to the Committee on Appropriations",7,0,0,0,7
625546,367110,2014-05-23,Assembly,"Do pass",17,0,0,0,17
625546,367496,2014-05-27,Assembly,"AB 2276 BOCANEGRA  Assembly Third Reading",77,0,0,2,79
625546,374510,2014-06-25,Senate,"Do pass, but re-refer to the Committee on Appropriations Recommend 	Consent",6,0,1,0,7
625546,376611,2014-08-04,Senate,"Placed on Appropriations Suspense file",7,0,0,0,7
625546,377388,2014-08-14,Senate,"Do pass as amended",6,0,1,0,7
625546,378064,2014-08-21,Senate,"Assembly 3rd Reading AB2276 Bocanegra By Lara",35,0,5,0,40
625546,378211,2014-08-22,Assembly,"AB 2276 BOCANEGRA  Concurrence in Senate Amendments",76,0,0,3,79
625547,358586,2014-04-22,Assembly,"Do pass as amended and be re-referred to the Committee on 	Appropriations",10,0,0,0,10
625547,363008,2014-05-07,Assembly,"Do pass",14,3,0,0,17
625547,364985,2014-05-15,Assembly,"AB 2365 PEREZ, J.  Assembly Third Reading",74,2,0,3,79
625547,374633,2014-06-24,Senate,"Do pass, but re-refer to the Committee on Appropriations",6,1,0,0,7
625547,377104,2014-08-13,Senate,"Assembly 3rd Reading AB2365 John A. P",27,9,4,0,40
625547,377646,2014-08-18,Assembly,"AB 2365 PEREZ, J.  Concurrence in Senate Amendments",63,14,0,2,79
625548,353238,2014-04-08,Senate,"Do pass",5,2,0,0,7
625548,361550,2014-05-01,Senate,"Senate 3rd Reading SB1306 Leno",25,10,5,0,40
625548,370557,2014-06-10,Assembly,"Do pass",7,1,0,2,10
625548,375421,2014-06-30,Assembly,"SB 1306 Leno  Senate Third Reading  By WIECKOWSKI",54,16,0,9,79
625549,363078,2014-05-07,Senate,"Do pass as amended, and re-refer to the Committee on Appropriations",2,4,1,0,7
625549,363079,2014-05-07,Senate,"Set, first hearing.  Failed passage in Committee.  Reconsideration 	granted",6,0,1,0,7
625554,358445,2014-04-22,Assembly,"Do pass and re-refer to Committee on Appropriations with 	recommendation:  To Consent Calendar",14,0,0,0,14
625554,361222,2014-04-30,Assembly,"Do pass, to Consent Calendar",17,0,0,0,17
625554,363479,2014-05-08,Assembly,"AB 2376 WEBER  Consent Calendar Second Day  Regular Session",73,0,0,6,79
625554,370610,2014-06-10,Senate,"Do pass, but re-refer to the Committee on Appropriations Recommend 	Consent",8,0,2,0,10
625554,374831,2014-06-26,Senate,"Consent Calendar 2nd AB2376 Weber",32,0,8,0,40
625555,353180,2014-04-08,Senate,"Do pass, but re-refer to the Committee on Appropriations",6,3,1,0,10
625555,360082,2014-04-28,Senate,"Placed on Appropriations Suspense file",6,0,1,0,7
625558,358923,2014-04-22,Assembly,"Do pass as amended and be re-referred to the Committee on 	Appropriations",18,0,0,1,19
625558,364485,2014-05-14,Assembly,"Do pass, to Consent Calendar",17,0,0,0,17
625558,366790,2014-05-23,Assembly,"AB 2374 MANSOOR  Consent Calendar Second Day  Regular Session",73,0,0,6,79
625558,374748,2014-06-25,Senate,"Do pass as amended, and re-refer to the Committee on 	Appropriations",8,0,1,0,9
625558,376445,2014-08-04,Senate,"Placed on Appropriations Suspense file",7,0,0,0,7
625558,377359,2014-08-14,Senate,"Do pass as amended",5,0,2,0,7
625558,378630,2014-08-27,Senate,"Special Consent #19 AB2374 Mansoor By Walters",36,0,4,0,40
625558,378850,2014-08-28,Assembly,"AB 2374 MANSOOR  Concurrence in Senate Amendments",79,0,0,0,79
625559,359131,2014-04-22,Senate,"Do pass, but re-refer to the Committee on Appropriations",5,0,0,0,5
625559,362324,2014-05-05,Senate,"Placed on Appropriations Suspense file",7,0,0,0,7
625559,366791,2014-05-23,Senate,"Do pass",7,0,0,0,7
625559,367463,2014-05-27,Senate,"Senate 3rd Reading SB1442 Lara",34,0,6,0,40
625559,374658,2014-06-24,Assembly,"Do pass as amended and be re-referred to the Committee on 	Appropriations",5,1,0,1,7
625559,377481,2014-08-14,Assembly,"Do pass as amended",15,1,0,1,17
625559,379133,2014-08-30,Senate,"W/O REF. TO FILE SB1442 Lara Concurrence",27,1,12,0,40
625559,379134,2014-08-30,Assembly,"SB 1442 Lara  Senate Third Reading  By GARCIA",73,5,0,1,79
625560,361666,2014-04-30,Assembly,"Do pass and be re-referred to the Committee on Appropriations",8,1,0,0,9
625560,366229,2014-05-21,Assembly,"Do pass as amended",13,4,0,0,17
625560,367465,2014-05-27,Assembly,"AB 2292 BONTA  Assembly Third Reading",65,7,0,7,79
625560,372714,2014-06-18,Senate,"Do pass",7,0,0,0,7
625560,376351,2014-08-04,Senate,"Assembly 3rd Reading AB2292 Bonta By Padilla",36,0,4,0,40
625560,377042,2014-08-13,Assembly,"Senate amendments be concurred in",8,0,0,1,9
625560,377604,2014-08-18,Assembly,"AB 2292 BONTA  Concurrence in Senate Amendments",66,11,0,2,79
625561,360692,2014-04-29,Assembly,"Do pass and be re-referred to the Committee on Appropriations",13,0,0,0,13
625561,363026,2014-05-07,Assembly,"Do pass as amended, to Consent Calendar",17,0,0,0,17
625561,364819,2014-05-15,Assembly,"AB 2610 WILLIAMS  Consent Calendar Second Day  Regular Session",78,0,0,1,79
625561,374556,2014-06-25,Senate,"Do pass as amended, and re-refer to the Committee on Appropriations",6,0,1,0,7
625561,376415,2014-08-04,Senate,"Placed on Appropriations Suspense file",7,0,0,0,7
625562,358436,2014-04-22,Senate,"Do pass, but re-refer to the Committee on Appropriations Recommend 	Consent",10,0,0,0,10
625562,363440,2014-05-08,Senate,"Consent Calendar 2nd SB1417 Jackson",35,0,5,0,40
625562,374336,2014-06-25,Assembly,"Do pass and re-refer to Committee on Appropriations with 	recommendation:  To Consent Calendar",16,0,0,3,19
625562,375569,2014-07-02,Assembly,"Do pass, to Consent Calendar",17,0,0,0,17
625562,376800,2014-08-07,Assembly,"SB 1417 Jackson  Consent Calendar Second Day  Regular Session",77,0,0,2,79
625563,359109,2014-04-23,Assembly,"Do pass and be re-referred to the Committee on Appropriations",8,0,0,1,9
625563,362961,2014-05-07,Assembly,"Do pass, to Consent Calendar",17,0,0,0,17
625563,364911,2014-05-15,Assembly,"AB 2647 WAGNER  Consent Calendar Second Day  Regular Session",78,0,0,1,79
625563,372595,2014-06-18,Senate,"Do pass, but re-refer to the Committee on Appropriations",7,0,0,0,7
625563,378618,2014-08-27,Senate,"Special Consent #19 AB2647 Wagner",36,0,4,0,40
625563,378963,2014-08-28,Assembly,"AB 2647 WAGNER  Concurrence in Senate Amendments",78,0,0,1,79
625564,358403,2014-04-21,Assembly,"Do pass and be re-referred to the Committee on Appropriations",13,0,0,2,15
625564,366881,2014-05-23,Assembly,"Do pass",17,0,0,0,17
625564,368727,2014-05-29,Assembly,"AB 2581 BRADFORD  Assembly Third Reading",79,0,0,0,79
625564,374156,2014-06-23,Senate,"Do pass as amended, and re-refer to the Committee on Appropriations",7,3,1,0,11
625564,376591,2014-08-04,Senate,"Placed on Appropriations Suspense file",7,0,0,0,7
625564,377218,2014-08-14,Senate,"Do pass as amended",5,0,2,0,7
625564,378451,2014-08-26,Senate,"Assembly 3rd Reading AB2581 Bradford By Padilla",29,5,6,0,40
625564,378785,2014-08-27,Assembly,"AB 2581 BRADFORD  Concurrence in Senate Amendments",76,0,0,3,79
625567,350891,2014-04-02,Senate,"Do pass, but re-refer to the Committee on Appropriations",5,0,2,0,7
625567,361632,2014-05-01,Senate,"Senate 3rd Reading SB1415 Hill",36,0,4,0,40
625567,372269,2014-06-16,Assembly,"Do pass and be re-referred to the Committee on Local Government",9,0,0,0,9
625567,374315,2014-06-25,Assembly,"Do pass and be re-referred to the Committee on Appropriations",8,0,0,1,9
625567,376695,2014-08-06,Assembly,"Do pass",15,2,0,0,17
625567,377155,2014-08-14,Assembly,"SB 1415 Hill  Senate Third Reading  By LEVINE",74,3,0,2,79
625568,360683,2014-04-29,Assembly,"Do pass and re-refer to Committee on Appropriations with 	recommendation:  To Consent Calendar",14,0,0,0,14
625568,364602,2014-05-14,Assembly,"Do pass, to Consent Calendar",17,0,0,0,17
625568,367092,2014-05-23,Assembly,"AB 2270 TING  Consent Calendar Second Day  Regular Session",73,0,0,6,79
625568,374232,2014-06-24,Senate,"Do pass, but re-refer to the Committee on Appropriations Recommend 	Consent",11,0,0,0,11
625568,378914,2014-08-28,Senate,"Assembly 3rd Reading AB2270 Ting By DeSaulnier",34,0,6,0,40
625569,360070,2014-04-28,Senate,"Do pass as amended, and re-refer to the Committee on 	Appropriations",8,0,1,0,9
625569,365361,2014-05-19,Senate,"Placed on Appropriations Suspense file",7,0,0,0,7
625570,360516,2014-04-29,Senate,"Do pass, but re-refer to the Committee on Appropriations",6,0,1,0,7
625570,365419,2014-05-19,Senate,"Placed on Appropriations Suspense file",7,0,0,0,7
625570,366906,2014-05-23,Senate,"Do pass as amended",7,0,0,0,7
625570,368200,2014-05-28,Senate,"Senate 3rd Reading SB1454 Gaines",37,0,3,0,40
625570,372129,2014-06-17,Assembly,"Do pass and re-refer to Committee on Appropriations with 	recommendation:  To Consent Calendar",15,0,0,0,15
625570,377565,2014-08-14,Assembly,"Do pass",17,0,0,0,17
625570,377844,2014-08-19,Assembly,"SB 1454 Gaines  Senate Third Reading  By FRAZIER",78,0,0,1,79
625572,361087,2014-04-29,Senate,"Do pass, but re-refer to the Committee on Rules",11,0,0,0,11
625572,365352,2014-05-19,Senate,"Placed on Appropriations Suspense file",7,0,0,0,7
625573,374776,2014-06-25,Assembly,"Do pass and be re-referred to the Committee on Appropriations",6,0,0,3,9
625574,359303,2014-04-23,Assembly,"Do pass and be re-referred to the Committee on Appropriations",9,0,0,0,9
625574,364391,2014-05-14,Assembly,"Do pass",15,2,0,0,17
625574,366691,2014-05-23,Assembly,"AB 2719 BONTA  Assembly Third Reading",67,6,0,6,79
625574,374288,2014-06-25,Senate,"Do pass, but re-refer to the Committee on Appropriations",6,1,0,0,7
625574,376410,2014-08-04,Senate,"Placed on Appropriations Suspense file",7,0,0,0,7
625574,377554,2014-08-14,Senate,"Do pass",5,0,2,0,7
625574,378298,2014-08-25,Senate,"Assembly 3rd Reading AB2719 Bonta By DeSaulnier",30,3,7,0,40
625574,378803,2014-08-27,Assembly,"AB 2719 BONTA  Concurrence in Senate Amendments",69,9,0,1,79
625575,361674,2014-04-30,Senate,"Do pass, but re-refer to the Committee on Appropriations",6,0,3,0,9
625575,365409,2014-05-19,Senate,"Placed on Appropriations Suspense file",7,0,0,0,7
625575,367016,2014-05-23,Senate,"Do pass as amended",7,0,0,0,7
625575,368070,2014-05-28,Senate,"Senate 3rd Reading SB1421 Fuller",33,1,6,0,40
625575,375036,2014-06-25,Assembly,"Do pass as amended and be re-referred to the Committee on 	Appropriations",7,0,0,0,7
625576,358769,2014-04-22,Assembly,"Do pass",6,0,0,1,7
625576,359647,2014-04-24,Assembly,"AB 2526 GONZALEZ  Assembly Third Reading",64,5,0,10,79
625577,353303,2014-04-08,Assembly,"Do pass as amended and be re-referred to the Committee on 	Appropriations",7,3,0,0,10
625577,366999,2014-05-23,Assembly,"Do pass as amended",12,5,0,0,17
625577,368623,2014-05-29,Assembly,"AB 2332 WIECKOWSKI  Assembly Third Reading",52,23,0,4,79
625577,374547,2014-06-24,Senate,"Do pass as amended, and re-refer to the Committee on 	Appropriations",5,2,0,0,7
625577,376439,2014-08-04,Senate,"Placed on Appropriations Suspense file",7,0,0,0,7
625578,361524,2014-04-30,Assembly,"Do pass, to Consent Calendar",7,0,0,0,7
625578,363415,2014-05-08,Assembly,"AB 2470 SALAS  Consent Calendar Second Day  Regular Session",73,0,0,6,79
625578,372258,2014-06-17,Senate,"Do pass, but re-refer to the Committee on Appropriations",5,0,0,0,5
625578,376841,2014-08-07,Senate,"Assembly 3rd Reading AB2470 Salas By Galgiani",34,0,6,0,40
625578,376866,2014-08-11,Assembly,"AB 2470 SALAS  Concurrence in Senate Amendments",77,2,0,0,79
625579,347655,2014-03-25,Assembly,"Do pass as amended and be re-referred to the Committee on 	Appropriations",10,0,0,0,10
625579,354439,2014-04-09,Assembly,"Do pass",16,0,0,1,17
625579,359665,2014-04-24,Assembly,"AB 2310 RIDLEY-THOMAS  Third Reading Urgency",70,1,0,8,79
625579,374487,2014-06-24,Senate,"Do pass as amended, and re-refer to the Committee on 	Appropriations",7,0,0,0,7
625579,377950,2014-08-20,Senate,"Assembly 3rd Reading AB2310 Ridley-Thomas Urgency Clause",35,0,5,0,40
625579,378376,2014-08-25,Assembly,"AB 2310 RIDLEY-THOMAS  Concurrence in Senate Amendments",77,1,0,1,79
625581,353240,2014-04-08,Senate,"Do pass",7,0,0,0,7
625581,355125,2014-04-10,Senate,"Senate 3rd Reading SB1296 Leno",30,2,8,0,40
625581,370460,2014-06-10,Assembly,"Do pass",7,0,0,0,7
625581,373105,2014-06-19,Assembly,"SB 1296 Leno  Senate Third Reading  By MELENDEZ",77,1,0,1,79
625582,360733,2014-04-28,Assembly,"Do pass as amended and be re-referred to the Committee on 	Appropriations",7,1,0,1,9
625582,364458,2014-05-14,Assembly,"Do pass",17,0,0,0,17
625582,367049,2014-05-23,Assembly,"AB 2417 NAZARIAN  Assembly Third Reading",65,4,0,10,79
625583,354155,2014-04-09,Assembly,"Do pass and be re-referred to the Committee on Appropriations",9,3,0,1,13
625583,361218,2014-04-30,Assembly,"Do pass",15,1,0,1,17
625583,367073,2014-05-23,Assembly,"AB 2726 DALY  Assembly Third Reading",64,8,0,7,79
625583,374250,2014-06-24,Senate,"Do pass, but re-refer to the Committee on Appropriations",7,3,0,0,10
625583,376629,2014-08-04,Senate,"Do pass",5,2,0,0,7
625583,376873,2014-08-11,Senate,"Assembly 3rd Reading AB2726 Daly By Correa",22,13,5,0,40
625585,360580,2014-04-29,Assembly,"Do pass as amended and re-refer to Committee on Appropriations 	with recommendation:  To Consent Calendar",19,0,0,0,19
625585,366821,2014-05-23,Assembly,"Do pass as amended",16,0,0,1,17
625585,368071,2014-05-28,Assembly,"AB 2577 COOLEY  Third Reading Urgency",77,0,0,2,79
625585,373166,2014-06-18,Senate,"Do pass, but re-refer to the Committee on Appropriations",8,0,1,0,9
625585,376470,2014-08-04,Senate,"Placed on Appropriations Suspense file",7,0,0,0,7
625585,377182,2014-08-14,Senate,"Do pass",5,0,2,0,7
625585,378751,2014-08-27,Senate,"Special Consent #19 AB2577 Cooley By Gaines",35,0,5,0,40
625585,378942,2014-08-28,Assembly,"AB 2577 COOLEY  Concurrence in Senate Amendments",79,0,0,0,79
625586,359896,2014-04-24,Senate,"Do pass as amended, and re-refer to the Committee on 	Appropriations",7,1,1,0,9
625586,363873,2014-05-12,Senate,"Placed on Appropriations Suspense file",7,0,0,0,7
625586,366667,2014-05-23,Senate,"Do pass as amended",5,2,0,0,7
625586,368754,2014-05-29,Senate,"Senate 3rd Reading SB1384 Mitchell",23,12,5,0,40
625586,374307,2014-06-24,Assembly,"Do pass and be re-referred to the Committee on Appropriations",10,6,0,3,19
625586,376704,2014-08-06,Assembly,"Do pass",12,5,0,0,17
625586,377898,2014-08-20,Assembly,"SB 1384 Mitchell  Senate Third Reading  By DICKINSON",48,26,0,5,79
625586,378035,2014-08-21,Senate,"Unfinished Business SB1384 Mitchell Concurrence",24,10,6,0,40
625589,358544,2014-04-22,Assembly,"Do pass and be re-referred to the Committee on Appropriations",19,0,0,0,19
625589,361198,2014-04-30,Assembly,"Do pass, to Consent Calendar",17,0,0,0,17
625589,363350,2014-05-08,Assembly,"AB 2275 RIDLEY-THOMAS  Consent Calendar Second Day  Regular Session",73,0,0,6,79
625589,374289,2014-06-24,Senate,"Do pass, but re-refer to the Committee on Appropriations",3,4,0,0,7
625590,359245,2014-04-23,Assembly,"Do pass and be re-referred to the Committee on Judiciary",6,0,0,3,9
625590,360619,2014-04-29,Assembly,"Do pass as amended and be re-referred to the Committee on 	Appropriations",4,3,0,3,10
625591,360546,2014-04-28,Assembly,"Do pass and be re-referred to the Committee on Appropriations",3,5,0,1,9
625593,363027,2014-05-07,Assembly,"Do pass",6,0,0,1,7
625593,365385,2014-05-19,Assembly,"AB 2575 CAMPOS  Assembly Third Reading",76,0,0,3,79
625596,363180,2014-05-06,Senate,"Do pass",5,2,0,0,7
625596,368597,2014-05-29,Senate,"Senate 3rd Reading SB1407 Jackson",30,5,5,0,40
625596,374151,2014-06-24,Assembly,"Do pass",9,0,0,1,10
625597,361642,2014-04-30,Assembly,"Do pass and be re-referred to the Committee on Appropriations",5,0,0,2,7
625598,361316,2014-04-29,Senate,"Do pass, but re-refer to the Committee on Appropriations",2,5,0,0,7
625598,361317,2014-04-29,Senate,"Set, first hearing.  Failed passage in Committee.  Reconsideration 	granted",7,0,0,0,7
625600,348104,2014-03-26,Assembly,"Do pass and be re-referred to the Committee on Local Government",6,1,0,0,7
625600,350870,2014-04-02,Assembly,"Do pass as amended and be re-referred to the Committee on 	Appropriations",8,1,0,0,9
625600,361137,2014-04-30,Assembly,"Do pass",12,4,0,1,17
625600,363382,2014-05-08,Assembly,"AB 2280 ALEJO  Assembly Third Reading",57,12,0,10,79
625600,370556,2014-06-10,Senate,"Do pass, but re-refer to the Committee on Governance and Finance",8,2,1,0,11
625600,374473,2014-06-25,Senate,"Do pass, but re-refer to the Committee on Appropriations",4,2,1,0,7
625600,376479,2014-08-04,Senate,"Placed on Appropriations Suspense file",7,0,0,0,7
625600,377148,2014-08-14,Senate,"Do pass as amended",5,1,1,0,7
625600,378200,2014-08-22,Senate,"Assembly 3rd Reading AB2280 Alejo By Lara",25,7,8,0,40
625600,378772,2014-08-27,Assembly,"AB 2280 ALEJO  Concurrence in Senate Amendments",57,19,0,3,79
625601,358717,2014-04-22,Assembly,"Do pass and be re-referred to the Committee on Natural Resources",6,0,0,1,7
625601,360540,2014-04-28,Assembly,"Do pass as amended and be re-referred to the Committee on 	Appropriations",8,0,0,1,9
625601,363148,2014-05-07,Assembly,"Do pass, to Consent Calendar",17,0,0,0,17
625601,364820,2014-05-15,Assembly,"AB 2661 BRADFORD  Consent Calendar Second Day  Regular Session",78,0,0,1,79
625601,372154,2014-06-17,Senate,"Do pass, but re-refer to the Committee on Energy, Utilities and 	Communications",4,0,1,0,5
625601,375275,2014-06-30,Senate,"Placed on Appropriations Suspense file",6,0,1,0,7
625601,377178,2014-08-14,Senate,"Do pass",5,0,2,0,7
625601,378394,2014-08-25,Senate,"Assembly 3rd Reading AB2661 Bradford By Hueso",34,0,6,0,40
625602,361124,2014-04-29,Assembly,"Do pass and be re-referred to the Committee on Appropriations",6,0,0,1,7
625602,367076,2014-05-23,Assembly,"Do pass as amended",17,0,0,0,17
625602,368154,2014-05-28,Assembly,"AB 2621 GARCIA  Assembly Third Reading",78,0,0,1,79
625602,374471,2014-06-24,Senate,"Do pass as amended, and re-refer to the Committee on Appropriations",4,0,1,0,5
625602,377603,2014-08-18,Senate,"Assembly 3rd Reading AB2621 Garcia By Fuller",36,0,4,0,40
625602,377807,2014-08-19,Assembly,"AB 2621 GARCIA  Concurrence in Senate Amendments",78,0,0,1,79
625603,360589,2014-04-28,Assembly,"Do pass as amended and be re-referred to the Committee on 	Appropriations",8,0,0,1,9
625603,363413,2014-05-08,Assembly,"AB 2467 NESTANDE  Assembly Third Reading",73,0,0,6,79
625603,372571,2014-06-18,Senate,"Do pass, but re-refer to the Committee on Appropriations",7,0,0,0,7
625603,375263,2014-06-30,Senate,"Placed on Appropriations Suspense file",6,0,1,0,7
625603,377471,2014-08-14,Senate,"Do pass",5,0,2,0,7
625603,378538,2014-08-26,Senate,"Assembly 3rd Reading AB2467 Nestande By Hill",34,0,6,0,40
625604,361859,2014-04-30,Senate,"Do pass as amended, and re-refer to the Committee on Appropriations",9,0,0,0,9
625604,365423,2014-05-19,Senate,"Placed on Appropriations Suspense file",7,0,0,0,7
625606,360566,2014-04-29,Assembly,"Do pass as amended",7,0,0,0,7
625606,364802,2014-05-15,Assembly,"AB 2673 BRADFORD  Assembly Third Reading",75,1,0,3,79
625606,372249,2014-06-17,Senate,"Do pass",5,0,2,0,7
625606,378881,2014-08-28,Senate,"Assembly 3rd Reading AB2673 Bradford By Mitchell",37,0,3,0,40
625607,358388,2014-04-22,Assembly,"Do pass and be re-referred to the Committee on Local Government",6,3,0,1,10
625607,361593,2014-04-30,Assembly,"Do pass and be re-referred to the Committee on Appropriations",5,1,0,3,9
625607,368699,2014-05-29,Assembly,"AB 2561 BRADFORD  Assembly Third Reading",53,24,0,2,79
625607,372165,2014-06-17,Senate,"Do pass, but re-refer to the Committee on Judiciary",10,1,0,0,11
625607,374341,2014-06-24,Senate,"Do pass as amended",7,0,0,0,7
625607,378078,2014-08-21,Senate,"Assembly 3rd Reading AB2561 Bradford By Lara",30,4,6,0,40
625607,378792,2014-08-27,Assembly,"AB 2561 BRADFORD  Concurrence in Senate Amendments",56,22,0,1,79
625609,359423,2014-04-23,Assembly,"Do pass and be re-referred to the Committee on Health",5,1,0,1,7
625609,360635,2014-04-29,Assembly,"Do pass as amended and be re-referred to the Committee on 	Appropriations",13,6,0,0,19
625609,366716,2014-05-23,Assembly,"Do pass as amended",12,5,0,0,17
625609,368619,2014-05-29,Assembly,"AB 2706 HERNANDEZ  Assembly Third Reading",57,20,0,2,79
625609,374444,2014-06-25,Senate,"Do pass as amended, and re-refer to the Committee on Appropriations",4,2,1,0,7
625609,376639,2014-08-04,Senate,"Placed on Appropriations Suspense file",7,0,0,0,7
625609,377398,2014-08-14,Senate,"Do pass",5,0,2,0,7
625609,378468,2014-08-26,Senate,"Assembly 3rd Reading AB2706 Roger Hern",25,9,6,0,40
625609,378704,2014-08-27,Assembly,"AB 2706 HERNANDEZ  Concurrence in Senate Amendments",55,22,0,2,79
625610,358528,2014-04-22,Assembly,"Do pass as amended and be re-referred to the Committee on 	Appropriations",5,2,0,0,7
625611,354457,2014-04-09,Senate,"Do pass as amended",9,0,0,0,9
625611,361670,2014-05-01,Senate,"Senate 3rd Reading SB1301 DeSaulnier",36,0,4,0,40
625611,370747,2014-06-09,Assembly,"Do pass as amended and be re-referred to the Committee on Judiciary",10,2,0,0,12
625611,374190,2014-06-24,Assembly,"Do pass as amended",9,0,0,1,10
625611,377660,2014-08-18,Assembly,"SB 1301 DeSaulnier  Senate Third Reading  By ACHADJIAN",64,14,0,1,79
625611,377743,2014-08-19,Senate,"Unfinished Business SB1301 DeSaulnier Concurrence",34,0,6,0,40
625612,360701,2014-04-29,Assembly,"Do pass and be re-referred to the Committee on Appropriations",10,0,0,0,10
625612,364471,2014-05-14,Assembly,"Do pass",13,1,0,3,17
625612,365317,2014-05-19,Assembly,"AB 2344 AMMIANO  Assembly Third Reading",62,4,0,13,79
625612,372748,2014-06-17,Senate,"Do pass as amended, and re-refer to the Committee on 	Appropriations",6,0,1,0,7
625612,377700,2014-08-18,Senate,"Assembly 3rd Reading AB2344 Ammiano By Jackson",28,3,9,0,40
625612,377965,2014-08-20,Assembly,"AB 2344 AMMIANO  Concurrence in Senate Amendments",65,5,0,9,79
625613,360503,2014-04-29,Assembly,"Do pass and be re-referred to the Committee on Labor and Employment",8,0,0,2,10
625614,360801,2014-04-29,Assembly,"Do pass",5,0,0,2,7
625614,367004,2014-05-23,Assembly,"AB 2515 DONNELLY  Assembly Third Reading",34,16,0,29,79
625615,358969,2014-04-22,Assembly,"Do pass and be re-referred to the Committee on Appropriations",6,0,0,1,7
625615,361068,2014-04-30,Assembly,"Do pass, to Consent Calendar",17,0,0,0,17
625615,365391,2014-05-19,Assembly,"AB 2692 FONG  Assembly Third Reading",76,0,0,3,79
625615,372237,2014-06-17,Senate,"Do pass, but re-refer to the Committee on Appropriations",4,0,1,0,5
625615,377435,2014-08-14,Senate,"Assembly 3rd Reading AB2692 Fong By Jackson",34,0,6,0,40
625618,360896,2014-04-29,Assembly,"Do pass and be re-referred to the Committee on Appropriations",13,0,0,0,13
625618,366918,2014-05-23,Assembly,"Do pass as amended",13,0,0,4,17
625618,368197,2014-05-28,Assembly,"AB 2377 PEREZ, J.  Assembly Third Reading",74,2,0,3,79
625618,374610,2014-06-25,Senate,"Do pass, but re-refer to the Committee on Appropriations",5,1,1,0,7
625618,376584,2014-08-04,Senate,"Placed on Appropriations Suspense file",7,0,0,0,7
625618,377576,2014-08-14,Senate,"Do pass as amended",5,0,2,0,7
625618,378417,2014-08-25,Senate,"Assembly 3rd Reading AB2377 John A. P",29,5,6,0,40
625618,378648,2014-08-27,Assembly,"AB 2377 PEREZ, J.  Concurrence in Senate Amendments",72,4,0,3,79
625619,361239,2014-04-30,Senate,"Do pass",4,2,1,0,7
625619,364932,2014-05-15,Senate,"Senate 3rd Reading SB1335 Leno",22,13,5,0,40
625619,375033,2014-06-25,Assembly,"Do pass as amended",6,3,0,0,9
625619,376697,2014-08-06,Assembly,"Do pass",11,6,0,0,17
625619,377143,2014-08-14,Assembly,"SB 1335 Leno  Senate Third Reading  By PAN",54,23,0,2,79
625619,377796,2014-08-19,Senate,"Unfinished Business SB1335 Leno Concurrence",24,10,6,0,40
625620,353230,2014-04-07,Assembly,"Do pass and be re-referred to the Committee on Local Government to 	Consent Calendar",12,0,0,0,12
625620,359284,2014-04-23,Assembly,"Do pass and be re-referred to the Committee on Appropriations to 	Consent Calendar",8,0,0,1,9
625620,361260,2014-04-30,Assembly,"Do pass, to Consent Calendar",17,0,0,0,17
625620,363325,2014-05-08,Assembly,"AB 2298 RODRIGUEZ  Consent Calendar Second Day  Regular Session",73,0,0,6,79
625620,369964,2014-06-04,Senate,"Do pass as amended, and re-refer to the Committee on Appropriations",8,0,1,0,9
625620,375680,2014-07-03,Senate,"Special Consent #18 AB2298 Rodriguez",35,0,5,0,40
625620,376386,2014-08-04,Assembly,"AB 2298 RODRIGUEZ  Concurrence in Senate Amendments",78,0,0,1,79
625622,353667,2014-04-07,Assembly,"Do pass as amended and be re-referred to the Committee on 	Appropriations",10,1,0,4,15
625622,367065,2014-05-23,Assembly,"Do pass as amended",12,0,0,5,17
625622,368746,2014-05-29,Assembly,"AB 2672 PEREA  Assembly Third Reading",61,7,0,11,79
625622,374104,2014-06-23,Senate,"Do pass as amended, and re-refer to the Committee on Appropriations",8,2,1,0,11
625622,376543,2014-08-04,Senate,"Placed on Appropriations Suspense file",7,0,0,0,7
625622,377505,2014-08-14,Senate,"Do pass",5,0,2,0,7
625622,378388,2014-08-25,Senate,"Assembly 3rd Reading AB2672 Perea By Cannella",24,9,7,0,40
625622,378829,2014-08-27,Assembly,"AB 2672 PEREA  Concurrence in Senate Amendments",60,13,0,6,79
625623,362820,2014-05-06,Assembly,"Do pass and be re-referred to the Committee on Revenue and Taxation",6,0,0,1,7
625623,364383,2014-05-13,Assembly,"Do pass and be re-referred to the Committee on Appropriations",8,0,0,1,9
625624,359650,2014-04-23,Assembly,"Do pass and be re-referred to the Committee on Appropriations",2,5,0,0,7
625625,359384,2014-04-22,Assembly,"Do pass and be re-referred to the Committee on Appropriations",13,0,0,0,13
625625,366959,2014-05-23,Assembly,"Do pass",17,0,0,0,17
625625,367620,2014-05-27,Assembly,"AB 2721 PAN  Assembly Third Reading",77,0,0,2,79
625625,374634,2014-06-25,Senate,"Do pass as amended, and re-refer to the Committee on Appropriations",4,0,3,0,7
625625,376538,2014-08-04,Senate,"Placed on Appropriations Suspense file",7,0,0,0,7
625625,377553,2014-08-14,Senate,"Do pass as amended",5,0,2,0,7
625625,378317,2014-08-25,Senate,"Assembly 3rd Reading AB2721 Pan By Liu",33,1,6,0,40
625625,378489,2014-08-26,Assembly,"AB 2721 PAN  Concurrence in Senate Amendments",78,0,0,1,79
625626,360748,2014-04-29,Assembly,"Do pass",11,2,0,2,15
625626,367627,2014-05-27,Assembly,"AB 2662 GATTO  Assembly Third Reading",61,9,0,9,79
625626,370474,2014-06-10,Senate,"Do pass",6,0,3,0,9
625627,359908,2014-04-24,Senate,"Do pass as amended, and re-refer to the Committee on 	Appropriations",8,0,1,0,9
625627,368164,2014-05-28,Senate,"Senate 3rd Reading SB1315 Monning",35,0,5,0,40
625627,374489,2014-06-24,Assembly,"Do pass as amended and re-refer to Committee on Appropriations 	with recommendation:  To Consent Calendar",17,0,0,2,19
625627,376723,2014-08-06,Assembly,"Do pass, to Consent Calendar",17,0,0,0,17
625627,377152,2014-08-14,Assembly,"SB 1315 Monning  Consent Calendar Second Day  Regular Session",78,0,0,1,79
625627,377717,2014-08-18,Senate,"Unfinished Business SB1315 Monning Concurrence",36,0,4,0,40
625631,355136,2014-04-09,Assembly,"Do pass as amended and be re-referred to the Committee on 	Appropriations",7,0,0,0,7
625631,361336,2014-04-30,Assembly,"Do pass, to Consent Calendar",17,0,0,0,17
625631,363369,2014-05-08,Assembly,"AB 2560 BONILLA  Consent Calendar Second Day  Regular Session",73,0,0,6,79
625631,369974,2014-06-04,Senate,"Do pass, but re-refer to the Committee on Appropriations Recommend 	Consent",6,0,1,0,7
625631,374747,2014-06-26,Senate,"Consent Calendar 2nd AB2560 Bonilla",32,0,8,0,40
625633,354262,2014-04-09,Assembly,"Do pass and be re-referred to the Committee on Transportation",9,0,0,0,9
625633,360576,2014-04-28,Assembly,"Do pass and be re-referred to the Committee on Appropriations",13,0,0,3,16
625633,362944,2014-05-07,Assembly,"Do pass, to Consent Calendar",17,0,0,0,17
625633,364941,2014-05-15,Assembly,"AB 2355 LEVINE  Consent Calendar Second Day  Regular Session",78,0,0,1,79
625633,372229,2014-06-17,Senate,"Do pass, but re-refer to the Committee on Appropriations Recommend 	Consent",11,0,0,0,11
625633,375486,2014-06-30,Senate,"Placed on Appropriations Suspense file",6,0,1,0,7
625633,377468,2014-08-14,Senate,"Do pass",5,0,2,0,7
625633,377886,2014-08-20,Senate,"Assembly 3rd Reading AB2355 Levine By Wolk",35,0,5,0,40
625633,378015,2014-08-21,Assembly,"AB 2355 LEVINE  Concurrence in Senate Amendments",79,0,0,0,79
625634,358705,2014-04-22,Assembly,"Do pass and be re-referred to the Committee on Arts, Entertain, 	Sports, Tourism, & Internet Media",7,0,0,0,7
625634,360575,2014-04-29,Assembly,"Do pass and be re-referred to the Committee on Appropriations",6,0,0,1,7
625634,363133,2014-05-07,Assembly,"Do pass",17,0,0,0,17
625634,364897,2014-05-15,Assembly,"AB 2457 LEVINE  Assembly Third Reading",76,0,0,3,79
625634,374576,2014-06-24,Senate,"Do pass, but re-refer to the Committee on Appropriations",6,1,0,0,7
625634,376472,2014-08-04,Senate,"Placed on Appropriations Suspense file",7,0,0,0,7
625641,358437,2014-04-22,Senate,"Do pass, but re-refer to the Committee on Appropriations Recommend 	Consent",9,0,0,0,9
625641,362356,2014-05-05,Senate,"Placed on Appropriations Suspense file",7,0,0,0,7
625648,362988,2014-05-07,Assembly,"Do pass",5,1,0,3,9
625648,368280,2014-05-28,Assembly,"AB 2492 JONES-SAWYER  Assembly Third Reading  Amend By JONES-SAWYER 	Set #1",67,2,0,10,79
625648,368609,2014-05-29,Assembly,"AB 2492 JONES-SAWYER  Assembly Third Reading",48,23,0,8,79
625648,374613,2014-06-24,Senate,"Do pass",5,2,0,0,7
625648,378092,2014-08-21,Senate,"Assembly 3rd Reading AB2492 Jones-Sawyer Lay on Table",23,10,7,0,40
625648,378093,2014-08-21,Senate,"Assembly 3rd Reading AB2492 Jones-Sawyer By Mitchell",21,11,8,0,40
625651,358404,2014-04-21,Assembly,"Do pass and be re-referred to the Committee on Appropriations",13,0,0,3,16
625651,366872,2014-05-23,Assembly,"Do pass as amended",16,0,0,1,17
625651,367978,2014-05-28,Assembly,"AB 2398 LEVINE  Assembly Third Reading",72,2,0,5,79
625651,372124,2014-06-17,Senate,"Do pass as amended, and re-refer to the Committee on Public Safety",10,1,0,0,11
625651,376399,2014-08-04,Senate,"Placed on Appropriations Suspense file",7,0,0,0,7
625651,377362,2014-08-14,Senate,"Do pass as amended",5,0,2,0,7
625651,378071,2014-08-21,Senate,"Assembly 3rd Reading AB2398 Levine By Evans",28,3,9,0,40
625651,378287,2014-08-25,Assembly,"AB 2398 LEVINE  Concurrence in Senate Amendments",75,3,0,1,79
625652,359563,2014-04-23,Assembly,"Do pass and be re-referred to the Committee on Appropriations",7,0,0,0,7
625652,363010,2014-05-07,Assembly,"Do pass, to Consent Calendar",17,0,0,0,17
625652,364871,2014-05-15,Assembly,"AB 2536 MULLIN  Consent Calendar Second Day  Regular Session",78,0,0,1,79
625652,371031,2014-06-11,Senate,"Do pass, but re-refer to the Committee on Appropriations",5,0,0,0,5
625652,375676,2014-07-03,Senate,"Special Consent #18 AB2536 Mullin",35,0,5,0,40
625652,377454,2014-08-14,Assembly,"AB 2536 MULLIN  Concurrence in Senate Amendments",79,0,0,0,79
625653,362631,2014-05-06,Assembly,"Do pass as amended",7,0,0,0,7
625653,365390,2014-05-19,Assembly,"AB 2397 FRAZIER  Assembly Third Reading",76,0,0,3,79
625653,370612,2014-06-10,Senate,"Do pass as amended, and re-refer to the Committee on Appropriations",6,0,1,0,7
625653,370967,2014-06-10,Senate,"Do pass as amended",6,0,1,0,7
625653,374766,2014-06-26,Senate,"Special Consent #17 AB2397 Frazier",32,0,8,0,40
625653,375316,2014-06-30,Assembly,"AB 2397 FRAZIER  Concurrence in Senate Amendments",78,0,0,1,79
625654,362852,2014-05-06,Assembly,"Do pass as amended",5,2,0,0,7
625656,353779,2014-04-08,Assembly,"Do pass, to Consent Calendar",7,0,0,0,7
625656,361442,2014-04-30,Assembly,"Do pass, to Consent Calendar",17,0,0,0,17
625656,363368,2014-05-08,Assembly,"AB 2357 SKINNER  Consent Calendar Second Day  Regular Session",73,0,0,6,79
625656,370425,2014-06-10,Senate,"Do pass, but re-refer to the Committee on Appropriations",6,0,1,0,7
625656,375654,2014-07-03,Senate,"Special Consent #18 AB2357 Skinner",35,0,5,0,40
625657,359202,2014-04-22,Senate,"Do pass",4,1,0,0,5
625657,360105,2014-04-28,Senate,"Senate 3rd Reading SB1365 Padilla",23,11,6,0,40
625657,374490,2014-06-24,Assembly,"Do pass as amended",5,1,0,1,7
625657,376877,2014-08-11,Assembly,"SB 1365 Padilla  Senate Third Reading  By PEREZ, J",54,23,0,2,79
625657,377037,2014-08-13,Senate,"Unfinished Business SB1365 Padilla Concurrence",23,12,5,0,40
625658,355122,2014-04-09,Assembly,"Be adopted, to Consent Calendar",7,0,0,0,7
625658,359581,2014-04-24,Assembly,"ACR 108 WAGNER  Consent Calendar Second Day  Regular Session",75,0,0,4,79
625658,366747,2014-05-23,Senate,"Special Consent #15 ACR108 Wagner",32,0,8,0,40
625660,359216,2014-04-22,Assembly,"Do pass as amended and be re-referred to the Committee on 	Appropriations",13,0,0,0,13
625660,364404,2014-05-14,Assembly,"Do pass, to Consent Calendar",17,0,0,0,17
625660,366692,2014-05-23,Assembly,"AB 2350 BONILLA  Consent Calendar Second Day  Regular Session",73,0,0,6,79
625660,374411,2014-06-25,Senate,"Do pass, but re-refer to the Committee on Appropriations Recommend 	Consent",6,0,1,0,7
625660,376589,2014-08-04,Senate,"Placed on Appropriations Suspense file",7,0,0,0,7
625660,377440,2014-08-14,Senate,"Do pass as amended",6,0,1,0,7
625660,377794,2014-08-19,Senate,"Assembly 3rd Reading AB2350 Bonilla By Mitchell",34,0,6,0,40
625660,377919,2014-08-20,Assembly,"AB 2350 BONILLA  Concurrence in Senate Amendments",77,0,0,2,79
625663,362651,2014-05-06,Assembly,"Do pass",10,0,0,3,13
625663,367604,2014-05-27,Assembly,"AB 2705 WILLIAMS  Assembly Third Reading",56,9,0,14,79
625663,374644,2014-06-25,Senate,"Do pass",4,0,3,0,7
625663,376862,2014-08-11,Senate,"Placed on Appropriations Suspense file",7,0,0,0,7
625664,361775,2014-04-30,Assembly,"Do pass",2,2,0,3,7
625665,353200,2014-04-08,Assembly,"Amend, and do pass as amended and be re-referred to the Committee 	on Aging and Long",7,0,0,0,7
625665,358395,2014-04-22,Assembly,"Do pass as amended and be re-referred to the Committee on 	Appropriations",7,0,0,0,7
625665,366867,2014-05-23,Assembly,"Do pass as amended",16,0,0,1,17
625665,368605,2014-05-29,Assembly,"AB 2623 PAN  Assembly Third Reading",78,0,0,1,79
625665,374457,2014-06-24,Senate,"Do pass, but re-refer to the Committee on Appropriations",7,0,0,0,7
625665,376659,2014-08-04,Senate,"Do pass",7,0,0,0,7
625665,377890,2014-08-20,Senate,"Assembly 3rd Reading AB2623 Pan By Gaines",35,0,5,0,40
625666,358599,2014-04-22,Assembly,"Do pass and be re-referred to the Committee on Public Safety",18,0,0,1,19
625666,360662,2014-04-29,Assembly,"Subject matter be referred",4,0,0,3,7
625667,360491,2014-04-29,Assembly,"Do pass and be re-referred to the Committee on Appropriations",5,1,0,1,7
625667,366837,2014-05-23,Assembly,"Do pass",12,0,0,5,17
625667,368166,2014-05-28,Assembly,"AB 2501 BONILLA  Assembly Third Reading",50,18,0,11,79
625667,374375,2014-06-24,Senate,"Do pass, but re-refer to the Committee on Appropriations",5,2,0,0,7
625667,376431,2014-08-04,Senate,"Placed on Appropriations Suspense file",7,0,0,0,7
625667,377392,2014-08-14,Senate,"Do pass",5,1,1,0,7
625667,378472,2014-08-26,Senate,"Assembly 3rd Reading AB2501 Bonilla By Lara",25,9,6,0,40
625667,378715,2014-08-27,Assembly,"AB 2501 BONILLA  Concurrence in Senate Amendments",58,15,0,6,79
625668,355227,2014-04-09,Assembly,"Do pass as amended and be re-referred to the Committee on Arts, 	Entertain, Sports, Tourism, & Internet Media",5,1,0,1,7
625668,360708,2014-04-29,Assembly,"Do pass",6,1,0,0,7
625668,362188,2014-05-05,Assembly,"AB 2512 BONILLA  Assembly Third Reading",60,11,0,8,79
625668,369923,2014-06-04,Senate,"Do pass as amended",6,0,1,0,7
625668,378568,2014-08-26,Senate,"Assembly 3rd Reading AB2512 Bonilla By Jackson",33,0,7,0,40
625668,378733,2014-08-27,Assembly,"AB 2512 BONILLA  Concurrence in Senate Amendments",69,4,0,6,79
625670,354585,2014-04-09,Assembly,"Do pass",9,0,0,0,9
625670,359580,2014-04-24,Assembly,"AB 2259 RIDLEY-THOMAS  Assembly Third Reading",75,0,0,4,79
625670,374350,2014-06-24,Senate,"Do pass as amended",7,0,0,0,7
625670,377874,2014-08-19,Senate,"Assembly 3rd Reading AB2259 Ridley-Thomas By Pavley",34,0,6,0,40
625670,377971,2014-08-20,Assembly,"AB 2259 RIDLEY-THOMAS  Concurrence in Senate Amendments",77,0,0,2,79
625671,360501,2014-04-28,Assembly,"Do pass as amended and be re-referred to the Committee on 	Appropriations",5,2,0,2,9
625671,367108,2014-05-23,Assembly,"Do pass",12,4,0,1,17
625671,368054,2014-05-28,Assembly,"AB 2516 GORDON  Assembly Third Reading",56,20,0,3,79
625671,374121,2014-06-24,Senate,"Do pass as amended, and re-refer to the Committee on Appropriations",8,1,0,0,9
625671,376587,2014-08-04,Senate,"Placed on Appropriations Suspense file",7,0,0,0,7
625671,377507,2014-08-14,Senate,"Do pass",5,0,2,0,7
625671,378307,2014-08-25,Senate,"Assembly 3rd Reading AB2516 Gordon By Leno",23,10,7,0,40
625671,378694,2014-08-27,Assembly,"AB 2516 GORDON  Concurrence in Senate Amendments",57,20,0,2,79
625673,359158,2014-04-23,Assembly,"Do pass and be re-referred to the Committee on Appropriations",6,0,0,1,7
625673,361262,2014-04-30,Assembly,"Do pass, to Consent Calendar",17,0,0,0,17
625673,363457,2014-05-08,Assembly,"AB 2582 BONTA  Consent Calendar Second Day  Regular Session",73,0,0,6,79
625673,370184,2014-06-09,Senate,"Do pass as amended, and re-refer to the Committee on 	Appropriations",5,0,0,0,5
625673,373739,2014-06-23,Senate,"Do pass",7,0,0,0,7
625673,375659,2014-07-03,Senate,"Special Consent #18 AB2582 Bonta",35,0,5,0,40
625673,376362,2014-08-04,Assembly,"AB 2582 BONTA  Concurrence in Senate Amendments",77,0,0,2,79
625674,360628,2014-04-29,Assembly,"Do pass and re-refer to Committee on Appropriations with 	recommendation:  To Consent Calendar",7,0,0,0,7
625674,363175,2014-05-07,Assembly,"Do pass, to Consent Calendar",17,0,0,0,17
625674,364947,2014-05-15,Assembly,"AB 2570 SKINNER  Consent Calendar Second Day  Regular Session",78,0,0,1,79
625674,370515,2014-06-10,Senate,"Do pass, but re-refer to the Committee on Appropriations",5,0,2,0,7
625674,375694,2014-07-03,Senate,"Special Consent #18 AB2570 Skinner",35,0,5,0,40
625674,377665,2014-08-18,Senate,"Assembly 3rd Reading AB2570 Skinner By Liu",36,0,4,0,40
625674,377747,2014-08-19,Assembly,"AB 2570 SKINNER  Concurrence in Senate Amendments",78,0,0,1,79
625675,354742,2014-04-09,Assembly,"Do pass and be re-referred to the Committee on Appropriations",8,2,0,3,13
625675,366900,2014-05-23,Assembly,"Do pass",12,4,0,1,17
625675,367985,2014-05-28,Assembly,"AB 2675 LOWENTHAL  Assembly Third Reading",52,23,0,4,79
625675,374056,2014-06-24,Senate,"Do pass, but re-refer to the Committee on Appropriations",7,3,0,0,10
625675,377008,2014-08-11,Senate,"Placed on Appropriations Suspense file",7,0,0,0,7
625675,377140,2014-08-14,Senate,"Do pass",5,0,2,0,7
625675,378745,2014-08-27,Senate,"Assembly 3rd Reading AB2675 Lowenthal By DeSaulnier",23,12,5,0,40
625675,378934,2014-08-28,Assembly,"AB 2675 LOWENTHAL  Concurrence in Senate Amendments",51,25,0,3,79
625676,362813,2014-05-06,Assembly,"Do pass",4,1,0,2,7
625676,367984,2014-05-28,Assembly,"AB 2369 HAGMAN  Assembly Third Reading",66,7,0,6,79
625676,374579,2014-06-24,Senate,"Do pass",5,0,0,0,5
625676,377016,2014-08-11,Senate,"Assembly 3rd Reading AB2369 Hagman By Anderson",36,0,4,0,40
625676,377632,2014-08-18,Assembly,"AB 2369 HAGMAN  Concurrence in Senate Amendments",72,0,0,7,79
625677,360960,2014-04-29,Assembly,"Do pass as amended",5,2,0,0,7
625677,363358,2014-05-08,Assembly,"AB 2442 GORDON  Assembly Third Reading",52,22,0,5,79
625677,372895,2014-06-18,Senate,"Do pass, but re-refer to the Committee on Judiciary",5,2,0,0,7
625677,374300,2014-06-24,Senate,"Do pass as amended",5,2,0,0,7
625677,378348,2014-08-25,Senate,"Assembly 3rd Reading AB2442 Gordon By Hill",22,12,6,0,40
625677,378815,2014-08-27,Assembly,"AB 2442 GORDON  Concurrence in Senate Amendments",54,24,0,1,79
625678,361209,2014-04-29,Assembly,"Do pass and be re-referred to the Committee on Appropriations",5,0,0,2,7
625678,366965,2014-05-23,Assembly,"Do pass as amended",13,0,0,4,17
625678,368040,2014-05-28,Assembly,"AB 2591 WEBER  Assembly Third Reading",78,0,0,1,79
625678,374520,2014-06-24,Senate,"Do pass, but re-refer to the Committee on Appropriations Recommend 	Consent",4,0,1,0,5
625678,376556,2014-08-04,Senate,"Placed on Appropriations Suspense file",7,0,0,0,7
625680,361619,2014-04-30,Assembly,"Do pass and re-refer to Committee on Appropriations with 	recommendation:  To Consent Calendar",7,0,0,0,7
625681,360553,2014-04-28,Assembly,"Do pass as amended and be re-referred to the Committee on 	Appropriations",7,1,0,1,9
625683,374900,2014-06-26,Assembly,"Do pass",9,0,0,0,9
625683,374901,2014-06-26,Assembly,"AB 2389 FOX  Third Reading Urgency",72,2,0,5,79
625683,375502,2014-07-01,Senate,"Do pass as amended, and re-refer to the Committee on Appropriations",4,2,1,0,7
625683,375655,2014-07-03,Senate,"Do pass",6,0,1,0,7
625683,375656,2014-07-03,Assembly,"AB 2389 FOX  Concurrence in Senate Amendments",68,2,0,9,79
625683,375657,2014-07-03,Senate,"W/O REF. TO FILE AB2389 Fox Urgency Clause",28,6,6,0,40
625684,360524,2014-04-29,Assembly,"Do pass and be re-referred to the Committee on Appropriations",12,2,0,0,14
625684,364657,2014-05-14,Assembly,"Do pass",16,0,0,1,17
625684,365322,2014-05-19,Assembly,"AB 2624 MEDINA  Assembly Third Reading",69,4,0,6,79
625684,374543,2014-06-24,Senate,"Do pass as amended, and re-refer to the Committee on 	Appropriations",5,2,0,0,7
625685,350375,2014-04-01,Assembly,"Be adopted, to Consent Calendar",10,0,0,1,11
625685,351844,2014-04-03,Assembly,"ACR 106 GORDON  Consent Calendar Second Day",76,0,0,3,79
625685,362382,2014-05-05,Senate,"Assembly 3rd Reading ACR106 Gordon",36,0,4,0,40
625686,350578,2014-04-01,Assembly,"Do pass and re-refer to Committee on Appropriations with 	recommendation:  To Consent Calendar",7,0,0,0,7
625686,354356,2014-04-09,Assembly,"Do pass, to Consent Calendar",17,0,0,0,17
625686,359783,2014-04-24,Assembly,"AB 2320 FONG  Consent Calendar Second Day  Regular Session",75,0,0,4,79
625686,372131,2014-06-17,Senate,"Do pass, but re-refer to the Committee on Appropriations",4,0,1,0,5
625686,378004,2014-08-20,Senate,"Assembly 3rd Reading AB2320 Fong By Jackson",33,1,6,0,40
625687,352947,2014-04-07,Senate,"Do pass, but re-refer to the Committee on Judiciary",8,0,1,0,9
625687,359248,2014-04-22,Senate,"Do pass as amended, and re-refer to the Committee on 	Appropriations",6,0,1,0,7
625687,364887,2014-05-15,Senate,"Special Consent #14 SB1256 Mitchell",36,0,4,0,40
625687,374027,2014-06-24,Assembly,"Do pass as amended and re-refer to Committee on Appropriations 	with recommendation:  To Consent Calendar",14,0,0,0,14
625687,375563,2014-07-02,Assembly,"Do pass, to Consent Calendar",17,0,0,0,17
625687,376848,2014-08-07,Assembly,"SB 1256 Mitchell  Consent Calendar Second Day  Regular Session",77,0,0,2,79
625687,376885,2014-08-11,Senate,"Unfinished Business SB1256 Mitchell Concurrence",35,0,5,0,40
625691,360458,2014-04-29,Assembly,"Do pass as amended and be re-referred to the Committee on 	Appropriations",13,4,0,2,19
625691,367036,2014-05-23,Assembly,"Do pass as amended",12,0,0,5,17
625691,368242,2014-05-28,Assembly,"AB 2612 DABABNEH  Assembly Third Reading",69,1,0,9,79
625691,373109,2014-06-18,Senate,"Do pass, but re-refer to the Committee on Appropriations",6,1,2,0,9
625691,376583,2014-08-04,Senate,"Placed on Appropriations Suspense file",7,0,0,0,7
625691,377538,2014-08-14,Senate,"Do pass as amended",5,0,2,0,7
625691,378360,2014-08-25,Senate,"Assembly 3rd Reading AB2612 Dababneh By Beall",32,1,7,0,40
625691,378824,2014-08-27,Assembly,"AB 2612 DABABNEH  Concurrence in Senate Amendments",74,2,0,3,79
625692,363275,2014-05-07,Assembly,"Do pass, to Consent Calendar",12,0,0,1,13
625692,364938,2014-05-15,Assembly,"AB 2279 HAGMAN  Consent Calendar Second Day  Regular Session",78,0,0,1,79
625692,371155,2014-06-11,Senate,"Do pass",10,0,1,0,11
625692,374795,2014-06-26,Senate,"Special Consent #17 AB2279 Hagman",32,0,8,0,40
625693,359619,2014-04-24,Assembly,"Be referred to Committee on Water, Parks and Wildlife",10,0,0,1,11
625693,360700,2014-04-29,Assembly,"Do pass and be re-referred to the Committee on Appropriations",10,5,0,0,15
625694,360762,2014-04-29,Assembly,"Do pass and re-refer to Committee on Appropriations with 	recommendation:  To Consent Calendar",7,0,0,0,7
625694,367050,2014-05-23,Assembly,"Do pass",17,0,0,0,17
625694,368176,2014-05-28,Assembly,"AB 2690 MULLIN  Assembly Third Reading",79,0,0,0,79
625694,374607,2014-06-24,Senate,"Do pass, but re-refer to the Committee on Appropriations",7,0,0,0,7
625694,376651,2014-08-04,Senate,"Placed on Appropriations Suspense file",7,0,0,0,7
625694,377502,2014-08-14,Senate,"Do pass",5,0,2,0,7
625694,378357,2014-08-25,Senate,"Assembly 3rd Reading AB2690 Mullin By Hill",35,0,5,0,40
625695,353215,2014-04-08,Senate,"Do pass, but re-refer to the Committee on Appropriations",8,2,1,0,11
625695,362242,2014-05-05,Senate,"Placed on Appropriations Suspense file",7,0,0,0,7
625698,353598,2014-04-08,Assembly,"Do pass and be re-referred to the Committee on Appropriations",5,0,0,2,7
625698,361074,2014-04-30,Assembly,"Do pass",12,0,0,5,17
625698,362289,2014-05-05,Assembly,"AB 2499 BONILLA  Assembly Third Reading",56,0,0,23,79
625698,372238,2014-06-17,Senate,"Do pass as amended, and re-refer to the Committee on Appropriations",5,0,2,0,7
625698,376524,2014-08-04,Senate,"Do pass",5,2,0,0,7
625698,376883,2014-08-11,Senate,"Assembly 3rd Reading AB2499 Bonilla By DeSaulnier",27,8,5,0,40
625698,377691,2014-08-18,Assembly,"AB 2499 BONILLA  Concurrence in Senate Amendments",53,17,0,9,79
625699,350262,2014-04-01,Assembly,"Do pass",7,0,0,3,10
625699,357955,2014-04-21,Assembly,"AB 2607 SKINNER  Assembly Third Reading",62,0,0,17,79
625699,370535,2014-06-10,Senate,"Do pass as amended, and re-refer to the Committee on Appropriations",5,0,2,0,7
625699,378492,2014-08-26,Senate,"Assembly 3rd Reading AB2607 Skinner By Mitchell",33,1,6,0,40
625699,378738,2014-08-27,Assembly,"AB 2607 SKINNER  Concurrence in Senate Amendments",78,0,0,1,79
625700,364254,2014-05-13,Assembly,"Do pass as amended and be re-referred to the Committee on 	Appropriations",8,0,0,1,9
625701,359622,2014-04-24,Senate,"Do pass, but re-refer to the Committee on Appropriations",6,0,1,0,7
625701,362290,2014-05-05,Senate,"Placed on Appropriations Suspense file",7,0,0,0,7
625701,367134,2014-05-23,Senate,"Do pass",7,0,0,0,7
625701,368232,2014-05-28,Senate,"Senate 3rd Reading SB1413 Wyland",37,0,3,0,40
625701,374115,2014-06-23,Assembly,"Do pass and re-refer to Committee on Appropriations with 	recommendation:  To Consent Calendar",9,0,0,0,9
625702,358459,2014-04-22,Senate,"Do pass, but re-refer to the Committee on Appropriations",7,0,0,0,7
625702,367461,2014-05-27,Senate,"Senate 3rd Reading SB1388 Lieu",34,0,6,0,40
625702,374022,2014-06-24,Assembly,"Do pass as amended and be re-referred to the Committee on 	Appropriations",7,0,0,0,7
625702,377703,2014-08-18,Assembly,"SB 1388 Lieu  Senate Third Reading  By COOLEY",77,0,0,2,79
625702,378128,2014-08-21,Senate,"Unfinished Business SB1388 Lieu",32,0,8,0,40
625703,350981,2014-04-02,Senate,"Do pass as amended, and re-refer to the Committee on Governance and 	Finance",5,0,4,0,9
625703,361077,2014-04-30,Senate,"Do pass as amended, and re-refer to the Committee on Appropriations",4,2,1,0,7
625703,365302,2014-05-19,Senate,"Placed on Appropriations Suspense file",7,0,0,0,7
625703,366679,2014-05-23,Senate,"Do pass as amended",6,1,0,0,7
625703,368080,2014-05-28,Senate,"Senate 3rd Reading SB1455 DeSaulnier",31,4,5,0,40
625703,374868,2014-06-25,Assembly,"Do pass and be re-referred to the Committee on Appropriations",7,0,0,0,7
625703,375521,2014-07-02,Assembly,"Do pass",13,3,0,1,17
625703,377255,2014-08-14,Assembly,"SB 1455 DeSaulnier  Senate Third Reading  By BONILLA",65,12,0,2,79
625704,364441,2014-05-13,Assembly,"Do pass and be re-referred to the Committee on Appropriations",6,0,0,3,9
625705,361606,2014-04-30,Senate,"Do pass as amended, and re-refer to the Committee on Appropriations",8,1,0,0,9
625705,368209,2014-05-28,Senate,"Senate 3rd Reading SB1263 Pavley",21,12,7,0,40
625705,374813,2014-06-25,Assembly,"Do pass as amended",5,2,0,0,7
625705,378496,2014-08-26,Assembly,"SB 1263 Pavley  Senate Third Reading  By BUCHANAN",48,25,0,6,79
625705,378895,2014-08-28,Senate,"Unfinished Business SB1263 Pavley",23,11,6,0,40
625706,360514,2014-04-28,Assembly,"Do pass and re-refer to Committee on Appropriations with 	recommendation:  To Consent Calendar",15,0,0,1,16
625706,367117,2014-05-23,Assembly,"Do pass",17,0,0,0,17
625706,367482,2014-05-27,Assembly,"AB 2450 LOGUE  Assembly Third Reading",76,0,0,3,79
625706,374917,2014-06-26,Senate,"Do pass, but re-refer to the Committee on Appropriations Recommend 	Consent",10,0,1,0,11
625706,376496,2014-08-04,Senate,"Placed on Appropriations Suspense file",7,0,0,0,7
625706,377438,2014-08-14,Senate,"Do pass",5,0,2,0,7
625706,377999,2014-08-20,Senate,"Assembly 3rd Reading AB2450 Logue By Cannella",35,0,5,0,40
625707,358917,2014-04-22,Assembly,"Do pass and be re-referred to the Committee on Health",3,6,0,1,10
625707,358918,2014-04-22,Assembly,"Set second hearing.  Failed passage.  Reconsideration granted",10,0,0,0,10
625708,361422,2014-04-29,Assembly,"Do pass as amended and re-refer to Committee on Appropriations 	with recommendation:  To Consent Calendar",7,0,0,0,7
625708,366492,2014-05-21,Assembly,"Do pass, to Consent Calendar",17,0,0,0,17
625708,367525,2014-05-27,Assembly,"AB 2386 MULLIN  Consent Calendar Second Day  Regular Session",77,0,0,2,79
625708,374630,2014-06-24,Senate,"Do pass as amended, but re-refer to the Committee on Appropriations 	Recommend Consent",4,0,1,0,5
625708,376820,2014-08-07,Senate,"Consent Calendar 2nd AB2386 Mullin",34,0,6,0,40
625708,378294,2014-08-25,Senate,"Assembly 3rd Reading AB2386 Mullin By Berryhill",33,0,7,0,40
625708,378461,2014-08-26,Assembly,"AB 2386 MULLIN  Concurrence in Senate Amendments",79,0,0,0,79
625709,358555,2014-04-22,Assembly,"Do pass and be re-referred to the Committee on Appropriations",6,13,0,0,19
625710,360876,2014-04-28,Assembly,"Do pass as amended",8,0,0,1,9
625710,366460,2014-05-21,Assembly,"Do pass",16,0,0,1,17
625710,366997,2014-05-23,Assembly,"AB 2678 RIDLEY-THOMAS  Assembly Third Reading",72,0,0,7,79
625710,374090,2014-06-24,Senate,"Do pass as amended, and re-refer to the Committee on Appropriations",8,0,1,0,9
625710,379010,2014-08-30,Senate,"Assembly 3rd Supp 7 AB2678 Ridley-Thomas Urgency Clause",35,0,5,0,40
625711,359177,2014-04-23,Assembly,"Do pass and re-refer to Committee on Appropriations with 	recommendation:  To Consent Calendar",6,0,0,1,7
625711,363187,2014-05-07,Assembly,"Do pass, to Consent Calendar",17,0,0,0,17
625711,364942,2014-05-15,Assembly,"AB 2476 P.E., R.& S.S.  Consent Calendar Second Day  Regular Session",78,0,0,1,79
625711,373709,2014-06-23,Senate,"Do pass, but re-refer to the Committee on Appropriations Recommend 	Consent",5,0,0,0,5
625711,376818,2014-08-07,Senate,"Consent Calendar 2nd AB2476 Committee on P.E.,R.& S.S.(Bonta)",34,0,6,0,40
625711,376900,2014-08-11,Assembly,"AB 2476 P.E., R.& S.S.  Concurrence in Senate Amendments By BONTA",79,0,0,0,79
625713,361465,2014-04-30,Assembly,"Do pass and be re-referred to the Committee on Judiciary",7,0,0,0,7
625713,361466,2014-04-30,Assembly,"Do pass and be re-referred to the Committee on Judiciary",7,0,0,0,7
625713,362666,2014-05-06,Assembly,"Do pass as amended, to Consent Calendar",10,0,0,0,10
625713,364960,2014-05-15,Assembly,"AB 2430 MAIENSCHEIN  Consent Calendar Second Day  Regular Session",78,0,0,1,79
625713,372818,2014-06-17,Senate,"Do pass",6,0,1,0,7
625713,375716,2014-07-03,Senate,"Special Consent #18 AB2430 Maienschein",35,0,5,0,40
625714,348542,2014-03-26,Senate,"Do pass, but re-refer to the Committee on Rules",5,2,2,0,9
625714,359340,2014-04-22,Senate,"Do pass, but re-refer to the Committee on Agriculture",4,2,1,0,7
625714,363703,2014-05-12,Senate,"Placed on Appropriations Suspense file",7,0,0,0,7
625714,366676,2014-05-23,Senate,"Do pass",5,2,0,0,7
625714,368099,2014-05-28,Senate,"Senate 3rd Reading SB1381 Evans",19,17,4,0,40
625714,368100,2014-05-28,Senate,"Senate 3rd Reading SB1381 Evans Reconsider",36,0,4,0,40
625714,368614,2014-05-29,Senate,"Senate 3rd Reading SB1381 Evans",19,16,5,0,40
625717,360536,2014-04-29,Senate,"Do pass",6,0,1,0,7
625717,368732,2014-05-29,Senate,"Senate 3rd Reading SB1295 Block",37,0,3,0,40
625717,374082,2014-06-24,Assembly,"Do pass",7,0,0,0,7
625717,377344,2014-08-14,Assembly,"SB 1295 Block  Senate Third Reading  By MEDINA",78,0,0,1,79
625717,377721,2014-08-18,Senate,"Unfinished Business SB1295 Block Concurrence",36,0,4,0,40
625720,360463,2014-04-29,Assembly,"Do pass as amended and be re-referred to the Committee on 	Appropriations",18,0,0,1,19
625720,367072,2014-05-23,Assembly,"Do pass as amended",16,0,0,1,17
625720,368769,2014-05-29,Assembly,"AB 2452 PAN  Assembly Third Reading",75,0,0,4,79
625723,350241,2014-04-01,Senate,"Be adopted, but re-refer to the Committee on Appropriations 	Recommend Consent",11,0,0,0,11
625723,376979,2014-08-11,Senate,"Senate 3rd Reading SCR87 Anderson",36,0,4,0,40
625724,351372,2014-04-02,Assembly,"Be adopted, to Consent Calendar",9,0,0,0,9
625724,370063,2014-06-05,Senate,"Special Consent #16 ACR110 Fox",33,0,7,0,40
625725,360465,2014-04-29,Senate,"Do pass, but re-refer to the Committee on Appropriations",8,0,1,0,9
625725,363721,2014-05-12,Senate,"Placed on Appropriations Suspense file",7,0,0,0,7
625725,366935,2014-05-23,Senate,"Do pass",6,0,1,0,7
625725,367634,2014-05-27,Senate,"Senate 3rd Reading SB1281 Pavley",27,3,10,0,40
625725,374129,2014-06-23,Assembly,"Do pass and be re-referred to the Committee on Appropriations",6,3,0,0,9
625725,377264,2014-08-14,Assembly,"Do pass as amended",10,6,0,1,17
625725,378635,2014-08-27,Assembly,"SB 1281 Pavley  Senate Third Reading  By RIDLEY-THOMAS",72,6,0,1,79
625725,378893,2014-08-28,Senate,"Unfinished Business SB1281 Pavley Concurrence",33,0,7,0,40
625726,361141,2014-04-29,Senate,"Do pass as amended, and re-refer to the Committee on 	Appropriations",7,0,0,0,7
625726,365399,2014-05-19,Senate,"Placed on Appropriations Suspense file",7,0,0,0,7
625727,362665,2014-05-06,Assembly,"Do pass",7,0,0,0,7
625727,363444,2014-05-08,Assembly,"AB 2424 CAMPOS  Assembly Third Reading",73,0,0,6,79
625727,372296,2014-06-17,Senate,"Do pass",5,0,2,0,7
625727,374882,2014-06-26,Senate,"Assembly 3rd Reading AB2424 Campos By Correa",30,0,10,0,40
625730,358513,2014-04-22,Senate,"Do pass, but re-refer to the Committee on Judiciary",10,0,0,0,10
625730,361330,2014-04-29,Senate,"Do pass, but re-refer to the Committee on Appropriations",7,0,0,0,7
625730,363695,2014-05-12,Senate,"Placed on Appropriations Suspense file",7,0,0,0,7
625730,367066,2014-05-23,Senate,"Do pass as amended",7,0,0,0,7
625730,367982,2014-05-28,Senate,"Senate 3rd Reading SB1337 DeSaulnier",35,0,5,0,40
625730,372789,2014-06-18,Assembly,"Do pass and be re-referred to the Committee on Appropriations",13,0,0,0,13
625730,375533,2014-07-02,Assembly,"Do pass, to Consent Calendar",17,0,0,0,17
625730,376843,2014-08-07,Assembly,"SB 1337 DeSaulnier  Consent Calendar Second Day  Regular Session",77,0,0,2,79
625732,354209,2014-04-08,Assembly,"Do pass and be re-referred to the Committee on Judiciary",7,0,0,0,7
625732,358788,2014-04-22,Assembly,"Do pass and re-refer to Committee on Appropriations with 	recommendation:  To Consent Calendar",10,0,0,0,10
625732,361142,2014-04-30,Assembly,"Do pass, to Consent Calendar",17,0,0,0,17
625732,363484,2014-05-08,Assembly,"AB 2454 QUIRK-SILVA  Consent Calendar Second Day  Regular Session",73,0,0,6,79
625732,370725,2014-06-10,Senate,"Do pass as amended, but re-refer to the Committee on Judiciary 	Recommend Consent",4,0,1,0,5
625732,374572,2014-06-24,Senate,"Do pass as amended, but re-refer to the Committee on 	Appropriations Recommend Consent",7,0,0,0,7
625732,376624,2014-08-04,Senate,"Placed on Appropriations Suspense file",7,0,0,0,7
625732,377586,2014-08-14,Senate,"Do pass",5,0,2,0,7
625732,378186,2014-08-21,Senate,"Assembly 3rd Reading AB2454 Quirk-Silva By Beall",36,0,4,0,40
625732,378221,2014-08-22,Assembly,"AB 2454 QUIRK-SILVA  Concurrence in Senate Amendments",76,0,0,3,79
625733,360946,2014-04-29,Assembly,"Do pass as amended",7,0,0,0,7
625733,364901,2014-05-15,Assembly,"AB 2645 DABABNEH  Assembly Third Reading",77,0,0,2,79
625733,370580,2014-06-10,Senate,"Do pass",6,0,1,0,7
625733,374975,2014-06-26,Senate,"Special Consent #17 AB2645 Dababneh",32,0,8,0,40
625734,350358,2014-04-01,Senate,"Do pass, but re-refer to the Committee on Appropriations",9,0,2,0,11
625734,352643,2014-04-07,Senate,"Placed on Appropriations Suspense file",7,0,0,0,7
625734,366827,2014-05-23,Senate,"Do pass as amended",7,0,0,0,7
625734,368159,2014-05-28,Senate,"Senate 3rd Reading SB1364 Fuller Urgency Clause",37,0,3,0,40
625734,374070,2014-06-23,Assembly,"Do pass and be re-referred to the Committee on Appropriations",14,0,0,1,15
625734,377273,2014-08-14,Assembly,"Do pass",17,0,0,0,17
625734,378334,2014-08-25,Assembly,"SB 1364 Fuller  Third Reading Urgency  By QUIRK",78,0,0,1,79
625734,378448,2014-08-26,Senate,"Unfinished Supp 1 SB1364 Fuller Concurrence",36,0,4,0,40
625735,359873,2014-04-24,Senate,"Do pass, but re-refer to the Committee on Environmental Quality",7,0,2,0,9
625735,361261,2014-04-30,Senate,"Do pass, but re-refer to the Committee on Appropriations",7,0,0,0,7
625735,363738,2014-05-12,Senate,"Placed on Appropriations Suspense file",7,0,0,0,7
625735,366874,2014-05-23,Senate,"Do pass as amended",7,0,0,0,7
625735,367992,2014-05-28,Senate,"Senate 3rd Reading SB1395 Block",35,0,5,0,40
625735,372268,2014-06-17,Assembly,"Do pass and re-refer to Committee on Appropriations with 	recommendation:  To Consent Calendar",7,0,0,0,7
625735,377401,2014-08-14,Assembly,"Do pass",17,0,0,0,17
625735,378455,2014-08-26,Assembly,"SB 1395 Block  Senate Third Reading  By CHESBRO",78,0,0,1,79
625735,378799,2014-08-27,Senate,"Unfinished Business SB1395 Block Concurrence",34,0,6,0,40
625736,350433,2014-04-01,Assembly,"Do pass as amended and be re-referred to the Committee on 	Appropriations",13,0,0,6,19
625736,366793,2014-05-23,Assembly,"Do pass as amended",12,0,0,5,17
625736,368088,2014-05-28,Assembly,"AB 2406 RODRIGUEZ  Assembly Third Reading",64,5,0,10,79
625737,350947,2014-04-02,Assembly,"Do pass and re-refer to Committee on Appropriations with 	recommendation:  To Consent Calendar",6,0,0,1,7
625737,354249,2014-04-09,Assembly,"Do pass, to Consent Calendar",17,0,0,0,17
625737,359705,2014-04-24,Assembly,"AB 2472 P.E., R.& S.S.  Consent Calendar Second Day  Regular Session",75,0,0,4,79
625737,373749,2014-06-23,Senate,"Do pass, but re-refer to the Committee on Appropriations Recommend 	Consent",5,0,0,0,5
625737,376751,2014-08-07,Senate,"Consent Calendar 2nd AB2472 Committee on P.E.,R.& S.S.(Bonta)",34,0,6,0,40
625737,376932,2014-08-11,Assembly,"AB 2472 P.E., R.& S.S.  Concurrence in Senate Amendments By BONTA",78,0,0,1,79
625738,351878,2014-04-02,Assembly,"Do pass and be re-referred to the Committee on Appropriations",5,1,0,1,7
625738,367190,2014-05-23,Assembly,"Do pass",13,4,0,0,17
625738,367480,2014-05-27,Assembly,"AB 2272 GRAY  Assembly Third Reading",56,17,0,6,79
625738,372191,2014-06-17,Senate,"Do pass, but re-refer to the Committee on Labor and Industrial 	Relations",8,1,2,0,11
625738,374326,2014-06-25,Senate,"Do pass as amended, and re-refer to the Committee on Appropriations",4,1,0,0,5
625738,376625,2014-08-04,Senate,"Placed on Appropriations Suspense file",7,0,0,0,7
625738,377373,2014-08-14,Senate,"Do pass as amended",5,0,2,0,7
625738,378460,2014-08-26,Senate,"Assembly 3rd Reading AB2272 Gray By Lieu",23,11,6,0,40
625738,378788,2014-08-27,Assembly,"AB 2272 GRAY  Concurrence in Senate Amendments",57,18,0,4,79
625739,358496,2014-04-22,Assembly,"Do pass as amended and re-refer to Committee on Appropriations 	with recommendation:  To Consent Calendar",6,0,0,1,7
625739,363122,2014-05-07,Assembly,"Do pass, to Consent Calendar",17,0,0,0,17
625739,364913,2014-05-15,Assembly,"AB 2404 EGGMAN  Consent Calendar Second Day  Regular Session",78,0,0,1,79
625739,370645,2014-06-10,Senate,"Do pass, but re-refer to the Committee on Appropriations",6,0,1,0,7
625739,376957,2014-08-11,Senate,"Assembly 3rd Reading AB2404 Eggman By Galgiani",35,0,5,0,40
625739,377628,2014-08-18,Assembly,"AB 2404 EGGMAN  Concurrence in Senate Amendments",78,0,0,1,79
625740,354521,2014-04-09,Senate,"Do pass as amended, and re-refer to the Committee on Judiciary",8,0,1,0,9
625742,359044,2014-04-21,Assembly,"Do pass as amended and re-refer to Committee on Appropriations 	with recommendation:  To Consent Calendar",15,0,0,1,16
625742,363150,2014-05-07,Assembly,"Do pass, to Consent Calendar",17,0,0,0,17
625742,364807,2014-05-15,Assembly,"AB 2250 DALY  Consent Calendar Second Day  Regular Session",78,0,0,1,79
625742,374254,2014-06-24,Senate,"Do pass as amended, and re-refer to the Committee on 	Appropriations",11,0,0,0,11
625742,378002,2014-08-20,Senate,"Assembly 3rd Reading AB2250 Daly By DeSaulnier",32,0,8,0,40
625742,378089,2014-08-21,Assembly,"AB 2250 DALY  Concurrence in Senate Amendments",79,0,0,0,79
625745,353331,2014-04-08,Assembly,"Do pass and be re-referred to the Committee on Water, Parks and 	Wildlife",4,2,0,0,6
625745,360699,2014-04-29,Assembly,"Do pass as amended and be re-referred to the Committee on 	Appropriations",9,5,0,1,15
625745,364517,2014-05-14,Assembly,"Do pass",12,5,0,0,17
625745,366964,2014-05-23,Assembly,"AB 2657 BLOOM  Assembly Third Reading",54,20,0,5,79
625745,374606,2014-06-25,Senate,"Do pass, but re-refer to the Committee on Appropriations",6,0,1,0,7
625745,377771,2014-08-19,Senate,"Assembly 3rd Reading AB2657 Bloom By Pavley",26,6,8,0,40
625745,378032,2014-08-21,Assembly,"AB 2657 BLOOM  Concurrence in Senate Amendments",58,21,0,0,79
625747,347581,2014-03-25,Assembly,"Do pass as amended",7,1,0,2,10
625747,351806,2014-04-03,Assembly,"AB 2256 GARCIA  Assembly Third Reading",52,11,0,16,79
625747,370968,2014-06-10,Senate,"Do pass as amended",6,1,0,0,7
625747,377271,2014-08-14,Senate,"Assembly 3rd Reading AB2256 Garcia By Lara",30,4,6,0,40
625747,377640,2014-08-18,Assembly,"AB 2256 GARCIA  Concurrence in Senate Amendments",54,13,0,12,79
625751,360720,2014-04-29,Assembly,"Do pass as amended",7,2,0,1,10
625751,368276,2014-05-28,Assembly,"AB 2617 WEBER  Assembly Third Reading",49,25,0,5,79
625751,374614,2014-06-24,Senate,"Do pass",5,2,0,0,7
625751,378016,2014-08-21,Senate,"Assembly 3rd Reading AB2617 Weber By Corbett",21,11,8,0,40
625751,378642,2014-08-27,Assembly,"AB 2617 WEBER  Concurrence in Senate Amendments",50,24,0,5,79
625752,353202,2014-04-08,Senate,"Do pass as amended, but re-refer to the Committee on Appropriations 	Recommend Consent",5,0,0,0,5
625752,362296,2014-05-05,Senate,"Placed on Appropriations Suspense file",7,0,0,0,7
625752,366680,2014-05-23,Senate,"Do pass",7,0,0,0,7
625752,368087,2014-05-28,Senate,"Senate 3rd Reading SB1445 Evans",37,0,3,0,40
625752,372308,2014-06-17,Assembly,"Do pass as amended and re-refer to Committee on Appropriations 	with recommendation:  To Consent Calendar",6,0,0,1,7
625752,375584,2014-07-02,Assembly,"Do pass, to Consent Calendar",17,0,0,0,17
625752,376823,2014-08-07,Assembly,"SB 1445 Evans  Consent Calendar Second Day  Regular Session",77,0,0,2,79
625752,376909,2014-08-11,Senate,"Unfinished Business SB1445 Evans Concurrence",36,0,4,0,40
625753,361159,2014-04-30,Senate,"Do pass, but re-refer to the Committee on Appropriations",4,2,1,0,7
625753,363733,2014-05-12,Senate,"Placed on Appropriations Suspense file",7,0,0,0,7
625753,366931,2014-05-23,Senate,"Do pass",7,0,0,0,7
625753,368127,2014-05-28,Senate,"Senate 3rd Reading SB1292 Hueso",32,2,6,0,40
625753,372300,2014-06-17,Assembly,"Do pass and be re-referred to the Committee on Appropriations",7,0,0,0,7
625753,377533,2014-08-14,Assembly,"Do pass as amended",17,0,0,0,17
625753,378700,2014-08-27,Assembly,"SB 1292 Hueso  Senate Third Reading  By ALEJO",78,0,0,1,79
625753,378903,2014-08-28,Senate,"Unfinished Business SB1292 Hueso Concurrence",33,0,7,0,40
625754,360735,2014-04-29,Assembly,"Do pass and be re-referred to the Committee on Appropriations",7,0,0,0,7
625754,363083,2014-05-07,Assembly,"Do pass, to Consent Calendar",17,0,0,0,17
625754,364844,2014-05-15,Assembly,"AB 2724 BRADFORD  Consent Calendar Second Day  Regular Session",78,0,0,1,79
625754,374388,2014-06-24,Senate,"Do pass, but re-refer to the Committee on Appropriations",7,0,0,0,7
625754,376507,2014-08-04,Senate,"Placed on Appropriations Suspense file",7,0,0,0,7
625755,364603,2014-05-13,Assembly,"Do pass as amended and be re-referred to the Committee on 	Appropriations",8,0,0,1,9
625756,353455,2014-04-08,Senate,"Do pass",4,1,0,0,5
625756,357959,2014-04-21,Senate,"Senate 3rd Reading SB1382 Block",23,8,9,0,40
625756,372316,2014-06-17,Assembly,"Do pass as amended",6,1,0,0,7
625756,378515,2014-08-26,Assembly,"SB 1382 Block  Senate Third Reading  By SKINNER",55,21,0,3,79
625756,378731,2014-08-27,Senate,"Unfinished Business SB1382 Block Concurrence",25,8,7,0,40
625757,360644,2014-04-29,Assembly,"Do pass",4,1,0,2,7
625757,363428,2014-05-08,Assembly,"AB 2487 WAGNER  Assembly Third Reading",52,11,0,16,79
625757,374309,2014-06-24,Senate,"Do pass",3,4,0,0,7
625759,360604,2014-04-29,Senate,"Do pass as amended, and re-refer to the Committee on Appropriations",10,0,1,0,11
625759,365349,2014-05-19,Senate,"Placed on Appropriations Suspense file",7,0,0,0,7
625760,363073,2014-05-07,Assembly,"Do pass",9,0,0,0,9
625760,365357,2014-05-19,Assembly,"AB 2403 RENDON  Assembly Third Reading",74,1,0,4,79
625760,370941,2014-06-11,Senate,"Do pass and be placed on the Consent Calendar",7,0,0,0,7
625760,371747,2014-06-16,Senate,"Consent Calendar 2nd AB2403 Rendon",35,0,5,0,40
625760,373099,2014-06-19,Assembly,"AB 2403 RENDON  Concurrence in Senate Amendments",77,1,0,1,79
625762,361123,2014-04-30,Senate,"Do pass, but re-refer to the Committee on Judiciary",4,1,2,0,7
625763,358475,2014-04-21,Assembly,"Be referred to Committee on Agriculture",9,0,0,2,11
625763,361326,2014-04-30,Assembly,"Do pass and be re-referred to the Committee on Appropriations",7,0,0,0,7
625764,361591,2014-04-30,Assembly,"Do pass as amended",9,0,0,0,9
625764,363381,2014-05-08,Assembly,"AB 2618 PEREZ, J.A.  Assembly Third Reading",74,0,0,5,79
625764,372575,2014-06-18,Senate,"Do pass as amended",7,0,0,0,7
625764,376816,2014-08-07,Senate,"Assembly 3rd Reading AB2618 John A. P",35,0,5,0,40
625764,376928,2014-08-11,Assembly,"AB 2618 PEREZ, J.  Concurrence in Senate Amendments",79,0,0,0,79
625765,354703,2014-04-09,Assembly,"Do pass and be re-referred to the Committee on Public Safety",6,2,0,1,9
625765,360646,2014-04-29,Assembly,"Do pass and be re-referred to the Committee on Appropriations",5,2,0,0,7
625767,361255,2014-04-29,Assembly,"Do pass and re-refer to Committee on Appropriations with 	recommendation:  To Consent Calendar",7,0,0,0,7
625767,366817,2014-05-23,Assembly,"Do pass",16,0,0,1,17
625767,368155,2014-05-28,Assembly,"AB 2236 MAIENSCHEIN  Assembly Third Reading",78,0,0,1,79
625767,374680,2014-06-24,Senate,"Do pass, but re-refer to the Committee on Appropriations",4,0,1,0,5
625767,376594,2014-08-04,Senate,"Placed on Appropriations Suspense file",7,0,0,0,7
625767,377424,2014-08-14,Senate,"Do pass",5,0,2,0,7
625767,378737,2014-08-27,Senate,"From Committee:  That the measure be returned to the Senate floor 	for consideration",3,0,2,0,5
625767,378889,2014-08-28,Assembly,"AB 2236 MAIENSCHEIN  Concurrence in Senate Amendments",76,0,0,3,79
625767,378890,2014-08-28,Senate,"Assembly 3rd Reading AB2236 Maienschein By Beall",34,0,6,0,40
625769,360913,2014-04-29,Assembly,"Do pass as amended and be re-referred to the Committee on 	Appropriations",19,0,0,0,19
625769,364397,2014-05-14,Assembly,"Do pass as amended, to Consent Calendar",17,0,0,0,17
625769,367061,2014-05-23,Assembly,"AB 2679 LOGUE  Consent Calendar Second Day  Regular Session",73,0,0,6,79
625769,374765,2014-06-25,Senate,"Do pass as amended, and re-refer to the Committee on 	Appropriations",8,0,1,0,9
625769,377696,2014-08-18,Senate,"Assembly 3rd Reading AB2679 Logue By Vidak",36,0,4,0,40
625769,377784,2014-08-19,Assembly,"AB 2679 LOGUE  Concurrence in Senate Amendments",78,0,0,1,79
625770,358422,2014-04-22,Senate,"Do pass as amended, and re-refer to the Committee on Appropriations",7,0,0,0,7
625770,365373,2014-05-19,Senate,"Placed on Appropriations Suspense file",7,0,0,0,7
625772,361365,2014-04-29,Assembly,"Do pass and be re-referred to the Committee on Appropriations",4,0,0,3,7
625772,366991,2014-05-23,Assembly,"Do pass as amended",12,0,0,5,17
625772,368084,2014-05-28,Assembly,"AB 2311 BRADFORD  Assembly Third Reading",73,0,0,6,79
625772,374635,2014-06-24,Senate,"Do pass, but re-refer to the Committee on Appropriations",4,0,1,0,5
625772,376620,2014-08-04,Senate,"Placed on Appropriations Suspense file",7,0,0,0,7
625776,361152,2014-04-29,Senate,"Do pass as amended, and re-refer to the Committee on 	Appropriations",11,0,0,0,11
625776,363743,2014-05-12,Senate,"Placed on Appropriations Suspense file",7,0,0,0,7
625781,355163,2014-04-09,Assembly,"Do pass and be re-referred to the Committee on Higher Education",7,0,0,0,7
625781,359149,2014-04-22,Assembly,"Do pass and be re-referred to the Committee on Appropriations",13,0,0,0,13
625781,366919,2014-05-23,Assembly,"Do pass as amended",16,0,0,1,17
625781,368069,2014-05-28,Assembly,"AB 2235 BUCHANAN  Third Reading Urgency",75,0,0,4,79
625781,372776,2014-06-18,Senate,"Do pass as amended, and re-refer to the Committee on Governance and 	Finance",5,0,2,0,7
625781,374407,2014-06-25,Senate,"Do pass, but re-refer to the Committee on Appropriations",6,0,1,0,7
625781,376950,2014-08-11,Senate,"Placed on Appropriations Suspense file",7,0,0,0,7
625781,377333,2014-08-14,Senate,"Do pass as amended",5,0,2,0,7
625783,359274,2014-04-22,Senate,"Do pass, but re-refer to the Committee on Appropriations",5,0,0,0,5
625783,365386,2014-05-19,Senate,"Senate 3rd Reading SB1443 De Le",34,0,6,0,40
625783,374553,2014-06-24,Assembly,"Do pass as amended and be re-referred to the Committee on 	Appropriations",6,0,0,1,7
625783,376737,2014-08-06,Assembly,"Do pass",17,0,0,0,17
625783,377602,2014-08-18,Assembly,"SB 1443 De Leon  Senate Third Reading  By GARCIA",75,0,0,4,79
625783,379081,2014-08-29,Senate,"Unfinished Business SB1443 De Le",37,0,3,0,40
625784,367651,2014-05-27,Senate,"Senate 3rd Reading SCR86 Hueso",33,1,6,0,40
625784,370962,2014-06-11,Assembly,"Be adopted as amended",6,0,0,1,7
625784,374759,2014-06-26,Assembly,"SCR 86 Hueso  Senate Third Reading  By BUCHANAN",73,0,0,6,79
625784,376390,2014-08-04,Senate,"Unfinished Business SCR86 Hueso Concurrence",34,1,5,0,40
625785,361252,2014-04-29,Assembly,"Do pass and be re-referred to the Committee on Appropriations",5,1,0,1,7
625786,355159,2014-04-09,Assembly,"Do pass as amended and be re-referred to the Committee on 	Appropriations",7,0,0,0,7
625788,353184,2014-04-07,Assembly,"Do pass and be re-referred to the Committee on Natural Resources",8,4,0,3,15
625788,359648,2014-04-24,Assembly,"Be referred to Committee on Natural Resources",10,0,0,1,11
625788,360486,2014-04-28,Assembly,"Do pass and be re-referred to the Committee on Appropriations",5,3,0,1,9
625788,367088,2014-05-23,Assembly,"Do pass as amended",11,1,0,5,17
625790,362725,2014-05-06,Assembly,"Do pass",10,0,0,0,10
625790,364843,2014-05-15,Assembly,"AB 2586 BLOOM  Assembly Third Reading",77,0,0,2,79
625790,370977,2014-06-10,Senate,"Do pass as amended",6,0,1,0,7
625790,374873,2014-06-26,Senate,"Special Consent #17 AB2586 Bloom By Jackson",32,0,8,0,40
625790,375272,2014-06-30,Assembly,"AB 2586 BLOOM  Concurrence in Senate Amendments",77,0,0,2,79
625791,353297,2014-04-08,Senate,"Do pass, but re-refer to the Committee on Appropriations",6,0,1,0,7
625791,360164,2014-04-28,Senate,"Placed on Appropriations Suspense file",6,0,1,0,7
625791,367085,2014-05-23,Senate,"Do pass",7,0,0,0,7
625791,367530,2014-05-27,Senate,"Senate 3rd Reading SB1440 Wolk",34,0,6,0,40
625791,372812,2014-06-17,Assembly,"Do pass and be re-referred to the Committee on Appropriations",9,0,0,1,10
625791,377517,2014-08-14,Assembly,"Do pass as amended",17,0,0,0,17
625791,378616,2014-08-27,Assembly,"SB 1440 Wolk  Senate Third Reading  By BROWN",78,0,0,1,79
625791,378920,2014-08-28,Senate,"Unfinished Business SB1440 Wolk Concurrence",34,0,6,0,40
625793,360922,2014-04-29,Assembly,"Do pass and be re-referred to the Committee on Appropriations",12,0,0,1,13
625795,360810,2014-04-29,Assembly,"Do pass as amended and be re-referred to the Committee on 	Appropriations",13,3,0,3,19
625796,350944,2014-04-02,Senate,"Do pass as amended, and re-refer to the Committee on Environmental 	Quality",8,0,1,0,9
625796,361125,2014-04-30,Senate,"Do pass, but re-refer to the Committee on Appropriations",7,0,0,0,7
625796,363757,2014-05-12,Senate,"Placed on Appropriations Suspense file",7,0,0,0,7
625796,366849,2014-05-23,Senate,"Do pass",7,0,0,0,7
625796,367581,2014-05-27,Senate,"Senate 3rd Reading SB1405 DeSaulnier",34,0,6,0,40
625796,370960,2014-06-11,Assembly,"Do pass and be re-referred to the Committee on Environmental Safety 	and Toxic Materials",5,0,0,2,7
625796,372262,2014-06-17,Assembly,"Do pass and be re-referred to the Committee on Appropriations",7,0,0,0,7
625796,377527,2014-08-14,Assembly,"Do pass as amended",17,0,0,0,17
625796,378613,2014-08-27,Assembly,"SB 1405 DeSaulnier  Senate Third Reading  By WIECKOWSKI",76,0,0,3,79
625796,378981,2014-08-28,Senate,"Unfinished Business SB1405 DeSaulnier Concurrence",34,0,6,0,40
625800,354247,2014-04-09,Assembly,"Do pass and be re-referred to the Committee on Appropriations",13,0,0,0,13
625800,366798,2014-05-23,Assembly,"Do pass",16,0,0,1,17
625800,367650,2014-05-27,Assembly,"AB 2328 PEREZ, J.  Assembly Third Reading",76,0,0,3,79
625800,374016,2014-06-24,Senate,"Do pass, but re-refer to the Committee on Appropriations",10,0,0,0,10
625800,376911,2014-08-11,Senate,"Placed on Appropriations Suspense file",7,0,0,0,7
625800,377128,2014-08-14,Senate,"Do pass as amended",5,0,2,0,7
625800,378038,2014-08-21,Senate,"Assembly 3rd Reading AB2328 John A. P",32,3,5,0,40
625800,378382,2014-08-25,Assembly,"AB 2328 PEREZ, J.  Concurrence in Senate Amendments",78,1,0,0,79
625802,358443,2014-04-21,Assembly,"Do pass and be re-referred to the Committee on Appropriations",12,0,0,4,16
625802,361229,2014-04-30,Assembly,"Do pass",16,0,0,1,17
625802,363355,2014-05-08,Assembly,"AB 2687 BOCANEGRA  Assembly Third Reading",72,0,0,7,79
625802,372357,2014-06-17,Senate,"Do pass, but re-refer to the Committee on Appropriations",5,0,2,0,7
625802,376846,2014-08-07,Senate,"Assembly 3rd Reading AB2687 Bocanegra By Mitchell",33,1,6,0,40
625803,361005,2014-04-29,Assembly,"Do pass and be re-referred to the Committee on Appropriations",13,0,0,0,13
625806,358467,2014-04-22,Assembly,"Do pass and re-refer to Committee on Appropriations with 	recommendation:  To Consent Calendar",6,0,0,1,7
625806,361105,2014-04-30,Assembly,"Do pass",17,0,0,0,17
625806,363330,2014-05-08,Assembly,"AB 2631 DABABNEH  Assembly Third Reading",71,1,0,7,79
625806,374351,2014-06-24,Senate,"Do pass, but re-refer to the Committee on Appropriations",4,1,0,0,5
625806,377048,2014-08-13,Senate,"Assembly 3rd Reading AB2631 Dababneh By Pavley",27,9,4,0,40
625806,377678,2014-08-18,Assembly,"AB 2631 DABABNEH  Concurrence in Senate Amendments",78,0,0,1,79
625807,359229,2014-04-22,Senate,"Do pass, but re-refer to the Committee on Appropriations",1,4,0,0,5
625807,359230,2014-04-22,Senate,"Reconsideration granted",5,0,0,0,5
625808,361091,2014-04-30,Assembly,"Do pass and be re-referred to the Committee on Appropriations",7,0,0,0,7
625808,364715,2014-05-14,Assembly,"Do pass, to Consent Calendar",17,0,0,0,17
625808,367445,2014-05-27,Assembly,"AB 2490 EGGMAN  Assembly Third Reading",75,0,0,4,79
625808,372210,2014-06-17,Senate,"Do pass, but re-refer to the Committee on Appropriations",5,0,0,0,5
625808,377690,2014-08-18,Senate,"Assembly 3rd Reading AB2490 Eggman By Cannella",34,1,5,0,40
625808,378086,2014-08-21,Assembly,"AB 2490 EGGMAN  Concurrence in Senate Amendments",76,2,0,1,79
625809,360519,2014-04-29,Assembly,"Do pass and be re-referred to the Committee on Local Government",6,0,0,1,7
625809,361694,2014-04-30,Assembly,"Do pass and be re-referred to the Committee on Appropriations",9,0,0,0,9
625809,364260,2014-05-14,Assembly,"Do pass, to Consent Calendar",17,0,0,0,17
625809,367570,2014-05-27,Assembly,"AB 2712 DALY  Assembly Third Reading",73,1,0,5,79
625809,372565,2014-06-18,Senate,"Do pass, but re-refer to the Committee on Judiciary",7,0,0,0,7
625809,374482,2014-06-24,Senate,"Do pass as amended, and re-refer to the Committee on 	Appropriations",7,0,0,0,7
625809,376597,2014-08-04,Senate,"Placed on Appropriations Suspense file",7,0,0,0,7
625809,377584,2014-08-14,Senate,"Do pass",5,0,2,0,7
625811,359156,2014-04-23,Assembly,"Do pass and re-refer to Committee on Appropriations with 	recommendation:  To Consent Calendar",7,0,0,0,7
625811,363038,2014-05-07,Assembly,"Do pass, to Consent Calendar",17,0,0,0,17
625811,364940,2014-05-15,Assembly,"AB 2408 ALLEN  Consent Calendar Second Day  Regular Session",78,0,0,1,79
625811,369934,2014-06-04,Senate,"Do pass as amended, but re-refer to the Committee on Appropriations 	Recommend Consent",6,0,1,0,7
625811,375719,2014-07-03,Senate,"Consent Calendar 2nd AB2408 Allen",35,0,5,0,40
625811,377973,2014-08-20,Senate,"Assembly 3rd Reading AB2408 Allen By Vidak",34,0,6,0,40
625811,378151,2014-08-21,Assembly,"AB 2408 ALLEN  Concurrence in Senate Amendments",74,3,0,2,79
625812,350741,2014-04-01,Assembly,"Do pass and re-refer to Committee on Appropriations with 	recommendation:  To Consent Calendar",7,0,0,0,7
625813,350281,2014-04-01,Assembly,"Do pass",13,0,0,0,13
625813,359507,2014-04-24,Assembly,"AB 2445 CHAU  Assembly Third Reading",73,0,0,6,79
625813,369930,2014-06-04,Senate,"Do pass and be placed on the Consent Calendar",6,0,1,0,7
625813,371783,2014-06-16,Senate,"Consent Calendar 2nd AB2445 Chau",35,0,5,0,40
625814,361418,2014-04-29,Senate,"Do pass, but re-refer to the Committee on Appropriations",11,0,0,0,11
625814,363853,2014-05-12,Senate,"Placed on Appropriations Suspense file",7,0,0,0,7
625814,366665,2014-05-23,Senate,"Do pass",7,0,0,0,7
625814,367644,2014-05-27,Senate,"Senate 3rd Reading SB1368 Wolk",35,0,5,0,40
625814,373791,2014-06-23,Assembly,"Do pass and re-refer to Committee on Appropriations with 	recommendation:  To Consent Calendar",13,0,0,3,16
625814,376728,2014-08-06,Assembly,"Do pass, to Consent Calendar",17,0,0,0,17
625814,377217,2014-08-14,Assembly,"SB 1368 Wolk  Consent Calendar Second Day  Regular Session",78,0,0,1,79
625814,377685,2014-08-18,Senate,"Unfinished Business SB1368 Wolk Concurrence",36,0,4,0,40
625815,360500,2014-04-29,Assembly,"Do pass and be re-referred to the Committee on Appropriations",8,5,0,1,14
625817,352009,2014-04-03,Senate,"Senate 3rd Reading SCR90 Hueso",35,0,5,0,40
625817,372386,2014-06-16,Assembly,"Be adopted",9,0,0,0,9
625817,373349,2014-06-19,Assembly,"SCR 90 Hueso  Senate Third Reading  By GONZALEZ",78,0,0,1,79
625817,375278,2014-06-30,Senate,"Unfinished Business SCR90 Hueso Concurrence",33,0,7,0,40
625818,361211,2014-04-30,Assembly,"Do pass as amended and be re-referred to the Committee on 	Appropriations",8,0,0,1,9
625819,361710,2014-04-30,Assembly,"Do pass and be re-referred to the Committee on Appropriations",0,7,0,0,7
625821,360656,2014-04-29,Assembly,"Do pass as amended and be re-referred to the Committee on 	Appropriations",17,1,0,1,19
625821,367083,2014-05-23,Assembly,"Do pass",12,1,0,4,17
625821,368046,2014-05-28,Assembly,"AB 2400 RIDLEY-THOMAS  Assembly Third Reading",55,8,0,16,79
625823,361194,2014-04-29,Assembly,"Do pass as amended and be re-referred to the Committee on 	Appropriations",5,0,0,2,7
625823,366852,2014-05-23,Assembly,"Do pass",13,0,0,4,17
625823,367534,2014-05-27,Assembly,"AB 2382 BRADFORD  Assembly Third Reading",66,2,0,11,79
625823,374713,2014-06-24,Senate,"Do pass, but re-refer to the Committee on Appropriations",3,1,1,0,5
625823,376452,2014-08-04,Senate,"Placed on Appropriations Suspense file",7,0,0,0,7
625823,377560,2014-08-14,Senate,"Do pass as amended",5,0,2,0,7
625823,378096,2014-08-21,Senate,"Assembly 3rd Reading AB2382 Bradford By Beall",24,9,7,0,40
625823,378415,2014-08-25,Assembly,"AB 2382 BRADFORD  Concurrence in Senate Amendments",64,7,0,8,79
625824,359343,2014-04-22,Assembly,"Do pass as amended and be re-referred to the Committee on 	Appropriations",12,0,0,1,13
625824,362939,2014-05-07,Assembly,"Do pass, to Consent Calendar",17,0,0,0,17
625824,364874,2014-05-15,Assembly,"AB 2247 WILLIAMS  Consent Calendar Second Day  Regular Session",78,0,0,1,79
625824,372842,2014-06-18,Senate,"Do pass as amended, and re-refer to the Committee on Appropriations",7,0,0,0,7
625824,377642,2014-08-18,Senate,"Assembly 3rd Reading AB2247 Williams By Block",36,0,4,0,40
625824,377776,2014-08-19,Assembly,"AB 2247 WILLIAMS  Concurrence in Senate Amendments",78,0,0,1,79
625826,359828,2014-04-24,Senate,"Do pass as amended, and re-refer to the Committee on Appropriations",6,0,1,0,7
625826,364817,2014-05-15,Senate,"Special Consent #14 SB1323 Lieu",36,0,4,0,40
625826,373314,2014-06-19,Assembly,"Be referred to Committee on Transportation",11,0,0,0,11
625826,374789,2014-06-26,Assembly,"Do pass as amended and be re-referred to the Committee on 	Appropriations",14,0,0,2,16
625826,377248,2014-08-14,Assembly,"Do pass as amended",17,0,0,0,17
625826,378742,2014-08-27,Assembly,"SB 1323 Lieu  Third Reading Urgency  By ACHADJIAN",78,0,0,1,79
625826,378839,2014-08-28,Senate,"From committee:  That the Assembly Amendments be concurred in",6,0,1,0,7
625826,379070,2014-08-29,Senate,"Unfinished Supp 1 SB1323 Lieu Concurrence",35,0,5,0,40
625827,360705,2014-04-28,Assembly,"Do pass",15,0,0,1,16
625827,361750,2014-05-01,Assembly,"AB 2707 CHAU  Assembly Third Reading",74,0,0,5,79
625827,370636,2014-06-10,Senate,"Do pass",10,0,1,0,11
625827,375273,2014-06-30,Senate,"Assembly 3rd Reading AB2707 Chau By DeSaulnier",36,0,4,0,40
625827,377824,2014-08-19,Assembly,"AB 2707 CHAU  Concurrence in Senate Amendments",78,0,0,1,79
625828,359900,2014-04-24,Senate,"Do pass, but re-refer to the Committee on Public Safety",9,0,0,0,9
625828,360687,2014-04-29,Senate,"Do pass as amended, and re-refer to the Committee on Appropriations",6,0,1,0,7
625828,367084,2014-05-23,Senate,"Senate 3rd Reading SB1438 Pavley",31,0,9,0,40
625828,372273,2014-06-17,Assembly,"Do pass and be re-referred to the Committee on Judiciary to Consent 	Calendar",17,0,0,2,19
625828,374159,2014-06-24,Assembly,"Do pass and be re-referred to the Committee on Appropriations",9,0,0,1,10
625828,376690,2014-08-06,Assembly,"Do pass, to Consent Calendar",17,0,0,0,17
625828,378705,2014-08-27,Assembly,"SB 1438 Pavley  Senate Third Reading  By BLOOM",78,0,0,1,79
625828,378871,2014-08-28,Senate,"Unfinished Business SB1438 Pavley Concurrence",34,0,6,0,40
625829,359765,2014-04-24,Senate,"Do pass, but re-refer to the Committee on Appropriations",7,0,2,0,9
625829,362195,2014-05-05,Senate,"Placed on Appropriations Suspense file",7,0,0,0,7
625829,367018,2014-05-23,Senate,"Do pass as amended",7,0,0,0,7
625829,367998,2014-05-28,Senate,"Senate 3rd Reading SB1425 Block",37,0,3,0,40
625829,374426,2014-06-24,Assembly,"Do pass and be re-referred to the Committee on Appropriations",13,0,0,0,13
625830,354164,2014-04-08,Assembly,"Do pass and be re-referred to the Committee on Public Employees, 	Retirement and Social Security",13,6,0,0,19
625830,359192,2014-04-23,Assembly,"Do pass and be re-referred to the Committee on Appropriations",5,1,0,1,7
625830,366703,2014-05-23,Assembly,"Do pass",12,5,0,0,17
625830,368067,2014-05-28,Assembly,"AB 2325 PEREZ, J.  Assembly Third Reading",53,25,0,1,79
625830,373169,2014-06-18,Senate,"Do pass, but re-refer to the Committee on Appropriations",6,2,1,0,9
625830,376423,2014-08-04,Senate,"Placed on Appropriations Suspense file",7,0,0,0,7
625830,377168,2014-08-14,Senate,"Do pass",5,0,2,0,7
625830,378882,2014-08-28,Assembly,"AB 2325 PEREZ, J.  Concurrence in Senate Amendments By TING",54,24,0,1,79
625830,378883,2014-08-28,Senate,"Assembly 3rd Reading AB2325 John A. P",24,10,6,0,40
625832,360714,2014-04-28,Assembly,"Do pass as amended and be re-referred to the Committee on 	Appropriations",9,0,0,0,9
625833,354140,2014-04-09,Assembly,"Do pass and be re-referred to the Committee on Appropriations",19,0,0,0,19
625833,361416,2014-04-30,Assembly,"Do pass as amended, to Consent Calendar",17,0,0,0,17
625833,363374,2014-05-08,Assembly,"AB 2488 LEVINE  Consent Calendar Second Day  Regular Session",73,0,0,6,79
625833,370571,2014-06-10,Senate,"Do pass, but re-refer to the Committee on Appropriations",8,0,2,0,10
625833,374961,2014-06-26,Senate,"Assembly 3rd Reading AB2488 Levine Urgency Clause",30,0,10,0,40
625834,358698,2014-04-22,Assembly,"Do pass and be re-referred to the Committee on Appropriations",6,0,0,1,7
625834,361172,2014-04-30,Assembly,"Do pass, to Consent Calendar",17,0,0,0,17
625834,363424,2014-05-08,Assembly,"AB 2625 ACHADJIAN  Consent Calendar Second Day  Regular Session",73,0,0,6,79
625834,370669,2014-06-10,Senate,"Do pass, but re-refer to the Committee on Appropriations",6,0,1,0,7
625834,373900,2014-06-23,Senate,"Do pass",7,0,0,0,7
625834,378421,2014-08-25,Senate,"Assembly 3rd Reading AB2625 Achadjian By Nielsen",33,0,7,0,40
625834,378439,2014-08-26,Assembly,"AB 2625 ACHADJIAN  Concurrence in Senate Amendments",79,0,0,0,79
625835,348120,2014-03-26,Senate,"Do pass",3,1,1,0,5
625835,350309,2014-04-01,Senate,"Senate 3rd Reading SB1360 Padilla",23,7,9,0,39
625835,370970,2014-06-11,Assembly,"Do pass",5,0,0,2,7
625835,373144,2014-06-19,Assembly,"SB 1360 Padilla  Senate Third Reading  By ALEJO",55,19,0,5,79
625836,354281,2014-04-08,Assembly,"Do pass as amended and be re-referred to the Committee on Judiciary",7,0,0,0,7
625836,362727,2014-05-06,Assembly,"Do pass, to Consent Calendar",10,0,0,0,10
625836,364849,2014-05-15,Assembly,"AB 2379 WEBER  Consent Calendar Second Day  Regular Session",78,0,0,1,79
625836,370715,2014-06-10,Senate,"Do pass and be placed on the Consent Calendar",4,0,1,0,5
625836,371745,2014-06-16,Senate,"Consent Calendar 2nd AB2379 Weber",35,0,5,0,40
625837,358504,2014-04-22,Assembly,"Do pass and be re-referred to the Committee on Appropriations",6,13,0,0,19
625838,364374,2014-05-13,Assembly,"Do pass as amended and be re-referred to the Committee on 	Appropriations",6,1,0,2,9
625840,355176,2014-04-10,Assembly,"Be referred to Committee on Local Government",7,0,0,4,11
625840,359300,2014-04-23,Assembly,"Do pass and be re-referred to the Committee on Revenue and Taxation",6,2,0,1,9
625840,360529,2014-04-28,Assembly,"Do pass and be re-referred to the Committee on Appropriations",6,2,0,1,9
625840,366898,2014-05-23,Assembly,"Do pass as amended",12,4,0,1,17
625840,368612,2014-05-29,Assembly,"AB 2415 TING  Assembly Third Reading",48,26,0,5,79
625840,372788,2014-06-18,Senate,"Do pass as amended, and re-refer to the Committee on Appropriations",5,0,2,0,7
625840,376960,2014-08-11,Senate,"Do pass",5,2,0,0,7
625840,378387,2014-08-25,Senate,"Assembly 3rd Reading AB2415 Ting By Hill",22,12,6,0,40
625840,378654,2014-08-27,Assembly,"AB 2415 TING  Concurrence in Senate Amendments",50,28,0,1,79
625842,360640,2014-04-28,Assembly,"Do pass as amended and be re-referred to the Committee on 	Appropriations",12,0,0,3,15
625842,366259,2014-05-21,Assembly,"Do pass, to Consent Calendar",17,0,0,0,17
625842,367586,2014-05-27,Assembly,"AB 2584 NESTANDE  Consent Calendar Second Day  Regular Session",77,0,0,2,79
625842,373977,2014-06-23,Senate,"Do pass, but re-refer to the Committee on Appropriations",7,3,1,0,11
625842,376509,2014-08-04,Senate,"Placed on Appropriations Suspense file",7,0,0,0,7
625844,359510,2014-04-24,Assembly,"Be referred to Committee on Human Services",10,0,0,1,11
625844,361140,2014-04-29,Assembly,"Do pass and be re-referred to the Committee on Appropriations",2,2,0,3,7
625845,350896,2014-04-02,Senate,"Do pass, but re-refer to the Committee on Appropriations Recommend 	Consent",6,0,1,0,7
625845,361656,2014-05-01,Senate,"Consent Calendar 2nd SB1274 Hancock",35,0,5,0,40
625845,374113,2014-06-23,Assembly,"Do pass and re-refer to Committee on Appropriations with 	recommendation:  To Consent Calendar",9,0,0,0,9
625845,375528,2014-07-02,Assembly,"Do pass, to Consent Calendar",17,0,0,0,17
625845,376831,2014-08-07,Assembly,"SB 1274 Hancock  Consent Calendar Second Day  Regular Session",77,0,0,2,79
625845,378187,2014-08-21,Senate,"Unfinished Business SB1274 Hancock Concurrence",34,0,6,0,40
625847,360609,2014-04-28,Assembly,"Do pass and be re-referred to the Committee on Appropriations",5,10,0,1,16
625847,360610,2014-04-28,Assembly,"Reconsideration granted",16,0,0,0,16
625849,354398,2014-04-08,Assembly,"Do pass as amended and be re-referred to the Committee on Public 	Safety",9,0,0,1,10
625849,360547,2014-04-29,Assembly,"Do pass and re-refer to Committee on Appropriations with 	recommendation:  To Consent Calendar",7,0,0,0,7
625849,367138,2014-05-23,Assembly,"Do pass as amended",17,0,0,0,17
625849,368743,2014-05-29,Assembly,"AB 2263 BRADFORD  Assembly Third Reading",77,0,0,2,79
625849,372216,2014-06-17,Senate,"Do pass, but re-refer to the Committee on Veterans Affairs",5,0,2,0,7
625849,374028,2014-06-24,Senate,"Do pass, but re-refer to the Committee on Appropriations",6,0,1,0,7
625849,376571,2014-08-04,Senate,"Placed on Appropriations Suspense file",7,0,0,0,7
625849,377529,2014-08-14,Senate,"Do pass",5,0,2,0,7
625849,378399,2014-08-25,Senate,"Assembly 3rd Reading AB2263 Bradford By Knight",35,0,5,0,40
625849,378592,2014-08-26,Assembly,"AB 2263 BRADFORD  Concurrence in Senate Amendments",79,0,0,0,79
625850,363028,2014-05-07,Assembly,"Do pass, to Consent Calendar",12,0,0,1,13
625850,364920,2014-05-15,Assembly,"AB 2578 DABABNEH  Consent Calendar Second Day  Regular Session",78,0,0,1,79
625850,374894,2014-06-25,Senate,"Do pass and be placed on the Consent Calendar",10,0,1,0,11
625850,375674,2014-07-03,Senate,"Consent Calendar 2nd AB2578 Dababneh",35,0,5,0,40
625850,377845,2014-08-19,Assembly,"AB 2578 DABABNEH  Concurrence in Senate Amendments",77,1,0,1,79
625851,358399,2014-04-22,Senate,"Do pass as amended, and re-refer to the Committee on Appropriations",6,0,1,0,7
625851,365364,2014-05-19,Senate,"Senate 3rd Reading SB1422 Padilla",34,0,6,0,40
625851,372809,2014-06-17,Assembly,"Do pass and be re-referred to the Committee on Appropriations",9,0,0,1,10
625851,375615,2014-07-02,Assembly,"Do pass, to Consent Calendar",17,0,0,0,17
625851,376749,2014-08-07,Assembly,"SB 1422 Padilla  Consent Calendar Second Day  Regular Session",77,0,0,2,79
625851,376864,2014-08-11,Senate,"Unfinished Business SB1422 Padilla Concurrence",36,0,4,0,40
625853,360507,2014-04-29,Assembly,"Do pass and be re-referred to the Committee on Appropriations",11,2,0,1,14
625853,362999,2014-05-07,Assembly,"Do pass",12,5,0,0,17
625853,366805,2014-05-23,Assembly,"AB 2396 BONTA  Assembly Third Reading",55,17,0,7,79
625853,374100,2014-06-23,Senate,"Do pass, but re-refer to the Committee on Appropriations",5,3,1,0,9
625853,376528,2014-08-04,Senate,"Placed on Appropriations Suspense file",7,0,0,0,7
625853,377322,2014-08-14,Senate,"Do pass",5,0,2,0,7
625853,378041,2014-08-21,Senate,"Assembly 3rd Reading AB2396 Bonta By Corbett",24,10,6,0,40
625853,378564,2014-08-26,Assembly,"AB 2396 BONTA  Concurrence in Senate Amendments",62,15,0,2,79
625854,364489,2014-05-13,Assembly,"Do pass as amended and be re-referred to the Committee on 	Appropriations",6,1,0,2,9
625854,366362,2014-05-21,Assembly,"Do pass",17,0,0,0,17
625854,367013,2014-05-23,Assembly,"AB 2323 GORELL  Assembly Third Reading",56,7,0,16,79
625854,372893,2014-06-18,Senate,"Do pass as amended, and re-refer to the Committee on Appropriations",7,0,0,0,7
625854,376889,2014-08-11,Senate,"Placed on Appropriations Suspense file",7,0,0,0,7
625855,360561,2014-04-29,Assembly,"Do pass as amended and be re-referred to the Committee on 	Appropriations",10,1,0,4,15
625856,359321,2014-04-23,Assembly,"Do pass and be re-referred to the Committee on Appropriations",13,0,0,0,13
625856,361127,2014-04-30,Assembly,"Do pass, to Consent Calendar",17,0,0,0,17
625856,363348,2014-05-08,Assembly,"AB 2362 GROVE  Consent Calendar Second Day  Regular Session",73,0,0,6,79
625856,371033,2014-06-11,Senate,"Do pass, but re-refer to the Committee on Public Safety",2,2,1,0,5
625856,371034,2014-06-11,Senate,"Set, first hearing.  Failed passage in Committee.  Reconsideration 	granted",5,0,0,0,5
625857,359674,2014-04-23,Assembly,"Do pass and be re-referred to the Committee on Judiciary",7,0,0,0,7
625857,360564,2014-04-29,Assembly,"Do pass",10,0,0,0,10
625857,362274,2014-05-05,Assembly,"AB 2288 HERNANDEZ  Assembly Third Reading",76,0,0,3,79
625857,370879,2014-06-10,Senate,"Do pass",6,0,1,0,7
625857,374741,2014-06-26,Senate,"Special Consent #17 AB2288 Roger Hern",32,0,8,0,40
625859,361266,2014-04-30,Senate,"Do pass as amended",4,2,1,0,7
625859,363725,2014-05-12,Senate,"Senate 3rd Reading SB1404 Leno",22,9,9,0,40
625859,369813,2014-06-04,Assembly,"Do pass and be re-referred to the Committee on Housing and 	Community Development",7,0,0,2,9
625859,372775,2014-06-18,Assembly,"Do pass",5,1,0,1,7
625859,377873,2014-08-19,Assembly,"SB 1404 Leno  Senate Third Reading  By AMMIANO",55,21,0,3,79
625859,377956,2014-08-20,Senate,"Unfinished Business SB1404 Leno Concurrence",24,11,5,0,40
625859,379031,2014-08-29,Senate,"Unfinished Supp 4 SB1404 Leno Concurrence",22,11,7,0,40
625860,348074,2014-03-26,Assembly,"Do pass and be re-referred to the Committee on Local Government",6,0,0,1,7
625860,350945,2014-04-02,Assembly,"Do pass and be re-referred to the Committee on Appropriations",9,0,0,0,9
625860,367048,2014-05-23,Assembly,"Do pass as amended",16,0,0,1,17
625860,368027,2014-05-28,Assembly,"AB 2241 EGGMAN  Assembly Third Reading",76,0,0,3,79
625860,372557,2014-06-18,Senate,"Do pass, but re-refer to the Committee on Appropriations Recommend 	Consent",7,0,0,0,7
625860,375274,2014-06-30,Senate,"Placed on Appropriations Suspense file",6,0,1,0,7
625860,377196,2014-08-14,Senate,"Do pass",5,0,2,0,7
625860,377792,2014-08-19,Senate,"Assembly 3rd Reading AB2241 Eggman By Wolk",33,0,7,0,40
625861,350270,2014-04-01,Senate,"Do pass, but re-refer to the Committee on Environmental Quality",5,0,0,0,5
625861,361251,2014-04-30,Senate,"Do pass, but re-refer to the Committee on Appropriations",7,0,0,0,7
625861,365351,2014-05-19,Senate,"Senate 3rd Reading SB1332 Wolk",26,7,7,0,40
625861,372317,2014-06-17,Assembly,"Do pass and be re-referred to the Committee on Appropriations",6,1,0,0,7
625861,375626,2014-07-02,Assembly,"Do pass",13,4,0,0,17
625861,376858,2014-08-07,Assembly,"SB 1332 Wolk  Senate Third Reading  By ALEJO",61,14,0,4,79
625862,361219,2014-04-29,Assembly,"Do pass and re-refer to Committee on Appropriations with 	recommendation:  To Consent Calendar",7,0,0,0,7
625862,364722,2014-05-14,Assembly,"Do pass as amended, to Consent Calendar",17,0,0,0,17
625862,366773,2014-05-23,Assembly,"AB 2547 GAINES  Consent Calendar Second Day  Regular Session",73,0,0,6,79
625862,373461,2014-06-18,Senate,"Do pass, but re-refer to the Committee on Human Services Recommend 	Consent",8,0,1,0,9
625862,374516,2014-06-24,Senate,"Do pass, but re-refer to the Committee on Appropriations Recommend 	Consent",4,0,1,0,5
625862,376755,2014-08-07,Senate,"Consent Calendar 2nd AB2547 Beth Gaines",34,0,6,0,40
625863,350555,2014-04-01,Assembly,"Do pass and re-refer to Committee on Appropriations with 	recommendation:  To Consent Calendar",7,0,0,0,7
625863,367058,2014-05-23,Assembly,"Do pass as amended",17,0,0,0,17
625863,368218,2014-05-28,Assembly,"AB 2521 HAGMAN  Assembly Third Reading",78,0,0,1,79
625863,374545,2014-06-24,Senate,"Do pass, but re-refer to the Committee on Appropriations",7,0,0,0,7
625863,376462,2014-08-04,Senate,"Placed on Appropriations Suspense file",7,0,0,0,7
625864,363156,2014-05-07,Assembly,"Do pass, to Consent Calendar",18,0,0,1,19
625864,364973,2014-05-15,Assembly,"AB 2655 HALL  Consent Calendar Second Day  Regular Session",78,0,0,1,79
625864,374116,2014-06-24,Senate,"Do pass and be placed on the Consent Calendar",10,0,0,0,10
625864,375261,2014-06-30,Senate,"Consent Calendar 2nd AB2655 Hall",36,0,4,0,40
625865,353921,2014-04-08,Senate,"Do pass as amended, and re-refer to the Committee on 	Appropriations",6,2,2,0,10
625865,360124,2014-04-28,Senate,"Placed on Appropriations Suspense file",6,0,1,0,7
625866,360707,2014-04-28,Assembly,"Do pass, to Consent Calendar",15,0,0,1,16
625866,362326,2014-05-05,Assembly,"AB 2438 LOWENTHAL  Consent Calendar Second Day",75,0,0,4,79
625866,370470,2014-06-10,Senate,"Do pass",10,0,1,0,11
625866,374867,2014-06-26,Senate,"Special Consent #17 AB2438 Lowenthal By Walters",32,0,8,0,40
625867,350373,2014-04-01,Senate,"Do pass, but re-refer to the Committee on Appropriations Recommend 	Consent",5,0,0,0,5
625867,361613,2014-05-01,Senate,"Consent Calendar 2nd SB1399 Galgiani",35,0,5,0,40
625867,373353,2014-06-18,Assembly,"Do pass and be re-referred to the Committee on Appropriations",7,0,0,0,7
625867,375629,2014-07-02,Assembly,"Do pass, to Consent Calendar",17,0,0,0,17
625867,376860,2014-08-11,Assembly,"SB 1399 Galgiani  Senate Third Reading  By EGGMAN",79,0,0,0,79
625868,358768,2014-04-22,Senate,"Do pass as amended, and re-refer to the Committee on Appropriations",4,1,2,0,7
625868,363773,2014-05-12,Senate,"Placed on Appropriations Suspense file",7,0,0,0,7
625868,366666,2014-05-23,Senate,"Do pass",7,0,0,0,7
625868,367497,2014-05-27,Senate,"Senate 3rd Reading SB1284 Galgiani",30,1,9,0,40
625869,354577,2014-04-08,Assembly,"Do pass, to Consent Calendar",7,0,0,0,7
625869,359562,2014-04-24,Assembly,"AB 2252 PEREZ, J.  Consent Calendar Second Day",75,0,0,4,79
625869,370971,2014-06-10,Senate,"Do pass as amended",6,0,1,0,7
625869,375365,2014-06-30,Senate,"Assembly 3rd Reading AB2252 John A. P",33,0,7,0,40
625869,375633,2014-07-03,Assembly,"AB 2252 PEREZ, J.  Concurrence in Senate Amendments",77,0,0,2,79
625870,360639,2014-04-28,Assembly,"Do pass and be re-referred to the Committee on Insurance",13,0,0,2,15
625870,362978,2014-05-07,Assembly,"Do pass",11,0,0,2,13
625870,367431,2014-05-27,Assembly,"AB 2293 BONILLA  Assembly Third Reading",71,0,0,8,79
625870,372242,2014-06-17,Senate,"Do pass, but re-refer to the Committee on Insurance",10,0,1,0,11
625870,374767,2014-06-25,Senate,"Do pass as amended, and re-refer to the Committee on 	Appropriations",9,1,1,0,11
625870,376440,2014-08-04,Senate,"Placed on Appropriations Suspense file",7,0,0,0,7
625870,377269,2014-08-14,Senate,"Do pass as amended",5,1,1,0,7
625870,378669,2014-08-27,Senate,"Assembly 3rd Supp 1 AB2293 Bonilla By Mitchell",30,4,6,0,40
625870,378908,2014-08-28,Assembly,"AB 2293 BONILLA  Concurrence in Senate Amendments",73,0,0,6,79
625871,348323,2014-03-26,Assembly,"Do pass and be re-referred to the Committee on Appropriations",5,1,0,1,7
625871,367144,2014-05-23,Assembly,"Do pass as amended",12,5,0,0,17
625871,368211,2014-05-28,Assembly,"AB 2449 BOCANEGRA  Assembly Third Reading",55,23,0,1,79
625871,374557,2014-06-25,Senate,"Do pass, but re-refer to the Committee on Appropriations",4,2,1,0,7
625871,376619,2014-08-04,Senate,"Placed on Appropriations Suspense file",7,0,0,0,7
625873,360622,2014-04-28,Assembly,"Do pass and be re-referred to the Committee on Appropriations",8,0,0,1,9
625873,367140,2014-05-23,Assembly,"Do pass",16,0,0,1,17
625873,367610,2014-05-27,Assembly,"AB 2262 FRAZIER  Assembly Third Reading",75,0,0,4,79
625873,372555,2014-06-18,Senate,"Do pass, but re-refer to the Committee on Appropriations",7,0,0,0,7
625873,375217,2014-06-30,Senate,"Placed on Appropriations Suspense file",6,0,1,0,7
625874,350890,2014-04-02,Senate,"Do pass as amended, and re-refer to the Committee on Appropriations",7,0,2,0,9
625874,360122,2014-04-28,Senate,"Placed on Appropriations Suspense file",6,0,1,0,7
625874,366950,2014-05-23,Senate,"Do pass",7,0,0,0,7
625874,368719,2014-05-29,Senate,"Senate 3rd Reading SB1346 Wyland",31,0,9,0,40
625875,363241,2014-05-07,Senate,"Do pass, but re-refer to the Committee on Appropriations",2,4,1,0,7
625875,363242,2014-05-07,Senate,"Set, first hearing.  Failed passage in Committee.  Reconsideration 	granted",6,0,1,0,7
625875,364407,2014-05-14,Senate,"Do pass as amended, and re-refer to the Committee on Appropriations",1,4,2,0,7
625876,361635,2014-04-30,Senate,"Do pass as amended, and re-refer to the Committee on 	Appropriations",6,1,2,0,9
625876,367598,2014-05-27,Senate,"Senate 3rd Reading SB1297 Hueso",23,10,7,0,40
625879,360558,2014-04-29,Senate,"Do pass, but re-refer to the Committee on Appropriations",4,2,1,0,7
625879,363833,2014-05-12,Senate,"Placed on Appropriations Suspense file",7,0,0,0,7
625879,366941,2014-05-23,Senate,"Do pass",5,2,0,0,7
625879,367520,2014-05-27,Senate,"Senate 3rd Reading SB1363 Hancock",15,16,9,0,40
625879,367521,2014-05-27,Senate,"Senate 3rd Reading SB1363 Hancock Reconsider",35,0,5,0,40
625881,353338,2014-04-08,Senate,"Do pass, but re-refer to the Committee on Environmental Quality",7,1,1,0,9
625881,361304,2014-04-30,Senate,"Do pass as amended, and re-refer to the Committee on 	Appropriations",5,1,1,0,7
625881,365488,2014-05-19,Senate,"Placed on Appropriations Suspense file",7,0,0,0,7
625881,367075,2014-05-23,Senate,"Do pass as amended",6,1,0,0,7
625881,368201,2014-05-28,Senate,"Senate 3rd Reading SB1319 Pavley",23,12,5,0,40
625881,372261,2014-06-16,Assembly,"Do pass and be re-referred to the Committee on Utilities and 	Commerce",6,3,0,0,9
625881,374117,2014-06-23,Assembly,"Do pass as amended and be re-referred to the Committee on 	Appropriations",9,5,0,1,15
625881,377215,2014-08-14,Assembly,"Do pass as amended",12,0,0,5,17
625881,378231,2014-08-22,Assembly,"SB 1319 Pavley  Senate Third Reading  Amend By DICKINSON  Set #1",50,20,0,9,79
625881,378937,2014-08-28,Assembly,"Do pass as amended",11,5,0,1,17
625881,379036,2014-08-29,Assembly,"SB 1319 Pavley  Senate Third Reading  By DICKINSON",48,26,0,5,79
625881,379037,2014-08-29,Senate,"Unfinished Supp 3 SB1319 Pavley Concurrence",24,10,6,0,40
625882,361423,2014-04-29,Senate,"Do pass, but re-refer to the Committee on Appropriations",8,0,3,0,11
625882,365340,2014-05-19,Senate,"Senate 3rd Reading SB1430 Hill Urgency Clause",28,4,8,0,40
625882,373779,2014-06-23,Assembly,"Do pass and be re-referred to the Committee on Appropriations",11,0,0,5,16
625882,376669,2014-08-06,Assembly,"Do pass",14,3,0,0,17
625882,377833,2014-08-19,Assembly,"SB 1430 Hill  Third Reading Urgency  By MULLIN",61,13,0,5,79
625883,360570,2014-04-29,Assembly,"Do pass and be re-referred to the Committee on Appropriations",13,0,0,0,13
625883,364574,2014-05-14,Assembly,"Do pass, to Consent Calendar",17,0,0,0,17
625883,366748,2014-05-23,Assembly,"AB 2557 WILLIAMS  Consent Calendar Second Day  Regular Session",73,0,0,6,79
625883,374703,2014-06-25,Senate,"Do pass, but re-refer to the Committee on Appropriations Recommend 	Consent",6,0,1,0,7
625883,379066,2014-08-29,Assembly,"Senate amendments be concurred in",15,2,0,2,19
625883,379067,2014-08-29,Senate,"Do pass, but re-refer to the Committee on Appropriations",8,0,1,0,9
625883,379068,2014-08-29,Senate,"Assembly 3rd Supp 1 AB2557 Pan Urgency Clause",34,0,6,0,40
625883,379069,2014-08-30,Assembly,"AB 2557 PAN  Concurrence- Urgency Added",74,4,0,1,79
625884,361193,2014-04-30,Senate,"Do pass, but re-refer to the Committee on Appropriations",5,2,0,0,7
625884,363688,2014-05-12,Senate,"Placed on Appropriations Suspense file",7,0,0,0,7
625884,366879,2014-05-23,Senate,"Do pass as amended",5,2,0,0,7
625884,368724,2014-05-29,Senate,"Senate 3rd Reading SB1261 Jackson",29,5,6,0,40
625884,372247,2014-06-17,Assembly,"Do pass and be re-referred to the Committee on Appropriations",7,0,0,0,7
625884,375572,2014-07-02,Assembly,"Do pass",17,0,0,0,17
625884,376947,2014-08-11,Assembly,"SB 1261 Jackson  Senate Third Reading  By ALEJO",78,0,0,1,79
625884,378379,2014-08-25,Assembly,"SB 1261 Jackson  Senate Third Reading  By ALEJO",79,0,0,0,79
625884,378462,2014-08-26,Senate,"Unfinished Supp 1 SB1261 Jackson Concurrence",36,0,4,0,40
625886,350306,2014-04-01,Assembly,"Do pass and be re-referred to the Committee on Appropriations",13,0,0,0,13
625886,367211,2014-05-23,Assembly,"Do pass as amended",17,0,0,0,17
625886,368042,2014-05-28,Assembly,"AB 2232 GRAY  Assembly Third Reading",76,0,0,3,79
625886,372688,2014-06-18,Senate,"Do pass, but re-refer to the Committee on Appropriations Recommend 	Consent",7,0,0,0,7
625886,375319,2014-06-30,Senate,"Placed on Appropriations Suspense file",6,0,1,0,7
625887,358407,2014-04-22,Senate,"Do pass, but re-refer to the Committee on Appropriations Recommend 	Consent",10,0,0,0,10
625887,362280,2014-05-05,Senate,"Placed on Appropriations Suspense file",7,0,0,0,7
625887,366677,2014-05-23,Senate,"Do pass",7,0,0,0,7
625887,368082,2014-05-28,Senate,"Senate 3rd Reading SB1265 Hueso",35,0,5,0,40
625887,373021,2014-06-18,Assembly,"Do pass and be re-referred to the Committee on Appropriations",13,0,0,0,13
625887,377393,2014-08-14,Assembly,"Do pass as amended",16,1,0,0,17
625887,378680,2014-08-27,Assembly,"SB 1265 Hueso  Senate Third Reading  By FRAZIER",75,2,0,2,79
625887,378884,2014-08-28,Senate,"Unfinished Business SB1265 Hueso Concurrence",34,0,6,0,40
625888,353865,2014-04-07,Assembly,"Do pass and be re-referred to the Committee on Utilities and 	Commerce",3,3,0,3,9
625888,353866,2014-04-07,Assembly,"Set first hearing.  Failed passage.  Reconsideration granted",9,0,0,0,9
625891,363149,2014-05-07,Assembly,"Do pass",6,1,0,2,9
625891,368370,2014-05-28,Assembly,"AB 2453 ACHADJIAN  Assembly Third Reading",50,11,0,18,79
625891,372683,2014-06-18,Senate,"Do pass, but re-refer to the Committee on Natural Resources and 	Water",6,0,1,0,7
625891,374087,2014-06-24,Senate,"Do pass as amended",8,0,1,0,9
625891,377099,2014-08-13,Senate,"Assembly 3rd Reading AB2453 Achadjian By Monning",30,3,7,0,40
625891,377695,2014-08-18,Assembly,"AB 2453 ACHADJIAN  Concurrence in Senate Amendments",51,8,0,20,79
625892,360945,2014-04-29,Assembly,"Do pass and be re-referred to the Committee on Appropriations",19,0,0,0,19
625892,363013,2014-05-07,Assembly,"Do pass, to Consent Calendar",17,0,0,0,17
625892,364922,2014-05-15,Assembly,"AB 2425 QUIRK  Consent Calendar Second Day  Regular Session",78,0,0,1,79
625892,375081,2014-06-25,Senate,"Do pass as amended, and re-refer to the Committee on 	Appropriations",8,0,1,0,9
625892,378119,2014-08-21,Senate,"Assembly 3rd Reading AB2425 Quirk By Beall",36,0,4,0,40
625892,378236,2014-08-22,Assembly,"AB 2425 QUIRK  Concurrence in Senate Amendments",76,0,0,3,79
625893,354854,2014-04-09,Assembly,"Do pass",6,2,0,1,9
625893,365348,2014-05-19,Assembly,"AB 2443 RENDON  Assembly Third Reading",51,23,0,5,79
625893,374019,2014-06-24,Senate,"Do pass",5,1,3,0,9
625893,378638,2014-08-27,Senate,"Assembly 3rd Reading AB2443 Rendon By Lara",35,0,5,0,40
625893,378976,2014-08-28,Assembly,"AB 2443 RENDON  Concurrence in Senate Amendments",77,1,0,1,79
625894,360657,2014-04-29,Senate,"Do pass as amended",6,0,1,0,7
625894,365415,2014-05-19,Senate,"Placed on Appropriations Suspense file",7,0,0,0,7
625896,359877,2014-04-24,Senate,"Do pass as amended, but re-refer to the Committee on Public Safety 	Recommend Consent",8,0,1,0,9
625896,363764,2014-05-12,Senate,"Placed on Appropriations Suspense file",7,0,0,0,7
625896,367111,2014-05-23,Senate,"Do pass as amended",7,0,0,0,7
625896,368058,2014-05-28,Senate,"Senate 3rd Reading SB1339 Cannella",36,0,4,0,40
625896,374683,2014-06-24,Assembly,"Do pass as amended and re-refer to Committee on Appropriations 	with recommendation:  To Consent Calendar",17,0,0,2,19
625896,377041,2014-08-13,Assembly,"Do pass, to Consent Calendar",17,0,0,0,17
625896,377781,2014-08-19,Assembly,"SB 1339 Cannella  Consent Calendar Second Day",78,0,0,1,79
625896,377912,2014-08-20,Senate,"Unfinished Business SB1339 Cannella Concurrence",35,0,5,0,40
625898,363154,2014-05-07,Assembly,"Do pass",9,0,0,0,9
625898,365380,2014-05-19,Assembly,"AB 2546 SALAS  Assembly Third Reading",76,0,0,3,79
625898,373329,2014-06-18,Senate,"Do pass, but re-refer to the Committee on Governance and Finance",8,0,1,0,9
625898,374526,2014-06-25,Senate,"Do pass as amended",7,0,0,0,7
625898,377288,2014-08-14,Senate,"Assembly 3rd Reading AB2546 Salas By Fuller",34,0,6,0,40
625898,378153,2014-08-21,Assembly,"AB 2546 SALAS  Concurrence in Senate Amendments",79,0,0,0,79
625899,353299,2014-04-07,Assembly,"Do pass and be re-referred to the Committee on Natural Resources",10,4,0,1,15
625899,360929,2014-04-28,Assembly,"Do pass and be re-referred to the Committee on Appropriations",5,2,0,2,9
625899,366952,2014-05-23,Assembly,"Do pass",12,4,0,1,17
625899,368193,2014-05-28,Assembly,"AB 2593 BRADFORD  Assembly Third Reading",53,22,0,4,79
625899,374290,2014-06-25,Senate,"Do pass, but re-refer to the Committee on Appropriations",5,2,0,0,7
625899,376614,2014-08-04,Senate,"Placed on Appropriations Suspense file",7,0,0,0,7
625899,377539,2014-08-14,Senate,"Do pass",5,0,2,0,7
625899,378422,2014-08-25,Senate,"Assembly 3rd Reading AB2593 Bradford By Hueso",21,12,7,0,40
625899,378653,2014-08-27,Assembly,"AB 2593 BRADFORD  Concurrence in Senate Amendments",54,22,0,3,79
625900,348473,2014-03-26,Senate,"Do pass as amended, and re-refer to the Committee on 	Appropriations",7,0,2,0,9
625900,360076,2014-04-28,Senate,"Do pass",5,0,2,0,7
625900,361688,2014-05-01,Senate,"Senate 3rd Reading SB1457 Evans",35,0,5,0,40
625900,374402,2014-06-24,Assembly,"Do pass as amended and be re-referred to the Committee on 	Appropriations",17,0,0,2,19
625900,376732,2014-08-06,Assembly,"Do pass, to Consent Calendar",17,0,0,0,17
625900,377163,2014-08-14,Assembly,"SB 1457 Evans  Consent Calendar Second Day  Regular Session",78,0,0,1,79
625900,377662,2014-08-18,Senate,"Unfinished Business SB1457 Evans Concurrence",36,0,4,0,40
625902,360652,2014-04-29,Assembly,"Do pass and be re-referred to the Committee on Appropriations",19,0,0,0,19
625902,366927,2014-05-23,Assembly,"Do pass as amended",17,0,0,0,17
625902,368747,2014-05-29,Assembly,"AB 2418 BONILLA  Assembly Third Reading",75,1,0,3,79
625902,374835,2014-06-25,Senate,"Do pass as amended, and re-refer to the Committee on 	Appropriations",7,0,2,0,9
625902,376576,2014-08-04,Senate,"Placed on Appropriations Suspense file",7,0,0,0,7
625902,377242,2014-08-14,Senate,"Do pass as amended",6,0,1,0,7
625902,378097,2014-08-21,Senate,"Assembly 3rd Reading AB2418 Bonilla By Hill",31,1,8,0,40
625902,378319,2014-08-25,Assembly,"AB 2418 BONILLA  Concurrence in Senate Amendments",79,0,0,0,79
625904,353227,2014-04-08,Assembly,"Do pass as amended and be re-referred to the Committee on 	Transportation",14,0,0,0,14
625904,360721,2014-04-28,Assembly,"Do pass and be re-referred to the Committee on Appropriations",15,0,0,1,16
625904,363127,2014-05-07,Assembly,"Do pass, to Consent Calendar",17,0,0,0,17
625904,364861,2014-05-15,Assembly,"AB 2503 HAGMAN  Consent Calendar Second Day  Regular Session",78,0,0,1,79
625904,371746,2014-06-16,Senate,"Do pass, but re-refer to the Committee on Transportation and 	Housing",8,0,1,0,9
625904,376520,2014-08-05,Senate,"Do pass, but re-refer to the Committee on Appropriations",10,0,1,0,11
625904,378080,2014-08-21,Senate,"Assembly 3rd Reading AB2503 Hagman Urgency Clause",36,0,4,0,40
625904,378219,2014-08-22,Assembly,"AB 2503 HAGMAN  Concurrence- Urgency Added",76,0,0,3,79
625905,360726,2014-04-29,Senate,"Do pass as amended, and re-refer to the Committee on Appropriations",8,1,2,0,11
625905,365383,2014-05-19,Senate,"Placed on Appropriations Suspense file",7,0,0,0,7
625905,366796,2014-05-23,Senate,"Do pass as amended",5,2,0,0,7
625905,368717,2014-05-29,Senate,"Senate 3rd Reading SB1371 Leno",25,10,5,0,40
625905,373978,2014-06-23,Assembly,"Do pass and be re-referred to the Committee on Appropriations",10,3,0,2,15
625905,377139,2014-08-14,Assembly,"Do pass",13,4,0,0,17
625905,378494,2014-08-26,Assembly,"SB 1371 Leno  Senate Third Reading  By MULLIN",57,20,0,2,79
625905,378728,2014-08-27,Senate,"Unfinished Business SB1371 Leno Concurrence",23,11,6,0,40
625906,358629,2014-04-22,Assembly,"Do pass and re-refer to Committee on Appropriations with 	recommendation:  To Consent Calendar",14,0,0,0,14
625906,361243,2014-04-30,Assembly,"Do pass, to Consent Calendar",17,0,0,0,17
625906,363354,2014-05-08,Assembly,"AB 2312 NESTANDE  Consent Calendar Second Day  Regular Session",73,0,0,6,79
625906,371754,2014-06-16,Senate,"Do pass, but re-refer to the Committee on Public Safety",7,0,2,0,9
625906,374513,2014-06-24,Senate,"Do pass, but re-refer to the Committee on Appropriations",7,0,0,0,7
625906,376884,2014-08-11,Senate,"Assembly 3rd Reading AB2312 Nestande By Berryhill",33,1,6,0,40
625906,377675,2014-08-18,Assembly,"AB 2312 NESTANDE  Concurrence in Senate Amendments",78,0,0,1,79
625907,360595,2014-04-29,Assembly,"Do pass as amended and be re-referred to the Committee on 	Appropriations",19,0,0,0,19
625907,364395,2014-05-14,Assembly,"Do pass, to Consent Calendar",17,0,0,0,17
625907,366695,2014-05-23,Assembly,"AB 2264 LEVINE  Consent Calendar Second Day  Regular Session",73,0,0,6,79
625907,374312,2014-06-24,Senate,"Do pass as amended, and re-refer to the Committee on Appropriations",7,0,0,0,7
625907,376436,2014-08-04,Senate,"Do pass",7,0,0,0,7
625907,377101,2014-08-13,Senate,"Assembly 3rd Reading AB2264 Levine By Pavley",36,0,4,0,40
625907,378571,2014-08-26,Assembly,"Senate amendments be concurred in",7,0,0,0,7
625907,378670,2014-08-27,Assembly,"AB 2264 LEVINE  Concurrence in Senate Amendments",77,0,0,2,79
625908,360574,2014-04-29,Assembly,"Do pass and be re-referred to the Committee on Appropriations",13,0,0,0,13
625908,364771,2014-05-14,Assembly,"Do pass, to Consent Calendar",17,0,0,0,17
625908,366861,2014-05-23,Assembly,"AB 2295 RIDLEY-THOMAS  Consent Calendar Second Day  Regular Session",73,0,0,6,79
625908,374558,2014-06-25,Senate,"Do pass as amended, but re-refer to the Committee on Appropriations 	Recommend Consent",6,0,1,0,7
625908,376596,2014-08-04,Senate,"Placed on Appropriations Suspense file",7,0,0,0,7
625908,377532,2014-08-14,Senate,"Do pass",5,0,2,0,7
625908,377801,2014-08-19,Senate,"Assembly 3rd Reading AB2295 Ridley-Thomas By Correa",32,0,8,0,40
625908,377930,2014-08-20,Assembly,"AB 2295 RIDLEY-THOMAS  Concurrence in Senate Amendments",77,0,0,2,79
625911,353265,2014-04-08,Assembly,"Do pass and be re-referred to the Committee on Appropriations",10,5,0,0,15
625911,367178,2014-05-23,Assembly,"Do pass as amended",12,5,0,0,17
625911,368730,2014-05-29,Assembly,"AB 2684 STONE  Assembly Third Reading",55,20,0,4,79
625911,374434,2014-06-25,Senate,"Do pass, but re-refer to the Committee on Appropriations",5,1,1,0,7
625911,376459,2014-08-04,Senate,"Placed on Appropriations Suspense file",7,0,0,0,7
625912,358670,2014-04-22,Assembly,"Do pass as amended and be re-referred to the Committee on 	Appropriations",10,0,0,0,10
625912,363152,2014-05-07,Assembly,"Do pass, to Consent Calendar",17,0,0,0,17
625912,365249,2014-05-19,Assembly,"AB 2399 PEREZ, J.  Assembly Third Reading",76,0,0,3,79
625912,372355,2014-06-17,Senate,"Do pass, but re-refer to the Committee on Judiciary",11,0,0,0,11
625912,374316,2014-06-24,Senate,"Do pass, but re-refer to the Committee on Appropriations",7,0,0,0,7
625912,378390,2014-08-25,Senate,"Assembly 3rd Reading AB2399 John A. P",33,0,7,0,40
625912,378550,2014-08-26,Assembly,"AB 2399 PEREZ, J.  Concurrence in Senate Amendments",79,0,0,0,79
625913,361671,2014-04-30,Assembly,"Do pass and be re-referred to the Committee on Appropriations",7,0,0,0,7
625913,367191,2014-05-23,Assembly,"Do pass as amended",13,0,0,4,17
625913,368130,2014-05-28,Assembly,"AB 2303 BLOOM  Assembly Third Reading",65,11,0,3,79
625913,374286,2014-06-25,Senate,"Do pass as amended, and re-refer to the Committee on Appropriations",5,1,1,0,7
625913,376504,2014-08-04,Senate,"Placed on Appropriations Suspense file",7,0,0,0,7
625914,364479,2014-05-13,Assembly,"Do pass and be re-referred to the Committee on Appropriations",5,2,0,2,9
625915,364467,2014-05-13,Assembly,"Do pass and be re-referred to the Committee on Appropriations",7,0,0,2,9
625917,354515,2014-04-08,Assembly,"Do pass as amended and be re-referred to the Committee on Judiciary",7,0,0,0,7
625917,360518,2014-04-29,Assembly,"Do pass and be re-referred to the Committee on Appropriations",10,0,0,0,10
625917,366864,2014-05-23,Assembly,"Do pass",17,0,0,0,17
625917,367591,2014-05-27,Assembly,"AB 2391 CALDERON  Assembly Third Reading",77,0,0,2,79
625918,353684,2014-04-07,Assembly,"Do pass as amended and be re-referred to the Committee on 	Appropriations",9,0,0,0,9
625919,352692,2014-04-07,Assembly,"Be referred to Committee on Natural Resources",11,0,0,0,11
625919,353256,2014-04-07,Assembly,"Be referred to Committee on Revenue and Taxation",11,0,0,0,11
625919,358075,2014-04-21,Assembly,"Do pass as amended and be re-referred to the Committee on Natural 	Resources",8,0,0,1,9
625919,360456,2014-04-28,Assembly,"Do pass and be re-referred to the Committee on Appropriations",6,0,0,3,9
625919,363121,2014-05-07,Assembly,"Do pass, to Consent Calendar",17,0,0,0,17
625919,365248,2014-05-19,Assembly,"AB 2597 TING  Assembly Third Reading",75,0,0,4,79
625919,372158,2014-06-17,Senate,"Do pass, but re-refer to the Committee on Appropriations",9,1,1,0,11
625919,376791,2014-08-07,Senate,"Assembly 3rd Reading AB2597 Ting By Pavley",28,6,6,0,40
625919,377729,2014-08-18,Assembly,"AB 2597 TING  Concurrence in Senate Amendments",75,0,0,4,79
625920,361028,2014-04-29,Assembly,"Do pass",10,4,0,0,14
625920,363509,2014-05-08,Assembly,"AB 2414 TING  Assembly Third Reading",52,20,0,7,79
625920,374204,2014-06-24,Senate,"Do pass",8,2,0,0,10
625920,376388,2014-08-04,Senate,"Assembly 3rd Reading AB2414 Ting By De Le",25,11,4,0,40
625922,353286,2014-04-08,Assembly,"Do pass as amended and be re-referred to the Committee on Local 	Government",4,0,0,2,6
625922,361618,2014-04-30,Assembly,"Do pass and be re-referred to the Committee on Appropriations",8,0,0,1,9
625922,366813,2014-05-23,Assembly,"Do pass",16,0,0,1,17
625922,367596,2014-05-27,Assembly,"AB 2371 MULLIN  Assembly Third Reading",76,0,0,3,79
625925,359600,2014-04-24,Senate,"Do pass, but re-refer to the Committee on Appropriations",5,0,0,0,5
625925,364854,2014-05-15,Senate,"Special Consent #14 SB1314 Monning",36,0,4,0,40
625925,374365,2014-06-25,Assembly,"Do pass and re-refer to Committee on Appropriations with 	recommendation:  To Consent Calendar",13,0,0,0,13
625925,377212,2014-08-14,Assembly,"Do pass",17,0,0,0,17
625925,377990,2014-08-20,Assembly,"SB 1314 Monning  Senate Third Reading  By PEREA",78,0,0,1,79
625925,378125,2014-08-21,Senate,"Unfinished Business SB1314 Monning Concurrence",35,0,5,0,40
625926,355054,2014-04-09,Senate,"Do pass",8,0,1,0,9
625926,360059,2014-04-28,Senate,"Senate 3rd Reading SB1340 Hernandez",33,0,7,0,40
625926,372445,2014-06-17,Assembly,"Do pass",17,0,0,2,19
625926,374959,2014-06-26,Assembly,"SB 1340 Hernandez  Senate Third Reading  By MAIENSCHEIN",77,0,0,2,79
625927,359680,2014-04-24,Senate,"Do pass and be placed on the Consent Calendar",7,0,0,0,7
625927,361689,2014-05-01,Senate,"Consent Calendar 2nd SB1352 Hancock",35,0,5,0,40
625927,369830,2014-06-04,Assembly,"Do pass, to Consent Calendar",8,0,0,1,9
625927,371383,2014-06-12,Assembly,"SB 1352 Hancock  Consent Calendar Second Day  Regular Session",76,0,0,3,79
625928,362726,2014-05-06,Assembly,"Do pass, to Consent Calendar",6,0,0,1,7
625928,364899,2014-05-15,Assembly,"AB 2562 FONG  Consent Calendar Second Day  Regular Session",78,0,0,1,79
625928,372206,2014-06-17,Senate,"Do pass",4,0,1,0,5
625928,378146,2014-08-21,Senate,"Assembly 3rd Reading AB2562 Fong By Padilla",33,0,7,0,40
625928,378249,2014-08-22,Assembly,"AB 2562 FONG  Concurrence in Senate Amendments",76,0,0,3,79
625930,359355,2014-04-23,Assembly,"Do pass",5,1,0,1,7
625930,365008,2014-05-15,Assembly,"AB 2419 GARCIA  Assembly Third Reading",51,22,0,6,79
625930,370234,2014-06-09,Senate,"Do pass",3,2,0,0,5
625930,375447,2014-06-30,Senate,"Assembly 3rd Reading AB2419 Garcia By Torres",25,10,5,0,40
625931,360487,2014-04-28,Assembly,"Do pass and be re-referred to the Committee on Appropriations",3,2,0,4,9
625932,360750,2014-04-29,Assembly,"Do pass as amended and be re-referred to the Committee on 	Appropriations",13,4,0,2,19
625932,364447,2014-05-14,Assembly,"Do pass",12,5,0,0,17
625932,365309,2014-05-19,Assembly,"AB 2539 TING  Assembly Third Reading",52,23,0,4,79
625932,373379,2014-06-18,Senate,"Do pass as amended, and re-refer to the Committee on 	Appropriations",6,2,1,0,9
625932,378279,2014-08-25,Senate,"Assembly 3rd Reading AB2539 Ting By Monning",22,11,7,0,40
625932,378641,2014-08-27,Assembly,"AB 2539 TING  Concurrence in Senate Amendments",53,24,0,2,79
625933,358679,2014-04-22,Assembly,"Do pass as amended and be re-referred to the Committee on 	Appropriations",6,0,0,3,9
625935,347551,2014-03-25,Assembly,"Do pass as amended and be re-referred to the Committee on 	Appropriations",10,0,0,0,10
625935,354591,2014-04-09,Assembly,"Do pass as amended",16,0,0,1,17
625935,359643,2014-04-24,Assembly,"AB 2485 DICKINSON  Third Reading Urgency",71,0,0,8,79
625935,374690,2014-06-24,Senate,"Do pass as amended, and re-refer to the Committee on 	Appropriations",6,1,0,0,7
625935,377968,2014-08-20,Senate,"Assembly 3rd Reading AB2485 Dickinson Urgency Clause",32,0,8,0,40
625935,378250,2014-08-22,Assembly,"AB 2485 DICKINSON  Concurrence in Senate Amendments",73,0,0,6,79
625936,361785,2014-04-30,Assembly,"Do pass and be re-referred to the Committee on Appropriations",7,0,0,0,7
625938,359281,2014-04-22,Assembly,"Do pass as amended and be re-referred to the Committee on 	Appropriations",7,0,0,2,9
625939,358585,2014-04-22,Assembly,"Do pass as amended and be re-referred to the Committee on 	Appropriations",7,0,0,0,7
625941,362859,2014-05-06,Assembly,"Do pass, to Consent Calendar",10,0,0,0,10
625941,364937,2014-05-15,Assembly,"AB 2317 MAIENSCHEIN  Consent Calendar Second Day  Regular Session",78,0,0,1,79
625941,372899,2014-06-17,Senate,"Do pass",6,0,1,0,7
625941,375645,2014-07-03,Senate,"Special Consent #18 AB2317 Maienschein",35,0,5,0,40
625942,353207,2014-04-07,Assembly,"Do pass as amended and be re-referred to the Committee on 	Appropriations",6,3,0,0,9
625943,351420,2014-04-02,Senate,"Do pass",7,0,0,0,7
625943,352660,2014-04-07,Senate,"Senate 3rd Reading SB1291 Nielsen",36,0,4,0,40
625943,369807,2014-06-04,Assembly,"Do pass",8,0,0,1,9
625943,376937,2014-08-11,Assembly,"SB 1291 Nielsen  Senate Third Reading  By DAHLE",79,0,0,0,79
625944,374405,2014-06-24,Senate,"Do pass as amended, and re-refer to the Committee on Public Safety",2,1,2,0,5
625944,374406,2014-06-24,Senate,"Reconsideration granted",5,0,0,0,5
625948,359626,2014-04-24,Senate,"Do pass, but re-refer to the Committee on Public Safety",8,0,1,0,9
625948,360539,2014-04-29,Senate,"Do pass, but re-refer to the Committee on Appropriations",6,0,1,0,7
625948,363772,2014-05-12,Senate,"Placed on Appropriations Suspense file",7,0,0,0,7
625948,366870,2014-05-23,Senate,"Do pass",7,0,0,0,7
625948,367595,2014-05-27,Senate,"Senate 3rd Reading SB1391 Hancock",35,0,5,0,40
625948,374422,2014-06-24,Assembly,"Do pass as amended and be re-referred to the Committee on 	Appropriations",12,1,0,0,13
625948,377282,2014-08-14,Assembly,"Do pass as amended",17,0,0,0,17
625948,378762,2014-08-27,Assembly,"SB 1391 Hancock  Senate Third Reading  By BONTA",77,1,0,1,79
625948,378946,2014-08-28,Senate,"Unfinished Business SB1391 Hancock Concurrence",34,0,6,0,40
625950,361300,2014-04-30,Assembly,"Do pass and be re-referred to the Committee on Appropriations",13,0,0,0,13
625950,366962,2014-05-23,Assembly,"Do pass as amended",14,0,0,3,17
625950,368647,2014-05-29,Assembly,"AB 2471 FRAZIER  Assembly Third Reading",63,11,0,5,79
625950,374187,2014-06-24,Senate,"Do pass as amended, and re-refer to the Committee on 	Appropriations",10,0,0,0,10
625951,363160,2014-05-07,Senate,"Do pass as amended, and re-refer to the Committee on Appropriations",2,4,1,0,7
625951,363161,2014-05-07,Senate,"Set, first hearing.  Failed passage in Committee.  Reconsideration 	granted",6,0,1,0,7
625951,364454,2014-05-14,Senate,"Do pass as amended, and re-refer to the Committee on Appropriations",1,4,2,0,7
625952,359263,2014-04-22,Assembly,"Do pass and be re-referred to the Committee on Appropriations",12,0,0,1,13
625952,367147,2014-05-23,Assembly,"Do pass",17,0,0,0,17
625952,367514,2014-05-27,Assembly,"AB 2352 CHESBRO  Assembly Third Reading",77,0,0,2,79
625952,374333,2014-06-25,Senate,"Do pass, but re-refer to the Committee on Appropriations Recommend 	Consent",6,0,1,0,7
625952,376546,2014-08-04,Senate,"Placed on Appropriations Suspense file",7,0,0,0,7
625953,360542,2014-04-29,Senate,"Do pass",6,0,1,0,7
625953,362311,2014-05-05,Senate,"Senate 3rd Reading SB1406 Wolk",37,0,3,0,40
625953,370518,2014-06-10,Assembly,"Do pass, to Consent Calendar",7,0,0,0,7
625953,371775,2014-06-16,Assembly,"SB 1406 Wolk  Consent Calendar Second Day  Regular Session",77,0,0,2,79
625954,359122,2014-04-22,Senate,"Do pass, but re-refer to the Committee on Appropriations",10,0,1,0,11
625954,362184,2014-05-05,Senate,"Do pass",6,0,1,0,7
625954,363465,2014-05-08,Senate,"Senate 3rd Reading SB1433 Hill",35,0,5,0,40
625954,372708,2014-06-18,Assembly,"Do pass and be re-referred to the Committee on Transportation",8,0,0,1,9
625954,373708,2014-06-23,Assembly,"Do pass and be re-referred to the Committee on Appropriations",11,0,0,5,16
625954,377085,2014-08-13,Assembly,"Do pass as amended",15,2,0,0,17
625954,378898,2014-08-28,Assembly,"SB 1433 Hill  Senate Third Reading  By GORDON",78,0,0,1,79
625954,379108,2014-08-29,Senate,"Unfinished Business SB1433 Hill Concurrence",37,0,3,0,40
625955,358480,2014-04-21,Senate,"Do pass, but re-refer to the Committee on Public Safety",7,2,0,0,9
625955,360590,2014-04-29,Senate,"Do pass, but re-refer to the Committee on Appropriations",5,1,1,0,7
625955,363716,2014-05-12,Senate,"Placed on Appropriations Suspense file",7,0,0,0,7
625956,362942,2014-05-07,Assembly,"Do pass, to Consent Calendar",12,0,0,1,13
625956,364814,2014-05-15,Assembly,"AB 2347 GONZALEZ  Consent Calendar Second Day  Regular Session",78,0,0,1,79
625956,370998,2014-06-11,Senate,"Do pass as amended",10,0,1,0,11
625956,375431,2014-06-30,Senate,"Assembly 3rd Reading AB2347 Gonzalez By Torres",36,0,4,0,40
625956,375665,2014-07-03,Assembly,"AB 2347 GONZALEZ  Concurrence in Senate Amendments",76,0,0,3,79
625958,360578,2014-04-29,Senate,"Do pass as amended, and re-refer to the Committee on Appropriations",10,0,1,0,11
625958,366809,2014-05-23,Senate,"Senate 3rd Reading SB1414 Wolk",31,0,9,0,40
625958,374018,2014-06-23,Assembly,"Do pass and be re-referred to the Committee on Appropriations",14,0,0,1,15
625958,377132,2014-08-14,Assembly,"Do pass",17,0,0,0,17
625958,378356,2014-08-25,Assembly,"SB 1414 Wolk  Senate Third Reading  By WILLIAMS",79,0,0,0,79
625958,378542,2014-08-26,Senate,"Unfinished Supp 1 SB1414 Wolk Concurrence",36,0,4,0,40
625961,361000,2014-04-29,Assembly,"Do pass",5,0,0,2,7
625961,363393,2014-05-08,Assembly,"AB 2506 SALAS  Assembly Third Reading",69,0,0,10,79
625961,372354,2014-06-17,Senate,"Do pass",5,0,2,0,7
625961,377590,2014-08-14,Senate,"Assembly 3rd Reading AB2506 Salas By Beall",33,1,6,0,40
625963,359227,2014-04-22,Assembly,"Do pass and be re-referred to the Committee on Appropriations",6,1,0,2,9
625963,363104,2014-05-07,Assembly,"Do pass",12,5,0,0,17
625963,364875,2014-05-15,Assembly,"AB 2290 PEREZ, J.  Assembly Third Reading",57,20,0,2,79
625963,374398,2014-06-25,Senate,"Do pass, but re-refer to the Committee on Appropriations",5,2,0,0,7
625964,354463,2014-04-08,Assembly,"Do pass and be re-referred to the Committee on Appropriations",16,2,0,1,19
625965,363095,2014-05-07,Assembly,"Do pass as amended, to Consent Calendar",7,0,0,0,7
625966,338614,2014-03-10,Senate,"Senate 3rd Reading SCR89 Wolk",35,0,4,0,39
625966,347053,2014-03-24,Assembly,"Be adopted, to Consent Calendar",8,0,0,3,11
625966,348891,2014-03-28,Assembly,"SCR 89 Wolk  Consent Calendar Second Day  Regular Session",68,0,0,12,80
625968,359890,2014-04-24,Senate,"Do pass, but re-refer to the Committee on Judiciary",8,0,1,0,9
625968,361092,2014-04-29,Senate,"Do pass as amended, and re-refer to the Committee on 	Appropriations",5,1,1,0,7
625968,365418,2014-05-19,Senate,"Placed on Appropriations Suspense file",7,0,0,0,7
625969,360650,2014-04-29,Assembly,"Do pass as amended and be re-referred to the Committee on 	Appropriations",11,0,0,3,14
625969,364373,2014-05-14,Assembly,"Do pass, to Consent Calendar",17,0,0,0,17
625969,367557,2014-05-27,Assembly,"AB 2605 BONILLA  Assembly Third Reading",74,1,0,4,79
625969,373979,2014-06-23,Senate,"Do pass, but re-refer to the Committee on Appropriations",8,0,1,0,9
625969,376492,2014-08-04,Senate,"Do pass as amended",7,0,0,0,7
625969,378523,2014-08-26,Senate,"Assembly 3rd Reading AB2605 Bonilla By Corbett",34,0,6,0,40
625969,378820,2014-08-27,Assembly,"AB 2605 BONILLA  Concurrence in Senate Amendments",70,3,0,6,79
625970,360648,2014-04-28,Assembly,"Do pass as amended and be re-referred to the Committee on 	Appropriations",10,0,0,2,12
625970,363096,2014-05-07,Assembly,"Do pass",16,0,0,1,17
625970,364988,2014-05-15,Assembly,"AB 2274 GORDON  Assembly Third Reading",76,0,0,3,79
625970,372925,2014-06-18,Senate,"Do pass, but re-refer to the Committee on Appropriations Recommend 	Consent",7,0,0,0,7
625970,375698,2014-07-03,Senate,"Consent Calendar 2nd AB2274 Gordon",35,0,5,0,40
625972,358554,2014-04-22,Senate,"Do pass, but re-refer to the Committee on Appropriations Recommend 	Consent",9,0,0,0,9
625972,362317,2014-05-05,Senate,"Do pass",7,0,0,0,7
625972,364813,2014-05-15,Senate,"Special Consent #14 SB1345 Committee on N.R. & W. (Pavley)",36,0,4,0,40
625972,372222,2014-06-16,Assembly,"Do pass and be re-referred to the Committee on Local Government to 	Consent Calendar",9,0,0,0,9
625972,374385,2014-06-25,Assembly,"Do pass and be re-referred to the Committee on Appropriations to 	Consent Calendar",9,0,0,0,9
625972,376717,2014-08-06,Assembly,"Do pass, to Consent Calendar",17,0,0,0,17
625972,377256,2014-08-14,Assembly,"SB 1345 N.R.& W.  Consent Calendar Second Day  Regular Session",78,0,0,1,79
625972,377699,2014-08-18,Senate,"Unfinished Business SB1345 Committee on N.R. & W. (Pavley) 	Concurrence",35,0,5,0,40
625973,350889,2014-04-02,Senate,"Do pass as amended, and re-refer to the Committee on Health",7,0,2,0,9
625973,359857,2014-04-24,Senate,"Do pass, but re-refer to the Committee on Judiciary",9,0,0,0,9
625973,361157,2014-04-29,Senate,"Do pass as amended, and re-refer to the Committee on 	Appropriations",7,0,0,0,7
625973,365347,2014-05-19,Senate,"Placed on Appropriations Suspense file",7,0,0,0,7
625973,366757,2014-05-23,Senate,"Do pass as amended",7,0,0,0,7
625973,368132,2014-05-28,Senate,"Senate 3rd Reading SB1266 Huff",37,0,3,0,40
625973,372180,2014-06-17,Assembly,"Do pass and be re-referred to the Committee on Education",10,0,0,0,10
625973,374857,2014-06-25,Assembly,"Do pass as amended and be re-referred to the Committee on 	Appropriations",7,0,0,0,7
625973,377247,2014-08-14,Assembly,"Do pass as amended",17,0,0,0,17
625973,378710,2014-08-27,Assembly,"SB 1266 Huff  Senate Third Reading  By BUCHANAN",76,0,0,3,79
625973,378886,2014-08-28,Senate,"Unfinished Business SB1266 Huff Concurrence",34,0,6,0,40
625975,358438,2014-04-21,Senate,"Do pass, but re-refer to the Committee on Health",9,0,0,0,9
625975,361576,2014-04-30,Senate,"Do pass as amended, and re-refer to the Committee on 	Appropriations",6,0,3,0,9
625975,365243,2014-05-19,Senate,"Placed on Appropriations Suspense file",7,0,0,0,7
625975,366843,2014-05-23,Senate,"Do pass as amended",7,0,0,0,7
625975,368074,2014-05-28,Senate,"Senate 3rd Reading SB1262 Correa",31,0,9,0,40
625975,372224,2014-06-17,Assembly,"Do pass and be re-referred to the Committee on Public Safety",10,2,0,2,14
625975,374764,2014-06-26,Assembly,"Do pass as amended and be re-referred to the Committee on 	Appropriations",6,1,0,0,7
625976,360517,2014-04-28,Assembly,"Do pass and be re-referred to the Committee on Appropriations",8,0,0,1,9
625976,367152,2014-05-23,Assembly,"Do pass",17,0,0,0,17
625976,367517,2014-05-27,Assembly,"AB 2465 CHESBRO  Assembly Third Reading",77,0,0,2,79
625976,372836,2014-06-18,Senate,"Do pass, but re-refer to the Committee on Appropriations",7,0,0,0,7
625976,375287,2014-06-30,Senate,"Placed on Appropriations Suspense file",6,0,1,0,7
625976,377520,2014-08-14,Senate,"Do pass as amended",5,0,2,0,7
625976,377996,2014-08-20,Senate,"Assembly 3rd Reading AB2465 Chesbro By Hill",34,0,6,0,40
625976,378135,2014-08-21,Assembly,"AB 2465 CHESBRO  Concurrence in Senate Amendments",79,0,0,0,79
625978,357981,2014-04-21,Senate,"Do pass",2,2,1,0,5
625978,357982,2014-04-21,Senate,"Set, first hearing.  Failed passage in Committee.  Reconsideration 	granted",4,0,1,0,5
625979,361834,2014-04-30,Senate,"Do pass as amended, and re-refer to the Committee on 	Appropriations",6,1,2,0,9
625979,365355,2014-05-19,Senate,"Placed on Appropriations Suspense file",7,0,0,0,7
625980,353294,2014-04-07,Assembly,"Do pass as amended and be re-referred to the Committee on 	Appropriations",6,3,0,0,9
625980,366858,2014-05-23,Assembly,"Do pass as amended",12,4,0,1,17
625980,368690,2014-05-29,Assembly,"AB 2284 WILLIAMS  Assembly Third Reading",54,21,0,4,79
625981,359778,2014-04-24,Senate,"Set, first hearing.  Failed passage in Committee.  Reconsideration 	granted",3,8,0,0,11
625981,359872,2014-04-24,Senate,"Set, first hearing.  Failed passage in Committee.  Reconsideration 	granted",11,0,0,0,11
625984,360151,2014-04-28,Senate,"Do pass",8,1,0,0,9
625984,361549,2014-05-01,Senate,"Senate 3rd Reading SB1416 Block",33,0,7,0,40
625984,370686,2014-06-10,Assembly,"Do pass",8,1,0,5,14
625984,373107,2014-06-19,Assembly,"SB 1416 Block  Senate Third Reading  By DICKINSON",47,22,0,10,79
625985,360681,2014-04-28,Assembly,"Do pass and be re-referred to the Committee on Appropriations",5,1,0,3,9
625985,367154,2014-05-23,Assembly,"Do pass",12,4,0,1,17
625985,368118,2014-05-28,Assembly,"AB 2658 BOCANEGRA  Assembly Third Reading",54,22,0,3,79
625985,372740,2014-06-18,Senate,"Do pass, but re-refer to the Committee on Transportation and 	Housing",5,1,1,0,7
625985,374843,2014-06-26,Senate,"Do pass as amended, and re-refer to the Committee on 	Appropriations",4,3,4,0,11
625985,374844,2014-06-26,Senate,"Set, first hearing.  Failed passage in Committee.  Reconsideration 	granted",10,0,1,0,11
625986,359197,2014-04-22,Assembly,"Do pass as amended and be re-referred to the Committee on 	Appropriations",7,0,0,2,9
625986,364408,2014-05-14,Assembly,"Do pass",16,0,0,1,17
625986,365241,2014-05-19,Assembly,"AB 2713 QUIRK-SILVA  Assembly Third Reading",74,0,0,5,79
625986,371760,2014-06-16,Senate,"Do pass, but re-refer to the Committee on Appropriations",9,0,0,0,9
625986,375223,2014-06-30,Senate,"Placed on Appropriations Suspense file",6,0,1,0,7
625987,358413,2014-04-22,Senate,"Do pass, but re-refer to the Committee on Appropriations",9,0,1,0,10
625987,362358,2014-05-05,Senate,"Placed on Appropriations Suspense file",7,0,0,0,7
625987,366915,2014-05-23,Senate,"Do pass",7,0,0,0,7
625987,367624,2014-05-27,Senate,"Senate 3rd Reading SB1401 Block",34,0,6,0,40
625988,353416,2014-04-07,Assembly,"Do pass as amended and be re-referred to the Committee on 	Appropriations",9,0,0,0,9
625988,361256,2014-04-30,Assembly,"Do pass, to Consent Calendar",17,0,0,0,17
625988,363443,2014-05-08,Assembly,"AB 2239 CHESBRO  Consent Calendar Second Day  Regular Session",73,0,0,6,79
625988,374252,2014-06-24,Senate,"Do pass, but re-refer to the Committee on Appropriations Recommend 	Consent",9,0,0,0,9
625988,376781,2014-08-07,Senate,"Consent Calendar 2nd AB2239 Chesbro",34,0,6,0,40
625988,376875,2014-08-11,Assembly,"AB 2239 CHESBRO  Concurrence in Senate Amendments",79,0,0,0,79
625990,360845,2014-04-29,Senate,"Do pass, but re-refer to the Committee on Appropriations",9,0,0,0,9
625990,363718,2014-05-12,Senate,"Placed on Appropriations Suspense file",7,0,0,0,7
625990,366682,2014-05-23,Senate,"Do pass as amended",7,0,0,0,7
625990,368117,2014-05-28,Senate,"Senate 3rd Reading SB1259 Pavley",35,1,4,0,40
625990,372413,2014-06-17,Assembly,"Do pass and be re-referred to the Committee on Appropriations",14,0,0,1,15
625992,361636,2014-04-30,Senate,"Do pass as amended, and re-refer to the Committee on Appropriations",9,0,0,0,9
625992,365242,2014-05-19,Senate,"Placed on Appropriations Suspense file",7,0,0,0,7
625996,360556,2014-04-29,Assembly,"Do pass and be re-referred to the Committee on Appropriations",4,3,0,3,10
625997,361071,2014-04-29,Assembly,"Do pass and be re-referred to the Committee on Appropriations",9,0,0,1,10
626000,359400,2014-04-23,Assembly,"Do pass",1,5,0,1,7
626001,353366,2014-04-08,Assembly,"Do pass",10,3,0,2,15
626001,359786,2014-04-24,Assembly,"AB 2364 PEREZ, V.M.  Assembly Third Reading",52,10,0,17,79
626001,370530,2014-06-10,Senate,"Do pass",7,1,2,0,10
626001,373269,2014-06-19,Senate,"Assembly 3rd Reading AB2364 V. Manuel P",24,9,7,0,40
626002,353425,2014-04-07,Assembly,"Do pass and re-refer to Committee on Appropriations with 	recommendation:  To Consent Calendar",12,0,0,0,12
626002,361162,2014-04-30,Assembly,"Do pass, to Consent Calendar",17,0,0,0,17
626002,363371,2014-05-08,Assembly,"AB 2289 DALY  Consent Calendar Second Day  Regular Session",73,0,0,6,79
626002,372823,2014-06-18,Senate,"Do pass, but re-refer to the Committee on Appropriations Recommend 	Consent",9,0,0,0,9
626002,377291,2014-08-14,Senate,"Assembly 3rd Reading AB2289 Daly By Evans",32,0,8,0,40
626002,377808,2014-08-19,Assembly,"AB 2289 DALY  Concurrence in Senate Amendments",78,0,0,1,79
626003,358811,2014-04-21,Assembly,"Do pass and be re-referred to the Committee on Appropriations",15,0,0,1,16
626003,367020,2014-05-23,Assembly,"Do pass",17,0,0,0,17
626003,367434,2014-05-27,Assembly,"AB 2321 GOMEZ  Assembly Third Reading",76,0,0,3,79
626003,374862,2014-06-26,Senate,"Do pass, but re-refer to the Committee on Appropriations Recommend 	Consent",10,0,1,0,11
626003,376527,2014-08-04,Senate,"Placed on Appropriations Suspense file",7,0,0,0,7
626003,377428,2014-08-14,Senate,"Do pass",5,0,2,0,7
626003,378182,2014-08-21,Senate,"Assembly 3rd Reading AB2321 Gomez By Evans",36,0,4,0,40
626005,350295,2014-04-01,Assembly,"Do pass and be re-referred to the Committee on Appropriations",6,0,0,1,7
626005,366688,2014-05-23,Assembly,"Do pass as amended",13,0,0,4,17
626005,368139,2014-05-28,Assembly,"AB 2308 STONE  Assembly Third Reading",75,1,0,3,79
626005,374519,2014-06-24,Senate,"Do pass, but re-refer to the Committee on Appropriations",7,0,0,0,7
626005,376531,2014-08-04,Senate,"Placed on Appropriations Suspense file",7,0,0,0,7
626005,377580,2014-08-14,Senate,"Do pass as amended",5,0,2,0,7
626005,378594,2014-08-26,Senate,"Assembly 3rd Reading AB2308 Stone By Block",34,0,6,0,40
626005,378631,2014-08-27,Assembly,"AB 2308 STONE  Concurrence in Senate Amendments",78,0,0,1,79
626006,361153,2014-04-29,Senate,"Do pass as amended, and re-refer to the Committee on 	Appropriations",8,2,1,0,11
626006,365363,2014-05-19,Senate,"Do pass",7,0,0,0,7
626006,366694,2014-05-23,Senate,"Senate 3rd Reading SB1358 Wolk",29,1,10,0,40
626006,374220,2014-06-24,Assembly,"Do pass and be re-referred to the Committee on Appropriations",10,2,0,2,14
626006,376708,2014-08-06,Assembly,"Do pass",13,4,0,0,17
626006,378872,2014-08-28,Assembly,"Do pass",12,1,0,1,14
626006,379125,2014-08-29,Assembly,"SB 1358 Wolk  Senate Third Reading  By GARCIA",66,11,0,2,79
626006,379126,2014-08-29,Senate,"Unfinished Supp 4 SB1358 Wolk Concurrence",31,2,7,0,40
626008,360605,2014-04-29,Assembly,"Do pass as amended and be re-referred to the Committee on 	Appropriations",10,0,0,4,14
626009,358468,2014-04-22,Senate,"Do pass as amended, and re-refer to the Committee on Appropriations",4,0,1,0,5
626009,362228,2014-05-05,Senate,"Placed on Appropriations Suspense file",7,0,0,0,7
626010,353243,2014-04-08,Assembly,"Do pass and be re-referred to the Committee on Appropriations",7,0,0,0,7
626010,366786,2014-05-23,Assembly,"Do pass",17,0,0,0,17
626010,367459,2014-05-27,Assembly,"AB 2520 MAIENSCHEIN  Assembly Third Reading",77,0,0,2,79
626010,374524,2014-06-24,Senate,"Do pass, but re-refer to the Committee on Appropriations",7,0,0,0,7
626010,376403,2014-08-04,Senate,"Placed on Appropriations Suspense file",7,0,0,0,7
626010,377551,2014-08-14,Senate,"Do pass",5,0,2,0,7
626010,378465,2014-08-26,Senate,"Assembly 3rd Reading AB2520 Maienschein By Block",34,0,6,0,40
626010,378696,2014-08-27,Assembly,"AB 2520 MAIENSCHEIN  Concurrence in Senate Amendments",77,0,0,2,79
626011,361672,2014-04-30,Assembly,"Do pass and be re-referred to the Committee on Appropriations",7,0,0,0,7
626012,351040,2014-04-02,Assembly,"Do pass and be re-referred to the Committee on Appropriations",9,0,0,0,9
626013,360478,2014-04-29,Assembly,"Do pass, to Consent Calendar",10,0,0,0,10
626013,362297,2014-05-05,Assembly,"AB 2683 COOLEY  Consent Calendar Second Day  Regular Session",75,0,0,4,79
626013,370409,2014-06-10,Senate,"Do pass",6,0,1,0,7
626013,374971,2014-06-26,Senate,"Special Consent #17 AB2683 Cooley",32,0,8,0,40
626014,361186,2014-04-29,Assembly,"Do pass and re-refer to Committee on Appropriations with 	recommendation:  To Consent Calendar",7,0,0,0,7
626015,348290,2014-03-26,Senate,"Do pass, but re-refer to the Committee on Judiciary",3,0,2,0,5
626015,362357,2014-05-05,Senate,"Placed on Appropriations Suspense file",7,0,0,0,7
626015,366726,2014-05-23,Senate,"Do pass",4,2,1,0,7
626015,367508,2014-05-27,Senate,"Senate 3rd Reading SB1300 Hancock",24,9,7,0,40
626015,374753,2014-06-25,Assembly,"Do pass and be re-referred to the Committee on Appropriations",5,1,0,1,7
626015,377524,2014-08-14,Assembly,"Do pass as amended",13,4,0,0,17
626015,379023,2014-08-28,Assembly,"Do pass as amended",6,0,0,1,7
626015,379024,2014-08-29,Assembly,"SB 1300 Hancock  Senate Third Reading  By SKINNER",68,5,0,6,79
626015,379025,2014-08-29,Senate,"Unfinished Supp 5 SB1300 Hancock Concurrence",34,0,6,0,40
626017,362702,2014-05-06,Assembly,"Do pass",15,4,0,0,19
626017,367200,2014-05-23,Assembly,"AB 2340 GARCIA  Assembly Third Reading",64,2,0,13,79
626018,360511,2014-04-29,Senate,"Do pass, but re-refer to the Committee on Appropriations",9,0,0,0,9
626018,365270,2014-05-19,Senate,"Senate 3rd Reading SB1434 Wolk",34,0,6,0,40
626018,372335,2014-06-17,Assembly,"Do pass and re-refer to Committee on Appropriations with 	recommendation:  To Consent Calendar",15,0,0,0,15
626018,375602,2014-07-02,Assembly,"Do pass, to Consent Calendar",17,0,0,0,17
626018,376826,2014-08-07,Assembly,"SB 1434 Wolk  Consent Calendar Second Day  Regular Session",77,0,0,2,79
626018,376936,2014-08-11,Senate,"Unfinished Business SB1434 Wolk Concurrence",36,0,4,0,40
626019,358376,2014-04-22,Assembly,"Do pass and be re-referred to the Committee on Appropriations",6,0,0,1,7
626019,366947,2014-05-23,Assembly,"Do pass",15,0,0,2,17
626019,367541,2014-05-27,Assembly,"AB 2313 NESTANDE  Assembly Third Reading",66,3,0,10,79
626019,374340,2014-06-24,Senate,"Do pass as amended, and re-refer to the Committee on Appropriations",7,0,0,0,7
626019,376443,2014-08-04,Senate,"Placed on Appropriations Suspense file",7,0,0,0,7
626019,377385,2014-08-14,Senate,"Do pass",5,0,2,0,7
626021,360525,2014-04-29,Assembly,"Do pass and be re-referred to the Committee on Appropriations",6,1,0,0,7
626021,366911,2014-05-23,Assembly,"Do pass as amended",17,0,0,0,17
626021,368618,2014-05-29,Assembly,"AB 2411 BONTA  Assembly Third Reading",75,0,0,4,79
626021,374509,2014-06-24,Senate,"Do pass as amended, and re-refer to the Committee on Appropriations",7,0,0,0,7
626021,376555,2014-08-04,Senate,"Placed on Appropriations Suspense file",7,0,0,0,7
626021,377204,2014-08-14,Senate,"Do pass",5,0,2,0,7
626021,378726,2014-08-27,Senate,"Assembly 3rd Reading AB2411 Bonta Urgency Clause",36,0,4,0,40
626021,378927,2014-08-28,Assembly,"AB 2411 BONTA  Concurrence- Urgency Added",79,0,0,0,79
626022,350453,2014-04-01,Assembly,"Do pass and be re-referred to the Committee on Appropriations",5,1,0,1,7
626022,367077,2014-05-23,Assembly,"Do pass as amended",12,5,0,0,17
626022,368122,2014-05-28,Assembly,"AB 2530 RODRIGUEZ  Assembly Third Reading",53,25,0,1,79
626022,374623,2014-06-24,Senate,"Do pass, but re-refer to the Committee on Appropriations",4,1,0,0,5
626022,378601,2014-08-26,Senate,"Assembly 3rd Reading AB2530 Rodriguez By Torres",23,11,6,0,40
626022,378860,2014-08-28,Assembly,"AB 2530 RODRIGUEZ  Concurrence in Senate Amendments",54,25,0,0,79
626023,361777,2014-04-30,Assembly,"Do pass as amended",5,2,0,2,9
626024,361282,2014-04-29,Assembly,"Do pass as amended and be re-referred to the Committee on 	Appropriations",6,0,0,1,7
626024,366712,2014-05-23,Assembly,"Do pass as amended",13,0,0,4,17
626024,368115,2014-05-28,Assembly,"AB 2299 NAZARIAN  Assembly Third Reading",74,0,0,5,79
626024,374619,2014-06-24,Senate,"Do pass, but re-refer to the Committee on Appropriations",4,0,1,0,5
626024,376899,2014-08-11,Senate,"Placed on Appropriations Suspense file",7,0,0,0,7
626025,360606,2014-04-29,Assembly,"Do pass",11,0,0,4,15
626025,362186,2014-05-05,Assembly,"AB 2478 STONE  Assembly Third Reading",76,0,0,3,79
626026,360686,2014-04-29,Assembly,"Do pass and be re-referred to the Committee on Appropriations",19,0,0,0,19
626026,364388,2014-05-14,Assembly,"Do pass, to Consent Calendar",17,0,0,0,17
626026,367122,2014-05-23,Assembly,"AB 2491 NESTANDE  Consent Calendar Second Day  Regular Session",73,0,0,6,79
626026,374954,2014-06-25,Senate,"Do pass as amended, and re-refer to the Committee on 	Appropriations",8,0,1,0,9
626026,376513,2014-08-04,Senate,"Placed on Appropriations Suspense file",7,0,0,0,7
626027,359677,2014-04-24,Senate,"Do pass as amended, and re-refer to the Committee on Appropriations",8,0,1,0,9
626027,363751,2014-05-12,Senate,"Placed on Appropriations Suspense file",7,0,0,0,7
626027,366698,2014-05-23,Senate,"Do pass as amended",7,0,0,0,7
626027,368098,2014-05-28,Senate,"Senate 3rd Reading SB1369 Block",35,0,5,0,40
626027,374694,2014-06-24,Assembly,"Do pass and be re-referred to the Committee on Appropriations",13,0,0,0,13
626029,347613,2014-03-25,Senate,"Do pass as amended, and re-refer to the Committee on Appropriations",7,0,0,0,7
626029,360113,2014-04-28,Senate,"Placed on Appropriations Suspense file",6,0,1,0,7
626031,352809,2014-04-07,Assembly,"Be referred to Committee on Water, Parks and Wildlife",11,0,0,0,11
626031,360655,2014-04-29,Assembly,"Do pass and be re-referred to the Committee on Appropriations",10,3,0,2,15
626032,360488,2014-04-28,Assembly,"Do pass and be re-referred to the Committee on Appropriations",8,0,0,1,9
626032,362974,2014-05-07,Assembly,"Do pass, to Consent Calendar",17,0,0,0,17
626032,365332,2014-05-19,Assembly,"AB 2718 BLOOM  Assembly Third Reading",76,0,0,3,79
626032,370690,2014-06-10,Senate,"Do pass as amended, but re-refer to the Committee on Rules 	Recommend Consent",9,0,0,0,9
626033,358770,2014-04-22,Senate,"Do pass as amended, and re-refer to the Committee on Appropriations",9,0,0,0,9
626033,363810,2014-05-12,Senate,"Placed on Appropriations Suspense file",7,0,0,0,7
626033,366841,2014-05-23,Senate,"Do pass",6,0,1,0,7
626033,367566,2014-05-27,Senate,"Senate 3rd Reading SB1390 Correa",30,2,8,0,40
626033,374001,2014-06-23,Assembly,"Do pass as amended and be re-referred to the Committee on 	Appropriations",6,2,0,1,9
626033,377224,2014-08-14,Assembly,"Do pass",13,4,0,0,17
626033,378475,2014-08-26,Assembly,"SB 1390 Correa  Senate Third Reading  By LINDER",59,18,0,2,79
626033,378702,2014-08-27,Senate,"Unfinished Business SB1390 Correa Concurrence",28,3,9,0,40
626034,362634,2014-05-06,Assembly,"Do pass",6,0,0,1,7
626034,364934,2014-05-15,Assembly,"AB 2351 GORDON  Assembly Third Reading",77,0,0,2,79
626034,372510,2014-06-17,Senate,"Do pass and be placed on the Consent Calendar",4,0,1,0,5
626034,378300,2014-08-25,Senate,"Assembly 3rd Reading AB2351 Gordon By DeSaulnier",34,0,6,0,40
626034,378580,2014-08-26,Assembly,"AB 2351 GORDON  Concurrence in Senate Amendments",79,0,0,0,79
626035,361740,2014-04-30,Senate,"Do pass, but re-refer to the Committee on Appropriations",6,0,3,0,9
626035,365247,2014-05-19,Senate,"Placed on Appropriations Suspense file",7,0,0,0,7
626038,354832,2014-04-09,Assembly,"Do pass as amended and be re-referred to the Committee on Business, 	Professions and Consumer Protection",7,0,0,0,7
626038,360484,2014-04-29,Assembly,"Do pass and be re-referred to the Committee on Appropriations",14,0,0,0,14
626038,367027,2014-05-23,Assembly,"Do pass",17,0,0,0,17
626038,367443,2014-05-27,Assembly,"AB 2282 GATTO  Assembly Third Reading",77,0,0,2,79
626038,372156,2014-06-17,Senate,"Do pass, but re-refer to the Committee on Environmental Quality 	Recommend Consent",11,0,0,0,11
626038,374544,2014-06-25,Senate,"Do pass as amended, and re-refer to the Committee on 	Appropriations",6,0,1,0,7
626038,377006,2014-08-11,Senate,"Placed on Appropriations Suspense file",7,0,0,0,7
626038,377492,2014-08-14,Senate,"Do pass",5,0,2,0,7
626038,378106,2014-08-21,Senate,"Assembly 3rd Reading AB2282 Gatto By DeSaulnier",35,0,5,0,40
626038,378233,2014-08-22,Assembly,"AB 2282 GATTO  Concurrence in Senate Amendments",74,0,0,5,79
626039,362856,2014-05-05,Assembly,"Do pass as amended",9,0,0,0,9
626039,365388,2014-05-19,Assembly,"AB 2517 DALY  Third Reading Urgency",75,0,0,4,79
626040,362997,2014-05-07,Senate,"Do pass as amended, and re-refer to the Committee on Appropriations",9,0,0,0,9
626040,368626,2014-05-29,Senate,"Senate 3rd Reading SB1446 DeSaulnier Urgency Clause",35,0,5,0,40
626040,370433,2014-06-10,Assembly,"Do pass and be re-referred to the Committee on Appropriations",18,0,0,1,19
626040,372758,2014-06-18,Assembly,"Do pass, to Consent Calendar",15,0,0,2,17
626040,374783,2014-06-26,Assembly,"SB 1446 DeSaulnier  Consent Calendar Second Day  Regular Session",76,0,0,3,79
626041,378377,2014-08-25,Assembly,"Be adopted, to Consent Calendar",8,0,0,3,11
626041,378740,2014-08-27,Assembly,"ACR 105 NESTANDE  Consent Calendar Second Day",78,0,0,1,79
626041,378922,2014-08-28,Senate,"W/O REF. TO FILE ACR105 Nestande",37,0,3,0,40
626043,359902,2014-04-24,Senate,"Do pass, but re-refer to the Committee on Appropriations Recommend 	Consent",8,0,1,0,9
626043,363470,2014-05-08,Senate,"Consent Calendar 2nd SB1311 Hill",35,0,5,0,40
626043,370509,2014-06-10,Assembly,"Do pass and re-refer to Committee on Appropriations with 	recommendation:  To Consent Calendar",17,0,0,2,19
626043,375606,2014-07-02,Assembly,"Do pass, to Consent Calendar",17,0,0,0,17
626043,376980,2014-08-11,Assembly,"SB 1311 Hill  Senate Third Reading  By PAN",78,0,0,1,79
626043,377094,2014-08-13,Senate,"Unfinished Business SB1311 Hill Concurrence",37,0,3,0,40
626046,361865,2014-04-30,Assembly,"Do pass and be re-referred to the Committee on Natural Resources",2,3,0,4,9
626046,361866,2014-04-30,Assembly,"Set second hearing.  Failed passage.  Reconsideration granted",9,0,0,0,9
626049,364257,2014-05-13,Assembly,"Do pass as amended and be re-referred to the Committee on 	Appropriations",9,0,0,0,9
626049,366845,2014-05-23,Assembly,"Do pass",17,0,0,0,17
626049,367576,2014-05-27,Assembly,"AB 2434 GOMEZ  Assembly Third Reading",77,0,0,2,79
626049,374442,2014-06-25,Senate,"Do pass, but re-refer to the Committee on Appropriations Recommend 	Consent",6,0,1,0,7
626049,376653,2014-08-04,Senate,"Placed on Appropriations Suspense file",7,0,0,0,7
626049,377340,2014-08-14,Senate,"Do pass",5,0,2,0,7
626049,378928,2014-08-28,Senate,"Assembly 3rd Reading AB2434 Gomez By Correa",35,0,5,0,40
626050,364544,2014-05-13,Assembly,"Do pass and be re-referred to the Committee on Appropriations",7,0,0,2,9
626050,366160,2014-05-21,Assembly,"Do pass, to Consent Calendar",17,0,0,0,17
626050,368235,2014-05-28,Assembly,"AB 2681 DABABNEH  Assembly Third Reading",75,0,0,4,79
626050,374583,2014-06-25,Senate,"Do pass, but re-refer to the Committee on Appropriations",7,0,0,0,7
626050,377805,2014-08-19,Senate,"Assembly 3rd Reading AB2681 Dababneh By Correa",33,0,7,0,40
626051,358782,2014-04-22,Assembly,"Do pass as amended and be re-referred to the Committee on 	Appropriations",18,1,0,0,19
626052,361080,2014-04-29,Assembly,"Do pass and be re-referred to the Committee on Appropriations",5,2,0,0,7
626053,355126,2014-04-09,Assembly,"Do pass as amended",7,0,0,0,7
626053,367622,2014-05-27,Assembly,"AB 2287 PAN  Assembly Third Reading",76,0,0,3,79
626054,362706,2014-05-06,Assembly,"Do pass and be re-referred to the Committee on Judiciary",6,13,0,0,19
626055,359381,2014-04-22,Senate,"Do pass, but re-refer to the Committee on Appropriations",5,0,0,0,5
626055,362301,2014-05-05,Senate,"Do pass",6,0,1,0,7
626055,363717,2014-05-12,Senate,"Senate 3rd Reading SB1441 Lara",33,0,7,0,40
626055,370744,2014-06-10,Assembly,"Do pass and re-refer to Committee on Appropriations with 	recommendation:  To Consent Calendar",6,0,0,1,7
626055,375591,2014-07-02,Assembly,"Do pass",17,0,0,0,17
626055,378652,2014-08-27,Assembly,"SB 1441 Lara  Senate Third Reading  By GARCIA",78,0,0,1,79
626055,378857,2014-08-28,Senate,"Unfinished Business SB1441 Lara Concurrence",37,0,3,0,40
626056,360551,2014-04-29,Senate,"Do pass, but re-refer to the Committee on Appropriations",9,0,2,0,11
626056,364966,2014-05-15,Senate,"Special Consent #14 SB1409 Hill",36,0,4,0,40
626056,370231,2014-06-09,Assembly,"Do pass and be re-referred to the Committee on Appropriations",14,0,0,1,15
626056,375614,2014-07-02,Assembly,"Do pass as amended",17,0,0,0,17
626056,378437,2014-08-26,Assembly,"SB 1409 Hill  Senate Third Reading  By PATTERSON",79,0,0,0,79
626056,378646,2014-08-27,Senate,"Unfinished Business SB1409 Hill Concurrence",34,0,6,0,40
626057,347594,2014-03-25,Assembly,"Do pass and be re-referred to the Committee on Appropriations",13,0,0,2,15
626057,367139,2014-05-23,Assembly,"Do pass as amended",12,0,0,5,17
626057,367977,2014-05-28,Assembly,"AB 2636 GATTO  Assembly Third Reading",74,2,0,3,79
626057,372550,2014-06-18,Senate,"Do pass as amended, and re-refer to the Committee on Natural 	Resources and Water",6,0,1,0,7
626057,374023,2014-06-24,Senate,"Do pass as amended, and re-refer to the Committee on Appropriations",8,0,1,0,9
626057,376508,2014-08-04,Senate,"Placed on Appropriations Suspense file",7,0,0,0,7
626057,377335,2014-08-14,Senate,"Do pass as amended",5,0,2,0,7
626057,378103,2014-08-21,Senate,"Assembly 3rd Reading AB2636 Gatto By Pavley",32,0,8,0,40
626057,378229,2014-08-22,Assembly,"AB 2636 GATTO  Concurrence in Senate Amendments",75,0,0,4,79
626058,353799,2014-04-08,Assembly,"Do pass",7,0,0,0,7
626058,368147,2014-05-28,Assembly,"AB 2603 PEREZ, V.M.  Assembly Third Reading",79,0,0,0,79
626058,374641,2014-06-24,Senate,"Do pass as amended",7,0,0,0,7
626058,377292,2014-08-14,Senate,"Assembly 3rd Reading AB2603 V. Manuel P",35,0,5,0,40
626058,377724,2014-08-18,Assembly,"AB 2603 PEREZ, V.M.  Concurrence in Senate Amendments",78,0,0,1,79
626059,350962,2014-04-02,Senate,"Do pass, but re-refer to the Committee on Appropriations",6,0,1,0,7
626059,361554,2014-05-01,Senate,"Senate 3rd Reading SB1383 Hueso",35,0,5,0,40
626059,374119,2014-06-23,Assembly,"Do pass as amended and be re-referred to the Committee on 	Appropriations",8,0,0,1,9
626059,376688,2014-08-06,Assembly,"Do pass, to Consent Calendar",17,0,0,0,17
626059,377289,2014-08-14,Assembly,"SB 1383 Hueso  Consent Calendar Second Day  Regular Session",78,0,0,1,79
626059,377694,2014-08-18,Senate,"Unfinished Business SB1383 Hueso Concurrence",34,0,6,0,40
626061,358509,2014-04-21,Assembly,"Do pass and be re-referred to the Committee on Natural Resources",10,4,0,1,15
626061,360691,2014-04-28,Assembly,"Do pass and be re-referred to the Committee on Appropriations",5,3,0,1,9
626062,353355,2014-04-08,Assembly,"Do pass as amended",10,0,0,0,10
626062,361104,2014-04-30,Assembly,"Do pass",16,1,0,0,17
626062,362243,2014-05-05,Assembly,"AB 2444 HALL  Assembly Third Reading",72,1,0,6,79
626062,374410,2014-06-24,Senate,"Do pass as amended, and re-refer to the Committee on 	Appropriations",6,1,0,0,7
626062,377689,2014-08-18,Senate,"Assembly 3rd Reading AB2444 Hall By Mitchell",33,2,5,0,40
626062,378055,2014-08-21,Assembly,"AB 2444 HALL  Concurrence in Senate Amendments",71,1,0,7,79
626063,359639,2014-04-24,Senate,"Do pass, but re-refer to the Committee on Health",4,1,0,0,5
626063,361741,2014-04-30,Senate,"Do pass, but re-refer to the Committee on Appropriations",5,1,3,0,9
626063,363727,2014-05-12,Senate,"Placed on Appropriations Suspense file",7,0,0,0,7
626063,366942,2014-05-23,Senate,"Do pass as amended",5,2,0,0,7
626063,368745,2014-05-29,Senate,"Senate 3rd Reading SB1299 Padilla",22,13,5,0,40
626063,370832,2014-06-11,Assembly,"Do pass and be re-referred to the Committee on Health",5,1,0,1,7
626063,372267,2014-06-17,Assembly,"Do pass and be re-referred to the Committee on Appropriations",14,5,0,0,19
626063,377211,2014-08-14,Assembly,"Do pass",12,5,0,0,17
626063,377902,2014-08-20,Assembly,"SB 1299 Padilla  Senate Third Reading  By SKINNER",54,21,0,4,79
626063,378051,2014-08-21,Senate,"Unfinished Business SB1299 Padilla Concurrence",23,11,6,0,40
626064,361076,2014-04-30,Assembly,"Do pass and be re-referred to the Committee on Appropriations",12,0,0,1,13
626064,366768,2014-05-23,Assembly,"Do pass",17,0,0,0,17
626064,367501,2014-05-27,Assembly,"AB 2253 TING  Assembly Third Reading",75,0,0,4,79
626064,374005,2014-06-24,Senate,"Do pass, but re-refer to the Committee on Appropriations Recommend 	Consent",10,0,0,0,10
626064,376420,2014-08-04,Senate,"Do pass",7,0,0,0,7
626064,377738,2014-08-18,Senate,"Assembly 3rd Reading AB2253 Ting",36,0,4,0,40
626065,360727,2014-04-29,Assembly,"Do pass and be re-referred to the Committee on Elections and 	Redistricting",3,7,0,0,10
626066,354441,2014-04-09,Senate,"Do pass as amended, and re-refer to the Committee on Judiciary",6,2,1,0,9
626066,363107,2014-05-06,Senate,"Do pass as amended",5,2,0,0,7
626066,367500,2014-05-27,Senate,"From Committee:  That the measure be returned to the Senate floor 	for consideration",5,2,2,0,9
626067,355274,2014-04-09,Assembly,"Do pass and re-refer to Committee on Appropriations with 	recommendation:  To Consent Calendar",7,0,0,0,7
626067,361154,2014-04-30,Assembly,"Do pass, to Consent Calendar",17,0,0,0,17
626067,363421,2014-05-08,Assembly,"AB 2585 DALY  Consent Calendar Second Day  Regular Session",73,0,0,6,79
626067,370928,2014-06-11,Senate,"Do pass, but re-refer to the Committee on Appropriations Recommend 	Consent",6,0,1,0,7
626067,377772,2014-08-19,Senate,"Assembly 3rd Reading AB2585 Daly By Liu",34,0,6,0,40
626067,377897,2014-08-20,Assembly,"AB 2585 DALY  Concurrence in Senate Amendments",75,1,0,3,79
626068,361178,2014-04-29,Senate,"Do pass as amended, and re-refer to the Committee on 	Appropriations",11,0,0,0,11
626068,365493,2014-05-19,Senate,"Placed on Appropriations Suspense file",7,0,0,0,7
626068,367091,2014-05-23,Senate,"Do pass",7,0,0,0,7
626068,367619,2014-05-27,Senate,"Senate 3rd Reading SB1298 Hernandez",31,0,9,0,40
626068,373744,2014-06-23,Assembly,"Do pass and be re-referred to the Committee on Appropriations",12,1,0,3,16
626068,376715,2014-08-06,Assembly,"Do pass",15,1,0,1,17
626068,378024,2014-08-21,Assembly,"SB 1298 Hernandez  Senate Third Reading  By RIDLEY-THOMAS",70,7,0,2,79
626068,378195,2014-08-22,Senate,"Unfinished Business SB1298 Hernandez Concurrence",33,0,7,0,40
626070,353454,2014-04-07,Assembly,"Do pass as amended and be re-referred to the Committee on 	Appropriations",6,3,0,0,9
626070,366700,2014-05-23,Assembly,"Do pass as amended",11,5,0,1,17
626070,368639,2014-05-29,Assembly,"AB 2390 MURATSUCHI  Assembly Third Reading",23,38,0,18,79
626073,352687,2014-04-07,Senate,"Do pass, but re-refer to the Committee on Judiciary",8,0,1,0,9
626073,361156,2014-04-29,Senate,"Do pass",7,0,0,0,7
626073,362256,2014-05-05,Senate,"Senate 3rd Reading SB1326 Roth",37,0,3,0,40
626073,374138,2014-06-24,Assembly,"Do pass",12,0,0,2,14
626073,376763,2014-08-07,Assembly,"SB 1326 Roth  Senate Third Reading  By MULLIN",78,0,0,1,79
626073,376993,2014-08-11,Senate,"Unfinished Business SB1326 Roth Concurrence",35,0,5,0,40
626075,361196,2014-04-29,Assembly,"Do pass and re-refer to Committee on Appropriations with 	recommendation:  To Consent Calendar",7,0,0,0,7
626075,366151,2014-05-21,Assembly,"Do pass, to Consent Calendar",17,0,0,0,17
626075,367487,2014-05-27,Assembly,"AB 2556 CHAU  Consent Calendar Second Day  Regular Session",77,0,0,2,79
626076,359091,2014-04-22,Senate,"Do pass, but re-refer to the Committee on Appropriations Recommend 	Consent",6,0,1,0,7
626076,363367,2014-05-08,Senate,"Consent Calendar 2nd SB1356 Lieu",35,0,5,0,40
626076,370424,2014-06-10,Assembly,"Do pass and be re-referred to the Committee on Appropriations",9,0,0,1,10
626076,372554,2014-06-18,Assembly,"Do pass, to Consent Calendar",15,0,0,2,17
626076,378222,2014-08-22,Assembly,"SB 1356 De Leon  Third Reading Urgency  By GATTO",74,0,0,5,79
626076,378349,2014-08-25,Senate,"Unfinished Business SB1356 De Le",34,0,6,0,40
626077,353257,2014-04-08,Senate,"Do pass, but re-refer to the Committee on Judiciary",6,4,1,0,11
626077,362969,2014-05-06,Senate,"Do pass as amended",5,2,0,0,7
626077,368090,2014-05-28,Senate,"Senate 3rd Reading SB1439 Leno",18,19,3,0,40
626077,368091,2014-05-28,Senate,"Senate 3rd Reading SB1439 Leno Reconsider",36,0,4,0,40
626077,368716,2014-05-29,Senate,"Senate 3rd Reading SB1439 Leno",21,13,6,0,40
626077,372752,2014-06-18,Assembly,"Do pass and be re-referred to the Committee on Judiciary",3,4,0,0,7
626077,372753,2014-06-18,Assembly,"Set first hearing.  Failed passage.  Reconsideration granted",7,0,0,0,7
626078,359587,2014-04-24,Senate,"Do pass as amended, but re-refer to the Committee on Appropriations 	Recommend Consent",8,0,1,0,9
626078,362272,2014-05-05,Senate,"Do pass",6,0,1,0,7
626078,363692,2014-05-12,Senate,"Senate 3rd Reading SB1380 Wyland",33,0,7,0,40
626078,375119,2014-06-25,Assembly,"Do pass and re-refer to Committee on Appropriations with 	recommendation:  To Consent Calendar",7,0,0,0,7
626078,377268,2014-08-14,Assembly,"Do pass",16,0,0,1,17
626078,378459,2014-08-26,Assembly,"SB 1380 Wyland  Senate Third Reading  By NAZARIAN",78,0,0,1,79
626078,378681,2014-08-27,Senate,"Unfinished Business SB1380 Wyland Concurrence",34,0,6,0,40
626079,354154,2014-04-09,Assembly,"Do pass as amended and be re-referred to the Committee on 	Appropriations",12,0,0,1,13
626079,367177,2014-05-23,Assembly,"Do pass",17,0,0,0,17
626079,368206,2014-05-28,Assembly,"AB 2523 COOLEY  Assembly Third Reading",78,0,0,1,79
626079,375514,2014-07-01,Senate,"Do pass as amended, and re-refer to the Committee on 	Appropriations",7,1,2,0,10
626079,376428,2014-08-04,Senate,"Do pass",7,0,0,0,7
626079,378139,2014-08-21,Senate,"Assembly 3rd Reading AB2523 Cooley Urgency Clause",29,7,4,0,40
626079,378245,2014-08-22,Assembly,"AB 2523 COOLEY  Concurrence- Urgency Added",76,0,0,3,79
626081,358510,2014-04-22,Assembly,"Do pass as amended and be re-referred to the Committee on 	Appropriations",10,0,0,0,10
626081,363000,2014-05-07,Assembly,"Do pass, to Consent Calendar",17,0,0,0,17
626081,365266,2014-05-19,Assembly,"AB 2643 WIECKOWSKI  Assembly Third Reading",75,0,0,4,79
626081,372736,2014-06-17,Senate,"Do pass as amended, and re-refer to the Committee on 	Appropriations",6,0,1,0,7
626081,378011,2014-08-21,Senate,"Assembly 3rd Reading AB2643 Wieckowski By Cannella",36,0,4,0,40
626081,378315,2014-08-25,Assembly,"AB 2643 WIECKOWSKI  Concurrence in Senate Amendments",79,0,0,0,79
626083,350479,2014-04-01,Assembly,"Do pass and be re-referred to the Committee on Appropriations",5,1,0,1,7
626083,354334,2014-04-09,Assembly,"Do pass",13,4,0,0,17
626083,358034,2014-04-21,Assembly,"AB 2243 WEBER  Assembly Third Reading",59,13,0,7,79
626083,372453,2014-06-17,Senate,"Do pass, but re-refer to the Committee on Appropriations",5,0,2,0,7
626083,377131,2014-08-14,Senate,"Assembly 3rd Reading AB2243 Weber By Block",22,10,8,0,40
626084,360669,2014-04-29,Assembly,"Do pass as amended and be re-referred to the Committee on 	Appropriations",7,0,0,0,7
626084,364253,2014-05-14,Assembly,"Do pass",17,0,0,0,17
626084,365297,2014-05-19,Assembly,"AB 2314 HALL  Assembly Third Reading",75,0,0,4,79
626086,361526,2014-04-29,Assembly,"Do pass as amended and be re-referred to the Committee on 	Appropriations",6,0,0,1,7
626086,366138,2014-05-21,Assembly,"Do pass",13,4,0,0,17
626086,368146,2014-05-28,Assembly,"AB 2668 QUIRK-SILVA  Assembly Third Reading",61,14,0,4,79
626086,374636,2014-06-24,Senate,"Do pass as amended, and re-refer to the Committee on Public Safety",4,0,1,0,5
626086,376525,2014-08-04,Senate,"Placed on Appropriations Suspense file",7,0,0,0,7
626086,377180,2014-08-14,Senate,"Do pass as amended",5,0,2,0,7
626086,378161,2014-08-21,Senate,"Assembly 3rd Reading AB2668 Quirk-Silva By Beall",33,0,7,0,40
626086,378302,2014-08-25,Assembly,"AB 2668 QUIRK-SILVA  Concurrence in Senate Amendments",60,18,0,1,79
626087,350559,2014-04-01,Assembly,"Do pass as amended",9,0,0,1,10
626087,359812,2014-04-24,Assembly,"AB 2634 BRADFORD  Assembly Third Reading",65,2,0,12,79
626087,371198,2014-06-10,Senate,"Do pass",5,1,1,0,7
626087,376787,2014-08-07,Senate,"Assembly 3rd Reading AB2634 Bradford By Hueso",28,5,7,0,40
626087,377007,2014-08-11,Assembly,"AB 2634 BRADFORD  Concurrence in Senate Amendments",69,5,0,5,79
626089,361047,2014-04-29,Assembly,"Do pass as amended and be re-referred to the Committee on 	Appropriations",7,0,0,0,7
626089,364390,2014-05-14,Assembly,"Do pass, to Consent Calendar",17,0,0,0,17
626089,367588,2014-05-27,Assembly,"AB 2685 COOLEY  Assembly Third Reading",77,0,0,2,79
626089,372520,2014-06-17,Senate,"Do pass, but re-refer to the Committee on Appropriations",5,0,2,0,7
626089,378430,2014-08-25,Senate,"Assembly 3rd Reading AB2685 Cooley By Galgiani",35,0,5,0,40
626089,378532,2014-08-26,Assembly,"AB 2685 COOLEY  Concurrence in Senate Amendments",79,0,0,0,79
626093,350338,2014-04-01,Senate,"Do pass, but re-refer to the Committee on Rules",11,0,0,0,11
626093,361227,2014-04-30,Senate,"Do pass as amended, and re-refer to the Committee on 	Appropriations",6,1,0,0,7
626093,365387,2014-05-19,Senate,"Placed on Appropriations Suspense file",7,0,0,0,7
626093,367019,2014-05-23,Senate,"Do pass",6,1,0,0,7
626093,367567,2014-05-27,Senate,"Senate 3rd Reading SB1275 De Le",27,9,4,0,40
626093,371889,2014-06-16,Assembly,"Do pass and be re-referred to the Committee on Natural Resources",10,2,0,4,16
626093,374146,2014-06-23,Assembly,"Do pass as amended and be re-referred to the Committee on 	Appropriations",6,3,0,0,9
626093,377320,2014-08-14,Assembly,"Do pass as amended",12,5,0,0,17
626093,378672,2014-08-27,Assembly,"SB 1275 De Leon  Senate Third Reading  By BOCANEGRA",53,24,0,2,79
626093,378958,2014-08-28,Senate,"Unfinished Business SB1275 De Le",26,11,3,0,40
626104,362661,2014-05-06,Assembly,"Do pass, to Consent Calendar",10,0,0,0,10
626104,364949,2014-05-15,Assembly,"AB 2306 CHAU  Consent Calendar Second Day  Regular Session",78,0,0,1,79
626104,371147,2014-06-10,Senate,"Do pass",7,0,0,0,7
626104,378666,2014-08-27,Senate,"Special Consent #19 AB2306 Chau By Jackson",36,0,4,0,40
626104,378870,2014-08-28,Assembly,"AB 2306 CHAU  Concurrence in Senate Amendments",79,0,0,0,79
626107,361441,2014-04-30,Assembly,"Do pass and re-refer to Committee on Appropriations with 	recommendation:  To Consent Calendar",19,0,0,0,19
626107,364671,2014-05-14,Assembly,"Do pass, to Consent Calendar",17,0,0,0,17
626107,366673,2014-05-23,Assembly,"AB 2637 HALL  Consent Calendar Second Day  Regular Session",73,0,0,6,79
626107,374076,2014-06-24,Senate,"Do pass, but re-refer to the Committee on Appropriations Recommend 	Consent",10,0,0,0,10
626107,376780,2014-08-07,Senate,"Consent Calendar 2nd AB2637 Hall",34,0,6,0,40
626115,359530,2014-04-23,Assembly,"Do pass and be re-referred to the Committee on Appropriations",5,2,0,0,7
626115,366723,2014-05-23,Assembly,"Do pass",12,5,0,0,17
626115,368215,2014-05-28,Assembly,"AB 2271 CALDERON  Assembly Third Reading  Amend By JONES  Set #1 	Motion to  Lay on the Table  By PEREZ, V.M",51,24,0,4,79
626115,368216,2014-05-28,Assembly,"AB 2271 CALDERON  Assembly Third Reading",51,23,0,5,79
626115,372841,2014-06-17,Senate,"Do pass, but re-refer to the Committee on Labor and Industrial 	Relations",5,1,1,0,7
626115,374499,2014-06-25,Senate,"Do pass, but re-refer to the Committee on Appropriations",4,1,0,0,5
626115,376644,2014-08-04,Senate,"Placed on Appropriations Suspense file",7,0,0,0,7
626115,377463,2014-08-14,Senate,"Do pass as amended",5,0,2,0,7
626115,377766,2014-08-19,Senate,"Assembly 3rd Reading AB2271 Ian Calderon By Leno",24,9,7,0,40
626115,378023,2014-08-21,Assembly,"AB 2271 CALDERON  Concurrence in Senate Amendments",55,21,0,3,79
626118,354506,2014-04-09,Assembly,"Do pass",8,1,0,0,9
626118,362346,2014-05-05,Assembly,"AB 2549 RIDLEY-THOMAS  Assembly Third Reading",61,5,0,13,79
626122,354608,2014-04-02,Assembly,"Do pass and be re-referred to the Committee on Appropriations",17,1,0,1,19
626122,354609,2014-04-09,Assembly,"Do pass",16,1,0,0,17
626122,362306,2014-05-05,Assembly,"AB 2441 MULLIN  Assembly Third Reading",70,4,0,5,79
626122,372136,2014-06-17,Senate,"Do pass, but re-refer to the Committee on Appropriations",11,0,0,0,11
626961,344007,2014-03-17,Assembly,"From committee:  Be adopted.  To third reading",10,0,0,1,11
626961,359651,2014-04-24,Senate,"Special Consent #12 ACR111 Levine",37,0,3,0,40
626962,350973,2014-04-02,Senate,"Do pass, but re-refer to the Committee on Appropriations Recommend 	Consent",6,0,1,0,7
626962,361652,2014-05-01,Senate,"Consent Calendar 2nd SB1458 Committee on E.Q. (Hill)",35,0,5,0,40
626962,372252,2014-06-17,Assembly,"Do pass and re-refer to Committee on Appropriations with 	recommendation:  To Consent Calendar",7,0,0,0,7
626962,376692,2014-08-06,Assembly,"Do pass, to Consent Calendar",17,0,0,0,17
626962,377429,2014-08-14,Assembly,"SB 1458 E.Q.  Consent Calendar Second Day  Regular Session",78,0,0,1,79
626962,377608,2014-08-18,Senate,"Unfinished Business SB1458 Committee on E.Q. (Hill) Concurrence",36,0,4,0,40
626964,355042,2014-04-09,Assembly,"Do pass and re-refer to Committee on Appropriations with 	recommendation:  To Consent Calendar",7,0,0,0,7
626964,361371,2014-04-30,Assembly,"Do pass",17,0,0,0,17
626964,364967,2014-05-15,Assembly,"AB 2730 AGRI.  Assembly Third Reading  By EGGMAN",78,0,0,1,79
626964,372271,2014-06-17,Senate,"Do pass, but re-refer to the Committee on Appropriations Recommend 	Consent",5,0,0,0,5
628027,342135,2014-03-13,Assembly,"From committee:  Be adopted.  To third reading",9,0,0,2,11
628027,359605,2014-04-24,Senate,"Special Consent #12 ACR112 Mullin",37,0,3,0,40
628034,358489,2014-04-22,Senate,"Do pass, but re-refer to the Committee on Appropriations Recommend 	Consent",4,0,1,0,5
628034,362198,2014-05-05,Senate,"Placed on Appropriations Suspense file",7,0,0,0,7
628034,366824,2014-05-23,Senate,"Do pass",7,0,0,0,7
628034,368631,2014-05-29,Senate,"Senate 3rd Reading SB1460 Committee on HUMAN S. (Beall)",37,0,3,0,40
628034,372147,2014-06-17,Assembly,"Do pass and re-refer to Committee on Appropriations with 	recommendation:  To Consent Calendar",6,0,0,1,7
628034,376686,2014-08-06,Assembly,"Do pass",17,0,0,0,17
628034,378513,2014-08-26,Assembly,"SB 1460 HUMAN. S.  Senate Third Reading  By STONE",79,0,0,0,79
628034,378768,2014-08-27,Senate,"Unfinished Business SB1460 Committee on HUMAN S. (Beall) Concurrence",34,0,6,0,40
628042,351427,2014-04-02,Assembly,"Do pass and be re-referred to the Committee on Revenue and Taxation 	to Consent Calendar",12,0,0,1,13
628042,360469,2014-04-28,Assembly,"Do pass and re-refer to Committee on Appropriations with 	recommendation:  To Consent Calendar",9,0,0,0,9
628042,363158,2014-05-07,Assembly,"Do pass, to Consent Calendar",17,0,0,0,17
628042,364865,2014-05-15,Assembly,"AB 2734 INS.  Consent Calendar Second Day  Regular Session",78,0,0,1,79
628042,374955,2014-06-25,Senate,"Do pass, but re-refer to the Committee on Appropriations Recommend 	Consent",10,0,1,0,11
628042,378090,2014-08-21,Senate,"Assembly 3rd Reading AB2734 Committee on INS. (Perea) By Correa",35,0,5,0,40
628042,378225,2014-08-22,Assembly,"AB 2734 INS.  Concurrence in Senate Amendments By PEREA",76,0,0,3,79
628051,350922,2014-04-02,Assembly,"Do pass, to Consent Calendar",12,0,0,1,13
628051,361278,2014-04-30,Assembly,"Do pass, to Consent Calendar",17,0,0,0,17
628051,363417,2014-05-08,Assembly,"AB 2732 INS.  Consent Calendar Second Day  Regular Session",73,0,0,6,79
628051,371195,2014-06-11,Senate,"Do pass, but re-refer to the Committee on Appropriations",5,0,0,0,5
628051,375644,2014-07-03,Senate,"Special Consent #18 AB2732 Committee on INS. (Perea)",35,0,5,0,40
628051,376377,2014-08-04,Assembly,"AB 2732 INS.  Concurrence in Senate Amendments By PEREA",78,0,0,1,79
628059,341935,2014-03-13,Assembly,"From committee:  Be adopted.  To third reading",9,0,0,2,11
628059,363430,2014-05-08,Senate,"Assembly 3rd Reading ACR114 Campos By Lara",34,0,6,0,40
628059,364885,2014-05-15,Assembly,"ACR 114 CAMPOS  Concurrence in Senate Amendments",76,0,0,3,79
628066,342000,2014-03-13,Assembly,"From committee:  Be adopted.  To third reading",9,0,0,2,11
628066,358027,2014-04-21,Senate,"Assembly 3rd Reading ACR113 Hagman By Fuller",35,0,5,0,40
628074,361803,2014-05-01,Assembly,"From committee:  Be adopted.  To third reading",10,0,0,1,11
628074,363372,2014-05-08,Assembly,"ACR 115 CALDERON  Assembly Third Reading",75,0,0,4,79
628074,370070,2014-06-05,Senate,"Special Consent #16 ACR115 Ian Calderon",33,0,7,0,40
628083,350859,2014-04-02,Assembly,"Do pass, to Consent Calendar",12,0,0,1,13
628083,355063,2014-04-10,Assembly,"AB 2731 INS.  Consent Calendar Second Day  Regular Session",74,0,0,5,79
628083,374974,2014-06-25,Senate,"Do pass and be placed on the Consent Calendar",10,0,1,0,11
628083,379012,2014-08-29,Senate,"Do pass",8,0,3,0,11
628083,379013,2014-08-29,Senate,"Assembly 3rd Supp 1 AB2731 Perea Urgency Clause",34,0,6,0,40
628083,379014,2014-08-29,Assembly,"AB 2731 PEREA  Concurrence- Urgency Added",76,0,0,3,79
628091,351594,2014-04-02,Assembly,"Do pass and re-refer to Committee on Appropriations with 	recommendation:  To Consent Calendar",12,0,0,1,13
628091,354233,2014-04-09,Assembly,"Do pass, to Consent Calendar",17,0,0,0,17
628091,359606,2014-04-24,Assembly,"AB 2733 INS.  Consent Calendar Second Day  Regular Session",75,0,0,4,79
628091,371053,2014-06-11,Senate,"Do pass as amended, but re-refer to the Committee on Appropriations 	Recommend Consent",10,0,1,0,11
628091,374856,2014-06-26,Senate,"Consent Calendar 2nd AB2733 Committee on INS. (Perea)",32,0,8,0,40
628091,375290,2014-06-30,Assembly,"AB 2733 INS.  Concurrence in Senate Amendments By PEREA",78,0,0,1,79
628098,350915,2014-04-02,Assembly,"Do pass and re-refer to Committee on Appropriations with 	recommendation:  To Consent Calendar",12,0,0,1,13
628098,354430,2014-04-09,Assembly,"Do pass, to Consent Calendar",17,0,0,0,17
628098,359709,2014-04-24,Assembly,"AB 2735 INS.  Consent Calendar Second Day  Regular Session",75,0,0,4,79
628098,374876,2014-06-25,Senate,"Do pass as amended, but re-refer to the Committee on 	Appropriations Recommend Consent",10,0,1,0,11
628098,377065,2014-08-13,Senate,"Assembly 3rd Reading AB2735 Committee on INS. (Perea) By Monning",36,0,4,0,40
628098,377657,2014-08-18,Assembly,"AB 2735 INS.  Concurrence in Senate Amendments By PEREA",78,0,0,1,79
628105,361221,2014-04-30,Senate,"Do pass, but re-refer to the Committee on Appropriations Recommend 	Consent",9,0,0,0,9
628105,364845,2014-05-15,Senate,"Consent Calendar 2nd SB1459 Committee on B. & F.I. (Correa)",36,0,4,0,40
628105,370454,2014-06-09,Assembly,"Do pass and re-refer to Committee on Appropriations with 	recommendation:  To Consent Calendar",12,0,0,0,12
628105,372795,2014-06-18,Assembly,"Do pass, to Consent Calendar",15,0,0,2,17
628105,374808,2014-06-26,Assembly,"SB 1459 B.&.F.I.  Consent Calendar Second Day  Regular Session",76,0,0,3,79
629395,350481,2014-04-01,Assembly,"Do pass and be re-referred to the Committee on Appropriations",13,0,0,0,13
629395,354487,2014-04-09,Assembly,"Do pass as amended, to Consent Calendar",17,0,0,0,17
629395,360150,2014-04-28,Assembly,"AB 2736 HIGHER ED.  Consent Calendar Second Day  Regular Session",78,0,0,1,79
629395,372726,2014-06-18,Senate,"Do pass as amended, and re-refer to the Committee on Appropriations",7,0,0,0,7
629395,377688,2014-08-18,Senate,"Assembly 3rd Reading AB2736 Committee on HIGHER ED. (Williams By 	Lara",36,0,4,0,40
629395,378563,2014-08-25,Assembly,"Senate amendments be concurred in",11,0,0,2,13
629395,378810,2014-08-27,Assembly,"AB 2736 HIGHER ED.  Concurrence in Senate Amendments By WILLIAMS",78,0,0,1,79
629397,371748,2014-06-16,Senate,"Senate 3rd Reading SCR91 Fuller",36,0,4,0,40
629397,376401,2014-08-04,Assembly,"From committee:  Be adopted.  To third reading",9,0,0,2,11
629397,377444,2014-08-14,Senate,"Unfinished Business SCR91 Fuller Concurrence",31,0,9,0,40
629411,343999,2014-03-17,Senate,"Senate 3rd Reading SCR92 Galgiani",35,0,4,0,39
629411,348894,2014-03-28,Assembly,"Be adopted, to Consent Calendar",10,0,0,1,11
629411,351889,2014-04-03,Assembly,"SCR 92 Galgiani  Consent Calendar Second Day  Regular Session",76,0,0,3,79
629419,358481,2014-04-22,Assembly,"Do pass and be re-referred to the Committee on Appropriations",14,0,0,0,14
629419,361295,2014-04-30,Assembly,"Do pass, to Consent Calendar",17,0,0,0,17
629419,363342,2014-05-08,Assembly,"AB 2740 BONILLA  Consent Calendar Second Day  Regular Session",73,0,0,6,79
629419,374214,2014-06-23,Senate,"Do pass, but re-refer to the Committee on Appropriations",8,0,1,0,9
629419,378177,2014-08-21,Senate,"Assembly 3rd Reading AB2740 Bonilla By Lieu",32,0,8,0,40
629419,378266,2014-08-22,Assembly,"AB 2740 BONILLA  Concurrence in Senate Amendments",75,0,0,4,79
629425,360672,2014-04-29,Assembly,"Do pass and be re-referred to the Committee on Appropriations",5,1,0,1,7
629430,360549,2014-04-29,Assembly,"Do pass and be re-referred to the Committee on Appropriations",6,1,0,0,7
629430,366907,2014-05-23,Assembly,"Do pass as amended",13,0,0,4,17
629430,368192,2014-05-28,Assembly,"AB 2738 E.S.& T.M.  Assembly Third Reading  By ALEJO",63,8,0,8,79
629430,374491,2014-06-25,Senate,"Do pass as amended, and re-refer to the Committee on 	Appropriations",5,1,1,0,7
629430,376745,2014-08-07,Senate,"Assembly 3rd Reading AB2738 Committee on E.S. & T.M.(Alejo) By Hill",33,0,7,0,40
629430,377470,2014-08-14,Assembly,"AB 2738 E.S.& T.M.  Concurrence in Senate Amendments By ALEJO",78,0,0,1,79
629435,355200,2014-04-10,Assembly,"From committee:  Be adopted.  To third reading",7,0,0,4,11
629435,367037,2014-05-23,Senate,"Special Consent #15 ACR116 Chesbro",32,0,8,0,40
629454,358371,2014-04-22,Assembly,"Do pass and be re-referred to the Committee on Appropriations",13,0,0,1,14
629454,367189,2014-05-23,Assembly,"Do pass",13,0,0,4,17
629454,367603,2014-05-27,Assembly,"AB 2741 BONILLA  Assembly Third Reading",61,10,0,8,79
629454,374166,2014-06-23,Senate,"Do pass, but re-refer to the Committee on Appropriations",8,0,1,0,9
629454,376622,2014-08-04,Senate,"Placed on Appropriations Suspense file",7,0,0,0,7
629454,377522,2014-08-14,Senate,"Do pass",5,1,1,0,7
629454,377959,2014-08-20,Senate,"Assembly 3rd Reading AB2741 Bonilla By Lieu",29,5,6,0,40
630645,352008,2014-04-02,Assembly,"Do pass and be re-referred to the Committee on Appropriations",5,0,0,2,7
630645,354464,2014-04-09,Assembly,"Do pass",12,5,0,0,17
630645,361782,2014-05-01,Assembly,"AB 2743 L.& E.  Assembly Third Reading  By HERNANDEZ",49,23,0,7,79
630645,371183,2014-06-11,Senate,"Do pass, but re-refer to the Committee on Appropriations",4,1,0,0,5
630645,376368,2014-08-04,Senate,"Assembly 3rd Reading AB2743 Committee on L. & E. (R.Hern",25,11,4,0,40
630646,359577,2014-04-23,Assembly,"Do pass and be re-referred to the Committee on Appropriations",7,0,0,0,7
630646,361335,2014-04-30,Assembly,"Do pass, to Consent Calendar",17,0,0,0,17
630646,363392,2014-05-08,Assembly,"AB 2744 L.& E.  Consent Calendar Second Day  Regular Session",73,0,0,6,79
630646,374403,2014-06-25,Senate,"Do pass, but re-refer to the Committee on Appropriations",5,0,0,0,5
630646,376819,2014-08-07,Senate,"Assembly 3rd Reading AB2744 Committee on L. & E. (R.Hern",34,0,6,0,40
630646,376948,2014-08-11,Assembly,"AB 2744 L.& E.  Concurrence in Senate Amendments By HERNANDEZ",79,0,0,0,79
630649,353275,2014-04-07,Assembly,"Do pass, to Consent Calendar",12,0,0,0,12
630649,357972,2014-04-21,Assembly,"AB 2742 B.& F.  Consent Calendar Second Day  Regular Session",77,0,0,2,79
630649,369990,2014-06-04,Senate,"Do pass",8,0,1,0,9
630649,371789,2014-06-16,Senate,"Consent Calendar 2nd AB2742 Committee on B. & F. (Dickinson)",35,0,5,0,40
632798,360703,2014-04-29,Senate,"Do pass",6,0,1,0,7
632798,363397,2014-05-08,Senate,"Special Consent #13 SB1461 Committee on Pub. S. (Hancock)",35,0,5,0,40
632798,370613,2014-06-10,Assembly,"Do pass, to Consent Calendar",7,0,0,0,7
632798,371805,2014-06-16,Assembly,"SB 1461 PUB. S.  Consent Calendar Second Day  Regular Session",77,0,0,2,79
632860,376771,2014-08-07,Senate,"Senate 3rd Reading SCR93 Corbett",36,0,4,0,40
632860,378057,2014-08-21,Assembly,"Be adopted, to Consent Calendar",10,0,0,1,11
632860,378353,2014-08-25,Assembly,"SCR 93 Corbett  Consent Calendar Second Day  Regular Session",79,0,0,0,79
633606,353864,2014-04-08,Assembly,"Do pass and be re-referred to the Committee on Appropriations",10,0,0,0,10
633606,366833,2014-05-23,Assembly,"Do pass",17,0,0,0,17
633606,367478,2014-05-27,Assembly,"AB 2745 JUD.  Assembly Third Reading  By WIECKOWSKI",76,0,0,3,79
633606,372707,2014-06-17,Senate,"Do pass, but re-refer to the Committee on Appropriations",6,0,1,0,7
633606,376652,2014-08-04,Senate,"Placed on Appropriations Suspense file",7,0,0,0,7
633606,377582,2014-08-14,Senate,"Do pass",5,0,2,0,7
633606,377815,2014-08-19,Senate,"Assembly 3rd Reading AB2745 Committee on JUD. (Wieckowski) By 	Corbett",33,0,7,0,40
633606,378105,2014-08-21,Assembly,"AB 2745 JUD.  Concurrence in Senate Amendments By WIECKOWSKI",79,0,0,0,79
633608,346414,2014-03-20,Senate,"Senate 3rd Reading SR32 Vidak",33,0,6,0,39
633611,358798,2014-04-21,Assembly,"Be adopted, and re-refer to Committee on Appropriations with 	recommendation:  To Consent Calendar",15,0,0,1,16
633611,361228,2014-04-30,Assembly,"Be adopted, to Consent Calendar",17,0,0,0,17
633611,362214,2014-05-05,Assembly,"ACR 117 TING  Consent Calendar Second Day  Regular Session",75,0,0,4,79
633611,370708,2014-06-10,Senate,"Be adopted, but re-refer to the Committee on Appropriations 	Recommend Consent",10,0,1,0,11
633611,374866,2014-06-26,Senate,"Consent Calendar 2nd ACR117 Ting",32,0,8,0,40
633611,375350,2014-06-30,Assembly,"ACR 117 TING  Concurrence in Senate Amendments",77,0,0,2,79
633613,362704,2014-05-06,Assembly,"Do pass as amended",10,0,0,0,10
633613,364816,2014-05-15,Assembly,"AB 2746 JUD.  Assembly Third Reading  By WIECKOWSKI",76,0,0,3,79
633613,374284,2014-06-24,Senate,"Do pass as amended",6,1,0,0,7
633613,378514,2014-08-26,Senate,"Assembly 3rd Reading AB2746 Committee on JUD. (Wieckowski) By 	Jackson",33,1,6,0,40
633613,378793,2014-08-27,Assembly,"AB 2746 JUD.  Concurrence in Senate Amendments By WIECKOWSKI",74,2,0,3,79
633616,360668,2014-04-29,Assembly,"Do pass as amended and be re-referred to the Committee on 	Appropriations",7,0,0,3,10
633616,366296,2014-05-21,Assembly,"Do pass",12,5,0,0,17
633616,367063,2014-05-23,Assembly,"AB 2747 JUD.  Assembly Third Reading  By WIECKOWSKI",53,19,0,7,79
633616,374674,2014-06-24,Senate,"Do pass as amended, and re-refer to the Committee on 	Appropriations",5,2,0,0,7
633616,378381,2014-08-25,Senate,"Assembly 3rd Reading AB2747 Committee on JUD. (Wieckowski) By 	Jackson",23,12,5,0,40
633616,378744,2014-08-27,Assembly,"AB 2747 JUD.  Concurrence in Senate Amendments By WIECKOWSKI",56,21,0,2,79
634371,343955,2014-03-17,Assembly,"From committee:  Be adopted.  To third reading",10,0,0,1,11
634396,336557,2014-03-06,Senate,"W/O REF. TO FILE SR33 Steinberg",30,0,9,0,39
635056,359409,2014-04-22,Assembly,"Be adopted and be re-referred to the Committee on Appropriations",12,0,0,1,13
635056,361230,2014-04-30,Assembly,"Be adopted, to Consent Calendar",17,0,0,0,17
635056,362295,2014-05-05,Assembly,"ACR 119 MURATSUCHI  Consent Calendar Second Day  Regular Session",75,0,0,4,79
635056,370904,2014-06-11,Senate,"Be adopted, but re-refer to the Committee on Appropriations 	Recommend Consent",6,0,1,0,7
635056,375292,2014-06-30,Senate,"Placed on Appropriations Suspense file",6,0,1,0,7
635056,378202,2014-08-22,Senate,"Assembly 3rd Reading ACR119 Muratsuchi By Lieu",33,0,7,0,40
635056,378599,2014-08-26,Assembly,"ACR 119 MURATSUCHI  Concurrence in Senate Amendments",79,0,0,0,79
635059,371426,2014-06-12,Assembly,"Be referred to Committee on Transportation",10,0,0,1,11
635059,373729,2014-06-23,Assembly,"Be adopted, and re-refer to Committee on Appropriations with 	recommendation:  To Consent Calendar",13,0,0,3,16
635059,375609,2014-07-02,Assembly,"Be adopted, to Consent Calendar",17,0,0,0,17
635059,376345,2014-08-04,Assembly,"ACR 118 LOGUE  Consent Calendar Second Day",78,0,0,1,79
635059,378719,2014-08-27,Senate,"Consent Calendar 2nd ACR118 Logue",36,0,4,0,40
635059,378918,2014-08-28,Assembly,"ACR 118 LOGUE  Concurrence in Senate Amendments",78,0,0,1,79
635061,347619,2014-03-25,Senate,"Be adopted, but re-refer to the Committee on Appropriations",8,0,2,0,10
635061,359584,2014-04-24,Senate,"Special Consent #12 SCR95 Steinberg",37,0,3,0,40
635061,373534,2014-06-18,Assembly,"Be adopted, and re-refer to Committee on Appropriations with 	recommendation:  To Consent Calendar",7,0,0,0,7
635061,375522,2014-07-02,Assembly,"Be adopted, to Consent Calendar",17,0,0,0,17
635061,376353,2014-08-04,Assembly,"SCR 95 Steinberg  Consent Calendar Second Day  Regular Session",78,0,0,1,79
635064,360675,2014-04-29,Assembly,"Do pass, to Consent Calendar",7,0,0,0,7
635064,364691,2014-05-14,Assembly,"Do pass, to Consent Calendar",17,0,0,0,17
635064,366710,2014-05-23,Assembly,"AB 2748 E.S.& T.M.  Consent Calendar Second Day  Regular Session",73,0,0,6,79
635064,372546,2014-06-18,Senate,"Do pass, but re-refer to the Committee on Appropriations Recommend 	Consent",7,0,0,0,7
635064,378403,2014-08-25,Senate,"Assembly 3rd Reading AB2748 Committee on E.S. & T.M.(Alejo) By 	Jackson",35,0,5,0,40
635064,378508,2014-08-26,Assembly,"AB 2748 E.S.& T.M.  Concurrence in Senate Amendments By ALEJO",79,0,0,0,79
635066,355160,2014-04-10,Senate,"Senate 3rd Reading SCR94 Evans",34,0,6,0,40
635066,359585,2014-04-24,Assembly,"Be adopted, to Consent Calendar",8,0,0,3,11
635066,361766,2014-05-01,Assembly,"SCR 94 Evans  Consent Calendar Second Day",74,0,0,5,79
636311,351797,2014-04-03,Assembly,"From committee:  Be adopted.  To third reading",9,0,0,2,11
636311,364906,2014-05-15,Senate,"Assembly 3rd Reading ACR120 Levine By Block",36,0,4,0,40
636395,343966,2014-03-17,Senate,"W/O REF. TO FILE SCR96 Yee",35,0,4,0,39
636437,354923,2014-04-09,Senate,"Do pass",7,0,2,0,9
636437,359597,2014-04-24,Senate,"Special Consent #12 SJR19 Correa",37,0,3,0,40
636437,374049,2014-06-23,Assembly,"Be adopted as amended",12,0,0,0,12
636437,376407,2014-08-04,Assembly,"SJR 19 Correa  Senate Third Reading  By DABABNEH",78,0,0,1,79
636437,377038,2014-08-13,Senate,"Unfinished Business SJR19 Correa Concurrence",34,0,6,0,40
636477,346571,2014-03-20,Senate,"Senate 3rd Reading SCR99 Beall",33,0,6,0,39
636477,350279,2014-04-01,Assembly,"From committee:  Be adopted.  To third reading",10,0,0,1,11
636477,355093,2014-04-10,Senate,"Unfinished Business SCR99 Beall Concurrence",34,0,6,0,40
636520,359582,2014-04-24,Senate,"Do pass and be placed on the Consent Calendar",7,0,0,0,7
636520,359583,2014-04-24,Senate,"Do pass as amended, but re-refer to the Committee on Appropriations 	Recommend Consent",7,0,0,0,7
636520,361667,2014-05-01,Senate,"Consent Calendar 2nd SB1462 Committee on GOV. & F. (Wolk)",35,0,5,0,40
636520,372826,2014-06-18,Assembly,"Do pass, to Consent Calendar",9,0,0,0,9
636520,374817,2014-06-26,Assembly,"SB 1462 GOV.& F.  Consent Calendar Second Day  Regular Session",76,0,0,3,79
636520,376357,2014-08-04,Senate,"Unfinished Business SB1462 Committee on GOV. & F. (Wolk) Concurrence",36,0,4,0,40
636562,350389,2014-04-01,Senate,"Senate 3rd Reading SCR97 Anderson",33,0,6,0,39
636562,375690,2014-07-03,Assembly,"Be adopted, to Consent Calendar",11,0,0,0,11
636562,376832,2014-08-07,Assembly,"SCR 97 Anderson  Consent Calendar Second Day  Regular Session",77,0,0,2,79
636596,350626,2014-04-01,Senate,"Senate 3rd Reading SCR98 Wyland",28,0,11,0,39
636596,375692,2014-07-03,Assembly,"Be adopted, to Consent Calendar",11,0,0,0,11
636596,376814,2014-08-07,Assembly,"SCR 98 Wyland  Consent Calendar Second Day  Regular Session",77,0,0,2,79
636596,376994,2014-08-11,Senate,"Unfinished Business SCR98 Wyland Concurrence",32,0,8,0,40
636761,350745,2014-04-01,Assembly,"Be adopted, to Consent Calendar",10,0,0,1,11
636761,351822,2014-04-03,Assembly,"HR 35 CAMPOS  Consent Calendar Second Day  Regular Session",76,0,0,3,79
636841,359259,2014-04-22,Assembly,"Do pass and be re-referred to the Committee on Appropriations to 	Consent Calendar",5,0,0,4,9
636841,363130,2014-05-07,Assembly,"Do pass, to Consent Calendar",17,0,0,0,17
636841,364951,2014-05-15,Assembly,"AB 2749 J., E.D.& E.  Consent Calendar Second Day  Regular Session",78,0,0,1,79
636841,371808,2014-06-16,Senate,"Do pass, but re-refer to the Committee on Appropriations Recommend 	Consent",9,0,0,0,9
636841,375671,2014-07-03,Senate,"Consent Calendar 2nd AB2749 Committee on Jobs, Economic Devel",35,0,5,0,40
637852,358925,2014-04-21,Assembly,"Be adopted, and re-refer to Committee on Appropriations with 	recommendation:  To Consent Calendar",15,0,0,1,16
637852,361235,2014-04-30,Assembly,"Be adopted, to Consent Calendar",17,0,0,0,17
637852,362299,2014-05-05,Assembly,"ACR 121 DAHLE  Consent Calendar Second Day  Regular Session",75,0,0,4,79
637869,363306,2014-05-07,Assembly,"Do pass",5,1,0,1,7
637869,364856,2014-05-15,Assembly,"AB 2751 HERNANDEZ  Assembly Third Reading",54,19,0,6,79
637869,370965,2014-06-10,Senate,"Do pass",5,1,1,0,7
637869,373143,2014-06-19,Senate,"Assembly 3rd Reading AB2751 Roger Hern",27,1,12,0,40
637869,373701,2014-06-23,Assembly,"AB 2751 HERNANDEZ  Concurrence in Senate Amendments",57,4,0,18,79
637888,359792,2014-04-24,Senate,"Do pass, but re-refer to the Committee on Appropriations Recommend 	Consent",7,0,0,0,7
637888,363498,2014-05-08,Senate,"Special Consent #13 SB1464 Committee on GOV. & F. (Wolk)",35,0,5,0,40
637888,374898,2014-06-25,Assembly,"Do pass, to Consent Calendar",9,0,0,0,9
637888,375710,2014-07-03,Assembly,"SB 1464 GOV.& F.  Consent Calendar Second Day  Regular Session",76,0,0,3,79
637905,363097,2014-05-07,Assembly,"Do pass, to Consent Calendar",6,0,0,1,7
637905,365360,2014-05-19,Assembly,"AB 2750 HERNANDEZ  Assembly Third Reading",73,0,0,6,79
637922,359803,2014-04-24,Senate,"Do pass and be placed on the Consent Calendar",7,0,0,0,7
637922,359804,2014-04-24,Senate,"Do pass as amended, but re-refer to the Committee on Appropriations 	Recommend Consent",7,0,0,0,7
637922,363505,2014-05-08,Senate,"Consent Calendar 2nd SB1463 Committee on GOV. & F. (Wolk)",35,0,5,0,40
637922,374179,2014-06-23,Assembly,"Do pass and re-refer to Committee on Appropriations with 	recommendation:  To Consent Calendar",12,0,0,0,12
637922,375537,2014-07-02,Assembly,"Do pass, to Consent Calendar",17,0,0,0,17
637922,376829,2014-08-07,Assembly,"SB 1463 GOV.& F.  Consent Calendar Second Day  Regular Session",77,0,0,2,79
638557,348876,2014-03-28,Senate,"Senate 3rd Reading SR36 Walters",28,0,11,0,39
638561,347077,2014-03-24,Senate,"Senate 3rd Reading SCR100 Knight",34,0,5,0,39
638561,376834,2014-08-07,Assembly,"Be adopted, to Consent Calendar",7,0,0,4,11
638561,377360,2014-08-14,Assembly,"SCR 100 Knight  Consent Calendar Second Day",78,0,0,1,79
638566,359642,2014-04-24,Assembly,"From committee:  Be adopted.  To third reading",8,0,0,3,11
638566,366831,2014-05-23,Senate,"Special Consent #15 ACR122 Beth Gaines",32,0,8,0,40
639216,372732,2014-06-17,Assembly,"From committee:  Be adopted.  To third reading",9,0,0,1,10
639216,375682,2014-07-03,Assembly,"AJR 46 FRAZIER  Assembly Third Reading",77,0,0,2,79
639216,378393,2014-08-25,Senate,"Assembly 3rd Reading AJR46 Frazier By Hueso",35,0,5,0,40
639216,378588,2014-08-26,Assembly,"AJR 46 FRAZIER  Concurrence in Senate Amendments",79,0,0,0,79
639644,358461,2014-04-21,Assembly,"From committee:  Be adopted.  To third reading",9,0,0,2,11
639644,359683,2014-04-24,Assembly,"AJR 41 CALDERON  Assembly Third Reading",74,1,0,4,79
639644,370114,2014-06-05,Senate,"Special Consent #16 AJR41 Ian Calderon",33,0,7,0,40
639648,360711,2014-04-28,Assembly,"Do pass and re-refer to Committee on Appropriations with 	recommendation:  To Consent Calendar",15,0,0,1,16
639648,363103,2014-05-07,Assembly,"Do pass, to Consent Calendar",17,0,0,0,17
639648,364904,2014-05-15,Assembly,"AB 2752 TRANS.  Consent Calendar Second Day  Regular Session",78,0,0,1,79
639648,374743,2014-06-26,Senate,"Do pass, but re-refer to the Committee on Appropriations Recommend 	Consent",10,0,1,0,11
639648,377998,2014-08-20,Senate,"Assembly 3rd Reading AB2752 Committee on TRANS. (Lowenthal) By 	DeSaulnier",34,0,6,0,40
639648,378160,2014-08-21,Assembly,"AB 2752 TRANS.  Concurrence in Senate Amendments By LOWENTHAL",79,0,0,0,79
639652,361739,2014-05-01,Senate,"Senate 3rd Reading SJR20 Leno",28,3,9,0,40
639652,373274,2014-06-19,Assembly,"Be adopted, to Consent Calendar",8,0,0,3,11
639652,374940,2014-06-26,Assembly,"SJR 20 Leno  Consent Calendar Second Day  Regular Session",76,0,0,3,79
639652,376827,2014-08-07,Senate,"Unfinished Business SJR20 Leno Concurrence",28,4,8,0,40
640027,361145,2014-04-30,Assembly,"Do pass and re-refer to Committee on Appropriations with 	recommendation:  To Consent Calendar",7,0,0,0,7
640027,364686,2014-05-14,Assembly,"Do pass, to Consent Calendar",17,0,0,0,17
640027,366711,2014-05-23,Assembly,"AB 2753 H.& C.D.  Consent Calendar Second Day  Regular Session",73,0,0,6,79
640027,374106,2014-06-24,Senate,"Do pass, but re-refer to the Committee on Appropriations Recommend 	Consent",11,0,0,0,11
640027,376742,2014-08-07,Senate,"Consent Calendar 2nd AB2753 Committee on H. & C.D.(Chau)",34,0,6,0,40
640027,376906,2014-08-11,Assembly,"AB 2753 H.& C.D.  Concurrence in Senate Amendments By CHAU",79,0,0,0,79
640028,359905,2014-04-24,Senate,"Do pass, but re-refer to the Committee on Appropriations Recommend 	Consent",8,0,1,0,9
640028,363404,2014-05-08,Senate,"Consent Calendar 2nd SB1465 Committee on Health (Hernandez)",35,0,5,0,40
640028,372329,2014-06-17,Assembly,"Do pass and re-refer to Committee on Appropriations with 	recommendation:  To Consent Calendar",17,0,0,2,19
640028,377129,2014-08-14,Assembly,"Do pass",17,0,0,0,17
640028,377760,2014-08-19,Assembly,"SB 1465 HEALTH  Third Reading Urgency  By BONTA",78,0,0,1,79
640028,377917,2014-08-20,Senate,"From committee:  That the Assembly Amendments be concurred in",9,0,0,0,9
640028,378101,2014-08-21,Senate,"Unfinished Business SB1465 Committee on Health (Hernandez) 	Concurrence",34,0,6,0,40
640468,360766,2014-04-29,Assembly,"Do pass and re-refer to Committee on Appropriations with 	recommendation:  To Consent Calendar",14,0,0,1,15
640468,364634,2014-05-14,Assembly,"Do pass, to Consent Calendar",17,0,0,0,17
640468,366967,2014-05-23,Assembly,"AB 2759 W., P.& W.  Consent Calendar Second Day  Regular Session",73,0,0,6,79
640468,370573,2014-06-10,Senate,"Do pass, but re-refer to the Committee on Judiciary Recommend 	Consent",9,0,0,0,9
640468,374708,2014-06-24,Senate,"Do pass, but re-refer to the Committee on Appropriations Recommend 	Consent",7,0,0,0,7
640468,376790,2014-08-07,Senate,"Consent Calendar 2nd AB2759 Committee on W.,P. & W. (Rendon)",34,0,6,0,40
640471,360474,2014-04-28,Assembly,"Do pass and be re-referred to the Committee on Appropriations",6,2,0,1,9
640471,367182,2014-05-23,Assembly,"Do pass as amended",12,5,0,0,17
640471,368718,2014-05-29,Assembly,"AB 2754 REV.& TAX.  Assembly Third Reading  By BOCANEGRA",55,20,0,4,79
640471,374585,2014-06-25,Senate,"Do pass, but re-refer to the Committee on Appropriations",4,2,1,0,7
640471,378452,2014-08-26,Senate,"Assembly 3rd Reading AB2754 Committee on REV. & TAX. (Bocaneg By 	Wolk",24,12,4,0,40
640471,378945,2014-08-28,Assembly,"AB 2754 REV.& TAX.  Concurrence in Senate Amendments By BOCANEGRA",54,24,0,1,79
640472,360598,2014-04-28,Assembly,"Do pass",12,0,0,3,15
640472,363378,2014-05-08,Assembly,"AB 2761 U.& C.  Assembly Third Reading  By BRADFORD",75,0,0,4,79
640472,372391,2014-06-17,Senate,"Do pass",10,0,1,0,11
640472,376746,2014-08-07,Senate,"Assembly 3rd Reading AB2761 Committee on U. & C. (Bradford) By Hill",34,0,6,0,40
640472,376891,2014-08-11,Assembly,"AB 2761 U.& C.  Concurrence in Senate Amendments By BRADFORD",79,0,0,0,79
640476,360560,2014-04-28,Assembly,"Do pass",11,0,0,4,15
640476,363488,2014-05-08,Assembly,"AB 2760 U.& C.  Assembly Third Reading  By BRADFORD",73,0,0,6,79
640476,374096,2014-06-23,Senate,"Do pass",10,0,1,0,11
640476,377012,2014-08-11,Senate,"Assembly 3rd Reading AB2760 Committee on U. & C. (Bradford) By Hill",36,0,4,0,40
640478,361768,2014-04-30,Assembly,"Do pass and be re-referred to the Committee on Appropriations to 	Consent Calendar",9,0,0,0,9
640478,364393,2014-05-14,Assembly,"Do pass, to Consent Calendar",17,0,0,0,17
640478,366742,2014-05-23,Assembly,"AB 2762 L. GOV.  Consent Calendar Second Day  Regular Session",73,0,0,6,79
640478,370972,2014-06-11,Senate,"Do pass, but re-refer to the Committee on Appropriations Recommend 	Consent",7,0,0,0,7
640478,374828,2014-06-26,Senate,"Consent Calendar 2nd AB2762 Committee on L. GOV. (Achadjian)",32,0,8,0,40
640480,352717,2014-04-07,Senate,"Senate 3rd Reading SJR21 De Le",35,0,5,0,40
640480,361540,2014-05-01,Assembly,"Be adopted, to Consent Calendar",10,0,0,1,11
640480,363349,2014-05-08,Assembly,"SJR 21 De Leon  Consent Calendar Second Day  Regular Session",73,0,0,6,79
640485,362715,2014-05-06,Assembly,"From committee:  Be adopted.  To third reading",9,0,0,1,10
640485,370102,2014-06-05,Assembly,"AJR 42 WILLIAMS  Assembly Third Reading",62,0,0,17,79
640485,374598,2014-06-24,Senate,"Be adopted",7,0,0,0,7
640485,376347,2014-08-04,Senate,"Assembly 3rd Reading AJR42 Williams By Monning",36,0,4,0,40
640487,360464,2014-04-28,Assembly,"Do pass and re-refer to Committee on Appropriations with 	recommendation:  To Consent Calendar",9,0,0,0,9
640487,364729,2014-05-14,Assembly,"Do pass, to Consent Calendar",17,0,0,0,17
640487,366775,2014-05-23,Assembly,"AB 2758 REV.& TAX.  Consent Calendar Second Day  Regular Session",73,0,0,6,79
640487,374401,2014-06-25,Senate,"Do pass, but re-refer to the Committee on Appropriations Recommend 	Consent",6,0,1,0,7
640487,378447,2014-08-26,Senate,"Assembly 3rd Reading AB2758 Committee on REV. & TAX. (Bocaneg By 	Wolk",34,0,6,0,40
640487,378796,2014-08-27,Assembly,"AB 2758 REV.& TAX.  Concurrence in Senate Amendments By BOCANEGRA",78,0,0,1,79
640491,363575,2014-05-08,Assembly,"Do pass as amended",7,1,0,4,12
640491,365305,2014-05-19,Assembly,"AB 2755 BOCANEGRA  Assembly Third Reading",62,7,0,10,79
640491,372583,2014-06-17,Senate,"Do pass",6,0,1,0,7
640491,378988,2014-08-28,Senate,"Assembly 3rd Reading AB2755 Bocanegra By Padilla",34,0,6,0,40
640493,352726,2014-04-07,Senate,"Senate 3rd Reading SCR101 Gaines",36,0,4,0,40
640493,376741,2014-08-07,Assembly,"Be adopted, to Consent Calendar",7,0,0,4,11
640493,377430,2014-08-14,Assembly,"SCR 101 Gaines  Consent Calendar Second Day  Regular Session",78,0,0,1,79
640493,377609,2014-08-18,Senate,"Unfinished Business SCR101 Gaines Concurrence",33,0,7,0,40
640494,360641,2014-04-28,Assembly,"Do pass and be re-referred to the Committee on Appropriations",9,0,0,0,9
640494,367179,2014-05-23,Assembly,"Do pass",17,0,0,0,17
640494,367601,2014-05-27,Assembly,"AB 2757 REV.& TAX.  Assembly Third Reading  By BOCANEGRA",76,0,0,3,79
640494,372141,2014-06-17,Senate,"Do pass, but re-refer to the Committee on Appropriations Recommend 	Consent",11,0,0,0,11
640498,352736,2014-04-07,Senate,"Senate 3rd Reading SJR22 Block",31,0,9,0,40
640498,370614,2014-06-10,Assembly,"From committee:  Be adopted.  To third reading",11,0,0,3,14
640498,373344,2014-06-19,Assembly,"SJR 22 Block  Senate Third Reading  By MAIENSCHEIN",69,1,0,9,79
640501,360468,2014-04-28,Assembly,"Do pass and be re-referred to the Committee on Appropriations",6,0,0,3,9
640501,367017,2014-05-23,Assembly,"Do pass as amended",12,0,0,5,17
640501,368171,2014-05-28,Assembly,"AB 2756 REV.& TAX.  Assembly Third Reading  By BOCANEGRA",60,10,0,9,79
640501,374468,2014-06-25,Senate,"Do pass, but re-refer to the Committee on Appropriations",5,1,1,0,7
640501,376448,2014-08-04,Senate,"Placed on Appropriations Suspense file",7,0,0,0,7
640501,377452,2014-08-14,Senate,"Do pass",6,0,1,0,7
640501,378314,2014-08-25,Senate,"Assembly 3rd Reading AB2756 Committee on REV. & TAX. (Bocaneg By 	Wolk",34,1,5,0,40
640501,378783,2014-08-27,Assembly,"AB 2756 REV.& TAX.  Concurrence in Senate Amendments By BOCANEGRA",62,14,0,3,79
640954,360371,2014-04-28,Assembly,"From committee:  Be adopted.  To third reading",9,0,0,2,11
640954,367093,2014-05-23,Senate,"Special Consent #15 ACR123 Harkey By Beall",32,0,8,0,40
640964,360051,2014-04-28,Senate,"Do pass as amended, but re-refer to the Committee on 	Appropriations Recommend Consent",9,0,0,0,9
640964,364914,2014-05-15,Senate,"Consent Calendar 2nd SB1467 Committee on B.P. & E.D. (Lieu)",36,0,4,0,40
640964,374046,2014-06-24,Assembly,"Do pass and be re-referred to the Committee on Appropriations",13,0,0,1,14
640964,376706,2014-08-06,Assembly,"Do pass",16,1,0,0,17
640964,377974,2014-08-20,Assembly,"SB 1467 B. P.& E.D.  Senate Third Reading  By BONILLA",75,1,0,3,79
640964,378205,2014-08-22,Senate,"Unfinished Business SB1467 Committee on B.P. & E.D. (Lieu) 	Concurrence",31,0,9,0,40
640974,360034,2014-04-28,Senate,"Do pass, but re-refer to the Committee on Appropriations Recommend 	Consent",9,0,0,0,9
640974,364962,2014-05-15,Senate,"Consent Calendar 2nd SB1466 Committee on B.P. & E.D. (Lieu)",36,0,4,0,40
640974,374142,2014-06-24,Assembly,"Do pass as amended and be re-referred to the Committee on 	Appropriations",13,0,0,1,14
640974,376709,2014-08-06,Assembly,"Do pass",16,1,0,0,17
640974,377970,2014-08-20,Assembly,"SB 1466 B. P.& E.D.  Senate Third Reading  By BONILLA",75,1,0,3,79
640974,378020,2014-08-21,Senate,"Unfinished Business SB1466 Committee on B.P. & E.D. (Lieu) 	Concurrence",35,0,5,0,40
641379,352719,2014-04-07,Assembly,"From committee:  Be adopted.  To third reading",11,0,0,0,11
641379,367039,2014-05-23,Senate,"Special Consent #15 ACR124 Wieckowski",32,0,8,0,40
641397,361455,2014-04-30,Assembly,"Do pass and be re-referred to the Committee on Appropriations",13,0,0,0,13
641397,364521,2014-05-14,Assembly,"Do pass, to Consent Calendar",17,0,0,0,17
641397,367028,2014-05-23,Assembly,"AB 2763A& A.R.  Consent Calendar Second Day  Regular Session",73,0,0,6,79
641397,374188,2014-06-24,Senate,"Do pass, but re-refer to the Committee on Appropriations Recommend 	Consent",10,0,0,0,10
641397,378727,2014-08-27,Senate,"Assembly 3rd Reading AB2763 Committee on ACC. & ADM. REV. (Fr By 	Correa",36,0,4,0,40
641397,378932,2014-08-28,Assembly,"AB 2763A& A.R.  Concurrence in Senate Amendments By FRAZIER",78,0,0,1,79
641700,360661,2014-04-28,Assembly,"Do pass and re-refer to Committee on Appropriations with 	recommendation:  To Consent Calendar",8,0,0,1,9
641700,362968,2014-05-07,Assembly,"Do pass, to Consent Calendar",17,0,0,0,17
641700,364889,2014-05-15,Assembly,"AB 2764 NAT. RES.  Consent Calendar Second Day  Regular Session",78,0,0,1,79
641700,370446,2014-06-10,Senate,"Do pass as amended, and re-refer to the Committee on Environmental 	Quality",8,0,1,0,9
641700,374582,2014-06-25,Senate,"Do pass as amended, and re-refer to the Committee on 	Appropriations",5,1,1,0,7
641700,376609,2014-08-04,Senate,"Placed on Appropriations Suspense file",7,0,0,0,7
641700,377309,2014-08-14,Senate,"Do pass as amended",5,0,2,0,7
641700,378821,2014-08-27,Senate,"Assembly 3rd Reading AB2764 Committee on NAT. RES. (Chesbro) By 	Pavley",35,0,5,0,40
641700,378969,2014-08-28,Assembly,"AB 2764 NAT. RES.  Concurrence in Senate Amendments By CHESBRO",79,0,0,0,79
641721,375216,2014-06-30,Assembly,"From committee:  Be adopted.  To third reading",11,0,0,0,11
641761,357967,2014-04-21,Senate,"Senate 3rd Reading SCR103 De Le",33,0,7,0,40
641761,370769,2014-06-10,Assembly,"Be adopted as amended",8,0,0,1,9
641761,376844,2014-08-07,Senate,"Unfinished Business SCR103 De Le",34,0,6,0,40
642037,362737,2014-05-06,Senate,"Be adopted, but re-refer to the Committee on Appropriations",4,1,0,0,5
642037,365350,2014-05-19,Senate,"Placed on Appropriations Suspense file",7,0,0,0,7
642037,366479,2014-05-14,Senate,"Be adopted, but re-refer to the Committee on Appropriations",4,0,1,0,5
642037,366672,2014-05-23,Senate,"Be adopted",7,0,0,0,7
642037,367505,2014-05-27,Senate,"Senate 3rd Reading SCA17 Steinberg Lay on Table",22,12,6,0,40
642037,367506,2014-05-27,Senate,"Senate 3rd Reading SCA17 Steinberg",31,3,6,0,40
642037,375401,2014-06-30,Assembly,"From committee:  Be adopted.  To third reading",11,0,0,0,11
642037,376734,2014-08-06,Assembly,"Be adopted",17,0,0,0,17
642037,377964,2014-08-20,Assembly,"SCA 17 Steinberg  Senate Third Reading  By ATKINS",73,2,0,4,79
642038,363221,2014-05-07,Assembly,"Do pass, to Consent Calendar",18,0,0,1,19
642038,364848,2014-05-15,Assembly,"AB 2765 G.O.  Consent Calendar Second Day  Regular Session",78,0,0,1,79
642038,370611,2014-06-10,Senate,"Do pass, but re-refer to the Committee on Appropriations Recommend 	Consent",8,0,2,0,10
642038,378286,2014-08-25,Senate,"Assembly 3rd Reading AB2765 Committee on G.O. (Hall) By Vidak",35,0,5,0,40
642038,378938,2014-08-28,Assembly,"AB 2765 G.O.  Concurrence in Senate Amendments By HALL",77,0,0,2,79
642039,352678,2014-04-07,Assembly,"From committee:  Be adopted.  To third reading",11,0,0,0,11
642039,359601,2014-04-24,Senate,"Special Consent #12 ACR125 John A. P",37,0,3,0,40
642040,348873,2014-03-28,Senate,"W/O REF. TO FILE SR38 By Steinberg",28,1,10,0,39
643103,363467,2014-05-08,Assembly,"Be adopted, to Consent Calendar",10,0,0,1,11
643103,364870,2014-05-15,Assembly,"ACR 127 BONTA  Consent Calendar Second Day  Regular Session",78,0,0,1,79
643103,370057,2014-06-05,Senate,"Special Consent #16 ACR127 Bonta",33,0,7,0,40
643112,373820,2014-06-23,Senate,"Senate 3rd Reading SCR106 Fuller",35,0,5,0,40
643112,378190,2014-08-21,Assembly,"Be adopted, to Consent Calendar",10,0,0,1,11
643112,378420,2014-08-25,Assembly,"SCR 106 Fuller  Consent Calendar Second Day  Regular Session",79,0,0,0,79
643120,357930,2014-04-21,Senate,"Senate 3rd Reading SCR105 Lieu",35,0,5,0,40
643120,375375,2014-06-30,Assembly,"Be adopted, to Consent Calendar",11,0,0,0,11
643120,375707,2014-07-03,Assembly,"SCR 105 Lieu  Consent Calendar Second Day  Regular Session",76,0,0,3,79
643129,370338,2014-06-09,Assembly,"From committee:  Be adopted.  To third reading",10,0,0,1,11
643129,375687,2014-07-03,Senate,"Special Consent #18 ACR126 Atkins",35,0,5,0,40
643138,355064,2014-04-10,Assembly,"From committee:  Be adopted.  To third reading",7,0,0,4,11
643138,367054,2014-05-23,Senate,"Special Consent #15 ACR129 Brown",32,0,8,0,40
643146,366756,2014-05-23,Senate,"Senate 3rd Reading SCR104 Huff",32,0,8,0,40
643146,374936,2014-06-26,Assembly,"From committee:  Be adopted.  To third reading",9,0,0,2,11
643146,377798,2014-08-19,Senate,"Unfinished Business SCR104 Huff",33,0,7,0,40
643153,363088,2014-05-07,Assembly,"Be adopted, as amended, to Consent Calendar",7,0,0,0,7
643153,365393,2014-05-19,Assembly,"ACR 128 TING  Consent Calendar Second Day",76,0,0,3,79
643153,370066,2014-06-05,Senate,"Special Consent #16 ACR128 Ting",33,0,7,0,40
643153,370192,2014-06-09,Assembly,"ACR 128 TING  Concurrence in Senate Amendments",75,0,0,4,79
643453,362675,2014-05-06,Assembly,"Do pass",4,0,0,3,7
643453,364924,2014-05-15,Assembly,"AB 2766 E.& R.  Assembly Third Reading  By FONG",54,22,0,3,79
643453,372402,2014-06-17,Senate,"Do pass",4,0,1,0,5
643453,377018,2014-08-11,Senate,"Assembly 3rd Reading AB2766 Committee on E. & R. (Fong) By Padilla",23,12,5,0,40
643463,363331,2014-05-08,Senate,"Senate 3rd Reading SCR107 Hueso",33,0,7,0,40
643463,369460,2014-06-02,Assembly,"From committee:  Be adopted.  To third reading",11,0,0,0,11
643463,371373,2014-06-12,Senate,"Unfinished Business SCR107 Hueso Concurrence",33,0,7,0,40
643475,364961,2014-05-15,Assembly,"From committee:  Be adopted.  To third reading",10,0,0,1,11
643475,374877,2014-06-26,Senate,"Special Consent #17 ACR130 Rendon",32,0,8,0,40
643485,362309,2014-05-05,Assembly,"From committee:  Be adopted.  To third reading",10,0,0,1,11
643485,370083,2014-06-05,Senate,"Special Consent #16 ACR131 Nazarian",33,0,7,0,40
644069,358465,2014-04-21,Assembly,"Be adopted, to Consent Calendar",9,0,0,2,11
644069,359586,2014-04-24,Assembly,"ACR 132 EGGMAN  Consent Calendar Second Day  Regular Session",75,0,0,4,79
644069,367121,2014-05-23,Senate,"Special Consent #15 ACR132 Eggman",32,0,8,0,40
644326,360679,2014-04-29,Senate,"Be adopted as amended, and re-refer to the Committee on 	Appropriations",10,0,1,0,11
644326,367623,2014-05-27,Senate,"Senate 3rd Reading SCR108 Evans",34,0,6,0,40
644326,370194,2014-06-09,Assembly,"Be adopted, to Consent Calendar",14,0,0,1,15
644326,371428,2014-06-12,Assembly,"SCR 108 Evans  Consent Calendar Second Day  Regular Session",76,0,0,3,79
644550,372307,2014-06-17,Assembly,"Be adopted, to Consent Calendar",15,0,0,0,15
644550,373307,2014-06-19,Assembly,"AJR 43 CHESBRO  Consent Calendar Second Day  Regular Session",77,0,0,2,79
644550,376972,2014-08-11,Senate,"Assembly 3rd Reading AJR43 Chesbro By Monning",36,0,4,0,40
644559,355071,2014-04-10,Senate,"W/O REF. TO FILE SR39 Steinberg",34,0,6,0,40
644568,360037,2014-04-28,Assembly,"From committee:  Be adopted.  To third reading",9,0,0,2,11
644568,370100,2014-06-05,Senate,"Special Consent #16 ACR133 Bonta",33,0,7,0,40
644577,360131,2014-04-28,Senate,"Senate 3rd Reading SCR109 Lara",30,0,10,0,40
644577,376782,2014-08-07,Assembly,"Be adopted, to Consent Calendar",7,0,0,4,11
644577,377259,2014-08-14,Assembly,"SCR 109 Lara  Consent Calendar Second Day  Regular Session",78,0,0,1,79
644834,370053,2014-06-05,Senate,"Senate 3rd Reading SJR23 Huff",32,0,8,0,40
644834,377020,2014-08-12,Assembly,"Be adopted as amended",9,0,0,1,10
644834,377818,2014-08-19,Assembly,"SJR 23 Huff  Senate Third Reading  By CONWAY",78,0,0,1,79
644834,378060,2014-08-21,Senate,"Unfinished Business SJR23 Huff Concurrence",31,0,9,0,40
644842,362987,2014-05-06,Senate,"Be adopted",6,1,0,0,7
644842,363327,2014-05-08,Senate,"Senate 3rd Reading SR40 Correa",27,3,10,0,40
644851,360462,2014-04-28,Assembly,"Be adopted, and re-refer to Committee on Appropriations with 	recommendation:  To Consent Calendar",15,0,0,1,16
644851,362980,2014-05-07,Assembly,"Be adopted, to Consent Calendar",17,0,0,0,17
644851,364888,2014-05-15,Assembly,"ACR 134 LINDER  Consent Calendar Second Day  Regular Session",78,0,0,1,79
644851,370522,2014-06-10,Senate,"Be adopted, but re-refer to the Committee on Appropriations 	Recommend Consent",10,0,1,0,11
644851,374849,2014-06-26,Senate,"Consent Calendar 2nd ACR134 Linder",32,0,8,0,40
644860,360169,2014-04-28,Senate,"Senate 3rd Reading SCR111 Correa",33,0,7,0,40
644870,362575,2014-05-06,Assembly,"Be adopted",7,0,0,0,7
644870,365428,2014-05-19,Assembly,"AJR 45 SKINNER  Assembly Third Reading",76,0,0,3,79
644870,370071,2014-06-05,Senate,"Special Consent #16 AJR45 Skinner",33,0,7,0,40
644879,360559,2014-04-28,Assembly,"Be adopted, and re-refer to Committee on Appropriations with 	recommendation:  To Consent Calendar",15,0,0,1,16
644879,363032,2014-05-07,Assembly,"Be adopted, to Consent Calendar",17,0,0,0,17
644879,364898,2014-05-15,Assembly,"ACR 135 PATTERSON  Consent Calendar Second Day  Regular Session",78,0,0,1,79
644879,370615,2014-06-10,Senate,"Be adopted, but re-refer to the Committee on Appropriations 	Recommend Consent",10,0,1,0,11
644879,374885,2014-06-26,Senate,"Consent Calendar 2nd ACR135 Patterson",32,0,8,0,40
644888,370451,2014-06-10,Assembly,"From committee:  Be adopted.  To third reading",5,0,0,2,7
644888,376356,2014-08-04,Assembly,"HR 37 WIECKOWSKI  Assembly Third Reading",54,22,0,3,79
644898,372540,2014-06-17,Assembly,"From committee:  Be adopted.  To third reading",8,0,0,2,10
644898,373324,2014-06-19,Assembly,"AJR 44 BLOOM  Assembly Third Reading",59,0,0,20,79
644898,377034,2014-08-12,Senate,"Be adopted",7,0,0,0,7
644898,377918,2014-08-20,Senate,"Assembly 3rd Reading AJR44 Bloom By Lieu",34,0,6,0,40
644907,360052,2014-04-28,Senate,"Senate 3rd Reading SCR110 Hernandez",34,0,6,0,40
644907,365372,2014-05-19,Assembly,"From committee:  Be adopted.  To third reading",9,0,0,2,11
644907,373474,2014-06-19,Assembly,"SCR 110 Hernandez  Senate Third Reading  By QUIRK-SILVA",78,0,0,1,79
644907,373799,2014-06-23,Senate,"Unfinished Business SCR110 Hernandez Concurrence",31,0,9,0,40
645729,370436,2014-06-10,Senate,"Be adopted, but re-refer to the Committee on Appropriations 	Recommend Consent",10,0,1,0,11
645729,374785,2014-06-26,Senate,"Consent Calendar 2nd SCR115 Lara",32,0,8,0,40
645729,377822,2014-08-18,Assembly,"Be adopted, and re-refer to Committee on Appropriations with 	recommendation:  To Consent Calendar",16,0,0,0,16
645729,377823,2014-08-19,Assembly,"Be adopted, to Consent Calendar",13,0,0,4,17
645729,378111,2014-08-21,Assembly,"SCR 115 Lara  Consent Calendar Second Day  Regular Session",77,0,0,2,79
645730,360161,2014-04-28,Senate,"Senate 3rd Reading SCR112 Berryhill",34,0,6,0,40
645731,361588,2014-05-01,Senate,"Senate 3rd Reading SJR24 DeSaulnier",36,0,4,0,40
645731,370168,2014-06-09,Assembly,"Be adopted, to Consent Calendar",16,0,0,0,16
645731,371322,2014-06-12,Assembly,"SJR 24 DeSaulnier  Consent Calendar Second Day  Regular Session",76,0,0,3,79
645732,362577,2014-05-06,Senate,"Be adopted, but re-refer to the Committee on Appropriations 	Recommend Consent",11,0,0,0,11
645732,366806,2014-05-23,Senate,"Consent Calendar 2nd SCR114 Gaines",32,0,8,0,40
645732,371695,2014-06-16,Assembly,"Be adopted, and re-refer to Committee on Appropriations with 	recommendation:  To Consent Calendar",15,0,0,1,16
645732,375603,2014-07-02,Assembly,"Be adopted, to Consent Calendar",17,0,0,0,17
645732,376383,2014-08-04,Assembly,"SCR 114 Gaines  Consent Calendar Second Day  Regular Session",78,0,0,1,79
645734,359549,2014-04-24,Assembly,"From committee:  Be adopted.  To third reading",10,0,0,1,11
645734,360063,2014-04-28,Assembly,"HR 38 QUIRK-SILVA  Assembly Third Reading",78,0,0,1,79
645735,362457,2014-05-05,Assembly,"From committee:  Be adopted.  To third reading",10,0,0,1,11
645735,363353,2014-05-08,Assembly,"HR 39 TING  Assembly Third Reading",72,0,0,7,79
645736,362592,2014-05-06,Senate,"Be adopted, but re-refer to the Committee on Appropriations 	Recommend Consent",11,0,0,0,11
645736,366690,2014-05-23,Senate,"Consent Calendar 2nd SCR113 Evans",32,0,8,0,40
645736,373767,2014-06-23,Assembly,"Be adopted, and re-refer to Committee on Appropriations with 	recommendation:  To Consent Calendar",13,0,0,3,16
645736,375595,2014-07-02,Assembly,"Be adopted, to Consent Calendar",17,0,0,0,17
645736,376375,2014-08-04,Assembly,"SCR 113 Evans  Consent Calendar Second Day  Regular Session",78,0,0,1,79
645736,376893,2014-08-11,Senate,"Unfinished Business SCR113 Evans Concurrence",36,0,4,0,40
645737,361778,2014-05-01,Assembly,"From committee:  Be adopted.  To third reading",10,0,0,1,11
645737,370051,2014-06-05,Senate,"Special Consent #16 ACR138 Achadjian",33,0,7,0,40
645738,359628,2014-04-24,Assembly,"From committee:  Be adopted.  To third reading",10,0,0,1,11
645738,367097,2014-05-23,Senate,"Special Consent #15 ACR136 Eggman",32,0,8,0,40
645807,359634,2014-04-24,Assembly,"From committee:  Be adopted.  To third reading",10,0,0,1,11
645807,367067,2014-05-23,Senate,"Special Consent #15 ACR139 Ridley-Thomas",32,0,8,0,40
645808,377578,2014-08-14,Assembly,"From committee:  Be adopted.  To third reading",8,0,0,3,11
645975,363426,2014-05-08,Assembly,"From committee:  Be adopted.  To third reading",10,0,0,1,11
645975,364476,2014-05-14,Assembly,"From committee:  Be adopted.  To third reading",17,0,0,0,17
645975,364946,2014-05-15,Assembly,"ACR 140 WEBER  Assembly Third Reading",78,0,0,1,79
645975,372691,2014-06-18,Senate,"Be adopted, but re-refer to the Committee on Appropriations 	Recommend Consent",7,0,0,0,7
645975,375260,2014-06-30,Senate,"Placed on Appropriations Suspense file",6,0,1,0,7
645975,378358,2014-08-25,Senate,"Assembly 3rd Reading ACR140 Weber By Mitchell",33,0,7,0,40
646027,364369,2014-05-14,Assembly,"Be adopted",9,0,0,0,9
646027,364829,2014-05-15,Assembly,"ACA1 PEREZ, J.  Assembly Third Reading  Second Extraordinary Session",78,0,0,1,79
646027,364830,2014-05-15,Senate,"W/O REF. TO FILE ACA1 John A. P",36,0,4,0,40
646199,362232,2014-05-05,Senate,"W/O REF. TO FILE SCR116 Correa",37,0,3,0,40
646214,362307,2014-05-05,Senate,"Senate 3rd Reading SCR117 Liu",37,0,3,0,40
646214,367026,2014-05-23,Assembly,"From committee:  Be adopted.  To third reading",10,0,0,1,11
647076,364842,2014-05-15,Assembly,"From committee:  Be adopted.  To third reading",10,0,0,1,11
647076,374841,2014-06-26,Senate,"Special Consent #17 ACR141 Holden",32,0,8,0,40
647302,367605,2014-05-27,Assembly,"Be adopted, to Consent Calendar",9,0,0,2,11
647302,368738,2014-05-29,Assembly,"ACR 144 OLSEN  Consent Calendar Second Day",78,0,0,1,79
647302,374935,2014-06-26,Senate,"Special Consent #17 ACR144 Olsen",32,0,8,0,40
647303,370163,2014-06-09,Assembly,"Be adopted, to Consent Calendar",8,0,0,3,11
647303,371358,2014-06-12,Assembly,"ACR 143 BIGELOW  Consent Calendar Second Day",76,0,0,3,79
647303,375688,2014-07-03,Senate,"Special Consent #18 ACR143 Bigelow",35,0,5,0,40
647304,375367,2014-06-30,Senate,"Senate 3rd Reading SCR118 Anderson",34,0,6,0,40
647304,376748,2014-08-07,Assembly,"Be adopted, to Consent Calendar",7,0,0,4,11
647304,377348,2014-08-14,Assembly,"SCR 118 Anderson  Consent Calendar Second Day  Regular Session",78,0,0,1,79
647305,370283,2014-06-09,Assembly,"Be adopted, and re-refer to Committee on Appropriations with 	recommendation:  To Consent Calendar",16,0,0,0,16
647305,372677,2014-06-18,Assembly,"Be adopted, to Consent Calendar",15,0,0,2,17
647305,373796,2014-06-23,Assembly,"ACR 145 ACHADJIAN  Consent Calendar Second Day",75,0,0,4,79
647305,376455,2014-08-05,Senate,"Be adopted, but re-refer to the Committee on Appropriations",10,0,1,0,11
647305,377896,2014-08-20,Senate,"Assembly 3rd Reading ACR145 Achadjian By Monning",34,0,6,0,40
647541,365337,2014-05-19,Senate,"Senate 3rd Reading SJR25 Vidak",33,0,7,0,40
647542,376968,2014-08-11,Assembly,"From committee:  Be adopted.  To third reading",10,0,0,1,11
647542,378637,2014-08-27,Senate,"Special Consent #19 ACR147 Dickinson",36,0,4,0,40
647543,363763,2014-05-12,Assembly,"From committee:  Be adopted.  To third reading",9,0,0,2,11
647543,370052,2014-06-05,Senate,"Special Consent #16 ACR146 Bloom",33,0,7,0,40
647826,370442,2014-06-10,Assembly,"Be adopted, to Consent Calendar",17,0,0,2,19
647826,371749,2014-06-16,Assembly,"ACR 148 LOWENTHAL  Consent Calendar Second Day",77,0,0,2,79
647826,375632,2014-07-03,Senate,"Special Consent #18 ACR148 Lowenthal",35,0,5,0,40
647836,370981,2014-06-11,Senate,"Be adopted",2,5,0,0,7
647836,370982,2014-06-11,Senate,"Set, first hearing.  Failed passage in Committee.  Reconsideration 	granted",7,0,0,0,7
648412,370546,2014-06-10,Senate,"Be adopted, but re-refer to the Committee on Appropriations 	Recommend Consent",10,0,1,0,11
648412,374745,2014-06-26,Senate,"Consent Calendar 2nd SCR119 Fuller",32,0,8,0,40
648412,377754,2014-08-18,Assembly,"Be adopted, and re-refer to Committee on Appropriations with 	recommendation:  To Consent Calendar",16,0,0,0,16
648412,377755,2014-08-19,Assembly,"Be adopted, to Consent Calendar",13,0,0,4,17
648412,378007,2014-08-21,Assembly,"SCR 119 Fuller  Consent Calendar Second Day  Regular Session",77,0,0,2,79
648627,370173,2014-06-09,Assembly,"From committee:  Be adopted.  To third reading",10,0,0,1,11
648627,375670,2014-07-03,Senate,"Special Consent #18 ACR150 Bocanegra",35,0,5,0,40
648629,365359,2014-05-19,Senate,"Senate 3rd Reading SR42 Corbett",34,0,6,0,40
648631,375718,2014-07-03,Assembly,"From committee:  Be adopted.  To third reading",11,0,0,0,11
648631,377629,2014-08-18,Senate,"Assembly 3rd Reading ACR149 Weber By Lara",35,0,5,0,40
648856,367476,2014-05-27,Senate,"Senate 3rd Reading SCR120 De Le",34,0,6,0,40
648856,370084,2014-06-05,Assembly,"Be adopted, to Consent Calendar",10,0,0,1,11
648856,371702,2014-06-16,Senate,"Unfinished Business SCR120 De Le",36,0,4,0,40
648860,366508,2014-05-21,Senate,"Be adopted",4,0,1,0,5
648860,370183,2014-06-09,Senate,"Senate 3rd Reading SR45 Steinberg",35,1,4,0,40
648863,366509,2014-05-21,Senate,"Be adopted",4,0,1,0,5
648863,370245,2014-06-09,Senate,"Senate 3rd Reading SR43 Steinberg",35,1,4,0,40
648867,366512,2014-05-21,Senate,"Be adopted",4,0,1,0,5
648867,370213,2014-06-09,Senate,"Senate 3rd Reading SR44 De Le",34,1,5,0,40
649360,367607,2014-05-27,Senate,"Senate 3rd Reading SR46 Beall",34,0,6,0,40
649665,367512,2014-05-27,Assembly,"From committee:  Be adopted.  To third reading",9,0,0,2,11
649665,375703,2014-07-03,Senate,"Special Consent #18 ACR151 Wilk",35,0,5,0,40
649668,367990,2014-05-28,Assembly,"From committee:  Be adopted.  To third reading",11,0,0,2,13
649670,368710,2014-05-29,Senate,"Senate 3rd Reading SR47 Leno",32,0,8,0,40
649672,370160,2014-06-09,Senate,"Senate 3rd Reading SCR121 Block",34,0,6,0,40
649672,374797,2014-06-24,Assembly,"Be adopted as amended",8,0,0,1,9
649672,376984,2014-08-11,Senate,"Unfinished Business SCR121 Block Concurrence",35,0,5,0,40
649968,370095,2014-06-05,Senate,"Senate 3rd Reading SCR122 De Le",32,0,8,0,40
649968,377024,2014-08-12,Assembly,"From committee:  Be adopted.  To third reading",9,0,0,1,10
649968,378136,2014-08-21,Senate,"Unfinished Business SCR122 De Le",36,0,4,0,40
649969,371824,2014-06-16,Assembly,"Be adopted, to Consent Calendar",10,0,0,1,11
649969,373120,2014-06-19,Assembly,"HR 42 FRAZIER  Consent Calendar Second Day",77,0,0,2,79
650155,366887,2014-05-23,Senate,"Senate 3rd Reading SR48 Steinberg",32,0,8,0,40
650161,370162,2014-06-09,Senate,"Senate 3rd Reading SCR123 Wyland",34,0,6,0,40
650161,373160,2014-06-19,Assembly,"Be adopted, to Consent Calendar",11,0,0,0,11
650161,374884,2014-06-26,Assembly,"SCR 123 Wyland  Consent Calendar Second Day  Regular Session",76,0,0,3,79
650357,370704,2014-06-10,Assembly,"From committee:  Be adopted.  To third reading",15,2,0,2,19
650357,377434,2014-08-14,Senate,"Assembly 3rd Reading ACR152 Pan By Monning",24,6,10,0,40
650549,373420,2014-06-19,Senate,"Senate 3rd Reading SCR124 Corbett",35,0,5,0,40
650549,375701,2014-07-03,Assembly,"Be adopted, to Consent Calendar",11,0,0,0,11
650549,376852,2014-08-07,Assembly,"SCR 124 Corbett  Consent Calendar Second Day  Regular Session",77,0,0,2,79
650552,370110,2014-06-05,Assembly,"From committee:  Be adopted.  To third reading",8,0,0,3,11
650552,374183,2014-06-24,Senate,"Do pass",4,1,2,0,7
650552,376364,2014-08-04,Senate,"Assembly 3rd Reading ACR153 Dickinson By Hueso",26,1,13,0,40
650852,370903,2014-06-11,Assembly,"Be adopted, to Consent Calendar",6,0,0,1,7
650852,371705,2014-06-16,Assembly,"ACR 154 GRAY  Consent Calendar Second Day  Regular Session",77,0,0,2,79
650852,376760,2014-08-07,Senate,"Assembly 2nd Reading ACR154 Gray By Cannella",33,0,7,0,40
651086,372250,2014-06-17,Assembly,"From committee:  Be adopted.  To third reading",16,0,0,3,19
651086,377656,2014-08-18,Senate,"Assembly 3rd Reading ACR155 Bocanegra By Mitchell",34,0,6,0,40
651092,370188,2014-06-09,Senate,"Senate 3rd Reading SJR28 Monning",31,0,9,0,40
651092,374455,2014-06-25,Assembly,"From committee:  Be adopted.  To third reading",11,0,0,2,13
651092,375695,2014-07-03,Assembly,"SJR 28 Monning  Senate Third Reading  By COOLEY",69,1,0,9,79
651097,371786,2014-06-16,Senate,"Senate 3rd Reading SJR27 Padilla",36,0,4,0,40
651097,374762,2014-06-26,Assembly,"From committee:  Be adopted.  To third reading",14,0,0,2,16
651097,375639,2014-07-03,Assembly,"SJR 27 Padilla  Senate Third Reading",72,1,0,6,79
651097,376977,2014-08-11,Senate,"Unfinished Business SJR27 Padilla Concurrence",36,0,4,0,40
651271,370514,2014-06-10,Senate,"Be adopted, but re-refer to the Committee on Appropriations 	Recommend Consent",10,0,1,0,11
651271,374838,2014-06-26,Senate,"Consent Calendar 2nd SCR125 Corbett",32,0,8,0,40
651271,377838,2014-08-18,Assembly,"Be adopted, and re-refer to Committee on Appropriations with 	recommendation:  To Consent Calendar",16,0,0,0,16
651271,377839,2014-08-19,Assembly,"Be adopted, to Consent Calendar",13,0,0,4,17
651271,378082,2014-08-21,Assembly,"SCR 125 Corbett  Consent Calendar Second Day  Regular Session",77,0,0,2,79
651540,373104,2014-06-19,Assembly,"From committee:  Be adopted.  To third reading",8,0,0,3,11
651541,371770,2014-06-16,Assembly,"Be adopted, and re-refer to Committee on Appropriations with 	recommendation:  To Consent Calendar",15,0,0,1,16
651541,372534,2014-06-18,Assembly,"Be adopted, to Consent Calendar",15,0,0,2,17
651541,373801,2014-06-23,Assembly,"ACR 156 WEBER  Consent Calendar Second Day  Regular Session",75,0,0,4,79
651541,376418,2014-08-05,Senate,"Be adopted, but re-refer to the Committee on Appropriations 	Recommend Consent",10,0,1,0,11
651541,377243,2014-08-14,Senate,"Consent Calendar 2nd ACR156 Weber",33,0,7,0,40
651676,373707,2014-06-23,Senate,"Senate 3rd Reading SR49 Leno",22,3,15,0,40
651678,371751,2014-06-16,Senate,"Senate 3rd Reading SCR126 Fuller",35,0,5,0,40
651678,376825,2014-08-07,Assembly,"Be adopted, to Consent Calendar",7,0,0,4,11
651678,377351,2014-08-14,Assembly,"SCR 126 Fuller  Consent Calendar Second Day  Regular Session",78,0,0,1,79
651793,371727,2014-06-16,Senate,"Senate 3rd Reading SCR127 Huff",35,0,5,0,40
651793,373747,2014-06-23,Assembly,"Be adopted, to Consent Calendar",7,0,0,4,11
651793,374943,2014-06-26,Assembly,"SCR 127 Huff  Consent Calendar Second Day  Regular Session",76,0,0,3,79
652014,371355,2014-06-12,Assembly,"From committee:  Be adopted.  To third reading",10,0,0,1,11
652067,373732,2014-06-23,Assembly,"Be adopted, and re-refer to Committee on Appropriations with 	recommendation:  To Consent Calendar",13,0,0,3,16
652067,375520,2014-07-02,Assembly,"Be adopted, to Consent Calendar",17,0,0,0,17
652067,376365,2014-08-04,Assembly,"ACR 158 PEREA  Consent Calendar Second Day  Regular Session",78,0,0,1,79
652067,378674,2014-08-27,Senate,"Consent Calendar 2nd ACR158 Perea",36,0,4,0,40
652206,377045,2014-08-13,Senate,"Senate 3rd Reading SCR128 Liu",33,1,6,0,40
652206,378167,2014-08-21,Assembly,"Be adopted, to Consent Calendar",10,0,0,1,11
652206,378343,2014-08-25,Assembly,"SCR 128 Liu  Consent Calendar Second Day  Regular Session",79,0,0,0,79
652406,374109,2014-06-23,Assembly,"Be adopted as amended",6,3,0,0,9
652406,376350,2014-08-04,Assembly,"ACR 160 GORDON  Assembly Third Reading",57,20,0,2,79
652406,377459,2014-08-14,Senate,"Assembly 3rd Reading ACR160 Gordon By Leno",23,7,10,0,40
652415,374051,2014-06-23,Senate,"Be adopted",7,0,2,0,9
652415,375307,2014-06-30,Senate,"Senate 3rd Reading SJR29 Lieu",36,0,4,0,40
652424,373712,2014-06-23,Assembly,"Be adopted, and re-refer to Committee on Appropriations with 	recommendation:  To Consent Calendar",13,0,0,3,16
652424,375592,2014-07-02,Assembly,"Be adopted, to Consent Calendar",17,0,0,0,17
652424,376393,2014-08-04,Assembly,"ACR 159 CHESBRO  Consent Calendar Second Day  Regular Session",78,0,0,1,79
652424,378660,2014-08-27,Senate,"Consent Calendar 2nd ACR159 Chesbro",36,0,4,0,40
652424,378968,2014-08-28,Assembly,"ACR 159 CHESBRO  Concurrence in Senate Amendments",78,0,0,1,79
652431,375254,2014-06-30,Assembly,"From committee:  Be adopted.  To third reading",11,0,0,0,11
652575,376973,2014-08-11,Assembly,"From committee:  Be adopted.  To third reading",10,0,0,1,11
652575,378137,2014-08-21,Senate,"Assembly 3rd Reading ACR161 Logue By Nielsen",35,0,5,0,40
652591,377049,2014-08-13,Senate,"Senate 3rd Reading SCR129 Liu",34,0,6,0,40
652591,378115,2014-08-21,Assembly,"Be adopted, to Consent Calendar",10,0,0,1,11
652591,378416,2014-08-25,Assembly,"SCR 129 Liu  Consent Calendar Second Day  Regular Session",79,0,0,0,79
653185,374934,2014-06-26,Assembly,"Be adopted, to Consent Calendar",14,0,0,2,16
653185,375634,2014-07-03,Assembly,"ACR 162 MEDINA  Consent Calendar Second Day",76,0,0,3,79
653185,378238,2014-08-22,Senate,"Assembly 3rd Reading ACR162 Medina By Roth",33,0,7,0,40
653193,373741,2014-06-23,Senate,"Senate 3rd Reading SR51 Lara",24,7,9,0,40
653201,375291,2014-06-30,Assembly,"From committee:  Be adopted.  To third reading",11,0,0,0,11
653201,377671,2014-08-18,Senate,"Assembly 3rd Reading ACR163 Ridley-Thomas By Beall",36,0,4,0,40
653201,377788,2014-08-19,Assembly,"ACR 163 RIDLEY-THOMAS  Concurrence in Senate Amendments",77,0,0,2,79
653307,374756,2014-06-26,Assembly,"From committee:  Be adopted.  To third reading",9,0,0,2,11
653312,377035,2014-08-12,Assembly,"Be adopted, to Consent Calendar",17,0,0,2,19
653312,377723,2014-08-18,Assembly,"AJR 48 RODRIGUEZ  Consent Calendar Second Day",77,0,0,2,79
653312,378595,2014-08-26,Senate,"Assembly 3rd Reading AJR48 Rodriguez By Torres",34,0,6,0,40
653414,374811,2014-06-26,Assembly,"From committee:  Be adopted.  To third reading",9,0,0,2,11
653587,375237,2014-06-30,Senate,"Senate 3rd Reading SCR130 Mitchell",36,0,4,0,40
653697,376374,2014-08-04,Senate,"Senate 3rd Reading SCR131 Gaines",35,0,5,0,40
653757,377802,2014-08-18,Assembly,"Be adopted, and re-refer to Committee on Appropriations with 	recommendation:  To Consent Calendar",16,0,0,0,16
653757,377803,2014-08-19,Assembly,"Be adopted, to Consent Calendar",13,0,0,4,17
653757,378058,2014-08-21,Assembly,"ACR 165 WALDRON  Consent Calendar Second Day",77,0,0,2,79
653760,375653,2014-07-03,Assembly,"From committee:  Be adopted.  To third reading",11,0,0,0,11
653760,378790,2014-08-27,Senate,"Special Consent #19 ACR164 Waldron",36,0,4,0,40
653832,375648,2014-07-03,Senate,"Senate 3rd Reading SR52 Morrell",35,0,5,0,40
653834,376355,2014-08-04,Senate,"Senate 3rd Reading SCR132 Lieu",36,0,4,0,40
653834,377728,2014-08-18,Assembly,"Be adopted, to Consent Calendar",9,0,0,2,11
653834,377887,2014-08-20,Assembly,"SCR 132 Lieu  Consent Calendar Second Day  Regular Session",77,0,0,2,79
653837,377307,2014-08-14,Senate,"Senate 3rd Reading SR53 Correa",32,0,8,0,40
654048,376343,2014-08-04,Senate,"Senate 3rd Reading SR54 Mitchell",25,5,10,0,40
654054,376892,2014-08-11,Senate,"Senate 3rd Reading SCR133 Hill",36,0,4,0,40
654054,378081,2014-08-21,Assembly,"Be adopted, to Consent Calendar",10,0,0,1,11
654054,378398,2014-08-25,Assembly,"SCR 133 Hill  Consent Calendar Second Day  Regular Session",79,0,0,0,79
654097,375709,2014-07-03,Assembly,"From committee:  Be adopted.  To third reading",11,0,0,0,11
654097,377249,2014-08-14,Senate,"Assembly 3rd Reading ACR166 Atkins By Leno",34,0,6,0,40
654114,377022,2014-08-12,Assembly,"Be adopted as amended",7,2,0,1,10
654114,378178,2014-08-21,Assembly,"AJR 49 GONZALEZ  Assembly Third Reading",55,18,0,6,79
654114,379113,2014-08-29,Senate,"Assembly 3rd Supp 4 AJR49 Gonzalez By Correa",26,3,11,0,40
654116,376396,2014-08-04,Senate,"Senate 3rd Reading SCR134 Beall",34,0,6,0,40
654116,377462,2014-08-14,Assembly,"From committee:  Be adopted.  To third reading",8,0,0,3,11
654134,377028,2014-08-12,Senate,"Be adopted as amended",4,2,1,0,7
654134,377893,2014-08-20,Senate,"Senate 3rd Reading SR55 Jackson",24,10,6,0,40
654135,377278,2014-08-14,Assembly,"From committee:  Be adopted.  To third reading",8,0,0,3,11
654135,378293,2014-08-25,Senate,"Assembly 3rd Reading ACR167 Achadjian By Berryhill",34,0,6,0,40
654137,376770,2014-08-07,Senate,"Senate 3rd Reading SCR135 Evans",36,0,4,0,40
654137,378656,2014-08-27,Assembly,"Be adopted, to Consent Calendar",6,0,0,5,11
654137,379093,2014-08-29,Assembly,"SCR 135 Evans  Consent Calendar Second Day",78,0,0,1,79
654137,379094,2014-08-29,Senate,"Unfinished Supp 4 SCR135 Evans Concurrence",34,0,6,0,40
655669,377107,2014-08-13,Assembly,"Be adopted as amended",4,0,0,3,7
655669,377625,2014-08-18,Assembly,"ACR 168 ALEJO  Assembly Third Reading",51,4,0,24,79
655669,378723,2014-08-27,Senate,"Assembly 3rd Reading ACR168 Alejo By Correa",25,7,8,0,40
655670,377265,2014-08-14,Assembly,"From committee:  Be adopted.  To third reading",8,0,0,3,11
655670,378689,2014-08-27,Senate,"Special Consent #19 ACR169 Bonta",36,0,4,0,40
655671,378581,2014-08-25,Assembly,"From committee:  Be adopted.  To third reading",8,1,0,4,13
655671,378609,2014-08-27,Assembly,"HR 49 JONES-SAWYER  Assembly Third Reading",60,16,0,3,79
655672,376766,2014-08-07,Senate,"Senate 3rd Reading SCR137 Walters",35,0,5,0,40
655672,378030,2014-08-21,Assembly,"Be adopted, to Consent Calendar",10,0,0,1,11
655672,378365,2014-08-25,Assembly,"SCR 137 Walters  Consent Calendar Second Day  Regular Session",79,0,0,0,79
655672,378441,2014-08-26,Senate,"Unfinished Supp 1 SCR137 Walters Concurrence",35,0,5,0,40
655673,377748,2014-08-19,Assembly,"Be adopted as amended",8,1,0,1,10
655675,376920,2014-08-11,Senate,"Senate 3rd Reading SCR138 Wolk",36,0,4,0,40
655675,378148,2014-08-21,Assembly,"Be adopted, to Consent Calendar",10,0,0,1,11
655675,378385,2014-08-25,Assembly,"SCR 138 Wolk  Consent Calendar Second Day  Regular Session",79,0,0,0,79
655676,377697,2014-08-18,Assembly,"Be adopted, to Consent Calendar",9,0,0,2,11
655676,377911,2014-08-20,Assembly,"HR 52 HOLDEN  Consent Calendar Second Day",77,0,0,2,79
655677,377831,2014-08-18,Assembly,"Be adopted, and re-refer to Committee on Appropriations with 	recommendation:  To Consent Calendar",16,0,0,0,16
655677,377832,2014-08-19,Assembly,"Be adopted, to Consent Calendar",13,0,0,4,17
655677,378008,2014-08-21,Assembly,"ACR 170 HOLDEN  Consent Calendar Second Day  Regular Session",77,0,0,2,79
655677,379005,2014-08-29,Senate,"W/O REF. TO FILE ACR170 Holden",36,0,4,0,40
655678,378649,2014-08-27,Senate,"Consent Calendar 2nd SCR139 Gaines",36,0,4,0,40
655700,377785,2014-08-19,Assembly,"Be adopted as amended",8,2,0,0,10
655700,378166,2014-08-21,Assembly,"AJR 50 BLOOM  Assembly Third Reading",58,15,0,6,79
655700,379041,2014-08-29,Senate,"Assembly 3rd Supp 4 AJR50 Bloom By Leno",32,0,8,0,40
655701,376996,2014-08-11,Senate,"Senate 3rd Reading SCR140 Evans",30,1,9,0,40
655715,377214,2014-08-14,Senate,"Be adopted as amended",7,0,0,0,7
655715,377938,2014-08-20,Senate,"Senate 3rd Reading SJR31 Torres",34,0,6,0,40
655720,377626,2014-08-18,Assembly,"Be adopted, to Consent Calendar",9,0,0,2,11
655720,377881,2014-08-20,Assembly,"HR 53 LEVINE  Consent Calendar Second Day  Regular Session",77,0,0,2,79
655726,378832,2014-08-27,Assembly,"From committee:  Be adopted.  To third reading",6,0,0,5,11
655726,379061,2014-08-29,Senate,"Assembly 3rd Supp 5 ACR172 Beth Gaines By Gaines",34,0,6,0,40
655728,378651,2014-08-27,Assembly,"Be adopted",7,0,0,3,10
655728,378858,2014-08-28,Assembly,"AJR 52 LINDER  Assembly Third Reading",75,0,0,4,79
655730,378174,2014-08-21,Assembly,"Be adopted, to Consent Calendar",10,0,0,1,11
655730,378341,2014-08-25,Assembly,"AJR 51 BROWN  Consent Calendar Second Day",79,0,0,0,79
655730,378707,2014-08-27,Senate,"Assembly 3rd Reading AJR51 Brown By Mitchell",35,0,5,0,40
655732,377647,2014-08-18,Assembly,"From committee:  Be adopted.  To third reading",9,0,0,2,11
655732,378676,2014-08-27,Senate,"Special Consent #19 ACR171 Wilk",36,0,4,0,40
655757,377851,2014-08-18,Assembly,"Be adopted, to Consent Calendar",16,0,0,0,16
655757,377934,2014-08-20,Assembly,"AJR 53 RENDON  Consent Calendar Second Day  Regular Session",77,0,0,2,79
655757,378405,2014-08-25,Senate,"Assembly 3rd Reading AJR53 Rendon By DeSaulnier",32,0,8,0,40
655758,377086,2014-08-13,Senate,"Senate 3rd Reading SR56 Lieu",35,0,5,0,40
655759,377827,2014-08-18,Assembly,"Be adopted, and re-refer to Committee on Appropriations with 	recommendation:  To Consent Calendar",16,0,0,0,16
655759,377828,2014-08-19,Assembly,"Be adopted, to Consent Calendar",13,0,0,4,17
655759,378123,2014-08-21,Assembly,"ACR 173 GOMEZ  Consent Calendar Second Day  Regular Session",77,0,0,2,79
655759,379054,2014-08-29,Senate,"Be adopted, but re-refer to the Committee on Appropriations 	Recommend Consent",8,0,3,0,11
655759,379055,2014-08-29,Senate,"Assembly 3rd Supp 1 ACR173 Gomez By De Le",34,0,6,0,40
655804,377677,2014-08-18,Assembly,"From committee:  Be adopted.  To third reading",9,0,0,2,11
655804,378746,2014-08-27,Senate,"Assembly 3rd Reading ACR174 Nestande By Fuller",36,0,4,0,40
655842,378691,2014-08-27,Senate,"Senate 3rd Reading SR58 Walters",34,0,6,0,40
655865,378192,2014-08-22,Senate,"Senate 3rd Reading SR59 Lieu",19,11,10,0,40
655879,378431,2014-08-25,Senate,"Senate 3rd Reading SR60 Mitchell",35,0,5,0,40
655891,378383,2014-08-25,Assembly,"From committee:  Be adopted.  To third reading",8,0,0,3,11
655891,378944,2014-08-28,Senate,"W/O REF. TO FILE ACR175 Ian Calderon",37,0,3,0,40
655928,378423,2014-08-25,Senate,"Senate 3rd Reading SR61 Gaines",35,0,5,0,40
655940,378997,2014-08-29,Assembly,"HR 55 RIDLEY-THOMAS  Assembly Third Reading",63,6,0,10,79
656004,379114,2014-08-29,Senate,"Senate 3rd Reading SJR34 Galgiani",29,1,10,0,40
656018,379040,2014-08-29,Senate,"W/O REF. TO FILE SR63 De Le",36,0,4,0,40
