bill_id,roll_call_id,date,chamber,description,yea,nay,nv,absent,total
1385398,1051885,2021-04-13,Senate,"Do pass, but first be re-referred to the Committee on [Appropriations]",6,2,1,0,9
1385398,1056349,2021-04-19,Senate,"Placed on suspense file",7,0,0,0,7
1385398,1081612,2021-05-20,Senate,"Do pass",5,2,0,0,7
1385398,1089539,2021-06-01,Senate,"Senate 3rd Reading SB47 Lim贸n",25,10,5,0,40
1385398,1104494,2021-07-07,Assembly,"Do pass and be re-referred to the Committee on [Appropriations]",8,2,1,0,11
1385398,1106850,2021-08-26,Assembly,"Do pass",12,4,0,0,16
1385398,1108204,2021-09-08,Assembly,"SB 47 Lim贸n Senate Third Reading By Bennett",52,21,0,7,80
1385398,1108344,2021-09-09,Senate,"Unfinished Business SB47 Lim贸n et al. Concurrence",27,10,0,3,40
1385399,1053495,2021-04-14,Assembly,"Do pass as amended and be re-referred to the Committee on [Local Government]",11,0,0,0,11
1385399,1065087,2021-04-28,Assembly,"Do pass and be re-referred to the Committee on [Appropriations] with recommendation: To Consent Calendar",8,0,0,0,8
1385399,1081479,2021-05-20,Assembly,"Do pass",16,0,0,0,16
1385399,1086950,2021-05-27,Assembly,"AB 9 Wood Assembly Third Reading",78,0,0,0,78
1385399,1104767,2021-07-13,Senate,"Do pass as amended, but first amend, and re-refer to the Committee on [Appropriations] with the recommendation: To Consent Calendar",8,0,1,0,9
1385399,1106149,2021-08-16,Senate,"Placed on suspense file",7,0,0,0,7
1385399,1106942,2021-08-26,Senate,"Do pass",7,0,0,0,7
1385399,1108303,2021-09-09,Senate,"Assembly 3rd Reading AB9 Wood By Lim贸n",38,0,0,2,40
1385399,1108304,2021-09-09,Assembly,"AB 9 WOOD Concurrence in Senate Amendments",79,0,0,1,80
1385400,1060937,2021-04-22,Assembly,"Do pass and be re-referred to the Committee on [Appropriations]",6,0,1,0,7
1385400,1081556,2021-05-20,Assembly,"Do pass",12,4,0,0,16
1385400,1086944,2021-05-27,Assembly,"AB 7 Rodriguez Assembly Third Reading",61,11,6,0,78
1385400,1102495,2021-06-28,Senate,"Do pass, but first be re-referred to the Committee on [Appropriations]",4,1,0,0,5
1385400,1105154,2021-07-15,Senate,"Placed on suspense file",7,0,0,0,7
1385400,1106917,2021-08-26,Senate,"Do pass",5,2,0,0,7
1385400,1107695,2021-09-02,Senate,"Assembly 3rd Reading AB7 Rodriguez et al. By Cortese",30,9,0,1,40
1385400,1107932,2021-09-07,Assembly,"AB 7 Rodriguez Concurrence in Senate Amendments",57,9,0,14,80
1385401,988135,2021-01-15,Assembly,"AB 84 Ting Assembly Third Reading",48,13,19,0,80
1385401,1028411,2021-03-15,Senate,"Do pass",13,5,0,0,18
1385401,1050801,2021-04-12,Senate,"Do pass",13,3,2,0,18
1385401,1134645,2022-02-03,Senate,"Do pass",13,3,0,2,18
1385402,1059244,2021-04-21,Assembly,"Be adopted. To third reading",9,0,0,0,9
1385402,1066773,2021-04-29,Assembly,"AJR 2 O'Donnell Assembly Third Reading",75,0,3,0,78
1385402,1097780,2021-06-14,Senate,"Be adopted. Ordered to third reading",7,0,0,0,7
1385402,1107642,2021-09-02,Senate,"Assembly 3rd Reading AJR2 O'Donnell et al. By Allen",39,0,0,1,40
1385402,1107942,2021-09-07,Assembly,"AJR 2 O'Donnell Concurrence in Senate Amendments",72,0,0,8,80
1385403,1029577,2021-03-16,Senate,"Do pass, but first be re-referred to the Committee on [Governance and Finance]",7,2,0,0,9
1385403,1054638,2021-04-15,Senate,"Do pass, but first be re-referred to the Committee on [Appropriations]",5,0,0,0,5
1385403,1068261,2021-05-03,Senate,"Placed on suspense file",6,0,1,0,7
1385403,1082192,2021-05-20,Senate,"Do pass",5,2,0,0,7
1385403,1122871,2022-01-10,Senate,"Do pass, but first be re-referred to the Committee on [Appropriations] with the recommendation: To Consent Calendar",6,0,0,1,7
1385403,1124814,2022-01-18,Senate,"Placed on suspense file",6,0,0,1,7
1385403,1126297,2022-01-20,Senate,"Do pass",7,0,0,0,7
1385403,1127224,2022-01-24,Senate,"Senate 3rd Reading SB45 Portantino",36,0,0,4,40
1385403,1214373,2022-06-06,Assembly,"Do pass and be re-referred to the Committee on [Appropriations] with recommendation: To Consent Calendar",9,0,0,1,10
1385403,1223788,2022-08-11,Assembly,"Do pass as amended",12,0,0,4,16
1385403,1225044,2022-08-29,Assembly,"SB 45 Portantino Senate Third Reading By Gabriel",77,0,0,3,80
1385403,1225263,2022-08-30,Senate,"Unfinished Business SB45 Portantino Concurrence",40,0,0,0,40
1385404,1048964,2021-04-08,Assembly,"Do pass as amended and be re-referred to the Committee on [Appropriations]",7,0,0,0,7
1385404,1081448,2021-05-20,Assembly,"Do pass as amended",16,0,0,0,16
1385404,1092902,2021-06-01,Assembly,"AB 73 Robert Rivas Third Reading Urgency",78,0,1,0,79
1385404,1101678,2021-06-23,Senate,"Do pass, but first be re-referred to the Committee on [Labor, Public Employment and Retirement ]",11,0,0,0,11
1385404,1104184,2021-07-05,Senate,"Do pass, but first be re-referred to the Committee on [Appropriations]",5,0,0,0,5
1385404,1105042,2021-07-15,Senate,"Placed on suspense file",7,0,0,0,7
1385404,1106606,2021-08-26,Senate,"Do pass as amended",7,0,0,0,7
1385404,1108621,2021-09-10,Senate,"Assembly 3rd Reading AB73 Robert Rivas et al. By Caballero Urgency Clause",37,0,0,3,40
1385404,1108622,2021-09-10,Assembly,"AB 73 Robert Rivas Concurrence in Senate Amendments",78,0,0,2,80
1385405,1053488,2021-04-14,Assembly,"Do pass and be re-referred to the Committee on [Human Services]",6,0,1,0,7
1385405,1059302,2021-04-21,Assembly,"Do pass as amended and be re-referred to the Committee on [Appropriations]",8,0,0,0,8
1385405,1081865,2021-05-20,Assembly,"Do pass",14,0,2,0,16
1385405,1092895,2021-06-01,Assembly,"AB 46 Luz Rivas Assembly Third Reading",73,0,6,0,79
1385405,1100325,2021-06-22,Senate,"Do pass as amended, but first amend, and re-refer to the Committee on [Human Services]",11,2,2,0,15
1385405,1104374,2021-07-06,Senate,"Do pass, but first be re-referred to the Committee on [Appropriations]",4,1,0,0,5
1385405,1106172,2021-08-16,Senate,"Placed on suspense file",7,0,0,0,7
1385405,1106987,2021-08-26,Senate,"Do pass as amended",5,1,0,1,7
1385405,1108130,2021-09-08,Senate,"Assembly 3rd Reading AB46 Luz Rivas et al. By Wiener",30,4,0,6,40
1385405,1108286,2021-09-09,Assembly,"AB 46 Luz Rivas Concurrence in Senate Amendments",71,1,0,8,80
1385406,1123783,2022-01-12,Assembly,"Do pass as amended and be re-referred to the Committee on [Appropriations]",6,0,0,1,7
1385406,1126337,2022-01-20,Assembly,"Do pass",15,0,0,1,16
1385406,1127185,2022-01-24,Assembly,"AB 58 Salas Assembly Third Reading",67,0,0,9,76
1385406,1215009,2022-06-08,Senate,"Do pass, but first be re-referred to the Committee on [Appropriations] with the recommendation: To Consent Calendar",7,0,0,0,7
1385406,1217064,2022-06-20,Senate,"Placed on suspense file",4,0,0,3,7
1385406,1223362,2022-08-11,Senate,"Do pass as amended",7,0,0,0,7
1385406,1224550,2022-08-23,Senate,"Special Consent AB58",40,0,0,0,40
1385406,1224682,2022-08-24,Assembly,"AB 58 Salas Concurrence in Senate Amendments",77,0,0,3,80
1385407,1053515,2021-04-14,Assembly,"Do pass and be re-referred to the Committee on [Appropriations] with recommendation: To Consent Calendar",11,0,0,0,11
1385407,1081879,2021-05-20,Assembly,"Do pass",16,0,0,0,16
1385407,1087078,2021-05-27,Assembly,"AB 78 O'Donnell Assembly Third Reading",78,0,0,0,78
1385407,1102867,2021-06-29,Senate,"Do pass, but first be re-referred to the Committee on [Appropriations]",8,0,1,0,9
1385407,1106422,2021-08-23,Senate,"Placed on suspense file",7,0,0,0,7
1385408,1097793,2021-06-14,Senate,"Senate 3rd Reading SCR3 Umberg et al",39,0,1,0,40
1385408,1103793,2021-07-01,Assembly,"Be adopted. To Consent Calendar",9,0,3,0,12
1385408,1104510,2021-07-08,Assembly,"SCR 3 Umberg Consent Calendar Second Day Regular Session",76,0,3,0,79
1385415,984521,2021-01-11,Assembly,"Be adopted. To third reading",11,0,1,0,12
1385415,1101629,2021-06-24,Senate,"Special Consent ACR2",39,0,1,0,40
1385416,1026091,2021-03-10,Senate,"Do pass, but first be re-referred to the Committee on [Public Safety]",7,3,1,0,11
1385416,1046117,2021-04-06,Senate,"Do pass",4,1,0,0,5
1385416,1060900,2021-04-22,Senate,"Senate 3rd Reading SB57 Wiener et al",21,11,8,0,40
1385416,1123289,2022-01-11,Assembly,"Do pass as amended and be re-referred to the Committee on [Public Safety]",9,4,0,2,15
1385416,1211879,2022-06-01,Assembly,"Do pass",5,2,0,0,7
1385416,1221290,2022-06-30,Assembly,"SB 57 Wiener Senate Third Reading By Haney",42,29,0,9,80
1385416,1222620,2022-08-01,Senate,"Unfinished Business SB57 Wiener et al. Concurrence",21,11,0,8,40
1385418,1066748,2021-04-29,Senate,"Senate 3rd Reading SCR4 Umberg et al",37,0,3,0,40
1385418,1077537,2021-05-13,Assembly,"Be adopted. To Consent Calendar",10,0,2,0,12
1385418,1082117,2021-05-20,Assembly,"SCR 4 Umberg Consent Calendar Second Day Regular Session",76,0,2,0,78
1385421,1048873,2021-04-08,Assembly,"Do pass and be re-referred to the Committee on [Appropriations]",22,0,0,0,22
1385422,1064041,2021-04-27,Senate,"Do pass as amended, but first amend, and re-refer to the Committee on [Appropriations] with the recommendation: To Consent Calendar",15,0,2,0,17
1385422,1075306,2021-05-10,Senate,"Placed on suspense file",7,0,0,0,7
1385422,1082013,2021-05-20,Senate,"Do pass",7,0,0,0,7
1385422,1089487,2021-06-01,Senate,"Special Consent SB66",39,0,1,0,40
1385422,1099738,2021-06-21,Assembly,"Do pass and be re-referred to the Committee on [Communications and Conveyance]",14,0,1,0,15
1385422,1104380,2021-07-07,Assembly,"Do pass and be re-referred to the Committee on [Appropriations]",11,0,2,0,13
1385423,1054610,2021-04-15,Assembly,"Do pass and be re-referred to the Committee on [Appropriations]",5,0,2,0,7
1385423,1065253,2021-04-28,Assembly,"Do pass",12,0,4,0,16
1385424,1050806,2021-04-12,Senate,"Do pass as amended, but first amend, and re-refer to the Committee on [Judiciary]",11,1,2,0,14
1385424,1068231,2021-05-03,Senate,"Placed on suspense file",6,0,1,0,7
1385424,1081818,2021-05-20,Senate,"Do pass as amended",5,2,0,0,7
1385424,1090431,2021-06-02,Senate,"Senate 3rd Reading SB4 Gonzalez et al. Urgency Clause",31,5,4,0,40
1385424,1104385,2021-07-07,Assembly,"Do pass and be re-referred to the Committee on [Appropriations]",8,3,2,0,13
1385424,1106974,2021-08-26,Assembly,"Do pass as amended",12,3,0,1,16
1385424,1108034,2021-09-08,Assembly,"SB 4 Gonzalez Third Reading Urgency By Aguiar-Curry",55,9,0,16,80
1385424,1108351,2021-09-09,Senate,"Unfinished Business SB4 Gonzalez et al. Urgency Clause Concurrence",29,8,0,3,40
1385425,1062763,2021-04-26,Senate,"Do pass, but first be re-referred to the Committee on [Appropriations] with the recommendation: To Consent Calendar",7,0,0,0,7
1385425,1075269,2021-05-10,Senate,"Placed on suspense file",7,0,0,0,7
1385425,1081465,2021-05-20,Senate,"Do pass",7,0,0,0,7
1385425,1089583,2021-06-01,Senate,"Special Consent SB42",39,0,1,0,40
1385425,1193382,2022-04-26,Assembly,"Do pass and be re-referred to the Committee on [Appropriations]",14,1,0,0,15
1385425,1217997,2022-06-22,Assembly,"Do pass as amended",15,0,0,1,16
1385427,988119,2021-01-15,Assembly,"AB 87 Ting Assembly Third Reading",48,13,19,0,80
1385427,1065075,2021-04-28,Senate,"Do pass",12,5,1,0,18
1385427,1134640,2022-02-03,Senate,"Do pass",16,0,0,2,18
1385428,1056359,2021-04-19,Senate,"Do pass as amended, but first amend, and re-refer to the Committee on [Judiciary]",10,2,2,0,14
1385428,1078822,2021-05-17,Senate,"Placed on suspense file",7,0,0,0,7
1385428,1081548,2021-05-20,Senate,"Do pass as amended",5,2,0,0,7
1385428,1087625,2021-05-28,Senate,"Senate 3rd Reading SB68 Becker",35,1,4,0,40
1385428,1103493,2021-06-30,Assembly,"Do pass and be re-referred to the Committee on [Appropriations]",15,0,0,0,15
1385428,1106990,2021-08-26,Assembly,"Do pass",15,0,0,1,16
1385428,1107542,2021-09-01,Assembly,"SB 68 Becker Senate Third Reading By Carrillo",75,0,0,4,79
1385428,1108541,2021-09-10,Senate,"Unfinished Business SB68 Becker et al. Concurrence",32,4,0,4,40
1385428,1108542,2021-09-10,Assembly,"SB 68 Becker Senate Third Reading By Carrillo",74,0,0,6,80
1385430,1062748,2021-04-26,Senate,"Do pass, but first be re-referred to the Committee on [Appropriations]",5,1,1,0,7
1385430,1127186,2022-01-24,Senate,"Senate 3rd Reading SB54 Allen et al",29,7,0,4,40
1385430,1219907,2022-06-28,Assembly,"Do pass and be re-referred to the Committee on [Appropriations]",9,0,0,2,11
1385430,1220866,2022-06-29,Assembly,"Do pass",14,0,0,2,16
1385430,1221235,2022-06-30,Senate,"Unfinished Business SB54 Allen et al. Concurrence",29,0,0,11,40
1385430,1221534,2022-06-29,Assembly,"SB 54 Allen Senate Third Reading By RIVAS, L",67,2,0,11,80
1385431,1049027,2021-04-07,Assembly,"Do pass as amended and be re-referred to the Committee on [Appropriations]",7,0,0,0,7
1385431,1081697,2021-05-20,Assembly,"Do pass as amended",16,0,0,0,16
1385431,1090483,2021-06-02,Assembly,"AB 22 McCarty Assembly Third Reading",76,0,3,0,79
1385431,1103426,2021-06-30,Senate,"Do pass as amended, but first amend, and re-refer to the Committee on [Human Services]",4,0,3,0,7
1385431,1104421,2021-07-06,Senate,"Do pass, but first be re-referred to the Committee on [Appropriations]",4,1,0,0,5
1385431,1106400,2021-08-23,Senate,"Placed on suspense file",7,0,0,0,7
1385431,1221228,2022-06-30,Senate,"Do pass as amended, but first amend, and re-refer to the Committee on [Appropriations]",6,0,0,1,7
1385431,1223246,2022-08-08,Senate,"Placed on suspense file",7,0,0,0,7
1385431,1223799,2022-08-11,Senate,"Do pass",7,0,0,0,7
1385431,1225413,2022-08-30,Senate,"Assembly 3rd Reading AB22 McCarty By Lim贸n",40,0,0,0,40
1385431,1225414,2022-08-31,Assembly,"AB 22 McCarty Concurrence in Senate Amendments",80,0,0,0,80
1385432,1056340,2021-04-19,Senate,"Do pass as amended, but first amend, and re-refer to the Committee on [Appropriations]",9,3,2,0,14
1385432,1075265,2021-05-10,Senate,"Placed on suspense file",7,0,0,0,7
1385433,1028418,2021-03-15,Senate,"Do pass as amended, but first amend, and re-refer to the Committee on [Appropriations]",5,2,0,0,7
1385433,1045009,2021-04-05,Senate,"Placed on suspense file",7,0,0,0,7
1385433,1081739,2021-05-20,Senate,"Do pass as amended",5,2,0,0,7
1385433,1091737,2021-06-03,Senate,"Senate 3rd Reading SB38 Wieckowski",23,8,9,0,40
1385433,1219373,2022-06-27,Assembly,"Do pass as amended and be re-referred to the Committee on [Appropriations]",10,0,0,1,11
1385433,1224027,2022-08-11,Assembly,"Do pass as amended",13,3,0,0,16
1385433,1224538,2022-08-23,Assembly,"SB 38 Wieckowski Senate Third Reading By Wood",74,0,0,6,80
1385433,1225764,2022-08-29,Senate,"That the Assembly amendments be concurred in",6,0,0,1,7
1385433,1225765,2022-08-30,Senate,"Unfinished Business SB38 Wieckowski Concurrence",38,0,0,2,40
1385434,1037856,2021-03-25,Senate,"Do pass, but first be re-referred to the Committee on [Housing]",5,0,0,0,5
1385434,1066790,2021-04-29,Senate,"Do pass as amended, but first amend, and re-refer to the Committee on [Appropriations]",8,1,0,0,9
1385434,1083863,2021-05-24,Senate,"Senate 3rd Reading SB8 Skinner et al",30,2,8,0,40
1385434,1100289,2021-06-22,Assembly,"Do pass and be re-referred to the Committee on [Local Government]",6,0,2,0,8
1385434,1103814,2021-06-30,Assembly,"Do pass as amended and be re-referred to the Committee on [Appropriations]",7,1,0,0,8
1385434,1106340,2021-08-19,Assembly,"Do pass",16,0,0,0,16
1385434,1107116,2021-08-30,Assembly,"SB 8 Skinner Senate Third Reading By Daly",67,1,0,11,79
1385434,1107471,2021-09-01,Senate,"Unfinished Business SB8 Skinner et al. Concurrence",30,3,0,7,40
1385435,1054648,2021-04-15,Assembly,"Do pass as amended and be re-referred to the Committee on [Appropriations]",7,0,1,0,8
1385435,1081425,2021-05-20,Assembly,"Do pass",16,0,0,0,16
1385435,1091749,2021-06-03,Assembly,"AB 68 Quirk-Silva Assembly Third Reading",77,0,2,0,79
1385435,1104505,2021-07-08,Senate,"Do pass as amended, but first amend, and re-refer to the Committee on [Appropriations] with the recommendation: To Consent Calendar",9,0,0,0,9
1385435,1106246,2021-08-16,Senate,"Placed on suspense file",7,0,0,0,7
1385435,1106635,2021-08-26,Senate,"Do pass as amended",7,0,0,0,7
1385435,1108192,2021-09-08,Senate,"Special Consent AB68",38,0,0,2,40
1385435,1108343,2021-09-09,Assembly,"AB 68 Quirk-Silva Concurrence in Senate Amendments",78,0,0,2,80
1385436,1048971,2021-04-08,Senate,"Do pass as amended, and be ordered to the Consent Calendar",12,0,0,0,12
1385436,1060998,2021-04-22,Senate,"Consent Calendar SB11",38,0,2,0,40
1385436,1101607,2021-06-24,Assembly,"Do pass as amended. To Consent Calendar",14,0,0,0,14
1385436,1103843,2021-07-01,Assembly,"SB 11 Rubio Consent Calendar Second Day Regular Session",77,0,2,0,79
1385436,1104522,2021-07-08,Senate,"Unfinished Business SB11 Rubio et al. Urgency Clause Concurrence",39,0,1,0,40
1385437,1033609,2021-03-22,Senate,"Do pass, but first be re-referred to the Committee on [Governance and Finance]",14,0,0,0,14
1385437,1074148,2021-05-06,Senate,"Do pass as amended, but first amend, and re-refer to the Committee on [Appropriations]",5,0,0,0,5
1385437,1078815,2021-05-17,Senate,"Placed on suspense file",7,0,0,0,7
1385437,1081571,2021-05-20,Senate,"Do pass",7,0,0,0,7
1385437,1127196,2022-01-24,Senate,"Senate 3rd Reading SB49 Umberg et al",36,0,0,4,40
1385437,1217051,2022-06-20,Assembly,"Do pass and be re-referred to the Committee on [Judiciary] with recommendation: To Consent Calendar",10,0,0,2,12
1385437,1220091,2022-06-28,Assembly,"Do pass and be re-referred to the Committee on [Appropriations] with recommendation: To Consent Calendar",11,0,0,0,11
1385437,1223007,2022-08-03,Assembly,"Do pass. To Consent Calendar",15,0,0,1,16
1385437,1223781,2022-08-11,Assembly,"SB 49 Umberg Consent Calendar Second Day Regular Session",76,0,0,4,80
1385437,1224101,2022-08-16,Senate,"Unfinished Business SB49 Umberg et al. Concurrence",36,0,0,4,40
1385439,1023826,2021-03-08,Senate,"Do pass, but first be re-referred to the Committee on [Judiciary]",5,0,0,0,5
1385439,1035270,2021-03-23,Senate,"Do pass, but first be re-referred to the Committee on [Appropriations] with the recommendation: To Consent Calendar",11,0,0,0,11
1385439,1075354,2021-05-10,Senate,"Consent Calendar SB58 Wilk et al. Urgency Clause",37,0,3,0,40
1385439,1099158,2021-06-17,Assembly,"Do pass as amended, and be re-referred to the Committee on [Insurance] with recommendation: To Consent Calendar",10,0,0,0,10
1385439,1101594,2021-06-24,Assembly,"Do pass and be re-referred to the Committee on [Appropriations] with recommendation: To Consent Calendar",14,0,0,0,14
1385441,1102526,2021-06-28,Senate,"Be adopted, but first be re-referred to the Committee on [Appropriations]",4,1,0,0,5
1385441,1105104,2021-07-15,Senate,"Placed on suspense file",7,0,0,0,7
1385441,1106842,2021-08-26,Senate,"Be adopted",5,2,0,0,7
1385442,1036520,2021-03-23,Assembly,"Do pass as amended and be re-referred to the Committee on [Appropriations]",6,2,0,0,8
1385442,1081722,2021-05-20,Assembly,"Do pass as amended",12,4,0,0,16
1385442,1092830,2021-06-01,Assembly,"AB 26 Holden Assembly Third Reading",49,18,12,0,79
1385442,1102868,2021-06-29,Senate,"Do pass, but first be re-referred to the Committee on [Appropriations]",4,1,0,0,5
1385442,1106385,2021-08-23,Senate,"Placed on suspense file",7,0,0,0,7
1385442,1106588,2021-08-26,Senate,"Do pass",5,2,0,0,7
1385442,1107142,2021-08-30,Senate,"Assembly 3rd Reading AB26 Holden By Bradford",26,9,0,5,40
1385442,1107505,2021-09-01,Assembly,"AB 26 Holden Concurrence in Senate Amendments",51,16,0,12,79
1385443,988134,2021-01-15,Assembly,"AB 82 Ting Assembly Third Reading",48,13,19,0,80
1385443,1009522,2021-02-18,Senate,"Do pass",17,0,1,0,18
1385443,1011742,2021-02-22,Senate,"Assembly 3rd Reading AB82 Ting By Skinner",38,0,1,0,39
1385443,1011743,2021-02-22,Assembly,"AB 82 TING Assembly Third Reading",77,0,2,0,79
1385443,1013297,2021-02-22,Assembly,"AB 82 TING Concurrence in Senate Amendments",77,0,2,0,79
1385446,988125,2021-01-15,Assembly,"AB 86 Ting Assembly Third Reading",48,13,19,0,80
1385446,1020027,2021-03-02,Senate,"Do pass",18,0,0,0,18
1385446,1022323,2021-03-04,Senate,"Assembly 3rd Reading AB86 BUDGET (Ting) By Skinner",36,0,3,0,39
1385446,1022324,2021-03-04,Assembly,"AB 86 BUDGET Concurrence in Senate Amendments By TING",72,4,3,0,79
1385447,1028434,2021-03-15,Senate,"Do pass, but first be re-referred to the Committee on [Natural Resources and Water]",5,0,2,0,7
1385447,1064146,2021-04-27,Senate,"Do pass, but first be re-referred to the Committee on [Appropriations]",7,0,2,0,9
1385447,1075274,2021-05-10,Senate,"Placed on suspense file",7,0,0,0,7
1385447,1081801,2021-05-20,Senate,"Do pass as amended",5,2,0,0,7
1385447,1087589,2021-05-28,Senate,"Senate 3rd Reading SB27 Skinner et al",34,3,3,0,40
1385447,1100803,2021-06-23,Assembly,"Do pass as amended and be re-referred to the Committee on [Appropriations]",11,0,0,0,11
1385447,1106758,2021-08-26,Assembly,"Do pass as amended",12,0,0,4,16
1385447,1107624,2021-09-02,Assembly,"SB 27 Skinner Senate Third Reading By Robert Rivas",75,0,0,4,79
1385447,1107832,2021-09-03,Senate,"Unfinished Business SB27 Skinner et al. Concurrence",34,4,0,2,40
1385448,1046148,2021-04-05,Senate,"Do pass as amended, but first amend, and re-refer to the Committee on [Appropriations]",5,0,0,0,5
1385448,1068195,2021-05-03,Senate,"Senate 3rd Reading SB33 Cortese",36,0,4,0,40
1385448,1215297,2022-06-09,Assembly,"Be re-referred to the Committees on [Natural Resources] and [Judiciary]",8,0,0,3,11
1385449,988131,2021-01-15,Assembly,"AB 79 Ting Assembly Third Reading",48,13,19,0,80
1385449,990809,2021-01-26,Senate,"Do pass",16,0,2,0,18
1385449,1050769,2021-04-12,Senate,"Do pass",16,0,2,0,18
1385453,983019,2020-12-07,Senate,"W/O REF. TO FILE SCR1 Umberg",36,0,0,0,36
1385453,983020,2020-12-07,Assembly,"SCR 1 Umberg Senate Third Reading By REYES",75,0,5,0,80
1385455,1046214,2021-04-06,Assembly,"Do pass as amended and be re-referred to the Committee on [Appropriations]",15,0,0,0,15
1385455,1081978,2021-05-20,Assembly,"Do pass as amended",13,0,3,0,16
1385455,1092876,2021-06-01,Assembly,"AB 70 Salas Assembly Third Reading",72,2,5,0,79
1385455,1104460,2021-07-07,Senate,"Do pass as amended, but first amend, and re-refer to the Committee on [Appropriations]",9,0,2,0,11
1385455,1106227,2021-08-16,Senate,"Placed on suspense file",7,0,0,0,7
1385455,1107003,2021-08-26,Senate,"Do pass as amended",5,0,0,2,7
1385455,1107636,2021-09-02,Senate,"Assembly 3rd Reading AB70 Salas et al. By Pan",35,0,0,5,40
1385455,1107929,2021-09-07,Assembly,"AB 70 Salas Concurrence in Senate Amendments",67,0,0,13,80
1385456,1065157,2021-04-28,Senate,"Do pass as amended, but first amend, and re-refer to the Committee on [Appropriations]",7,0,0,0,7
1385456,1078779,2021-05-17,Senate,"Senate 3rd Reading SB43 Umberg et al",38,0,2,0,40
1385456,1219980,2022-06-28,Assembly,"Do pass and be re-referred to the Committee on [Appropriations]",10,0,0,1,11
1385459,1026145,2021-03-10,Senate,"Do pass, but first be re-referred to the Committee on [Governance and Finance]",5,1,1,0,7
1385459,1048945,2021-04-08,Senate,"Do pass, but first be re-referred to the Committee on [Appropriations]",5,0,0,0,5
1385459,1056336,2021-04-19,Senate,"Placed on suspense file",7,0,0,0,7
1385459,1082128,2021-05-20,Senate,"Do pass as amended",5,1,1,0,7
1385459,1091751,2021-06-03,Senate,"Senate 3rd Reading SB22 Glazer et al",31,5,4,0,40
1385460,1053461,2021-04-13,Assembly,"Do pass and be re-referred to the Committee on [Governmental Organization]",6,7,6,0,19
1385461,988128,2021-01-15,Assembly,"AB 88 Ting Assembly Third Reading",48,13,19,0,80
1385461,1009543,2021-02-18,Senate,"Do pass",13,0,5,0,18
1385461,1028397,2021-03-15,Senate,"Do pass",14,0,4,0,18
1385461,1028398,2021-03-15,Senate,"Assembly 3rd Reading AB88 BUDGET (Ting) By Skinner",32,0,8,0,40
1385461,1028399,2021-03-15,Assembly,"AB 88 BUDGET Concurrence in Senate Amendments By TING",66,0,12,0,78
1385462,1036528,2021-03-23,Assembly,"Do pass and be re-referred to the Committee on [Appropriations]",6,2,0,0,8
1385462,1082105,2021-05-20,Assembly,"Do pass",12,4,0,0,16
1385462,1092925,2021-06-01,Assembly,"AB 48 Lorena Gonzalez Assembly Third Reading",46,19,14,0,79
1385462,1104294,2021-07-06,Senate,"Do pass, but first be re-referred to the Committee on [Appropriations]",4,1,0,0,5
1385462,1106139,2021-08-16,Senate,"Placed on suspense file",7,0,0,0,7
1385462,1107000,2021-08-26,Senate,"Do pass as amended",5,2,0,0,7
1385462,1107615,2021-09-02,Senate,"Assembly 3rd Reading AB48 Lorena Gonzalez et a By Gonzalez",26,10,0,4,40
1385462,1108191,2021-09-08,Assembly,"AB 48 Lorena Gonzalez Concurrence in Senate Amendments",49,19,0,12,80
1385463,1028408,2021-03-15,Senate,"Do pass as amended, but first amend, and re-refer to the Committee on [Environmental Quality]",12,0,2,0,14
1385463,1066675,2021-04-29,Senate,"Do pass as amended, but first amend, and re-refer to the Committee on [Appropriations]",6,0,1,0,7
1385463,1078817,2021-05-17,Senate,"Placed on suspense file",7,0,0,0,7
1385463,1081579,2021-05-20,Senate,"Do pass as amended",7,0,0,0,7
1385463,1087600,2021-05-28,Senate,"Senate 3rd Reading SB18 Skinner et al",38,0,2,0,40
1385463,1098667,2021-06-16,Assembly,"Do pass as amended and be re-referred to the Committee on [Natural Resources]",15,0,0,0,15
1385463,1104375,2021-07-07,Assembly,"Do pass and be re-referred to the Committee on [Appropriations]",11,0,0,0,11
1385464,1036538,2021-03-24,Senate,"Do pass as amended, but first amend, and re-refer to the Committee on [Governance and Finance]",4,2,1,0,7
1385464,1068162,2021-05-03,Senate,"Placed on suspense file",6,0,1,0,7
1385464,1081592,2021-05-20,Senate,"Do pass as amended",5,2,0,0,7
1385464,1127179,2022-01-24,Senate,"Senate 3rd Reading SB34 Umberg Urgency Clause",30,4,0,6,40
1385464,1220726,2022-06-29,Assembly,"Do pass and be re-referred to the Committee on [Appropriations]",7,0,0,0,7
1385464,1222993,2022-08-03,Assembly,"Do pass",14,0,0,2,16
1385464,1224081,2022-08-15,Assembly,"SB 34 Umberg Senate Third Reading By Daly",74,0,0,6,80
1385464,1224131,2022-08-17,Senate,"That the Assembly amendments be concurred in",10,0,0,5,15
1385464,1225203,2022-08-29,Senate,"Unfinished Business SB34 Umberg et al. Concurrence",40,0,0,0,40
1385465,1063990,2021-04-27,Assembly,"Do pass and be re-referred to the Committee on [Appropriations]",13,0,2,0,15
1385465,1081503,2021-05-20,Assembly,"Do pass as amended",16,0,0,0,16
1385465,1092841,2021-06-01,Assembly,"AB 32 Aguiar-Curry Assembly Third Reading",78,0,1,0,79
1385465,1221222,2022-06-29,Senate,"Do pass, but first be re-referred to the Committee on [Appropriations]",10,0,0,1,11
1385465,1223242,2022-08-08,Senate,"Placed on suspense file",7,0,0,0,7
1385465,1223468,2022-08-11,Senate,"Do pass",7,0,0,0,7
1385465,1225395,2022-08-31,Senate,"Special Consent AB32",40,0,0,0,40
1385465,1225396,2022-08-31,Assembly,"AB 32 Aguiar-Curry Concurrence in Senate Amendments",71,0,0,9,80
1385466,983022,2020-12-07,Assembly,"HR 2 RENDON Assembly Third Reading By REYES",75,0,5,0,80
1385467,1064152,2021-04-27,Assembly,"Do pass as amended and be re-referred to the Committee on [Appropriations]",14,1,0,0,15
1385467,1081515,2021-05-20,Assembly,"Do pass as amended",13,3,0,0,16
1385467,1092864,2021-06-01,Assembly,"AB 45 Aguiar-Curry Third Reading Urgency",64,9,6,0,79
1385467,1101681,2021-06-23,Senate,"Do pass as amended, but first amend, and re-refer to the Committee on [Agriculture]",11,0,0,0,11
1385467,1103802,2021-07-01,Senate,"Do pass, but first be re-referred to the Committee on [Appropriations]",5,0,0,0,5
1385467,1106144,2021-08-16,Senate,"Placed on suspense file",7,0,0,0,7
1385467,1106649,2021-08-26,Senate,"Do pass",7,0,0,0,7
1385467,1108056,2021-09-08,Senate,"Assembly 3rd Reading AB45 Aguiar-Curry et al. By Allen Urgency Clause",29,2,0,9,40
1385467,1108417,2021-09-09,Assembly,"AB 45 Aguiar-Curry Concurrence in Senate Amendments",64,3,0,13,80
1385468,1054735,2021-04-15,Senate,"Do pass, but first be re-referred to the Committee on [Governance and Finance]",7,2,0,0,9
1385468,1060850,2021-04-22,Senate,"Do pass as amended, but first amend, and re-refer to the Committee on [Appropriations]",5,0,0,0,5
1385468,1075292,2021-05-10,Senate,"Placed on suspense file",7,0,0,0,7
1385468,1081390,2021-05-20,Senate,"Do pass",5,2,0,0,7
1385468,1086120,2021-05-26,Senate,"Senate 3rd Reading SB9 Atkins et al",28,6,6,0,40
1385468,1096094,2021-06-09,Assembly,"Do pass and be re-referred to the Committee on [Housing and Community Development]",5,1,2,0,8
1385468,1100292,2021-06-22,Assembly,"Do pass and be re-referred to the Committee on [Appropriations]",5,1,2,0,8
1385468,1106334,2021-08-19,Assembly,"Do pass",12,1,0,3,16
1385468,1106619,2021-08-26,Assembly,"SB 9 Atkins Senate Third Reading By Robert Rivas",45,19,0,15,79
1385468,1107136,2021-08-30,Senate,"Unfinished Business SB9 Atkins et al. Concurrence",28,7,0,5,40
1385470,1054592,2021-04-15,Assembly,"Do pass and be re-referred to the Committee on [Appropriations] with recommendation: To Consent Calendar",13,0,0,0,13
1385470,1081908,2021-05-20,Assembly,"Do pass",16,0,0,0,16
1385470,1092914,2021-06-01,Assembly,"AB 74 Lorena Gonzalez Assembly Third Reading",78,0,1,0,79
1385470,1104667,2021-07-12,Senate,"Do pass as amended, but first amend, and re-refer to the Committee on [Appropriations]",12,0,2,0,14
1385470,1106053,2021-08-16,Senate,"Placed on suspense file",7,0,0,0,7
1385470,1107008,2021-08-26,Senate,"Do pass as amended",5,1,0,1,7
1385470,1108095,2021-09-08,Senate,"Assembly 3rd Reading AB74 Lorena Gonzalez et a By Hueso",37,0,0,3,40
1385470,1108287,2021-09-09,Assembly,"With recommendation: That Senate amendments be concurred in",11,0,0,2,13
1385470,1108288,2021-09-09,Assembly,"AB 74 GONZALEZ Concurrence in Senate Amendments",72,4,0,4,80
1385471,1047468,2021-04-06,Assembly,"Do pass and be re-referred to the Committee on [Appropriations]",2,5,1,0,8
1385472,1029568,2021-03-16,Senate,"Do pass, but first be re-referred to the Committee on [Housing]",8,0,1,0,9
1385472,1066696,2021-04-29,Senate,"Do pass as amended, but first amend, and re-refer to the Committee on [Appropriations]",8,0,1,0,9
1385472,1078756,2021-05-17,Senate,"Placed on suspense file",7,0,0,0,7
1385472,1081504,2021-05-20,Senate,"Do pass",7,0,0,0,7
1385472,1087626,2021-05-28,Senate,"Senate 3rd Reading SB63 Stern",38,0,2,0,40
1385472,1100797,2021-06-23,Assembly,"Do pass and be re-referred to the Committee on [Housing and Community Development]",11,0,0,0,11
1385472,1104621,2021-07-12,Assembly,"Do pass and be re-referred to the Committee on [Appropriations]",8,0,0,0,8
1385472,1106575,2021-08-26,Assembly,"Do pass as amended",12,0,0,4,16
1385472,1108611,2021-09-10,Senate,"Unfinished Business SB63 Stern et al. Concurrence",37,0,0,3,40
1385472,1108612,2021-09-10,Assembly,"SB 63 Stern Senate Third Reading By Friedman",73,0,0,7,80
1385473,1027196,2021-03-11,Senate,"Do pass",5,0,0,0,5
1385473,1031899,2021-03-18,Senate,"Senate 3rd Reading SB60 Glazer et al",32,5,3,0,40
1385473,1096127,2021-06-09,Assembly,"Do pass",8,0,0,0,8
1385473,1107204,2021-08-30,Assembly,"SB 60 Glazer Third Reading Urgency By Bauer-Kahan",63,9,0,7,79
1385473,1107506,2021-09-01,Senate,"Unfinished Business SB60 Glazer et al. Urgency Clause Concurrence",34,4,0,2,40
1385475,1053562,2021-04-14,Senate,"Do pass, but first be re-referred to the Committee on [Human Services]",11,0,0,0,11
1385475,1078800,2021-05-17,Senate,"Placed on suspense file",7,0,0,0,7
1385475,1081904,2021-05-20,Senate,"Do pass",5,2,0,0,7
1385475,1083844,2021-05-24,Senate,"Senate 3rd Reading SB65 Skinner et al",31,7,2,0,40
1385475,1100823,2021-06-22,Assembly,"Do pass and be re-referred to the Committee on [Human Services]",11,2,2,0,15
1385475,1103501,2021-06-30,Assembly,"Do pass and be re-referred to the Committee on [Appropriations]",6,1,1,0,8
1385475,1106550,2021-08-26,Assembly,"Do pass as amended",12,3,0,1,16
1385475,1108441,2021-09-09,Assembly,"SB 65 Skinner Senate Third Reading By Burke",77,0,0,3,80
1385475,1108524,2021-09-10,Senate,"Unfinished Business SB65 Skinner et al. Concurrence",31,5,0,4,40
1385476,1064126,2021-04-26,Assembly,"Do pass and be re-referred to the Committee on [Appropriations]",11,4,0,0,15
1385476,1126343,2022-01-20,Assembly,"Do pass as amended",12,3,0,1,16
1385476,1131275,2022-01-31,Assembly,"AB 30 Kalra Assembly Third Reading",54,18,0,4,76
1385476,1211868,2022-06-01,Senate,"Do pass as amended, but first amend, and re-refer to the Committee on [Appropriations]",8,0,0,1,9
1385476,1217067,2022-06-20,Senate,"Placed on suspense file",4,0,0,3,7
1385476,1224031,2022-08-11,Senate,"Do pass as amended",7,0,0,0,7
1385476,1224712,2022-08-24,Senate,"Assembly 3rd Reading AB30 Kalra et al. By Hueso",40,0,0,0,40
1385476,1225179,2022-08-30,Assembly,"With recommendation: That Senate amendments be concurred in",10,2,0,3,15
1385476,1225462,2022-08-31,Assembly,"AB 30 Kalra Concurrence in Senate Amendments",64,11,0,5,80
1385477,1054620,2021-04-15,Assembly,"Do pass and be re-referred to the Committee on [Appropriations]",6,1,0,0,7
1385477,1081572,2021-05-20,Assembly,"Do pass",12,4,0,0,16
1385477,1087020,2021-05-27,Assembly,"AB 37 Berman Assembly Third Reading Amend By GALLAGHER Set #1 Motion to Lay on the Table By REYES",54,18,6,0,78
1385477,1087021,2021-05-27,Assembly,"AB 37 Berman Assembly Third Reading Amend By SEYARTO Set #2 Motion to Lay on the Table By REYES",56,19,3,0,78
1385477,1087022,2021-05-27,Assembly,"AB 37 Berman Assembly Third Reading",59,16,3,0,78
1385477,1104627,2021-07-12,Senate,"Do pass as amended, but first amend, and re-refer to the Committee on [Appropriations]",4,1,0,0,5
1385477,1106243,2021-08-16,Senate,"Placed on suspense file",7,0,0,0,7
1385477,1106627,2021-08-26,Senate,"Do pass as amended",5,2,0,0,7
1385477,1107632,2021-09-02,Senate,"Assembly 3rd Reading AB37 Berman et al. By Umberg",30,7,0,3,40
1385477,1107827,2021-09-03,Assembly,"AB 37 Berman Concurrence in Senate Amendments",60,17,0,2,79
1385478,1026103,2021-03-10,Senate,"Do pass, but first be re-referred to the Committee on [Appropriations]",9,2,0,0,11
1385478,1033622,2021-03-22,Senate,"Placed on suspense file",7,0,0,0,7
1385478,1081649,2021-05-20,Senate,"Do pass as amended",5,2,0,0,7
1385478,1090385,2021-06-02,Senate,"Senate 3rd Reading SB56 Durazo et al",29,7,4,0,40
1385478,1100819,2021-06-22,Assembly,"Do pass and be re-referred to the Committee on [Appropriations]",11,3,1,0,15
1385480,1065106,2021-04-27,Assembly,"Do pass as amended and be re-referred to the Committee on [Appropriations]",7,1,0,0,8
1385481,1027160,2021-03-11,Senate,"Do pass, but first be re-referred to the Committee on [Housing]",5,0,0,0,5
1385481,1066787,2021-04-29,Senate,"Do pass, but first be re-referred to the Committee on [Appropriations]",8,0,1,0,9
1385481,1075321,2021-05-10,Senate,"Placed on suspense file",7,0,0,0,7
1385481,1081603,2021-05-20,Senate,"Do pass",6,1,0,0,7
1385481,1083801,2021-05-24,Senate,"Senate 3rd Reading SB6 Caballero et al",32,2,6,0,40
1385481,1220782,2022-06-29,Assembly,"Do pass and be re-referred to the Committee on [Appropriations]",6,1,0,1,8
1385481,1223733,2022-08-11,Assembly,"Do pass as amended",12,2,0,2,16
1385481,1225067,2022-08-29,Assembly,"SB 6 Caballero Senate Third Reading By Wicks",67,0,0,13,80
1385481,1225599,2022-08-29,Senate,"Unfinished Business SB6 Caballero et al. Concurrence",34,0,0,6,40
1385482,1051995,2021-04-13,Senate,"Do pass, but first be re-referred to the Committee on [Judiciary]",4,0,1,0,5
1385482,1065265,2021-04-27,Senate,"Do pass as amended, but first amend, and re-refer to the Committee on [Appropriations]",7,2,2,0,11
1385482,1075353,2021-05-10,Senate,"Placed on suspense file",7,0,0,0,7
1385482,1081723,2021-05-20,Senate,"Do pass as amended",5,2,0,0,7
1385482,1086115,2021-05-26,Senate,"Senate 3rd Reading SB2 Bradford et al",26,9,5,0,40
1385482,1104301,2021-07-06,Assembly,"Do pass and be re-referred to the Committee on [Public Safety]",8,2,1,0,11
1385482,1104734,2021-07-13,Assembly,"Do pass and be re-referred to the Committee on [Appropriations]",6,2,0,0,8
1385482,1106745,2021-08-26,Assembly,"Do pass as amended",12,4,0,0,16
1385482,1107785,2021-09-03,Assembly,"SB 2 Bradford Senate Third Reading By Akilah Weber",49,21,0,9,79
1385482,1108152,2021-09-08,Senate,"Unfinished Business SB2 Bradford et al. Concurrence",28,9,0,3,40
1385484,1059317,2021-04-20,Assembly,"Do pass and be re-referred to the Committee on [Public Employment and Retirement]",6,0,2,0,8
1385484,1066826,2021-04-29,Assembly,"Do pass as amended and be re-referred to the Committee on [Appropriations]",6,0,1,0,7
1385486,983023,2020-12-07,Assembly,"HR 3 RENDON Assembly Third Reading By REYES",75,0,5,0,80
1385487,1029566,2021-03-16,Senate,"Do pass as amended, but first amend, and re-refer to the Committee on [Labor, Public Employment and Retirement ]",4,0,1,0,5
1385487,1064089,2021-04-26,Senate,"Do pass, but first be re-referred to the Committee on [Appropriations]",5,0,0,0,5
1385487,1075304,2021-05-10,Senate,"Placed on suspense file",7,0,0,0,7
1385487,1082077,2021-05-20,Senate,"Do pass",7,0,0,0,7
1385487,1087616,2021-05-28,Senate,"Senate 3rd Reading SB39 Grove et al. Urgency Clause",38,0,2,0,40
1385487,1099113,2021-06-17,Assembly,"Do pass as amended and be re-referred to the Committee on [Insurance]",10,0,0,0,10
1385487,1101649,2021-06-24,Assembly,"Do pass and be re-referred to the Committee on [Appropriations]",14,0,0,0,14
1385488,1038741,2021-03-22,Senate,"Do pass, but first be re-referred to the Committee on [Judiciary]",4,0,1,0,5
1385488,1047600,2021-04-06,Senate,"Do pass as amended, but first amend, and re-refer to the Committee on [Appropriations]",9,2,0,0,11
1385488,1056407,2021-04-19,Senate,"Placed on suspense file",7,0,0,0,7
1385488,1081727,2021-05-20,Senate,"Do pass",5,2,0,0,7
1385488,1083872,2021-05-24,Senate,"Senate 3rd Reading SB62 Durazo et al",29,9,2,0,40
1385488,1095044,2021-06-08,Assembly,"Do pass and be re-referred to the Committee on [Judiciary]",5,2,0,0,7
1385488,1100278,2021-06-22,Assembly,"Do pass and be re-referred to the Committee on [Appropriations]",8,3,0,0,11
1385488,1106994,2021-08-26,Assembly,"Do pass as amended",12,4,0,0,16
1385488,1107821,2021-09-03,Assembly,"SB 62 Durazo Senate Third Reading By Lorena Gonzalez Amend By GONZALEZ Set #1",54,17,0,8,79
1385488,1108014,2021-09-08,Assembly,"SB 62 Durazo Senate Third Reading By Lorena Gonzalez",50,19,0,11,80
1385488,1108604,2021-09-10,Senate,"Unfinished Business SB62 Durazo et al. Concurrence",26,10,0,4,40
1385491,1123754,2022-01-12,Senate,"Do pass, but first be re-referred to the Committee on [Appropriations]",7,0,0,0,7
1385491,1124822,2022-01-18,Senate,"Placed on suspense file",6,0,0,1,7
1385491,1126316,2022-01-20,Senate,"Do pass as amended",7,0,0,0,7
1385491,1129895,2022-01-27,Senate,"Senate 3rd Reading SB3 Caballero et al",36,0,0,4,40
1385492,1056317,2021-04-19,Assembly,"Do pass and be re-referred to the Committee on [Appropriations]",15,0,0,0,15
1385492,1073334,2021-05-05,Assembly,"Do pass",14,1,1,0,16
1385492,1075380,2021-05-10,Assembly,"AB 43 Friedman Assembly Third Reading",65,3,10,0,78
1385492,1104694,2021-07-13,Senate,"Do pass as amended, but first amend, and re-refer to the Committee on [Appropriations]",14,1,2,0,17
1385492,1108018,2021-09-08,Senate,"Assembly 3rd Reading AB43 Friedman et al. By Gonzalez",30,5,0,5,40
1385492,1108268,2021-09-09,Assembly,"AB 43 Friedman Concurrence in Senate Amendments",68,5,0,7,80
1385493,1031873,2021-03-18,Senate,"Do pass, but first be re-referred to the Committee on [Appropriations]",7,1,1,0,9
1385493,1044978,2021-04-05,Senate,"Placed on suspense file",7,0,0,0,7
1385493,1082132,2021-05-20,Senate,"Do pass as amended",5,2,0,0,7
1385493,1089547,2021-06-01,Senate,"Senate 3rd Reading SB15 Portantino et al",38,0,2,0,40
1385495,1057699,2021-04-19,Assembly,"Do pass and be re-referred to the Committee on [Housing and Community Development]",7,4,0,0,11
1385495,1067617,2021-04-29,Assembly,"Do pass as amended and be re-referred to the Committee on [Appropriations]",5,2,1,0,8
1385495,1081387,2021-05-20,Assembly,"Do pass as amended",12,4,0,0,16
1385498,1054637,2021-04-15,Assembly,"Do pass and be re-referred to the Committee on [Governmental Organization]",5,1,1,0,7
1385498,1060868,2021-04-22,Assembly,"Do pass and be re-referred to the Committee on [Appropriations]",14,4,4,0,22
1385499,993690,2021-02-01,Senate,"Do pass, but first be re-referred to the Committee on [Appropriations]",15,0,2,0,17
1385499,996626,2021-02-04,Senate,"Do pass",4,0,2,0,6
1385499,1005313,2021-02-12,Senate,"Senate 3rd Reading SB51 Durazo et al. Urgency Clause",32,0,7,0,39
1385499,1029555,2021-03-15,Assembly,"Do pass and be re-referred to the Committee on [Appropriations]",8,0,0,0,8
1385499,1031886,2021-03-18,Assembly,"Do pass",16,0,0,0,16
1385499,1104630,2021-07-12,Assembly,"SB 51 Durazo Third Reading Urgency By Carrillo",63,10,6,0,79
1385499,1105125,2021-07-15,Senate,"Unfinished Business SB51 Durazo et al. Urgency Clause Concurrence",32,7,1,0,40
1385500,1036434,2021-03-23,Assembly,"Do pass as amended, and be re-referred to the Committee on [Appropriations] with recommendation: To Consent Calendar",8,0,0,0,8
1385500,1081642,2021-05-20,Assembly,"Do pass as amended",12,0,4,0,16
1385500,1092922,2021-06-01,Assembly,"AB 57 Gabriel Assembly Third Reading",79,0,0,0,79
1385500,1102851,2021-06-29,Senate,"Do pass, but first be re-referred to the Committee on [Appropriations] with the recommendation: To Consent Calendar",5,0,0,0,5
1385500,1105117,2021-07-15,Senate,"Placed on suspense file",7,0,0,0,7
1385500,1106861,2021-08-26,Senate,"Do pass as amended",7,0,0,0,7
1385500,1108215,2021-09-08,Senate,"Special Consent AB57 Gabriel et al. By Min",38,0,0,2,40
1385500,1108330,2021-09-09,Assembly,"AB 57 Gabriel Concurrence in Senate Amendments",78,0,0,2,80
1385501,1025096,2021-03-09,Senate,"Do pass, but first be re-referred to the Committee on [Appropriations]",14,0,0,0,14
1385501,1033657,2021-03-22,Senate,"Placed on suspense file",7,0,0,0,7
1385501,1081537,2021-05-20,Senate,"Do pass",7,0,0,0,7
1385501,1089498,2021-06-01,Senate,"Special Consent SB19 Glazer et al",39,0,1,0,40
1385501,1102850,2021-06-29,Assembly,"Do pass and be re-referred to the Committee on [Appropriations]",21,0,1,0,22
1385501,1106704,2021-08-26,Assembly,"Do pass as amended",12,0,0,4,16
1385501,1107512,2021-09-01,Assembly,"SB 19 Glazer Senate Third Reading By Bauer-Kahan",76,0,0,3,79
1385501,1107671,2021-09-02,Senate,"Unfinished Business SB19 Glazer et al. Concurrence",39,0,0,1,40
1385502,1050779,2021-04-12,Senate,"Do pass, but first be re-referred to the Committee on [Governmental Organization]",14,0,0,0,14
1385502,1057695,2021-04-20,Senate,"Do pass as amended, but first amend, and re-refer to the Committee on [Appropriations]",11,0,4,0,15
1385502,1078808,2021-05-17,Senate,"Placed on suspense file",7,0,0,0,7
1385502,1081958,2021-05-20,Senate,"Do pass",7,0,0,0,7
1385502,1083807,2021-05-24,Senate,"Senate 3rd Reading SB28 Caballero et al",36,0,4,0,40
1385502,1100769,2021-06-23,Assembly,"Do pass as amended and be re-referred to the Committee on [Privacy and Consumer Protection]",9,0,4,0,13
1385502,1103798,2021-07-01,Assembly,"Do pass as amended and be re-referred to the Committee on [Appropriations]",11,0,0,0,11
1385502,1106691,2021-08-26,Assembly,"Do pass as amended",12,0,0,4,16
1385502,1108160,2021-09-08,Assembly,"SB 28 Caballero Senate Third Reading By Salas",74,0,0,6,80
1385502,1108390,2021-09-09,Senate,"Unfinished Business SB28 Caballero et al. Concurrence",38,0,0,2,40
1385503,983025,2020-12-07,Assembly,"HR 1 COOLEY Assembly Third Reading",56,19,5,0,80
1385505,1062745,2021-04-26,Senate,"Do pass, but first be re-referred to the Committee on [Appropriations]",7,0,0,0,7
1385505,1075281,2021-05-10,Senate,"Placed on suspense file",7,0,0,0,7
1385505,1081896,2021-05-20,Senate,"Do pass",7,0,0,0,7
1385505,1089557,2021-06-01,Senate,"Special Consent SB37",39,0,1,0,40
1385505,1098619,2021-06-16,Assembly,"Do pass and be re-referred to the Committee on [Natural Resources]",6,3,0,0,9
1385505,1104485,2021-07-07,Assembly,"Do pass and be re-referred to the Committee on [Appropriations]",7,1,3,0,11
1385505,1107005,2021-08-26,Assembly,"Do pass as amended",12,4,0,0,16
1385506,1048963,2021-04-08,Assembly,"Do pass and be re-referred to the Committee on [Appropriations]",5,2,0,0,7
1385507,1053548,2021-04-14,Assembly,"Do pass and be re-referred to the Committee on [Appropriations]",11,0,0,0,11
1385508,1059221,2021-04-21,Assembly,"Do pass and be re-referred to the Committee on [Appropriations]",8,0,0,0,8
1385509,1048962,2021-04-08,Assembly,"Do pass and be re-referred to the Committee on [Appropriations]",9,0,2,0,11
1385509,1081577,2021-05-20,Assembly,"Do pass as amended",12,3,1,0,16
1385509,1092920,2021-06-01,Assembly,"AB 13 Chau Assembly Third Reading",52,16,11,0,79
1385509,1100316,2021-06-22,Senate,"Do pass as amended, but first amend, and re-refer to the Committee on [Judiciary]",8,3,4,0,15
1385509,1104892,2021-07-13,Senate,"Do pass as amended, but first amend, and re-refer to the Committee on [Appropriations]",8,1,2,0,11
1385509,1106110,2021-08-16,Senate,"Placed on suspense file",7,0,0,0,7
1385509,1223292,2022-08-08,Senate,"Do pass",6,0,0,1,7
1385509,1224860,2022-08-24,Senate,"Assembly 3rd Reading AB13 Holden By Portantino Urgency Clause",34,0,0,6,40
1385509,1224909,2022-08-25,Assembly,"AB 13 Holden Concurrence - Urgency Added",71,0,0,9,80
1385513,1123305,2022-01-11,Assembly,"Do pass and be re-referred to the Committee on [Appropriations] with recommendation: To Consent Calendar",15,0,0,0,15
1385516,1028407,2021-03-15,Senate,"Do pass as amended, but first amend, and re-refer to the Committee on [Rules]",4,0,1,0,5
1385516,1051895,2021-04-13,Senate,"Do pass, but first be re-referred to the Committee on [Appropriations]",4,0,1,0,5
1385516,1075338,2021-05-10,Senate,"Senate 3rd Reading SB35 Umberg",29,2,9,0,40
1385516,1098629,2021-06-16,Assembly,"Do pass as amended and be re-referred to the Committee on [Public Safety]",6,1,0,0,7
1385516,1104764,2021-07-13,Assembly,"Do pass as amended and be re-referred to the Committee on [Appropriations]",8,0,0,0,8
1385516,1106310,2021-08-19,Assembly,"Do pass",16,0,0,0,16
1385516,1106718,2021-08-26,Assembly,"SB 35 Umberg Senate Third Reading By Berman Amendment Set #1",59,15,0,5,79
1385516,1107310,2021-08-31,Assembly,"Do pass",6,0,0,1,7
1385516,1107683,2021-09-02,Assembly,"SB 35 Umberg Senate Third Reading By Berman",61,13,0,5,79
1385516,1108161,2021-09-08,Senate,"That the Assembly amendments be concurred in",4,0,0,1,5
1385516,1108362,2021-09-09,Senate,"Unfinished Business SB35 Umberg et al. Concurrence",29,5,0,6,40
1385517,1036522,2021-03-23,Assembly,"Do pass and be re-referred to the Committee on [Appropriations]",8,0,0,0,8
1385518,1048892,2021-04-08,Assembly,"Do pass and be re-referred to the Committee on [Insurance] with recommendation: To Consent Calendar",11,0,0,0,11
1385518,1066336,2021-04-29,Assembly,"Do pass and be re-referred to the Committee on [Appropriations] with recommendation: To Consent Calendar",13,0,0,0,13
1385518,1076922,2021-05-12,Assembly,"Do pass. To Consent Calendar",16,0,0,0,16
1385518,1081855,2021-05-20,Assembly,"AB 12 Seyarto Consent Calendar Second Day",76,0,2,0,78
1385518,1100261,2021-06-22,Senate,"Do pass, but first be re-referred to the Committee on [Judiciary] with the recommendation: To Consent Calendar",15,0,0,0,15
1385518,1103408,2021-06-29,Senate,"Do pass, but first be re-referred to the Committee on [Appropriations] with the recommendation: To Consent Calendar",11,0,0,0,11
1385518,1107194,2021-08-30,Senate,"Consent Calendar AB12 Seyarto et al. Urgency Clause",39,0,0,1,40
1385521,1065145,2021-04-27,Assembly,"Do pass",6,2,0,0,8
1385521,1091724,2021-06-03,Assembly,"AB 89 Jones-Sawyer Assembly Third Reading",49,13,17,0,79
1385521,1104771,2021-07-13,Senate,"Do pass as amended, but first amend, and re-refer to the Committee on [Appropriations]",5,0,0,0,5
1385521,1106183,2021-08-16,Senate,"Placed on suspense file",7,0,0,0,7
1385521,1106892,2021-08-26,Senate,"Do pass as amended",7,0,0,0,7
1385521,1108547,2021-09-10,Senate,"Assembly 3rd Reading AB89 Jones-Sawyer et al. By Portantino",32,3,0,5,40
1385521,1108548,2021-09-10,Assembly,"AB 89 Jones-Sawyer Concurrence in Senate Amendments",54,17,0,9,80
1385522,1048950,2021-04-07,Assembly,"Do pass and be re-referred to the Committee on [Higher Education]",5,0,2,0,7
1385522,1060911,2021-04-22,Assembly,"Do pass and be re-referred to the Committee on [Appropriations]",10,0,2,0,12
1385522,1081598,2021-05-20,Assembly,"Do pass as amended and be re-referred to the Committee on [Rules]",13,1,2,0,16
1385522,1090392,2021-06-02,Assembly,"AB 75 O'Donnell Third Reading Urgency",69,1,9,0,79
1385523,988118,2021-01-15,Assembly,"AB 81 Ting Assembly Third Reading",48,13,19,0,80
1385523,1009564,2021-02-18,Senate,"Do pass",16,0,2,0,18
1385523,1011709,2021-02-22,Senate,"Assembly 3rd Reading AB81 Ting By Skinner",37,0,2,0,39
1385523,1011710,2021-02-22,Assembly,"AB 81 TING Concurrence in Senate Amendments",77,0,2,0,79
1385524,1031897,2021-03-18,Senate,"Do pass as amended, but first amend, and re-refer to the Committee on [Governance and Finance]",7,1,1,0,9
1385524,1060830,2021-04-22,Senate,"Do pass as amended, but first amend, and re-refer to the Committee on [Appropriations]",4,1,0,0,5
1385524,1075312,2021-05-10,Senate,"Placed on suspense file",7,0,0,0,7
1385524,1081398,2021-05-20,Senate,"Do pass",6,1,0,0,7
1385524,1090481,2021-06-02,Senate,"Senate 3rd Reading SB10 Wiener et al",27,7,6,0,40
1385524,1100294,2021-06-22,Assembly,"Do pass as amended and be re-referred to the Committee on [Local Government]",6,1,1,0,8
1385524,1103765,2021-06-30,Assembly,"Do pass as amended",6,1,1,0,8
1385524,1106421,2021-08-23,Assembly,"SB 10 Wiener Senate Third Reading By Chiu",44,12,0,23,79
1385524,1107205,2021-08-30,Senate,"Unfinished Business SB10 Wiener et al. Concurrence",28,6,0,6,40
1385526,1035260,2021-03-23,Assembly,"Do pass as amended and be re-referred to the Committee on [Arts, Entertainment, Sports, Tourism, and Internet Media]",8,2,1,0,11
1385526,1062739,2021-04-26,Assembly,"Do pass as amended and be re-referred to the Committee on [Appropriations]",4,1,2,0,7
1385526,1081953,2021-05-20,Assembly,"Do pass",12,3,1,0,16
1385526,1092924,2021-06-01,Assembly,"AB 35 Chau Assembly Third Reading",59,16,4,0,79
1385526,1199994,2022-05-03,Senate,"Do pass",11,0,0,0,11
1385526,1200486,2022-05-05,Senate,"Assembly 2nd Reading AB35 Reyes et al. By Umberg",37,1,0,2,40
1385526,1203373,2022-05-11,Assembly,"With recommendation: That Senate amendments be concurred in",9,0,0,1,10
1385526,1204128,2022-05-12,Assembly,"AB 35 Reyes Concurrence in Senate Amendments",66,0,0,12,78
1385528,1051893,2021-04-13,Assembly,"Do pass and be re-referred to the Committee on [Appropriations]",11,3,1,0,15
1385528,1081519,2021-05-20,Assembly,"Do pass",12,4,0,0,16
1385528,1092903,2021-06-01,Assembly,"AB 4 Arambula Assembly Third Reading",58,18,3,0,79
1385528,1098633,2021-06-16,Senate,"Do pass, but first be re-referred to the Committee on [Appropriations]",8,2,1,0,11
1385528,1104152,2021-07-05,Senate,"Placed on suspense file",6,0,1,0,7
1385529,1011730,2021-02-22,Senate,"Do pass, but first be re-referred to the Committee on [Appropriations]",5,0,2,0,7
1385529,1016174,2021-02-25,Senate,"Do pass",6,0,0,0,6
1385529,1018524,2021-03-01,Senate,"Senate 3rd Reading SB7 Atkins et al. Urgency Clause",34,0,5,0,39
1385529,1065097,2021-04-28,Assembly,"Do pass and be re-referred to the Committee on [Appropriations]",9,1,1,0,11
1385529,1073368,2021-05-05,Assembly,"Do pass",16,0,0,0,16
1385529,1075376,2021-05-10,Assembly,"SB 7 Atkins Third Reading Urgency By RIVAS, R",71,2,5,0,78
1385530,1023839,2021-03-08,Senate,"Do pass as amended, but first amend, and re-refer to the Committee on [Appropriations]",11,1,2,0,14
1385530,1091714,2021-06-03,Senate,"Senate 3rd Reading SB48 Lim贸n et al",38,0,2,0,40
1385530,1104288,2021-07-06,Assembly,"Do pass as amended and be re-referred to the Committee on [Appropriations]",15,0,0,0,15
1385530,1106636,2021-08-26,Assembly,"Do pass",16,0,0,0,16
1385530,1107626,2021-09-02,Assembly,"SB 48 Lim贸n Senate Third Reading By Nazarian",77,0,0,2,79
1385530,1108007,2021-09-08,Senate,"That the Assembly amendments be concurred in",8,1,0,2,11
1385530,1108458,2021-09-09,Senate,"Unfinished Business SB48 Lim贸n et al. Concurrence",31,4,0,5,40
1385531,1026121,2021-03-10,Senate,"Do pass as amended, but first amend, and re-refer to the Committee on [Appropriations]",7,0,0,0,7
1385531,1044946,2021-04-05,Senate,"Placed on suspense file",7,0,0,0,7
1385531,1081916,2021-05-20,Senate,"Do pass",7,0,0,0,7
1385531,1120727,2022-01-06,Senate,"Senate 3rd Reading SB20 Dodd et al",32,0,0,8,40
1385531,1215812,2022-06-14,Assembly,"Do pass and be re-referred to the Committee on [Appropriations]",12,0,0,0,12
1385531,1220658,2022-06-29,Assembly,"Do pass. To Consent Calendar",14,0,0,2,16
1385531,1223020,2022-08-04,Assembly,"SB 20 Dodd Consent Calendar Second Day Regular Session",76,0,0,4,80
1385531,1223227,2022-08-08,Senate,"Unfinished Business SB20 Dodd et al. Concurrence",37,0,0,3,40
1385534,1023848,2021-03-08,Senate,"Do pass, but first be re-referred to the Committee on [Appropriations]",5,0,0,0,5
1385534,1033613,2021-03-22,Senate,"Placed on suspense file",7,0,0,0,7
1385534,1081558,2021-05-20,Senate,"Do pass as amended",6,1,0,0,7
1385535,1097041,2021-06-10,Assembly,"Be adopted. To third reading",12,0,0,0,12
1385535,1105157,2021-07-15,Senate,"Special Consent ACR1",38,0,2,0,40
1385536,984522,2021-01-11,Assembly,"Be adopted. To Consent Calendar",11,0,1,0,12
1385536,988129,2021-01-15,Assembly,"HR 4 Stone Consent Calendar Second Day",66,0,14,0,80
1385537,1054680,2021-04-15,Senate,"Do pass, but first be re-referred to the Committee on [Appropriations]",4,1,0,0,5
1385537,1068241,2021-05-03,Senate,"Placed on suspense file",6,0,1,0,7
1385538,1065311,2021-04-28,Assembly,"Do pass and be re-referred to the Committee on [Appropriations]",7,0,1,0,8
1385538,1080392,2021-05-19,Assembly,"Do pass. To Consent Calendar",15,0,1,0,16
1385538,1087077,2021-05-27,Assembly,"AB 36 Gallagher Consent Calendar Second Day Regular Session",75,0,3,0,78
1385538,1099168,2021-06-17,Senate,"Do pass, but first be re-referred to the Committee on [Appropriations]",5,0,0,0,5
1385538,1106887,2021-08-26,Senate,"Assembly 3rd Reading AB36 Gallagher et al. By Nielsen",36,0,0,4,40
1385539,988126,2021-01-15,Assembly,"AB 80 Ting Assembly Third Reading",48,13,19,0,80
1385539,990807,2021-01-26,Senate,"Do pass",11,0,7,0,18
1385539,1009550,2021-02-18,Senate,"Do pass",17,0,1,0,18
1385539,1056329,2021-04-19,Senate,"Assembly 3rd Reading AB80 Burke et al. By Skinner Urgency Clause",37,0,3,0,40
1385539,1062781,2021-04-26,Assembly,"With recommendation: That Senate amendments be concurred in",9,0,2,0,11
1385539,1062782,2021-04-26,Assembly,"AB 80 BURKE Concurrence in Senate Amendments",75,0,3,0,78
1385541,1066692,2021-04-29,Senate,"Be adopted, but first be re-referred to the Committee on [Elections and Constitutional Amendments] with recommendation: To Consent Calendar",9,0,0,0,9
1385541,1102468,2021-06-28,Senate,"Be adopted, but first be re-referred to the Committee on [Appropriations] with recommendation: To Consent Calendar",5,0,0,0,5
1385541,1105037,2021-07-15,Senate,"Placed on suspense file",7,0,0,0,7
1385541,1106765,2021-08-26,Senate,"Be adopted",7,0,0,0,7
1385541,1128987,2022-01-26,Senate,"Senate 3rd Reading SCA2 Allen et al",37,0,0,3,40
1385541,1203345,2022-05-11,Assembly,"Be adopted and re-referred to the Committee on [Appropriations]",8,0,0,0,8
1385541,1223672,2022-08-11,Assembly,"Be adopted",15,0,0,1,16
1385541,1225412,2022-08-31,Assembly,"SCA 2 Allen Senate Third Reading By KALRA",73,0,0,7,80
1385542,1025103,2021-03-09,Senate,"Do pass as amended, but first amend, and re-refer to the Committee on [Appropriations]",9,2,0,0,11
1385542,1033661,2021-03-22,Senate,"Placed on suspense file",7,0,0,0,7
1385542,1081769,2021-05-20,Senate,"Do pass as amended",5,2,0,0,7
1385543,1036501,2021-03-24,Assembly,"Do pass as amended and be re-referred to the Committee on [Appropriations]",8,1,2,0,11
1385543,1082092,2021-05-20,Assembly,"Do pass as amended",13,3,0,0,16
1385543,1092885,2021-06-01,Assembly,"AB 66 Boerner Horvath Assembly Third Reading",70,3,6,0,79
1385543,1098631,2021-06-16,Senate,"Do pass, but first be re-referred to the Committee on [Judiciary]",7,0,0,0,7
1385543,1104401,2021-07-06,Senate,"Do pass as amended, but first amend, and re-refer to the Committee on [Appropriations]",11,0,0,0,11
1385543,1106141,2021-08-16,Senate,"Placed on suspense file",7,0,0,0,7
1385543,1106610,2021-08-26,Senate,"Do pass",7,0,0,0,7
1385543,1107476,2021-09-01,Senate,"Assembly 3rd Reading AB66 Boerner Horvath et a By Laird",39,0,0,1,40
1385543,1107641,2021-09-02,Assembly,"AB 66 Boerner Horvath Concurrence in Senate Amendments",69,3,0,7,79
1385544,1049001,2021-04-08,Assembly,"Do pass as amended and be re-referred to the Committee on [Insurance]",11,0,0,0,11
1385544,1066713,2021-04-29,Assembly,"Do pass and be re-referred to the Committee on [Appropriations] with recommendation: To Consent Calendar",13,0,0,0,13
1385544,1081654,2021-05-20,Assembly,"Do pass",16,0,0,0,16
1385544,1086990,2021-05-27,Assembly,"AB 56 Salas Assembly Third Reading",77,0,1,0,78
1385544,1100357,2021-06-21,Senate,"Do pass, but first be re-referred to the Committee on [Judiciary]",5,0,0,0,5
1385544,1103418,2021-06-29,Senate,"Do pass, but first be re-referred to the Committee on [Appropriations] with the recommendation: To Consent Calendar",11,0,0,0,11
1385544,1105115,2021-07-15,Senate,"Placed on suspense file",7,0,0,0,7
1385544,1106725,2021-08-26,Senate,"Do pass",7,0,0,0,7
1385544,1108312,2021-09-09,Senate,"Assembly 3rd Reading AB56 Salas et al. By Laird",38,0,0,2,40
1385544,1108313,2021-09-09,Assembly,"AB 56 SALAS Concurrence in Senate Amendments",77,0,0,3,80
1385545,1029565,2021-03-16,Senate,"Do pass, but first be re-referred to the Committee on [Public Safety] with the recommendation: To Consent Calendar",11,0,0,0,11
1385545,1064122,2021-04-27,Senate,"Do pass as amended, but first amend, and re-refer to the Committee on [Appropriations]",4,0,1,0,5
1385545,1075268,2021-05-10,Senate,"Placed on suspense file",7,0,0,0,7
1385545,1082115,2021-05-20,Senate,"Do pass as amended",7,0,0,0,7
1385545,1131258,2022-01-31,Senate,"Senate 3rd Reading SB53 Leyva et al",36,0,0,4,40
1385545,1214953,2022-06-08,Assembly,"Do pass as amended, and be re-referred to the Committee on [Privacy and Consumer Protection] with recommendation: To Consent Calendar",10,0,0,0,10
1385545,1217318,2022-06-21,Assembly,"Do pass as amended",11,0,0,0,11
1385545,1223914,2022-08-11,Assembly,"Do pass as amended",12,0,0,4,16
1385545,1224241,2022-08-18,Assembly,"SB 53 Leyva Senate Third Reading By Aguiar-Curry",76,0,0,4,80
1385545,1224381,2022-08-22,Senate,"Unfinished Business SB53 Leyva et al. Concurrence",37,0,0,3,40
1385546,1025114,2021-03-09,Senate,"Do pass, but first be re-referred to the Committee on [Appropriations]",13,0,1,0,14
1385546,1066726,2021-04-29,Senate,"Senate 3rd Reading SB52 Dodd et al",36,0,4,0,40
1385546,1104173,2021-07-05,Assembly,"Do pass. To Consent Calendar",7,0,0,0,7
1385546,1107195,2021-08-30,Assembly,"SB 52 Dodd Senate Third Reading By Aguiar-Curry",75,0,0,4,79
1385546,1107405,2021-09-01,Senate,"Unfinished Business SB52 Dodd et al. Concurrence",39,0,0,1,40
1385547,1029559,2021-03-16,Senate,"Do pass as amended, but first amend, and re-refer to the Committee on [Environmental Quality]",7,2,0,0,9
1385547,1050772,2021-04-12,Senate,"Do pass, but first be re-referred to the Committee on [Appropriations]",5,1,1,0,7
1385547,1056338,2021-04-19,Senate,"Placed on suspense file",7,0,0,0,7
1385547,1081971,2021-05-20,Senate,"Do pass",6,1,0,0,7
1385547,1083811,2021-05-24,Senate,"Senate 3rd Reading SB1 Atkins et al",33,5,2,0,40
1385547,1100830,2021-06-23,Assembly,"Do pass as amended and be re-referred to the Committee on [Appropriations]",9,0,2,0,11
1385547,1106776,2021-08-26,Assembly,"Do pass",13,3,0,0,16
1385547,1107524,2021-09-01,Assembly,"SB 1 Atkins Senate Third Reading By Petrie-Norris",60,12,0,7,79
1385547,1107584,2021-09-02,Senate,"Unfinished Business SB1 Atkins et al. Concurrence",33,2,0,5,40
1385549,1036464,2021-03-24,Assembly,"Do pass as amended and be re-referred to the Committee on [Judiciary]",6,3,2,0,11
1385551,1028422,2021-03-15,Senate,"Do pass, but first be re-referred to the Committee on [Judiciary]",7,0,0,0,7
1385551,1053457,2021-04-13,Senate,"Do pass, but first be re-referred to the Committee on [Appropriations]",9,0,2,0,11
1385551,1068252,2021-05-03,Senate,"Placed on suspense file",6,0,1,0,7
1385551,1081461,2021-05-20,Senate,"Do pass",6,0,1,0,7
1385551,1086111,2021-05-26,Senate,"Senate 3rd Reading SB44 Allen et al",37,0,3,0,40
1385551,1100780,2021-06-23,Assembly,"Do pass as amended and be re-referred to the Committee on [Judiciary]",9,1,1,0,11
1385551,1104738,2021-07-13,Assembly,"Do pass as amended and be re-referred to the Committee on [Appropriations]",10,0,1,0,11
1385551,1106924,2021-08-26,Assembly,"Do pass as amended",12,0,0,4,16
1385551,1107664,2021-09-02,Assembly,"SB 44 Allen Senate Third Reading By Carrillo",76,0,0,3,79
1385551,1107782,2021-09-03,Senate,"Unfinished Business SB44 Allen et al. Concurrence",33,0,0,7,40
1385552,1029562,2021-03-16,Senate,"Do pass as amended, but first amend, and re-refer to the Committee on [Appropriations]",5,0,0,0,5
1385552,1045006,2021-04-05,Senate,"Placed on suspense file",7,0,0,0,7
1385552,1081559,2021-05-20,Senate,"Do pass",7,0,0,0,7
1385552,1089589,2021-06-01,Senate,"Special Consent SB23",39,0,1,0,40
1385552,1102810,2021-06-29,Assembly,"Do pass as amended, and be re-referred to the Committee on [Appropriations] with recommendation: To Consent Calendar",8,0,0,0,8
1385552,1106816,2021-08-26,Assembly,"Do pass",16,0,0,0,16
1385552,1107676,2021-09-02,Assembly,"SB 23 Rubio Senate Third Reading By Bauer-Kahan",77,0,0,2,79
1385552,1107817,2021-09-03,Senate,"Unfinished Business SB23 Rubio et al. Concurrence",38,0,0,2,40
1385553,1064120,2021-04-26,Assembly,"Do pass and be re-referred to the Committee on [Appropriations]",6,3,2,0,11
1385555,988130,2021-01-15,Assembly,"AB 83 Ting Assembly Third Reading",48,13,19,0,80
1385555,1009552,2021-02-18,Senate,"Do pass",17,0,1,0,18
1385555,1028430,2021-03-15,Senate,"Do pass",18,0,0,0,18
1385555,1028431,2021-03-15,Senate,"Assembly 3rd Reading AB83 BUDGET (Ting) By Skinner",39,0,1,0,40
1385555,1028432,2021-03-15,Assembly,"AB 83 BUDGET Concurrence in Senate Amendments By TING",75,0,3,0,78
1385556,1059285,2021-04-21,Assembly,"Do pass and be re-referred to the Committee on [Appropriations]",6,0,2,0,8
1385556,1081443,2021-05-20,Assembly,"Do pass as amended",12,0,4,0,16
1385556,1092946,2021-06-01,Assembly,"AB 47 Reyes Assembly Third Reading",61,5,13,0,79
1385556,1104402,2021-07-06,Senate,"Do pass, but first be re-referred to the Committee on [Appropriations]",4,1,0,0,5
1385556,1106216,2021-08-16,Senate,"Placed on suspense file",7,0,0,0,7
1385557,1036542,2021-03-24,Assembly,"Do pass as amended and be re-referred to the Committee on [Natural Resources]",8,4,0,0,12
1385557,1053528,2021-04-14,Assembly,"Do pass and be re-referred to the Committee on [Appropriations]",8,0,3,0,11
1385557,1065237,2021-04-28,Assembly,"Do pass",11,4,1,0,16
1385557,1077566,2021-05-13,Assembly,"AB 39 Chau Assembly Third Reading",50,16,12,0,78
1385557,1096081,2021-06-09,Senate,"Do pass, but first be re-referred to the Committee on [Environmental Quality]",5,1,1,0,7
1385557,1097781,2021-06-14,Senate,"Do pass, but first be re-referred to the Committee on [Appropriations]",5,2,0,0,7
1385557,1099754,2021-06-21,Senate,"Placed on suspense file",7,0,0,0,7
1385557,1106779,2021-08-26,Senate,"Do pass as amended",5,2,0,0,7
1385557,1108026,2021-09-08,Senate,"Assembly 3rd Reading AB39 Chau By Skinner",29,8,0,3,40
1385557,1108223,2021-09-09,Assembly,"AB 39 Chau Concurrence in Senate Amendments",56,12,0,12,80
1385558,1036546,2021-03-24,Senate,"Do pass, but first be re-referred to the Committee on [Human Services]",5,1,1,0,7
1385558,1046217,2021-04-06,Senate,"Do pass, but first be re-referred to the Committee on [Appropriations]",5,0,0,0,5
1385558,1056425,2021-04-19,Senate,"Placed on suspense file",7,0,0,0,7
1385558,1081981,2021-05-20,Senate,"Do pass as amended",7,0,0,0,7
1385558,1089579,2021-06-01,Senate,"Senate 3rd Reading SB50 Lim贸n et al",39,0,1,0,40
1385558,1103400,2021-06-30,Assembly,"Do pass and be re-referred to the Committee on [Education]",8,0,0,0,8
1385558,1104368,2021-07-07,Assembly,"Do pass as amended and be re-referred to the Committee on [Appropriations]",7,0,0,0,7
1385558,1106932,2021-08-26,Assembly,"Do pass as amended",12,0,0,4,16
1385558,1108194,2021-09-08,Assembly,"SB 50 Lim贸n Senate Third Reading By McCarty",80,0,0,0,80
1385558,1108403,2021-09-09,Senate,"Unfinished Business SB50 Lim贸n et al. Concurrence",38,0,0,2,40
1385559,1054754,2021-04-14,Assembly,"Do pass and be re-referred to the Committee on [Transportation]",11,1,1,0,13
1385559,1064158,2021-04-26,Assembly,"Do pass and be re-referred to the Committee on [Appropriations]",11,2,2,0,15
1385559,1082060,2021-05-20,Assembly,"Do pass as amended",12,0,4,0,16
1385559,1092913,2021-06-01,Assembly,"AB 41 Wood Assembly Third Reading",70,1,8,0,79
1385559,1104217,2021-07-05,Senate,"Do pass, but first be re-referred to the Committee on [Transportation]",12,0,2,0,14
1385559,1104716,2021-07-13,Senate,"Do pass as amended, but first amend, and re-refer to the Committee on [Appropriations]",13,0,4,0,17
1385559,1106118,2021-08-16,Senate,"Placed on suspense file",7,0,0,0,7
1385559,1106584,2021-08-26,Senate,"Do pass as amended",7,0,0,0,7
1385559,1108586,2021-09-10,Senate,"Assembly 3rd Reading AB41 Wood et al. By McGuire",38,0,0,2,40
1385559,1108587,2021-09-10,Assembly,"AB 41 Wood Concurrence in Senate Amendments",76,0,0,4,80
1385560,1037800,2021-03-25,Senate,"Do pass, but first be re-referred to the Committee on [Housing]",5,0,0,0,5
1385560,1066735,2021-04-29,Senate,"Do pass as amended, but first amend, and re-refer to the Committee on [Appropriations]",7,2,0,0,9
1385560,1078748,2021-05-17,Senate,"Placed on suspense file",7,0,0,0,7
1385560,1081844,2021-05-20,Senate,"Do pass",5,2,0,0,7
1385560,1089610,2021-06-01,Senate,"Senate 3rd Reading SB12 McGuire et al",31,8,1,0,40
1385560,1101621,2021-06-23,Assembly,"Do pass and be re-referred to the Committee on [Housing and Community Development]",6,2,0,0,8
1385560,1104655,2021-07-12,Assembly,"Do pass as amended and be re-referred to the Committee on [Appropriations]",4,2,2,0,8
1385560,1104656,2021-07-12,Assembly,Reconsideration,8,0,0,0,8
1385561,987928,2021-01-14,Senate,"Do pass as amended, but first amend, and re-refer to the Committee on [Appropriations]",4,1,0,0,5
1385561,989382,2021-01-21,Senate,"Do pass",4,2,0,0,6
1385561,992288,2021-01-28,Senate,"Senate 3rd Reading SB29 Umberg et al. Urgency Clause",29,7,3,0,39
1385561,1002171,2021-02-09,Assembly,"Do pass",6,1,0,0,7
1385561,1007213,2021-02-16,Assembly,"SB 29 Umberg Third Reading Urgency By Berman",55,15,9,0,79
1385562,1025088,2021-03-09,Senate,"Do pass as amended, but first amend, and re-refer to the Committee on [Appropriations]",11,0,0,0,11
1385562,1033635,2021-03-22,Senate,"Placed on suspense file",7,0,0,0,7
1385562,1081802,2021-05-20,Senate,"Do pass",7,0,0,0,7
1385562,1087583,2021-05-28,Senate,"Senate 3rd Reading SB41 Umberg Urgency Clause",38,0,2,0,40
1385562,1103811,2021-07-01,Assembly,"Do pass and be re-referred to the Committee on [Judiciary]",11,0,0,0,11
1385562,1104698,2021-07-13,Assembly,"Do pass and be re-referred to the Committee on [Appropriations]",11,0,0,0,11
1385562,1107010,2021-08-26,Assembly,"Do pass as amended",12,0,0,4,16
1385562,1108047,2021-09-08,Assembly,"SB 41 Umberg Senate Third Reading By Gabriel",80,0,0,0,80
1385562,1108386,2021-09-09,Senate,"Unfinished Business SB41 Umberg et al. Concurrence",38,0,0,2,40
1385563,1049883,2021-04-08,Assembly,"Do pass and be re-referred to the Committee on [Appropriations] with recommendation: To Consent Calendar",15,0,0,0,15
1385563,1059159,2021-04-21,Assembly,"Do pass. To Consent Calendar",14,0,2,0,16
1385563,1066690,2021-04-29,Assembly,"AB 63 Petrie-Norris Consent Calendar Second Day Regular Session",77,0,1,0,78
1385563,1102830,2021-06-29,Senate,"Do pass as amended, but first amend, and re-refer to the Committee on [Appropriations] with the recommendation: To Consent Calendar",9,0,0,0,9
1385563,1107730,2021-09-02,Senate,"Assembly 3rd Reading AB63 Petrie-Norris et al. By Min",39,0,0,1,40
1385563,1107926,2021-09-07,Assembly,"AB 63 Petrie-Norris Concurrence in Senate Amendments",73,0,0,7,80
1385565,992320,2021-01-28,Assembly,"Be adopted. To Consent Calendar",10,0,2,0,12
1385565,996617,2021-02-04,Assembly,"HR 5 Chau Consent Calendar Second Day Regular Session",72,0,7,0,79
1385566,1026083,2021-03-10,Senate,"Do pass as amended, but first amend, and re-refer to the Committee on [Appropriations]",7,0,0,0,7
1385566,1044950,2021-04-05,Senate,"Placed on suspense file",7,0,0,0,7
1385566,1081913,2021-05-20,Senate,"Do pass as amended",7,0,0,0,7
1385566,1091684,2021-06-03,Senate,"Senate 3rd Reading SB14 Portantino et al. Urgency Clause",38,0,2,0,40
1385566,1104371,2021-07-07,Assembly,"Do pass as amended and be re-referred to the Committee on [Appropriations]",7,0,0,0,7
1385566,1106321,2021-08-19,Assembly,"Do pass",16,0,0,0,16
1385566,1108581,2021-09-10,Senate,"Unfinished Business SB14 Portantino et al. Urgency Clause Concurrence",37,0,0,3,40
1385566,1108582,2021-09-10,Assembly,"SB 14 Portantino Third Reading Urgency By Low",75,1,0,4,80
1385567,1059292,2021-04-21,Assembly,"Do pass and be re-referred to the Committee on [Education]",8,0,0,0,8
1385567,1065100,2021-04-28,Assembly,"Do pass as amended and be re-referred to the Committee on [Appropriations]",7,0,0,0,7
1385567,1081477,2021-05-20,Assembly,"Do pass",16,0,0,0,16
1385567,1087030,2021-05-27,Assembly,"AB 92 Reyes Assembly Third Reading",78,0,0,0,78
1385567,1100763,2021-06-23,Senate,"Do pass, but first be re-referred to the Committee on [Human Services]",6,0,1,0,7
1385567,1104377,2021-07-06,Senate,"Do pass, but first be re-referred to the Committee on [Appropriations]",4,1,0,0,5
1385567,1223271,2022-08-08,Senate,"Placed on suspense file",7,0,0,0,7
1385567,1223402,2022-08-11,Senate,"Do pass as amended",6,1,0,0,7
1385567,1225383,2022-08-29,Senate,"Assembly 3rd Reading AB92 Reyes et al. By Lim贸n",33,0,0,7,40
1385567,1225384,2022-08-30,Assembly,"AB 92 Reyes Concurrence in Senate Amendments",79,0,0,1,80
1385569,1054623,2021-04-14,Assembly,"Do pass and be re-referred to the Committee on [Privacy and Consumer Protection]",11,1,1,0,13
1385569,1060800,2021-04-22,Assembly,"Do pass and be re-referred to the Committee on [Appropriations]",9,2,0,0,11
1385571,1044958,2021-04-05,Senate,"Do pass, but first be re-referred to the Committee on [Environmental Quality]",12,0,2,0,14
1385571,1062761,2021-04-26,Senate,"Do pass, but first be re-referred to the Committee on [Appropriations]",6,0,1,0,7
1385572,1045017,2021-04-05,Senate,"Senate 3rd Reading SCR2 Umberg et al",38,0,2,0,40
1385572,1066676,2021-04-29,Assembly,"Be adopted. To Consent Calendar",9,0,3,0,12
1385572,1074135,2021-05-06,Assembly,"SCR 2 Umberg Consent Calendar Second Day Regular Session",77,0,1,0,78
1385573,1035238,2021-03-23,Senate,"Do pass as amended, but first amend, and re-refer to the Committee on [Judiciary]",9,3,3,0,15
1385573,1053466,2021-04-13,Senate,"Do pass as amended, but first amend, and re-refer to the Committee on [Appropriations]",8,1,2,0,11
1385573,1068221,2021-05-03,Senate,"Placed on suspense file",6,0,1,0,7
1385573,1081866,2021-05-20,Senate,"Do pass as amended",5,2,0,0,7
1385573,1090418,2021-06-02,Senate,"Senate 3rd Reading SB17 Pan et al",31,6,3,0,40
1385573,1103500,2021-06-30,Assembly,"Do pass as amended and be re-referred to the Committee on [Appropriations]",5,0,2,0,7
1385573,1223937,2022-08-11,Assembly,"Do pass as amended",12,3,0,1,16
1385574,1025124,2021-03-09,Senate,"Do pass, but first be re-referred to the Committee on [Judiciary]",4,0,0,0,4
1385574,1053469,2021-04-13,Senate,"Do pass as amended, but first amend, and re-refer to the Committee on [Appropriations]",8,1,2,0,11
1385574,1068161,2021-05-03,Senate,"Placed on suspense file",6,0,1,0,7
1385574,1081664,2021-05-20,Senate,"Do pass as amended",5,2,0,0,7
1385574,1090415,2021-06-02,Senate,"Senate 3rd Reading SB16 Skinner",31,3,6,0,40
1385574,1102799,2021-06-29,Assembly,"Do pass and be re-referred to the Committee on [Judiciary]",6,1,1,0,8
1385574,1104282,2021-07-06,Assembly,"Do pass as amended and be re-referred to the Committee on [Appropriations]",8,2,1,0,11
1385574,1106888,2021-08-26,Assembly,"Do pass as amended",12,4,0,0,16
1385574,1107494,2021-09-01,Assembly,"SB 16 Skinner Senate Third Reading By Grayson",57,13,0,9,79
1385574,1107682,2021-09-02,Senate,"Unfinished Business SB16 Skinner Concurrence",29,9,0,2,40
1385576,1047527,2021-04-07,Assembly,"Do pass and be re-referred to the Committee on [Appropriations]",7,0,2,0,9
1385576,1081885,2021-05-20,Assembly,"Do pass",12,0,4,0,16
1385576,1087003,2021-05-27,Assembly,"AB 1 Cristina Garcia Assembly Third Reading",58,3,17,0,78
1385576,1211824,2022-06-01,Senate,"Do pass, but first be re-referred to the Committee on [Judiciary] with the recommendation: To Consent Calendar",6,0,0,1,7
1385577,1052016,2021-04-13,Senate,"Do pass, but first be re-referred to the Committee on [Appropriations] with the recommendation: To Consent Calendar",16,0,1,0,17
1385577,1068262,2021-05-03,Senate,"Placed on suspense file",6,0,1,0,7
1385577,1126344,2022-01-20,Senate,"Do pass",7,0,0,0,7
1385577,1128993,2022-01-26,Senate,"Senate 3rd Reading SB21 Glazer et al",37,0,0,3,40
1385577,1215560,2022-06-13,Assembly,"Do pass and be re-referred to the Committee on [Appropriations]",14,0,0,1,15
1385579,1051892,2021-04-13,Assembly,"Be adopted. To third reading",7,3,1,0,11
1385580,1060932,2021-04-22,Assembly,"Do pass and be re-referred to the Committee on [Health]",20,0,2,0,22
1385580,1064062,2021-04-27,Assembly,"Do pass as amended and be re-referred to the Committee on [Appropriations]",15,0,0,0,15
1385580,1081488,2021-05-20,Assembly,"Do pass as amended",12,0,4,0,16
1385580,1092907,2021-06-01,Assembly,"AB 61 Gabriel Assembly Third Reading",79,0,0,0,79
1385580,1100286,2021-06-22,Senate,"Do pass as amended, but first amend, and re-refer to the Committee on [Health]",15,0,0,0,15
1385580,1104932,2021-07-14,Senate,"Do pass as amended, but first amend, and re-refer to the Committee on [Appropriations]",9,0,2,0,11
1385580,1106244,2021-08-16,Senate,"Placed on suspense file",7,0,0,0,7
1385580,1106628,2021-08-26,Senate,"Do pass as amended",7,0,0,0,7
1385580,1108127,2021-09-08,Senate,"Special Consent AB61 Gabriel et al. By Wiener Urgency Clause",38,0,0,2,40
1385580,1108367,2021-09-09,Assembly,"AB 61 Gabriel Concurrence - Urgency Added",78,0,0,2,80
1385583,1054607,2021-04-14,Assembly,"Do pass and be re-referred to the Committee on [Local Government]",9,1,3,0,13
1385583,1065257,2021-04-28,Assembly,"Do pass and be re-referred to the Committee on [Appropriations]",5,2,1,0,8
1385583,1081674,2021-05-20,Assembly,"Do pass",12,3,1,0,16
1385583,1090463,2021-06-02,Assembly,"AB 14 Aguiar-Curry Third Reading Urgency",62,7,10,0,79
1385583,1104207,2021-07-05,Senate,"Do pass as amended, but first amend, and re-refer to the Committee on [Governance and Finance]",11,1,2,0,14
1385583,1106106,2021-08-16,Senate,"Placed on suspense file",7,0,0,0,7
1385583,1106959,2021-08-26,Senate,"Do pass",5,2,0,0,7
1385583,1108225,2021-09-09,Senate,"Assembly 3rd Reading AB14 Aguiar-Curry et al. By Gonzalez Urgency Clause",28,8,0,4,40
1385583,1108226,2021-09-09,Assembly,"AB 14 AGUIAR-CURRY Concurrence in Senate Amendments",60,7,0,13,80
1385584,1052007,2021-04-13,Assembly,"Do pass and be re-referred to the Committee on [Appropriations]",15,0,0,0,15
1385585,1059313,2021-04-21,Assembly,"Do pass as amended, and be re-referred to the Committee on [Appropriations] with recommendation: To Consent Calendar",15,0,0,0,15
1385585,1076961,2021-05-12,Assembly,"Do pass. To Consent Calendar",16,0,0,0,16
1385585,1081780,2021-05-20,Assembly,"AB 33 Ting Consent Calendar Second Day Regular Session",76,0,2,0,78
1385585,1104594,2021-07-12,Senate,"Do pass as amended, but first amend, and re-refer to the Committee on [Appropriations]",13,0,1,0,14
1385585,1106075,2021-08-16,Senate,"Placed on suspense file",7,0,0,0,7
1385585,1106988,2021-08-26,Senate,"Do pass",7,0,0,0,7
1385585,1107538,2021-09-01,Senate,"Assembly 3rd Reading AB33 Ting et al. By Hertzberg",39,0,0,1,40
1385585,1107609,2021-09-02,Assembly,"AB 33 Ting Concurrence in Senate Amendments",74,0,0,5,79
1385586,988136,2021-01-15,Assembly,"AB 85 Ting Assembly Third Reading",48,13,19,0,80
1385586,1009534,2021-02-18,Senate,"Do pass",12,3,3,0,18
1385586,1011802,2021-02-22,Senate,"Assembly 3rd Reading AB85 BUDGET (Ting) By Skinner",30,8,1,0,39
1385586,1011803,2021-02-22,Assembly,"AB 85 BUDGET Assembly Third Reading By TING",64,3,12,0,79
1385586,1013310,2021-02-22,Assembly,"AB 85 BUDGET Concurrence in Senate Amendments By TING",64,3,12,0,79
1385587,1026116,2021-03-10,Senate,"Do pass, but first be re-referred to the Committee on [Judiciary]",6,0,1,0,7
1385587,1035236,2021-03-23,Senate,"Do pass, but first be re-referred to the Committee on [Appropriations] with the recommendation: To Consent Calendar",11,0,0,0,11
1385587,1045002,2021-04-05,Senate,"Placed on suspense file",7,0,0,0,7
1385587,1082000,2021-05-20,Senate,"Do pass as amended",7,0,0,0,7
1385587,1089574,2021-06-01,Senate,"Special Consent SB26",39,0,1,0,40
1385587,1099760,2021-06-21,Assembly,"Do pass as amended and be re-referred to the Committee on [Higher Education]",7,0,0,0,7
1385587,1102827,2021-06-29,Assembly,"Do pass and be re-referred to the Committee on [Appropriations]",12,0,0,0,12
1385587,1104901,2021-07-14,Assembly,"Do pass. To Consent Calendar",13,0,3,0,16
1385587,1106368,2021-08-19,Assembly,"SB 26 Skinner Consent Calendar Second Day Regular Session",73,0,0,6,79
1385587,1106618,2021-08-26,Senate,"Unfinished Business SB26 Skinner et al. Urgency Clause Concurrence",36,0,0,4,40
1385588,1035243,2021-03-22,Assembly,"Do pass and be re-referred to the Committee on [Appropriations]",13,1,1,0,15
1385588,1053536,2021-04-14,Assembly,"Do pass",15,0,1,0,16
1385588,1060894,2021-04-22,Assembly,"AB 3 Fong Assembly Third Reading",68,6,5,0,79
1385588,1098166,2021-06-15,Senate,"Do pass as amended, but first amend, and re-refer to the Committee on [Public Safety]",17,0,0,0,17
1385588,1104745,2021-07-13,Senate,"Do pass as amended, but first amend, and re-refer to the Committee on [Appropriations]",5,0,0,0,5
1385588,1106405,2021-08-23,Senate,"Placed on suspense file",7,0,0,0,7
1385588,1106933,2021-08-26,Senate,"Do pass",7,0,0,0,7
1385588,1107771,2021-09-03,Senate,"Special Consent AB3 Fong et al",37,0,0,3,40
1385588,1108084,2021-09-08,Assembly,"AB 3 Fong Concurrence in Senate Amendments",77,0,0,3,80
1385589,1074184,2021-05-06,Senate,"Do pass as amended",5,0,0,0,5
1385589,1078801,2021-05-17,Senate,"Senate 3rd Reading SB13 Dodd Urgency Clause",38,0,2,0,40
1385589,1101596,2021-06-23,Assembly,"Do pass as amended",8,0,0,0,8
1385589,1106076,2021-08-16,Assembly,"SB 13 Dodd Third Reading Urgency By Aguiar-Curry",77,0,0,2,79
1385589,1106359,2021-08-19,Senate,"Unfinished Business SB13 Dodd Urgency Clause Concurrence",38,0,0,2,40
1385591,1053532,2021-04-14,Assembly,"Do pass and be re-referred to the Committee on [Appropriations]",11,0,0,0,11
1385591,1081929,2021-05-20,Assembly,"Do pass",16,0,0,0,16
1385591,1087059,2021-05-27,Assembly,"AB 72 Petrie-Norris Assembly Third Reading",78,0,0,0,78
1385591,1104497,2021-07-08,Senate,"Do pass, but first be re-referred to the Committee on [Appropriations] with the recommendation: To Consent Calendar",8,0,1,0,9
1385591,1106140,2021-08-16,Senate,"Placed on suspense file",7,0,0,0,7
1385591,1106977,2021-08-26,Senate,"Do pass",7,0,0,0,7
1385591,1107793,2021-09-03,Senate,"Special Consent AB72",37,0,0,3,40
1385591,1107930,2021-09-07,Assembly,"AB 72 Petrie-Norris Concurrence in Senate Amendments",73,0,0,7,80
1385592,1065302,2021-04-28,Assembly,"Do pass and be re-referred to the Committee on [Appropriations]",7,0,0,0,7
1385593,1025090,2021-03-09,Senate,"Do pass, but first be re-referred to the Committee on [Appropriations]",11,0,0,0,11
1385593,1044987,2021-04-05,Senate,"Senate 3rd Reading SB24 Caballero et al",38,0,2,0,40
1385593,1095037,2021-06-08,Assembly,"Do pass and be re-referred to the Committee on [Appropriations]",11,0,0,0,11
1385593,1103490,2021-06-30,Assembly,"Do pass. To Consent Calendar",14,0,2,0,16
1385593,1104533,2021-07-08,Assembly,"SB 24 Caballero Consent Calendar Second Day Regular Session",76,0,3,0,79
1385593,1104591,2021-07-12,Senate,"Unfinished Business SB24 Caballero et al. Concurrence",39,0,1,0,40
1385594,1026089,2021-03-10,Senate,"Do pass as amended, but first amend, and re-refer to the Committee on [Appropriations]",11,0,0,0,11
1385594,1056392,2021-04-19,Senate,"Placed on suspense file",7,0,0,0,7
1385594,1081876,2021-05-20,Senate,"Do pass as amended",6,1,0,0,7
1385594,1087610,2021-05-28,Senate,"Senate 3rd Reading SB40 Hurtado et al",37,1,2,0,40
1385594,1104342,2021-07-06,Assembly,"Do pass and be re-referred to the Committee on [Appropriations] with recommendation: To Consent Calendar",15,0,0,0,15
1385595,1036481,2021-03-24,Assembly,"Do pass as amended and be re-referred to the Committee on [Appropriations]",7,0,0,0,7
1385595,1082103,2021-05-20,Assembly,"Do pass as amended",16,0,0,0,16
1385595,1091682,2021-06-03,Assembly,"AB 27 Luz Rivas Third Reading Urgency",76,0,3,0,79
1385595,1104459,2021-07-07,Senate,"Do pass, but first be re-referred to the Committee on [Appropriations] with the recommendation: To Consent Calendar",7,0,0,0,7
1385595,1104549,2021-07-07,Senate,"Do pass as amended, but first amend, and re-refer to the Committee on [Appropriations] with the recommendation: To Consent Calendar",7,0,0,0,7
1385595,1106084,2021-08-16,Senate,"Placed on suspense file",7,0,0,0,7
1385595,1106940,2021-08-26,Senate,"Do pass as amended",7,0,0,0,7
1385595,1108080,2021-09-08,Senate,"Assembly 3rd Reading AB27 Luz Rivas et al. By Skinner Urgency Clause",38,0,0,2,40
1385595,1108244,2021-09-09,Assembly,"AB 27 Luz Rivas Concurrence in Senate Amendments",79,0,0,1,80
1385753,1064007,2021-04-27,Assembly,"Do pass and be re-referred to the Committee on [Appropriations]",13,1,1,0,15
1385753,1082160,2021-05-20,Assembly,"Do pass",12,2,2,0,16
1385753,1087000,2021-05-27,Assembly,"AB 97 Nazarian Assembly Third Reading",70,0,8,0,78
1385753,1104987,2021-07-14,Senate,"Do pass, but first be re-referred to the Committee on [Appropriations]",7,0,4,0,11
1385753,1106403,2021-08-23,Senate,"Placed on suspense file",7,0,0,0,7
1385755,1051949,2021-04-13,Senate,"Do pass, but first be re-referred to the Committee on [Appropriations]",16,0,1,0,17
1385755,1075329,2021-05-10,Senate,"Placed on suspense file",7,0,0,0,7
1385755,1082016,2021-05-20,Senate,"Do pass",7,0,0,0,7
1385755,1089548,2021-06-01,Senate,"Special Consent SB69",39,0,1,0,40
1385755,1104251,2021-07-05,Assembly,"Do pass and be re-referred to the Committee on [Appropriations]",15,0,0,0,15
1385755,1106626,2021-08-26,Assembly,"Do pass as amended",14,2,0,0,16
1385755,1107998,2021-09-08,Assembly,"SB 69 McGuire Senate Third Reading By Wood",71,0,0,9,80
1385755,1108378,2021-09-09,Senate,"Unfinished Business SB69 McGuire Concurrence",38,0,0,2,40
1385756,1030819,2021-03-17,Senate,"Do pass, but first be re-referred to the Committee on [Appropriations]",5,2,0,0,7
1385756,1044951,2021-04-05,Senate,"Placed on suspense file",7,0,0,0,7
1385756,1082210,2021-05-20,Senate,"Do pass as amended",5,2,0,0,7
1385756,1129006,2022-01-26,Senate,"Senate 3rd Reading SB70 Rubio et al",32,5,0,3,40
1385756,1216623,2022-06-15,Assembly,"Do pass as amended and be re-referred to the Committee on [Appropriations]",5,1,0,1,7
1385756,1223549,2022-08-11,Assembly,"Do pass as amended",12,4,0,0,16
1385756,1224181,2022-08-18,Assembly,"SB 70 Rubio Senate Third Reading By Quirk-Silva",59,12,0,9,80
1385756,1225773,2022-08-29,Senate,"Unfinished Business SB70 Rubio et al. Concurrence",33,5,0,2,40
1385862,1057725,2021-04-20,Assembly,"Do pass and be re-referred to the Committee on [Health] with recommendation: To Consent Calendar",7,0,0,0,7
1385862,1064009,2021-04-27,Assembly,"Do pass as amended, and be re-referred to the Committee on [Appropriations] with recommendation: To Consent Calendar",15,0,0,0,15
1385862,1081429,2021-05-20,Assembly,"Do pass",16,0,0,0,16
1385862,1087007,2021-05-27,Assembly,"AB 98 Frazier Assembly Third Reading",78,0,0,0,78
1385862,1220038,2022-06-28,Senate,"Do pass, but first be re-referred to the Committee on [Appropriations] with the recommendation: To Consent Calendar",13,0,0,2,15
1385862,1224747,2022-08-24,Senate,"Assembly 3rd Reading AB98 Kalra et al. By Cortese Urgency Clause",40,0,0,0,40
1385862,1225132,2022-08-29,Assembly,"With recommendation: That Senate amendments be concurred in",21,0,0,1,22
1385862,1225397,2022-08-30,Assembly,"AB 98 Kalra Concurrence - Urgency Added",79,0,0,1,80
1385863,1048960,2021-04-07,Assembly,"Do pass and be re-referred to the Committee on [Higher Education]",7,0,0,0,7
1385863,1061001,2021-04-22,Assembly,"Do pass as amended and be re-referred to the Committee on [Appropriations]",12,0,0,0,12
1385863,1082062,2021-05-20,Assembly,"Do pass",16,0,0,0,16
1385863,1086930,2021-05-27,Assembly,"AB 99 Irwin Assembly Third Reading",78,0,0,0,78
1385863,1221274,2022-06-30,Senate,"Do pass as amended, but first amend, and re-refer to the Committee on [Appropriations]",6,0,0,1,7
1385863,1223183,2022-08-08,Senate,"Placed on suspense file",7,0,0,0,7
1385863,1223998,2022-08-11,Senate,"Do pass as amended",7,0,0,0,7
1385864,1060854,2021-04-22,Assembly,"Be adopted. To third reading",12,0,0,0,12
1385864,1078783,2021-05-17,Senate,"Assembly 3rd Reading ACR4 Nguyen et al. By Cortese",38,0,2,0,40
1385866,1025087,2021-03-09,Senate,"Do pass and be ordered to the Consent Calendar",4,0,0,0,4
1385866,1033614,2021-03-22,Senate,"Consent Calendar SB71 McGuire",37,0,3,0,40
1385866,1098144,2021-06-15,Assembly,"Do pass as amended",7,0,1,0,8
1385866,1106454,2021-08-23,Assembly,"SB 71 McGuire Senate Third Reading By Friedman",65,0,0,14,79
1385866,1107694,2021-09-02,Senate,"Unfinished Business SB71 McGuire Concurrence",39,0,0,1,40
1386879,1048882,2021-04-08,Senate,"Do pass, but first be re-referred to the Committee on [Appropriations] with the recommendation: To Consent Calendar",12,0,0,0,12
1386879,1068284,2021-05-03,Senate,"Placed on suspense file",6,0,1,0,7
1386879,1081873,2021-05-20,Senate,"Do pass",7,0,0,0,7
1386879,1089482,2021-06-01,Senate,"Special Consent SB72",39,0,1,0,40
1386879,1101556,2021-06-24,Assembly,"Do pass as amended, and be re-referred to the Committee on [Appropriations] with recommendation: To Consent Calendar",14,0,0,0,14
1386880,1025132,2021-03-09,Senate,"Do pass, but first be re-referred to the Committee on [Appropriations]",3,1,0,0,4
1386880,1050842,2021-04-12,Senate,"Senate 3rd Reading SB73 Wiener et al",25,10,5,0,40
1386880,1098170,2021-06-15,Assembly,"Do pass and be re-referred to the Committee on [Appropriations]",6,1,1,0,8
1386880,1106806,2021-08-26,Assembly,"Do pass as amended",12,4,0,0,16
1386880,1108328,2021-09-09,Assembly,"SB 73 Wiener Senate Third Reading By Carrillo",42,26,0,12,80
1386880,1108526,2021-09-10,Senate,"Unfinished Business SB73 Wiener et al. Concurrence",23,12,0,5,40
1387073,1047488,2021-04-07,Assembly,"Do pass and be re-referred to the Committee on [Appropriations]",8,0,1,0,9
1387073,1081983,2021-05-20,Assembly,"Do pass",13,0,3,0,16
1387073,1087057,2021-05-27,Assembly,"AB 100 Holden Assembly Third Reading",57,0,21,0,78
1387073,1104366,2021-07-07,Senate,"Do pass, but first be re-referred to the Committee on [Appropriations] with the recommendation: To Consent Calendar",7,0,0,0,7
1387073,1106418,2021-08-23,Senate,"Placed on suspense file",7,0,0,0,7
1387073,1106715,2021-08-26,Senate,"Do pass",7,0,0,0,7
1387073,1107768,2021-09-03,Senate,"Special Consent AB100",37,0,0,3,40
1387073,1107893,2021-09-07,Assembly,"AB 100 Holden Concurrence in Senate Amendments",72,0,0,8,80
1387074,1049014,2021-04-07,Assembly,"Do pass as amended and be re-referred to the Committee on [Appropriations]",5,2,0,0,7
1387074,1082085,2021-05-20,Assembly,"Do pass",12,4,0,0,16
1387074,1087044,2021-05-27,Assembly,"AB 101 Medina Assembly Third Reading",58,9,11,0,78
1387074,1104920,2021-07-14,Senate,"Do pass as amended, but first amend, and re-refer to the Committee on [Appropriations]",4,2,1,0,7
1387074,1106112,2021-08-16,Senate,"Placed on suspense file",7,0,0,0,7
1387074,1106686,2021-08-26,Senate,"Do pass as amended",5,2,0,0,7
1387074,1108208,2021-09-08,Senate,"Assembly 3rd Reading AB101 Medina et al. By Durazo",29,8,0,3,40
1387074,1108209,2021-09-08,Assembly,"AB 101 MEDINA Concurrence in Senate Amendments",59,12,0,9,80
1387075,1036495,2021-03-24,Assembly,"Do pass as amended and be re-referred to the Committee on [Education]",12,0,0,0,12
1387075,1123765,2022-01-12,Assembly,"Do pass and be re-referred to the Committee on [Appropriations] with recommendation: To Consent Calendar",6,0,0,1,7
1387075,1126283,2022-01-20,Assembly,"Do pass",15,0,0,1,16
1387075,1127176,2022-01-24,Assembly,"AB 102 Holden Assembly Third Reading",66,0,0,10,76
1387075,1211936,2022-06-01,Senate,"Do pass, but first be re-referred to the Committee on [Appropriations] with the recommendation: To Consent Calendar",6,0,0,1,7
1387075,1215530,2022-06-13,Senate,"Placed on suspense file",7,0,0,0,7
1387075,1223977,2022-08-11,Senate,"Do pass as amended",7,0,0,0,7
1387075,1225237,2022-08-31,Senate,"Special Consent AB102",40,0,0,0,40
1387075,1225238,2022-08-31,Assembly,"AB 102 Holden Concurrence in Senate Amendments",80,0,0,0,80
1387077,1036470,2021-03-24,Assembly,"Do pass and be re-referred to the Committee on [Appropriations]",7,0,0,0,7
1387077,1047493,2021-04-07,Assembly,"Do pass as amended",14,0,2,0,16
1387077,1054727,2021-04-15,Assembly,"AB 104 Lorena Gonzalez Third Reading Urgency",77,0,1,0,78
1387077,1087014,2021-05-27,Senate,"Do pass as amended, but first amend, and re-refer to the Committee on [Appropriations]",6,0,1,0,7
1387077,1097035,2021-06-10,Senate,"Do pass",7,0,0,0,7
1387077,1099159,2021-06-17,Senate,"Assembly 3rd Reading AB104 Lorena Gonzalez et a By Lim贸n Urgency Clause",37,0,3,0,40
1387077,1099757,2021-06-21,Assembly,"AB 104 Lorena Gonzalez Concurrence in Senate Amendments",76,0,3,0,79
1387347,1066753,2021-04-29,Assembly,"Do pass and be re-referred to the Committee on [Appropriations]",5,1,1,0,7
1387347,1081482,2021-05-20,Assembly,"Do pass",12,3,1,0,16
1387347,1092932,2021-06-01,Assembly,"AB 105 Holden Assembly Third Reading",58,12,9,0,79
1387347,1100321,2021-06-21,Senate,"Do pass as amended, but first amend, and re-refer to the Committee on [Judiciary]",4,0,1,0,5
1387347,1104967,2021-07-13,Senate,"Do pass as amended, but first amend, and re-refer to the Committee on [Appropriations]",9,2,0,0,11
1387347,1106398,2021-08-23,Senate,"Placed on suspense file",7,0,0,0,7
1387347,1106552,2021-08-26,Senate,"Do pass as amended",5,2,0,0,7
1387347,1108185,2021-09-08,Senate,"Assembly 3rd Reading AB105 Holden et al. By Kamlager",29,8,0,3,40
1387347,1108407,2021-09-09,Assembly,"AB 105 Holden Concurrence in Senate Amendments",58,12,0,10,80
1387348,1097019,2021-06-10,Assembly,"Be adopted. To third reading",12,0,0,0,12
1387348,1105113,2021-07-15,Senate,"Special Consent ACR5",38,0,2,0,40
1387349,1074140,2021-05-06,Assembly,"Be adopted. To third reading",11,0,1,0,12
1387349,1089606,2021-06-01,Senate,"Special Consent ACR6",39,0,1,0,40
1387350,1105151,2021-07-15,Assembly,"Be adopted. To Consent Calendar",10,0,2,0,12
1387350,1106367,2021-08-19,Assembly,"ACR 7 Salas Consent Calendar Second Day",73,0,0,6,79
1387350,1107878,2021-09-07,Senate,"Assembly 3rd Reading ACR7",37,0,0,3,40
1387684,1123296,2022-01-11,Senate,"Do pass, but first be re-referred to the Committee on [Appropriations]",1,1,0,3,5
1387685,1046101,2021-04-05,Senate,"Do pass, but first be re-referred to the Committee on [Judiciary] with the recommendation: To Consent Calendar",5,0,0,0,5
1387685,1059290,2021-04-20,Senate,"Do pass, but first be re-referred to the Committee on [Appropriations] with the recommendation: To Consent Calendar",11,0,0,0,11
1387685,1068260,2021-05-03,Senate,"Placed on suspense file",6,0,1,0,7
1387685,1081969,2021-05-20,Senate,"Do pass",7,0,0,0,7
1387685,1089593,2021-06-01,Senate,"Special Consent SB76",39,0,1,0,40
1387685,1100773,2021-06-23,Assembly,"Do pass and be re-referred to the Committee on [Judiciary]",7,0,0,0,7
1387685,1104246,2021-07-06,Assembly,"Do pass and be re-referred to the Committee on [Appropriations] with recommendation: To Consent Calendar",10,0,1,0,11
1387685,1106614,2021-08-26,Assembly,"Do pass",16,0,0,0,16
1387685,1107962,2021-09-07,Assembly,"SB 76 Nielsen Senate Third Reading By REYES",72,0,0,8,80
1387688,1048970,2021-04-08,Senate,"Do pass, but first be re-referred to the Committee on [Transportation] with the recommendation: To Consent Calendar",5,0,0,0,5
1387688,1064137,2021-04-27,Senate,"Do pass and be ordered to the Consent Calendar",15,0,2,0,17
1387688,1068198,2021-05-03,Senate,"Consent Calendar SB79 Nielsen Urgency Clause",36,0,4,0,40
1387688,1096134,2021-06-09,Assembly,"Do pass. To Consent Calendar",8,0,0,0,8
1387688,1099105,2021-06-17,Assembly,"SB 79 Nielsen Consent Calendar Second Day Regular Session",72,0,7,0,79
1387688,1099719,2021-06-21,Senate,"Unfinished Business SB79 Nielsen Urgency Clause Concurrence",40,0,0,0,40
1387689,1029564,2021-03-16,Senate,"Do pass as amended, but first amend, and re-refer to the Committee on [Health] with the recommendation: To Consent Calendar",9,0,0,0,9
1387689,1053418,2021-04-14,Senate,"Do pass as amended, but first amend, and re-refer to the Committee on [Appropriations]",11,0,0,0,11
1387689,1068246,2021-05-03,Senate,"Placed on suspense file",6,0,1,0,7
1387689,1081474,2021-05-20,Senate,"Do pass",7,0,0,0,7
1387689,1089545,2021-06-01,Senate,"Special Consent SB80 McGuire et al. Urgency Clause",39,0,1,0,40
1387689,1103855,2021-07-01,Assembly,"Do pass and be re-referred to the Committee on [Health]",15,0,0,0,15
1387689,1104703,2021-07-13,Assembly,"Do pass and be re-referred to the Committee on [Appropriations]",15,0,0,0,15
1387689,1107012,2021-08-26,Assembly,"Do pass as amended",13,0,0,3,16
1387689,1108302,2021-09-09,Assembly,"Do pass",11,0,0,4,15
1387689,1108556,2021-09-10,Senate,"Unfinished Business SB80 McGuire et al. Urgency Clause Concurrence",37,0,0,3,40
1387689,1108557,2021-09-10,Assembly,"SB 80 McGuire Senate Second Reading By Stone",78,0,0,2,80
1387690,1029583,2021-03-16,Senate,"Do pass, but first be re-referred to the Committee on [Appropriations]",4,0,1,0,5
1387690,1068173,2021-05-03,Senate,"Placed on suspense file",6,0,1,0,7
1387690,1081550,2021-05-20,Senate,"Do pass",5,2,0,0,7
1387690,1086116,2021-05-26,Senate,"Senate 3rd Reading SB81 Skinner",27,9,4,0,40
1387690,1102828,2021-06-29,Assembly,"Do pass as amended and be re-referred to the Committee on [Appropriations]",6,2,0,0,8
1387690,1106771,2021-08-26,Assembly,"Do pass as amended",11,4,0,1,16
1387690,1108128,2021-09-08,Assembly,"SB 81 Skinner Senate Third Reading By Bauer-Kahan",46,24,0,10,80
1387690,1108460,2021-09-09,Senate,"Unfinished Business SB81 Skinner et al. Concurrence",23,11,0,6,40
1387691,1029574,2021-03-16,Senate,"Do pass as amended, but first amend, and re-refer to the Committee on [Appropriations]",4,1,0,0,5
1387691,1044963,2021-04-05,Senate,"Placed on suspense file",7,0,0,0,7
1387692,1029582,2021-03-16,Senate,"Do pass, but first be re-referred to the Committee on [Governance and Finance]",9,0,0,0,9
1387692,1078768,2021-05-17,Senate,"Placed on suspense file",7,0,0,0,7
1387692,1081813,2021-05-20,Senate,"Do pass as amended",6,0,1,0,7
1387692,1087601,2021-05-28,Senate,"Senate 3rd Reading SB83 Allen",35,2,3,0,40
1387692,1100783,2021-06-23,Assembly,"Do pass as amended and be re-referred to the Committee on [Appropriations]",9,0,2,0,11
1387692,1106701,2021-08-26,Assembly,"Do pass",12,3,0,1,16
1387692,1107646,2021-09-02,Assembly,"SB 83 Allen Senate Third Reading By Petrie-Norris",60,8,0,11,79
1387692,1108345,2021-09-09,Senate,"Unfinished Business SB83 Allen et al. Concurrence",33,2,0,5,40
1387693,1029572,2021-03-16,Senate,"Do pass as amended, but first amend, and re-refer to the Committee on [Appropriations]",7,1,1,0,9
1387693,1066764,2021-04-29,Senate,"Senate 3rd Reading SB84 Hurtado",31,3,6,0,40
1387693,1096071,2021-06-09,Assembly,"Do pass and be re-referred to the Committee on [Appropriations]",11,0,0,0,11
1387693,1106807,2021-08-26,Assembly,"Do pass",14,0,0,2,16
1387693,1107965,2021-09-07,Assembly,"SB 84 Hurtado Senate Third Reading By Salas",66,0,0,14,80
1387693,1108069,2021-09-08,Senate,"Unfinished Business SB84 Hurtado Concurrence",35,0,0,5,40
1388067,1064118,2021-04-27,Assembly,"Do pass as amended and be re-referred to the Committee on [Appropriations]",6,0,1,0,7
1388067,1081399,2021-05-20,Assembly,"Do pass",16,0,0,0,16
1388067,1086926,2021-05-27,Assembly,"AB 106 Salas Assembly Third Reading",78,0,0,0,78
1388068,1035209,2021-03-23,Assembly,"Do pass as amended and be re-referred to the Committee on [Military and Veterans Affairs]",17,0,2,0,19
1388068,1065166,2021-04-28,Assembly,"Do pass and be re-referred to the Committee on [Appropriations]",11,0,0,0,11
1388068,1082082,2021-05-20,Assembly,"Do pass",16,0,0,0,16
1388068,1092947,2021-06-01,Assembly,"AB 107 Salas Assembly Third Reading",79,0,0,0,79
1388068,1103409,2021-06-30,Senate,"Do pass, but first be re-referred to the Committee on [Military and Veterans Affairs]",13,0,1,0,14
1388068,1105085,2021-07-14,Senate,"Do pass as amended, but first amend, and re-refer to the Committee on [Appropriations]",5,0,2,0,7
1388068,1106077,2021-08-16,Senate,"Placed on suspense file",7,0,0,0,7
1388068,1106743,2021-08-26,Senate,"Do pass as amended",7,0,0,0,7
1388068,1107890,2021-09-07,Senate,"Assembly 3rd Reading AB107 Salas et al. By Umberg",37,0,0,3,40
1388068,1108064,2021-09-08,Assembly,"AB 107 Salas Concurrence in Senate Amendments",77,0,0,3,80
1388071,989383,2021-01-21,Senate,"Senate 3rd Reading SB85 Skinner",22,2,15,0,39
1388071,1050822,2021-04-12,Senate,"Unfinished Business SB85 B. & F.R. (Skinner) Concurrence",39,0,1,0,40
1388071,1053417,2021-04-12,Assembly,"SB 85 B. & F. R. Senate Third Reading By TING",74,0,4,0,78
1388072,989387,2021-01-21,Senate,"Senate 3rd Reading SB86 Skinner",25,1,13,0,39
1388072,1053503,2021-04-12,Assembly,"SB 86 B. & F. R. Senate Third Reading By TING",73,0,5,0,78
1388072,1054634,2021-04-15,Senate,"Unfinished Business SB86 B. & F.R. (Skinner) Concurrence",30,0,10,0,40
1388073,989389,2021-01-21,Senate,"Senate 3rd Reading SB87 Skinner",22,2,15,0,39
1388073,1011718,2021-02-22,Senate,"Unfinished Business SB87 Caballero et al. Concurrence",38,0,1,0,39
1388073,1011719,2021-02-22,Assembly,"SB 87 Caballero Senate Third Reading By TING",77,0,2,0,79
1388074,989386,2021-01-21,Senate,"Senate 3rd Reading SB88",22,2,15,0,39
1388074,1011751,2021-02-22,Senate,"Unfinished Business SB88 B. & F.R. (Skinner) Concurrence",31,0,8,0,39
1388074,1011752,2021-02-22,Assembly,"SB 88 B. & F. R. Senate Third Reading By TING",67,1,11,0,79
1388075,989390,2021-01-21,Senate,"Senate 3rd Reading SB89",22,2,15,0,39
1388075,992302,2021-01-28,Senate,"Unfinished Business SB89 Skinner Concurrence",37,0,2,0,39
1388075,992303,2021-01-28,Assembly,"SB 89 Skinner Senate Third Reading By REYES",75,0,5,0,80
1388077,989384,2021-01-21,Senate,"Senate 3rd Reading SB91",22,2,15,0,39
1388077,992318,2021-01-28,Senate,"Unfinished Business SB91 B. & F.R. (Skinner) Concurrence",34,0,5,0,39
1388077,992319,2021-01-28,Assembly,"SB 91 B. & F. R. Senate Third Reading By REYES",72,1,7,0,80
1388078,989391,2021-01-21,Senate,"Senate 3rd Reading SB92",22,2,15,0,39
1388078,1066799,2021-04-29,Assembly,"SB 92 B. & F. R. Senate Third Reading",56,17,5,0,78
1388078,1068281,2021-05-03,Senate,"Unfinished Business SB92 B. & F.R. (Skinner) Concurrence",28,8,4,0,40
1388079,989397,2021-01-21,Senate,"Senate 3rd Reading SB93",22,2,15,0,39
1388079,1053473,2021-04-12,Assembly,"SB 93 B. & F. R. Senate Third Reading By TING",54,19,5,0,78
1388079,1054642,2021-04-15,Senate,"Unfinished Business SB93 B. & F.R. (Skinner) Concurrence",25,11,4,0,40
1388080,989385,2021-01-21,Senate,"Senate 3rd Reading SB94",22,2,15,0,39
1388080,1011714,2021-02-22,Senate,"Unfinished Business SB94 Skinner Concurrence",38,0,1,0,39
1388080,1011715,2021-02-22,Assembly,"SB 94 Skinner Senate Third Reading By TING",77,0,2,0,79
1388081,989381,2021-01-21,Senate,"Senate 3rd Reading SB95",22,2,15,0,39
1388081,1028391,2021-03-15,Assembly,"SB 95 Skinner Senate Third Reading By TING",57,19,2,0,78
1388081,1031884,2021-03-18,Senate,"Unfinished Business SB95 Skinner Concurrence",29,8,3,0,40
1388315,1048913,2021-04-08,Assembly,"Do pass as amended and be re-referred to the Committee on [Insurance]",10,0,1,0,11
1388315,1066682,2021-04-29,Assembly,"Do pass and be re-referred to the Committee on [Appropriations]",13,0,0,0,13
1388315,1081956,2021-05-20,Assembly,"Do pass",16,0,0,0,16
1388315,1092909,2021-06-01,Assembly,"AB 110 Petrie-Norris Third Reading Urgency",77,0,2,0,79
1388315,1102834,2021-06-29,Senate,"Do pass, but first be re-referred to the Committee on [Labor, Public Employment and Retirement ]",4,0,1,0,5
1388315,1104651,2021-07-12,Senate,"Do pass, but first be re-referred to the Committee on [Appropriations] with the recommendation: To Consent Calendar",5,0,0,0,5
1388315,1106108,2021-08-16,Senate,"Placed on suspense file",7,0,0,0,7
1388315,1107009,2021-08-26,Senate,"Do pass",7,0,0,0,7
1388315,1107435,2021-09-01,Senate,"Assembly 3rd Reading AB110 Petrie-Norris et al. By Allen Urgency Clause",39,0,0,1,40
1388315,1107696,2021-09-02,Assembly,"AB 110 Petrie-Norris Concurrence in Senate Amendments",75,0,0,4,79
1388317,1035216,2021-03-23,Assembly,"Do pass as amended, and be re-referred to the Committee on [Appropriations] with recommendation: To Consent Calendar",15,0,0,0,15
1388319,1052017,2021-04-13,Assembly,"Do pass and be re-referred to the Committee on [Appropriations]",15,0,0,0,15
1388319,1081893,2021-05-20,Assembly,"Do pass as amended",16,0,0,0,16
1388319,1087073,2021-05-27,Assembly,"AB 114 Maienschein Assembly Third Reading",77,0,1,0,78
1388319,1098635,2021-06-16,Senate,"Do pass, but first be re-referred to the Committee on [Appropriations]",10,0,1,0,11
1388500,1054683,2021-04-15,Assembly,"Do pass as amended and be re-referred to the Committee on [Local Government]",5,2,1,0,8
1388502,1044974,2021-04-05,Assembly,"Do pass and be re-referred to the Committee on [Appropriations]",11,0,4,0,15
1388502,1082072,2021-05-20,Assembly,"Do pass as amended",12,3,1,0,16
1388502,1092930,2021-06-01,Assembly,"AB 117 Boerner Horvath Assembly Third Reading",74,2,3,0,79
1388502,1101571,2021-06-24,Senate,"Do pass, but first be re-referred to the Committee on [Environmental Quality]",14,0,3,0,17
1388502,1104587,2021-07-12,Senate,"Do pass, but first be re-referred to the Committee on [Appropriations]",6,1,0,0,7
1388502,1106105,2021-08-16,Senate,"Placed on suspense file",7,0,0,0,7
1388502,1223526,2022-08-11,Senate,"Do pass as amended",5,0,0,2,7
1388502,1224667,2022-08-24,Senate,"Assembly 3rd Reading AB117 Boerner Horvath et a By Gonzalez",37,0,0,3,40
1388502,1225004,2022-08-25,Assembly,"AB 117 Boerner Horvath Concurrence in Senate Amendments",73,0,0,7,80
1388503,1044959,2021-04-05,Assembly,"Do pass and be re-referred to the Committee on [Appropriations]",6,0,1,0,7
1388503,1081576,2021-05-20,Assembly,"Do pass",15,0,1,0,16
1388503,1087093,2021-05-27,Assembly,"AB 118 Kamlager Assembly Third Reading By KALRA",75,0,3,0,78
1388503,1104253,2021-07-06,Senate,"Do pass, but first be re-referred to the Committee on [Appropriations]",13,1,1,0,15
1388503,1105128,2021-07-15,Senate,"Placed on suspense file",7,0,0,0,7
1388503,1106923,2021-08-26,Senate,"Do pass as amended",6,0,0,1,7
1388503,1107487,2021-09-01,Senate,"Assembly 3rd Reading AB118 Kamlager et al",34,4,0,2,40
1388503,1108042,2021-09-08,Assembly,"AB 118 Kamlager Concurrence in Senate Amendments By BAUER-KAHAN",76,0,0,4,80
1388505,1048880,2021-04-08,Assembly,"Do pass and be re-referred to the Committee on [Appropriations]",22,0,0,0,22
1388505,1065153,2021-04-28,Assembly,"Do pass. To Consent Calendar",16,0,0,0,16
1388505,1074156,2021-05-06,Assembly,"AB 120 Salas Consent Calendar Second Day",77,0,1,0,78
1388505,1095061,2021-06-08,Senate,"Do pass, but first be re-referred to the Committee on [Appropriations] with the recommendation: To Consent Calendar",14,0,1,0,15
1388505,1101577,2021-06-24,Senate,"Consent Calendar AB120",39,0,1,0,40
1388507,1035251,2021-03-22,Assembly,"Do pass as amended and be re-referred to the Committee on [Appropriations]",10,4,1,0,15
1388507,1053489,2021-04-14,Assembly,"Do pass",12,3,1,0,16
1388507,1060891,2021-04-22,Assembly,"AB 122 Boerner Horvath Assembly Third Reading",53,11,15,0,79
1388507,1102842,2021-06-29,Senate,"Do pass as amended, but first amend, and re-refer to the Committee on [Appropriations]",14,2,1,0,17
1388507,1107191,2021-08-30,Senate,"Assembly 3rd Reading AB122 Boerner Horvath et a By Wiener",31,5,0,4,40
1388507,1107389,2021-09-01,Assembly,"AB 122 Boerner Horvath Concurrence in Senate Amendments",49,19,0,11,79
1388508,1054747,2021-04-15,Assembly,"Do pass and be re-referred to the Committee on [Appropriations]",10,1,2,0,13
1388508,1081823,2021-05-20,Assembly,"Do pass",12,3,1,0,16
1388508,1086975,2021-05-27,Assembly,"AB 123 Lorena Gonzalez Assembly Third Reading",65,0,13,0,78
1388508,1100252,2021-06-21,Senate,"Do pass, but first be re-referred to the Committee on [Appropriations]",5,0,0,0,5
1388508,1104201,2021-07-05,Senate,"Placed on suspense file",6,0,1,0,7
1388508,1106966,2021-08-26,Senate,"Do pass",5,0,0,2,7
1388508,1108216,2021-09-08,Senate,"Assembly 3rd Reading AB123 Lorena Gonzalez et a By Lim贸n",32,0,0,8,40
1388508,1108243,2021-09-09,Assembly,"AB 123 Lorena Gonzalez Concurrence in Senate Amendments",68,0,0,12,80
1388509,1059167,2021-04-20,Assembly,"Do pass and be re-referred to the Committee on [Appropriations]",6,2,0,0,8
1388509,1081765,2021-05-20,Assembly,"Do pass",12,4,0,0,16
1388509,1090494,2021-06-02,Assembly,"AB 124 Kamlager Assembly Third Reading By GARCIA, C",54,12,13,0,79
1388509,1104262,2021-07-06,Senate,"Do pass as amended, but first amend, and re-refer to the Committee on [Appropriations]",4,0,1,0,5
1388509,1106086,2021-08-16,Senate,"Placed on suspense file",7,0,0,0,7
1388509,1106744,2021-08-26,Senate,"Do pass as amended",5,2,0,0,7
1388509,1107703,2021-09-02,Senate,"Assembly 3rd Reading AB124 Kamlager et al",28,8,0,4,40
1388509,1107704,2021-09-02,Senate,"Assembly 3rd Reading AB124 Kamlager et al. Reconsider",39,0,0,1,40
1388509,1108607,2021-09-10,Senate,"Assembly 3rd Reading AB124 Kamlager et al. By Kamlager",23,9,0,8,40
1388509,1108608,2021-09-10,Assembly,"AB 124 Kamlager Concurrence in Senate Amendments By GARCIA, C",55,16,0,9,80
1388510,1054713,2021-04-15,Assembly,"Do pass and be re-referred to the Committee on [Natural Resources]",10,0,1,0,11
1388511,1036442,2021-03-24,Assembly,"Do pass as amended, and be re-referred to the Committee on [Appropriations] with recommendation: To Consent Calendar",7,0,0,0,7
1388511,1081849,2021-05-20,Assembly,"Do pass",16,0,0,0,16
1388511,1090451,2021-06-02,Assembly,"AB 126 Eduardo Garcia Assembly Third Reading",76,0,3,0,79
1388512,1059234,2021-04-20,Assembly,"Do pass",6,0,2,0,8
1388512,1068180,2021-05-03,Assembly,"AB 127 Kamlager Assembly Third Reading By STONE",57,8,13,0,78
1388512,1095076,2021-06-08,Senate,"Do pass",4,0,1,0,5
1388512,1097059,2021-06-10,Senate,"Assembly 3rd Reading AB127 Kamlager",30,7,3,0,40
1388513,1098162,2021-06-15,Assembly,"Be adopted and re-referred to the Committee on [Appropriations]",7,0,1,0,8
1388513,1106727,2021-08-26,Assembly,"Be adopted",13,0,0,3,16
1388513,1173480,2022-03-21,Assembly,"ACA 3 Kamlager Assembly Third Reading By KALRA",59,0,0,17,76
1388513,1210944,2022-05-31,Senate,"Be adopted, but first be re-referred to the Committee on [Elections and Constitutional Amendments]",5,0,0,0,5
1388513,1215540,2022-06-13,Senate,"Be adopted, but first be re-referred to the Committee on [Appropriations]",4,0,0,1,5
1388513,1216633,2022-06-16,Senate,"Be adopted",5,0,0,2,7
1388513,1218667,2022-06-23,Senate,"Assembly 3rd Reading ACA3 Kamlager et al. Reconsider",21,6,0,13,40
1388513,1218668,2022-06-23,Senate,"Assembly 3rd Reading ACA3 Kamlager et al. Reconsider",34,0,0,6,40
1388733,1026133,2021-03-10,Senate,"Do pass, but first be re-referred to the Committee on [Appropriations] with the recommendation: To Consent Calendar",7,0,0,0,7
1388733,1033683,2021-03-22,Senate,"Placed on suspense file",7,0,0,0,7
1388733,1081833,2021-05-20,Senate,"Do pass",7,0,0,0,7
1388733,1089470,2021-06-01,Senate,"Special Consent SB97",39,0,1,0,40
1388733,1104467,2021-07-07,Assembly,"Do pass as amended, and be re-referred to the Committee on [Appropriations] with recommendation: To Consent Calendar",7,0,0,0,7
1388733,1106811,2021-08-26,Assembly,"Do pass",16,0,0,0,16
1388733,1107544,2021-09-01,Assembly,"SB 97 Roth Senate Third Reading By Cervantes",78,0,0,1,79
1388733,1107640,2021-09-02,Senate,"Unfinished Business SB97 Roth Concurrence",39,0,0,1,40
1388849,1025146,2021-03-09,Senate,"Do pass, but first be re-referred to the Committee on [Appropriations]",3,0,1,0,4
1388849,1033624,2021-03-22,Senate,"Placed on suspense file",7,0,0,0,7
1388849,1081800,2021-05-20,Senate,"Do pass as amended",6,0,1,0,7
1388849,1089530,2021-06-01,Senate,"Senate 3rd Reading SB98 McGuire et al",34,2,4,0,40
1388849,1104711,2021-07-13,Assembly,"Do pass and be re-referred to the Committee on [Appropriations]",6,2,0,0,8
1388849,1106950,2021-08-26,Assembly,"Do pass as amended",12,4,0,0,16
1388849,1108605,2021-09-10,Senate,"Unfinished Business SB98 McGuire et al. Concurrence",29,5,0,6,40
1388849,1108606,2021-09-10,Assembly,"SB 98 McGuire Senate Third Reading By Wicks",50,18,0,12,80
1388850,1170596,2022-03-15,Senate,"Be adopted, but first be re-referred to the Committee on [Appropriations]",4,8,0,3,15
1388850,1170597,2022-03-15,Senate,"[03-15-2022] hearing: Motion to Reconsider. [Reconsideration Granted.]",14,0,0,1,15
1389028,1035259,2021-03-23,Senate,"Do pass as amended, but first amend, and re-refer to the Committee on [Appropriations] with the recommendation: To Consent Calendar",5,0,0,0,5
1389028,1056375,2021-04-19,Senate,"Placed on suspense file",7,0,0,0,7
1389029,1056413,2021-04-19,Senate,"Do pass, but first be re-referred to the Committee on [Appropriations]",12,0,2,0,14
1389029,1068266,2021-05-03,Senate,"Placed on suspense file",6,0,1,0,7
1389029,1081467,2021-05-20,Senate,"Do pass",7,0,0,0,7
1389029,1083813,2021-05-24,Senate,"Senate 3rd Reading SB99 Dodd",40,0,0,0,40
1389029,1103383,2021-06-30,Assembly,"Do pass as amended, and be re-referred to the Committee on [Appropriations] with recommendation: To Consent Calendar",15,0,0,0,15
1391001,1025092,2021-03-09,Senate,"Do pass, but first be re-referred to the Committee on [Appropriations] with the recommendation: To Consent Calendar",4,0,0,0,4
1391001,1033654,2021-03-22,Senate,"Placed on suspense file",7,0,0,0,7
1391785,1044964,2021-04-05,Senate,"Do pass as amended, but first amend, and re-refer to the Committee on [Governmental Organization]",6,7,1,0,14
1391785,1044965,2021-04-05,Senate,"[Final] hearing set for [04-05-2021]: Failed passage in Committee. Reconsideration granted",14,0,0,0,14
1394324,1028419,2021-03-15,Senate,"Do pass as amended, but first amend, and re-refer to the Committee on [Appropriations]",5,0,0,0,5
1394324,1062799,2021-04-26,Senate,"Senate 3rd Reading SB103 Dodd",38,0,2,0,40
1394324,1210208,2022-05-27,Assembly,"Be re-referred to the Committee on [Elections]",7,0,0,4,11
1394324,1220663,2022-06-29,Assembly,"Do pass and be re-referred to the Committee on [Appropriations] with recommendation: To Consent Calendar",7,0,0,0,7
1394324,1222999,2022-08-03,Assembly,"Do pass. To Consent Calendar",15,0,0,1,16
1394324,1223456,2022-08-11,Assembly,"SB 103 Dodd Consent Calendar Second Day Regular Session",76,0,0,4,80
1394325,1037808,2021-03-25,Senate,"Do pass as amended, but first amend, and re-refer to the Committee on [Appropriations]",5,0,0,0,5
1394325,1056352,2021-04-19,Senate,"Placed on suspense file",7,0,0,0,7
1394327,1065148,2021-04-28,Senate,"Do pass as amended, but first amend, and re-refer to the Committee on [Appropriations]",11,0,0,0,11
1394327,1078732,2021-05-17,Senate,"Placed on suspense file",7,0,0,0,7
1394328,1025111,2021-03-09,Senate,"Do pass, but first be re-referred to the Committee on [Appropriations]",4,0,0,0,4
1394328,1120719,2022-01-06,Senate,"Senate 3rd Reading SB107 Wiener et al",32,0,0,8,40
1394328,1214971,2022-06-08,Assembly,"Do pass and be re-referred to the Committee on [Public Safety]",7,1,0,2,10
1394328,1220032,2022-06-28,Assembly,"Do pass as amended and be re-referred to the Committee on [Appropriations]",5,2,0,0,7
1394328,1222949,2022-08-03,Assembly,"Do pass",11,4,0,1,16
1394328,1223196,2022-08-08,Assembly,"SB 107 Wiener Senate Third Reading Amend By WILSON Set #1",52,18,0,10,80
1394328,1224365,2022-08-22,Assembly,"SB 107 Wiener Senate Third Reading By Wilson Amendment Set #1",56,17,0,7,80
1394328,1225070,2022-08-29,Assembly,"SB 107 Wiener Senate Third Reading By Wilson",60,19,0,1,80
1394328,1225166,2022-08-30,Senate,"That the Assembly amendments be concurred in",8,2,0,1,11
1394328,1225543,2022-08-31,Senate,"Unfinished Business SB107 Wiener et al. Concurrence",30,9,0,1,40
1394329,1035246,2021-03-23,Senate,"Do pass, but first be re-referred to the Committee on [Rules]",4,0,1,0,5
1394329,1068267,2021-05-03,Senate,"Placed on suspense file",6,0,1,0,7
1394329,1081549,2021-05-20,Senate,"Do pass as amended",5,1,1,0,7
1394329,1087613,2021-05-28,Senate,"Senate 3rd Reading SB108 Hurtado",35,1,4,0,40
1394329,1103482,2021-06-30,Assembly,"Do pass and be re-referred to the Committee on [Appropriations]",7,0,1,0,8
1395390,1025106,2021-03-09,Senate,"Do pass, but first be re-referred to the Committee on [Appropriations]",13,0,1,0,14
1395390,1033618,2021-03-22,Senate,"Placed on suspense file",7,0,0,0,7
1395390,1081830,2021-05-20,Senate,"Do pass as amended",7,0,0,0,7
1395390,1089481,2021-06-01,Senate,"Special Consent SB109",39,0,1,0,40
1395390,1104219,2021-07-05,Assembly,"Do pass and be re-referred to the Committee on [Appropriations]",7,0,0,0,7
1395390,1106838,2021-08-26,Assembly,"Do pass as amended",13,0,0,3,16
1395390,1107451,2021-09-01,Assembly,"SB 109 Dodd Senate Third Reading By Rodriguez",78,0,0,1,79
1395390,1107613,2021-09-02,Senate,"Unfinished Business SB109 Dodd et al. Concurrence",39,0,0,1,40
1395391,1059325,2021-04-21,Senate,"Do pass, but first be re-referred to the Committee on [Appropriations]",10,0,1,0,11
1395391,1078758,2021-05-17,Senate,"Placed on suspense file",7,0,0,0,7
1395391,1081434,2021-05-20,Senate,"Do pass",7,0,0,0,7
1395391,1089582,2021-06-01,Senate,"Special Consent SB110",39,0,1,0,40
1395391,1104747,2021-07-13,Assembly,"Do pass and be re-referred to the Committee on [Appropriations]",14,0,1,0,15
1395391,1106572,2021-08-26,Assembly,"Do pass as amended",13,0,0,3,16
1395391,1107667,2021-09-02,Assembly,"SB 110 Wiener Senate Third Reading By Irwin",76,0,0,3,79
1395391,1107788,2021-09-03,Senate,"Unfinished Business SB110 Wiener et al. Concurrence",38,0,0,2,40
1395392,988122,2021-01-15,Senate,"Senate 3rd Reading SCR6 Bradford",30,0,9,0,39
1395392,992310,2021-01-28,Assembly,"Be adopted. To Consent Calendar",10,0,2,0,12
1395392,996629,2021-02-04,Assembly,"SCR 6 Bradford Consent Calendar Second Day Regular Session",72,0,7,0,79
1398145,1016207,2021-02-25,Assembly,"AB 128 BUDGET Assembly Third Reading By TING",56,18,5,0,79
1398145,1097785,2021-06-14,Senate,"Do pass",13,2,3,0,18
1398145,1097786,2021-06-14,Senate,"Assembly 2nd Reading AB128 Ting By Skinner",30,8,2,0,40
1398145,1097787,2021-06-14,Assembly,"AB 128 TING Concurrence in Senate Amendments",58,18,3,0,79
1398146,1016188,2021-02-25,Assembly,"AB 129 BUDGET Assembly Third Reading By TING",56,18,5,0,79
1398146,1102499,2021-06-28,Senate,"Do pass",13,1,4,0,18
1398146,1219402,2022-06-27,Senate,"Do pass",15,0,0,4,19
1398147,1016252,2021-02-25,Assembly,"AB 130 BUDGET Assembly Third Reading By TING",56,18,5,0,79
1398147,1104436,2021-07-07,Senate,"Do pass",13,2,3,0,18
1398147,1104573,2021-07-08,Senate,"Assembly 2nd Reading AB130 BUDGET (Ting) By Skinner",33,2,5,0,40
1398147,1104574,2021-07-08,Assembly,"AB 130 BUDGET Concurrence in Senate Amendments By TING",61,11,7,0,79
1398148,1016190,2021-02-25,Assembly,"AB 131 BUDGET Assembly Third Reading By TING",56,18,5,0,79
1398148,1104911,2021-07-14,Senate,"Do pass",15,0,3,0,18
1398148,1105155,2021-07-15,Senate,"Assembly 2nd Reading AB131 BUDGET (Ting) By Skinner",34,0,6,0,40
1398148,1105156,2021-07-15,Assembly,"AB 131 BUDGET Concurrence in Senate Amendments By TING",77,0,2,0,79
1398149,1016271,2021-02-25,Assembly,"AB 132 BUDGET Assembly Third Reading By TING",56,18,5,0,79
1398149,1104902,2021-07-14,Senate,"Do pass",15,2,1,0,18
1398149,1105106,2021-07-15,Senate,"Assembly 2nd Reading AB132 BUDGET (Ting) By Skinner",32,4,4,0,40
1398149,1105107,2021-07-15,Assembly,"AB 132 BUDGET Concurrence in Senate Amendments By TING",63,9,7,0,79
1398150,1016231,2021-02-25,Assembly,"AB 133 BUDGET Assembly Third Reading By TING",56,18,5,0,79
1398150,1104977,2021-07-14,Senate,"Do pass",13,4,1,0,18
1398150,1105080,2021-07-15,Senate,"Assembly 2nd Reading AB133 BUDGET (Ting) By Skinner",31,8,1,0,40
1398150,1105081,2021-07-15,Assembly,"AB 133 BUDGET Concurrence in Senate Amendments By TING",60,8,11,0,79
1398151,1016226,2021-02-25,Assembly,"AB 134 BUDGET Assembly Third Reading By TING",56,18,5,0,79
1398151,1103390,2021-06-30,Senate,"Do pass",17,0,1,0,18
1398151,1103788,2021-07-01,Senate,"Assembly 2nd Reading AB134 BUDGET (Ting) By Skinner",40,0,0,0,40
1398151,1103789,2021-07-01,Assembly,"AB 134 BUDGET Concurrence in Senate Amendments By TING",78,0,1,0,79
1398152,1016253,2021-02-25,Assembly,"AB 135 BUDGET Assembly Third Reading By TING",56,18,5,0,79
1398152,1104906,2021-07-14,Senate,"Do pass",13,4,1,0,18
1398152,1105132,2021-07-15,Senate,"Assembly 2nd Reading AB135 BUDGET (Ting) By Skinner",31,7,2,0,40
1398152,1105133,2021-07-15,Assembly,"AB 135 BUDGET Concurrence in Senate Amendments By TING",62,10,7,0,79
1398153,1016214,2021-02-25,Assembly,"AB 136 BUDGET Assembly Third Reading By TING",56,18,5,0,79
1398153,1103496,2021-06-30,Senate,"Do pass",16,0,2,0,18
1398153,1103772,2021-07-01,Senate,"Assembly 2nd Reading AB136 BUDGET (Ting) By Skinner",40,0,0,0,40
1398153,1103773,2021-07-01,Assembly,"AB 136 BUDGET Concurrence in Senate Amendments By TING",78,0,1,0,79
1398154,1016165,2021-02-25,Assembly,"AB 137 BUDGET Assembly Third Reading By TING",56,18,5,0,79
1398154,1103403,2021-06-30,Senate,"Do pass",16,1,1,0,18
1398154,1103846,2021-07-01,Senate,"Assembly 2nd Reading AB137 BUDGET (Ting) By Skinner",34,3,3,0,40
1398154,1103847,2021-07-01,Assembly,"AB 137 BUDGET Concurrence in Senate Amendments By TING",61,13,5,0,79
1398155,1016260,2021-02-25,Assembly,"AB 138 BUDGET Assembly Third Reading By TING",56,18,5,0,79
1398155,1103461,2021-06-30,Senate,"Do pass",15,1,2,0,18
1398155,1103770,2021-07-01,Senate,"Assembly 2nd Reading AB138 BUDGET (Ting) By Skinner",33,5,2,0,40
1398155,1103771,2021-07-01,Assembly,"AB 138 BUDGET Concurrence in Senate Amendments By TING",62,14,3,0,79
1398156,1016274,2021-02-25,Assembly,"AB 139 BUDGET Assembly Third Reading By TING",56,18,5,0,79
1398156,1102521,2021-06-28,Senate,"Do pass",14,3,1,0,18
1398156,1134575,2022-02-03,Senate,"Do pass",16,0,0,2,18
1398157,1016168,2021-02-25,Assembly,"AB 140 BUDGET Assembly Third Reading By TING",56,18,5,0,79
1398157,1104883,2021-07-14,Senate,"Do pass",16,0,2,0,18
1398157,1105076,2021-07-15,Senate,"Assembly 2nd Reading AB140 BUDGET (Ting) By Skinner",38,0,2,0,40
1398157,1105077,2021-07-15,Assembly,"AB 140 BUDGET Concurrence in Senate Amendments By TING",67,9,3,0,79
1398158,1016251,2021-02-25,Assembly,"AB 141 BUDGET Assembly Third Reading By TING",56,18,5,0,79
1398158,1103365,2021-06-30,Senate,"Do pass",13,0,5,0,18
1398158,1103752,2021-07-01,Senate,"Assembly 2nd Reading AB141 BUDGET (Ting) By Skinner",28,5,7,0,40
1398158,1103753,2021-07-01,Assembly,"AB 141 BUDGET Concurrence in Senate Amendments By TING",58,18,3,0,79
1398159,1016236,2021-02-25,Assembly,"AB 142 BUDGET Assembly Third Reading By TING",56,18,5,0,79
1398159,1102523,2021-06-28,Senate,"Do pass",16,1,1,0,18
1398159,1134589,2022-02-03,Senate,"Do pass",16,0,0,2,18
1398160,1016232,2021-02-25,Assembly,"AB 143 BUDGET Assembly Third Reading By TING",56,18,5,0,79
1398160,1103377,2021-06-30,Senate,"Do pass",17,0,1,0,18
1398160,1103800,2021-07-01,Senate,"Assembly 2nd Reading AB143 BUDGET (Ting) By Skinner",40,0,0,0,40
1398160,1103801,2021-07-01,Assembly,"AB 143 BUDGET Concurrence in Senate Amendments By TING",60,11,8,0,79
1398161,1016270,2021-02-25,Assembly,"AB 144 BUDGET Assembly Third Reading By TING",56,18,5,0,79
1398161,1104986,2021-07-14,Senate,"Do pass",15,0,3,0,18
1398162,1016178,2021-02-25,Assembly,"AB 145 BUDGET Assembly Third Reading By TING",56,18,5,0,79
1398162,1103402,2021-06-30,Senate,"Do pass",13,4,1,0,18
1398162,1103850,2021-07-01,Senate,"Assembly 2nd Reading AB145 BUDGET (Ting) By Skinner",30,10,0,0,40
1398162,1103851,2021-07-01,Assembly,"AB 145 BUDGET Concurrence in Senate Amendments By TING",55,7,17,0,79
1398163,1016263,2021-02-25,Assembly,"AB 146 BUDGET Assembly Third Reading By TING",56,18,5,0,79
1398163,1102470,2021-06-28,Senate,"Do pass",13,4,1,0,18
1398164,1016262,2021-02-25,Assembly,"AB 147 BUDGET Assembly Third Reading By TING",56,18,5,0,79
1398164,1102471,2021-06-28,Senate,"Do pass",17,0,1,0,18
1398164,1134596,2022-02-03,Senate,"Do pass",13,2,0,3,18
1398165,1016220,2021-02-25,Assembly,"AB 148 BUDGET Assembly Third Reading By TING",56,18,5,0,79
1398165,1104947,2021-07-14,Senate,"Do pass",13,3,2,0,18
1398165,1105109,2021-07-15,Senate,"Assembly 2nd Reading AB148 BUDGET (Ting) By Skinner",29,9,2,0,40
1398165,1105110,2021-07-15,Assembly,"AB 148 BUDGET Concurrence in Senate Amendments By TING",58,18,3,0,79
1398166,1016243,2021-02-25,Assembly,"AB 149 BUDGET Assembly Third Reading By TING",56,18,5,0,79
1398166,1103394,2021-06-30,Senate,"Do pass",17,0,1,0,18
1398166,1103807,2021-07-01,Senate,"Assembly 2nd Reading AB149 BUDGET (Ting) By Skinner",39,0,1,0,40
1398166,1103808,2021-07-01,Assembly,"AB 149 BUDGET Concurrence in Senate Amendments By TING",78,0,1,0,79
1398167,1016255,2021-02-25,Assembly,"AB 150 BUDGET Assembly Third Reading By TING",56,18,5,0,79
1398167,1103384,2021-06-30,Senate,"Do pass",17,0,1,0,18
1398167,1103836,2021-07-01,Senate,"Assembly 2nd Reading AB150 BUDGET (Ting) By Skinner",40,0,0,0,40
1398167,1103837,2021-07-01,Assembly,"AB 150 BUDGET Concurrence in Senate Amendments By TING",78,0,1,0,79
1398168,1016240,2021-02-25,Assembly,"AB 151 BUDGET Assembly Third Reading By TING",56,18,5,0,79
1398168,1103401,2021-06-30,Senate,"Do pass",15,0,3,0,18
1398168,1225127,2022-08-29,Senate,"Do pass",18,0,0,1,19
1398168,1225435,2022-08-30,Senate,"Assembly 2nd Reading AB151 BUDGET (Ting) By Skinner",40,0,0,0,40
1398168,1225436,2022-08-31,Assembly,"AB 151 BUDGET Concurrence in Senate Amendments By TING",80,0,0,0,80
1398169,1016191,2021-02-25,Assembly,"AB 152 BUDGET Assembly Third Reading By TING",56,18,5,0,79
1398169,1102494,2021-06-28,Senate,"Do pass",12,4,2,0,18
1398169,1225079,2022-08-29,Senate,"Do pass",15,0,0,4,19
1398169,1225471,2022-08-30,Senate,"Assembly 2nd Reading AB152 BUDGET (Ting) By Skinner",32,0,0,8,40
1398169,1225472,2022-08-31,Assembly,"AB 152 BUDGET Concurrence in Senate Amendments By TING",79,0,0,1,80
1398170,1016234,2021-02-25,Assembly,"AB 153 BUDGET Assembly Third Reading By TING",56,18,5,0,79
1398170,1104904,2021-07-14,Senate,"Do pass",15,0,3,0,18
1398170,1105040,2021-07-15,Senate,"Assembly 2nd Reading AB153 BUDGET (Ting) By Skinner",36,0,4,0,40
1398170,1105041,2021-07-15,Assembly,"AB 153 BUDGET Concurrence in Senate Amendments By TING",73,0,6,0,79
1398171,1016266,2021-02-25,Assembly,"AB 154 BUDGET Assembly Third Reading By TING",56,18,5,0,79
1398171,1215289,2022-06-09,Senate,"Do pass",12,2,0,5,19
1398172,1016222,2021-02-25,Assembly,"AB 155 BUDGET Assembly Third Reading By TING",56,18,5,0,79
1398172,1108660,2021-09-07,Senate,"Do pass",12,4,0,2,18
1398173,1016250,2021-02-25,Assembly,"AB 156 BUDGET Assembly Third Reading By TING",56,18,5,0,79
1398173,1104908,2021-07-14,Senate,"Do pass",15,0,3,0,18
1398173,1225093,2022-08-29,Senate,"Do pass",14,1,0,4,19
1398173,1225489,2022-08-30,Senate,"Assembly 2nd Reading AB156 BUDGET (Ting) By Skinner",31,3,0,6,40
1398173,1225490,2022-08-31,Assembly,"AB 156 BUDGET Concurrence in Senate Amendments By TING",64,8,0,8,80
1398174,1016180,2021-02-25,Assembly,"AB 157 BUDGET Assembly Third Reading By TING",56,18,5,0,79
1398174,1103406,2021-06-30,Senate,"Do pass",13,4,1,0,18
1398174,1225050,2022-08-29,Senate,"Do pass",14,0,0,5,19
1398174,1225482,2022-08-30,Senate,"Assembly 2nd Reading AB157 BUDGET (Ting) By Skinner",32,0,0,8,40
1398174,1225483,2022-08-31,Assembly,"AB 157 BUDGET Concurrence in Senate Amendments By TING",67,0,0,13,80
1398175,1016242,2021-02-25,Assembly,"AB 158 BUDGET Assembly Third Reading By TING",56,18,5,0,79
1398175,1102512,2021-06-28,Senate,"Do pass",13,3,2,0,18
1398175,1225074,2022-08-29,Senate,"Do pass",14,3,0,2,19
1398175,1225290,2022-08-30,Senate,"Assembly 2nd Reading AB158 BUDGET (Ting) By Skinner",31,9,0,0,40
1398175,1225291,2022-08-31,Assembly,"AB 158 BUDGET Concurrence in Senate Amendments By TING",65,2,0,13,80
1398176,1016201,2021-02-25,Assembly,"AB 159 BUDGET Assembly Third Reading By TING",56,18,5,0,79
1398176,1102446,2021-06-28,Senate,"Do pass",16,0,2,0,18
1398176,1102447,2021-06-28,Senate,"Assembly 2nd Reading AB159 BUDGET (Ting) By Skinner",35,2,3,0,40
1398177,1016257,2021-02-25,Assembly,"AB 160 BUDGET Assembly Third Reading By TING",56,18,5,0,79
1398177,1104930,2021-07-14,Senate,"Do pass",14,3,1,0,18
1398177,1225123,2022-08-29,Senate,"Do pass",15,0,0,4,19
1398177,1225449,2022-08-30,Senate,"Assembly 2nd Reading AB160 BUDGET (Ting) By Skinner",31,0,0,9,40
1398177,1225450,2022-08-31,Assembly,"AB 160 BUDGET Concurrence in Senate Amendments By TING",69,0,0,11,80
1398178,1016229,2021-02-25,Assembly,"AB 161 BUDGET Assembly Third Reading By TING",56,18,5,0,79
1398178,1104408,2021-07-07,Senate,"Do pass",16,0,2,0,18
1398178,1104512,2021-07-08,Senate,"Assembly 2nd Reading AB161 Ting By Skinner",38,0,2,0,40
1398178,1104513,2021-07-08,Assembly,"AB 161 TING Concurrence in Senate Amendments",75,0,4,0,79
1398179,1016161,2021-02-25,Assembly,"AB 162 BUDGET Assembly Third Reading By TING",56,18,5,0,79
1398179,1108681,2021-09-07,Senate,"Do pass",12,5,0,1,18
1398180,1016269,2021-02-25,Assembly,"AB 163 BUDGET Assembly Third Reading By TING",56,18,5,0,79
1398180,1108338,2021-09-09,Senate,"Assembly 3rd Reading AB163 BUDGET (Ting) By Skinner",38,0,0,2,40
1398180,1108339,2021-09-09,Assembly,"AB 163 BUDGET Concurrence in Senate Amendments By TING",78,0,0,2,80
1398180,1108645,2021-09-07,Senate,"Do pass",17,0,0,1,18
1398181,1016273,2021-02-25,Assembly,"AB 164 BUDGET Assembly Third Reading By TING",56,18,5,0,79
1398181,1104985,2021-07-14,Senate,"Do pass",16,0,2,0,18
1398181,1105123,2021-07-15,Senate,"Assembly 2nd Reading AB164 Ting By Skinner",37,0,3,0,40
1398181,1105124,2021-07-15,Assembly,"AB 164 TING Concurrence in Senate Amendments",73,5,1,0,79
1398182,1016247,2021-02-25,Assembly,"AB 165 BUDGET Assembly Third Reading By TING",56,18,5,0,79
1398182,1108655,2021-09-07,Senate,"Do pass",17,0,0,1,18
1398183,1016170,2021-02-25,Assembly,"AB 166 BUDGET Assembly Third Reading By TING",56,18,5,0,79
1398183,1108661,2021-09-07,Senate,"Do pass",12,5,0,1,18
1398184,1016235,2021-02-25,Assembly,"AB 167 BUDGET Assembly Third Reading By TING",56,18,5,0,79
1398184,1108426,2021-09-09,Senate,"Assembly 3rd Reading AB167 BUDGET (Ting) By Skinner",38,0,0,2,40
1398184,1108427,2021-09-09,Assembly,"AB 167 BUDGET Concurrence in Senate Amendments By TING",71,0,0,9,80
1398184,1108577,2021-09-07,Senate,"Do pass",16,0,0,2,18
1398185,1016187,2021-02-25,Assembly,"AB 168 BUDGET Assembly Third Reading By TING",56,18,5,0,79
1398185,1108642,2021-09-07,Senate,"Do pass",17,0,0,1,18
1398185,1169418,2022-03-14,Senate,"Do pass",16,0,0,3,19
1398186,1016172,2021-02-25,Assembly,"AB 169 BUDGET Assembly Third Reading By TING",56,18,5,0,79
1398186,1108675,2021-09-07,Senate,"Do pass",17,0,0,1,18
1398186,1169422,2022-03-14,Senate,"Do pass",13,2,0,4,19
1398187,1016275,2021-02-25,Assembly,"AB 170 BUDGET Assembly Third Reading By TING",56,18,5,0,79
1398187,1108597,2021-09-07,Senate,"Do pass",12,2,0,4,18
1398188,1016167,2021-02-25,Assembly,"AB 171 BUDGET Assembly Third Reading By TING",56,18,5,0,79
1398188,1108666,2021-09-07,Senate,"Do pass",17,0,0,1,18
1398189,1016258,2021-02-25,Assembly,"AB 172 BUDGET Assembly Third Reading By TING",56,18,5,0,79
1398189,1108247,2021-09-09,Senate,"Assembly 3rd Reading AB172 BUDGET (Ting) By Skinner",32,1,0,7,40
1398189,1108248,2021-09-09,Assembly,"AB 172 BUDGET Concurrence in Senate Amendments By TING",79,0,0,1,80
1398189,1108591,2021-09-07,Senate,"Do pass",14,1,0,3,18
1398190,1016219,2021-02-25,Assembly,"AB 173 BUDGET Assembly Third Reading By TING",56,18,5,0,79
1398190,1108393,2021-09-09,Senate,"Assembly 3rd Reading AB173 BUDGET (Ting) By Skinner",28,9,0,3,40
1398190,1108394,2021-09-09,Assembly,"AB 173 BUDGET Concurrence in Senate Amendments By TING",59,18,0,3,80
1398190,1108540,2021-09-07,Senate,"Do pass",12,5,0,1,18
1398191,1016171,2021-02-25,Assembly,"AB 174 BUDGET Assembly Third Reading By TING",56,18,5,0,79
1398191,1108326,2021-09-09,Senate,"Assembly 3rd Reading AB174 BUDGET (Ting) By Skinner",35,0,0,5,40
1398191,1108327,2021-09-09,Assembly,"AB 174 BUDGET Concurrence in Senate Amendments By TING",79,0,0,1,80
1398191,1108659,2021-09-07,Senate,"Do pass",15,0,0,3,18
1398192,1016205,2021-02-25,Assembly,"AB 175 BUDGET Assembly Third Reading By TING",56,18,5,0,79
1398192,1108436,2021-09-09,Senate,"Assembly 3rd Reading AB175 BUDGET (Ting) By Skinner",30,0,0,10,40
1398192,1108437,2021-09-09,Assembly,"AB 175 BUDGET Concurrence in Senate Amendments By TING",79,0,0,1,80
1398192,1108662,2021-09-07,Senate,"Do pass",13,0,0,5,18
1398193,1016173,2021-02-25,Assembly,"AB 176 BUDGET Assembly Third Reading By TING",56,18,5,0,79
1398193,1108446,2021-09-09,Senate,"Assembly 3rd Reading AB176 BUDGET (Ting) By Skinner",34,0,0,6,40
1398193,1108447,2021-09-09,Assembly,"AB 176 BUDGET Concurrence in Senate Amendments By TING",79,0,0,1,80
1398193,1108667,2021-09-07,Senate,"Do pass",13,0,0,5,18
1398194,1016256,2021-02-25,Assembly,"AB 177 BUDGET Assembly Third Reading By TING",56,18,5,0,79
1398194,1108398,2021-09-09,Senate,"Assembly 3rd Reading AB177 BUDGET (Ting) By Skinner",29,9,0,2,40
1398194,1108399,2021-09-09,Assembly,"AB 177 BUDGET Concurrence in Senate Amendments By TING",57,19,0,4,80
1398194,1108617,2021-09-07,Senate,"Do pass",12,4,0,2,18
1398195,1016239,2021-02-25,Assembly,"AB 178 BUDGET Assembly Third Reading By TING",56,18,5,0,79
1398195,1219496,2022-06-27,Senate,"Do pass",12,2,0,5,19
1398195,1221527,2022-06-29,Senate,"Assembly 3rd Reading AB178 Ting By Skinner",28,6,0,6,40
1398195,1221528,2022-06-29,Assembly,"AB 178 TING Concurrence in Senate Amendments",61,8,0,11,80
1398196,1016216,2021-02-25,Assembly,"AB 179 BUDGET Assembly Third Reading By TING",56,18,5,0,79
1398196,1225055,2022-08-29,Senate,"Do pass",14,2,0,3,19
1398196,1225980,2022-08-31,Senate,"Assembly 3rd Reading AB179 Ting By Skinner",31,7,0,2,40
1398196,1225981,2022-08-31,Assembly,"AB 179 TING Concurrence in Senate Amendments",60,13,0,7,80
1398197,1016151,2021-02-25,Assembly,"AB 180 BUDGET Assembly Third Reading By TING",56,18,5,0,79
1398197,1219428,2022-06-27,Senate,"Do pass",12,2,0,5,19
1398197,1221708,2022-06-29,Senate,"Assembly 3rd Reading AB180 Ting By Skinner",28,7,0,5,40
1398197,1221709,2022-06-29,Assembly,"AB 180 TING Concurrence in Senate Amendments",61,16,0,3,80
1398198,1016238,2021-02-25,Assembly,"AB 181 BUDGET Assembly Third Reading By TING",56,18,5,0,79
1398198,1219398,2022-06-27,Senate,"Do pass",15,0,0,4,19
1398198,1221543,2022-06-29,Senate,"Assembly 3rd Reading AB181 BUDGET (Ting) By Skinner",36,0,0,4,40
1398198,1221544,2022-06-29,Assembly,"AB 181 BUDGET Concurrence in Senate Amendments By TING",78,0,0,2,80
1398199,1016245,2021-02-25,Assembly,"AB 182 BUDGET Assembly Third Reading By TING",56,18,5,0,79
1398199,1219390,2022-06-27,Senate,"Do pass",15,0,0,4,19
1398199,1221545,2022-06-29,Senate,"Assembly 3rd Reading AB182 BUDGET (Ting) By Skinner",36,0,0,4,40
1398199,1221546,2022-06-29,Assembly,"AB 182 BUDGET Concurrence in Senate Amendments By TING",79,0,0,1,80
1398200,1016209,2021-02-25,Assembly,"AB 183 BUDGET Assembly Third Reading By TING",56,18,5,0,79
1398200,1219527,2022-06-27,Senate,"Do pass",15,0,0,4,19
1398200,1221590,2022-06-29,Senate,"Assembly 3rd Reading AB183 BUDGET (Ting) By Skinner",36,0,0,4,40
1398200,1221591,2022-06-29,Assembly,"AB 183 BUDGET Concurrence in Senate Amendments By TING",79,0,0,1,80
1398201,1016237,2021-02-25,Assembly,"AB 184 BUDGET Assembly Third Reading By TING",56,18,5,0,79
1398201,1219458,2022-06-27,Senate,"Do pass",12,3,0,4,19
1398202,1016186,2021-02-25,Assembly,"AB 185 BUDGET Assembly Third Reading By TING",56,18,5,0,79
1398202,1225099,2022-08-29,Senate,"Do pass",15,0,0,4,19
1398202,1225375,2022-08-30,Senate,"Assembly 2nd Reading AB185 BUDGET (Ting) By Skinner",33,2,0,5,40
1398202,1225376,2022-08-31,Assembly,"AB 185 BUDGET Concurrence in Senate Amendments By TING",79,0,0,1,80
1398203,1016261,2021-02-25,Assembly,"AB 186 BUDGET Assembly Third Reading By TING",56,18,5,0,79
1398203,1219497,2022-06-27,Senate,"Do pass",12,3,0,4,19
1398203,1221598,2022-06-29,Senate,"Assembly 3rd Reading AB186 BUDGET (Ting) By Skinner",28,8,0,4,40
1398203,1221599,2022-06-29,Assembly,"AB 186 BUDGET Concurrence in Senate Amendments By TING",59,17,0,4,80
1398204,1016225,2021-02-25,Assembly,"AB 187 BUDGET Assembly Third Reading By TING",56,18,5,0,79
1398204,1219407,2022-06-27,Senate,"Do pass",13,1,0,5,19
1398205,1016210,2021-02-25,Assembly,"AB 188 BUDGET Assembly Third Reading By TING",56,18,5,0,79
1398205,1219389,2022-06-27,Senate,"Do pass",15,0,0,4,19
1398206,1016189,2021-02-25,Assembly,"AB 189 BUDGET Assembly Third Reading By TING",56,18,5,0,79
1398206,1219471,2022-06-27,Senate,"Do pass",12,2,0,5,19
1398207,1016185,2021-02-25,Assembly,"AB 190 BUDGET Assembly Third Reading By TING",56,18,5,0,79
1398207,1225068,2022-08-29,Senate,"Do pass",14,1,0,4,19
1398207,1225955,2022-08-30,Senate,"Assembly 2nd Reading AB190 BUDGET (Ting) By Skinner",31,2,0,7,40
1398207,1225956,2022-08-31,Assembly,"AB 190 BUDGET Concurrence in Senate Amendments By TING",70,1,0,9,80
1398208,1016254,2021-02-25,Assembly,"AB 191 BUDGET Assembly Third Reading By TING",56,18,5,0,79
1398208,1219450,2022-06-27,Senate,"Do pass",12,0,0,7,19
1398209,1016248,2021-02-25,Assembly,"AB 192 BUDGET Assembly Third Reading By TING",56,18,5,0,79
1398209,1219463,2022-06-27,Senate,"Do pass",14,0,0,5,19
1398209,1221592,2022-06-29,Senate,"Assembly 3rd Reading AB192 BUDGET (Ting) By Skinner",36,0,0,4,40
1398209,1221593,2022-06-29,Assembly,"AB 192 BUDGET Concurrence in Senate Amendments By TING",74,0,0,6,80
1398210,1016206,2021-02-25,Assembly,"AB 193 BUDGET Assembly Third Reading By TING",56,18,5,0,79
1398210,1219408,2022-06-27,Senate,"Do pass",13,0,0,6,19
1398211,1016196,2021-02-25,Assembly,"AB 194 BUDGET Assembly Third Reading By TING",56,18,5,0,79
1398211,1219361,2022-06-27,Senate,"Do pass",14,0,0,5,19
1398211,1221594,2022-06-29,Senate,"Assembly 3rd Reading AB194 BUDGET (Ting) By Skinner",35,0,0,5,40
1398211,1221595,2022-06-29,Assembly,"AB 194 BUDGET Concurrence in Senate Amendments By TING",77,0,0,3,80
1398212,1016181,2021-02-25,Assembly,"AB 195 BUDGET Assembly Third Reading By TING",56,18,5,0,79
1398212,1219427,2022-06-27,Senate,"Do pass",13,1,0,5,19
1398212,1221561,2022-06-29,Senate,"Assembly 3rd Reading AB195 BUDGET (Ting) By Skinner",34,0,0,6,40
1398212,1221562,2022-06-29,Assembly,"AB 195 BUDGET Concurrence in Senate Amendments By TING",69,1,0,10,80
1398213,1016228,2021-02-25,Assembly,"AB 196 BUDGET Assembly Third Reading By TING",56,18,5,0,79
1398213,1219413,2022-06-27,Senate,"Do pass",15,0,0,4,19
1398214,1016203,2021-02-25,Assembly,"AB 197 BUDGET Assembly Third Reading By TING",56,18,5,0,79
1398214,1219473,2022-06-27,Senate,"Do pass",13,2,0,4,19
1398215,1016267,2021-02-25,Assembly,"AB 198 BUDGET Assembly Third Reading By TING",56,18,5,0,79
1398215,1219526,2022-06-27,Senate,"Do pass",13,2,0,4,19
1398216,1016233,2021-02-25,Assembly,"AB 199 BUDGET Assembly Third Reading By TING",56,18,5,0,79
1398216,1219356,2022-06-27,Senate,"Do pass",13,1,0,5,19
1398216,1221555,2022-06-29,Senate,"Assembly 3rd Reading AB199 BUDGET (Ting) By Skinner",31,0,0,9,40
1398216,1221556,2022-06-29,Assembly,"AB 199 BUDGET Concurrence in Senate Amendments By TING",63,15,0,2,80
1398217,1016211,2021-02-25,Assembly,"AB 200 BUDGET Assembly Third Reading By TING",56,18,5,0,79
1398217,1219421,2022-06-27,Senate,"Do pass",12,3,0,4,19
1398217,1221588,2022-06-29,Senate,"Assembly 3rd Reading AB200 BUDGET (Ting) By Skinner",28,8,0,4,40
1398217,1221589,2022-06-29,Assembly,"AB 200 BUDGET Concurrence in Senate Amendments By TING",59,17,0,4,80
1398218,1016197,2021-02-25,Assembly,"AB 201 BUDGET Assembly Third Reading By TING",56,18,5,0,79
1398218,1219374,2022-06-27,Senate,"Do pass",13,1,0,5,19
1398219,1016177,2021-02-25,Assembly,"AB 202 BUDGET Assembly Third Reading By TING",56,18,5,0,79
1398219,1219357,2022-06-27,Senate,"Do pass",14,1,0,4,19
1398219,1221596,2022-06-29,Senate,"Assembly 3rd Reading AB202 BUDGET (Ting) By Skinner",30,1,0,9,40
1398219,1221597,2022-06-29,Assembly,"AB 202 BUDGET Concurrence in Senate Amendments By TING",79,0,0,1,80
1398220,1016162,2021-02-25,Assembly,"AB 203 BUDGET Assembly Third Reading By TING",56,18,5,0,79
1398220,1219504,2022-06-27,Senate,"Do pass",12,3,0,4,19
1398220,1221762,2022-06-29,Senate,"Assembly 3rd Reading AB203 BUDGET (Ting) By Skinner",28,8,0,4,40
1398220,1221763,2022-06-29,Assembly,"AB 203 BUDGET Concurrence in Senate Amendments By TING",75,0,0,5,80
1398221,1016259,2021-02-25,Assembly,"AB 204 BUDGET Assembly Third Reading By TING",56,18,5,0,79
1398221,1225121,2022-08-29,Senate,"Do pass",14,3,0,2,19
1398221,1225242,2022-08-30,Senate,"Assembly 2nd Reading AB204 BUDGET (Ting) By Skinner",31,9,0,0,40
1398221,1225243,2022-08-31,Assembly,"AB 204 BUDGET Concurrence in Senate Amendments By TING",59,18,0,3,80
1398222,1016182,2021-02-25,Assembly,"AB 205 BUDGET Assembly Third Reading By TING",56,18,5,0,79
1398222,1219502,2022-06-27,Senate,"Do pass",12,2,0,5,19
1398222,1221557,2022-06-29,Senate,"Assembly 3rd Reading AB205 BUDGET (Ting) By Skinner",27,8,0,5,40
1398222,1221558,2022-06-29,Assembly,"AB 205 BUDGET Concurrence in Senate Amendments By TING",64,13,0,3,80
1398223,1016202,2021-02-25,Assembly,"AB 206 BUDGET Assembly Third Reading By TING",56,18,5,0,79
1398224,1016163,2021-02-25,Assembly,"AB 207 BUDGET Assembly Third Reading By TING",56,18,5,0,79
1398224,1225116,2022-08-29,Senate,"Do pass",15,0,0,4,19
1398224,1225802,2022-08-30,Senate,"Assembly 2nd Reading AB207 BUDGET (Ting) By Skinner",35,1,0,4,40
1398224,1225803,2022-08-31,Assembly,"AB 207 BUDGET Concurrence in Senate Amendments By TING",80,0,0,0,80
1398225,1016160,2021-02-25,Assembly,"AB 208 BUDGET Assembly Third Reading By TING",56,18,5,0,79
1398225,1219484,2022-06-27,Senate,"Do pass",14,0,0,5,19
1398226,1016166,2021-02-25,Assembly,"AB 209 BUDGET Assembly Third Reading By TING",56,18,5,0,79
1398226,1225114,2022-08-29,Senate,"Do pass",13,2,0,4,19
1398226,1225986,2022-08-31,Senate,"Assembly 3rd Reading AB209 BUDGET (Ting) By Skinner",31,6,0,3,40
1398226,1225987,2022-08-31,Assembly,"AB 209 BUDGET Concurrence in Senate Amendments By TING",58,17,0,5,80
1398227,1016194,2021-02-25,Assembly,"AB 210 BUDGET Assembly Third Reading By TING",56,18,5,0,79
1398227,1219380,2022-06-27,Senate,"Do pass",13,2,0,4,19
1398227,1221537,2022-06-29,Senate,"Assembly 3rd Reading AB210 BUDGET (Ting) By Skinner",30,0,0,10,40
1398227,1221538,2022-06-29,Assembly,"AB 210 BUDGET Concurrence in Senate Amendments By TING",79,0,0,1,80
1398228,1016164,2021-02-25,Assembly,"AB 211 BUDGET Assembly Third Reading By TING",56,18,5,0,79
1398228,1225036,2022-08-29,Senate,"Do pass",13,2,0,4,19
1398228,1225554,2022-08-31,Senate,"Assembly 3rd Reading AB211 BUDGET (Ting) By Skinner",31,0,0,9,40
1398228,1225555,2022-08-31,Assembly,"AB 211 BUDGET Concurrence in Senate Amendments By TING",62,8,0,10,80
1398229,1016208,2021-02-25,Assembly,"AB 212 BUDGET Assembly Third Reading By TING",56,18,5,0,79
1398229,1219395,2022-06-27,Senate,"Do pass",15,0,0,4,19
1398230,1016212,2021-02-25,Assembly,"AB 213 BUDGET Assembly Third Reading By TING",56,18,5,0,79
1398230,1050792,2021-04-12,Senate,"Do pass",14,0,4,0,18
1398230,1219381,2022-06-27,Senate,"Do pass",12,3,0,4,19
1398232,984520,2021-01-11,Assembly,"Be adopted. To third reading",11,0,1,0,12
1398234,1011768,2021-02-22,Senate,"Senate 3rd Reading SB113 Skinner",29,8,2,0,39
1398234,1136465,2022-02-07,Senate,"Unfinished Business SB113 B. & F.R. (Skinner) Concurrence",37,0,0,3,40
1398234,1136466,2022-02-07,Assembly,"SB 113 B. & F. R. Senate Third Reading By TING",68,0,0,7,75
1398235,1011735,2021-02-22,Senate,"Senate 3rd Reading SB114 Skinner",29,8,2,0,39
1398235,1136485,2022-02-07,Senate,"Unfinished Business SB114 B. & F.R. (Skinner) Concurrence",30,7,0,3,40
1398235,1136486,2022-02-07,Assembly,"SB 114 B. & F. R. Senate Third Reading By TING",55,8,0,12,75
1398236,1011733,2021-02-22,Senate,"Senate 3rd Reading SB115",29,8,2,0,39
1398236,1136461,2022-02-07,Senate,"Unfinished Business SB115 Skinner Concurrence",30,5,0,5,40
1398236,1136462,2022-02-07,Assembly,"SB 115 Skinner Senate Third Reading By TING",55,6,0,14,75
1398237,1011734,2021-02-22,Senate,"Senate 3rd Reading SB116",29,8,2,0,39
1398237,1136463,2022-02-07,Senate,"Unfinished Business SB116 B. & F.R. (Skinner) Concurrence",37,0,0,3,40
1398237,1136464,2022-02-07,Assembly,"SB 116 B. & F. R. Senate Third Reading By TING",68,0,0,7,75
1398238,1011785,2021-02-22,Senate,"Senate 3rd Reading SB117",29,8,2,0,39
1398238,1136473,2022-02-07,Senate,"Unfinished Business SB117 B. & F.R. (Skinner) Concurrence",37,0,0,3,40
1398238,1136474,2022-02-07,Assembly,"SB 117 B. & F. R. Senate Third Reading By TING",66,0,0,9,75
1398239,1011787,2021-02-22,Senate,"Senate 3rd Reading SB118",29,8,2,0,39
1398239,1169412,2022-03-14,Senate,"Unfinished Business SB118 B. & F.R. (Skinner) Concurrence",34,0,0,6,40
1398239,1169413,2022-03-14,Assembly,"SB 118 B. & F. R. Senate Third Reading By TING",70,0,0,6,76
1398240,1011736,2021-02-22,Senate,"Senate 3rd Reading SB119",29,8,2,0,39
1398240,1169431,2022-03-14,Senate,"Unfinished Business SB119 Skinner Concurrence",29,6,0,5,40
1398240,1169432,2022-03-14,Assembly,"SB 119 Skinner Senate Third Reading By TING",56,10,0,10,76
1398241,1011704,2021-02-22,Senate,"Senate 3rd Reading SB120",29,8,2,0,39
1398242,1011725,2021-02-22,Senate,"Senate 3rd Reading SB121",29,8,2,0,39
1398243,1011761,2021-02-22,Senate,"Senate 3rd Reading SB122",29,8,2,0,39
1398244,1011749,2021-02-22,Senate,"Senate 3rd Reading SB123",29,8,2,0,39
1398245,1011777,2021-02-22,Senate,"Senate 3rd Reading SB124",29,8,2,0,39
1398246,1011760,2021-02-22,Senate,"Senate 3rd Reading SB125",29,8,2,0,39
1398246,1221760,2022-06-29,Senate,"Unfinished Business SB125 B. & F.R. (Skinner) Concurrence",31,1,0,8,40
1398246,1221761,2022-06-29,Assembly,"SB 125 B. & F. R. Senate Third Reading",56,19,0,5,80
1398247,1011810,2021-02-22,Senate,"Senate 3rd Reading SB126",29,8,2,0,39
1398248,1011837,2021-02-22,Senate,"Senate 3rd Reading SB127",29,8,2,0,39
1398249,1011775,2021-02-22,Senate,"Senate 3rd Reading SB128",29,8,2,0,39
1398250,1011786,2021-02-22,Senate,"Senate 3rd Reading SB129",29,8,2,0,39
1398250,1102480,2021-06-28,Senate,"Unfinished Business SB129 Skinner Concurrence",31,5,4,0,40
1398250,1102481,2021-06-28,Assembly,"SB 129 Skinner Senate Third Reading By TING Amend By FLORA Set #1 Motion to Lay on the Table By REYES",55,20,4,0,79
1398250,1102482,2021-06-28,Assembly,"SB 129 Skinner Senate Third Reading By TING Amend By SEYARTO Set #2 Motion to Lay on the Table By REYES",55,19,5,0,79
1398250,1102483,2021-06-28,Assembly,"SB 129 Skinner Senate Third Reading By TING Amend By SMITH Set #3 Motion to Lay on the Table By REYES",55,19,5,0,79
1398250,1102484,2021-06-28,Assembly,"SB 129 Skinner Senate Third Reading By TING Amend By GALLAGHER Set #4 Motion to Lay on the Table By REYES",55,20,4,0,79
1398250,1102485,2021-06-28,Assembly,"SB 129 Skinner Senate Third Reading By TING Amend By CHOI Set #5 Motion to Lay on the Table By REYES",54,19,6,0,79
1398250,1102486,2021-06-28,Assembly,"SB 129 Skinner Senate Third Reading By TING Amend By DAVIES Set #6 Motion to Lay on the Table By REYES",55,19,5,0,79
1398250,1102487,2021-06-28,Assembly,"SB 129 Skinner Senate Third Reading By TING",61,13,5,0,79
1398251,1011794,2021-02-22,Senate,"Senate 3rd Reading SB130",29,8,2,0,39
1398251,1221535,2022-06-29,Senate,"Unfinished Business SB130 B. & F.R. (Skinner) Concurrence",36,0,0,4,40
1398251,1221536,2022-06-29,Assembly,"SB 130 B. & F. R. Senate Third Reading By TING",79,0,0,1,80
1398252,1011755,2021-02-22,Senate,"Senate 3rd Reading SB131",29,8,2,0,39
1398252,1221532,2022-06-29,Senate,"Unfinished Business SB131 B. & F.R. (Skinner) Concurrence",28,8,0,4,40
1398252,1221533,2022-06-29,Assembly,"SB 131 B. & F. R. Senate Third Reading By TING",60,17,0,3,80
1398253,1011745,2021-02-22,Senate,"Senate 3rd Reading SB132",29,8,2,0,39
1398253,1221552,2022-06-29,Senate,"Unfinished Business SB132 B. & F.R. (Skinner) Concurrence",36,0,0,4,40
1398253,1221553,2022-06-29,Assembly,"SB 132 B. & F. R. Senate Third Reading By TING",79,0,0,1,80
1398254,1011703,2021-02-22,Senate,"Senate 3rd Reading SB133",29,8,2,0,39
1398255,1011744,2021-02-22,Senate,"Senate 3rd Reading SB134",29,8,2,0,39
1398256,1011829,2021-02-22,Senate,"Senate 3rd Reading SB135",29,8,2,0,39
1398257,1011824,2021-02-22,Senate,"Senate 3rd Reading SB136",29,8,2,0,39
1398258,1011766,2021-02-22,Senate,"Senate 3rd Reading SB137",29,8,2,0,39
1398259,1011801,2021-02-22,Senate,"Senate 3rd Reading SB138",29,8,2,0,39
1398260,1011746,2021-02-22,Senate,"Senate 3rd Reading SB139",29,8,2,0,39
1398260,1102524,2021-06-28,Senate,"Unfinished Business SB139 B. & F.R. (Skinner) Concurrence",32,8,0,0,40
1398260,1102525,2021-06-28,Assembly,"SB 139 B. & F. R. Senate Third Reading By TING",69,6,4,0,79
1398261,1011750,2021-02-22,Senate,"Senate 3rd Reading SB140",29,8,2,0,39
1398262,1011792,2021-02-22,Senate,"Senate 3rd Reading SB141",29,8,2,0,39
1398263,1011748,2021-02-22,Senate,"Senate 3rd Reading SB142",29,8,2,0,39
1398263,1102451,2021-06-28,Senate,"Unfinished Business SB142 B. & F.R. (Skinner) Concurrence",38,0,2,0,40
1398263,1102452,2021-06-28,Assembly,"SB 142 B. & F. R. Senate Third Reading By TING",71,0,8,0,79
1398264,1011747,2021-02-22,Senate,"Senate 3rd Reading SB143",29,8,2,0,39
1398265,1011770,2021-02-22,Senate,"Senate 3rd Reading SB144",29,8,2,0,39
1398265,1104918,2021-07-14,Assembly,"Do pass",9,0,2,0,11
1398265,1105143,2021-07-15,Senate,"Unfinished Business SB144 Portantino et al. Concurrence",37,0,3,0,40
1398265,1105144,2021-07-15,Assembly,"SB 144 Portantino Senate Third Reading By CARRILLO",66,4,9,0,79
1398266,1011738,2021-02-22,Senate,"Senate 3rd Reading SB145",29,8,2,0,39
1398267,1011717,2021-02-22,Senate,"Senate 3rd Reading SB146",29,8,2,0,39
1398267,1102492,2021-06-28,Senate,"Unfinished Business SB146 B. & F.R. (Skinner) Concurrence",31,9,0,0,40
1398267,1102493,2021-06-28,Assembly,"SB 146 B. & F. R. Senate Third Reading By TING",60,17,2,0,79
1398268,1011815,2021-02-22,Senate,"Senate 3rd Reading SB147",29,8,2,0,39
1398268,1102519,2021-06-28,Senate,"Unfinished Business SB147 B. & F.R. (Skinner) Concurrence",40,0,0,0,40
1398268,1102520,2021-06-28,Assembly,"SB 147 B. & F. R. Senate Third Reading By TING",79,0,0,0,79
1398269,1011699,2021-02-22,Senate,"Senate 3rd Reading SB148",29,8,2,0,39
1398270,1011806,2021-02-22,Senate,"Senate 3rd Reading SB149",29,8,2,0,39
1398271,1011804,2021-02-22,Senate,"Senate 3rd Reading SB150",29,8,2,0,39
1398272,1011741,2021-02-22,Senate,"Senate 3rd Reading SB151",29,8,2,0,39
1398272,1103790,2021-07-01,Senate,"Unfinished Business SB151 B. & F.R. (Skinner) Concurrence",36,0,4,0,40
1398272,1103791,2021-07-01,Assembly,"SB 151 B. & F. R. Senate Third Reading By TING",78,0,1,0,79
1398273,1011740,2021-02-22,Senate,"Senate 3rd Reading SB152",29,8,2,0,39
1398273,1102500,2021-06-28,Senate,"Unfinished Business SB152 B. & F.R. (Skinner) Concurrence",31,9,0,0,40
1398273,1102501,2021-06-28,Assembly,"SB 152 B. & F. R. Senate Third Reading By TING Amend By SEYARTO Set #1 Motion to Lay on the Table By REYES",57,19,3,0,79
1398273,1102502,2021-06-28,Assembly,"SB 152 B. & F. R. Senate Third Reading By TING",59,19,1,0,79
1398274,1011808,2021-02-22,Senate,"Senate 3rd Reading SB153",29,8,2,0,39
1398275,1011821,2021-02-22,Senate,"Senate 3rd Reading SB154",29,8,2,0,39
1398275,1215519,2022-06-13,Senate,"Unfinished Business SB154 Skinner Concurrence",28,8,0,4,40
1398275,1215520,2022-06-13,Assembly,"SB 154 Skinner Senate Third Reading By TING",56,18,0,4,78
1398276,1011798,2021-02-22,Senate,"Senate 3rd Reading SB155",29,8,2,0,39
1398276,1108239,2021-09-09,Senate,"Unfinished Business SB155 B. & F.R. (Skinner) Concurrence",28,9,0,3,40
1398276,1108240,2021-09-09,Assembly,"SB 155 B. & F. R. Senate Third Reading",68,8,0,4,80
1398277,1011712,2021-02-22,Senate,"Senate 3rd Reading SB156",29,8,2,0,39
1398277,1105046,2021-07-15,Senate,"Unfinished Business SB156 B. & F.R. (Skinner) Concurrence",39,0,1,0,40
1398277,1105047,2021-07-15,Assembly,"SB 156 B. & F. R. Senate Third Reading By TING",78,0,1,0,79
1398278,1011813,2021-02-22,Senate,"Senate 3rd Reading SB157",29,8,2,0,39
1398278,1103829,2021-07-01,Senate,"Unfinished Business SB157 B. & F.R. (Skinner) Concurrence",29,10,1,0,40
1398278,1103830,2021-07-01,Assembly,"SB 157 B. & F. R. Senate Third Reading By TING",72,0,7,0,79
1398279,1011789,2021-02-22,Senate,"Senate 3rd Reading SB158",29,8,2,0,39
1398279,1102459,2021-06-28,Senate,"Unfinished Business SB158 B. & F.R. (Skinner) Concurrence",29,9,2,0,40
1398279,1102460,2021-06-28,Assembly,"SB 158 B. & F. R. Senate Third Reading By TING",58,19,2,0,79
1398280,1011778,2021-02-22,Senate,"Senate 3rd Reading SB159",29,8,2,0,39
1398280,1103853,2021-07-01,Senate,"Unfinished Business SB159 B. & F.R. (Skinner) Concurrence",32,5,3,0,40
1398280,1103854,2021-07-01,Assembly,"SB 159 B. & F. R. Senate Third Reading By TING",77,0,2,0,79
1398281,1011799,2021-02-22,Senate,"Senate 3rd Reading SB160",29,8,2,0,39
1398281,1105061,2021-07-15,Senate,"Unfinished Business SB160 B. & F.R. (Skinner) Concurrence",31,8,1,0,40
1398281,1105062,2021-07-15,Assembly,"SB 160 B. & F. R. Senate Third Reading By TING",60,15,4,0,79
1398282,1011706,2021-02-22,Senate,"Senate 3rd Reading SB161",29,8,2,0,39
1398283,1011731,2021-02-22,Senate,"Senate 3rd Reading SB162",29,8,2,0,39
1398283,1108349,2021-09-09,Senate,"Unfinished Business SB162 B. & F.R. (Skinner) Concurrence",29,9,0,2,40
1398283,1108350,2021-09-09,Assembly,"SB 162 B. & F. R. Senate Third Reading By TING",61,16,0,3,80
1398284,1011727,2021-02-22,Senate,"Senate 3rd Reading SB163",29,8,2,0,39
1398285,1011783,2021-02-22,Senate,"Senate 3rd Reading SB164",29,8,2,0,39
1398286,1011729,2021-02-22,Senate,"Senate 3rd Reading SB165",29,8,2,0,39
1398286,1108229,2021-09-09,Senate,"Unfinished Business SB165 B. & F.R. (Skinner) Concurrence",38,0,0,2,40
1398286,1108230,2021-09-09,Assembly,"SB 165 B. & F. R. Senate Third Reading By TING",80,0,0,0,80
1398287,1011832,2021-02-22,Senate,"Senate 3rd Reading SB166",29,8,2,0,39
1398287,1108449,2021-09-09,Senate,"Unfinished Business SB166 B. & F.R. (Skinner) Concurrence",29,8,0,3,40
1398287,1108450,2021-09-09,Assembly,"SB 166 B. & F. R. Senate Third Reading",71,1,0,8,80
1398288,1011800,2021-02-22,Senate,"Senate 3rd Reading SB167",29,8,2,0,39
1398289,1011701,2021-02-22,Senate,"Senate 3rd Reading SB168",29,8,2,0,39
1398289,1108255,2021-09-09,Senate,"Unfinished Business SB168 B. & F.R. (Skinner) Concurrence",38,0,0,2,40
1398289,1108256,2021-09-09,Assembly,"SB 168 B. & F. R. Senate Third Reading",80,0,0,0,80
1398290,1011739,2021-02-22,Senate,"Senate 3rd Reading SB169",29,8,2,0,39
1398290,1108290,2021-09-09,Senate,"Unfinished Business SB169 B. & F.R. (Skinner) Concurrence",38,0,0,2,40
1398290,1108291,2021-09-09,Assembly,"SB 169 B. & F. R. Senate Third Reading By TING",75,1,0,4,80
1398291,1011754,2021-02-22,Senate,"Senate 3rd Reading SB170",29,8,2,0,39
1398291,1108462,2021-09-09,Senate,"Unfinished Business SB170 Skinner Concurrence",29,3,0,8,40
1398291,1108463,2021-09-09,Assembly,"SB 170 Skinner Senate Third Reading By TING",63,12,0,5,80
1398292,1011779,2021-02-22,Senate,"Senate 3rd Reading SB171",29,8,2,0,39
1398292,1108421,2021-09-09,Senate,"Unfinished Business SB171 B. & F.R. (Skinner) Concurrence",38,0,0,2,40
1398292,1108422,2021-09-09,Assembly,"SB 171 B. & F. R. Senate Third Reading By TING",80,0,0,0,80
1398293,1011753,2021-02-22,Senate,"Senate 3rd Reading SB172",29,8,2,0,39
1398294,1011762,2021-02-22,Senate,"Senate 3rd Reading SB173",29,8,2,0,39
1398295,1011835,2021-02-22,Senate,"Senate 3rd Reading SB174",29,8,2,0,39
1398296,1011826,2021-02-22,Senate,"Senate 3rd Reading SB175",29,8,2,0,39
1398297,1011772,2021-02-22,Senate,"Senate 3rd Reading SB176",29,8,2,0,39
1398298,1011758,2021-02-22,Senate,"Senate 3rd Reading SB177",29,8,2,0,39
1398299,1011757,2021-02-22,Senate,"Senate 3rd Reading SB178",29,8,2,0,39
1398300,1011726,2021-02-22,Senate,"Senate 3rd Reading SB179",29,8,2,0,39
1398300,1225432,2022-08-31,Assembly,"SB 179 Skinner Senate Third Reading By Ting",62,11,0,7,80
1398301,1011774,2021-02-22,Senate,"Senate 3rd Reading SB180",29,8,2,0,39
1398302,1011782,2021-02-22,Senate,"Senate 3rd Reading SB181",29,8,2,0,39
1398303,1011788,2021-02-22,Senate,"Senate 3rd Reading SB182",29,8,2,0,39
1398304,1011793,2021-02-22,Senate,"Senate 3rd Reading SB183",29,8,2,0,39
1398305,1011796,2021-02-22,Senate,"Senate 3rd Reading SB184",29,8,2,0,39
1398305,1221548,2022-06-29,Senate,"Unfinished Business SB184 B. & F.R. (Skinner) Concurrence",28,8,0,4,40
1398305,1221549,2022-06-29,Assembly,"SB 184 B. & F. R. Senate Third Reading By TING",60,18,0,2,80
1398306,1011769,2021-02-22,Senate,"Senate 3rd Reading SB185",29,8,2,0,39
1398307,1011724,2021-02-22,Senate,"Senate 3rd Reading SB186",29,8,2,0,39
1398308,1011828,2021-02-22,Senate,"Senate 3rd Reading SB187",29,8,2,0,39
1398308,1221758,2022-06-29,Senate,"Unfinished Business SB187 B. & F.R. (Skinner) Concurrence",29,2,0,9,40
1398308,1221759,2022-06-29,Assembly,"SB 187 B. & F. R. Senate Third Reading By TING",75,0,0,5,80
1398309,1011823,2021-02-22,Senate,"Senate 3rd Reading SB188",29,8,2,0,39
1398309,1221756,2022-06-29,Senate,"Unfinished Business SB188 B. & F.R. (Skinner) Concurrence",36,0,0,4,40
1398309,1221757,2022-06-29,Assembly,"SB 188 B. & F. R. Senate Third Reading By TING",79,0,0,1,80
1398310,1011759,2021-02-22,Senate,"Senate 3rd Reading SB189",29,8,2,0,39
1398310,1221569,2022-06-29,Senate,"Unfinished Business SB189 B. & F.R. (Skinner) Concurrence",28,7,0,5,40
1398310,1221570,2022-06-29,Assembly,"SB 189 B. & F. R. Senate Third Reading By TING",61,17,0,2,80
1398311,1011708,2021-02-22,Senate,"Senate 3rd Reading SB190",29,8,2,0,39
1398312,1011784,2021-02-22,Senate,"Senate 3rd Reading SB191",29,8,2,0,39
1398312,1221749,2022-06-29,Senate,"Unfinished Business SB191 B. & F.R. (Skinner) Concurrence",28,2,0,10,40
1398312,1221750,2022-06-29,Assembly,"SB 191 B. & F. R. Senate Third Reading By TING",60,14,0,6,80
1398313,1011756,2021-02-22,Senate,"Senate 3rd Reading SB192",29,8,2,0,39
1398314,1011764,2021-02-22,Senate,"Senate 3rd Reading SB193",29,8,2,0,39
1398314,1221710,2022-06-29,Senate,"Unfinished Business SB193 B. & F.R. (Skinner) Concurrence",28,3,0,9,40
1398314,1221711,2022-06-29,Assembly,"SB 193 B. & F. R. Senate Third Reading By TING",76,0,0,4,80
1398315,1011732,2021-02-22,Senate,"Senate 3rd Reading SB194",29,8,2,0,39
1398316,1011700,2021-02-22,Senate,"Senate 3rd Reading SB195",29,8,2,0,39
1398317,1011702,2021-02-22,Senate,"Senate 3rd Reading SB196",29,8,2,0,39
1398317,1221754,2022-06-29,Senate,"Unfinished Business SB196 B. & F.R. (Skinner) Concurrence",36,0,0,4,40
1398317,1221755,2022-06-29,Assembly,"SB 196 B. & F. R. Senate Third Reading By TING",78,0,0,2,80
1398318,1011765,2021-02-22,Senate,"Senate 3rd Reading SB197",29,8,2,0,39
1398318,1221574,2022-06-29,Senate,"Unfinished Business SB197 B. & F.R. (Skinner) Concurrence",29,5,0,6,40
1398318,1221575,2022-06-29,Assembly,"SB 197 B. & F. R. Senate Third Reading By TING",79,0,0,1,80
1398319,1011805,2021-02-22,Senate,"Senate 3rd Reading SB198",29,8,2,0,39
1398319,1221540,2022-06-29,Senate,"Unfinished Business SB198 B. & F.R. (Skinner) Concurrence",29,6,0,5,40
1398319,1221541,2022-06-29,Assembly,"SB 198 B. & F. R. Senate Third Reading By TING",59,19,0,2,80
1398320,1011776,2021-02-22,Senate,"Senate 3rd Reading SB199",29,8,2,0,39
1398321,1011780,2021-02-22,Senate,"Senate 3rd Reading SB200",29,8,2,0,39
1398322,1011795,2021-02-22,Senate,"Senate 3rd Reading SB201",29,8,2,0,39
1398322,1221752,2022-06-29,Senate,"Unfinished Business SB201 B. & F.R. (Skinner) Concurrence",33,0,0,7,40
1398322,1221753,2022-06-29,Assembly,"SB 201 B. & F. R. Senate Third Reading By TING",75,0,0,5,80
1398323,1011716,2021-02-22,Senate,"Senate 3rd Reading SB202",29,8,2,0,39
1400479,1054681,2021-04-15,Assembly,"Do pass and be re-referred to the Committee on [Local Government]",5,0,3,0,8
1400479,1065244,2021-04-28,Assembly,"Do pass and be re-referred to the Committee on [Appropriations]",7,0,1,0,8
1400479,1081740,2021-05-20,Assembly,"Do pass",12,4,0,0,16
1400479,1092927,2021-06-01,Assembly,"AB 215 Chiu Assembly Third Reading",58,11,10,0,79
1400479,1103815,2021-07-01,Senate,"Do pass, but first be re-referred to the Committee on [Appropriations]",5,2,2,0,9
1400479,1106441,2021-08-23,Senate,"Placed on suspense file",7,0,0,0,7
1400479,1106582,2021-08-26,Senate,"Do pass",4,2,0,1,7
1400479,1108630,2021-09-10,Senate,"Assembly 3rd Reading AB215 Chiu By Wiener",22,9,0,9,40
1400479,1108631,2021-09-10,Assembly,"AB 215 CHIU Concurrence in Senate Amendments",60,5,0,15,80
1400481,1123290,2022-01-10,Assembly,"Do pass and be re-referred to the Committee on [Appropriations]",7,1,0,3,11
1400482,1035220,2021-03-23,Assembly,"Do pass and be re-referred to the Committee on [Health]",8,3,0,0,11
1400482,1081938,2021-05-20,Assembly,"Do pass as amended",12,4,0,0,16
1400482,1092933,2021-06-01,Assembly,"AB 218 Ward Assembly Third Reading",60,15,4,0,79
1400482,1103411,2021-06-29,Senate,"Do pass, but first be re-referred to the Committee on [Health]",9,2,0,0,11
1400482,1104931,2021-07-14,Senate,"Do pass, but first be re-referred to the Committee on [Appropriations]",8,1,2,0,11
1400482,1106082,2021-08-16,Senate,"Placed on suspense file",7,0,0,0,7
1400482,1106868,2021-08-26,Senate,"Do pass as amended",5,2,0,0,7
1400482,1108189,2021-09-08,Senate,"Assembly 3rd Reading AB218 Ward et al. By Rubio",29,9,0,2,40
1400482,1108456,2021-09-09,Assembly,"AB 218 Ward Concurrence in Senate Amendments",60,13,0,7,80
1400485,1047579,2021-04-07,Assembly,"Do pass and be re-referred to the Committee on [Appropriations]",7,0,1,0,8
1400485,1082118,2021-05-20,Assembly,"Do pass",14,0,2,0,16
1400485,1092898,2021-06-01,Assembly,"AB 221 Santiago Third Reading Urgency",71,0,8,0,79
1400485,1100302,2021-06-22,Senate,"Do pass as amended, but first amend, and re-refer to the Committee on [Appropriations]",4,1,0,0,5
1400485,1105116,2021-07-15,Senate,"Placed on suspense file",7,0,0,0,7
1400487,1049866,2021-04-08,Assembly,"Do pass and be re-referred to the Committee on [Appropriations]",12,0,3,0,15
1400487,1081557,2021-05-20,Assembly,"Do pass as amended",16,0,0,0,16
1400487,1092866,2021-06-01,Assembly,"AB 223 Ward Assembly Third Reading",78,0,1,0,79
1400487,1102808,2021-06-29,Senate,"Do pass, but first be re-referred to the Committee on [Public Safety]",9,0,0,0,9
1400487,1104718,2021-07-13,Senate,"Do pass as amended, but first amend, and re-refer to the Committee on [Appropriations]",4,0,1,0,5
1400487,1106195,2021-08-16,Senate,"Placed on suspense file",7,0,0,0,7
1400487,1106944,2021-08-26,Senate,"Do pass",7,0,0,0,7
1400487,1107833,2021-09-03,Senate,"Special Consent AB223",37,0,0,3,40
1400487,1107908,2021-09-07,Assembly,"AB 223 Ward Concurrence in Senate Amendments",73,0,0,7,80
1400488,1046197,2021-04-06,Assembly,"Do pass as amended and be re-referred to the Committee on [Appropriations]",18,0,1,0,19
1400488,1081897,2021-05-20,Assembly,"Do pass",16,0,0,0,16
1400488,1090434,2021-06-02,Assembly,"AB 224 Daly Third Reading Urgency",78,0,1,0,79
1400488,1104989,2021-07-14,Senate,"Do pass, but first be re-referred to the Committee on [Appropriations]",9,1,4,0,14
1400488,1106131,2021-08-16,Senate,"Placed on suspense file",7,0,0,0,7
1400489,1046155,2021-04-06,Assembly,"Do pass and be re-referred to the Committee on [Military and Veterans Affairs] with recommendation: To Consent Calendar",18,0,1,0,19
1400489,1065271,2021-04-28,Assembly,"Do pass and be re-referred to the Committee on [Appropriations] with recommendation: To Consent Calendar",11,0,0,0,11
1400489,1081875,2021-05-20,Assembly,"Do pass as amended",12,0,4,0,16
1400489,1092917,2021-06-01,Assembly,"AB 225 Gray Assembly Third Reading",79,0,0,0,79
1400490,1059305,2021-04-21,Assembly,"Do pass and be re-referred to the Committee on [Appropriations] with recommendation: To Consent Calendar",8,0,0,0,8
1400490,1081620,2021-05-20,Assembly,"Do pass",16,0,0,0,16
1400490,1092827,2021-06-01,Assembly,"AB 226 Ramos Assembly Third Reading",79,0,0,0,79
1400490,1103451,2021-06-30,Senate,"Do pass, but first be re-referred to the Committee on [Human Services] with the recommendation: To Consent Calendar",10,0,1,0,11
1400490,1104383,2021-07-06,Senate,"Do pass as amended, but first amend, and re-refer to the Committee on [Appropriations]",4,0,1,0,5
1400490,1106046,2021-08-16,Senate,"Placed on suspense file",7,0,0,0,7
1400490,1106674,2021-08-26,Senate,"Do pass as amended",6,0,0,1,7
1400490,1108592,2021-09-10,Senate,"Assembly 3rd Reading AB226 Ramos et al. By Portantino",37,0,0,3,40
1400490,1108593,2021-09-10,Assembly,"AB 226 Ramos Concurrence in Senate Amendments",78,0,0,2,80
1400492,984519,2021-01-11,Assembly,"HR 7 MAYES Assembly Third Reading",51,6,23,0,80
1400493,1028396,2021-03-15,Senate,"Do pass as amended, but first amend, and re-refer to the Committee on [Appropriations]",14,0,0,0,14
1400493,1044980,2021-04-05,Senate,"Placed on suspense file",7,0,0,0,7
1400494,1026094,2021-03-10,Senate,"Do pass, but first be re-referred to the Committee on [Appropriations]",4,2,1,0,7
1400494,1033632,2021-03-22,Senate,"Placed on suspense file",7,0,0,0,7
1400494,1081767,2021-05-20,Senate,"Do pass",5,2,0,0,7
1400495,1023876,2021-03-08,Senate,"Do pass, but first be re-referred to the Committee on [Judiciary]",5,0,0,0,5
1400495,1035223,2021-03-23,Senate,"Do pass as amended, but first amend, and re-refer to the Committee on [Appropriations] with the recommendation: To Consent Calendar",11,0,0,0,11
1400495,1056371,2021-04-19,Senate,"Placed on suspense file",7,0,0,0,7
1400495,1081406,2021-05-20,Senate,"Do pass",7,0,0,0,7
1400495,1089618,2021-06-01,Senate,"Special Consent SB206",39,0,1,0,40
1400495,1100806,2021-06-23,Assembly,"Do pass and be re-referred to the Committee on [Judiciary]",7,0,0,0,7
1400495,1104314,2021-07-06,Assembly,"Do pass and be re-referred to the Committee on [Appropriations] with recommendation: To Consent Calendar",10,0,1,0,11
1400495,1106837,2021-08-26,Assembly,"Do pass",16,0,0,0,16
1400495,1107946,2021-09-07,Assembly,"SB 206 McGuire Senate Third Reading By Flora",73,0,0,7,80
1400495,1108157,2021-09-08,Senate,"Unfinished Business SB206 McGuire et al. Concurrence",38,0,0,2,40
1400496,1028405,2021-03-15,Senate,"Do pass as amended, but first amend, and re-refer to the Committee on [Appropriations] with the recommendation: To Consent Calendar",7,0,0,0,7
1400496,1044990,2021-04-05,Senate,"Placed on suspense file",7,0,0,0,7
1400496,1081493,2021-05-20,Senate,"Do pass as amended",7,0,0,0,7
1400496,1089573,2021-06-01,Senate,"Special Consent SB207",39,0,1,0,40
1400496,1176485,2022-03-23,Assembly,"Do pass as amended. To Consent Calendar",8,0,0,0,8
1400496,1181303,2022-03-31,Assembly,"SB 207 Dahle Consent Calendar Second Day Regular Session",68,0,0,8,76
1400496,1190533,2022-04-20,Senate,"That the Assembly amendments be concurred in",5,0,0,0,5
1400496,1209967,2022-05-26,Senate,"Unfinished Business SB207 Dahle Urgency Clause Concurrence",34,0,0,6,40
1403933,1123782,2022-01-12,Assembly,"Do pass as amended and be re-referred to the Committee on [Appropriations]",7,0,0,0,7
1403934,1123343,2022-01-11,Assembly,"Do pass and be re-referred to the Committee on [Appropriations]",7,0,0,0,7
1403934,1126352,2022-01-20,Assembly,"Do pass as amended",12,0,0,4,16
1403934,1131224,2022-01-31,Assembly,"AB 228 Rodriguez Assembly Third Reading",69,0,0,7,76
1403934,1210918,2022-05-31,Senate,"Do pass, but first be re-referred to the Committee on [Appropriations]",5,0,0,0,5
1403934,1215517,2022-06-13,Senate,"Do pass",7,0,0,0,7
1403934,1219379,2022-06-27,Senate,"Assembly 3rd Reading AB228 Rodriguez By Hurtado",37,0,0,3,40
1403935,1065113,2021-04-27,Assembly,"Do pass and be re-referred to the Committee on [Appropriations]",19,0,0,0,19
1403935,1073415,2021-05-05,Assembly,"Do pass",16,0,0,0,16
1403935,1078741,2021-05-17,Assembly,"AB 229 Holden Assembly Third Reading",73,0,5,0,78
1403935,1103368,2021-06-30,Senate,"Do pass, but first be re-referred to the Committee on [Public Safety]",12,0,2,0,14
1403935,1104744,2021-07-13,Senate,"Do pass as amended, but first amend, and re-refer to the Committee on [Appropriations]",5,0,0,0,5
1403935,1106424,2021-08-23,Senate,"Placed on suspense file",7,0,0,0,7
1403935,1106963,2021-08-26,Senate,"Do pass",7,0,0,0,7
1403935,1107868,2021-09-07,Senate,"Assembly 3rd Reading AB229 Holden et al. By Roth",36,0,0,4,40
1403935,1108048,2021-09-08,Assembly,"AB 229 Holden Concurrence in Senate Amendments",78,0,0,2,80
1403938,1035212,2021-03-22,Assembly,"Do pass and be re-referred to the Committee on [Appropriations] with recommendation: To Consent Calendar",15,0,0,0,15
1403938,1053427,2021-04-14,Assembly,"Do pass. To Consent Calendar",16,0,0,0,16
1403938,1060907,2021-04-22,Assembly,"AB 232 Gallagher Consent Calendar Second Day",77,0,2,0,79
1403938,1098174,2021-06-15,Senate,"Do pass, but first be re-referred to the Committee on [Appropriations] with the recommendation: To Consent Calendar",17,0,0,0,17
1403938,1107390,2021-09-01,Senate,"Assembly 3rd Reading AB232 Gallagher et al. By Wieckowski",39,0,0,1,40
1403939,1048994,2021-04-08,Assembly,"Do pass and be re-referred to the Committee on [Appropriations]",12,0,0,0,12
1403939,1081864,2021-05-20,Assembly,"Do pass as amended",16,0,0,0,16
1403939,1092838,2021-06-01,Assembly,"AB 233 Boerner Horvath Assembly Third Reading",78,1,0,0,79
1403939,1100798,2021-06-23,Senate,"Do pass, but first be re-referred to the Committee on [Appropriations]",6,0,1,0,7
1403939,1104202,2021-07-05,Senate,"Placed on suspense file",6,0,1,0,7
1403940,1035174,2021-03-23,Assembly,"Do pass and be re-referred to the Committee on [Appropriations] with recommendation: To Consent Calendar",15,0,0,0,15
1403942,1036498,2021-03-24,Assembly,"Be adopted. To third reading",9,0,2,0,11
1403942,1044984,2021-04-05,Assembly,"AJR 4 Cristina Garcia Assembly Third Reading",60,0,18,0,78
1403942,1097777,2021-06-14,Senate,"Be adopted. Ordered to third reading",5,0,2,0,7
1403942,1104214,2021-07-05,Senate,"Assembly 3rd Reading AJR4 Cristina Garcia et a By Stern",34,0,6,0,40
1403943,1029563,2021-03-16,Senate,"Do pass, but first be re-referred to the Committee on [Appropriations] with the recommendation: To Consent Calendar",9,0,0,0,9
1403943,1033629,2021-03-22,Senate,"Placed on suspense file",7,0,0,0,7
1403943,1081706,2021-05-20,Senate,"Do pass",7,0,0,0,7
1403943,1089578,2021-06-01,Senate,"Special Consent SB208",39,0,1,0,40
1403943,1100821,2021-06-23,Assembly,"Do pass and be re-referred to the Committee on [Appropriations] with recommendation: To Consent Calendar",11,0,0,0,11
1403943,1106821,2021-08-26,Assembly,"Do pass",16,0,0,0,16
1403943,1107719,2021-09-02,Assembly,"SB 208 Dahle Senate Third Reading By Bigelow",77,0,0,2,79
1403945,1035193,2021-03-23,Senate,"Do pass, but first be re-referred to the Committee on [Appropriations]",9,1,1,0,11
1403945,1044961,2021-04-05,Senate,"Placed on suspense file",7,0,0,0,7
1403946,1072213,2021-05-04,Senate,"Do pass as amended, and be ordered to the Consent Calendar",11,0,0,0,11
1403946,1075254,2021-05-10,Senate,"Consent Calendar SB211",37,0,3,0,40
1403946,1104749,2021-07-13,Assembly,"Do pass as amended",11,0,0,0,11
1403946,1107947,2021-09-07,Assembly,"SB 211 Umberg Senate Third Reading By Stone",72,0,0,8,80
1403946,1108099,2021-09-08,Senate,"Unfinished Business SB211 Umberg Concurrence",38,0,0,2,40
1403947,1057719,2021-04-20,Senate,"Do pass, but first be re-referred to the Committee on [Appropriations]",1,3,1,0,5
1403948,1038723,2021-03-22,Senate,"Do pass, but first be re-referred to the Committee on [Appropriations]",4,1,0,0,5
1403948,1056322,2021-04-19,Senate,"Placed on suspense file",7,0,0,0,7
1403948,1081402,2021-05-20,Senate,"Do pass",5,2,0,0,7
1403948,1091721,2021-06-03,Senate,"Senate 3rd Reading SB213 Cortese et al",20,10,10,0,40
1403948,1091722,2021-06-03,Senate,"Senate 3rd Reading SB213 Cortese et al. Reconsider",35,0,5,0,40
1403948,1131260,2022-01-31,Senate,"Senate 3rd Reading SB213 Cortese et al",21,9,0,10,40
1403949,1051991,2021-04-13,Senate,"Do pass, but first be re-referred to the Committee on [Appropriations] with the recommendation: To Consent Calendar",16,0,1,0,17
1403949,1075256,2021-05-10,Senate,"Consent Calendar SB214",37,0,3,0,40
1403949,1099758,2021-06-21,Assembly,"Do pass and be re-referred to the Committee on [Appropriations] with recommendation: To Consent Calendar",15,0,0,0,15
1403949,1103438,2021-06-30,Assembly,"Do pass. To Consent Calendar",14,0,2,0,16
1403949,1104523,2021-07-08,Assembly,"SB 214 Bates Consent Calendar Second Day Regular Session",76,0,3,0,79
1405776,1054736,2021-04-15,Assembly,"Do pass and be re-referred to the Committee on [Appropriations]",5,0,2,0,7
1405776,1065120,2021-04-28,Assembly,"Do pass",12,4,0,0,16
1405777,1054663,2021-04-15,Assembly,"Do pass and be re-referred to the Committee on [Appropriations]",6,0,1,0,7
1405777,1065080,2021-04-28,Assembly,"Do pass",13,3,0,0,16
1405777,1078733,2021-05-17,Assembly,"AB 237 Gray Assembly Third Reading",62,9,7,0,78
1405777,1100239,2021-06-21,Senate,"Do pass, but first be re-referred to the Committee on [Judiciary]",5,0,0,0,5
1405777,1104389,2021-07-06,Senate,"Do pass, but first be re-referred to the Committee on [Appropriations]",9,2,0,0,11
1405777,1107208,2021-08-30,Senate,"Assembly 3rd Reading AB237 Gray et al. By Cortese",30,8,0,2,40
1405779,1048902,2021-04-08,Assembly,"Do pass and be re-referred to the Committee on [Appropriations]",22,0,0,0,22
1405779,1065124,2021-04-28,Assembly,"Do pass. To Consent Calendar",16,0,0,0,16
1405779,1074120,2021-05-06,Assembly,"AB 239 Villapudua Consent Calendar Second Day Regular Session",77,0,1,0,78
1405779,1095018,2021-06-08,Senate,"Do pass, but first be re-referred to the Committee on [Appropriations]",14,0,1,0,15
1405779,1107157,2021-08-30,Senate,"Assembly 3rd Reading AB239 Villapudua et al. By Wiener",39,0,0,1,40
1405779,1107412,2021-09-01,Assembly,"AB 239 Villapudua Concurrence in Senate Amendments",78,0,0,1,79
1405780,1046179,2021-04-06,Assembly,"Do pass and be re-referred to the Committee on [Appropriations] with recommendation: To Consent Calendar",15,0,0,0,15
1405780,1082161,2021-05-20,Assembly,"Do pass",16,0,0,0,16
1405780,1087068,2021-05-27,Assembly,"AB 240 Rodriguez Assembly Third Reading",78,0,0,0,78
1405780,1098644,2021-06-16,Senate,"Do pass as amended, but first amend, and re-refer to the Committee on [Appropriations]",10,0,1,0,11
1405780,1104159,2021-07-05,Senate,"Placed on suspense file",6,0,1,0,7
1405780,1223566,2022-08-11,Senate,"Do pass as amended",7,0,0,0,7
1405780,1224525,2022-08-23,Senate,"Assembly 3rd Reading AB240 Rodriguez et al. By Pan",40,0,0,0,40
1405780,1224641,2022-08-24,Assembly,"AB 240 Rodriguez Concurrence in Senate Amendments",76,0,0,4,80
1405782,1047560,2021-04-07,Assembly,"Do pass as amended, and be re-referred to the Committee on [Appropriations] with recommendation: To Consent Calendar",15,0,0,0,15
1405782,1059282,2021-04-21,Assembly,"Do pass. To Consent Calendar",14,0,2,0,16
1405782,1083856,2021-05-24,Assembly,"AB 242 Holden Assembly Third Reading",76,0,2,0,78
1405782,1099759,2021-06-21,Senate,"Do pass, but first be re-referred to the Committee on [Appropriations] with the recommendation: To Consent Calendar",13,0,1,0,14
1405782,1106432,2021-08-23,Senate,"Placed on suspense file",7,0,0,0,7
1405782,1106919,2021-08-26,Senate,"Do pass",7,0,0,0,7
1405782,1107759,2021-09-03,Senate,"Special Consent AB242",37,0,0,3,40
1405782,1107909,2021-09-07,Assembly,"AB 242 Holden Concurrence in Senate Amendments",73,0,0,7,80
1405783,1123317,2022-01-10,Assembly,"Do pass as amended and be re-referred to the Committee on [Appropriations]",8,1,0,2,11
1405785,1036536,2021-03-24,Assembly,"Do pass and be re-referred to the Committee on [Appropriations]",11,0,1,0,12
1405785,1053520,2021-04-14,Assembly,"Do pass",12,0,4,0,16
1405785,1083803,2021-05-24,Assembly,"AB 245 Chiu Assembly Third Reading",63,2,13,0,78
1405785,1098651,2021-06-16,Senate,"Do pass as amended, but first amend, and re-refer to the Committee on [Judiciary]",6,1,0,0,7
1405785,1103419,2021-06-29,Senate,"Do pass, but first be re-referred to the Committee on [Appropriations]",9,2,0,0,11
1405785,1106415,2021-08-23,Senate,"Assembly 3rd Reading AB245 Chiu et al. By Wiener",29,8,0,3,40
1405785,1107235,2021-08-30,Assembly,"AB 245 Chiu Concurrence in Senate Amendments",61,1,0,17,79
1405786,1035187,2021-03-23,Assembly,"Do pass and be re-referred to the Committee on [Appropriations]",17,0,2,0,19
1405786,1053575,2021-04-14,Assembly,"Do pass. To Consent Calendar",16,0,0,0,16
1405786,1060819,2021-04-22,Assembly,"AB 246 Quirk Consent Calendar Second Day Regular Session",77,0,2,0,79
1405786,1093676,2021-06-07,Senate,"Do pass, but first be re-referred to the Committee on [Appropriations] with the recommendation: To Consent Calendar",12,0,2,0,14
1405786,1101660,2021-06-24,Senate,"Consent Calendar AB246",39,0,1,0,40
1405788,1025126,2021-03-09,Senate,"Do pass, but first be re-referred to the Committee on [Appropriations] with the recommendation: To Consent Calendar",4,0,0,0,4
1405788,1033623,2021-03-22,Senate,"Placed on suspense file",7,0,0,0,7
1405788,1082152,2021-05-20,Senate,"Do pass as amended",7,0,0,0,7
1405788,1089491,2021-06-01,Senate,"Senate 3rd Reading SB215 Leyva et al",40,0,0,0,40
1405788,1102824,2021-06-29,Assembly,"Do pass and be re-referred to the Committee on [Appropriations] with recommendation: To Consent Calendar",8,0,0,0,8
1405788,1106916,2021-08-26,Assembly,"Do pass",16,0,0,0,16
1405788,1107637,2021-09-02,Assembly,"SB 215 Leyva Senate Third Reading By Chiu",77,0,0,2,79
1405789,1023844,2021-03-08,Senate,"Do pass as amended, but first amend, and re-refer to the Committee on [Appropriations]",14,0,0,0,14
1405789,1033648,2021-03-22,Senate,"Placed on suspense file",7,0,0,0,7
1405789,1081563,2021-05-20,Senate,"Do pass",7,0,0,0,7
1405789,1120725,2022-01-06,Senate,"Senate 3rd Reading SB216 Dodd",28,0,0,12,40
1405789,1215752,2022-06-14,Assembly,"Do pass and be re-referred to the Committee on [Insurance]",15,0,0,3,18
1405789,1217942,2022-06-22,Assembly,"Do pass and be re-referred to the Committee on [Appropriations]",11,0,0,3,14
1405789,1223699,2022-08-11,Assembly,"Do pass",14,0,0,2,16
1405789,1224156,2022-08-18,Assembly,"SB 216 Dodd Senate Third Reading By Quirk",70,0,0,10,80
1405789,1224280,2022-08-22,Senate,"Unfinished Business SB216 Dodd Concurrence",39,0,0,1,40
1405790,1026109,2021-03-10,Senate,"Do pass, but first be re-referred to the Committee on [Appropriations]",3,3,1,0,7
1405790,1026110,2021-03-10,Senate,"[03-10-2021] hearing: Motion to Reconsider. [Reconsideration Granted.]",7,0,0,0,7
1405790,1053422,2021-03-10,Senate,"[First] hearing set for [04-14-2021]: Failed passage in Committee. Reconsideration granted",7,0,0,0,7
1405790,1065261,2021-04-28,Senate,"Do pass as amended, but first amend, and re-refer to the Committee on [Appropriations]",4,1,2,0,7
1405790,1078811,2021-05-17,Senate,"Placed on suspense file",7,0,0,0,7
1405791,1026095,2021-03-10,Senate,"Do pass, but first be re-referred to the Committee on [Judiciary]",9,0,0,0,9
1405791,1047580,2021-04-06,Senate,"Do pass as amended, but first amend, and re-refer to the Committee on [Appropriations] with the recommendation: To Consent Calendar",11,0,0,0,11
1405791,1060865,2021-04-22,Senate,"Consent Calendar SB218",38,0,2,0,40
1405791,1102875,2021-06-29,Assembly,"Do pass and be re-referred to the Committee on [Judiciary] with recommendation: To Consent Calendar",12,0,0,0,12
1405791,1124157,2022-01-13,Assembly,"Do pass and be re-referred to the Committee on [Appropriations] with recommendation: To Consent Calendar",10,0,0,0,10
1405791,1217871,2022-06-22,Assembly,"Do pass. To Consent Calendar",13,0,0,3,16
1405791,1221566,2022-06-29,Assembly,"SB 218 Jones Consent Calendar Second Day Regular Session",78,0,0,2,80
1405791,1223273,2022-08-08,Senate,"Special Consent SB218",36,0,0,4,40
1405792,1027180,2021-03-11,Senate,"Do pass, but first be re-referred to the Committee on [Appropriations] with the recommendation: To Consent Calendar",5,0,0,0,5
1405792,1037843,2021-03-25,Senate,"Consent Calendar SB219 McGuire et al. Urgency Clause",38,0,2,0,40
1405792,1100293,2021-06-21,Assembly,"Do pass and be re-referred to the Committee on [Appropriations] with recommendation: To Consent Calendar",11,0,0,0,11
1405792,1104471,2021-07-07,Assembly,"Do pass. To Consent Calendar",14,0,2,0,16
1405792,1105101,2021-07-15,Assembly,"SB 219 McGuire Consent Calendar Second Day Regular Session",70,0,9,0,79
1405794,1030783,2021-03-17,Senate,"Do pass as amended, but first amend, and re-refer to the Committee on [Appropriations]",9,0,2,0,11
1405794,1068257,2021-05-03,Senate,"Placed on suspense file",6,0,1,0,7
1405794,1081445,2021-05-20,Senate,"Do pass as amended",5,2,0,0,7
1405794,1089488,2021-06-01,Senate,"Senate 3rd Reading SB221 Wiener et al",32,7,1,0,40
1405794,1104340,2021-07-06,Assembly,"Do pass and be re-referred to the Committee on [Appropriations]",15,0,0,0,15
1405794,1106579,2021-08-26,Assembly,"Do pass",16,0,0,0,16
1405794,1108029,2021-09-08,Assembly,"SB 221 Wiener Senate Third Reading By Waldron",76,0,0,4,80
1405794,1108360,2021-09-09,Senate,"Unfinished Business SB221 Wiener et al. Concurrence",35,1,0,4,40
1407537,1123295,2022-01-10,Assembly,"Do pass and be re-referred to the Committee on [Appropriations]",8,1,0,2,11
1407539,1036477,2021-03-24,Assembly,"Do pass",12,0,0,0,12
1407539,1049019,2021-04-08,Assembly,"AB 251 Choi Assembly Third Reading",74,0,4,0,78
1407539,1096106,2021-06-09,Senate,"Do pass",7,0,0,0,7
1407539,1101583,2021-06-24,Senate,"Special Consent AB251",39,0,1,0,40
1407540,1049888,2021-04-08,Assembly,"Do pass and be re-referred to the Committee on [Appropriations]",15,0,0,0,15
1407540,1081648,2021-05-20,Assembly,"Do pass",16,0,0,0,16
1407540,1090448,2021-06-02,Assembly,"AB 252 Robert Rivas Assembly Third Reading",78,0,1,0,79
1407540,1104707,2021-07-13,Senate,"Do pass, but first be re-referred to the Committee on [Rules]",8,0,1,0,9
1407540,1106410,2021-08-23,Senate,"Placed on suspense file",7,0,0,0,7
1407540,1106749,2021-08-26,Senate,"Do pass as amended",7,0,0,0,7
1407540,1220771,2022-06-28,Senate,"Do pass as amended",9,1,0,1,11
1407540,1224658,2022-08-24,Senate,"Assembly 3rd Reading AB252 Mia Bonta et al. By Skinner",30,8,0,2,40
1407540,1225112,2022-08-29,Assembly,"With recommendation: That Senate amendments be concurred in",6,2,0,0,8
1407540,1225295,2022-08-30,Assembly,"AB 252 Mia Bonta Concurrence in Senate Amendments",61,17,0,2,80
1407541,1036465,2021-03-23,Assembly,"Do pass",5,2,1,0,8
1407541,1054676,2021-04-15,Assembly,"AB 253 Patterson Assembly Third Reading",50,11,17,0,78
1407542,1053429,2021-04-13,Assembly,"Do pass and be re-referred to the Committee on [Appropriations] with recommendation: To Consent Calendar",8,0,0,0,8
1407542,1081712,2021-05-20,Assembly,"Do pass as amended",13,0,3,0,16
1407542,1092919,2021-06-01,Assembly,"AB 254 Jones-Sawyer Assembly Third Reading",79,0,0,0,79
1407542,1104256,2021-07-06,Senate,"Do pass, but first be re-referred to the Committee on [Appropriations] with the recommendation: To Consent Calendar",5,0,0,0,5
1407542,1223173,2022-08-08,Senate,"Placed on suspense file",7,0,0,0,7
1407543,1072229,2021-05-04,Assembly,"Do pass as amended",8,3,0,0,11
1407543,1090372,2021-06-02,Assembly,"AB 255 Muratsuchi Assembly Third Reading",28,21,30,0,79
1407544,1036483,2021-03-23,Assembly,"Do pass and be re-referred to the Committee on [Appropriations]",6,2,0,0,8
1407544,1081751,2021-05-20,Assembly,"Do pass as amended",12,4,0,0,16
1407544,1092884,2021-06-01,Assembly,"AB 256 Kalra Assembly Third Reading",45,21,13,0,79
1407544,1102798,2021-06-29,Senate,"Do pass, but first be re-referred to the Committee on [Appropriations]",4,1,0,0,5
1407544,1105033,2021-07-15,Senate,"Placed on suspense file",7,0,0,0,7
1407544,1223675,2022-08-11,Senate,"Do pass as amended",5,2,0,0,7
1407544,1225163,2022-08-30,Assembly,"With recommendation: That Senate amendments be concurred in",5,2,0,0,7
1407544,1225597,2022-08-29,Senate,"Assembly 3rd Reading AB256 Kalra et al. By Kamlager",30,10,0,0,40
1407544,1225598,2022-08-31,Assembly,"AB 256 Kalra Concurrence in Senate Amendments",46,25,0,9,80
1407545,1105070,2021-07-15,Assembly,"Be adopted. To Consent Calendar",10,0,2,0,12
1407545,1106447,2021-08-23,Assembly,"HR 8 Choi Consent Calendar Second Day",70,0,0,9,79
1407546,1050811,2021-04-12,Senate,"Do pass as amended, but first amend, and re-refer to the Committee on [Environmental Quality]",11,2,1,0,14
1407546,1066777,2021-04-29,Senate,"Do pass as amended, but first amend, and re-refer to the Committee on [Appropriations]",5,2,0,0,7
1407546,1078747,2021-05-17,Senate,"Placed on suspense file",7,0,0,0,7
1407546,1081718,2021-05-20,Senate,"Do pass as amended",5,2,0,0,7
1407546,1089483,2021-06-01,Senate,"Senate 3rd Reading SB222 Dodd et al",31,7,2,0,40
1407546,1098666,2021-06-16,Assembly,"Do pass and be re-referred to the Committee on [Utilities and Energy]",7,2,0,0,9
1407546,1103476,2021-06-30,Assembly,"Do pass as amended and be re-referred to the Committee on [Appropriations]",12,0,3,0,15
1407546,1106928,2021-08-26,Assembly,"Do pass as amended",13,3,0,0,16
1407546,1225060,2022-08-29,Assembly,"SB 222 Dodd Senate Third Reading By Robert Rivas",52,13,0,15,80
1407546,1225706,2022-08-30,Senate,"Unfinished Business SB222 Dodd et al. Concurrence",31,8,0,1,40
1407547,1050813,2021-04-12,Senate,"Do pass as amended, but first amend, and re-refer to the Committee on [Environmental Quality]",11,1,2,0,14
1407547,1066800,2021-04-29,Senate,"Do pass as amended, but first amend, and re-refer to the Committee on [Appropriations]",5,2,0,0,7
1407547,1078833,2021-05-17,Senate,"Placed on suspense file",7,0,0,0,7
1407548,1026098,2021-03-10,Senate,"Do pass as amended, but first amend, and re-refer to the Committee on [Appropriations]",7,0,0,0,7
1407548,1044945,2021-04-05,Senate,"Placed on suspense file",7,0,0,0,7
1407548,1081421,2021-05-20,Senate,"Do pass as amended",7,0,0,0,7
1407548,1089591,2021-06-01,Senate,"Special Consent SB224",39,0,1,0,40
1407548,1104489,2021-07-07,Assembly,"Do pass as amended and be re-referred to the Committee on [Appropriations]",7,0,0,0,7
1407548,1106864,2021-08-26,Assembly,"Do pass as amended",12,0,0,4,16
1407548,1107693,2021-09-02,Assembly,"SB 224 Portantino Senate Third Reading By Low",72,1,0,6,79
1407548,1107756,2021-09-03,Senate,"Unfinished Business SB224 Portantino et al. Concurrence",38,0,0,2,40
1407549,1122861,2022-01-10,Senate,"Do pass, but first be re-referred to the Committee on [Judiciary]",9,0,0,5,14
1407549,1124835,2022-01-18,Senate,"Senate 3rd Reading SB225 Wiener",29,0,0,11,40
1407549,1219935,2022-06-28,Assembly,"Do pass as amended and be re-referred to the Committee on [Appropriations]",12,0,0,3,15
1407549,1223619,2022-08-11,Assembly,"Do pass",14,0,0,2,16
1407549,1224665,2022-08-24,Assembly,"SB 225 Wiener Senate Third Reading By Arambula",75,0,0,5,80
1407549,1225037,2022-08-29,Senate,"That the Assembly amendments be concurred in",7,0,0,4,11
1407549,1225403,2022-08-30,Senate,"Unfinished Business SB225 Wiener Concurrence",38,0,0,2,40
1408675,1060989,2021-04-22,Assembly,"Do pass and be re-referred to the Committee on [Judiciary]",5,2,0,0,7
1408675,1064031,2021-04-27,Assembly,"Do pass as amended and be re-referred to the Committee on [Appropriations]",7,3,1,0,11
1408675,1082224,2021-05-20,Assembly,"Do pass",12,4,0,0,16
1408675,1091742,2021-06-03,Assembly,"AB 257 Lorena Gonzalez Assembly Third Reading",38,27,14,0,79
1408675,1126277,2022-01-20,Assembly,"AB 257 Assembly Third Reading By HOLDEN Amendment Set #1",43,13,0,20,76
1408675,1129867,2022-01-27,Assembly,"AB 257 Holden Assembly Third Reading Amendment Set #1",44,16,0,16,76
1408675,1131262,2022-01-31,Assembly,"AB 257 Holden Assembly Third Reading",41,21,0,14,76
1408675,1215787,2022-06-13,Senate,"Do pass as amended, but first amend, and re-refer to the Committee on [Judiciary]",3,2,0,0,5
1408675,1220644,2022-06-28,Senate,"Do pass, but first be re-referred to the Committee on [Appropriations]",7,1,0,3,11
1408675,1222638,2022-08-01,Senate,"Placed on suspense file",7,0,0,0,7
1408675,1223466,2022-08-11,Senate,"Do pass",5,2,0,0,7
1408675,1225119,2022-08-29,Assembly,"AB 257 HOLDEN Concurrence in Senate Amendments",47,19,0,14,80
1408675,1225271,2022-08-29,Senate,"Assembly 3rd Reading AB257 Holden et al. By Durazo",21,12,0,7,40
1408676,1054643,2021-04-15,Assembly,"Do pass as amended and be re-referred to the Committee on [Judiciary]",8,0,0,0,8
1408676,1064117,2021-04-27,Assembly,"Do pass and be re-referred to the Committee on [Appropriations]",10,0,1,0,11
1408678,1035177,2021-03-23,Assembly,"Do pass and be re-referred to the Committee on [Human Services] with recommendation: To Consent Calendar",11,0,0,0,11
1408678,1059162,2021-04-21,Assembly,"Do pass and be re-referred to the Committee on [Appropriations] with recommendation: To Consent Calendar",8,0,0,0,8
1408678,1073365,2021-05-05,Assembly,"Do pass. To Consent Calendar",16,0,0,0,16
1408678,1077583,2021-05-13,Assembly,"AB 260 Stone Consent Calendar Second Day",75,0,3,0,78
1408678,1098140,2021-06-15,Senate,"Do pass, but first be re-referred to the Committee on [Human Services]",10,0,1,0,11
1408678,1104491,2021-07-06,Senate,"Do pass, but first be re-referred to the Committee on [Appropriations]",5,0,0,0,5
1408678,1106189,2021-08-16,Senate,"Placed on suspense file",7,0,0,0,7
1408678,1106939,2021-08-26,Senate,"Do pass as amended",7,0,0,0,7
1408678,1108040,2021-09-08,Senate,"Assembly 3rd Reading AB260 Stone By Hurtado",37,0,0,3,40
1408678,1108381,2021-09-09,Assembly,"AB 260 Stone Concurrence in Senate Amendments",79,0,0,1,80
1408680,1036487,2021-03-23,Assembly,"Do pass and be re-referred to the Committee on [Appropriations] with recommendation: To Consent Calendar",8,0,0,0,8
1408680,1081670,2021-05-20,Assembly,"Do pass",16,0,0,0,16
1408680,1090417,2021-06-02,Assembly,"AB 262 Patterson Assembly Third Reading",78,0,1,0,79
1408680,1104693,2021-07-13,Senate,"Do pass, but first be re-referred to the Committee on [Appropriations] with the recommendation: To Consent Calendar",5,0,0,0,5
1408680,1106155,2021-08-16,Senate,"Placed on suspense file",7,0,0,0,7
1408680,1106875,2021-08-26,Senate,"Do pass as amended",7,0,0,0,7
1408680,1108002,2021-09-08,Senate,"Special Consent AB262",38,0,0,2,40
1408680,1108395,2021-09-09,Assembly,"AB 262 Patterson Concurrence in Senate Amendments",79,0,0,1,80
1408681,1036473,2021-03-23,Assembly,"Do pass",8,0,0,0,8
1408681,1066698,2021-04-29,Assembly,"AB 263 Arambula Third Reading Urgency",71,0,7,0,78
1408681,1098173,2021-06-15,Senate,"Do pass, but first be re-referred to the Committee on [Judiciary] with the recommendation: To Consent Calendar",4,0,1,0,5
1408681,1104454,2021-07-06,Senate,"Do pass",11,0,0,0,11
1408681,1107261,2021-08-30,Senate,"Special Consent AB263 Arambula et al. By Durazo Urgency Clause",39,0,0,1,40
1408681,1107384,2021-09-01,Assembly,"AB 263 Arambula Concurrence in Senate Amendments",74,0,0,5,79
1408683,1035191,2021-03-23,Assembly,"Do pass and be re-referred to the Committee on [Appropriations]",15,0,0,0,15
1408684,1053574,2021-04-13,Assembly,"Do pass and be re-referred to the Committee on [Appropriations]",2,4,2,0,8
1408684,1059190,2021-04-20,Assembly,Reconsideration,8,0,0,0,8
1408684,1123351,2022-01-11,Assembly,"Do pass and be re-referred to the Committee on [Appropriations]",2,5,0,0,7
1408685,1036420,2021-03-24,Assembly,"Do pass and be re-referred to the Committee on [Appropriations]",8,1,2,0,11
1408685,1053537,2021-04-14,Assembly,"Do pass",13,0,3,0,16
1408685,1066680,2021-04-29,Assembly,"AB 267 Valladares Assembly Third Reading",62,2,14,0,78
1408685,1211827,2022-06-01,Senate,"Do pass, but first be re-referred to the Committee on [Environmental Quality]",7,0,0,2,9
1408685,1220791,2022-06-29,Senate,"Do pass as amended, but first amend, and re-refer to the Committee on [Appropriations]",6,0,0,1,7
1408685,1222723,2022-08-01,Senate,"Placed on suspense file",7,0,0,0,7
1408685,1223950,2022-08-11,Senate,"Do pass",7,0,0,0,7
1408686,1047545,2021-04-06,Assembly,"Do pass and be re-referred to the Committee on [Privacy and Consumer Protection]",7,0,1,0,8
1408686,1060834,2021-04-22,Assembly,"Do pass and be re-referred to the Committee on [Appropriations]",8,1,2,0,11
1408686,1081816,2021-05-20,Assembly,"Do pass",15,0,1,0,16
1408686,1087002,2021-05-27,Assembly,"AB 268 Irwin Assembly Third Reading",75,1,2,0,78
1408687,1106349,2021-08-19,Assembly,"Be adopted. To third reading",11,0,0,1,12
1408687,1107867,2021-09-07,Senate,"Assembly 3rd Reading ACR10",37,0,0,3,40
1408689,992316,2021-01-28,Assembly,"Be adopted. To Consent Calendar",10,0,2,0,12
1408689,996622,2021-02-04,Assembly,"HR 9 Kiley Consent Calendar Second Day Regular Session",72,0,7,0,79
1408690,1026127,2021-03-10,Senate,"Do pass, but first be re-referred to the Committee on [Appropriations] with the recommendation: To Consent Calendar",11,0,0,0,11
1408690,1037818,2021-03-25,Senate,"Consent Calendar SB226",38,0,2,0,40
1408690,1095052,2021-06-08,Assembly,"Do pass and be re-referred to the Committee on [Appropriations] with recommendation: To Consent Calendar",15,0,0,0,15
1408690,1106823,2021-08-26,Assembly,"Do pass",16,0,0,0,16
1408690,1107734,2021-09-02,Assembly,"SB 226 Pan Senate Third Reading By McCarty",77,0,0,2,79
1408691,1051911,2021-04-13,Senate,"Do pass, but first be re-referred to the Committee on [Natural Resources and Water]",12,2,3,0,17
1408691,1064003,2021-04-27,Senate,"Do pass, but first be re-referred to the Committee on [Appropriations]",6,2,1,0,9
1408691,1075251,2021-05-10,Senate,"Placed on suspense file",7,0,0,0,7
1408691,1081782,2021-05-20,Senate,"Do pass as amended",7,0,0,0,7
1408691,1090490,2021-06-02,Senate,"Senate 3rd Reading SB227 Jones et al",26,8,6,0,40
1408691,1099750,2021-06-21,Assembly,"Do pass as amended and be re-referred to the Committee on [Water, Parks, and Wildlife]",13,0,2,0,15
1408692,1026120,2021-03-10,Senate,"Do pass, but first be re-referred to the Committee on [Human Services] with the recommendation: To Consent Calendar",7,0,0,0,7
1408692,1035180,2021-03-23,Senate,"Do pass, but first be re-referred to the Committee on [Appropriations] with the recommendation: To Consent Calendar",5,0,0,0,5
1408692,1045001,2021-04-05,Senate,"Placed on suspense file",7,0,0,0,7
1408692,1082165,2021-05-20,Senate,"Do pass as amended",7,0,0,0,7
1411970,1057753,2021-04-20,Assembly,"Do pass and be re-referred to the Committee on [Appropriations]",19,0,0,0,19
1411972,1036439,2021-03-24,Assembly,"Do pass and be re-referred to the Committee on [Appropriations]",8,0,0,0,8
1411972,1053505,2021-04-14,Assembly,"Do pass",16,0,0,0,16
1411972,1056487,2021-04-19,Assembly,"AB 271 Robert Rivas Assembly Third Reading",76,1,2,0,79
1411972,1097047,2021-06-10,Senate,"Do pass, but first be re-referred to the Committee on [Appropriations]",5,0,0,0,5
1411972,1101671,2021-06-24,Senate,"Assembly 3rd Reading AB271 Robert Rivas et al. By Laird",39,0,1,0,40
1411973,1046129,2021-04-06,Assembly,"Do pass",11,0,0,0,11
1411973,1075286,2021-05-10,Assembly,"AB 272 Kiley Assembly Third Reading",72,0,6,0,78
1411973,1098149,2021-06-15,Senate,"Do pass",10,0,1,0,11
1411973,1106164,2021-08-16,Senate,"Assembly 3rd Reading AB272 Kiley et al. By Wiener",39,0,0,1,40
1411974,1065147,2021-04-27,Assembly,"Do pass and be re-referred to the Committee on [Appropriations]",8,0,11,0,19
1411976,1036466,2021-03-24,Assembly,"Do pass",10,1,1,0,12
1411976,1056488,2021-04-19,Assembly,"AB 275 Medina Assembly Third Reading",65,2,12,0,79
1411976,1102505,2021-06-28,Senate,"Do pass as amended",4,0,1,0,5
1411976,1104639,2021-07-12,Senate,"Assembly 3rd Reading AB275 Medina By Newman",29,10,1,0,40
1411976,1106463,2021-08-23,Assembly,"AB 275 Medina Concurrence in Senate Amendments",59,5,0,15,79
1411978,1035196,2021-03-23,Assembly,"Do pass as amended, and be re-referred to the Committee on [Appropriations] with recommendation: To Consent Calendar",11,0,0,0,11
1411978,1053468,2021-04-14,Assembly,"Do pass",16,0,0,0,16
1411978,1060880,2021-04-22,Assembly,"AB 277 Valladares Assembly Third Reading",77,0,2,0,79
1411978,1095033,2021-06-08,Senate,"Do pass, but first be re-referred to the Committee on [Appropriations] with the recommendation: To Consent Calendar",11,0,0,0,11
1411978,1099721,2021-06-21,Senate,"Placed on suspense file",7,0,0,0,7
1411978,1106981,2021-08-26,Senate,"Do pass",7,0,0,0,7
1411978,1107796,2021-09-03,Senate,"Special Consent AB277",37,0,0,3,40
1411978,1107910,2021-09-07,Assembly,"AB 277 Valladares Concurrence in Senate Amendments",73,0,0,7,80
1411979,1035162,2021-03-23,Assembly,"Do pass and be re-referred to the Committee on [Appropriations] with recommendation: To Consent Calendar",15,0,0,0,15
1411980,992321,2021-01-28,Assembly,"Be adopted. To Consent Calendar",10,0,2,0,12
1411980,996615,2021-02-04,Assembly,"HR 11 Bauer-Kahan Consent Calendar Second Day Regular Session",72,0,7,0,79
1411981,1053453,2021-04-14,Senate,"Do pass as amended, but first amend, and re-refer to the Committee on [Education]",11,0,0,0,11
1411981,1065228,2021-04-28,Senate,"Do pass as amended, but first amend, and re-refer to the Committee on [Appropriations] with the recommendation: To Consent Calendar",7,0,0,0,7
1411981,1075391,2021-05-10,Senate,"Placed on suspense file",7,0,0,0,7
1411982,1028394,2021-03-15,Senate,"Do pass, but first be re-referred to the Committee on [Appropriations]",7,0,0,0,7
1411982,1124825,2022-01-18,Senate,"Placed on suspense file",6,0,0,1,7
1411982,1126267,2022-01-20,Senate,"Do pass as amended",7,0,0,0,7
1411982,1128986,2022-01-26,Senate,"Senate 3rd Reading SB230 Portantino",37,0,0,3,40
1411982,1220068,2022-06-28,Assembly,"Do pass and be re-referred to the Committee on [Appropriations]",8,0,0,0,8
1411982,1223771,2022-08-11,Assembly,"Do pass as amended",12,0,0,4,16
1411982,1225043,2022-08-29,Assembly,"SB 230 Portantino Senate Third Reading By Quirk",76,0,0,4,80
1411982,1225275,2022-08-30,Senate,"Unfinished Business SB230 Portantino Concurrence",40,0,0,0,40
1411983,1064044,2021-04-27,Senate,"Do pass, but first be re-referred to the Committee on [Appropriations]",17,0,0,0,17
1411983,1091725,2021-06-03,Senate,"Senate 3rd Reading SB231 McGuire et al",39,0,1,0,40
1411983,1104293,2021-07-05,Assembly,"Do pass and be re-referred to the Committee on [Appropriations]",15,0,0,0,15
1411983,1106355,2021-08-19,Assembly,"Do pass. To Consent Calendar",16,0,0,0,16
1411983,1107948,2021-09-07,Assembly,"SB 231 McGuire Senate Third Reading By Wood",73,0,0,7,80
1411983,1107999,2021-09-08,Senate,"Unfinished Business SB231 McGuire et al. Concurrence",38,0,0,2,40
1411984,1064006,2021-04-26,Senate,"Do pass, but first be re-referred to the Committee on [Appropriations]",5,0,0,0,5
1411984,1075307,2021-05-10,Senate,"Placed on suspense file",7,0,0,0,7
1411984,1081901,2021-05-20,Senate,"Do pass",7,0,0,0,7
1411984,1089471,2021-06-01,Senate,"Special Consent SB232",39,0,1,0,40
1411984,1101676,2021-06-24,Assembly,"Do pass and be re-referred to the Committee on [Appropriations] with recommendation: To Consent Calendar",14,0,0,0,14
1411985,1047589,2021-04-06,Senate,"Do pass and be ordered to the Consent Calendar",11,0,0,0,11
1411985,1060812,2021-04-22,Senate,"Consent Calendar SB233 Umberg",38,0,2,0,40
1411985,1216600,2022-06-16,Assembly,"Be re-referred to the Committee on [Judiciary]",8,0,0,3,11
1411985,1220063,2022-06-28,Assembly,"Do pass and be re-referred to the Committee on [Appropriations] with recommendation: To Consent Calendar",11,0,0,0,11
1411985,1223835,2022-08-11,Assembly,"Do pass",16,0,0,0,16
1411985,1224210,2022-08-18,Assembly,"SB 233 Umberg Senate Third Reading By Stone",77,0,0,3,80
1411985,1224723,2022-08-24,Senate,"That the Assembly amendments be concurred in",9,0,0,2,11
1411985,1225877,2022-08-30,Senate,"Special Consent SB233",38,0,0,2,40
1411986,1025100,2021-03-09,Senate,"Do pass, but first be re-referred to the Committee on [Housing]",4,0,0,0,4
1411986,1054594,2021-04-15,Senate,"Do pass, but first be re-referred to the Committee on [Appropriations] with the recommendation: To Consent Calendar",9,0,0,0,9
1411986,1068187,2021-05-03,Senate,"Placed on suspense file",6,0,1,0,7
1411986,1081615,2021-05-20,Senate,"Do pass",7,0,0,0,7
1411986,1120729,2022-01-06,Senate,"Senate 3rd Reading SB234 Wiener",32,0,0,8,40
1411986,1216336,2022-06-15,Assembly,"Do pass and be re-referred to the Committee on [Human Services]",8,0,0,0,8
1411986,1219939,2022-06-28,Assembly,"Do pass and be re-referred to the Committee on [Appropriations] with recommendation: To Consent Calendar",7,0,0,1,8
1411987,1026122,2021-03-10,Senate,"Do pass, but first be re-referred to the Committee on [Agriculture]",11,0,0,0,11
1411987,1054745,2021-04-15,Senate,"Do pass, but first be re-referred to the Committee on [Appropriations]",5,0,0,0,5
1411987,1075285,2021-05-10,Senate,"Placed on suspense file",7,0,0,0,7
1411987,1081498,2021-05-20,Senate,"Do pass as amended",7,0,0,0,7
1417849,1052021,2021-04-13,Assembly,"Do pass as amended and be re-referred to the Committee on [Appropriations]",11,2,2,0,15
1417849,1065137,2021-04-28,Assembly,"Do pass",12,4,0,0,16
1417849,1077525,2021-05-13,Assembly,"AB 279 Muratsuchi Third Reading Urgency",58,1,19,0,78
1417849,1101695,2021-06-23,Senate,"Do pass as amended, but first amend, and re-refer to the Committee on [Appropriations]",10,0,1,0,11
1417849,1105102,2021-07-15,Senate,"Do pass",6,0,1,0,7
1417849,1106408,2021-08-23,Senate,"Assembly 3rd Reading AB279 Muratsuchi et al. By Durazo Urgency Clause",32,3,0,5,40
1417849,1107221,2021-08-30,Assembly,"AB 279 Muratsuchi Concurrence in Senate Amendments",62,0,0,17,79
1417852,1047479,2021-04-06,Assembly,"Do pass as amended",5,3,0,0,8
1417852,1086967,2021-05-27,Assembly,"AB 282 Lackey Assembly Third Reading",64,9,5,0,78
1417852,1104713,2021-07-13,Senate,"Do pass",1,3,1,0,5
1417852,1104714,2021-07-13,Senate,"[First] hearing set for [07-13-2021]: Failed passage in Committee. Reconsideration granted",5,0,0,0,5
1417853,1054693,2021-04-15,Assembly,"Do pass and be re-referred to the Committee on [Appropriations] with recommendation: To Consent Calendar",12,0,0,0,12
1417853,1065082,2021-04-28,Assembly,"Do pass. To Consent Calendar",16,0,0,0,16
1417853,1074126,2021-05-06,Assembly,"AB 283 Chen Consent Calendar Second Day Regular Session",77,0,1,0,78
1417853,1096091,2021-06-09,Senate,"Do pass, but first be re-referred to the Committee on [Judiciary] with the recommendation: To Consent Calendar",9,0,0,0,9
1417853,1100810,2021-06-22,Senate,"Do pass, but first be re-referred to the Committee on [Appropriations] with the recommendation: To Consent Calendar",11,0,0,0,11
1417853,1107222,2021-08-30,Senate,"Consent Calendar AB283",39,0,0,1,40
1417854,1036533,2021-03-24,Assembly,"Do pass and be re-referred to the Committee on [Appropriations]",8,1,2,0,11
1417854,1081681,2021-05-20,Assembly,"Do pass",12,4,0,0,16
1417854,1092843,2021-06-01,Assembly,"AB 284 Robert Rivas Assembly Third Reading",52,18,9,0,79
1417854,1102457,2021-06-28,Senate,"Do pass as amended, but first amend, and re-refer to the Committee on [Natural Resources and Water]",4,2,1,0,7
1417854,1104730,2021-07-13,Senate,"Do pass as amended, but first amend, and re-refer to the Committee on [Appropriations]",7,1,1,0,9
1417854,1106127,2021-08-16,Senate,"Placed on suspense file",7,0,0,0,7
1417854,1106867,2021-08-26,Senate,"Do pass",5,2,0,0,7
1417855,1036422,2021-03-24,Assembly,"Do pass and be re-referred to the Committee on [Appropriations] with recommendation: To Consent Calendar",7,0,0,0,7
1417856,1060971,2021-04-22,Assembly,"Do pass as amended",9,1,1,0,11
1417856,1077568,2021-05-13,Assembly,"AB 286 Lorena Gonzalez Assembly Third Reading",56,8,14,0,78
1417856,1100802,2021-06-22,Senate,"Do pass, but first be re-referred to the Committee on [Business, Professions and Economic Development]",9,2,0,0,11
1417856,1104971,2021-07-14,Senate,"Do pass as amended, but first amend, and re-refer to the Committee on [Appropriations]",9,2,3,0,14
1417856,1106404,2021-08-23,Senate,"Assembly 3rd Reading AB286 Lorena Gonzalez et a By Roth",27,8,0,5,40
1417856,1107385,2021-09-01,Assembly,"AB 286 Lorena Gonzalez Concurrence in Senate Amendments",58,11,0,10,79
1417857,1035167,2021-03-23,Assembly,"Do pass as amended, and be re-referred to the Committee on [Business and Professions] with recommendation: To Consent Calendar",11,0,0,0,11
1417857,1057640,2021-04-20,Assembly,"Do pass and be re-referred to the Committee on [Appropriations] with recommendation: To Consent Calendar",19,0,0,0,19
1417857,1081507,2021-05-20,Assembly,"Do pass",16,0,0,0,16
1417857,1086986,2021-05-27,Assembly,"AB 287 Quirk Assembly Third Reading",78,0,0,0,78
1417857,1099728,2021-06-21,Senate,"Do pass, but first be re-referred to the Committee on [Judiciary] with the recommendation: To Consent Calendar",11,0,3,0,14
1417857,1103488,2021-06-29,Senate,"Do pass, but first be re-referred to the Committee on [Appropriations] with the recommendation: To Consent Calendar",11,0,0,0,11
1417857,1105044,2021-07-15,Senate,"Placed on suspense file",7,0,0,0,7
1417857,1106675,2021-08-26,Senate,"Do pass",7,0,0,0,7
1417857,1107808,2021-09-03,Senate,"Special Consent AB287",37,0,0,3,40
1417858,1036489,2021-03-24,Assembly,"Do pass and be re-referred to the Committee on [Appropriations]",12,0,0,0,12
1417858,1126271,2022-01-20,Assembly,"Do pass as amended",12,0,0,4,16
1417858,1131267,2022-01-31,Assembly,"AB 288 Calderon Assembly Third Reading",76,0,0,0,76
1417858,1211845,2022-06-01,Senate,"Do pass, but first be re-referred to the Committee on [Appropriations]",6,0,0,1,7
1417858,1224146,2022-08-17,Senate,"Assembly 3rd Reading AB288 Calderon et al. By Skinner",38,0,0,2,40
1417858,1224311,2022-08-22,Assembly,"AB 288 Calderon Concurrence in Senate Amendments",76,0,0,4,80
1417859,1054600,2021-04-15,Assembly,"Do pass and be re-referred to the Committee on [Higher Education]",7,0,0,0,7
1417859,1060906,2021-04-22,Assembly,"Do pass and be re-referred to the Committee on [Appropriations]",11,1,0,0,12
1417859,1073363,2021-05-05,Assembly,"Do pass",14,0,2,0,16
1417859,1077601,2021-05-13,Assembly,"AB 289 Calderon Assembly Third Reading",70,0,8,0,78
1417859,1093674,2021-06-07,Senate,"Do pass, but first be re-referred to the Committee on [Appropriations]",5,0,0,0,5
1417859,1104177,2021-07-05,Senate,"Assembly 3rd Reading AB289 Calderon By Durazo",38,0,2,0,40
1417862,1036428,2021-03-23,Assembly,"Do pass and be re-referred to the Committee on [Appropriations]",6,2,0,0,8
1417862,1081986,2021-05-20,Assembly,"Do pass",12,4,0,0,16
1417862,1092879,2021-06-01,Assembly,"AB 292 Stone Assembly Third Reading",43,27,9,0,79
1417862,1104352,2021-07-06,Senate,"Do pass, but first be re-referred to the Committee on [Appropriations]",4,1,0,0,5
1417862,1106193,2021-08-16,Senate,"Placed on suspense file",7,0,0,0,7
1417862,1107027,2021-08-26,Senate,"Do pass as amended",5,2,0,0,7
1417862,1107531,2021-09-01,Senate,"Assembly 3rd Reading AB292 Stone By Bradford",31,6,0,3,40
1417862,1107724,2021-09-02,Assembly,"AB 292 Stone Concurrence in Senate Amendments",48,18,0,13,79
1417863,1035140,2021-03-23,Assembly,"Do pass and be re-referred to the Committee on [Business and Professions] with recommendation: To Consent Calendar",11,0,0,0,11
1417863,1051964,2021-04-13,Assembly,"Do pass and be re-referred to the Committee on [Appropriations]",17,0,2,0,19
1417863,1081566,2021-05-20,Assembly,"Do pass",16,0,0,0,16
1417863,1087042,2021-05-27,Assembly,"AB 293 Kalra Assembly Third Reading",78,0,0,0,78
1417863,1099733,2021-06-21,Senate,"Do pass, but first be re-referred to the Committee on [Judiciary]",11,0,3,0,14
1417863,1104370,2021-07-06,Senate,"Do pass, but first be re-referred to the Committee on [Appropriations] with the recommendation: To Consent Calendar",11,0,0,0,11
1417863,1106219,2021-08-16,Senate,"Placed on suspense file",7,0,0,0,7
1417863,1106910,2021-08-26,Senate,"Do pass",7,0,0,0,7
1417863,1107791,2021-09-03,Senate,"Special Consent AB293",37,0,0,3,40
1417864,1122864,2022-01-10,Assembly,"Do pass and be re-referred to the Committee on [Business and Professions]",12,0,0,3,15
1417864,1123328,2022-01-11,Assembly,"Do pass and be re-referred to the Committee on [Appropriations]",15,0,0,3,18
1417865,1123297,2022-01-11,Assembly,"Do pass and be re-referred to the Committee on [Appropriations]",9,1,0,2,12
1417865,1126276,2022-01-20,Assembly,"Do pass",12,3,0,1,16
1417865,1129889,2022-01-27,Assembly,"AB 295 Jones-Sawyer Assembly Third Reading",53,4,0,19,76
1417865,1211885,2022-06-01,Senate,"Do pass as amended, but first amend, and re-refer to the Committee on [Appropriations]",5,0,0,2,7
1417865,1217092,2022-06-20,Senate,"Placed on suspense file",4,0,0,3,7
1417866,992308,2021-01-28,Assembly,"Be adopted. To Consent Calendar",10,0,2,0,12
1417866,996628,2021-02-04,Assembly,"ACR 11 Flora Consent Calendar Second Day",72,0,7,0,79
1417866,1018557,2021-03-01,Senate,"Assembly 3rd Reading ACR11 Flora et al",36,0,3,0,39
1417867,1104511,2021-07-08,Assembly,"Be adopted. To third reading",10,0,2,0,12
1417867,1107152,2021-08-30,Senate,"Special Consent ACR12",39,0,0,1,40
1417868,1105092,2021-07-15,Assembly,"Be adopted. To Consent Calendar",10,0,2,0,12
1417868,1106317,2021-08-19,Assembly,"ACR 13 Seyarto Consent Calendar Second Day Regular Session",73,0,0,6,79
1417868,1107875,2021-09-07,Senate,"Assembly 3rd Reading ACR13",37,0,0,3,40
1417869,992291,2021-01-28,Assembly,"Be adopted. To Consent Calendar",10,0,2,0,12
1417869,996621,2021-02-04,Assembly,"ACR 14 Stone Consent Calendar Second Day Regular Session",72,0,7,0,79
1417869,1018538,2021-03-01,Senate,"Assembly 3rd Reading ACR14",36,0,3,0,39
1417871,1026138,2021-03-10,Senate,"Do pass, but first be re-referred to the Committee on [Appropriations]",7,0,0,0,7
1417871,1033640,2021-03-22,Senate,"Placed on suspense file",7,0,0,0,7
1417871,1081735,2021-05-20,Senate,"Do pass as amended",7,0,0,0,7
1417871,1089612,2021-06-01,Senate,"Special Consent SB237",39,0,1,0,40
1417872,1059297,2021-04-20,Senate,"Do pass, but first be re-referred to the Committee on [Appropriations]",2,9,0,0,11
1417872,1059298,2021-04-20,Senate,"[First] hearing set for [04-21-2021]: Failed passage in Committee. Reconsideration granted",11,0,0,0,11
1417873,1026086,2021-03-10,Senate,"Do pass, but first be re-referred to the Committee on [Appropriations] with the recommendation: To Consent Calendar",9,0,0,0,9
1417873,1037839,2021-03-25,Senate,"Consent Calendar SB239 B. & F.I",38,0,2,0,40
1417873,1102862,2021-06-29,Assembly,"Do pass and be re-referred to the Committee on [Appropriations] with recommendation: To Consent Calendar",12,0,0,0,12
1417873,1104959,2021-07-14,Assembly,"Do pass. To Consent Calendar",13,0,3,0,16
1417873,1106443,2021-08-23,Assembly,"SB 239 B. & F.I. Senate Third Reading By GRAYSON",69,0,0,10,79
1417873,1107178,2021-08-30,Senate,"Unfinished Business SB239 B. & F.I. (Lim贸n) Concurrence",39,0,0,1,40
1417874,1037863,2021-03-25,Senate,"Do pass, but first be re-referred to the Committee on [Appropriations]",5,0,0,0,5
1417874,1056433,2021-04-19,Senate,"Placed on suspense file",7,0,0,0,7
1417874,1081716,2021-05-20,Senate,"Do pass",7,0,0,0,7
1417875,1044937,2021-04-05,Senate,"Do pass as amended, but first amend, and re-refer to the Committee on [Judiciary]",13,0,1,0,14
1417875,1059252,2021-04-20,Senate,"Do pass as amended, but first amend, and re-refer to the Committee on [Appropriations]",9,0,2,0,11
1417875,1075293,2021-05-10,Senate,"Placed on suspense file",7,0,0,0,7
1417875,1082174,2021-05-20,Senate,"Do pass as amended",7,0,0,0,7
1417875,1090477,2021-06-02,Senate,"Senate 3rd Reading SB241 Umberg",36,0,4,0,40
1417875,1100311,2021-06-22,Assembly,"Do pass as amended and be re-referred to the Committee on [Judiciary]",16,0,3,0,19
1417875,1104728,2021-07-13,Assembly,"Do pass and be re-referred to the Committee on [Appropriations]",11,0,0,0,11
1417875,1107028,2021-08-26,Assembly,"Do pass as amended",12,0,0,4,16
1417875,1108088,2021-09-08,Assembly,"SB 241 Umberg Senate Third Reading By Stone",79,0,0,1,80
1417875,1108275,2021-09-09,Senate,"Unfinished Business SB241 Umberg Concurrence",37,0,0,3,40
1417876,1026124,2021-03-10,Senate,"Do pass as amended, but first amend, and re-refer to the Committee on [Appropriations]",8,2,1,0,11
1417876,1056418,2021-04-19,Senate,"Placed on suspense file",7,0,0,0,7
1417876,1081996,2021-05-20,Senate,"Do pass",5,2,0,0,7
1417876,1089500,2021-06-01,Senate,"Senate 3rd Reading SB242 Newman et al. Urgency Clause",30,8,2,0,40
1417876,1104692,2021-07-13,Assembly,"Do pass as amended and be re-referred to the Committee on [Appropriations]",11,1,3,0,15
1417876,1106898,2021-08-26,Assembly,"Do pass as amended",12,4,0,0,16
1417876,1108132,2021-09-08,Assembly,"SB 242 Newman Senate Third Reading By Robert Rivas",58,11,0,11,80
1417876,1108452,2021-09-09,Senate,"Unfinished Business SB242 Newman et al. Concurrence",29,9,0,2,40
1417877,1029547,2021-03-16,Senate,"Do pass, but first be re-referred to the Committee on [Appropriations] with the recommendation: To Consent Calendar",5,0,0,0,5
1417877,1045008,2021-04-05,Senate,"Placed on suspense file",7,0,0,0,7
1417878,1028406,2021-03-15,Senate,"Do pass, but first be re-referred to the Committee on [Natural Resources and Water] with the recommendation: To Consent Calendar",7,0,0,0,7
1417878,1064015,2021-04-27,Senate,"Do pass, but first be re-referred to the Committee on [Appropriations] with the recommendation: To Consent Calendar",9,0,0,0,9
1417878,1075314,2021-05-10,Senate,"Placed on suspense file",7,0,0,0,7
1417878,1081867,2021-05-20,Senate,"Do pass",7,0,0,0,7
1417878,1089594,2021-06-01,Senate,"Special Consent SB244",39,0,1,0,40
1417878,1098625,2021-06-16,Assembly,"Do pass and be re-referred to the Committee on [Natural Resources] with recommendation: To Consent Calendar",9,0,0,0,9
1417878,1104367,2021-07-07,Assembly,"Do pass and be re-referred to the Committee on [Appropriations] with recommendation: To Consent Calendar",11,0,0,0,11
1417878,1106595,2021-08-26,Assembly,"Do pass as amended",12,0,0,4,16
1417878,1107619,2021-09-02,Assembly,"SB 244 Archuleta Senate Third Reading By Cristina Garcia",76,0,0,3,79
1417878,1107802,2021-09-03,Senate,"Unfinished Business SB244 Archuleta et al. Concurrence",38,0,0,2,40
1419942,1047577,2021-04-07,Senate,"Do pass as amended, but first amend, and re-refer to the Committee on [Appropriations]",8,2,1,0,11
1419942,1068274,2021-05-03,Senate,"Placed on suspense file",6,0,1,0,7
1419942,1082014,2021-05-20,Senate,"Do pass",5,2,0,0,7
1419942,1089480,2021-06-01,Senate,"Senate 3rd Reading SB245 Gonzalez et al",31,8,1,0,40
1419942,1100794,2021-06-22,Assembly,"Do pass and be re-referred to the Committee on [Appropriations]",11,3,1,0,15
1419942,1126336,2022-01-20,Assembly,"Do pass",12,3,0,1,16
1419942,1143390,2022-02-14,Assembly,"SB 245 Gonzalez Senate Third Reading By Akilah Weber Amendment Set #1",50,17,0,8,75
1419942,1172418,2022-03-17,Assembly,"SB 245 Gonzalez Senate Third Reading By Akilah Weber",52,17,0,7,76
1419942,1173478,2022-03-21,Senate,"Unfinished Business SB245 Gonzalez et al. Concurrence",28,7,0,5,40
1419943,1026108,2021-03-10,Senate,"Do pass as amended, but first amend, and re-refer to the Committee on [Human Services]",7,0,0,0,7
1419943,1046153,2021-04-06,Senate,"Do pass, but first be re-referred to the Committee on [Appropriations]",5,0,0,0,5
1419943,1068160,2021-05-03,Senate,"Placed on suspense file",6,0,1,0,7
1419943,1081721,2021-05-20,Senate,"Do pass",7,0,0,0,7
1419943,1089607,2021-06-01,Senate,"Special Consent SB246",39,0,1,0,40
1419943,1103497,2021-06-30,Assembly,"Do pass and be re-referred to the Committee on [Education] with recommendation: To Consent Calendar",8,0,0,0,8
1419943,1104444,2021-07-07,Assembly,"Do pass and be re-referred to the Committee on [Appropriations]",7,0,0,0,7
1419944,1026102,2021-03-10,Senate,"Do pass, but first be re-referred to the Committee on [Appropriations]",11,0,0,0,11
1419944,1068287,2021-05-03,Senate,"Placed on suspense file",6,0,1,0,7
1419944,1082177,2021-05-20,Senate,"Do pass as amended",7,0,0,0,7
1419944,1089630,2021-06-01,Senate,"Special Consent SB247",39,0,1,0,40
1419944,1104277,2021-07-06,Assembly,"Do pass and be re-referred to the Committee on [Appropriations] with recommendation: To Consent Calendar",15,0,0,0,15
1419944,1106920,2021-08-26,Assembly,"Do pass",16,0,0,0,16
1419944,1107697,2021-09-02,Assembly,"SB 247 Eggman Senate Third Reading By Levine",77,0,0,2,79
1419945,1029578,2021-03-16,Senate,"Do pass as amended, but first amend, and re-refer to the Committee on [Appropriations]",5,0,0,0,5
1419945,1044957,2021-04-05,Senate,"Placed on suspense file",7,0,0,0,7
1419945,1081754,2021-05-20,Senate,"Do pass",7,0,0,0,7
1419945,1089484,2021-06-01,Senate,"Special Consent SB248",39,0,1,0,40
1419945,1104722,2021-07-13,Assembly,"Do pass and be re-referred to the Committee on [Appropriations] with recommendation: To Consent Calendar",8,0,0,0,8
1419945,1106741,2021-08-26,Assembly,"Do pass",16,0,0,0,16
1419945,1107949,2021-09-07,Assembly,"SB 248 Bates Senate Third Reading By Lackey",72,0,0,8,80
1422140,1046107,2021-04-05,Assembly,"Do pass and be re-referred to the Committee on [Appropriations]",10,0,1,0,11
1422140,1059264,2021-04-21,Assembly,"Do pass. To Consent Calendar",14,0,2,0,16
1422140,1066742,2021-04-29,Assembly,"AB 296 Gipson Consent Calendar Second Day Regular Session",77,0,1,0,78
1422140,1101647,2021-06-24,Senate,"Do pass, but first be re-referred to the Committee on [Appropriations] with the recommendation: To Consent Calendar",5,0,0,0,5
1422140,1107254,2021-08-30,Senate,"Consent Calendar AB296",39,0,0,1,40
1422142,1046170,2021-04-06,Assembly,"Do pass and be re-referred to the Committee on [Appropriations] with recommendation: To Consent Calendar",18,0,1,0,19
1422142,1059194,2021-04-21,Assembly,"Do pass. To Consent Calendar",14,0,2,0,16
1422142,1066716,2021-04-29,Assembly,"AB 298 Irwin Consent Calendar Second Day Regular Session",77,0,1,0,78
1422142,1093666,2021-06-07,Senate,"Do pass, but first be re-referred to the Committee on [Judiciary] with the recommendation: To Consent Calendar",12,0,2,0,14
1422142,1098163,2021-06-15,Senate,"Do pass as amended, but first amend, and re-refer to the Committee on [Appropriations] with the recommendation: To Consent Calendar",10,0,1,0,11
1422142,1107145,2021-08-30,Senate,"Consent Calendar AB298",39,0,0,1,40
1422142,1107499,2021-09-01,Assembly,"AB 298 Irwin Concurrence in Senate Amendments",76,0,0,3,79
1422146,1036448,2021-03-24,Assembly,"Do pass. To Consent Calendar",8,0,0,0,8
1422146,1049013,2021-04-08,Assembly,"AB 302 Ward Consent Calendar Second Day Regular Session",74,0,4,0,78
1422146,1098146,2021-06-15,Senate,"Do pass as amended, and be ordered to the Consent Calendar",17,0,0,0,17
1422146,1101656,2021-06-24,Senate,"Consent Calendar AB302 Ward",39,0,1,0,40
1422146,1102503,2021-06-28,Assembly,"AB 302 Ward Concurrence in Senate Amendments",79,0,0,0,79
1422147,1049873,2021-04-08,Assembly,"Do pass and be re-referred to the Committee on [Natural Resources]",10,0,5,0,15
1422148,1047603,2021-04-07,Assembly,"Do pass and be re-referred to the Committee on [Appropriations]",9,0,0,0,9
1422148,1053519,2021-04-14,Assembly,"Do pass. To Consent Calendar",16,0,0,0,16
1422148,1060972,2021-04-22,Assembly,"AB 304 Quirk Consent Calendar Second Day Regular Session",77,0,2,0,79
1422148,1097782,2021-06-14,Senate,"Do pass, but first be re-referred to the Committee on [Appropriations]",6,1,0,0,7
1422148,1108004,2021-09-08,Senate,"Assembly 3rd Reading AB304 Quirk et al. By Gonzalez",35,3,0,2,40
1422148,1108385,2021-09-09,Assembly,"AB 304 Quirk Concurrence in Senate Amendments",78,0,0,2,80
1422149,1065196,2021-04-28,Assembly,"Do pass and be re-referred to the Committee on [Appropriations]",11,0,0,0,11
1422149,1081689,2021-05-20,Assembly,"Do pass as amended",12,0,4,0,16
1422149,1092910,2021-06-01,Assembly,"AB 305 Maienschein Assembly Third Reading",79,0,0,0,79
1422149,1100352,2021-06-22,Senate,"Do pass, but first be re-referred to the Committee on [Military and Veterans Affairs] with the recommendation: To Consent Calendar",15,0,0,0,15
1422149,1103381,2021-06-30,Senate,"Do pass, but first be re-referred to the Committee on [Appropriations] with the recommendation: To Consent Calendar",6,0,1,0,7
1422149,1105147,2021-07-15,Senate,"Placed on suspense file",7,0,0,0,7
1422149,1106826,2021-08-26,Senate,"Do pass as amended",7,0,0,0,7
1422149,1225507,2022-08-31,Senate,"Special Consent AB305",40,0,0,0,40
1422149,1225508,2022-08-31,Assembly,"AB 305 Maienschein Concurrence in Senate Amendments",80,0,0,0,80
1422150,1036457,2021-03-24,Assembly,"Do pass as amended, and be re-referred to the Committee on [Appropriations] with recommendation: To Consent Calendar",7,0,0,0,7
1422150,1059266,2021-04-21,Assembly,"Do pass. To Consent Calendar",14,0,2,0,16
1422150,1066756,2021-04-29,Assembly,"AB 306 O'Donnell Consent Calendar Second Day Regular Session",77,0,1,0,78
1422150,1096111,2021-06-09,Senate,"Do pass, but first be re-referred to the Committee on [Appropriations] with the recommendation: To Consent Calendar",7,0,0,0,7
1422150,1101679,2021-06-24,Senate,"Consent Calendar AB306",39,0,1,0,40
1422152,1036446,2021-03-23,Assembly,"Do pass as amended and be re-referred to the Committee on [Appropriations]",7,0,1,0,8
1422153,1065286,2021-04-28,Assembly,"Do pass and be re-referred to the Committee on [Appropriations]",7,0,0,0,7
1422153,1076928,2021-05-12,Assembly,"Do pass. To Consent Calendar",16,0,0,0,16
1422153,1081757,2021-05-20,Assembly,"AB 309 Gabriel Consent Calendar Second Day Regular Session",76,0,2,0,78
1422153,1098645,2021-06-16,Senate,"Do pass as amended, but first amend, and re-refer to the Committee on [Appropriations] with the recommendation: To Consent Calendar",7,0,0,0,7
1422153,1108065,2021-09-08,Senate,"Assembly 3rd Reading AB309 Gabriel et al. By Ochoa Bogh",38,0,0,2,40
1422153,1108246,2021-09-09,Assembly,"AB 309 Gabriel Concurrence in Senate Amendments",79,0,0,1,80
1422155,1047562,2021-04-06,Assembly,"Do pass and be re-referred to the Committee on [Appropriations]",5,2,1,0,8
1422155,1126346,2022-01-20,Assembly,"Do pass as amended",12,3,0,1,16
1422155,1131268,2022-01-31,Assembly,"AB 311 Ward Assembly Third Reading",51,22,0,3,76
1422155,1210938,2022-05-31,Senate,"Do pass, but first be re-referred to the Committee on [Appropriations]",4,1,0,0,5
1422155,1219343,2022-06-27,Senate,"Assembly 3rd Reading AB311 Ward et al. By Hueso",30,5,0,5,40
1422155,1221531,2022-06-29,Assembly,"AB 311 Ward Concurrence in Senate Amendments",56,18,0,6,80
1422156,1036427,2021-03-24,Assembly,"Do pass and be re-referred to the Committee on [Appropriations]",6,0,1,0,7
1422156,1081937,2021-05-20,Assembly,"Do pass",16,0,0,0,16
1422156,1086935,2021-05-27,Assembly,"AB 312 Seyarto Assembly Third Reading",76,0,2,0,78
1422156,1221258,2022-06-30,Senate,"Do pass, but first be re-referred to the Committee on [Appropriations]",6,0,0,1,7
1422156,1222757,2022-08-01,Senate,"Placed on suspense file",7,0,0,0,7
1422157,1054640,2021-04-15,Assembly,"Do pass and be re-referred to the Committee on [Appropriations] with recommendation: To Consent Calendar",7,0,0,0,7
1422157,1081951,2021-05-20,Assembly,"Do pass",16,0,0,0,16
1422157,1086964,2021-05-27,Assembly,"AB 313 Cristina Garcia Assembly Third Reading",78,0,0,0,78
1422157,1104673,2021-07-12,Senate,"Do pass, but first be re-referred to the Committee on [Appropriations] with the recommendation: To Consent Calendar",5,0,0,0,5
1422157,1106236,2021-08-16,Senate,"Placed on suspense file",7,0,0,0,7
1422157,1106603,2021-08-26,Senate,"Do pass as amended",7,0,0,0,7
1422157,1108201,2021-09-08,Senate,"Assembly 3rd Reading AB313 Cristina Garcia By Glazer",38,0,0,2,40
1422157,1108389,2021-09-09,Assembly,"AB 313 Cristina Garcia Concurrence in Senate Amendments",79,0,0,1,80
1422159,1049891,2021-04-08,Assembly,"Do pass and be re-referred to the Committee on [Judiciary] with recommendation: To Consent Calendar",15,0,0,0,15
1422159,1057645,2021-04-20,Assembly,"Do pass as amended, and be re-referred to the Committee on [Appropriations] with recommendation: To Consent Calendar",10,0,1,0,11
1422159,1081766,2021-05-20,Assembly,"Do pass",16,0,0,0,16
1422159,1086982,2021-05-27,Assembly,"AB 315 Stone Assembly Third Reading",78,0,0,0,78
1422159,1102866,2021-06-29,Senate,"Do pass, but first be re-referred to the Committee on [Judiciary] with the recommendation: To Consent Calendar",9,0,0,0,9
1422159,1104390,2021-07-06,Senate,"Do pass, but first be re-referred to the Committee on [Appropriations] with the recommendation: To Consent Calendar",11,0,0,0,11
1422159,1106194,2021-08-16,Senate,"Placed on suspense file",7,0,0,0,7
1422159,1107023,2021-08-26,Senate,"Do pass as amended",7,0,0,0,7
1422159,1108138,2021-09-08,Senate,"Assembly 3rd Reading AB315 Stone By Laird",38,0,0,2,40
1422159,1108325,2021-09-09,Assembly,"AB 315 Stone Concurrence in Senate Amendments",79,0,0,1,80
1422160,1054591,2021-04-15,Assembly,"Do pass and be re-referred to the Committee on [Appropriations]",7,0,0,0,7
1422160,1081677,2021-05-20,Assembly,"Do pass",16,0,0,0,16
1422160,1092837,2021-06-01,Assembly,"AB 316 Cooper Assembly Third Reading",77,0,2,0,79
1422160,1100235,2021-06-21,Senate,"Do pass, but first be re-referred to the Committee on [Appropriations] with the recommendation: To Consent Calendar",5,0,0,0,5
1422160,1106464,2021-08-23,Senate,"Placed on suspense file",7,0,0,0,7
1422160,1106567,2021-08-26,Senate,"Do pass",7,0,0,0,7
1422160,1224360,2022-08-22,Senate,"Assembly 3rd Reading AB316 Cooper By Rubio",32,0,0,8,40
1422160,1224408,2022-08-23,Assembly,"AB 316 Cooper Concurrence in Senate Amendments",71,0,0,9,80
1422161,1005316,2021-02-12,Assembly,"Be adopted. To Consent Calendar",11,0,1,0,12
1422161,1009528,2021-02-18,Assembly,"ACR 15 Luz Rivas Consent Calendar Second Day",68,0,11,0,79
1422161,1037803,2021-03-25,Senate,"Special Consent ACR15",38,0,2,0,40
1422162,1009545,2021-02-18,Assembly,"Be adopted. To third reading",10,0,2,0,12
1422162,1037855,2021-03-25,Senate,"Special Consent ACR16",38,0,2,0,40
1422163,992292,2021-01-28,Assembly,"Be adopted. To third reading",9,0,3,0,12
1422165,992313,2021-01-28,Assembly,"Be adopted. To third reading",10,0,2,0,12
1422166,1059164,2021-04-20,Senate,"Do pass, but first be re-referred to the Committee on [Education]",2,9,0,0,11
1422166,1059165,2021-04-20,Senate,"[First] hearing set for [04-21-2021]: Failed passage in Committee. Reconsideration granted",11,0,0,0,11
1422167,1030777,2021-03-17,Senate,"Do pass, but first be re-referred to the Committee on [Appropriations]",9,1,1,0,11
1422167,1056382,2021-04-19,Senate,"Placed on suspense file",7,0,0,0,7
1422167,1081665,2021-05-20,Senate,"Do pass",5,1,1,0,7
1422167,1089598,2021-06-01,Senate,"Senate 3rd Reading SB250 Pan et al",31,8,1,0,40
1422167,1219937,2022-06-28,Assembly,"Do pass as amended and be re-referred to the Committee on [Appropriations]",12,2,0,1,15
1422169,1047583,2021-04-06,Senate,"Do pass as amended, but first amend, and re-refer to the Committee on [Appropriations]",7,1,3,0,11
1422169,1056386,2021-04-19,Senate,"Placed on suspense file",7,0,0,0,7
1422169,1081787,2021-05-20,Senate,"Do pass as amended",5,2,0,0,7
1422169,1090470,2021-06-02,Senate,"Senate 3rd Reading SB252 Wiener et al",30,1,9,0,40
1422169,1104255,2021-07-06,Assembly,"Do pass and be re-referred to the Committee on [Appropriations]",10,0,1,0,11
1422171,1030790,2021-03-17,Senate,"Do pass and be ordered to the Consent Calendar",7,0,0,0,7
1422171,1037812,2021-03-25,Senate,"Consent Calendar SB254 Borgeas",38,0,2,0,40
1422171,1100766,2021-06-23,Assembly,"Do pass. To Consent Calendar",7,0,0,0,7
1422171,1103769,2021-07-01,Assembly,"SB 254 Borgeas Consent Calendar Second Day Regular Session",77,0,2,0,79
1422172,1051992,2021-04-13,Senate,"Be adopted, but first be re-referred to the Committee on [Appropriations] with recommendation: To Consent Calendar",15,0,2,0,17
1422172,1075250,2021-05-10,Senate,"Consent Calendar SCR7",37,0,3,0,40
1422172,1104278,2021-07-05,Assembly,"Be adopted. To Consent Calendar",15,0,0,0,15
1422172,1104537,2021-07-08,Assembly,"SCR 7 Roth Consent Calendar Second Day Regular Session",76,0,3,0,79
1422173,1005296,2021-02-12,Senate,"Senate 3rd Reading SR5 Melendez",32,0,7,0,39
1424570,1047465,2021-04-07,Assembly,"Do pass and be re-referred to the Committee on [Appropriations] with recommendation: To Consent Calendar",8,0,0,0,8
1424570,1059171,2021-04-21,Assembly,"Do pass. To Consent Calendar",14,0,2,0,16
1424570,1066802,2021-04-29,Assembly,"AB 317 Patterson Consent Calendar Second Day Regular Session",77,0,1,0,78
1424570,1104295,2021-07-06,Senate,"Do pass, but first be re-referred to the Committee on [Rules] with the recommendation: To Consent Calendar",5,0,0,0,5
1424570,1104939,2021-07-13,Senate,"Do pass, but first be re-referred to the Committee on [Appropriations] with the recommendation: To Consent Calendar",11,0,0,0,11
1424570,1106383,2021-08-23,Senate,"Placed on suspense file",7,0,0,0,7
1424570,1106927,2021-08-26,Senate,"Do pass",7,0,0,0,7
1424570,1108257,2021-09-09,Senate,"Assembly 3rd Reading AB317 Patterson et al. By Hurtado",38,0,0,2,40
1424570,1108258,2021-09-09,Assembly,"AB 317 PATTERSON Concurrence in Senate Amendments",78,0,0,2,80
1424571,1059312,2021-04-21,Assembly,"Do pass and be re-referred to the Committee on [Appropriations]",9,0,0,0,9
1424571,1082207,2021-05-20,Assembly,"Do pass as amended",12,0,4,0,16
1424572,1054686,2021-04-15,Assembly,"Do pass and be re-referred to the Committee on [Appropriations] with recommendation: To Consent Calendar",7,0,0,0,7
1424572,1065174,2021-04-28,Assembly,"Do pass. To Consent Calendar",16,0,0,0,16
1424572,1074160,2021-05-06,Assembly,"AB 319 Valladares Consent Calendar Second Day Regular Session",77,0,1,0,78
1424572,1102464,2021-06-28,Senate,"Do pass, but first be re-referred to the Committee on [Appropriations] with the recommendation: To Consent Calendar",5,0,0,0,5
1424572,1107128,2021-08-30,Senate,"Consent Calendar AB319",39,0,0,1,40
1424573,1036492,2021-03-24,Assembly,"Do pass and be re-referred to the Committee on [Higher Education] with recommendation: To Consent Calendar",7,0,0,0,7
1424573,1060848,2021-04-22,Assembly,"Do pass as amended and be re-referred to the Committee on [Appropriations]",12,0,0,0,12
1424573,1076951,2021-05-12,Assembly,"Do pass. To Consent Calendar",16,0,0,0,16
1424573,1082087,2021-05-20,Assembly,"AB 320 Medina Consent Calendar Second Day Regular Session",76,0,2,0,78
1424573,1098630,2021-06-16,Senate,"Do pass, but first be re-referred to the Committee on [Appropriations] with the recommendation: To Consent Calendar",7,0,0,0,7
1424573,1107993,2021-09-08,Senate,"Assembly 3rd Reading AB320 Medina By Rubio",38,0,0,2,40
1424573,1108461,2021-09-09,Assembly,"AB 320 Medina Concurrence in Senate Amendments",78,0,0,2,80
1424574,1123324,2022-01-11,Assembly,"Do pass and be re-referred to the Committee on [Education]",7,0,0,1,8
1424574,1123753,2022-01-12,Assembly,"Do pass and be re-referred to the Committee on [Appropriations] with recommendation: To Consent Calendar",6,0,0,1,7
1424574,1126357,2022-01-20,Assembly,"Do pass",15,0,0,1,16
1424574,1129880,2022-01-27,Assembly,"AB 321 Valladares Assembly Third Reading",68,0,0,8,76
1424574,1211832,2022-06-01,Senate,"Do pass, but first be re-referred to the Committee on [Human Services] with the recommendation: To Consent Calendar",6,0,0,1,7
1424574,1217430,2022-06-20,Senate,"Do pass, but first be re-referred to the Committee on [Appropriations]",5,0,0,0,5
1424574,1222722,2022-08-01,Senate,"Placed on suspense file",7,0,0,0,7
1424574,1223970,2022-08-11,Senate,"Do pass as amended",7,0,0,0,7
1424574,1225603,2022-08-31,Senate,"Special Consent AB321",40,0,0,0,40
1424574,1225604,2022-08-31,Assembly,"AB 321 Valladares Concurrence in Senate Amendments",80,0,0,0,80
1424575,1047430,2021-04-07,Assembly,"Do pass as amended and be re-referred to the Committee on [Natural Resources]",13,0,2,0,15
1424575,1065110,2021-04-28,Assembly,"Do pass and be re-referred to the Committee on [Appropriations]",10,0,1,0,11
1424575,1076925,2021-05-12,Assembly,"Do pass. To Consent Calendar",16,0,0,0,16
1424575,1081409,2021-05-20,Assembly,"AB 322 Salas Consent Calendar Second Day Regular Session",76,0,2,0,78
1424575,1104160,2021-07-05,Senate,"Do pass, but first be re-referred to the Committee on [Appropriations]",12,1,1,0,14
1424575,1107248,2021-08-30,Senate,"Assembly 3rd Reading AB322 Salas et al. By Eggman",37,0,0,3,40
1424575,1107400,2021-09-01,Assembly,"AB 322 Salas Concurrence in Senate Amendments",77,0,0,2,79
1424576,1064106,2021-04-27,Assembly,"Do pass and be re-referred to the Committee on [Appropriations]",11,1,3,0,15
1424576,1073366,2021-05-05,Assembly,"Do pass",13,3,0,0,16
1424576,1078726,2021-05-17,Assembly,"AB 323 Kalra Assembly Third Reading",54,12,12,0,78
1424576,1103374,2021-06-30,Senate,"Do pass, but first be re-referred to the Committee on [Judiciary]",10,0,1,0,11
1424576,1104905,2021-07-13,Senate,"Do pass as amended, but first amend, and re-refer to the Committee on [Appropriations]",9,1,1,0,11
1424576,1107620,2021-09-02,Senate,"Assembly 3rd Reading AB323 Kalra et al. By Wiener",30,7,0,3,40
1424576,1107911,2021-09-07,Assembly,"AB 323 Kalra Concurrence in Senate Amendments",48,13,0,19,80
1424577,1123291,2022-01-10,Assembly,"Do pass and be re-referred to the Committee on [Appropriations]",8,1,0,2,11
1424578,1065296,2021-04-28,Assembly,"Do pass and be re-referred to the Committee on [Appropriations] with recommendation: To Consent Calendar",11,0,0,0,11
1424578,1081452,2021-05-20,Assembly,"Do pass",16,0,0,0,16
1424578,1086941,2021-05-27,Assembly,"AB 325 Irwin Assembly Third Reading",78,0,0,0,78
1424578,1215830,2022-06-14,Senate,"Do pass, but first be re-referred to the Committee on [Appropriations]",5,0,0,2,7
1424578,1219362,2022-06-27,Senate,"Placed on suspense file",6,0,0,1,7
1424578,1223979,2022-08-11,Senate,"Do pass",7,0,0,0,7
1424578,1224477,2022-08-23,Senate,"Special Consent AB325 Irwin By Eggman",40,0,0,0,40
1424579,1035158,2021-03-23,Assembly,"Do pass and be re-referred to the Committee on [Appropriations]",13,1,1,0,15
1424579,1053479,2021-04-14,Assembly,"Do pass",12,4,0,0,16
1424579,1075266,2021-05-10,Assembly,"AB 326 Luz Rivas Assembly Third Reading",56,13,9,0,78
1424579,1098634,2021-06-16,Senate,"Do pass, but first be re-referred to the Committee on [Appropriations]",8,2,1,0,11
1424579,1104150,2021-07-05,Senate,"Placed on suspense file",6,0,1,0,7
1424579,1106798,2021-08-26,Senate,"Do pass",5,2,0,0,7
1424579,1108091,2021-09-08,Senate,"Assembly 3rd Reading AB326 Luz Rivas By Becker",29,9,0,2,40
1424579,1108468,2021-09-09,Assembly,"AB 326 Luz Rivas Concurrence in Senate Amendments",61,15,0,4,80
1424581,1029580,2021-03-15,Assembly,"Do pass as amended and be re-referred to the Committee on [Appropriations]",6,2,0,0,8
1424582,1059228,2021-04-21,Senate,"Do pass as amended, but first amend, and re-refer to the Committee on [Appropriations]",11,0,0,0,11
1424582,1078825,2021-05-17,Senate,"Placed on suspense file",7,0,0,0,7
1424582,1081933,2021-05-20,Senate,"Do pass as amended",7,0,0,0,7
1424582,1089560,2021-06-01,Senate,"Special Consent SB255",39,0,1,0,40
1424582,1100815,2021-06-22,Assembly,"Do pass and be re-referred to the Committee on [Appropriations]",14,0,1,0,15
1424582,1106822,2021-08-26,Assembly,"Do pass",16,0,0,0,16
1424582,1107992,2021-09-08,Assembly,"SB 255 Portantino Senate Third Reading By Burke",78,1,0,1,80
1424582,1108335,2021-09-09,Senate,"Unfinished Business SB255 Portantino et al. Concurrence",38,0,0,2,40
1424583,1065225,2021-04-28,Senate,"Do pass, but first be re-referred to the Committee on [Appropriations]",11,0,0,0,11
1424583,1078807,2021-05-17,Senate,"Placed on suspense file",7,0,0,0,7
1424583,1081853,2021-05-20,Senate,"Do pass",7,0,0,0,7
1424583,1089576,2021-06-01,Senate,"Special Consent SB256",39,0,1,0,40
1424584,1074138,2021-05-06,Senate,"Do pass, but first be re-referred to the Committee on [Appropriations]",5,0,0,0,5
1424584,1078781,2021-05-17,Senate,"Placed on suspense file",7,0,0,0,7
1424585,1025108,2021-03-09,Senate,"Do pass, but first be re-referred to the Committee on [Appropriations]",3,0,1,0,4
1424585,1074119,2021-05-06,Senate,"Senate 3rd Reading SB258 Laird et al",36,0,4,0,40
1424585,1102872,2021-06-29,Assembly,"Do pass and be re-referred to the Committee on [Appropriations]",7,0,0,0,7
1424585,1104470,2021-07-07,Assembly,"Do pass. To Consent Calendar",14,0,2,0,16
1424585,1105097,2021-07-15,Assembly,"SB 258 Laird Consent Calendar Second Day Regular Session",70,0,9,0,79
1424587,1050840,2021-04-12,Senate,"Do pass as amended, but first amend, and re-refer to the Committee on [Judiciary]",4,2,1,0,7
1424587,1065206,2021-04-27,Senate,"Do pass, but first be re-referred to the Committee on [Appropriations]",8,2,1,0,11
1424587,1078737,2021-05-17,Senate,"Placed on suspense file",7,0,0,0,7
1424587,1126326,2022-01-20,Senate,"Do pass",5,2,0,0,7
1424587,1129003,2022-01-26,Senate,"Senate 3rd Reading SB260 Wiener et al",23,7,0,10,40
1424587,1215532,2022-06-13,Assembly,"Do pass and be re-referred to the Committee on [Judiciary]",7,2,0,2,11
1424587,1217434,2022-06-21,Assembly,"Do pass as amended and be re-referred to the Committee on [Appropriations]",6,3,0,1,10
1424587,1223654,2022-08-11,Assembly,"Do pass as amended",12,4,0,0,16
1424587,1225705,2022-08-31,Assembly,"SB 260 Wiener Senate Third Reading By Cristina Garcia",37,25,0,18,80
1426671,1036507,2021-03-23,Assembly,"Do pass and be re-referred to the Committee on [Appropriations]",5,2,1,0,8
1426673,1036436,2021-03-23,Assembly,"Do pass and be re-referred to the Committee on [Appropriations] with recommendation: To Consent Calendar",8,0,0,0,8
1426673,1081680,2021-05-20,Assembly,"Do pass",16,0,0,0,16
1426673,1087015,2021-05-27,Assembly,"AB 331 Jones-Sawyer Third Reading Urgency",78,0,0,0,78
1426673,1100237,2021-06-22,Senate,"Do pass, but first be re-referred to the Committee on [Appropriations]",5,0,0,0,5
1426673,1104605,2021-07-12,Senate,"Do pass",6,0,1,0,7
1426673,1105065,2021-07-15,Senate,"Assembly 3rd Reading AB331 Jones-Sawyer By Roth Urgency Clause",39,0,1,0,40
1426673,1105066,2021-07-15,Assembly,"AB 331 JONES-SAWYER Concurrence in Senate Amendments",68,0,11,0,79
1426674,1047548,2021-04-07,Assembly,"Do pass and be re-referred to the Committee on [Appropriations] with recommendation: To Consent Calendar",9,0,0,0,9
1426674,1053507,2021-04-14,Assembly,"Do pass. To Consent Calendar",16,0,0,0,16
1426674,1083857,2021-05-24,Assembly,"AB 332 E.S. & T.M. Third Reading Urgency By QUIRK",76,0,2,0,78
1426674,1097790,2021-06-14,Senate,"Do pass, but first be re-referred to the Committee on [Judiciary] with the recommendation: To Consent Calendar",7,0,0,0,7
1426674,1100789,2021-06-22,Senate,"Do pass, but first be re-referred to the Committee on [Appropriations] with the recommendation: To Consent Calendar",11,0,0,0,11
1426674,1106417,2021-08-23,Senate,"Consent Calendar AB332 E.S. & T.M. (Quirk) By Allen Urgency Clause",37,0,0,3,40
1426674,1107238,2021-08-30,Assembly,"AB 332 E.S. & T.M. Concurrence in Senate Amendments By QUIRK",76,0,0,3,79
1426675,1047536,2021-04-06,Assembly,"Do pass",6,2,0,0,8
1426675,1078814,2021-05-17,Assembly,"AB 333 Kamlager Assembly Third Reading By GRAY",38,27,13,0,78
1426675,1091715,2021-06-03,Assembly,"AB 333 Kamlager Assembly Third Reading",43,27,9,0,79
1426675,1104329,2021-07-06,Senate,"Do pass as amended, but first amend, and re-refer to the Committee on [Appropriations]",4,1,0,0,5
1426675,1106119,2021-08-16,Senate,"Placed on suspense file",7,0,0,0,7
1426675,1106698,2021-08-26,Senate,"Do pass",5,2,0,0,7
1426675,1107383,2021-09-01,Senate,"Assembly 3rd Reading AB333 Kamlager",25,10,0,5,40
1426675,1108005,2021-09-08,Assembly,"AB 333 Kamlager Concurrence in Senate Amendments By WEBER, A",41,30,0,9,80
1426676,1066704,2021-04-29,Assembly,"Do pass and be re-referred to the Committee on [Appropriations]",13,0,0,0,13
1426676,1076980,2021-05-12,Assembly,"Do pass. To Consent Calendar",16,0,0,0,16
1426676,1082232,2021-05-20,Assembly,"AB 334 Mullin Consent Calendar Second Day Regular Session",76,0,2,0,78
1426676,1100254,2021-06-21,Senate,"Do pass, but first be re-referred to the Committee on [Appropriations]",5,0,0,0,5
1426676,1224520,2022-08-23,Senate,"Assembly 3rd Reading AB334 Mullin et al. By Cortese",38,0,0,2,40
1426677,1048878,2021-04-08,Assembly,"Do pass and be re-referred to the Committee on [Appropriations] with recommendation: To Consent Calendar",11,0,0,0,11
1426677,1059170,2021-04-21,Assembly,"Do pass. To Consent Calendar",14,0,2,0,16
1426677,1068181,2021-05-03,Assembly,"AB 335 Boerner Horvath Assembly Third Reading",74,1,3,0,78
1426677,1095039,2021-06-08,Senate,"Do pass, but first be re-referred to the Committee on [Appropriations]",11,0,0,0,11
1426677,1108195,2021-09-08,Senate,"Assembly 3rd Reading AB335 Boerner Horvath et a By Hertzberg",38,0,0,2,40
1426677,1108368,2021-09-09,Assembly,"AB 335 Boerner Horvath Concurrence in Senate Amendments",77,0,0,3,80
1426678,1036494,2021-03-24,Assembly,"Do pass. To Consent Calendar",8,0,0,0,8
1426678,1049030,2021-04-08,Assembly,"AB 336 Villapudua Consent Calendar Second Day Regular Session",74,0,4,0,78
1426678,1097060,2021-06-10,Senate,"Do pass and be ordered to the Consent Calendar",5,0,0,0,5
1426678,1099146,2021-06-17,Senate,"Consent Calendar AB336",37,0,3,0,40
1426679,992312,2021-01-28,Assembly,"Be adopted. To third reading",10,0,2,0,12
1426680,1028424,2021-03-15,Senate,"Do pass, but first be re-referred to the Committee on [Transportation]",5,2,0,0,7
1426681,1035144,2021-03-23,Senate,"Do pass, but first be re-referred to the Committee on [Appropriations]",4,1,0,0,5
1426681,1044941,2021-04-05,Senate,"Placed on suspense file",7,0,0,0,7
1426681,1081960,2021-05-20,Senate,"Do pass as amended",5,2,0,0,7
1426681,1086124,2021-05-26,Senate,"Senate 3rd Reading SB262 Hertzberg et al",30,9,1,0,40
1426681,1104682,2021-07-13,Assembly,"Do pass and be re-referred to the Committee on [Appropriations]",5,2,1,0,8
1426681,1106803,2021-08-26,Assembly,"Do pass as amended",11,4,0,1,16
1426681,1225305,2022-08-31,Assembly,"SB 262 Hertzberg Senate Third Reading By Bauer-Kahan",32,29,0,19,80
1426682,1023857,2021-03-08,Senate,"Do pass, but first be re-referred to the Committee on [Appropriations]",12,1,1,0,14
1426682,1062755,2021-04-26,Senate,"Senate 3rd Reading SB263 Rubio et al",38,0,2,0,40
1426682,1104344,2021-07-06,Assembly,"Do pass and be re-referred to the Committee on [Appropriations] with recommendation: To Consent Calendar",19,0,0,0,19
1426682,1106996,2021-08-26,Assembly,"Do pass as amended",13,0,0,3,16
1426682,1108188,2021-09-08,Assembly,"SB 263 Rubio Senate Third Reading By Cristina Garcia",78,0,0,2,80
1426682,1108249,2021-09-09,Senate,"Unfinished Business SB263 Rubio et al. Concurrence",35,3,0,2,40
1426683,1029591,2021-03-16,Senate,"Do pass, but first be re-referred to the Committee on [Rules]",4,1,0,0,5
1426683,1068186,2021-05-03,Senate,"Placed on suspense file",6,0,1,0,7
1426683,1081441,2021-05-20,Senate,"Do pass",5,2,0,0,7
1426683,1089587,2021-06-01,Senate,"Senate 3rd Reading SB264 Min et al",29,9,2,0,40
1426683,1104740,2021-07-13,Assembly,"Do pass and be re-referred to the Committee on [Appropriations]",5,2,1,0,8
1426683,1106960,2021-08-26,Assembly,"Do pass as amended",12,4,0,0,16
1426683,1107604,2021-09-02,Assembly,"SB 264 Min Senate Third Reading By Ting",51,21,0,7,79
1426683,1107767,2021-09-03,Senate,"Unfinished Business SB264 Min et al. Concurrence",28,8,0,4,40
1426685,1005300,2021-02-12,Senate,"Senate 3rd Reading SCR8 Pan",32,0,7,0,39
1426685,1016268,2021-02-25,Assembly,"Be adopted. To Consent Calendar",11,0,1,0,12
1426685,1022337,2021-03-04,Assembly,"SCR 8 Pan Consent Calendar Second Day Regular Session",72,0,7,0,79
1429090,1036430,2021-03-24,Assembly,"Do pass",12,0,0,0,12
1429090,1053447,2021-04-12,Assembly,"AB 337 Medina Assembly Third Reading",73,0,5,0,78
1429090,1096077,2021-06-09,Senate,"Do pass and be ordered to the Consent Calendar",7,0,0,0,7
1429090,1099127,2021-06-17,Senate,"Consent Calendar AB337",37,0,3,0,40
1429091,1066723,2021-04-29,Assembly,"Do pass and be re-referred to the Committee on [Appropriations]",9,0,3,0,12
1429091,1076949,2021-05-12,Assembly,"Do pass",12,0,4,0,16
1429091,1087033,2021-05-27,Assembly,"AB 338 Ramos Assembly Third Reading",66,2,10,0,78
1429091,1100309,2021-06-22,Senate,"Do pass, but first be re-referred to the Committee on [Appropriations]",12,0,3,0,15
1429091,1106437,2021-08-23,Senate,"Assembly 3rd Reading AB338 Ramos et al. By Laird",28,2,0,10,40
1429092,1065254,2021-04-28,Assembly,"Do pass as amended and be re-referred to the Committee on [Appropriations]",7,0,1,0,8
1429092,1080434,2021-05-19,Assembly,"Do pass",11,2,3,0,16
1429092,1090371,2021-06-02,Assembly,"AB 339 Lee Assembly Third Reading",54,9,16,0,79
1429092,1103805,2021-07-01,Senate,"Do pass as amended, but first amend, and re-refer to the Committee on [Judiciary]",5,0,0,0,5
1429092,1104963,2021-07-13,Senate,"Do pass, but first be re-referred to the Committee on [Appropriations]",9,0,2,0,11
1429092,1108259,2021-09-09,Senate,"Assembly 3rd Reading AB339 Lee et al. By Gonzalez",25,8,0,7,40
1429092,1108260,2021-09-09,Assembly,"AB 339 LEE Concurrence in Senate Amendments",58,7,0,15,80
1429093,1036478,2021-03-24,Assembly,"Do pass and be re-referred to the Committee on [Appropriations]",12,0,0,0,12
1429093,1081874,2021-05-20,Assembly,"Do pass",16,0,0,0,16
1429093,1087072,2021-05-27,Assembly,"AB 340 Ward Assembly Third Reading",78,0,0,0,78
1429093,1100786,2021-06-23,Senate,"Do pass, but first be re-referred to the Committee on [Governance and Finance] with the recommendation: To Consent Calendar",7,0,0,0,7
1429093,1103840,2021-07-01,Senate,"Do pass, but first be re-referred to the Committee on [Appropriations] with the recommendation: To Consent Calendar",5,0,0,0,5
1429093,1105087,2021-07-15,Senate,"Placed on suspense file",7,0,0,0,7
1429093,1106836,2021-08-26,Senate,"Do pass",7,0,0,0,7
1429093,1107762,2021-09-03,Senate,"Special Consent AB340",37,0,0,3,40
1429093,1107912,2021-09-07,Assembly,"AB 340 Ward Concurrence in Senate Amendments",73,0,0,7,80
1429094,1036515,2021-03-23,Assembly,"Do pass as amended. To Consent Calendar",8,0,0,0,8
1429094,1048918,2021-04-08,Assembly,"AB 341 Boerner Horvath Consent Calendar Second Day Regular Session",74,0,4,0,78
1429094,1095082,2021-06-08,Senate,"Do pass and be ordered to the Consent Calendar",4,0,1,0,5
1429094,1099137,2021-06-17,Senate,"Consent Calendar AB341",37,0,3,0,40
1429095,1035183,2021-03-23,Assembly,"Do pass as amended and be re-referred to the Committee on [Appropriations]",14,0,1,0,15
1429095,1082071,2021-05-20,Assembly,"Do pass",14,0,2,0,16
1429095,1086972,2021-05-27,Assembly,"AB 342 Gipson Assembly Third Reading",70,0,8,0,78
1429095,1103507,2021-06-30,Senate,"Do pass as amended, but first amend, and re-refer to the Committee on [Appropriations]",10,0,1,0,11
1429095,1106828,2021-08-26,Senate,"Assembly 3rd Reading AB342 Gipson et al. By Pan",32,0,0,8,40
1429095,1107739,2021-09-02,Assembly,"AB 342 Gipson Concurrence in Senate Amendments",69,0,0,10,79
1429096,1053542,2021-04-14,Assembly,"Do pass and be re-referred to the Committee on [Judiciary] with recommendation: To Consent Calendar",7,0,0,0,7
1429096,1057634,2021-04-20,Assembly,"Do pass as amended, and be re-referred to the Committee on [Appropriations] with recommendation: To Consent Calendar",10,0,1,0,11
1429096,1081518,2021-05-20,Assembly,"Do pass as amended",16,0,0,0,16
1429096,1092856,2021-06-01,Assembly,"AB 343 Fong Assembly Third Reading",79,0,0,0,79
1429096,1217987,2022-06-21,Senate,"Do pass, but first be re-referred to the Committee on [Governmental Organization] with the recommendation: To Consent Calendar",11,0,0,0,11
1429098,1029588,2021-03-15,Assembly,"Do pass and be re-referred to the Committee on [Local Government] with recommendation: To Consent Calendar",8,0,0,0,8
1429098,1036462,2021-03-24,Assembly,"Do pass and be re-referred to the Committee on [Appropriations]",7,1,0,0,8
1429098,1082023,2021-05-20,Assembly,"Do pass",16,0,0,0,16
1429098,1086927,2021-05-27,Assembly,"AB 345 Quirk-Silva Assembly Third Reading",76,1,1,0,78
1429098,1103833,2021-07-01,Senate,"Do pass, but first be re-referred to the Committee on [Governance and Finance] with the recommendation: To Consent Calendar",9,0,0,0,9
1429098,1104575,2021-07-08,Senate,"Do pass, but first be re-referred to the Committee on [Appropriations] with the recommendation: To Consent Calendar",5,0,0,0,5
1429098,1107139,2021-08-30,Senate,"Consent Calendar AB345",39,0,0,1,40
1429098,1107658,2021-09-02,Assembly,"AB 345 Quirk-Silva Concurrence in Senate Amendments",75,1,0,3,79
1429100,1046181,2021-04-06,Assembly,"Do pass as amended and be re-referred to the Committee on [Appropriations]",13,1,1,0,15
1429100,1082185,2021-05-20,Assembly,"Do pass as amended",13,3,0,0,16
1429100,1090429,2021-06-02,Assembly,"AB 347 Arambula Assembly Third Reading",69,1,9,0,79
1429100,1104388,2021-07-07,Senate,"Do pass as amended, but first amend, and re-refer to the Committee on [Appropriations]",8,0,3,0,11
1429100,1106169,2021-08-16,Senate,"Placed on suspense file",7,0,0,0,7
1429100,1106594,2021-08-26,Senate,"Do pass as amended",5,1,0,1,7
1429100,1108190,2021-09-08,Senate,"Assembly 3rd Reading AB347 Arambula et al. By Wiener",37,0,0,3,40
1429100,1108391,2021-09-09,Assembly,"AB 347 Arambula Concurrence in Senate Amendments",72,0,0,8,80
1429102,1064058,2021-04-26,Assembly,"Do pass and be re-referred to the Committee on [Appropriations] with recommendation: To Consent Calendar",15,0,0,0,15
1429102,1081536,2021-05-20,Assembly,"Do pass",16,0,0,0,16
1429102,1092954,2021-06-01,Assembly,"AB 349 Holden Assembly Third Reading",79,0,0,0,79
1429102,1100310,2021-06-22,Senate,"Do pass, but first be re-referred to the Committee on [Transportation] with the recommendation: To Consent Calendar",15,0,0,0,15
1429102,1104727,2021-07-13,Senate,"Do pass, but first be re-referred to the Committee on [Appropriations] with the recommendation: To Consent Calendar",16,0,1,0,17
1429102,1106414,2021-08-23,Senate,"Placed on suspense file",7,0,0,0,7
1429103,1054644,2021-04-15,Assembly,"Do pass and be re-referred to the Committee on [Water, Parks, and Wildlife]",11,0,0,0,11
1429103,1064064,2021-04-26,Assembly,"Do pass and be re-referred to the Committee on [Appropriations]",15,0,0,0,15
1429103,1082221,2021-05-20,Assembly,"Do pass as amended",12,0,4,0,16
1429103,1091723,2021-06-03,Assembly,"AB 350 Villapudua Assembly Third Reading",76,0,3,0,79
1429103,1103777,2021-07-01,Senate,"Do pass as amended, but first amend, and re-refer to the Committee on [Appropriations]",5,0,0,0,5
1429103,1106156,2021-08-16,Senate,"Placed on suspense file",7,0,0,0,7
1429103,1106599,2021-08-26,Senate,"Do pass as amended",7,0,0,0,7
1429104,1060991,2021-04-22,Assembly,"Do pass. To Consent Calendar",21,0,1,0,22
1429104,1066731,2021-04-29,Assembly,"AB 351 Cristina Garcia Consent Calendar Second Day Regular Session",77,0,1,0,78
1429104,1100262,2021-06-22,Senate,"Do pass and be ordered to the Consent Calendar",15,0,0,0,15
1429104,1215788,2022-06-13,Senate,"Do pass, but first be re-referred to the Committee on [Health]",10,0,0,4,14
1429104,1218626,2022-06-22,Senate,"Do pass as amended, but first amend, and re-refer to the Committee on [Appropriations]",9,0,0,2,11
1429104,1222928,2022-08-01,Senate,"Placed on suspense file",7,0,0,0,7
1429104,1223901,2022-08-11,Senate,"Do pass as amended",6,0,0,1,7
1429104,1225343,2022-08-29,Senate,"Assembly 3rd Reading AB351 Cristina Garcia et a By Eggman",35,0,0,5,40
1429104,1225344,2022-08-30,Assembly,"AB 351 Cristina Garcia Concurrence in Senate Amendments",65,0,0,15,80
1429106,1123301,2022-01-10,Assembly,"Do pass and be re-referred to the Committee on [Appropriations] with recommendation: To Consent Calendar",11,0,0,0,11
1429106,1126303,2022-01-20,Assembly,"Do pass",15,0,0,1,16
1429106,1127190,2022-01-24,Assembly,"AB 353 O'Donnell Assembly Third Reading",67,0,0,9,76
1429106,1211859,2022-06-01,Senate,"Do pass, but first be re-referred to the Committee on [Appropriations] with the recommendation: To Consent Calendar",8,0,0,1,9
1429106,1222910,2022-08-01,Senate,"Placed on suspense file",7,0,0,0,7
1429106,1224017,2022-08-11,Senate,"Do pass",7,0,0,0,7
1429106,1224591,2022-08-23,Senate,"Special Consent AB353",40,0,0,0,40
1429107,1047557,2021-04-07,Assembly,"Do pass and be re-referred to the Committee on [Natural Resources] with recommendation: To Consent Calendar",15,0,0,0,15
1429107,1065180,2021-04-28,Assembly,"Do pass and be re-referred to the Committee on [Appropriations]",11,0,0,0,11
1429109,1029571,2021-03-16,Senate,"Do pass as amended, but first amend, and re-refer to the Committee on [Appropriations]",9,0,0,0,9
1429109,1045005,2021-04-05,Senate,"Placed on suspense file",7,0,0,0,7
1429109,1081435,2021-05-20,Senate,"Do pass",7,0,0,0,7
1429109,1083795,2021-05-24,Senate,"Senate 3rd Reading SB266 Newman et al",40,0,0,0,40
1429109,1103821,2021-07-01,Assembly,"Do pass and be re-referred to the Committee on [Appropriations] with recommendation: To Consent Calendar",14,0,1,0,15
1429109,1106989,2021-08-26,Assembly,"Do pass",16,0,0,0,16
1429109,1107409,2021-09-01,Assembly,"SB 266 Newman Senate Third Reading By Chen",78,0,0,1,79
1429110,1027189,2021-03-11,Senate,"Do pass, but first be re-referred to the Committee on [Appropriations]",5,0,0,0,5
1429110,1048959,2021-04-08,Senate,"Senate 3rd Reading SB267 Hertzberg",34,2,4,0,40
1429110,1104334,2021-07-05,Assembly,"Do pass and be re-referred to the Committee on [Appropriations]",11,0,0,0,11
1429110,1106561,2021-08-26,Assembly,"Do pass",13,0,0,3,16
1429110,1107417,2021-09-01,Assembly,"SB 267 Hertzberg Senate Third Reading By Ward",72,1,0,6,79
1429110,1107629,2021-09-02,Senate,"Unfinished Business SB267 Hertzberg Concurrence",33,4,0,3,40
1429111,1037859,2021-03-25,Senate,"Do pass as amended, but first amend, and re-refer to the Committee on [Appropriations]",5,0,0,0,5
1429111,1056380,2021-04-19,Senate,"Placed on suspense file",7,0,0,0,7
1429111,1081663,2021-05-20,Senate,"Do pass",7,0,0,0,7
1429111,1089546,2021-06-01,Senate,"Special Consent SB268",39,0,1,0,40
1429111,1101589,2021-06-23,Assembly,"Do pass and be re-referred to the Committee on [Water, Parks, and Wildlife] with recommendation: To Consent Calendar",8,0,0,0,8
1429111,1103803,2021-07-01,Assembly,"Do pass and be re-referred to the Committee on [Appropriations] with recommendation: To Consent Calendar",14,0,1,0,15
1429111,1107030,2021-08-26,Assembly,"Do pass",16,0,0,0,16
1429111,1107602,2021-09-02,Assembly,"SB 268 Archuleta Senate Third Reading By Cristina Garcia",77,0,0,2,79
1429112,1026134,2021-03-10,Senate,"Do pass, but first be re-referred to the Committee on [Appropriations]",9,0,0,0,9
1429112,1045013,2021-04-05,Senate,"Senate 3rd Reading SB269 Portantino",38,0,2,0,40
1429112,1102825,2021-06-29,Assembly,"Do pass and be re-referred to the Committee on [Appropriations] with recommendation: To Consent Calendar",12,0,0,0,12
1429112,1104929,2021-07-14,Assembly,"Do pass. To Consent Calendar",13,0,3,0,16
1429112,1106362,2021-08-19,Assembly,"SB 269 Portantino Consent Calendar Second Day Regular Session",73,0,0,6,79
1429112,1107168,2021-08-30,Senate,"Special Consent SB269",39,0,0,1,40
1429113,1046168,2021-04-05,Senate,"Do pass, but first be re-referred to the Committee on [Judiciary]",4,0,1,0,5
1429113,1053551,2021-04-13,Senate,"Do pass as amended, but first amend, and re-refer to the Committee on [Appropriations]",8,2,1,0,11
1429113,1068230,2021-05-03,Senate,"Placed on suspense file",6,0,1,0,7
1429113,1081547,2021-05-20,Senate,"Do pass",5,2,0,0,7
1429113,1089608,2021-06-01,Senate,"Senate 3rd Reading SB270 Durazo",30,10,0,0,40
1429113,1100764,2021-06-23,Assembly,"Do pass and be re-referred to the Committee on [Judiciary]",5,2,0,0,7
1429113,1104715,2021-07-13,Assembly,"Do pass and be re-referred to the Committee on [Appropriations]",8,2,1,0,11
1429113,1106791,2021-08-26,Assembly,"Do pass",12,4,0,0,16
1429113,1107482,2021-09-01,Assembly,"SB 270 Durazo Senate Third Reading By Cooper",58,15,0,6,79
1429113,1108408,2021-09-09,Assembly,"SB 270 Durazo Senate Third Reading By Cooper",58,15,0,7,80
1429113,1108565,2021-09-10,Senate,"Unfinished Business SB270 Durazo et al. Concurrence",27,10,0,3,40
1429114,1029575,2021-03-16,Senate,"Do pass, but first be re-referred to the Committee on [Governance and Finance]",4,1,0,0,5
1429114,1120724,2022-01-06,Senate,"Do pass, but first be re-referred to the Committee on [Judiciary]",3,1,0,1,5
1429114,1123778,2022-01-12,Senate,"Do pass, but first be re-referred to the Committee on [Appropriations]",9,0,0,2,11
1429114,1124810,2022-01-18,Senate,"Placed on suspense file",6,0,0,1,7
1429115,1025115,2021-03-09,Senate,"Be adopted. Ordered to third reading",9,1,1,0,11
1429115,1056346,2021-04-19,Senate,"Senate 3rd Reading SR6 Skinner",29,8,3,0,40
1430809,1051985,2021-04-13,Senate,"Do pass, but first be re-referred to the Committee on [Judiciary] with the recommendation: To Consent Calendar",8,0,1,0,9
1430809,1059231,2021-04-20,Senate,"Do pass and be ordered to the Consent Calendar",11,0,0,0,11
1430809,1066798,2021-04-29,Senate,"Consent Calendar SB272",36,0,4,0,40
1430809,1096089,2021-06-09,Assembly,"Do pass and be re-referred to the Committee on [Judiciary] with recommendation: To Consent Calendar",11,0,0,0,11
1430809,1100258,2021-06-22,Assembly,"Do pass. To Consent Calendar",11,0,0,0,11
1430809,1104606,2021-07-12,Assembly,"SB 272 Laird Third Reading Urgency By Bauer-Kahan",75,0,4,0,79
1430809,1105120,2021-07-15,Senate,"Unfinished Business SB272 Laird et al. Urgency Clause Concurrence",39,0,1,0,40
1430810,1027169,2021-03-11,Senate,"Do pass, but first be re-referred to the Committee on [Environmental Quality] with the recommendation: To Consent Calendar",5,0,0,0,5
1430810,1050795,2021-04-12,Senate,"Do pass, but first be re-referred to the Committee on [Appropriations] with the recommendation: To Consent Calendar",7,0,0,0,7
1430810,1060898,2021-04-22,Senate,"Consent Calendar SB273",38,0,2,0,40
1430810,1096126,2021-06-09,Assembly,"Do pass as amended and be re-referred to the Committee on [Environmental Safety and Toxic Materials]",8,0,0,0,8
1430810,1103373,2021-06-30,Assembly,"Do pass and be re-referred to the Committee on [Appropriations]",9,0,0,0,9
1430810,1104428,2021-07-07,Assembly,"Do pass",14,0,2,0,16
1430810,1106312,2021-08-19,Assembly,"SB 273 Hertzberg Senate Third Reading By Bauer-Kahan",70,0,0,9,79
1430810,1107184,2021-08-30,Senate,"Special Consent SB273",39,0,0,1,40
1430811,1037845,2021-03-25,Senate,"Do pass as amended, but first amend, and re-refer to the Committee on [Appropriations]",5,0,0,0,5
1430811,1060895,2021-04-22,Senate,"Consent Calendar SB274",38,0,2,0,40
1430811,1101578,2021-06-23,Assembly,"Do pass and be re-referred to the Committee on [Appropriations]",8,0,0,0,8
1430811,1104398,2021-07-07,Assembly,"Do pass",14,0,2,0,16
1430811,1106381,2021-08-23,Assembly,"SB 274 Wieckowski Senate Third Reading By Luz Rivas",70,0,0,9,79
1430813,1054752,2021-04-15,Senate,"Do pass, but first be re-referred to the Committee on [Appropriations]",5,0,0,0,5
1430813,1068276,2021-05-03,Senate,"Placed on suspense file",6,0,1,0,7
1430814,1057755,2021-04-20,Senate,"Do pass, but first be re-referred to the Committee on [Judiciary]",14,0,1,0,15
1430814,1068208,2021-05-03,Senate,"Placed on suspense file",6,0,1,0,7
1430814,1081457,2021-05-20,Senate,"Do pass as amended",7,0,0,0,7
1430814,1087624,2021-05-28,Senate,"Senate 3rd Reading SB277 Archuleta et al",38,0,2,0,40
1430814,1217989,2022-06-22,Assembly,"Do pass as amended and be re-referred to the Committee on [Environmental Safety and Toxic Materials]",20,0,0,2,22
1430814,1220016,2022-06-28,Assembly,"Do pass and be re-referred to the Committee on [Appropriations]",8,0,0,0,8
1430814,1222981,2022-08-03,Assembly,"Do pass. To Consent Calendar",15,0,0,1,16
1430814,1223713,2022-08-11,Assembly,"SB 277 Archuleta Consent Calendar Second Day Regular Session",76,0,0,4,80
1430814,1224110,2022-08-16,Senate,"Unfinished Business SB277 Archuleta et al. Concurrence",36,0,0,4,40
1430815,1023827,2021-03-08,Senate,"Do pass, but first be re-referred to the Committee on [Judiciary]",5,0,0,0,5
1430815,1047552,2021-04-06,Senate,"Do pass, but first be re-referred to the Committee on [Appropriations]",10,1,0,0,11
1430815,1056321,2021-04-19,Senate,"Placed on suspense file",7,0,0,0,7
1430815,1082138,2021-05-20,Senate,"Do pass",6,0,1,0,7
1430815,1089478,2021-06-01,Senate,"Senate 3rd Reading SB278 Leyva",35,0,5,0,40
1430815,1100793,2021-06-23,Assembly,"Do pass and be re-referred to the Committee on [Appropriations]",7,0,0,0,7
1430815,1106856,2021-08-26,Assembly,"Do pass",15,0,0,1,16
1430815,1107950,2021-09-07,Assembly,"SB 278 Leyva Senate Third Reading By Rodriguez",65,0,0,15,80
1430815,1107994,2021-09-08,Senate,"Unfinished Business SB278 Leyva et al. Concurrence",37,1,0,2,40
1430816,1065168,2021-04-28,Senate,"Do pass, but first be re-referred to the Committee on [Appropriations]",11,0,0,0,11
1430816,1078765,2021-05-17,Senate,"Placed on suspense file",7,0,0,0,7
1430816,1081578,2021-05-20,Senate,"Do pass",7,0,0,0,7
1433149,1046146,2021-04-06,Assembly,"Do pass and be re-referred to the Committee on [Business and Professions]",15,0,0,0,15
1433149,1065293,2021-04-27,Assembly,"Do pass and be re-referred to the Committee on [Appropriations] with recommendation: To Consent Calendar",19,0,0,0,19
1433149,1081935,2021-05-20,Assembly,"Do pass",16,0,0,0,16
1433149,1087051,2021-05-27,Assembly,"AB 356 Chen Assembly Third Reading",78,0,0,0,78
1433149,1099752,2021-06-21,Senate,"Do pass, but first be re-referred to the Committee on [Appropriations]",11,0,3,0,14
1433149,1104157,2021-07-05,Senate,"Placed on suspense file",6,0,1,0,7
1433149,1106794,2021-08-26,Senate,"Do pass as amended",7,0,0,0,7
1433149,1108041,2021-09-08,Senate,"Assembly 3rd Reading AB356 Chen et al. By Newman",38,0,0,2,40
1433149,1108443,2021-09-09,Assembly,"AB 356 Chen Concurrence in Senate Amendments",79,0,0,1,80
1433151,1072245,2021-05-04,Assembly,"Do pass as amended",11,0,0,0,11
1433151,1086966,2021-05-27,Assembly,"AB 358 Flora Assembly Third Reading",78,0,0,0,78
1433151,1103505,2021-06-29,Senate,"Do pass as amended, and be ordered to the Consent Calendar",11,0,0,0,11
1433151,1106337,2021-08-19,Senate,"Assembly 3rd Reading AB358 Flora et al. By Ochoa Bogh",37,0,0,3,40
1433151,1106382,2021-08-23,Assembly,"AB 358 Flora Concurrence in Senate Amendments",70,0,0,9,79
1433152,1046184,2021-04-06,Assembly,"Do pass and be re-referred to the Committee on [Appropriations] with recommendation: To Consent Calendar",18,0,1,0,19
1433152,1053440,2021-04-14,Assembly,"Do pass. To Consent Calendar",16,0,0,0,16
1433152,1060885,2021-04-22,Assembly,"AB 359 Cooper Consent Calendar Second Day Regular Session",77,0,2,0,79
1433152,1104646,2021-07-12,Senate,"Do pass as amended, but first amend, and re-refer to the Committee on [Appropriations]",14,0,0,0,14
1433152,1106438,2021-08-23,Senate,"Placed on suspense file",7,0,0,0,7
1433152,1106985,2021-08-26,Senate,"Do pass as amended",7,0,0,0,7
1433152,1108079,2021-09-08,Senate,"Special Consent AB359 Cooper et al. By Pan Urgency Clause",38,0,0,2,40
1433152,1108252,2021-09-09,Assembly,"AB 359 Cooper Concurrence in Senate Amendments",79,0,0,1,80
1433154,1073384,2021-05-05,Assembly,"Do pass as amended",7,0,1,0,8
1433154,1078769,2021-05-17,Assembly,"AB 361 Robert Rivas Assembly Third Reading",62,4,12,0,78
1433154,1103839,2021-07-01,Senate,"Do pass as amended, but first amend, and re-refer to the Committee on [Judiciary]",5,0,0,0,5
1433154,1104928,2021-07-13,Senate,"Do pass",10,0,1,0,11
1433154,1108251,2021-09-09,Senate,"Pursuant to Senate Rule 29.10, that the measure be re-referred to the Committee on Appropriations pursuant to Joint Rule 10.5",9,1,0,1,11
1433154,1108602,2021-09-10,Senate,"Assembly 2nd Reading AB361 Robert Rivas By Caballero Urgency Clause",28,7,0,5,40
1433154,1108603,2021-09-10,Assembly,"AB 361 Robert Rivas Concurrence - Urgency Added",66,4,0,10,80
1433155,1067607,2021-04-29,Assembly,"Do pass as amended and be re-referred to the Committee on [Appropriations]",6,2,0,0,8
1433155,1082022,2021-05-20,Assembly,"Do pass as amended",12,3,1,0,16
1433155,1092940,2021-06-01,Assembly,"AB 362 Quirk-Silva Assembly Third Reading",60,16,3,0,79
1433155,1104528,2021-07-08,Senate,"Do pass, but first be re-referred to the Committee on [Appropriations]",7,0,2,0,9
1433155,1106233,2021-08-16,Senate,"Placed on suspense file",7,0,0,0,7
1433155,1107017,2021-08-26,Senate,"Do pass as amended",5,2,0,0,7
1433155,1108366,2021-09-09,Senate,"Assembly 3rd Reading AB362 Quirk-Silva By Wieckowski",29,9,0,2,40
1433155,1108561,2021-09-10,Assembly,"AB 362 Quirk-Silva Concurrence in Senate Amendments",60,16,0,4,80
1433156,1064133,2021-04-26,Assembly,"Do pass and be re-referred to the Committee on [Appropriations]",12,0,3,0,15
1433156,1081725,2021-05-20,Assembly,"Do pass as amended",12,0,4,0,16
1433156,1092966,2021-06-01,Assembly,"AB 363 Medina Assembly Third Reading",64,3,12,0,79
1433156,1102448,2021-06-28,Senate,"Do pass, but first be re-referred to the Committee on [Transportation]",6,0,1,0,7
1433157,1049020,2021-04-08,Assembly,"Do pass and be re-referred to the Committee on [Judiciary]",5,2,0,0,7
1433157,1057747,2021-04-20,Assembly,"Do pass and be re-referred to the Committee on [Appropriations]",8,2,1,0,11
1433157,1081472,2021-05-20,Assembly,"Do pass",11,5,0,0,16
1433157,1090400,2021-06-02,Assembly,"AB 364 Rodriguez Assembly Third Reading",53,19,7,0,79
1433157,1102449,2021-06-28,Senate,"Do pass, but first be re-referred to the Committee on [Judiciary]",4,0,1,0,5
1433157,1104882,2021-07-13,Senate,"Do pass, but first be re-referred to the Committee on [Appropriations]",9,2,0,0,11
1433157,1106129,2021-08-16,Senate,"Placed on suspense file",7,0,0,0,7
1433157,1106827,2021-08-26,Senate,"Do pass",5,2,0,0,7
1433157,1224862,2022-08-24,Senate,"Assembly 3rd Reading AB364 Rodriguez et al. By Hueso",31,8,0,1,40
1433158,1123300,2022-01-10,Assembly,"Do pass as amended and be re-referred to the Committee on [Appropriations]",9,0,0,2,11
1433159,1047550,2021-04-07,Assembly,"Do pass and be re-referred to the Committee on [Appropriations] with recommendation: To Consent Calendar",8,0,0,0,8
1433159,1082225,2021-05-20,Assembly,"Do pass as amended",16,0,0,0,16
1433159,1092887,2021-06-01,Assembly,"AB 366 Blanca Rubio Assembly Third Reading",79,0,0,0,79
1433159,1104394,2021-07-06,Senate,"Do pass as amended, but first amend, and re-refer to the Committee on [Judiciary]",5,0,0,0,5
1433159,1108221,2021-09-09,Senate,"Assembly 3rd Reading AB366 Blanca Rubio et al. By Rubio",38,0,0,2,40
1433159,1108503,2021-09-10,Assembly,"With recommendation: That Senate amendments be concurred in",7,0,0,1,8
1433159,1108623,2021-09-10,Assembly,"AB 366 Blanca Rubio Concurrence in Senate Amendments",78,0,0,2,80
1433160,1036433,2021-03-24,Assembly,"Do pass as amended and be re-referred to the Committee on [Higher Education]",7,0,0,0,7
1433160,1060950,2021-04-22,Assembly,"Do pass as amended and be re-referred to the Committee on [Appropriations]",11,0,1,0,12
1433160,1082126,2021-05-20,Assembly,"Do pass as amended",15,1,0,0,16
1433160,1092855,2021-06-01,Assembly,"AB 367 Cristina Garcia Assembly Third Reading",77,0,2,0,79
1433160,1100804,2021-06-23,Senate,"Do pass, but first be re-referred to the Committee on [Appropriations]",6,0,1,0,7
1433160,1104187,2021-07-05,Senate,"Placed on suspense file",6,0,1,0,7
1433160,1106721,2021-08-26,Senate,"Do pass as amended",7,0,0,0,7
1433160,1108164,2021-09-08,Senate,"Assembly 3rd Reading AB367 Cristina Garcia et a By Skinner",38,0,0,2,40
1433160,1108165,2021-09-08,Senate,"Assembly 3rd Reading AB367 Cristina Garcia et a By Skinner Reconsider",38,0,0,2,40
1433160,1108166,2021-09-08,Senate,"Assembly 3rd Reading AB367 Cristina Garcia et a By Skinner",34,2,0,4,40
1433160,1108455,2021-09-09,Assembly,"AB 367 Cristina Garcia Concurrence in Senate Amendments",79,0,0,1,80
1433161,1051975,2021-04-13,Assembly,"Do pass as amended and be re-referred to the Committee on [Appropriations]",15,0,0,0,15
1433162,1057700,2021-04-20,Assembly,"Do pass as amended and be re-referred to the Committee on [Appropriations]",14,0,1,0,15
1433162,1081894,2021-05-20,Assembly,"Do pass",15,0,1,0,16
1433162,1086976,2021-05-27,Assembly,"AB 369 Kamlager Assembly Third Reading By SANTIAGO",74,0,4,0,78
1433162,1104923,2021-07-14,Senate,"Do pass, but first be re-referred to the Committee on [Appropriations]",7,0,4,0,11
1433162,1106187,2021-08-16,Senate,"Placed on suspense file",7,0,0,0,7
1433162,1106605,2021-08-26,Senate,"Do pass",5,0,0,2,7
1433162,1107216,2021-08-30,Senate,"Assembly 3rd Reading AB369 Kamlager et al",32,0,0,8,40
1433162,1107728,2021-09-02,Assembly,"AB 369 Kamlager Concurrence in Senate Amendments By WEBER, A",72,0,0,7,79
1433163,1051879,2021-04-13,Assembly,"Do pass as amended and be re-referred to the Committee on [Appropriations]",15,0,0,0,15
1433164,1048979,2021-04-08,Assembly,"Do pass and be re-referred to the Committee on [Judiciary]",9,0,2,0,11
1433164,1051909,2021-04-13,Assembly,"Do pass as amended",11,0,0,0,11
1433164,1077591,2021-05-13,Assembly,"AB 371 Jones-Sawyer Assembly Third Reading",59,3,16,0,78
1433164,1103425,2021-06-29,Senate,"Do pass as amended, but first amend, and re-refer to the Committee on [Insurance]",9,0,2,0,11
1433164,1217964,2022-06-22,Senate,"Do pass as amended, but first amend, and re-refer to the Committee on [Appropriations]",7,1,0,4,12
1433164,1222932,2022-08-01,Senate,"Placed on suspense file",7,0,0,0,7
1433164,1223805,2022-08-11,Senate,"Do pass as amended",5,1,0,1,7
1433164,1224654,2022-08-24,Senate,"Assembly 3rd Reading AB371 Jones-Sawyer et al. By Hueso",25,5,0,10,40
1433164,1225109,2022-08-29,Assembly,"AB 371 Jones-Sawyer Concurrence in Senate Amendments",55,0,0,25,80
1433168,1036535,2021-03-24,Assembly,"Do pass and be re-referred to the Committee on [Appropriations]",12,0,0,0,12
1433168,1081820,2021-05-20,Assembly,"Do pass as amended",16,0,0,0,16
1433168,1090457,2021-06-02,Assembly,"AB 375 Medina Assembly Third Reading",77,0,2,0,79
1433168,1103467,2021-06-30,Senate,"Do pass, but first be re-referred to the Committee on [Appropriations] with the recommendation: To Consent Calendar",7,0,0,0,7
1433168,1105056,2021-07-15,Senate,"Placed on suspense file",7,0,0,0,7
1433168,1106878,2021-08-26,Senate,"Do pass",7,0,0,0,7
1433168,1107828,2021-09-03,Senate,"Special Consent AB375",37,0,0,3,40
1433170,1059258,2021-04-21,Assembly,"Do pass and be re-referred to the Committee on [Appropriations]",5,3,1,0,9
1433171,1035239,2021-03-23,Assembly,"Do pass. To Consent Calendar",11,0,0,0,11
1433171,1062756,2021-04-26,Assembly,"AB 378 Bauer-Kahan Assembly Third Reading",74,0,4,0,78
1433171,1095079,2021-06-08,Senate,"Do pass and be ordered to the Consent Calendar",11,0,0,0,11
1433171,1099131,2021-06-17,Senate,"Consent Calendar AB378",37,0,3,0,40
1433171,1101692,2021-06-24,Assembly,"AB 378 Bauer-Kahan Concurrence in Senate Amendments",75,0,4,0,79
1433172,1049871,2021-04-08,Assembly,"Do pass and be re-referred to the Committee on [Appropriations]",15,0,0,0,15
1433172,1059295,2021-04-21,Assembly,"Do pass as amended",14,0,2,0,16
1433172,1075253,2021-05-10,Assembly,"AB 379 Gallagher Assembly Third Reading",74,0,4,0,78
1433172,1104756,2021-07-13,Senate,"Do pass as amended, but first amend, and re-refer to the Committee on [Appropriations]",7,0,2,0,9
1433172,1106413,2021-08-23,Senate,"Placed on suspense file",7,0,0,0,7
1433172,1106881,2021-08-26,Senate,"Do pass as amended",7,0,0,0,7
1433172,1108055,2021-09-08,Senate,"Special Consent AB379",38,0,0,2,40
1433172,1108329,2021-09-09,Assembly,"AB 379 Gallagher Concurrence in Senate Amendments",79,0,0,1,80
1433173,1077559,2021-05-13,Assembly,"Be adopted. To Consent Calendar",10,0,2,0,12
1433173,1081746,2021-05-20,Assembly,"ACR 17 Voepel Consent Calendar Second Day Regular Session",76,0,2,0,78
1433173,1101620,2021-06-24,Senate,"Special Consent ACR17",39,0,1,0,40
1433174,1005301,2021-02-12,Assembly,"Be adopted. To third reading",11,0,1,0,12
1433174,1018543,2021-03-01,Senate,"Assembly 3rd Reading ACR18",36,0,3,0,39
1433175,1103750,2021-07-01,Assembly,"Be adopted. To third reading",11,3,1,0,15
1433175,1106122,2021-08-16,Assembly,"AJR 5 Luz Rivas Assembly Third Reading",59,4,0,16,79
1433176,1026129,2021-03-10,Senate,"Do pass, but first be re-referred to the Committee on [Judiciary]",11,0,0,0,11
1433176,1035253,2021-03-23,Senate,"Do pass, but first be re-referred to the Committee on [Appropriations] with the recommendation: To Consent Calendar",11,0,0,0,11
1433176,1068245,2021-05-03,Senate,"Do pass",6,0,1,0,7
1433176,1089596,2021-06-01,Senate,"Senate 3rd Reading SB280 Lim贸n",39,0,1,0,40
1433176,1104287,2021-07-06,Assembly,"Do pass and be re-referred to the Committee on [Appropriations] with recommendation: To Consent Calendar",15,0,0,0,15
1433176,1106328,2021-08-19,Assembly,"Do pass. To Consent Calendar",16,0,0,0,16
1433176,1106690,2021-08-26,Assembly,"SB 280 Lim贸n Consent Calendar Second Day Regular Session",73,0,0,6,79
1433177,1030774,2021-03-17,Senate,"Do pass as amended, but first amend, and re-refer to the Committee on [Appropriations] with the recommendation: To Consent Calendar",10,0,1,0,11
1433177,1075366,2021-05-10,Senate,"Consent Calendar SB281 Dodd Urgency Clause",37,0,3,0,40
1433177,1217400,2022-06-21,Assembly,"Do pass as amended, and be re-referred to the Committee on [Appropriations] with recommendation: To Consent Calendar",15,0,0,0,15
1433177,1222959,2022-08-03,Assembly,"Do pass. To Consent Calendar",15,0,0,1,16
1433177,1224338,2022-08-22,Assembly,"SB 281 Dodd Senate Third Reading By Wood",76,0,0,4,80
1433177,1224585,2022-08-23,Senate,"Unfinished Business SB281 Dodd Concurrence",40,0,0,0,40
1433179,1048992,2021-04-08,Senate,"Do pass",12,0,0,0,12
1433179,1066779,2021-04-29,Senate,"Senate 3rd Reading SB283 Gonzalez",36,0,4,0,40
1433179,1101624,2021-06-24,Assembly,"Do pass. To Consent Calendar",14,0,0,0,14
1433179,1103756,2021-07-01,Assembly,"SB 283 Gonzalez Consent Calendar Second Day Regular Session",77,0,2,0,79
1433179,1104564,2021-07-08,Senate,"Unfinished Business SB283 Gonzalez et al. Concurrence",39,0,1,0,40
1433180,1023847,2021-03-08,Senate,"Do pass, but first be re-referred to the Committee on [Appropriations]",4,0,1,0,5
1433180,1033653,2021-03-22,Senate,"Placed on suspense file",7,0,0,0,7
1433180,1081564,2021-05-20,Senate,"Do pass",5,2,0,0,7
1433180,1090403,2021-06-02,Senate,"Senate 3rd Reading SB284 Stern",37,1,2,0,40
1433180,1101585,2021-06-24,Assembly,"Do pass as amended and be re-referred to the Committee on [Appropriations]",14,0,0,0,14
1433180,1106846,2021-08-26,Assembly,"Do pass as amended",12,0,0,4,16
1433180,1224378,2022-08-22,Assembly,"SB 284 Stern Senate Third Reading By Cooper",71,0,0,9,80
1433180,1225596,2022-08-29,Senate,"Unfinished Business SB284 Stern et al. Concurrence",39,0,0,1,40
1433181,1023836,2021-03-08,Senate,"Do pass, but first be re-referred to the Committee on [Appropriations]",14,0,0,0,14
1433181,1033643,2021-03-22,Senate,"Placed on suspense file",7,0,0,0,7
1433181,1082055,2021-05-20,Senate,"Do pass as amended",7,0,0,0,7
1433182,1123760,2022-01-12,Senate,"Do pass, but first be re-referred to the Committee on [Elections and Constitutional Amendments]",5,2,0,0,7
1433182,1124164,2022-01-13,Senate,"Do pass, but first be re-referred to the Committee on [Appropriations]",4,1,0,0,5
1433182,1124813,2022-01-18,Senate,"Placed on suspense file",6,0,0,1,7
1433182,1126339,2022-01-20,Senate,"Do pass",5,2,0,0,7
1433182,1128995,2022-01-26,Senate,"Senate 3rd Reading SB286 Min",30,7,0,3,40
1433182,1216311,2022-06-15,Assembly,"Do pass and be re-referred to the Committee on [Education]",5,1,0,1,7
1433182,1220695,2022-06-29,Assembly,"Do pass and be re-referred to the Committee on [Appropriations]",5,1,0,1,7
1433183,1052018,2021-04-13,Senate,"Do pass, but first be re-referred to the Committee on [Appropriations] with the recommendation: To Consent Calendar",16,0,1,0,17
1433183,1075368,2021-05-10,Senate,"Placed on suspense file",7,0,0,0,7
1433183,1081495,2021-05-20,Senate,"Do pass",7,0,0,0,7
1433183,1089565,2021-06-01,Senate,"Special Consent SB287",39,0,1,0,40
1433183,1104323,2021-07-05,Assembly,"Do pass and be re-referred to the Committee on [Appropriations] with recommendation: To Consent Calendar",15,0,0,0,15
1433183,1106564,2021-08-26,Assembly,"Do pass as amended",16,0,0,0,16
1433183,1108068,2021-09-08,Assembly,"SB 287 Grove Senate Third Reading By Low",80,0,0,0,80
1433183,1108365,2021-09-09,Senate,"Unfinished Business SB287 Grove Concurrence",38,0,0,2,40
1433184,1026137,2021-03-10,Senate,"Do pass, but first be re-referred to the Committee on [Judiciary]",9,0,0,0,9
1433184,1029584,2021-03-16,Senate,"Do pass, but first be re-referred to the Committee on [Appropriations] with the recommendation: To Consent Calendar",11,0,0,0,11
1433184,1044954,2021-04-05,Senate,"Do pass",7,0,0,0,7
1433184,1050832,2021-04-12,Senate,"Senate 3rd Reading SB288 Jones et al",39,0,1,0,40
1433184,1102813,2021-06-29,Assembly,"Do pass and be re-referred to the Committee on [Judiciary] with recommendation: To Consent Calendar",12,0,0,0,12
1433184,1104241,2021-07-06,Assembly,"Do pass and be re-referred to the Committee on [Appropriations]",4,3,4,0,11
1433185,1050829,2021-04-12,Senate,"Do pass as amended, but first amend, and re-refer to the Committee on [Judiciary]",5,2,0,0,7
1433185,1065264,2021-04-27,Senate,"Do pass, but first be re-referred to the Committee on [Appropriations]",9,2,0,0,11
1433185,1078797,2021-05-17,Senate,"Placed on suspense file",7,0,0,0,7
1433186,1031904,2021-03-18,Senate,"Do pass, but first be re-referred to the Committee on [Governance and Finance]",6,1,2,0,9
1433186,1054605,2021-04-15,Senate,"Do pass, but first be re-referred to the Committee on [Appropriations]",5,0,0,0,5
1433186,1068280,2021-05-03,Senate,"Placed on suspense file",6,0,1,0,7
1433186,1082032,2021-05-20,Senate,"Do pass",5,2,0,0,7
1433186,1083790,2021-05-24,Senate,"Senate 3rd Reading SB290 Skinner",33,4,3,0,40
1433186,1100240,2021-06-22,Assembly,"Do pass and be re-referred to the Committee on [Local Government]",8,0,0,0,8
1433186,1103845,2021-06-30,Assembly,"Do pass and be re-referred to the Committee on [Appropriations]",7,1,0,0,8
1433186,1104945,2021-07-14,Assembly,"Do pass",13,0,3,0,16
1433186,1106396,2021-08-23,Assembly,"SB 290 Skinner Senate Third Reading By Quirk-Silva",66,1,0,12,79
1433186,1107230,2021-08-30,Senate,"Unfinished Business SB290 Skinner Concurrence",32,4,0,4,40
1433187,1026125,2021-03-10,Senate,"Do pass, but first be re-referred to the Committee on [Appropriations] with the recommendation: To Consent Calendar",7,0,0,0,7
1433187,1033663,2021-03-22,Senate,"Placed on suspense file",7,0,0,0,7
1433187,1081641,2021-05-20,Senate,"Do pass as amended",7,0,0,0,7
1433187,1127195,2022-01-24,Senate,"Senate 3rd Reading SB291 Stern",36,0,0,4,40
1433187,1216610,2022-06-15,Assembly,"Do pass as amended and be re-referred to the Committee on [Appropriations]",6,0,0,1,7
1433187,1220583,2022-06-29,Assembly,"Do pass. To Consent Calendar",14,0,0,2,16
1433187,1224372,2022-08-22,Assembly,"SB 291 Stern Senate Third Reading By Megan Dahle",77,0,0,3,80
1433187,1225848,2022-08-30,Senate,"Special Consent SB291",38,0,0,2,40
1433188,1031898,2021-03-18,Senate,"Do pass, but first be re-referred to the Committee on [Public Safety] with the recommendation: To Consent Calendar",5,0,0,0,5
1433188,1060956,2021-04-22,Senate,"Consent Calendar SB292",38,0,2,0,40
1433188,1098627,2021-06-16,Assembly,"Do pass and be re-referred to the Committee on [Appropriations]",11,0,0,0,11
1433188,1104482,2021-07-07,Assembly,"Do pass. To Consent Calendar",14,0,2,0,16
1433188,1106386,2021-08-23,Assembly,"SB 292 Wilk Senate Third Reading By Aguiar-Curry",70,0,0,9,79
1433188,1107175,2021-08-30,Senate,"Unfinished Business SB292 Wilk et al. Concurrence",39,0,0,1,40
1433189,1030773,2021-03-17,Senate,"Do pass as amended, but first amend, and re-refer to the Committee on [Appropriations]",11,0,0,0,11
1433189,1068171,2021-05-03,Senate,"Placed on suspense file",6,0,1,0,7
1433189,1082084,2021-05-20,Senate,"Do pass as amended",7,0,0,0,7
1433189,1089543,2021-06-01,Senate,"Special Consent SB293",39,0,1,0,40
1433189,1104322,2021-07-06,Assembly,"Do pass and be re-referred to the Committee on [Appropriations]",15,0,0,0,15
1433190,1005307,2021-02-12,Senate,"Senate 3rd Reading SR7 Ochoa Bogh et al",32,0,7,0,39
1434853,1035147,2021-03-23,Assembly,"Do pass as amended and be re-referred to the Committee on [Judiciary]",15,0,0,0,15
1434853,1053465,2021-04-14,Assembly,"Do pass. To Consent Calendar",16,0,0,0,16
1434853,1060954,2021-04-22,Assembly,"AB 381 Davies Consent Calendar Second Day Regular Session",77,0,2,0,79
1434853,1097063,2021-06-10,Senate,"Do pass as amended, but first amend, and re-refer to the Committee on [Judiciary]",10,0,1,0,11
1434853,1100818,2021-06-22,Senate,"Do pass, but first be re-referred to the Committee on [Appropriations] with the recommendation: To Consent Calendar",11,0,0,0,11
1434853,1107202,2021-08-30,Senate,"Consent Calendar AB381",39,0,0,1,40
1434853,1107381,2021-09-01,Assembly,"AB 381 Davies Concurrence in Senate Amendments",78,0,0,1,79
1434854,1035204,2021-03-23,Assembly,"Do pass and be re-referred to the Committee on [Appropriations] with recommendation: To Consent Calendar",15,0,0,0,15
1434854,1053459,2021-04-14,Assembly,"Do pass. To Consent Calendar",16,0,0,0,16
1434854,1074192,2021-05-06,Assembly,"AB 382 Kamlager Assembly Third Reading By NAZARIAN",76,0,2,0,78
1434854,1097022,2021-06-10,Senate,"Do pass, but first be re-referred to the Committee on [Appropriations] with the recommendation: To Consent Calendar",10,0,1,0,11
1434854,1101700,2021-06-24,Senate,"Consent Calendar AB382",39,0,1,0,40
1434855,1046223,2021-04-06,Assembly,"Do pass and be re-referred to the Committee on [Health]",7,0,0,0,7
1434855,1057624,2021-04-20,Assembly,"Do pass as amended, and be re-referred to the Committee on [Appropriations] with recommendation: To Consent Calendar",15,0,0,0,15
1434855,1081423,2021-05-20,Assembly,"Do pass",16,0,0,0,16
1434855,1086979,2021-05-27,Assembly,"AB 383 Salas Assembly Third Reading",78,0,0,0,78
1434855,1098620,2021-06-16,Senate,"Do pass as amended, but first amend, and re-refer to the Committee on [Human Services]",10,0,1,0,11
1434855,1104488,2021-07-06,Senate,"Do pass, but first be re-referred to the Committee on [Appropriations]",4,0,1,0,5
1434855,1106079,2021-08-16,Senate,"Placed on suspense file",7,0,0,0,7
1434856,1051974,2021-04-13,Assembly,"Do pass as amended and be re-referred to the Committee on [Appropriations]",18,0,1,0,19
1434858,1054621,2021-04-15,Assembly,"Do pass and be re-referred to the Committee on [Judiciary]",7,0,0,0,7
1434858,1064135,2021-04-27,Assembly,"Do pass as amended and be re-referred to the Committee on [Appropriations]",6,0,5,0,11
1434858,1076967,2021-05-12,Assembly,"Do pass",10,5,1,0,16
1434858,1092950,2021-06-01,Assembly,"AB 386 Cooper Assembly Third Reading",53,10,16,0,79
1434858,1100243,2021-06-21,Senate,"Do pass, but first be re-referred to the Committee on [Judiciary]",4,0,1,0,5
1434858,1104937,2021-07-13,Senate,"Do pass as amended, but first amend, and re-refer to the Committee on [Appropriations]",4,3,4,0,11
1434858,1104938,2021-07-13,Senate,"[First] hearing set for [07-14-2021]: Failed passage in Committee. Reconsideration granted",11,0,0,0,11
1434860,1036475,2021-03-24,Assembly,"Do pass and be re-referred to the Committee on [Appropriations]",4,2,1,0,7
1434860,1082187,2021-05-20,Assembly,"Do pass",12,4,0,0,16
1434860,1090401,2021-06-02,Assembly,"AB 388 Medina Assembly Third Reading",52,17,10,0,79
1434860,1103378,2021-06-30,Senate,"Do pass, but first be re-referred to the Committee on [Appropriations]",4,2,1,0,7
1434860,1105057,2021-07-15,Senate,"Placed on suspense file",7,0,0,0,7
1434861,1051987,2021-04-13,Assembly,"Do pass",13,0,2,0,15
1434861,1090498,2021-06-02,Assembly,"AB 389 Grayson Assembly Third Reading",67,0,12,0,79
1434861,1104972,2021-07-14,Senate,"Do pass as amended",8,1,2,0,11
1434861,1108383,2021-09-09,Senate,"Assembly 3rd Reading AB389 Grayson By Hertzberg",37,0,0,3,40
1434861,1108384,2021-09-09,Assembly,"AB 389 GRAYSON Concurrence in Senate Amendments",78,0,0,2,80
1434862,1060980,2021-04-22,Assembly,"Do pass",11,0,0,0,11
1434862,1068242,2021-05-03,Assembly,"AB 390 Berman Assembly Third Reading",72,1,5,0,78
1434862,1100782,2021-06-22,Senate,"Do pass",11,0,0,0,11
1434862,1107622,2021-09-02,Senate,"Assembly 3rd Reading AB390 Berman et al. By Hertzberg",39,0,0,1,40
1434862,1108021,2021-09-08,Assembly,"AB 390 Berman Concurrence in Senate Amendments",78,0,0,2,80
1434863,1054734,2021-04-15,Assembly,"Do pass and be re-referred to the Committee on [Appropriations]",11,0,0,0,11
1434863,1081918,2021-05-20,Assembly,"Do pass as amended",16,0,0,0,16
1434863,1092874,2021-06-01,Assembly,"AB 391 Villapudua Assembly Third Reading",79,0,0,0,79
1434863,1099152,2021-06-17,Senate,"Do pass, but first be re-referred to the Committee on [Appropriations] with the recommendation: To Consent Calendar",4,0,1,0,5
1434863,1104223,2021-07-05,Senate,"Placed on suspense file",6,0,1,0,7
1434863,1106637,2021-08-26,Senate,"Do pass as amended",7,0,0,0,7
1434863,1108082,2021-09-08,Senate,"Special Consent AB391",38,0,0,2,40
1434864,1051925,2021-04-13,Assembly,"Do pass",18,0,1,0,19
1434864,1074190,2021-05-06,Assembly,"AB 392 Nazarian Assembly Third Reading",73,0,5,0,78
1434864,1104595,2021-07-12,Senate,"Do pass",14,0,0,0,14
1434864,1224674,2022-08-24,Senate,"Assembly 3rd Reading AB392 Nazarian By Hueso",40,0,0,0,40
1434864,1224963,2022-08-25,Assembly,"AB 392 Nazarian Concurrence in Senate Amendments",71,0,0,9,80
1434865,1059185,2021-04-21,Assembly,"Do pass and be re-referred to the Committee on [Appropriations] with recommendation: To Consent Calendar",8,0,0,0,8
1434866,1056414,2021-04-19,Assembly,"Be adopted. To Consent Calendar",15,0,0,0,15
1434866,1060993,2021-04-22,Assembly,"ACR 19 Gallagher Consent Calendar Second Day Regular Session",77,0,2,0,79
1434866,1102807,2021-06-29,Senate,"Be adopted, but first be re-referred to the Committee on [Appropriations] with recommendation: To Consent Calendar",17,0,0,0,17
1434866,1107129,2021-08-30,Senate,"Consent Calendar ACR19",39,0,0,1,40
1434867,1016217,2021-02-25,Assembly,"Be adopted. To Consent Calendar",11,0,1,0,12
1434867,1022328,2021-03-04,Assembly,"HR 16 Choi Consent Calendar Second Day Regular Session",72,0,7,0,79
1434868,1105084,2021-07-15,Assembly,"Be adopted. To Consent Calendar",10,0,2,0,12
1434868,1106423,2021-08-23,Assembly,"HR 17 Choi Consent Calendar Second Day Regular Session",70,0,0,9,79
1434869,1023832,2021-03-08,Senate,"Do pass, but first be re-referred to the Committee on [Appropriations]",4,1,0,0,5
1434869,1068277,2021-05-03,Senate,"Senate 3rd Reading SB294 Leyva et al",29,7,4,0,40
1434869,1100831,2021-06-23,Assembly,"Do pass and be re-referred to the Committee on [Appropriations]",6,0,1,0,7
1434869,1104387,2021-07-07,Assembly,"Do pass",10,4,2,0,16
1434869,1106052,2021-08-16,Assembly,"SB 294 Leyva Senate Third Reading By O'Donnell",58,14,0,7,79
1434869,1106735,2021-08-26,Senate,"Unfinished Business SB294 Leyva et al. Concurrence",27,9,0,4,40
1434870,1005302,2021-02-12,Senate,"Senate 3rd Reading SCR9 Rubio et al",32,0,7,0,39
1434870,1016183,2021-02-25,Assembly,"Be adopted. To Consent Calendar",11,0,1,0,12
1434870,1022320,2021-03-04,Assembly,"SCR 9 Rubio Consent Calendar Second Day Regular Session",72,0,7,0,79
1436507,1036503,2021-03-23,Assembly,"Do pass and be re-referred to the Committee on [Appropriations]",6,2,0,0,8
1436508,1049015,2021-04-08,Assembly,"Do pass and be re-referred to the Committee on [Human Services]",11,0,1,0,12
1436508,1059250,2021-04-21,Assembly,"Do pass and be re-referred to the Committee on [Appropriations] with recommendation: To Consent Calendar",8,0,0,0,8
1436508,1082215,2021-05-20,Assembly,"Do pass",16,0,0,0,16
1436508,1086929,2021-05-27,Assembly,"AB 396 Gabriel Assembly Third Reading",78,0,0,0,78
1436508,1100273,2021-06-22,Senate,"Do pass as amended, but first amend, and re-refer to the Committee on [Education] with the recommendation: To Consent Calendar",5,0,0,0,5
1436508,1104417,2021-07-07,Senate,"Do pass, but first be re-referred to the Committee on [Appropriations] with the recommendation: To Consent Calendar",7,0,0,0,7
1436508,1107860,2021-09-07,Senate,"Assembly 3rd Reading AB396 Gabriel et al. By Hurtado",37,0,0,3,40
1436508,1108000,2021-09-08,Assembly,"AB 396 Gabriel Concurrence in Senate Amendments",78,0,0,2,80
1436509,1054622,2021-04-15,Assembly,"Do pass and be re-referred to the Committee on [Appropriations] with recommendation: To Consent Calendar",13,0,0,0,13
1436509,1082145,2021-05-20,Assembly,"Do pass",16,0,0,0,16
1436509,1090454,2021-06-02,Assembly,"AB 397 Mayes Assembly Third Reading",78,0,1,0,79
1436509,1102466,2021-06-28,Senate,"Do pass, but first be re-referred to the Committee on [Appropriations] with the recommendation: To Consent Calendar",5,0,0,0,5
1436509,1105074,2021-07-15,Senate,"Placed on suspense file",7,0,0,0,7
1436509,1106590,2021-08-26,Senate,"Do pass as amended",7,0,0,0,7
1436509,1108167,2021-09-08,Senate,"Assembly 3rd Reading AB397 Mayes et al. By Wilk",38,0,0,2,40
1436509,1108388,2021-09-09,Assembly,"AB 397 Mayes Concurrence in Senate Amendments",80,0,0,0,80
1436510,1035175,2021-03-22,Assembly,"Do pass and be re-referred to the Committee on [Appropriations] with recommendation: To Consent Calendar",15,0,0,0,15
1436510,1065090,2021-04-28,Assembly,"Do pass. To Consent Calendar",16,0,0,0,16
1436510,1074114,2021-05-06,Assembly,"AB 398 Fong Consent Calendar Second Day Regular Session",77,0,1,0,78
1436510,1095066,2021-06-08,Senate,"Do pass, but first be re-referred to the Committee on [Appropriations] with the recommendation: To Consent Calendar",4,0,1,0,5
1436510,1101605,2021-06-24,Senate,"Consent Calendar AB398",39,0,1,0,40
1436510,1102489,2021-06-28,Assembly,"AB 398 Fong Concurrence in Senate Amendments",79,0,0,0,79
1436511,1123294,2022-01-11,Assembly,"Do pass and be re-referred to the Committee on [Appropriations]",11,0,0,3,14
1436511,1126347,2022-01-20,Assembly,"Do pass",15,0,0,1,16
1436511,1129924,2022-01-27,Assembly,"AB 399 Salas Assembly Third Reading",69,0,0,7,76
1436512,1066722,2021-04-29,Assembly,"Do pass and be re-referred to the Committee on [Appropriations] with recommendation: To Consent Calendar",13,0,0,0,13
1436513,1054667,2021-04-15,Assembly,"Do pass and be re-referred to the Committee on [Appropriations] with recommendation: To Consent Calendar",13,0,0,0,13
1436513,1081679,2021-05-20,Assembly,"Do pass as amended",16,0,0,0,16
1436513,1092896,2021-06-01,Assembly,"AB 401 Chiu Assembly Third Reading",79,0,0,0,79
1436513,1102474,2021-06-28,Senate,"Do pass, but first be re-referred to the Committee on [Appropriations]",5,0,0,0,5
1436514,1066824,2021-04-29,Assembly,"Do pass and be re-referred to the Committee on [Appropriations] with recommendation: To Consent Calendar",13,0,0,0,13
1436514,1082219,2021-05-20,Assembly,"Do pass",16,0,0,0,16
1436514,1087029,2021-05-27,Assembly,"AB 402 Wicks Assembly Third Reading",78,0,0,0,78
1436514,1104206,2021-07-05,Senate,"Do pass, but first be re-referred to the Committee on [Appropriations]",5,0,0,0,5
1436514,1105093,2021-07-15,Senate,"Placed on suspense file",7,0,0,0,7
1436514,1107020,2021-08-26,Senate,"Do pass as amended",7,0,0,0,7
1436516,1066776,2021-04-29,Assembly,"Do pass and be re-referred to the Committee on [Appropriations] with recommendation: To Consent Calendar",13,0,0,0,13
1436516,1081606,2021-05-20,Assembly,"Do pass",16,0,0,0,16
1436516,1092967,2021-06-01,Assembly,"AB 404 Salas Assembly Third Reading",79,0,0,0,79
1436516,1100271,2021-06-21,Senate,"Do pass, but first be re-referred to the Committee on [Appropriations] with the recommendation: To Consent Calendar",5,0,0,0,5
1436516,1104151,2021-07-05,Senate,"Placed on suspense file",6,0,1,0,7
1436519,1065129,2021-04-27,Assembly,"Do pass and be re-referred to the Committee on [Appropriations]",19,0,0,0,19
1436519,1073376,2021-05-05,Assembly,"Do pass. To Consent Calendar",16,0,0,0,16
1436519,1077586,2021-05-13,Assembly,"AB 407 Salas Consent Calendar Second Day Regular Session",75,0,3,0,78
1436519,1104889,2021-07-14,Senate,"Do pass, but first be re-referred to the Committee on [Appropriations]",13,0,1,0,14
1436519,1108033,2021-09-08,Senate,"Assembly 3rd Reading AB407 Salas et al. By Roth",38,0,0,2,40
1436519,1108507,2021-09-10,Assembly,"With recommendation: That Senate amendments be concurred in",18,0,0,1,19
1436519,1108525,2021-09-10,Assembly,"AB 407 Salas Concurrence in Senate Amendments",78,0,0,2,80
1436520,1123750,2022-01-12,Assembly,"Do pass and be re-referred to the Committee on [Appropriations]",6,0,0,1,7
1436520,1126318,2022-01-20,Assembly,"Do pass",15,0,0,1,16
1436520,1129901,2022-01-27,Assembly,"AB 408 Quirk-Silva Assembly Third Reading",67,0,0,9,76
1436520,1214986,2022-06-08,Senate,"Do pass, but first be re-referred to the Committee on [Appropriations] with the recommendation: To Consent Calendar",7,0,0,0,7
1436520,1222828,2022-08-01,Senate,"Placed on suspense file",7,0,0,0,7
1436520,1223441,2022-08-11,Senate,"Do pass",7,0,0,0,7
1436520,1224583,2022-08-23,Senate,"Special Consent AB408",40,0,0,0,40
1436520,1224818,2022-08-24,Assembly,"AB 408 Quirk-Silva Concurrence in Senate Amendments",76,0,0,4,80
1436521,1036449,2021-03-23,Assembly,"Do pass and be re-referred to the Committee on [Judiciary]",7,0,1,0,8
1436521,1046108,2021-04-06,Assembly,"Do pass as amended and be re-referred to the Committee on [Appropriations]",10,0,1,0,11
1436523,1029590,2021-03-15,Assembly,"Do pass and be re-referred to the Committee on [Military and Veterans Affairs]",8,0,0,0,8
1436523,1065186,2021-04-28,Assembly,"Do pass and be re-referred to the Committee on [Appropriations] with recommendation: To Consent Calendar",11,0,0,0,11
1436523,1126334,2022-01-20,Assembly,"Do pass as amended",12,0,0,4,16
1436523,1131257,2022-01-31,Assembly,"AB 411 Irwin Assembly Third Reading",76,0,0,0,76
1436523,1211853,2022-05-31,Senate,"Do pass, but first be re-referred to the Committee on [Governance and Finance]",8,0,0,1,9
1436523,1216399,2022-06-15,Senate,"Do pass, but first be re-referred to the Committee on [Appropriations]",5,0,0,0,5
1436523,1219366,2022-06-27,Senate,"Placed on suspense file",6,0,0,1,7
1436524,1065251,2021-04-28,Assembly,"Do pass as amended and be re-referred to the Committee on [Appropriations]",7,0,0,0,7
1436524,1081858,2021-05-20,Assembly,"Do pass",15,1,0,0,16
1436524,1087004,2021-05-27,Assembly,"AB 412 Reyes Assembly Third Reading",70,0,8,0,78
1436524,1100274,2021-06-22,Senate,"Do pass as amended, but first amend, and re-refer to the Committee on [Judiciary]",10,4,1,0,15
1436524,1104425,2021-07-06,Senate,"Do pass, but first be re-referred to the Committee on [Appropriations]",9,2,0,0,11
1436524,1106120,2021-08-16,Senate,"Placed on suspense file",7,0,0,0,7
1436524,1106999,2021-08-26,Senate,"Do pass as amended",5,2,0,0,7
1436524,1107379,2021-09-01,Senate,"Assembly 3rd Reading AB412 Reyes et al. By Becker",31,7,0,2,40
1436524,1107723,2021-09-02,Assembly,"AB 412 Reyes Concurrence in Senate Amendments",68,0,0,11,79
1436525,1029586,2021-03-15,Assembly,"Do pass as amended and be re-referred to the Committee on [Human Services]",8,0,0,0,8
1436525,1047460,2021-04-07,Assembly,"Do pass and be re-referred to the Committee on [Appropriations] with recommendation: To Consent Calendar",8,0,0,0,8
1436526,1054721,2021-04-14,Assembly,"Do pass. To Consent Calendar",8,0,0,0,8
1436526,1060836,2021-04-22,Assembly,"AB 414 Maienschein Consent Calendar Second Day Regular Session",77,0,2,0,79
1436526,1095030,2021-06-08,Senate,"Do pass, but first be re-referred to the Committee on [Governance and Finance] with the recommendation: To Consent Calendar",11,0,0,0,11
1436526,1103760,2021-07-01,Senate,"Do pass and be ordered to the Consent Calendar",5,0,0,0,5
1436526,1104589,2021-07-12,Senate,"Consent Calendar AB414",39,0,1,0,40
1436529,1035258,2021-03-23,Senate,"Do pass, but first be re-referred to the Committee on [Appropriations] with the recommendation: To Consent Calendar",5,0,0,0,5
1436529,1044994,2021-04-05,Senate,"Placed on suspense file",7,0,0,0,7
1436529,1081808,2021-05-20,Senate,"Do pass as amended",7,0,0,0,7
1436529,1089506,2021-06-01,Senate,"Senate 3rd Reading SB296 Lim贸n",40,0,0,0,40
1436529,1102843,2021-06-29,Assembly,"Do pass and be re-referred to the Committee on [Appropriations] with recommendation: To Consent Calendar",8,0,0,0,8
1436529,1106620,2021-08-26,Assembly,"Do pass",16,0,0,0,16
1436529,1107402,2021-09-01,Assembly,"SB 296 Lim贸n Senate Third Reading By Jones-Sawyer",78,0,0,1,79
1436530,1023840,2021-03-08,Senate,"Do pass as amended, but first amend, and re-refer to the Committee on [Judiciary]",14,0,0,0,14
1436530,1035264,2021-03-23,Senate,"Do pass as amended, but first amend, and re-refer to the Committee on [Appropriations]",11,0,0,0,11
1436530,1068229,2021-05-03,Senate,"Senate 3rd Reading SB297 Durazo",36,0,4,0,40
1436530,1095023,2021-06-08,Assembly,"Do pass and be re-referred to the Committee on [Appropriations]",9,0,2,0,11
1436530,1103417,2021-06-30,Assembly,"Do pass",13,0,3,0,16
1436530,1106392,2021-08-23,Assembly,"SB 297 Durazo Senate Third Reading By Levine",65,0,0,14,79
1436530,1107123,2021-08-30,Senate,"Unfinished Business SB297 Durazo Concurrence",39,0,0,1,40
1436531,1025093,2021-03-09,Senate,"Do pass as amended, but first amend, and re-refer to the Committee on [Appropriations]",13,0,1,0,14
1436531,1062753,2021-04-26,Senate,"Senate 3rd Reading SB298 Dodd",38,0,2,0,40
1436531,1210216,2022-05-27,Assembly,"Be re-referred to the Committee on [Governmental Organization]",7,0,0,4,11
1436531,1218044,2022-06-22,Assembly,"Do pass as amended and be re-referred to the Committee on [Appropriations]",20,0,0,2,22
1436531,1223633,2022-08-11,Assembly,"Do pass as amended",12,0,0,4,16
1436531,1224203,2022-08-18,Assembly,"SB 298 Dodd Senate Third Reading By Aguiar-Curry",76,0,0,4,80
1436531,1224350,2022-08-22,Senate,"Unfinished Business SB298 Dodd Concurrence",39,0,0,1,40
1436532,1051970,2021-04-13,Senate,"Do pass, but first be re-referred to the Committee on [Appropriations]",5,0,0,0,5
1436532,1068155,2021-05-03,Senate,"Placed on suspense file",6,0,1,0,7
1436532,1081521,2021-05-20,Senate,"Do pass as amended",5,2,0,0,7
1436532,1090442,2021-06-02,Senate,"Senate 3rd Reading SB299 Leyva et al",32,6,2,0,40
1436532,1102857,2021-06-29,Assembly,"Do pass as amended and be re-referred to the Committee on [Appropriations]",6,2,0,0,8
1436532,1106689,2021-08-26,Assembly,"Do pass as amended",12,4,0,0,16
1436533,1046111,2021-04-06,Senate,"Do pass, but first be re-referred to the Committee on [Appropriations]",4,0,1,0,5
1436533,1056426,2021-04-19,Senate,"Placed on suspense file",7,0,0,0,7
1436533,1081831,2021-05-20,Senate,"Do pass as amended",5,2,0,0,7
1436533,1105119,2021-07-15,Senate,"Senate 3rd Reading SB300 Cortese et al. Urgency Clause",27,8,5,0,40
1436533,1211849,2022-06-01,Assembly,"Do pass and be re-referred to the Committee on [Appropriations]",5,2,0,0,7
1436533,1224053,2022-08-11,Assembly,"Do pass",12,4,0,0,16
1436534,1123772,2022-01-12,Senate,"Do pass as amended, but first amend, and re-refer to the Committee on [Appropriations]",9,0,0,2,11
1436534,1124817,2022-01-18,Senate,"Placed on suspense file",6,0,0,1,7
1436534,1126335,2022-01-20,Senate,"Do pass",7,0,0,0,7
1436534,1127183,2022-01-24,Senate,"Senate 3rd Reading SB301 Skinner",34,0,0,6,40
1436534,1215755,2022-06-14,Assembly,"Do pass as amended and be re-referred to the Committee on [Judiciary]",9,0,0,2,11
1436534,1217465,2022-06-21,Assembly,"Do pass as amended, and be re-referred to the Committee on [Appropriations] with recommendation: To Consent Calendar",10,0,0,0,10
1436534,1223574,2022-08-11,Assembly,"Do pass",16,0,0,0,16
1436534,1224255,2022-08-22,Assembly,"SB 301 Skinner Senate Third Reading By Aguiar-Curry",77,0,0,3,80
1436534,1224666,2022-08-24,Senate,"Unfinished Business SB301 Skinner et al. Concurrence",40,0,0,0,40
1436535,1025095,2021-03-09,Senate,"Do pass, but first be re-referred to the Committee on [Appropriations] with the recommendation: To Consent Calendar",14,0,0,0,14
1436535,1037801,2021-03-25,Senate,"Consent Calendar SB302 G.O",38,0,2,0,40
1436535,1102819,2021-06-29,Assembly,"Do pass and be re-referred to the Committee on [Appropriations] with recommendation: To Consent Calendar",21,0,1,0,22
1436535,1107022,2021-08-26,Assembly,"Do pass. To Consent Calendar",16,0,0,0,16
1436535,1108105,2021-09-08,Assembly,"SB 302 Dodd Third Reading Urgency By Bigelow",80,0,0,0,80
1436535,1108448,2021-09-09,Senate,"Unfinished Business SB302 Dodd et al. Urgency Clause Concurrence",38,0,0,2,40
1436536,1027173,2021-03-11,Senate,"Do pass, but first be re-referred to the Committee on [Appropriations]",5,0,0,0,5
1436536,1066695,2021-04-29,Senate,"Senate 3rd Reading SB303 Borgeas et al",36,0,4,0,40
1436536,1100259,2021-06-21,Assembly,"Do pass and be re-referred to the Committee on [Appropriations]",10,0,1,0,11
1436536,1106862,2021-08-26,Assembly,"Do pass as amended",16,0,0,0,16
1436536,1107714,2021-09-02,Assembly,"SB 303 Borgeas Senate Third Reading By Bigelow",77,0,0,2,79
1436536,1107766,2021-09-03,Senate,"Unfinished Business SB303 Borgeas et al. Concurrence",38,0,0,2,40
1436537,1033627,2021-03-22,Senate,"Do pass as amended, but first amend, and re-refer to the Committee on [Appropriations]",8,0,6,0,14
1436538,1028421,2021-03-15,Senate,"Do pass, but first be re-referred to the Committee on [Appropriations] with the recommendation: To Consent Calendar",5,0,0,0,5
1436538,1033669,2021-03-22,Senate,"Placed on suspense file",7,0,0,0,7
1436539,1007232,2021-02-16,Senate,"Senate 3rd Reading SCR10 Bradford et al",33,0,6,0,39
1436539,1016176,2021-02-25,Assembly,"Be adopted. To Consent Calendar",11,0,1,0,12
1436539,1022325,2021-03-04,Assembly,"SCR 10 Bradford Consent Calendar Second Day Regular Session",72,0,7,0,79
1438433,1065290,2021-04-28,Assembly,"Do pass and be re-referred to the Committee on [Appropriations]",4,3,0,0,7
1438433,1081568,2021-05-20,Assembly,"Do pass as amended",12,4,0,0,16
1438433,1090465,2021-06-02,Assembly,"AB 416 Kalra Assembly Third Reading",49,19,11,0,79
1438433,1104285,2021-07-06,Senate,"Do pass as amended, but first amend, and re-refer to the Committee on [Appropriations]",11,4,0,0,15
1438433,1106138,2021-08-16,Senate,"Placed on suspense file",7,0,0,0,7
1438433,1106992,2021-08-26,Senate,"Do pass",5,2,0,0,7
1438433,1108003,2021-09-08,Senate,"Assembly 3rd Reading AB416 Kalra et al. By Allen",30,8,0,2,40
1438433,1108279,2021-09-09,Assembly,"AB 416 Kalra Concurrence in Senate Amendments",54,21,0,5,80
1438434,1036497,2021-03-24,Assembly,"Do pass and be re-referred to the Committee on [Appropriations]",12,0,0,0,12
1438434,1081762,2021-05-20,Assembly,"Do pass",16,0,0,0,16
1438434,1087091,2021-05-27,Assembly,"AB 417 McCarty Assembly Third Reading",78,0,0,0,78
1438434,1104405,2021-07-07,Senate,"Do pass, but first be re-referred to the Committee on [Appropriations]",7,0,0,0,7
1438434,1106056,2021-08-16,Senate,"Placed on suspense file",7,0,0,0,7
1438434,1106955,2021-08-26,Senate,"Do pass",7,0,0,0,7
1438434,1107824,2021-09-03,Senate,"Special Consent AB417",37,0,0,3,40
1438435,1046128,2021-04-05,Assembly,"Do pass as amended and be re-referred to the Committee on [Utilities and Energy]",7,0,0,0,7
1438435,1081489,2021-05-20,Assembly,"Do pass as amended",16,0,0,0,16
1438435,1092872,2021-06-01,Assembly,"AB 418 Valladares Assembly Third Reading",79,0,0,0,79
1438435,1100270,2021-06-22,Senate,"Do pass, but first be re-referred to the Committee on [Appropriations] with the recommendation: To Consent Calendar",15,0,0,0,15
1438435,1104199,2021-07-05,Senate,"Placed on suspense file",6,0,1,0,7
1438435,1106952,2021-08-26,Senate,"Do pass",7,0,0,0,7
1438435,1107783,2021-09-03,Senate,"Special Consent AB418",37,0,0,3,40
1438436,1036544,2021-03-23,Assembly,"Do pass as amended",8,0,0,0,8
1438436,1053421,2021-04-12,Assembly,"AB 419 Davies Assembly Third Reading",74,0,4,0,78
1438436,1100255,2021-06-22,Senate,"Do pass",5,0,0,0,5
1438436,1104161,2021-07-05,Senate,"Special Consent AB419",38,0,2,0,40
1438438,1036413,2021-03-24,Assembly,"Do pass and be re-referred to the Committee on [Appropriations]",12,0,0,0,12
1438438,1082056,2021-05-20,Assembly,"Do pass as amended",16,0,0,0,16
1438438,1092948,2021-06-01,Assembly,"AB 421 Ward Assembly Third Reading",79,0,0,0,79
1438438,1098658,2021-06-16,Senate,"Do pass, but first be re-referred to the Committee on [Appropriations] with the recommendation: To Consent Calendar",7,0,0,0,7
1438438,1104190,2021-07-05,Senate,"Placed on suspense file",6,0,1,0,7
1438438,1106799,2021-08-26,Senate,"Do pass",7,0,0,0,7
1438438,1210892,2022-05-31,Senate,"Do pass as amended",8,0,0,3,11
1438438,1215280,2022-06-09,Senate,"Assembly 3rd Reading AB421 Ward By Laird Urgency Clause",29,8,0,3,40
1438438,1215828,2022-06-14,Assembly,"With recommendation: That Senate amendments be concurred in",9,1,0,1,11
1438438,1217093,2022-06-20,Assembly,"AB 421 Ward Concurrence - Urgency Added",57,1,0,22,80
1438441,1054646,2021-04-15,Assembly,"Do pass and be re-referred to the Committee on [Judiciary]",9,3,0,0,12
1438441,1057632,2021-04-20,Assembly,"Do pass as amended and be re-referred to the Committee on [Appropriations]",8,2,1,0,11
1438441,1081523,2021-05-20,Assembly,"Do pass",12,4,0,0,16
1438441,1086955,2021-05-27,Assembly,"AB 424 Stone Assembly Third Reading",56,20,2,0,78
1438441,1100822,2021-06-23,Senate,"Do pass, but first be re-referred to the Committee on [Judiciary]",7,2,0,0,9
1438441,1104406,2021-07-06,Senate,"Do pass as amended, but first amend, and re-refer to the Committee on [Appropriations]",9,2,0,0,11
1438441,1106212,2021-08-16,Senate,"Placed on suspense file",7,0,0,0,7
1438441,1106560,2021-08-26,Senate,"Do pass as amended",5,2,0,0,7
1438441,1107535,2021-09-01,Senate,"Assembly 3rd Reading AB424 Stone et al. By Wieckowski",31,8,0,1,40
1438441,1107628,2021-09-02,Assembly,"AB 424 Stone Concurrence in Senate Amendments",56,18,0,5,79
1438442,1054624,2021-04-15,Assembly,"Do pass and be re-referred to the Committee on [Appropriations] with recommendation: To Consent Calendar",11,0,0,0,11
1438442,1073337,2021-05-05,Assembly,"Do pass. To Consent Calendar",16,0,0,0,16
1438442,1077607,2021-05-13,Assembly,"AB 425 Mathis Consent Calendar Second Day Regular Session",75,0,3,0,78
1438442,1099174,2021-06-17,Senate,"Do pass, but first be re-referred to the Committee on [Appropriations] with the recommendation: To Consent Calendar",4,0,1,0,5
1438442,1107256,2021-08-30,Senate,"Consent Calendar AB425",39,0,0,1,40
1438444,1059239,2021-04-21,Assembly,"Do pass as amended and be re-referred to the Committee on [Appropriations]",11,2,2,0,15
1438445,1054652,2021-04-14,Assembly,"Do pass and be re-referred to the Committee on [Elections]",7,1,0,0,8
1438445,1066760,2021-04-29,Assembly,"Do pass",6,0,1,0,7
1438445,1077534,2021-05-13,Assembly,"AB 428 Mayes Assembly Third Reading",48,11,19,0,78
1438445,1103826,2021-07-01,Senate,"Do pass, but first be re-referred to the Committee on [Elections and Constitutional Amendments]",4,1,0,0,5
1438445,1104665,2021-07-12,Senate,"Do pass as amended",3,2,0,0,5
1438445,1107135,2021-08-30,Senate,"Assembly 3rd Reading AB428 Mayes By Hertzberg",29,8,0,3,40
1438445,1107407,2021-09-01,Assembly,"AB 428 Mayes Concurrence in Senate Amendments",58,11,0,10,79
1438446,1035157,2021-03-23,Assembly,"Do pass and be re-referred to the Committee on [Appropriations] with recommendation: To Consent Calendar",11,0,0,0,11
1438446,1053526,2021-04-14,Assembly,"Do pass. To Consent Calendar",16,0,0,0,16
1438446,1060909,2021-04-22,Assembly,"AB 429 Megan Dahle Consent Calendar Second Day Regular Session",77,0,2,0,79
1438446,1095053,2021-06-08,Senate,"Do pass, but first be re-referred to the Committee on [Appropriations] with the recommendation: To Consent Calendar",11,0,0,0,11
1438446,1101687,2021-06-24,Senate,"Consent Calendar AB429",39,0,1,0,40
1438447,1054597,2021-04-15,Assembly,"Do pass and be re-referred to the Committee on [Judiciary] with recommendation: To Consent Calendar",12,0,0,0,12
1438447,1057635,2021-04-20,Assembly,"Do pass as amended. To Consent Calendar",10,0,1,0,11
1438447,1066708,2021-04-29,Assembly,"AB 430 Grayson Consent Calendar Second Day",77,0,1,0,78
1438447,1096084,2021-06-09,Senate,"Do pass, but first be re-referred to the Committee on [Judiciary] with the recommendation: To Consent Calendar",9,0,0,0,9
1438447,1100837,2021-06-22,Senate,"Do pass as amended, but first amend, and re-refer to the Committee on [Appropriations] with the recommendation: To Consent Calendar",11,0,0,0,11
1438447,1105064,2021-07-15,Senate,"Placed on suspense file",7,0,0,0,7
1438447,1106943,2021-08-26,Senate,"Do pass",7,0,0,0,7
1438447,1107812,2021-09-03,Senate,"Special Consent AB430",37,0,0,3,40
1438447,1107913,2021-09-07,Assembly,"AB 430 Grayson Concurrence in Senate Amendments",72,0,0,8,80
1438448,1036467,2021-03-24,Assembly,"Do pass and be re-referred to the Committee on [Appropriations] with recommendation: To Consent Calendar",11,0,0,0,11
1438448,1053435,2021-04-14,Assembly,"Do pass. To Consent Calendar",16,0,0,0,16
1438448,1060844,2021-04-22,Assembly,"AB 431 Patterson Consent Calendar Second Day Regular Session",77,0,2,0,79
1438448,1102844,2021-06-29,Senate,"Do pass, but first be re-referred to the Committee on [Appropriations] with the recommendation: To Consent Calendar",9,0,0,0,9
1438448,1107207,2021-08-30,Senate,"Consent Calendar AB431",39,0,0,1,40
1438452,1046194,2021-04-06,Assembly,"Do pass and be re-referred to the Committee on [Appropriations] with recommendation: To Consent Calendar",18,0,1,0,19
1438452,1053441,2021-04-14,Assembly,"Do pass. To Consent Calendar",16,0,0,0,16
1438452,1061002,2021-04-22,Assembly,"AB 435 Mullin Consent Calendar Second Day Regular Session",77,0,2,0,79
1438452,1099765,2021-06-21,Senate,"Do pass, but first be re-referred to the Committee on [Appropriations] with the recommendation: To Consent Calendar",11,0,3,0,14
1438452,1107187,2021-08-30,Senate,"Consent Calendar AB435",39,0,0,1,40
1438454,1036537,2021-03-24,Assembly,"Do pass and be re-referred to the Committee on [Appropriations] with recommendation: To Consent Calendar",7,0,0,0,7
1438454,1081428,2021-05-20,Assembly,"Do pass",16,0,0,0,16
1438454,1087048,2021-05-27,Assembly,"AB 437 Kalra Assembly Third Reading",78,0,0,0,78
1438454,1218594,2022-06-22,Senate,"Do pass, but first be re-referred to the Committee on [Judiciary]",4,0,0,1,5
1438454,1220728,2022-06-28,Senate,"Do pass as amended, but first amend, and re-refer to the Committee on [Appropriations]",9,1,0,1,11
1438454,1223277,2022-08-08,Senate,"Placed on suspense file",7,0,0,0,7
1438454,1223958,2022-08-11,Senate,"Do pass as amended",4,2,0,1,7
1438455,1054722,2021-04-15,Assembly,"Do pass and be re-referred to the Committee on [Appropriations]",6,1,0,0,7
1438455,1081733,2021-05-20,Assembly,"Do pass",12,4,0,0,16
1438455,1086962,2021-05-27,Assembly,"AB 438 Reyes Assembly Third Reading",57,14,7,0,78
1438455,1104162,2021-07-05,Senate,"Do pass, but first be re-referred to the Committee on [Appropriations]",4,1,0,0,5
1438455,1105058,2021-07-15,Senate,"Placed on suspense file",7,0,0,0,7
1438455,1106967,2021-08-26,Senate,"Do pass as amended",5,2,0,0,7
1438455,1107881,2021-09-07,Senate,"Assembly 3rd Reading AB438 Reyes et al. By Hertzberg",26,8,0,6,40
1438455,1108175,2021-09-08,Assembly,"AB 438 Reyes Concurrence in Senate Amendments",56,16,0,8,80
1438456,1046211,2021-04-06,Assembly,"Do pass",13,1,1,0,15
1438456,1056489,2021-04-19,Assembly,"AB 439 Bauer-Kahan Assembly Third Reading",65,2,12,0,79
1438456,1097072,2021-06-10,Senate,"Do pass",9,1,1,0,11
1438456,1099746,2021-06-21,Senate,"Assembly 3rd Reading AB439 Bauer-Kahan et al. By Wiener",32,6,2,0,40
1438456,1101673,2021-06-24,Assembly,"AB 439 Bauer-Kahan Concurrence in Senate Amendments",63,0,16,0,79
1438457,1047544,2021-04-07,Assembly,"Do pass and be re-referred to the Committee on [Appropriations] with recommendation: To Consent Calendar",9,0,0,0,9
1438457,1053510,2021-04-14,Assembly,"Do pass. To Consent Calendar",16,0,0,0,16
1438457,1060922,2021-04-22,Assembly,"AB 440 Bigelow Consent Calendar Second Day Regular Session",77,0,2,0,79
1438457,1097794,2021-06-14,Senate,"Do pass, but first be re-referred to the Committee on [Appropriations] with the recommendation: To Consent Calendar",7,0,0,0,7
1438457,1101638,2021-06-24,Senate,"Consent Calendar AB440",39,0,1,0,40
1438458,1046116,2021-04-06,Assembly,"Do pass as amended and be re-referred to the Committee on [Appropriations]",15,0,0,0,15
1438458,1059161,2021-04-21,Assembly,"Do pass. To Consent Calendar",14,0,2,0,16
1438458,1066681,2021-04-29,Assembly,"AB 441 Mayes Consent Calendar Second Day Regular Session",77,0,1,0,78
1438458,1104461,2021-07-07,Senate,"Do pass, but first be re-referred to the Committee on [Appropriations]",9,0,2,0,11
1438458,1106083,2021-08-16,Senate,"Placed on suspense file",7,0,0,0,7
1438459,1036426,2021-03-24,Assembly,"Do pass and be re-referred to the Committee on [Water, Parks, and Wildlife] with recommendation: To Consent Calendar",11,0,0,0,11
1438459,1064008,2021-04-26,Assembly,"Do pass and be re-referred to the Committee on [Appropriations] with recommendation: To Consent Calendar",15,0,0,0,15
1438459,1073356,2021-05-05,Assembly,"Do pass as amended. To Consent Calendar",16,0,0,0,16
1438459,1087053,2021-05-27,Assembly,"AB 442 Mayes Consent Calendar Second Day",75,0,3,0,78
1438459,1104559,2021-07-08,Senate,"Do pass as amended, but first amend, and re-refer to the Committee on [Appropriations]",8,0,1,0,9
1438459,1107394,2021-09-01,Senate,"Assembly 3rd Reading AB442 Mayes By Roth",39,0,0,1,40
1438459,1107582,2021-09-02,Assembly,"AB 442 Mayes Concurrence in Senate Amendments",77,0,0,2,79
1438460,1065112,2021-04-27,Assembly,"Do pass and be re-referred to the Committee on [Appropriations] with recommendation: To Consent Calendar",19,0,0,0,19
1438460,1076946,2021-05-12,Assembly,"Do pass",16,0,0,0,16
1438460,1087016,2021-05-27,Assembly,"AB 443 Carrillo Assembly Third Reading",77,0,1,0,78
1438461,1005309,2021-02-12,Assembly,"Be adopted. To third reading",11,0,1,0,12
1438461,1037844,2021-03-25,Senate,"Special Consent ACR20",38,0,2,0,40
1438462,1044969,2021-04-05,Assembly,"Be adopted. To Consent Calendar",14,0,1,0,15
1438462,1048954,2021-04-08,Assembly,"ACR 21 Megan Dahle Consent Calendar Second Day Regular Session",74,0,4,0,78
1438462,1102806,2021-06-29,Senate,"Be adopted, but first be re-referred to the Committee on [Appropriations] with recommendation: To Consent Calendar",17,0,0,0,17
1438462,1107196,2021-08-30,Senate,"Consent Calendar ACR21",39,0,0,1,40
1438463,1022314,2021-03-04,Assembly,"Be adopted. To Consent Calendar",11,0,1,0,12
1438463,1050773,2021-04-12,Senate,"Assembly 3rd Reading ACR22 Boerner Horvath",39,0,1,0,40
1438465,1060863,2021-04-22,Assembly,"Be adopted. To third reading",12,0,0,0,12
1438466,1047561,2021-04-07,Senate,"Do pass, but first be re-referred to the Committee on [Business, Professions and Economic Development]",9,1,1,0,11
1438466,1056360,2021-04-19,Senate,"Do pass, but first be re-referred to the Committee on [Appropriations]",10,3,1,0,14
1438466,1075344,2021-05-10,Senate,"Placed on suspense file",7,0,0,0,7
1438466,1082197,2021-05-20,Senate,"Do pass as amended",5,2,0,0,7
1438466,1090472,2021-06-02,Senate,"Senate 3rd Reading SB306 Pan et al",31,7,2,0,40
1438466,1100833,2021-06-22,Assembly,"Do pass and be re-referred to the Committee on [Business and Professions]",12,2,1,0,15
1438466,1104309,2021-07-06,Assembly,"Do pass and be re-referred to the Committee on [Appropriations]",16,2,1,0,19
1438466,1106929,2021-08-26,Assembly,"Do pass as amended",13,3,0,0,16
1438466,1108543,2021-09-10,Senate,"Unfinished Business SB306 Pan et al. Concurrence",28,9,0,3,40
1438466,1108544,2021-09-10,Assembly,"SB 306 Pan Senate Third Reading By Low",61,9,0,10,80
1438467,1120216,2022-01-04,Senate,"Do pass, but first be re-referred to the Committee on [Appropriations]",11,0,0,6,17
1438467,1127169,2022-01-24,Senate,"Senate 3rd Reading SB307 McGuire et al",33,2,0,5,40
1438467,1215547,2022-06-13,Assembly,"Do pass and be re-referred to the Committee on [Appropriations]",13,0,0,2,15
1438467,1223323,2022-08-10,Assembly,"Do pass",13,0,0,3,16
1438467,1226005,2022-08-30,Senate,"Unfinished Business SB307 McGuire et al. Concurrence",35,1,0,4,40
1438467,1226006,2022-08-30,Assembly,"SB 307 McGuire Senate Third Reading By Wood",67,0,0,13,80
1438468,1025099,2021-03-09,Senate,"Do pass, but first be re-referred to the Committee on [Appropriations] with the recommendation: To Consent Calendar",11,0,0,0,11
1438468,1037815,2021-03-25,Senate,"Consent Calendar SB308",38,0,2,0,40
1438468,1095025,2021-06-08,Assembly,"Do pass and be re-referred to the Committee on [Appropriations] with recommendation: To Consent Calendar",11,0,0,0,11
1438468,1103495,2021-06-30,Assembly,"Do pass. To Consent Calendar",14,0,2,0,16
1438468,1104553,2021-07-08,Assembly,"SB 308 Min Consent Calendar Second Day Regular Session",76,0,3,0,79
1438469,1026106,2021-03-10,Senate,"Do pass, but first be re-referred to the Committee on [Appropriations]",5,0,2,0,7
1438469,1033686,2021-03-22,Senate,"Placed on suspense file",7,0,0,0,7
1438469,1081589,2021-05-20,Senate,"Do pass as amended",5,1,1,0,7
1438469,1087602,2021-05-28,Senate,"Senate 3rd Reading SB309 Leyva et al",31,3,6,0,40
1438470,1023852,2021-03-08,Senate,"Do pass, but first be re-referred to the Committee on [Judiciary]",14,0,0,0,14
1438470,1047447,2021-04-06,Senate,"Do pass as amended, but first amend, and re-refer to the Committee on [Appropriations] with the recommendation: To Consent Calendar",11,0,0,0,11
1438470,1056416,2021-04-19,Senate,"Placed on suspense file",7,0,0,0,7
1438470,1082141,2021-05-20,Senate,"Do pass as amended",7,0,0,0,7
1438470,1089536,2021-06-01,Senate,"Senate 3rd Reading SB310 Rubio et al",40,0,0,0,40
1438470,1100303,2021-06-22,Assembly,"Do pass and be re-referred to the Committee on [Health]",19,0,0,0,19
1438470,1104717,2021-07-13,Assembly,"Do pass as amended and be re-referred to the Committee on [Appropriations]",13,0,2,0,15
1438470,1106886,2021-08-26,Assembly,"Do pass as amended",15,0,0,1,16
1438470,1108112,2021-09-08,Assembly,"SB 310 Rubio Senate Third Reading By Burke",79,0,0,1,80
1438470,1108566,2021-09-10,Senate,"Unfinished Business SB310 Rubio et al. Concurrence",37,0,0,3,40
1438471,1026097,2021-03-10,Senate,"Do pass",11,0,0,0,11
1438471,1033687,2021-03-22,Senate,"Senate 3rd Reading SB311 Hueso et al",36,0,4,0,40
1438471,1095060,2021-06-08,Assembly,"Do pass",15,0,0,0,15
1438471,1107444,2021-09-01,Assembly,"SB 311 Hueso Senate Third Reading By Wood Amendment Set #1",67,1,0,11,79
1438471,1108311,2021-09-09,Assembly,"SB 311 Hueso Senate Third Reading By Wood",71,1,0,8,80
1438471,1108549,2021-09-10,Senate,"Unfinished Business SB311 Hueso et al. Concurrence",36,1,0,3,40
1438474,1057751,2021-04-20,Senate,"Do pass, but first be re-referred to the Committee on [Appropriations]",15,0,0,0,15
1438474,1068204,2021-05-03,Senate,"Placed on suspense file",6,0,1,0,7
1438474,1081743,2021-05-20,Senate,"Do pass",7,0,0,0,7
1438474,1089511,2021-06-01,Senate,"Special Consent SB314 Wiener et al. Urgency Clause",39,0,1,0,40
1438474,1104778,2021-07-12,Assembly,"Do pass and be re-referred to the Committee on [Appropriations]",22,0,0,0,22
1438474,1106647,2021-08-26,Assembly,"Do pass as amended",13,0,0,3,16
1438474,1107625,2021-09-02,Assembly,"SB 314 Wiener Third Reading Urgency By Gabriel",76,0,0,3,79
1438474,1107835,2021-09-03,Senate,"Unfinished Business SB314 Wiener et al. Urgency Clause Concurrence",37,0,0,3,40
1438475,1047537,2021-04-06,Senate,"Do pass, but first be re-referred to the Committee on [Appropriations]",10,0,1,0,11
1438475,1056378,2021-04-19,Senate,"Placed on suspense file",7,0,0,0,7
1438475,1081912,2021-05-20,Senate,"Do pass",7,0,0,0,7
1438475,1086123,2021-05-26,Senate,"Senate 3rd Reading SB315 Roth",40,0,0,0,40
1438475,1100231,2021-06-22,Assembly,"Do pass and be re-referred to the Committee on [Appropriations]",11,0,0,0,11
1438475,1103479,2021-06-30,Assembly,"Do pass. To Consent Calendar",14,0,2,0,16
1438475,1107433,2021-09-01,Assembly,"SB 315 Roth Senate Third Reading By Chau",77,0,0,2,79
1438475,1107579,2021-09-02,Senate,"Unfinished Business SB315 Roth Concurrence",39,0,0,1,40
1438476,1026117,2021-03-10,Senate,"Do pass, but first be re-referred to the Committee on [Appropriations] with the recommendation: To Consent Calendar",11,0,0,0,11
1438476,1033679,2021-03-22,Senate,"Placed on suspense file",7,0,0,0,7
1438476,1081731,2021-05-20,Senate,"Do pass",7,0,0,0,7
1438476,1089465,2021-06-01,Senate,"Special Consent SB316",39,0,1,0,40
1438476,1100784,2021-06-22,Assembly,"Do pass and be re-referred to the Committee on [Appropriations] with recommendation: To Consent Calendar",15,0,0,0,15
1438476,1106905,2021-08-26,Assembly,"Do pass",16,0,0,0,16
1438477,1064032,2021-04-27,Senate,"Do pass as amended, but first amend, and re-refer to the Committee on [Appropriations]",5,0,0,0,5
1438477,1087597,2021-05-28,Senate,"Senate 3rd Reading SB317 Stern",32,5,3,0,40
1438477,1102854,2021-06-29,Assembly,"Do pass and be re-referred to the Committee on [Appropriations]",7,0,1,0,8
1438477,1106338,2021-08-19,Assembly,"Do pass",16,0,0,0,16
1438477,1107951,2021-09-07,Assembly,"SB 317 Stern Senate Third Reading By Santiago",65,0,0,15,80
1438477,1108179,2021-09-08,Senate,"Unfinished Business SB317 Stern By Wiener Concurrence",32,5,0,3,40
1438479,1048988,2021-04-08,Senate,"Do pass",5,0,0,0,5
1438479,1068200,2021-05-03,Senate,"Senate 3rd Reading SB319 Melendez",36,0,4,0,40
1438479,1101604,2021-06-23,Assembly,"Do pass",8,0,0,0,8
1438479,1106394,2021-08-23,Assembly,"SB 319 Melendez Senate Third Reading By Aguiar-Curry",71,0,0,8,79
1438480,1025125,2021-03-09,Senate,"Do pass, but first be re-referred to the Committee on [Judiciary]",4,0,0,0,4
1438480,1035173,2021-03-23,Senate,"Do pass as amended, but first amend, and re-refer to the Committee on [Appropriations] with the recommendation: To Consent Calendar",11,0,0,0,11
1438480,1056421,2021-04-19,Senate,"Placed on suspense file",7,0,0,0,7
1438480,1081667,2021-05-20,Senate,"Do pass",7,0,0,0,7
1438480,1089476,2021-06-01,Senate,"Special Consent SB320",39,0,1,0,40
1438480,1102832,2021-06-29,Assembly,"Do pass and be re-referred to the Committee on [Judiciary] with recommendation: To Consent Calendar",8,0,0,0,8
1438480,1104265,2021-07-06,Assembly,"Do pass as amended and be re-referred to the Committee on [Appropriations]",10,0,1,0,11
1438480,1106303,2021-08-19,Assembly,"Do pass. To Consent Calendar",16,0,0,0,16
1438480,1108222,2021-09-09,Assembly,"SB 320 Eggman Senate Third Reading By Blanca Rubio",79,0,0,1,80
1438480,1108590,2021-09-10,Senate,"Unfinished Business SB320 Eggman et al. By Rubio Concurrence",37,0,0,3,40
1438481,1048989,2021-04-08,Senate,"Senate 3rd Reading SCR11 Rubio et al",38,0,2,0,40
1438481,1104729,2021-07-13,Assembly,"Be adopted. To third reading",15,0,0,0,15
1438481,1107173,2021-08-30,Senate,"Unfinished Business SCR11 Rubio et al. Concurrence",39,0,0,1,40
1438482,1052022,2021-04-13,Senate,"Be adopted, but first be re-referred to the Committee on [Appropriations] with recommendation: To Consent Calendar",15,0,2,0,17
1438482,1075288,2021-05-10,Senate,"Consent Calendar SCR12",37,0,3,0,40
1438482,1104232,2021-07-05,Assembly,"Be adopted. To Consent Calendar",15,0,0,0,15
1438482,1104544,2021-07-08,Assembly,"SCR 12 Bates Consent Calendar Second Day Regular Session",76,0,3,0,79
1439683,1038725,2021-03-22,Senate,"Do pass, but first be re-referred to the Committee on [Judiciary]",4,1,0,0,5
1439683,1053496,2021-04-13,Senate,"Do pass as amended, but first amend, and re-refer to the Committee on [Appropriations]",8,2,1,0,11
1439683,1068218,2021-05-03,Senate,"Placed on suspense file",6,0,1,0,7
1439683,1081522,2021-05-20,Senate,"Do pass",5,2,0,0,7
1439683,1089501,2021-06-01,Senate,"Senate 3rd Reading SB321 Durazo et al",30,10,0,0,40
1439683,1100301,2021-06-22,Assembly,"Do pass and be re-referred to the Committee on [Judiciary]",5,1,1,0,7
1439683,1104327,2021-07-06,Assembly,"Do pass as amended and be re-referred to the Committee on [Appropriations]",9,0,2,0,11
1439683,1106911,2021-08-26,Assembly,"Do pass",13,0,0,3,16
1439683,1107169,2021-08-30,Assembly,"SB 321 Durazo Senate Third Reading Amend By CHIU Set #1",57,16,0,6,79
1439683,1108037,2021-09-08,Assembly,"SB 321 Durazo Senate Third Reading By Chiu",63,0,0,17,80
1439683,1108377,2021-09-09,Senate,"Unfinished Business SB321 Durazo et al. Concurrence",29,9,0,2,40
1439684,1029550,2021-03-16,Senate,"Do pass, but first be re-referred to the Committee on [Appropriations]",9,0,0,0,9
1439684,1033625,2021-03-22,Senate,"Placed on suspense file",7,0,0,0,7
1439685,1037841,2021-03-25,Senate,"Do pass, but first be re-referred to the Committee on [Judiciary]",4,1,0,0,5
1439685,1059206,2021-04-20,Senate,"Do pass",10,0,1,0,11
1439685,1074177,2021-05-06,Senate,"Senate 3rd Reading SB323 Caballero et al",34,1,5,0,40
1439685,1096075,2021-06-09,Assembly,"Do pass and be re-referred to the Committee on [Judiciary]",8,0,0,0,8
1439685,1100313,2021-06-22,Assembly,"Do pass as amended",11,0,0,0,11
1439685,1106347,2021-08-19,Assembly,"Do pass",15,0,0,1,16
1439685,1108347,2021-09-09,Assembly,"SB 323 Caballero Senate Third Reading By Luz Rivas",77,0,0,3,80
1439685,1108555,2021-09-10,Senate,"Unfinished Business SB323 Caballero et al. Concurrence",33,2,0,5,40
1439687,1123346,2022-01-11,Senate,"Do pass",4,0,0,1,5
1439687,1128989,2022-01-26,Senate,"Senate 3rd Reading SB325 Bradford",27,6,0,7,40
1439688,1026100,2021-03-10,Senate,"Do pass, but first be re-referred to the Committee on [Appropriations]",11,0,0,0,11
1439688,1074144,2021-05-06,Senate,"Senate 3rd Reading SB326 Pan et al",36,0,4,0,40
1439688,1104761,2021-07-13,Assembly,"Do pass and be re-referred to the Committee on [Appropriations] with recommendation: To Consent Calendar",14,0,1,0,15
1439688,1106309,2021-08-19,Assembly,"Do pass",13,0,0,3,16
1439688,1107952,2021-09-07,Assembly,"SB 326 Pan Senate Third Reading By Wood",62,0,0,18,80
1439688,1108032,2021-09-08,Senate,"Unfinished Business SB326 Pan et al. Concurrence",38,0,0,2,40
1439690,1047445,2021-04-07,Senate,"Do pass as amended, but first amend, and re-refer to the Committee on [Governance and Finance]",5,1,1,0,7
1439690,1060908,2021-04-22,Senate,"Do pass as amended, but first amend, and re-refer to the Committee on [Appropriations]",4,0,1,0,5
1439690,1078818,2021-05-17,Senate,"Senate 3rd Reading SB328 Portantino",31,2,7,0,40
1439691,1025119,2021-03-09,Senate,"Do pass and be ordered to the Consent Calendar",11,0,0,0,11
1439691,1033621,2021-03-22,Senate,"Consent Calendar SB329",37,0,3,0,40
1441507,1054589,2021-04-15,Assembly,"Do pass and be re-referred to the Committee on [Appropriations] with recommendation: To Consent Calendar",7,0,0,0,7
1441507,1065232,2021-04-28,Assembly,"Do pass. To Consent Calendar",16,0,0,0,16
1441507,1074116,2021-05-06,Assembly,"AB 444 P.E. & R. Consent Calendar Second Day Regular Session",77,0,1,0,78
1441507,1093682,2021-06-07,Senate,"Do pass, but first be re-referred to the Committee on [Appropriations] with the recommendation: To Consent Calendar",5,0,0,0,5
1441507,1101610,2021-06-24,Senate,"Consent Calendar AB444 P.E. & R",39,0,1,0,40
1441508,1047492,2021-04-07,Assembly,"Do pass and be re-referred to the Committee on [Appropriations] with recommendation: To Consent Calendar",8,0,0,0,8
1441508,1059215,2021-04-21,Assembly,"Do pass. To Consent Calendar",14,0,2,0,16
1441508,1066725,2021-04-29,Assembly,"AB 445 Calderon Consent Calendar Second Day Regular Session",77,0,1,0,78
1441508,1095011,2021-06-08,Senate,"Do pass, but first be re-referred to the Committee on [Appropriations]",5,0,0,0,5
1441508,1106096,2021-08-16,Senate,"Assembly 3rd Reading AB445 Calderon By Hurtado",39,0,0,1,40
1441508,1106384,2021-08-23,Assembly,"AB 445 Calderon Concurrence in Senate Amendments",69,0,0,10,79
1441509,1066724,2021-04-29,Assembly,"Do pass as amended and be re-referred to the Committee on [Appropriations]",6,0,1,0,7
1441509,1082030,2021-05-20,Assembly,"Do pass",13,3,0,0,16
1441509,1090384,2021-06-02,Assembly,"AB 446 Mayes Assembly Third Reading",70,4,5,0,79
1441509,1104664,2021-07-12,Senate,"Do pass, but first be re-referred to the Committee on [Appropriations]",4,1,0,0,5
1441509,1106184,2021-08-16,Senate,"Placed on suspense file",7,0,0,0,7
1441509,1106918,2021-08-26,Senate,"Do pass as amended",6,0,0,1,7
1441509,1107709,2021-09-02,Senate,"Assembly 3rd Reading AB446 Mayes By Glazer",32,1,0,7,40
1441509,1107914,2021-09-07,Assembly,"AB 446 Mayes Concurrence in Senate Amendments",65,2,0,13,80
1441510,1054688,2021-04-15,Assembly,"Do pass and be re-referred to the Committee on [Appropriations] with recommendation: To Consent Calendar",12,0,0,0,12
1441510,1065165,2021-04-28,Assembly,"Do pass. To Consent Calendar",16,0,0,0,16
1441510,1074132,2021-05-06,Assembly,"AB 447 Grayson Consent Calendar Second Day Regular Session",77,0,1,0,78
1441510,1103784,2021-07-01,Senate,"Do pass, but first be re-referred to the Committee on [Governance and Finance] with the recommendation: To Consent Calendar",9,0,0,0,9
1441510,1104504,2021-07-08,Senate,"Do pass, but first be re-referred to the Committee on [Appropriations] with the recommendation: To Consent Calendar",5,0,0,0,5
1441510,1106165,2021-08-16,Senate,"Placed on suspense file",7,0,0,0,7
1441510,1106716,2021-08-26,Senate,"Do pass as amended",7,0,0,0,7
1441510,1108010,2021-09-08,Senate,"Assembly 3rd Reading AB447 Grayson By Skinner",38,0,0,2,40
1441510,1108504,2021-09-10,Assembly,"With recommendation: That Senate amendments be concurred in",7,0,0,1,8
1441510,1108636,2021-09-10,Assembly,"AB 447 Grayson Concurrence in Senate Amendments",78,0,0,2,80
1441511,1059270,2021-04-21,Assembly,"Do pass and be re-referred to the Committee on [Natural Resources]",15,0,0,0,15
1441513,1051958,2021-04-13,Assembly,"Do pass and be re-referred to the Committee on [Emergency Management]",15,0,0,0,15
1441513,1057655,2021-04-19,Assembly,"Do pass. To Consent Calendar",6,0,1,0,7
1441513,1081861,2021-05-20,Assembly,"Do pass",16,0,0,0,16
1441513,1086997,2021-05-27,Assembly,"AB 450 Lorena Gonzalez Assembly Third Reading",78,0,0,0,78
1441513,1101568,2021-06-23,Senate,"Do pass as amended, but first amend, and re-refer to the Committee on [Judiciary]",10,0,1,0,11
1441513,1104462,2021-07-06,Senate,"Do pass, but first be re-referred to the Committee on [Appropriations]",11,0,0,0,11
1441513,1106206,2021-08-16,Senate,"Placed on suspense file",7,0,0,0,7
1441513,1106680,2021-08-26,Senate,"Do pass",7,0,0,0,7
1441513,1108375,2021-09-09,Senate,"Assembly 3rd Reading AB450 Lorena Gonzalez et a By Pan",38,0,0,2,40
1441513,1108376,2021-09-09,Assembly,"AB 450 GONZALEZ Concurrence in Senate Amendments",78,0,0,2,80
1441514,1046220,2021-04-06,Assembly,"Do pass and be re-referred to the Committee on [Appropriations]",15,0,0,0,15
1441514,1053490,2021-04-14,Assembly,"Do pass. To Consent Calendar",16,0,0,0,16
1441514,1075289,2021-05-10,Assembly,"AB 451 Arambula Assembly Third Reading",73,0,5,0,78
1441514,1097069,2021-06-10,Senate,"Do pass, but first be re-referred to the Committee on [Appropriations]",9,1,1,0,11
1441514,1107889,2021-09-07,Senate,"Assembly 3rd Reading AB451 Arambula By Roth",36,0,0,4,40
1441514,1108012,2021-09-08,Assembly,"AB 451 Arambula Concurrence in Senate Amendments",79,0,0,1,80
1441515,1123751,2022-01-12,Assembly,"Do pass and be re-referred to the Committee on [Appropriations]",6,0,0,1,7
1441515,1126364,2022-01-20,Assembly,"Do pass",15,0,0,1,16
1441515,1129893,2022-01-27,Assembly,"AB 452 Friedman Assembly Third Reading",66,1,0,9,76
1441515,1211940,2022-06-01,Senate,"Do pass, but first be re-referred to the Committee on [Judiciary]",6,0,0,1,7
1441515,1214972,2022-06-08,Senate,"Do pass as amended, but first amend, and re-refer to the Committee on [Appropriations]",7,0,0,4,11
1441515,1216617,2022-06-16,Senate,"Do pass",6,0,0,1,7
1441515,1223215,2022-08-08,Senate,"Assembly 3rd Reading AB452 Friedman et al. By Portantino",32,0,0,8,40
1441515,1223610,2022-08-11,Assembly,"AB 452 Friedman Concurrence in Senate Amendments",73,0,0,7,80
1441516,1052012,2021-04-13,Assembly,"Do pass",11,0,0,0,11
1441516,1056490,2021-04-19,Assembly,"AB 453 Cristina Garcia Assembly Third Reading",74,0,5,0,79
1441516,1095074,2021-06-08,Senate,"Do pass, but first be re-referred to the Committee on [Appropriations] with the recommendation: To Consent Calendar",11,0,0,0,11
1441516,1099749,2021-06-21,Senate,"Placed on suspense file",7,0,0,0,7
1441516,1106830,2021-08-26,Senate,"Do pass",7,0,0,0,7
1441516,1107790,2021-09-03,Senate,"Special Consent AB453",37,0,0,3,40
1441516,1107915,2021-09-07,Assembly,"AB 453 Cristina Garcia Concurrence in Senate Amendments",73,0,0,7,80
1441517,1064004,2021-04-27,Assembly,"Do pass as amended and be re-referred to the Committee on [Appropriations]",10,1,4,0,15
1441518,1064027,2021-04-26,Assembly,"Do pass and be re-referred to the Committee on [Appropriations]",11,0,4,0,15
1441518,1076938,2021-05-12,Assembly,"Do pass",12,2,2,0,16
1441518,1086919,2021-05-27,Assembly,"AB 455 Wicks Assembly Third Reading",55,15,8,0,78
1441518,1216391,2022-06-14,Senate,"Do pass, but first be re-referred to the Committee on [Appropriations]",11,1,0,5,17
1441518,1219409,2022-06-27,Senate,"Placed on suspense file",6,0,0,1,7
1441519,1049028,2021-04-08,Assembly,"Do pass and be re-referred to the Committee on [Appropriations] with recommendation: To Consent Calendar",22,0,0,0,22
1441520,1057631,2021-04-20,Assembly,"Do pass as amended and be re-referred to the Committee on [Appropriations]",13,0,2,0,15
1441520,1081660,2021-05-20,Assembly,"Do pass",12,0,4,0,16
1441520,1086987,2021-05-27,Assembly,"AB 457 Santiago Assembly Third Reading",63,1,14,0,78
1441520,1101619,2021-06-23,Senate,"Do pass as amended, but first amend, and re-refer to the Committee on [Appropriations]",9,1,1,0,11
1441520,1105090,2021-07-15,Senate,"Placed on suspense file",7,0,0,0,7
1441520,1106693,2021-08-26,Senate,"Do pass",5,2,0,0,7
1441520,1108609,2021-09-10,Senate,"Assembly 3rd Reading AB457 Santiago et al. By Pan",37,0,0,3,40
1441520,1108610,2021-09-10,Assembly,"AB 457 Santiago Concurrence in Senate Amendments",75,0,0,5,80
1441522,1035170,2021-03-22,Assembly,"Do pass and be re-referred to the Committee on [Military and Veterans Affairs] with recommendation: To Consent Calendar",15,0,0,0,15
1441522,1065315,2021-04-28,Assembly,"Do pass and be re-referred to the Committee on [Appropriations] with recommendation: To Consent Calendar",11,0,0,0,11
1441524,1059273,2021-04-21,Assembly,"Do pass and be re-referred to the Committee on [Appropriations]",8,0,0,0,8
1441524,1081854,2021-05-20,Assembly,"Do pass",16,0,0,0,16
1441524,1092868,2021-06-01,Assembly,"AB 461 Villapudua Assembly Third Reading",78,0,1,0,79
1441524,1100256,2021-06-22,Senate,"Do pass, but first be re-referred to the Committee on [Appropriations]",5,0,0,0,5
1441524,1104215,2021-07-05,Senate,"Placed on suspense file",6,0,1,0,7
1441524,1106682,2021-08-26,Senate,"Do pass",7,0,0,0,7
1441524,1107794,2021-09-03,Senate,"Special Consent AB461",37,0,0,3,40
1441524,1107916,2021-09-07,Assembly,"AB 461 Villapudua Concurrence in Senate Amendments",73,0,0,7,80
1441525,1057667,2021-04-20,Assembly,"Do pass and be re-referred to the Committee on [Appropriations] with recommendation: To Consent Calendar",19,0,0,0,19
1441525,1065105,2021-04-28,Assembly,"Do pass. To Consent Calendar",16,0,0,0,16
1441525,1074196,2021-05-06,Assembly,"AB 462 Carrillo Consent Calendar Second Day Regular Session",77,0,1,0,78
1441525,1099725,2021-06-21,Senate,"Do pass, but first be re-referred to the Committee on [Appropriations]",11,0,3,0,14
1441525,1107882,2021-09-07,Senate,"Assembly 3rd Reading AB462 Carrillo By Lim贸n",37,0,0,3,40
1441525,1108168,2021-09-08,Assembly,"AB 462 Carrillo Concurrence in Senate Amendments",79,0,0,1,80
1441527,1054649,2021-04-14,Assembly,"Do pass. To Consent Calendar",8,0,0,0,8
1441527,1060948,2021-04-22,Assembly,"AB 464 Mullin Consent Calendar Second Day Regular Session",77,0,2,0,79
1441527,1097061,2021-06-10,Senate,"Do pass and be ordered to the Consent Calendar",5,0,0,0,5
1441527,1099138,2021-06-17,Senate,"Consent Calendar AB464",37,0,3,0,40
1441528,1046175,2021-04-06,Assembly,"Do pass and be re-referred to the Committee on [Appropriations]",18,0,1,0,19
1441528,1059335,2021-04-21,Assembly,"Do pass",14,0,2,0,16
1441528,1068238,2021-05-03,Assembly,"AB 465 Nazarian Assembly Third Reading",69,0,9,0,78
1441528,1093687,2021-06-07,Senate,"Do pass, but first be re-referred to the Committee on [Appropriations]",10,1,3,0,14
1441528,1107150,2021-08-30,Senate,"Assembly 3rd Reading AB465 Nazarian By Laird",31,1,0,8,40
1441528,1107431,2021-09-01,Assembly,"AB 465 Nazarian Concurrence in Senate Amendments",72,0,0,7,79
1441529,1035249,2021-03-22,Assembly,"Do pass and be re-referred to the Committee on [Appropriations]",9,0,2,0,11
1441529,1059309,2021-04-21,Assembly,"Do pass. To Consent Calendar",14,0,2,0,16
1441529,1066686,2021-04-29,Assembly,"AB 466 Petrie-Norris Consent Calendar Second Day Regular Session",77,0,1,0,78
1441529,1097028,2021-06-10,Senate,"Do pass, but first be re-referred to the Committee on [Appropriations] with the recommendation: To Consent Calendar",5,0,0,0,5
1441529,1101689,2021-06-24,Senate,"Consent Calendar AB466",39,0,1,0,40
1441531,1052011,2021-04-13,Assembly,"Do pass and be re-referred to the Committee on [Appropriations]",18,0,1,0,19
1441531,1073364,2021-05-05,Assembly,"Do pass. To Consent Calendar",16,0,0,0,16
1441531,1077584,2021-05-13,Assembly,"AB 468 Friedman Consent Calendar Second Day Regular Session",75,0,3,0,78
1441531,1103380,2021-06-30,Senate,"Do pass, but first be re-referred to the Committee on [Judiciary]",13,0,1,0,14
1441531,1104940,2021-07-13,Senate,"Do pass as amended, but first amend, and re-refer to the Committee on [Appropriations]",11,0,0,0,11
1441531,1107124,2021-08-30,Senate,"Assembly 3rd Reading AB468 Friedman et al. By Bates",39,0,0,1,40
1441531,1107522,2021-09-01,Assembly,"AB 468 Friedman Concurrence in Senate Amendments",78,0,0,1,79
1441532,1048999,2021-04-07,Assembly,"Do pass and be re-referred to the Committee on [Appropriations]",7,0,0,0,7
1441532,1081695,2021-05-20,Assembly,"Do pass as amended",12,0,4,0,16
1441532,1092962,2021-06-01,Assembly,"AB 469 Reyes Assembly Third Reading",77,0,2,0,79
1441532,1104909,2021-07-14,Senate,"Do pass, but first be re-referred to the Committee on [Appropriations]",7,0,0,0,7
1441532,1106198,2021-08-16,Senate,"Placed on suspense file",7,0,0,0,7
1441532,1106717,2021-08-26,Senate,"Do pass as amended",7,0,0,0,7
1441532,1108640,2021-09-10,Senate,"Assembly 3rd Reading AB469 Reyes et al. By Leyva",37,0,0,3,40
1441532,1108641,2021-09-10,Assembly,"AB 469 Reyes Concurrence in Senate Amendments",77,0,0,3,80
1441533,1046147,2021-04-06,Assembly,"Do pass as amended and be re-referred to the Committee on [Appropriations]",12,0,3,0,15
1441533,1082036,2021-05-20,Assembly,"Do pass",13,1,2,0,16
1441533,1087019,2021-05-27,Assembly,"AB 470 Carrillo Assembly Third Reading",70,2,6,0,78
1441533,1103460,2021-06-30,Senate,"Do pass, but first be re-referred to the Committee on [Appropriations]",10,0,1,0,11
1441533,1105063,2021-07-15,Senate,"Placed on suspense file",7,0,0,0,7
1441534,1057681,2021-04-20,Assembly,"Do pass and be re-referred to the Committee on [Appropriations] with recommendation: To Consent Calendar",19,0,0,0,19
1441534,1081742,2021-05-20,Assembly,"Do pass as amended",12,0,4,0,16
1441534,1092863,2021-06-01,Assembly,"AB 471 Low Assembly Third Reading",77,1,1,0,79
1441534,1103420,2021-06-30,Senate,"Do pass, but first be re-referred to the Committee on [Judiciary]",12,0,2,0,14
1441534,1104944,2021-07-13,Senate,"Do pass as amended, but first amend, and re-refer to the Committee on [Appropriations] with the recommendation: To Consent Calendar",11,0,0,0,11
1441534,1106099,2021-08-16,Senate,"Placed on suspense file",7,0,0,0,7
1441534,1106573,2021-08-26,Senate,"Do pass",7,0,0,0,7
1441534,1108615,2021-09-10,Senate,"Assembly 3rd Reading AB471 Low et al. By Min",37,0,0,3,40
1441534,1108616,2021-09-10,Assembly,"AB 471 Low Concurrence in Senate Amendments",76,0,0,4,80
1441535,1050790,2021-04-12,Assembly,"Do pass and be re-referred to the Committee on [Privacy and Consumer Protection]",7,0,0,0,7
1441535,1060995,2021-04-22,Assembly,"Do pass and be re-referred to the Committee on [Appropriations] with recommendation: To Consent Calendar",11,0,0,0,11
1441535,1073377,2021-05-05,Assembly,"Do pass. To Consent Calendar",16,0,0,0,16
1441535,1077563,2021-05-13,Assembly,"AB 472 Cooley Consent Calendar Second Day Regular Session",75,0,3,0,78
1441535,1093675,2021-06-07,Senate,"Do pass, but first be re-referred to the Committee on [Appropriations]",12,0,2,0,14
1441535,1099723,2021-06-21,Senate,"Placed on suspense file",7,0,0,0,7
1441535,1106659,2021-08-26,Senate,"Do pass",7,0,0,0,7
1441535,1107803,2021-09-03,Senate,"Special Consent AB472",37,0,0,3,40
1441536,1035247,2021-03-23,Assembly,"Do pass. To Consent Calendar",11,0,0,0,11
1441536,1081881,2021-05-20,Assembly,"Do pass",16,0,0,0,16
1441536,1091691,2021-06-03,Assembly,"AB 473 Chau Assembly Third Reading",78,0,1,0,79
1441536,1103367,2021-06-29,Senate,"Do pass and be ordered to the Consent Calendar",11,0,0,0,11
1441536,1107232,2021-08-30,Senate,"Assembly 3rd Reading AB473 Chau By Roth",39,0,0,1,40
1441536,1107388,2021-09-01,Assembly,"AB 473 Chau Concurrence in Senate Amendments",78,0,0,1,79
1441537,1035203,2021-03-23,Assembly,"Do pass. To Consent Calendar",11,0,0,0,11
1441537,1081446,2021-05-20,Assembly,"Do pass",16,0,0,0,16
1441537,1090420,2021-06-02,Assembly,"AB 474 Chau Assembly Third Reading",76,0,3,0,79
1441537,1103508,2021-06-29,Senate,"Do pass and be ordered to the Consent Calendar",11,0,0,0,11
1441537,1107134,2021-08-30,Senate,"Assembly 3rd Reading AB474 Chau By Roth",39,0,0,1,40
1441537,1107446,2021-09-01,Assembly,"AB 474 Chau Concurrence in Senate Amendments",78,0,0,1,79
1441538,1064169,2021-04-27,Assembly,"Do pass and be re-referred to the Committee on [Appropriations] with recommendation: To Consent Calendar",6,0,1,0,7
1441540,1047584,2021-04-07,Assembly,"Do pass as amended. To Consent Calendar",8,0,0,0,8
1441540,1056491,2021-04-19,Assembly,"AB 477 Blanca Rubio Consent Calendar Second Day",78,0,1,0,79
1441540,1095013,2021-06-08,Senate,"Do pass",4,0,1,0,5
1441540,1101627,2021-06-24,Senate,"Special Consent AB477",39,0,1,0,40
1441540,1102473,2021-06-28,Assembly,"AB 477 Blanca Rubio Concurrence in Senate Amendments",79,0,0,0,79
1441541,1053543,2021-04-14,Assembly,"Do pass and be re-referred to the Committee on [Judiciary]",8,0,3,0,11
1441541,1057742,2021-04-20,Assembly,"Do pass as amended and be re-referred to the Committee on [Appropriations]",8,1,2,0,11
1441541,1081506,2021-05-20,Assembly,"Do pass",12,3,1,0,16
1441541,1087025,2021-05-27,Assembly,"AB 478 Ting Assembly Third Reading",54,3,21,0,78
1441541,1103799,2021-07-01,Senate,"Do pass as amended, but first amend, and re-refer to the Committee on [Judiciary]",5,1,1,0,7
1441541,1104960,2021-07-13,Senate,"Do pass, but first be re-referred to the Committee on [Appropriations]",8,2,1,0,11
1441541,1106430,2021-08-23,Senate,"Placed on suspense file",7,0,0,0,7
1441542,1059330,2021-04-21,Assembly,"Do pass and be re-referred to the Committee on [Appropriations]",8,0,0,0,8
1441543,1047526,2021-04-07,Assembly,"Do pass and be re-referred to the Committee on [Appropriations]",6,1,2,0,9
1441543,1081838,2021-05-20,Assembly,"Do pass as amended",12,4,0,0,16
1441543,1090407,2021-06-02,Assembly,"AB 480 Carrillo Assembly Third Reading",48,14,17,0,79
1441543,1102461,2021-06-28,Senate,"Do pass, but first be re-referred to the Committee on [Judiciary]",5,1,1,0,7
1441543,1104399,2021-07-06,Senate,"Do pass, but first be re-referred to the Committee on [Appropriations]",9,2,0,0,11
1441543,1107711,2021-09-02,Senate,"Assembly 3rd Reading AB480 Carrillo et al. By Durazo",33,4,0,3,40
1441543,1107917,2021-09-07,Assembly,"AB 480 Carrillo Concurrence in Senate Amendments",62,0,0,18,80
1441544,1036472,2021-03-24,Assembly,"Do pass and be re-referred to the Committee on [Appropriations]",5,2,1,0,8
1441544,1037805,2021-03-24,Assembly,"Do pass and be re-referred to the Committee on [Public Safety]",5,2,1,0,8
1441544,1065158,2021-04-27,Assembly,"Do pass and be re-referred to the Committee on [Appropriations]",6,2,0,0,8
1441544,1082163,2021-05-20,Assembly,"Do pass as amended",12,4,0,0,16
1441544,1092912,2021-06-01,Assembly,"AB 481 Chiu Assembly Third Reading",50,22,7,0,79
1441544,1102823,2021-06-29,Senate,"Do pass, but first be re-referred to the Committee on [Governance and Finance]",4,1,0,0,5
1441544,1104501,2021-07-08,Senate,"Do pass as amended, but first amend, and re-refer to the Committee on [Appropriations]",4,1,0,0,5
1441544,1106190,2021-08-16,Senate,"Placed on suspense file",7,0,0,0,7
1441544,1107011,2021-08-26,Senate,"Do pass as amended",5,2,0,0,7
1441544,1108369,2021-09-09,Senate,"Assembly 3rd Reading AB481 Chiu et al. By McGuire",24,11,0,5,40
1441544,1108370,2021-09-09,Assembly,"AB 481 CHIU Concurrence in Senate Amendments",48,25,0,7,80
1441545,1029573,2021-03-15,Assembly,"Do pass as amended. To Consent Calendar",8,0,0,0,8
1441545,1037813,2021-03-25,Assembly,"AB 482 Ward Consent Calendar Second Day",74,0,4,0,78
1441545,1099123,2021-06-17,Senate,"Do pass",7,0,2,0,9
1441545,1104153,2021-07-05,Senate,"Special Consent AB482",38,0,2,0,40
1441546,1036425,2021-03-23,Assembly,"Do pass and be re-referred to the Committee on [Appropriations] with recommendation: To Consent Calendar",8,0,0,0,8
1441546,1081995,2021-05-20,Assembly,"Do pass",16,0,0,0,16
1441546,1087047,2021-05-27,Assembly,"AB 483 Jones-Sawyer Assembly Third Reading",77,1,0,0,78
1441546,1104250,2021-07-06,Senate,"Do pass, but first be re-referred to the Committee on [Appropriations]",5,0,0,0,5
1441546,1106121,2021-08-16,Senate,"Placed on suspense file",7,0,0,0,7
1441546,1106998,2021-08-26,Senate,"Do pass as amended",6,0,0,1,7
1441546,1107678,2021-09-02,Senate,"Assembly 3rd Reading AB483 Jones-Sawyer By Kamlager",38,0,0,2,40
1441546,1107918,2021-09-07,Assembly,"AB 483 Jones-Sawyer Concurrence in Senate Amendments",72,0,0,8,80
1441547,1051980,2021-04-13,Assembly,"Do pass and be re-referred to the Committee on [Appropriations]",17,0,2,0,19
1441547,1065205,2021-04-28,Assembly,"Do pass. To Consent Calendar",16,0,0,0,16
1441547,1074178,2021-05-06,Assembly,"AB 484 Medina Consent Calendar Second Day Regular Session",77,0,1,0,78
1441547,1099735,2021-06-21,Senate,"Do pass, but first be re-referred to the Committee on [Appropriations] with the recommendation: To Consent Calendar",11,0,3,0,14
1441547,1107149,2021-08-30,Senate,"Consent Calendar AB484",39,0,0,1,40
1441548,1123315,2022-01-11,Assembly,"Do pass and be re-referred to the Committee on [Appropriations] with recommendation: To Consent Calendar",7,0,0,0,7
1441548,1126315,2022-01-20,Assembly,"Do pass",15,0,0,1,16
1441548,1127192,2022-01-24,Assembly,"AB 485 Nguyen Assembly Third Reading",64,0,0,12,76
1441548,1210933,2022-05-31,Senate,"Do pass and be ordered to the Consent Calendar",5,0,0,0,5
1441548,1211835,2022-05-31,Senate,"Do pass, but first be re-referred to the Committee on [Appropriations] with the recommendation: To Consent Calendar",5,0,0,0,5
1441548,1215531,2022-06-13,Senate,"Placed on suspense file",7,0,0,0,7
1441548,1223790,2022-08-11,Senate,"Do pass",7,0,0,0,7
1441548,1224605,2022-08-23,Senate,"Special Consent AB485",40,0,0,0,40
1441549,1065216,2021-04-28,Assembly,"Do pass and be re-referred to the Committee on [Appropriations] with recommendation: To Consent Calendar",7,0,0,0,7
1441549,1082208,2021-05-20,Assembly,"Do pass",16,0,0,0,16
1441549,1086937,2021-05-27,Assembly,"AB 486 ED. Assembly Third Reading By O'DONNELL",78,0,0,0,78
1441549,1098654,2021-06-16,Senate,"Do pass, but first be re-referred to the Committee on [Appropriations] with the recommendation: To Consent Calendar",7,0,0,0,7
1441549,1106407,2021-08-23,Senate,"Placed on suspense file",7,0,0,0,7
1441549,1106953,2021-08-26,Senate,"Do pass",7,0,0,0,7
1441549,1108087,2021-09-08,Senate,"Assembly 3rd Reading AB486 ED. (O'Donnell) By Leyva",38,0,0,2,40
1441549,1108348,2021-09-09,Assembly,"AB 486 ED. Concurrence in Senate Amendments By O'DONNELL",78,0,0,2,80
1441551,1048947,2021-04-08,Assembly,"Do pass and be re-referred to the Committee on [Appropriations]",8,3,0,0,11
1441551,1082196,2021-05-20,Assembly,"Do pass",12,4,0,0,16
1441551,1086949,2021-05-27,Assembly,"AB 488 Irwin Assembly Third Reading",59,18,1,0,78
1441551,1103459,2021-06-29,Senate,"Do pass, but first be re-referred to the Committee on [Appropriations]",9,1,1,0,11
1441551,1105105,2021-07-15,Senate,"Placed on suspense file",7,0,0,0,7
1441551,1106877,2021-08-26,Senate,"Do pass as amended",5,2,0,0,7
1441551,1107500,2021-09-01,Senate,"Assembly 3rd Reading AB488 Irwin By Lim贸n",30,9,0,1,40
1441551,1107576,2021-09-02,Assembly,"AB 488 Irwin Concurrence in Senate Amendments",58,18,0,3,79
1441553,1053442,2021-04-13,Assembly,"Do pass and be re-referred to the Committee on [Appropriations]",6,2,0,0,8
1441553,1081915,2021-05-20,Assembly,"Do pass",12,4,0,0,16
1441553,1090458,2021-06-02,Assembly,"AB 490 Gipson Assembly Third Reading",55,15,9,0,79
1441553,1104739,2021-07-13,Senate,"Do pass, but first be re-referred to the Committee on [Appropriations]",4,1,0,0,5
1441553,1106094,2021-08-16,Senate,"Placed on suspense file",7,0,0,0,7
1441553,1106908,2021-08-26,Senate,"Do pass as amended",5,2,0,0,7
1441553,1108072,2021-09-08,Senate,"Assembly 3rd Reading AB490 Gipson et al. By Durazo",28,8,0,4,40
1441553,1108289,2021-09-09,Assembly,"AB 490 Gipson Concurrence in Senate Amendments",55,18,0,7,80
1441554,1067615,2021-04-29,Assembly,"Do pass as amended and be re-referred to the Committee on [Appropriations]",7,0,1,0,8
1441554,1076937,2021-05-12,Assembly,"Do pass as amended. To Consent Calendar",16,0,0,0,16
1441554,1081807,2021-05-20,Assembly,"AB 491 Ward Consent Calendar Second Day Regular Session",76,0,2,0,78
1441554,1103831,2021-07-01,Senate,"Do pass, but first be re-referred to the Committee on [Appropriations]",9,0,0,0,9
1441554,1107188,2021-08-30,Senate,"Assembly 3rd Reading AB491 Ward et al. By Wiener",39,0,0,1,40
1441554,1107466,2021-09-01,Assembly,"AB 491 Ward Concurrence in Senate Amendments",77,0,0,2,79
1441555,1057619,2021-04-20,Assembly,"Do pass and be re-referred to the Committee on [Appropriations]",19,0,0,0,19
1441555,1065240,2021-04-28,Assembly,"Do pass. To Consent Calendar",16,0,0,0,16
1441555,1074115,2021-05-06,Assembly,"AB 492 Patterson Consent Calendar Second Day Regular Session",77,0,1,0,78
1441556,1035267,2021-03-23,Assembly,"Do pass",13,1,1,0,15
1441556,1048984,2021-04-08,Assembly,"AB 493 Wood Assembly Third Reading",62,2,14,0,78
1441557,1027161,2021-03-11,Assembly,"Be adopted. To third reading",8,0,4,0,12
1441557,1050803,2021-04-12,Senate,"Assembly 3rd Reading ACR23 Villapudua et al",39,0,1,0,40
1441558,1035190,2021-03-23,Assembly,"Be adopted, and re-refer to the Committee on [Appropriations] with recommendation: To Consent Calendar",11,0,0,0,11
1441558,1053524,2021-04-14,Assembly,"Be adopted. To Consent Calendar",16,0,0,0,16
1441558,1056497,2021-04-19,Assembly,"ACR 24 Chau Consent Calendar Second Day Regular Session",78,0,1,0,79
1441558,1103454,2021-06-29,Senate,"Be adopted, but first be re-referred to the Committee on [Appropriations] with recommendation: To Consent Calendar",11,0,0,0,11
1441558,1107166,2021-08-30,Senate,"Consent Calendar ACR24",39,0,0,1,40
1441559,1074153,2021-05-06,Assembly,"Be adopted. To Consent Calendar",11,0,1,0,12
1441559,1077579,2021-05-13,Assembly,"ACR 25 Nguyen Consent Calendar Second Day Regular Session",75,0,3,0,78
1441559,1089601,2021-06-01,Senate,"Special Consent ACR25",39,0,1,0,40
1441561,1027167,2021-03-11,Assembly,"Be adopted. To third reading",8,0,4,0,12
1441562,1060943,2021-04-22,Assembly,"Be adopted. To third reading",12,0,0,0,12
1441563,1026101,2021-03-10,Senate,"Do pass as amended, but first amend, and re-refer to the Committee on [Appropriations]",5,1,1,0,7
1441563,1044940,2021-04-05,Senate,"Placed on suspense file",7,0,0,0,7
1441563,1081963,2021-05-20,Senate,"Do pass",5,2,0,0,7
1441563,1091686,2021-06-03,Senate,"Senate 3rd Reading SB330 Durazo",31,5,4,0,40
1441563,1106488,2021-08-24,Assembly,"Do pass and be re-referred to the Committee on [Appropriations]",6,2,0,0,8
1441563,1106578,2021-08-26,Assembly,"Do pass",12,4,0,0,16
1441563,1107498,2021-09-01,Assembly,"SB 330 Durazo Senate Third Reading By Santiago",63,11,0,5,79
1441563,1107864,2021-09-07,Senate,"That the Assembly amendments be concurred in",4,0,0,3,7
1441563,1108155,2021-09-08,Senate,"Unfinished Business SB330 Durazo Concurrence",31,6,0,3,40
1441564,1053413,2021-04-13,Senate,"Do pass as amended, but first amend, and re-refer to the Committee on [Appropriations]",8,2,1,0,11
1441564,1074165,2021-05-06,Senate,"Senate 3rd Reading SB331 Leyva",29,8,3,0,40
1441564,1095016,2021-06-08,Assembly,"Do pass as amended and be re-referred to the Committee on [Labor and Employment]",8,3,0,0,11
1441564,1100312,2021-06-22,Assembly,"Do pass",5,1,1,0,7
1441564,1106893,2021-08-26,Assembly,"SB 331 Leyva Senate Third Reading By Reyes",58,13,0,8,79
1441564,1107154,2021-08-30,Senate,"Unfinished Business SB331 Leyva Concurrence",30,8,0,2,40
1441565,1072215,2021-05-04,Senate,"Do pass as amended",11,0,0,0,11
1441565,1078812,2021-05-17,Senate,"Placed on suspense file",7,0,0,0,7
1441565,1081985,2021-05-20,Senate,"Do pass",7,0,0,0,7
1441565,1090421,2021-06-02,Senate,"Senate 3rd Reading SB332 Dodd et al",38,0,2,0,40
1441565,1100348,2021-06-22,Assembly,"Do pass as amended and be re-referred to the Committee on [Natural Resources]",11,0,0,0,11
1441565,1104457,2021-07-07,Assembly,"Do pass and be re-referred to the Committee on [Appropriations] with recommendation: To Consent Calendar",11,0,0,0,11
1441565,1106876,2021-08-26,Assembly,"Do pass",16,0,0,0,16
1441565,1107484,2021-09-01,Assembly,"SB 332 Dodd Senate Third Reading By Wood",78,0,0,1,79
1441565,1107587,2021-09-02,Senate,"Unfinished Business SB332 Dodd et al. Concurrence",39,0,0,1,40
1441566,1051929,2021-04-13,Senate,"Do pass, but first be re-referred to the Committee on [Appropriations] with the recommendation: To Consent Calendar",16,0,1,0,17
1441566,1075255,2021-05-10,Senate,"Consent Calendar SB333",37,0,3,0,40
1441566,1101552,2021-06-23,Assembly,"Do pass as amended and be re-referred to the Committee on [Appropriations]",8,0,0,0,8
1441566,1104449,2021-07-07,Assembly,"Do pass. To Consent Calendar",14,0,2,0,16
1441566,1105089,2021-07-15,Assembly,"SB 333 Eggman Consent Calendar Second Day Regular Session",70,0,9,0,79
1441566,1106457,2021-08-23,Senate,"Unfinished Business SB333 Eggman et al. Concurrence",37,0,0,3,40
1441567,1037811,2021-03-25,Senate,"Do pass, but first be re-referred to the Committee on [Judiciary]",8,1,3,0,12
1441567,1059179,2021-04-20,Senate,"Do pass, but first be re-referred to the Committee on [Appropriations]",9,2,0,0,11
1441567,1083871,2021-05-24,Senate,"Senate 3rd Reading SB334 Durazo et al",30,9,1,0,40
1441567,1101584,2021-06-24,Assembly,"Do pass as amended and be re-referred to the Committee on [Public Safety]",12,1,1,0,14
1441567,1104758,2021-07-13,Assembly,"Do pass",6,2,0,0,8
1441567,1108176,2021-09-08,Assembly,"SB 334 Durazo Senate Third Reading By Reyes",61,14,0,5,80
1441567,1108459,2021-09-09,Senate,"Unfinished Business SB334 Durazo et al. Concurrence",29,9,0,2,40
1441568,1064048,2021-04-26,Senate,"Do pass, but first be re-referred to the Committee on [Appropriations]",4,1,0,0,5
1441568,1075340,2021-05-10,Senate,"Placed on suspense file",7,0,0,0,7
1441568,1081502,2021-05-20,Senate,"Do pass",5,2,0,0,7
1441568,1089559,2021-06-01,Senate,"Senate 3rd Reading SB335 Cortese",29,10,1,0,40
1441568,1104695,2021-07-13,Assembly,"Do pass as amended and be re-referred to the Committee on [Appropriations]",7,0,7,0,14
1441569,1065159,2021-04-28,Senate,"Do pass as amended, but first amend, and re-refer to the Committee on [Appropriations]",11,0,0,0,11
1441569,1078742,2021-05-17,Senate,"Placed on suspense file",7,0,0,0,7
1441569,1081729,2021-05-20,Senate,"Do pass",7,0,0,0,7
1441569,1089473,2021-06-01,Senate,"Special Consent SB336 Ochoa Bogh et al. Urgency Clause",39,0,1,0,40
1441569,1104347,2021-07-06,Assembly,"Do pass as amended, and be re-referred to the Committee on [Appropriations] with recommendation: To Consent Calendar",15,0,0,0,15
1441569,1106870,2021-08-26,Assembly,"Do pass",16,0,0,0,16
1441569,1108035,2021-09-08,Assembly,"SB 336 Ochoa Bogh Third Reading Urgency By Gipson",79,0,0,1,80
1441569,1108392,2021-09-09,Senate,"Unfinished Business SB336 Ochoa Bogh et al. Urgency Clause Concurrence",38,0,0,2,40
1441571,1046174,2021-04-05,Senate,"Do pass, but first be re-referred to the Committee on [Judiciary]",4,1,0,0,5
1441571,1059158,2021-04-20,Senate,"Do pass as amended, but first amend, and re-refer to the Committee on [Appropriations]",9,2,0,0,11
1441571,1068275,2021-05-03,Senate,"Placed on suspense file",6,0,1,0,7
1441571,1082169,2021-05-20,Senate,"Do pass",5,2,0,0,7
1441571,1089617,2021-06-01,Senate,"Senate 3rd Reading SB338 Gonzalez",29,9,2,0,40
1441571,1100299,2021-06-22,Assembly,"Do pass and be re-referred to the Committee on [Judiciary]",5,1,1,0,7
1441571,1104712,2021-07-13,Assembly,"Do pass as amended and be re-referred to the Committee on [Appropriations]",8,3,0,0,11
1441571,1106833,2021-08-26,Assembly,"Do pass as amended",12,4,0,0,16
1441571,1108097,2021-09-08,Assembly,"SB 338 Gonzalez Senate Third Reading By Carrillo",60,18,0,2,80
1441571,1108265,2021-09-09,Senate,"Unfinished Business SB338 Gonzalez et al. Concurrence",28,9,0,3,40
1441572,1052031,2021-04-13,Senate,"Do pass, but first be re-referred to the Committee on [Appropriations]",10,4,3,0,17
1441572,1068254,2021-05-03,Senate,"Placed on suspense file",6,0,1,0,7
1441572,1081599,2021-05-20,Senate,"Do pass as amended",5,2,0,0,7
1441572,1089510,2021-06-01,Senate,"Senate 3rd Reading SB339 Wiener et al",28,11,1,0,40
1441572,1099739,2021-06-21,Assembly,"Do pass and be re-referred to the Committee on [Appropriations]",11,4,0,0,15
1441572,1106789,2021-08-26,Assembly,"Do pass as amended",12,4,0,0,16
1441572,1107491,2021-09-01,Assembly,"SB 339 Wiener Senate Third Reading By Friedman",51,19,0,9,79
1441572,1107607,2021-09-02,Senate,"Unfinished Business SB339 Wiener et al. Concurrence",27,10,0,3,40
1444422,1054584,2021-04-15,Assembly,"Do pass and be re-referred to the Committee on [Appropriations] with recommendation: To Consent Calendar",13,0,0,0,13
1444422,1065200,2021-04-28,Assembly,"Do pass. To Consent Calendar",16,0,0,0,16
1444422,1074117,2021-05-06,Assembly,"AB 494 Mayes Consent Calendar Second Day Regular Session",77,0,1,0,78
1444422,1101648,2021-06-24,Senate,"Do pass, but first be re-referred to the Committee on [Judiciary]",12,0,0,0,12
1444422,1104422,2021-07-06,Senate,"Do pass, but first be re-referred to the Committee on [Appropriations] with the recommendation: To Consent Calendar",11,0,0,0,11
1444422,1107200,2021-08-30,Senate,"Consent Calendar AB494",39,0,0,1,40
1444423,1048911,2021-04-08,Assembly,"Do pass and be re-referred to the Committee on [Appropriations] with recommendation: To Consent Calendar",22,0,0,0,22
1444423,1059153,2021-04-21,Assembly,"Do pass. To Consent Calendar",14,0,2,0,16
1444423,1066717,2021-04-29,Assembly,"AB 495 Bigelow Consent Calendar Second Day Regular Session",77,0,1,0,78
1444423,1220104,2022-06-28,Senate,"Do pass, but first be re-referred to the Committee on [Appropriations]",11,0,0,4,15
1444423,1222883,2022-08-01,Senate,"Placed on suspense file",7,0,0,0,7
1444423,1224043,2022-08-11,Senate,"Do pass as amended",6,0,0,1,7
1444424,1035256,2021-03-23,Assembly,"Do pass. To Consent Calendar",17,0,2,0,19
1444424,1044942,2021-04-05,Assembly,"AB 496 Chen Consent Calendar Second Day Regular Session",74,0,4,0,78
1444424,1093680,2021-06-07,Senate,"Do pass, but first be re-referred to the Committee on [Military and Veterans Affairs] with the recommendation: To Consent Calendar",12,0,2,0,14
1444424,1103506,2021-06-30,Senate,"Do pass and be ordered to the Consent Calendar",6,0,1,0,7
1444424,1104674,2021-07-12,Senate,"Consent Calendar AB496",39,0,1,0,40
1444426,1048893,2021-04-07,Assembly,"Do pass as amended, and be re-referred to the Committee on [Appropriations] with recommendation: To Consent Calendar",7,0,0,0,7
1444426,1082106,2021-05-20,Assembly,"Do pass",16,0,0,0,16
1444426,1087058,2021-05-27,Assembly,"AB 498 Quirk-Silva Assembly Third Reading",78,0,0,0,78
1444426,1104481,2021-07-07,Senate,"Do pass, but first be re-referred to the Committee on [Appropriations]",7,0,0,0,7
1444426,1218661,2022-06-22,Senate,"Do pass, but first be re-referred to the Committee on [Governance and Finance]",9,0,0,2,11
1444426,1221276,2022-06-29,Senate,"Do pass as amended, but first amend, and re-refer to the Committee on [Appropriations]",5,0,0,0,5
1444426,1225165,2022-08-30,Assembly,"With recommendation: That Senate amendments be concurred in",13,0,0,1,14
1444426,1225579,2022-08-29,Senate,"Assembly 3rd Reading AB498 Quirk-Silva et al. By Min",40,0,0,0,40
1444426,1225580,2022-08-31,Assembly,"AB 498 Quirk-Silva Concurrence in Senate Amendments",80,0,0,0,80
1444426,1229729,2022-08-30,Senate,"Assembly 3rd Reading AB498 Quirk-Silva et al. By Min",40,0,0,0,40
1444427,1047569,2021-04-07,Assembly,"Do pass and be re-referred to the Committee on [Aging and Long-Term Care]",8,0,0,0,8
1444427,1057639,2021-04-20,Assembly,"Do pass and be re-referred to the Committee on [Appropriations]",7,0,0,0,7
1444427,1082044,2021-05-20,Assembly,"Do pass",16,0,0,0,16
1444427,1086946,2021-05-27,Assembly,"AB 499 Blanca Rubio Assembly Third Reading",78,0,0,0,78
1444427,1100260,2021-06-22,Senate,"Do pass as amended, but first amend, and re-refer to the Committee on [Judiciary]",5,0,0,0,5
1444427,1104976,2021-07-13,Senate,"Do pass as amended, but first amend, and re-refer to the Committee on [Appropriations]",10,1,0,0,11
1444427,1106090,2021-08-16,Senate,"Do pass",7,0,0,0,7
1444427,1225415,2022-08-29,Senate,"Assembly 3rd Reading AB499 Blanca Rubio et al. By Umberg",38,0,0,2,40
1444427,1225416,2022-08-30,Assembly,"AB 499 Blanca Rubio Concurrence in Senate Amendments",79,0,0,1,80
1444428,1065154,2021-04-28,Assembly,"Do pass and be re-referred to the Committee on [Housing and Community Development]",7,3,1,0,11
1444428,1067631,2021-04-29,Assembly,"Do pass and be re-referred to the Committee on [Appropriations]",6,2,0,0,8
1444428,1081846,2021-05-20,Assembly,"Do pass",11,5,0,0,16
1444428,1086999,2021-05-27,Assembly,"AB 500 Ward Assembly Third Reading",53,20,5,0,78
1444428,1102846,2021-06-29,Senate,"Do pass as amended, but first amend, and re-refer to the Committee on [Governance and Finance]",6,2,1,0,9
1444428,1104557,2021-07-08,Senate,"Do pass as amended, but first amend, and re-refer to the Committee on [Appropriations]",4,1,0,0,5
1444428,1106157,2021-08-16,Senate,"Placed on suspense file",7,0,0,0,7
1444428,1107025,2021-08-26,Senate,"Do pass",5,2,0,0,7
1444428,1107887,2021-09-07,Senate,"That the measure be returned to Senate Floor for consideration. Ordered to third reading",3,1,0,1,5
1444429,1057629,2021-04-20,Assembly,"Do pass and be re-referred to the Committee on [Appropriations] with recommendation: To Consent Calendar",19,0,0,0,19
1444429,1081839,2021-05-20,Assembly,"Do pass",16,0,0,0,16
1444429,1087054,2021-05-27,Assembly,"AB 501 Cristina Garcia Assembly Third Reading",75,0,3,0,78
1444429,1099767,2021-06-21,Senate,"Do pass as amended, but first amend, and re-refer to the Committee on [Health]",9,0,5,0,14
1444429,1104942,2021-07-14,Senate,"Do pass as amended, but first amend, and re-refer to the Committee on [Appropriations]",9,0,2,0,11
1444429,1106126,2021-08-16,Senate,"Placed on suspense file",7,0,0,0,7
1444430,1067630,2021-04-29,Assembly,"Do pass as amended and be re-referred to the Committee on [Appropriations]",8,0,0,0,8
1444430,1083876,2021-05-24,Assembly,"AB 502 Davies Assembly Third Reading",73,0,5,0,78
1444430,1099133,2021-06-17,Senate,"Do pass as amended, but first amend, and re-refer to the Committee on [Judiciary]",7,1,1,0,9
1444430,1104979,2021-07-13,Senate,"Do pass as amended",10,0,1,0,11
1444430,1108187,2021-09-08,Senate,"Assembly 3rd Reading AB502 Davies By Hertzberg",38,0,0,2,40
1444430,1108280,2021-09-09,Assembly,"AB 502 Davies Concurrence in Senate Amendments",78,0,0,2,80
1444431,1036486,2021-03-23,Assembly,"Do pass",6,2,0,0,8
1444431,1053502,2021-04-12,Assembly,"AB 503 Stone Assembly Third Reading",35,22,21,0,78
1444431,1056492,2021-04-19,Assembly,"AB 503 Stone Assembly Third Reading",41,22,16,0,79
1444431,1102863,2021-06-29,Senate,"Do pass",4,1,0,0,5
1444431,1225625,2022-08-30,Senate,"Assembly 3rd Reading AB503 Stone et al. By Kamlager",21,13,0,6,40
1444431,1225626,2022-08-31,Assembly,"AB 503 Stone Concurrence in Senate Amendments",45,22,0,13,80
1444432,1036452,2021-03-24,Assembly,"Do pass and be re-referred to the Committee on [Appropriations] with recommendation: To Consent Calendar",11,0,0,0,11
1444432,1053530,2021-04-14,Assembly,"Do pass. To Consent Calendar",16,0,0,0,16
1444432,1060910,2021-04-22,Assembly,"AB 504 McCarty Consent Calendar Second Day Regular Session",77,0,2,0,79
1444432,1097788,2021-06-14,Senate,"Do pass, but first be re-referred to the Committee on [Appropriations] with the recommendation: To Consent Calendar",7,0,0,0,7
1444432,1101653,2021-06-24,Senate,"Consent Calendar AB504",39,0,1,0,40
1444434,1065282,2021-04-27,Assembly,"Do pass as amended and be re-referred to the Committee on [Appropriations]",8,0,0,0,8
1444434,1076932,2021-05-12,Assembly,"Do pass",16,0,0,0,16
1444434,1078744,2021-05-17,Assembly,"AB 506 Lorena Gonzalez Assembly Third Reading",74,0,4,0,78
1444434,1100349,2021-06-22,Senate,"Do pass as amended, but first amend, and re-refer to the Committee on [Appropriations]",5,0,0,0,5
1444434,1106460,2021-08-23,Senate,"Assembly 3rd Reading AB506 Lorena Gonzalez By Min",37,0,0,3,40
1444434,1107413,2021-09-01,Assembly,"AB 506 Lorena Gonzalez Concurrence in Senate Amendments",78,0,0,1,79
1444439,1066809,2021-04-29,Assembly,"Do pass and be re-referred to the Committee on [Appropriations]",12,0,0,0,12
1444439,1081430,2021-05-20,Assembly,"Do pass",16,0,0,0,16
1444439,1092963,2021-06-01,Assembly,"AB 511 Muratsuchi Assembly Third Reading",78,0,1,0,79
1444439,1100827,2021-06-23,Senate,"Do pass as amended, but first amend, and re-refer to the Committee on [Judiciary] with the recommendation: To Consent Calendar",9,0,0,0,9
1444439,1104392,2021-07-06,Senate,"Do pass, but first be re-referred to the Committee on [Appropriations] with the recommendation: To Consent Calendar",11,0,0,0,11
1444439,1106228,2021-08-16,Senate,"Placed on suspense file",7,0,0,0,7
1444439,1106679,2021-08-26,Senate,"Do pass",7,0,0,0,7
1444439,1107765,2021-09-03,Senate,"Special Consent AB511",37,0,0,3,40
1444439,1107919,2021-09-07,Assembly,"AB 511 Muratsuchi Concurrence in Senate Amendments",72,0,0,8,80
1444440,1054761,2021-04-15,Assembly,"Do pass and be re-referred to the Committee on [Appropriations]",8,0,0,0,8
1444440,1081919,2021-05-20,Assembly,"Do pass as amended",13,0,3,0,16
1444440,1092952,2021-06-01,Assembly,"AB 512 Holden Assembly Third Reading",68,0,11,0,79
1444440,1220608,2022-06-28,Senate,"Do pass as amended, but first amend, and re-refer to the Committee on [Appropriations]",13,0,0,4,17
1444440,1223206,2022-08-08,Senate,"Placed on suspense file",7,0,0,0,7
1444440,1224029,2022-08-11,Senate,"Do pass",5,0,0,2,7
1444440,1225157,2022-08-30,Assembly,"With recommendation: That Senate amendments be concurred in",8,2,0,5,15
1444440,1225701,2022-08-29,Senate,"Assembly 3rd Reading AB512 Holden By Portantino",27,0,0,13,40
1444440,1225702,2022-08-31,Assembly,"AB 512 Holden Concurrence in Senate Amendments",61,15,0,4,80
1444442,1072280,2021-05-04,Assembly,"Do pass. To Consent Calendar",11,0,0,0,11
1444442,1075300,2021-05-10,Assembly,"AB 514 Ward Consent Calendar Second Day Regular Session",74,0,4,0,78
1444442,1098143,2021-06-15,Senate,"Do pass as amended, but first amend, and re-refer to the Committee on [Appropriations] with the recommendation: To Consent Calendar",10,0,1,0,11
1444442,1104224,2021-07-05,Senate,"Placed on suspense file",6,0,1,0,7
1444442,1106873,2021-08-26,Senate,"Do pass",7,0,0,0,7
1444442,1107807,2021-09-03,Senate,"Special Consent AB514",37,0,0,3,40
1444442,1107920,2021-09-07,Assembly,"AB 514 Ward Concurrence in Senate Amendments",73,0,0,7,80
1444443,1036469,2021-03-23,Assembly,"Do pass as amended, and be re-referred to the Committee on [Appropriations] with recommendation: To Consent Calendar",8,0,0,0,8
1444443,1053570,2021-04-14,Assembly,"Do pass",16,0,0,0,16
1444443,1056493,2021-04-19,Assembly,"AB 515 Chen Assembly Third Reading",78,0,1,0,79
1444443,1098148,2021-06-15,Senate,"Do pass, but first be re-referred to the Committee on [Appropriations]",4,0,1,0,5
1444443,1107870,2021-09-07,Senate,"Assembly 3rd Reading AB515 Chen By Ochoa Bogh",37,0,0,3,40
1444443,1108129,2021-09-08,Assembly,"AB 515 Chen Concurrence in Senate Amendments",79,0,0,1,80
1444444,1056345,2021-04-19,Assembly,"Be adopted. To Consent Calendar",15,0,0,0,15
1444444,1060986,2021-04-22,Assembly,"ACR 27 Gallagher Consent Calendar Second Day Regular Session",77,0,2,0,79
1444444,1102833,2021-06-29,Senate,"Be adopted, but first be re-referred to the Committee on [Appropriations] with recommendation: To Consent Calendar",17,0,0,0,17
1444444,1107189,2021-08-30,Senate,"Consent Calendar ACR27",39,0,0,1,40
1444445,1059204,2021-04-21,Senate,"Do pass as amended, but first amend, and re-refer to the Committee on [Judiciary]",11,0,0,0,11
1444445,1072197,2021-05-04,Senate,"Do pass and be ordered to the Consent Calendar",11,0,0,0,11
1444445,1075352,2021-05-10,Senate,"Consent Calendar SB340",37,0,3,0,40
1444445,1215294,2022-06-09,Assembly,"Be re-referred to the Committees on [Health] and [Judiciary]",8,0,0,3,11
1444445,1217479,2022-06-21,Assembly,"Do pass and be re-referred to the Committee on [Judiciary] with recommendation: To Consent Calendar",15,0,0,0,15
1444446,1028433,2021-03-15,Senate,"Do pass as amended, but first amend, and re-refer to the Committee on [Governmental Organization]",13,0,1,0,14
1444446,1046166,2021-04-06,Senate,"Do pass, but first be re-referred to the Committee on [Appropriations]",13,1,1,0,15
1444446,1068220,2021-05-03,Senate,"Do pass",5,0,2,0,7
1444446,1077603,2021-05-13,Senate,"Senate 3rd Reading SB341 McGuire et al",37,0,3,0,40
1444446,1100759,2021-06-23,Assembly,"Do pass as amended and be re-referred to the Committee on [Emergency Management]",13,0,0,0,13
1444446,1104197,2021-07-05,Assembly,"Do pass and be re-referred to the Committee on [Appropriations]",6,0,1,0,7
1444446,1106645,2021-08-26,Assembly,"Do pass",15,1,0,0,16
1444446,1108183,2021-09-08,Assembly,"SB 341 McGuire Senate Third Reading By Santiago",74,0,0,6,80
1444446,1108379,2021-09-09,Senate,"Unfinished Business SB341 McGuire et al. Concurrence",38,0,0,2,40
1444447,1050839,2021-04-12,Senate,"Do pass, but first be re-referred to the Committee on [Governance and Finance]",5,0,2,0,7
1444447,1074161,2021-05-06,Senate,"Do pass",3,1,1,0,5
1444447,1131231,2022-01-31,Senate,"Senate 3rd Reading SB342 Gonzalez et al",19,8,0,13,40
1444448,1028426,2021-03-15,Senate,"Do pass as amended, but first amend, and re-refer to the Committee on [Judiciary]",5,0,2,0,7
1444448,1047530,2021-04-06,Senate,"Do pass as amended, but first amend, and re-refer to the Committee on [Appropriations]",9,0,2,0,11
1444448,1056420,2021-04-19,Senate,"Placed on suspense file",7,0,0,0,7
1444448,1082005,2021-05-20,Senate,"Do pass as amended",5,2,0,0,7
1444448,1089469,2021-06-01,Senate,"Senate 3rd Reading SB343 Allen et al",31,6,3,0,40
1444448,1100762,2021-06-23,Assembly,"Do pass as amended and be re-referred to the Committee on [Judiciary]",8,0,3,0,11
1444448,1104341,2021-07-06,Assembly,"Do pass as amended and be re-referred to the Committee on [Appropriations]",7,2,2,0,11
1444448,1106948,2021-08-26,Assembly,"Do pass as amended",11,4,0,1,16
1444448,1108120,2021-09-08,Assembly,"SB 343 Allen Senate Third Reading By Lorena Gonzalez",50,3,0,27,80
1444448,1108227,2021-09-09,Senate,"Unfinished Business SB343 Allen et al. Concurrence",29,7,0,4,40
1444449,1031915,2021-03-18,Senate,"Do pass as amended, but first amend, and re-refer to the Committee on [Appropriations]",8,0,1,0,9
1444449,1045019,2021-04-05,Senate,"Placed on suspense file",7,0,0,0,7
1444449,1081476,2021-05-20,Senate,"Do pass as amended",7,0,0,0,7
1444449,1090427,2021-06-02,Senate,"Senate 3rd Reading SB344 Hertzberg et al",38,0,2,0,40
1444449,1104610,2021-07-12,Assembly,"Do pass and be re-referred to the Committee on [Appropriations]",8,0,0,0,8
1444450,1028423,2021-03-15,Senate,"Do pass as amended, but first amend, and re-refer to the Committee on [Appropriations]",10,2,2,0,14
1444450,1044962,2021-04-05,Senate,"Placed on suspense file",7,0,0,0,7
1444451,1029554,2021-03-16,Senate,"Do pass, but first be re-referred to the Committee on [Appropriations]",10,1,0,0,11
1444451,1044995,2021-04-05,Senate,"Placed on suspense file",7,0,0,0,7
1444451,1082108,2021-05-20,Senate,"Do pass",5,2,0,0,7
1444451,1086102,2021-05-26,Senate,"Senate 3rd Reading SB346 Wieckowski",36,3,1,0,40
1444451,1217462,2022-06-21,Assembly,"Do pass as amended and be re-referred to the Committee on [Appropriations]",9,0,0,2,11
1444451,1223529,2022-08-11,Assembly,"Do pass as amended",13,1,0,2,16
1444451,1225092,2022-08-29,Assembly,"SB 346 Wieckowski Senate Third Reading By Gabriel",61,1,0,18,80
1444451,1225725,2022-08-30,Senate,"Unfinished Business SB346 Wieckowski et al. Concurrence",36,3,0,1,40
1444452,1029551,2021-03-16,Senate,"Do pass as amended, but first amend, and re-refer to the Committee on [Governance and Finance]",9,0,0,0,9
1444452,1037816,2021-03-25,Senate,"Do pass, but first be re-referred to the Committee on [Appropriations] with the recommendation: To Consent Calendar",5,0,0,0,5
1444452,1060940,2021-04-22,Senate,"Consent Calendar SB347",38,0,2,0,40
1444452,1096099,2021-06-09,Assembly,"Do pass and be re-referred to the Committee on [Revenue and Taxation] with recommendation: To Consent Calendar",11,0,0,0,11
1444452,1100247,2021-06-21,Assembly,"Do pass and be re-referred to the Committee on [Appropriations] with recommendation: To Consent Calendar",11,0,0,0,11
1444452,1103358,2021-06-30,Assembly,"Do pass. To Consent Calendar",14,0,2,0,16
1444452,1104521,2021-07-08,Assembly,"SB 347 Caballero Consent Calendar Second Day Regular Session",76,0,3,0,79
1444453,1053484,2021-04-14,Senate,"Do pass, but first be re-referred to the Committee on [Appropriations]",7,0,0,0,7
1444453,1068235,2021-05-03,Senate,"Placed on suspense file",6,0,1,0,7
1444453,1081534,2021-05-20,Senate,"Do pass",7,0,0,0,7
1444453,1089561,2021-06-01,Senate,"Special Consent SB348",39,0,1,0,40
1444453,1104252,2021-07-06,Assembly,"Do pass and be re-referred to the Committee on [Appropriations]",11,0,0,0,11
1444454,1030780,2021-03-17,Senate,"Do pass, but first be re-referred to the Committee on [Judiciary]",10,0,1,0,11
1444454,1047456,2021-04-06,Senate,"Do pass as amended, but first amend, and re-refer to the Committee on [Appropriations] with the recommendation: To Consent Calendar",11,0,0,0,11
1444454,1068225,2021-05-03,Senate,"Placed on suspense file",6,0,1,0,7
1444454,1082129,2021-05-20,Senate,"Do pass",7,0,0,0,7
1444454,1087612,2021-05-28,Senate,"Senate 3rd Reading SB349 Umberg",38,0,2,0,40
1444454,1104280,2021-07-06,Assembly,"Do pass and be re-referred to the Committee on [Appropriations]",15,0,0,0,15
1444454,1104705,2021-07-13,Assembly,"Do pass as amended and be re-referred to the Committee on [Appropriations]",10,1,0,0,11
1444454,1106558,2021-08-26,Assembly,"Do pass",16,0,0,0,16
1444454,1179360,2022-03-28,Assembly,"SB 349 Umberg Senate Third Reading By Petrie-Norris",65,0,0,11,76
1444454,1182518,2022-04-04,Senate,"Unfinished Business SB349 Umberg et al. Concurrence",35,0,0,5,40
1444455,1035201,2021-03-23,Senate,"Do pass, but first be re-referred to the Committee on [Appropriations]",1,1,3,0,5
1444455,1035202,2021-03-23,Senate,"[First] hearing set for [03-23-2021]: Failed passage in Committee. Reconsideration granted",5,0,0,0,5
1444455,1123309,2022-01-11,Senate,"Do pass, but first be re-referred to the Committee on [Appropriations]",1,4,0,0,5
1444456,1054739,2021-04-15,Senate,"Do pass as amended, but first amend, and re-refer to the Committee on [Appropriations]",9,0,0,0,9
1444456,1075337,2021-05-10,Senate,"Placed on suspense file",7,0,0,0,7
1444457,1030825,2021-03-17,Senate,"Do pass, but first be re-referred to the Committee on [Judiciary]",7,0,0,0,7
1444457,1047585,2021-04-06,Senate,"Do pass as amended, but first amend, and re-refer to the Committee on [Appropriations] with the recommendation: To Consent Calendar",11,0,0,0,11
1444457,1060869,2021-04-22,Senate,"Consent Calendar SB352",38,0,2,0,40
1444457,1104324,2021-07-06,Assembly,"Do pass and be re-referred to the Committee on [Judiciary] with recommendation: To Consent Calendar",11,0,0,0,11
1444457,1104765,2021-07-13,Assembly,"Do pass and be re-referred to the Committee on [Appropriations] with recommendation: To Consent Calendar",11,0,0,0,11
1444457,1106324,2021-08-19,Assembly,"Do pass. To Consent Calendar",16,0,0,0,16
1444457,1106638,2021-08-26,Assembly,"SB 352 Eggman Consent Calendar Second Day Regular Session",73,0,0,6,79
1444458,1026087,2021-03-10,Senate,"Do pass, but first be re-referred to the Committee on [Appropriations] with the recommendation: To Consent Calendar",11,0,0,0,11
1444458,1060958,2021-04-22,Senate,"Consent Calendar SB353",38,0,2,0,40
1444458,1095014,2021-06-08,Assembly,"Do pass and be re-referred to the Committee on [Appropriations] with recommendation: To Consent Calendar",15,0,0,0,15
1444458,1103469,2021-06-30,Assembly,"Do pass. To Consent Calendar",14,0,2,0,16
1444458,1106221,2021-08-16,Assembly,"SB 353 Roth Senate Third Reading By Irwin",76,0,0,3,79
1444458,1107138,2021-08-30,Senate,"Special Consent SB353 Roth",39,0,0,1,40
1444459,1046086,2021-04-06,Senate,"Do pass, but first be re-referred to the Committee on [Judiciary]",4,0,1,0,5
1444459,1065223,2021-04-27,Senate,"Do pass as amended, but first amend, and re-refer to the Committee on [Appropriations] with the recommendation: To Consent Calendar",11,0,0,0,11
1444459,1075382,2021-05-10,Senate,"Placed on suspense file",7,0,0,0,7
1444459,1082217,2021-05-20,Senate,"Do pass as amended",7,0,0,0,7
1444459,1087614,2021-05-28,Senate,"Senate 3rd Reading SB354 Skinner",38,0,2,0,40
1444459,1103489,2021-06-30,Assembly,"Do pass and be re-referred to the Committee on [Judiciary]",7,0,1,0,8
1444459,1104332,2021-07-06,Assembly,"Do pass and be re-referred to the Committee on [Appropriations]",10,0,1,0,11
1444459,1106797,2021-08-26,Assembly,"Do pass as amended",11,0,0,5,16
1444459,1108632,2021-09-10,Senate,"Unfinished Business SB354 Skinner et al. Concurrence",37,0,0,3,40
1444459,1108633,2021-09-10,Assembly,"SB 354 Skinner Senate Third Reading By Blanca Rubio",69,0,0,11,80
1444460,1029569,2021-03-16,Senate,"Do pass as amended, but first amend, and re-refer to the Committee on [Appropriations] with the recommendation: To Consent Calendar",11,0,0,0,11
1444460,1044977,2021-04-05,Senate,"Placed on suspense file",7,0,0,0,7
1444460,1082133,2021-05-20,Senate,"Do pass as amended",7,0,0,0,7
1444460,1089462,2021-06-01,Senate,"Special Consent SB355",39,0,1,0,40
1444460,1104279,2021-07-06,Assembly,"Do pass and be re-referred to the Committee on [Appropriations]",8,0,3,0,11
1444460,1106739,2021-08-26,Assembly,"Do pass",14,0,0,2,16
1444462,1051989,2021-04-13,Senate,"Do pass, but first be re-referred to the Committee on [Appropriations]",4,1,0,0,5
1444462,1068190,2021-05-03,Senate,"Placed on suspense file",6,0,1,0,7
1444462,1081737,2021-05-20,Senate,"Do pass",5,2,0,0,7
1444462,1089516,2021-06-01,Senate,"Senate 3rd Reading SB357 Wiener et al",29,9,2,0,40
1444462,1104726,2021-07-13,Assembly,"Do pass and be re-referred to the Committee on [Appropriations]",6,2,0,0,8
1444462,1106853,2021-08-26,Assembly,"Do pass as amended",12,4,0,0,16
1444462,1108573,2021-09-10,Senate,"Unfinished Business SB357 Wiener et al. Concurrence",26,9,0,5,40
1444462,1108574,2021-09-10,Assembly,"SB 357 Wiener Senate Third Reading By Bauer-Kahan",41,29,0,10,80
1444463,1051947,2021-04-13,Senate,"Do pass as amended, but first amend, and re-refer to the Committee on [Appropriations]",4,0,1,0,5
1444463,1068209,2021-05-03,Senate,"Placed on suspense file",6,0,1,0,7
1444463,1082195,2021-05-20,Senate,"Do pass",7,0,0,0,7
1444463,1089581,2021-06-01,Senate,"Special Consent SB358",39,0,1,0,40
1444463,1102829,2021-06-29,Assembly,"Do pass and be re-referred to the Committee on [Appropriations]",5,0,3,0,8
1444464,1054655,2021-04-15,Senate,"Do pass as amended, but first amend, and re-refer to the Committee on [Appropriations]",9,0,0,0,9
1444464,1068172,2021-05-03,Senate,"Placed on suspense file",6,0,1,0,7
1444465,1022331,2021-03-04,Senate,"Senate 3rd Reading SCR13 Pan",34,0,5,0,39
1444465,1060872,2021-04-22,Assembly,"Be adopted. To Consent Calendar",12,0,0,0,12
1444465,1066732,2021-04-29,Assembly,"SCR 13 Pan Consent Calendar Second Day Regular Session",77,0,1,0,78
1447122,1036526,2021-03-24,Assembly,"Do pass and be re-referred to the Committee on [Appropriations] with recommendation: To Consent Calendar",7,0,0,0,7
1447122,1081761,2021-05-20,Assembly,"Do pass",16,0,0,0,16
1447122,1087005,2021-05-27,Assembly,"AB 516 Megan Dahle Assembly Third Reading",78,0,0,0,78
1447122,1098682,2021-06-16,Senate,"Do pass as amended, but first amend, and re-refer to the Committee on [Appropriations] with the recommendation: To Consent Calendar",7,0,0,0,7
1447122,1107233,2021-08-30,Senate,"Assembly 3rd Reading AB516 Megan Dahle By Dahle Reconsider",39,0,0,1,40
1447122,1107234,2021-08-30,Senate,"Assembly 3rd Reading AB516 Megan Dahle By Dahle Reconsider",39,0,0,1,40
1447122,1107311,2021-08-30,Senate,"Assembly 3rd Reading AB516 Megan Dahle By Dahle",39,0,0,1,40
1447122,1108646,2021-09-10,Senate,"Assembly 3rd Reading AB516 Megan Dahle By Dahle",37,0,0,3,40
1447122,1108647,2021-09-10,Assembly,"AB 516 Megan Dahle Concurrence in Senate Amendments",78,0,0,2,80
1447123,1049887,2021-04-08,Assembly,"Do pass and be re-referred to the Committee on [Appropriations]",12,0,3,0,15
1447124,1036447,2021-03-23,Assembly,"Do pass and be re-referred to the Committee on [Appropriations]",6,2,0,0,8
1447124,1053512,2021-04-14,Assembly,"Do pass",12,4,0,0,16
1447124,1075280,2021-05-10,Assembly,"AB 518 Wicks Assembly Third Reading",41,23,14,0,78
1447124,1098150,2021-06-15,Senate,"Do pass, but first be re-referred to the Committee on [Appropriations]",3,1,1,0,5
1447124,1107118,2021-08-30,Senate,"Assembly 3rd Reading AB518 Wicks et al. By Skinner",29,10,0,1,40
1447125,1066795,2021-04-29,Assembly,"Do pass and be re-referred to the Committee on [Appropriations] with recommendation: To Consent Calendar",11,0,0,0,11
1447126,1048901,2021-04-07,Assembly,"Do pass as amended and be re-referred to the Committee on [Appropriations]",7,0,0,0,7
1447126,1081542,2021-05-20,Assembly,"Do pass",16,0,0,0,16
1447126,1086968,2021-05-27,Assembly,"AB 520 Gipson Assembly Third Reading",76,0,2,0,78
1447126,1104973,2021-07-14,Senate,"Do pass, but first be re-referred to the Committee on [Appropriations]",7,0,0,0,7
1447127,1046151,2021-04-06,Assembly,"Do pass and be re-referred to the Committee on [Appropriations] with recommendation: To Consent Calendar",15,0,0,0,15
1447128,1123329,2022-01-10,Assembly,"Do pass as amended and be re-referred to the Committee on [Appropriations]",9,0,0,2,11
1447128,1126298,2022-01-20,Assembly,"Do pass",14,1,0,1,16
1447128,1129879,2022-01-27,Assembly,"AB 522 Fong Assembly Third Reading",59,4,0,13,76
1447128,1220674,2022-06-28,Senate,"Do pass, but first be re-referred to the Committee on [Appropriations]",5,0,0,4,9
1447128,1224334,2022-08-22,Senate,"Assembly 3rd Reading AB522 Fong By Caballero",29,2,0,9,40
1447129,1046144,2021-04-06,Assembly,"Do pass and be re-referred to the Committee on [Health]",6,0,1,0,7
1447129,1064176,2021-04-27,Assembly,"Do pass as amended and be re-referred to the Committee on [Appropriations]",15,0,0,0,15
1447129,1082006,2021-05-20,Assembly,"Do pass",16,0,0,0,16
1447129,1086985,2021-05-27,Assembly,"AB 523 Nazarian Assembly Third Reading",78,0,0,0,78
1447129,1101666,2021-06-23,Senate,"Do pass, but first be re-referred to the Committee on [Appropriations] with the recommendation: To Consent Calendar",11,0,0,0,11
1447129,1104186,2021-07-05,Senate,"Placed on suspense file",6,0,1,0,7
1447129,1106643,2021-08-26,Senate,"Do pass",7,0,0,0,7
1447129,1107818,2021-09-03,Senate,"Special Consent AB523",37,0,0,3,40
1447129,1108238,2021-09-09,Assembly,"AB 523 Nazarian Concurrence in Senate Amendments",80,0,0,0,80
1447130,1060904,2021-04-22,Assembly,"Do pass and be re-referred to the Committee on [Appropriations]",11,0,1,0,12
1447130,1073351,2021-05-05,Assembly,"Do pass",16,0,0,0,16
1447130,1127199,2022-01-24,Assembly,"AB 524 Rodriguez Assembly Third Reading",64,0,0,12,76
1447130,1211935,2022-06-01,Senate,"Do pass, but first be re-referred to the Committee on [Appropriations]",7,0,0,0,7
1447130,1224986,2022-08-25,Senate,"Assembly 3rd Reading AB524 Rodriguez et al. By Newman",37,0,0,3,40
1447130,1224987,2022-08-25,Assembly,"AB 524 Rodriguez Concurrence in Senate Amendments",75,0,0,5,80
1447131,1059202,2021-04-21,Assembly,"Do pass as amended and be re-referred to the Committee on [Natural Resources]",14,0,1,0,15
1447131,1065249,2021-04-28,Assembly,"Do pass and be re-referred to the Committee on [Appropriations]",11,0,0,0,11
1447131,1081639,2021-05-20,Assembly,"Do pass",13,1,2,0,16
1447131,1086978,2021-05-27,Assembly,"AB 525 Chiu Assembly Third Reading",71,1,6,0,78
1447131,1104176,2021-07-05,Senate,"Do pass, but first be re-referred to the Committee on [Natural Resources and Water]",13,0,1,0,14
1447131,1104743,2021-07-13,Senate,"Do pass as amended, but first amend, and re-refer to the Committee on [Appropriations]",8,0,1,0,9
1447131,1106055,2021-08-16,Senate,"Placed on suspense file",7,0,0,0,7
1447131,1106601,2021-08-26,Senate,"Do pass as amended",7,0,0,0,7
1447131,1108415,2021-09-09,Senate,"Assembly 3rd Reading AB525 Chiu et al. By Laird",38,0,0,2,40
1447131,1108416,2021-09-09,Assembly,"AB 525 CHIU Concurrence in Senate Amendments",74,1,0,5,80
1447132,1051906,2021-04-13,Assembly,"Do pass and be re-referred to the Committee on [Appropriations]",18,0,1,0,19
1447132,1065252,2021-04-28,Assembly,"Do pass. To Consent Calendar",16,0,0,0,16
1447132,1074145,2021-05-06,Assembly,"AB 526 Wood Consent Calendar Second Day Regular Session",77,0,1,0,78
1447132,1104613,2021-07-12,Senate,"Do pass, but first be re-referred to the Committee on [Appropriations]",14,0,0,0,14
1447132,1107855,2021-09-07,Senate,"Assembly 3rd Reading AB526 Wood By Eggman Urgency Clause",37,0,0,3,40
1447132,1108075,2021-09-08,Assembly,"AB 526 Wood Concurrence in Senate Amendments",79,0,0,1,80
1447133,1052023,2021-04-13,Assembly,"Do pass",17,0,2,0,19
1447133,1060875,2021-04-22,Assembly,"AB 527 Wood Consent Calendar Second Day Regular Session",77,0,2,0,79
1447133,1099715,2021-06-21,Senate,"Do pass, but first be re-referred to the Committee on [Public Safety]",9,0,5,0,14
1447133,1104736,2021-07-13,Senate,"Do pass, but first be re-referred to the Committee on [Appropriations] with the recommendation: To Consent Calendar",5,0,0,0,5
1447133,1107880,2021-09-07,Senate,"Assembly 3rd Reading AB527 Wood By Roth",36,0,0,4,40
1447133,1108305,2021-09-09,Assembly,"With recommendation: That Senate amendments be concurred in",10,0,0,0,10
1447133,1108558,2021-09-10,Assembly,"AB 527 Wood Concurrence in Senate Amendments",74,0,0,6,80
1447134,1064075,2021-04-26,Assembly,"Do pass as amended and be re-referred to the Committee on [Appropriations]",7,2,2,0,11
1447138,1046141,2021-04-06,Assembly,"Do pass and be re-referred to the Committee on [Appropriations] with recommendation: To Consent Calendar",15,0,0,0,15
1447138,1053485,2021-04-14,Assembly,"Do pass. To Consent Calendar",16,0,0,0,16
1447138,1060888,2021-04-22,Assembly,"AB 532 Wood Consent Calendar Second Day Regular Session",77,0,2,0,79
1447138,1097048,2021-06-10,Senate,"Do pass, but first be re-referred to the Committee on [Appropriations] with the recommendation: To Consent Calendar",10,0,1,0,11
1447138,1107858,2021-09-07,Senate,"Assembly 3rd Reading AB532 Wood By Pan",37,0,0,3,40
1447138,1108116,2021-09-08,Assembly,"AB 532 Wood Concurrence in Senate Amendments",79,0,0,1,80
1447141,1051944,2021-04-13,Assembly,"Do pass and be re-referred to the Committee on [Appropriations]",13,0,2,0,15
1447141,1059318,2021-04-21,Assembly,"Do pass",11,3,2,0,16
1447141,1078743,2021-05-17,Assembly,"AB 535 Aguiar-Curry Assembly Third Reading",56,7,15,0,78
1447141,1103768,2021-07-01,Senate,"Do pass, but first be re-referred to the Committee on [Health]",5,0,0,0,5
1447141,1104934,2021-07-14,Senate,"Do pass as amended, but first amend, and re-refer to the Committee on [Appropriations]",9,0,2,0,11
1447141,1107218,2021-08-30,Senate,"Assembly 3rd Reading AB535 Aguiar-Curry et al. By Hurtado",38,0,0,2,40
1447141,1107539,2021-09-01,Assembly,"AB 535 Aguiar-Curry Concurrence in Senate Amendments",70,0,0,9,79
1447142,1057718,2021-04-19,Assembly,"Do pass. To Consent Calendar",6,0,1,0,7
1447142,1073390,2021-05-05,Assembly,"Do pass. To Consent Calendar",16,0,0,0,16
1447142,1077526,2021-05-13,Assembly,"AB 536 Rodriguez Consent Calendar Second Day Regular Session",75,0,3,0,78
1447142,1104306,2021-07-06,Senate,"Do pass, but first be re-referred to the Committee on [Appropriations] with the recommendation: To Consent Calendar",15,0,0,0,15
1447142,1105140,2021-07-15,Senate,"Placed on suspense file",7,0,0,0,7
1447143,1054595,2021-04-14,Assembly,"Do pass and be re-referred to the Committee on [Communications and Conveyance]",8,0,0,0,8
1447143,1065094,2021-04-28,Assembly,"Do pass and be re-referred to the Committee on [Appropriations]",13,0,0,0,13
1447143,1080459,2021-05-19,Assembly,"Do pass",14,0,2,0,16
1447143,1092894,2021-06-01,Assembly,"AB 537 Quirk Assembly Third Reading",74,1,4,0,79
1447143,1099718,2021-06-21,Senate,"Do pass, but first be re-referred to the Committee on [Governance and Finance]",10,0,4,0,14
1447143,1104554,2021-07-08,Senate,"Do pass as amended, but first amend, and re-refer to the Committee on [Appropriations]",5,0,0,0,5
1447143,1106201,2021-08-16,Senate,"Placed on suspense file",7,0,0,0,7
1447143,1106904,2021-08-26,Senate,"Do pass as amended",6,0,0,1,7
1447143,1107536,2021-09-01,Senate,"Assembly 3rd Reading AB537 Quirk By Hertzberg",39,0,0,1,40
1447143,1107661,2021-09-02,Assembly,"AB 537 Quirk Concurrence in Senate Amendments",72,0,0,7,79
1447144,1064114,2021-04-27,Assembly,"Do pass as amended and be re-referred to the Committee on [Appropriations]",6,0,1,0,7
1447144,1081596,2021-05-20,Assembly,"Do pass as amended",16,0,0,0,16
1447144,1092835,2021-06-01,Assembly,"AB 538 Muratsuchi Assembly Third Reading",79,0,0,0,79
1447144,1099761,2021-06-21,Senate,"Do pass, but first be re-referred to the Committee on [Appropriations]",11,0,3,0,14
1447144,1104195,2021-07-05,Senate,"Placed on suspense file",6,0,1,0,7
1447145,1054662,2021-04-15,Assembly,"Do pass and be re-referred to the Committee on [Appropriations]",7,0,0,0,7
1447145,1065260,2021-04-28,Assembly,"Do pass. To Consent Calendar",16,0,0,0,16
1447145,1074169,2021-05-06,Assembly,"AB 539 Cooley Consent Calendar Second Day Regular Session",77,0,1,0,78
1447145,1100267,2021-06-21,Senate,"Do pass, but first be re-referred to the Committee on [Appropriations]",5,0,0,0,5
1447145,1108196,2021-09-08,Senate,"Assembly 3rd Reading AB539 Cooley et al. By Cortese",37,0,0,3,40
1447146,1046173,2021-04-06,Assembly,"Do pass and be re-referred to the Committee on [Health]",7,0,0,0,7
1447146,1057774,2021-04-20,Assembly,"Do pass as amended and be re-referred to the Committee on [Appropriations]",15,0,0,0,15
1447146,1082086,2021-05-20,Assembly,"Do pass",16,0,0,0,16
1447146,1090440,2021-06-02,Assembly,"AB 540 Petrie-Norris Assembly Third Reading",78,0,1,0,79
1447146,1104154,2021-06-30,Senate,"Do pass, but first be re-referred to the Committee on [Appropriations] with the recommendation: To Consent Calendar",10,0,1,0,11
1447146,1105078,2021-07-15,Senate,"Placed on suspense file",7,0,0,0,7
1447147,1035199,2021-03-23,Assembly,"Do pass and be re-referred to the Committee on [Appropriations] with recommendation: To Consent Calendar",15,0,0,0,15
1447147,1082137,2021-05-20,Assembly,"Do pass as amended",12,0,4,0,16
1447147,1092882,2021-06-01,Assembly,"AB 541 Berman Assembly Third Reading",77,0,2,0,79
1447147,1098670,2021-06-16,Senate,"Do pass as amended, but first amend, and re-refer to the Committee on [Appropriations]",9,0,2,0,11
1447147,1104599,2021-07-12,Senate,"Assembly 3rd Reading AB541 Berman et al. By Rubio",39,0,1,0,40
1447147,1106249,2021-08-16,Assembly,"AB 541 Berman Concurrence in Senate Amendments",77,0,0,2,79
1447148,1049878,2021-04-08,Assembly,"Do pass and be re-referred to the Committee on [Appropriations]",15,0,0,0,15
1447149,1036548,2021-03-24,Assembly,"Do pass as amended and be re-referred to the Committee on [Appropriations]",12,0,0,0,12
1447149,1053444,2021-04-14,Assembly,"Do pass. To Consent Calendar",16,0,0,0,16
1447149,1060965,2021-04-22,Assembly,"AB 543 Davies Consent Calendar Second Day Regular Session",77,0,2,0,79
1447149,1096070,2021-06-09,Senate,"Do pass as amended, but first amend, and re-refer to the Committee on [Appropriations] with the recommendation: To Consent Calendar",7,0,0,0,7
1447149,1107201,2021-08-30,Senate,"Consent Calendar AB543",39,0,0,1,40
1447149,1107545,2021-09-01,Assembly,"AB 543 Davies Concurrence in Senate Amendments",78,0,0,1,79
1447150,1036502,2021-03-24,Assembly,"Do pass as amended and be re-referred to the Committee on [Appropriations]",7,0,0,0,7
1447150,1081760,2021-05-20,Assembly,"Do pass",16,0,0,0,16
1447150,1092860,2021-06-01,Assembly,"AB 544 O'Donnell Assembly Third Reading",79,0,0,0,79
1447151,1064091,2021-04-26,Assembly,"Do pass as amended and be re-referred to the Committee on [Appropriations]",7,2,2,0,11
1447151,1081551,2021-05-20,Assembly,"Do pass",12,4,0,0,16
1447151,1092862,2021-06-01,Assembly,"AB 545 Quirk Assembly Third Reading",58,20,1,0,79
1447151,1101640,2021-06-24,Senate,"Do pass as amended, but first amend, and re-refer to the Committee on [Education]",4,1,0,0,5
1447151,1104962,2021-07-14,Senate,"Do pass, but first be re-referred to the Committee on [Appropriations]",4,2,1,0,7
1447151,1106225,2021-08-16,Senate,"Placed on suspense file",7,0,0,0,7
1447152,1047558,2021-04-07,Assembly,"Do pass and be re-referred to the Committee on [Judiciary] with recommendation: To Consent Calendar",8,0,0,0,8
1447152,1052005,2021-04-13,Assembly,"Do pass and be re-referred to the Committee on [Appropriations] with recommendation: To Consent Calendar",11,0,0,0,11
1447152,1065268,2021-04-28,Assembly,"Do pass. To Consent Calendar",16,0,0,0,16
1447152,1074183,2021-05-06,Assembly,"AB 546 Maienschein Consent Calendar Second Day Regular Session",77,0,1,0,78
1447152,1095065,2021-06-08,Senate,"Do pass as amended, but first amend, and re-refer to the Committee on [Judiciary] with the recommendation: To Consent Calendar",5,0,0,0,5
1447152,1103466,2021-06-29,Senate,"Do pass, but first be re-referred to the Committee on [Appropriations] with the recommendation: To Consent Calendar",11,0,0,0,11
1447152,1107122,2021-08-30,Senate,"Assembly 3rd Reading AB546 Maienschein By Kamlager",39,0,0,1,40
1447152,1107436,2021-09-01,Assembly,"AB 546 Maienschein Concurrence in Senate Amendments",78,0,0,1,79
1447153,1036506,2021-03-23,Assembly,"Do pass and be re-referred to the Committee on [Appropriations] with recommendation: To Consent Calendar",8,0,0,0,8
1447153,1081709,2021-05-20,Assembly,"Do pass",16,0,0,0,16
1447153,1124335,2022-01-14,Assembly,"AB 547 McCarty Assembly Third Reading",66,0,0,10,76
1447153,1210902,2022-05-31,Senate,"Do pass as amended, but first amend, and re-refer to the Committee on [Appropriations]",5,0,0,0,5
1447153,1223223,2022-08-08,Senate,"Placed on suspense file",7,0,0,0,7
1447153,1223573,2022-08-11,Senate,"Do pass",7,0,0,0,7
1447153,1225950,2022-08-29,Senate,"Assembly 3rd Reading AB547 McCarty By Rubio",37,0,0,3,40
1447153,1225951,2022-08-30,Assembly,"AB 547 McCarty Concurrence in Senate Amendments",78,1,0,1,80
1447155,1047554,2021-04-07,Assembly,"Do pass and be re-referred to the Committee on [Judiciary]",8,0,0,0,8
1447155,1052019,2021-04-13,Assembly,"Do pass and be re-referred to the Committee on [Appropriations]",11,0,0,0,11
1447156,1064162,2021-04-26,Assembly,"Do pass as amended and be re-referred to the Committee on [Appropriations]",13,0,2,0,15
1447157,1054666,2021-04-15,Assembly,"Do pass and be re-referred to the Committee on [Appropriations]",4,2,1,0,7
1447157,1073447,2021-05-05,Assembly,"Do pass",12,4,0,0,16
1447157,1129884,2022-01-27,Assembly,"AB 551 Rodriguez Assembly Third Reading",54,13,0,9,76
1447157,1211899,2022-06-01,Senate,"Do pass, but first be re-referred to the Committee on [Appropriations]",5,0,0,0,5
1447157,1225183,2022-08-31,Assembly,"With recommendation: That Senate amendments be concurred in",7,0,0,0,7
1447157,1225406,2022-08-29,Senate,"Assembly 3rd Reading AB551 Rodriguez By Hertzberg",36,0,0,4,40
1447157,1225407,2022-08-31,Assembly,"AB 551 Rodriguez Concurrence in Senate Amendments",74,0,0,6,80
1447158,1036499,2021-03-24,Assembly,"Do pass as amended and be re-referred to the Committee on [Health]",7,0,0,0,7
1447158,1123326,2022-01-11,Assembly,"Do pass and be re-referred to the Committee on [Appropriations]",15,0,0,0,15
1447158,1126281,2022-01-20,Assembly,"Do pass as amended",12,0,0,4,16
1447158,1131246,2022-01-31,Assembly,"AB 552 Quirk-Silva Assembly Third Reading",76,0,0,0,76
1447158,1211938,2022-06-01,Senate,"Do pass, but first be re-referred to the Committee on [Health]",7,0,0,0,7
1447158,1216256,2022-06-15,Senate,"Do pass as amended, but first amend, and re-refer to the Committee on [Appropriations] with the recommendation: To Consent Calendar",9,0,0,2,11
1447158,1222637,2022-08-01,Senate,"Placed on suspense file",7,0,0,0,7
1447158,1223584,2022-08-11,Senate,"Do pass",7,0,0,0,7
1447158,1224459,2022-08-23,Senate,"Special Consent AB552",40,0,0,0,40
1447158,1224789,2022-08-24,Assembly,"AB 552 Quirk-Silva Concurrence in Senate Amendments",76,0,0,4,80
1447160,1049890,2021-04-08,Assembly,"Do pass and be re-referred to the Committee on [Appropriations]",8,5,2,0,15
1447162,1005314,2021-02-12,Assembly,"Be adopted. To Consent Calendar",11,0,1,0,12
1447162,1009553,2021-02-18,Assembly,"ACR 28 Calderon Consent Calendar Second Day Regular Session",68,0,11,0,79
1447162,1037847,2021-03-25,Senate,"Special Consent ACR28",38,0,2,0,40
1447163,1005304,2021-02-12,Assembly,"Be adopted. To third reading",11,0,1,0,12
1447164,1026107,2021-03-10,Senate,"Do pass, but first be re-referred to the Committee on [Judiciary]",9,0,0,0,9
1447164,1035153,2021-03-23,Senate,"Do pass, but first be re-referred to the Committee on [Appropriations] with the recommendation: To Consent Calendar",11,0,0,0,11
1447164,1045016,2021-04-05,Senate,"Placed on suspense file",7,0,0,0,7
1447164,1081511,2021-05-20,Senate,"Do pass",7,0,0,0,7
1447164,1089534,2021-06-01,Senate,"Special Consent SB360",39,0,1,0,40
1447164,1102869,2021-06-29,Assembly,"Do pass. To Consent Calendar",12,0,0,0,12
1447164,1104196,2021-07-05,Assembly,"SB 360 Wilk Consent Calendar Second Day",76,0,3,0,79
1447165,1047448,2021-04-06,Senate,"Do pass",10,1,0,0,11
1447165,1066834,2021-04-29,Senate,"Senate 3rd Reading SB361 Umberg",36,0,4,0,40
1447165,1216630,2022-06-15,Assembly,"Do pass as amended and be re-referred to the Committee on [Housing and Community Development]",7,1,0,0,8
1447165,1220761,2022-06-29,Assembly,"Do pass and be re-referred to the Committee on [Appropriations]",6,1,0,1,8
1447165,1223837,2022-08-11,Assembly,"Do pass as amended",12,4,0,0,16
1447166,1033626,2021-03-22,Senate,"Do pass, but first be re-referred to the Committee on [Appropriations]",9,3,2,0,14
1447166,1044982,2021-04-05,Senate,"Placed on suspense file",7,0,0,0,7
1447166,1082049,2021-05-20,Senate,"Do pass as amended",5,2,0,0,7
1447166,1089460,2021-06-01,Senate,"Senate 3rd Reading SB362 Newman",30,9,1,0,40
1447166,1104353,2021-07-06,Assembly,"Do pass as amended and be re-referred to the Committee on [Appropriations]",18,0,1,0,19
1447166,1106377,2021-08-19,Assembly,"Do pass",16,0,0,0,16
1447166,1107162,2021-08-30,Assembly,"SB 362 Newman Senate Third Reading By Blanca Rubio",73,0,0,6,79
1447166,1107508,2021-09-01,Senate,"Unfinished Business SB362 Newman Concurrence",31,6,0,3,40
1447167,1053425,2021-04-14,Senate,"Do pass, but first be re-referred to the Committee on [Rules]",4,1,2,0,7
1447167,1072243,2021-05-04,Senate,"Do pass as amended",9,0,2,0,11
1447167,1078767,2021-05-17,Senate,"Senate 3rd Reading SB363 Leyva et al",29,2,9,0,40
1447167,1100801,2021-06-23,Assembly,"Do pass and be re-referred to the Committee on [Judiciary]",5,1,1,0,7
1447167,1104686,2021-07-13,Assembly,"Do pass as amended",8,2,1,0,11
1447167,1107501,2021-09-01,Assembly,"SB 363 Leyva Senate Third Reading By Lorena Gonzalez",60,5,0,14,79
1447167,1107621,2021-09-02,Senate,"Unfinished Business SB363 Leyva et al. Concurrence",30,1,0,9,40
1447168,1047452,2021-04-07,Senate,"Do pass as amended, but first amend, and re-refer to the Committee on [Human Services]",7,0,0,0,7
1447168,1057707,2021-04-20,Senate,"Do pass, but first be re-referred to the Committee on [Appropriations]",5,0,0,0,5
1447168,1075270,2021-05-10,Senate,"Placed on suspense file",7,0,0,0,7
1447168,1126355,2022-01-20,Senate,"Do pass as amended",7,0,0,0,7
1447168,1129001,2022-01-26,Senate,"Senate 3rd Reading SB364 Skinner et al",37,0,0,3,40
1447168,1216655,2022-06-15,Assembly,"Do pass and be re-referred to the Committee on [Human Services]",6,0,0,1,7
1447168,1220031,2022-06-28,Assembly,"Do pass and be re-referred to the Committee on [Appropriations] with recommendation: To Consent Calendar",7,0,0,1,8
1447169,1036437,2021-03-24,Senate,"Do pass, but first be re-referred to the Committee on [Appropriations]",11,0,0,0,11
1447169,1078786,2021-05-17,Senate,"Placed on suspense file",7,0,0,0,7
1447169,1081891,2021-05-20,Senate,"Do pass",7,0,0,0,7
1447169,1087594,2021-05-28,Senate,"Senate 3rd Reading SB365 Caballero et al",38,0,2,0,40
1447169,1104299,2021-07-06,Assembly,"Do pass and be re-referred to the Committee on [Appropriations]",15,0,0,0,15
1447169,1106623,2021-08-26,Assembly,"Do pass",16,0,0,0,16
1447169,1107439,2021-09-01,Assembly,"SB 365 Caballero Senate Third Reading By Robert Rivas",78,0,0,1,79
1447170,1052013,2021-04-13,Senate,"Do pass, but first be re-referred to the Committee on [Appropriations] with the recommendation: To Consent Calendar",16,0,1,0,17
1447170,1068263,2021-05-03,Senate,"Placed on suspense file",6,0,1,0,7
1447170,1081860,2021-05-20,Senate,"Do pass",7,0,0,0,7
1447170,1089577,2021-06-01,Senate,"Special Consent SB366",39,0,1,0,40
1447170,1104296,2021-07-05,Assembly,"Do pass and be re-referred to the Committee on [Appropriations]",15,0,0,0,15
1447170,1106954,2021-08-26,Assembly,"Do pass",16,0,0,0,16
1447170,1108193,2021-09-08,Assembly,"SB 366 Umberg Senate Third Reading By Quirk-Silva",78,0,0,2,80
1447170,1108277,2021-09-09,Senate,"Unfinished Business SB366 Umberg Concurrence",38,0,0,2,40
1447171,1030826,2021-03-17,Senate,"Do pass as amended, but first amend, and re-refer to the Committee on [Health]",7,0,0,0,7
1447171,1047429,2021-04-07,Senate,"Do pass as amended, but first amend, and re-refer to the Committee on [Appropriations] with the recommendation: To Consent Calendar",11,0,0,0,11
1447171,1075294,2021-05-10,Senate,"Consent Calendar SB367",37,0,3,0,40
1447171,1212428,2022-06-02,Assembly,"Be re-referred to the Committees on [Higher Education] and [Health]",8,0,0,3,11
1447171,1215798,2022-06-14,Assembly,"Do pass and be re-referred to the Committee on [Health]",12,0,0,0,12
1447171,1220011,2022-06-28,Assembly,"Do pass and be re-referred to the Committee on [Appropriations] with recommendation: To Consent Calendar",15,0,0,0,15
1447171,1222991,2022-08-03,Assembly,"Do pass. To Consent Calendar",15,0,0,1,16
1447171,1223696,2022-08-11,Assembly,"SB 367 Hurtado Consent Calendar Second Day Regular Session",76,0,0,4,80
1447172,1030787,2021-03-17,Senate,"Do pass as amended, but first amend, and re-refer to the Committee on [Appropriations]",9,2,0,0,11
1447172,1056412,2021-04-19,Senate,"Placed on suspense file",7,0,0,0,7
1447172,1081819,2021-05-20,Senate,"Do pass",5,2,0,0,7
1447172,1089580,2021-06-01,Senate,"Senate 3rd Reading SB368 Lim贸n",31,9,0,0,40
1447172,1104328,2021-07-06,Assembly,"Do pass as amended and be re-referred to the Committee on [Appropriations]",13,2,0,0,15
1447172,1106760,2021-08-26,Assembly,"Do pass",13,3,0,0,16
1447172,1107649,2021-09-02,Assembly,"SB 368 Lim贸n Senate Third Reading By Arambula",59,14,0,6,79
1447172,1108199,2021-09-08,Senate,"Unfinished Business SB368 Lim贸n Concurrence",29,9,0,2,40
1447173,1029556,2021-03-16,Senate,"Do pass, but first be re-referred to the Committee on [Appropriations] with the recommendation: To Consent Calendar",9,0,0,0,9
1447173,1037807,2021-03-25,Senate,"Consent Calendar SB369",38,0,2,0,40
1447173,1099180,2021-06-17,Assembly,"Do pass and be re-referred to the Committee on [Appropriations]",15,0,0,0,15
1447173,1106903,2021-08-26,Assembly,"Do pass",16,0,0,0,16
1447173,1107575,2021-09-02,Assembly,"SB 369 Pan Senate Third Reading By Aguiar-Curry",76,0,0,3,79
1447173,1107777,2021-09-03,Senate,"Unfinished Business SB369 Pan Concurrence",38,0,0,2,40
1447174,1064084,2021-04-27,Senate,"Do pass as amended, but first amend, and re-refer to the Committee on [Appropriations] with the recommendation: To Consent Calendar",9,0,0,0,9
1447174,1120726,2022-01-06,Senate,"Senate 3rd Reading SB370 Dodd et al",32,0,0,8,40
1447174,1215905,2022-06-14,Assembly,"Do pass and be re-referred to the Committee on [Appropriations] with recommendation: To Consent Calendar",15,0,0,0,15
1447174,1217976,2022-06-22,Assembly,"Do pass. To Consent Calendar",13,0,0,3,16
1447174,1221567,2022-06-29,Assembly,"SB 370 Dodd Consent Calendar Second Day Regular Session",78,0,0,2,80
1447175,1036445,2021-03-24,Senate,"Do pass, but first be re-referred to the Committee on [Appropriations]",11,0,0,0,11
1447175,1056323,2021-04-19,Senate,"Placed on suspense file",7,0,0,0,7
1447175,1081832,2021-05-20,Senate,"Do pass as amended",7,0,0,0,7
1447175,1087623,2021-05-28,Senate,"Senate 3rd Reading SB371 Caballero et al",38,0,2,0,40
1447176,1050830,2021-04-12,Senate,"Do pass as amended, but first amend, and re-refer to the Committee on [Transportation]",6,1,0,0,7
1447176,1064039,2021-04-27,Senate,"Do pass, but first be re-referred to the Committee on [Appropriations]",16,0,1,0,17
1447176,1075323,2021-05-10,Senate,"Placed on suspense file",7,0,0,0,7
1447176,1082226,2021-05-20,Senate,"Do pass as amended",6,1,0,0,7
1447176,1089495,2021-06-01,Senate,"Senate 3rd Reading SB372 Leyva et al",37,2,1,0,40
1447176,1099716,2021-06-21,Assembly,"Do pass and be re-referred to the Committee on [Natural Resources]",15,0,0,0,15
1447176,1104416,2021-07-07,Assembly,"Do pass as amended and be re-referred to the Committee on [Appropriations]",11,0,0,0,11
1447176,1106961,2021-08-26,Assembly,"Do pass",16,0,0,0,16
1447176,1107541,2021-09-01,Assembly,"SB 372 Leyva Senate Third Reading By Friedman",75,0,0,4,79
1447176,1107687,2021-09-02,Senate,"Unfinished Business SB372 Leyva et al. Concurrence",37,2,0,1,40
1447178,1035184,2021-03-23,Senate,"Do pass, but first be re-referred to the Committee on [Appropriations]",11,0,0,0,11
1447178,1066688,2021-04-29,Senate,"Senate 3rd Reading SB374 Min et al",37,0,3,0,40
1447178,1095009,2021-06-08,Assembly,"Do pass and be re-referred to the Committee on [Appropriations]",9,1,1,0,11
1447178,1103386,2021-06-30,Assembly,"Do pass",11,0,5,0,16
1447178,1104658,2021-07-12,Assembly,"SB 374 Min Senate Third Reading By Petrie-Norris",56,0,23,0,79
1447180,1054691,2021-04-15,Senate,"Do pass, but first be re-referred to the Committee on [Public Safety]",7,0,2,0,9
1447180,1064136,2021-04-27,Senate,"Do pass as amended, but first amend, and re-refer to the Committee on [Appropriations]",5,0,0,0,5
1447180,1078809,2021-05-17,Senate,"Placed on suspense file",7,0,0,0,7
1447181,1023845,2021-03-08,Senate,"Do pass, but first be re-referred to the Committee on [Public Safety]",8,2,4,0,14
1447181,1124824,2022-01-18,Senate,"Placed on suspense file",6,0,0,1,7
1447182,1048966,2021-04-08,Senate,"Do pass as amended, but first amend, and re-refer to the Committee on [Energy, Utilities and Communications]",5,0,0,0,5
1447182,1062770,2021-04-26,Senate,"Do pass as amended, but first amend, and re-refer to the Committee on [Appropriations]",13,0,1,0,14
1447182,1081532,2021-05-20,Senate,"Senate 3rd Reading SB378 Gonzalez et al",35,0,5,0,40
1447182,1096058,2021-06-09,Assembly,"Do pass as amended and be re-referred to the Committee on [Communications and Conveyance]",8,0,0,0,8
1447182,1104447,2021-07-07,Assembly,"Do pass and be re-referred to the Committee on [Appropriations]",12,0,1,0,13
1447182,1106318,2021-08-19,Assembly,"Do pass",16,0,0,0,16
1447182,1107160,2021-08-30,Assembly,"SB 378 Gonzalez Senate Third Reading By Quirk",72,0,0,7,79
1447182,1107717,2021-09-02,Senate,"Unfinished Business SB378 Gonzalez et al. Concurrence",39,0,0,1,40
1447183,1030775,2021-03-17,Senate,"Do pass, but first be re-referred to the Committee on [Health]",5,2,0,0,7
1447183,1059219,2021-04-21,Senate,"Do pass, but first be re-referred to the Committee on [Appropriations]",9,2,0,0,11
1447183,1075378,2021-05-10,Senate,"Placed on suspense file",7,0,0,0,7
1447183,1120720,2022-01-06,Senate,"Do pass, but first be re-referred to the Committee on [Energy, Utilities and Communications]",3,1,0,1,5
1447183,1122870,2022-01-10,Senate,"Do pass as amended, but first amend, and re-refer to the Committee on [Appropriations]",11,1,0,2,14
1447183,1124820,2022-01-18,Senate,"Placed on suspense file",6,0,0,1,7
1447183,1126325,2022-01-20,Senate,"Do pass",5,0,0,2,7
1447183,1127175,2022-01-24,Senate,"Senate 3rd Reading SB379 Wiener",31,1,0,8,40
1447183,1216632,2022-06-15,Assembly,"Do pass as amended and be re-referred to the Committee on [Utilities and Energy]",6,1,0,1,8
1447183,1220813,2022-06-29,Assembly,"Do pass and be re-referred to the Committee on [Appropriations]",12,0,0,3,15
1447183,1223666,2022-08-11,Assembly,"Do pass as amended",13,2,0,1,16
1447183,1224199,2022-08-18,Assembly,"SB 379 Wiener Senate Third Reading By Muratsuchi",64,7,0,9,80
1447183,1224597,2022-08-23,Senate,"Unfinished Business SB379 Wiener et al. Concurrence",33,3,0,4,40
1447184,1036424,2021-03-24,Senate,"Do pass as amended, but first amend, and re-refer to the Committee on [Judiciary]",8,1,2,0,11
1447184,1059341,2021-04-20,Senate,"Do pass as amended, but first amend, and re-refer to the Committee on [Appropriations]",9,1,1,0,11
1447184,1078745,2021-05-17,Senate,"Placed on suspense file",7,0,0,0,7
1447184,1082004,2021-05-20,Senate,"Do pass",5,2,0,0,7
1447184,1087596,2021-05-28,Senate,"Senate 3rd Reading SB380 Eggman et al",26,8,6,0,40
1447184,1100807,2021-06-22,Assembly,"Do pass and be re-referred to the Committee on [Judiciary]",10,3,2,0,15
1447184,1104349,2021-07-06,Assembly,"Do pass and be re-referred to the Committee on [Appropriations]",6,2,3,0,11
1447184,1106885,2021-08-26,Assembly,"Do pass as amended",10,4,0,2,16
1447184,1108575,2021-09-10,Senate,"Unfinished Business SB380 Eggman et al. By Leyva Concurrence",26,8,0,6,40
1447184,1108576,2021-09-10,Assembly,"SB 380 Eggman Senate Third Reading By Wood",51,16,0,13,80
1447185,1064138,2021-04-27,Senate,"Do pass as amended, but first amend, and re-refer to the Committee on [Appropriations]",16,0,1,0,17
1447185,1078751,2021-05-17,Senate,"Placed on suspense file",7,0,0,0,7
1447185,1082130,2021-05-20,Senate,"Do pass as amended",7,0,0,0,7
1447185,1089556,2021-06-01,Senate,"Special Consent SB381 Portantino Urgency Clause",39,0,1,0,40
1447185,1104652,2021-07-12,Assembly,"Do pass and be re-referred to the Committee on [Appropriations]",8,0,0,0,8
1447185,1106970,2021-08-26,Assembly,"Do pass",16,0,0,0,16
1447185,1108505,2021-09-10,Assembly,"Do pass",6,1,0,1,8
1447185,1108638,2021-09-10,Senate,"Unfinished Business SB381 Portantino Urgency Clause Concurrence",35,0,0,5,40
1447185,1108639,2021-09-10,Assembly,"SB 381 Portantino Third Reading Urgency By RUBIO",63,12,0,5,80
1447186,1046183,2021-04-06,Senate,"Do pass, but first be re-referred to the Committee on [Appropriations]",5,0,0,0,5
1447186,1056342,2021-04-19,Senate,"Placed on suspense file",7,0,0,0,7
1447186,1082001,2021-05-20,Senate,"Do pass as amended",7,0,0,0,7
1447186,1127181,2022-01-24,Senate,"Senate 3rd Reading SB382 Caballero et al",36,0,0,4,40
1447186,1211861,2022-06-01,Assembly,"Do pass. To Consent Calendar",7,0,0,0,7
1447186,1215290,2022-06-09,Assembly,"SB 382 Caballero Consent Calendar Second Day Regular Session",69,0,0,9,78
1447186,1216604,2022-06-16,Senate,"Special Consent SB382",35,0,0,5,40
1447187,1051962,2021-04-13,Senate,"Do pass, but first be re-referred to the Committee on [Appropriations]",5,0,0,0,5
1447187,1086109,2021-05-26,Senate,"Senate 3rd Reading SB383 Cortese",32,6,2,0,40
1447187,1098145,2021-06-15,Assembly,"Do pass and be re-referred to the Committee on [Appropriations]",6,1,1,0,8
1447187,1103457,2021-06-30,Assembly,"Do pass",10,3,3,0,16
1447187,1108598,2021-09-10,Senate,"Unfinished Business SB383 Cortese Concurrence",29,7,0,4,40
1447187,1108599,2021-09-10,Assembly,"SB 383 Cortese Senate Third Reading By Stone",58,16,0,6,80
1447188,1025123,2021-03-09,Senate,"Do pass as amended, but first amend, and re-refer to the Committee on [Public Safety]",4,0,0,0,4
1447188,1051994,2021-04-13,Senate,"Do pass, but first be re-referred to the Committee on [Appropriations] with the recommendation: To Consent Calendar",5,0,0,0,5
1447188,1075241,2021-05-10,Senate,"Consent Calendar SB384",37,0,3,0,40
1447188,1210199,2022-05-27,Assembly,"Be re-referred to the Committee on [Human Services]",7,0,0,4,11
1447188,1220039,2022-06-28,Assembly,"Do pass as amended, and be re-referred to the Committee on [Appropriations] with recommendation: To Consent Calendar",7,0,0,1,8
1447188,1223825,2022-08-11,Assembly,"Do pass as amended",12,0,0,4,16
1447188,1224300,2022-08-22,Assembly,"SB 384 Cortese Senate Third Reading By Bennett",77,0,0,3,80
1447188,1224942,2022-08-25,Senate,"Unfinished Business SB384 Cortese Concurrence",40,0,0,0,40
1447189,1035194,2021-03-23,Senate,"Do pass, but first be re-referred to the Committee on [Appropriations] with the recommendation: To Consent Calendar",5,0,0,0,5
1447189,1044971,2021-04-05,Senate,"Placed on suspense file",7,0,0,0,7
1450050,1035161,2021-03-23,Assembly,"Do pass",10,1,0,0,11
1450050,1044967,2021-04-05,Assembly,"AB 556 Maienschein Assembly Third Reading",68,0,10,0,78
1450050,1095036,2021-06-08,Senate,"Do pass, but first be re-referred to the Committee on [Appropriations]",11,0,0,0,11
1450050,1099756,2021-06-21,Senate,"Placed on suspense file",7,0,0,0,7
1450050,1106589,2021-08-26,Senate,"Do pass",7,0,0,0,7
1450050,1107534,2021-09-01,Senate,"Assembly 3rd Reading AB556 Maienschein By Laird",39,0,0,1,40
1450051,1059230,2021-04-20,Assembly,"Do pass and be re-referred to the Committee on [Appropriations]",8,0,0,0,8
1450051,1081961,2021-05-20,Assembly,"Do pass",16,0,0,0,16
1450051,1092859,2021-06-01,Assembly,"AB 557 Muratsuchi Assembly Third Reading",79,0,0,0,79
1450051,1104254,2021-07-06,Senate,"Do pass, but first be re-referred to the Committee on [Appropriations] with the recommendation: To Consent Calendar",5,0,0,0,5
1450051,1106153,2021-08-16,Senate,"Placed on suspense file",7,0,0,0,7
1450051,1106775,2021-08-26,Senate,"Do pass as amended",5,0,0,2,7
1450051,1220756,2022-06-28,Senate,"Do pass, but first be re-referred to the Committee on [Appropriations]",5,0,0,0,5
1450051,1222789,2022-08-01,Senate,"Placed on suspense file",7,0,0,0,7
1450051,1223514,2022-08-11,Senate,"Do pass",7,0,0,0,7
1450051,1224609,2022-08-23,Senate,"Special Consent AB557",40,0,0,0,40
1450051,1225065,2022-08-29,Assembly,"With recommendation: That Senate amendments be concurred in",7,0,0,0,7
1450051,1225685,2022-08-30,Assembly,"AB 557 Muratsuchi Concurrence in Senate Amendments",79,0,0,1,80
1450052,1123773,2022-01-12,Assembly,"Do pass and be re-referred to the Committee on [Appropriations]",5,0,0,2,7
1450052,1126291,2022-01-20,Assembly,"Do pass",11,0,0,5,16
1450052,1129881,2022-01-27,Assembly,"AB 558 Nazarian Assembly Third Reading",47,7,0,22,76
1450052,1217842,2022-06-22,Senate,"Do pass as amended, but first amend, and re-refer to the Committee on [Appropriations]",4,1,0,2,7
1450052,1225404,2022-08-29,Senate,"Assembly 3rd Reading AB558 Nazarian et al. By Glazer",36,0,0,4,40
1450052,1225405,2022-08-30,Assembly,"AB 558 Nazarian Concurrence in Senate Amendments",66,0,0,14,80
1450053,1036480,2021-03-24,Assembly,"Do pass and be re-referred to the Committee on [Governmental Organization]",8,0,3,0,11
1450053,1060825,2021-04-22,Assembly,"Do pass and be re-referred to the Committee on [Appropriations]",13,5,4,0,22
1450053,1080389,2021-05-19,Assembly,"Do pass",11,4,1,0,16
1450053,1086940,2021-05-27,Assembly,"AB 559 Arambula Assembly Third Reading",56,17,5,0,78
1450053,1104576,2021-07-08,Senate,"Do pass as amended, but first amend, and re-refer to the Committee on [Appropriations]",7,1,1,0,9
1450053,1106391,2021-08-23,Senate,"Placed on suspense file",7,0,0,0,7
1450053,1106629,2021-08-26,Senate,"Do pass",5,2,0,0,7
1450053,1107437,2021-09-01,Senate,"Assembly 3rd Reading AB559 Arambula By Caballero",29,7,0,4,40
1450053,1107656,2021-09-02,Assembly,"AB 559 Arambula Concurrence in Senate Amendments",56,15,0,8,79
1450055,1067628,2021-04-29,Assembly,"Do pass and be re-referred to the Committee on [Appropriations]",5,0,3,0,8
1450055,1082066,2021-05-20,Assembly,"Do pass",12,3,1,0,16
1450055,1087011,2021-05-27,Assembly,"AB 561 Ting Assembly Third Reading",58,7,13,0,78
1450055,1104503,2021-07-08,Senate,"Do pass as amended, but first amend, and re-refer to the Committee on [Appropriations]",7,2,0,0,9
1450055,1106109,2021-08-16,Senate,"Placed on suspense file",7,0,0,0,7
1450055,1106621,2021-08-26,Senate,"Do pass as amended",5,2,0,0,7
1450056,1046145,2021-04-06,Assembly,"Do pass as amended and be re-referred to the Committee on [Health]",18,0,1,0,19
1450056,1081623,2021-05-20,Assembly,"Do pass",16,0,0,0,16
1450056,1086959,2021-05-27,Assembly,"AB 562 Low Third Reading Urgency",75,0,3,0,78
1450056,1103427,2021-06-30,Senate,"Do pass, but first be re-referred to the Committee on [Judiciary]",12,0,2,0,14
1450056,1104448,2021-07-06,Senate,"Do pass, but first be re-referred to the Committee on [Appropriations]",10,0,1,0,11
1450056,1106162,2021-08-16,Senate,"Placed on suspense file",7,0,0,0,7
1450057,1036435,2021-03-24,Assembly,"Do pass as amended and be re-referred to the Committee on [Health]",7,0,0,0,7
1450057,1051886,2021-04-13,Assembly,"Do pass and be re-referred to the Committee on [Appropriations] with recommendation: To Consent Calendar",15,0,0,0,15
1450057,1082046,2021-05-20,Assembly,"Do pass",16,0,0,0,16
1450057,1087008,2021-05-27,Assembly,"AB 563 Berman Assembly Third Reading",76,0,2,0,78
1450059,1048987,2021-04-08,Assembly,"Do pass and be re-referred to the Committee on [Appropriations] with recommendation: To Consent Calendar",7,0,0,0,7
1450059,1081590,2021-05-20,Assembly,"Do pass",16,0,0,0,16
1450059,1087065,2021-05-27,Assembly,"AB 565 Lackey Assembly Third Reading",78,0,0,0,78
1450059,1100353,2021-06-21,Senate,"Do pass, but first be re-referred to the Committee on [Appropriations] with the recommendation: To Consent Calendar",5,0,0,0,5
1450059,1107215,2021-08-30,Senate,"Assembly 3rd Reading AB565 Lackey et al. By Wilk",39,0,0,1,40
1450059,1107430,2021-09-01,Assembly,"AB 565 Lackey Concurrence in Senate Amendments",78,0,0,1,79
1450062,1047533,2021-04-07,Assembly,"Do pass and be re-referred to the Committee on [Education] with recommendation: To Consent Calendar",8,0,0,0,8
1450062,1065151,2021-04-28,Assembly,"Do pass as amended and be re-referred to the Committee on [Appropriations]",7,0,0,0,7
1450063,1035181,2021-03-23,Assembly,"Do pass and be re-referred to the Committee on [Appropriations]",17,0,2,0,19
1450063,1053547,2021-04-14,Assembly,"Do pass. To Consent Calendar",16,0,0,0,16
1450063,1060976,2021-04-22,Assembly,"AB 569 Grayson Consent Calendar Second Day Regular Session",77,0,2,0,79
1450063,1093668,2021-06-07,Senate,"Do pass, but first be re-referred to the Committee on [Judiciary]",12,0,2,0,14
1450063,1104203,2021-07-05,Senate,"Assembly 3rd Reading AB569 Grayson By Caballero",39,0,1,0,40
1450064,1064038,2021-04-27,Assembly,"Do pass and be re-referred to the Committee on [Appropriations]",10,2,3,0,15
1450064,1081415,2021-05-20,Assembly,"Do pass as amended",12,4,0,0,16
1450064,1092888,2021-06-01,Assembly,"AB 570 Santiago Assembly Third Reading",58,16,5,0,79
1450064,1101611,2021-06-23,Senate,"Do pass as amended, but first amend, and re-refer to the Committee on [Appropriations]",9,2,0,0,11
1450064,1105112,2021-07-15,Senate,"Placed on suspense file",7,0,0,0,7
1450064,1107019,2021-08-26,Senate,"Do pass as amended",5,2,0,0,7
1450064,1107479,2021-09-01,Senate,"Assembly 3rd Reading AB570 Santiago et al. By Durazo",30,9,0,1,40
1450064,1107722,2021-09-02,Assembly,"AB 570 Santiago Concurrence in Senate Amendments",54,15,0,10,79
1450065,1054751,2021-04-15,Assembly,"Do pass and be re-referred to the Committee on [Local Government]",8,0,0,0,8
1450065,1065185,2021-04-28,Assembly,"Do pass as amended and be re-referred to the Committee on [Appropriations]",8,0,0,0,8
1450065,1080420,2021-05-19,Assembly,"Do pass. To Consent Calendar",15,0,1,0,16
1450065,1087043,2021-05-27,Assembly,"AB 571 Mayes Consent Calendar Second Day Regular Session",75,0,3,0,78
1450065,1099117,2021-06-17,Senate,"Do pass, but first be re-referred to the Committee on [Governance and Finance]",8,0,1,0,9
1450065,1103795,2021-07-01,Senate,"Do pass, but first be re-referred to the Committee on [Appropriations]",5,0,0,0,5
1450065,1107873,2021-09-07,Senate,"Assembly 3rd Reading AB571 Mayes By Ochoa Bogh",37,0,0,3,40
1450065,1108119,2021-09-08,Assembly,"AB 571 Mayes Concurrence in Senate Amendments",79,0,0,1,80
1450066,1060843,2021-04-22,Assembly,"Do pass and be re-referred to the Committee on [Appropriations]",5,2,0,0,7
1450067,1035208,2021-03-23,Assembly,"Do pass and be re-referred to the Committee on [Appropriations]",14,0,1,0,15
1450070,1036504,2021-03-24,Assembly,"Do pass as amended and be re-referred to the Committee on [Appropriations]",12,0,0,0,12
1450070,1081646,2021-05-20,Assembly,"Do pass",16,0,0,0,16
1450070,1086928,2021-05-27,Assembly,"AB 576 Maienschein Assembly Third Reading",78,0,0,0,78
1450070,1098646,2021-06-16,Senate,"Do pass as amended, but first amend, and re-refer to the Committee on [Military and Veterans Affairs]",7,0,0,0,7
1450070,1103395,2021-06-30,Senate,"Do pass, but first be re-referred to the Committee on [Appropriations] with the recommendation: To Consent Calendar",6,0,1,0,7
1450070,1106224,2021-08-16,Senate,"Placed on suspense file",7,0,0,0,7
1450070,1106723,2021-08-26,Senate,"Do pass",7,0,0,0,7
1450070,1107816,2021-09-03,Senate,"Special Consent AB576",37,0,0,3,40
1450070,1107921,2021-09-07,Assembly,"AB 576 Maienschein Concurrence in Senate Amendments",73,0,0,7,80
1450073,1065258,2021-04-28,Assembly,"Do pass and be re-referred to the Committee on [Appropriations]",11,0,0,0,11
1450073,1081744,2021-05-20,Assembly,"Do pass",16,0,0,0,16
1450073,1086983,2021-05-27,Assembly,"AB 579 Flora Assembly Third Reading",77,0,1,0,78
1450073,1102856,2021-06-29,Senate,"Do pass, but first be re-referred to the Committee on [Public Safety] with the recommendation: To Consent Calendar",9,0,0,0,9
1450073,1104762,2021-07-13,Senate,"Do pass, but first be re-referred to the Committee on [Appropriations] with the recommendation: To Consent Calendar",5,0,0,0,5
1450073,1106211,2021-08-16,Senate,"Placed on suspense file",7,0,0,0,7
1450073,1106586,2021-08-26,Senate,"Do pass",7,0,0,0,7
1450073,1107776,2021-09-03,Senate,"Special Consent AB579",37,0,0,3,40
1450074,1057661,2021-04-19,Assembly,"Do pass. To Consent Calendar",6,0,1,0,7
1450074,1073340,2021-05-05,Assembly,"Do pass. To Consent Calendar",16,0,0,0,16
1450074,1077612,2021-05-13,Assembly,"AB 580 Rodriguez Consent Calendar Second Day Regular Session",75,0,3,0,78
1450074,1100281,2021-06-22,Senate,"Do pass, but first be re-referred to the Committee on [Appropriations] with the recommendation: To Consent Calendar",15,0,0,0,15
1450074,1104205,2021-07-05,Senate,"Placed on suspense file",6,0,1,0,7
1450074,1106851,2021-08-26,Senate,"Do pass",7,0,0,0,7
1450074,1108358,2021-09-09,Senate,"Assembly 3rd Reading AB580 Rodriguez By Leyva",38,0,0,2,40
1450074,1108359,2021-09-09,Assembly,"AB 580 RODRIGUEZ Concurrence in Senate Amendments",79,0,0,1,80
1450075,1048969,2021-04-08,Assembly,"Do pass and be re-referred to the Committee on [Accountability and Administrative Review] with recommendation: To Consent Calendar",11,0,0,0,11
1450075,1065245,2021-04-28,Assembly,"Do pass and be re-referred to the Committee on [Appropriations]",7,0,0,0,7
1450075,1126307,2022-01-20,Assembly,"Do pass",15,0,0,1,16
1450075,1131250,2022-01-31,Assembly,"AB 581 Irwin Assembly Third Reading",75,0,0,1,76
1450075,1215730,2022-06-14,Senate,"Do pass, but first be re-referred to the Committee on [Appropriations]",14,0,0,1,15
1450075,1219372,2022-06-27,Senate,"Placed on suspense file",6,0,0,1,7
1450076,1047547,2021-04-06,Assembly,"Do pass and be re-referred to the Committee on [Appropriations]",7,1,0,0,8
1450077,1035197,2021-03-23,Assembly,"Do pass",11,0,0,0,11
1450077,1083837,2021-05-24,Assembly,"AB 583 Davies Third Reading Urgency",75,0,3,0,78
1450077,1098161,2021-06-15,Senate,"Do pass",10,0,1,0,11
1450077,1108241,2021-09-09,Senate,"Assembly 3rd Reading AB583 Davies et al. By Min Urgency Clause",38,0,0,2,40
1450077,1108242,2021-09-09,Assembly,"AB 583 DAVIES Concurrence in Senate Amendments",77,0,0,3,80
1450079,1036543,2021-03-24,Assembly,"Do pass and be re-referred to the Committee on [Appropriations]",9,0,2,0,11
1450079,1081955,2021-05-20,Assembly,"Do pass as amended",13,1,2,0,16
1450079,1090482,2021-06-02,Assembly,"AB 585 Luz Rivas Assembly Third Reading",67,1,11,0,79
1450079,1102848,2021-06-29,Senate,"Do pass as amended, but first amend, and re-refer to the Committee on [Environmental Quality]",9,0,0,0,9
1450079,1104619,2021-07-12,Senate,"Do pass as amended, but first amend, and re-refer to the Committee on [Appropriations]",5,0,2,0,7
1450079,1106068,2021-08-16,Senate,"Placed on suspense file",7,0,0,0,7
1450080,1048982,2021-04-07,Assembly,"Do pass and be re-referred to the Committee on [Health]",7,0,0,0,7
1450080,1051976,2021-04-13,Assembly,"Do pass as amended and be re-referred to the Committee on [Appropriations]",15,0,0,0,15
1450080,1081837,2021-05-20,Assembly,"Do pass as amended",12,0,4,0,16
1450080,1092904,2021-06-01,Assembly,"AB 586 O'Donnell Assembly Third Reading",78,0,1,0,79
1450081,1060824,2021-04-22,Assembly,"Do pass and be re-referred to the Committee on [Judiciary]",9,0,2,0,11
1450081,1064105,2021-04-27,Assembly,"Do pass as amended and be re-referred to the Committee on [Appropriations]",10,0,1,0,11
1450081,1081803,2021-05-20,Assembly,"Do pass",13,0,3,0,16
1450081,1090423,2021-06-02,Assembly,"AB 587 Gabriel Assembly Third Reading",64,1,14,0,79
1450081,1220678,2022-06-28,Senate,"Do pass as amended, but first amend, and re-refer to the Committee on [Appropriations]",9,0,0,2,11
1450081,1222893,2022-08-01,Senate,"Placed on suspense file",7,0,0,0,7
1450081,1223815,2022-08-11,Senate,"Do pass as amended",5,0,0,2,7
1450081,1225567,2022-08-29,Senate,"Assembly 3rd Reading AB587 Gabriel et al. By Umberg",33,3,0,4,40
1450081,1225568,2022-08-30,Assembly,"AB 587 Gabriel Concurrence in Senate Amendments",66,0,0,14,80
1450081,1229727,2022-08-30,Senate,"Assembly 3rd Reading AB587 Gabriel et al. By Umberg",33,3,0,4,40
1450085,1035232,2021-03-22,Assembly,"Do pass and be re-referred to the Committee on [Appropriations] with recommendation: To Consent Calendar",15,0,0,0,15
1450085,1053565,2021-04-14,Assembly,"Do pass. To Consent Calendar",16,0,0,0,16
1450085,1060916,2021-04-22,Assembly,"AB 591 Villapudua Consent Calendar Second Day Regular Session",77,0,2,0,79
1450085,1098169,2021-06-15,Senate,"Do pass and be ordered to the Consent Calendar",17,0,0,0,17
1450085,1101600,2021-06-24,Senate,"Consent Calendar AB591",39,0,1,0,40
1450086,1059191,2021-04-21,Assembly,"Do pass and be re-referred to the Committee on [Appropriations] with recommendation: To Consent Calendar",8,0,0,0,8
1450086,1082040,2021-05-20,Assembly,"Do pass as amended",16,0,0,0,16
1450086,1086956,2021-05-27,Assembly,"AB 592 Friedman Assembly Third Reading",76,0,2,0,78
1450086,1100264,2021-06-22,Senate,"Do pass as amended, but first amend, and re-refer to the Committee on [Appropriations]",5,0,0,0,5
1450086,1105153,2021-07-15,Senate,"Placed on suspense file",7,0,0,0,7
1450086,1106796,2021-08-26,Senate,"Do pass",7,0,0,0,7
1450086,1107757,2021-09-03,Senate,"Special Consent AB592",37,0,0,3,40
1450086,1107922,2021-09-07,Assembly,"AB 592 Friedman Concurrence in Senate Amendments",73,0,0,7,80
1450087,1051959,2021-04-12,Assembly,"Do pass as amended and be re-referred to the Committee on [Appropriations]",9,0,2,0,11
1450088,1036532,2021-03-23,Assembly,"Do pass and be re-referred to the Committee on [Appropriations]",5,1,2,0,8
1450089,1036444,2021-03-24,Assembly,"Do pass and be re-referred to the Committee on [Appropriations]",11,1,0,0,12
1450089,1126266,2022-01-20,Assembly,"Do pass",15,0,0,1,16
1450089,1127201,2022-01-24,Assembly,"AB 595 Medina Third Reading Urgency",66,0,0,10,76
1450089,1211881,2022-06-01,Senate,"Do pass as amended, but first amend, and re-refer to the Committee on [Appropriations]",5,0,0,2,7
1450089,1217060,2022-06-20,Senate,"Placed on suspense file",4,0,0,3,7
1450093,1048904,2021-04-07,Assembly,"Do pass as amended and be re-referred to the Committee on [Appropriations]",7,0,0,0,7
1450093,1065288,2021-04-28,Assembly,"Do pass. To Consent Calendar",16,0,0,0,16
1450093,1074131,2021-05-06,Assembly,"AB 599 Jones-Sawyer Consent Calendar Second Day Regular Session",77,0,1,0,78
1450093,1104970,2021-07-14,Senate,"Do pass as amended, but first amend, and re-refer to the Committee on [Appropriations] with the recommendation: To Consent Calendar",7,0,0,0,7
1450093,1106063,2021-08-16,Senate,"Placed on suspense file",7,0,0,0,7
1450093,1106633,2021-08-26,Senate,"Do pass",7,0,0,0,7
1450093,1107822,2021-09-03,Senate,"Special Consent AB599",37,0,0,3,40
1450093,1107923,2021-09-07,Assembly,"AB 599 Jones-Sawyer Concurrence in Senate Amendments",73,0,0,7,80
1450094,1047593,2021-04-06,Assembly,"Do pass as amended and be re-referred to the Committee on [Appropriations]",7,0,1,0,8
1450094,1081964,2021-05-20,Assembly,"Do pass",14,0,2,0,16
1450094,1090426,2021-06-02,Assembly,"AB 600 Arambula Assembly Third Reading",71,0,8,0,79
1450094,1104770,2021-07-13,Senate,"Do pass, but first be re-referred to the Committee on [Appropriations] with the recommendation: To Consent Calendar",5,0,0,0,5
1450094,1106061,2021-08-16,Senate,"Placed on suspense file",7,0,0,0,7
1450094,1106896,2021-08-26,Senate,"Do pass",6,0,0,1,7
1450094,1107392,2021-09-01,Senate,"Assembly 3rd Reading AB600 Arambula By Pan",35,0,0,5,40
1450094,1107633,2021-09-02,Assembly,"AB 600 Arambula Concurrence in Senate Amendments",70,0,0,9,79
1450096,1054590,2021-04-14,Assembly,"Do pass as amended and be re-referred to the Committee on [Housing and Community Development]",8,0,0,0,8
1450096,1067632,2021-04-29,Assembly,"Do pass as amended and be re-referred to the Committee on [Appropriations]",7,0,1,0,8
1450096,1081708,2021-05-20,Assembly,"Do pass",16,0,0,0,16
1450096,1087027,2021-05-27,Assembly,"AB 602 Grayson Assembly Third Reading",76,0,2,0,78
1450096,1103763,2021-07-01,Senate,"Do pass as amended, but first amend, and re-refer to the Committee on [Housing]",5,0,0,0,5
1450096,1104538,2021-07-08,Senate,"Do pass, but first be re-referred to the Committee on [Appropriations]",9,0,0,0,9
1450096,1106135,2021-08-16,Senate,"Placed on suspense file",7,0,0,0,7
1450096,1106824,2021-08-26,Senate,"Do pass as amended",7,0,0,0,7
1450096,1107859,2021-09-07,Senate,"Assembly 3rd Reading AB602 Grayson et al. By Caballero",37,0,0,3,40
1450096,1108207,2021-09-08,Assembly,"AB 602 Grayson Concurrence in Senate Amendments",78,0,0,2,80
1450097,1047495,2021-04-06,Assembly,"Do pass and be re-referred to the Committee on [Appropriations] with recommendation: To Consent Calendar",8,0,0,0,8
1450097,1065136,2021-04-28,Assembly,"Do pass. To Consent Calendar",16,0,0,0,16
1450097,1074118,2021-05-06,Assembly,"AB 603 McCarty Consent Calendar Second Day Regular Session",77,0,1,0,78
1450097,1100245,2021-06-22,Senate,"Do pass, but first be re-referred to the Committee on [Appropriations]",5,0,0,0,5
1450097,1107606,2021-09-02,Senate,"Assembly 3rd Reading AB603 McCarty By Allen",39,0,0,1,40
1450097,1107924,2021-09-07,Assembly,"AB 603 McCarty Concurrence in Senate Amendments",73,0,0,7,80
1450098,1044989,2021-04-05,Assembly,"Do pass and be re-referred to the Committee on [Appropriations] with recommendation: To Consent Calendar",14,0,1,0,15
1450098,1081741,2021-05-20,Assembly,"Do pass",16,0,0,0,16
1450098,1090379,2021-06-02,Assembly,"AB 604 Daly Assembly Third Reading",75,0,4,0,79
1450098,1102853,2021-06-29,Senate,"Do pass, but first be re-referred to the Committee on [Appropriations] with the recommendation: To Consent Calendar",17,0,0,0,17
1450098,1105118,2021-07-15,Senate,"Placed on suspense file",7,0,0,0,7
1450098,1106913,2021-08-26,Senate,"Do pass",7,0,0,0,7
1450098,1107758,2021-09-03,Senate,"Special Consent AB604",37,0,0,3,40
1450099,1106352,2021-08-19,Assembly,"Be adopted. To Consent Calendar",11,0,0,1,12
1450099,1107024,2021-08-26,Assembly,"ACR 29 Voepel Consent Calendar Second Day",73,0,0,6,79
1450099,1140882,2022-02-10,Senate,"Special Consent ACR29 Voepel et al",37,0,0,3,40
1450100,1025101,2021-03-09,Senate,"Do pass, but first be re-referred to the Committee on [Appropriations]",12,0,2,0,14
1450100,1062769,2021-04-26,Senate,"Senate 3rd Reading SB386 Umberg",37,1,2,0,40
1450100,1104696,2021-07-12,Assembly,"Do pass and be re-referred to the Committee on [Appropriations]",21,0,1,0,22
1450100,1106314,2021-08-19,Assembly,"Do pass. To Consent Calendar",16,0,0,0,16
1450100,1108098,2021-09-08,Assembly,"SB 386 Umberg Senate Third Reading By Daly",79,0,0,1,80
1450100,1108228,2021-09-09,Senate,"Unfinished Business SB386 Umberg et al. Concurrence",37,1,0,2,40
1450101,1057674,2021-04-20,Senate,"Do pass as amended, but first amend, and re-refer to the Committee on [Appropriations]",5,0,0,0,5
1450101,1075258,2021-05-10,Senate,"Placed on suspense file",7,0,0,0,7
1450101,1081975,2021-05-20,Senate,"Do pass as amended",7,0,0,0,7
1450101,1123756,2022-01-12,Senate,"Do pass, but first be re-referred to the Committee on [Appropriations]",7,0,0,0,7
1450101,1124831,2022-01-18,Senate,"Placed on suspense file",6,0,0,1,7
1450101,1126280,2022-01-20,Senate,"Do pass",7,0,0,0,7
1450101,1127172,2022-01-24,Senate,"Senate 3rd Reading SB387 Portantino",36,0,0,4,40
1450103,1057733,2021-04-20,Senate,"Do pass as amended, but first amend, and re-refer to the Committee on [Appropriations]",15,0,0,0,15
1450103,1075302,2021-05-10,Senate,"Senate 3rd Reading SB389 Dodd et al",36,0,4,0,40
1450103,1105071,2021-07-12,Assembly,"Do pass as amended and be re-referred to the Committee on [Appropriations]",21,0,1,0,22
1450103,1106699,2021-08-26,Assembly,"Do pass as amended",12,0,0,4,16
1450103,1108051,2021-09-08,Assembly,"SB 389 Dodd Senate Third Reading By Bauer-Kahan",80,0,0,0,80
1450103,1108308,2021-09-09,Senate,"Unfinished Business SB389 Dodd et al. Concurrence",38,0,0,2,40
1450104,1056408,2021-04-19,Senate,"Do pass, but first be re-referred to the Committee on [Appropriations] with the recommendation: To Consent Calendar",5,0,0,0,5
1450104,1075342,2021-05-10,Senate,"Placed on suspense file",7,0,0,0,7
1450104,1081458,2021-05-20,Senate,"Do pass as amended",7,0,0,0,7
1450104,1087592,2021-05-28,Senate,"Senate 3rd Reading SB390 Laird et al",38,0,2,0,40
1450104,1101644,2021-06-24,Assembly,"Do pass and be re-referred to the Committee on [Appropriations] with recommendation: To Consent Calendar",14,0,0,0,14
1450104,1106782,2021-08-26,Assembly,"Do pass",16,0,0,0,16
1450104,1107386,2021-09-01,Assembly,"SB 390 Laird Senate Third Reading By Wicks",78,0,0,1,79
1450104,1107580,2021-09-02,Senate,"Unfinished Business SB390 Laird et al. Concurrence",39,0,0,1,40
1450105,1031894,2021-03-18,Senate,"Do pass as amended, but first amend, and re-refer to the Committee on [Judiciary]",6,0,3,0,9
1450105,1047474,2021-04-06,Senate,"Do pass as amended",10,1,0,0,11
1450105,1066825,2021-04-29,Senate,"Senate 3rd Reading SB391 Min Urgency Clause",35,1,4,0,40
1450105,1095012,2021-06-08,Assembly,"Do pass and be re-referred to the Committee on [Judiciary]",7,0,1,0,8
1450105,1100265,2021-06-22,Assembly,"Do pass",10,0,1,0,11
1450105,1104612,2021-07-12,Assembly,"SB 391 Min Third Reading Urgency By Davies",71,0,8,0,79
1450105,1106186,2021-08-16,Senate,"Unfinished Business SB391 Min et al. Urgency Clause Concurrence",39,0,0,1,40
1450106,1054677,2021-04-15,Senate,"Do pass, but first be re-referred to the Committee on [Judiciary]",8,0,1,0,9
1450106,1065303,2021-04-27,Senate,"Do pass as amended",10,1,0,0,11
1450106,1077581,2021-05-13,Senate,"Senate 3rd Reading SB392 Archuleta et al",36,0,4,0,40
1450106,1095064,2021-06-08,Assembly,"Do pass as amended and be re-referred to the Committee on [Judiciary]",7,0,1,0,8
1450106,1100342,2021-06-22,Assembly,"Do pass as amended",8,0,3,0,11
1450106,1104669,2021-07-12,Assembly,"SB 392 Archuleta Senate Third Reading By Mayes",76,0,3,0,79
1450106,1106311,2021-08-19,Senate,"Unfinished Business SB392 Archuleta et al. Concurrence",38,0,0,2,40
1450106,1108688,2021-09-10,Senate,"Unfinished Business SB392 Archuleta et al. Concurrence",37,0,0,3,40
1450106,1108689,2021-09-10,Assembly,"SB 392 Archuleta Senate Third Reading By Mayes",77,0,0,3,80
1450107,1030792,2021-03-17,Senate,"Do pass, but first be re-referred to the Committee on [Human Services] with the recommendation: To Consent Calendar",7,0,0,0,7
1450107,1035255,2021-03-23,Senate,"Do pass, but first be re-referred to the Committee on [Appropriations] with the recommendation: To Consent Calendar",5,0,0,0,5
1450107,1056422,2021-04-19,Senate,"Placed on suspense file",7,0,0,0,7
1450107,1082173,2021-05-20,Senate,"Do pass as amended",7,0,0,0,7
1450107,1089604,2021-06-01,Senate,"Special Consent SB393",39,0,1,0,40
1450107,1103376,2021-06-30,Assembly,"Do pass and be re-referred to the Committee on [Education]",8,0,0,0,8
1450107,1104376,2021-07-07,Assembly,"Do pass and be re-referred to the Committee on [Appropriations] with recommendation: To Consent Calendar",7,0,0,0,7
1450107,1106931,2021-08-26,Assembly,"Do pass as amended",12,0,0,4,16
1450107,1107537,2021-09-01,Assembly,"SB 393 Hurtado Senate Third Reading By Salas",77,0,0,2,79
1450107,1107735,2021-09-02,Senate,"Unfinished Business SB393 Hurtado Concurrence",39,0,0,1,40
1450108,1028413,2021-03-15,Senate,"Do pass, but first be re-referred to the Committee on [Appropriations]",14,0,0,0,14
1450108,1044975,2021-04-05,Senate,"Senate 3rd Reading SB394 Hueso",38,0,2,0,40
1450108,1104458,2021-07-07,Assembly,"Do pass and be re-referred to the Committee on [Appropriations] with recommendation: To Consent Calendar",12,0,1,0,13
1450108,1106694,2021-08-26,Assembly,"Do pass",16,0,0,0,16
1450108,1107543,2021-09-01,Assembly,"SB 394 Hueso Senate Third Reading By Santiago",78,0,0,1,79
1450109,1049010,2021-04-08,Senate,"Do pass as amended, but first amend, and re-refer to the Committee on [Health]",4,0,1,0,5
1450109,1065301,2021-04-28,Senate,"Do pass as amended, but first amend, and re-refer to the Committee on [Appropriations]",8,2,1,0,11
1450109,1078789,2021-05-17,Senate,"Placed on suspense file",7,0,0,0,7
1450109,1082031,2021-05-20,Senate,"Do pass",5,1,1,0,7
1450109,1089597,2021-06-01,Senate,"Senate 3rd Reading SB395 Caballero et al",29,8,3,0,40
1450109,1100263,2021-06-21,Assembly,"Do pass and be re-referred to the Committee on [Health]",8,1,2,0,11
1450109,1104766,2021-07-13,Assembly,"Do pass as amended and be re-referred to the Committee on [Appropriations]",12,2,1,0,15
1450109,1106585,2021-08-26,Assembly,"Do pass as amended",12,4,0,0,16
1450109,1107450,2021-09-01,Assembly,"SB 395 Caballero Senate Third Reading By Arambula",61,14,0,4,79
1450109,1107598,2021-09-02,Senate,"Unfinished Business SB395 Caballero et al. Concurrence",29,9,0,2,40
1450110,1054609,2021-04-15,Senate,"Do pass as amended, but first amend, and re-refer to the Committee on [Appropriations] with the recommendation: To Consent Calendar",9,0,0,0,9
1450110,1056343,2021-04-15,Senate,"Do pass, but first be re-referred to the Committee on [Appropriations] with the recommendation: To Consent Calendar",9,0,0,0,9
1450110,1077606,2021-05-13,Senate,"Consent Calendar SB396 Dahle",38,0,2,0,40
1450110,1104456,2021-07-07,Assembly,"Do pass as amended and be re-referred to the Committee on [Appropriations]",11,0,0,0,11
1450110,1106639,2021-08-26,Assembly,"Do pass",16,0,0,0,16
1450110,1214375,2022-06-06,Assembly,"Do pass as amended",6,0,0,4,10
1450110,1222628,2022-08-01,Assembly,"SB 396 Bradford Senate Third Reading By Mayes",54,1,0,25,80
1450110,1224107,2022-08-16,Senate,"That the Assembly amendments be taken up for consideration",8,3,0,3,14
1450111,1053555,2021-04-13,Senate,"Do pass, but first be re-referred to the Committee on [Governmental Organization]",2,7,2,0,11
1450111,1053556,2021-04-13,Senate,"[First] hearing set for [04-14-2021]: Failed passage in Committee. Reconsideration granted",10,0,1,0,11
1450112,1048998,2021-04-08,Senate,"Do pass as amended, but first amend, and re-refer to the Committee on [Rules]",4,1,0,0,5
1450112,1056435,2021-04-19,Senate,"Do pass, but first be re-referred to the Committee on [Appropriations]",9,4,1,0,14
1450112,1068170,2021-05-03,Senate,"Placed on suspense file",6,0,1,0,7
1450113,1007231,2021-02-16,Senate,"Senate 3rd Reading SR9 Atkins",33,0,6,0,39
1451018,1123288,2022-01-10,Assembly,"Do pass and be re-referred to the Committee on [Appropriations]",9,0,0,2,11
1451022,1035166,2021-03-23,Assembly,"Do pass. To Consent Calendar",11,0,0,0,11
1451022,1044991,2021-04-05,Assembly,"AB 611 Quirk-Silva Consent Calendar Second Day",74,0,4,0,78
1451022,1099143,2021-06-17,Senate,"Do pass, but first be re-referred to the Committee on [Judiciary] with the recommendation: To Consent Calendar",8,0,1,0,9
1451022,1103487,2021-06-29,Senate,"Do pass and be ordered to the Consent Calendar",11,0,0,0,11
1451022,1104640,2021-07-12,Senate,"Consent Calendar AB611 Quirk-Silva",39,0,1,0,40
1451022,1106143,2021-08-16,Assembly,"AB 611 Quirk-Silva Concurrence in Senate Amendments",77,0,0,2,79
1451025,1049869,2021-04-08,Assembly,"Do pass and be re-referred to the Committee on [Appropriations]",13,1,1,0,15
1451025,1081484,2021-05-20,Assembly,"Do pass as amended",12,0,4,0,16
1451025,1092958,2021-06-01,Assembly,"AB 614 Aguiar-Curry Assembly Third Reading",65,2,12,0,79
1451025,1104687,2021-07-13,Senate,"Do pass, but first be re-referred to the Committee on [Appropriations]",8,0,1,0,9
1451025,1106185,2021-08-16,Senate,"Placed on suspense file",7,0,0,0,7
1451025,1106632,2021-08-26,Senate,"Do pass",7,0,0,0,7
1451025,1107454,2021-09-01,Senate,"Assembly 3rd Reading AB614 Aguiar-Curry By Cortese",35,1,0,4,40
1451025,1107588,2021-09-02,Assembly,"AB 614 Aguiar-Curry Concurrence in Senate Amendments",69,2,0,8,79
1451026,1054708,2021-04-15,Assembly,"Do pass and be re-referred to the Committee on [Appropriations]",5,2,0,0,7
1451026,1081786,2021-05-20,Assembly,"Do pass",12,4,0,0,16
1451026,1087080,2021-05-27,Assembly,"AB 615 Rodriguez Assembly Third Reading",58,15,5,0,78
1451026,1102514,2021-06-28,Senate,"Do pass, but first be re-referred to the Committee on [Appropriations]",4,1,0,0,5
1451026,1105083,2021-07-15,Senate,"Placed on suspense file",7,0,0,0,7
1451026,1106665,2021-08-26,Senate,"Do pass",5,2,0,0,7
1451026,1107688,2021-09-02,Senate,"Assembly 3rd Reading AB615 Rodriguez By Pan",30,7,0,3,40
1451026,1107925,2021-09-07,Assembly,"AB 615 Rodriguez Concurrence in Senate Amendments",58,5,0,17,80
1451027,1060931,2021-04-22,Assembly,"Do pass and be re-referred to the Committee on [Appropriations]",5,2,0,0,7
1451027,1073413,2021-05-05,Assembly,"Do pass",12,4,0,0,16
1451027,1075339,2021-05-10,Assembly,"AB 616 Stone Assembly Third Reading",50,17,11,0,78
1451027,1093664,2021-06-07,Senate,"Do pass, but first be re-referred to the Committee on [Appropriations]",4,1,0,0,5
1451027,1106670,2021-08-26,Senate,"Assembly 3rd Reading AB616 Stone et al. By Leyva",24,11,0,5,40
1451027,1107427,2021-09-01,Assembly,"AB 616 Stone Concurrence in Senate Amendments",52,19,0,8,79
1451029,1064013,2021-04-27,Assembly,"Do pass as amended, and be re-referred to the Committee on [Appropriations] with recommendation: To Consent Calendar",11,0,0,0,11
1451030,1046126,2021-04-06,Assembly,"Do pass as amended and be re-referred to the Committee on [Emergency Management]",15,0,0,0,15
1451030,1057669,2021-04-19,Assembly,"Do pass. To Consent Calendar",6,0,1,0,7
1451030,1081835,2021-05-20,Assembly,"Do pass as amended",16,0,0,0,16
1451030,1092945,2021-06-01,Assembly,"AB 619 Calderon Assembly Third Reading",79,0,0,0,79
1451030,1101574,2021-06-23,Senate,"Do pass as amended, but first amend, and re-refer to the Committee on [Governmental Organization] with the recommendation: To Consent Calendar",11,0,0,0,11
1451030,1104311,2021-07-06,Senate,"Do pass, but first be re-referred to the Committee on [Appropriations] with the recommendation: To Consent Calendar",15,0,0,0,15
1451030,1106192,2021-08-16,Senate,"Placed on suspense file",7,0,0,0,7
1451030,1106593,2021-08-26,Senate,"Do pass as amended",7,0,0,0,7
1451030,1108043,2021-09-08,Senate,"Assembly 3rd Reading AB619 Calderon et al. By Pan",38,0,0,2,40
1451030,1108296,2021-09-09,Assembly,"AB 619 Calderon Concurrence in Senate Amendments",80,0,0,0,80
1451034,1054728,2021-04-15,Assembly,"Do pass and be re-referred to the Committee on [Appropriations] with recommendation: To Consent Calendar",11,0,0,0,11
1451034,1065267,2021-04-28,Assembly,"Do pass. To Consent Calendar",16,0,0,0,16
1451034,1074147,2021-05-06,Assembly,"AB 623 AGRI. Consent Calendar Second Day Regular Session",77,0,1,0,78
1451034,1103755,2021-07-01,Senate,"Do pass, but first be re-referred to the Committee on [Appropriations] with the recommendation: To Consent Calendar",5,0,0,0,5
1451034,1107203,2021-08-30,Senate,"Assembly 3rd Reading AB623 AGRI. (Rivas, R.) By Caballero",39,0,0,1,40
1451034,1107422,2021-09-01,Assembly,"AB 623 AGRI. Concurrence in Senate Amendments By RIVAS, R",78,0,0,1,79
1451035,1065178,2021-04-27,Assembly,"Do pass and be re-referred to the Committee on [Appropriations]",8,0,0,0,8
1451035,1081886,2021-05-20,Assembly,"Do pass",16,0,0,0,16
1451035,1086995,2021-05-27,Assembly,"AB 624 Bauer-Kahan Assembly Third Reading",77,0,1,0,78
1451035,1104304,2021-07-06,Senate,"Do pass, but first be re-referred to the Committee on [Appropriations] with the recommendation: To Consent Calendar",5,0,0,0,5
1451035,1107125,2021-08-30,Senate,"Consent Calendar AB624",39,0,0,1,40
1451036,1059199,2021-04-20,Assembly,"Do pass and be re-referred to the Committee on [Appropriations] with recommendation: To Consent Calendar",8,0,0,0,8
1451036,1082057,2021-05-20,Assembly,"Do pass as amended",16,0,0,0,16
1451036,1090466,2021-06-02,Assembly,"AB 625 Arambula Assembly Third Reading",77,0,2,0,79
1451036,1104737,2021-07-13,Senate,"Do pass, but first be re-referred to the Committee on [Appropriations] with the recommendation: To Consent Calendar",5,0,0,0,5
1451036,1106161,2021-08-16,Senate,"Placed on suspense file",7,0,0,0,7
1451036,1106912,2021-08-26,Senate,"Do pass",7,0,0,0,7
1451036,1107810,2021-09-03,Senate,"Special Consent AB625",37,0,0,3,40
1451038,1035213,2021-03-23,Assembly,"Do pass and be re-referred to the Committee on [Appropriations] with recommendation: To Consent Calendar",11,0,0,0,11
1451038,1053521,2021-04-14,Assembly,"Do pass. To Consent Calendar",16,0,0,0,16
1451038,1060914,2021-04-22,Assembly,"AB 627 Waldron Consent Calendar Second Day Regular Session",77,0,2,0,79
1451038,1095008,2021-06-08,Senate,"Do pass, but first be re-referred to the Committee on [Appropriations] with the recommendation: To Consent Calendar",11,0,0,0,11
1451038,1101566,2021-06-24,Senate,"Consent Calendar AB627",39,0,1,0,40
1451039,1048983,2021-04-08,Assembly,"Do pass and be re-referred to the Committee on [Jobs, Economic Development, and the Economy]",7,0,0,0,7
1451039,1064124,2021-04-27,Assembly,"Do pass as amended and be re-referred to the Committee on [Appropriations]",6,0,1,0,7
1451039,1081973,2021-05-20,Assembly,"Do pass",13,3,0,0,16
1451039,1087040,2021-05-27,Assembly,"AB 628 Eduardo Garcia Assembly Third Reading",69,5,4,0,78
1451039,1102518,2021-06-28,Senate,"Do pass as amended, but first amend, and re-refer to the Committee on [Appropriations]",5,0,0,0,5
1451039,1105034,2021-07-15,Senate,"Placed on suspense file",7,0,0,0,7
1451039,1106688,2021-08-26,Senate,"Do pass as amended",7,0,0,0,7
1451039,1108115,2021-09-08,Senate,"Special Consent AB628",38,0,0,2,40
1451039,1108406,2021-09-09,Assembly,"AB 628 Eduardo Garcia Concurrence in Senate Amendments",76,0,0,4,80
1451040,1064151,2021-04-26,Assembly,"Do pass and be re-referred to the Committee on [Appropriations] with recommendation: To Consent Calendar",15,0,0,0,15
1451041,1064063,2021-04-27,Assembly,"Do pass as amended, and be re-referred to the Committee on [Appropriations] with recommendation: To Consent Calendar",6,0,1,0,7
1451042,1048879,2021-04-08,Assembly,"Do pass and be re-referred to the Committee on [Appropriations]",21,0,1,0,22
1451042,1080395,2021-05-19,Assembly,"Do pass. To Consent Calendar",15,0,1,0,16
1451042,1131253,2022-01-31,Assembly,"AB 631 Bloom Assembly Third Reading",76,0,0,0,76
1451042,1215791,2022-06-14,Senate,"Do pass, but first be re-referred to the Committee on [Appropriations]",14,0,0,1,15
1451042,1224510,2022-08-23,Senate,"Assembly 3rd Reading AB631 Bloom et al. By Portantino",40,0,0,0,40
1451042,1224717,2022-08-24,Assembly,"AB 631 Bloom Concurrence in Senate Amendments",75,0,0,5,80
1451044,1035226,2021-03-23,Assembly,"Do pass. To Consent Calendar",11,0,0,0,11
1451044,1044983,2021-04-05,Assembly,"AB 633 Calderon Consent Calendar Second Day Regular Session",74,0,4,0,78
1451044,1100816,2021-06-22,Senate,"Do pass as amended, and be ordered to the Consent Calendar",11,0,0,0,11
1451044,1104166,2021-07-05,Senate,"Consent Calendar AB633 Calderon",38,0,2,0,40
1451044,1104637,2021-07-12,Assembly,"AB 633 Calderon Concurrence in Senate Amendments",77,0,2,0,79
1451045,1054654,2021-04-15,Assembly,"Do pass as amended and be re-referred to the Committee on [Local Government]",6,2,0,0,8
1451045,1073342,2021-05-05,Assembly,"Do pass",6,2,0,0,8
1451045,1083794,2021-05-24,Assembly,"AB 634 Carrillo Assembly Third Reading",55,15,8,0,78
1451045,1099139,2021-06-17,Senate,"Do pass",6,2,1,0,9
1451045,1108022,2021-09-08,Senate,"Assembly 3rd Reading AB634 Carrillo By Hertzberg",29,9,0,2,40
1451045,1108404,2021-09-09,Assembly,"AB 634 Carrillo Concurrence in Senate Amendments",58,19,0,3,80
1451046,1036493,2021-03-24,Assembly,"Do pass and be re-referred to the Committee on [Appropriations]",12,0,0,0,12
1451047,1046216,2021-04-06,Assembly,"Do pass",7,0,0,0,7
1451047,1053415,2021-04-12,Assembly,"AB 636 Maienschein Assembly Third Reading",73,0,5,0,78
1451047,1095087,2021-06-08,Senate,"Do pass, but first be re-referred to the Committee on [Judiciary] with the recommendation: To Consent Calendar",4,0,1,0,5
1451047,1103464,2021-06-29,Senate,"Do pass as amended, and be ordered to the Consent Calendar",11,0,0,0,11
1451047,1107411,2021-09-01,Senate,"Assembly 3rd Reading AB636 Maienschein By Hertzberg",39,0,0,1,40
1451047,1107685,2021-09-02,Assembly,"AB 636 Maienschein Concurrence in Senate Amendments",77,0,0,2,79
1451048,1049021,2021-04-08,Assembly,"Do pass and be re-referred to the Committee on [Appropriations] with recommendation: To Consent Calendar",7,0,0,0,7
1451049,1046167,2021-04-06,Assembly,"Do pass and be re-referred to the Committee on [Appropriations]",15,0,0,0,15
1451049,1053423,2021-04-14,Assembly,"Do pass. To Consent Calendar",16,0,0,0,16
1451049,1060840,2021-04-22,Assembly,"AB 638 Quirk-Silva Consent Calendar Second Day Regular Session",77,0,2,0,79
1451049,1097021,2021-06-10,Senate,"Do pass, but first be re-referred to the Committee on [Appropriations]",10,0,1,0,11
1451049,1104607,2021-07-12,Senate,"Assembly 3rd Reading AB638 Quirk-Silva et al. By Rubio",39,0,1,0,40
1451049,1106402,2021-08-23,Assembly,"AB 638 Quirk-Silva Concurrence in Senate Amendments",71,0,0,8,79
1451051,1059279,2021-04-21,Assembly,"Do pass and be re-referred to the Committee on [Appropriations] with recommendation: To Consent Calendar",8,0,0,0,8
1451051,1081810,2021-05-20,Assembly,"Do pass",16,0,0,0,16
1451051,1092865,2021-06-01,Assembly,"AB 640 Cooley Assembly Third Reading",79,0,0,0,79
1451051,1100296,2021-06-22,Senate,"Do pass, but first be re-referred to the Committee on [Judiciary] with the recommendation: To Consent Calendar",5,0,0,0,5
1451051,1104453,2021-07-06,Senate,"Do pass as amended, but first amend, and re-refer to the Committee on [Appropriations] with the recommendation: To Consent Calendar",11,0,0,0,11
1451051,1107616,2021-09-02,Senate,"Assembly 3rd Reading AB640 Cooley By Lim贸n",39,0,0,1,40
1451051,1107927,2021-09-07,Assembly,"AB 640 Cooley Concurrence in Senate Amendments",73,0,0,7,80
1451052,1059306,2021-04-21,Assembly,"Do pass as amended and be re-referred to the Committee on [Appropriations]",13,0,2,0,15
1451052,1076930,2021-05-12,Assembly,"Do pass",12,2,2,0,16
1451052,1092826,2021-06-01,Assembly,"AB 641 Holden Assembly Third Reading",64,11,4,0,79
1451052,1104189,2021-07-05,Senate,"Do pass, but first be re-referred to the Committee on [Transportation]",11,1,2,0,14
1451052,1104685,2021-07-13,Senate,"Do pass as amended, but first amend, and re-refer to the Committee on [Appropriations]",12,4,1,0,17
1451052,1106387,2021-08-23,Senate,"Placed on suspense file",7,0,0,0,7
1451053,1036419,2021-03-24,Assembly,"Do pass and be re-referred to the Committee on [Appropriations]",9,0,2,0,11
1451053,1082076,2021-05-20,Assembly,"Do pass",16,0,0,0,16
1451053,1086969,2021-05-27,Assembly,"AB 642 Friedman Assembly Third Reading",73,0,5,0,78
1451053,1102840,2021-06-29,Senate,"Do pass as amended, but first amend, and re-refer to the Committee on [Governmental Organization]",9,0,0,0,9
1451053,1104336,2021-07-06,Senate,"Do pass, but first be re-referred to the Committee on [Appropriations] with the recommendation: To Consent Calendar",15,0,0,0,15
1451053,1106450,2021-08-23,Senate,"Placed on suspense file",7,0,0,0,7
1451053,1106752,2021-08-26,Senate,"Do pass",7,0,0,0,7
1451053,1108104,2021-09-08,Senate,"Assembly 3rd Reading AB642 Friedman et al. By Laird",37,0,0,3,40
1451053,1108372,2021-09-09,Assembly,"AB 642 Friedman Concurrence in Senate Amendments",77,0,0,3,80
1451054,1060874,2021-04-22,Assembly,"Do pass and be re-referred to the Committee on [Appropriations] with recommendation: To Consent Calendar",7,0,0,0,7
1451054,1073355,2021-05-05,Assembly,"Do pass. To Consent Calendar",16,0,0,0,16
1451054,1077562,2021-05-13,Assembly,"AB 643 Ramos Consent Calendar Second Day Regular Session",75,0,3,0,78
1451054,1096119,2021-06-09,Senate,"Do pass, but first be re-referred to the Committee on [Labor, Public Employment and Retirement ] with the recommendation: To Consent Calendar",7,0,0,0,7
1451054,1102455,2021-06-28,Senate,"Do pass, but first be re-referred to the Committee on [Appropriations]",5,0,0,0,5
1451054,1107147,2021-08-30,Senate,"Assembly 3rd Reading AB643 Ramos By Leyva",39,0,0,1,40
1451055,1047590,2021-04-06,Assembly,"Do pass and be re-referred to the Committee on [Appropriations]",8,0,0,0,8
1451055,1059224,2021-04-21,Assembly,"Do pass. To Consent Calendar",14,0,2,0,16
1451055,1066835,2021-04-29,Assembly,"AB 644 Waldron Consent Calendar Second Day Regular Session",77,0,1,0,78
1451055,1095045,2021-06-08,Senate,"Do pass, but first be re-referred to the Committee on [Appropriations] with the recommendation: To Consent Calendar",4,0,1,0,5
1451055,1101626,2021-06-24,Senate,"Consent Calendar AB644",39,0,1,0,40
1451056,1049877,2021-04-08,Assembly,"Do pass and be re-referred to the Committee on [Appropriations]",15,0,0,0,15
1451057,1035165,2021-03-23,Assembly,"Do pass and be re-referred to the Committee on [Appropriations]",17,0,2,0,19
1451057,1126258,2022-01-20,Assembly,"Do pass as amended",12,0,0,4,16
1451057,1131272,2022-01-31,Assembly,"AB 646 Low Assembly Third Reading",75,0,0,1,76
1451057,1217414,2022-06-20,Senate,"Do pass, but first be re-referred to the Committee on [Public Safety]",10,1,0,3,14
1451057,1220863,2022-06-28,Senate,"Do pass, but first be re-referred to the Committee on [Appropriations]",5,0,0,0,5
1451057,1222816,2022-08-01,Senate,"Placed on suspense file",7,0,0,0,7
1451060,1123314,2022-01-10,Assembly,"Do pass and be re-referred to the Committee on [Appropriations] with recommendation: To Consent Calendar",11,0,0,0,11
1451060,1126289,2022-01-20,Assembly,"Do pass. To Consent Calendar",15,0,0,1,16
1451060,1129910,2022-01-27,Assembly,"AB 649 Bennett Consent Calendar Second Day Regular Session",61,0,0,15,76
1451060,1211834,2022-06-01,Senate,"Do pass, but first be re-referred to the Committee on [Appropriations]",4,0,0,3,7
1451060,1224336,2022-08-22,Senate,"Assembly 3rd Reading AB649 Bennett et al. By Gonzalez",32,1,0,7,40
1451061,1060947,2021-04-22,Assembly,"Do pass and be re-referred to the Committee on [Appropriations]",5,2,0,0,7
1451061,1081611,2021-05-20,Assembly,"Do pass as amended",9,1,6,0,16
1451062,1057660,2021-04-20,Assembly,"Do pass as amended and be re-referred to the Committee on [Appropriations]",19,0,0,0,19
1451062,1082119,2021-05-20,Assembly,"Do pass as amended",16,0,0,0,16
1451062,1092976,2021-06-01,Assembly,"AB 651 Gipson Assembly Third Reading",78,1,0,0,79
1451062,1104896,2021-07-14,Senate,"Do pass, but first be re-referred to the Committee on [Appropriations]",13,0,1,0,14
1451062,1106222,2021-08-16,Senate,"Placed on suspense file",7,0,0,0,7
1451062,1106840,2021-08-26,Senate,"Do pass as amended",7,0,0,0,7
1451062,1108400,2021-09-09,Senate,"Assembly 3rd Reading AB651 Gipson By Hueso",38,0,0,2,40
1451062,1108401,2021-09-09,Assembly,"AB 651 GIPSON Concurrence in Senate Amendments",76,0,0,4,80
1451063,1047454,2021-04-07,Assembly,"Do pass",6,1,2,0,9
1451063,1081991,2021-05-20,Assembly,"AB 652 Friedman Assembly Third Reading",54,0,24,0,78
1451063,1104472,2021-07-07,Senate,"Do pass as amended",5,0,2,0,7
1451063,1107429,2021-09-01,Senate,"Assembly 3rd Reading AB652 Friedman et al. By Allen",38,0,0,2,40
1451063,1107650,2021-09-02,Assembly,"AB 652 Friedman Concurrence in Senate Amendments",60,2,0,17,79
1451064,1047531,2021-04-06,Assembly,"Do pass and be re-referred to the Committee on [Appropriations] with recommendation: To Consent Calendar",8,0,0,0,8
1451064,1081546,2021-05-20,Assembly,"Do pass",16,0,0,0,16
1451064,1087064,2021-05-27,Assembly,"AB 653 Waldron Assembly Third Reading",78,0,0,0,78
1451064,1102861,2021-06-29,Senate,"Do pass, but first be re-referred to the Committee on [Appropriations] with the recommendation: To Consent Calendar",5,0,0,0,5
1451064,1105052,2021-07-15,Senate,"Placed on suspense file",7,0,0,0,7
1451064,1106598,2021-08-26,Senate,"Do pass as amended",7,0,0,0,7
1451064,1108020,2021-09-08,Senate,"Special Consent AB653",38,0,0,2,40
1451064,1108264,2021-09-09,Assembly,"AB 653 Waldron Concurrence in Senate Amendments",79,0,0,1,80
1451065,1049008,2021-04-08,Assembly,"Do pass and be re-referred to the Committee on [Appropriations]",5,2,0,0,7
1451065,1082088,2021-05-20,Assembly,"Do pass as amended",12,4,0,0,16
1451065,1092880,2021-06-01,Assembly,"AB 654 Reyes Third Reading Urgency",48,22,9,0,79
1451065,1107928,2021-09-07,Assembly,"AB 654 Reyes Third Reading Urgency",65,0,0,15,80
1451065,1108502,2021-09-10,Senate,"Do pass",5,0,0,0,5
1451065,1108600,2021-09-10,Senate,"Assembly 2nd Reading AB654 Reyes By Lim贸n Urgency Clause",37,0,0,3,40
1451066,1047592,2021-04-06,Assembly,"Do pass and be re-referred to the Committee on [Appropriations]",5,3,0,0,8
1451066,1126313,2022-01-20,Assembly,"Do pass as amended",12,3,0,1,16
1451066,1131244,2022-01-31,Assembly,"AB 655 Kalra Assembly Third Reading",48,18,0,10,76
1451066,1217374,2022-06-21,Senate,"Do pass, but first be re-referred to the Committee on [Appropriations]",4,0,0,1,5
1451066,1222753,2022-08-01,Senate,"Placed on suspense file",7,0,0,0,7
1451066,1223457,2022-08-11,Senate,"Do pass",5,2,0,0,7
1451066,1224973,2022-08-25,Senate,"Assembly 3rd Reading AB655 Kalra et al. By Bradford",30,0,0,10,40
1451066,1224974,2022-08-25,Assembly,"AB 655 Kalra Concurrence in Senate Amendments",53,14,0,13,80
1451068,1066709,2021-04-29,Assembly,"Do pass and be re-referred to the Committee on [Appropriations]",6,1,0,0,7
1451068,1081609,2021-05-20,Assembly,"Do pass",12,3,1,0,16
1451068,1092861,2021-06-01,Assembly,"AB 657 Cooper Assembly Third Reading",59,14,6,0,79
1451068,1100347,2021-06-21,Senate,"Do pass, but first be re-referred to the Committee on [Governmental Organization]",4,1,0,0,5
1451068,1104269,2021-07-06,Senate,"Do pass as amended, but first amend, and re-refer to the Committee on [Appropriations]",6,6,3,0,15
1451068,1104270,2021-07-06,Senate,"[First] hearing set for [07-06-2021]: Failed passage in Committee. Reconsideration granted",15,0,0,0,15
1451068,1219486,2022-06-27,Senate,"Do pass, but first be re-referred to the Committee on [Appropriations]",10,4,0,0,14
1451068,1224892,2022-08-25,Senate,"Assembly 3rd Reading AB657 Cooper By Kamlager",30,9,0,1,40
1451068,1225156,2022-08-30,Assembly,"With recommendation: That Senate amendments be concurred in",10,2,0,6,18
1451068,1225768,2022-08-31,Assembly,"AB 657 Cooper Concurrence in Senate Amendments",59,17,0,4,80
1451071,1054702,2021-04-14,Assembly,"Do pass and be re-referred to the Committee on [Transportation]",13,0,0,0,13
1451071,1064055,2021-04-26,Assembly,"Do pass and be re-referred to the Committee on [Appropriations] with recommendation: To Consent Calendar",15,0,0,0,15
1451071,1126329,2022-01-20,Assembly,"Do pass. To Consent Calendar",15,0,0,1,16
1451071,1129890,2022-01-27,Assembly,"AB 660 Cooper Consent Calendar Second Day Regular Session",61,0,0,15,76
1451072,1065182,2021-04-28,Assembly,"Do pass and be re-referred to the Committee on [Appropriations]",5,2,0,0,7
1451072,1126323,2022-01-20,Assembly,"Do pass as amended",12,3,0,1,16
1451072,1131227,2022-01-31,Assembly,"AB 661 Bennett Assembly Third Reading",56,19,0,1,76
1451072,1215801,2022-06-14,Senate,"Do pass as amended, but first amend, and re-refer to the Committee on [Environmental Quality]",9,5,0,1,15
1451072,1220878,2022-06-29,Senate,"Do pass as amended, but first amend, and re-refer to the Committee on [Appropriations]",5,2,0,0,7
1451072,1223248,2022-08-08,Senate,"Placed on suspense file",7,0,0,0,7
1451072,1223621,2022-08-11,Senate,"Do pass",4,2,0,1,7
1451072,1225777,2022-08-29,Senate,"Assembly 3rd Reading AB661 Bennett By Allen",31,8,0,1,40
1451072,1225778,2022-08-30,Assembly,"AB 661 Bennett Concurrence in Senate Amendments",58,18,0,4,80
1451073,1057696,2021-04-20,Assembly,"Do pass and be re-referred to the Committee on [Judiciary]",14,0,1,0,15
1451073,1064059,2021-04-27,Assembly,"Do pass as amended, and be re-referred to the Committee on [Appropriations] with recommendation: To Consent Calendar",11,0,0,0,11
1451073,1081898,2021-05-20,Assembly,"Do pass",16,0,0,0,16
1451073,1127171,2022-01-24,Assembly,"AB 662 Rodriguez Assembly Third Reading",65,0,0,11,76
1451073,1219971,2022-06-28,Senate,"Do pass, but first be re-referred to the Committee on [Appropriations] with the recommendation: To Consent Calendar",13,0,0,2,15
1451073,1222920,2022-08-01,Senate,"Placed on suspense file",7,0,0,0,7
1451073,1223631,2022-08-11,Senate,"Do pass as amended",7,0,0,0,7
1451073,1224602,2022-08-23,Senate,"Special Consent AB662",40,0,0,0,40
1451073,1225162,2022-08-30,Assembly,"With recommendation: That Senate amendments be concurred in",12,0,0,2,14
1451073,1225252,2022-08-31,Assembly,"AB 662 Rodriguez Concurrence in Senate Amendments",80,0,0,0,80
1451074,1054701,2021-04-15,Assembly,"Do pass and be re-referred to the Committee on [Appropriations] with recommendation: To Consent Calendar",12,0,0,0,12
1451074,1065285,2021-04-28,Assembly,"Do pass. To Consent Calendar",16,0,0,0,16
1451074,1074122,2021-05-06,Assembly,"AB 663 Chen Consent Calendar Second Day Regular Session",77,0,1,0,78
1451074,1096101,2021-06-09,Senate,"Do pass as amended, but first amend, and re-refer to the Committee on [Judiciary] with the recommendation: To Consent Calendar",9,0,0,0,9
1451074,1103387,2021-06-29,Senate,"Do pass as amended, but first amend, and re-refer to the Committee on [Appropriations] with the recommendation: To Consent Calendar",11,0,0,0,11
1451074,1107181,2021-08-30,Senate,"Consent Calendar AB663",39,0,0,1,40
1451074,1108341,2021-09-09,Senate,"Assembly 3rd Reading AB663 Chen By Wieckowski",35,2,0,3,40
1451074,1108342,2021-09-09,Assembly,"AB 663 CHEN Concurrence in Senate Amendments",79,0,0,1,80
1451076,1059169,2021-04-21,Assembly,"Do pass and be re-referred to the Committee on [Appropriations] with recommendation: To Consent Calendar",8,0,0,0,8
1451076,1082198,2021-05-20,Assembly,"Do pass as amended",16,0,0,0,16
1451076,1092829,2021-06-01,Assembly,"AB 665 Eduardo Garcia Assembly Third Reading",79,0,0,0,79
1451076,1104483,2021-07-06,Senate,"Do pass, but first be re-referred to the Committee on [Appropriations]",5,0,0,0,5
1451076,1107199,2021-08-30,Senate,"Assembly 3rd Reading AB665 Eduardo Garcia By Hueso",39,0,0,1,40
1451076,1107457,2021-09-01,Assembly,"AB 665 Eduardo Garcia Concurrence in Senate Amendments",78,0,0,1,79
1451077,1051986,2021-04-13,Assembly,"Do pass and be re-referred to the Committee on [Appropriations]",15,0,0,0,15
1451077,1081593,2021-05-20,Assembly,"Do pass as amended",16,0,0,0,16
1451077,1086943,2021-05-27,Assembly,"AB 666 Chiu Assembly Third Reading",77,0,1,0,78
1451077,1101680,2021-06-23,Senate,"Do pass, but first be re-referred to the Committee on [Appropriations] with the recommendation: To Consent Calendar",11,0,0,0,11
1451077,1104210,2021-07-05,Senate,"Placed on suspense file",6,0,1,0,7
1451077,1106722,2021-08-26,Senate,"Do pass",7,0,0,0,7
1451077,1107789,2021-09-03,Senate,"Special Consent AB666",37,0,0,3,40
1451077,1143396,2022-02-14,Senate,"Assembly 3rd Reading AB666 Quirk-Silva et al. By Umberg",35,0,0,5,40
1451077,1150950,2022-02-22,Assembly,"AB 666 Quirk-Silva Concurrence in Senate Amendments",68,0,0,8,76
1451078,1047539,2021-04-06,Assembly,"Do pass and be re-referred to the Committee on [Appropriations] with recommendation: To Consent Calendar",8,0,0,0,8
1451080,1047443,2021-04-06,Assembly,"Do pass",6,2,0,0,8
1451080,1087032,2021-05-27,Assembly,"AB 669 Lackey Assembly Third Reading",60,13,5,0,78
1451080,1104243,2021-07-06,Senate,"Do pass",1,1,3,0,5
1451080,1104244,2021-07-06,Senate,"[First] hearing set for [07-06-2021]: Failed passage in Committee. Reconsideration granted",5,0,0,0,5
1451081,1047482,2021-04-07,Assembly,"Do pass and be re-referred to the Committee on [Judiciary] with recommendation: To Consent Calendar",8,0,0,0,8
1451081,1057633,2021-04-20,Assembly,"Do pass and be re-referred to the Committee on [Appropriations] with recommendation: To Consent Calendar",10,0,1,0,11
1451081,1082020,2021-05-20,Assembly,"Do pass",16,0,0,0,16
1451081,1086924,2021-05-27,Assembly,"AB 670 Calderon Assembly Third Reading",76,0,2,0,78
1451081,1100329,2021-06-22,Senate,"Do pass, but first be re-referred to the Committee on [Judiciary]",5,0,0,0,5
1451081,1104381,2021-07-06,Senate,"Do pass, but first be re-referred to the Committee on [Appropriations] with the recommendation: To Consent Calendar",11,0,0,0,11
1451081,1106158,2021-08-16,Senate,"Placed on suspense file",7,0,0,0,7
1451081,1106971,2021-08-26,Senate,"Do pass",7,0,0,0,7
1451081,1107770,2021-09-03,Senate,"Special Consent AB670",37,0,0,3,40
1451081,1108531,2021-09-10,Senate,"Assembly 3rd Reading AB670 Calderon By Umberg",37,0,0,3,40
1451081,1108532,2021-09-10,Assembly,"AB 670 CALDERON Concurrence in Senate Amendments",71,0,0,9,80
1451082,1035185,2021-03-23,Assembly,"Do pass and be re-referred to the Committee on [Appropriations] with recommendation: To Consent Calendar",15,0,0,0,15
1451082,1082043,2021-05-20,Assembly,"Do pass",16,0,0,0,16
1451083,1123784,2022-01-12,Assembly,"Do pass as amended and be re-referred to the Committee on [Appropriations]",5,2,0,1,8
1451083,1123785,2022-01-12,Assembly,"Do pass and be re-referred to the Committee on [Local Government]",6,2,0,0,8
1451084,1047494,2021-04-06,Assembly,"Do pass and be re-referred to the Committee on [Appropriations] with recommendation: To Consent Calendar",8,0,0,0,8
1451084,1059281,2021-04-21,Assembly,"Do pass. To Consent Calendar",14,0,2,0,16
1451084,1066762,2021-04-29,Assembly,"AB 673 Salas Consent Calendar Second Day Regular Session",77,0,1,0,78
1451084,1100276,2021-06-22,Senate,"Do pass, but first be re-referred to the Committee on [Appropriations] with the recommendation: To Consent Calendar",5,0,0,0,5
1451084,1107226,2021-08-30,Senate,"Assembly 3rd Reading AB673 Salas et al. By Rubio",39,0,0,1,40
1451084,1107514,2021-09-01,Assembly,"AB 673 Salas Concurrence in Senate Amendments",78,0,0,1,79
1451085,1047487,2021-04-07,Assembly,"Do pass and be re-referred to the Committee on [Judiciary] with recommendation: To Consent Calendar",8,0,0,0,8
1451085,1051961,2021-04-13,Assembly,"Do pass and be re-referred to the Committee on [Appropriations] with recommendation: To Consent Calendar",11,0,0,0,11
1451085,1065221,2021-04-28,Assembly,"Do pass. To Consent Calendar",16,0,0,0,16
1451085,1074107,2021-05-06,Assembly,"AB 674 Bennett Consent Calendar Second Day Regular Session",77,0,1,0,78
1451085,1095050,2021-06-08,Senate,"Do pass, but first be re-referred to the Committee on [Judiciary]",5,0,0,0,5
1451085,1103415,2021-06-29,Senate,"Do pass, but first be re-referred to the Committee on [Appropriations]",11,0,0,0,11
1451085,1107414,2021-09-01,Senate,"Assembly 3rd Reading AB674 Bennett By Hurtado",39,0,0,1,40
1451085,1107699,2021-09-02,Assembly,"AB 674 Bennett Concurrence in Senate Amendments",75,0,0,4,79
1451087,1123338,2022-01-11,Assembly,"Do pass and be re-referred to the Committee on [Judiciary]",15,0,0,3,18
1451087,1124158,2022-01-13,Assembly,"Do pass as amended and be re-referred to the Committee on [Appropriations]",10,0,0,0,10
1451087,1126287,2022-01-20,Assembly,"Do pass",13,0,0,3,16
1451087,1129917,2022-01-27,Assembly,"AB 676 Holden Assembly Third Reading",63,1,0,12,76
1451087,1215038,2022-06-08,Senate,"Do pass, but first be re-referred to the Committee on [Banking and Financial Institutions]",9,0,0,2,11
1451087,1217957,2022-06-22,Senate,"Do pass, but first be re-referred to the Committee on [Appropriations]",7,0,0,2,9
1451087,1222868,2022-08-01,Senate,"Placed on suspense file",7,0,0,0,7
1451087,1223531,2022-08-11,Senate,"Do pass",6,0,0,1,7
1451087,1224847,2022-08-24,Senate,"Assembly 3rd Reading AB676 Holden By Wilk",40,0,0,0,40
1451087,1224881,2022-08-25,Assembly,"AB 676 Holden Concurrence in Senate Amendments",75,0,0,5,80
1451088,1059200,2021-04-21,Assembly,"Do pass and be re-referred to the Committee on [Appropriations]",7,1,0,0,8
1451090,1053475,2021-04-13,Assembly,"Do pass and be re-referred to the Committee on [Appropriations]",6,2,0,0,8
1451090,1065125,2021-04-28,Assembly,"Do pass",11,4,1,0,16
1451091,1048997,2021-04-08,Assembly,"Do pass and be re-referred to the Committee on [Natural Resources]",5,1,1,0,7
1451091,1065127,2021-04-28,Assembly,"Do pass as amended and be re-referred to the Committee on [Appropriations]",8,0,3,0,11
1451091,1081693,2021-05-20,Assembly,"Do pass as amended",12,4,0,0,16
1451091,1090424,2021-06-02,Assembly,"AB 680 Burke Assembly Third Reading",61,13,5,0,79
1451091,1102515,2021-06-28,Senate,"Do pass as amended, but first amend, and re-refer to the Committee on [Environmental Quality]",4,1,0,0,5
1451091,1104626,2021-07-12,Senate,"Do pass as amended, but first amend, and re-refer to the Committee on [Appropriations]",5,1,1,0,7
1451091,1106180,2021-08-16,Senate,"Placed on suspense file",7,0,0,0,7
1451091,1106825,2021-08-26,Senate,"Do pass as amended",5,2,0,0,7
1451091,1108653,2021-09-10,Senate,"Assembly 3rd Reading AB680 Burke By Bradford",27,7,0,6,40
1451091,1108654,2021-09-10,Assembly,"AB 680 Burke Concurrence in Senate Amendments",61,14,0,5,80
1451092,1123334,2022-01-11,Assembly,"Do pass as amended and be re-referred to the Committee on [Appropriations]",15,0,0,0,15
1451093,1123748,2022-01-12,Assembly,"Do pass as amended and be re-referred to the Committee on [Appropriations]",7,0,0,1,8
1451093,1123749,2022-01-12,Assembly,"Do pass and be re-referred to the Committee on [Local Government]",6,1,0,1,8
1451093,1126348,2022-01-20,Assembly,"Do pass",12,2,0,2,16
1451093,1129886,2022-01-27,Assembly,"AB 682 Bloom Assembly Third Reading",52,8,0,16,76
1451093,1215929,2022-06-13,Senate,"Do pass, but first be re-referred to the Committee on [Governance and Finance]",7,0,0,2,9
1451093,1218023,2022-06-22,Senate,"Do pass as amended, but first amend, and re-refer to the Committee on [Appropriations]",4,1,0,0,5
1451093,1225647,2022-08-29,Senate,"Assembly 3rd Reading AB682 Bloom By Wiener",31,5,0,4,40
1451093,1225648,2022-08-30,Assembly,"AB 682 Bloom Concurrence in Senate Amendments",58,2,0,20,80
1451096,1051950,2021-04-13,Senate,"Do pass, but first be re-referred to the Committee on [Appropriations] with the recommendation: To Consent Calendar",16,0,1,0,17
1451096,1068202,2021-05-03,Senate,"Placed on suspense file",6,0,1,0,7
1451096,1081450,2021-05-20,Senate,"Do pass",7,0,0,0,7
1451096,1089568,2021-06-01,Senate,"Senate 3rd Reading SB399 Umberg",40,0,0,0,40
1451096,1099722,2021-06-21,Assembly,"Do pass and be re-referred to the Committee on [Military and Veterans Affairs]",15,0,0,0,15
1451096,1104343,2021-07-06,Assembly,"Do pass and be re-referred to the Committee on [Appropriations] with recommendation: To Consent Calendar",11,0,0,0,11
1451097,1030781,2021-03-17,Senate,"Do pass, but first be re-referred to the Committee on [Appropriations] with the recommendation: To Consent Calendar",7,0,0,0,7
1451097,1048938,2021-04-08,Senate,"Consent Calendar SB400",38,0,2,0,40
1451097,1104435,2021-07-07,Assembly,"Do pass as amended, and be re-referred to the Committee on [Appropriations] with recommendation: To Consent Calendar",7,0,0,0,7
1451097,1106354,2021-08-19,Assembly,"Do pass. To Consent Calendar",16,0,0,0,16
1451097,1107953,2021-09-07,Assembly,"SB 400 Jones Senate Third Reading By Luz Rivas",73,0,0,7,80
1451097,1108171,2021-09-08,Senate,"Unfinished Business SB400 Jones Concurrence",38,0,0,2,40
1451098,1033682,2021-03-22,Senate,"Do pass, but first be re-referred to the Committee on [Appropriations] with the recommendation: To Consent Calendar",14,0,0,0,14
1451098,1060927,2021-04-22,Senate,"Consent Calendar SB401",38,0,2,0,40
1451098,1210214,2022-05-27,Assembly,"Be re-referred to the Committee on [Business and Professions]",7,0,0,4,11
1451098,1217402,2022-06-21,Assembly,"Do pass and be re-referred to the Committee on [Appropriations] with recommendation: To Consent Calendar",18,0,0,1,19
1451098,1222972,2022-08-03,Assembly,"Do pass. To Consent Calendar",15,0,0,1,16
1451098,1223833,2022-08-11,Assembly,"SB 401 Pan Consent Calendar Second Day Regular Session",76,0,0,4,80
1451098,1224095,2022-08-16,Senate,"Unfinished Business SB401 Pan Concurrence",36,0,0,4,40
1451099,1047578,2021-04-07,Senate,"Do pass as amended, but first amend, and re-refer to the Committee on [Appropriations]",11,0,0,0,11
1451099,1068244,2021-05-03,Senate,"Placed on suspense file",6,0,1,0,7
1451099,1081970,2021-05-20,Senate,"Do pass as amended",7,0,0,0,7
1451099,1089504,2021-06-01,Senate,"Special Consent SB402",39,0,1,0,40
1451099,1104772,2021-07-13,Assembly,"Do pass and be re-referred to the Committee on [Appropriations] with recommendation: To Consent Calendar",14,0,1,0,15
1451100,1028402,2021-03-15,Senate,"Do pass, but first be re-referred to the Committee on [Governance and Finance]",5,1,1,0,7
1451100,1060876,2021-04-22,Senate,"Do pass as amended, but first amend, and re-refer to the Committee on [Appropriations]",3,1,1,0,5
1451100,1081587,2021-05-20,Senate,"Senate 3rd Reading SB403 Gonzalez et al",27,7,6,0,40
1451100,1098628,2021-06-16,Assembly,"Do pass and be re-referred to the Committee on [Local Government]",6,3,0,0,9
1451100,1103817,2021-06-30,Assembly,"Do pass as amended and be re-referred to the Committee on [Appropriations]",6,2,0,0,8
1451100,1106661,2021-08-26,Assembly,"Do pass",12,4,0,0,16
1451100,1107459,2021-09-01,Assembly,"SB 403 Gonzalez Senate Third Reading By Arambula",60,18,0,1,79
1451100,1107727,2021-09-02,Senate,"Unfinished Business SB403 Gonzalez et al. Concurrence",30,9,0,1,40
1451103,1051924,2021-04-13,Senate,"Do pass, but first be re-referred to the Committee on [Appropriations]",7,0,2,0,9
1451103,1056367,2021-04-19,Senate,"Placed on suspense file",7,0,0,0,7
1451103,1081814,2021-05-20,Senate,"Do pass as amended",6,0,1,0,7
1451103,1090410,2021-06-02,Senate,"Senate 3rd Reading SB406 Stern",36,0,4,0,40
1451103,1104486,2021-07-07,Assembly,"Do pass as amended and be re-referred to the Committee on [Appropriations]",8,0,3,0,11
1451103,1106995,2021-08-26,Assembly,"Do pass as amended",12,0,0,4,16
1451103,1108663,2021-09-10,Senate,"Unfinished Business SB406 Stern et al. By Kamlager Concurrence",30,0,0,10,40
1451103,1108664,2021-09-10,Assembly,"SB 406 Stern Senate Third Reading By Bryan",55,8,0,17,80
1451104,1033634,2021-03-22,Senate,"Do pass, but first be re-referred to the Committee on [Appropriations] with the recommendation: To Consent Calendar",14,0,0,0,14
1451104,1044968,2021-04-05,Senate,"Do pass",7,0,0,0,7
1451105,1074124,2021-05-06,Senate,"Do pass, but first be re-referred to the Committee on [Appropriations]",5,0,0,0,5
1451105,1078823,2021-05-17,Senate,"Placed on suspense file",7,0,0,0,7
1451106,1023831,2021-03-08,Senate,"Do pass, but first be re-referred to the Committee on [Appropriations]",14,0,0,0,14
1451106,1045000,2021-04-05,Senate,"Senate 3rd Reading SB409 Caballero",38,0,2,0,40
1451106,1104247,2021-07-06,Assembly,"Do pass as amended and be re-referred to the Committee on [Appropriations]",19,0,0,0,19
1451106,1106341,2021-08-19,Assembly,"Do pass. To Consent Calendar",16,0,0,0,16
1451106,1107954,2021-09-07,Assembly,"SB 409 Caballero Senate Third Reading By Low",73,0,0,7,80
1451106,1108078,2021-09-08,Senate,"Unfinished Business SB409 Caballero Concurrence",38,0,0,2,40
1451107,1056393,2021-04-19,Senate,"Do pass, but first be re-referred to the Committee on [Appropriations]",4,1,0,0,5
1451107,1078778,2021-05-17,Senate,"Senate 3rd Reading SB410 Leyva",22,9,9,0,40
1451107,1095035,2021-06-08,Assembly,"Do pass and be re-referred to the Committee on [Appropriations]",5,2,0,0,7
1451107,1104479,2021-07-07,Assembly,"Do pass",9,4,3,0,16
1451107,1224075,2022-08-15,Assembly,"SB 410 Leyva Senate Third Reading By Medina Amendment Set #1",50,15,0,15,80
1451107,1224318,2022-08-22,Assembly,"Do pass as amended",8,2,0,2,12
1451107,1225491,2022-08-31,Senate,"Unfinished Business SB410 Leyva Concurrence",26,10,0,4,40
1451107,1225492,2022-08-31,Assembly,"SB 410 Leyva Senate Third Reading By Medina",61,12,0,7,80
1451108,1056437,2021-04-19,Senate,"Do pass, but first be re-referred to the Committee on [Appropriations]",5,0,0,0,5
1451108,1075267,2021-05-10,Senate,"Senate 3rd Reading SB411 Cortese",36,0,4,0,40
1451108,1100817,2021-06-23,Assembly,"Do pass and be re-referred to the Committee on [Appropriations]",7,0,0,0,7
1451108,1104434,2021-07-07,Assembly,"Do pass. To Consent Calendar",14,0,2,0,16
1451108,1105137,2021-07-15,Assembly,"SB 411 Cortese Consent Calendar Second Day Regular Session",70,0,9,0,79
1451111,1033684,2021-03-22,Senate,"Do pass, but first be re-referred to the Committee on [Governance and Finance] with the recommendation: To Consent Calendar",14,0,0,0,14
1451111,1054627,2021-04-15,Senate,"Do pass, but first be re-referred to the Committee on [Appropriations]",5,0,0,0,5
1451111,1074163,2021-05-06,Senate,"Senate 3rd Reading SB414 Jones",37,0,3,0,40
1451111,1100341,2021-06-22,Assembly,"Do pass and be re-referred to the Committee on [Local Government] with recommendation: To Consent Calendar",19,0,0,0,19
1451111,1103778,2021-06-30,Assembly,"Do pass. To Consent Calendar",8,0,0,0,8
1451111,1104555,2021-07-08,Assembly,"SB 414 Jones Consent Calendar Second Day Regular Session",76,0,3,0,79
1451113,1035163,2021-03-23,Senate,"Do pass, but first be re-referred to the Committee on [Education] with the recommendation: To Consent Calendar",5,0,0,0,5
1451113,1053525,2021-04-14,Senate,"Do pass as amended, but first amend, and re-refer to the Committee on [Appropriations] with the recommendation: To Consent Calendar",7,0,0,0,7
1451113,1068169,2021-05-03,Senate,"Placed on suspense file",6,0,1,0,7
1451113,1081764,2021-05-20,Senate,"Do pass as amended",7,0,0,0,7
1451113,1087621,2021-05-28,Senate,"Senate 3rd Reading SB416 Hueso et al",38,0,2,0,40
1451113,1098131,2021-06-15,Assembly,"Do pass as amended, and be re-referred to the Committee on [Higher Education] with recommendation: To Consent Calendar",7,0,1,0,8
1451113,1102835,2021-06-29,Assembly,"Do pass and be re-referred to the Committee on [Appropriations]",12,0,0,0,12
1451113,1106565,2021-08-26,Assembly,"Do pass as amended",12,0,0,4,16
1451113,1107718,2021-09-02,Assembly,"SB 416 Hueso Senate Third Reading By Bryan",74,0,0,5,79
1451113,1107784,2021-09-03,Senate,"Unfinished Business SB416 Hueso et al. Concurrence",37,0,0,3,40
1451114,1035155,2021-03-23,Senate,"Do pass, but first be re-referred to the Committee on [Appropriations]",14,0,1,0,15
1451114,1062772,2021-04-26,Senate,"Senate 3rd Reading SB417 Dodd",38,0,2,0,40
1451114,1210200,2022-05-27,Assembly,"Be re-referred to the Committee on [Governmental Organization]",7,0,0,4,11
1451115,1064082,2021-04-27,Senate,"Do pass, but first be re-referred to the Committee on [Appropriations] with the recommendation: To Consent Calendar",9,0,0,0,9
1451115,1075395,2021-05-10,Senate,"Placed on suspense file",7,0,0,0,7
1451115,1082149,2021-05-20,Senate,"Do pass",7,0,0,0,7
1451115,1089464,2021-06-01,Senate,"Special Consent SB418",39,0,1,0,40
1451115,1104412,2021-07-07,Assembly,"Do pass and be re-referred to the Committee on [Appropriations] with recommendation: To Consent Calendar",11,0,0,0,11
1451115,1106748,2021-08-26,Assembly,"Do pass",16,0,0,0,16
1451115,1125578,2022-01-19,Assembly,"Do pass as amended",8,0,0,0,8
1451115,1129868,2022-01-27,Assembly,"SB 418 Laird Third Reading Urgency By Robert Rivas",69,0,0,7,76
1451115,1133410,2022-02-02,Senate,"That the Assembly amendments be concurred in",5,0,0,0,5
1451115,1134585,2022-02-03,Senate,"Unfinished Business SB418 Laird et al. Urgency Clause Concurrence",35,0,0,5,40
1451116,1051981,2021-04-13,Senate,"Do pass as amended, but first amend, and re-refer to the Committee on [Labor, Public Employment and Retirement ]",7,2,0,0,9
1451116,1064065,2021-04-26,Senate,"Do pass, but first be re-referred to the Committee on [Appropriations]",4,1,0,0,5
1451116,1091716,2021-06-03,Senate,"Senate 3rd Reading SB419 Stern",23,7,10,0,40
1451116,1100323,2021-06-22,Assembly,"Do pass and be re-referred to the Committee on [Natural Resources]",6,1,0,0,7
1451117,1038716,2021-03-22,Senate,"Do pass, but first be re-referred to the Committee on [Rules]",5,0,0,0,5
1451117,1064157,2021-04-27,Senate,"Do pass, but first be re-referred to the Committee on [Appropriations] with the recommendation: To Consent Calendar",5,0,0,0,5
1451117,1075393,2021-05-10,Senate,"Placed on suspense file",7,0,0,0,7
1451117,1082230,2021-05-20,Senate,"Do pass",7,0,0,0,7
1451117,1090408,2021-06-02,Senate,"Senate 3rd Reading SB420 Umberg",38,0,2,0,40
1451117,1101675,2021-06-24,Assembly,"Do pass as amended, and be re-referred to the Committee on [Public Safety] with recommendation: To Consent Calendar",14,0,0,0,14
1451117,1104754,2021-07-13,Assembly,"Do pass and be re-referred to the Committee on [Appropriations] with recommendation: To Consent Calendar",8,0,0,0,8
1451118,1063991,2021-04-27,Senate,"Do pass, but first be re-referred to the Committee on [Appropriations]",5,0,0,0,5
1451118,1075361,2021-05-10,Senate,"Placed on suspense file",7,0,0,0,7
1451119,1056429,2021-04-19,Senate,"Do pass, but first be re-referred to the Committee on [Appropriations]",4,1,0,0,5
1451119,1068224,2021-05-03,Senate,"Placed on suspense file",6,0,1,0,7
1451119,1081692,2021-05-20,Senate,"Do pass",5,2,0,0,7
1451119,1089550,2021-06-01,Senate,"Senate 3rd Reading SB422 Pan",31,8,1,0,40
1451119,1100825,2021-06-23,Assembly,"Do pass and be re-referred to the Committee on [Appropriations]",6,0,1,0,7
1451119,1106724,2021-08-26,Assembly,"Do pass",12,4,0,0,16
1451119,1225726,2022-08-30,Assembly,"SB 422 Pan Senate Third Reading By Arambula",57,17,0,6,80
1451119,1225727,2022-08-31,Senate,"Unfinished Business SB422 Pan Concurrence",31,9,0,0,40
1451120,1050778,2021-04-12,Senate,"Do pass as amended, but first amend, and re-refer to the Committee on [Environmental Quality]",10,3,1,0,14
1451120,1062737,2021-04-26,Senate,"Do pass as amended, but first amend, and re-refer to the Committee on [Appropriations]",5,2,0,0,7
1451120,1078771,2021-05-17,Senate,"Placed on suspense file",7,0,0,0,7
1451120,1082171,2021-05-20,Senate,"Do pass as amended",5,2,0,0,7
1451120,1089507,2021-06-01,Senate,"Senate 3rd Reading SB423 Stern",31,9,0,0,40
1451120,1103472,2021-06-30,Assembly,"Do pass as amended and be re-referred to the Committee on [Natural Resources]",13,0,2,0,15
1451120,1104463,2021-07-07,Assembly,"Do pass as amended and be re-referred to the Committee on [Appropriations]",10,0,1,0,11
1451120,1106914,2021-08-26,Assembly,"Do pass as amended",12,0,0,4,16
1451120,1108594,2021-09-10,Senate,"Unfinished Business SB423 Stern et al. Concurrence",29,7,0,4,40
1451120,1108595,2021-09-10,Assembly,"SB 423 Stern Senate Third Reading By Muratsuchi",77,0,0,3,80
1451121,1074171,2021-05-06,Senate,"Do pass as amended, but first amend, and re-refer to the Committee on [Appropriations]",5,0,0,0,5
1451121,1078787,2021-05-17,Senate,"Placed on suspense file",7,0,0,0,7
1451123,1028425,2021-03-15,Senate,"Do pass, but first be re-referred to the Committee on [Appropriations]",7,0,0,0,7
1451123,1033604,2021-03-22,Senate,"Placed on suspense file",7,0,0,0,7
1451123,1082131,2021-05-20,Senate,"Do pass",7,0,0,0,7
1451124,1048941,2021-04-08,Senate,"Do pass as amended, but first amend, and re-refer to the Committee on [Public Safety]",5,0,0,0,5
1451124,1068214,2021-05-03,Senate,"Senate 3rd Reading SB427 Eggman",36,0,4,0,40
1451124,1096118,2021-06-09,Assembly,"Do pass",8,0,0,0,8
1451124,1104608,2021-07-12,Assembly,"SB 427 Eggman Senate Third Reading By COOPER",76,0,3,0,79
1451125,1059183,2021-04-21,Senate,"Do pass, but first be re-referred to the Committee on [Appropriations]",11,0,0,0,11
1451125,1078777,2021-05-17,Senate,"Placed on suspense file",7,0,0,0,7
1451125,1081525,2021-05-20,Senate,"Do pass",7,0,0,0,7
1451125,1089562,2021-06-01,Senate,"Special Consent SB428",39,0,1,0,40
1451125,1104339,2021-07-06,Assembly,"Do pass as amended and be re-referred to the Committee on [Appropriations]",15,0,0,0,15
1451125,1106656,2021-08-26,Assembly,"Do pass",16,0,0,0,16
1451125,1108310,2021-09-09,Assembly,"SB 428 Hurtado Senate Third Reading By Gray",78,0,0,2,80
1451125,1108554,2021-09-10,Senate,"Unfinished Business SB428 Hurtado et al. Concurrence",37,0,0,3,40
1451127,1025130,2021-03-09,Senate,"Do pass, but first be re-referred to the Committee on [Business, Professions and Economic Development]",14,0,0,0,14
1451127,1033656,2021-03-22,Senate,"Do pass, but first be re-referred to the Committee on [Appropriations]",12,0,2,0,14
1451127,1056351,2021-04-19,Senate,"Placed on suspense file",7,0,0,0,7
1451128,1037861,2021-03-25,Senate,"Do pass and be ordered to the Consent Calendar",5,0,0,0,5
1451128,1048977,2021-04-08,Senate,"Consent Calendar SB431 Rubio",38,0,2,0,40
1451128,1096129,2021-06-09,Assembly,"Do pass. To Consent Calendar",8,0,0,0,8
1451128,1099103,2021-06-17,Assembly,"SB 431 Rubio Consent Calendar Second Day Regular Session",72,0,7,0,79
1451129,1054699,2021-04-15,Senate,"Do pass, but first be re-referred to the Committee on [Judiciary] with the recommendation: To Consent Calendar",9,0,0,0,9
1451129,1072237,2021-05-04,Senate,"Do pass and be ordered to the Consent Calendar",11,0,0,0,11
1451129,1075335,2021-05-10,Senate,"Consent Calendar SB432",37,0,3,0,40
1451129,1095032,2021-06-08,Assembly,"Do pass and be re-referred to the Committee on [Judiciary] with recommendation: To Consent Calendar",8,0,0,0,8
1451129,1100350,2021-06-22,Assembly,"Do pass",11,0,0,0,11
1451129,1107955,2021-09-07,Assembly,"SB 432 Wieckowski Senate Third Reading By Chen",72,0,0,8,80
1451129,1108212,2021-09-08,Senate,"Unfinished Business SB432 Wieckowski Concurrence",38,0,0,2,40
1451130,1064149,2021-04-27,Senate,"Do pass as amended, but first amend, and re-refer to the Committee on [Appropriations]",9,0,0,0,9
1451130,1078831,2021-05-17,Senate,"Placed on suspense file",7,0,0,0,7
1451130,1081604,2021-05-20,Senate,"Do pass",6,0,1,0,7
1451130,1086110,2021-05-26,Senate,"Senate 3rd Reading SB433 Allen",36,2,2,0,40
1451130,1100761,2021-06-23,Assembly,"Do pass and be re-referred to the Committee on [Appropriations]",10,0,1,0,11
1451130,1106634,2021-08-26,Assembly,"Do pass as amended",14,0,0,2,16
1451130,1108121,2021-09-08,Assembly,"SB 433 Allen Senate Third Reading By Petrie-Norris",75,0,0,5,80
1451130,1108274,2021-09-09,Senate,"Unfinished Business SB433 Allen Concurrence",33,0,0,7,40
1451131,1018532,2021-03-01,Senate,"Senate 3rd Reading SR10 Pan",35,0,4,0,39
1453355,1123342,2022-01-11,Assembly,"Do pass and be re-referred to the Committee on [Appropriations]",15,0,0,0,15
1453356,1036488,2021-03-24,Assembly,"Do pass. To Consent Calendar",8,0,0,0,8
1453356,1048915,2021-04-08,Assembly,"AB 687 Seyarto Consent Calendar Second Day Regular Session",74,0,4,0,78
1453356,1097037,2021-06-10,Senate,"Do pass, but first be re-referred to the Committee on [Housing] with the recommendation: To Consent Calendar",5,0,0,0,5
1453356,1103774,2021-07-01,Senate,"Do pass and be ordered to the Consent Calendar",9,0,0,0,9
1453356,1104584,2021-07-12,Senate,"Consent Calendar AB687",39,0,1,0,40
1453358,1053460,2021-04-13,Assembly,"Do pass and be re-referred to the Committee on [Appropriations] with recommendation: To Consent Calendar",8,0,0,0,8
1453358,1073341,2021-05-05,Assembly,"Do pass. To Consent Calendar",16,0,0,0,16
1453358,1077598,2021-05-13,Assembly,"AB 689 Petrie-Norris Consent Calendar Second Day Regular Session",75,0,3,0,78
1453358,1095070,2021-06-08,Senate,"Do pass, but first be re-referred to the Committee on [Appropriations] with the recommendation: To Consent Calendar",4,0,1,0,5
1453358,1106065,2021-08-16,Senate,"Assembly 3rd Reading AB689 Petrie-Norris et al. By Rubio",39,0,0,1,40
1453358,1106380,2021-08-23,Assembly,"AB 689 Petrie-Norris Concurrence in Senate Amendments",71,0,0,8,79
1453359,1046163,2021-04-06,Assembly,"Do pass and be re-referred to the Committee on [Appropriations] with recommendation: To Consent Calendar",18,0,1,0,19
1453359,1053424,2021-04-14,Assembly,"Do pass. To Consent Calendar",16,0,0,0,16
1453359,1090425,2021-06-02,Assembly,"AB 690 Arambula Assembly Third Reading",75,0,4,0,79
1453359,1103499,2021-06-30,Senate,"Do pass, but first be re-referred to the Committee on [Appropriations]",13,0,1,0,14
1453359,1108142,2021-09-08,Senate,"Assembly 3rd Reading AB690 Arambula By Roth",37,0,0,3,40
1453359,1108396,2021-09-09,Assembly,"AB 690 Arambula Concurrence in Senate Amendments",79,0,0,1,80
1453360,1057690,2021-04-20,Assembly,"Do pass and be re-referred to the Committee on [Appropriations]",19,0,0,0,19
1453360,1073414,2021-05-05,Assembly,"Do pass. To Consent Calendar",16,0,0,0,16
1453360,1077561,2021-05-13,Assembly,"AB 691 Chau Consent Calendar Second Day Regular Session",75,0,3,0,78
1453360,1103393,2021-06-30,Senate,"Do pass, but first be re-referred to the Committee on [Appropriations]",13,0,1,0,14
1453360,1108077,2021-09-08,Senate,"Assembly 3rd Reading AB691 Chau By Leyva Urgency Clause",38,0,0,2,40
1453360,1108224,2021-09-09,Assembly,"AB 691 Chau Concurrence in Senate Amendments",80,0,0,0,80
1453361,1049868,2021-04-08,Assembly,"Do pass and be re-referred to the Committee on [Appropriations] with recommendation: To Consent Calendar",15,0,0,0,15
1453361,1081946,2021-05-20,Assembly,"Do pass as amended",13,0,3,0,16
1453361,1092956,2021-06-01,Assembly,"AB 692 Waldron Assembly Third Reading",77,0,2,0,79
1453361,1104536,2021-07-08,Senate,"Do pass, but first be re-referred to the Committee on [Appropriations] with the recommendation: To Consent Calendar",8,0,1,0,9
1453361,1106245,2021-08-16,Senate,"Placed on suspense file",7,0,0,0,7
1453361,1106759,2021-08-26,Senate,"Do pass",7,0,0,0,7
1453361,1107830,2021-09-03,Senate,"Special Consent AB692",37,0,0,3,40
1453363,1060918,2021-04-22,Assembly,"Do pass and be re-referred to the Committee on [Appropriations] with recommendation: To Consent Calendar",11,0,0,0,11
1453363,1073391,2021-05-05,Assembly,"Do pass. To Consent Calendar",16,0,0,0,16
1453363,1077544,2021-05-13,Assembly,"AB 694 P. & C.P. Consent Calendar Second Day Regular Session",75,0,3,0,78
1453363,1104445,2021-07-06,Senate,"Do pass as amended, but first amend, and re-refer to the Committee on [Appropriations] with the recommendation: To Consent Calendar",11,0,0,0,11
1453363,1108331,2021-09-09,Senate,"Assembly 3rd Reading AB694 P. & C.P. (Gabriel) By Hertzberg",38,0,0,2,40
1453363,1108332,2021-09-09,Assembly,"AB 694 P. & C.P. Concurrence in Senate Amendments By GABRIEL",78,0,0,2,80
1453364,1057687,2021-04-20,Assembly,"Do pass and be re-referred to the Committee on [Appropriations]",7,0,0,0,7
1453364,1081842,2021-05-20,Assembly,"Do pass",16,0,0,0,16
1453364,1090390,2021-06-02,Assembly,"AB 695 Arambula Assembly Third Reading",78,0,1,0,79
1453364,1104415,2021-07-06,Senate,"Do pass, but first be re-referred to the Committee on [Judiciary]",5,0,0,0,5
1453364,1104978,2021-07-13,Senate,"Do pass, but first be re-referred to the Committee on [Appropriations]",11,0,0,0,11
1453364,1106237,2021-08-16,Senate,"Placed on suspense file",7,0,0,0,7
1453366,1036509,2021-03-24,Assembly,"Do pass and be re-referred to the Committee on [Appropriations]",8,2,1,0,11
1453366,1076935,2021-05-12,Assembly,"Do pass",13,1,2,0,16
1453366,1092957,2021-06-01,Assembly,"AB 697 Chau Assembly Third Reading",66,0,13,0,79
1453366,1104720,2021-07-13,Senate,"Do pass as amended, but first amend, and re-refer to the Committee on [Appropriations]",7,0,2,0,9
1453366,1106095,2021-08-16,Senate,"Placed on suspense file",7,0,0,0,7
1453366,1106763,2021-08-26,Senate,"Do pass as amended",5,0,0,2,7
1453366,1107525,2021-09-01,Senate,"Assembly 3rd Reading AB697 Chau et al. By Laird",37,1,0,2,40
1453366,1107596,2021-09-02,Assembly,"AB 697 Chau Concurrence in Senate Amendments",75,0,0,4,79
1453367,1047575,2021-04-07,Assembly,"Do pass and be re-referred to the Committee on [Appropriations] with recommendation: To Consent Calendar",9,0,0,0,9
1453367,1053534,2021-04-14,Assembly,"Do pass. To Consent Calendar",16,0,0,0,16
1453367,1060949,2021-04-22,Assembly,"AB 698 E.S. & T.M. Consent Calendar Second Day Regular Session",77,0,2,0,79
1453367,1097789,2021-06-14,Senate,"Do pass, but first be re-referred to the Committee on [Appropriations] with the recommendation: To Consent Calendar",7,0,0,0,7
1453367,1106100,2021-08-16,Senate,"Assembly 3rd Reading AB698 E.S. & T.M. (Quirk) By Allen",39,0,0,1,40
1453367,1106409,2021-08-23,Assembly,"AB 698 E.S. & T.M. Concurrence in Senate Amendments By QUIRK",71,0,0,8,79
1453368,1047478,2021-04-07,Assembly,"Do pass as amended and be re-referred to the Committee on [Natural Resources]",12,0,3,0,15
1453368,1065155,2021-04-28,Assembly,"Do pass as amended and be re-referred to the Committee on [Appropriations]",11,0,0,0,11
1453369,1065192,2021-04-27,Assembly,"Do pass as amended",8,0,0,0,8
1453369,1092870,2021-06-01,Assembly,"AB 700 Cunningham Assembly Third Reading",78,0,1,0,79
1453369,1102864,2021-06-29,Senate,"Do pass",5,0,0,0,5
1453369,1106795,2021-08-26,Senate,"Assembly 3rd Reading AB700 Cunningham By Umberg",36,0,0,4,40
1453370,1060847,2021-04-22,Assembly,"Do pass and be re-referred to the Committee on [Appropriations]",5,2,0,0,7
1453370,1081634,2021-05-20,Assembly,"Do pass",12,4,0,0,16
1453370,1088019,2021-05-28,Assembly,"AB 701 Lorena Gonzalez Assembly Third Reading",52,19,8,0,79
1453370,1104226,2021-07-05,Senate,"Do pass as amended, but first amend, and re-refer to the Committee on [Judiciary]",4,1,0,0,5
1453370,1104981,2021-07-13,Senate,"Do pass as amended, but first amend, and re-refer to the Committee on [Appropriations]",9,2,0,0,11
1453370,1106150,2021-08-16,Senate,"Placed on suspense file",7,0,0,0,7
1453370,1106753,2021-08-26,Senate,"Do pass as amended",5,2,0,0,7
1453370,1108218,2021-09-08,Senate,"Assembly 3rd Reading AB701 Lorena Gonzalez et a By Becker",26,11,0,3,40
1453370,1108374,2021-09-09,Assembly,"AB 701 Lorena Gonzalez Concurrence in Senate Amendments",52,19,0,9,80
1453373,1123304,2022-01-10,Assembly,"Do pass as amended and be re-referred to the Committee on [Appropriations]",6,1,0,4,11
1453375,1077557,2021-05-13,Assembly,"Do pass",10,0,2,0,12
1453375,1092858,2021-06-01,Assembly,"AB 706 Cooley Assembly Third Reading",69,2,8,0,79
1453375,1100233,2021-06-22,Senate,"Do pass",13,1,1,0,15
1453376,1059243,2021-04-21,Assembly,"Do pass and be re-referred to the Committee on [Appropriations]",8,0,1,0,9
1453376,1081471,2021-05-20,Assembly,"Do pass as amended",12,0,4,0,16
1453376,1092853,2021-06-01,Assembly,"AB 707 Quirk Assembly Third Reading",72,0,7,0,79
1453376,1104600,2021-07-12,Senate,"Do pass, but first be re-referred to the Committee on [Appropriations] with the recommendation: To Consent Calendar",7,0,0,0,7
1453376,1106116,2021-08-16,Senate,"Placed on suspense file",7,0,0,0,7
1453376,1106768,2021-08-26,Senate,"Do pass as amended",7,0,0,0,7
1453376,1108181,2021-09-08,Senate,"Assembly 3rd Reading AB707 Quirk By Caballero",38,0,0,2,40
1453376,1108284,2021-09-09,Assembly,"AB 707 Quirk Concurrence in Senate Amendments",78,0,0,2,80
1453379,1054603,2021-04-15,Assembly,"Do pass and be re-referred to the Committee on [Appropriations]",9,1,1,0,11
1453379,1081567,2021-05-20,Assembly,"Do pass",12,4,0,0,16
1453379,1088020,2021-05-28,Assembly,"AB 710 Eduardo Garcia Assembly Third Reading",50,16,13,0,79
1453379,1215908,2022-06-13,Senate,"Do pass, but first be re-referred to the Committee on [Agriculture]",7,2,0,5,14
1453381,1073395,2021-05-05,Assembly,"Do pass as amended",8,0,0,0,8
1453381,1083804,2021-05-24,Assembly,"AB 712 Calderon Assembly Third Reading",76,0,2,0,78
1453381,1099134,2021-06-17,Senate,"Do pass and be ordered to the Consent Calendar",5,0,0,0,5
1453381,1101634,2021-06-24,Senate,"Consent Calendar AB712",39,0,1,0,40
1453381,1102509,2021-06-28,Assembly,"AB 712 Calderon Concurrence in Senate Amendments",79,0,0,0,79
1453382,1065164,2021-04-28,Assembly,"Do pass and be re-referred to the Committee on [Appropriations]",10,0,1,0,11
1453382,1081451,2021-05-20,Assembly,"Do pass as amended",12,4,0,0,16
1453382,1092854,2021-06-01,Assembly,"AB 713 Cristina Garcia Assembly Third Reading",66,9,4,0,79
1453382,1102508,2021-06-28,Senate,"Do pass, but first be re-referred to the Committee on [Appropriations]",4,1,2,0,7
1453382,1105088,2021-07-15,Senate,"Placed on suspense file",7,0,0,0,7
1453385,1035206,2021-03-23,Assembly,"Do pass as amended and be re-referred to the Committee on [Appropriations]",10,0,1,0,11
1453385,1082204,2021-05-20,Assembly,"Do pass",14,0,2,0,16
1453385,1086988,2021-05-27,Assembly,"AB 716 Bennett Assembly Third Reading",72,0,6,0,78
1453385,1104913,2021-07-13,Senate,"Do pass as amended, but first amend, and re-refer to the Committee on [Appropriations]",10,0,1,0,11
1453385,1106125,2021-08-16,Senate,"Placed on suspense file",7,0,0,0,7
1453385,1106958,2021-08-26,Senate,"Do pass",7,0,0,0,7
1453385,1108613,2021-09-10,Senate,"Assembly 3rd Reading AB716 Bennett By Umberg",36,0,0,4,40
1453385,1108614,2021-09-10,Assembly,"AB 716 Bennett Concurrence in Senate Amendments",77,0,0,3,80
1453386,1053416,2021-04-13,Assembly,"Do pass and be re-referred to the Committee on [Appropriations]",6,2,0,0,8
1453386,1081923,2021-05-20,Assembly,"Do pass",12,4,0,0,16
1453386,1092851,2021-06-01,Assembly,"AB 717 Stone Assembly Third Reading",64,13,2,0,79
1453386,1104308,2021-07-06,Senate,"Do pass, but first be re-referred to the Committee on [Appropriations]",5,0,0,0,5
1453387,1053452,2021-04-13,Assembly,"Do pass and be re-referred to the Committee on [Appropriations] with recommendation: To Consent Calendar",8,0,0,0,8
1453387,1065085,2021-04-28,Assembly,"Do pass. To Consent Calendar",16,0,0,0,16
1453387,1074110,2021-05-06,Assembly,"AB 718 Cunningham Consent Calendar Second Day Regular Session",77,0,1,0,78
1453387,1098151,2021-06-15,Senate,"Do pass, but first be re-referred to the Committee on [Appropriations] with the recommendation: To Consent Calendar",4,0,1,0,5
1453387,1104188,2021-07-05,Senate,"Placed on suspense file",6,0,1,0,7
1453388,1066796,2021-04-29,Assembly,"Do pass and be re-referred to the Committee on [Appropriations] with recommendation: To Consent Calendar",11,0,0,0,11
1453388,1081581,2021-05-20,Assembly,"Do pass as amended",16,0,0,0,16
1453388,1092949,2021-06-01,Assembly,"AB 719 AGRI. Assembly Third Reading By RIVAS, R",78,0,1,0,79
1453388,1103852,2021-07-01,Senate,"Do pass, but first be re-referred to the Committee on [Appropriations]",5,0,0,0,5
1453388,1105082,2021-07-15,Senate,"Placed on suspense file",7,0,0,0,7
1453388,1106889,2021-08-26,Senate,"Do pass as amended",7,0,0,0,7
1453388,1225924,2022-08-31,Senate,"Special Consent AB719 AGRI",40,0,0,0,40
1453388,1225925,2022-08-31,Assembly,"AB 719 Agriculture Concurrence in Senate Amendments By RIVAS, R",80,0,0,0,80
1453390,1054737,2021-04-15,Assembly,"Do pass as amended and be re-referred to the Committee on [Judiciary]",5,0,3,0,8
1453390,1064081,2021-04-27,Assembly,"Do pass as amended and be re-referred to the Committee on [Appropriations]",7,3,1,0,11
1453390,1081902,2021-05-20,Assembly,"Do pass as amended",12,4,0,0,16
1453390,1090459,2021-06-02,Assembly,"AB 721 Bloom Assembly Third Reading",52,18,9,0,79
1453390,1103797,2021-07-01,Senate,"Do pass as amended, but first amend, and re-refer to the Committee on [Judiciary]",7,2,0,0,9
1453390,1104975,2021-07-13,Senate,"Do pass, but first be re-referred to the Committee on [Appropriations]",8,2,1,0,11
1453390,1106466,2021-08-23,Senate,"Placed on suspense file",7,0,0,0,7
1453390,1106899,2021-08-26,Senate,"Do pass",5,2,0,0,7
1453390,1107428,2021-09-01,Senate,"Assembly 3rd Reading AB721 Bloom By Wiener",29,9,0,2,40
1453390,1107674,2021-09-02,Assembly,"AB 721 Bloom Concurrence in Senate Amendments",53,17,0,9,79
1453392,1035266,2021-03-23,Assembly,"Do pass and be re-referred to the Committee on [Appropriations] with recommendation: To Consent Calendar",17,0,2,0,19
1453392,1053471,2021-04-14,Assembly,"Do pass. To Consent Calendar",16,0,0,0,16
1453392,1092857,2021-06-01,Assembly,"AB 723 Low Assembly Third Reading",77,0,2,0,79
1453392,1104782,2021-07-13,Senate,"Do pass, but first be re-referred to the Committee on [Appropriations]",13,3,1,0,17
1453392,1106390,2021-08-23,Senate,"Placed on suspense file",7,0,0,0,7
1453392,1106844,2021-08-26,Senate,"Do pass as amended",5,2,0,0,7
1453392,1107467,2021-09-01,Senate,"Assembly 3rd Reading AB723 Low et al. By Portantino",32,7,0,1,40
1453392,1107468,2021-09-01,Senate,"Assembly 3rd Reading AB723 Low et al. By Portantino Reconsider",39,0,0,1,40
1453392,1108081,2021-09-08,Senate,"Assembly 3rd Reading AB723 Low et al. By Portantino",33,5,0,2,40
1453395,1036496,2021-03-24,Assembly,"Do pass",8,0,0,0,8
1453395,1048948,2021-04-08,Assembly,"AB 726 Eduardo Garcia Assembly Third Reading",74,0,4,0,78
1453395,1099148,2021-06-17,Senate,"Do pass as amended",5,0,0,0,5
1453395,1104208,2021-07-05,Senate,"Special Consent AB726",38,0,2,0,40
1453395,1104663,2021-07-12,Assembly,"AB 726 Eduardo Garcia Concurrence in Senate Amendments",77,0,2,0,79
1453397,1054641,2021-04-15,Assembly,"Do pass and be re-referred to the Committee on [Appropriations]",7,0,0,0,7
1453399,1050810,2021-04-12,Assembly,"Do pass and be re-referred to the Committee on [Higher Education]",7,0,0,0,7
1453399,1060990,2021-04-22,Assembly,"Do pass and be re-referred to the Committee on [Appropriations]",12,0,0,0,12
1453399,1073381,2021-05-05,Assembly,"Do pass",16,0,0,0,16
1453399,1083799,2021-05-24,Assembly,"AB 730 Quirk-Silva Assembly Third Reading",76,0,2,0,78
1453399,1099730,2021-06-21,Senate,"Do pass, but first be re-referred to the Committee on [Appropriations] with the recommendation: To Consent Calendar",11,0,3,0,14
1453399,1104148,2021-07-05,Senate,"Placed on suspense file",6,0,1,0,7
1453400,1053531,2021-04-13,Assembly,"Do pass and be re-referred to the Committee on [Appropriations]",7,0,1,0,8
1453400,1081468,2021-05-20,Assembly,"Do pass",13,1,2,0,16
1453400,1086993,2021-05-27,Assembly,"AB 731 Bauer-Kahan Assembly Third Reading",67,0,11,0,78
1453400,1102858,2021-06-29,Senate,"Do pass as amended, but first amend, and re-refer to the Committee on [Appropriations]",4,0,1,0,5
1453400,1106071,2021-08-16,Senate,"Placed on suspense file",7,0,0,0,7
1453400,1106849,2021-08-26,Senate,"Do pass as amended",5,0,0,2,7
1453400,1224590,2022-08-23,Senate,"Assembly 3rd Reading AB731 Bauer-Kahan et al. By Portantino",31,8,0,1,40
1453400,1224680,2022-08-24,Assembly,"AB 731 Bauer-Kahan Concurrence in Senate Amendments",60,0,0,20,80
1453401,1123335,2022-01-11,Assembly,"Do pass. To Consent Calendar",6,0,0,3,9
1453401,1124829,2022-01-18,Assembly,"AB 732 Quirk Consent Calendar Second Day",66,0,0,10,76
1453401,1211944,2022-06-01,Senate,"Do pass, but first be re-referred to the Committee on [Appropriations] with the recommendation: To Consent Calendar",6,0,0,1,7
1453401,1224663,2022-08-24,Senate,"Assembly 3rd Reading AB732 Quirk By Newman",40,0,0,0,40
1453401,1224984,2022-08-25,Assembly,"AB 732 Quirk Concurrence in Senate Amendments",75,0,0,5,80
1453407,1123332,2022-01-11,Assembly,"Do pass as amended and be re-referred to the Committee on [Appropriations]",15,0,0,0,15
1453407,1126279,2022-01-20,Assembly,"Do pass. To Consent Calendar",15,0,0,1,16
1453407,1129875,2022-01-27,Assembly,"AB 738 Nguyen Consent Calendar Second Day Regular Session",61,0,0,15,76
1453407,1211926,2022-06-01,Senate,"Do pass as amended, but first amend, and re-refer to the Committee on [Appropriations]",9,0,0,2,11
1453407,1225674,2022-08-31,Senate,"Assembly 3rd Reading AB738 Nguyen By Archuleta",40,0,0,0,40
1453407,1225675,2022-08-31,Assembly,"AB 738 Nguyen Concurrence in Senate Amendments",80,0,0,0,80
1453409,1123759,2022-01-12,Assembly,"Do pass as amended, and be re-referred to the Committee on [Appropriations] with recommendation: To Consent Calendar",6,0,0,1,7
1453409,1126314,2022-01-20,Assembly,"Do pass",15,0,0,1,16
1453409,1127174,2022-01-24,Assembly,"AB 740 McCarty Assembly Third Reading",65,0,0,11,76
1453409,1211920,2022-06-01,Senate,"Do pass, but first be re-referred to the Committee on [Judiciary] with the recommendation: To Consent Calendar",6,0,0,1,7
1453409,1216346,2022-06-14,Senate,"Do pass, but first be re-referred to the Committee on [Appropriations] with the recommendation: To Consent Calendar",11,0,0,0,11
1453409,1222790,2022-08-01,Senate,"Placed on suspense file",7,0,0,0,7
1453409,1223627,2022-08-11,Senate,"Do pass",7,0,0,0,7
1453409,1225417,2022-08-29,Senate,"Assembly 3rd Reading AB740 McCarty et al. By Pan",37,0,0,3,40
1453409,1225418,2022-08-30,Assembly,"AB 740 McCarty Concurrence in Senate Amendments",79,0,0,1,80
1453411,1035265,2021-03-22,Assembly,"Do pass and be re-referred to the Committee on [Appropriations]",10,0,1,0,11
1453411,1059236,2021-04-21,Assembly,"Do pass. To Consent Calendar",14,0,2,0,16
1453411,1066745,2021-04-29,Assembly,"AB 742 Calderon Consent Calendar Second Day Regular Session",77,0,1,0,78
1453411,1097032,2021-06-10,Senate,"Do pass, but first be re-referred to the Committee on [Appropriations] with the recommendation: To Consent Calendar",5,0,0,0,5
1453411,1101652,2021-06-24,Senate,"Consent Calendar AB742",39,0,1,0,40
1453411,1102463,2021-06-28,Assembly,"AB 742 Calderon Concurrence in Senate Amendments",79,0,0,0,79
1453413,1052015,2021-04-12,Assembly,"Do pass and be re-referred to the Committee on [Appropriations] with recommendation: To Consent Calendar",15,0,0,0,15
1453413,1082079,2021-05-20,Assembly,"Do pass",16,0,0,0,16
1453413,1086920,2021-05-27,Assembly,"AB 744 Rodriguez Assembly Third Reading",78,0,0,0,78
1453413,1101588,2021-06-24,Senate,"Do pass, but first be re-referred to the Committee on [Appropriations] with the recommendation: To Consent Calendar",15,0,2,0,17
1453413,1104174,2021-07-05,Senate,"Placed on suspense file",6,0,1,0,7
1453413,1106592,2021-08-26,Senate,"Do pass",7,0,0,0,7
1453413,1107775,2021-09-03,Senate,"Special Consent AB744",37,0,0,3,40
1453414,1064042,2021-04-26,Assembly,"Do pass and be re-referred to the Committee on [Appropriations] with recommendation: To Consent Calendar",15,0,0,0,15
1453415,1072287,2021-05-04,Assembly,"Do pass as amended",9,1,1,0,11
1453415,1078785,2021-05-17,Assembly,"AB 746 Cervantes Assembly Third Reading",63,5,10,0,78
1453415,1103445,2021-06-29,Senate,"Do pass",10,0,1,0,11
1453415,1107462,2021-09-01,Senate,"Assembly 3rd Reading AB746 Cervantes By Eggman",33,1,0,6,40
1453415,1107627,2021-09-02,Assembly,"AB 746 Cervantes Concurrence in Senate Amendments",66,2,0,11,79
1453417,1123752,2022-01-12,Assembly,"Do pass and be re-referred to the Committee on [Appropriations] with recommendation: To Consent Calendar",6,0,0,1,7
1453417,1126284,2022-01-20,Assembly,"Do pass",15,0,0,1,16
1453417,1131240,2022-01-31,Assembly,"AB 748 Carrillo Assembly Third Reading",75,0,0,1,76
1453417,1211852,2022-06-01,Senate,"Do pass as amended, but first amend, and re-refer to the Committee on [Judiciary] with the recommendation: To Consent Calendar",6,0,0,1,7
1453417,1216333,2022-06-14,Senate,"Do pass as amended, but first amend, and re-refer to the Committee on [Appropriations]",11,0,0,0,11
1453417,1219521,2022-06-27,Senate,"Placed on suspense file",6,0,0,1,7
1453417,1223537,2022-08-11,Senate,"Do pass",7,0,0,0,7
1453417,1224460,2022-08-23,Senate,"Special Consent AB748",40,0,0,0,40
1453417,1224729,2022-08-24,Assembly,"AB 748 Carrillo Concurrence in Senate Amendments",75,0,0,5,80
1453418,1057731,2021-04-20,Assembly,"Do pass and be re-referred to the Committee on [Appropriations]",15,0,0,0,15
1453418,1065283,2021-04-28,Assembly,"Do pass. To Consent Calendar",16,0,0,0,16
1453418,1074187,2021-05-06,Assembly,"AB 749 Nazarian Consent Calendar Second Day Regular Session",77,0,1,0,78
1453418,1097014,2021-06-10,Senate,"Do pass as amended, but first amend, and re-refer to the Committee on [Appropriations]",10,0,1,0,11
1453418,1104183,2021-07-05,Senate,"Placed on suspense file",6,0,1,0,7
1453418,1106663,2021-08-26,Senate,"Do pass as amended",7,0,0,0,7
1453418,1108092,2021-09-08,Senate,"Special Consent AB749",38,0,0,2,40
1453418,1108432,2021-09-09,Assembly,"AB 749 Nazarian Concurrence in Senate Amendments",79,0,0,1,80
1453419,1059254,2021-04-20,Assembly,"Do pass and be re-referred to the Committee on [Appropriations] with recommendation: To Consent Calendar",8,0,0,0,8
1453419,1081533,2021-05-20,Assembly,"Do pass",16,0,0,0,16
1453419,1087026,2021-05-27,Assembly,"AB 750 Jones-Sawyer Assembly Third Reading",77,0,1,0,78
1453419,1104242,2021-07-06,Senate,"Do pass, but first be re-referred to the Committee on [Appropriations] with the recommendation: To Consent Calendar",5,0,0,0,5
1453419,1106092,2021-08-16,Senate,"Placed on suspense file",7,0,0,0,7
1453419,1106934,2021-08-26,Senate,"Do pass",7,0,0,0,7
1453419,1107798,2021-09-03,Senate,"Special Consent AB750",37,0,0,3,40
1453420,1057647,2021-04-20,Assembly,"Do pass and be re-referred to the Committee on [Appropriations]",15,0,0,0,15
1453420,1065083,2021-04-28,Assembly,"Do pass",16,0,0,0,16
1453420,1068203,2021-05-03,Assembly,"AB 751 Irwin Assembly Third Reading",75,0,3,0,78
1453420,1104890,2021-07-13,Senate,"Do pass as amended, but first amend, and re-refer to the Committee on [Appropriations]",9,1,1,0,11
1453420,1107393,2021-09-01,Senate,"Assembly 3rd Reading AB751 Irwin et al. By Umberg",36,1,0,3,40
1453420,1107701,2021-09-02,Assembly,"AB 751 Irwin Concurrence in Senate Amendments",74,0,0,5,79
1453421,1052029,2021-04-13,Assembly,"Do pass as amended and be re-referred to the Committee on [Appropriations]",13,0,2,0,15
1453422,1059218,2021-04-21,Assembly,"Do pass and be re-referred to the Committee on [Housing and Community Development]",7,1,1,0,9
1453422,1067603,2021-04-29,Assembly,"Do pass and be re-referred to the Committee on [Appropriations]",6,2,0,0,8
1453422,1081884,2021-05-20,Assembly,"Do pass as amended",12,4,0,0,16
1453422,1092869,2021-06-01,Assembly,"AB 753 Grayson Assembly Third Reading",61,15,3,0,79
1453422,1102517,2021-06-28,Senate,"Do pass, but first be re-referred to the Committee on [Appropriations]",4,1,2,0,7
1453422,1104158,2021-07-05,Senate,"Placed on suspense file",6,0,1,0,7
1453423,1064098,2021-04-26,Assembly,"Do pass and be re-referred to the Committee on [Appropriations]",9,4,2,0,15
1453423,1080458,2021-05-19,Assembly,"Do pass",10,1,5,0,16
1453423,1090428,2021-06-02,Assembly,"AB 754 Mathis Assembly Third Reading",45,21,13,0,79
1453423,1104723,2021-07-13,Senate,"Do pass, but first be re-referred to the Committee on [Appropriations]",1,4,4,0,9
1453423,1104724,2021-07-13,Senate,"[Second] hearing set for [07-13-2021]: Failed passage in Committee. Reconsideration granted",8,0,1,0,9
1453425,1060962,2021-04-22,Assembly,"Do pass and be re-referred to the Committee on [Banking and Finance]",9,2,1,0,12
1453427,1065173,2021-04-28,Assembly,"Do pass as amended and be re-referred to the Committee on [Appropriations]",7,0,1,0,8
1453427,1080409,2021-05-19,Assembly,"Do pass. To Consent Calendar",15,0,1,0,16
1453427,1087066,2021-05-27,Assembly,"AB 758 Nazarian Consent Calendar Second Day Regular Session",75,0,3,0,78
1453427,1101690,2021-06-24,Senate,"Do pass, but first be re-referred to the Committee on [Energy, Utilities and Communications]",5,0,0,0,5
1453427,1104616,2021-07-12,Senate,"Do pass as amended, but first amend, and re-refer to the Committee on [Appropriations]",13,0,1,0,14
1453427,1107176,2021-08-30,Senate,"Assembly 3rd Reading AB758 Nazarian et al. By Hertzberg",39,0,0,1,40
1453427,1107460,2021-09-01,Assembly,"AB 758 Nazarian Concurrence in Senate Amendments",77,0,0,2,79
1453428,1066774,2021-04-29,Assembly,"Do pass and be re-referred to the Committee on [Appropriations]",5,1,1,0,7
1453428,1081910,2021-05-20,Assembly,"Do pass",12,4,0,0,16
1453428,1090479,2021-06-02,Assembly,"AB 759 McCarty Assembly Third Reading",51,20,8,0,79
1453428,1102479,2021-06-28,Senate,"Do pass, but first be re-referred to the Committee on [Governance and Finance]",3,2,0,0,5
1453428,1104519,2021-07-08,Senate,"Do pass, but first be re-referred to the Committee on [Appropriations]",4,1,0,0,5
1453428,1106453,2021-08-23,Senate,"Placed on suspense file",7,0,0,0,7
1453428,1106854,2021-08-26,Senate,"Do pass",5,2,0,0,7
1453428,1225621,2022-08-29,Senate,"Assembly 3rd Reading AB759 McCarty et al. By Newman",21,11,0,8,40
1453428,1225622,2022-08-31,Assembly,"AB 759 McCarty Concurrence in Senate Amendments",48,21,0,11,80
1453428,1229700,2022-08-30,Senate,"Assembly 3rd Reading AB759 McCarty et al. By Newman",21,11,0,8,40
1453429,1059182,2021-04-20,Assembly,"Do pass and be re-referred to the Committee on [Appropriations] with recommendation: To Consent Calendar",8,0,0,0,8
1453430,1054724,2021-04-15,Assembly,"Do pass. To Consent Calendar",7,0,0,0,7
1453430,1060835,2021-04-22,Assembly,"AB 761 Chen Consent Calendar Second Day Regular Session",77,0,2,0,79
1453430,1093658,2021-06-07,Senate,"Do pass and be ordered to the Consent Calendar",5,0,0,0,5
1453430,1099144,2021-06-17,Senate,"Consent Calendar AB761",37,0,3,0,40
1453431,1047587,2021-04-07,Assembly,"Do pass and be re-referred to the Committee on [Education]",6,0,3,0,9
1453431,1065248,2021-04-28,Assembly,"Do pass as amended and be re-referred to the Committee on [Appropriations]",5,1,1,0,7
1453431,1081872,2021-05-20,Assembly,"Do pass",12,0,4,0,16
1453431,1092901,2021-06-01,Assembly,"AB 762 Lee Assembly Third Reading",61,2,16,0,79
1453431,1102469,2021-06-28,Senate,"Do pass, but first be re-referred to the Committee on [Education]",4,2,1,0,7
1453431,1104373,2021-07-07,Senate,"Do pass, but first be re-referred to the Committee on [Appropriations]",4,2,1,0,7
1453431,1106124,2021-08-16,Senate,"Placed on suspense file",7,0,0,0,7
1453433,1053482,2021-04-13,Assembly,"Do pass and be re-referred to the Committee on [Appropriations] with recommendation: To Consent Calendar",8,0,0,0,8
1453433,1065123,2021-04-28,Assembly,"Do pass",16,0,0,0,16
1453433,1074186,2021-05-06,Assembly,"AB 764 Cervantes Assembly Third Reading",76,0,2,0,78
1453433,1104710,2021-07-13,Senate,"Do pass as amended, but first amend, and re-refer to the Committee on [Appropriations]",5,0,0,0,5
1453433,1106147,2021-08-16,Senate,"Placed on suspense file",7,0,0,0,7
1453433,1106581,2021-08-26,Senate,"Do pass",7,0,0,0,7
1453433,1107764,2021-09-03,Senate,"Special Consent AB764",37,0,0,3,40
1453433,1107931,2021-09-07,Assembly,"AB 764 Cervantes Concurrence in Senate Amendments",73,0,0,7,80
1453438,1122876,2022-01-10,Assembly,"Do pass and be re-referred to the Committee on [Appropriations] with recommendation: To Consent Calendar",11,0,0,1,12
1453438,1126278,2022-01-20,Assembly,"Do pass. To Consent Calendar",15,0,0,1,16
1453438,1129929,2022-01-27,Assembly,"AB 769 Grayson Consent Calendar Second Day Regular Session",61,0,0,15,76
1453438,1173507,2022-03-21,Senate,"Do pass",10,0,0,1,11
1453438,1173508,2022-03-21,Senate,"Do pass, but first be re-referred to the Committee on [Judiciary]",8,0,0,1,9
1453438,1176533,2022-03-24,Senate,"Assembly 3rd Reading AB769 Grayson By Hueso Urgency Clause",36,0,0,4,40
1453438,1176534,2022-03-24,Assembly,"AB 769 GRAYSON Concurrence - Urgency Added",74,0,0,2,76
1453440,1035248,2021-03-22,Assembly,"Do pass and be re-referred to the Committee on [Appropriations] with recommendation: To Consent Calendar",15,0,0,0,15
1453442,1073369,2021-05-05,Assembly,"Do pass",8,0,0,0,8
1453442,1077582,2021-05-13,Assembly,"AB 773 Nazarian Assembly Third Reading",72,0,6,0,78
1453442,1104748,2021-07-13,Senate,"Do pass",13,2,2,0,17
1453442,1106436,2021-08-23,Senate,"Assembly 3rd Reading AB773 Nazarian By Wiener",30,5,0,5,40
1453442,1107186,2021-08-30,Assembly,"AB 773 Nazarian Concurrence in Senate Amendments",73,0,0,6,79
1453444,1048967,2021-04-08,Assembly,"Do pass as amended and be re-referred to the Committee on [Appropriations]",12,0,0,0,12
1453444,1081545,2021-05-20,Assembly,"Do pass as amended",12,0,4,0,16
1453444,1091707,2021-06-03,Assembly,"AB 775 Berman Assembly Third Reading",76,0,3,0,79
1453444,1104641,2021-07-12,Senate,"Do pass as amended, but first amend, and re-refer to the Committee on [Appropriations]",5,0,0,0,5
1453444,1225186,2022-08-31,Assembly,"With recommendation: That Senate amendments be concurred in",4,0,0,3,7
1453444,1225544,2022-08-29,Senate,"Assembly 3rd Reading AB775 Berman et al. By Glazer",38,0,0,2,40
1453444,1225545,2022-08-31,Assembly,"AB 775 Berman Concurrence in Senate Amendments",80,0,0,0,80
1453446,1065222,2021-04-28,Assembly,"Do pass as amended and be re-referred to the Committee on [Appropriations]",7,0,0,0,7
1453446,1082098,2021-05-20,Assembly,"Do pass",16,0,0,0,16
1453446,1090391,2021-06-02,Assembly,"AB 777 McCarty Assembly Third Reading",75,0,4,0,79
1453446,1100336,2021-06-22,Senate,"Do pass, but first be re-referred to the Committee on [Appropriations] with the recommendation: To Consent Calendar",15,0,0,0,15
1453446,1105048,2021-07-15,Senate,"Placed on suspense file",7,0,0,0,7
1453446,1106997,2021-08-26,Senate,"Do pass as amended",6,1,0,0,7
1453446,1107614,2021-09-02,Senate,"Assembly 3rd Reading AB777 McCarty By Pan",39,0,0,1,40
1453446,1225947,2022-08-31,Senate,"Assembly 3rd Reading AB777 McCarty By Pan",32,1,0,7,40
1453446,1225948,2022-08-31,Assembly,"AB 777 McCarty Concurrence in Senate Amendments",74,0,0,6,80
1453447,1053511,2021-04-14,Assembly,"Do pass and be re-referred to the Committee on [Agriculture]",7,0,0,0,7
1453447,1066697,2021-04-29,Assembly,"Do pass as amended and be re-referred to the Committee on [Appropriations]",11,0,0,0,11
1453447,1082078,2021-05-20,Assembly,"Do pass",16,0,0,0,16
1453447,1087067,2021-05-27,Assembly,"AB 778 Eduardo Garcia Assembly Third Reading",75,0,3,0,78
1453447,1215783,2022-06-14,Senate,"Do pass as amended, but first amend, and re-refer to the Committee on [Agriculture]",13,0,0,2,15
1453447,1217324,2022-06-21,Senate,"Do pass, but first be re-referred to the Committee on [Appropriations]",5,0,0,0,5
1453447,1222842,2022-08-01,Senate,"Placed on suspense file",7,0,0,0,7
1453447,1223433,2022-08-11,Senate,"Do pass as amended",7,0,0,0,7
1453447,1225205,2022-08-30,Senate,"Assembly 3rd Reading AB778 Eduardo Garcia et al By Caballero",40,0,0,0,40
1453447,1225206,2022-08-31,Assembly,"AB 778 Eduardo Garcia Concurrence in Senate Amendments",80,0,0,0,80
1453448,1047559,2021-04-06,Assembly,"Do pass",6,1,1,0,8
1453448,1056494,2021-04-19,Assembly,"AB 779 Bigelow Assembly Third Reading",70,3,6,0,79
1453448,1104776,2021-07-13,Senate,"Do pass, but first be re-referred to the Committee on [Appropriations]",4,0,1,0,5
1453448,1106223,2021-08-16,Senate,"Placed on suspense file",7,0,0,0,7
1453448,1106787,2021-08-26,Senate,"Do pass",6,0,0,1,7
1453448,1107854,2021-09-07,Senate,"Assembly 3rd Reading AB779 Bigelow et al. By McGuire",36,0,0,4,40
1453450,1064096,2021-04-26,Assembly,"Do pass and be re-referred to the Committee on [Appropriations] with recommendation: To Consent Calendar",15,0,0,0,15
1453450,1082050,2021-05-20,Assembly,"Do pass",16,0,0,0,16
1453450,1086947,2021-05-27,Assembly,"AB 781 Daly Assembly Third Reading",78,0,0,0,78
1453450,1102826,2021-06-29,Senate,"Do pass, but first be re-referred to the Committee on [Judiciary] with the recommendation: To Consent Calendar",9,0,0,0,9
1453450,1104484,2021-07-06,Senate,"Do pass, but first be re-referred to the Committee on [Appropriations] with the recommendation: To Consent Calendar",11,0,0,0,11
1453450,1106142,2021-08-16,Senate,"Placed on suspense file",7,0,0,0,7
1453450,1106676,2021-08-26,Senate,"Do pass",7,0,0,0,7
1453450,1107769,2021-09-03,Senate,"Special Consent AB781",37,0,0,3,40
1453452,1060845,2021-04-22,Assembly,"Do pass and be re-referred to the Committee on [Appropriations]",7,0,0,0,7
1453452,1082026,2021-05-20,Assembly,"Do pass as amended",13,0,3,0,16
1453452,1092970,2021-06-01,Assembly,"AB 783 Gray Assembly Third Reading",79,0,0,0,79
1453452,1102476,2021-06-28,Senate,"Do pass, but first be re-referred to the Committee on [Appropriations] with the recommendation: To Consent Calendar",5,0,0,0,5
1453452,1105122,2021-07-15,Senate,"Do pass",6,1,0,0,7
1453452,1106702,2021-08-26,Senate,"Assembly 3rd Reading AB783 Gray By Hurtado",36,0,0,4,40
1453453,1036534,2021-03-24,Assembly,"Do pass and be re-referred to the Committee on [Appropriations]",8,0,0,0,8
1453453,1053535,2021-04-14,Assembly,"Do pass. To Consent Calendar",16,0,0,0,16
1453453,1060936,2021-04-22,Assembly,"AB 784 Quirk Consent Calendar Second Day Regular Session",77,0,2,0,79
1453453,1098137,2021-06-15,Senate,"Do pass as amended, but first amend, and re-refer to the Committee on [Governance and Finance] with the recommendation: To Consent Calendar",17,0,0,0,17
1453453,1103848,2021-07-01,Senate,"Do pass as amended, but first amend, and re-refer to the Committee on [Appropriations]",5,0,0,0,5
1453453,1106371,2021-08-19,Senate,"Assembly 3rd Reading AB784 Quirk By Wieckowski",37,0,0,3,40
1453453,1106964,2021-08-26,Assembly,"AB 784 Quirk Concurrence in Senate Amendments",74,0,0,5,79
1453456,1054744,2021-04-15,Assembly,"Do pass as amended and be re-referred to the Committee on [Local Government]",8,0,0,0,8
1453456,1065121,2021-04-28,Assembly,"Do pass as amended and be re-referred to the Committee on [Appropriations]",8,0,0,0,8
1453456,1081917,2021-05-20,Assembly,"Do pass",16,0,0,0,16
1453456,1086958,2021-05-27,Assembly,"AB 787 Gabriel Assembly Third Reading",78,0,0,0,78
1453456,1104517,2021-07-08,Senate,"Do pass, but first be re-referred to the Committee on [Appropriations] with the recommendation: To Consent Calendar",9,0,0,0,9
1453456,1106176,2021-08-16,Senate,"Placed on suspense file",7,0,0,0,7
1453456,1106783,2021-08-26,Senate,"Do pass as amended",7,0,0,0,7
1453456,1108089,2021-09-08,Senate,"Special Consent AB787",38,0,0,2,40
1453456,1108471,2021-09-09,Assembly,"AB 787 Gabriel Concurrence in Senate Amendments",79,0,0,1,80
1453457,1047419,2021-04-07,Assembly,"Do pass and be re-referred to the Committee on [Judiciary] with recommendation: To Consent Calendar",8,0,0,0,8
1453457,1052026,2021-04-13,Assembly,"Do pass. To Consent Calendar",11,0,0,0,11
1453457,1056495,2021-04-19,Assembly,"AB 788 Calderon Consent Calendar Second Day Regular Session",78,0,1,0,79
1453457,1095022,2021-06-08,Senate,"Do pass, but first be re-referred to the Committee on [Judiciary]",5,0,0,0,5
1453457,1103421,2021-06-29,Senate,"Do pass",11,0,0,0,11
1453457,1107119,2021-08-30,Senate,"Special Consent AB788",39,0,0,1,40
1453457,1107442,2021-09-01,Assembly,"AB 788 Calderon Concurrence in Senate Amendments",78,0,0,1,79
1453458,1057666,2021-04-20,Assembly,"Do pass and be re-referred to the Committee on [Appropriations] with recommendation: To Consent Calendar",15,0,0,0,15
1453458,1082125,2021-05-20,Assembly,"Do pass as amended",16,0,0,0,16
1453458,1092960,2021-06-01,Assembly,"AB 789 Low Assembly Third Reading",78,0,1,0,79
1453458,1101630,2021-06-23,Senate,"Do pass as amended, but first amend, and re-refer to the Committee on [Judiciary] with the recommendation: To Consent Calendar",11,0,0,0,11
1453458,1103509,2021-06-29,Senate,"Do pass, but first be re-referred to the Committee on [Appropriations] with the recommendation: To Consent Calendar",11,0,0,0,11
1453458,1107132,2021-08-30,Senate,"Consent Calendar AB789",39,0,0,1,40
1453458,1107404,2021-09-01,Assembly,"AB 789 Low Concurrence in Senate Amendments",76,0,0,3,79
1453459,1048936,2021-04-08,Assembly,"Do pass and be re-referred to the Committee on [Judiciary] with recommendation: To Consent Calendar",11,0,0,0,11
1453459,1072248,2021-05-04,Assembly,"Do pass. To Consent Calendar",11,0,0,0,11
1453459,1075328,2021-05-10,Assembly,"AB 790 Quirk-Silva Consent Calendar Second Day Regular Session",74,0,4,0,78
1453459,1098136,2021-06-15,Senate,"Do pass, but first be re-referred to the Committee on [Appropriations] with the recommendation: To Consent Calendar",10,0,1,0,11
1453459,1104156,2021-07-05,Senate,"Placed on suspense file",6,0,1,0,7
1453459,1106700,2021-08-26,Senate,"Do pass",7,0,0,0,7
1453459,1107761,2021-09-03,Senate,"Special Consent AB790",37,0,0,3,40
1453461,1065279,2021-04-28,Assembly,"Do pass and be re-referred to the Committee on [Appropriations]",11,0,0,0,11
1453463,1060957,2021-04-22,Assembly,"Do pass and be re-referred to the Committee on [Transportation]",5,2,0,0,7
1453463,1064161,2021-04-26,Assembly,"Do pass as amended and be re-referred to the Committee on [Appropriations]",11,4,0,0,15
1453463,1081473,2021-05-20,Assembly,"Do pass as amended",12,4,0,0,16
1453463,1090471,2021-06-02,Assembly,"AB 794 Carrillo Assembly Third Reading",52,17,10,0,79
1453463,1104492,2021-07-07,Senate,"Do pass as amended, but first amend, and re-refer to the Committee on [Labor, Public Employment and Retirement ]",5,0,2,0,7
1453463,1104604,2021-07-12,Senate,"Do pass, but first be re-referred to the Committee on [Appropriations]",4,1,0,0,5
1453463,1106235,2021-08-16,Senate,"Placed on suspense file",7,0,0,0,7
1453463,1106553,2021-08-26,Senate,"Do pass as amended",5,2,0,0,7
1453463,1108177,2021-09-08,Senate,"Assembly 3rd Reading AB794 Carrillo et al. By Gonzalez",29,9,0,2,40
1453463,1108464,2021-09-09,Assembly,"AB 794 Carrillo Concurrence in Senate Amendments",58,19,0,3,80
1453465,1054753,2021-04-15,Assembly,"Do pass and be re-referred to the Committee on [Transportation]",5,1,1,0,7
1453465,1064000,2021-04-26,Assembly,"Do pass and be re-referred to the Committee on [Appropriations]",10,4,1,0,15
1453465,1082223,2021-05-20,Assembly,"Do pass",12,4,0,0,16
1453465,1087060,2021-05-27,Assembly,"AB 796 Berman Assembly Third Reading",58,18,2,0,78
1453465,1102516,2021-06-28,Senate,"Do pass as amended, but first amend, and re-refer to the Committee on [Transportation]",4,1,0,0,5
1453465,1104780,2021-07-13,Senate,"Do pass, but first be re-referred to the Committee on [Appropriations]",12,4,1,0,17
1453465,1106171,2021-08-16,Senate,"Placed on suspense file",7,0,0,0,7
1453465,1106968,2021-08-26,Senate,"Do pass as amended",5,2,0,0,7
1453465,1107546,2021-09-01,Senate,"Assembly 3rd Reading AB796 Berman et al. By Newman",30,9,0,1,40
1453465,1107635,2021-09-02,Assembly,"AB 796 Berman Concurrence in Senate Amendments",59,18,0,2,79
1453467,1056417,2021-04-19,Assembly,"Do pass and be re-referred to the Committee on [Appropriations] with recommendation: To Consent Calendar",15,0,0,0,15
1453467,1073383,2021-05-05,Assembly,"Do pass. To Consent Calendar",16,0,0,0,16
1453467,1077535,2021-05-13,Assembly,"AB 798 Ramos Consent Calendar Second Day Regular Session",75,0,3,0,78
1453467,1098171,2021-06-15,Senate,"Do pass, but first be re-referred to the Committee on [Appropriations] with the recommendation: To Consent Calendar",17,0,0,0,17
1453467,1107253,2021-08-30,Senate,"Consent Calendar AB798",39,0,0,1,40
1453467,1107516,2021-09-01,Assembly,"AB 798 Ramos Concurrence in Senate Amendments",77,0,0,2,79
1453472,1054665,2021-04-15,Assembly,"Do pass as amended and be re-referred to the Committee on [Local Government]",8,0,0,0,8
1453472,1065304,2021-04-28,Assembly,"Do pass and be re-referred to the Committee on [Appropriations]",8,0,0,0,8
1453472,1076933,2021-05-12,Assembly,"Do pass. To Consent Calendar",16,0,0,0,16
1453472,1081799,2021-05-20,Assembly,"AB 803 Boerner Horvath Consent Calendar Second Day Regular Session",76,0,2,0,78
1453472,1099108,2021-06-17,Senate,"Do pass, but first be re-referred to the Committee on [Governance and Finance] with the recommendation: To Consent Calendar",8,0,1,0,9
1453472,1103764,2021-07-01,Senate,"Do pass, but first be re-referred to the Committee on [Appropriations]",5,0,0,0,5
1453472,1106301,2021-08-19,Senate,"Assembly 3rd Reading AB803 Boerner Horvath By Hertzberg",37,0,0,3,40
1453472,1106459,2021-08-23,Assembly,"AB 803 Boerner Horvath Concurrence in Senate Amendments",69,0,0,10,79
1453473,1049889,2021-04-08,Assembly,"Do pass and be re-referred to the Committee on [Appropriations]",11,0,4,0,15
1453473,1059207,2021-04-21,Assembly,"Do pass",12,2,2,0,16
1453473,1066815,2021-04-29,Assembly,"AB 804 Megan Dahle Assembly Third Reading",58,11,9,0,78
1453473,1102804,2021-06-29,Senate,"Do pass as amended, but first amend, and re-refer to the Committee on [Appropriations] with the recommendation: To Consent Calendar",9,0,0,0,9
1453473,1106411,2021-08-23,Senate,"Do pass",7,0,0,0,7
1453473,1107529,2021-09-01,Senate,"Assembly 3rd Reading AB804 Megan Dahle et al. By Dahle",37,0,0,3,40
1453473,1107662,2021-09-02,Assembly,"AB 804 Megan Dahle Concurrence in Senate Amendments",64,9,0,6,79
1453474,1044949,2021-04-05,Assembly,"Do pass and be re-referred to the Committee on [Appropriations]",7,0,0,0,7
1453476,1064060,2021-04-26,Assembly,"Do pass and be re-referred to the Committee on [Appropriations] with recommendation: To Consent Calendar",15,0,0,0,15
1453476,1081811,2021-05-20,Assembly,"Do pass",16,0,0,0,16
1453476,1087013,2021-05-27,Assembly,"AB 807 Grayson Assembly Third Reading",78,0,0,0,78
1453476,1104297,2021-07-06,Senate,"Do pass, but first be re-referred to the Committee on [Appropriations] with the recommendation: To Consent Calendar",15,0,0,0,15
1453476,1107130,2021-08-30,Senate,"Consent Calendar AB807 Grayson Urgency Clause",39,0,0,1,40
1453476,1107398,2021-09-01,Assembly,"AB 807 Grayson Concurrence - Urgency Added",78,0,0,1,79
1453477,1059168,2021-04-21,Assembly,"Do pass and be re-referred to the Committee on [Health]",8,0,0,0,8
1453477,1064053,2021-04-27,Assembly,"Do pass and be re-referred to the Committee on [Appropriations]",15,0,0,0,15
1453477,1082095,2021-05-20,Assembly,"Do pass as amended",16,0,0,0,16
1453477,1092953,2021-06-01,Assembly,"AB 808 Stone Assembly Third Reading",79,0,0,0,79
1453477,1100328,2021-06-22,Senate,"Do pass as amended, but first amend, and re-refer to the Committee on [Health]",4,0,1,0,5
1453478,1049018,2021-04-08,Assembly,"Do pass and be re-referred to the Committee on [Accountability and Administrative Review] with recommendation: To Consent Calendar",11,0,0,0,11
1453478,1065289,2021-04-28,Assembly,"Do pass as amended and be re-referred to the Committee on [Appropriations]",7,0,0,0,7
1453480,1054653,2021-04-14,Assembly,"Do pass and be re-referred to the Committee on [Transportation]",8,0,0,0,8
1453480,1064018,2021-04-26,Assembly,"Do pass and be re-referred to the Committee on [Appropriations] with recommendation: To Consent Calendar",15,0,0,0,15
1453480,1090386,2021-06-02,Assembly,"AB 811 Luz Rivas Assembly Third Reading",76,1,2,0,79
1453480,1102873,2021-06-29,Senate,"Do pass",17,0,0,0,17
1453480,1108114,2021-09-08,Senate,"Assembly 3rd Reading AB811 Luz Rivas et al. By Allen",38,0,0,2,40
1453480,1108282,2021-09-09,Assembly,"AB 811 Luz Rivas Concurrence in Senate Amendments",79,0,0,1,80
1453482,1059223,2021-04-21,Assembly,"Do pass and be re-referred to the Committee on [Appropriations] with recommendation: To Consent Calendar",8,0,0,0,8
1453482,1081932,2021-05-20,Assembly,"Do pass",16,0,0,0,16
1453482,1088021,2021-05-28,Assembly,"AB 813 Mullin Assembly Third Reading",76,1,2,0,79
1453482,1104455,2021-07-06,Senate,"Do pass, but first be re-referred to the Committee on [Appropriations]",5,0,0,0,5
1453483,1049032,2021-04-08,Assembly,"Do pass and be re-referred to the Committee on [Judiciary]",10,1,0,0,11
1453483,1057740,2021-04-20,Assembly,"Do pass as amended and be re-referred to the Committee on [Appropriations]",8,2,1,0,11
1453483,1081796,2021-05-20,Assembly,"Do pass as amended",12,4,0,0,16
1453483,1092923,2021-06-01,Assembly,"AB 814 Levine Assembly Third Reading",60,13,6,0,79
1453483,1104442,2021-07-06,Senate,"Do pass as amended, but first amend, and re-refer to the Committee on [Appropriations]",9,2,0,0,11
1453483,1106093,2021-08-16,Senate,"Placed on suspense file",7,0,0,0,7
1453484,1036456,2021-03-24,Assembly,"Do pass and be re-referred to the Committee on [Appropriations]",7,0,0,0,7
1453484,1082122,2021-05-20,Assembly,"Do pass",16,0,0,0,16
1453484,1090402,2021-06-02,Assembly,"AB 815 Luz Rivas Assembly Third Reading",76,0,3,0,79
1453484,1103404,2021-06-30,Senate,"Do pass as amended, but first amend, and re-refer to the Committee on [Appropriations]",5,0,2,0,7
1453484,1106213,2021-08-16,Senate,"Placed on suspense file",7,0,0,0,7
1453484,1106962,2021-08-26,Senate,"Do pass as amended",7,0,0,0,7
1453484,1108124,2021-09-08,Senate,"Special Consent AB815",38,0,0,2,40
1453484,1108444,2021-09-09,Assembly,"AB 815 Luz Rivas Concurrence in Senate Amendments",79,0,0,1,80
1453485,1067605,2021-04-29,Assembly,"Do pass as amended and be re-referred to the Committee on [Appropriations]",5,1,2,0,8
1453485,1082035,2021-05-20,Assembly,"Do pass",12,3,1,0,16
1453485,1086931,2021-05-27,Assembly,"AB 816 Chiu Assembly Third Reading",55,15,8,0,78
1453485,1103824,2021-07-01,Senate,"Do pass, but first be re-referred to the Committee on [Human Services]",6,2,1,0,9
1453485,1104437,2021-07-06,Senate,"Do pass, but first be re-referred to the Committee on [Appropriations]",4,1,0,0,5
1453485,1107146,2021-08-30,Senate,"Assembly 3rd Reading AB816 Chiu et al. By Wiener",32,7,0,1,40
1453485,1108506,2021-09-10,Assembly,"With recommendation: That Senate amendments be concurred in",6,1,0,1,8
1453485,1108523,2021-09-10,Assembly,"AB 816 Chiu Concurrence in Senate Amendments",62,14,0,4,80
1453486,1049886,2021-04-08,Assembly,"Do pass and be re-referred to the Committee on [Appropriations] with recommendation: To Consent Calendar",15,0,0,0,15
1453486,1081701,2021-05-20,Assembly,"Do pass as amended",16,0,0,0,16
1453486,1092911,2021-06-01,Assembly,"AB 817 Wood Assembly Third Reading",78,0,1,0,79
1453486,1104763,2021-07-13,Senate,"Do pass as amended, but first amend, and re-refer to the Committee on [Appropriations]",8,0,1,0,9
1453486,1106078,2021-08-16,Senate,"Placed on suspense file",7,0,0,0,7
1453486,1106615,2021-08-26,Senate,"Do pass",7,0,0,0,7
1453486,1107869,2021-09-07,Senate,"Assembly 3rd Reading AB817 Wood et al. By Dodd",37,0,0,3,40
1453486,1107995,2021-09-08,Assembly,"AB 817 Wood Concurrence in Senate Amendments",79,0,0,1,80
1453487,1047481,2021-04-07,Assembly,"Do pass and be re-referred to the Committee on [Judiciary] with recommendation: To Consent Calendar",9,0,0,0,9
1453487,1051917,2021-04-13,Assembly,"Do pass and be re-referred to the Committee on [Appropriations] with recommendation: To Consent Calendar",11,0,0,0,11
1453487,1073350,2021-05-05,Assembly,"Do pass. To Consent Calendar",16,0,0,0,16
1453487,1077545,2021-05-13,Assembly,"AB 818 Bloom Consent Calendar Second Day Regular Session",75,0,3,0,78
1453487,1097783,2021-06-14,Senate,"Do pass, but first be re-referred to the Committee on [Judiciary] with the recommendation: To Consent Calendar",7,0,0,0,7
1453487,1103450,2021-06-29,Senate,"Do pass as amended, but first amend, and re-refer to the Committee on [Appropriations] with the recommendation: To Consent Calendar",11,0,0,0,11
1453487,1107148,2021-08-30,Senate,"Consent Calendar AB818",39,0,0,1,40
1453487,1107396,2021-09-01,Assembly,"AB 818 Bloom Concurrence in Senate Amendments",76,0,0,3,79
1453488,1036476,2021-03-24,Assembly,"Do pass as amended and be re-referred to the Committee on [Appropriations]",11,0,0,0,11
1453488,1053550,2021-04-14,Assembly,"Do pass. To Consent Calendar",16,0,0,0,16
1453488,1060827,2021-04-22,Assembly,"AB 819 Levine Consent Calendar Second Day Regular Session",77,0,2,0,79
1453488,1097795,2021-06-14,Senate,"Do pass, but first be re-referred to the Committee on [Appropriations] with the recommendation: To Consent Calendar",7,0,0,0,7
1453488,1101691,2021-06-24,Senate,"Consent Calendar AB819",39,0,1,0,40
1453488,1102510,2021-06-28,Assembly,"AB 819 Levine Concurrence in Senate Amendments",79,0,0,0,79
1453489,1123313,2022-01-10,Assembly,"Do pass as amended and be re-referred to the Committee on [Appropriations]",8,1,0,2,11
1453491,1064099,2021-04-27,Assembly,"Do pass and be re-referred to the Committee on [Appropriations]",15,0,0,0,15
1453493,1036431,2021-03-24,Assembly,"Do pass as amended and be re-referred to the Committee on [Appropriations]",7,0,0,0,7
1453493,1065317,2021-04-28,Assembly,"Do pass. To Consent Calendar",16,0,0,0,16
1453493,1074189,2021-05-06,Assembly,"AB 824 Bennett Consent Calendar Second Day Regular Session",77,0,1,0,78
1453493,1098660,2021-06-16,Senate,"Do pass as amended, but first amend, and re-refer to the Committee on [Appropriations]",5,0,2,0,7
1453493,1107488,2021-09-01,Senate,"Assembly 3rd Reading AB824 Bennett By Leyva",31,6,0,3,40
1453493,1107660,2021-09-02,Assembly,"AB 824 Bennett Concurrence in Senate Amendments",74,0,0,5,79
1453494,1048995,2021-04-08,Assembly,"Do pass and be re-referred to the Committee on [Appropriations]",11,0,0,0,11
1453494,1081657,2021-05-20,Assembly,"Do pass",16,0,0,0,16
1453494,1087017,2021-05-27,Assembly,"AB 825 Levine Assembly Third Reading",75,0,3,0,78
1453494,1100777,2021-06-22,Senate,"Do pass, but first be re-referred to the Committee on [Appropriations]",10,1,0,0,11
1453494,1104179,2021-07-05,Senate,"Placed on suspense file",6,0,1,0,7
1453494,1106622,2021-08-26,Senate,"Do pass",5,2,0,0,7
1453494,1108061,2021-09-08,Senate,"Assembly 3rd Reading AB825 Levine By Umberg",30,0,0,10,40
1453494,1108062,2021-09-08,Senate,"Assembly 3rd Reading AB825 Levine By Umberg Reconsider",37,0,0,3,40
1453494,1108063,2021-09-08,Senate,"Assembly 3rd Reading AB825 Levine By Umberg",30,0,0,10,40
1453495,1053522,2021-04-14,Assembly,"Do pass as amended and be re-referred to the Committee on [Appropriations]",9,2,0,0,11
1453495,1081414,2021-05-20,Assembly,"Do pass",13,3,0,0,16
1453495,1086923,2021-05-27,Assembly,"AB 826 Bennett Assembly Third Reading",64,9,5,0,78
1453495,1104614,2021-07-12,Senate,"Do pass as amended",4,1,0,0,5
1453495,1224278,2022-08-22,Senate,"Assembly 3rd Reading AB826 Irwin By Gonzalez",29,9,0,2,40
1453495,1225184,2022-08-31,Assembly,"With recommendation: That Senate amendments be concurred in",6,0,0,1,7
1453495,1225431,2022-08-31,Assembly,"AB 826 Irwin Concurrence in Senate Amendments",64,10,0,6,80
1453497,1026090,2021-03-10,Senate,"Do pass, but first be re-referred to the Committee on [Human Services] with the recommendation: To Consent Calendar",11,0,0,0,11
1453497,1035182,2021-03-23,Senate,"Do pass, but first be re-referred to the Committee on [Appropriations]",5,0,0,0,5
1453497,1078828,2021-05-17,Senate,"Senate 3rd Reading SB434 Bates et al",38,0,2,0,40
1453497,1095046,2021-06-08,Assembly,"Do pass and be re-referred to the Committee on [Appropriations] with recommendation: To Consent Calendar",15,0,0,0,15
1453497,1106346,2021-08-19,Assembly,"Do pass. To Consent Calendar",16,0,0,0,16
1453497,1106790,2021-08-26,Assembly,"SB 434 Bates Consent Calendar Second Day Regular Session",73,0,0,6,79
1453498,1123769,2022-01-12,Senate,"Do pass, but first be re-referred to the Committee on [Appropriations]",6,1,0,4,11
1453498,1124830,2022-01-18,Senate,"Placed on suspense file",6,0,0,1,7
1453499,1026111,2021-03-10,Senate,"Do pass and be ordered to the Consent Calendar",7,0,0,0,7
1453499,1033616,2021-03-22,Senate,"Consent Calendar SB436",37,0,3,0,40
1453499,1098168,2021-06-15,Assembly,"Do pass",12,0,0,0,12
1453499,1107729,2021-09-02,Assembly,"SB 436 Dahle Senate Third Reading By Bigelow",76,1,0,2,79
1453499,1107886,2021-09-07,Senate,"Unfinished Business SB436 Dahle Concurrence",37,0,0,3,40
1453500,1056383,2021-04-19,Senate,"Do pass as amended, but first amend, and re-refer to the Committee on [Transportation]",11,3,0,0,14
1453500,1075305,2021-05-10,Senate,"Do pass",5,2,0,0,7
1453500,1077524,2021-05-13,Senate,"Senate 3rd Reading SB437 Wieckowski",29,9,2,0,40
1453500,1098662,2021-06-16,Assembly,"Do pass and be re-referred to the Committee on [Appropriations]",11,0,4,0,15
1453500,1103447,2021-06-30,Assembly,"Do pass",10,2,4,0,16
1453500,1104654,2021-07-12,Assembly,"SB 437 Wieckowski Senate Third Reading By HOLDEN",59,12,8,0,79
1453501,1037846,2021-03-25,Senate,"Do pass, but first be re-referred to the Committee on [Appropriations]",5,0,0,0,5
1453501,1056374,2021-04-19,Senate,"Placed on suspense file",7,0,0,0,7
1453501,1082111,2021-05-20,Senate,"Do pass",7,0,0,0,7
1453501,1083841,2021-05-24,Senate,"Senate 3rd Reading SB438 Laird et al",40,0,0,0,40
1453501,1096113,2021-06-09,Assembly,"Do pass and be re-referred to the Committee on [Appropriations]",8,0,0,0,8
1453501,1097031,2021-06-09,Assembly,"Do pass and be re-referred to the Committee on [Housing and Community Development] with recommendation: To Consent Calendar",8,0,0,0,8
1453501,1100351,2021-06-22,Assembly,"Do pass and be re-referred to the Committee on [Appropriations] with recommendation: To Consent Calendar",7,0,1,0,8
1453503,1123321,2022-01-11,Senate,"Do pass, but first be re-referred to the Committee on [Appropriations] with the recommendation: To Consent Calendar",14,0,0,1,15
1453503,1127184,2022-01-24,Senate,"Consent Calendar SB440 Dodd et al",36,0,0,4,40
1453503,1219984,2022-06-27,Assembly,"Do pass and be re-referred to the Committee on [Appropriations] with recommendation: To Consent Calendar",11,0,0,0,11
1453503,1223832,2022-08-11,Assembly,"Do pass as amended",12,0,0,4,16
1453503,1224410,2022-08-23,Assembly,"SB 440 Dodd Senate Third Reading By Aguiar-Curry",77,0,0,3,80
1453503,1225061,2022-08-29,Senate,"That the Assembly amendments be concurred in",5,0,0,0,5
1453503,1225616,2022-08-30,Senate,"Unfinished Business SB440 Dodd Concurrence",40,0,0,0,40
1453504,1047453,2021-04-07,Senate,"Do pass, but first be re-referred to the Committee on [Appropriations] with the recommendation: To Consent Calendar",11,0,0,0,11
1453504,1075238,2021-05-10,Senate,"Consent Calendar SB441",37,0,3,0,40
1453504,1095027,2021-06-08,Assembly,"Do pass and be re-referred to the Committee on [Appropriations]",15,0,0,0,15
1453505,1050796,2021-04-12,Senate,"Do pass as amended, but first amend, and re-refer to the Committee on [Education]",5,0,0,0,5
1453505,1065156,2021-04-28,Senate,"Do pass",6,0,1,0,7
1453505,1074142,2021-05-06,Senate,"Senate 3rd Reading SB442 Newman",34,0,6,0,40
1453505,1098657,2021-06-16,Assembly,"Do pass and be re-referred to the Committee on [Higher Education]",7,0,0,0,7
1453505,1102860,2021-06-29,Assembly,"Do pass",12,0,0,0,12
1453505,1104638,2021-07-12,Assembly,"SB 442 Newman Senate Third Reading By O'Donnell",70,0,9,0,79
1453506,1062732,2021-04-26,Senate,"Do pass as amended, but first amend, and re-refer to the Committee on [Appropriations]",4,1,0,0,5
1453506,1077621,2021-05-13,Senate,"Senate 3rd Reading SB443 Hertzberg",31,6,3,0,40
1453506,1216597,2022-06-16,Assembly,"Be re-referred to the Committee on [Health]",8,0,0,3,11
1453507,1037872,2021-03-25,Senate,"Do pass, but first be re-referred to the Committee on [Appropriations] with the recommendation: To Consent Calendar",5,0,0,0,5
1453507,1056344,2021-04-19,Senate,"Placed on suspense file",7,0,0,0,7
1453507,1081661,2021-05-20,Senate,"Do pass as amended",7,0,0,0,7
1453507,1124802,2022-01-18,Senate,"Senate 3rd Reading SB444 Hertzberg et al",34,0,0,6,40
1453508,1064147,2021-04-27,Senate,"Do pass, but first be re-referred to the Committee on [Appropriations]",1,3,1,0,5
1453508,1064148,2021-04-27,Senate,"[First] hearing set for [04-27-2021]: Failed passage in Committee. Reconsideration granted",5,0,0,0,5
1453509,1046105,2021-04-06,Senate,"Do pass, but first be re-referred to the Committee on [Appropriations] with the recommendation: To Consent Calendar",5,0,0,0,5
1453509,1056330,2021-04-19,Senate,"Placed on suspense file",7,0,0,0,7
1453509,1081655,2021-05-20,Senate,"Do pass as amended",7,0,0,0,7
1453509,1091711,2021-06-03,Senate,"Senate 3rd Reading SB446 Glazer et al",39,0,1,0,40
1453509,1104689,2021-07-13,Assembly,"Do pass and be re-referred to the Committee on [Appropriations] with recommendation: To Consent Calendar",8,0,0,0,8
1453509,1106814,2021-08-26,Assembly,"Do pass",16,0,0,0,16
1453509,1107684,2021-09-02,Assembly,"SB 446 Glazer Senate Third Reading By Santiago",75,0,0,4,79
1453509,1107800,2021-09-03,Senate,"Unfinished Business SB446 Glazer et al. Concurrence",38,0,0,2,40
1453510,1059284,2021-04-20,Senate,"Do pass as amended",9,2,0,0,11
1453510,1066801,2021-04-29,Senate,"Senate 3rd Reading SB447 Laird",24,10,6,0,40
1453510,1100346,2021-06-22,Assembly,"Do pass and be re-referred to the Committee on [Appropriations]",7,3,1,0,11
1453510,1106922,2021-08-26,Assembly,"Do pass as amended",11,4,0,1,16
1453510,1107670,2021-09-02,Assembly,"SB 447 Laird Senate Third Reading By Stone",49,16,0,14,79
1453510,1107836,2021-09-03,Senate,"Unfinished Business SB447 Laird Concurrence",27,8,0,5,40
1453512,1059151,2021-04-21,Senate,"Do pass as amended, but first amend, and re-refer to the Committee on [Environmental Quality]",6,2,1,0,9
1453512,1066740,2021-04-29,Senate,"Do pass, but first be re-referred to the Committee on [Appropriations]",5,2,0,0,7
1453512,1078766,2021-05-17,Senate,"Placed on suspense file",7,0,0,0,7
1453513,1035222,2021-03-23,Senate,"Do pass, but first be re-referred to the Committee on [Appropriations] with the recommendation: To Consent Calendar",14,0,1,0,15
1453513,1045024,2021-04-05,Senate,"Placed on suspense file",7,0,0,0,7
1453513,1081602,2021-05-20,Senate,"Do pass",7,0,0,0,7
1453513,1124821,2022-01-18,Senate,"Senate 3rd Reading SB450 Hertzberg",34,0,0,6,40
1453513,1219417,2022-06-27,Assembly,"Do pass and be re-referred to the Committee on [Appropriations]",7,0,0,0,7
1453513,1223916,2022-08-11,Assembly,"Do pass",16,0,0,0,16
1453513,1224629,2022-08-23,Assembly,"SB 450 Hertzberg Senate Third Reading By Rodriguez",76,0,0,4,80
1453513,1225926,2022-08-30,Senate,"Special Consent SB450",38,0,0,2,40
1453514,1062760,2021-04-26,Senate,"Do pass, but first be re-referred to the Committee on [Appropriations]",7,0,0,0,7
1453514,1075247,2021-05-10,Senate,"Placed on suspense file",7,0,0,0,7
1453514,1081812,2021-05-20,Senate,"Do pass",7,0,0,0,7
1453514,1089526,2021-06-01,Senate,"Special Consent SB451 Dodd Urgency Clause",39,0,1,0,40
1453515,1035192,2021-03-23,Senate,"Do pass as amended, but first amend, and re-refer to the Committee on [Judiciary]",9,3,3,0,15
1453515,1065316,2021-04-27,Senate,"Do pass, but first be re-referred to the Committee on [Appropriations]",9,1,1,0,11
1453515,1075262,2021-05-10,Senate,"Placed on suspense file",7,0,0,0,7
1453515,1082109,2021-05-20,Senate,"Do pass as amended",5,2,0,0,7
1453515,1087603,2021-05-28,Senate,"Senate 3rd Reading SB452 Gonzalez et al",30,8,2,0,40
1453515,1100345,2021-06-22,Assembly,"Do pass and be re-referred to the Committee on [Appropriations]",8,3,0,0,11
1453516,1031910,2021-03-18,Senate,"Do pass, but first be re-referred to the Committee on [Education]",5,0,0,0,5
1453516,1047532,2021-04-07,Senate,"Do pass, but first be re-referred to the Committee on [Appropriations] with the recommendation: To Consent Calendar",7,0,0,0,7
1453516,1056333,2021-04-19,Senate,"Placed on suspense file",7,0,0,0,7
1453516,1081605,2021-05-20,Senate,"Do pass as amended",7,0,0,0,7
1453516,1089520,2021-06-01,Senate,"Special Consent SB453",39,0,1,0,40
1453516,1098648,2021-06-16,Assembly,"Do pass and be re-referred to the Committee on [Higher Education]",10,0,1,0,11
1453516,1102818,2021-06-29,Assembly,"Do pass as amended and be re-referred to the Committee on [Appropriations]",12,0,0,0,12
1453516,1104899,2021-07-14,Assembly,"Do pass as amended. To Consent Calendar",13,0,3,0,16
1453516,1106325,2021-08-19,Assembly,"SB 453 Hurtado Consent Calendar Second Day Regular Session",73,0,0,6,79
1453516,1107244,2021-08-30,Senate,"Special Consent SB453",39,0,0,1,40
1453517,1047491,2021-04-06,Senate,"Do pass and be ordered to the Consent Calendar",11,0,0,0,11
1453517,1060829,2021-04-22,Senate,"Consent Calendar SB454",38,0,2,0,40
1453517,1095041,2021-06-08,Assembly,"Do pass and be re-referred to the Committee on [Appropriations]",11,0,0,0,11
1453518,1036512,2021-03-24,Senate,"Do pass, but first be re-referred to the Committee on [Appropriations]",11,0,0,0,11
1453518,1074181,2021-05-06,Senate,"Senate 3rd Reading SB455 Leyva",36,0,4,0,40
1453519,1064090,2021-04-27,Senate,"Do pass, but first be re-referred to the Committee on [Appropriations]",9,0,0,0,9
1453519,1075362,2021-05-10,Senate,"Placed on suspense file",7,0,0,0,7
1453519,1082093,2021-05-20,Senate,"Do pass as amended",7,0,0,0,7
1453519,1089531,2021-06-01,Senate,"Special Consent SB456",39,0,1,0,40
1453519,1104438,2021-07-07,Assembly,"Do pass as amended and be re-referred to the Committee on [Appropriations]",11,0,0,0,11
1453519,1107029,2021-08-26,Assembly,"Do pass as amended",12,0,0,4,16
1453519,1107408,2021-09-01,Assembly,"SB 456 Laird Senate Third Reading By Wood",77,0,0,2,79
1453519,1107648,2021-09-02,Senate,"Unfinished Business SB456 Laird et al. Concurrence",39,0,0,1,40
1453520,1056334,2021-04-19,Senate,"Do pass, but first be re-referred to the Committee on [Appropriations]",4,1,0,0,5
1453520,1068216,2021-05-03,Senate,"Placed on suspense file",6,0,1,0,7
1453520,1082176,2021-05-20,Senate,"Do pass",7,0,0,0,7
1453520,1083869,2021-05-24,Senate,"Senate 3rd Reading SB457 Portantino et al",36,0,4,0,40
1453520,1221324,2022-06-30,Assembly,"Do pass and be re-referred to the Committee on [Appropriations]",10,1,0,0,11
1453520,1223934,2022-08-11,Assembly,"Do pass",14,0,0,2,16
1453520,1225299,2022-08-31,Senate,"Unfinished Business SB457 Portantino Concurrence",33,2,0,5,40
1453520,1225300,2022-08-31,Assembly,"SB 457 Portantino Senate Third Reading By Luz Rivas",67,2,0,11,80
1453521,1027164,2021-03-11,Senate,"Do pass and be ordered to the Consent Calendar",5,0,0,0,5
1453521,1033619,2021-03-22,Senate,"Consent Calendar SB458",37,0,3,0,40
1453522,1062794,2021-04-26,Senate,"Do pass as amended, but first amend, and re-refer to the Committee on [Appropriations]",4,0,1,0,5
1453522,1075348,2021-05-10,Senate,"Placed on suspense file",7,0,0,0,7
1453522,1082162,2021-05-20,Senate,"Do pass",5,1,1,0,7
1453522,1089595,2021-06-01,Senate,"Senate 3rd Reading SB459 Allen et al",34,3,3,0,40
1453522,1103392,2021-06-30,Assembly,"Do pass as amended and be re-referred to the Committee on [Appropriations]",6,0,1,0,7
1453522,1223698,2022-08-11,Assembly,"Do pass as amended",13,3,0,0,16
1453522,1225697,2022-08-31,Senate,"Unfinished Business SB459 Allen et al. Concurrence",33,4,0,3,40
1453522,1225698,2022-08-31,Assembly,"SB 459 Allen Senate Third Reading By Mullin",62,8,0,10,80
1453523,1035257,2021-03-23,Senate,"Do pass, but first be re-referred to the Committee on [Health] with the recommendation: To Consent Calendar",5,0,0,0,5
1453523,1053458,2021-04-14,Senate,"Do pass, but first be re-referred to the Committee on [Appropriations] with the recommendation: To Consent Calendar",11,0,0,0,11
1453523,1068271,2021-05-03,Senate,"Placed on suspense file",6,0,1,0,7
1453523,1082042,2021-05-20,Senate,"Do pass",7,0,0,0,7
1453524,1035156,2021-03-23,Senate,"Do pass, but first be re-referred to the Committee on [Appropriations]",9,1,1,0,11
1453524,1044997,2021-04-05,Senate,"Placed on suspense file",7,0,0,0,7
1453524,1081974,2021-05-20,Senate,"Do pass",5,2,0,0,7
1453524,1089569,2021-06-01,Senate,"Senate 3rd Reading SB461 Cortese",31,9,0,0,40
1453524,1104257,2021-07-06,Assembly,"Do pass",8,2,1,0,11
1453524,1104588,2021-07-12,Assembly,"SB 461 Cortese Senate Third Reading By KALRA",54,20,5,0,79
1453525,1025129,2021-03-09,Senate,"Do pass, but first be re-referred to the Committee on [Appropriations]",14,0,0,0,14
1453525,1033649,2021-03-22,Senate,"Placed on suspense file",7,0,0,0,7
1453526,1054742,2021-04-15,Senate,"Do pass and be ordered to the Consent Calendar",9,0,0,0,9
1453526,1060963,2021-04-22,Senate,"Consent Calendar SB463",38,0,2,0,40
1453526,1220855,2022-06-28,Assembly,"Do pass as amended",5,4,0,6,15
1453527,1035244,2021-03-23,Senate,"Do pass, but first be re-referred to the Committee on [Appropriations]",4,1,0,0,5
1453527,1068223,2021-05-03,Senate,"Placed on suspense file",6,0,1,0,7
1453527,1082205,2021-05-20,Senate,"Do pass as amended",5,2,0,0,7
1453527,1089479,2021-06-01,Senate,"Senate 3rd Reading SB464 Hurtado",31,9,0,0,40
1453527,1103435,2021-06-30,Assembly,"Do pass and be re-referred to the Committee on [Appropriations]",6,2,0,0,8
1453528,1059246,2021-04-21,Senate,"Do pass as amended, but first amend, and re-refer to the Committee on [Appropriations]",11,0,0,0,11
1453528,1075394,2021-05-10,Senate,"Placed on suspense file",7,0,0,0,7
1453528,1081672,2021-05-20,Senate,"Do pass as amended",7,0,0,0,7
1453528,1089572,2021-06-01,Senate,"Special Consent SB465",39,0,1,0,40
1453528,1100775,2021-06-22,Assembly,"Do pass and be re-referred to the Committee on [Appropriations]",15,0,0,0,15
1453528,1106986,2021-08-26,Assembly,"Do pass as amended",12,0,0,4,16
1453528,1107736,2021-09-02,Assembly,"SB 465 Eggman Senate Third Reading By Arambula",76,0,0,3,79
1453528,1107795,2021-09-03,Senate,"Unfinished Business SB465 Eggman et al. Concurrence",37,0,0,3,40
1453529,1074151,2021-05-06,Senate,"Do pass as amended",5,0,0,0,5
1453529,1078821,2021-05-17,Senate,"Senate 3rd Reading SB466 Wieckowski",35,1,4,0,40
1453530,1051940,2021-04-13,Senate,"Do pass as amended, but first amend, and re-refer to the Committee on [Environmental Quality]",4,3,2,0,9
1453530,1051941,2021-04-13,Senate,"[First] hearing set for [04-13-2021]: Failed passage in Committee. Reconsideration granted",9,0,0,0,9
1453530,1123325,2022-01-11,Senate,"Do pass, but first be re-referred to the Committee on [Appropriations] with the recommendation: To Consent Calendar",5,0,0,0,5
1453530,1124827,2022-01-18,Senate,"Placed on suspense file",6,0,0,1,7
1453530,1126311,2022-01-20,Senate,"Do pass as amended",7,0,0,0,7
1453530,1128997,2022-01-26,Senate,"Senate 3rd Reading SB467 Wiener et al",30,3,0,7,40
1453530,1211900,2022-06-01,Assembly,"Do pass and be re-referred to the Committee on [Appropriations]",6,0,0,1,7
1453530,1223553,2022-08-11,Assembly,"Do pass as amended",12,0,0,4,16
1453530,1225048,2022-08-29,Assembly,"SB 467 Wiener Senate Third Reading By Mia Bonta",67,1,0,12,80
1453530,1225486,2022-08-30,Senate,"Unfinished Business SB467 Wiener et al. Concurrence",39,0,0,1,40
1453531,1057698,2021-04-20,Senate,"Do pass, but first be re-referred to the Committee on [Appropriations] with the recommendation: To Consent Calendar",15,0,0,0,15
1453531,1075381,2021-05-10,Senate,"Consent Calendar SB468",37,0,3,0,40
1453531,1210210,2022-05-27,Assembly,"Be re-referred to the Committee on [Emergency Management]",7,0,0,4,11
1453531,1219360,2022-06-27,Assembly,"Do pass and be re-referred to the Committee on [Appropriations]",7,0,0,0,7
1453531,1222985,2022-08-03,Assembly,"Do pass. To Consent Calendar",15,0,0,1,16
1453531,1224026,2022-08-11,Assembly,"SB 468 Dodd Consent Calendar Second Day Regular Session",76,0,0,4,80
1453531,1224100,2022-08-16,Senate,"Unfinished Business SB468 Dodd Concurrence",36,0,0,4,40
1453532,1023841,2021-03-08,Senate,"Senate 3rd Reading SR11 Leyva et al",35,0,4,0,39
1453533,1029570,2021-03-16,Senate,"Be adopted. Ordered to third reading",11,0,0,0,11
1453533,1031913,2021-03-18,Senate,"Senate 3rd Reading SR12 Min et al",36,0,4,0,40
1454830,1047490,2021-04-07,Assembly,"Do pass and be re-referred to the Committee on [Judiciary]",7,0,1,0,8
1454830,1051887,2021-04-13,Assembly,"Do pass and be re-referred to the Committee on [Appropriations]",9,0,2,0,11
1454830,1081688,2021-05-20,Assembly,"Do pass",14,0,2,0,16
1454830,1087056,2021-05-27,Assembly,"AB 829 Levine Assembly Third Reading",68,0,10,0,78
1454830,1100282,2021-06-22,Senate,"Do pass, but first be re-referred to the Committee on [Judiciary]",5,0,0,0,5
1454830,1104921,2021-07-13,Senate,"Do pass, but first be re-referred to the Committee on [Appropriations] with the recommendation: To Consent Calendar",11,0,0,0,11
1454830,1106098,2021-08-16,Senate,"Placed on suspense file",7,0,0,0,7
1454830,1106780,2021-08-26,Senate,"Do pass",6,0,0,1,7
1454830,1108153,2021-09-08,Senate,"Assembly 3rd Reading AB829 Levine et al. By Hurtado",36,0,0,4,40
1454830,1108382,2021-09-09,Assembly,"AB 829 Levine Concurrence in Senate Amendments",73,0,0,7,80
1454831,1065213,2021-04-27,Assembly,"Do pass and be re-referred to the Committee on [Appropriations] with recommendation: To Consent Calendar",19,0,0,0,19
1454831,1073444,2021-05-05,Assembly,"Do pass. To Consent Calendar",16,0,0,0,16
1454831,1092832,2021-06-01,Assembly,"AB 830 Flora Assembly Third Reading",79,0,0,0,79
1454831,1104620,2021-07-12,Senate,"Do pass, but first be re-referred to the Committee on [Appropriations] with the recommendation: To Consent Calendar",14,0,0,0,14
1454831,1108198,2021-09-08,Senate,"Assembly 3rd Reading AB830 Flora By Roth",38,0,0,2,40
1454831,1108519,2021-09-10,Assembly,"With recommendation: That Senate amendments be concurred in",18,0,0,1,19
1454831,1108584,2021-09-10,Assembly,"AB 830 Flora Concurrence in Senate Amendments",79,0,0,1,80
1454832,1035179,2021-03-23,Assembly,"Do pass and be re-referred to the Committee on [Appropriations] with recommendation: To Consent Calendar",15,0,0,0,15
1454832,1053456,2021-04-14,Assembly,"Do pass. To Consent Calendar",16,0,0,0,16
1454832,1060866,2021-04-22,Assembly,"AB 831 HEALTH Consent Calendar Second Day Regular Session",77,0,2,0,79
1454832,1097038,2021-06-10,Senate,"Do pass, but first be re-referred to the Committee on [Appropriations] with the recommendation: To Consent Calendar",10,0,1,0,11
1454832,1104615,2021-07-12,Senate,"Assembly 3rd Reading AB831 HEALTH (Wood) By Dahle",39,0,1,0,40
1454832,1106089,2021-08-16,Assembly,"AB 831 HEALTH Concurrence in Senate Amendments By WOOD",75,0,0,4,79
1454833,1054704,2021-04-15,Assembly,"Do pass and be re-referred to the Committee on [Local Government]",8,0,0,0,8
1454833,1073353,2021-05-05,Assembly,"Do pass as amended",8,0,0,0,8
1454833,1102496,2021-06-28,Assembly,"Do pass with recommendation: That the Floor amendments be adopted",8,3,0,0,11
1454833,1102497,2021-06-28,Senate,"Assembly 2nd Reading AB832 Chiu et al. By Caballero Urgency Clause",34,0,6,0,40
1454833,1102498,2021-06-28,Assembly,"AB 832 CHIU Assembly Third Reading",65,9,5,0,79
1454836,1052001,2021-04-13,Assembly,"Do pass and be re-referred to the Committee on [Appropriations]",13,0,2,0,15
1454836,1082063,2021-05-20,Assembly,"Do pass as amended",13,0,3,0,16
1454836,1092942,2021-06-01,Assembly,"AB 835 Nazarian Assembly Third Reading",59,2,18,0,79
1454836,1104446,2021-07-07,Senate,"Do pass as amended, but first amend, and re-refer to the Committee on [Appropriations]",8,1,2,0,11
1454836,1106251,2021-08-16,Senate,"Placed on suspense file",7,0,0,0,7
1454838,1046159,2021-04-05,Assembly,"Do pass and be re-referred to the Committee on [Appropriations]",9,0,2,0,11
1454839,1054670,2021-04-15,Assembly,"Do pass and be re-referred to the Committee on [Appropriations]",6,2,0,0,8
1454839,1065227,2021-04-28,Assembly,"Do pass",12,4,0,0,16
1454839,1075273,2021-05-10,Assembly,"AB 838 Friedman Assembly Third Reading",45,18,15,0,78
1454839,1103783,2021-07-01,Senate,"Do pass, but first be re-referred to the Committee on [Rules]",6,1,2,0,9
1454839,1104572,2021-07-08,Senate,"Do pass as amended, but first amend, and re-refer to the Committee on [Appropriations]",4,0,1,0,5
1454839,1106057,2021-08-16,Senate,"Placed on suspense file",7,0,0,0,7
1454839,1106817,2021-08-26,Senate,"Do pass",5,2,0,0,7
1454839,1107425,2021-09-01,Senate,"Assembly 3rd Reading AB838 Friedman et al. By Durazo",26,10,0,4,40
1454839,1107639,2021-09-02,Assembly,"AB 838 Friedman Concurrence in Senate Amendments",51,20,0,8,79
1454840,1048885,2021-04-07,Assembly,"Do pass and be re-referred to the Committee on [Appropriations]",7,0,0,0,7
1454842,1047433,2021-04-07,Assembly,"Do pass and be re-referred to the Committee on [Judiciary] with recommendation: To Consent Calendar",8,0,0,0,8
1454842,1051880,2021-04-13,Assembly,"Do pass. To Consent Calendar",11,0,0,0,11
1454842,1056496,2021-04-19,Assembly,"AB 841 Cunningham Consent Calendar Second Day Regular Session",78,0,1,0,79
1454842,1095021,2021-06-08,Senate,"Do pass as amended, and be ordered to the Consent Calendar",11,0,0,0,11
1454842,1099164,2021-06-17,Senate,"Consent Calendar AB841",37,0,3,0,40
1454842,1102450,2021-06-28,Assembly,"AB 841 Cunningham Concurrence in Senate Amendments",79,0,0,0,79
1454844,1047428,2021-04-07,Assembly,"Do pass as amended and be re-referred to the Committee on [Appropriations]",15,0,0,0,15
1454844,1081903,2021-05-20,Assembly,"Do pass as amended",12,0,4,0,16
1454844,1092916,2021-06-01,Assembly,"AB 843 Aguiar-Curry Assembly Third Reading",78,0,1,0,79
1454844,1104645,2021-07-12,Senate,"Do pass, but first be re-referred to the Committee on [Appropriations]",13,0,1,0,14
1454844,1106050,2021-08-16,Senate,"Placed on suspense file",7,0,0,0,7
1454844,1106608,2021-08-26,Senate,"Do pass",7,0,0,0,7
1454844,1107820,2021-09-03,Senate,"Special Consent AB843",37,0,0,3,40
1454844,1107933,2021-09-07,Assembly,"AB 843 Aguiar-Curry Concurrence in Senate Amendments",71,0,0,9,80
1454845,1065181,2021-04-27,Assembly,"Do pass as amended. To Consent Calendar",6,0,1,0,7
1454845,1075279,2021-05-10,Assembly,"AB 844 Grayson Consent Calendar Second Day",74,0,4,0,78
1454845,1099763,2021-06-21,Senate,"Do pass, but first be re-referred to the Committee on [Governance and Finance]",11,0,3,0,14
1454845,1104527,2021-07-08,Senate,"Do pass and be ordered to the Consent Calendar",5,0,0,0,5
1454845,1107863,2021-09-07,Senate,"Assembly 3rd Reading AB844 Grayson et al. By Dodd",36,0,0,4,40
1454845,1108111,2021-09-08,Assembly,"AB 844 Grayson Concurrence in Senate Amendments",79,0,0,1,80
1454846,1054685,2021-04-15,Assembly,"Do pass and be re-referred to the Committee on [Appropriations]",6,1,0,0,7
1454846,1065122,2021-04-28,Assembly,"Do pass",14,0,2,0,16
1454846,1074113,2021-05-06,Assembly,"AB 845 Rodriguez Assembly Third Reading",74,0,4,0,78
1454846,1093667,2021-06-07,Senate,"Do pass, but first be re-referred to the Committee on [Appropriations]",5,0,0,0,5
1454846,1104625,2021-07-12,Senate,"Assembly 3rd Reading AB845 Rodriguez By Cortese",39,0,1,0,40
1454847,1048976,2021-04-08,Assembly,"Do pass and be re-referred to the Committee on [Appropriations]",9,3,0,0,12
1454847,1059197,2021-04-21,Assembly,"Do pass",10,4,2,0,16
1454847,1087012,2021-05-27,Assembly,"AB 846 Low Assembly Third Reading",57,16,5,0,78
1454847,1098647,2021-06-16,Senate,"Do pass, but first be re-referred to the Committee on [Appropriations]",5,2,0,0,7
1454847,1107241,2021-08-30,Senate,"Assembly 3rd Reading AB846 Low By Cortese",30,9,0,1,40
1454848,1051905,2021-04-13,Assembly,"Do pass and be re-referred to the Committee on [Appropriations]",17,0,2,0,19
1454848,1081713,2021-05-20,Assembly,"Do pass as amended",16,0,0,0,16
1454848,1126359,2022-01-20,Assembly,"AB 847 Quirk Assembly Third Reading",63,0,0,13,76
1454848,1214379,2022-06-06,Senate,"Do pass, but first be re-referred to the Committee on [Energy, Utilities and Communications]",11,0,0,3,14
1454848,1225282,2022-08-29,Senate,"Assembly 3rd Reading AB847 Quirk By Hueso",40,0,0,0,40
1454848,1225283,2022-08-30,Assembly,"AB 847 Quirk Concurrence in Senate Amendments",78,0,0,2,80
1454848,1229723,2022-08-30,Senate,"Assembly 3rd Reading AB847 Quirk By Hueso",40,0,0,0,40
1454849,1035263,2021-03-23,Assembly,"Do pass and be re-referred to the Committee on [Appropriations] with recommendation: To Consent Calendar",15,0,0,0,15
1454850,1051954,2021-04-13,Assembly,"Do pass",8,3,0,0,11
1454850,1062743,2021-04-26,Assembly,"AB 849 Reyes Assembly Third Reading",51,14,13,0,78
1454850,1100838,2021-06-22,Senate,"Do pass as amended",9,2,0,0,11
1454850,1107590,2021-09-02,Senate,"Assembly 3rd Reading AB849 Reyes et al. By Laird",29,7,0,4,40
1454850,1107934,2021-09-07,Assembly,"AB 849 Reyes Concurrence in Senate Amendments",54,6,0,20,80
1454851,1049870,2021-04-08,Assembly,"Do pass and be re-referred to the Committee on [Local Government]",15,0,0,0,15
1454851,1065152,2021-04-28,Assembly,"Do pass and be re-referred to the Committee on [Appropriations] with recommendation: To Consent Calendar",8,0,0,0,8
1454851,1080435,2021-05-19,Assembly,"Do pass. To Consent Calendar",15,0,1,0,16
1454851,1087010,2021-05-27,Assembly,"AB 850 Gallagher Consent Calendar Second Day Regular Session",75,0,3,0,78
1454851,1103781,2021-07-01,Senate,"Do pass, but first be re-referred to the Committee on [Appropriations]",5,0,0,0,5
1454851,1107141,2021-08-30,Senate,"Assembly 3rd Reading AB850 Gallagher et al. By Archuleta",39,0,0,1,40
1454851,1107421,2021-09-01,Assembly,"AB 850 Gallagher Concurrence in Senate Amendments",78,0,0,1,79
1454853,1057653,2021-04-20,Assembly,"Do pass as amended and be re-referred to the Committee on [Appropriations]",17,0,2,0,19
1454853,1073420,2021-05-05,Assembly,"Do pass",16,0,0,0,16
1454853,1083867,2021-05-24,Assembly,"AB 852 Wood Assembly Third Reading",75,0,3,0,78
1454853,1219490,2022-06-27,Senate,"Do pass, but first be re-referred to the Committee on [Judiciary]",11,0,0,3,14
1454853,1223162,2022-08-08,Senate,"Placed on suspense file",7,0,0,0,7
1454853,1223498,2022-08-11,Senate,"Do pass",5,0,0,2,7
1454853,1225158,2022-08-30,Assembly,"With recommendation: That Senate amendments be concurred in",15,0,0,3,18
1454853,1225676,2022-08-29,Senate,"Assembly 3rd Reading AB852 Wood By Dodd",32,2,0,6,40
1454853,1225677,2022-08-31,Assembly,"AB 852 Wood Concurrence in Senate Amendments",75,0,0,5,80
1454855,1123774,2022-01-12,Assembly,"Do pass as amended and be re-referred to the Committee on [Appropriations]",6,2,0,0,8
1454855,1126317,2022-01-20,Assembly,"Do pass",12,3,0,1,16
1454856,1035252,2021-03-23,Assembly,"Do pass and be re-referred to the Committee on [Appropriations]",10,0,1,0,11
1454856,1053472,2021-04-14,Assembly,"Do pass",16,0,0,0,16
1454856,1062788,2021-04-26,Assembly,"AB 855 Ramos Assembly Third Reading",75,0,3,0,78
1454856,1095054,2021-06-08,Senate,"Do pass, but first be re-referred to the Committee on [Appropriations]",10,0,1,0,11
1454856,1106217,2021-08-16,Senate,"Assembly 3rd Reading AB855 Ramos et al. By Hertzberg",32,0,0,8,40
1454856,1106855,2021-08-26,Assembly,"AB 855 Ramos Concurrence in Senate Amendments",73,0,0,6,79
1454857,1036451,2021-03-24,Assembly,"Do pass as amended, and be re-referred to the Committee on [Appropriations] with recommendation: To Consent Calendar",7,0,0,0,7
1454857,1053433,2021-04-14,Assembly,"Do pass. To Consent Calendar",16,0,0,0,16
1454857,1060883,2021-04-22,Assembly,"AB 856 Maienschein Consent Calendar Second Day Regular Session",77,0,2,0,79
1454857,1096073,2021-06-09,Senate,"Do pass, but first be re-referred to the Committee on [Appropriations]",7,0,0,0,7
1454857,1104660,2021-07-12,Senate,"Assembly 3rd Reading AB856 Maienschein By Portantino Urgency Clause",39,0,1,0,40
1454857,1105086,2021-07-15,Assembly,"AB 856 Maienschein Concurrence - Urgency Added By REYES",69,0,10,0,79
1454858,1048914,2021-04-08,Assembly,"Do pass and be re-referred to the Committee on [Appropriations]",5,2,0,0,7
1454858,1059315,2021-04-21,Assembly,"Do pass",9,5,2,0,16
1454858,1074157,2021-05-06,Assembly,"AB 857 Kalra Assembly Third Reading",43,21,14,0,78
1454858,1093657,2021-06-07,Senate,"Do pass, but first be re-referred to the Committee on [Judiciary]",4,1,0,0,5
1454858,1104952,2021-07-13,Senate,"Do pass, but first be re-referred to the Committee on [Appropriations]",8,2,1,0,11
1454858,1225899,2022-08-29,Senate,"Assembly 3rd Reading AB857 Kalra et al. By Durazo",27,9,0,4,40
1454858,1225900,2022-08-30,Assembly,"AB 857 Kalra Concurrence in Senate Amendments",56,14,0,10,80
1454859,1048958,2021-04-08,Assembly,"Do pass and be re-referred to the Committee on [Health]",6,1,0,0,7
1454859,1064066,2021-04-27,Assembly,"Do pass as amended, and be re-referred to the Committee on [Appropriations] with recommendation: To Consent Calendar",12,1,2,0,15
1454859,1065084,2021-04-27,Assembly,"Do pass as amended and be re-referred to the Committee on [Appropriations]",12,1,2,0,15
1454859,1081841,2021-05-20,Assembly,"Do pass as amended",12,3,1,0,16
1454859,1090399,2021-06-02,Assembly,"AB 858 Jones-Sawyer Assembly Third Reading",52,15,12,0,79
1454859,1104168,2021-07-05,Senate,"Do pass, but first be re-referred to the Committee on [Health]",4,1,0,0,5
1454859,1104922,2021-07-14,Senate,"Do pass as amended, but first amend, and re-refer to the Committee on [Appropriations]",8,1,2,0,11
1454859,1106202,2021-08-16,Senate,"Placed on suspense file",7,0,0,0,7
1454859,1106785,2021-08-26,Senate,"Do pass",5,2,0,0,7
1454859,1225908,2022-08-29,Senate,"Assembly 3rd Reading AB858 Jones-Sawyer et al. By Durazo",29,9,0,2,40
1454859,1225909,2022-08-30,Assembly,"AB 858 Jones-Sawyer Concurrence in Senate Amendments",58,16,0,6,80
1454860,1048946,2021-04-08,Assembly,"Do pass and be re-referred to the Committee on [Appropriations]",8,0,3,0,11
1454862,1068278,2021-05-03,Assembly,"Do pass as amended",6,2,0,0,8
1454862,1075351,2021-05-10,Assembly,"AB 861 Bennett Assembly Third Reading",41,20,17,0,78
1454862,1098158,2021-06-15,Senate,"Do pass as amended",8,1,2,0,11
1454862,1108438,2021-09-09,Senate,"Assembly 3rd Reading AB861 Bennett By Umberg",29,8,0,3,40
1454862,1108439,2021-09-09,Assembly,"AB 861 BENNETT Concurrence in Senate Amendments",47,21,0,12,80
1454864,1051971,2021-04-12,Assembly,"Do pass and be re-referred to the Committee on [Appropriations]",15,0,0,0,15
1454866,1047427,2021-04-07,Assembly,"Do pass and be re-referred to the Committee on [Education] with recommendation: To Consent Calendar",8,0,0,0,8
1454866,1065089,2021-04-28,Assembly,"Do pass and be re-referred to the Committee on [Appropriations]",7,0,0,0,7
1454866,1081470,2021-05-20,Assembly,"Do pass",16,0,0,0,16
1454866,1087045,2021-05-27,Assembly,"AB 865 Quirk-Silva Assembly Third Reading",78,0,0,0,78
1454866,1100785,2021-06-23,Senate,"Do pass, but first be re-referred to the Committee on [Human Services] with the recommendation: To Consent Calendar",7,0,0,0,7
1454866,1104391,2021-07-06,Senate,"Do pass as amended, but first amend, and re-refer to the Committee on [Appropriations] with the recommendation: To Consent Calendar",5,0,0,0,5
1454866,1106115,2021-08-16,Senate,"Placed on suspense file",7,0,0,0,7
1454866,1106708,2021-08-26,Senate,"Do pass as amended",7,0,0,0,7
1454866,1108049,2021-09-08,Senate,"Special Consent AB865",38,0,0,2,40
1454866,1108387,2021-09-09,Assembly,"AB 865 Quirk-Silva Concurrence in Senate Amendments",79,0,0,1,80
1454867,1054674,2021-04-15,Assembly,"Do pass and be re-referred to the Committee on [Appropriations]",11,0,0,0,11
1454869,1059195,2021-04-21,Assembly,"Do pass and be re-referred to the Committee on [Business and Professions]",7,0,1,0,8
1454869,1063995,2021-04-27,Assembly,"Do pass and be re-referred to the Committee on [Appropriations] with recommendation: To Consent Calendar",19,0,0,0,19
1454869,1081544,2021-05-20,Assembly,"Do pass as amended",15,0,1,0,16
1454869,1092955,2021-06-01,Assembly,"AB 868 Eduardo Garcia Assembly Third Reading",75,0,4,0,79
1454870,1054746,2021-04-15,Assembly,"Do pass and be re-referred to the Committee on [Appropriations]",12,0,0,0,12
1454870,1065143,2021-04-28,Assembly,"Do pass. To Consent Calendar",16,0,0,0,16
1454870,1074158,2021-05-06,Assembly,"AB 869 Bloom Consent Calendar Second Day Regular Session",77,0,1,0,78
1454870,1095010,2021-06-08,Senate,"Do pass, but first be re-referred to the Committee on [Appropriations] with the recommendation: To Consent Calendar",14,0,1,0,15
1454870,1101591,2021-06-24,Senate,"Consent Calendar AB869",39,0,1,0,40
1454873,1066694,2021-04-29,Assembly,"Do pass and be re-referred to the Committee on [Appropriations]",13,0,0,0,13
1454873,1081965,2021-05-20,Assembly,"Do pass",16,0,0,0,16
1454873,1086971,2021-05-27,Assembly,"AB 872 Wood Assembly Third Reading",76,0,2,0,78
1454873,1100297,2021-06-21,Senate,"Do pass, but first be re-referred to the Committee on [Appropriations]",5,0,0,0,5
1454873,1104204,2021-07-05,Senate,"Placed on suspense file",6,0,1,0,7
1454873,1106984,2021-08-26,Senate,"Do pass",7,0,0,0,7
1454873,1108017,2021-09-08,Senate,"Assembly 3rd Reading AB872 Wood By Dodd",38,0,0,2,40
1454873,1108269,2021-09-09,Assembly,"AB 872 Wood Concurrence in Senate Amendments",79,0,0,1,80
1454874,1059211,2021-04-21,Assembly,"Do pass and be re-referred to the Committee on [Appropriations] with recommendation: To Consent Calendar",8,0,0,0,8
1454874,1076934,2021-05-12,Assembly,"Do pass. To Consent Calendar",16,0,0,0,16
1454874,1081486,2021-05-20,Assembly,"AB 873 Ramos Consent Calendar Second Day Regular Session",76,0,2,0,78
1454874,1100319,2021-06-22,Senate,"Do pass, but first be re-referred to the Committee on [Judiciary] with the recommendation: To Consent Calendar",5,0,0,0,5
1454874,1104465,2021-07-06,Senate,"Do pass, but first be re-referred to the Committee on [Appropriations] with the recommendation: To Consent Calendar",11,0,0,0,11
1454874,1106148,2021-08-16,Senate,"Placed on suspense file",7,0,0,0,7
1454874,1106813,2021-08-26,Senate,"Do pass",7,0,0,0,7
1454874,1108651,2021-09-10,Senate,"Assembly 3rd Reading AB873 Ramos By Hurtado",37,0,0,3,40
1454874,1108652,2021-09-10,Assembly,"AB 873 Ramos Concurrence in Senate Amendments",78,0,0,2,80
1454875,1066730,2021-04-29,Assembly,"Do pass and be re-referred to the Committee on [Appropriations]",12,0,0,0,12
1454876,1064166,2021-04-27,Assembly,"Do pass and be re-referred to the Committee on [Appropriations]",14,0,1,0,15
1454877,1053419,2021-04-13,Assembly,"Do pass and be re-referred to the Committee on [Appropriations]",6,2,0,0,8
1454879,1049874,2021-04-08,Assembly,"Do pass and be re-referred to the Committee on [Appropriations] with recommendation: To Consent Calendar",15,0,0,0,15
1454880,1046118,2021-04-05,Assembly,"Do pass as amended and be re-referred to the Committee on [Appropriations]",10,0,1,0,11
1454881,1054712,2021-04-15,Assembly,"Do pass and be re-referred to the Committee on [Appropriations]",8,0,0,0,8
1454882,1036455,2021-03-24,Assembly,"Do pass and be re-referred to the Committee on [Appropriations]",11,0,0,0,11
1454882,1076926,2021-05-12,Assembly,"Do pass. To Consent Calendar",16,0,0,0,16
1454882,1081900,2021-05-20,Assembly,"AB 881 Lorena Gonzalez Consent Calendar Second Day Regular Session",76,0,2,0,78
1454882,1102475,2021-06-28,Senate,"Do pass, but first be re-referred to the Committee on [Appropriations] with the recommendation: To Consent Calendar",6,0,1,0,7
1454882,1106442,2021-08-23,Senate,"Assembly 3rd Reading AB881 Lorena Gonzalez et a By Hueso",37,0,0,3,40
1454882,1107493,2021-09-01,Assembly,"AB 881 Lorena Gonzalez Concurrence in Senate Amendments",78,0,0,1,79
1454883,1046203,2021-04-06,Assembly,"Do pass as amended and be re-referred to the Committee on [Appropriations]",14,0,1,0,15
1454884,1046221,2021-04-06,Assembly,"Do pass as amended and be re-referred to the Committee on [Education]",15,0,0,0,15
1454884,1065175,2021-04-28,Assembly,"Do pass and be re-referred to the Committee on [Appropriations] with recommendation: To Consent Calendar",7,0,0,0,7
1454885,1053432,2021-04-14,Assembly,"Do pass and be re-referred to the Committee on [Governmental Organization]",7,0,0,0,7
1454885,1060953,2021-04-22,Assembly,"Do pass and be re-referred to the Committee on [Appropriations]",20,0,2,0,22
1454887,1065170,2021-04-27,Assembly,"Do pass as amended, and be re-referred to the Committee on [Appropriations] with recommendation: To Consent Calendar",8,0,0,0,8
1454888,1035176,2021-03-23,Assembly,"Do pass and be re-referred to the Committee on [Appropriations]",11,0,0,0,11
1454888,1081851,2021-05-20,Assembly,"Do pass",16,0,0,0,16
1454888,1087038,2021-05-27,Assembly,"AB 887 Levine Assembly Third Reading",78,0,0,0,78
1454888,1100770,2021-06-22,Senate,"Do pass, but first be re-referred to the Committee on [Appropriations] with the recommendation: To Consent Calendar",11,0,0,0,11
1454888,1104170,2021-07-05,Senate,"Placed on suspense file",6,0,1,0,7
1454888,1106566,2021-08-26,Senate,"Do pass as amended",7,0,0,0,7
1454888,1108109,2021-09-08,Senate,"Special Consent AB887",38,0,0,2,40
1454888,1108353,2021-09-09,Assembly,"AB 887 Levine Concurrence in Senate Amendments",79,0,0,1,80
1454889,1066679,2021-04-29,Assembly,"Do pass and be re-referred to the Committee on [Appropriations]",10,0,1,0,11
1454889,1082202,2021-05-20,Assembly,"Do pass as amended",12,0,4,0,16
1454889,1092839,2021-06-01,Assembly,"AB 888 Levine Assembly Third Reading",77,0,2,0,79
1454889,1103806,2021-07-01,Senate,"Do pass, but first be re-referred to the Committee on [Appropriations] with the recommendation: To Consent Calendar",5,0,0,0,5
1454889,1105134,2021-07-15,Senate,"Placed on suspense file",7,0,0,0,7
1454889,1106604,2021-08-26,Senate,"Do pass as amended",7,0,0,0,7
1454889,1108094,2021-09-08,Senate,"Special Consent AB888",38,0,0,2,40
1454889,1108445,2021-09-09,Assembly,"AB 888 Levine Concurrence in Senate Amendments",77,0,0,3,80
1454890,1059245,2021-04-21,Assembly,"Do pass and be re-referred to the Committee on [Appropriations]",6,2,0,0,8
1454890,1073354,2021-05-05,Assembly,"Do pass",12,4,0,0,16
1454890,1083824,2021-05-24,Assembly,"AB 889 Gipson Assembly Third Reading",47,18,13,0,78
1454890,1104894,2021-07-13,Senate,"Do pass, but first be re-referred to the Committee on [Appropriations]",3,2,6,0,11
1454890,1104895,2021-07-13,Senate,"[First] hearing set for [07-14-2021]: Failed passage in Committee. Reconsideration granted",11,0,0,0,11
1454891,1066759,2021-04-29,Assembly,"Do pass and be re-referred to the Committee on [Appropriations]",5,1,1,0,7
1454891,1081699,2021-05-20,Assembly,"Do pass as amended",13,3,0,0,16
1454891,1092831,2021-06-01,Assembly,"AB 890 Cervantes Assembly Third Reading",65,10,4,0,79
1454891,1104182,2021-07-05,Senate,"Do pass, but first be re-referred to the Committee on [Appropriations]",5,0,0,0,5
1454891,1105146,2021-07-15,Senate,"Do pass",5,2,0,0,7
1454891,1106556,2021-08-26,Senate,"Assembly 3rd Reading AB890 Cervantes et al. By Bradford",27,8,0,5,40
1454892,1035160,2021-03-23,Assembly,"Do pass. To Consent Calendar",11,0,0,0,11
1454892,1045011,2021-04-05,Assembly,"AB 891 Cunningham Consent Calendar Second Day Regular Session",74,0,4,0,78
1454892,1095028,2021-06-08,Senate,"Do pass and be ordered to the Consent Calendar",11,0,0,0,11
1454892,1099157,2021-06-17,Senate,"Consent Calendar AB891",37,0,3,0,40
1454893,1053439,2021-04-13,Assembly,"Do pass and be re-referred to the Committee on [Appropriations]",3,4,1,0,8
1454896,1123336,2022-01-11,Assembly,"Do pass as amended, and be re-referred to the Committee on [Appropriations] with recommendation: To Consent Calendar",15,0,0,0,15
1454896,1126299,2022-01-20,Assembly,"Do pass. To Consent Calendar",15,0,0,1,16
1454896,1129899,2022-01-27,Assembly,"AB 895 Holden Consent Calendar Second Day Regular Session",61,0,0,15,76
1454896,1211901,2022-06-01,Senate,"Do pass as amended, but first amend, and re-refer to the Committee on [Rules] with the recommendation: To Consent Calendar",9,0,0,2,11
1454896,1219929,2022-06-27,Senate,"Do pass as amended, but first amend, and re-refer to the Committee on [Appropriations]",5,0,0,0,5
1454896,1224756,2022-08-24,Senate,"Assembly 3rd Reading AB895 Holden By Pan",40,0,0,0,40
1454896,1224944,2022-08-25,Assembly,"AB 895 Holden Concurrence in Senate Amendments",75,0,0,5,80
1454897,1036423,2021-03-24,Assembly,"Do pass and be re-referred to the Committee on [Appropriations]",8,0,3,0,11
1454897,1081531,2021-05-20,Assembly,"Do pass",12,4,0,0,16
1454897,1092934,2021-06-01,Assembly,"AB 896 Bennett Assembly Third Reading",65,12,2,0,79
1454897,1104570,2021-07-08,Senate,"Do pass as amended, but first amend, and re-refer to the Committee on [Appropriations]",7,0,2,0,9
1454897,1106058,2021-08-16,Senate,"Placed on suspense file",7,0,0,0,7
1454897,1106646,2021-08-26,Senate,"Do pass as amended",5,2,0,0,7
1454897,1108149,2021-09-08,Senate,"Assembly 3rd Reading AB896 Bennett et al. By Lim贸n",30,7,0,3,40
1454897,1108454,2021-09-09,Assembly,"AB 896 Bennett Concurrence in Senate Amendments",67,8,0,5,80
1454898,1053538,2021-04-14,Assembly,"Do pass as amended and be re-referred to the Committee on [Appropriations]",8,1,2,0,11
1454898,1081478,2021-05-20,Assembly,"Do pass",12,3,1,0,16
1454898,1090414,2021-06-02,Assembly,"AB 897 Mullin Assembly Third Reading",64,6,9,0,79
1454898,1102513,2021-06-28,Senate,"Do pass, but first be re-referred to the Committee on [Natural Resources and Water]",4,1,2,0,7
1454898,1104709,2021-07-13,Senate,"Do pass as amended, but first amend, and re-refer to the Committee on [Appropriations]",7,1,1,0,9
1454898,1106088,2021-08-16,Senate,"Placed on suspense file",7,0,0,0,7
1454899,1047450,2021-04-06,Assembly,"Do pass and be re-referred to the Committee on [Appropriations] with recommendation: To Consent Calendar",8,0,0,0,8
1454899,1081588,2021-05-20,Assembly,"Do pass",16,0,0,0,16
1454899,1086934,2021-05-27,Assembly,"AB 898 Lee Assembly Third Reading",76,0,2,0,78
1454899,1104291,2021-07-06,Senate,"Do pass, but first be re-referred to the Committee on [Appropriations] with the recommendation: To Consent Calendar",5,0,0,0,5
1454899,1106203,2021-08-16,Senate,"Placed on suspense file",7,0,0,0,7
1454899,1106583,2021-08-26,Senate,"Do pass",7,0,0,0,7
1454899,1108126,2021-09-08,Senate,"Assembly 3rd Reading AB898 Lee et al. By Laird",38,0,0,2,40
1454899,1108323,2021-09-09,Assembly,"AB 898 Lee Concurrence in Senate Amendments",49,6,0,25,80
1454901,1035198,2021-03-23,Assembly,"Do pass",9,2,0,0,11
1454901,1044979,2021-04-05,Assembly,"AB 900 Reyes Assembly Third Reading",54,15,9,0,78
1454901,1098156,2021-06-15,Senate,"Do pass",8,2,1,0,11
1454901,1108686,2021-09-10,Senate,"Assembly 3rd Reading AB900 Reyes By Min",28,8,0,4,40
1454901,1108687,2021-09-10,Assembly,"AB 900 Reyes Concurrence in Senate Amendments",59,14,0,7,80
1454902,1060961,2021-04-22,Assembly,"Do pass as amended. To Consent Calendar",11,0,0,0,11
1454902,1068286,2021-05-03,Assembly,"AB 901 Calderon Consent Calendar Second Day",76,0,2,0,78
1454902,1103379,2021-06-29,Senate,"Do pass",10,1,0,0,11
1454902,1108067,2021-09-08,Senate,"Assembly 3rd Reading AB901 Calderon By Hertzberg",36,0,0,4,40
1454902,1108235,2021-09-09,Assembly,"AB 901 Calderon Concurrence in Senate Amendments",79,1,0,0,80
1454903,1123761,2022-01-12,Assembly,"Do pass as amended and be re-referred to the Committee on [Appropriations]",5,0,0,2,7
1454903,1126321,2022-01-20,Assembly,"Do pass",12,1,0,3,16
1454903,1129873,2022-01-27,Assembly,"AB 902 O'Donnell Assembly Third Reading",57,5,0,14,76
1454903,1211833,2022-06-01,Senate,"Do pass, but first be re-referred to the Committee on [Appropriations]",5,1,0,1,7
1454903,1223241,2022-08-08,Senate,"Placed on suspense file",7,0,0,0,7
1454904,1054629,2021-04-14,Assembly,"Do pass as amended and be re-referred to the Committee on [Appropriations]",8,0,0,0,8
1454904,1065172,2021-04-28,Assembly,"Do pass",16,0,0,0,16
1454904,1075242,2021-05-10,Assembly,"AB 903 Frazier Assembly Third Reading",70,0,8,0,78
1454904,1104546,2021-07-08,Senate,"Do pass as amended, but first amend, and re-refer to the Committee on [Appropriations]",2,0,3,0,5
1454904,1104547,2021-07-08,Senate,"[First] hearing set for [07-08-2021]: Failed passage in Committee. Reconsideration granted",3,0,2,0,5
1454908,1064040,2021-04-26,Assembly,"Do pass and be re-referred to the Committee on [Appropriations]",11,4,0,0,15
1454914,1046102,2021-04-06,Assembly,"Do pass and be re-referred to the Committee on [Public Safety]",18,0,1,0,19
1454914,1065220,2021-04-27,Assembly,"Do pass and be re-referred to the Committee on [Appropriations] with recommendation: To Consent Calendar",8,0,0,0,8
1454914,1076943,2021-05-12,Assembly,"Do pass. To Consent Calendar",16,0,0,0,16
1454914,1081921,2021-05-20,Assembly,"AB 913 Smith Consent Calendar Second Day Regular Session",76,0,2,0,78
1454914,1104888,2021-07-14,Senate,"Do pass, but first be re-referred to the Committee on [Appropriations]",13,0,1,0,14
1454914,1108626,2021-09-10,Senate,"Assembly 3rd Reading AB913 Smith By Jones",36,0,0,4,40
1454914,1108627,2021-09-10,Assembly,"AB 913 Smith Concurrence in Senate Amendments",78,0,0,2,80
1454915,1036541,2021-03-24,Assembly,"Do pass and be re-referred to the Committee on [Appropriations]",12,0,0,0,12
1454915,1053561,2021-04-14,Assembly,"Do pass. To Consent Calendar",16,0,0,0,16
1454915,1083874,2021-05-24,Assembly,"AB 914 Irwin Assembly Third Reading",76,0,2,0,78
1454915,1098663,2021-06-16,Senate,"Do pass, but first be re-referred to the Committee on [Appropriations] with the recommendation: To Consent Calendar",7,0,0,0,7
1454915,1107702,2021-09-02,Senate,"Assembly 3rd Reading AB914 Akilah Weber et al. By Dahle",39,0,0,1,40
1454915,1107935,2021-09-07,Assembly,"AB 914 Akilah Weber Concurrence in Senate Amendments",72,0,0,8,80
1454916,1064071,2021-04-27,Assembly,"Do pass as amended and be re-referred to the Committee on [Appropriations]",6,0,1,0,7
1454916,1081656,2021-05-20,Assembly,"Do pass",14,0,2,0,16
1454916,1088022,2021-05-28,Assembly,"AB 915 Chiu Assembly Third Reading",69,0,10,0,79
1454916,1100305,2021-06-22,Senate,"Do pass, but first be re-referred to the Committee on [Business, Professions and Economic Development]",14,0,1,0,15
1454916,1104916,2021-07-14,Senate,"Do pass, but first be re-referred to the Committee on [Appropriations]",13,0,1,0,14
1454916,1106250,2021-08-16,Senate,"Placed on suspense file",7,0,0,0,7
1454917,1123763,2022-01-12,Assembly,"Do pass and be re-referred to the Committee on [Appropriations]",8,0,0,0,8
1454917,1123764,2022-01-12,Assembly,"Do pass and be re-referred to the Committee on [Local Government]",7,0,0,1,8
1454917,1126269,2022-01-20,Assembly,"Do pass. To Consent Calendar",15,0,0,1,16
1454917,1129920,2022-01-27,Assembly,"AB 916 Salas Consent Calendar Second Day Regular Session",61,0,0,15,76
1454917,1215849,2022-06-13,Senate,"Do pass as amended, but first amend, and re-refer to the Committee on [Governance and Finance]",6,1,0,2,9
1454917,1221283,2022-06-29,Senate,"Do pass, but first be re-referred to the Committee on [Appropriations]",5,0,0,0,5
1454917,1225654,2022-08-29,Senate,"Assembly 3rd Reading AB916 Salas et al. By Caballero",39,0,0,1,40
1454917,1225655,2022-08-30,Assembly,"AB 916 Salas Concurrence in Senate Amendments",76,0,0,4,80
1454917,1229706,2022-08-30,Senate,"Assembly 3rd Reading AB916 Salas et al. By Caballero",39,0,0,1,40
1454918,1044981,2021-04-05,Assembly,"Do pass and be re-referred to the Committee on [Privacy and Consumer Protection]",13,0,2,0,15
1454918,1060878,2021-04-22,Assembly,"Do pass as amended",10,0,1,0,11
1454918,1090374,2021-06-02,Assembly,"AB 917 Bloom Assembly Third Reading",72,2,5,0,79
1454918,1102884,2021-06-29,Senate,"Do pass as amended, but first amend, and re-refer to the Committee on [Judiciary]",14,3,0,0,17
1454918,1104897,2021-07-13,Senate,"Do pass as amended",8,0,3,0,11
1454918,1107586,2021-09-02,Senate,"Assembly 3rd Reading AB917 Bloom et al. By Min",31,5,0,4,40
1454918,1108030,2021-09-08,Assembly,"AB 917 Bloom Concurrence in Senate Amendments",73,1,0,6,80
1454921,1066721,2021-04-29,Assembly,"Do pass. To Consent Calendar",11,0,0,0,11
1454921,1074105,2021-05-06,Assembly,"AB 920 Aguiar-Curry Consent Calendar Second Day Regular Session",77,0,1,0,78
1454921,1097020,2021-06-10,Senate,"Do pass and be ordered to the Consent Calendar",5,0,0,0,5
1454921,1225091,2022-08-29,Senate,"Do pass, but first be re-referred to the Committee on [Appropriations]",11,0,0,4,15
1454921,1225187,2022-08-31,Assembly,"With recommendation: That Senate amendments be concurred in",20,0,0,2,22
1454921,1225904,2022-08-31,Senate,"Assembly 3rd Reading AB920 Aguiar-Curry et al. By Allen Urgency Clause",40,0,0,0,40
1454921,1225905,2022-08-31,Assembly,"AB 920 AGUIAR-CURRY Concurrence - Urgency Added",79,0,0,1,80
1454922,1049884,2021-04-08,Assembly,"Do pass and be re-referred to the Committee on [Appropriations]",9,0,6,0,15
1454922,1081501,2021-05-20,Assembly,"Do pass",12,0,4,0,16
1454922,1124819,2022-01-18,Assembly,"AB 921 McCarty Assembly Third Reading",56,0,0,20,76
1454924,1065108,2021-04-28,Assembly,"Do pass and be re-referred to the Committee on [Appropriations]",7,0,0,0,7
1454924,1126353,2022-01-20,Assembly,"Do pass as amended",15,0,0,1,16
1454924,1131261,2022-01-31,Assembly,"AB 923 Ramos Assembly Third Reading",76,0,0,0,76
1454924,1219879,2022-06-28,Senate,"Do pass, but first be re-referred to the Committee on [Appropriations]",13,0,0,2,15
1454924,1222830,2022-08-01,Senate,"Placed on suspense file",7,0,0,0,7
1454924,1223639,2022-08-11,Senate,"Do pass as amended",7,0,0,0,7
1454924,1225761,2022-08-31,Senate,"Special Consent AB923",40,0,0,0,40
1454924,1225762,2022-08-31,Assembly,"AB 923 Ramos Concurrence in Senate Amendments",80,0,0,0,80
1454926,1053500,2021-04-13,Assembly,"Do pass and be re-referred to the Committee on [Appropriations] with recommendation: To Consent Calendar",8,0,0,0,8
1454926,1081930,2021-05-20,Assembly,"Do pass",16,0,0,0,16
1454926,1087023,2021-05-27,Assembly,"AB 925 Megan Dahle Assembly Third Reading",77,0,1,0,78
1454926,1102877,2021-06-29,Senate,"Do pass, but first be re-referred to the Committee on [Appropriations] with the recommendation: To Consent Calendar",5,0,0,0,5
1454927,1065101,2021-04-28,Assembly,"Do pass and be re-referred to the Committee on [Appropriations]",11,0,0,0,11
1454928,1060853,2021-04-22,Assembly,"Do pass and be re-referred to the Committee on [Appropriations]",11,0,1,0,12
1454928,1082181,2021-05-20,Assembly,"Do pass",16,0,0,0,16
1454928,1092921,2021-06-01,Assembly,"AB 927 Medina Assembly Third Reading",79,0,0,0,79
1454928,1104926,2021-07-14,Senate,"Do pass as amended, but first amend, and re-refer to the Committee on [Appropriations]",7,0,0,0,7
1454928,1106097,2021-08-16,Senate,"Placed on suspense file",7,0,0,0,7
1454928,1106957,2021-08-26,Senate,"Do pass as amended",7,0,0,0,7
1454928,1108071,2021-09-08,Senate,"Special Consent AB927",38,0,0,2,40
1454928,1108319,2021-09-09,Assembly,"AB 927 Medina Concurrence in Senate Amendments",79,0,0,1,80
1454929,1060849,2021-04-22,Assembly,"Do pass as amended and be re-referred to the Committee on [Appropriations]",12,0,0,0,12
1454929,1081633,2021-05-20,Assembly,"Do pass as amended",16,0,0,0,16
1454929,1092918,2021-06-01,Assembly,"AB 928 Berman Assembly Third Reading",79,0,0,0,79
1454929,1104884,2021-07-14,Senate,"Do pass as amended, but first amend, and re-refer to the Committee on [Appropriations]",7,0,0,0,7
1454929,1106137,2021-08-16,Senate,"Placed on suspense file",7,0,0,0,7
1454929,1106668,2021-08-26,Senate,"Do pass as amended",7,0,0,0,7
1454929,1108206,2021-09-08,Senate,"Special Consent AB928",38,0,0,2,40
1454929,1108380,2021-09-09,Assembly,"AB 928 Berman Concurrence in Senate Amendments",79,0,0,1,80
1454931,1035242,2021-03-23,Assembly,"Do pass as amended and be re-referred to the Committee on [Appropriations]",8,1,2,0,11
1454931,1082090,2021-05-20,Assembly,"Do pass",12,4,0,0,16
1454931,1087035,2021-05-27,Assembly,"AB 930 Levine Assembly Third Reading",51,19,8,0,78
1454931,1103471,2021-06-30,Senate,"Do pass, but first be re-referred to the Committee on [Judiciary]",13,0,1,0,14
1454931,1104431,2021-07-06,Senate,"Do pass, but first be re-referred to the Committee on [Appropriations]",11,0,0,0,11
1454931,1107415,2021-09-01,Senate,"Assembly 3rd Reading AB930 Levine By Umberg",38,1,0,1,40
1454931,1107663,2021-09-02,Assembly,"AB 930 Levine Concurrence in Senate Amendments",53,16,0,10,79
1454932,1053541,2021-04-13,Assembly,"Do pass and be re-referred to the Committee on [Appropriations] with recommendation: To Consent Calendar",8,0,0,0,8
1454932,1081629,2021-05-20,Assembly,"Do pass as amended",16,0,0,0,16
1454932,1092944,2021-06-01,Assembly,"AB 931 Villapudua Assembly Third Reading",79,0,0,0,79
1454932,1220762,2022-06-28,Senate,"Do pass, but first be re-referred to the Committee on [Appropriations]",1,2,0,2,5
1454933,1047449,2021-04-07,Assembly,"Do pass and be re-referred to the Committee on [Appropriations]",8,0,0,0,8
1454934,1123345,2022-01-11,Assembly,"Do pass as amended and be re-referred to the Committee on [Appropriations]",15,0,0,0,15
1454935,1065088,2021-04-28,Assembly,"Do pass and be re-referred to the Committee on [Appropriations]",7,0,0,0,7
1454935,1081698,2021-05-20,Assembly,"Do pass",16,0,0,0,16
1454935,1087006,2021-05-27,Assembly,"AB 934 Cooley Assembly Third Reading",76,0,2,0,78
1454935,1104348,2021-07-06,Senate,"Do pass, but first be re-referred to the Committee on [Appropriations] with the recommendation: To Consent Calendar",15,0,0,0,15
1454935,1107172,2021-08-30,Senate,"Consent Calendar AB934",39,0,0,1,40
1454936,1064050,2021-04-27,Assembly,"Do pass and be re-referred to the Committee on [Appropriations]",12,0,3,0,15
1454938,1047432,2021-04-06,Assembly,"Do pass and be re-referred to the Committee on [Judiciary]",5,2,1,0,8
1454938,1057743,2021-04-20,Assembly,"Do pass as amended and be re-referred to the Committee on [Appropriations]",7,2,2,0,11
1454938,1081555,2021-05-20,Assembly,"Do pass",11,4,1,0,16
1454938,1091713,2021-06-03,Assembly,"AB 937 Carrillo Assembly Third Reading",42,21,16,0,79
1454938,1104741,2021-07-13,Senate,"Do pass, but first be re-referred to the Committee on [Appropriations]",4,1,0,0,5
1454938,1106205,2021-08-16,Senate,"Placed on suspense file",7,0,0,0,7
1454938,1106697,2021-08-26,Senate,"Do pass",5,2,0,0,7
1454938,1225667,2022-08-31,Senate,"Assembly 3rd Reading AB937 Carrillo et al. By Wiener",18,13,0,9,40
1454939,1035231,2021-03-23,Assembly,"Do pass. To Consent Calendar",11,0,0,0,11
1454939,1044944,2021-04-05,Assembly,"AB 938 Davies Consent Calendar Second Day Regular Session",74,0,4,0,78
1454939,1103430,2021-06-29,Senate,"Do pass and be ordered to the Consent Calendar",11,0,0,0,11
1454939,1104642,2021-07-12,Senate,"Consent Calendar AB938",39,0,1,0,40
1454940,1065305,2021-04-27,Assembly,"Do pass",8,0,0,0,8
1454940,1083843,2021-05-24,Assembly,"AB 939 Cervantes Assembly Third Reading",75,0,3,0,78
1454940,1104750,2021-07-13,Senate,"Do pass",5,0,0,0,5
1454940,1108145,2021-09-08,Senate,"Assembly 3rd Reading AB939 Cervantes et al. By Rubio",38,0,0,2,40
1454940,1108373,2021-09-09,Assembly,"AB 939 Cervantes Concurrence in Senate Amendments",80,0,0,0,80
1454941,1035172,2021-03-23,Assembly,"Do pass and be re-referred to the Committee on [Higher Education]",14,0,1,0,15
1454941,1048986,2021-04-08,Assembly,"Do pass and be re-referred to the Committee on [Appropriations]",11,0,1,0,12
1454942,1059296,2021-04-21,Assembly,"Do pass and be re-referred to the Committee on [Appropriations]",8,0,0,0,8
1454942,1081877,2021-05-20,Assembly,"Do pass as amended",16,0,0,0,16
1454942,1092941,2021-06-01,Assembly,"AB 941 Bennett Assembly Third Reading",78,0,1,0,79
1454942,1104418,2021-07-06,Senate,"Do pass, but first be re-referred to the Committee on [Appropriations]",3,0,2,0,5
1454942,1106420,2021-08-23,Senate,"Placed on suspense file",7,0,0,0,7
1454942,1107013,2021-08-26,Senate,"Do pass as amended",5,0,0,2,7
1454942,1108086,2021-09-08,Senate,"Assembly 3rd Reading AB941 Bennett et al. By Lim贸n",33,0,0,7,40
1454942,1108354,2021-09-09,Assembly,"AB 941 Bennett Concurrence in Senate Amendments",77,0,0,3,80
1454943,1063989,2021-04-27,Assembly,"Do pass and be re-referred to the Committee on [Appropriations]",15,0,0,0,15
1454943,1081662,2021-05-20,Assembly,"Do pass as amended",16,0,0,0,16
1454944,1123337,2022-01-10,Assembly,"Do pass as amended and be re-referred to the Committee on [Appropriations]",8,2,0,1,11
1454946,1048949,2021-04-07,Assembly,"Do pass and be re-referred to the Committee on [Judiciary] with recommendation: To Consent Calendar",7,0,0,0,7
1454946,1057636,2021-04-20,Assembly,"Do pass and be re-referred to the Committee on [Appropriations] with recommendation: To Consent Calendar",10,0,1,0,11
1454946,1082008,2021-05-20,Assembly,"Do pass as amended",16,0,0,0,16
1454946,1091703,2021-06-03,Assembly,"AB 945 Ramos Assembly Third Reading",78,0,1,0,79
1454946,1100824,2021-06-23,Senate,"Do pass, but first be re-referred to the Committee on [Judiciary]",7,0,0,0,7
1454946,1104413,2021-07-06,Senate,"Do pass, but first be re-referred to the Committee on [Appropriations] with the recommendation: To Consent Calendar",11,0,0,0,11
1454946,1106051,2021-08-16,Senate,"Placed on suspense file",7,0,0,0,7
1454946,1106733,2021-08-26,Senate,"Do pass",7,0,0,0,7
1454946,1107809,2021-09-03,Senate,"Special Consent AB945",37,0,0,3,40
1454946,1107936,2021-09-07,Assembly,"AB 945 Ramos Concurrence in Senate Amendments",73,0,0,7,80
1454949,1065184,2021-04-27,Assembly,"Do pass and be re-referred to the Committee on [Appropriations] with recommendation: To Consent Calendar",19,0,0,0,19
1454949,1081847,2021-05-20,Assembly,"Do pass as amended",16,0,0,0,16
1454949,1092849,2021-06-01,Assembly,"AB 948 Holden Assembly Third Reading",78,0,1,0,79
1454949,1103375,2021-06-30,Senate,"Do pass, but first be re-referred to the Committee on [Judiciary]",12,1,1,0,14
1454949,1104961,2021-07-13,Senate,"Do pass as amended, but first amend, and re-refer to the Committee on [Appropriations]",10,1,0,0,11
1454949,1106429,2021-08-23,Senate,"Placed on suspense file",7,0,0,0,7
1454949,1106909,2021-08-26,Senate,"Do pass as amended",6,1,0,0,7
1454949,1107593,2021-09-02,Senate,"Assembly 3rd Reading AB948 Holden et al. By Eggman",38,1,0,1,40
1454949,1107937,2021-09-07,Assembly,"AB 948 Holden Concurrence in Senate Amendments",72,0,0,8,80
1454951,1067640,2021-04-29,Assembly,"Do pass and be re-referred to the Committee on [Appropriations]",7,0,1,0,8
1454951,1082102,2021-05-20,Assembly,"Do pass as amended",14,0,2,0,16
1454951,1092833,2021-06-01,Assembly,"AB 950 Ward Assembly Third Reading",69,0,10,0,79
1454951,1102809,2021-06-29,Senate,"Do pass, but first be re-referred to the Committee on [Environmental Quality]",13,4,0,0,17
1454951,1104632,2021-07-12,Senate,"Do pass as amended, but first amend, and re-refer to the Committee on [Appropriations]",5,2,0,0,7
1454951,1223185,2022-08-08,Senate,"Placed on suspense file",7,0,0,0,7
1454956,1051943,2021-04-12,Assembly,"Do pass and be re-referred to the Committee on [Communications and Conveyance] with recommendation: To Consent Calendar",15,0,0,0,15
1454956,1065177,2021-04-28,Assembly,"Do pass and be re-referred to the Committee on [Appropriations] with recommendation: To Consent Calendar",13,0,0,0,13
1454956,1081954,2021-05-20,Assembly,"Do pass as amended",12,0,4,0,16
1454956,1092871,2021-06-01,Assembly,"AB 955 Quirk Assembly Third Reading",79,0,0,0,79
1454956,1101613,2021-06-24,Senate,"Do pass, but first be re-referred to the Committee on [Appropriations]",14,0,3,0,17
1454956,1104163,2021-07-05,Senate,"Placed on suspense file",6,0,1,0,7
1454956,1106965,2021-08-26,Senate,"Do pass as amended",7,0,0,0,7
1454956,1107885,2021-09-07,Senate,"Assembly 3rd Reading AB955 Quirk By Dodd",37,0,0,3,40
1454956,1108131,2021-09-08,Assembly,"AB 955 Quirk Concurrence in Senate Amendments",78,0,0,2,80
1454958,1048985,2021-04-08,Assembly,"Do pass and be re-referred to the Committee on [Appropriations] with recommendation: To Consent Calendar",22,0,0,0,22
1454958,1059275,2021-04-21,Assembly,"Do pass. To Consent Calendar",14,0,2,0,16
1454958,1066714,2021-04-29,Assembly,"AB 957 Salas Consent Calendar Second Day Regular Session",77,0,1,0,78
1454958,1095062,2021-06-08,Senate,"Do pass, but first be re-referred to the Committee on [Appropriations] with the recommendation: To Consent Calendar",14,0,1,0,15
1454958,1107419,2021-09-01,Senate,"Assembly 3rd Reading AB957 Salas et al. By Hurtado Urgency Clause",38,0,0,2,40
1454958,1107938,2021-09-07,Assembly,"AB 957 Salas Concurrence - Urgency Added",73,0,0,7,80
1454959,1065229,2021-04-27,Assembly,"Do pass as amended and be re-referred to the Committee on [Appropriations]",8,0,0,0,8
1454959,1081659,2021-05-20,Assembly,"Do pass as amended",16,0,0,0,16
1454959,1088023,2021-05-28,Assembly,"AB 958 Gipson Assembly Third Reading",73,1,5,0,79
1454959,1104316,2021-07-06,Senate,"Do pass, but first be re-referred to the Committee on [Appropriations]",5,0,0,0,5
1454959,1104480,2021-07-06,Senate,"Do pass as amended, but first amend, and re-refer to the Committee on [Appropriations]",5,0,0,0,5
1454959,1106123,2021-08-16,Senate,"Placed on suspense file",7,0,0,0,7
1454959,1106757,2021-08-26,Senate,"Do pass",7,0,0,0,7
1454959,1107778,2021-09-03,Senate,"Special Consent AB958",37,0,0,3,40
1454959,1108146,2021-09-08,Assembly,"AB 958 Gipson Concurrence in Senate Amendments",78,0,0,2,80
1454960,1073360,2021-05-05,Assembly,"Do pass as amended",8,0,0,0,8
1454960,1088024,2021-05-28,Assembly,"AB 959 Mullin Assembly Third Reading",77,0,2,0,79
1454960,1103754,2021-07-01,Senate,"Do pass as amended",5,0,0,0,5
1454960,1107197,2021-08-30,Senate,"Assembly 3rd Reading AB959 Mullin et al. By Becker",39,0,0,1,40
1454960,1107585,2021-09-02,Assembly,"AB 959 Mullin Concurrence in Senate Amendments",77,0,0,2,79
1454961,1059181,2021-04-20,Assembly,"Do pass as amended and be re-referred to the Committee on [Appropriations]",6,2,0,0,8
1454961,1081460,2021-05-20,Assembly,"Do pass",12,4,0,0,16
1454961,1091693,2021-06-03,Assembly,"AB 960 Ting Assembly Third Reading",45,24,10,0,79
1454961,1220687,2022-06-28,Senate,"Do pass, but first be re-referred to the Committee on [Appropriations]",4,1,0,0,5
1454961,1224960,2022-08-25,Senate,"Assembly 3rd Reading AB960 Ting By Bradford",29,9,0,2,40
1454961,1225104,2022-08-29,Assembly,"With recommendation: That Senate amendments be concurred in",5,1,0,1,7
1454961,1225318,2022-08-30,Assembly,"AB 960 Ting Concurrence in Senate Amendments",46,21,0,13,80
1454963,1065126,2021-04-28,Assembly,"Do pass and be re-referred to the Committee on [Appropriations]",11,0,0,0,11
1454963,1076960,2021-05-12,Assembly,"Do pass. To Consent Calendar",16,0,0,0,16
1454963,1081840,2021-05-20,Assembly,"AB 962 Kamlager Consent Calendar Second Day By REYES",76,0,2,0,78
1454963,1102454,2021-06-28,Senate,"Do pass as amended, but first amend, and re-refer to the Committee on [Appropriations]",6,0,1,0,7
1454963,1105094,2021-07-15,Senate,"Placed on suspense file",7,0,0,0,7
1454963,1106576,2021-08-26,Senate,"Do pass",7,0,0,0,7
1454963,1108074,2021-09-08,Senate,"Assembly 3rd Reading AB962 Kamlager et al. By Kamlager",38,0,0,2,40
1454963,1108419,2021-09-09,Assembly,"AB 962 Kamlager Concurrence in Senate Amendments By FRIEDMAN",77,0,0,3,80
1454964,1065274,2021-04-28,Assembly,"Do pass and be re-referred to the Committee on [Appropriations]",11,0,0,0,11
1454966,1067636,2021-04-29,Assembly,"Do pass and be re-referred to the Committee on [Appropriations] with recommendation: To Consent Calendar",8,0,0,0,8
1454966,1081422,2021-05-20,Assembly,"Do pass",16,0,0,0,16
1454966,1087018,2021-05-27,Assembly,"AB 965 Levine Assembly Third Reading",78,0,0,0,78
1454966,1104535,2021-07-08,Senate,"Do pass, but first be re-referred to the Committee on [Appropriations]",8,0,1,0,9
1454966,1106128,2021-08-16,Senate,"Placed on suspense file",7,0,0,0,7
1454966,1106832,2021-08-26,Senate,"Do pass",6,1,0,0,7
1454967,1065146,2021-04-28,Assembly,"Do pass and be re-referred to the Committee on [Appropriations] with recommendation: To Consent Calendar",7,0,0,0,7
1454968,1048929,2021-04-07,Assembly,"Do pass as amended and be re-referred to the Committee on [Appropriations]",7,0,0,0,7
1454968,1081540,2021-05-20,Assembly,"Do pass as amended",16,0,0,0,16
1454968,1092875,2021-06-01,Assembly,"AB 967 Frazier Assembly Third Reading",79,0,0,0,79
1454972,1016241,2021-02-25,Assembly,"Be adopted. To third reading",11,0,1,0,12
1454972,1037871,2021-03-25,Senate,"Special Consent ACR30",38,0,2,0,40
1454974,1054606,2021-04-15,Senate,"Do pass as amended, but first amend, and re-refer to the Committee on [Appropriations]",9,0,0,0,9
1454974,1075309,2021-05-10,Senate,"Placed on suspense file",7,0,0,0,7
1454974,1082167,2021-05-20,Senate,"Do pass",7,0,0,0,7
1454974,1089492,2021-06-01,Senate,"Special Consent SB470",39,0,1,0,40
1454974,1103782,2021-07-01,Assembly,"Do pass and be re-referred to the Committee on [Appropriations]",14,0,1,0,15
1454976,1046215,2021-04-06,Senate,"Do pass, but first be re-referred to the Committee on [Appropriations] with the recommendation: To Consent Calendar",5,0,0,0,5
1454976,1056419,2021-04-19,Senate,"Placed on suspense file",7,0,0,0,7
1454976,1082053,2021-05-20,Senate,"Do pass as amended",7,0,0,0,7
1454976,1089537,2021-06-01,Senate,"Senate 3rd Reading SB472 Caballero et al",39,0,1,0,40
1454976,1104752,2021-07-13,Assembly,"Do pass as amended, and be re-referred to the Committee on [Appropriations] with recommendation: To Consent Calendar",8,0,0,0,8
1454977,1123292,2022-01-11,Senate,"Do pass as amended, but first amend, and re-refer to the Committee on [Appropriations]",11,0,0,0,11
1454977,1127182,2022-01-24,Senate,"Senate 3rd Reading SB473 Bates et al",36,0,0,4,40
1454977,1215862,2022-06-14,Assembly,"Do pass as amended and be re-referred to the Committee on [Appropriations]",13,0,0,2,15
1454979,1062742,2021-04-26,Senate,"Do pass, but first be re-referred to the Committee on [Transportation]",6,0,1,0,7
1454980,1059286,2021-04-21,Senate,"Do pass as amended, but first amend, and re-refer to the Committee on [Appropriations]",8,1,0,0,9
1454980,1075287,2021-05-10,Senate,"Placed on suspense file",7,0,0,0,7
1454980,1081952,2021-05-20,Senate,"Do pass as amended",5,2,0,0,7
1454980,1089535,2021-06-01,Senate,"Senate 3rd Reading SB476 Min",31,4,5,0,40
1454980,1101598,2021-06-23,Assembly,"Do pass and be re-referred to the Committee on [Banking and Finance]",3,2,3,0,8
1454981,1031903,2021-03-18,Senate,"Do pass, but first be re-referred to the Committee on [Appropriations]",7,0,2,0,9
1454981,1044953,2021-04-05,Senate,"Placed on suspense file",7,0,0,0,7
1454981,1081508,2021-05-20,Senate,"Do pass as amended",6,0,1,0,7
1454981,1087598,2021-05-28,Senate,"Senate 3rd Reading SB477 Wiener et al",36,0,4,0,40
1454981,1100354,2021-06-22,Assembly,"Do pass as amended and be re-referred to the Committee on [Local Government]",8,0,0,0,8
1454981,1103779,2021-06-30,Assembly,"Do pass and be re-referred to the Committee on [Appropriations]",8,0,0,0,8
1454981,1107018,2021-08-26,Assembly,"Do pass as amended",13,0,0,3,16
1454981,1107681,2021-09-02,Assembly,"SB 477 Wiener Senate Third Reading By Berman",71,1,0,7,79
1454981,1107787,2021-09-03,Senate,"Unfinished Business SB477 Wiener et al. Concurrence",37,0,0,3,40
1454982,1048891,2021-04-08,Senate,"Do pass as amended, but first amend, and re-refer to the Committee on [Housing]",4,1,0,0,5
1454982,1066754,2021-04-29,Senate,"Do pass, but first be re-referred to the Committee on [Appropriations]",7,1,1,0,9
1454982,1075319,2021-05-10,Senate,"Placed on suspense file",7,0,0,0,7
1454982,1081437,2021-05-20,Senate,"Do pass as amended",6,1,0,0,7
1454982,1086106,2021-05-26,Senate,"Senate 3rd Reading SB478 Wiener",29,5,6,0,40
1454982,1100338,2021-06-22,Assembly,"Do pass as amended and be re-referred to the Committee on [Local Government]",7,1,0,0,8
1454982,1103841,2021-06-30,Assembly,"Do pass as amended and be re-referred to the Committee on [Appropriations]",5,2,1,0,8
1454982,1106975,2021-08-26,Assembly,"Do pass as amended",11,4,0,1,16
1454982,1108159,2021-09-08,Assembly,"SB 478 Wiener Senate Third Reading By Carrillo",56,14,0,10,80
1454982,1108316,2021-09-09,Senate,"Unfinished Business SB478 Wiener et al. Concurrence",30,6,0,4,40
1454983,1028400,2021-03-15,Senate,"Do pass as amended, but first amend, and re-refer to the Committee on [Appropriations]",14,0,0,0,14
1454983,1050785,2021-04-12,Senate,"Senate 3rd Reading SB479 Laird",39,0,1,0,40
1454983,1098650,2021-06-16,Assembly,"Do pass and be re-referred to the Committee on [Appropriations] with recommendation: To Consent Calendar",14,0,1,0,15
1454983,1103486,2021-06-30,Assembly,"Do pass. To Consent Calendar",14,0,2,0,16
1454983,1104532,2021-07-08,Assembly,"SB 479 Laird Consent Calendar Second Day Regular Session",76,0,3,0,79
1454983,1104666,2021-07-12,Senate,"Unfinished Business SB479 Laird Concurrence",39,0,1,0,40
1454984,1054703,2021-04-15,Senate,"Do pass, but first be re-referred to the Committee on [Appropriations]",5,0,0,0,5
1454984,1091720,2021-06-03,Senate,"Senate 3rd Reading SB480 Stern",38,0,2,0,40
1454984,1101650,2021-06-23,Assembly,"Do pass and be re-referred to the Committee on [Appropriations]",8,0,0,0,8
1454984,1104397,2021-07-07,Assembly,"Do pass. To Consent Calendar",14,0,2,0,16
1454985,1064119,2021-04-27,Senate,"Do pass, but first be re-referred to the Committee on [Appropriations]",4,1,0,0,5
1454985,1075301,2021-05-10,Senate,"Placed on suspense file",7,0,0,0,7
1454985,1081752,2021-05-20,Senate,"Do pass as amended",5,2,0,0,7
1454987,1064171,2021-04-27,Senate,"Do pass, but first be re-referred to the Committee on [Appropriations]",4,1,0,0,5
1454987,1075373,2021-05-10,Senate,"Placed on suspense file",7,0,0,0,7
1454987,1082048,2021-05-20,Senate,"Do pass as amended",5,2,0,0,7
1454987,1090398,2021-06-02,Senate,"Senate 3rd Reading SB483 Allen",26,9,5,0,40
1454987,1104735,2021-07-13,Assembly,"Do pass as amended and be re-referred to the Committee on [Appropriations]",6,2,0,0,8
1454987,1106754,2021-08-26,Assembly,"Do pass",12,4,0,0,16
1454987,1108315,2021-09-09,Assembly,"SB 483 Allen Senate Third Reading By Bryan",43,25,0,12,80
1454987,1108578,2021-09-10,Senate,"Unfinished Business SB483 Allen Concurrence",26,10,0,4,40
1454988,1023834,2021-03-08,Senate,"Do pass as amended, but first amend, and re-refer to the Committee on [Appropriations]",11,0,3,0,14
1454988,1074137,2021-05-06,Senate,"Senate 3rd Reading SB484 Archuleta",35,1,4,0,40
1454988,1100244,2021-06-22,Assembly,"Do pass and be re-referred to the Committee on [Appropriations]",18,0,1,0,19
1454988,1106306,2021-08-19,Assembly,"Do pass",16,0,0,0,16
1454988,1107608,2021-09-02,Assembly,"SB 484 Archuleta Senate Third Reading By Akilah Weber",70,3,0,6,79
1454989,1074166,2021-05-06,Senate,"Do pass as amended, but first amend, and re-refer to the Committee on [Appropriations]",5,0,0,0,5
1454989,1078734,2021-05-17,Senate,"Placed on suspense file",7,0,0,0,7
1454989,1081491,2021-05-20,Senate,"Do pass as amended",7,0,0,0,7
1454989,1120723,2022-01-06,Senate,"Pursuant to Senate Rule 29.10, that the measure be re-referred to the Committee on Appropriations pursuant to Joint Rule 10.5",4,0,0,1,5
1454989,1124806,2022-01-18,Senate,"Placed on suspense file",6,0,0,1,7
1454989,1126354,2022-01-20,Senate,"That the measure be returned to Senate Floor for consideration. Ordered to third reading",7,0,0,0,7
1454989,1127200,2022-01-24,Senate,"Senate 3rd Reading SB485 Portantino et al",36,0,0,4,40
1454989,1216314,2022-06-15,Assembly,"Do pass and be re-referred to the Committee on [Revenue and Taxation]",7,0,0,0,7
1454989,1221297,2022-06-30,Assembly,"Do pass as amended and be re-referred to the Committee on [Appropriations]",10,0,0,1,11
1454989,1223407,2022-08-11,Assembly,"Do pass as amended",12,0,0,4,16
1454990,1064051,2021-04-27,Senate,"Do pass, but first be re-referred to the Committee on [Appropriations]",6,3,8,0,17
1454991,1053497,2021-04-14,Senate,"Do pass, but first be re-referred to the Committee on [Appropriations] with the recommendation: To Consent Calendar",11,0,0,0,11
1454991,1075331,2021-05-10,Senate,"Consent Calendar SB487",37,0,3,0,40
1454992,1030805,2021-03-17,Senate,"Do pass, but first be re-referred to the Committee on [Appropriations]",7,0,0,0,7
1454992,1044948,2021-04-05,Senate,"Placed on suspense file",7,0,0,0,7
1454992,1081824,2021-05-20,Senate,"Do pass",7,0,0,0,7
1454992,1089489,2021-06-01,Senate,"Special Consent SB488",39,0,1,0,40
1454992,1100811,2021-06-23,Assembly,"Do pass as amended and be re-referred to the Committee on [Appropriations]",7,0,0,0,7
1454992,1106872,2021-08-26,Assembly,"Do pass as amended",12,0,0,4,16
1454992,1108038,2021-09-08,Assembly,"SB 488 Rubio Senate Third Reading By Lorena Gonzalez",80,0,0,0,80
1454992,1108430,2021-09-09,Senate,"Unfinished Business SB488 Rubio et al. Concurrence",38,0,0,2,40
1454993,1031879,2021-03-18,Senate,"Do pass as amended, but first amend, and re-refer to the Committee on [Appropriations]",5,0,0,0,5
1454993,1068167,2021-05-03,Senate,"Senate 3rd Reading SB489 Laird",36,0,4,0,40
1454993,1215288,2022-06-09,Assembly,"Be re-referred to the Committee on [Water, Parks, and Wildlife]",8,0,0,3,11
1454993,1219901,2022-06-28,Assembly,"Do pass and be re-referred to the Committee on [Appropriations]",14,0,0,1,15
1454993,1222973,2022-08-03,Assembly,"Do pass. To Consent Calendar",15,0,0,1,16
1454993,1223561,2022-08-11,Assembly,"SB 489 Laird Consent Calendar Second Day Regular Session",76,0,0,4,80
1454993,1224103,2022-08-16,Senate,"That the Assembly amendments be concurred in",7,0,0,2,9
1454993,1224194,2022-08-18,Senate,"Unfinished Business SB489 Laird et al. Concurrence",38,0,0,2,40
1454994,1054593,2021-04-15,Senate,"Do pass, but first be re-referred to the Committee on [Appropriations]",8,0,1,0,9
1454994,1068236,2021-05-03,Senate,"Placed on suspense file",6,0,1,0,7
1454994,1081404,2021-05-20,Senate,"Do pass",7,0,0,0,7
1454994,1127168,2022-01-24,Senate,"Senate 3rd Reading SB490 Caballero et al",36,0,0,4,40
1454994,1220870,2022-06-29,Assembly,"Do pass and be re-referred to the Committee on [Appropriations]",7,0,0,1,8
1454994,1223880,2022-08-11,Assembly,"Do pass",13,3,0,0,16
1454994,1225084,2022-08-29,Assembly,"Do pass",7,0,0,4,11
1454994,1225577,2022-08-30,Assembly,"SB 490 Caballero Senate Third Reading By WILSON",69,0,0,11,80
1454994,1225578,2022-08-31,Senate,"Unfinished Business SB490 Caballero Concurrence",39,1,0,0,40
1454995,1037848,2021-03-25,Senate,"Do pass as amended, but first amend, and re-refer to the Committee on [Public Safety]",5,0,0,0,5
1454995,1064074,2021-04-27,Senate,"Do pass, but first be re-referred to the Committee on [Appropriations] with the recommendation: To Consent Calendar",5,0,0,0,5
1454995,1075379,2021-05-10,Senate,"Placed on suspense file",7,0,0,0,7
1454995,1081999,2021-05-20,Senate,"Do pass",7,0,0,0,7
1454995,1089614,2021-06-01,Senate,"Special Consent SB491",39,0,1,0,40
1454995,1100284,2021-06-21,Assembly,"Do pass and be re-referred to the Committee on [Public Safety] with recommendation: To Consent Calendar",10,0,1,0,11
1454995,1104731,2021-07-13,Assembly,"Do pass and be re-referred to the Committee on [Appropriations] with recommendation: To Consent Calendar",8,0,0,0,8
1454996,1065277,2021-04-28,Senate,"Do pass, but first be re-referred to the Committee on [Appropriations]",11,0,0,0,11
1454996,1078775,2021-05-17,Senate,"Placed on suspense file",7,0,0,0,7
1454996,1081714,2021-05-20,Senate,"Do pass",7,0,0,0,7
1454997,1057652,2021-04-20,Senate,"Do pass, but first be re-referred to the Committee on [Appropriations]",4,1,0,0,5
1454997,1068153,2021-05-03,Senate,"Placed on suspense file",6,0,1,0,7
1454998,1025086,2021-03-09,Senate,"Do pass and be ordered to the Consent Calendar",14,0,0,0,14
1454998,1033617,2021-03-22,Senate,"Consent Calendar SB494",37,0,3,0,40
1454998,1098152,2021-06-15,Assembly,"Do pass as amended and be re-referred to the Committee on [Appropriations]",7,0,1,0,8
1454998,1107002,2021-08-26,Assembly,"Do pass",16,0,0,0,16
1454998,1107399,2021-09-01,Assembly,"SB 494 Dodd Senate Third Reading By Bauer-Kahan",77,0,0,2,79
1454998,1107877,2021-09-07,Senate,"That the Assembly amendments be concurred in",5,0,0,0,5
1454998,1108001,2021-09-08,Senate,"Unfinished Business SB494 Dodd Concurrence",38,0,0,2,40
1454999,1066794,2021-04-29,Senate,"Do pass, but first be re-referred to the Committee on [Governance and Finance]",2,0,5,0,7
1455000,1064005,2021-04-27,Senate,"Do pass, but first be re-referred to the Committee on [Appropriations] with the recommendation: To Consent Calendar",9,0,0,0,9
1455000,1075290,2021-05-10,Senate,"Placed on suspense file",7,0,0,0,7
1455000,1082188,2021-05-20,Senate,"Do pass",7,0,0,0,7
1455000,1089611,2021-06-01,Senate,"Special Consent SB496",39,0,1,0,40
1455000,1103823,2021-07-01,Assembly,"Do pass and be re-referred to the Committee on [Appropriations] with recommendation: To Consent Calendar",14,0,1,0,15
1455000,1106662,2021-08-26,Assembly,"Do pass",16,0,0,0,16
1455000,1107401,2021-09-01,Assembly,"SB 496 Laird Senate Third Reading By Robert Rivas",78,0,0,1,79
1455000,1107595,2021-09-02,Senate,"Unfinished Business SB496 Laird et al. Concurrence",39,0,0,1,40
1455001,1047528,2021-04-07,Senate,"Do pass, but first be re-referred to the Committee on [Human Services]",9,0,0,0,9
1455001,1057724,2021-04-20,Senate,"Do pass as amended, but first amend, and re-refer to the Committee on [Appropriations] with the recommendation: To Consent Calendar",5,0,0,0,5
1455001,1075325,2021-05-10,Senate,"Placed on suspense file",7,0,0,0,7
1455001,1081805,2021-05-20,Senate,"Do pass",7,0,0,0,7
1455001,1089554,2021-06-01,Senate,"Senate 3rd Reading SB497 Lim贸n et al",40,0,0,0,40
1455001,1102805,2021-06-29,Assembly,"Do pass and be re-referred to the Committee on [Human Services] with recommendation: To Consent Calendar",12,0,0,0,12
1455001,1103397,2021-06-30,Assembly,"Do pass and be re-referred to the Committee on [Appropriations] with recommendation: To Consent Calendar",8,0,0,0,8
1455001,1106307,2021-08-19,Assembly,"Do pass. To Consent Calendar",16,0,0,0,16
1455001,1106751,2021-08-26,Assembly,"SB 497 Lim贸n Consent Calendar Second Day Regular Session",73,0,0,6,79
1455001,1107144,2021-08-30,Senate,"Unfinished Business SB497 Lim贸n et al. Concurrence",39,0,0,1,40
1455002,1035169,2021-03-23,Senate,"Do pass, but first be re-referred to the Committee on [Military & Veterans Affairs] with the recommendation: To Consent Calendar",11,0,0,0,11
1455002,1053506,2021-04-14,Senate,"Do pass and be ordered to the Consent Calendar",7,0,0,0,7
1455002,1060837,2021-04-22,Senate,"Consent Calendar SB498",38,0,2,0,40
1455002,1100287,2021-06-22,Assembly,"Do pass and be re-referred to the Committee on [Military and Veterans Affairs] with recommendation: To Consent Calendar",11,0,0,0,11
1455002,1104245,2021-07-06,Assembly,"Do pass. To Consent Calendar",11,0,0,0,11
1455002,1105121,2021-07-15,Assembly,"SB 498 Umberg Consent Calendar Second Day Regular Session",70,0,9,0,79
1455002,1107250,2021-08-30,Senate,"Special Consent SB498",39,0,0,1,40
1455004,1051993,2021-04-13,Senate,"Do pass as amended, but first amend, and re-refer to the Committee on [Appropriations]",12,2,3,0,17
1455004,1075240,2021-05-10,Senate,"Placed on suspense file",7,0,0,0,7
1455004,1081630,2021-05-20,Senate,"Do pass as amended",5,2,0,0,7
1455004,1090389,2021-06-02,Senate,"Senate 3rd Reading SB500 Min",29,7,4,0,40
1455004,1099726,2021-06-21,Assembly,"Do pass as amended and be re-referred to the Committee on [Communications and Conveyance]",11,4,0,0,15
1455004,1104378,2021-07-07,Assembly,"Do pass and be re-referred to the Committee on [Appropriations]",9,3,1,0,13
1455004,1106316,2021-08-19,Assembly,"Do pass",12,4,0,0,16
1455004,1107523,2021-09-01,Assembly,"SB 500 Min Senate Third Reading By Berman",53,20,0,6,79
1455004,1107725,2021-09-02,Senate,"Unfinished Business SB500 Min Concurrence",30,9,0,1,40
1455005,1035228,2021-03-23,Senate,"Do pass as amended, but first amend, and re-refer to the Committee on [Appropriations] with the recommendation: To Consent Calendar",11,0,0,0,11
1455005,1056324,2021-04-19,Senate,"Placed on suspense file",7,0,0,0,7
1455005,1081945,2021-05-20,Senate,"Do pass as amended",7,0,0,0,7
1455005,1089590,2021-06-01,Senate,"Special Consent SB501",39,0,1,0,40
1455005,1100320,2021-06-22,Assembly,"Do pass and be re-referred to the Committee on [Appropriations] with recommendation: To Consent Calendar",11,0,0,0,11
1455005,1106671,2021-08-26,Assembly,"Do pass",16,0,0,0,16
1455005,1107496,2021-09-01,Assembly,"SB 501 Wieckowski Senate Third Reading By Maienschein",78,0,0,1,79
1455006,1028403,2021-03-15,Senate,"Do pass, but first be re-referred to the Committee on [Appropriations]",5,0,2,0,7
1455006,1033652,2021-03-22,Senate,"Placed on suspense file",7,0,0,0,7
1455006,1081621,2021-05-20,Senate,"Do pass",5,1,1,0,7
1455006,1124800,2022-01-18,Senate,"Senate 3rd Reading SB502 Allen",27,5,0,8,40
1455006,1216969,2022-06-14,Assembly,"Do pass and be re-referred to the Committee on [Appropriations]",9,0,0,0,9
1455006,1223710,2022-08-11,Assembly,"Do pass",16,0,0,0,16
1455006,1225437,2022-08-31,Senate,"Unfinished Business SB502 Allen Concurrence",31,4,0,5,40
1455006,1225438,2022-08-31,Assembly,"SB 502 Allen Senate Third Reading By Cristina Garcia",78,0,0,2,80
1455007,1028414,2021-03-15,Senate,"Do pass, but first be re-referred to the Committee on [Appropriations]",4,1,0,0,5
1455007,1033659,2021-03-22,Senate,"Placed on suspense file",7,0,0,0,7
1455007,1081944,2021-05-20,Senate,"Do pass as amended",5,2,0,0,7
1455007,1089468,2021-06-01,Senate,"Senate 3rd Reading SB503 Becker",31,8,1,0,40
1455007,1103429,2021-06-30,Assembly,"Do pass as amended and be re-referred to the Committee on [Appropriations]",6,1,0,0,7
1455007,1106345,2021-08-19,Assembly,"Do pass",12,4,0,0,16
1455007,1107600,2021-09-02,Assembly,"SB 503 Becker Senate Third Reading By Berman",59,18,0,2,79
1455007,1107752,2021-09-03,Senate,"Unfinished Business SB503 Becker Concurrence",29,8,0,3,40
1455008,1028390,2021-03-15,Senate,"Do pass, but first be re-referred to the Committee on [Public Safety]",5,0,0,0,5
1455008,1057618,2021-04-20,Senate,"Do pass, but first be re-referred to the Committee on [Appropriations] with the recommendation: To Consent Calendar",5,0,0,0,5
1455008,1068265,2021-05-03,Senate,"Placed on suspense file",6,0,1,0,7
1455008,1081728,2021-05-20,Senate,"Do pass",7,0,0,0,7
1455008,1091731,2021-06-03,Senate,"Senate 3rd Reading SB504 Becker",39,0,1,0,40
1455008,1103382,2021-06-30,Assembly,"Do pass and be re-referred to the Committee on [Public Safety]",7,0,0,0,7
1455008,1104721,2021-07-13,Assembly,"Do pass and be re-referred to the Committee on [Appropriations]",8,0,0,0,8
1455008,1106569,2021-08-26,Assembly,"Do pass",16,0,0,0,16
1455008,1107448,2021-09-01,Assembly,"SB 504 Becker Senate Third Reading By Mayes",74,0,0,5,79
1455008,1140918,2022-02-10,Assembly,"SB 504 Becker Third Reading Urgency By Bryan",58,0,0,17,75
1455008,1179143,2022-03-28,Assembly,"SB 504 Becker Third Reading Urgency By Bryan",62,0,0,14,76
1455008,1179144,2022-03-29,Senate,"That the Assembly amendments be concurred in",5,0,0,0,5
1455008,1181288,2022-03-31,Senate,"Unfinished Business SB504 Becker Urgency Clause Concurrence",39,0,0,1,40
1455009,1046099,2021-04-05,Senate,"Do pass as amended, but first amend, and re-refer to the Committee on [Judiciary] with the recommendation: To Consent Calendar",5,0,0,0,5
1455009,1059274,2021-04-20,Senate,"Do pass, but first be re-referred to the Committee on [Appropriations] with the recommendation: To Consent Calendar",11,0,0,0,11
1455009,1075252,2021-05-10,Senate,"Consent Calendar SB505",37,0,3,0,40
1455009,1216612,2022-06-16,Assembly,"Be re-referred to the Committee on [Judiciary]",8,0,0,3,11
1455009,1219933,2022-06-28,Assembly,"Do pass as amended and be re-referred to the Committee on [Appropriations]",8,3,0,0,11
1455011,1036471,2021-03-24,Senate,"Do pass as amended, but first amend, and re-refer to the Committee on [Judiciary]",11,0,0,0,11
1455011,1047535,2021-04-06,Senate,"Do pass as amended, but first amend, and re-refer to the Committee on [Appropriations]",11,0,0,0,11
1455011,1068250,2021-05-03,Senate,"Placed on suspense file",6,0,1,0,7
1455011,1081817,2021-05-20,Senate,"Do pass",7,0,0,0,7
1455011,1087590,2021-05-28,Senate,"Senate 3rd Reading SB507 Eggman et al",38,0,2,0,40
1455011,1100834,2021-06-22,Assembly,"Do pass and be re-referred to the Committee on [Judiciary]",15,0,0,0,15
1455011,1104281,2021-07-06,Assembly,"Do pass",10,0,1,0,11
1455011,1106446,2021-08-23,Assembly,"SB 507 Eggman Senate Third Reading By Quirk-Silva",70,0,0,9,79
1455011,1107206,2021-08-30,Senate,"Unfinished Business SB507 Eggman et al. Concurrence",39,0,0,1,40
1455013,1056427,2021-04-19,Senate,"Do pass as amended, but first amend, and re-refer to the Committee on [Appropriations]",13,0,1,0,14
1455013,1077575,2021-05-13,Senate,"Senate 3rd Reading SB509 Wilk et al. Urgency Clause",38,0,2,0,40
1455013,1104273,2021-07-06,Assembly,"Do pass and be re-referred to the Committee on [Appropriations]",19,0,0,0,19
1455013,1106366,2021-08-19,Assembly,"Do pass. To Consent Calendar",16,0,0,0,16
1455013,1106762,2021-08-26,Assembly,"SB 509 Wilk Consent Calendar Second Day Regular Session",73,0,0,6,79
1455013,1107228,2021-08-30,Senate,"Unfinished Business SB509 Wilk et al. Urgency Clause Concurrence",39,0,0,1,40
1455014,1047439,2021-04-07,Senate,"Do pass as amended, but first amend, and re-refer to the Committee on [Appropriations]",9,1,1,0,11
1455014,1068228,2021-05-03,Senate,"Placed on suspense file",6,0,1,0,7
1455014,1082038,2021-05-20,Senate,"Do pass as amended",5,2,0,0,7
1455014,1089467,2021-06-01,Senate,"Senate 3rd Reading SB510 Pan Urgency Clause",32,7,1,0,40
1455014,1104704,2021-07-13,Assembly,"Do pass as amended and be re-referred to the Committee on [Appropriations]",11,3,1,0,15
1455014,1106983,2021-08-26,Assembly,"Do pass",12,4,0,0,16
1455014,1107668,2021-09-02,Assembly,"SB 510 Pan Third Reading Urgency By Aguiar-Curry",47,18,0,14,79
1455014,1107811,2021-09-03,Assembly,"SB 510 Pan Third Reading Urgency By Aguiar-Curry Amend By AGUIAR-CURRY Set #1",58,19,0,2,79
1455014,1108237,2021-09-09,Assembly,"SB 510 Pan Senate Third Reading By Aguiar-Curry",55,17,0,8,80
1455014,1108601,2021-09-10,Senate,"Unfinished Business SB510 Pan Concurrence",27,8,0,5,40
1455016,1052014,2021-04-13,Senate,"Do pass, but first be re-referred to the Committee on [Appropriations] with the recommendation: To Consent Calendar",16,0,1,0,17
1455016,1068182,2021-05-03,Senate,"Placed on suspense file",6,0,1,0,7
1455016,1081990,2021-05-20,Senate,"Do pass",7,0,0,0,7
1455016,1089463,2021-06-01,Senate,"Special Consent SB512",39,0,1,0,40
1455016,1102802,2021-06-29,Assembly,"Do pass and be re-referred to the Committee on [Human Services]",12,0,0,0,12
1455016,1103491,2021-06-30,Assembly,"Do pass and be re-referred to the Committee on [Appropriations] with recommendation: To Consent Calendar",8,0,0,0,8
1455016,1106761,2021-08-26,Assembly,"Do pass",16,0,0,0,16
1455016,1108413,2021-09-09,Assembly,"SB 512 Min Senate Third Reading By Berman",79,0,0,1,80
1455016,1108650,2021-09-10,Senate,"Unfinished Business SB512 Min et al. Concurrence",37,0,0,3,40
1455017,1120235,2022-01-05,Senate,"Do pass, but first be re-referred to the Committee on [Appropriations]",7,0,0,2,9
1455017,1124826,2022-01-18,Senate,"Placed on suspense file",6,0,0,1,7
1455017,1126275,2022-01-20,Senate,"Do pass",7,0,0,0,7
1455017,1127197,2022-01-24,Senate,"Senate 3rd Reading SB513 Hertzberg",36,0,0,4,40
1455017,1216282,2022-06-15,Assembly,"Do pass and be re-referred to the Committee on [Appropriations]",8,0,0,0,8
1455020,1047444,2021-04-06,Senate,"Do pass as amended, but first amend, and re-refer to the Committee on [Health]",11,0,0,0,11
1455020,1059214,2021-04-21,Senate,"Do pass, but first be re-referred to the Committee on [Appropriations]",10,0,1,0,11
1455020,1075239,2021-05-10,Senate,"Senate 3rd Reading SB516 Eggman et al",34,0,6,0,40
1455022,1057662,2021-04-20,Senate,"Do pass, but first be re-referred to the Committee on [Judiciary]",5,0,0,0,5
1455022,1065256,2021-04-27,Senate,"Do pass, but first be re-referred to the Committee on [Appropriations] with the recommendation: To Consent Calendar",11,0,0,0,11
1455022,1078739,2021-05-17,Senate,"Placed on suspense file",7,0,0,0,7
1455022,1081797,2021-05-20,Senate,"Do pass as amended",7,0,0,0,7
1455022,1122873,2022-01-10,Senate,"Senate 3rd Reading SB518 Laird",31,0,0,9,40
1455022,1220030,2022-06-27,Assembly,"Do pass as amended and be re-referred to the Committee on [Appropriations]",11,0,0,0,11
1455022,1222989,2022-08-03,Assembly,"Do pass",15,0,0,1,16
1455022,1224078,2022-08-15,Assembly,"SB 518 Laird Senate Third Reading By Aguiar-Curry",75,0,0,5,80
1455022,1224136,2022-08-17,Senate,"That the Assembly amendments be concurred in",5,0,0,0,5
1455022,1224172,2022-08-18,Senate,"Unfinished Business SB518 Laird et al. Concurrence",38,0,0,2,40
1455023,1046204,2021-04-06,Senate,"Do pass, but first be re-referred to the Committee on [Health]",4,1,0,0,5
1455023,1053508,2021-04-14,Senate,"Do pass as amended, but first amend, and re-refer to the Committee on [Appropriations]",6,2,3,0,11
1455023,1068211,2021-05-03,Senate,"Placed on suspense file",6,0,1,0,7
1455023,1081625,2021-05-20,Senate,"Do pass as amended",5,2,0,0,7
1455023,1089518,2021-06-01,Senate,"Senate 3rd Reading SB519 Wiener et al",21,16,3,0,40
1455023,1102852,2021-06-29,Assembly,"Do pass as amended and be re-referred to the Committee on [Health]",5,3,0,0,8
1455023,1104684,2021-07-13,Assembly,"Do pass as amended and be re-referred to the Committee on [Appropriations]",8,4,3,0,15
1455023,1223669,2022-08-11,Assembly,"Do pass as amended",9,5,0,2,16
1455024,1029597,2021-03-16,Senate,"Do pass as amended, but first amend, and re-refer to the Committee on [Appropriations]",9,0,0,0,9
1455024,1045021,2021-04-05,Senate,"Do pass",7,0,0,0,7
1455024,1066792,2021-04-29,Senate,"Senate 3rd Reading SB520 Wilk et al",36,0,4,0,40
1455024,1220840,2022-06-28,Assembly,"Do pass and be re-referred to the Committee on [Appropriations]",3,2,0,10,15
1455025,1047540,2021-04-07,Senate,"Do pass as amended, but first amend, and re-refer to the Committee on [Appropriations]",11,0,0,0,11
1455025,1078740,2021-05-17,Senate,"Placed on suspense file",7,0,0,0,7
1455025,1082058,2021-05-20,Senate,"Do pass",7,0,0,0,7
1455025,1089514,2021-06-01,Senate,"Special Consent SB521",39,0,1,0,40
1455025,1100778,2021-06-22,Assembly,"Do pass and be re-referred to the Committee on [Appropriations]",15,0,0,0,15
1455027,1046172,2021-04-05,Senate,"Do pass, but first be re-referred to the Committee on [Health]",4,0,1,0,5
1455027,1065214,2021-04-28,Senate,"Do pass as amended, but first amend, and re-refer to the Committee on [Appropriations]",8,2,1,0,11
1455027,1078813,2021-05-17,Senate,"Placed on suspense file",7,0,0,0,7
1455027,1082136,2021-05-20,Senate,"Do pass",5,2,0,0,7
1455027,1089605,2021-06-01,Senate,"Senate 3rd Reading SB523 Leyva et al",32,5,3,0,40
1455027,1100246,2021-06-22,Assembly,"Do pass and be re-referred to the Committee on [Health]",5,1,1,0,7
1455027,1104351,2021-07-06,Assembly,"Do pass as amended and be re-referred to the Committee on [Appropriations]",11,2,2,0,15
1455027,1223812,2022-08-11,Assembly,"Do pass as amended",13,3,0,0,16
1455027,1225126,2022-08-29,Assembly,"SB 523 Leyva Senate Third Reading By Cristina Garcia",62,11,0,7,80
1455027,1225170,2022-08-30,Senate,"That the Assembly amendments be concurred in",8,2,0,1,11
1455027,1225274,2022-08-31,Senate,"Unfinished Business SB523 Leyva et al. Concurrence",31,9,0,0,40
1455028,1044966,2021-04-05,Senate,"Do pass as amended, but first amend, and re-refer to the Committee on [Health]",11,0,3,0,14
1455028,1065307,2021-04-28,Senate,"Do pass as amended, but first amend, and re-refer to the Committee on [Appropriations]",10,0,1,0,11
1455028,1078790,2021-05-17,Senate,"Placed on suspense file",7,0,0,0,7
1455028,1081779,2021-05-20,Senate,"Do pass",6,0,1,0,7
1455028,1083847,2021-05-24,Senate,"Senate 3rd Reading SB524 Skinner",39,0,1,0,40
1455028,1100808,2021-06-22,Assembly,"Do pass and be re-referred to the Committee on [Business and Professions]",11,1,3,0,15
1455028,1104235,2021-07-06,Assembly,"Do pass as amended and be re-referred to the Committee on [Appropriations]",15,1,3,0,19
1455028,1106839,2021-08-26,Assembly,"Do pass as amended",13,3,0,0,16
1455028,1107675,2021-09-02,Assembly,"SB 524 Skinner Senate Third Reading By Arambula",57,7,0,15,79
1455028,1107774,2021-09-03,Senate,"Unfinished Business SB524 Skinner et al. Concurrence",35,0,0,5,40
1455029,1059299,2021-04-21,Senate,"Do pass, but first be re-referred to the Committee on [Education] with the recommendation: To Consent Calendar",11,0,0,0,11
1455029,1065233,2021-04-28,Senate,"Do pass, but first be re-referred to the Committee on [Appropriations] with the recommendation: To Consent Calendar",7,0,0,0,7
1455029,1075347,2021-05-10,Senate,"Placed on suspense file",7,0,0,0,7
1455032,1025116,2021-03-09,Senate,"Do pass as amended, but first amend, and re-refer to the Committee on [Health]",4,0,0,0,4
1455032,1026096,2021-03-09,Senate,"Do pass, but first be re-referred to the Committee on [Health]",4,0,0,0,4
1455032,1065102,2021-04-28,Senate,"Do pass, but first be re-referred to the Committee on [Appropriations] with the recommendation: To Consent Calendar",11,0,0,0,11
1455032,1075278,2021-05-10,Senate,"Placed on suspense file",7,0,0,0,7
1455032,1082007,2021-05-20,Senate,"Do pass as amended",7,0,0,0,7
1455032,1090369,2021-06-02,Senate,"Senate 3rd Reading SB528 Jones",37,1,2,0,40
1455032,1215920,2022-06-14,Assembly,"Do pass as amended",7,0,0,1,8
1455032,1225128,2022-08-29,Assembly,"SB 528 Jones Senate Third Reading By Villapudua",79,0,0,1,80
1455032,1225528,2022-08-30,Senate,"Unfinished Business SB528 Jones Concurrence",40,0,0,0,40
1455033,1062778,2021-04-26,Senate,"Do pass, but first be re-referred to the Committee on [Appropriations]",14,0,0,0,14
1455033,1077593,2021-05-13,Senate,"Senate 3rd Reading SB529 Hertzberg",38,0,2,0,40
1455033,1216640,2022-06-16,Assembly,"Be re-referred to the Committee on [Utilities and Energy]",8,0,0,3,11
1455033,1220757,2022-06-29,Assembly,"Do pass and be re-referred to the Committee on [Appropriations]",12,0,0,3,15
1455033,1223343,2022-08-10,Assembly,"Do pass",12,2,0,2,16
1455033,1225695,2022-08-31,Senate,"Unfinished Business SB529 Hertzberg Concurrence",31,9,0,0,40
1455033,1225696,2022-08-31,Assembly,"SB 529 Hertzberg Senate Third Reading By Quirk",65,4,0,11,80
1455035,1047486,2021-04-07,Senate,"Do pass as amended, but first amend, and re-refer to the Committee on [Judiciary]",7,2,0,0,9
1455035,1065139,2021-04-27,Senate,"Do pass as amended, but first amend, and re-refer to the Committee on [Appropriations]",9,1,1,0,11
1455035,1077604,2021-05-13,Senate,"Senate 3rd Reading SB531 Wieckowski",29,9,2,0,40
1455035,1102803,2021-06-29,Assembly,"Do pass and be re-referred to the Committee on [Judiciary]",9,0,3,0,12
1455035,1104354,2021-07-06,Assembly,"Do pass as amended and be re-referred to the Committee on [Appropriations]",9,1,1,0,11
1455035,1106305,2021-08-19,Assembly,"Do pass",15,1,0,0,16
1455035,1107210,2021-08-30,Assembly,"SB 531 Wieckowski Senate Third Reading By Gallagher",68,1,0,10,79
1455035,1107420,2021-09-01,Senate,"Unfinished Business SB531 Wieckowski Concurrence",38,0,0,2,40
1455036,1030796,2021-03-17,Senate,"Do pass as amended, but first amend, and re-refer to the Committee on [Appropriations] with the recommendation: To Consent Calendar",7,0,0,0,7
1455036,1056369,2021-04-19,Senate,"Placed on suspense file",7,0,0,0,7
1455036,1081770,2021-05-20,Senate,"Do pass",7,0,0,0,7
1455036,1127189,2022-01-24,Senate,"Senate 3rd Reading SB532 Caballero et al",36,0,0,4,40
1455036,1216650,2022-06-15,Assembly,"Do pass as amended and be re-referred to the Committee on [Appropriations]",6,0,0,1,7
1455036,1224018,2022-08-11,Assembly,"Do pass",16,0,0,0,16
1455036,1224544,2022-08-23,Assembly,"SB 532 Caballero Senate Third Reading By Cooper",77,0,0,3,80
1455036,1225511,2022-08-30,Senate,"Special Consent SB532",38,0,0,2,40
1455037,1056432,2021-04-19,Senate,"Do pass as amended, but first amend, and re-refer to the Committee on [Judiciary]",9,3,2,0,14
1455037,1065295,2021-04-27,Senate,"Do pass as amended, but first amend, and re-refer to the Committee on [Appropriations]",9,2,0,0,11
1455037,1078729,2021-05-17,Senate,"Placed on suspense file",7,0,0,0,7
1455037,1082041,2021-05-20,Senate,"Do pass as amended",5,1,1,0,7
1455037,1090476,2021-06-02,Senate,"Senate 3rd Reading SB533 Stern",36,0,4,0,40
1455037,1103391,2021-06-30,Assembly,"Do pass as amended, and be re-referred to the Committee on [Judiciary] with recommendation: To Consent Calendar",15,0,0,0,15
1455037,1106841,2021-08-26,Assembly,"Do pass",15,1,0,0,16
1455037,1108418,2021-09-09,Assembly,"SB 533 Stern Senate Third Reading By Gabriel",77,0,0,3,80
1455037,1108562,2021-09-10,Senate,"Unfinished Business SB533 Stern By McGuire Concurrence",37,0,0,3,40
1455038,1045007,2021-04-05,Senate,"Do pass, but first be re-referred to the Committee on [Appropriations]",14,0,0,0,14
1455038,1056376,2021-04-19,Senate,"Do pass",7,0,0,0,7
1455038,1074130,2021-05-06,Senate,"Senate 3rd Reading SB534 Jones",37,0,3,0,40
1455038,1100314,2021-06-22,Assembly,"Do pass and be re-referred to the Committee on [Appropriations]",19,0,0,0,19
1455038,1106890,2021-08-26,Assembly,"Do pass as amended",16,0,0,0,16
1455038,1107715,2021-09-02,Assembly,"SB 534 Jones Senate Third Reading By Chen",77,0,0,2,79
1455038,1107826,2021-09-03,Senate,"Unfinished Business SB534 Jones Concurrence",37,0,0,3,40
1455039,1059160,2021-04-21,Senate,"Do pass as amended, but first amend, and re-refer to the Committee on [Appropriations]",11,0,0,0,11
1455039,1075397,2021-05-10,Senate,"Placed on suspense file",7,0,0,0,7
1455039,1081942,2021-05-20,Senate,"Do pass as amended",7,0,0,0,7
1455039,1089508,2021-06-01,Senate,"Senate 3rd Reading SB535 Lim贸n et al",40,0,0,0,40
1455039,1104317,2021-07-06,Assembly,"Do pass as amended and be re-referred to the Committee on [Appropriations]",15,0,0,0,15
1455039,1106714,2021-08-26,Assembly,"Do pass",16,0,0,0,16
1455039,1107738,2021-09-02,Assembly,"SB 535 Lim贸n Senate Third Reading By Lorena Gonzalez",77,0,0,2,79
1455039,1107866,2021-09-07,Senate,"Unfinished Business SB535 Lim贸n et al. Concurrence",37,0,0,3,40
1455041,1057748,2021-04-20,Senate,"Do pass as amended, but first amend, and re-refer to the Committee on [Judiciary]",5,0,0,0,5
1455041,1065176,2021-04-27,Senate,"Do pass as amended, but first amend, and re-refer to the Committee on [Appropriations] with the recommendation: To Consent Calendar",11,0,0,0,11
1455041,1075357,2021-05-10,Senate,"Placed on suspense file",7,0,0,0,7
1455041,1081485,2021-05-20,Senate,"Do pass as amended",7,0,0,0,7
1455042,1047455,2021-04-06,Senate,"Do pass as amended, but first amend, and re-refer to the Committee on [Rules]",11,0,0,0,11
1455042,1064080,2021-04-27,Senate,"Do pass, but first be re-referred to the Committee on [Appropriations] with the recommendation: To Consent Calendar",5,0,0,0,5
1455042,1075271,2021-05-10,Senate,"Placed on suspense file",7,0,0,0,7
1455042,1081496,2021-05-20,Senate,"Do pass as amended",7,0,0,0,7
1455042,1090456,2021-06-02,Senate,"Senate 3rd Reading SB538 Rubio",38,0,2,0,40
1455042,1100295,2021-06-22,Assembly,"Do pass and be re-referred to the Committee on [Public Safety]",9,0,2,0,11
1455042,1102847,2021-06-29,Assembly,"Do pass and be re-referred to the Committee on [Appropriations]",8,0,0,0,8
1455042,1106978,2021-08-26,Assembly,"Do pass",16,0,0,0,16
1455042,1108182,2021-09-08,Assembly,"SB 538 Rubio Senate Third Reading By Blanca Rubio",78,0,0,2,80
1456699,1123303,2022-01-10,Assembly,"Do pass and be re-referred to the Committee on [Appropriations]",8,2,0,1,11
1456699,1126282,2022-01-20,Assembly,"Do pass",12,3,0,1,16
1456699,1127194,2022-01-24,Assembly,"AB 1001 Cristina Garcia Assembly Second Reading Amendment Set #1",48,16,0,12,76
1456699,1131242,2022-01-31,Assembly,"AB 1001 Cristina Garcia Assembly Third Reading",43,24,0,9,76
1456700,1049006,2021-04-08,Assembly,"Do pass and be re-referred to the Committee on [Military and Veterans Affairs]",11,0,1,0,12
1456700,1053564,2021-04-08,Assembly,"Do pass as amended and be re-referred to the Committee on [Military and Veterans Affairs]",11,0,1,0,12
1456700,1065135,2021-04-28,Assembly,"Do pass and be re-referred to the Committee on [Appropriations] with recommendation: To Consent Calendar",11,0,0,0,11
1456700,1076959,2021-05-12,Assembly,"Do pass. To Consent Calendar",16,0,0,0,16
1456700,1081863,2021-05-20,Assembly,"AB 1002 Choi Consent Calendar Second Day Regular Session",76,0,2,0,78
1456700,1098673,2021-06-16,Senate,"Do pass, but first be re-referred to the Committee on [Military and Veterans Affairs] with the recommendation: To Consent Calendar",7,0,0,0,7
1456700,1103473,2021-06-30,Senate,"Do pass, but first be re-referred to the Committee on [Appropriations]",6,0,1,0,7
1456700,1107161,2021-08-30,Senate,"Assembly 3rd Reading AB1002 Choi et al. By Newman",39,0,0,1,40
1456700,1107463,2021-09-01,Assembly,"AB 1002 Choi Concurrence in Senate Amendments",77,0,0,2,79
1456701,1059247,2021-04-20,Assembly,"Do pass as amended and be re-referred to the Committee on [Appropriations]",8,0,0,0,8
1456701,1081668,2021-05-20,Assembly,"Do pass",16,0,0,0,16
1456701,1087034,2021-05-27,Assembly,"AB 1003 Lorena Gonzalez Assembly Third Reading",78,0,0,0,78
1456701,1102836,2021-06-29,Senate,"Do pass, but first be re-referred to the Committee on [Labor, Public Employment and Retirement ]",5,0,0,0,5
1456701,1104624,2021-07-12,Senate,"Do pass, but first be re-referred to the Committee on [Appropriations]",5,0,0,0,5
1456701,1106173,2021-08-16,Senate,"Placed on suspense file",7,0,0,0,7
1456701,1106625,2021-08-26,Senate,"Do pass as amended",7,0,0,0,7
1456701,1108169,2021-09-08,Senate,"Special Consent AB1003",38,0,0,2,40
1456701,1108410,2021-09-09,Assembly,"AB 1003 Lorena Gonzalez Concurrence in Senate Amendments",78,0,0,2,80
1456702,1047525,2021-04-07,Assembly,"Do pass and be re-referred to the Committee on [Appropriations] with recommendation: To Consent Calendar",8,0,0,0,8
1456702,1059344,2021-04-21,Assembly,"Do pass. To Consent Calendar",14,0,2,0,16
1456702,1066736,2021-04-29,Assembly,"AB 1004 Calderon Consent Calendar Second Day Regular Session",77,0,1,0,78
1456702,1095075,2021-06-08,Senate,"Do pass, but first be re-referred to the Committee on [Appropriations]",4,0,1,0,5
1456702,1104225,2021-07-05,Senate,"Assembly 3rd Reading AB1004 Calderon By Hurtado Urgency Clause",38,0,2,0,40
1456704,1047431,2021-04-07,Assembly,"Do pass and be re-referred to the Committee on [Appropriations] with recommendation: To Consent Calendar",8,0,0,0,8
1456705,1047594,2021-04-06,Assembly,"Do pass and be re-referred to the Committee on [Judiciary] with recommendation: To Consent Calendar",8,0,0,0,8
1456705,1051965,2021-04-13,Assembly,"Do pass and be re-referred to the Committee on [Appropriations] with recommendation: To Consent Calendar",11,0,0,0,11
1456705,1081539,2021-05-20,Assembly,"Do pass as amended",16,0,0,0,16
1456705,1092908,2021-06-01,Assembly,"AB 1007 Carrillo Assembly Third Reading",79,0,0,0,79
1456705,1102816,2021-06-29,Senate,"Do pass, but first be re-referred to the Committee on [Judiciary] with the recommendation: To Consent Calendar",5,0,0,0,5
1456705,1104898,2021-07-13,Senate,"Do pass, but first be re-referred to the Committee on [Appropriations]",11,0,0,0,11
1456707,1054682,2021-04-15,Assembly,"Do pass and be re-referred to the Committee on [Appropriations]",10,0,1,0,11
1456707,1082002,2021-05-20,Assembly,"Do pass",16,0,0,0,16
1456707,1087024,2021-05-27,Assembly,"AB 1009 Bloom Assembly Third Reading",75,0,3,0,78
1456707,1103761,2021-07-01,Senate,"Do pass, but first be re-referred to the Committee on [Appropriations]",5,0,0,0,5
1456707,1105111,2021-07-15,Senate,"Placed on suspense file",7,0,0,0,7
1456707,1106938,2021-08-26,Senate,"Do pass as amended",5,0,0,2,7
1456707,1108073,2021-09-08,Senate,"Assembly 3rd Reading AB1009 Bloom By Kamlager",31,2,0,7,40
1456707,1108431,2021-09-09,Assembly,"AB 1009 Bloom Concurrence in Senate Amendments",63,4,0,13,80
1456708,1035227,2021-03-23,Assembly,"Do pass as amended and be re-referred to the Committee on [Appropriations]",17,0,2,0,19
1456708,1053504,2021-04-14,Assembly,"Do pass",15,0,1,0,16
1456708,1056481,2021-04-19,Assembly,"AB 1010 Berman Assembly Third Reading",72,2,5,0,79
1456708,1093688,2021-06-07,Senate,"Do pass as amended, but first amend, and re-refer to the Committee on [Appropriations]",10,1,3,0,14
1456708,1099751,2021-06-21,Senate,"Do pass",5,1,1,0,7
1456708,1107507,2021-09-01,Senate,"Assembly 3rd Reading AB1010 Berman By Becker",31,6,0,3,40
1456708,1107589,2021-09-02,Assembly,"AB 1010 Berman Concurrence in Senate Amendments",71,1,0,7,79
1456710,1054626,2021-04-15,Assembly,"Do pass and be re-referred to the Committee on [Appropriations] with recommendation: To Consent Calendar",11,0,0,0,11
1456712,1057692,2021-04-20,Assembly,"Do pass and be re-referred to the Committee on [Appropriations]",17,0,2,0,19
1456712,1126293,2022-01-20,Assembly,"Do pass as amended",13,1,0,2,16
1456712,1131247,2022-01-31,Assembly,"AB 1014 McCarty Assembly Third Reading",56,6,0,14,76
1456712,1217393,2022-06-20,Senate,"Do pass, but first be re-referred to the Committee on [Labor, Public Employment and Retirement ]",8,4,0,2,14
1456712,1220774,2022-06-29,Senate,"Do pass, but first be re-referred to the Committee on [Appropriations]",4,0,0,1,5
1456712,1223200,2022-08-08,Senate,"Placed on suspense file",7,0,0,0,7
1456712,1223591,2022-08-11,Senate,"Do pass",5,2,0,0,7
1456712,1225670,2022-08-29,Senate,"Assembly 3rd Reading AB1014 McCarty By Wiener",22,8,0,10,40
1456712,1225671,2022-08-29,Senate,"Assembly 3rd Reading AB1014 McCarty By Wiener Reconsider",40,0,0,0,40
1456712,1229704,2022-08-30,Senate,"Assembly 3rd Reading AB1014 McCarty By Wiener",22,8,0,10,40
1456712,1229705,2022-08-30,Senate,"Assembly 3rd Reading AB1014 McCarty By Wiener Reconsider",40,0,0,0,40
1456713,1057701,2021-04-20,Assembly,"Do pass and be re-referred to the Committee on [Appropriations] with recommendation: To Consent Calendar",19,0,0,0,19
1456713,1081635,2021-05-20,Assembly,"Do pass",16,0,0,0,16
1456713,1086942,2021-05-27,Assembly,"AB 1015 Blanca Rubio Assembly Third Reading",78,0,0,0,78
1456713,1104915,2021-07-14,Senate,"Do pass, but first be re-referred to the Committee on [Appropriations]",13,0,1,0,14
1456713,1107871,2021-09-07,Senate,"Assembly 3rd Reading AB1015 Blanca Rubio et al. By Ochoa Bogh",36,0,0,4,40
1456713,1108151,2021-09-08,Assembly,"AB 1015 Blanca Rubio Concurrence in Senate Amendments",79,0,0,1,80
1456715,1065118,2021-04-28,Assembly,"Do pass and be re-referred to the Committee on [Appropriations]",7,1,0,0,8
1456715,1081691,2021-05-20,Assembly,"Do pass as amended",12,3,1,0,16
1456715,1092873,2021-06-01,Assembly,"AB 1017 Quirk-Silva Assembly Third Reading",62,3,14,0,79
1456715,1104567,2021-07-08,Senate,"Do pass as amended, but first amend, and re-refer to the Committee on [Governmental Organization]",4,1,0,0,5
1456715,1106154,2021-08-16,Senate,"Placed on suspense file",7,0,0,0,7
1456718,1046160,2021-04-06,Assembly,"Do pass as amended and be re-referred to the Committee on [Health]",9,2,0,0,11
1456718,1057657,2021-04-20,Assembly,"Do pass and be re-referred to the Committee on [Appropriations]",13,0,2,0,15
1456718,1081432,2021-05-20,Assembly,"Do pass",12,0,4,0,16
1456718,1092899,2021-06-01,Assembly,"AB 1020 Friedman Assembly Third Reading",65,3,11,0,79
1456718,1103413,2021-06-30,Senate,"Do pass, but first be re-referred to the Committee on [Judiciary]",10,0,1,0,11
1456718,1104907,2021-07-13,Senate,"Do pass, but first be re-referred to the Committee on [Appropriations]",9,0,2,0,11
1456718,1106388,2021-08-23,Senate,"Placed on suspense file",7,0,0,0,7
1456718,1106709,2021-08-26,Senate,"Do pass as amended",7,0,0,0,7
1456718,1107594,2021-09-02,Senate,"Assembly 3rd Reading AB1020 Friedman et al. By Umberg",39,0,0,1,40
1456718,1107894,2021-09-07,Assembly,"AB 1020 Friedman Concurrence in Senate Amendments",72,0,0,8,80
1456719,1054661,2021-04-14,Assembly,"Do pass as amended and be re-referred to the Committee on [Appropriations]",8,0,0,0,8
1456719,1081601,2021-05-20,Assembly,"Do pass as amended",12,0,4,0,16
1456719,1092988,2021-06-01,Assembly,"AB 1021 Mayes Assembly Third Reading",73,1,5,0,79
1456719,1104524,2021-07-08,Senate,"Do pass, but first be re-referred to the Committee on [Appropriations]",4,1,0,0,5
1456719,1107495,2021-09-01,Senate,"Assembly 3rd Reading AB1021 Mayes By McGuire Urgency Clause",35,1,0,4,40
1456719,1107691,2021-09-02,Assembly,"AB 1021 Mayes Concurrence - Urgency Added",72,0,0,7,79
1456721,1048912,2021-04-08,Assembly,"Do pass and be re-referred to the Committee on [Appropriations]",7,0,0,0,7
1456721,1081553,2021-05-20,Assembly,"Do pass as amended",16,0,0,0,16
1456721,1092959,2021-06-01,Assembly,"AB 1023 Flora Assembly Third Reading",78,0,1,0,79
1456721,1102445,2021-06-28,Senate,"Do pass, but first be re-referred to the Committee on [Appropriations]",5,0,0,0,5
1456721,1105130,2021-07-15,Senate,"Placed on suspense file",7,0,0,0,7
1456721,1106641,2021-08-26,Senate,"Do pass as amended",5,1,0,1,7
1456721,1108141,2021-09-08,Senate,"Assembly 3rd Reading AB1023 Flora By Ochoa Bogh",33,4,0,3,40
1456721,1108281,2021-09-09,Assembly,"AB 1023 Flora Concurrence in Senate Amendments",78,0,0,2,80
1456722,1047426,2021-04-07,Assembly,"Do pass and be re-referred to the Committee on [Appropriations] with recommendation: To Consent Calendar",9,0,0,0,9
1456722,1081784,2021-05-20,Assembly,"Do pass as amended",16,0,0,0,16
1456722,1092972,2021-06-01,Assembly,"AB 1024 Santiago Assembly Third Reading",79,0,0,0,79
1456722,1102458,2021-06-28,Senate,"Do pass, but first be re-referred to the Committee on [Appropriations] with the recommendation: To Consent Calendar",6,0,1,0,7
1456722,1107245,2021-08-30,Senate,"Consent Calendar AB1024",39,0,0,1,40
1456722,1107423,2021-09-01,Assembly,"AB 1024 Santiago Concurrence in Senate Amendments",77,0,0,2,79
1456724,1057749,2021-04-20,Assembly,"Do pass and be re-referred to the Committee on [Appropriations]",19,0,0,0,19
1456727,1054684,2021-04-15,Assembly,"Do pass and be re-referred to the Committee on [Local Government]",6,1,1,0,8
1456727,1065096,2021-04-28,Assembly,"Do pass and be re-referred to the Committee on [Appropriations]",6,2,0,0,8
1456727,1076953,2021-05-12,Assembly,"Do pass",12,4,0,0,16
1456727,1090449,2021-06-02,Assembly,"AB 1029 Mullin Third Reading Urgency",61,16,2,0,79
1456727,1103785,2021-07-01,Senate,"Do pass, but first be re-referred to the Committee on [Appropriations]",7,1,1,0,9
1456727,1107031,2021-08-26,Senate,"Assembly 3rd Reading AB1029 Mullin et al. By Becker Urgency Clause",27,9,0,4,40
1456727,1107630,2021-09-02,Assembly,"AB 1029 Mullin Concurrence in Senate Amendments",59,17,0,3,79
1456729,1054617,2021-04-15,Assembly,"Do pass and be re-referred to the Committee on [Appropriations]",6,0,1,0,7
1456729,1065104,2021-04-28,Assembly,"Do pass. To Consent Calendar",16,0,0,0,16
1456729,1074182,2021-05-06,Assembly,"AB 1031 Villapudua Consent Calendar Second Day Regular Session",77,0,1,0,78
1456729,1102467,2021-06-28,Senate,"Do pass as amended, but first amend, and re-refer to the Committee on [Appropriations]",5,0,0,0,5
1456729,1106804,2021-08-26,Senate,"Assembly 3rd Reading AB1031 Villapudua et al. By Jones",36,0,0,4,40
1456729,1107473,2021-09-01,Assembly,"AB 1031 Villapudua Concurrence in Senate Amendments",77,0,0,2,79
1456730,1054689,2021-04-15,Assembly,"Do pass and be re-referred to the Committee on [Military and Veterans Affairs]",7,0,0,0,7
1456731,1060973,2021-04-22,Assembly,"Do pass and be re-referred to the Committee on [Judiciary]",7,0,0,0,7
1456731,1064085,2021-04-27,Assembly,"Do pass as amended and be re-referred to the Committee on [Appropriations]",11,0,0,0,11
1456731,1081730,2021-05-20,Assembly,"Do pass",16,0,0,0,16
1456731,1087087,2021-05-27,Assembly,"AB 1033 Bauer-Kahan Assembly Third Reading",78,0,0,0,78
1456731,1103470,2021-06-29,Senate,"Do pass, but first be re-referred to the Committee on [Labor, Public Employment and Retirement ] with the recommendation: To Consent Calendar",11,0,0,0,11
1456731,1104585,2021-07-12,Senate,"Do pass, but first be re-referred to the Committee on [Appropriations] with the recommendation: To Consent Calendar",5,0,0,0,5
1456731,1106066,2021-08-16,Senate,"Placed on suspense file",7,0,0,0,7
1456731,1106860,2021-08-26,Senate,"Do pass as amended",7,0,0,0,7
1456731,1108100,2021-09-08,Senate,"Assembly 3rd Reading AB1033 Bauer-Kahan et al. By Laird",38,0,0,2,40
1456731,1108424,2021-09-09,Assembly,"AB 1033 Bauer-Kahan Concurrence in Senate Amendments",79,0,0,1,80
1456732,1057685,2021-04-20,Assembly,"Do pass",12,0,7,0,19
1456732,1087001,2021-05-27,Assembly,"AB 1034 Bloom Assembly Third Reading",52,5,21,0,78
1456733,1051922,2021-04-12,Assembly,"Do pass and be re-referred to the Committee on [Appropriations]",15,0,0,0,15
1456733,1082010,2021-05-20,Assembly,"Do pass",14,0,2,0,16
1456733,1086991,2021-05-27,Assembly,"AB 1035 Salas Assembly Third Reading",73,0,5,0,78
1456733,1101564,2021-06-24,Senate,"Do pass as amended, but first amend, and re-refer to the Committee on [Appropriations]",15,0,2,0,17
1456733,1105043,2021-07-15,Senate,"Placed on suspense file",7,0,0,0,7
1456733,1106703,2021-08-26,Senate,"Do pass",7,0,0,0,7
1456733,1107874,2021-09-07,Senate,"Assembly 3rd Reading AB1035 Salas et al. By Skinner",37,0,0,3,40
1456733,1108036,2021-09-08,Assembly,"AB 1035 Salas Concurrence in Senate Amendments",79,0,0,1,80
1456734,1064129,2021-04-27,Assembly,"Do pass and be re-referred to the Committee on [Appropriations] with recommendation: To Consent Calendar",6,0,1,0,7
1456734,1082107,2021-05-20,Assembly,"Do pass as amended",16,0,0,0,16
1456734,1092867,2021-06-01,Assembly,"AB 1036 Eduardo Garcia Assembly Third Reading",78,0,1,0,79
1456734,1104946,2021-07-14,Senate,"Do pass, but first be re-referred to the Committee on [Appropriations]",13,0,1,0,14
1456734,1106049,2021-08-16,Senate,"Placed on suspense file",7,0,0,0,7
1456734,1106907,2021-08-26,Senate,"Do pass as amended",7,0,0,0,7
1456734,1108170,2021-09-08,Senate,"Special Consent AB1036",38,0,0,2,40
1456734,1108320,2021-09-09,Assembly,"AB 1036 Eduardo Garcia Concurrence in Senate Amendments",79,0,0,1,80
1456735,1064123,2021-04-27,Assembly,"Do pass as amended and be re-referred to the Committee on [Appropriations]",6,0,1,0,7
1456735,1080423,2021-05-19,Assembly,"Do pass. To Consent Calendar",15,0,1,0,16
1456735,1087036,2021-05-27,Assembly,"AB 1037 Grayson Consent Calendar Second Day Regular Session",75,0,3,0,78
1456735,1104234,2021-07-06,Senate,"Do pass, but first be re-referred to the Committee on [Appropriations] with the recommendation: To Consent Calendar",15,0,0,0,15
1456735,1220780,2022-06-28,Senate,"Do pass, but first be re-referred to the Committee on [Appropriations] with the recommendation: To Consent Calendar",17,0,0,0,17
1456735,1222693,2022-08-01,Senate,"Placed on suspense file",7,0,0,0,7
1456735,1223453,2022-08-11,Senate,"Do pass",7,0,0,0,7
1456735,1224570,2022-08-23,Senate,"Special Consent AB1037",40,0,0,0,40
1456735,1225372,2022-08-30,Assembly,"AB 1037 Grayson Concurrence in Senate Amendments",79,0,0,1,80
1456736,1057638,2021-04-20,Assembly,"Do pass and be re-referred to the Committee on [Appropriations]",14,1,0,0,15
1456736,1081510,2021-05-20,Assembly,"Do pass",15,1,0,0,16
1456736,1092906,2021-06-01,Assembly,"AB 1038 Gipson Assembly Third Reading",73,2,4,0,79
1456736,1104452,2021-07-07,Senate,"Do pass as amended, but first amend, and re-refer to the Committee on [Appropriations]",8,0,3,0,11
1456736,1106103,2021-08-16,Senate,"Placed on suspense file",7,0,0,0,7
1456737,1036460,2021-03-24,Assembly,"Do pass and be re-referred to the Committee on [Appropriations] with recommendation: To Consent Calendar",7,0,0,0,7
1456737,1053539,2021-04-14,Assembly,"Do pass. To Consent Calendar",16,0,0,0,16
1456737,1068233,2021-05-03,Assembly,"AB 1039 Nguyen Assembly Third Reading",77,0,1,0,78
1456737,1096069,2021-06-09,Senate,"Do pass as amended, but first amend, and re-refer to the Committee on [Appropriations] with the recommendation: To Consent Calendar",7,0,0,0,7
1456737,1104192,2021-07-05,Senate,"Placed on suspense file",6,0,1,0,7
1456738,1049029,2021-04-08,Assembly,"Do pass as amended and be re-referred to the Committee on [Appropriations]",7,3,2,0,12
1456738,1081480,2021-05-20,Assembly,"Do pass",10,5,1,0,16
1456738,1087997,2021-05-28,Assembly,"AB 1040 Muratsuchi Assembly Third Reading",51,14,14,0,79
1456739,1048931,2021-04-08,Assembly,"Do pass and be re-referred to the Committee on [Insurance]",5,2,0,0,7
1456739,1081890,2021-05-20,Assembly,"Do pass",12,4,0,0,16
1456739,1087998,2021-05-28,Assembly,"AB 1041 Wicks Assembly Third Reading",53,16,10,0,79
1456739,1100306,2021-06-21,Senate,"Do pass, but first be re-referred to the Committee on [Appropriations]",4,1,0,0,5
1456739,1104165,2021-07-05,Senate,"Placed on suspense file",6,0,1,0,7
1456739,1106792,2021-08-26,Senate,"Do pass",5,2,0,0,7
1456739,1224734,2022-08-24,Senate,"Assembly 3rd Reading AB1041 Wicks et al. By Laird",31,7,0,2,40
1456739,1225028,2022-08-25,Assembly,"AB 1041 Wicks Concurrence in Senate Amendments",58,15,0,7,80
1456740,1051916,2021-04-13,Assembly,"Do pass and be re-referred to the Committee on [Appropriations]",12,2,1,0,15
1456740,1065076,2021-04-28,Assembly,"Do pass",12,4,0,0,16
1456740,1083798,2021-05-24,Assembly,"AB 1042 Jones-Sawyer Assembly Third Reading",58,16,4,0,78
1456740,1103385,2021-06-30,Senate,"Do pass as amended, but first amend, and re-refer to the Committee on [Appropriations]",9,1,1,0,11
1456740,1107643,2021-09-02,Senate,"Assembly 3rd Reading AB1042 Jones-Sawyer et al. By Rubio",30,9,0,1,40
1456740,1107644,2021-09-02,Senate,"Assembly 3rd Reading AB1042 Jones-Sawyer et al. By Rubio Reconsider",39,0,0,1,40
1456740,1108262,2021-09-09,Senate,"Assembly 3rd Reading AB1042 Jones-Sawyer et al. By Rubio",29,9,0,2,40
1456740,1108263,2021-09-09,Assembly,"AB 1042 JONES-SAWYER Concurrence in Senate Amendments",58,16,0,6,80
1456741,1067606,2021-04-29,Assembly,"Do pass as amended and be re-referred to the Committee on [Appropriations]",6,2,0,0,8
1456741,1076942,2021-05-12,Assembly,"Do pass",12,4,0,0,16
1456741,1091718,2021-06-03,Assembly,"AB 1043 Bryan Assembly Third Reading",60,17,2,0,79
1456741,1104577,2021-07-08,Senate,"Do pass, but first be re-referred to the Committee on [Appropriations]",9,0,0,0,9
1456741,1107517,2021-09-01,Senate,"Assembly 3rd Reading AB1043 Bryan et al. By Allen",39,0,0,1,40
1456743,1122858,2022-01-10,Assembly,"Do pass and be re-referred to the Committee on [Appropriations] with recommendation: To Consent Calendar",14,0,0,1,15
1456744,1051877,2021-04-13,Assembly,"Do pass and be re-referred to the Committee on [Appropriations] with recommendation: To Consent Calendar",15,0,0,0,15
1456744,1082018,2021-05-20,Assembly,"Do pass as amended",16,0,0,0,16
1456744,1092935,2021-06-01,Assembly,"AB 1046 Blanca Rubio Assembly Third Reading",77,0,2,0,79
1456745,1045014,2021-04-05,Assembly,"Do pass and be re-referred to the Committee on [Appropriations] with recommendation: To Consent Calendar",14,0,1,0,15
1456746,1066789,2021-04-29,Assembly,"Do pass",7,0,0,0,7
1456746,1090493,2021-06-02,Assembly,"AB 1048 Cooper Assembly Third Reading",77,0,2,0,79
1456746,1104611,2021-07-12,Senate,"Do pass and be ordered to the Consent Calendar",5,0,0,0,5
1456746,1107249,2021-08-30,Senate,"Consent Calendar AB1048 Cooper",39,0,0,1,40
1456748,1064046,2021-04-27,Assembly,"Do pass and be re-referred to the Committee on [Appropriations]",15,0,0,0,15
1456749,1047538,2021-04-07,Assembly,"Do pass and be re-referred to the Committee on [Health] with recommendation: To Consent Calendar",8,0,0,0,8
1456749,1057654,2021-04-20,Assembly,"Do pass and be re-referred to the Committee on [Appropriations] with recommendation: To Consent Calendar",15,0,0,0,15
1456749,1081809,2021-05-20,Assembly,"Do pass",16,0,0,0,16
1456749,1087999,2021-05-28,Assembly,"AB 1051 Bennett Assembly Third Reading",77,0,2,0,79
1456749,1101658,2021-06-23,Senate,"Do pass as amended, but first amend, and re-refer to the Committee on [Human Services] with the recommendation: To Consent Calendar",11,0,0,0,11
1456749,1102491,2021-06-23,Senate,"Do pass, but first be re-referred to the Committee on [Human Services] with the recommendation: To Consent Calendar",11,0,0,0,11
1456749,1104427,2021-07-06,Senate,"Do pass, but first be re-referred to the Committee on [Appropriations] with the recommendation: To Consent Calendar",5,0,0,0,5
1456749,1106102,2021-08-16,Senate,"Placed on suspense file",7,0,0,0,7
1456749,1106900,2021-08-26,Senate,"Do pass as amended",7,0,0,0,7
1456749,1225713,2022-08-31,Senate,"Special Consent AB1051",40,0,0,0,40
1456749,1225714,2022-08-31,Assembly,"AB 1051 Bennett Concurrence in Senate Amendments",80,0,0,0,80
1456753,1049017,2021-04-07,Assembly,"Do pass as amended and be re-referred to the Committee on [Human Services]",7,0,0,0,7
1456753,1059265,2021-04-21,Assembly,"Do pass as amended, and be re-referred to the Committee on [Appropriations] with recommendation: To Consent Calendar",8,0,0,0,8
1456753,1082034,2021-05-20,Assembly,"Do pass",16,0,0,0,16
1456753,1088000,2021-05-28,Assembly,"AB 1055 Ramos Assembly Third Reading",77,0,2,0,79
1456753,1100820,2021-06-23,Senate,"Do pass, but first be re-referred to the Committee on [Human Services] with the recommendation: To Consent Calendar",7,0,0,0,7
1456753,1104426,2021-07-06,Senate,"Do pass, but first be re-referred to the Committee on [Appropriations] with the recommendation: To Consent Calendar",5,0,0,0,5
1456753,1106200,2021-08-16,Senate,"Placed on suspense file",7,0,0,0,7
1456753,1106874,2021-08-26,Senate,"Do pass",7,0,0,0,7
1456753,1108676,2021-09-10,Senate,"Assembly 3rd Reading AB1055 Ramos et al. By Umberg",37,0,0,3,40
1456753,1108677,2021-09-10,Assembly,"AB 1055 RAMOS Concurrence in Senate Amendments",72,0,0,8,80
1456755,1059203,2021-04-20,Assembly,"Do pass and be re-referred to the Committee on [Appropriations] with recommendation: To Consent Calendar",8,0,0,0,8
1456755,1073418,2021-05-05,Assembly,"Do pass. To Consent Calendar",16,0,0,0,16
1456755,1077521,2021-05-13,Assembly,"AB 1057 Petrie-Norris Consent Calendar Second Day Regular Session",75,0,3,0,78
1456755,1104697,2021-07-13,Senate,"Do pass, but first be re-referred to the Committee on [Appropriations] with the recommendation: To Consent Calendar",5,0,0,0,5
1456755,1106101,2021-08-16,Senate,"Placed on suspense file",7,0,0,0,7
1456755,1106949,2021-08-26,Senate,"Do pass as amended",7,0,0,0,7
1456755,1107872,2021-09-07,Senate,"Assembly 3rd Reading AB1057 Petrie-Norris et al. By Min",36,0,0,4,40
1456755,1108136,2021-09-08,Assembly,"AB 1057 Petrie-Norris Concurrence in Senate Amendments",75,0,0,5,80
1456756,1047496,2021-04-07,Assembly,"Do pass as amended and be re-referred to the Committee on [Appropriations]",15,0,0,0,15
1456756,1059268,2021-04-21,Assembly,"Do pass. To Consent Calendar",14,0,2,0,16
1456756,1066833,2021-04-29,Assembly,"AB 1058 Cristina Garcia Consent Calendar Second Day Regular Session",77,0,1,0,78
1456756,1097796,2021-06-14,Senate,"Do pass, but first be re-referred to the Committee on [Appropriations]",11,0,1,0,12
1456756,1107247,2021-08-30,Senate,"Assembly 3rd Reading AB1058 Cristina Garcia By Dodd",39,0,0,1,40
1456756,1107520,2021-09-01,Assembly,"AB 1058 Cristina Garcia Concurrence in Senate Amendments",78,0,0,1,79
1456758,1057738,2021-04-19,Assembly,"Do pass. To Consent Calendar",6,0,1,0,7
1456759,1068194,2021-05-03,Assembly,"Do pass as amended",7,0,1,0,8
1456759,1077571,2021-05-13,Assembly,"AB 1061 Lee Assembly Third Reading",48,4,26,0,78
1456759,1100787,2021-06-22,Senate,"Do pass as amended",9,1,1,0,11
1456759,1106072,2021-08-16,Senate,"Assembly 3rd Reading AB1061 Lee et al. By Wiener",27,5,0,8,40
1456759,1106399,2021-08-23,Assembly,"AB 1061 Lee Concurrence in Senate Amendments",47,3,0,29,79
1456760,1072249,2021-05-04,Assembly,"Do pass as amended",11,0,0,0,11
1456760,1083848,2021-05-24,Assembly,"AB 1062 Mathis Assembly Third Reading",76,0,2,0,78
1456762,1065103,2021-04-27,Assembly,"Do pass and be re-referred to the Committee on [Appropriations] with recommendation: To Consent Calendar",19,0,0,0,19
1456762,1080447,2021-05-19,Assembly,"Do pass. To Consent Calendar",15,0,1,0,16
1456762,1086965,2021-05-27,Assembly,"AB 1064 Fong Consent Calendar Second Day Regular Session",75,0,3,0,78
1456762,1104650,2021-07-12,Senate,"Do pass, but first be re-referred to the Committee on [Appropriations]",13,0,1,0,14
1456762,1107519,2021-09-01,Senate,"Assembly 3rd Reading AB1064 Fong By Roth",39,0,0,1,40
1456762,1107577,2021-09-02,Assembly,"AB 1064 Fong Concurrence in Senate Amendments",76,0,0,3,79
1456763,1046104,2021-04-05,Assembly,"Do pass and be re-referred to the Committee on [Appropriations]",10,0,1,0,11
1456763,1059216,2021-04-21,Assembly,"Do pass. To Consent Calendar",14,0,2,0,16
1456763,1068288,2021-05-03,Assembly,"AB 1065 Maienschein Assembly Third Reading",77,0,1,0,78
1456763,1097033,2021-06-10,Senate,"Do pass, but first be re-referred to the Committee on [Appropriations] with the recommendation: To Consent Calendar",5,0,0,0,5
1456763,1101618,2021-06-24,Senate,"Consent Calendar AB1065",39,0,1,0,40
1456764,1059152,2021-04-21,Assembly,"Do pass and be re-referred to the Committee on [Appropriations]",6,2,1,0,9
1456764,1081497,2021-05-20,Assembly,"Do pass as amended",12,3,1,0,16
1456764,1091676,2021-06-03,Assembly,"AB 1066 Bloom Assembly Third Reading",63,11,5,0,79
1456764,1104450,2021-07-07,Senate,"Do pass, but first be re-referred to the Committee on [Appropriations]",6,0,1,0,7
1456764,1106234,2021-08-16,Senate,"Placed on suspense file",7,0,0,0,7
1456764,1106946,2021-08-26,Senate,"Do pass",7,0,0,0,7
1456764,1107410,2021-09-01,Senate,"Assembly 3rd Reading AB1066 Bloom et al. By Allen",36,1,0,3,40
1456764,1107617,2021-09-02,Assembly,"AB 1066 Bloom Concurrence in Senate Amendments",63,2,0,14,79
1456765,1123339,2022-01-10,Assembly,"Do pass as amended and be re-referred to the Committee on [Appropriations]",8,1,0,2,11
1456765,1126302,2022-01-20,Assembly,"Do pass",12,3,0,1,16
1456765,1129872,2022-01-27,Assembly,"AB 1067 Ting Assembly Third Reading",53,15,0,8,76
1456765,1211942,2022-06-01,Senate,"Do pass, but first be re-referred to the Committee on [Appropriations]",5,0,0,2,7
1456765,1217099,2022-06-20,Senate,"Placed on suspense file",4,0,0,3,7
1456768,1060975,2021-04-22,Assembly,"Do pass as amended and be re-referred to the Committee on [Appropriations]",20,0,2,0,22
1456768,1081453,2021-05-20,Assembly,"Do pass as amended",16,0,0,0,16
1456768,1092840,2021-06-01,Assembly,"AB 1070 Cooper Assembly Third Reading",79,0,0,0,79
1456768,1104331,2021-07-06,Senate,"Do pass, but first be re-referred to the Committee on [Appropriations]",15,0,0,0,15
1456768,1106458,2021-08-23,Senate,"Placed on suspense file",7,0,0,0,7
1456768,1106736,2021-08-26,Senate,"Do pass",7,0,0,0,7
1456768,1107815,2021-09-03,Senate,"Special Consent AB1070",37,0,0,3,40
1456769,1045026,2021-04-05,Assembly,"Do pass. To Consent Calendar",7,0,0,0,7
1456769,1081795,2021-05-20,Assembly,"Do pass",16,0,0,0,16
1456769,1090366,2021-06-02,Assembly,"AB 1071 Rodriguez Third Reading Urgency",78,0,1,0,79
1456769,1104266,2021-07-06,Senate,"Do pass, but first be re-referred to the Committee on [Appropriations] with the recommendation: To Consent Calendar",15,0,0,0,15
1456769,1105045,2021-07-15,Senate,"Placed on suspense file",7,0,0,0,7
1456770,1064020,2021-04-27,Assembly,"Do pass and be re-referred to the Committee on [Appropriations] with recommendation: To Consent Calendar",6,0,1,0,7
1456770,1081676,2021-05-20,Assembly,"Do pass as amended",16,0,0,0,16
1456770,1092961,2021-06-01,Assembly,"AB 1072 Reyes Assembly Third Reading",79,0,0,0,79
1456770,1103475,2021-06-30,Senate,"Do pass, but first be re-referred to the Committee on [Governmental Organization] with the recommendation: To Consent Calendar",13,0,1,0,14
1456770,1104318,2021-07-06,Senate,"Do pass, but first be re-referred to the Committee on [Appropriations] with the recommendation: To Consent Calendar",15,0,0,0,15
1456770,1223165,2022-08-08,Senate,"Placed on suspense file",7,0,0,0,7
1456771,1048934,2021-04-08,Assembly,"Do pass and be re-referred to the Committee on [Appropriations]",12,0,0,0,12
1456772,1060857,2021-04-22,Assembly,"Do pass and be re-referred to the Committee on [Appropriations]",5,2,0,0,7
1456772,1073382,2021-05-05,Assembly,"Do pass",12,4,0,0,16
1456772,1091729,2021-06-03,Assembly,"AB 1074 Lorena Gonzalez Assembly Third Reading",49,20,10,0,79
1456772,1104185,2021-07-05,Senate,"Do pass as amended, but first amend, and re-refer to the Committee on [Appropriations]",4,1,0,0,5
1456772,1108624,2021-09-10,Senate,"Assembly 3rd Reading AB1074 Lorena Gonzalez et a By Durazo",23,12,0,5,40
1456772,1108625,2021-09-10,Assembly,"AB 1074 Lorena Gonzalez Concurrence in Senate Amendments By CARRILLO",51,19,0,10,80
1456774,1056373,2021-04-19,Assembly,"Do pass and be re-referred to the Committee on [Privacy and Consumer Protection] with recommendation: To Consent Calendar",15,0,0,0,15
1456774,1060821,2021-04-22,Assembly,"Do pass and be re-referred to the Committee on [Appropriations] with recommendation: To Consent Calendar",11,0,0,0,11
1456776,1123312,2022-01-10,Assembly,"Do pass and be re-referred to the Committee on [Appropriations]",7,0,0,4,11
1456776,1126294,2022-01-20,Assembly,"Do pass. To Consent Calendar",15,0,0,1,16
1456776,1129870,2022-01-27,Assembly,"AB 1078 Patterson Consent Calendar Second Day Regular Session",61,0,0,15,76
1456776,1210928,2022-05-31,Senate,"Do pass as amended, but first amend, and re-refer to the Committee on [Appropriations]",8,0,0,6,14
1456776,1224240,2022-08-18,Senate,"Assembly 3rd Reading AB1078 Patterson et al. By Dahle",29,4,0,7,40
1456776,1224401,2022-08-23,Assembly,"AB 1078 Patterson Concurrence in Senate Amendments",67,0,0,13,80
1456777,1046130,2021-04-06,Assembly,"Do pass as amended. To Consent Calendar",11,0,0,0,11
1456777,1054709,2021-04-15,Assembly,"AB 1079 Gallagher Consent Calendar Second Day",75,0,3,0,78
1456777,1100791,2021-06-22,Senate,"Do pass and be ordered to the Consent Calendar",11,0,0,0,11
1456777,1104181,2021-07-05,Senate,"Consent Calendar AB1079",38,0,2,0,40
1456777,1106401,2021-08-23,Assembly,"AB 1079 Gallagher Concurrence in Senate Amendments",71,0,0,8,79
1456780,1035214,2021-03-23,Assembly,"Do pass and be re-referred to the Committee on [Appropriations] with recommendation: To Consent Calendar",15,0,0,0,15
1456780,1081594,2021-05-20,Assembly,"Do pass",16,0,0,0,16
1456780,1086952,2021-05-27,Assembly,"AB 1082 Waldron Assembly Third Reading",77,0,1,0,78
1456780,1098649,2021-06-16,Senate,"Do pass, but first be re-referred to the Committee on [Appropriations] with the recommendation: To Consent Calendar",10,0,1,0,11
1456780,1104213,2021-07-05,Senate,"Placed on suspense file",6,0,1,0,7
1456780,1106640,2021-08-26,Senate,"Do pass",7,0,0,0,7
1456780,1107780,2021-09-03,Senate,"Special Consent AB1082",37,0,0,3,40
1456781,1057617,2021-04-20,Assembly,"Do pass and be re-referred to the Committee on [Appropriations] with recommendation: To Consent Calendar",7,0,0,0,7
1456782,1046193,2021-04-06,Assembly,"Do pass and be re-referred to the Committee on [Judiciary]",11,4,4,0,19
1456782,1064140,2021-04-27,Assembly,"Do pass as amended and be re-referred to the Committee on [Appropriations]",7,3,1,0,11
1456782,1081456,2021-05-20,Assembly,"Do pass",10,4,2,0,16
1456782,1092931,2021-06-01,Assembly,"AB 1084 Low Assembly Third Reading",51,18,10,0,79
1456782,1103388,2021-06-30,Senate,"Do pass as amended, but first amend, and re-refer to the Committee on [Judiciary]",8,3,3,0,14
1456782,1104924,2021-07-13,Senate,"Do pass, but first be re-referred to the Committee on [Appropriations]",9,2,0,0,11
1456782,1106218,2021-08-16,Senate,"Placed on suspense file",7,0,0,0,7
1456782,1106732,2021-08-26,Senate,"Do pass",5,2,0,0,7
1456782,1107395,2021-09-01,Senate,"Assembly 3rd Reading AB1084 Low et al. By Wiener",29,9,0,2,40
1456782,1107721,2021-09-02,Assembly,"AB 1084 Low Concurrence in Senate Amendments",49,16,0,14,79
1456783,1054723,2021-04-14,Assembly,"Do pass and be re-referred to the Committee on [Appropriations] with recommendation: To Consent Calendar",8,0,0,0,8
1456783,1081924,2021-05-20,Assembly,"Do pass",16,0,0,0,16
1456783,1092845,2021-06-01,Assembly,"AB 1085 Bigelow Assembly Third Reading",79,0,0,0,79
1456783,1101587,2021-06-24,Senate,"Do pass, but first be re-referred to the Committee on [Appropriations] with the recommendation: To Consent Calendar",5,0,0,0,5
1456783,1104178,2021-07-05,Senate,"Placed on suspense file",6,0,1,0,7
1456784,1036540,2021-03-24,Assembly,"Do pass as amended and be re-referred to the Committee on [Appropriations]",10,0,1,0,11
1456784,1081490,2021-05-20,Assembly,"Do pass",16,0,0,0,16
1456784,1088001,2021-05-28,Assembly,"AB 1086 Aguiar-Curry Assembly Third Reading",77,0,2,0,79
1456784,1103749,2021-07-01,Senate,"Do pass as amended, but first amend, and re-refer to the Committee on [Natural Resources and Water]",7,0,0,0,7
1456784,1106238,2021-08-16,Senate,"Placed on suspense file",7,0,0,0,7
1456785,1047480,2021-04-07,Assembly,"Do pass as amended and be re-referred to the Committee on [Natural Resources]",8,3,4,0,15
1456785,1065234,2021-04-28,Assembly,"Do pass and be re-referred to the Committee on [Appropriations]",8,3,0,0,11
1456787,1054726,2021-04-15,Assembly,"Do pass and be re-referred to the Committee on [Privacy and Consumer Protection]",10,0,2,0,12
1456787,1060864,2021-04-22,Assembly,"Do pass as amended and be re-referred to the Committee on [Appropriations]",8,1,2,0,11
1456788,1067627,2021-04-29,Assembly,"Do pass and be re-referred to the Committee on [Appropriations]",7,1,0,0,8
1456789,1073375,2021-05-05,Assembly,"Do pass",7,0,1,0,8
1456791,1124166,2022-01-13,Assembly,"Do pass and be re-referred to the Committee on [Appropriations]",9,0,0,1,10
1456791,1126341,2022-01-20,Assembly,"Do pass",12,0,0,4,16
1456791,1129891,2022-01-27,Assembly,"AB 1093 Jones-Sawyer Assembly Third Reading",56,4,0,16,76
1456792,1052028,2021-04-13,Assembly,"Do pass and be re-referred to the Committee on [Judiciary] with recommendation: To Consent Calendar",15,0,0,0,15
1456792,1064011,2021-04-27,Assembly,"Do pass and be re-referred to the Committee on [Appropriations] with recommendation: To Consent Calendar",11,0,0,0,11
1456792,1081494,2021-05-20,Assembly,"Do pass",16,0,0,0,16
1456792,1090368,2021-06-02,Assembly,"AB 1094 Arambula Assembly Third Reading",76,0,3,0,79
1456792,1103492,2021-06-30,Senate,"Do pass, but first be re-referred to the Committee on [Judiciary]",10,0,1,0,11
1456792,1104984,2021-07-13,Senate,"Do pass, but first be re-referred to the Committee on [Appropriations] with the recommendation: To Consent Calendar",11,0,0,0,11
1456792,1106059,2021-08-16,Senate,"Placed on suspense file",7,0,0,0,7
1456792,1106750,2021-08-26,Senate,"Do pass",7,0,0,0,7
1456792,1107513,2021-09-01,Senate,"Assembly 3rd Reading AB1094 Arambula et al. By Eggman",39,0,0,1,40
1456792,1107700,2021-09-02,Assembly,"AB 1094 Arambula Concurrence in Senate Amendments",71,0,0,8,79
1456793,1067612,2021-04-29,Assembly,"Do pass and be re-referred to the Committee on [Appropriations] with recommendation: To Consent Calendar",8,0,0,0,8
1456793,1076972,2021-05-12,Assembly,"Do pass. To Consent Calendar",16,0,0,0,16
1456793,1081673,2021-05-20,Assembly,"AB 1095 Cooley Consent Calendar Second Day Regular Session",76,0,2,0,78
1456793,1099112,2021-06-17,Senate,"Do pass, but first be re-referred to the Committee on [Appropriations] with the recommendation: To Consent Calendar",8,0,1,0,9
1456793,1104193,2021-07-05,Senate,"Placed on suspense file",6,0,1,0,7
1456793,1106808,2021-08-26,Senate,"Do pass as amended",7,0,0,0,7
1456793,1108144,2021-09-08,Senate,"Assembly 3rd Reading AB1095 Cooley By Caballero",38,0,0,2,40
1456793,1108429,2021-09-09,Assembly,"AB 1095 Cooley Concurrence in Senate Amendments By BERMAN",79,0,0,1,80
1456794,1046218,2021-04-06,Assembly,"Do pass as amended",11,0,0,0,11
1456794,1082024,2021-05-20,Assembly,"AB 1096 Luz Rivas Assembly Third Reading",71,0,7,0,78
1456794,1098138,2021-06-15,Senate,"Do pass",8,2,1,0,11
1456794,1108200,2021-09-08,Senate,"Assembly 3rd Reading AB1096 Luz Rivas et al. By Durazo",30,8,0,2,40
1456794,1108236,2021-09-09,Assembly,"AB 1096 Luz Rivas Concurrence in Senate Amendments",73,0,0,7,80
1456796,1051953,2021-04-13,Assembly,"Do pass and be re-referred to the Committee on [Appropriations]",15,0,0,0,15
1456798,1054710,2021-04-14,Assembly,"Do pass and be re-referred to the Committee on [Emergency Management]",10,2,1,0,13
1456798,1057741,2021-04-19,Assembly,"Do pass and be re-referred to the Committee on [Appropriations]",5,2,0,0,7
1456798,1081719,2021-05-20,Assembly,"Do pass",12,4,0,0,16
1456798,1088002,2021-05-28,Assembly,"AB 1100 Aguiar-Curry Assembly Third Reading",57,18,4,0,79
1456798,1102453,2021-06-28,Senate,"Do pass as amended, but first amend, and re-refer to the Committee on [Judiciary]",11,2,1,0,14
1456798,1104982,2021-07-13,Senate,"Do pass, but first be re-referred to the Committee on [Appropriations]",9,1,1,0,11
1456798,1106133,2021-08-16,Senate,"Placed on suspense file",7,0,0,0,7
1456799,1067634,2021-04-29,Assembly,"Do pass and be re-referred to the Committee on [Judiciary]",7,0,1,0,8
1456799,1072214,2021-05-04,Assembly,"Do pass",10,0,1,0,11
1456799,1083868,2021-05-24,Assembly,"AB 1101 Irwin Assembly Third Reading",75,0,3,0,78
1456799,1099129,2021-06-17,Senate,"Do pass, but first be re-referred to the Committee on [Judiciary]",8,0,1,0,9
1456799,1103357,2021-06-29,Senate,"Do pass as amended",11,0,0,0,11
1456799,1106130,2021-08-16,Senate,"Assembly 3rd Reading AB1101 Irwin By Min",39,0,0,1,40
1456799,1106395,2021-08-23,Assembly,"AB 1101 Irwin Concurrence in Senate Amendments",70,0,0,9,79
1456800,1035151,2021-03-23,Assembly,"Do pass",17,0,2,0,19
1456800,1048961,2021-04-08,Assembly,"AB 1102 Low Consent Calendar Second Day",74,0,4,0,78
1456800,1104618,2021-07-12,Senate,"Do pass and be ordered to the Consent Calendar",14,0,0,0,14
1456800,1225309,2022-08-30,Senate,"Assembly 3rd Reading AB1102 Low By Pan",40,0,0,0,40
1456800,1225310,2022-08-31,Assembly,"AB 1102 Low Concurrence in Senate Amendments",79,0,0,1,80
1456801,1054635,2021-04-15,Assembly,"Do pass and be re-referred to the Committee on [Emergency Management]",11,0,0,0,11
1456801,1057650,2021-04-19,Assembly,"Do pass as amended and be re-referred to the Committee on [Appropriations]",7,0,0,0,7
1456801,1082194,2021-05-20,Assembly,"Do pass as amended",16,0,0,0,16
1456801,1087041,2021-05-27,Assembly,"AB 1103 Megan Dahle Assembly Third Reading",77,0,1,0,78
1456801,1099155,2021-06-17,Senate,"Do pass, but first be re-referred to the Committee on [Governmental Organization] with the recommendation: To Consent Calendar",4,0,1,0,5
1456801,1104333,2021-07-06,Senate,"Do pass, but first be re-referred to the Committee on [Appropriations]",15,0,0,0,15
1456801,1105049,2021-07-15,Senate,"Placed on suspense file",7,0,0,0,7
1456801,1106863,2021-08-26,Senate,"Do pass as amended",7,0,0,0,7
1456801,1108619,2021-09-10,Senate,"Assembly 3rd Reading AB1103 Megan Dahle et al. By Caballero",37,0,0,3,40
1456801,1108620,2021-09-10,Assembly,"AB 1103 Megan Dahle Concurrence in Senate Amendments",77,0,0,3,80
1456802,1046157,2021-04-06,Assembly,"Do pass as amended and be re-referred to the Committee on [Appropriations]",15,0,0,0,15
1456802,1081895,2021-05-20,Assembly,"Do pass as amended",16,0,0,0,16
1456802,1092929,2021-06-01,Assembly,"AB 1104 Grayson Third Reading Urgency",79,0,0,0,79
1456802,1103494,2021-06-30,Senate,"Do pass as amended, but first amend, and re-refer to the Committee on [Public Safety]",10,0,1,0,11
1456802,1104781,2021-07-13,Senate,"Do pass, but first be re-referred to the Committee on [Appropriations]",5,0,0,0,5
1456802,1106113,2021-08-16,Senate,"Placed on suspense file",7,0,0,0,7
1456802,1106738,2021-08-26,Senate,"Do pass",7,0,0,0,7
1456802,1107477,2021-09-01,Senate,"Assembly 3rd Reading AB1104 Grayson By Pan Urgency Clause",39,0,0,1,40
1456802,1107591,2021-09-02,Assembly,"AB 1104 Grayson Concurrence in Senate Amendments",77,0,0,2,79
1456803,1060831,2021-04-22,Assembly,"Do pass and be re-referred to the Committee on [Appropriations]",5,1,1,0,7
1456803,1081804,2021-05-20,Assembly,"Do pass as amended",12,4,0,0,16
1456803,1090409,2021-06-02,Assembly,"AB 1105 Rodriguez Assembly Third Reading",59,11,9,0,79
1456803,1102465,2021-06-28,Senate,"Do pass as amended, but first amend, and re-refer to the Committee on [Appropriations]",4,1,0,0,5
1456803,1105091,2021-07-15,Senate,"Placed on suspense file",7,0,0,0,7
1456804,1064156,2021-04-27,Assembly,"Do pass as amended and be re-referred to the Committee on [Appropriations]",6,0,1,0,7
1456804,1082231,2021-05-20,Assembly,"Do pass",16,0,0,0,16
1456804,1088003,2021-05-28,Assembly,"AB 1106 Cervantes Assembly Third Reading",77,0,2,0,79
1456804,1099720,2021-06-21,Senate,"Do pass, but first be re-referred to the Committee on [Labor, Public Employment and Retirement ]",11,0,3,0,14
1456804,1104198,2021-07-05,Senate,"Do pass, but first be re-referred to the Committee on [Appropriations]",5,0,0,0,5
1456804,1105060,2021-07-15,Senate,"Placed on suspense file",7,0,0,0,7
1456808,1064052,2021-04-27,Assembly,"Do pass as amended and be re-referred to the Committee on [Appropriations]",6,0,1,0,7
1456808,1081524,2021-05-20,Assembly,"Do pass",16,0,0,0,16
1456808,1090394,2021-06-02,Assembly,"AB 1110 Robert Rivas Assembly Third Reading",74,0,5,0,79
1456808,1103405,2021-06-30,Senate,"Do pass, but first be re-referred to the Committee on [Governmental Organization]",13,0,1,0,14
1456808,1104289,2021-07-06,Senate,"Do pass as amended, but first amend, and re-refer to the Committee on [Appropriations]",14,0,1,0,15
1456808,1106166,2021-08-16,Senate,"Placed on suspense file",7,0,0,0,7
1456808,1106788,2021-08-26,Senate,"Do pass as amended",7,0,0,0,7
1456808,1108162,2021-09-08,Senate,"Special Consent AB1110",38,0,0,2,40
1456809,1060920,2021-04-22,Assembly,"Do pass and be re-referred to the Committee on [Appropriations]",12,0,0,0,12
1456809,1082067,2021-05-20,Assembly,"Do pass",16,0,0,0,16
1456809,1086974,2021-05-27,Assembly,"AB 1111 Berman Assembly Third Reading",78,0,0,0,78
1456809,1104473,2021-07-07,Senate,"Do pass, but first be re-referred to the Committee on [Appropriations]",7,0,0,0,7
1456809,1106152,2021-08-16,Senate,"Placed on suspense file",7,0,0,0,7
1456809,1107014,2021-08-26,Senate,"Do pass as amended",7,0,0,0,7
1456809,1107997,2021-09-08,Senate,"Special Consent AB1111",38,0,0,2,40
1456809,1108435,2021-09-09,Assembly,"AB 1111 Berman Concurrence in Senate Amendments",79,0,0,1,80
1456810,1048952,2021-04-07,Assembly,"Do pass as amended, and be re-referred to the Committee on [Appropriations] with recommendation: To Consent Calendar",7,0,0,0,7
1456810,1065162,2021-04-28,Assembly,"Do pass. To Consent Calendar",16,0,0,0,16
1456810,1074195,2021-05-06,Assembly,"AB 1112 Carrillo Consent Calendar Second Day Regular Session",77,0,1,0,78
1456810,1104903,2021-07-14,Senate,"Do pass as amended, but first amend, and re-refer to the Committee on [Appropriations] with the recommendation: To Consent Calendar",7,0,0,0,7
1456810,1106146,2021-08-16,Senate,"Placed on suspense file",7,0,0,0,7
1456811,1048978,2021-04-08,Assembly,"Do pass and be re-referred to the Committee on [Appropriations]",11,0,1,0,12
1456811,1082140,2021-05-20,Assembly,"Do pass",16,0,0,0,16
1456811,1092842,2021-06-01,Assembly,"AB 1113 Medina Assembly Third Reading",79,0,0,0,79
1456811,1103448,2021-06-30,Senate,"Do pass, but first be re-referred to the Committee on [Appropriations] with the recommendation: To Consent Calendar",7,0,0,0,7
1456811,1105127,2021-07-15,Senate,"Placed on suspense file",7,0,0,0,7
1456811,1106921,2021-08-26,Senate,"Do pass as amended",7,0,0,0,7
1456811,1108028,2021-09-08,Senate,"Assembly 3rd Reading AB1113 Medina et al. By Laird",37,0,0,3,40
1456811,1108298,2021-09-09,Assembly,"AB 1113 Medina Concurrence in Senate Amendments",78,0,0,2,80
1456812,1051990,2021-04-13,Assembly,"Do pass as amended and be re-referred to the Committee on [Arts, Entertainment, Sports, Tourism, and Internet Media]",7,3,1,0,11
1456816,1060903,2021-04-22,Assembly,"Do pass and be re-referred to the Committee on [Appropriations]",8,1,3,0,12
1456817,1048890,2021-04-08,Assembly,"Do pass and be re-referred to the Committee on [Judiciary]",5,2,0,0,7
1456817,1057620,2021-04-20,Assembly,"Do pass as amended and be re-referred to the Committee on [Appropriations]",8,2,1,0,11
1456818,1123307,2022-01-11,Assembly,"Do pass and be re-referred to the Committee on [Appropriations]",13,0,0,5,18
1456818,1126300,2022-01-20,Assembly,"Do pass",14,0,0,2,16
1456818,1129882,2022-01-27,Assembly,"AB 1120 Irwin Assembly Third Reading",52,2,0,22,76
1456818,1215816,2022-06-13,Senate,"Do pass",12,0,0,2,14
1456818,1224813,2022-08-24,Senate,"Assembly 3rd Reading AB1120 Irwin By Dodd",36,0,0,4,40
1456818,1225086,2022-08-29,Assembly,"AB 1120 Irwin Concurrence in Senate Amendments",60,7,0,13,80
1456821,1057659,2021-04-19,Assembly,"Do pass and be re-referred to the Committee on [Appropriations]",7,0,0,0,7
1456821,1081449,2021-05-20,Assembly,"Do pass",16,0,0,0,16
1456822,1073378,2021-05-05,Assembly,"Do pass",8,0,0,0,8
1456822,1083786,2021-05-24,Assembly,"AB 1124 Friedman Assembly Third Reading",70,0,8,0,78
1456822,1099154,2021-06-17,Senate,"Do pass as amended",5,0,0,0,5
1456822,1107220,2021-08-30,Senate,"Assembly 3rd Reading AB1124 Friedman By McGuire",33,3,0,4,40
1456822,1107464,2021-09-01,Assembly,"AB 1124 Friedman Concurrence in Senate Amendments",71,0,0,8,79
1456824,1065190,2021-04-28,Assembly,"Do pass and be re-referred to the Committee on [Appropriations]",7,0,0,0,7
1456824,1081994,2021-05-20,Assembly,"Do pass",15,0,1,0,16
1456824,1088004,2021-05-28,Assembly,"AB 1126 Bloom Assembly Third Reading",68,0,11,0,79
1456824,1100333,2021-06-22,Senate,"Do pass as amended, but first amend, and re-refer to the Committee on [Judiciary]",10,4,1,0,15
1456824,1104382,2021-07-06,Senate,"Do pass, but first be re-referred to the Committee on [Appropriations]",9,2,0,0,11
1456824,1106064,2021-08-16,Senate,"Placed on suspense file",7,0,0,0,7
1456824,1107006,2021-08-26,Senate,"Do pass as amended",5,2,0,0,7
1456824,1107706,2021-09-02,Senate,"Assembly 3rd Reading AB1126 Bloom et al. By Allen",33,4,0,3,40
1456824,1108123,2021-09-08,Assembly,"AB 1126 Bloom Concurrence in Senate Amendments",70,0,0,10,80
1456825,1065273,2021-04-27,Assembly,"Do pass as amended and be re-referred to the Committee on [Appropriations]",6,2,0,0,8
1456825,1081821,2021-05-20,Assembly,"Do pass",11,4,1,0,16
1456828,1046165,2021-04-06,Assembly,"Do pass as amended and be re-referred to the Committee on [Appropriations]",12,0,3,0,15
1456828,1081466,2021-05-20,Assembly,"Do pass as amended",12,2,2,0,16
1456828,1091717,2021-06-03,Assembly,"AB 1130 Wood Assembly Third Reading",51,14,14,0,79
1456828,1092850,2021-06-01,Assembly,"AB 1130 Wood Assembly Third Reading Amendment Set #1",57,13,9,0,79
1456829,1046182,2021-04-06,Assembly,"Do pass and be re-referred to the Committee on [Appropriations]",13,1,1,0,15
1456830,1064047,2021-04-27,Assembly,"Do pass as amended and be re-referred to the Committee on [Appropriations]",15,0,0,0,15
1456830,1081653,2021-05-20,Assembly,"Do pass",16,0,0,0,16
1456830,1092939,2021-06-01,Assembly,"AB 1132 Wood Assembly Third Reading",79,0,0,0,79
1456833,1067623,2021-04-29,Assembly,"Do pass and be re-referred to the Committee on [Appropriations]",8,0,0,0,8
1456834,1054705,2021-04-15,Assembly,"Do pass and be re-referred to the Committee on [Appropriations] with recommendation: To Consent Calendar",12,0,0,0,12
1456835,1054656,2021-04-15,Assembly,"Do pass as amended and be re-referred to the Committee on [Appropriations]",6,1,0,0,7
1456835,1082134,2021-05-20,Assembly,"Do pass as amended",12,4,0,0,16
1456835,1090437,2021-06-02,Assembly,"AB 1137 Mullin Assembly Third Reading",60,17,2,0,79
1456836,1035235,2021-03-23,Assembly,"Do pass and be re-referred to the Committee on [Judiciary]",17,0,2,0,19
1456836,1057708,2021-04-20,Assembly,"Do pass as amended and be re-referred to the Committee on [Appropriations]",10,0,1,0,11
1456836,1081848,2021-05-20,Assembly,"Do pass",16,0,0,0,16
1456836,1088005,2021-05-28,Assembly,"AB 1138 Blanca Rubio Assembly Third Reading",75,0,4,0,79
1456836,1104393,2021-07-06,Senate,"Do pass as amended, but first amend, and re-refer to the Committee on [Business, Professions and Economic Development]",11,0,0,0,11
1456836,1104969,2021-07-14,Senate,"Do pass as amended, but first amend, and re-refer to the Committee on [Appropriations]",13,0,1,0,14
1456836,1106074,2021-08-16,Senate,"Placed on suspense file",7,0,0,0,7
1456836,1106781,2021-08-26,Senate,"Do pass",7,0,0,0,7
1456836,1108300,2021-09-09,Senate,"Assembly 3rd Reading AB1138 Blanca Rubio et al. By Archuleta",38,0,0,2,40
1456836,1108301,2021-09-09,Assembly,"AB 1138 RUBIO Concurrence in Senate Amendments",78,0,0,2,80
1456837,1059248,2021-04-21,Assembly,"Do pass as amended and be re-referred to the Committee on [Appropriations]",12,0,3,0,15
1456837,1081442,2021-05-20,Assembly,"Do pass",10,4,2,0,16
1456837,1090492,2021-06-02,Assembly,"AB 1139 Lorena Gonzalez Assembly Third Reading",27,27,25,0,79
1456838,1047581,2021-04-07,Assembly,"Do pass and be re-referred to the Committee on [Judiciary] with recommendation: To Consent Calendar",8,0,0,0,8
1456838,1051901,2021-04-13,Assembly,"Do pass. To Consent Calendar",11,0,0,0,11
1456838,1056482,2021-04-19,Assembly,"AB 1140 Robert Rivas Consent Calendar Second Day Regular Session",78,0,1,0,79
1456838,1095073,2021-06-08,Senate,"Do pass, but first be re-referred to the Committee on [Judiciary] with the recommendation: To Consent Calendar",5,0,0,0,5
1456838,1104917,2021-07-13,Senate,"Do pass and be ordered to the Consent Calendar",11,0,0,0,11
1456838,1108579,2021-09-10,Senate,"Assembly 3rd Reading AB1140 Robert Rivas By Durazo",37,0,0,3,40
1456838,1108580,2021-09-10,Assembly,"AB 1140 RIVAS, R. Concurrence in Senate Amendments",75,0,0,5,80
1456841,1051946,2021-04-13,Assembly,"Do pass",10,0,1,0,11
1456841,1056483,2021-04-19,Assembly,"AB 1143 Berman Assembly Third Reading",77,0,2,0,79
1456841,1100765,2021-06-22,Senate,"Do pass and be ordered to the Consent Calendar",11,0,0,0,11
1456841,1104175,2021-07-05,Senate,"Consent Calendar AB1143",38,0,2,0,40
1456841,1106445,2021-08-23,Assembly,"AB 1143 Berman Concurrence in Senate Amendments",71,0,0,8,79
1456842,1064022,2021-04-27,Assembly,"Do pass as amended and be re-referred to the Committee on [Appropriations]",15,0,0,0,15
1456842,1076962,2021-05-12,Assembly,"Do pass. To Consent Calendar",16,0,0,0,16
1456842,1082123,2021-05-20,Assembly,"AB 1144 Robert Rivas Consent Calendar Second Day Regular Session",76,0,2,0,78
1456842,1104396,2021-07-07,Senate,"Do pass, but first be re-referred to the Committee on [Appropriations]",9,0,2,0,11
1456842,1107180,2021-08-30,Senate,"Assembly 3rd Reading AB1144 Robert Rivas By Eggman",39,0,0,1,40
1456842,1107497,2021-09-01,Assembly,"AB 1144 Robert Rivas Concurrence in Senate Amendments",78,0,0,1,79
1456844,1052010,2021-04-13,Assembly,"Do pass as amended and be re-referred to the Committee on [Revenue and Taxation]",7,0,0,0,7
1456844,1123341,2022-01-10,Assembly,"Do pass and be re-referred to the Committee on [Appropriations]",9,0,0,2,11
1456845,1044985,2021-04-05,Assembly,"Do pass and be re-referred to the Committee on [Natural Resources]",10,3,2,0,15
1456845,1053584,2021-04-14,Assembly,"Do pass and be re-referred to the Committee on [Appropriations]",8,3,0,0,11
1456845,1081500,2021-05-20,Assembly,"Do pass",12,4,0,0,16
1456845,1088006,2021-05-28,Assembly,"AB 1147 Friedman Assembly Third Reading",56,19,4,0,79
1456845,1103762,2021-07-01,Senate,"Do pass, but first be re-referred to the Committee on [Transportation]",5,2,0,0,7
1456845,1104742,2021-07-13,Senate,"Do pass, but first be re-referred to the Committee on [Appropriations]",11,4,2,0,17
1456845,1106456,2021-08-23,Senate,"Placed on suspense file",7,0,0,0,7
1456845,1106991,2021-08-26,Senate,"Do pass",5,2,0,0,7
1456845,1107382,2021-09-01,Senate,"Assembly 3rd Reading AB1147 Friedman et al",29,10,0,1,40
1456845,1107581,2021-09-02,Assembly,"AB 1147 Friedman Concurrence in Senate Amendments",57,17,0,5,79
1456846,1054601,2021-04-15,Assembly,"Do pass and be re-referred to the Committee on [Appropriations] with recommendation: To Consent Calendar",13,0,0,0,13
1456846,1065194,2021-04-28,Assembly,"Do pass. To Consent Calendar",16,0,0,0,16
1456846,1074164,2021-05-06,Assembly,"AB 1148 Daly Consent Calendar Second Day Regular Session",77,0,1,0,78
1456847,1060884,2021-04-22,Assembly,"Do pass as amended and be re-referred to the Committee on [Appropriations]",19,0,3,0,22
1456847,1076927,2021-05-12,Assembly,"Do pass. To Consent Calendar",16,0,0,0,16
1456847,1082112,2021-05-20,Assembly,"AB 1149 Villapudua Consent Calendar Second Day Regular Session",76,0,2,0,78
1456847,1100250,2021-06-22,Senate,"Do pass, but first be re-referred to the Committee on [Appropriations] with the recommendation: To Consent Calendar",15,0,0,0,15
1456847,1107165,2021-08-30,Senate,"Consent Calendar AB1149 Villapudua Urgency Clause",39,0,0,1,40
1456847,1107472,2021-09-01,Assembly,"AB 1149 Villapudua Concurrence - Urgency Added",78,0,0,1,79
1456848,1049011,2021-04-08,Assembly,"Do pass and be re-referred to the Committee on [Appropriations] with recommendation: To Consent Calendar",22,0,0,0,22
1456848,1080396,2021-05-19,Assembly,"Do pass. To Consent Calendar",15,0,1,0,16
1456848,1087009,2021-05-27,Assembly,"AB 1150 Frazier Consent Calendar Second Day Regular Session",75,0,3,0,78
1456848,1100326,2021-06-22,Senate,"Do pass, but first be re-referred to the Committee on [Appropriations] with the recommendation: To Consent Calendar",15,0,0,0,15
1456849,1045010,2021-04-05,Assembly,"Do pass and be re-referred to the Committee on [Appropriations] with recommendation: To Consent Calendar",14,0,1,0,15
1456852,1123287,2022-01-10,Assembly,"Do pass as amended and be re-referred to the Committee on [Appropriations]",10,1,0,0,11
1456852,1126330,2022-01-20,Assembly,"Do pass",14,1,0,1,16
1456852,1129959,2022-01-27,Assembly,"AB 1154 Patterson Assembly Third Reading",60,2,0,14,76
1456852,1211943,2022-06-01,Senate,"Do pass as amended, but first amend, and re-refer to the Committee on [Appropriations]",6,0,0,1,7
1456852,1222668,2022-08-01,Senate,"Placed on suspense file",7,0,0,0,7
1456853,1048917,2021-04-08,Assembly,"Do pass and be re-referred to the Committee on [Appropriations] with recommendation: To Consent Calendar",22,0,0,0,22
1456853,1080406,2021-05-19,Assembly,"Do pass. To Consent Calendar",15,0,1,0,16
1456854,1059272,2021-04-21,Assembly,"Do pass and be re-referred to the Committee on [Appropriations] with recommendation: To Consent Calendar",15,0,0,0,15
1456854,1081734,2021-05-20,Assembly,"Do pass",16,0,0,0,16
1456854,1092834,2021-06-01,Assembly,"AB 1156 Holden Assembly Third Reading",79,0,0,0,79
1456855,1044947,2021-04-05,Assembly,"Do pass and be re-referred to the Committee on [Appropriations] with recommendation: To Consent Calendar",14,0,1,0,15
1456855,1059201,2021-04-21,Assembly,"Do pass. To Consent Calendar",14,0,2,0,16
1456855,1066749,2021-04-29,Assembly,"AB 1157 Lee Consent Calendar Second Day Regular Session",77,0,1,0,78
1456855,1098153,2021-06-15,Senate,"Do pass, but first be re-referred to the Committee on [Appropriations] with the recommendation: To Consent Calendar",17,0,0,0,17
1456855,1107264,2021-08-30,Senate,"Consent Calendar AB1157",39,0,0,1,40
1456856,1051963,2021-04-13,Assembly,"Do pass and be re-referred to the Committee on [Insurance]",15,0,0,0,15
1456856,1066811,2021-04-29,Assembly,"Do pass and be re-referred to the Committee on [Appropriations] with recommendation: To Consent Calendar",13,0,0,0,13
1456856,1081862,2021-05-20,Assembly,"Do pass as amended",16,0,0,0,16
1456856,1092981,2021-06-01,Assembly,"AB 1158 Petrie-Norris Assembly Third Reading",75,0,4,0,79
1456856,1103446,2021-06-30,Senate,"Do pass, but first be re-referred to the Committee on [Insurance]",10,0,1,0,11
1456856,1104508,2021-07-08,Senate,"Do pass as amended, but first amend, and re-refer to the Committee on [Appropriations]",10,0,2,0,12
1456856,1106175,2021-08-16,Senate,"Placed on suspense file",7,0,0,0,7
1456856,1106713,2021-08-26,Senate,"Do pass as amended",7,0,0,0,7
1456856,1108552,2021-09-10,Senate,"Assembly 3rd Reading AB1158 Petrie-Norris By Bates",37,0,0,3,40
1456856,1108553,2021-09-10,Assembly,"AB 1158 Petrie-Norris Concurrence in Senate Amendments",76,0,0,4,80
1456860,1057682,2021-04-20,Assembly,"Do pass as amended and be re-referred to the Committee on [Appropriations]",13,1,1,0,15
1456862,1064045,2021-04-26,Assembly,"Do pass as amended and be re-referred to the Committee on [Appropriations]",15,0,0,0,15
1456862,1076931,2021-05-12,Assembly,"Do pass. To Consent Calendar",16,0,0,0,16
1456862,1081843,2021-05-20,Assembly,"AB 1164 Flora Consent Calendar Second Day Regular Session",76,0,2,0,78
1456862,1211946,2022-06-01,Senate,"Do pass, but first be re-referred to the Committee on [Appropriations]",4,1,0,4,9
1456862,1211947,2022-06-01,Senate,"[Final] hearing set for [06-01-2022]: Failed passage in Committee. Reconsideration granted",7,0,0,2,9
1456862,1219898,2022-06-28,Senate,"Do pass, but first be re-referred to the Committee on [Appropriations]",6,0,0,3,9
1456862,1224713,2022-08-24,Senate,"Assembly 3rd Reading AB1164 Flora By Caballero",32,7,0,1,40
1456862,1225151,2022-08-30,Assembly,"With recommendation: That Senate amendments be concurred in",12,0,0,3,15
1456862,1225821,2022-08-31,Assembly,"AB 1164 Flora Concurrence in Senate Amendments",76,1,0,3,80
1456863,1065262,2021-04-27,Assembly,"Do pass and be re-referred to the Committee on [Appropriations]",6,2,0,0,8
1456863,1126304,2022-01-20,Assembly,"Do pass as amended",11,3,0,2,16
1456865,1060832,2021-04-22,Assembly,"Do pass and be re-referred to the Committee on [Appropriations] with recommendation: To Consent Calendar",21,0,1,0,22
1456867,1064012,2021-04-27,Assembly,"Do pass as amended, and be re-referred to the Committee on [Appropriations] with recommendation: To Consent Calendar",15,0,0,0,15
1456868,1049023,2021-04-08,Assembly,"Do pass and be re-referred to the Committee on [Appropriations] with recommendation: To Consent Calendar",22,0,0,0,22
1456868,1059262,2021-04-21,Assembly,"Do pass. To Consent Calendar",14,0,2,0,16
1456868,1066810,2021-04-29,Assembly,"AB 1170 Bigelow Consent Calendar Second Day Regular Session",77,0,1,0,78
1456869,1065218,2021-04-27,Assembly,"Do pass. To Consent Calendar",6,0,1,0,7
1456869,1086961,2021-05-27,Assembly,"Do pass and be re-referred to the Committee on [Appropriations]",8,0,0,0,8
1456869,1089540,2021-06-01,Assembly,"Do pass",10,0,6,0,16
1456869,1091689,2021-06-03,Assembly,"AB 1171 Cristina Garcia Assembly Third Reading",74,0,5,0,79
1456869,1104708,2021-07-13,Senate,"Do pass as amended, but first amend, and re-refer to the Committee on [Appropriations]",5,0,0,0,5
1456869,1106204,2021-08-16,Senate,"Placed on suspense file",7,0,0,0,7
1456869,1106650,2021-08-26,Senate,"Do pass as amended",7,0,0,0,7
1456869,1107883,2021-09-07,Senate,"Assembly 3rd Reading AB1171 Cristina Garcia et a By Eggman",37,0,0,3,40
1456869,1107996,2021-09-08,Assembly,"AB 1171 Cristina Garcia Concurrence in Senate Amendments",79,0,0,1,80
1456870,1066751,2021-04-29,Assembly,"Do pass as amended and be re-referred to the Committee on [Appropriations]",11,0,1,0,12
1456870,1080415,2021-05-19,Assembly,"Do pass. To Consent Calendar",15,0,1,0,16
1456870,1086963,2021-05-27,Assembly,"AB 1172 O'Donnell Consent Calendar Second Day Regular Session",75,0,3,0,78
1456871,1048899,2021-04-08,Assembly,"Do pass and be re-referred to the Committee on [Appropriations] with recommendation: To Consent Calendar",22,0,0,0,22
1456871,1076941,2021-05-12,Assembly,"Do pass. To Consent Calendar",16,0,0,0,16
1456871,1081836,2021-05-20,Assembly,"AB 1173 Cooper Consent Calendar Second Day Regular Session",76,0,2,0,78
1456871,1104330,2021-07-06,Senate,"Do pass, but first be re-referred to the Committee on [Appropriations]",15,0,0,0,15
1456871,1107857,2021-09-07,Senate,"Assembly 3rd Reading AB1173 Cooper By Dodd",37,0,0,3,40
1456871,1108508,2021-09-10,Assembly,"With recommendation: That Senate amendments be concurred in",19,0,0,3,22
1456871,1108618,2021-09-10,Assembly,"AB 1173 Cooper Concurrence in Senate Amendments",78,0,0,2,80
1456872,1054645,2021-04-15,Assembly,"Do pass and be re-referred to the Committee on [Local Government]",8,0,0,0,8
1456872,1065318,2021-04-28,Assembly,"Do pass and be re-referred to the Committee on [Appropriations]",7,0,1,0,8
1456872,1076965,2021-05-12,Assembly,"Do pass. To Consent Calendar",16,0,0,0,16
1456872,1083791,2021-05-24,Assembly,"AB 1174 Grayson Assembly Third Reading",71,0,7,0,78
1456872,1103816,2021-07-01,Senate,"Do pass, but first be re-referred to the Committee on [Governance and Finance]",8,0,1,0,9
1456872,1104526,2021-07-08,Senate,"Do pass as amended, but first amend, and re-refer to the Committee on [Appropriations]",5,0,0,0,5
1456872,1107456,2021-09-01,Senate,"Assembly 3rd Reading AB1174 Grayson By Umberg Urgency Clause",37,0,0,3,40
1456872,1107707,2021-09-02,Assembly,"AB 1174 Grayson Concurrence - Urgency Added",74,0,0,5,79
1456874,1065246,2021-04-28,Assembly,"Do pass and be re-referred to the Committee on [Appropriations]",8,3,2,0,13
1456875,1066765,2021-04-29,Assembly,"Do pass as amended and be re-referred to the Committee on [Appropriations]",7,4,1,0,12
1456875,1081624,2021-05-20,Assembly,"Do pass as amended",12,4,0,0,16
1456875,1090435,2021-06-02,Assembly,"AB 1177 Santiago Assembly Third Reading",48,24,7,0,79
1456875,1100832,2021-06-23,Senate,"Do pass as amended, but first amend, and re-refer to the Committee on [Labor, Public Employment and Retirement ]",7,2,0,0,9
1456875,1104145,2021-07-05,Senate,"Do pass as amended, but first amend, and re-refer to the Committee on [Appropriations]",4,1,0,0,5
1456875,1106070,2021-08-16,Senate,"Placed on suspense file",7,0,0,0,7
1456875,1106658,2021-08-26,Senate,"Do pass as amended",5,2,0,0,7
1456875,1108050,2021-09-08,Senate,"Assembly 3rd Reading AB1177 Santiago et al. By Hueso",29,9,0,2,40
1456875,1108293,2021-09-09,Assembly,"AB 1177 Santiago Concurrence in Senate Amendments",51,24,0,5,80
1456876,1057625,2021-04-20,Assembly,"Do pass as amended and be re-referred to the Committee on [Appropriations]",15,0,0,0,15
1456877,1060919,2021-04-22,Assembly,"Do pass and be re-referred to the Committee on [Appropriations]",5,2,0,0,7
1456878,1073411,2021-05-05,Assembly,"Do pass",8,0,0,0,8
1456878,1083818,2021-05-24,Assembly,"AB 1180 Mathis Assembly Third Reading",75,0,3,0,78
1456878,1099111,2021-06-17,Senate,"Do pass and be ordered to the Consent Calendar",5,0,0,0,5
1456878,1101642,2021-06-24,Senate,"Consent Calendar AB1180",39,0,1,0,40
1456881,1064024,2021-04-26,Assembly,"Do pass and be re-referred to the Committee on [Appropriations]",11,4,0,0,15
1456881,1082175,2021-05-20,Assembly,"Do pass",12,3,1,0,16
1456881,1090452,2021-06-02,Assembly,"AB 1183 Ramos Assembly Third Reading",59,13,7,0,79
1456881,1104525,2021-07-08,Senate,"Do pass as amended, but first amend, and re-refer to the Committee on [Appropriations]",7,0,2,0,9
1456881,1106114,2021-08-16,Senate,"Placed on suspense file",7,0,0,0,7
1456881,1106710,2021-08-26,Senate,"Do pass",5,1,0,1,7
1456881,1107654,2021-09-02,Senate,"Assembly 3rd Reading AB1183 Ramos By Roth",30,6,0,4,40
1456881,1107895,2021-09-07,Assembly,"AB 1183 Ramos Concurrence in Senate Amendments",53,14,0,13,80
1456882,1051968,2021-04-13,Assembly,"Do pass and be re-referred to the Committee on [Privacy and Consumer Protection]",11,3,1,0,15
1456882,1060897,2021-04-22,Assembly,"Do pass and be re-referred to the Committee on [Appropriations]",9,1,1,0,11
1456882,1073385,2021-05-05,Assembly,"Do pass",13,3,0,0,16
1456882,1077600,2021-05-13,Assembly,"AB 1184 Chiu Assembly Third Reading",59,13,6,0,78
1456882,1104429,2021-07-07,Senate,"Do pass, but first be re-referred to the Committee on [Judiciary]",8,1,2,0,11
1456882,1104880,2021-07-13,Senate,"Do pass as amended, but first amend, and re-refer to the Committee on [Appropriations]",9,2,0,0,11
1456882,1108006,2021-09-08,Senate,"Assembly 3rd Reading AB1184 Chiu et al. By Leyva",29,8,0,3,40
1456882,1108412,2021-09-09,Assembly,"AB 1184 Chiu Concurrence in Senate Amendments",61,14,0,5,80
1456883,1060816,2021-04-22,Assembly,"Do pass and be re-referred to the Committee on [Appropriations]",12,0,0,0,12
1456883,1081758,2021-05-20,Assembly,"Do pass",16,0,0,0,16
1456883,1087074,2021-05-27,Assembly,"AB 1185 Cervantes Third Reading Urgency",78,0,0,0,78
1456883,1103359,2021-06-30,Senate,"Do pass as amended, but first amend, and re-refer to the Committee on [Appropriations] with the recommendation: To Consent Calendar",7,0,0,0,7
1456883,1104149,2021-06-30,Senate,"Do pass, but first be re-referred to the Committee on [Appropriations] with the recommendation: To Consent Calendar",7,0,0,0,7
1456883,1106177,2021-08-16,Senate,"Placed on suspense file",7,0,0,0,7
1456883,1106895,2021-08-26,Senate,"Do pass as amended",7,0,0,0,7
1456883,1108174,2021-09-08,Senate,"Special Consent AB1185 Cervantes et al. By Glazer Urgency Clause",38,0,0,2,40
1456883,1108318,2021-09-09,Assembly,"AB 1185 Cervantes Concurrence in Senate Amendments",79,0,0,1,80
1456885,1123316,2022-01-11,Assembly,"Do pass and be re-referred to the Committee on [Appropriations]",12,0,0,0,12
1456885,1126351,2022-01-20,Assembly,"Do pass",15,0,0,1,16
1456885,1127180,2022-01-24,Assembly,"AB 1187 Irwin Assembly Third Reading",66,0,0,10,76
1456885,1211941,2022-06-01,Senate,"Do pass, but first be re-referred to the Committee on [Appropriations]",6,0,0,1,7
1456885,1215570,2022-06-13,Senate,"Placed on suspense file",7,0,0,0,7
1456885,1223460,2022-08-11,Senate,"Do pass as amended",7,0,0,0,7
1456885,1224740,2022-08-24,Senate,"Assembly 3rd Reading AB1187 Irwin By Wilk",40,0,0,0,40
1456885,1225118,2022-08-29,Assembly,"AB 1187 Irwin Concurrence in Senate Amendments",79,0,0,1,80
1456886,1067625,2021-04-29,Assembly,"Do pass as amended and be re-referred to the Committee on [Appropriations]",5,1,2,0,8
1456888,1064033,2021-04-26,Assembly,"Do pass and be re-referred to the Committee on [Appropriations] with recommendation: To Consent Calendar",15,0,0,0,15
1456888,1080397,2021-05-19,Assembly,"Do pass. To Consent Calendar",15,0,1,0,16
1456888,1087063,2021-05-27,Assembly,"AB 1190 Mayes Consent Calendar Second Day Regular Session",75,0,3,0,78
1456889,1059271,2021-04-20,Assembly,"Do pass and be re-referred to the Committee on [Appropriations]",8,0,0,0,8
1456889,1082073,2021-05-20,Assembly,"Do pass",16,0,0,0,16
1456889,1090469,2021-06-02,Assembly,"AB 1191 McCarty Assembly Third Reading",69,0,10,0,79
1456889,1104691,2021-07-13,Senate,"Do pass, but first be re-referred to the Committee on [Appropriations]",5,0,0,0,5
1456889,1106080,2021-08-16,Senate,"Placed on suspense file",7,0,0,0,7
1456889,1106549,2021-08-26,Senate,"Do pass as amended",7,0,0,0,7
1456889,1107659,2021-09-02,Senate,"Assembly 3rd Reading AB1191 McCarty et al. By Portantino",37,1,0,2,40
1456889,1107896,2021-09-07,Assembly,"AB 1191 McCarty Concurrence in Senate Amendments",65,0,0,15,80
1456890,1060923,2021-04-22,Assembly,"Do pass and be re-referred to the Committee on [Appropriations]",5,2,0,0,7
1456890,1082168,2021-05-20,Assembly,"Do pass",12,4,0,0,16
1456892,1051915,2021-04-13,Assembly,"Do pass and be re-referred to the Committee on [Judiciary]",17,0,2,0,19
1456892,1064076,2021-04-27,Assembly,"Do pass as amended and be re-referred to the Committee on [Appropriations]",11,0,0,0,11
1456892,1081878,2021-05-20,Assembly,"Do pass",15,0,1,0,16
1456892,1088007,2021-05-28,Assembly,"AB 1194 Low Assembly Third Reading",76,0,3,0,79
1456892,1100836,2021-06-22,Senate,"Do pass as amended, but first amend, and re-refer to the Committee on [Business, Professions and Economic Development]",11,0,0,0,11
1456892,1104643,2021-07-12,Senate,"Do pass, but first be re-referred to the Committee on [Appropriations]",14,0,0,0,14
1456892,1106145,2021-08-16,Senate,"Placed on suspense file",7,0,0,0,7
1456892,1106786,2021-08-26,Senate,"Do pass as amended",7,0,0,0,7
1456892,1108210,2021-09-08,Senate,"Assembly 3rd Reading AB1194 Low et al. By Allen",38,0,0,2,40
1456892,1108292,2021-09-09,Assembly,"AB 1194 Low Concurrence in Senate Amendments",76,0,0,4,80
1456893,1059291,2021-04-21,Assembly,"Do pass and be re-referred to the Committee on [Local Government]",6,0,3,0,9
1456893,1065201,2021-04-28,Assembly,"Do pass and be re-referred to the Committee on [Appropriations]",6,1,1,0,8
1456893,1081436,2021-05-20,Assembly,"Do pass as amended",12,4,0,0,16
1456893,1086992,2021-05-27,Assembly,"AB 1195 Cristina Garcia Assembly Third Reading",56,19,3,0,78
1456893,1220585,2022-06-29,Senate,"Do pass, but first be re-referred to the Committee on [Appropriations]",5,0,0,0,5
1456893,1224716,2022-08-24,Senate,"Assembly 3rd Reading AB1195 Cristina Garcia By Cortese",40,0,0,0,40
1456893,1225182,2022-08-31,Assembly,"With recommendation: That Senate amendments be concurred in",7,0,0,0,7
1456893,1225426,2022-08-31,Assembly,"AB 1195 Cristina Garcia Concurrence in Senate Amendments",75,1,0,4,80
1456894,1065150,2021-04-28,Assembly,"Do pass and be re-referred to the Committee on [Appropriations] with recommendation: To Consent Calendar",8,0,0,0,8
1456894,1073446,2021-05-05,Assembly,"Do pass",15,1,0,0,16
1456894,1083822,2021-05-24,Assembly,"AB 1196 Cooley Assembly Third Reading",72,2,4,0,78
1456894,1101615,2021-06-24,Senate,"Do pass, but first be re-referred to the Committee on [Appropriations]",14,0,3,0,17
1456894,1106926,2021-08-26,Senate,"Assembly 3rd Reading AB1196 Cooley By Pan",36,0,0,4,40
1456898,1047567,2021-04-07,Assembly,"Do pass",6,1,2,0,9
1456898,1060871,2021-04-22,Assembly,"AB 1200 Ting Assembly Third Reading",48,14,17,0,79
1456898,1101651,2021-06-23,Senate,"Do pass as amended, but first amend, and re-refer to the Committee on [Environmental Quality]",9,2,0,0,11
1456898,1104440,2021-07-07,Senate,"Do pass as amended",5,0,2,0,7
1456898,1107799,2021-09-03,Senate,"Assembly 3rd Reading AB1200 Ting et al. By Allen",36,0,0,4,40
1456898,1107897,2021-09-07,Assembly,"AB 1200 Ting Concurrence in Senate Amendments",60,0,0,20,80
1456899,1036474,2021-03-24,Assembly,"Do pass as amended and be re-referred to the Committee on [Appropriations]",10,0,1,0,11
1456899,1081487,2021-05-20,Assembly,"Do pass",16,0,0,0,16
1456899,1088008,2021-05-28,Assembly,"AB 1201 Ting Assembly Third Reading",77,0,2,0,79
1456899,1104451,2021-07-07,Senate,"Do pass, but first be re-referred to the Committee on [Appropriations]",5,0,2,0,7
1456899,1106419,2021-08-23,Senate,"Placed on suspense file",7,0,0,0,7
1456899,1106705,2021-08-26,Senate,"Do pass as amended",6,0,0,1,7
1456899,1108336,2021-09-09,Senate,"Assembly 3rd Reading AB1201 Ting et al. By Allen",32,2,0,6,40
1456899,1108337,2021-09-09,Assembly,"AB 1201 TING Concurrence in Senate Amendments",79,0,0,1,80
1456900,1057678,2021-04-19,Assembly,"Do pass. To Consent Calendar",6,0,1,0,7
1456901,1046122,2021-04-05,Assembly,"Do pass as amended",8,2,1,0,11
1456901,1054650,2021-04-15,Assembly,"AB 1203 Burke Assembly Third Reading",59,14,5,0,78
1456901,1104568,2021-07-08,Senate,"Do pass",4,0,1,0,5
1456901,1107236,2021-08-30,Senate,"Assembly 3rd Reading AB1203 Burke By Kamlager",31,6,0,3,40
1456901,1107527,2021-09-01,Assembly,"AB 1203 Burke Concurrence in Senate Amendments",61,15,0,3,79
1456902,1073443,2021-05-05,Assembly,"Do pass as amended",8,0,0,0,8
1456902,1092951,2021-06-01,Assembly,"AB 970 McCarty Assembly Third Reading",66,8,5,0,79
1456902,1104520,2021-07-08,Senate,"Do pass as amended",4,1,0,0,5
1456902,1107652,2021-09-02,Senate,"Assembly 3rd Reading AB970 McCarty et al. By Gonzalez",30,9,0,1,40
1456902,1107939,2021-09-07,Assembly,"AB 970 McCarty Concurrence in Senate Amendments",59,11,0,10,80
1456903,1064043,2021-04-26,Assembly,"Do pass and be re-referred to the Committee on [Appropriations] with recommendation: To Consent Calendar",15,0,0,0,15
1456904,1123755,2022-01-12,Assembly,"Do pass",6,0,0,1,7
1456904,1126301,2022-01-20,Assembly,"AB 972 Berman Assembly Third Reading",54,3,0,19,76
1456904,1215524,2022-06-13,Senate,"Do pass, but first be re-referred to the Committee on [Judiciary]",3,1,0,1,5
1456904,1217939,2022-06-21,Senate,"Do pass",10,1,0,0,11
1456904,1224546,2022-08-23,Senate,"Assembly 3rd Reading AB972 Berman By Hertzberg",33,6,0,1,40
1456905,1045025,2021-04-05,Assembly,"Do pass. To Consent Calendar",7,0,0,0,7
1456906,1051894,2021-04-12,Assembly,"Do pass and be re-referred to the Committee on [Appropriations]",15,0,0,0,15
1456906,1073393,2021-05-05,Assembly,"Do pass. To Consent Calendar",16,0,0,0,16
1456906,1077531,2021-05-13,Assembly,"AB 974 Luz Rivas Consent Calendar Second Day Regular Session",75,0,3,0,78
1456906,1098155,2021-06-15,Senate,"Do pass, but first be re-referred to the Committee on [Judiciary]",16,0,1,0,17
1456906,1103441,2021-06-29,Senate,"Do pass, but first be re-referred to the Committee on [Appropriations]",10,0,1,0,11
1456906,1107158,2021-08-30,Senate,"Assembly 3rd Reading AB974 Luz Rivas et al. By Portantino",36,1,0,3,40
1456906,1107483,2021-09-01,Assembly,"AB 974 Luz Rivas Concurrence in Senate Amendments",75,0,0,4,79
1456907,1054740,2021-04-15,Assembly,"Do pass as amended, and be re-referred to the Committee on [Appropriations] with recommendation: To Consent Calendar",7,0,0,0,7
1456907,1073412,2021-05-05,Assembly,"Do pass as amended. To Consent Calendar",16,0,0,0,16
1456907,1131282,2022-01-31,Assembly,"AB 975 Luz Rivas Assembly Third Reading",72,0,0,4,76
1456907,1215536,2022-06-13,Senate,"Do pass as amended, but first amend, and re-refer to the Committee on [Appropriations]",4,0,0,1,5
1456907,1224148,2022-08-17,Senate,"Assembly 3rd Reading AB975 Luz Rivas",21,14,0,5,40
1456907,1224149,2022-08-17,Senate,"Assembly 3rd Reading AB975 Luz Rivas",38,0,0,2,40
1456908,1036443,2021-03-24,Assembly,"Do pass and be re-referred to the Committee on [Appropriations]",8,0,3,0,11
1456909,1054707,2021-04-15,Assembly,"Do pass and be re-referred to the Committee on [Human Services]",8,0,0,0,8
1456909,1059277,2021-04-21,Assembly,"Do pass and be re-referred to the Committee on [Appropriations] with recommendation: To Consent Calendar",8,0,0,0,8
1456909,1082068,2021-05-20,Assembly,"Do pass",16,0,0,0,16
1456909,1087069,2021-05-27,Assembly,"AB 977 Gabriel Assembly Third Reading",78,0,0,0,78
1456909,1100285,2021-06-22,Senate,"Do pass as amended, but first amend, and re-refer to the Committee on [Housing] with the recommendation: To Consent Calendar",5,0,0,0,5
1456909,1100781,2021-06-22,Senate,"Do pass, but first be re-referred to the Committee on [Housing] with the recommendation: To Consent Calendar",5,0,0,0,5
1456909,1104531,2021-07-08,Senate,"Do pass as amended, but first amend, and re-refer to the Committee on [Appropriations] with the recommendation: To Consent Calendar",9,0,0,0,9
1456909,1106214,2021-08-16,Senate,"Placed on suspense file",7,0,0,0,7
1456909,1106956,2021-08-26,Senate,"Do pass as amended",7,0,0,0,7
1456909,1108083,2021-09-08,Senate,"Assembly 3rd Reading AB977 Gabriel et al. By Caballero",38,0,0,2,40
1456909,1108250,2021-09-09,Assembly,"AB 977 Gabriel Concurrence in Senate Amendments",79,0,0,1,80
1456910,1068212,2021-05-03,Assembly,"Do pass as amended",5,2,1,0,8
1456910,1082083,2021-05-20,Assembly,"AB 978 Quirk-Silva Assembly Third Reading",50,19,9,0,78
1456910,1100774,2021-06-22,Senate,"Do pass as amended",8,1,2,0,11
1456910,1104542,2021-07-08,Senate,"Assembly 3rd Reading AB978 Quirk-Silva et al. By Caballero",27,6,7,0,40
1456910,1104596,2021-07-12,Assembly,"AB 978 Quirk-Silva Concurrence in Senate Amendments",51,19,9,0,79
1456911,1064094,2021-04-26,Assembly,"Do pass and be re-referred to the Committee on [Appropriations]",9,5,1,0,15
1456912,1066677,2021-04-29,Assembly,"Do pass and be re-referred to the Committee on [Appropriations] with recommendation: To Consent Calendar",13,0,0,0,13
1456913,1053434,2021-04-14,Assembly,"Do pass as amended and be re-referred to the Committee on [Appropriations]",11,0,0,0,11
1456915,1060828,2021-04-22,Assembly,"Do pass and be re-referred to the Committee on [Appropriations]",5,1,1,0,7
1456915,1073387,2021-05-05,Assembly,"Do pass",12,3,1,0,16
1456915,1077594,2021-05-13,Assembly,"AB 983 Eduardo Garcia Assembly Third Reading",57,13,8,0,78
1456915,1100318,2021-06-22,Senate,"Do pass, but first be re-referred to the Committee on [Governance and Finance]",11,3,1,0,15
1456915,1218665,2022-06-22,Senate,"Do pass, but first be re-referred to the Committee on [Judiciary]",3,1,0,1,5
1456915,1220599,2022-06-28,Senate,"Do pass as amended, but first amend, and re-refer to the Committee on [Appropriations]",4,1,0,6,11
1456915,1220600,2022-06-28,Senate,"[First] hearing set for [06-29-2022]: Failed passage in Committee. Reconsideration granted",10,0,0,1,11
1456916,1044943,2021-04-05,Assembly,"Do pass as amended and be re-referred to the Committee on [Privacy and Consumer Protection]",12,0,3,0,15
1456916,1060988,2021-04-22,Assembly,"Do pass as amended and be re-referred to the Committee on [Appropriations]",9,0,2,0,11
1456916,1081883,2021-05-20,Assembly,"Do pass",13,0,3,0,16
1456916,1092915,2021-06-01,Assembly,"AB 984 Luz Rivas Assembly Third Reading",59,2,18,0,79
1456916,1101622,2021-06-24,Senate,"Do pass as amended, but first amend, and re-refer to the Committee on [Judiciary]",13,0,4,0,17
1456916,1104951,2021-07-13,Senate,"Do pass as amended, but first amend, and re-refer to the Committee on [Appropriations]",9,0,2,0,11
1456916,1106452,2021-08-23,Senate,"Placed on suspense file",7,0,0,0,7
1456916,1106692,2021-08-26,Senate,"Do pass as amended",7,0,0,0,7
1456916,1108272,2021-09-09,Senate,"Assembly 3rd Reading AB984 Luz Rivas et al. By Hueso",36,0,0,4,40
1456916,1108273,2021-09-09,Senate,"Assembly 3rd Reading AB984 Luz Rivas et al. By Hueso Reconsider",38,0,0,2,40
1456916,1225155,2022-08-30,Assembly,"With recommendation: That Senate amendments be concurred in",8,0,0,3,11
1456916,1225467,2022-08-29,Senate,"Assembly 3rd Reading AB984 Wilson et al. By Hertzberg",40,0,0,0,40
1456916,1225468,2022-08-31,Assembly,"AB 984 Wilson Concurrence in Senate Amendments",73,0,0,7,80
1456920,1057697,2021-04-20,Assembly,"Do pass and be re-referred to the Committee on [Communications and Conveyance]",11,2,2,0,15
1456920,1065239,2021-04-28,Assembly,"Do pass and be re-referred to the Committee on [Appropriations]",10,0,3,0,13
1456920,1081768,2021-05-20,Assembly,"Do pass as amended",12,4,0,0,16
1456920,1090413,2021-06-02,Assembly,"AB 988 Bauer-Kahan Assembly Third Reading",70,0,9,0,79
1456920,1219998,2022-06-28,Senate,"Do pass, but first be re-referred to the Committee on [Health]",12,0,0,3,15
1456920,1221300,2022-06-29,Senate,"Do pass, but first be re-referred to the Committee on [Appropriations]",10,0,0,1,11
1456920,1222874,2022-08-01,Senate,"Placed on suspense file",7,0,0,0,7
1456920,1223603,2022-08-11,Senate,"Do pass",5,0,0,2,7
1456920,1224927,2022-08-25,Senate,"Assembly 3rd Reading AB988 Bauer-Kahan et al. By Caballero Urgency Clause",38,0,0,2,40
1456920,1224928,2022-08-25,Assembly,"AB 988 Bauer-Kahan Concurrence - Urgency Added",64,0,0,16,80
1456921,1054738,2021-04-15,Assembly,"Do pass and be re-referred to the Committee on [Local Government]",6,0,2,0,8
1456921,1065107,2021-04-28,Assembly,"Do pass as amended and be re-referred to the Committee on [Appropriations]",8,0,0,0,8
1456921,1082180,2021-05-20,Assembly,"Do pass",13,3,0,0,16
1456921,1092900,2021-06-01,Assembly,"AB 989 Gabriel Assembly Third Reading",66,9,4,0,79
1456921,1103766,2021-07-01,Senate,"Do pass as amended, but first amend, and re-refer to the Committee on [Housing]",5,0,0,0,5
1456921,1104500,2021-07-08,Senate,"Do pass, but first be re-referred to the Committee on [Appropriations]",6,0,3,0,9
1456921,1106397,2021-08-23,Senate,"Placed on suspense file",7,0,0,0,7
1456921,1106653,2021-08-26,Senate,"Do pass",5,2,0,0,7
1456922,1059180,2021-04-20,Assembly,"Do pass as amended and be re-referred to the Committee on [Appropriations]",6,1,1,0,8
1456922,1081543,2021-05-20,Assembly,"Do pass as amended",12,1,3,0,16
1456922,1090396,2021-06-02,Assembly,"AB 990 Santiago Assembly Third Reading",47,18,14,0,79
1456922,1104681,2021-07-13,Senate,"Do pass, but first be re-referred to the Committee on [Appropriations]",4,0,1,0,5
1456922,1106159,2021-08-16,Senate,"Placed on suspense file",7,0,0,0,7
1456922,1106678,2021-08-26,Senate,"Do pass as amended",6,1,0,0,7
1456922,1107731,2021-09-02,Senate,"Assembly 3rd Reading AB990 Santiago et al. By Skinner",29,10,0,1,40
1456922,1108024,2021-09-08,Assembly,"AB 990 Santiago Concurrence in Senate Amendments",50,16,0,14,80
1456924,1045020,2021-04-05,Assembly,"Do pass and be re-referred to the Committee on [Natural Resources] with recommendation: To Consent Calendar",14,0,1,0,15
1456924,1065247,2021-04-28,Assembly,"Do pass and be re-referred to the Committee on [Appropriations]",11,0,0,0,11
1456924,1076969,2021-05-12,Assembly,"Do pass. To Consent Calendar",16,0,0,0,16
1456924,1081798,2021-05-20,Assembly,"AB 992 Cooley Consent Calendar Second Day Regular Session",76,0,2,0,78
1456924,1101582,2021-06-24,Senate,"Do pass, but first be re-referred to the Committee on [Environmental Quality] with the recommendation: To Consent Calendar",15,0,2,0,17
1456924,1104623,2021-07-12,Senate,"Do pass, but first be re-referred to the Committee on [Appropriations] with the recommendation: To Consent Calendar",7,0,0,0,7
1456924,1107140,2021-08-30,Senate,"Consent Calendar AB992",39,0,0,1,40
1456925,1046135,2021-04-06,Assembly,"Do pass and be re-referred to the Committee on [Appropriations] with recommendation: To Consent Calendar",11,0,0,0,11
1456925,1081736,2021-05-20,Assembly,"Do pass",16,0,0,0,16
1456925,1090367,2021-06-02,Assembly,"AB 993 Patterson Assembly Third Reading",78,0,1,0,79
1456925,1104395,2021-07-06,Senate,"Do pass, but first be re-referred to the Committee on [Appropriations] with the recommendation: To Consent Calendar",11,0,0,0,11
1456925,1106199,2021-08-16,Senate,"Placed on suspense file",7,0,0,0,7
1456927,1060855,2021-04-22,Assembly,"Do pass and be re-referred to the Committee on [Appropriations]",5,2,0,0,7
1456927,1082047,2021-05-20,Assembly,"Do pass",12,4,0,0,16
1456930,1047434,2021-04-06,Assembly,"Do pass and be re-referred to the Committee on [Appropriations] with recommendation: To Consent Calendar",8,0,0,0,8
1456930,1081950,2021-05-20,Assembly,"Do pass",16,0,0,0,16
1456930,1086954,2021-05-27,Assembly,"AB 998 Lackey Assembly Third Reading",77,0,1,0,78
1456930,1104283,2021-07-06,Senate,"Do pass, but first be re-referred to the Committee on [Appropriations] with the recommendation: To Consent Calendar",5,0,0,0,5
1456930,1106151,2021-08-16,Senate,"Placed on suspense file",7,0,0,0,7
1456932,1016246,2021-02-25,Assembly,"Be adopted. To Consent Calendar",11,0,1,0,12
1456932,1022347,2021-03-04,Assembly,"ACR 31 Grayson Consent Calendar Second Day",72,0,7,0,79
1456932,1037802,2021-03-25,Senate,"Special Consent ACR31",38,0,2,0,40
1456933,1051923,2021-04-12,Assembly,"Be adopted. To Consent Calendar",15,0,0,0,15
1456933,1054696,2021-04-15,Assembly,"ACR 32 Megan Dahle Consent Calendar Second Day Regular Session",75,0,3,0,78
1456933,1101616,2021-06-24,Senate,"Be adopted, but first be re-referred to the Committee on [Appropriations] with recommendation: To Consent Calendar",14,0,3,0,17
1456933,1107242,2021-08-30,Senate,"Special Consent ACR32 Megan Dahle",38,0,0,2,40
1456934,1021145,2021-03-03,Senate,"Do pass, but first be re-referred to the Committee on [Appropriations]",5,0,0,0,5
1456934,1091695,2021-06-03,Senate,"Senate 3rd Reading SB539 Hertzberg et al",37,0,3,0,40
1456934,1104271,2021-07-05,Assembly,"Do pass as amended and be re-referred to the Committee on [Appropriations]",10,0,1,0,11
1456934,1106577,2021-08-26,Assembly,"Do pass",16,0,0,0,16
1456934,1107956,2021-09-07,Assembly,"SB 539 Hertzberg Senate Third Reading By Mullin",69,0,0,11,80
1456934,1108214,2021-09-08,Senate,"Unfinished Business SB539 Hertzberg et al. Concurrence",38,0,0,2,40
1456935,1053436,2021-04-14,Senate,"Do pass, but first be re-referred to the Committee on [Appropriations]",6,1,0,0,7
1456935,1068226,2021-05-03,Senate,"Placed on suspense file",6,0,1,0,7
1456936,1030806,2021-03-17,Senate,"Do pass as amended, but first amend, and re-refer to the Committee on [Appropriations] with the recommendation: To Consent Calendar",10,0,1,0,11
1456936,1075264,2021-05-10,Senate,"Consent Calendar SB541",37,0,3,0,40
1456936,1095043,2021-06-08,Assembly,"Do pass and be re-referred to the Committee on [Appropriations] with recommendation: To Consent Calendar",15,0,0,0,15
1456936,1106326,2021-08-19,Assembly,"Do pass. To Consent Calendar",16,0,0,0,16
1456936,1106660,2021-08-26,Assembly,"SB 541 Bates Consent Calendar Second Day Regular Session",73,0,0,6,79
1456936,1107475,2021-09-01,Senate,"Unfinished Business SB541 Bates et al. Concurrence",38,0,0,2,40
1456937,1052008,2021-04-13,Senate,"Do pass as amended, but first amend, and re-refer to the Committee on [Governance and Finance]",14,0,3,0,17
1456937,1074179,2021-05-06,Senate,"Do pass, but first be re-referred to the Committee on [Appropriations]",4,1,0,0,5
1456937,1078770,2021-05-17,Senate,"Placed on suspense file",7,0,0,0,7
1456937,1081652,2021-05-20,Senate,"Do pass as amended",7,0,0,0,7
1456937,1124807,2022-01-18,Senate,"Senate 3rd Reading SB542 Lim贸n et al",33,0,0,7,40
1456937,1221261,2022-06-30,Assembly,"Do pass and be re-referred to the Committee on [Appropriations]",10,1,0,0,11
1456938,1025107,2021-03-09,Senate,"Do pass as amended, but first amend, and re-refer to the Committee on [Appropriations]",13,0,1,0,14
1456938,1033598,2021-03-22,Senate,"Placed on suspense file",7,0,0,0,7
1456938,1081512,2021-05-20,Senate,"Do pass as amended",7,0,0,0,7
1456938,1124818,2022-01-18,Senate,"Senate 3rd Reading SB543 Lim贸n et al",34,0,0,6,40
1456938,1216393,2022-06-15,Assembly,"Do pass and be re-referred to the Committee on [Appropriations]",7,0,0,0,7
1456938,1223548,2022-08-11,Assembly,"Do pass as amended",12,0,0,4,16
1456938,1224527,2022-08-23,Assembly,"SB 543 Lim贸n Senate Third Reading By Luz Rivas",76,0,0,4,80
1456938,1225808,2022-08-30,Senate,"Special Consent SB543",38,0,0,2,40
1456939,1033650,2021-03-22,Senate,"Do pass, but first be re-referred to the Committee on [Appropriations]",13,0,1,0,14
1456939,1045012,2021-04-05,Senate,"Placed on suspense file",7,0,0,0,7
1456939,1081682,2021-05-20,Senate,"Do pass as amended",7,0,0,0,7
1456939,1087587,2021-05-28,Senate,"Senate 3rd Reading SB544 Laird et al",38,0,2,0,40
1456939,1100253,2021-06-22,Assembly,"Do pass and be re-referred to the Committee on [Appropriations]",19,0,0,0,19
1456939,1103455,2021-06-30,Assembly,"Do pass. To Consent Calendar",14,0,2,0,16
1456939,1107133,2021-08-30,Assembly,"SB 544 Laird Senate Third Reading By Stone",76,0,0,3,79
1456939,1107502,2021-09-01,Senate,"Unfinished Business SB544 Laird et al. Concurrence",39,0,0,1,40
1456940,1053568,2021-04-14,Senate,"Do pass as amended, but first amend, and re-refer to the Committee on [Appropriations]",7,0,0,0,7
1456940,1068283,2021-05-03,Senate,"Placed on suspense file",6,0,1,0,7
1456940,1081828,2021-05-20,Senate,"Do pass",7,0,0,0,7
1456940,1089459,2021-06-01,Senate,"Special Consent SB545 Wilk Urgency Clause",39,0,1,0,40
1456941,1050836,2021-04-12,Senate,"Do pass as amended, but first amend, and re-refer to the Committee on [Human Services]",14,0,0,0,14
1456941,1057706,2021-04-20,Senate,"Do pass, but first be re-referred to the Committee on [Appropriations]",5,0,0,0,5
1456941,1075384,2021-05-10,Senate,"Placed on suspense file",7,0,0,0,7
1456941,1081889,2021-05-20,Senate,"Do pass as amended",7,0,0,0,7
1456941,1089499,2021-06-01,Senate,"Special Consent SB546 Wilk et al. Urgency Clause",39,0,1,0,40
1456941,1100799,2021-06-23,Assembly,"Do pass and be re-referred to the Committee on [Human Services]",12,0,1,0,13
1456941,1103480,2021-06-30,Assembly,"Do pass and be re-referred to the Committee on [Appropriations]",8,0,0,0,8
1456942,1031916,2021-03-18,Senate,"Do pass, but first be re-referred to the Committee on [Education]",5,0,0,0,5
1456942,1047576,2021-04-07,Senate,"Do pass, but first be re-referred to the Committee on [Appropriations] with the recommendation: To Consent Calendar",7,0,0,0,7
1456942,1056397,2021-04-19,Senate,"Placed on suspense file",7,0,0,0,7
1456942,1082012,2021-05-20,Senate,"Do pass",7,0,0,0,7
1456942,1089527,2021-06-01,Senate,"Special Consent SB547",39,0,1,0,40
1456942,1098626,2021-06-16,Assembly,"Do pass and be re-referred to the Committee on [Higher Education]",11,0,0,0,11
1456943,1051960,2021-04-13,Senate,"Do pass",16,0,1,0,17
1456943,1068165,2021-05-03,Senate,"Senate 3rd Reading SB548 Eggman et al",36,0,4,0,40
1456943,1099736,2021-06-21,Assembly,"Do pass and be re-referred to the Committee on [Appropriations]",15,0,0,0,15
1456943,1106191,2021-08-16,Assembly,"SB 548 Eggman Senate Third Reading By Bauer-Kahan",77,0,0,2,79
1456944,1046222,2021-04-05,Senate,"Do pass, but first be re-referred to the Committee on [Human Services] with the recommendation: To Consent Calendar",5,0,0,0,5
1456944,1057723,2021-04-20,Senate,"Do pass and be ordered to the Consent Calendar",5,0,0,0,5
1456944,1066784,2021-04-29,Senate,"Consent Calendar SB549 Jones Urgency Clause",36,0,4,0,40
1456944,1095077,2021-06-08,Assembly,"Do pass and be re-referred to the Committee on [Human Services]",7,0,0,0,7
1456944,1103371,2021-06-30,Assembly,"Do pass and be re-referred to the Committee on [Appropriations] with recommendation: To Consent Calendar",8,0,0,0,8
1456944,1106339,2021-08-19,Assembly,"Do pass. To Consent Calendar",16,0,0,0,16
1456944,1106777,2021-08-26,Assembly,"SB 549 Jones Consent Calendar Second Day Regular Session",73,0,0,6,79
1456944,1107120,2021-08-30,Senate,"Unfinished Business SB549 Jones Urgency Clause Concurrence",39,0,0,1,40
1456945,1056332,2021-04-19,Senate,"Do pass, but first be re-referred to the Committee on [Judiciary]",5,0,0,0,5
1456945,1065226,2021-04-27,Senate,"Do pass, but first be re-referred to the Committee on [Appropriations]",9,2,0,0,11
1456945,1075334,2021-05-10,Senate,"Placed on suspense file",7,0,0,0,7
1456946,1046132,2021-04-06,Senate,"Do pass as amended, but first amend, and re-refer to the Committee on [Transportation]",10,3,2,0,15
1456946,1064068,2021-04-27,Senate,"Do pass as amended, but first amend, and re-refer to the Committee on [Appropriations]",14,2,1,0,17
1456946,1078728,2021-05-17,Senate,"Placed on suspense file",7,0,0,0,7
1456946,1082017,2021-05-20,Senate,"Do pass as amended",5,2,0,0,7
1456946,1087593,2021-05-28,Senate,"Senate 3rd Reading SB551 Stern et al",31,6,3,0,40
1456946,1103440,2021-06-30,Assembly,"Do pass as amended and be re-referred to the Committee on [Transportation]",5,1,1,0,7
1456946,1104249,2021-07-05,Assembly,"Do pass as amended and be re-referred to the Committee on [Appropriations]",12,0,3,0,15
1456947,1051890,2021-04-13,Senate,"Do pass, but first be re-referred to the Committee on [Governance and Finance]",8,0,1,0,9
1456947,1060870,2021-04-22,Senate,"Do pass as amended, but first amend, and re-refer to the Committee on [Appropriations]",5,0,0,0,5
1456947,1075277,2021-05-10,Senate,"Placed on suspense file",7,0,0,0,7
1456947,1081871,2021-05-20,Senate,"Do pass as amended",7,0,0,0,7
1456947,1089497,2021-06-01,Senate,"Senate 3rd Reading SB552 Hertzberg et al",40,0,0,0,40
1456947,1099151,2021-06-17,Assembly,"Do pass as amended and be re-referred to the Committee on [Local Government]",11,3,1,0,15
1456947,1103775,2021-06-30,Assembly,"Do pass as amended and be re-referred to the Committee on [Appropriations]",8,0,0,0,8
1456947,1106731,2021-08-26,Assembly,"Do pass as amended",12,4,0,0,16
1456947,1108140,2021-09-08,Assembly,"SB 552 Hertzberg Senate Third Reading By Friedman",69,2,0,9,80
1456947,1108355,2021-09-09,Senate,"Unfinished Business SB552 Hertzberg et al. Concurrence",38,0,0,2,40
1456948,1074191,2021-05-06,Senate,"Do pass as amended, but first amend, and re-refer to the Committee on [Appropriations]",5,0,0,0,5
1456948,1078782,2021-05-17,Senate,"Placed on suspense file",7,0,0,0,7
1456950,1037809,2021-03-25,Senate,"Do pass, but first be re-referred to the Committee on [Judiciary]",5,0,0,0,5
1456950,1059233,2021-04-20,Senate,"Do pass, but first be re-referred to the Committee on [Appropriations]",11,0,0,0,11
1456950,1068206,2021-05-03,Senate,"Placed on suspense file",6,0,1,0,7
1456950,1081747,2021-05-20,Senate,"Do pass",7,0,0,0,7
1456950,1089502,2021-06-01,Senate,"Special Consent SB555",39,0,1,0,40
1456950,1100241,2021-06-21,Assembly,"Do pass and be re-referred to the Committee on [Judiciary]",10,0,1,0,11
1456950,1104769,2021-07-13,Assembly,"Do pass as amended and be re-referred to the Committee on [Appropriations]",9,0,2,0,11
1456951,1056384,2021-04-19,Senate,"Do pass, but first be re-referred to the Committee on [Rules]",11,1,2,0,14
1456951,1060892,2021-04-22,Senate,"Do pass as amended, but first amend, and re-refer to the Committee on [Appropriations]",4,1,0,0,5
1456951,1077548,2021-05-13,Senate,"Senate 3rd Reading SB556 Dodd et al",31,2,7,0,40
1456951,1096076,2021-06-09,Assembly,"Do pass and be re-referred to the Committee on [Communications and Conveyance]",7,0,1,0,8
1456951,1104466,2021-07-07,Assembly,"Do pass and be re-referred to the Committee on [Appropriations]",11,1,1,0,13
1456951,1106322,2021-08-19,Assembly,"Do pass",15,1,0,0,16
1456951,1107533,2021-09-01,Assembly,"SB 556 Dodd Senate Third Reading By Quirk",53,9,0,17,79
1456951,1107716,2021-09-02,Senate,"Unfinished Business SB556 Dodd et al. Concurrence",27,6,0,7,40
1456952,1050761,2021-04-12,Senate,"Do pass, but first be re-referred to the Committee on [Appropriations] with the recommendation: To Consent Calendar",7,0,0,0,7
1456952,1056387,2021-04-19,Senate,"Placed on suspense file",7,0,0,0,7
1456953,1053474,2021-04-14,Senate,"Do pass as amended, but first amend, and re-refer to the Committee on [Human Services]",10,0,1,0,11
1456953,1057726,2021-04-20,Senate,"Do pass as amended, but first amend, and re-refer to the Committee on [Appropriations]",5,0,0,0,5
1456953,1078826,2021-05-17,Senate,"Placed on suspense file",7,0,0,0,7
1456953,1082029,2021-05-20,Senate,"Do pass as amended",7,0,0,0,7
1456953,1127191,2022-01-24,Senate,"Senate 3rd Reading SB558 Caballero et al",36,0,0,4,40
1456953,1219481,2022-06-27,Assembly,"Do pass and be re-referred to the Committee on [Appropriations]",7,0,0,0,7
1456954,1064083,2021-04-27,Senate,"Do pass, but first be re-referred to the Committee on [Appropriations]",6,0,3,0,9
1456954,1075369,2021-05-10,Senate,"Placed on suspense file",7,0,0,0,7
1456954,1082120,2021-05-20,Senate,"Do pass as amended",6,1,0,0,7
1456954,1087607,2021-05-28,Senate,"Senate 3rd Reading SB559 Hurtado et al",34,1,5,0,40
1456954,1103804,2021-07-01,Assembly,"Do pass and be re-referred to the Committee on [Appropriations]",11,0,4,0,15
1456954,1106930,2021-08-26,Assembly,"Do pass as amended",11,0,0,5,16
1456954,1225427,2022-08-31,Senate,"Unfinished Business SB559 Hurtado et al. Urgency Clause Concurrence",40,0,0,0,40
1456954,1225428,2022-08-31,Assembly,"SB 559 Hurtado Third Reading Urgency By Salas",79,0,0,1,80
1456955,1062768,2021-04-26,Senate,"Do pass as amended, but first amend, and re-refer to the Committee on [Appropriations]",11,0,3,0,14
1456955,1078780,2021-05-17,Senate,"Placed on suspense file",7,0,0,0,7
1456955,1081416,2021-05-20,Senate,"Do pass as amended",5,2,0,0,7
1456955,1127167,2022-01-24,Senate,"Senate 3rd Reading SB560 Rubio",33,1,0,6,40
1456955,1219375,2022-06-27,Assembly,"Do pass and be re-referred to the Committee on [Appropriations]",11,0,0,0,11
1456956,1057643,2021-04-20,Senate,"Do pass, but first be re-referred to the Committee on [Appropriations]",15,0,0,0,15
1456956,1075345,2021-05-10,Senate,"Senate 3rd Reading SB561 Dodd",37,0,3,0,40
1456956,1210202,2022-05-27,Assembly,"Be re-referred to the Committees on [Accountability and Administrative Review] and [Housing and Community Development]",7,0,0,4,11
1456956,1216373,2022-06-15,Assembly,"Do pass and be re-referred to the Committee on [Housing and Community Development]",5,0,0,2,7
1456956,1220603,2022-06-29,Assembly,"Do pass as amended and be re-referred to the Committee on [Appropriations]",6,2,0,0,8
1456956,1223426,2022-08-11,Assembly,"Do pass as amended",13,3,0,0,16
1456956,1225519,2022-08-31,Senate,"Unfinished Business SB561 Dodd Concurrence",32,6,0,2,40
1456956,1225520,2022-08-31,Assembly,"SB 561 Dodd Senate Third Reading By Petrie-Norris",63,10,0,7,80
1456957,1046088,2021-04-06,Senate,"Do pass, but first be re-referred to the Committee on [Health]",5,0,0,0,5
1456957,1059142,2021-04-21,Senate,"Do pass, but first be re-referred to the Committee on [Appropriations]",11,0,0,0,11
1456957,1075311,2021-05-10,Senate,"Placed on suspense file",7,0,0,0,7
1456957,1081783,2021-05-20,Senate,"Do pass as amended",7,0,0,0,7
1456957,1089613,2021-06-01,Senate,"Senate 3rd Reading SB562 Portantino",40,0,0,0,40
1456957,1100792,2021-06-22,Assembly,"Do pass as amended and be re-referred to the Committee on [Appropriations]",11,0,4,0,15
1456957,1106612,2021-08-26,Assembly,"Do pass as amended",12,0,0,4,16
1456957,1225565,2022-08-31,Senate,"Unfinished Business SB562 Portantino Concurrence",40,0,0,0,40
1456957,1225566,2022-08-31,Assembly,"SB 562 Portantino Senate Third Reading By Bauer-Kahan",62,0,0,18,80
1456958,1049009,2021-04-08,Senate,"Do pass as amended, but first amend, and re-refer to the Committee on [Housing]",5,0,0,0,5
1456958,1066788,2021-04-29,Senate,"Do pass as amended, but first amend, and re-refer to the Committee on [Appropriations]",7,2,0,0,9
1456958,1078761,2021-05-17,Senate,"Placed on suspense file",7,0,0,0,7
1456959,1030803,2021-03-17,Senate,"Do pass as amended, but first amend, and re-refer to the Committee on [Appropriations] with the recommendation: To Consent Calendar",10,0,1,0,11
1456959,1060889,2021-04-22,Senate,"Consent Calendar SB564",38,0,2,0,40
1456959,1095057,2021-06-08,Assembly,"Do pass and be re-referred to the Committee on [Appropriations]",15,0,0,0,15
1456959,1103449,2021-06-30,Assembly,"Do pass. To Consent Calendar",14,0,2,0,16
1456959,1104539,2021-07-08,Assembly,"SB 564 Cortese Consent Calendar Second Day Regular Session",76,0,3,0,79
1456959,1107957,2021-09-07,Assembly,"SB 564 Cortese Senate Third Reading By Low",73,0,0,7,80
1456959,1108150,2021-09-08,Senate,"Unfinished Business SB564 Cortese Concurrence",38,0,0,2,40
1456960,1047485,2021-04-07,Senate,"Do pass, but first be re-referred to the Committee on [Judiciary] with the recommendation: To Consent Calendar",11,0,0,0,11
1456960,1053467,2021-04-13,Senate,"Do pass, but first be re-referred to the Committee on [Appropriations] with the recommendation: To Consent Calendar",10,0,1,0,11
1456960,1068191,2021-05-03,Senate,"Placed on suspense file",6,0,1,0,7
1456961,1026104,2021-03-10,Senate,"Do pass, but first be re-referred to the Committee on [Appropriations]",4,1,2,0,7
1456961,1033676,2021-03-22,Senate,"Placed on suspense file",7,0,0,0,7
1456962,1051918,2021-04-13,Senate,"Do pass as amended, but first amend, and re-refer to the Committee on [Appropriations]",4,1,0,0,5
1456962,1068210,2021-05-03,Senate,"Placed on suspense file",6,0,1,0,7
1456962,1081499,2021-05-20,Senate,"Do pass as amended",5,2,0,0,7
1456962,1090436,2021-06-02,Senate,"Senate 3rd Reading SB567 Bradford",30,7,3,0,40
1456962,1102870,2021-06-29,Assembly,"Do pass as amended and be re-referred to the Committee on [Appropriations]",6,2,0,0,8
1456962,1107021,2021-08-26,Assembly,"Do pass",12,4,0,0,16
1456962,1108173,2021-09-08,Assembly,"SB 567 Bradford Senate Third Reading By Kalra",41,23,0,16,80
1456962,1108266,2021-09-09,Senate,"Unfinished Business SB567 Bradford Concurrence",28,10,0,2,40
1456963,1065115,2021-04-28,Senate,"Do pass as amended, but first amend, and re-refer to the Committee on [Appropriations]",9,2,0,0,11
1456963,1078731,2021-05-17,Senate,"Placed on suspense file",7,0,0,0,7
1456963,1081882,2021-05-20,Senate,"Do pass",6,1,0,0,7
1456963,1089542,2021-06-01,Senate,"Senate 3rd Reading SB568 Pan",33,6,1,0,40
1456964,1065119,2021-04-27,Senate,"Do pass, but first be re-referred to the Committee on [Appropriations] with the recommendation: To Consent Calendar",11,0,0,0,11
1456964,1075377,2021-05-10,Senate,"Placed on suspense file",7,0,0,0,7
1456965,1063997,2021-04-27,Senate,"Do pass as amended, and be ordered to the Consent Calendar",15,0,2,0,17
1456965,1083823,2021-05-24,Senate,"Consent Calendar SB570 Wieckowski",40,0,0,0,40
1456965,1104274,2021-07-05,Assembly,"Do pass and be re-referred to the Committee on [Appropriations] with recommendation: To Consent Calendar",15,0,0,0,15
1456965,1106630,2021-08-26,Assembly,"Do pass",16,0,0,0,16
1456965,1108322,2021-09-09,Assembly,"SB 570 Wieckowski Senate Third Reading By Berman",78,0,0,2,80
1456965,1108550,2021-09-10,Senate,"Unfinished Business SB570 Wieckowski Concurrence",37,0,0,3,40
1456967,1046219,2021-04-05,Senate,"Do pass, but first be re-referred to the Committee on [Judiciary]",5,0,0,0,5
1456967,1059332,2021-04-20,Senate,"Do pass, but first be re-referred to the Committee on [Appropriations]",10,0,1,0,11
1456967,1075367,2021-05-10,Senate,"Senate 3rd Reading SB572 Hertzberg",36,0,4,0,40
1456967,1095071,2021-06-08,Assembly,"Do pass and be re-referred to the Committee on [Judiciary]",7,0,0,0,7
1456967,1100332,2021-06-22,Assembly,"Do pass and be re-referred to the Committee on [Appropriations]",9,2,0,0,11
1456967,1104893,2021-07-14,Assembly,"Do pass",11,2,3,0,16
1456967,1107231,2021-08-30,Assembly,"SB 572 Hertzberg Senate Third Reading By Davies",68,6,0,5,79
1456967,1107480,2021-09-01,Senate,"Unfinished Business SB572 Hertzberg Concurrence",39,0,0,1,40
1456969,1027166,2021-03-11,Senate,"Do pass, but first be re-referred to the Committee on [Appropriations] with the recommendation: To Consent Calendar",5,0,0,0,5
1456969,1037824,2021-03-25,Senate,"Consent Calendar SB574",38,0,2,0,40
1456969,1098637,2021-06-16,Assembly,"Do pass and be re-referred to the Committee on [Local Government] with recommendation: To Consent Calendar",11,0,0,0,11
1456969,1101654,2021-06-23,Assembly,"Do pass and be re-referred to the Committee on [Appropriations] with recommendation: To Consent Calendar",8,0,0,0,8
1456969,1104953,2021-07-14,Assembly,"Do pass. To Consent Calendar",13,0,3,0,16
1456969,1106363,2021-08-19,Assembly,"SB 574 Laird Consent Calendar Second Day Regular Session",73,0,0,6,79
1456970,1066785,2021-04-29,Senate,"Do pass, but first be re-referred to the Committee on [Appropriations]",5,2,0,0,7
1456970,1078774,2021-05-17,Senate,"Placed on suspense file",7,0,0,0,7
1456971,1046224,2021-04-06,Senate,"Do pass as amended, but first amend, and re-refer to the Committee on [Appropriations]",10,1,4,0,15
1456971,1075275,2021-05-10,Senate,"Senate 3rd Reading SB576 Archuleta",30,2,8,0,40
1456972,1059210,2021-04-21,Senate,"Do pass, but first be re-referred to the Committee on [Appropriations] with the recommendation: To Consent Calendar",9,0,0,0,9
1456972,1077580,2021-05-13,Senate,"Consent Calendar SB577",38,0,2,0,40
1456972,1122872,2022-01-10,Assembly,"Do pass as amended and be re-referred to the Committee on [Appropriations]",11,0,0,1,12
1456972,1124823,2022-01-03,Assembly,"Be re-referred to the Committee on [Banking and Finance]",8,0,0,4,12
1456972,1180237,2022-03-30,Assembly,"Do pass. To Consent Calendar",12,0,0,3,15
1456972,1186257,2022-04-07,Assembly,"SB 577 Lim贸n Consent Calendar Second Day Regular Session",65,0,0,12,77
1456972,1191289,2022-04-21,Senate,"Unfinished Business SB577 Lim贸n Urgency Clause Concurrence",39,0,0,1,40
1456973,1029598,2021-03-16,Senate,"Do pass, but first be re-referred to the Committee on [Appropriations] with the recommendation: To Consent Calendar",11,0,0,0,11
1456973,1048957,2021-04-08,Senate,"Consent Calendar SB578",38,0,2,0,40
1456973,1095049,2021-06-08,Assembly,"Do pass and be re-referred to the Committee on [Appropriations]",10,0,1,0,11
1456973,1106866,2021-08-26,Assembly,"Do pass as amended",16,0,0,0,16
1456973,1107634,2021-09-02,Assembly,"SB 578 Jones Senate Third Reading By Stone",77,0,0,2,79
1456973,1107773,2021-09-03,Senate,"Unfinished Business SB578 Jones Concurrence",37,0,0,3,40
1456974,1123757,2022-01-12,Senate,"Do pass, but first be re-referred to the Committee on [Appropriations]",6,0,0,1,7
1456974,1124815,2022-01-18,Senate,"Placed on suspense file",6,0,0,1,7
1456974,1126262,2022-01-20,Senate,"Do pass as amended",7,0,0,0,7
1456974,1128992,2022-01-26,Senate,"Senate 3rd Reading SB579 Allen",37,0,0,3,40
1456975,1052006,2021-04-13,Senate,"Do pass, but first be re-referred to the Committee on [Appropriations]",16,0,1,0,17
1456975,1068192,2021-05-03,Senate,"Placed on suspense file",6,0,1,0,7
1456975,1081614,2021-05-20,Senate,"Do pass as amended",7,0,0,0,7
1456976,1054672,2021-04-15,Senate,"Do pass, but first be re-referred to the Committee on [Appropriations] with the recommendation: To Consent Calendar",9,0,0,0,9
1456976,1075244,2021-05-10,Senate,"Consent Calendar SB581",37,0,3,0,40
1456976,1095017,2021-06-08,Assembly,"Do pass and be re-referred to the Committee on [Appropriations] with recommendation: To Consent Calendar",8,0,0,0,8
1456976,1103412,2021-06-30,Assembly,"Do pass. To Consent Calendar",14,0,2,0,16
1456977,1050834,2021-04-12,Senate,"Do pass, but first be re-referred to the Committee on [Natural Resources and Water]",5,2,0,0,7
1456977,1064172,2021-04-27,Senate,"Do pass, but first be re-referred to the Committee on [Appropriations]",7,2,0,0,9
1456977,1075313,2021-05-10,Senate,"Placed on suspense file",7,0,0,0,7
1456977,1081794,2021-05-20,Senate,"Do pass as amended",5,2,0,0,7
1456978,1050780,2021-04-12,Senate,"Do pass, but first be re-referred to the Committee on [Rules]",4,1,0,0,5
1456978,1064073,2021-04-27,Senate,"Do pass as amended, but first amend, and re-refer to the Committee on [Appropriations]",13,3,1,0,17
1456978,1075298,2021-05-10,Senate,"Placed on suspense file",7,0,0,0,7
1456978,1082096,2021-05-20,Senate,"Do pass as amended",5,1,1,0,7
1456978,1089490,2021-06-01,Senate,"Senate 3rd Reading SB583 Newman",31,9,0,0,40
1456979,1035261,2021-03-23,Senate,"Do pass, but first be re-referred to the Committee on [Appropriations]",5,0,0,0,5
1456979,1068255,2021-05-03,Senate,"Senate 3rd Reading SB584 Jones",36,0,4,0,40
1456979,1103399,2021-06-30,Assembly,"Do pass and be re-referred to the Committee on [Appropriations] with recommendation: To Consent Calendar",8,0,0,0,8
1456979,1104955,2021-07-14,Assembly,"Do pass. To Consent Calendar",13,0,3,0,16
1456979,1107958,2021-09-07,Assembly,"SB 584 Jones Senate Third Reading By Blanca Rubio",72,0,0,8,80
1456979,1108139,2021-09-08,Senate,"Unfinished Business SB584 Jones Concurrence",38,0,0,2,40
1456981,1051984,2021-04-13,Senate,"Do pass, but first be re-referred to the Committee on [Appropriations]",4,1,0,0,5
1456981,1068189,2021-05-03,Senate,"Placed on suspense file",6,0,1,0,7
1456981,1082199,2021-05-20,Senate,"Do pass as amended",5,2,0,0,7
1456981,1090473,2021-06-02,Senate,"Senate 3rd Reading SB586 Bradford et al",30,7,3,0,40
1456981,1104773,2021-07-13,Assembly,"Do pass and be re-referred to the Committee on [Appropriations]",6,1,1,0,8
1456981,1106657,2021-08-26,Assembly,"Do pass as amended",12,4,0,0,16
1456981,1107763,2021-09-03,Assembly,"SB 586 Bradford Senate Third Reading By Akilah Weber Amend By WEBER, A. Set #1",53,15,0,11,79
1456981,1108529,2021-09-10,Senate,"Unfinished Business SB586 Bradford Concurrence",28,9,0,3,40
1456981,1108530,2021-09-10,Assembly,"SB 586 Bradford Senate Third Reading By Akilah Weber",52,20,0,8,80
1456984,1050809,2021-04-12,Senate,"Do pass, but first be re-referred to the Committee on [Transportation]",14,0,0,0,14
1456984,1064132,2021-04-27,Senate,"Do pass, but first be re-referred to the Committee on [Appropriations]",17,0,0,0,17
1456984,1075396,2021-05-10,Senate,"Placed on suspense file",7,0,0,0,7
1456984,1081541,2021-05-20,Senate,"Do pass",7,0,0,0,7
1456984,1089588,2021-06-01,Senate,"Special Consent SB589",39,0,1,0,40
1456984,1100790,2021-06-23,Assembly,"Do pass and be re-referred to the Committee on [Transportation] with recommendation: To Consent Calendar",12,0,1,0,13
1456984,1104292,2021-07-05,Assembly,"Do pass and be re-referred to the Committee on [Appropriations] with recommendation: To Consent Calendar",15,0,0,0,15
1456984,1106769,2021-08-26,Assembly,"Do pass",16,0,0,0,16
1456984,1108122,2021-09-08,Assembly,"SB 589 Hueso Senate Third Reading By Eduardo Garcia",80,0,0,0,80
1456984,1108297,2021-09-09,Senate,"Unfinished Business SB589 Hueso et al. Concurrence",38,0,0,2,40
1456985,1062757,2021-04-26,Senate,"Do pass as amended",5,0,0,0,5
1456985,1074198,2021-05-06,Senate,"Senate 3rd Reading SB590 Allen",37,0,3,0,40
1456985,1098661,2021-06-16,Assembly,"Do pass as amended. To Consent Calendar",7,0,0,0,7
1456985,1101641,2021-06-24,Assembly,"SB 590 Allen Consent Calendar Second Day Regular Session",77,0,2,0,79
1456985,1104169,2021-07-05,Senate,"Unfinished Business SB590 Allen Concurrence",40,0,0,0,40
1456986,1059198,2021-04-20,Senate,"Do pass, but first be re-referred to the Committee on [Housing] with the recommendation: To Consent Calendar",11,0,0,0,11
1456986,1066775,2021-04-29,Senate,"Do pass as amended, and be ordered to the Consent Calendar",9,0,0,0,9
1456986,1075249,2021-05-10,Senate,"Consent Calendar SB591",37,0,3,0,40
1456986,1095069,2021-06-08,Assembly,"Do pass and be re-referred to the Committee on [Judiciary]",8,0,0,0,8
1456986,1100291,2021-06-22,Assembly,"Do pass",11,0,0,0,11
1456986,1106451,2021-08-23,Assembly,"SB 591 Becker Senate Third Reading By Wicks",71,0,0,8,79
1456986,1107263,2021-08-30,Senate,"Unfinished Business SB591 Becker et al. Concurrence",39,0,0,1,40
1456987,1054659,2021-04-15,Senate,"Do pass as amended, but first amend, and re-refer to the Committee on [Appropriations]",8,0,1,0,9
1456987,1075320,2021-05-10,Senate,"Placed on suspense file",7,0,0,0,7
1456988,1053446,2021-04-14,Senate,"Do pass, but first be re-referred to the Committee on [Appropriations]",7,0,0,0,7
1456988,1068243,2021-05-03,Senate,"Placed on suspense file",6,0,1,0,7
1456988,1082189,2021-05-20,Senate,"Do pass as amended",7,0,0,0,7
1456988,1090455,2021-06-02,Senate,"Senate 3rd Reading SB593 Glazer",35,0,5,0,40
1456989,1050782,2021-04-12,Senate,"Do pass, but first be re-referred to the Committee on [Governance and Finance] with the recommendation: To Consent Calendar",5,0,0,0,5
1456989,1074134,2021-05-06,Senate,"Do pass and be ordered to the Consent Calendar",5,0,0,0,5
1456989,1077549,2021-05-13,Senate,"Consent Calendar SB594 Glazer Urgency Clause",38,0,2,0,40
1456989,1106485,2021-08-24,Assembly,"Do pass",7,0,0,0,7
1456989,1107117,2021-08-30,Assembly,"SB 594 Glazer Third Reading Urgency By Berman",73,0,0,6,79
1456989,1107672,2021-09-02,Senate,"That the Assembly amendments be concurred in",4,0,0,1,5
1456989,1107797,2021-09-03,Senate,"Unfinished Business SB594 Glazer Urgency Clause Concurrence",37,0,0,3,40
1456989,1110442,2021-08-19,Assembly,"Be re-referred to the Committee on [Elections]",11,0,0,1,12
1456991,1066733,2021-04-29,Senate,"Do pass, but first be re-referred to the Committee on [Appropriations]",5,1,1,0,7
1456991,1078749,2021-05-17,Senate,"Placed on suspense file",7,0,0,0,7
1456991,1081959,2021-05-20,Senate,"Do pass",5,2,0,0,7
1456991,1083865,2021-05-24,Senate,"Senate 3rd Reading SB596 Becker",31,9,0,0,40
1456991,1100800,2021-06-23,Assembly,"Do pass as amended and be re-referred to the Committee on [Appropriations]",11,0,0,0,11
1456991,1106726,2021-08-26,Assembly,"Do pass as amended",13,3,0,0,16
1456991,1108156,2021-09-08,Assembly,"SB 596 Becker Senate Third Reading By Muratsuchi",74,2,0,4,80
1456991,1108317,2021-09-09,Senate,"Unfinished Business SB596 Becker et al. Concurrence",29,9,0,2,40
1456993,1046139,2021-04-05,Senate,"Do pass, but first be re-referred to the Committee on [Judiciary]",5,0,0,0,5
1456993,1059174,2021-04-20,Senate,"Do pass, but first be re-referred to the Committee on [Appropriations]",9,2,0,0,11
1456993,1068185,2021-05-03,Senate,"Placed on suspense file",6,0,1,0,7
1456993,1082075,2021-05-20,Senate,"Do pass",5,2,0,0,7
1456993,1089528,2021-06-01,Senate,"Senate 3rd Reading SB598 Pan et al",31,9,0,0,40
1456993,1100828,2021-06-23,Assembly,"Do pass and be re-referred to the Committee on [Judiciary]",6,0,1,0,7
1456993,1104755,2021-07-13,Assembly,"Do pass and be re-referred to the Committee on [Appropriations]",8,1,2,0,11
1456993,1106784,2021-08-26,Assembly,"Do pass",12,4,0,0,16
1456993,1108027,2021-09-08,Assembly,"SB 598 Pan Senate Third Reading By McCarty",67,6,0,7,80
1456993,1108234,2021-09-09,Senate,"Unfinished Business SB598 Pan et al. Concurrence",29,9,0,2,40
1456994,1056363,2021-04-19,Senate,"Do pass, but first be re-referred to the Committee on [Appropriations] with the recommendation: To Consent Calendar",14,0,0,0,14
1456994,1075308,2021-05-10,Senate,"Consent Calendar SB599",37,0,3,0,40
1456994,1215268,2022-06-09,Assembly,"Be re-referred to the Committee on [Utilities and Energy]",8,0,0,3,11
1456994,1220801,2022-06-29,Assembly,"Do pass and be re-referred to the Committee on [Appropriations]",12,0,0,3,15
1456994,1223341,2022-08-10,Assembly,"Do pass",11,0,0,5,16
1456994,1225496,2022-08-31,Senate,"Unfinished Business SB599 Hueso Concurrence",39,0,0,1,40
1456994,1225497,2022-08-31,Assembly,"SB 599 Hueso Senate Third Reading By Quirk",60,0,0,20,80
1456996,1074170,2021-05-06,Senate,"Do pass, but first be re-referred to the Committee on [Appropriations]",4,0,1,0,5
1456996,1078727,2021-05-17,Senate,"Placed on suspense file",7,0,0,0,7
1456996,1081966,2021-05-20,Senate,"Do pass as amended",7,0,0,0,7
1456996,1089544,2021-06-01,Senate,"Special Consent SB601",39,0,1,0,40
1456997,1053462,2021-04-13,Senate,"Do pass, but first be re-referred to the Committee on [Appropriations] with the recommendation: To Consent Calendar",10,0,1,0,11
1456997,1068158,2021-05-03,Senate,"Placed on suspense file",6,0,1,0,7
1456997,1082150,2021-05-20,Senate,"Do pass",7,0,0,0,7
1456997,1122859,2022-01-10,Senate,"Senate 3rd Reading SB602 Laird et al",31,0,0,9,40
1456997,1215003,2022-06-08,Assembly,"Do pass and be re-referred to the Committee on [Appropriations]",10,0,0,0,10
1456998,1044993,2021-04-05,Senate,"Do pass, but first be re-referred to the Committee on [Governance and Finance]",9,0,5,0,14
1456998,1054647,2021-04-15,Senate,"Do pass as amended, but first amend, and re-refer to the Committee on [Appropriations]",5,0,0,0,5
1456998,1068269,2021-05-03,Senate,"Placed on suspense file",6,0,1,0,7
1456998,1082116,2021-05-20,Senate,"Do pass as amended",5,0,2,0,7
1456998,1089602,2021-06-01,Senate,"Senate 3rd Reading SB603 Bradford",34,1,5,0,40
1456999,1054602,2021-04-15,Senate,"Do pass, but first be re-referred to the Committee on [Appropriations]",9,0,0,0,9
1456999,1068196,2021-05-03,Senate,"Placed on suspense file",6,0,1,0,7
1457000,1053563,2021-04-14,Senate,"Do pass as amended, but first amend, and re-refer to the Committee on [Judiciary]",10,0,1,0,11
1457000,1065133,2021-04-27,Senate,"Do pass as amended, but first amend, and re-refer to the Committee on [Appropriations]",9,0,2,0,11
1457000,1075322,2021-05-10,Senate,"Placed on suspense file",7,0,0,0,7
1457001,1038711,2021-03-22,Senate,"Do pass, but first be re-referred to the Committee on [Judiciary]",4,1,0,0,5
1457001,1047541,2021-04-06,Senate,"Do pass as amended, but first amend, and re-refer to the Committee on [Appropriations]",7,0,4,0,11
1457001,1047542,2021-04-06,Senate,"[04-07-2021] set for [First] hearing: Reconsideration of favorable vote granted",11,0,0,0,11
1457001,1047543,2021-04-06,Senate,"Do pass as amended, but first amend, and re-refer to the Committee on [Appropriations]",9,2,0,0,11
1457001,1056348,2021-04-19,Senate,"Placed on suspense file",7,0,0,0,7
1457001,1081669,2021-05-20,Senate,"Do pass as amended",5,2,0,0,7
1457001,1090487,2021-06-02,Senate,"Senate 3rd Reading SB606 Gonzalez et al",28,7,5,0,40
1457001,1100337,2021-06-22,Assembly,"Do pass and be re-referred to the Committee on [Judiciary]",5,2,0,0,7
1457001,1104307,2021-07-06,Assembly,"Do pass and be re-referred to the Committee on [Appropriations]",8,2,1,0,11
1457001,1106891,2021-08-26,Assembly,"Do pass as amended",11,4,0,1,16
1457001,1108110,2021-09-08,Assembly,"SB 606 Gonzalez Senate Third Reading By Kalra",53,19,0,8,80
1457001,1108245,2021-09-09,Senate,"Unfinished Business SB606 Gonzalez et al. Concurrence",27,10,0,3,40
1457002,1056434,2021-04-19,Senate,"Do pass, but first be re-referred to the Committee on [Appropriations]",13,0,1,0,14
1457002,1078832,2021-05-17,Senate,"Placed on suspense file",7,0,0,0,7
1457002,1081726,2021-05-20,Senate,"Do pass as amended",6,0,1,0,7
1457002,1089513,2021-06-01,Senate,"Senate 3rd Reading SB607 Roth",35,0,5,0,40
1457002,1104990,2021-07-14,Assembly,"Do pass and be re-referred to the Committee on [Appropriations]",19,0,0,0,19
1457002,1106562,2021-08-26,Assembly,"Do pass as amended",12,0,0,4,16
1457002,1108031,2021-09-08,Assembly,"SB 607 Min Senate Third Reading By Low",76,0,0,4,80
1457002,1108361,2021-09-09,Senate,"Unfinished Business SB607 Min et al. By Roth Concurrence",34,0,0,6,40
1457004,1046169,2021-04-06,Senate,"Do pass as amended, but first amend, and re-refer to the Committee on [Appropriations]",5,0,0,0,5
1457004,1068237,2021-05-03,Senate,"Placed on suspense file",6,0,1,0,7
1457004,1081771,2021-05-20,Senate,"Do pass as amended",7,0,0,0,7
1457004,1089599,2021-06-01,Senate,"Special Consent SB609",39,0,1,0,40
1457004,1103504,2021-06-30,Assembly,"Do pass and be re-referred to the Committee on [Appropriations] with recommendation: To Consent Calendar",8,0,0,0,8
1457004,1106767,2021-08-26,Assembly,"Do pass as amended",12,0,0,4,16
1457004,1108085,2021-09-08,Assembly,"SB 609 Hurtado Senate Third Reading By Arambula",78,0,0,2,80
1457004,1108231,2021-09-09,Senate,"Unfinished Business SB609 Hurtado Concurrence",38,0,0,2,40
1457005,1074143,2021-05-06,Senate,"Do pass, but first be re-referred to the Committee on [Appropriations]",5,0,0,0,5
1457005,1078799,2021-05-17,Senate,"Placed on suspense file",7,0,0,0,7
1457006,1074149,2021-05-06,Senate,"Do pass as amended, but first amend, and re-refer to the Committee on [Appropriations]",5,0,0,0,5
1457006,1078798,2021-05-17,Senate,"Placed on suspense file",7,0,0,0,7
1457006,1081643,2021-05-20,Senate,"Do pass",7,0,0,0,7
1457006,1089558,2021-06-01,Senate,"Senate 3rd Reading SB611 Allen",39,0,1,0,40
1457006,1099762,2021-06-21,Assembly,"Do pass and be re-referred to the Committee on [Revenue and Taxation]",7,0,0,0,7
1457006,1104259,2021-07-05,Assembly,"Do pass and be re-referred to the Committee on [Appropriations]",9,0,2,0,11
1457007,1062793,2021-04-26,Senate,"Do pass as amended, but first amend, and re-refer to the Committee on [Appropriations]",11,1,2,0,14
1457007,1078762,2021-05-17,Senate,"Placed on suspense file",7,0,0,0,7
1457007,1082127,2021-05-20,Senate,"Do pass as amended",5,2,0,0,7
1457007,1089485,2021-06-01,Senate,"Senate 3rd Reading SB612 Portantino et al",33,6,1,0,40
1457009,1030800,2021-03-17,Senate,"Do pass, but first be re-referred to the Committee on [Appropriations]",7,0,0,0,7
1457009,1050771,2021-04-12,Senate,"Senate 3rd Reading SB614 Archuleta et al",39,0,1,0,40
1457009,1104284,2021-07-06,Assembly,"Do pass and be re-referred to the Committee on [Appropriations] with recommendation: To Consent Calendar",11,0,0,0,11
1457009,1106342,2021-08-19,Assembly,"Do pass. To Consent Calendar",16,0,0,0,16
1457009,1106672,2021-08-26,Assembly,"SB 614 Archuleta Consent Calendar Second Day Regular Session",73,0,0,6,79
1457011,1065231,2021-04-28,Senate,"Do pass as amended, and be ordered to the Consent Calendar",7,0,0,0,7
1457011,1075236,2021-05-10,Senate,"Consent Calendar SB616",37,0,3,0,40
1457011,1220000,2022-06-28,Assembly,"Do pass",11,0,0,0,11
1457011,1224062,2022-08-15,Assembly,"SB 616 Rubio Senate Third Reading By RUBIO",76,0,0,4,80
1457011,1224689,2022-08-24,Senate,"That the Assembly amendments be taken up for consideration",11,0,0,0,11
1457012,1048877,2021-04-08,Senate,"Do pass as amended, but first amend, and re-refer to the Committee on [Energy, Utilities and Communications]",4,0,1,0,5
1457012,1062765,2021-04-26,Senate,"Do pass as amended, but first amend, and re-refer to the Committee on [Appropriations]",12,2,0,0,14
1457012,1078806,2021-05-17,Senate,"Placed on suspense file",7,0,0,0,7
1457014,1066693,2021-04-29,Senate,"Do pass, but first be re-referred to the Committee on [Appropriations]",7,0,0,0,7
1457014,1081455,2021-05-20,Senate,"Senate 3rd Reading SB619 Laird",35,0,5,0,40
1457014,1100795,2021-06-23,Assembly,"Do pass and be re-referred to the Committee on [Appropriations]",11,0,0,0,11
1457014,1106810,2021-08-26,Assembly,"Do pass as amended",12,0,0,4,16
1457014,1107792,2021-09-03,Assembly,"SB 619 Laird Senate Third Reading By Eduardo Garcia Amend By GARCIA, E. Set #1",56,14,0,9,79
1457014,1108106,2021-09-08,Assembly,"SB 619 Laird Senate Third Reading By Eduardo Garcia",79,0,0,1,80
1457014,1108285,2021-09-09,Senate,"Unfinished Business SB619 Laird Concurrence",38,0,0,2,40
1457015,1123299,2022-01-11,Senate,"Do pass as amended, but first amend, and re-refer to the Committee on [Appropriations]",8,1,0,6,15
1457015,1124812,2022-01-18,Senate,"Placed on suspense file",6,0,0,1,7
1457015,1126324,2022-01-20,Senate,"Do pass as amended",5,0,0,2,7
1457015,1131254,2022-01-31,Senate,"Senate 3rd Reading SB620 Allen et al",23,2,0,15,40
1457016,1054611,2021-04-15,Senate,"Do pass, but first be re-referred to the Committee on [Governance and Finance]",6,0,3,0,9
1457017,1046171,2021-04-06,Senate,"Do pass, but first be re-referred to the Committee on [Education] with the recommendation: To Consent Calendar",5,0,0,0,5
1457017,1123777,2022-01-12,Senate,"Do pass, but first be re-referred to the Committee on [Appropriations]",7,0,0,0,7
1457017,1124811,2022-01-18,Senate,"Placed on suspense file",6,0,0,1,7
1457018,1051948,2021-04-13,Senate,"Do pass, but first be re-referred to the Committee on [Judiciary]",15,0,2,0,17
1457019,1054628,2021-04-15,Senate,"Do pass as amended, but first amend, and re-refer to the Committee on [Environmental Quality]",9,0,0,0,9
1457019,1066827,2021-04-29,Senate,"Do pass, but first be re-referred to the Committee on [Appropriations] with the recommendation: To Consent Calendar",7,0,0,0,7
1457019,1078845,2021-05-17,Senate,"Placed on suspense file",7,0,0,0,7
1457019,1081622,2021-05-20,Senate,"Do pass",7,0,0,0,7
1457019,1083873,2021-05-24,Senate,"Senate 3rd Reading SB624 Hueso",39,0,1,0,40
1457019,1099140,2021-06-17,Assembly,"Do pass as amended and be re-referred to the Committee on [Appropriations]",13,0,2,0,15
1457020,1044955,2021-04-05,Senate,"Do pass, but first be re-referred to the Committee on [Appropriations]",14,0,0,0,14
1457020,1056403,2021-04-19,Senate,"Placed on suspense file",7,0,0,0,7
1457020,1081462,2021-05-20,Senate,"Do pass",7,0,0,0,7
1457020,1091730,2021-06-03,Senate,"Senate 3rd Reading SB625 Caballero et al",39,0,1,0,40
1457020,1217471,2022-06-21,Assembly,"Do pass as amended and be re-referred to the Committee on [Appropriations]",6,0,0,0,6
1457021,1064035,2021-04-27,Senate,"Do pass as amended, but first amend, and re-refer to the Committee on [Appropriations]",9,0,0,0,9
1457021,1090370,2021-06-02,Senate,"Senate 3rd Reading SB626 Dodd",36,2,2,0,40
1457021,1103809,2021-07-01,Assembly,"Do pass and be re-referred to the Committee on [Appropriations]",9,0,6,0,15
1457021,1104885,2021-07-14,Assembly,"Do pass",10,2,4,0,16
1457021,1107151,2021-08-30,Assembly,"SB 626 Dodd Senate Third Reading By Friedman",68,3,0,8,79
1457021,1107406,2021-09-01,Senate,"Unfinished Business SB626 Dodd Concurrence",34,4,0,2,40
1457022,1120217,2022-01-04,Senate,"Do pass, but first be re-referred to the Committee on [Environmental Quality]",2,6,0,1,9
1457023,1051966,2021-04-13,Senate,"Be adopted, but first be re-referred to the Committee on [Appropriations] with recommendation: To Consent Calendar",15,0,2,0,17
1457023,1075259,2021-05-10,Senate,"Consent Calendar SCR14",37,0,3,0,40
1457023,1104240,2021-07-05,Assembly,"Be adopted. To Consent Calendar",15,0,0,0,15
1457023,1104518,2021-07-08,Assembly,"SCR 14 Hurtado Consent Calendar Second Day Regular Session",76,0,3,0,79
1457024,1036517,2021-03-24,Senate,"Be adopted. Ordered to third reading",4,2,1,0,7
1457024,1062762,2021-04-26,Senate,"Senate 3rd Reading SJR1 Allen",29,6,5,0,40
1457024,1098159,2021-06-15,Assembly,"Be adopted as amended",9,1,2,0,12
1457024,1107219,2021-08-30,Assembly,"SJR 1 Allen Senate Third Reading By Lee",55,13,0,11,79
1457024,1108009,2021-09-08,Senate,"Unfinished Business SJR1 Allen Concurrence",29,9,0,2,40
1458756,1051932,2021-04-13,Assembly,"Do pass as amended and be re-referred to the Committee on [Appropriations]",11,3,1,0,15
1458756,1081431,2021-05-20,Assembly,"Do pass as amended",12,4,0,0,16
1458756,1090450,2021-06-02,Assembly,"AB 1204 Wicks Assembly Third Reading",54,18,7,0,79
1458756,1104493,2021-07-07,Senate,"Do pass as amended, but first amend, and re-refer to the Committee on [Appropriations]",8,1,2,0,11
1458756,1106188,2021-08-16,Senate,"Placed on suspense file",7,0,0,0,7
1458756,1106937,2021-08-26,Senate,"Do pass as amended",5,2,0,0,7
1458756,1108294,2021-09-09,Senate,"Assembly 3rd Reading AB1204 Wicks et al. By Leyva",29,9,0,2,40
1458756,1108295,2021-09-09,Assembly,"AB 1204 WICKS Concurrence in Senate Amendments",54,19,0,7,80
1458758,1123322,2022-01-10,Assembly,"Do pass and be re-referred to the Committee on [Housing and Community Development]",9,0,0,2,11
1458758,1123789,2022-01-12,Assembly,"Do pass and be re-referred to the Committee on [Appropriations]",8,0,0,0,8
1458758,1126264,2022-01-20,Assembly,"Do pass as amended",12,0,0,4,16
1458758,1131238,2022-01-31,Assembly,"AB 1206 Bennett Assembly Third Reading",75,0,0,1,76
1458758,1211865,2022-06-01,Senate,"Do pass, but first be re-referred to the Committee on [Appropriations] with the recommendation: To Consent Calendar",5,0,0,0,5
1458758,1222931,2022-08-01,Senate,"Placed on suspense file",7,0,0,0,7
1458758,1223393,2022-08-11,Senate,"Do pass",6,0,0,1,7
1458758,1224718,2022-08-24,Senate,"Assembly 3rd Reading AB1206 Bennett et al. By Wiener",40,0,0,0,40
1458758,1224874,2022-08-25,Assembly,"AB 1206 Bennett Concurrence in Senate Amendments",76,0,0,4,80
1458759,1057641,2021-04-20,Assembly,"Do pass as amended and be re-referred to the Committee on [Appropriations]",13,0,2,0,15
1458759,1081717,2021-05-20,Assembly,"Do pass",16,0,0,0,16
1458759,1091727,2021-06-03,Assembly,"AB 1207 Akilah Weber Assembly Third Reading",78,0,1,0,79
1458759,1103432,2021-06-30,Senate,"Do pass as amended, but first amend, and re-refer to the Committee on [Appropriations] with the recommendation: To Consent Calendar",10,0,1,0,11
1458759,1106060,2021-08-16,Senate,"Placed on suspense file",7,0,0,0,7
1458759,1106815,2021-08-26,Senate,"Do pass",7,0,0,0,7
1458759,1107856,2021-09-07,Senate,"Assembly 3rd Reading AB1207 Akilah Weber et al. By Rubio",37,0,0,3,40
1458759,1108011,2021-09-08,Assembly,"AB 1207 Akilah Weber Concurrence in Senate Amendments",79,0,0,1,80
1458760,1035152,2021-03-23,Assembly,"Do pass and be re-referred to the Committee on [Appropriations] with recommendation: To Consent Calendar",11,0,0,0,11
1458760,1082144,2021-05-20,Assembly,"Do pass",16,0,0,0,16
1458760,1131265,2022-01-31,Assembly,"AB 1208 Ting Assembly Third Reading",76,0,0,0,76
1458760,1210901,2022-05-31,Senate,"Do pass, but first be re-referred to the Committee on [Appropriations] with the recommendation: To Consent Calendar",8,0,0,3,11
1458760,1217086,2022-06-20,Senate,"Placed on suspense file",4,0,0,3,7
1458760,1223449,2022-08-11,Senate,"Do pass",7,0,0,0,7
1458760,1224599,2022-08-23,Senate,"Special Consent AB1208",40,0,0,0,40
1458762,1059163,2021-04-20,Assembly,"Do pass",6,2,0,0,8
1458762,1062744,2021-04-26,Assembly,"AB 1210 Ting Assembly Third Reading",56,17,5,0,78
1458762,1095019,2021-06-08,Senate,"Do pass as amended",4,0,1,0,5
1458764,1124336,2022-01-14,Assembly,"AB 1212 Wood Assembly Third Reading",65,0,0,11,76
1458766,1064092,2021-04-27,Assembly,"Do pass as amended and be re-referred to the Committee on [Appropriations]",14,0,1,0,15
1458766,1081993,2021-05-20,Assembly,"Do pass as amended",16,0,0,0,16
1458766,1092977,2021-06-01,Assembly,"AB 1214 Waldron Assembly Third Reading",78,0,1,0,79
1458767,1048993,2021-04-08,Assembly,"Do pass and be re-referred to the Committee on [Appropriations]",10,0,2,0,12
1458767,1081552,2021-05-20,Assembly,"Do pass",15,0,1,0,16
1458767,1090478,2021-06-02,Assembly,"AB 1215 Boerner Horvath Assembly Third Reading",76,0,3,0,79
1458767,1100776,2021-06-23,Senate,"Do pass, but first be re-referred to the Committee on [Appropriations]",6,0,1,0,7
1458767,1104218,2021-07-05,Senate,"Placed on suspense file",6,0,1,0,7
1458767,1106730,2021-08-26,Senate,"Do pass",7,0,0,0,7
1458767,1107638,2021-09-02,Senate,"Assembly 3rd Reading AB1215 Boerner Horvath et a By Leyva",38,0,0,2,40
1458768,1060882,2021-04-22,Assembly,"Do pass as amended and be re-referred to the Committee on [Appropriations]",12,0,0,0,12
1458769,1057677,2021-04-19,Assembly,"Do pass. To Consent Calendar",6,0,1,0,7
1458770,1056358,2021-04-19,Assembly,"Do pass and be re-referred to the Committee on [Appropriations]",8,5,2,0,15
1458770,1126312,2022-01-20,Assembly,"Do pass",11,3,0,2,16
1458771,1051889,2021-04-12,Assembly,"Do pass and be re-referred to the Committee on [Appropriations]",9,0,2,0,11
1458771,1082186,2021-05-20,Assembly,"Do pass",16,0,0,0,16
1458771,1091778,2021-06-03,Assembly,"AB 1219 Berman Assembly Third Reading",78,0,1,0,79
1458771,1103827,2021-07-01,Senate,"Do pass, but first be re-referred to the Committee on [Appropriations]",5,0,0,0,5
1458771,1105073,2021-07-15,Senate,"Placed on suspense file",7,0,0,0,7
1458771,1106570,2021-08-26,Senate,"Do pass",7,0,0,0,7
1458771,1107829,2021-09-03,Senate,"Special Consent AB1219",37,0,0,3,40
1458772,1067598,2021-04-29,Assembly,"Do pass as amended and be re-referred to the Committee on [Appropriations]",8,0,0,0,8
1458772,1076970,2021-05-12,Assembly,"Do pass. To Consent Calendar",16,0,0,0,16
1458772,1081947,2021-05-20,Assembly,"AB 1220 Luz Rivas Consent Calendar Second Day Regular Session",76,0,2,0,78
1458772,1100268,2021-06-22,Senate,"Do pass as amended, but first amend, and re-refer to the Committee on [Housing]",4,1,0,0,5
1458772,1104516,2021-07-08,Senate,"Do pass, but first be re-referred to the Committee on [Appropriations]",9,0,0,0,9
1458772,1108634,2021-09-10,Senate,"Assembly 3rd Reading AB1220 Luz Rivas et al. By Caballero",37,0,0,3,40
1458772,1108635,2021-09-10,Assembly,"AB 1220 Luz Rivas Concurrence in Senate Amendments",78,0,0,2,80
1458773,1048924,2021-04-08,Assembly,"Do pass and be re-referred to the Committee on [Judiciary] with recommendation: To Consent Calendar",11,0,0,0,11
1458773,1072226,2021-05-04,Assembly,"Do pass as amended. To Consent Calendar",11,0,0,0,11
1458773,1080441,2021-05-19,Assembly,"Do pass. To Consent Calendar",15,0,1,0,16
1458773,1086960,2021-05-27,Assembly,"AB 1221 Flora Consent Calendar Second Day Regular Session",75,0,3,0,78
1458773,1104968,2021-07-13,Senate,"Do pass as amended, but first amend, and re-refer to the Committee on [Appropriations] with the recommendation: To Consent Calendar",11,0,0,0,11
1458773,1106048,2021-08-16,Senate,"Placed on suspense file",7,0,0,0,7
1458773,1106884,2021-08-26,Senate,"Do pass as amended",7,0,0,0,7
1458773,1108015,2021-09-08,Senate,"Assembly 3rd Reading AB1221 Flora By Jones",38,0,0,2,40
1458773,1108423,2021-09-09,Assembly,"AB 1221 Flora Concurrence in Senate Amendments",79,0,0,1,80
1458774,1057705,2021-04-20,Assembly,"Do pass and be re-referred to the Committee on [Appropriations] with recommendation: To Consent Calendar",19,0,0,0,19
1458774,1065242,2021-04-28,Assembly,"Do pass. To Consent Calendar",16,0,0,0,16
1458774,1074121,2021-05-06,Assembly,"AB 1222 Chen Consent Calendar Second Day Regular Session",77,0,1,0,78
1458774,1104919,2021-07-14,Senate,"Do pass, but first be re-referred to the Committee on [Appropriations]",13,0,1,0,14
1458774,1107481,2021-09-01,Senate,"Assembly 3rd Reading AB1222 Chen By Hueso",38,0,0,2,40
1458774,1107742,2021-09-02,Assembly,"AB 1222 Chen Concurrence in Senate Amendments",75,0,0,4,79
1458775,1047573,2021-04-06,Assembly,"Do pass and be re-referred to the Committee on [Revenue and Taxation]",6,2,0,0,8
1458775,1064077,2021-04-26,Assembly,"Do pass as amended and be re-referred to the Committee on [Appropriations]",6,4,1,0,11
1458775,1081711,2021-05-20,Assembly,"Do pass as amended",12,4,0,0,16
1458775,1091755,2021-06-03,Assembly,"AB 1223 Levine Assembly Third Reading",46,20,13,0,79
1458775,1097066,2021-06-10,Assembly,"AB 1223 Levine Assembly Third Reading Amendment Set #1",50,17,12,0,79
1458775,1127177,2022-01-24,Assembly,"AB 1223 Levine Third Reading Urgency Amendment Set #1",43,16,0,17,76
1458776,1059187,2021-04-20,Assembly,"Do pass and be re-referred to the Committee on [Appropriations]",5,2,1,0,8
1458777,1059205,2021-04-20,Assembly,"Do pass and be re-referred to the Committee on [Appropriations] with recommendation: To Consent Calendar",8,0,0,0,8
1458779,1123302,2022-01-10,Assembly,"Do pass and be re-referred to the Committee on [Appropriations]",8,2,0,1,11
1458779,1126309,2022-01-20,Assembly,"Do pass",12,3,0,1,16
1458779,1131277,2022-01-31,Assembly,"AB 1227 Levine Assembly Third Reading",56,19,0,1,76
1458779,1216396,2022-06-15,Senate,"Do pass as amended, but first amend, and re-refer to the Committee on [Public Safety]",4,1,0,0,5
1458779,1220759,2022-06-28,Senate,"Do pass, but first be re-referred to the Committee on [Appropriations]",4,1,0,0,5
1458779,1222720,2022-08-01,Senate,"Placed on suspense file",7,0,0,0,7
1458779,1223661,2022-08-11,Senate,"Do pass as amended",5,2,0,0,7
1458779,1225530,2022-08-31,Senate,"Assembly 3rd Reading AB1227 Levine et al. By Hertzberg Urgency Clause",20,12,0,8,40
1458780,1059173,2021-04-20,Assembly,"Do pass as amended and be re-referred to the Committee on [Appropriations]",6,2,0,0,8
1458780,1081627,2021-05-20,Assembly,"Do pass as amended",12,4,0,0,16
1458780,1090444,2021-06-02,Assembly,"AB 1228 Lee Assembly Third Reading",50,20,9,0,79
1458780,1102876,2021-06-29,Senate,"Do pass as amended, but first amend, and re-refer to the Committee on [Appropriations]",4,1,0,0,5
1458780,1105050,2021-07-15,Senate,"Placed on suspense file",7,0,0,0,7
1458780,1106845,2021-08-26,Senate,"Do pass as amended",5,2,0,0,7
1458780,1108178,2021-09-08,Senate,"Assembly 3rd Reading AB1228 Lee By Cortese",25,11,0,4,40
1458780,1108563,2021-09-10,Assembly,"AB 1228 Lee Concurrence in Senate Amendments",48,22,0,10,80
1458781,1044992,2021-04-05,Assembly,"Do pass and be re-referred to the Committee on [Appropriations]",7,0,0,0,7
1458781,1046131,2021-04-05,Assembly,"Do pass and be re-referred to the Committee on [Health]",7,0,0,0,7
1458781,1064037,2021-04-27,Assembly,"Do pass and be re-referred to the Committee on [Appropriations]",15,0,0,0,15
1458784,1123293,2022-01-11,Assembly,"Do pass and be re-referred to the Committee on [Appropriations]",11,0,0,1,12
1458784,1126340,2022-01-20,Assembly,"Do pass",15,0,0,1,16
1458784,1129909,2022-01-27,Assembly,"AB 1232 McCarty Assembly Third Reading",67,0,0,9,76
1458784,1211922,2022-06-01,Senate,"Do pass, but first be re-referred to the Committee on [Appropriations] with the recommendation: To Consent Calendar",6,0,0,1,7
1458784,1222724,2022-08-01,Senate,"Placed on suspense file",7,0,0,0,7
1458784,1223887,2022-08-11,Senate,"Do pass",7,0,0,0,7
1458784,1224614,2022-08-23,Senate,"Assembly 3rd Reading AB1232 McCarty By Hurtado",40,0,0,0,40
1458784,1224642,2022-08-24,Assembly,"AB 1232 McCarty Concurrence in Senate Amendments",75,0,0,5,80
1458788,1065255,2021-04-27,Assembly,"Do pass as amended and be re-referred to the Committee on [Appropriations]",19,0,0,0,19
1458788,1081608,2021-05-20,Assembly,"Do pass",16,0,0,0,16
1458789,1053573,2021-04-13,Assembly,"Do pass and be re-referred to the Committee on [Privacy and Consumer Protection]",6,2,0,0,8
1458789,1060968,2021-04-22,Assembly,"Do pass as amended and be re-referred to the Committee on [Appropriations]",8,2,1,0,11
1458790,1064034,2021-04-26,Assembly,"Do pass and be re-referred to the Committee on [Appropriations]",12,2,1,0,15
1458790,1081513,2021-05-20,Assembly,"Do pass",13,3,0,0,16
1458790,1090393,2021-06-02,Assembly,"AB 1238 Ting Assembly Third Reading",58,16,5,0,79
1458790,1102814,2021-06-29,Senate,"Do pass as amended, but first amend, and re-refer to the Committee on [Appropriations]",9,4,4,0,17
1458790,1105067,2021-07-15,Senate,"Placed on suspense file",7,0,0,0,7
1458790,1106600,2021-08-26,Senate,"Do pass",5,2,0,0,7
1458790,1108154,2021-09-08,Senate,"Assembly 3rd Reading AB1238 Ting et al. By Gonzalez",22,8,0,10,40
1458790,1108254,2021-09-09,Assembly,"AB 1238 Ting Concurrence in Senate Amendments",58,17,0,5,80
1458792,1123308,2022-01-10,Assembly,"Do pass and be re-referred to the Committee on [Appropriations] with recommendation: To Consent Calendar",11,0,0,0,11
1458792,1126310,2022-01-20,Assembly,"Do pass as amended",12,0,0,4,16
1458792,1131228,2022-01-31,Assembly,"AB 1240 Ting Assembly Third Reading",75,0,0,1,76
1458792,1211914,2022-06-01,Senate,"Do pass, but first be re-referred to the Committee on [Appropriations]",4,1,0,2,7
1458792,1217053,2022-06-20,Senate,"Placed on suspense file",4,0,0,3,7
1458792,1223528,2022-08-11,Senate,"Do pass",5,1,0,1,7
1458794,1060917,2021-04-22,Assembly,"Do pass as amended and be re-referred to the Committee on [Appropriations]",20,0,2,0,22
1458794,1081936,2021-05-20,Assembly,"Do pass as amended",12,0,4,0,16
1458794,1092890,2021-06-01,Assembly,"AB 1242 Bauer-Kahan Assembly Third Reading",79,0,0,0,79
1458794,1104276,2021-07-06,Senate,"Do pass, but first be re-referred to the Committee on [Appropriations] with the recommendation: To Consent Calendar",15,0,0,0,15
1458794,1220883,2022-06-28,Senate,"Do pass, but first be re-referred to the Committee on [Appropriations]",4,0,0,1,5
1458794,1222727,2022-08-01,Senate,"Placed on suspense file",7,0,0,0,7
1458794,1223571,2022-08-11,Senate,"Do pass as amended",4,2,0,1,7
1458794,1225537,2022-08-30,Senate,"Assembly 3rd Reading AB1242 Bauer-Kahan et al. By Skinner Urgency Clause",31,8,0,1,40
1458794,1225538,2022-08-31,Assembly,"AB 1242 Bauer-Kahan Concurrence - Urgency Added",62,15,0,3,80
1458795,1072275,2021-05-04,Assembly,"Do pass",11,0,0,0,11
1458795,1083833,2021-05-24,Assembly,"AB 1243 Blanca Rubio Assembly Third Reading",76,0,2,0,78
1458795,1104966,2021-07-13,Senate,"Do pass, but first be re-referred to the Committee on [Appropriations] with the recommendation: To Consent Calendar",11,0,0,0,11
1458795,1106168,2021-08-16,Senate,"Placed on suspense file",7,0,0,0,7
1458795,1106793,2021-08-26,Senate,"Do pass as amended",7,0,0,0,7
1458795,1108113,2021-09-08,Senate,"Special Consent AB1243",38,0,0,2,40
1458795,1108465,2021-09-09,Assembly,"AB 1243 Blanca Rubio Concurrence in Senate Amendments",79,0,0,1,80
1458797,1065291,2021-04-27,Assembly,"Do pass and be re-referred to the Committee on [Appropriations]",6,1,1,0,8
1458799,1059189,2021-04-20,Assembly,"Do pass and be re-referred to the Committee on [Appropriations] with recommendation: To Consent Calendar",8,0,0,0,8
1458799,1081825,2021-05-20,Assembly,"Do pass as amended",16,0,0,0,16
1458799,1092926,2021-06-01,Assembly,"AB 1247 Chau Assembly Third Reading",78,0,1,0,79
1458799,1104326,2021-07-06,Senate,"Do pass, but first be re-referred to the Committee on [Appropriations] with the recommendation: To Consent Calendar",5,0,0,0,5
1458799,1106196,2021-08-16,Senate,"Placed on suspense file",7,0,0,0,7
1458799,1106871,2021-08-26,Senate,"Do pass",7,0,0,0,7
1458799,1107813,2021-09-03,Senate,"Special Consent AB1247",37,0,0,3,40
1458801,1123333,2022-01-10,Assembly,"Do pass and be re-referred to the Committee on [Appropriations]",9,0,0,2,11
1458801,1126331,2022-01-20,Assembly,"Do pass as amended",15,0,0,1,16
1458801,1131226,2022-01-31,Assembly,"AB 1249 Gallagher Third Reading Urgency",74,0,0,2,76
1458801,1211896,2022-06-01,Senate,"Do pass, but first be re-referred to the Committee on [Appropriations] with the recommendation: To Consent Calendar",5,0,0,0,5
1458801,1215515,2022-06-13,Senate,"Placed on suspense file",7,0,0,0,7
1458801,1223659,2022-08-11,Senate,"Do pass",7,0,0,0,7
1458801,1225226,2022-08-30,Senate,"Assembly 3rd Reading AB1249 Gallagher et al. By Nielsen Urgency Clause",40,0,0,0,40
1458801,1225227,2022-08-31,Assembly,"AB 1249 Gallagher Concurrence in Senate Amendments",80,0,0,0,80
1458802,1047476,2021-04-07,Assembly,"Do pass and be re-referred to the Committee on [Utilities and Energy]",9,0,0,0,9
1458802,1059196,2021-04-21,Assembly,"Do pass and be re-referred to the Committee on [Appropriations] with recommendation: To Consent Calendar",15,0,0,0,15
1458802,1081413,2021-05-20,Assembly,"Do pass as amended",13,0,3,0,16
1458802,1092979,2021-06-01,Assembly,"AB 1250 Calderon Assembly Third Reading",75,0,4,0,79
1458802,1102477,2021-06-28,Senate,"Do pass as amended, but first amend, and re-refer to the Committee on [Environmental Quality]",13,0,1,0,14
1458802,1104379,2021-07-07,Senate,"Do pass, but first be re-referred to the Committee on [Appropriations] with the recommendation: To Consent Calendar",7,0,0,0,7
1458802,1106085,2021-08-16,Senate,"Placed on suspense file",7,0,0,0,7
1458802,1106644,2021-08-26,Senate,"Do pass",7,0,0,0,7
1458802,1107753,2021-09-03,Senate,"Special Consent AB1250",37,0,0,3,40
1458802,1107898,2021-09-07,Assembly,"AB 1250 Calderon Concurrence in Senate Amendments",70,0,0,10,80
1458804,1035186,2021-03-23,Assembly,"Do pass and be re-referred to the Committee on [Privacy and Consumer Protection]",11,2,2,0,15
1458804,1060886,2021-04-22,Assembly,"Do pass and be re-referred to the Committee on [Appropriations]",8,1,2,0,11
1458804,1081998,2021-05-20,Assembly,"Do pass",12,3,1,0,16
1458807,1053438,2021-04-14,Assembly,"Do pass as amended and be re-referred to the Committee on [Appropriations]",8,1,2,0,11
1458807,1081574,2021-05-20,Assembly,"Do pass",13,1,2,0,16
1458809,1054706,2021-04-14,Assembly,"Do pass and be re-referred to the Committee on [Appropriations]",12,0,1,0,13
1458809,1081987,2021-05-20,Assembly,"Do pass",16,0,0,0,16
1458809,1092975,2021-06-01,Assembly,"AB 1257 Patterson Assembly Third Reading",79,0,0,0,79
1458809,1102462,2021-06-28,Senate,"Do pass, but first be re-referred to the Committee on [Appropriations]",14,0,0,0,14
1458809,1105036,2021-07-15,Senate,"Placed on suspense file",7,0,0,0,7
1458811,1065212,2021-04-27,Assembly,"Do pass and be re-referred to the Committee on [Appropriations]",6,2,0,0,8
1458811,1076971,2021-05-12,Assembly,"Do pass",12,4,0,0,16
1458811,1083797,2021-05-24,Assembly,"AB 1259 Chiu Assembly Third Reading",53,19,6,0,78
1458811,1100257,2021-06-22,Senate,"Do pass, but first be re-referred to the Committee on [Appropriations]",4,1,0,0,5
1458811,1104147,2021-07-05,Senate,"Placed on suspense file",6,0,1,0,7
1458811,1106602,2021-08-26,Senate,"Do pass",5,2,0,0,7
1458811,1108363,2021-09-09,Senate,"Assembly 3rd Reading AB1259 Chiu et al. By Skinner",27,10,0,3,40
1458812,1065095,2021-04-28,Assembly,"Do pass and be re-referred to the Committee on [Appropriations]",8,2,1,0,11
1458812,1076924,2021-05-12,Assembly,"Do pass",16,0,0,0,16
1458812,1083810,2021-05-24,Assembly,"AB 1260 Chen Assembly Third Reading",66,6,6,0,78
1458812,1102456,2021-06-28,Senate,"Do pass as amended, but first amend, and re-refer to the Committee on [Appropriations]",6,0,1,0,7
1458812,1106209,2021-08-16,Senate,"Placed on suspense file",7,0,0,0,7
1458813,1053487,2021-04-14,Assembly,"Do pass and be re-referred to the Committee on [Appropriations] with recommendation: To Consent Calendar",11,0,0,0,11
1458813,1081755,2021-05-20,Assembly,"Do pass as amended",16,0,0,0,16
1458813,1090480,2021-06-02,Assembly,"AB 1261 Burke Assembly Third Reading",76,0,3,0,79
1458813,1102507,2021-06-28,Senate,"Do pass, but first be re-referred to the Committee on [Appropriations] with the recommendation: To Consent Calendar",6,0,1,0,7
1458813,1104222,2021-07-05,Senate,"Placed on suspense file",6,0,1,0,7
1458813,1106720,2021-08-26,Senate,"Do pass as amended",7,0,0,0,7
1458813,1108101,2021-09-08,Senate,"Special Consent AB1261",38,0,0,2,40
1458813,1108371,2021-09-09,Assembly,"AB 1261 Burke Concurrence in Senate Amendments",79,0,0,1,80
1458814,1060813,2021-04-22,Assembly,"Do pass and be re-referred to the Committee on [Appropriations]",10,0,1,0,11
1458814,1073338,2021-05-05,Assembly,"Do pass",16,0,0,0,16
1458814,1075375,2021-05-10,Assembly,"AB 1262 Cunningham Assembly Third Reading",63,0,15,0,78
1458814,1123745,2022-01-12,Senate,"Do pass, but first be re-referred to the Committee on [Appropriations]",8,0,0,3,11
1458814,1223234,2022-08-08,Senate,"Placed on suspense file",7,0,0,0,7
1458814,1223775,2022-08-11,Senate,"Do pass",5,0,0,2,7
1458814,1225212,2022-08-31,Senate,"Assembly 3rd Reading AB1262 Cunningham et al. By Wieckowski",36,0,0,4,40
1458814,1225213,2022-08-31,Assembly,"AB 1262 Cunningham Concurrence in Senate Amendments",80,0,0,0,80
1458816,1051884,2021-04-13,Assembly,"Do pass and be re-referred to the Committee on [Appropriations] with recommendation: To Consent Calendar",15,0,0,0,15
1458819,1060860,2021-04-22,Assembly,"Do pass as amended and be re-referred to the Committee on [Appropriations]",21,0,1,0,22
1458819,1076957,2021-05-12,Assembly,"Do pass. To Consent Calendar",16,0,0,0,16
1458819,1081939,2021-05-20,Assembly,"AB 1267 Cunningham Consent Calendar Second Day Regular Session",76,0,2,0,78
1458819,1100290,2021-06-22,Senate,"Do pass, but first be re-referred to the Committee on [Appropriations]",12,0,3,0,15
1458819,1107193,2021-08-30,Senate,"Assembly 3rd Reading AB1267 Cunningham By Laird",39,0,0,1,40
1458819,1107490,2021-09-01,Assembly,"AB 1267 Cunningham Concurrence in Senate Amendments",77,0,0,2,79
1458821,1048937,2021-04-08,Assembly,"Do pass as amended and be re-referred to the Committee on [Appropriations]",11,1,0,0,12
1458823,1054632,2021-04-14,Assembly,"Do pass as amended and be re-referred to the Committee on [Housing and Community Development]",6,1,1,0,8
1458825,1060977,2021-04-22,Assembly,"Do pass and be re-referred to the Committee on [Appropriations] with recommendation: To Consent Calendar",7,0,0,0,7
1458825,1073419,2021-05-05,Assembly,"Do pass. To Consent Calendar",16,0,0,0,16
1458825,1077528,2021-05-13,Assembly,"AB 1273 Rodriguez Consent Calendar Second Day Regular Session",75,0,3,0,78
1458825,1093681,2021-06-07,Senate,"Do pass, but first be re-referred to the Committee on [Health]",5,0,0,0,5
1458825,1101637,2021-06-23,Senate,"Do pass as amended, but first amend, and re-refer to the Committee on [Appropriations]",9,0,2,0,11
1458825,1108148,2021-09-08,Senate,"Assembly 3rd Reading AB1273 Rodriguez By Hurtado",38,0,0,2,40
1458825,1108668,2021-09-10,Assembly,"AB 1273 Rodriguez Concurrence in Senate Amendments",72,0,0,8,80
1458827,1048883,2021-04-08,Assembly,"Do pass and be re-referred to the Committee on [Appropriations]",22,0,0,0,22
1458827,1080390,2021-05-19,Assembly,"Do pass. To Consent Calendar",15,0,1,0,16
1458827,1087037,2021-05-27,Assembly,"AB 1275 Jones-Sawyer Consent Calendar Second Day Regular Session",75,0,3,0,78
1458827,1100307,2021-06-22,Senate,"Do pass, but first be re-referred to the Committee on [Appropriations] with the recommendation: To Consent Calendar",15,0,0,0,15
1458827,1107115,2021-08-30,Senate,"Consent Calendar AB1275",39,0,0,1,40
1458828,1036468,2021-03-24,Assembly,"Do pass as amended and be re-referred to the Committee on [Appropriations]",8,0,3,0,11
1458828,1082011,2021-05-20,Assembly,"Do pass",12,4,0,0,16
1458828,1092889,2021-06-01,Assembly,"AB 1276 Carrillo Assembly Third Reading",58,14,7,0,79
1458828,1103786,2021-07-01,Senate,"Do pass as amended, but first amend, and re-refer to the Committee on [Governance and Finance]",5,2,0,0,7
1458828,1104529,2021-07-08,Senate,"Do pass, but first be re-referred to the Committee on [Appropriations]",5,0,0,0,5
1458828,1106467,2021-08-23,Senate,"Placed on suspense file",7,0,0,0,7
1458828,1106883,2021-08-26,Senate,"Do pass as amended",5,2,0,0,7
1458828,1108059,2021-09-08,Senate,"Assembly 3rd Reading AB1276 Carrillo et al. By Allen",28,10,0,2,40
1458828,1108397,2021-09-09,Assembly,"AB 1276 Carrillo Concurrence in Senate Amendments",58,15,0,7,80
1458830,1051972,2021-04-13,Assembly,"Do pass as amended and be re-referred to the Committee on [Appropriations]",13,0,6,0,19
1458830,1065179,2021-04-28,Assembly,"Do pass",12,0,4,0,16
1458830,1068199,2021-05-03,Assembly,"AB 1278 Nazarian Assembly Third Reading",54,9,15,0,78
1458830,1104635,2021-07-12,Senate,"Do pass as amended, but first amend, and re-refer to the Committee on [Appropriations]",8,0,6,0,14
1458830,1106412,2021-08-23,Senate,"Placed on suspense file",7,0,0,0,7
1458830,1223956,2022-08-11,Senate,"Do pass as amended",5,1,0,1,7
1458830,1225347,2022-08-29,Senate,"Assembly 3rd Reading AB1278 Nazarian By Allen",21,4,0,15,40
1458830,1225348,2022-08-30,Assembly,"AB 1278 Nazarian Concurrence in Senate Amendments",57,7,0,16,80
1458830,1229715,2022-08-30,Senate,"Assembly 3rd Reading AB1278 Nazarian By Allen",21,4,0,15,40
1458831,1064057,2021-04-26,Assembly,"Do pass and be re-referred to the Committee on [Appropriations] with recommendation: To Consent Calendar",15,0,0,0,15
1458831,1080391,2021-05-19,Assembly,"Do pass. To Consent Calendar",15,0,1,0,16
1458831,1086984,2021-05-27,Assembly,"AB 1279 Muratsuchi Consent Calendar Second Day Regular Session",75,0,3,0,78
1458831,1225451,2022-08-31,Senate,"Assembly 3rd Reading AB1279 Muratsuchi et al. By Lim贸n",26,10,0,4,40
1458831,1225452,2022-08-31,Assembly,"AB 1279 Muratsuchi Concurrence in Senate Amendments",52,18,0,10,80
1458832,1064026,2021-04-27,Assembly,"Do pass and be re-referred to the Committee on [Appropriations]",15,0,0,0,15
1458832,1073367,2021-05-05,Assembly,"Do pass. To Consent Calendar",16,0,0,0,16
1458832,1077605,2021-05-13,Assembly,"AB 1280 Irwin Consent Calendar Second Day Regular Session",75,0,3,0,78
1458832,1098638,2021-06-16,Senate,"Do pass, but first be re-referred to the Committee on [Appropriations] with the recommendation: To Consent Calendar",10,0,1,0,11
1458832,1107121,2021-08-30,Senate,"Assembly 3rd Reading AB1280 Irwin et al. By Roth",39,0,0,1,40
1458832,1107426,2021-09-01,Assembly,"AB 1280 Irwin Concurrence in Senate Amendments",78,0,0,1,79
1458833,1065171,2021-04-27,Assembly,"Do pass as amended",8,0,0,0,8
1458833,1083806,2021-05-24,Assembly,"AB 1281 Blanca Rubio Assembly Third Reading",75,0,3,0,78
1458833,1100283,2021-06-22,Senate,"Do pass",4,0,1,0,5
1458833,1108466,2021-09-09,Senate,"Assembly 3rd Reading AB1281 Blanca Rubio et al. By Rubio",37,0,0,3,40
1458833,1108467,2021-09-09,Assembly,"AB 1281 RUBIO Concurrence in Senate Amendments",78,0,0,2,80
1458834,1057735,2021-04-20,Assembly,"Do pass and be re-referred to the Committee on [Agriculture]",19,0,0,0,19
1458834,1066678,2021-04-29,Assembly,"Do pass and be re-referred to the Committee on [Appropriations]",9,1,1,0,11
1458834,1082113,2021-05-20,Assembly,"Do pass as amended",12,0,4,0,16
1458834,1092893,2021-06-01,Assembly,"AB 1282 Bloom Assembly Third Reading",75,1,3,0,79
1458834,1103759,2021-07-01,Senate,"Do pass, but first be re-referred to the Committee on [Business, Professions and Economic Development]",5,0,0,0,5
1458834,1104886,2021-07-14,Senate,"Do pass, but first be re-referred to the Committee on [Appropriations]",13,0,1,0,14
1458834,1106207,2021-08-16,Senate,"Placed on suspense file",7,0,0,0,7
1458834,1106611,2021-08-26,Senate,"Do pass as amended",7,0,0,0,7
1458834,1107510,2021-09-01,Senate,"Assembly 3rd Reading AB1282 Bloom et al. By Wilk",38,1,0,1,40
1458834,1107574,2021-09-02,Assembly,"AB 1282 Bloom Concurrence in Senate Amendments",75,1,0,3,79
1458835,1059260,2021-04-21,Assembly,"Do pass and be re-referred to the Committee on [Appropriations] with recommendation: To Consent Calendar",8,0,0,0,8
1458835,1073410,2021-05-05,Assembly,"Do pass. To Consent Calendar",16,0,0,0,16
1458835,1077541,2021-05-13,Assembly,"AB 1283 Stone Consent Calendar Second Day Regular Session",75,0,3,0,78
1458835,1095038,2021-06-08,Senate,"Do pass, but first be re-referred to the Committee on [Judiciary] with the recommendation: To Consent Calendar",5,0,0,0,5
1458835,1104419,2021-07-06,Senate,"Do pass, but first be re-referred to the Committee on [Appropriations] with the recommendation: To Consent Calendar",11,0,0,0,11
1458835,1107861,2021-09-07,Senate,"Assembly 3rd Reading AB1283 Stone By Hurtado",37,0,0,3,40
1458835,1108053,2021-09-08,Assembly,"AB 1283 Stone Concurrence in Senate Amendments",79,0,0,1,80
1458838,1064056,2021-04-27,Assembly,"Do pass and be re-referred to the Committee on [Appropriations] with recommendation: To Consent Calendar",15,0,0,0,15
1458839,1046123,2021-04-06,Assembly,"Do pass and be re-referred to the Committee on [Judiciary]",18,0,1,0,19
1458839,1057642,2021-04-20,Assembly,"Do pass as amended and be re-referred to the Committee on [Appropriations]",9,1,1,0,11
1458839,1126290,2022-01-20,Assembly,"Do pass",14,0,0,2,16
1458839,1129874,2022-01-27,Assembly,"AB 1287 Bauer-Kahan Assembly Third Reading",59,0,0,17,76
1458839,1215008,2022-06-08,Senate,"Do pass as amended, but first amend, and re-refer to the Committee on [Appropriations]",7,2,0,2,11
1458839,1219482,2022-06-27,Senate,"Placed on suspense file",6,0,0,1,7
1458839,1223855,2022-08-11,Senate,"Do pass",4,1,0,2,7
1458839,1225686,2022-08-29,Senate,"Assembly 3rd Reading AB1287 Bauer-Kahan et al. By Durazo",30,7,0,3,40
1458839,1225687,2022-08-30,Assembly,"AB 1287 Bauer-Kahan Concurrence in Senate Amendments",66,0,0,14,80
1458840,1123310,2022-01-10,Assembly,"Do pass and be re-referred to the Committee on [Appropriations]",7,0,0,4,11
1458840,1126306,2022-01-20,Assembly,"Do pass as amended",12,0,0,4,16
1458840,1131230,2022-01-31,Assembly,"AB 1288 Quirk-Silva Assembly Third Reading",58,0,0,18,76
1458840,1211903,2022-05-31,Senate,"Do pass, but first be re-referred to the Committee on [Governance and Finance]",7,0,0,2,9
1458840,1216383,2022-06-15,Senate,"Do pass as amended, but first amend, and re-refer to the Committee on [Appropriations]",5,0,0,0,5
1458840,1223268,2022-08-08,Senate,"Placed on suspense file",7,0,0,0,7
1458840,1223938,2022-08-11,Senate,"Do pass",6,0,0,1,7
1458840,1225424,2022-08-29,Senate,"Assembly 3rd Reading AB1288 Quirk-Silva By Skinner",32,0,0,8,40
1458840,1225425,2022-08-30,Assembly,"AB 1288 Quirk-Silva Concurrence in Senate Amendments",63,0,0,17,80
1458842,1048922,2021-04-08,Assembly,"Do pass and be re-referred to the Committee on [Appropriations]",12,0,0,0,12
1458842,1059155,2021-04-21,Assembly,"Do pass. To Consent Calendar",14,0,2,0,16
1458842,1066822,2021-04-29,Assembly,"AB 1290 Lee Consent Calendar Second Day Regular Session",77,0,1,0,78
1458842,1220749,2022-06-28,Senate,"Do pass as amended, but first amend, and re-refer to the Committee on [Appropriations] with the recommendation: To Consent Calendar",5,0,0,0,5
1458842,1224171,2022-08-18,Senate,"Assembly 3rd Reading AB1290 Lee By Stern",38,0,0,2,40
1458842,1225214,2022-08-31,Senate,"Special Consent AB1290",40,0,0,0,40
1458842,1225215,2022-08-31,Assembly,"AB 1290 Lee Concurrence in Senate Amendments",80,0,0,0,80
1458843,1048939,2021-04-08,Assembly,"Do pass and be re-referred to the Committee on [Appropriations] with recommendation: To Consent Calendar",22,0,0,0,22
1458843,1059177,2021-04-21,Assembly,"Do pass. To Consent Calendar",14,0,2,0,16
1458843,1066734,2021-04-29,Assembly,"AB 1291 Frazier Consent Calendar Second Day Regular Session",77,0,1,0,78
1458843,1095029,2021-06-08,Senate,"Do pass, but first be re-referred to the Committee on [Appropriations] with the recommendation: To Consent Calendar",14,0,1,0,15
1458843,1101674,2021-06-24,Senate,"Consent Calendar AB1291",39,0,1,0,40
1458845,1054636,2021-04-15,Assembly,"Do pass and be re-referred to the Committee on [Appropriations]",7,0,0,0,7
1458845,1073352,2021-05-05,Assembly,"Do pass",16,0,0,0,16
1458845,1077567,2021-05-13,Assembly,"AB 1293 Cooley Assembly Third Reading",75,0,3,0,78
1458845,1104601,2021-07-12,Senate,"Do pass, but first be re-referred to the Committee on [Appropriations] with the recommendation: To Consent Calendar",5,0,0,0,5
1458845,1107211,2021-08-30,Senate,"Consent Calendar AB1293",39,0,0,1,40
1458845,1107441,2021-09-01,Assembly,"AB 1293 Cooley Concurrence in Senate Amendments",77,0,0,2,79
1458846,1047477,2021-04-07,Assembly,"Do pass and be re-referred to the Committee on [Education] with recommendation: To Consent Calendar",8,0,0,0,8
1458846,1065269,2021-04-28,Assembly,"Do pass and be re-referred to the Committee on [Appropriations] with recommendation: To Consent Calendar",7,0,0,0,7
1458846,1081419,2021-05-20,Assembly,"Do pass",16,0,0,0,16
1458846,1088009,2021-05-28,Assembly,"AB 1294 Quirk Third Reading Urgency",77,0,2,0,79
1458846,1100809,2021-06-23,Senate,"Do pass, but first be re-referred to the Committee on [Human Services] with the recommendation: To Consent Calendar",7,0,0,0,7
1458846,1104384,2021-07-06,Senate,"Do pass, but first be re-referred to the Committee on [Appropriations] with the recommendation: To Consent Calendar",5,0,0,0,5
1458846,1106179,2021-08-16,Senate,"Placed on suspense file",7,0,0,0,7
1458846,1106617,2021-08-26,Senate,"Do pass as amended",7,0,0,0,7
1458846,1108184,2021-09-08,Senate,"Special Consent AB1294 Quirk et al. Urgency Clause",38,0,0,2,40
1458846,1108261,2021-09-09,Assembly,"AB 1294 Quirk Concurrence in Senate Amendments",79,0,0,1,80
1458849,1051928,2021-04-13,Assembly,"Do pass as amended and be re-referred to the Committee on [Housing and Community Development]",7,0,0,0,7
1458849,1067613,2021-04-29,Assembly,"Do pass and be re-referred to the Committee on [Appropriations]",5,1,2,0,8
1458849,1076979,2021-05-12,Assembly,"Do pass",13,3,0,0,16
1458849,1083800,2021-05-24,Assembly,"AB 1297 Holden Assembly Third Reading",65,1,12,0,78
1458849,1103428,2021-06-30,Senate,"Do pass, but first be re-referred to the Committee on [Housing]",12,0,2,0,14
1458849,1104541,2021-07-08,Senate,"Do pass, but first be re-referred to the Committee on [Appropriations]",9,0,0,0,9
1458849,1106455,2021-08-23,Senate,"Placed on suspense file",7,0,0,0,7
1458849,1106651,2021-08-26,Senate,"Do pass",7,0,0,0,7
1458849,1107486,2021-09-01,Senate,"Assembly 3rd Reading AB1297 Holden et al. By Wiener",38,0,0,2,40
1458849,1107689,2021-09-02,Assembly,"AB 1297 Holden Concurrence in Senate Amendments",67,0,0,12,79
1458850,1047556,2021-04-07,Assembly,"Do pass and be re-referred to the Committee on [Water, Parks, and Wildlife] with recommendation: To Consent Calendar",9,0,0,0,9
1458850,1064165,2021-04-26,Assembly,"Do pass and be re-referred to the Committee on [Appropriations] with recommendation: To Consent Calendar",15,0,0,0,15
1458850,1080425,2021-05-19,Assembly,"Do pass. To Consent Calendar",15,0,1,0,16
1458850,1090430,2021-06-02,Assembly,"AB 1298 Bloom Assembly Third Reading",76,0,3,0,79
1458850,1097775,2021-06-14,Senate,"Do pass, but first be re-referred to the Committee on [Natural Resources and Water] with the recommendation: To Consent Calendar",7,0,0,0,7
1458850,1104774,2021-07-13,Senate,"Do pass, but first be re-referred to the Committee on [Appropriations] with the recommendation: To Consent Calendar",8,0,1,0,9
1458850,1107246,2021-08-30,Senate,"Consent Calendar AB1298",39,0,0,1,40
1458854,1065111,2021-04-27,Assembly,"Do pass and be re-referred to the Committee on [Appropriations]",16,2,1,0,19
1458854,1080408,2021-05-19,Assembly,"Do pass",14,0,2,0,16
1458854,1086981,2021-05-27,Assembly,"AB 1302 Quirk Assembly Third Reading",58,7,13,0,78
1458854,1103410,2021-06-30,Senate,"Do pass, but first be re-referred to the Committee on [Transportation]",8,2,4,0,14
1458854,1104699,2021-07-13,Senate,"Do pass, but first be re-referred to the Committee on [Appropriations]",9,2,6,0,17
1458854,1107387,2021-09-01,Senate,"Assembly 3rd Reading AB1302 Quirk By Caballero",27,8,0,5,40
1458856,1054678,2021-04-15,Assembly,"Do pass and be re-referred to the Committee on [Local Government]",6,0,2,0,8
1458856,1065270,2021-04-28,Assembly,"Do pass and be re-referred to the Committee on [Appropriations]",7,1,0,0,8
1458856,1073358,2021-05-05,Assembly,"Do pass",12,3,1,0,16
1458856,1078776,2021-05-17,Assembly,"AB 1304 Santiago Assembly Third Reading",56,13,9,0,78
1458856,1099153,2021-06-17,Senate,"Do pass as amended, but first amend, and re-refer to the Committee on [Judiciary]",6,1,2,0,9
1458856,1104464,2021-07-06,Senate,"Do pass, but first be re-referred to the Committee on [Appropriations]",9,2,0,0,11
1458856,1108270,2021-09-09,Senate,"Assembly 3rd Reading AB1304 Santiago et al. By Wiener",29,9,0,2,40
1458856,1108271,2021-09-09,Assembly,"AB 1304 SANTIAGO Concurrence in Senate Amendments",57,17,0,6,80
1458857,1046150,2021-04-06,Assembly,"Do pass and be re-referred to the Committee on [Appropriations] with recommendation: To Consent Calendar",18,0,1,0,19
1458857,1053576,2021-04-14,Assembly,"Do pass. To Consent Calendar",16,0,0,0,16
1458857,1060913,2021-04-22,Assembly,"AB 1305 Lackey Consent Calendar Second Day Regular Session",77,0,2,0,79
1458857,1093659,2021-06-07,Senate,"Do pass, but first be re-referred to the Committee on [Appropriations] with the recommendation: To Consent Calendar",12,0,2,0,14
1458857,1106230,2021-08-16,Senate,"Assembly 3rd Reading AB1305 Lackey By Wilk",39,0,0,1,40
1458857,1106393,2021-08-23,Assembly,"AB 1305 Lackey Concurrence in Senate Amendments",70,0,0,9,79
1458858,1064049,2021-04-27,Assembly,"Do pass",15,0,0,0,15
1458858,1078738,2021-05-17,Assembly,"AB 1306 Arambula Assembly Third Reading",72,0,6,0,78
1458858,1104925,2021-07-14,Senate,"Do pass, but first be re-referred to the Committee on [Appropriations] with the recommendation: To Consent Calendar",9,0,2,0,11
1458858,1106163,2021-08-16,Senate,"Placed on suspense file",7,0,0,0,7
1458859,1123770,2022-01-12,Assembly,"Do pass as amended and be re-referred to the Committee on [Appropriations]",6,2,0,0,8
1458859,1123771,2022-01-12,Assembly,"Do pass and be re-referred to the Committee on [Local Government]",6,1,0,0,7
1458859,1126320,2022-01-20,Assembly,"Do pass",12,3,0,1,16
1458859,1129898,2022-01-27,Assembly,"AB 1307 Cervantes Assembly Third Reading",53,15,0,8,76
1458859,1215552,2022-06-13,Senate,"Do pass, but first be re-referred to the Committee on [Governance and Finance]",3,1,0,1,5
1458859,1217897,2022-06-22,Senate,"Do pass, but first be re-referred to the Committee on [Appropriations]",4,1,0,0,5
1458859,1222903,2022-08-01,Senate,"Placed on suspense file",7,0,0,0,7
1458859,1223896,2022-08-11,Senate,"Do pass",5,2,0,0,7
1458859,1225321,2022-08-29,Senate,"Assembly 3rd Reading AB1307 Cervantes et al. By Durazo",30,9,0,1,40
1458859,1225322,2022-08-30,Assembly,"AB 1307 Cervantes Concurrence in Senate Amendments",59,19,0,2,80
1458860,1065079,2021-04-27,Assembly,"Do pass and be re-referred to the Committee on [Appropriations]",6,2,0,0,8
1458860,1081469,2021-05-20,Assembly,"Do pass",12,4,0,0,16
1458860,1091698,2021-06-03,Assembly,"AB 1308 Ting Assembly Third Reading",54,18,7,0,79
1458863,1053481,2021-04-14,Assembly,"Do pass and be re-referred to the Committee on [Appropriations]",11,0,0,0,11
1458863,1081637,2021-05-20,Assembly,"Do pass",16,0,0,0,16
1458863,1088010,2021-05-28,Assembly,"AB 1311 Wood Assembly Third Reading",77,0,2,0,79
1458863,1104420,2021-07-07,Senate,"Do pass, but first be re-referred to the Committee on [Appropriations] with the recommendation: To Consent Calendar",7,0,0,0,7
1458863,1106215,2021-08-16,Senate,"Placed on suspense file",7,0,0,0,7
1458863,1107001,2021-08-26,Senate,"Do pass",7,0,0,0,7
1458863,1108306,2021-09-09,Senate,"Assembly 3rd Reading AB1311 Wood et al. By McGuire",38,0,0,2,40
1458863,1108307,2021-09-09,Assembly,"AB 1311 WOOD Concurrence in Senate Amendments",77,0,0,3,80
1458866,1065140,2021-04-28,Assembly,"Do pass. To Consent Calendar",11,0,0,0,11
1458866,1074139,2021-05-06,Assembly,"AB 1314 V. A. Consent Calendar Second Day Regular Session",77,0,1,0,78
1458866,1220872,2022-06-28,Senate,"Do pass, but first be re-referred to the Committee on [Appropriations]",5,0,0,0,5
1458866,1224916,2022-08-25,Senate,"Assembly 3rd Reading AB1314 Ramos et al. By Rubio",40,0,0,0,40
1458866,1225077,2022-08-29,Assembly,"With recommendation: That Senate amendments be concurred in",6,0,0,1,7
1458866,1225939,2022-08-30,Assembly,"AB 1314 Ramos Concurrence in Senate Amendments",79,0,0,1,80
1458867,1065163,2021-04-28,Assembly,"Do pass and be re-referred to the Committee on [Appropriations] with recommendation: To Consent Calendar",11,0,0,0,11
1458867,1073386,2021-05-05,Assembly,"Do pass. To Consent Calendar",16,0,0,0,16
1458867,1077532,2021-05-13,Assembly,"AB 1315 V. A. Consent Calendar Second Day Regular Session",75,0,3,0,78
1458868,1065114,2021-04-28,Assembly,"Do pass as amended and be re-referred to the Committee on [Appropriations]",5,2,0,0,7
1458868,1081928,2021-05-20,Assembly,"Do pass as amended",10,3,3,0,16
1458870,1046185,2021-04-06,Assembly,"Do pass",8,0,3,0,11
1458870,1053514,2021-04-12,Assembly,"AB 1318 Stone Assembly Third Reading",57,7,14,0,78
1458870,1104733,2021-07-13,Senate,"Do pass as amended, but first amend, and re-refer to the Committee on [Appropriations]",5,0,0,0,5
1458870,1107262,2021-08-30,Senate,"Assembly 3rd Reading AB1318 Stone By Cortese",30,7,0,3,40
1458870,1107478,2021-09-01,Assembly,"AB 1318 Stone Concurrence in Senate Amendments",60,13,0,6,79
1458871,1048968,2021-04-08,Assembly,"Do pass and be re-referred to the Committee on [Banking and Finance]",5,0,2,0,7
1458871,1066763,2021-04-29,Assembly,"Do pass and be re-referred to the Committee on [Appropriations]",9,1,2,0,12
1458872,1054657,2021-04-15,Assembly,"Do pass and be re-referred to the Committee on [Appropriations] with recommendation: To Consent Calendar",12,0,0,0,12
1458872,1065280,2021-04-28,Assembly,"Do pass. To Consent Calendar",16,0,0,0,16
1458872,1074172,2021-05-06,Assembly,"AB 1320 Bauer-Kahan Consent Calendar Second Day Regular Session",77,0,1,0,78
1458872,1096120,2021-06-09,Senate,"Do pass as amended, but first amend, and re-refer to the Committee on [Judiciary]",9,0,0,0,9
1458872,1100812,2021-06-22,Senate,"Do pass, but first be re-referred to the Committee on [Appropriations]",11,0,0,0,11
1458872,1104191,2021-07-05,Senate,"Placed on suspense file",6,0,1,0,7
1458872,1106563,2021-08-26,Senate,"Do pass as amended",7,0,0,0,7
1458872,1108147,2021-09-08,Senate,"Special Consent AB1320",38,0,0,2,40
1458872,1108433,2021-09-09,Assembly,"AB 1320 Bauer-Kahan Concurrence in Senate Amendments",78,0,0,2,80
1458874,1054668,2021-04-14,Assembly,"Do pass as amended and be re-referred to the Committee on [Housing and Community Development]",5,3,0,0,8
1458874,1067616,2021-04-29,Assembly,"Do pass as amended",6,2,0,0,8
1458874,1075295,2021-05-10,Assembly,"AB 1322 Robert Rivas Assembly Third Reading",49,22,7,0,78
1458874,1215020,2022-06-08,Senate,"Do pass as amended, but first amend, and re-refer to the Committee on [Appropriations]",4,0,0,3,7
1458874,1222647,2022-08-01,Senate,"Placed on suspense file",7,0,0,0,7
1458874,1224022,2022-08-11,Senate,"Do pass as amended",5,0,0,2,7
1458874,1225152,2022-08-30,Assembly,"With recommendation: That Senate amendments be concurred in",10,0,0,5,15
1458874,1225198,2022-08-29,Senate,"Assembly 3rd Reading AB1322 Robert Rivas et al. By Becker",33,0,0,7,40
1458874,1225199,2022-08-31,Assembly,"AB 1322 Robert Rivas Concurrence in Senate Amendments",73,0,0,7,80
1458875,1048927,2021-04-08,Assembly,"Do pass and be re-referred to the Committee on [Accountability and Administrative Review] with recommendation: To Consent Calendar",11,0,0,0,11
1458875,1065191,2021-04-28,Assembly,"Do pass and be re-referred to the Committee on [Appropriations] with recommendation: To Consent Calendar",7,0,0,0,7
1458875,1081562,2021-05-20,Assembly,"Do pass",16,0,0,0,16
1458875,1088011,2021-05-28,Assembly,"AB 1323 Chiu Assembly Third Reading",77,0,2,0,79
1458875,1219904,2022-06-28,Senate,"Do pass, but first be re-referred to the Committee on [Appropriations] with the recommendation: To Consent Calendar",13,0,0,2,15
1458875,1223238,2022-08-08,Senate,"Consent Calendar AB1323",36,0,0,4,40
1458875,1225066,2022-08-29,Assembly,"With recommendation: That Senate amendments be concurred in",21,0,0,1,22
1458875,1225839,2022-08-30,Assembly,"AB 1323 Haney Concurrence in Senate Amendments",79,0,0,1,80
1458878,1047546,2021-04-07,Assembly,"Do pass and be re-referred to the Committee on [Higher Education] with recommendation: To Consent Calendar",8,0,0,0,8
1458878,1060859,2021-04-22,Assembly,"Do pass as amended and be re-referred to the Committee on [Appropriations]",12,0,0,0,12
1458878,1081899,2021-05-20,Assembly,"Do pass",16,0,0,0,16
1458878,1092937,2021-06-01,Assembly,"AB 1326 Arambula Assembly Third Reading",79,0,0,0,79
1458878,1104432,2021-07-06,Senate,"Do pass, but first be re-referred to the Committee on [Education] with the recommendation: To Consent Calendar",5,0,0,0,5
1458878,1104927,2021-07-14,Senate,"Do pass, but first be re-referred to the Committee on [Appropriations] with the recommendation: To Consent Calendar",7,0,0,0,7
1458878,1106241,2021-08-16,Senate,"Placed on suspense file",7,0,0,0,7
1458878,1106859,2021-08-26,Senate,"Do pass",7,0,0,0,7
1458878,1107888,2021-09-07,Senate,"Assembly 3rd Reading AB1326 Arambula et al. By Hurtado",37,0,0,3,40
1458878,1108125,2021-09-08,Assembly,"AB 1326 Arambula Concurrence in Senate Amendments",78,0,0,2,80
1458879,1057750,2021-04-20,Assembly,"Do pass and be re-referred to the Committee on [Appropriations] with recommendation: To Consent Calendar",7,0,0,0,7
1458879,1081440,2021-05-20,Assembly,"Do pass as amended",16,0,0,0,16
1458880,1057691,2021-04-20,Assembly,"Do pass as amended and be re-referred to the Committee on [Appropriations]",19,0,0,0,19
1458880,1073359,2021-05-05,Assembly,"Do pass. To Consent Calendar",16,0,0,0,16
1458880,1077578,2021-05-13,Assembly,"AB 1328 Irwin Assembly Third Reading",71,0,7,0,78
1458880,1104659,2021-07-12,Senate,"Do pass as amended, but first amend, and re-refer to the Committee on [Appropriations]",9,1,4,0,14
1458880,1106247,2021-08-16,Senate,"Placed on suspense file",7,0,0,0,7
1458880,1223800,2022-08-11,Senate,"Do pass",6,1,0,0,7
1458881,1067622,2021-04-29,Assembly,"Do pass as amended and be re-referred to the Committee on [Appropriations]",6,2,0,0,8
1458881,1081925,2021-05-20,Assembly,"Do pass",12,4,0,0,16
1458881,1088012,2021-05-28,Assembly,"AB 1329 Nazarian Assembly Third Reading",54,19,6,0,79
1458881,1104566,2021-07-08,Senate,"Do pass, but first be re-referred to the Committee on [Appropriations]",7,2,0,0,9
1458881,1106231,2021-08-16,Senate,"Placed on suspense file",7,0,0,0,7
1458882,1049026,2021-04-08,Assembly,"Do pass and be re-referred to the Committee on [Appropriations] with recommendation: To Consent Calendar",22,0,0,0,22
1458882,1059241,2021-04-21,Assembly,"Do pass. To Consent Calendar",14,0,2,0,16
1458882,1066712,2021-04-29,Assembly,"AB 1330 Frazier Consent Calendar Second Day Regular Session",77,0,1,0,78
1458882,1104335,2021-07-06,Senate,"Do pass, but first be re-referred to the Committee on [Appropriations] with the recommendation: To Consent Calendar",15,0,0,0,15
1458882,1220052,2022-06-28,Senate,"Do pass, but first be re-referred to the Committee on [Appropriations] with the recommendation: To Consent Calendar",13,0,0,2,15
1458882,1224144,2022-08-17,Senate,"Assembly 3rd Reading AB1330 Mayes et al. By Ochoa Bogh",38,0,0,2,40
1458882,1225090,2022-08-29,Assembly,"With recommendation: That Senate amendments be concurred in",21,0,0,1,22
1458882,1225933,2022-08-30,Assembly,"AB 1330 Mayes Concurrence in Senate Amendments",79,0,0,1,80
1458883,1046140,2021-04-06,Assembly,"Do pass as amended and be re-referred to the Committee on [Appropriations]",15,0,0,0,15
1458883,1081888,2021-05-20,Assembly,"Do pass as amended",16,0,0,0,16
1458883,1092881,2021-06-01,Assembly,"AB 1331 Irwin Assembly Third Reading",78,0,1,0,79
1458883,1103364,2021-06-30,Senate,"Do pass, but first be re-referred to the Committee on [Judiciary]",10,0,1,0,11
1458883,1104949,2021-07-13,Senate,"Do pass, but first be re-referred to the Committee on [Appropriations]",9,0,2,0,11
1458883,1106081,2021-08-16,Senate,"Placed on suspense file",7,0,0,0,7
1458883,1106673,2021-08-26,Senate,"Do pass",6,0,0,1,7
1458883,1107592,2021-09-02,Senate,"Assembly 3rd Reading AB1331 Irwin By Rubio",38,0,0,2,40
1458883,1107899,2021-09-07,Assembly,"AB 1331 Irwin Concurrence in Senate Amendments",73,0,0,7,80
1458888,1065215,2021-04-27,Assembly,"Do pass and be re-referred to the Committee on [Appropriations] with recommendation: To Consent Calendar",8,0,0,0,8
1458889,1053492,2021-04-13,Assembly,"Do pass and be re-referred to the Committee on [Transportation] with recommendation: To Consent Calendar",8,0,0,0,8
1458889,1064078,2021-04-26,Assembly,"Do pass and be re-referred to the Committee on [Appropriations] with recommendation: To Consent Calendar",15,0,0,0,15
1458889,1076939,2021-05-12,Assembly,"Do pass",16,0,0,0,16
1458889,1083812,2021-05-24,Assembly,"AB 1337 Lee Assembly Third Reading",62,0,16,0,78
1458889,1098142,2021-06-15,Senate,"Do pass, but first be re-referred to the Committee on [Transportation] with the recommendation: To Consent Calendar",4,0,1,0,5
1458889,1101631,2021-06-24,Senate,"Do pass, but first be re-referred to the Committee on [Appropriations] with the recommendation: To Consent Calendar",15,0,2,0,17
1458889,1104220,2021-07-05,Senate,"Placed on suspense file",6,0,1,0,7
1458889,1107004,2021-08-26,Senate,"Do pass as amended",7,0,0,0,7
1458889,1108217,2021-09-08,Senate,"Assembly 3rd Reading AB1337 Lee By Wieckowski",38,0,0,2,40
1458889,1108411,2021-09-09,Assembly,"AB 1337 Lee Concurrence in Senate Amendments",77,0,0,3,80
1458890,1047438,2021-04-07,Assembly,"Do pass and be re-referred to the Committee on [Revenue and Taxation]",6,2,0,0,8
1458893,1051939,2021-04-13,Assembly,"Do pass as amended and be re-referred to the Committee on [Judiciary]",11,1,3,0,15
1458893,1064001,2021-04-27,Assembly,"Do pass as amended and be re-referred to the Committee on [Appropriations]",8,3,0,0,11
1458893,1126270,2022-01-20,Assembly,"Do pass",11,2,0,3,16
1458893,1129900,2022-01-27,Assembly,"AB 1341 Cristina Garcia Assembly Third Reading",53,13,0,10,76
1458893,1216270,2022-06-15,Senate,"Do pass, but first be re-referred to the Committee on [Judiciary]",8,0,0,3,11
1458893,1217934,2022-06-21,Senate,"Do pass, but first be re-referred to the Committee on [Appropriations]",9,2,0,0,11
1458893,1222904,2022-08-01,Senate,"Placed on suspense file",7,0,0,0,7
1458893,1223811,2022-08-11,Senate,"Do pass",5,2,0,0,7
1458893,1224516,2022-08-23,Senate,"Assembly 3rd Reading AB1341 Cristina Garcia et a By Lim贸n",32,6,0,2,40
1458893,1224777,2022-08-24,Assembly,"AB 1341 Cristina Garcia Concurrence in Senate Amendments",56,11,0,13,80
1458896,1065199,2021-04-28,Assembly,"Do pass and be re-referred to the Committee on [Appropriations]",6,4,1,0,11
1458896,1076936,2021-05-12,Assembly,"Do pass",11,4,1,0,16
1458896,1087050,2021-05-27,Assembly,"AB 1344 Arambula Assembly Third Reading",49,20,9,0,78
1458896,1098665,2021-06-16,Senate,"Do pass, but first be re-referred to the Committee on [Environmental Quality]",8,1,2,0,11
1458896,1103844,2021-07-01,Senate,"Do pass, but first be re-referred to the Committee on [Appropriations]",5,2,0,0,7
1458896,1107212,2021-08-30,Senate,"Assembly 3rd Reading AB1344 Arambula et al. By Skinner",28,9,0,3,40
1458896,1107509,2021-09-01,Assembly,"AB 1344 Arambula Concurrence in Senate Amendments",48,20,0,11,79
1458897,1057646,2021-04-19,Assembly,"Do pass. To Consent Calendar",6,0,1,0,7
1458897,1062785,2021-04-26,Assembly,"Do pass and be re-referred to the Committee on [Appropriations] with recommendation: To Consent Calendar",8,0,0,0,8
1458898,1065195,2021-04-28,Assembly,"Do pass and be re-referred to the Committee on [Appropriations]",7,3,1,0,11
1458898,1076921,2021-05-12,Assembly,"Set, [First] hearing. Referred to suspense file",16,0,0,0,16
1458898,1081433,2021-05-20,Assembly,"Do pass",12,4,0,0,16
1458898,1090377,2021-06-02,Assembly,"AB 1346 Berman Assembly Third Reading",49,20,10,0,79
1458898,1104628,2021-07-12,Senate,"Do pass, but first be re-referred to the Committee on [Appropriations]",5,2,0,0,7
1458898,1106047,2021-08-16,Senate,"Placed on suspense file",7,0,0,0,7
1458898,1106681,2021-08-26,Senate,"Do pass as amended",5,2,0,0,7
1458898,1108205,2021-09-08,Senate,"Assembly 3rd Reading AB1346 Berman et al. By Gonzalez",21,9,0,10,40
1458898,1108352,2021-09-09,Assembly,"AB 1346 Berman Concurrence in Senate Amendments",47,22,0,11,80
1458899,1065141,2021-04-27,Assembly,"Do pass. To Consent Calendar",8,0,0,0,8
1458899,1074108,2021-05-06,Assembly,"AB 1347 Jones-Sawyer Consent Calendar Second Day Regular Session",77,0,1,0,78
1458899,1098139,2021-06-15,Senate,"Do pass, but first be re-referred to the Committee on [Judiciary]",4,0,1,0,5
1458899,1103372,2021-06-29,Senate,"Do pass, but first be re-referred to the Committee on [Appropriations] with the recommendation: To Consent Calendar",11,0,0,0,11
1458899,1105114,2021-07-15,Senate,"Placed on suspense file",7,0,0,0,7
1458899,1106616,2021-08-26,Senate,"Do pass",7,0,0,0,7
1458899,1107772,2021-09-03,Senate,"Special Consent AB1347",37,0,0,3,40
1458899,1107900,2021-09-07,Assembly,"AB 1347 Jones-Sawyer Concurrence in Senate Amendments",72,0,0,8,80
1458900,1062797,2021-04-26,Assembly,"Do pass and be re-referred to the Committee on [Appropriations]",6,0,1,0,7
1458900,1082064,2021-05-20,Assembly,"Do pass",16,0,0,0,16
1458900,1126328,2022-01-20,Assembly,"AB 1348 McCarty Assembly Third Reading",63,0,0,13,76
1458900,1211889,2022-06-01,Senate,"Do pass as amended, but first amend, and re-refer to the Committee on [Appropriations] with the recommendation: To Consent Calendar",9,0,0,2,11
1458900,1222927,2022-08-01,Senate,"Placed on suspense file",7,0,0,0,7
1458900,1223593,2022-08-11,Senate,"Do pass",7,0,0,0,7
1458900,1225328,2022-08-29,Senate,"Assembly 3rd Reading AB1348 McCarty By Pan",40,0,0,0,40
1458900,1225329,2022-08-30,Assembly,"AB 1348 McCarty Concurrence in Senate Amendments",78,0,0,2,80
1458900,1229710,2022-08-30,Senate,"Assembly 3rd Reading AB1348 McCarty By Pan",40,0,0,0,40
1458901,1054731,2021-04-14,Assembly,"Do pass as amended and be re-referred to the Committee on [Judiciary]",13,0,0,0,13
1458901,1063999,2021-04-27,Assembly,"Do pass and be re-referred to the Committee on [Appropriations] with recommendation: To Consent Calendar",11,0,0,0,11
1458901,1076968,2021-05-12,Assembly,"Do pass. To Consent Calendar",16,0,0,0,16
1458901,1081426,2021-05-20,Assembly,"AB 1349 Mathis Consent Calendar Second Day Regular Session",76,0,2,0,78
1458901,1097784,2021-06-14,Senate,"Do pass, but first be re-referred to the Committee on [Judiciary]",12,0,0,0,12
1458901,1103477,2021-06-29,Senate,"Do pass, but first be re-referred to the Committee on [Appropriations] with the recommendation: To Consent Calendar",11,0,0,0,11
1458901,1107217,2021-08-30,Senate,"Consent Calendar AB1349",39,0,0,1,40
1458901,1108583,2021-09-10,Senate,"Assembly 3rd Reading AB1349 Mathis et al. By Ochoa Bogh",37,0,0,3,40
1458904,1048894,2021-04-08,Assembly,"Do pass and be re-referred to the Committee on [Military and Veterans Affairs] with recommendation: To Consent Calendar",11,0,0,0,11
1458904,1065266,2021-04-28,Assembly,"Do pass and be re-referred to the Committee on [Appropriations]",11,0,0,0,11
1458904,1076948,2021-05-12,Assembly,"Do pass. To Consent Calendar",16,0,0,0,16
1458904,1081444,2021-05-20,Assembly,"AB 1352 Chau Consent Calendar Second Day Regular Session",76,0,2,0,78
1458904,1103512,2021-06-30,Senate,"Do pass, but first be re-referred to the Committee on [Judiciary]",6,0,1,0,7
1458904,1104478,2021-07-06,Senate,"Do pass, but first be re-referred to the Committee on [Appropriations] with the recommendation: To Consent Calendar",11,0,0,0,11
1458904,1107380,2021-09-01,Senate,"Assembly 3rd Reading AB1352 Chau By Archuleta",39,0,0,1,40
1458904,1107573,2021-09-02,Assembly,"AB 1352 Chau Concurrence in Senate Amendments",77,0,0,2,79
1458907,1123327,2022-01-11,Assembly,"Do pass and be re-referred to the Committee on [Appropriations]",15,0,0,0,15
1458907,1126319,2022-01-20,Assembly,"Do pass",15,0,0,1,16
1458907,1129885,2022-01-27,Assembly,"AB 1355 Levine Assembly Third Reading",68,0,0,8,76
1458907,1211878,2022-06-01,Senate,"Do pass, but first be re-referred to the Committee on [Judiciary]",9,0,0,2,11
1458907,1216325,2022-06-14,Senate,"Do pass, but first be re-referred to the Committee on [Appropriations] with the recommendation: To Consent Calendar",11,0,0,0,11
1458907,1219525,2022-06-27,Senate,"Placed on suspense file",6,0,0,1,7
1458907,1223796,2022-08-11,Senate,"Do pass",7,0,0,0,7
1458907,1225501,2022-08-31,Senate,"Special Consent AB1355",40,0,0,0,40
1458907,1225502,2022-08-31,Assembly,"AB 1355 Levine Concurrence in Senate Amendments",80,0,0,0,80
1458908,1053491,2021-04-13,Assembly,"Do pass and be re-referred to the Committee on [Privacy and Consumer Protection]",6,2,0,0,8
1458908,1060858,2021-04-22,Assembly,"Do pass and be re-referred to the Committee on [Appropriations]",8,2,1,0,11
1458908,1081909,2021-05-20,Assembly,"Do pass",12,4,0,0,16
1458908,1090363,2021-06-02,Assembly,"AB 1356 Bauer-Kahan Assembly Third Reading",59,17,3,0,79
1458908,1104310,2021-07-06,Senate,"Do pass, but first be re-referred to the Committee on [Judiciary]",4,1,0,0,5
1458908,1104912,2021-07-13,Senate,"Do pass as amended, but first amend, and re-refer to the Committee on [Appropriations]",8,3,0,0,11
1458908,1106167,2021-08-16,Senate,"Placed on suspense file",7,0,0,0,7
1458908,1106882,2021-08-26,Senate,"Do pass as amended",5,2,0,0,7
1458908,1107528,2021-09-01,Senate,"Assembly 3rd Reading AB1356 Bauer-Kahan et al. By Gonzalez",29,10,0,1,40
1458908,1108180,2021-09-08,Assembly,"AB 1356 Bauer-Kahan Concurrence in Senate Amendments",60,18,0,2,80
1458909,1051973,2021-04-13,Assembly,"Do pass and be re-referred to the Committee on [Appropriations]",15,0,0,0,15
1458909,1081702,2021-05-20,Assembly,"Do pass",16,0,0,0,16
1458909,1087075,2021-05-27,Assembly,"AB 1357 Cervantes Assembly Third Reading",78,0,0,0,78
1458909,1098639,2021-06-16,Senate,"Do pass, but first be re-referred to the Committee on [Appropriations] with the recommendation: To Consent Calendar",10,0,1,0,11
1458909,1104180,2021-07-05,Senate,"Placed on suspense file",6,0,1,0,7
1458909,1106669,2021-08-26,Senate,"Do pass",7,0,0,0,7
1458909,1107786,2021-09-03,Senate,"Special Consent AB1357",37,0,0,3,40
1458910,1065284,2021-04-28,Assembly,"Do pass and be re-referred to the Committee on [Appropriations]",7,0,0,0,7
1458910,1082201,2021-05-20,Assembly,"Do pass as amended",14,0,2,0,16
1458910,1092847,2021-06-01,Assembly,"AB 1358 Bonta Assembly Third Reading By MURATSUCHI",73,0,6,0,79
1458910,1100304,2021-06-22,Senate,"Do pass, but first be re-referred to the Committee on [Health]",12,1,2,0,15
1458910,1104423,2021-07-07,Senate,"Do pass as amended, but first amend, and re-refer to the Committee on [Appropriations]",8,0,3,0,11
1458910,1106087,2021-08-16,Senate,"Placed on suspense file",7,0,0,0,7
1458912,1067614,2021-04-29,Assembly,"Do pass as amended and be re-referred to the Committee on [Appropriations]",6,2,0,0,8
1458913,1047571,2021-04-07,Assembly,"Do pass and be re-referred to the Committee on [Education]",8,0,0,0,8
1458913,1065183,2021-04-28,Assembly,"Do pass as amended and be re-referred to the Committee on [Appropriations]",6,1,0,0,7
1458914,1066786,2021-04-29,Assembly,"Do pass and be re-referred to the Committee on [Appropriations] with recommendation: To Consent Calendar",11,0,0,0,11
1458914,1080405,2021-05-19,Assembly,"Do pass. To Consent Calendar",15,0,1,0,16
1458914,1086948,2021-05-27,Assembly,"AB 1362 Carrillo Consent Calendar Second Day Regular Session",75,0,3,0,78
1458914,1099149,2021-06-17,Senate,"Do pass, but first be re-referred to the Committee on [Appropriations] with the recommendation: To Consent Calendar",4,0,1,0,5
1458914,1107183,2021-08-30,Senate,"Consent Calendar AB1362",39,0,0,1,40
1458916,1053513,2021-04-14,Assembly,"Do pass and be re-referred to the Committee on [Natural Resources]",5,1,1,0,7
1458918,1054716,2021-04-15,Assembly,"Do pass as amended, and be re-referred to the Committee on [Appropriations] with recommendation: To Consent Calendar",7,0,0,0,7
1458918,1073445,2021-05-05,Assembly,"Do pass. To Consent Calendar",16,0,0,0,16
1458918,1086951,2021-05-27,Assembly,"AB 1367 Low Assembly Third Reading",78,0,0,0,78
1458918,1104593,2021-07-12,Senate,"Do pass as amended, but first amend, and re-refer to the Committee on [Appropriations]",5,0,0,0,5
1458918,1107229,2021-08-30,Senate,"Assembly 3rd Reading AB1367 Low By Glazer",39,0,0,1,40
1458918,1107485,2021-09-01,Assembly,"AB 1367 Low Concurrence in Senate Amendments",78,0,0,1,79
1458919,1059192,2021-04-21,Assembly,"Do pass and be re-referred to the Committee on [Appropriations]",8,0,0,0,8
1458919,1081732,2021-05-20,Assembly,"Do pass",16,0,0,0,16
1458919,1088013,2021-05-28,Assembly,"AB 1368 Calderon Assembly Third Reading",76,0,3,0,79
1458919,1100322,2021-06-22,Senate,"Do pass, but first be re-referred to the Committee on [Appropriations]",4,1,0,0,5
1458919,1104200,2021-07-05,Senate,"Placed on suspense file",6,0,1,0,7
1458920,1053529,2021-04-14,Assembly,"Do pass and be re-referred to the Committee on [Natural Resources]",5,1,1,0,7
1458920,1123331,2022-01-10,Assembly,"Do pass as amended and be re-referred to the Committee on [Appropriations]",8,2,0,1,11
1458920,1126308,2022-01-20,Assembly,"Do pass",12,3,0,1,16
1458920,1131243,2022-01-31,Assembly,"AB 1369 Bennett Assembly Third Reading",57,17,0,2,76
1458920,1215739,2022-06-14,Senate,"Do pass, but first be re-referred to the Committee on [Environmental Quality]",9,5,0,1,15
1458920,1216313,2022-06-15,Senate,"Do pass, but first be re-referred to the Committee on [Appropriations]",5,2,0,0,7
1458920,1222767,2022-08-01,Senate,"Placed on suspense file",7,0,0,0,7
1458920,1223763,2022-08-11,Senate,"Do pass",4,2,0,1,7
1458922,1053470,2021-04-14,Assembly,"Do pass and be re-referred to the Committee on [Judiciary]",8,3,0,0,11
1458922,1057621,2021-04-20,Assembly,"Do pass as amended and be re-referred to the Committee on [Appropriations]",8,2,1,0,11
1458922,1081997,2021-05-20,Assembly,"Do pass as amended",12,4,0,0,16
1458922,1090395,2021-06-02,Assembly,"AB 1371 Friedman Assembly Third Reading",36,21,22,0,79
1458922,1091732,2021-06-03,Assembly,"AB 1371 Friedman Assembly Third Reading",36,28,15,0,79
1458925,1064021,2021-04-26,Assembly,"Do pass and be re-referred to the Committee on [Appropriations] with recommendation: To Consent Calendar",15,0,0,0,15
1458925,1076950,2021-05-12,Assembly,"Do pass. To Consent Calendar",16,0,0,0,16
1458925,1081666,2021-05-20,Assembly,"AB 1374 Mullin Consent Calendar Second Day Regular Session",76,0,2,0,78
1458925,1101609,2021-06-24,Senate,"Do pass, but first be re-referred to the Committee on [Appropriations] with the recommendation: To Consent Calendar",15,0,2,0,17
1458925,1107143,2021-08-30,Senate,"Consent Calendar AB1374",39,0,0,1,40
1458925,1107610,2021-09-02,Assembly,"AB 1374 Mullin Concurrence in Senate Amendments",77,0,0,2,79
1458928,1049034,2021-04-08,Assembly,"Do pass and be re-referred to the Committee on [Appropriations]",11,0,1,0,12
1458928,1081976,2021-05-20,Assembly,"Do pass as amended",16,0,0,0,16
1458928,1091712,2021-06-03,Assembly,"AB 1377 McCarty Assembly Third Reading",77,0,2,0,79
1458928,1104954,2021-07-14,Senate,"Do pass, but first be re-referred to the Committee on [Governance and Finance] with the recommendation: To Consent Calendar",7,0,0,0,7
1458928,1107137,2021-08-30,Senate,"Consent Calendar AB1377",39,0,0,1,40
1458928,1107445,2021-09-01,Assembly,"AB 1377 McCarty Concurrence in Senate Amendments",76,0,0,3,79
1458932,1122860,2022-01-10,Assembly,"Do pass and be re-referred to the Committee on [Appropriations]",11,0,0,1,12
1458932,1126285,2022-01-20,Assembly,"Do pass. To Consent Calendar",15,0,0,1,16
1458932,1129869,2022-01-27,Assembly,"AB 1381 Gallagher Consent Calendar Second Day Regular Session",61,0,0,15,76
1458932,1214951,2022-06-08,Senate,"Do pass as amended, but first amend, and re-refer to the Committee on [Appropriations]",9,0,0,2,11
1458932,1219479,2022-06-27,Senate,"Placed on suspense file",6,0,0,1,7
1458934,1048944,2021-04-08,Assembly,"Do pass",11,0,1,0,12
1458934,1074194,2021-05-06,Assembly,"AB 1383 Carrillo Assembly Third Reading",77,0,1,0,78
1458934,1096074,2021-06-09,Senate,"Do pass and be ordered to the Consent Calendar",7,0,0,0,7
1458934,1099147,2021-06-17,Senate,"Consent Calendar AB1383",37,0,3,0,40
1458935,1053553,2021-04-14,Assembly,"Do pass and be re-referred to the Committee on [Appropriations]",8,2,1,0,11
1458935,1082059,2021-05-20,Assembly,"Do pass",12,3,1,0,16
1458935,1088014,2021-05-28,Assembly,"AB 1384 Gabriel Assembly Third Reading",57,14,8,0,79
1458935,1102839,2021-06-29,Senate,"Do pass, but first be re-referred to the Committee on [Environmental Quality]",7,2,0,0,9
1458935,1104648,2021-07-12,Senate,"Do pass as amended, but first amend, and re-refer to the Committee on [Appropriations]",5,2,0,0,7
1458935,1106107,2021-08-16,Senate,"Placed on suspense file",7,0,0,0,7
1458935,1106613,2021-08-26,Senate,"Do pass as amended",5,2,0,0,7
1458935,1224353,2022-08-22,Senate,"Assembly 3rd Reading AB1384 Gabriel et al. By Allen",31,9,0,0,40
1458935,1224539,2022-08-23,Assembly,"AB 1384 Gabriel Concurrence in Senate Amendments",61,12,0,7,80
1458937,1065287,2021-04-27,Assembly,"Do pass and be re-referred to the Committee on [Appropriations]",19,0,0,0,19
1458939,1057703,2021-04-20,Assembly,"Do pass as amended and be re-referred to the Committee on [Appropriations]",15,0,0,0,15
1458940,1056431,2021-04-19,Assembly,"Do pass and be re-referred to the Committee on [Appropriations]",13,1,1,0,15
1458940,1076944,2021-05-12,Assembly,"Do pass",13,3,0,0,16
1458940,1086998,2021-05-27,Assembly,"AB 1389 Reyes Assembly Third Reading",58,12,8,0,78
1458940,1104167,2021-07-05,Senate,"Do pass, but first be re-referred to the Committee on [Transportation]",11,1,2,0,14
1458940,1104725,2021-07-13,Senate,"Do pass, but first be re-referred to the Committee on [Appropriations]",13,2,2,0,17
1458940,1106170,2021-08-16,Senate,"Placed on suspense file",7,0,0,0,7
1458940,1106707,2021-08-26,Senate,"Do pass",5,2,0,0,7
1458940,1225433,2022-08-30,Senate,"Assembly 3rd Reading AB1389 Reyes et al. By Gonzalez",24,11,0,5,40
1458940,1225434,2022-08-31,Assembly,"AB 1389 Reyes Concurrence in Senate Amendments",62,8,0,10,80
1458941,1065308,2021-04-28,Assembly,"Do pass and be re-referred to the Committee on [Appropriations]",10,0,1,0,11
1458941,1080402,2021-05-19,Assembly,"Do pass",15,0,1,0,16
1458941,1083851,2021-05-24,Assembly,"AB 1390 Boerner Horvath Assembly Third Reading",75,0,3,0,78
1458941,1102878,2021-06-29,Senate,"Do pass as amended, but first amend, and re-refer to the Committee on [Appropriations] with the recommendation: To Consent Calendar",9,0,0,0,9
1458941,1105138,2021-07-15,Senate,"Placed on suspense file",7,0,0,0,7
1458941,1106847,2021-08-26,Senate,"Do pass as amended",7,0,0,0,7
1458941,1108076,2021-09-08,Senate,"Special Consent AB1390",38,0,0,2,40
1458941,1108451,2021-09-09,Assembly,"AB 1390 Boerner Horvath Concurrence in Senate Amendments",78,0,0,2,80
1458942,1049005,2021-04-08,Assembly,"Do pass as amended. To Consent Calendar",11,0,0,0,11
1458942,1056484,2021-04-19,Assembly,"AB 1391 Chau Consent Calendar Second Day Regular Session",78,0,1,0,79
1458942,1095040,2021-06-08,Senate,"Do pass, but first be re-referred to the Committee on [Public Safety]",11,0,0,0,11
1458942,1102859,2021-06-29,Senate,"Do pass",5,0,0,0,5
1458942,1107260,2021-08-30,Senate,"Assembly 3rd Reading AB1391 Chau By Laird",39,0,0,1,40
1458942,1107492,2021-09-01,Assembly,"AB 1391 Chau Concurrence in Senate Amendments",78,0,0,1,79
1458945,1123323,2022-01-11,Assembly,"Do pass and be re-referred to the Committee on [Appropriations]",15,0,0,0,15
1458945,1126286,2022-01-20,Assembly,"Do pass. To Consent Calendar",15,0,0,1,16
1458945,1129883,2022-01-27,Assembly,"AB 1394 Irwin Consent Calendar Second Day Regular Session",61,0,0,15,76
1458945,1211890,2022-06-01,Senate,"Do pass, but first be re-referred to the Committee on [Appropriations] with the recommendation: To Consent Calendar",9,0,0,2,11
1458945,1219493,2022-06-27,Senate,"Consent Calendar AB1394",37,0,0,3,40
1458945,1221547,2022-06-29,Assembly,"AB 1394 Irwin Concurrence in Senate Amendments",76,0,0,4,80
1458946,1065149,2021-04-28,Assembly,"Do pass as amended and be re-referred to the Committee on [Appropriations]",8,3,0,0,11
1458946,1082052,2021-05-20,Assembly,"Do pass",11,4,1,0,16
1458946,1091706,2021-06-03,Assembly,"AB 1395 Muratsuchi Assembly Third Reading",42,21,16,0,79
1458946,1104676,2021-07-12,Senate,"Do pass as amended, but first amend, and re-refer to the Committee on [Appropriations]",5,2,0,0,7
1458946,1106182,2021-08-16,Senate,"Placed on suspense file",7,0,0,0,7
1458946,1106706,2021-08-26,Senate,"Do pass as amended",4,2,0,1,7
1458946,1108571,2021-09-10,Senate,"Assembly 3rd Reading AB1395 Muratsuchi et al. By Laird",14,12,0,14,40
1458946,1108572,2021-09-10,Senate,"Assembly 3rd Reading AB1395 Muratsuchi et al. By Laird Reconsider",37,0,0,3,40
1458949,1054675,2021-04-15,Assembly,"Do pass and be re-referred to the Committee on [Local Government]",6,2,0,0,8
1458949,1065142,2021-04-28,Assembly,"Do pass as amended and be re-referred to the Committee on [Appropriations]",5,1,2,0,8
1458949,1080438,2021-05-19,Assembly,"Do pass",11,4,1,0,16
1458949,1090378,2021-06-02,Assembly,"AB 1398 Bloom Assembly Third Reading",55,19,5,0,79
1458949,1103748,2021-07-01,Senate,"Do pass as amended, but first amend, and re-refer to the Committee on [Appropriations]",7,2,0,0,9
1458949,1108172,2021-09-08,Senate,"Assembly 3rd Reading AB1398 Bloom By Wiener",27,9,0,4,40
1458949,1108267,2021-09-09,Assembly,"AB 1398 Bloom Concurrence in Senate Amendments",55,20,0,5,80
1458951,1123320,2022-01-11,Assembly,"Do pass and be re-referred to the Committee on [Appropriations]",11,3,0,1,15
1458951,1126349,2022-01-20,Assembly,"Do pass as amended",11,3,0,2,16
1458952,1054690,2021-04-14,Assembly,"Do pass as amended and be re-referred to the Committee on [Housing and Community Development]",6,1,1,0,8
1458952,1067633,2021-04-29,Assembly,"Do pass and be re-referred to the Committee on [Appropriations]",7,1,0,0,8
1458952,1080455,2021-05-19,Assembly,"Do pass",11,4,1,0,16
1458952,1092928,2021-06-01,Assembly,"AB 1401 Friedman Assembly Third Reading",51,17,11,0,79
1458952,1103767,2021-07-01,Senate,"Do pass as amended, but first amend, and re-refer to the Committee on [Housing]",5,0,0,0,5
1458952,1104560,2021-07-08,Senate,"Do pass, but first be re-referred to the Committee on [Appropriations]",6,2,1,0,9
1458952,1106232,2021-08-16,Senate,"Placed on suspense file",7,0,0,0,7
1458953,1046113,2021-04-05,Assembly,"Do pass and be re-referred to the Committee on [Appropriations]",6,2,3,0,11
1458953,1059320,2021-04-21,Assembly,"Do pass",10,2,4,0,16
1458953,1062767,2021-04-26,Assembly,"AB 1402 Levine Assembly Third Reading",51,17,10,0,78
1458953,1101597,2021-06-24,Senate,"Do pass, but first be re-referred to the Committee on [Appropriations]",5,0,0,0,5
1458953,1106843,2021-08-26,Senate,"Assembly 3rd Reading AB1402 Levine By McGuire",31,5,0,4,40
1458953,1107443,2021-09-01,Assembly,"AB 1402 Levine Concurrence in Senate Amendments",60,11,0,8,79
1458954,1046112,2021-04-05,Assembly,"Do pass as amended and be re-referred to the Committee on [Appropriations]",7,0,0,0,7
1458954,1065224,2021-04-28,Assembly,"Do pass",15,1,0,0,16
1458954,1068152,2021-05-03,Assembly,"AB 1403 Levine Third Reading Urgency",62,0,16,0,78
1458954,1095048,2021-06-08,Senate,"Do pass as amended, but first amend, and re-refer to the Committee on [Appropriations]",9,1,5,0,15
1458954,1107805,2021-09-03,Senate,"Assembly 3rd Reading AB1403 Levine By Hueso Urgency Clause",28,8,0,4,40
1458954,1107806,2021-09-03,Senate,"Assembly 3rd Reading AB1403 Levine By Hueso Reconsider",37,0,0,3,40
1458954,1108058,2021-09-08,Senate,"Assembly 3rd Reading AB1403 Levine By Hueso Urgency Clause",28,5,0,7,40
1458954,1108469,2021-09-09,Assembly,"AB 1403 Levine Concurrence in Senate Amendments",61,9,0,10,80
1458956,1054598,2021-04-15,Assembly,"Do pass as amended and be re-referred to the Committee on [Judiciary]",9,3,0,0,12
1458956,1072238,2021-05-04,Assembly,"Do pass as amended and be re-referred to the Committee on [Appropriations]",8,2,1,0,11
1458956,1081967,2021-05-20,Assembly,"Do pass",12,4,0,0,16
1458956,1090491,2021-06-02,Assembly,"AB 1405 Wicks Assembly Third Reading",54,16,9,0,79
1458956,1100813,2021-06-23,Senate,"Do pass as amended, but first amend, and re-refer to the Committee on [Judiciary]",7,0,2,0,9
1458956,1104887,2021-07-13,Senate,"Do pass, but first be re-referred to the Committee on [Appropriations]",9,1,1,0,11
1458956,1106468,2021-08-23,Senate,"Placed on suspense file",7,0,0,0,7
1458956,1106802,2021-08-26,Senate,"Do pass",5,2,0,0,7
1458956,1107680,2021-09-02,Senate,"Assembly 3rd Reading AB1405 Wicks By Lim贸n",33,6,0,1,40
1458956,1107902,2021-09-07,Assembly,"AB 1405 Wicks Concurrence in Senate Amendments",53,17,0,10,80
1458957,1123348,2022-01-11,Assembly,"Do pass and be re-referred to the Committee on [Appropriations] with recommendation: To Consent Calendar",7,0,0,0,7
1458957,1126295,2022-01-20,Assembly,"Do pass",15,0,0,1,16
1458957,1131259,2022-01-31,Assembly,"AB 1406 Lackey Assembly Third Reading",73,0,0,3,76
1458957,1210894,2022-05-31,Senate,"Do pass and be ordered to the Consent Calendar",5,0,0,0,5
1458957,1211910,2022-05-31,Senate,"Do pass, but first be re-referred to the Committee on [Appropriations] with the recommendation: To Consent Calendar",5,0,0,0,5
1458957,1217091,2022-06-20,Senate,"Placed on suspense file",4,0,0,3,7
1458957,1223834,2022-08-11,Senate,"Do pass",7,0,0,0,7
1458957,1224412,2022-08-23,Senate,"Special Consent AB1406",40,0,0,0,40
1458958,1046106,2021-04-06,Assembly,"Do pass and be re-referred to the Committee on [Health]",15,0,4,0,19
1458958,1064104,2021-04-27,Assembly,"Do pass and be re-referred to the Committee on [Appropriations]",13,0,2,0,15
1458958,1080427,2021-05-19,Assembly,"Do pass",13,0,3,0,16
1458958,1083788,2021-05-24,Assembly,"AB 1407 Burke Assembly Third Reading",66,0,12,0,78
1458958,1103434,2021-06-30,Senate,"Do pass, but first be re-referred to the Committee on [Health]",12,1,1,0,14
1458958,1104891,2021-07-14,Senate,"Do pass as amended, but first amend, and re-refer to the Committee on [Appropriations]",8,0,3,0,11
1458958,1107225,2021-08-30,Senate,"Assembly 3rd Reading AB1407 Burke et al. By Bradford",32,1,0,7,40
1458958,1107397,2021-09-01,Assembly,"AB 1407 Burke Concurrence in Senate Amendments",68,0,0,11,79
1458960,1054614,2021-04-14,Assembly,"Do pass and be re-referred to the Committee on [Emergency Management] with recommendation: To Consent Calendar",8,0,0,0,8
1458960,1057644,2021-04-19,Assembly,"Do pass. To Consent Calendar",6,0,1,0,7
1458960,1065081,2021-04-28,Assembly,"Do pass. To Consent Calendar",16,0,0,0,16
1458960,1074146,2021-05-06,Assembly,"AB 1409 Levine Consent Calendar Second Day Regular Session",77,0,1,0,78
1458960,1099104,2021-06-17,Senate,"Do pass, but first be re-referred to the Committee on [Appropriations] with the recommendation: To Consent Calendar",5,0,0,0,5
1458960,1107209,2021-08-30,Senate,"Consent Calendar AB1409",39,0,0,1,40
1458961,1123758,2022-01-12,Assembly,"Do pass and be re-referred to the Committee on [Judiciary]",5,2,0,1,8
1458961,1124155,2022-01-13,Assembly,"Do pass as amended and be re-referred to the Committee on [Appropriations]",7,3,0,0,10
1458961,1131266,2022-01-31,Assembly,"AB 1410 Rodriguez Assembly Third Reading",54,17,0,5,76
1458961,1211848,2022-05-31,Senate,"Do pass, but first be re-referred to the Committee on [Judiciary]",6,1,0,2,9
1458961,1220667,2022-06-28,Senate,"Do pass as amended",9,1,0,1,11
1458961,1225588,2022-08-29,Senate,"Assembly 3rd Reading AB1410 Rodriguez By Durazo",30,9,0,1,40
1458961,1225589,2022-08-30,Assembly,"AB 1410 Rodriguez Concurrence in Senate Amendments",59,17,0,4,80
1458967,1123747,2022-01-12,Assembly,"Do pass and be re-referred to the Committee on [Appropriations]",6,1,0,0,7
1458967,1126342,2022-01-20,Assembly,"Do pass",12,3,0,1,16
1458967,1129927,2022-01-27,Assembly,"AB 1416 Santiago Assembly Third Reading Amendment Set #1",53,15,0,8,76
1458967,1131248,2022-01-31,Assembly,"AB 1416 Santiago Assembly Third Reading",57,19,0,0,76
1458967,1217313,2022-06-21,Senate,"Do pass as amended, but first amend, and re-refer to the Committee on [Appropriations]",3,2,0,0,5
1458967,1222895,2022-08-01,Senate,"Placed on suspense file",7,0,0,0,7
1458967,1223730,2022-08-11,Senate,"Do pass",5,2,0,0,7
1458967,1225681,2022-08-30,Senate,"Assembly 3rd Reading AB1416 Santiago et al. By Stern",23,12,0,5,40
1458967,1225682,2022-08-31,Assembly,"AB 1416 Santiago Concurrence in Senate Amendments",61,17,0,2,80
1458968,1060939,2021-04-22,Assembly,"Do pass and be re-referred to the Committee on [Appropriations]",12,0,0,0,12
1458968,1081463,2021-05-20,Assembly,"Do pass",16,0,0,0,16
1458968,1088015,2021-05-28,Assembly,"AB 1417 Frazier Assembly Third Reading",77,0,2,0,79
1458973,1057649,2021-04-20,Assembly,"Do pass as amended and be re-referred to the Committee on [Appropriations]",12,2,1,0,15
1458973,1081517,2021-05-20,Assembly,"Do pass as amended",12,4,0,0,16
1458973,1092883,2021-06-01,Assembly,"AB 1422 Gabriel Assembly Third Reading",57,18,4,0,79
1458973,1104403,2021-07-07,Senate,"Do pass as amended, but first amend, and re-refer to the Committee on [Appropriations]",8,1,2,0,11
1458973,1106067,2021-08-16,Senate,"Placed on suspense file",7,0,0,0,7
1458973,1106654,2021-08-26,Senate,"Do pass",5,2,0,0,7
1458973,1108093,2021-09-08,Senate,"Assembly 3rd Reading AB1422 Gabriel et al. By Leyva",29,9,0,2,40
1458973,1108453,2021-09-09,Assembly,"AB 1422 Gabriel Concurrence in Senate Amendments",59,18,0,3,80
1458974,1067609,2021-04-29,Assembly,"Do pass and be re-referred to the Committee on [Appropriations] with recommendation: To Consent Calendar",8,0,0,0,8
1458974,1081775,2021-05-20,Assembly,"Do pass",16,0,0,0,16
1458974,1087071,2021-05-27,Assembly,"AB 1423 Daly Assembly Third Reading",78,0,0,0,78
1458974,1104556,2021-07-08,Senate,"Do pass, but first be re-referred to the Committee on [Appropriations] with the recommendation: To Consent Calendar",9,0,0,0,9
1458974,1106226,2021-08-16,Senate,"Placed on suspense file",7,0,0,0,7
1458974,1106677,2021-08-26,Senate,"Do pass",7,0,0,0,7
1458974,1107879,2021-09-07,Senate,"Assembly 3rd Reading AB1423 Daly By Skinner",37,0,0,3,40
1458974,1108090,2021-09-08,Assembly,"AB 1423 Daly Concurrence in Senate Amendments",78,0,0,2,80
1458976,1065210,2021-04-28,Assembly,"Do pass and be re-referred to the Committee on [Appropriations]",10,3,0,0,13
1458976,1081920,2021-05-20,Assembly,"Do pass as amended",12,4,0,0,16
1458976,1091692,2021-06-03,Assembly,"AB 1425 Gipson Assembly Third Reading",57,18,4,0,79
1458976,1104622,2021-07-12,Senate,"Do pass as amended, but first amend, and re-refer to the Committee on [Appropriations]",11,2,1,0,14
1458976,1106220,2021-08-16,Senate,"Placed on suspense file",7,0,0,0,7
1458977,1054673,2021-04-14,Assembly,"Do pass and be re-referred to the Committee on [Appropriations]",13,0,0,0,13
1458977,1065219,2021-04-28,Assembly,"Do pass. To Consent Calendar",16,0,0,0,16
1458977,1074109,2021-05-06,Assembly,"AB 1426 Mathis Consent Calendar Second Day Regular Session",77,0,1,0,78
1458977,1097792,2021-06-14,Senate,"Do pass, but first be re-referred to the Committee on [Appropriations]",11,0,1,0,12
1458977,1223176,2022-08-08,Senate,"Special Consent AB1426",36,0,0,4,40
1458977,1225220,2022-08-30,Senate,"Assembly 3rd Reading AB1426 Mathis et al. By Grove",40,0,0,0,40
1458977,1225221,2022-08-31,Assembly,"AB 1426 Mathis Concurrence in Senate Amendments",79,0,0,1,80
1458979,1059184,2021-04-21,Assembly,"Do pass and be re-referred to the Committee on [Appropriations] with recommendation: To Consent Calendar",9,0,0,0,9
1458979,1080404,2021-05-19,Assembly,"Do pass. To Consent Calendar",15,0,1,0,16
1458979,1087079,2021-05-27,Assembly,"AB 1428 Quirk Consent Calendar Second Day Regular Session",75,0,3,0,78
1458979,1097791,2021-06-14,Senate,"Do pass, but first be re-referred to the Committee on [Appropriations] with the recommendation: To Consent Calendar",7,0,0,0,7
1458979,1101628,2021-06-24,Senate,"Consent Calendar AB1428",39,0,1,0,40
1458980,1065197,2021-04-28,Assembly,"Do pass and be re-referred to the Committee on [Appropriations] with recommendation: To Consent Calendar",7,0,0,0,7
1458980,1081651,2021-05-20,Assembly,"Do pass",16,0,0,0,16
1458980,1086925,2021-05-27,Assembly,"AB 1429 Holden Assembly Third Reading",78,0,0,0,78
1458980,1100248,2021-06-22,Senate,"Do pass, but first be re-referred to the Committee on [Appropriations] with the recommendation: To Consent Calendar",15,0,0,0,15
1458980,1106449,2021-08-23,Senate,"Placed on suspense file",7,0,0,0,7
1458981,1052025,2021-04-13,Assembly,"Do pass as amended and be re-referred to the Committee on [Appropriations]",13,4,2,0,19
1458981,1053566,2021-04-13,Assembly,"Do pass as amended and be re-referred to the Committee on [Judiciary]",13,4,2,0,19
1458981,1057711,2021-04-20,Assembly,"Do pass as amended and be re-referred to the Committee on [Appropriations]",8,2,1,0,11
1458982,1065238,2021-04-28,Assembly,"Do pass as amended and be re-referred to the Committee on [Appropriations]",11,0,0,0,11
1458982,1082142,2021-05-20,Assembly,"Do pass",16,0,0,0,16
1458982,1088016,2021-05-28,Assembly,"AB 1431 Frazier Assembly Third Reading",77,0,2,0,79
1458982,1104753,2021-07-13,Senate,"Do pass as amended, but first amend, and re-refer to the Committee on [Appropriations] with the recommendation: To Consent Calendar",8,0,1,0,9
1458982,1106134,2021-08-16,Senate,"Placed on suspense file",7,0,0,0,7
1458983,1049024,2021-04-08,Assembly,"Do pass and be re-referred to the Committee on [Appropriations]",11,0,1,0,12
1458983,1065116,2021-04-28,Assembly,"Do pass as amended",15,0,1,0,16
1458983,1074173,2021-05-06,Assembly,"AB 1432 Low Assembly Third Reading",71,0,7,0,78
1458983,1219943,2022-06-28,Senate,"Do pass",10,0,0,5,15
1458983,1224505,2022-08-23,Senate,"Assembly 3rd Reading AB1432 Low By Eggman",31,0,0,9,40
1458983,1224786,2022-08-24,Assembly,"AB 1432 Low Concurrence in Senate Amendments",64,0,0,16,80
1458985,1064111,2021-04-26,Assembly,"Do pass and be re-referred to the Committee on [Appropriations]",8,6,1,0,15
1458987,1048881,2021-04-08,Assembly,"Do pass. To Consent Calendar",11,0,0,0,11
1458987,1054729,2021-04-15,Assembly,"AB 1436 Chau Consent Calendar Second Day Regular Session",75,0,3,0,78
1458987,1103431,2021-06-29,Senate,"Do pass, but first be re-referred to the Committee on [Health]",9,2,0,0,11
1458987,1104933,2021-07-14,Senate,"Do pass as amended, but first amend, and re-refer to the Committee on [Appropriations]",8,1,2,0,11
1458987,1106178,2021-08-16,Senate,"Placed on suspense file",7,0,0,0,7
1458992,1057683,2021-04-19,Assembly,"Do pass. To Consent Calendar",6,0,1,0,7
1458992,1081694,2021-05-20,Assembly,"Do pass as amended",16,0,0,0,16
1458992,1092969,2021-06-01,Assembly,"AB 1441 Cervantes Assembly Third Reading",78,0,1,0,79
1458992,1104237,2021-07-06,Senate,"Do pass, but first be re-referred to the Committee on [Appropriations] with the recommendation: To Consent Calendar",15,0,0,0,15
1458992,1105055,2021-07-15,Senate,"Placed on suspense file",7,0,0,0,7
1458994,1057648,2021-04-20,Assembly,"Do pass and be re-referred to the Committee on [Appropriations]",15,0,0,0,15
1458994,1081845,2021-05-20,Assembly,"Do pass",16,0,0,0,16
1458994,1092978,2021-06-01,Assembly,"AB 1443 McCarty Assembly Third Reading",79,0,0,0,79
1458994,1104414,2021-07-07,Senate,"Do pass as amended, but first amend, and re-refer to the Committee on [Judiciary]",9,0,2,0,11
1458994,1104980,2021-07-13,Senate,"Do pass, but first be re-referred to the Committee on [Appropriations] with the recommendation: To Consent Calendar",11,0,0,0,11
1458994,1107126,2021-08-30,Senate,"Consent Calendar AB1443",39,0,0,1,40
1458994,1107521,2021-09-01,Assembly,"AB 1443 McCarty Concurrence in Senate Amendments",77,0,0,2,79
1458995,1060987,2021-04-22,Assembly,"Do pass as amended",9,0,2,0,11
1458995,1074174,2021-05-06,Assembly,"AB 1444 Lee Assembly Third Reading",68,0,10,0,78
1458995,1104404,2021-07-06,Senate,"Do pass, but first be re-referred to the Committee on [Business, Professions and Economic Development]",10,1,0,0,11
1458995,1104958,2021-07-14,Senate,"Do pass as amended",11,1,2,0,14
1458995,1107164,2021-08-30,Senate,"Assembly 3rd Reading AB1444 Lee et al. By Newman",34,1,0,5,40
1458995,1107526,2021-09-01,Assembly,"AB 1444 Lee Concurrence in Senate Amendments",61,8,0,10,79
1458996,1123766,2022-01-12,Assembly,"Do pass and be re-referred to the Committee on [Appropriations]",6,1,0,1,8
1458996,1123767,2022-01-12,Assembly,"Do pass and be re-referred to the Committee on [Local Government]",6,1,0,1,8
1458996,1126265,2022-01-20,Assembly,"Do pass",11,3,0,2,16
1458996,1131245,2022-01-31,Assembly,"AB 1445 Levine Assembly Third Reading",57,16,0,3,76
1458996,1211909,2022-05-31,Senate,"Do pass as amended, but first amend, and re-refer to the Committee on [Appropriations]",6,2,0,1,9
1458996,1215513,2022-06-13,Senate,"Placed on suspense file",7,0,0,0,7
1458996,1223981,2022-08-11,Senate,"Do pass as amended",5,2,0,0,7
1458996,1225224,2022-08-29,Senate,"Assembly 3rd Reading AB1445 Levine By Wiener",31,9,0,0,40
1458996,1225225,2022-08-30,Assembly,"AB 1445 Levine Concurrence in Senate Amendments",60,17,0,3,80
1458998,1057713,2021-04-19,Assembly,"Do pass and be re-referred to the Committee on [Jobs, Economic Development, and the Economy]",6,0,1,0,7
1458998,1064028,2021-04-27,Assembly,"Do pass as amended and be re-referred to the Committee on [Appropriations]",6,0,1,0,7
1459001,1046202,2021-04-05,Assembly,"Do pass as amended and be re-referred to the Committee on [Appropriations]",7,0,0,0,7
1459003,1065211,2021-04-27,Assembly,"Do pass and be re-referred to the Committee on [Appropriations] with recommendation: To Consent Calendar",8,0,0,0,8
1459003,1076958,2021-05-12,Assembly,"Do pass. To Consent Calendar",16,0,0,0,16
1459003,1082172,2021-05-20,Assembly,"AB 1452 Ting Consent Calendar Second Day Regular Session",76,0,2,0,78
1459003,1102865,2021-06-29,Senate,"Do pass, but first be re-referred to the Committee on [Appropriations] with the recommendation: To Consent Calendar",5,0,0,0,5
1459003,1107461,2021-09-01,Senate,"Assembly 3rd Reading AB1452 Ting et al. By Wiener",36,3,0,1,40
1459003,1107655,2021-09-02,Assembly,"AB 1452 Ting Concurrence in Senate Amendments",73,0,0,6,79
1459004,1048923,2021-04-08,Assembly,"Do pass and be re-referred to the Committee on [Natural Resources]",5,0,2,0,7
1459004,1065250,2021-04-28,Assembly,"Do pass and be re-referred to the Committee on [Appropriations]",8,0,3,0,11
1459005,1053498,2021-04-14,Assembly,"Do pass as amended and be re-referred to the Committee on [Appropriations]",11,0,0,0,11
1459005,1082179,2021-05-20,Assembly,"Do pass",16,0,0,0,16
1459005,1091690,2021-06-03,Assembly,"AB 1454 Bloom Assembly Third Reading",78,0,1,0,79
1459006,1046136,2021-04-06,Assembly,"Do pass as amended and be re-referred to the Committee on [Appropriations]",10,0,1,0,11
1459006,1082033,2021-05-20,Assembly,"Do pass",16,0,0,0,16
1459006,1088017,2021-05-28,Assembly,"AB 1455 Wicks Assembly Third Reading",71,0,8,0,79
1459006,1103474,2021-06-29,Senate,"Do pass as amended, but first amend, and re-refer to the Committee on [Appropriations]",9,0,2,0,11
1459006,1105095,2021-07-15,Senate,"Placed on suspense file",7,0,0,0,7
1459006,1106831,2021-08-26,Senate,"Do pass",5,0,0,2,7
1459006,1107645,2021-09-02,Senate,"Assembly 3rd Reading AB1455 Wicks By Umberg",32,1,0,7,40
1459006,1107903,2021-09-07,Assembly,"AB 1455 Wicks Concurrence in Senate Amendments",64,0,0,16,80
1459007,1060928,2021-04-22,Assembly,"Do pass and be re-referred to the Committee on [Appropriations]",10,0,2,0,12
1459007,1081560,2021-05-20,Assembly,"Do pass",13,0,3,0,16
1459007,1091757,2021-06-03,Assembly,"AB 1456 Medina Assembly Third Reading",78,0,1,0,79
1459007,1104956,2021-07-14,Senate,"Do pass as amended, but first amend, and re-refer to the Committee on [Appropriations]",7,0,0,0,7
1459007,1106440,2021-08-23,Senate,"Placed on suspense file",7,0,0,0,7
1459007,1106764,2021-08-26,Senate,"Do pass as amended",7,0,0,0,7
1459007,1108054,2021-09-08,Senate,"Assembly 3rd Reading AB1456 Medina et al. By Leyva",38,0,0,2,40
1459007,1108470,2021-09-09,Assembly,"AB 1456 Medina Concurrence in Senate Amendments",79,0,0,1,80
1459012,1059188,2021-04-21,Assembly,"Do pass and be re-referred to the Committee on [Appropriations]",8,0,0,0,8
1459012,1081492,2021-05-20,Assembly,"Do pass",16,0,0,0,16
1459012,1088018,2021-05-28,Assembly,"AB 1461 Reyes Assembly Third Reading",76,0,3,0,79
1459012,1100339,2021-06-22,Senate,"Do pass, but first be re-referred to the Committee on [Appropriations]",4,0,1,0,5
1459012,1104171,2021-07-05,Senate,"Placed on suspense file",6,0,1,0,7
1459012,1106597,2021-08-26,Senate,"Do pass as amended",7,0,0,0,7
1459012,1107710,2021-09-02,Senate,"Assembly 3rd Reading AB1461 Reyes By Durazo",39,0,0,1,40
1459012,1107904,2021-09-07,Assembly,"AB 1461 Reyes Concurrence in Senate Amendments",72,0,0,8,80
1459016,1066741,2021-04-29,Assembly,"Do pass and be re-referred to the Committee on [Appropriations] with recommendation: To Consent Calendar",13,0,0,0,13
1459016,1082184,2021-05-20,Assembly,"Do pass",16,0,0,0,16
1459016,1086933,2021-05-27,Assembly,"AB 1465 Reyes Assembly Third Reading",78,0,0,0,78
1459017,1051888,2021-04-13,Assembly,"Do pass and be re-referred to the Committee on [Appropriations]",9,0,2,0,11
1459017,1081565,2021-05-20,Assembly,"Do pass",13,0,3,0,16
1459017,1091719,2021-06-03,Assembly,"AB 1466 McCarty Assembly Third Reading",58,1,20,0,79
1459017,1103458,2021-06-29,Senate,"Do pass, but first be re-referred to the Committee on [Insurance]",10,0,1,0,11
1459017,1104530,2021-07-08,Senate,"Do pass as amended, but first amend, and re-refer to the Committee on [Appropriations]",10,0,2,0,12
1459017,1106117,2021-08-16,Senate,"Placed on suspense file",7,0,0,0,7
1459017,1106819,2021-08-26,Senate,"Do pass as amended",7,0,0,0,7
1459017,1108232,2021-09-09,Senate,"Assembly 3rd Reading AB1466 McCarty et al. By Rubio",38,0,0,2,40
1459017,1108233,2021-09-09,Assembly,"AB 1466 MCCARTY Concurrence in Senate Amendments",67,0,0,13,80
1459018,1060862,2021-04-22,Assembly,"Do pass and be re-referred to the Committee on [Judiciary]",10,0,2,0,12
1459018,1064153,2021-04-27,Assembly,"Do pass as amended and be re-referred to the Committee on [Appropriations]",10,0,1,0,11
1459018,1126332,2022-01-20,Assembly,"Do pass",14,0,0,2,16
1459018,1131251,2022-01-31,Assembly,"AB 1467 Cervantes Assembly Third Reading",75,0,0,1,76
1459018,1211847,2022-06-01,Senate,"Do pass, but first be re-referred to the Committee on [Judiciary] with the recommendation: To Consent Calendar",6,0,0,1,7
1459018,1216323,2022-06-14,Senate,"Do pass as amended, but first amend, and re-refer to the Committee on [Appropriations] with the recommendation: To Consent Calendar",11,0,0,0,11
1459018,1225359,2022-08-29,Senate,"Assembly 3rd Reading AB1467 Cervantes By Gonzalez",39,0,0,1,40
1459018,1225360,2022-08-30,Assembly,"AB 1467 Cervantes Concurrence in Senate Amendments",79,0,0,1,80
1459019,1064019,2021-04-27,Assembly,"Do pass as amended and be re-referred to the Committee on [Appropriations]",13,0,2,0,15
1459021,1046138,2021-04-06,Assembly,"Do pass as amended, and be re-referred to the Committee on [Military and Veterans Affairs] with recommendation: To Consent Calendar",15,0,0,0,15
1459021,1065275,2021-04-28,Assembly,"Do pass and be re-referred to the Committee on [Appropriations] with recommendation: To Consent Calendar",11,0,0,0,11
1459022,1059319,2021-04-21,Assembly,"Do pass as amended and be re-referred to the Committee on [Appropriations]",13,1,1,0,15
1459022,1073389,2021-05-05,Assembly,"Do pass",16,0,0,0,16
1459022,1077572,2021-05-13,Assembly,"AB 1471 Villapudua Assembly Third Reading",72,4,2,0,78
1459022,1102522,2021-06-28,Senate,"Do pass, but first be re-referred to the Committee on [Governmental Organization]",11,0,3,0,14
1459022,1104325,2021-07-06,Senate,"Do pass, but first be re-referred to the Committee on [Appropriations]",14,0,1,0,15
1459022,1106239,2021-08-16,Senate,"Placed on suspense file",7,0,0,0,7
1459025,1059157,2021-04-20,Assembly,"Do pass and be re-referred to the Committee on [Appropriations]",6,2,0,0,8
1459025,1082158,2021-05-20,Assembly,"Do pass",12,4,0,0,16
1459025,1090502,2021-06-02,Assembly,"AB 1474 Gabriel Assembly Third Reading",53,20,6,0,79
1459025,1102817,2021-06-29,Senate,"Do pass, but first be re-referred to the Committee on [Appropriations]",4,1,0,0,5
1459025,1106208,2021-08-16,Senate,"Placed on suspense file",7,0,0,0,7
1459026,1053549,2021-04-13,Assembly,"Do pass and be re-referred to the Committee on [Privacy and Consumer Protection]",7,0,1,0,8
1459026,1060842,2021-04-22,Assembly,"Do pass",10,0,1,0,11
1459026,1074112,2021-05-06,Assembly,"AB 1475 Low Assembly Third Reading",74,0,4,0,78
1459026,1098164,2021-06-15,Senate,"Do pass, but first be re-referred to the Committee on [Judiciary] with the recommendation: To Consent Calendar",4,0,1,0,5
1459026,1103465,2021-06-29,Senate,"Do pass",11,0,0,0,11
1459026,1104509,2021-07-08,Senate,"Assembly 3rd Reading AB1475 Low By Kamlager",39,0,1,0,40
1459026,1104597,2021-07-12,Assembly,"AB 1475 Low Concurrence in Senate Amendments",74,0,5,0,79
1459027,1036441,2021-03-24,Assembly,"Do pass as amended, and be re-referred to the Committee on [Appropriations] with recommendation: To Consent Calendar",8,0,0,0,8
1459027,1053451,2021-04-14,Assembly,"Do pass. To Consent Calendar",16,0,0,0,16
1459027,1060942,2021-04-22,Assembly,"AB 1476 Gray Consent Calendar Second Day Regular Session",77,0,2,0,79
1459027,1104514,2021-07-08,Senate,"Do pass, but first be re-referred to the Committee on [Appropriations]",5,0,0,0,5
1459027,1108052,2021-09-08,Senate,"Assembly 3rd Reading AB1476 Gray By Dodd",38,0,0,2,40
1459027,1108414,2021-09-09,Assembly,"AB 1476 Gray Concurrence in Senate Amendments",77,0,0,3,80
1459028,1064163,2021-04-27,Assembly,"Do pass as amended, and be re-referred to the Committee on [Appropriations] with recommendation: To Consent Calendar",15,0,0,0,15
1459028,1080450,2021-05-19,Assembly,"Do pass. To Consent Calendar",15,0,1,0,16
1459028,1086994,2021-05-27,Assembly,"AB 1477 Cervantes Consent Calendar Second Day Regular Session",75,0,3,0,78
1459028,1098659,2021-06-16,Senate,"Do pass as amended, but first amend, and re-refer to the Committee on [Appropriations]",10,0,1,0,11
1459028,1107515,2021-09-01,Senate,"Assembly 3rd Reading AB1477 Cervantes By Lim贸n",38,0,0,2,40
1459028,1107905,2021-09-07,Assembly,"AB 1477 Cervantes Concurrence in Senate Amendments",72,0,0,8,80
1459031,1065204,2021-04-27,Assembly,"Do pass and be re-referred to the Committee on [Appropriations]",8,0,0,0,8
1459031,1076940,2021-05-12,Assembly,"Do pass. To Consent Calendar",16,0,0,0,16
1459031,1082025,2021-05-20,Assembly,"AB 1480 Rodriguez Consent Calendar Second Day Regular Session",76,0,2,0,78
1459031,1102871,2021-06-29,Senate,"Do pass as amended, but first amend, and re-refer to the Committee on [Appropriations]",5,0,0,0,5
1459031,1106356,2021-08-19,Senate,"Assembly 3rd Reading AB1480 Rodriguez By Min",37,0,0,3,40
1459031,1106461,2021-08-23,Assembly,"AB 1480 Rodriguez Concurrence in Senate Amendments",71,0,0,8,79
1459034,1065098,2021-04-28,Assembly,"Do pass and be re-referred to the Committee on [Appropriations] with recommendation: To Consent Calendar",13,0,0,0,13
1459037,1053518,2021-04-14,Assembly,"Do pass and be re-referred to the Committee on [Housing and Community Development]",8,1,2,0,11
1459038,1046158,2021-04-06,Assembly,"Do pass as amended",9,2,0,0,11
1459038,1086936,2021-05-27,Assembly,"AB 1487 Gabriel Assembly Third Reading",58,17,3,0,78
1459038,1104410,2021-07-06,Senate,"Do pass",9,2,0,0,11
1459038,1108046,2021-09-08,Senate,"Assembly 3rd Reading AB1487 Gabriel et al. By Allen",29,9,0,2,40
1459038,1108276,2021-09-09,Assembly,"AB 1487 Gabriel Concurrence in Senate Amendments",59,17,0,4,80
1459039,1057656,2021-04-19,Assembly,"Do pass. To Consent Calendar",6,0,1,0,7
1459041,1049016,2021-04-08,Assembly,"Do pass and be re-referred to the Committee on [Appropriations]",9,0,2,0,11
1459041,1065241,2021-04-28,Assembly,"Do pass",12,0,4,0,16
1459042,1048956,2021-04-08,Assembly,"Do pass and be re-referred to the Committee on [Education]",11,0,1,0,12
1459042,1065134,2021-04-28,Assembly,"Do pass and be re-referred to the Committee on [Appropriations]",5,1,1,0,7
1459042,1076964,2021-05-12,Assembly,"Do pass",16,0,0,0,16
1459042,1124330,2022-01-14,Assembly,"AB 1491 McCarty Assembly Third Reading",63,0,0,13,76
1459042,1211866,2022-06-01,Senate,"Do pass as amended, but first amend, and re-refer to the Committee on [Appropriations]",7,0,0,0,7
1459042,1222812,2022-08-01,Senate,"Placed on suspense file",7,0,0,0,7
1459042,1223617,2022-08-11,Senate,"Do pass as amended",7,0,0,0,7
1459042,1224636,2022-08-23,Senate,"Special Consent AB1491",40,0,0,0,40
1459042,1224809,2022-08-24,Assembly,"AB 1491 McCarty Concurrence in Senate Amendments",76,0,0,4,80
1459043,1067611,2021-04-29,Assembly,"Do pass and be re-referred to the Committee on [Appropriations]",6,2,0,0,8
1459045,1057688,2021-04-20,Assembly,"Do pass as amended and be re-referred to the Committee on [Business and Professions]",12,1,2,0,15
1459045,1065276,2021-04-27,Assembly,"Do pass as amended",15,0,4,0,19
1459046,1066699,2021-04-29,Assembly,"Do pass and be re-referred to the Committee on [Appropriations]",6,1,0,0,7
1459046,1080394,2021-05-19,Assembly,"Do pass",11,3,2,0,16
1459046,1083861,2021-05-24,Assembly,"AB 1495 Berman Assembly Third Reading",60,16,2,0,78
1459046,1104649,2021-07-12,Senate,"Do pass, but first be re-referred to the Committee on [Appropriations]",5,0,0,0,5
1459046,1106331,2021-08-19,Senate,"Assembly 3rd Reading AB1495 Luz Rivas et al. By Stern",28,8,0,4,40
1459046,1106487,2021-08-24,Assembly,"With recommendation: That Senate amendments be concurred in",6,1,0,0,7
1459046,1106685,2021-08-26,Assembly,"AB 1495 Luz Rivas Concurrence in Senate Amendments",58,16,0,5,79
1459049,1123340,2022-01-11,Assembly,"Do pass and be re-referred to the Committee on [Appropriations] with recommendation: To Consent Calendar",17,0,0,1,18
1459050,1044988,2021-04-05,Assembly,"Do pass and be re-referred to the Committee on [Appropriations] with recommendation: To Consent Calendar",14,0,1,0,15
1459050,1081616,2021-05-20,Assembly,"Do pass as amended",16,0,0,0,16
1459050,1092943,2021-06-01,Assembly,"AB 1499 Daly Assembly Third Reading",77,0,2,0,79
1459050,1101592,2021-06-24,Senate,"Do pass, but first be re-referred to the Committee on [Appropriations] with the recommendation: To Consent Calendar",15,0,2,0,17
1459050,1105054,2021-07-15,Senate,"Do pass",7,0,0,0,7
1459050,1107190,2021-08-30,Senate,"Special Consent AB1499",39,0,0,1,40
1459051,1049881,2021-04-08,Assembly,"Do pass as amended and be re-referred to the Committee on [Natural Resources]",9,0,6,0,15
1459051,1073349,2021-05-05,Assembly,"Do pass as amended and be re-referred to the Committee on [Appropriations]",8,1,2,0,11
1459051,1081447,2021-05-20,Assembly,"Do pass and be re-referred to the Committee on [Rules]",12,3,1,0,16
1459053,1123330,2022-01-11,Assembly,"Do pass as amended and be re-referred to the Committee on [Appropriations]",12,2,0,1,15
1459053,1126296,2022-01-20,Assembly,"Do pass",12,3,0,1,16
1459053,1131241,2022-01-31,Assembly,"AB 1502 Muratsuchi Assembly Third Reading",55,15,0,6,76
1459053,1218595,2022-06-22,Senate,"Do pass as amended, but first amend, and re-refer to the Committee on [Judiciary]",8,0,0,3,11
1459053,1222775,2022-08-01,Senate,"Placed on suspense file",7,0,0,0,7
1459053,1223777,2022-08-11,Senate,"Do pass",5,1,0,1,7
1459053,1224961,2022-08-25,Senate,"Assembly 3rd Reading AB1502 Muratsuchi et al. By Pan",25,8,0,7,40
1459053,1224962,2022-08-25,Assembly,"AB 1502 Muratsuchi Concurrence in Senate Amendments",56,17,0,7,80
1459054,1045003,2021-04-05,Assembly,"Do pass and be re-referred to the Committee on [Privacy and Consumer Protection]",13,0,2,0,15
1459054,1060890,2021-04-22,Assembly,"Do pass as amended and be re-referred to the Committee on [Appropriations]",10,0,1,0,11
1459056,1123298,2022-01-11,Assembly,"Do pass and be re-referred to the Committee on [Appropriations]",12,0,0,0,12
1459056,1126350,2022-01-20,Assembly,"Do pass",15,0,0,1,16
1459056,1131269,2022-01-31,Assembly,"AB 1505 Rodriguez Assembly Third Reading",75,0,0,1,76
1459056,1211864,2022-06-01,Senate,"Do pass, but first be re-referred to the Committee on [Appropriations]",4,2,0,1,7
1459056,1215572,2022-06-13,Senate,"Placed on suspense file",7,0,0,0,7
1459057,1060985,2021-04-22,Assembly,"Do pass",5,1,1,0,7
1459057,1092964,2021-06-01,Assembly,"AB 1506 Kalra Assembly Third Reading",60,14,5,0,79
1459057,1104672,2021-07-12,Senate,"Do pass, but first be re-referred to the Committee on [Appropriations]",5,0,0,0,5
1459057,1106132,2021-08-16,Senate,"Placed on suspense file",7,0,0,0,7
1459057,1106902,2021-08-26,Senate,"Do pass as amended",7,0,0,0,7
1459057,1108060,2021-09-08,Senate,"Assembly 3rd Reading AB1506 Kalra By Cortese",38,0,0,2,40
1459057,1108522,2021-09-10,Assembly,"With recommendation: That Senate amendments be concurred in",5,0,0,2,7
1459057,1108682,2021-09-10,Assembly,"AB 1506 Kalra Concurrence in Senate Amendments",73,1,0,6,80
1459060,1065188,2021-04-27,Assembly,"Do pass and be re-referred to the Committee on [Appropriations]",6,2,0,0,8
1459062,1066737,2021-04-29,Assembly,"Do pass as amended, and be re-referred to the Committee on [Appropriations] with recommendation: To Consent Calendar",13,0,0,0,13
1459062,1076956,2021-05-12,Assembly,"Do pass. To Consent Calendar",16,0,0,0,16
1459062,1081483,2021-05-20,Assembly,"AB 1511 INS. Consent Calendar Second Day Regular Session",76,0,2,0,78
1459062,1101639,2021-06-24,Senate,"Do pass as amended, but first amend, and re-refer to the Committee on [Public Safety]",12,0,0,0,12
1459062,1105035,2021-07-15,Senate,"Do pass",7,0,0,0,7
1459062,1107258,2021-08-30,Senate,"Special Consent AB1511 INS",39,0,0,1,40
1459062,1108016,2021-09-08,Assembly,"With recommendation: That Senate amendments be concurred in",13,0,0,1,14
1459062,1108356,2021-09-09,Assembly,"AB 1511 INS. Concurrence in Senate Amendments By DALY",80,0,0,0,80
1459063,1064113,2021-04-26,Assembly,"Do pass and be re-referred to the Committee on [Appropriations]",11,4,0,0,15
1459063,1081464,2021-05-20,Assembly,"Do pass",12,4,0,0,16
1459063,1092965,2021-06-01,Assembly,"AB 1512 Bauer-Kahan Assembly Third Reading",57,20,2,0,79
1459063,1104540,2021-07-08,Senate,"Do pass as amended, but first amend, and re-refer to the Committee on [Appropriations]",6,1,2,0,9
1459063,1106073,2021-08-16,Senate,"Placed on suspense file",7,0,0,0,7
1459063,1106976,2021-08-26,Senate,"Do pass as amended",5,2,0,0,7
1459066,1057616,2021-04-19,Assembly,"Do pass as amended and be re-referred to the Committee on [Appropriations]",9,0,2,0,11
1459066,1082183,2021-05-20,Assembly,"Do pass",13,0,3,0,16
1459066,1092938,2021-06-01,Assembly,"AB 1515 Santiago Assembly Third Reading",69,0,10,0,79
1459066,1221204,2022-06-29,Senate,"Do pass as amended, but first amend, and re-refer to the Committee on [Appropriations]",5,0,0,0,5
1459070,1124154,2022-01-10,Assembly,"Do pass and be re-referred to the Committee on [Appropriations]",4,5,0,2,11
1459071,1064145,2021-04-27,Assembly,"Do pass and be re-referred to the Committee on [Appropriations]",14,0,1,0,15
1459075,1064097,2021-04-26,Assembly,"Do pass and be re-referred to the Committee on [Appropriations] with recommendation: To Consent Calendar",15,0,0,0,15
1459075,1081650,2021-05-20,Assembly,"Do pass as amended",12,0,4,0,16
1459075,1092973,2021-06-01,Assembly,"AB 1524 O'Donnell Assembly Third Reading",76,0,3,0,79
1459075,1103832,2021-07-01,Senate,"Do pass, but first be re-referred to the Committee on [Transportation] with the recommendation: To Consent Calendar",7,0,0,0,7
1459075,1104690,2021-07-13,Senate,"Do pass, but first be re-referred to the Committee on [Appropriations]",12,4,1,0,17
1459075,1106406,2021-08-23,Senate,"Placed on suspense file",7,0,0,0,7
1459078,1057694,2021-04-20,Assembly,"Do pass and be re-referred to the Committee on [Appropriations]",15,0,0,0,15
1459078,1065091,2021-04-28,Assembly,"Do pass. To Consent Calendar",16,0,0,0,16
1459078,1074129,2021-05-06,Assembly,"AB 1527 Ting Consent Calendar Second Day Regular Session",77,0,1,0,78
1459078,1097051,2021-06-10,Senate,"Do pass, but first be re-referred to the Committee on [Appropriations] with the recommendation: To Consent Calendar",10,0,1,0,11
1459078,1101669,2021-06-24,Senate,"Consent Calendar AB1527",39,0,1,0,40
1459082,1059186,2021-04-21,Assembly,"Do pass as amended, and be re-referred to the Committee on [Natural Resources] with recommendation: To Consent Calendar",15,0,0,0,15
1459082,1082124,2021-05-20,Assembly,"Do pass",16,0,0,0,16
1459082,1092974,2021-06-01,Assembly,"AB 1531 O'Donnell Assembly Third Reading",79,0,0,0,79
1459082,1104268,2021-07-06,Senate,"Do pass, but first be re-referred to the Committee on [Appropriations] with the recommendation: To Consent Calendar",15,0,0,0,15
1459083,1065309,2021-04-27,Assembly,"Do pass as amended",19,0,0,0,19
1459083,1082051,2021-05-20,Assembly,"Do pass",16,0,0,0,16
1459083,1086921,2021-05-27,Assembly,"AB 1532 B. & P. Assembly Third Reading By LOW",78,0,0,0,78
1459083,1104590,2021-07-12,Senate,"Do pass as amended, but first amend, and re-refer to the Committee on [Appropriations]",13,0,1,0,14
1459083,1106229,2021-08-16,Senate,"Placed on suspense file",7,0,0,0,7
1459083,1106894,2021-08-26,Senate,"Do pass",7,0,0,0,7
1459083,1107737,2021-09-02,Senate,"Assembly 3rd Reading AB1532 B. & P. (Low) By Roth",39,0,0,1,40
1459083,1108102,2021-09-08,Assembly,"AB 1532 B. & P. Concurrence in Senate Amendments By LOW",78,0,0,2,80
1459084,1065086,2021-04-27,Assembly,"Do pass and be re-referred to the Committee on [Appropriations]",18,0,1,0,19
1459084,1081869,2021-05-20,Assembly,"Do pass",16,0,0,0,16
1459084,1092836,2021-06-01,Assembly,"AB 1533 B. & P. Assembly Third Reading By LOW",77,0,2,0,79
1459084,1104657,2021-07-12,Senate,"Do pass as amended, but first amend, and re-refer to the Committee on [Judiciary]",12,0,2,0,14
1459084,1106111,2021-08-16,Senate,"Placed on suspense file",7,0,0,0,7
1459084,1107007,2021-08-26,Senate,"Do pass as amended",5,0,0,2,7
1459084,1108070,2021-09-08,Senate,"Assembly 3rd Reading AB1533 B. & P. (Low) By Roth",38,0,0,2,40
1459084,1108564,2021-09-10,Assembly,"AB 1533 B. & P. Concurrence in Senate Amendments By LOW",78,0,0,2,80
1459085,1065236,2021-04-27,Assembly,"Do pass and be re-referred to the Committee on [Appropriations] with recommendation: To Consent Calendar",19,0,0,0,19
1459085,1081686,2021-05-20,Assembly,"Do pass",16,0,0,0,16
1459085,1087031,2021-05-27,Assembly,"AB 1534 B. & P. Assembly Third Reading By LOW",78,0,0,0,78
1459085,1104592,2021-07-12,Senate,"Do pass, but first be re-referred to the Committee on [Appropriations]",14,0,0,0,14
1459085,1106210,2021-08-16,Senate,"Placed on suspense file",7,0,0,0,7
1459085,1106935,2021-08-26,Senate,"Do pass",7,0,0,0,7
1459085,1108278,2021-09-09,Senate,"Assembly 3rd Reading AB1534 B. & P. (Low) By Roth",38,0,0,2,40
1459085,1108520,2021-09-10,Assembly,"With recommendation: That Senate amendments be concurred in",18,0,0,1,19
1459085,1108665,2021-09-10,Assembly,"AB 1534 Business and Professions Concurrence in Senate Amendments By LOW",76,0,0,4,80
1459086,1065198,2021-04-27,Assembly,"Do pass and be re-referred to the Committee on [Appropriations]",19,0,0,0,19
1459086,1081439,2021-05-20,Assembly,"Do pass",16,0,0,0,16
1459086,1086973,2021-05-27,Assembly,"AB 1535 B. & P. Assembly Third Reading By LOW",78,0,0,0,78
1459086,1104629,2021-07-12,Senate,"Do pass, but first be re-referred to the Committee on [Appropriations]",14,0,0,0,14
1459086,1106240,2021-08-16,Senate,"Placed on suspense file",7,0,0,0,7
1459086,1106945,2021-08-26,Senate,"Do pass as amended",7,0,0,0,7
1459086,1107892,2021-09-07,Senate,"Assembly 3rd Reading AB1535 B. & P. (Low) By Roth",37,0,0,3,40
1459086,1108501,2021-09-10,Assembly,"With recommendation: That Senate amendments be concurred in",18,0,0,1,19
1459086,1108596,2021-09-10,Assembly,"AB 1535 Business and Professions Concurrence in Senate Amendments By LOW",76,0,0,4,80
1459087,1065278,2021-04-27,Assembly,"Do pass as amended and be re-referred to the Committee on [Appropriations]",19,0,0,0,19
1459087,1081715,2021-05-20,Assembly,"Do pass",16,0,0,0,16
1459087,1086996,2021-05-27,Assembly,"AB 1536 B. & P. Assembly Third Reading By LOW",78,0,0,0,78
1459087,1104662,2021-07-12,Senate,"Do pass, but first be re-referred to the Committee on [Appropriations]",14,0,0,0,14
1459087,1106433,2021-08-23,Senate,"Placed on suspense file",7,0,0,0,7
1459087,1106559,2021-08-26,Senate,"Do pass as amended",7,0,0,0,7
1459087,1107698,2021-09-02,Senate,"Assembly 3rd Reading AB1536 B. & P. (Low) By Roth",39,0,0,1,40
1459087,1108521,2021-09-10,Assembly,"With recommendation: That Senate amendments be concurred in",18,0,0,1,19
1459087,1108669,2021-09-10,Assembly,"AB 1536 Business and Professions Concurrence in Senate Amendments By LOW",76,0,0,4,80
1459088,1065099,2021-04-27,Assembly,"Do pass and be re-referred to the Committee on [Appropriations]",18,0,1,0,19
1459088,1074125,2021-05-06,Assembly,"AB 1537 Low Assembly Third Reading",76,0,2,0,78
1459088,1104634,2021-07-12,Senate,"Do pass",13,0,1,0,14
1459088,1107612,2021-09-02,Senate,"Assembly 3rd Reading AB1537 Low et al. By Roth",39,0,0,1,40
1459089,1057684,2021-04-19,Assembly,"Do pass as amended and be re-referred to the Committee on [Appropriations]",11,0,0,0,11
1459091,1065263,2021-04-27,Assembly,"Do pass and be re-referred to the Committee on [Appropriations]",6,2,0,0,8
1459091,1081785,2021-05-20,Assembly,"Do pass",12,4,0,0,16
1459091,1090461,2021-06-02,Assembly,"AB 1540 Ting Assembly Third Reading",53,20,6,0,79
1459091,1104264,2021-07-06,Senate,"Do pass as amended, but first amend, and re-refer to the Committee on [Appropriations]",4,1,0,0,5
1459091,1106091,2021-08-16,Senate,"Placed on suspense file",7,0,0,0,7
1459091,1106596,2021-08-26,Senate,"Do pass as amended",5,2,0,0,7
1459091,1108108,2021-09-08,Senate,"Assembly 3rd Reading AB1540 Ting et al. By Skinner",23,9,0,8,40
1459091,1108253,2021-09-09,Assembly,"AB 1540 Ting Concurrence in Senate Amendments",47,24,0,9,80
1459092,1054720,2021-04-15,Assembly,"Do pass and be re-referred to the Committee on [Appropriations] with recommendation: To Consent Calendar",13,0,0,0,13
1459092,1065138,2021-04-28,Assembly,"Do pass. To Consent Calendar",16,0,0,0,16
1459092,1074159,2021-05-06,Assembly,"AB 1541 INS. Consent Calendar Second Day Regular Session",77,0,1,0,78
1459092,1101623,2021-06-24,Senate,"Do pass, but first be re-referred to the Committee on [Appropriations] with the recommendation: To Consent Calendar",12,0,0,0,12
1459092,1107257,2021-08-30,Senate,"Consent Calendar AB1541 INS",39,0,0,1,40
1459093,1053405,2021-04-13,Assembly,"Do pass and be re-referred to the Committee on [Health]",7,0,1,0,8
1459093,1064134,2021-04-27,Assembly,"Do pass as amended and be re-referred to the Committee on [Appropriations]",11,2,2,0,15
1459093,1082028,2021-05-20,Assembly,"Do pass",11,4,1,0,16
1459093,1090468,2021-06-02,Assembly,"AB 1542 McCarty Assembly Third Reading",65,1,13,0,79
1459093,1102831,2021-06-29,Senate,"Do pass, but first be re-referred to the Committee on [Health]",3,0,2,0,5
1459093,1104957,2021-07-14,Senate,"Do pass as amended, but first amend, and re-refer to the Committee on [Appropriations]",9,0,2,0,11
1459093,1106197,2021-08-16,Senate,"Placed on suspense file",7,0,0,0,7
1459093,1106642,2021-08-26,Senate,"Do pass as amended",6,0,0,1,7
1459093,1107666,2021-09-02,Senate,"Assembly 3rd Reading AB1542 McCarty et al. By Dodd",39,0,0,1,40
1459093,1107906,2021-09-07,Assembly,"AB 1542 McCarty Concurrence in Senate Amendments",58,0,0,22,80
1459096,1048942,2021-04-08,Assembly,"Do pass as amended and be re-referred to the Committee on [Arts, Entertainment, Sports, Tourism, and Internet Media]",9,1,1,0,11
1459096,1062754,2021-04-26,Assembly,"Do pass and be re-referred to the Committee on [Appropriations]",4,0,3,0,7
1459097,1054616,2021-04-14,Assembly,"Do pass as amended and be re-referred to the Committee on [Elections]",7,0,1,0,8
1459097,1066715,2021-04-29,Assembly,"Do pass",7,0,0,0,7
1459097,1092971,2021-06-01,Assembly,"AB 1546 Chau Third Reading Urgency",69,6,4,0,79
1459097,1102490,2021-06-28,Senate,"Do pass, but first be re-referred to the Committee on [Education]",4,1,0,0,5
1459097,1104879,2021-07-14,Senate,"Do pass",7,0,0,0,7
1459097,1106174,2021-08-16,Senate,"Assembly 3rd Reading AB1546 Chau et al. By Rubio Urgency Clause",36,0,0,4,40
1459101,1054630,2021-04-15,Assembly,"Do pass and be re-referred to the Committee on [Appropriations]",6,0,1,0,7
1459101,1065117,2021-04-28,Assembly,"Do pass",12,4,0,0,16
1459101,1090495,2021-06-02,Assembly,"AB 1550 Luz Rivas Assembly Third Reading",61,16,2,0,79
1459101,1102478,2021-06-28,Senate,"Do pass, but first be re-referred to the Committee on [Appropriations]",4,0,1,0,5
1459101,1105098,2021-07-15,Senate,"Placed on suspense file",7,0,0,0,7
1459101,1106712,2021-08-26,Senate,"Do pass",5,2,0,0,7
1459101,1107673,2021-09-02,Senate,"Assembly 3rd Reading AB1550 Luz Rivas et al. By Leyva",26,11,0,3,40
1459102,1123775,2022-01-12,Assembly,"Do pass as amended and be re-referred to the Committee on [Appropriations]",8,0,0,0,8
1459102,1123776,2022-01-12,Assembly,"Do pass and be re-referred to the Committee on [Local Government]",7,0,0,1,8
1459102,1126305,2022-01-20,Assembly,"Do pass. To Consent Calendar",15,0,0,1,16
1459102,1129877,2022-01-27,Assembly,"AB 1551 Santiago Consent Calendar Second Day Regular Session",61,0,0,15,76
1459102,1211913,2022-05-31,Senate,"Do pass, but first be re-referred to the Committee on [Governance and Finance]",7,0,0,2,9
1459102,1217922,2022-06-22,Senate,"Do pass, but first be re-referred to the Committee on [Appropriations] with the recommendation: To Consent Calendar",5,0,0,0,5
1459102,1224549,2022-08-23,Senate,"Assembly 3rd Reading AB1551 Santiago By Hertzberg",39,0,0,1,40
1459103,1065092,2021-04-27,Assembly,"Do pass and be re-referred to the Committee on [Appropriations]",2,4,13,0,19
1459104,1123306,2022-01-11,Assembly,"Do pass and be re-referred to the Committee on [Appropriations]",6,0,0,3,9
1459107,1050788,2021-04-12,Assembly,"Do pass and be re-referred to the Committee on [Privacy and Consumer Protection]",6,0,1,0,7
1459107,1060856,2021-04-22,Assembly,"Do pass as amended and be re-referred to the Committee on [Appropriations]",11,0,0,0,11
1459107,1080446,2021-05-19,Assembly,"Do pass",15,0,1,0,16
1459107,1083842,2021-05-24,Assembly,"AB 1556 Friedman Assembly Third Reading",76,0,2,0,78
1459107,1099753,2021-06-21,Senate,"Do pass, but first be re-referred to the Committee on [Appropriations]",9,0,5,0,14
1459107,1107155,2021-08-30,Senate,"Assembly 3rd Reading AB1556 Friedman et al. By Newman",36,0,0,4,40
1459107,1107458,2021-09-01,Assembly,"AB 1556 Friedman Concurrence in Senate Amendments",78,0,0,1,79
1459111,1048953,2021-04-07,Assembly,"Do pass and be re-referred to the Committee on [Privacy and Consumer Protection] with recommendation: To Consent Calendar",7,0,0,0,7
1459111,1060966,2021-04-22,Assembly,"Do pass and be re-referred to the Committee on [Appropriations]",11,0,0,0,11
1459111,1081538,2021-05-20,Assembly,"Do pass",16,0,0,0,16
1459111,1092878,2021-06-01,Assembly,"AB 1560 Daly Assembly Third Reading",79,0,0,0,79
1459111,1100805,2021-06-23,Senate,"Do pass, but first be re-referred to the Committee on [Governmental Organization] with the recommendation: To Consent Calendar",7,0,0,0,7
1459111,1104337,2021-07-06,Senate,"Do pass, but first be re-referred to the Committee on [Appropriations] with the recommendation: To Consent Calendar",15,0,0,0,15
1459111,1106242,2021-08-16,Senate,"Placed on suspense file",7,0,0,0,7
1459111,1106740,2021-08-26,Senate,"Do pass as amended",7,0,0,0,7
1459111,1107733,2021-09-02,Senate,"Assembly 3rd Reading AB1560 Daly By Umberg",39,0,0,1,40
1459111,1108008,2021-09-08,Assembly,"AB 1560 Daly Concurrence in Senate Amendments",78,0,0,2,80
1459113,1104411,2021-07-07,Assembly,"Be adopted. To Consent Calendar",11,0,0,0,11
1459113,1104598,2021-07-12,Assembly,"ACR 33 Friedman Consent Calendar Second Day",77,0,2,0,79
1459113,1107171,2021-08-30,Senate,"Special Consent ACR33",39,0,0,1,40
1459114,1065144,2021-04-28,Assembly,"Be adopted. To Consent Calendar",11,0,0,0,11
1459114,1080401,2021-05-19,Assembly,"Be adopted. To Consent Calendar",15,0,1,0,16
1459114,1083831,2021-05-24,Assembly,"AJR 7 Patterson Consent Calendar Second Day",76,0,2,0,78
1459114,1103483,2021-06-30,Senate,"Be adopted, but first be re-referred to the Committee on [Appropriations] with recommendation: To Consent Calendar",6,0,1,0,7
1459114,1107131,2021-08-30,Senate,"Consent Calendar AJR7",39,0,0,1,40
1459115,1016215,2021-02-25,Assembly,"Be adopted. To third reading",11,0,1,0,12
1459116,1016175,2021-02-25,Assembly,"Be adopted. To Consent Calendar",11,0,1,0,12
1459116,1022304,2021-03-04,Assembly,"HR 25 Bonta Consent Calendar Second Day Regular Session",72,0,7,0,79
1459117,1056361,2021-04-19,Senate,"Do pass, but first be re-referred to the Committee on [Appropriations]",5,0,0,0,5
1459117,1068197,2021-05-03,Senate,"Placed on suspense file",6,0,1,0,7
1459117,1082110,2021-05-20,Senate,"Do pass",5,2,0,0,7
1459117,1086113,2021-05-26,Senate,"Senate 3rd Reading SB628 Allen",35,3,2,0,40
1459117,1099724,2021-06-21,Assembly,"Do pass and be re-referred to the Committee on [Labor and Employment]",7,0,0,0,7
1459117,1100344,2021-06-22,Assembly,"Do pass and be re-referred to the Committee on [Appropriations]",5,0,2,0,7
1459117,1106979,2021-08-26,Assembly,"Do pass as amended",13,0,0,3,16
1459117,1108013,2021-09-08,Assembly,"SB 628 Allen Senate Third Reading By Quirk-Silva",69,3,0,8,80
1459117,1108637,2021-09-10,Senate,"Unfinished Business SB628 Allen et al. Concurrence",35,1,0,4,40
1459118,1046103,2021-04-06,Senate,"Do pass, but first be re-referred to the Committee on [Transportation] with the recommendation: To Consent Calendar",5,0,0,0,5
1459118,1064036,2021-04-27,Senate,"Do pass, but first be re-referred to the Committee on [Appropriations] with the recommendation: To Consent Calendar",15,0,2,0,17
1459118,1077622,2021-05-13,Senate,"Consent Calendar SB629",38,0,2,0,40
1459118,1098165,2021-06-15,Assembly,"Do pass and be re-referred to the Committee on [Transportation]",7,0,1,0,8
1459118,1104305,2021-07-05,Assembly,"Do pass and be re-referred to the Committee on [Appropriations]",14,1,0,0,15
1459118,1106915,2021-08-26,Assembly,"Do pass",15,1,0,0,16
1459118,1107605,2021-09-02,Assembly,"SB 629 Roth Senate Third Reading By Stone",76,0,0,3,79
1459118,1107760,2021-09-03,Senate,"Unfinished Business SB629 Roth et al. Concurrence",38,0,0,2,40
1459120,1106248,2021-08-16,Senate,"Do pass",7,0,0,0,7
1459120,1106364,2021-08-19,Senate,"Senate 3rd Reading SB631 Portantino Urgency Clause",37,0,0,3,40
1459120,1106684,2021-08-26,Assembly,"Do pass",16,0,0,0,16
1459120,1107424,2021-09-01,Assembly,"SB 631 Portantino Third Reading Urgency By Lorena Gonzalez",78,0,0,1,79
1459121,1124809,2022-01-18,Senate,"Do pass",5,0,0,2,7
1459121,1128990,2022-01-26,Senate,"Senate 3rd Reading SB632 Portantino Urgency Clause",33,0,0,7,40
1459121,1203343,2022-05-11,Assembly,"Do pass",13,0,0,3,16
1459121,1217096,2022-06-20,Assembly,"SB 632 Portantino Third Reading Urgency By Holden",60,1,0,19,80
1459121,1221212,2022-06-30,Senate,"Unfinished Business SB632 Portantino Urgency Clause Concurrence",31,0,0,9,40
1459122,1053552,2021-04-13,Senate,"Do pass, but first be re-referred to the Committee on [Appropriations]",8,0,3,0,11
1459122,1128985,2022-01-26,Senate,"Senate 3rd Reading SB633 Lim贸n",31,1,0,8,40
1459122,1211892,2022-06-01,Assembly,"Do pass and be re-referred to the Committee on [Appropriations]",8,0,0,3,11
1459122,1218026,2022-06-22,Assembly,"Do pass. To Consent Calendar",13,0,0,3,16
1459122,1221579,2022-06-29,Assembly,"SB 633 Lim贸n Consent Calendar Second Day Regular Session",78,0,0,2,80
1459122,1223057,2022-08-04,Senate,"Unfinished Business SB633 Lim贸n Concurrence",35,0,0,5,40
1459123,1038696,2021-03-22,Senate,"Do pass, but first be re-referred to the Committee on [Appropriations] with the recommendation: To Consent Calendar",5,0,0,0,5
1459123,1048975,2021-04-08,Senate,"Consent Calendar SB634 L., P.E. & R",38,0,2,0,40
1459123,1100772,2021-06-23,Assembly,"Do pass and be re-referred to the Committee on [Appropriations] with recommendation: To Consent Calendar",7,0,0,0,7
1459123,1104439,2021-07-07,Assembly,"Do pass. To Consent Calendar",14,0,2,0,16
1459123,1105148,2021-07-15,Assembly,"SB 634 L., P.E. & R. Consent Calendar Second Day Regular Session",70,0,9,0,79
1459123,1106062,2021-08-16,Senate,"Unfinished Business SB634 L., P.E. & R. (Cortese) Concurrence",39,0,0,1,40
1459124,1051942,2021-04-13,Senate,"Do pass, but first be re-referred to the Committee on [Appropriations] with the recommendation: To Consent Calendar",16,0,1,0,17
1459124,1068293,2021-05-03,Senate,"Placed on suspense file",6,0,1,0,7
1459126,1065160,2021-04-28,Senate,"Do pass, but first be re-referred to the Committee on [Appropriations]",9,1,1,0,11
1459126,1078819,2021-05-17,Senate,"Placed on suspense file",7,0,0,0,7
1459126,1081790,2021-05-20,Senate,"Do pass",5,2,0,0,7
1459126,1089571,2021-06-01,Senate,"Senate 3rd Reading SB637 Newman et al",32,5,3,0,40
1459126,1104732,2021-07-13,Assembly,"Do pass as amended and be re-referred to the Committee on [Appropriations]",11,3,1,0,15
1459126,1106747,2021-08-26,Assembly,"Do pass",12,4,0,0,16
1459126,1107823,2021-09-03,Assembly,"SB 637 Newman Senate Third Reading By Maienschein Amend By MAIENSCHEIN Set #1",56,17,0,6,79
1459126,1225096,2022-08-29,Assembly,"Do pass",20,0,0,2,22
1459126,1225097,2022-08-29,Assembly,"SB 637 Ochoa Bogh Senate Third Reading",75,0,0,5,80
1459126,1225153,2022-08-30,Senate,"That the Assembly amendments be concurred in",3,3,0,9,15
1459127,1047467,2021-04-07,Senate,"Do pass as amended, but first amend, and re-refer to the Committee on [Judiciary]",9,0,0,0,9
1459127,1053455,2021-04-13,Senate,"Do pass, but first be re-referred to the Committee on [Appropriations] with the recommendation: To Consent Calendar",10,0,1,0,11
1459127,1075261,2021-05-10,Senate,"Consent Calendar SB638",37,0,3,0,40
1459127,1216651,2022-06-16,Assembly,"Be re-referred to the Committees on [Labor and Employment] and [Privacy and Consumer Protection]",8,0,0,3,11
1459127,1218031,2022-06-22,Assembly,"Do pass and be re-referred to the Committee on [Privacy and Consumer Protection]",6,0,0,1,7
1459127,1219926,2022-06-28,Assembly,"Do pass",8,0,0,2,10
1459128,1038699,2021-03-22,Senate,"Do pass, but first be re-referred to the Committee on [Human Services]",4,0,1,0,5
1459128,1057664,2021-04-20,Senate,"Do pass as amended, but first amend, and re-refer to the Committee on [Appropriations]",4,1,0,0,5
1459128,1068268,2021-05-03,Senate,"Placed on suspense file",6,0,1,0,7
1459128,1081632,2021-05-20,Senate,"Do pass as amended",5,2,0,0,7
1459128,1089457,2021-06-01,Senate,"Senate 3rd Reading SB639 Durazo et al",31,3,6,0,40
1459128,1100334,2021-06-22,Assembly,"Do pass and be re-referred to the Committee on [Human Services]",5,1,1,0,7
1459128,1103389,2021-06-30,Assembly,"Do pass as amended and be re-referred to the Committee on [Appropriations]",6,1,1,0,8
1459128,1106664,2021-08-26,Assembly,"Do pass as amended",12,3,0,1,16
1459128,1108137,2021-09-08,Assembly,"SB 639 Durazo Senate Third Reading By Lorena Gonzalez",45,13,0,22,80
1459128,1108425,2021-09-09,Senate,"Unfinished Business SB639 Durazo et al. Concurrence",29,3,0,8,40
1459129,1051983,2021-04-13,Senate,"Do pass, but first be re-referred to the Committee on [Appropriations] with the recommendation: To Consent Calendar",16,0,1,0,17
1459129,1068232,2021-05-03,Senate,"Placed on suspense file",6,0,1,0,7
1459129,1082178,2021-05-20,Senate,"Do pass as amended",7,0,0,0,7
1459129,1089533,2021-06-01,Senate,"Special Consent SB640",39,0,1,0,40
1459129,1099731,2021-06-21,Assembly,"Do pass and be re-referred to the Committee on [Appropriations] with recommendation: To Consent Calendar",15,0,0,0,15
1459129,1103396,2021-06-30,Assembly,"Do pass. To Consent Calendar",14,0,2,0,16
1459129,1104569,2021-07-08,Assembly,"SB 640 Becker Consent Calendar Second Day Regular Session",76,0,3,0,79
1459130,1120236,2022-01-05,Senate,"Do pass, but first be re-referred to the Committee on [Appropriations]",4,0,0,1,5
1459130,1124804,2022-01-18,Senate,"Placed on suspense file",6,0,0,1,7
1459130,1126333,2022-01-20,Senate,"Do pass as amended",7,0,0,0,7
1459130,1129005,2022-01-26,Senate,"Senate 3rd Reading SB641 Skinner",37,0,0,3,40
1459130,1220037,2022-06-28,Assembly,"Do pass and be re-referred to the Committee on [Appropriations]",7,0,0,1,8
1459130,1223991,2022-08-11,Assembly,"Do pass as amended",12,0,0,4,16
1459130,1224191,2022-08-18,Assembly,"SB 641 Skinner Senate Third Reading By Medina",75,0,0,5,80
1459130,1224472,2022-08-23,Senate,"Unfinished Business SB641 Skinner et al. Concurrence",40,0,0,0,40
1459131,1059269,2021-04-20,Senate,"Do pass, but first be re-referred to the Committee on [Rules]",8,2,1,0,11
1459131,1065217,2021-04-28,Senate,"Do pass as amended, but first amend, and re-refer to the Committee on [Appropriations]",9,1,1,0,11
1459131,1078752,2021-05-17,Senate,"Placed on suspense file",7,0,0,0,7
1459132,1050777,2021-04-12,Senate,"Do pass as amended, but first amend, and re-refer to the Committee on [Transportation]",7,0,0,0,7
1459132,1064093,2021-04-27,Senate,"Do pass as amended, but first amend, and re-refer to the Committee on [Appropriations]",16,0,1,0,17
1459132,1078746,2021-05-17,Senate,"Placed on suspense file",7,0,0,0,7
1459132,1081696,2021-05-20,Senate,"Do pass as amended",7,0,0,0,7
1459132,1089509,2021-06-01,Senate,"Senate 3rd Reading SB643 Archuleta et al",39,0,1,0,40
1459132,1100779,2021-06-23,Assembly,"Do pass and be re-referred to the Committee on [Transportation]",11,0,0,0,11
1459132,1104275,2021-07-05,Assembly,"Do pass and be re-referred to the Committee on [Appropriations] with recommendation: To Consent Calendar",15,0,0,0,15
1459132,1106947,2021-08-26,Assembly,"Do pass",16,0,0,0,16
1459132,1108186,2021-09-08,Assembly,"SB 643 Archuleta Senate Third Reading By Daly",80,0,0,0,80
1459132,1108420,2021-09-09,Senate,"Unfinished Business SB643 Archuleta et al. Concurrence",38,0,0,2,40
1459133,1047484,2021-04-07,Senate,"Do pass, but first be re-referred to the Committee on [Labor, Public Employment and Retirement ]",11,0,0,0,11
1459133,1064014,2021-04-26,Senate,"Do pass, but first be re-referred to the Committee on [Appropriations] with the recommendation: To Consent Calendar",5,0,0,0,5
1459133,1077538,2021-05-13,Senate,"Consent Calendar SB644",38,0,2,0,40
1459133,1210211,2022-05-27,Assembly,"Be re-referred to the Committees on [Health] and [Labor and Employment]",7,0,0,4,11
1459133,1215836,2022-06-14,Assembly,"Do pass and be re-referred to the Committee on [Labor and Employment]",12,1,0,2,15
1459133,1223641,2022-08-11,Assembly,"Do pass",14,2,0,0,16
1459133,1224253,2022-08-22,Assembly,"SB 644 Leyva Senate Third Reading By Luz Rivas Amendment Set #1",62,9,0,9,80
1459133,1225962,2022-08-31,Senate,"Unfinished Business SB644 Leyva et al. Concurrence",39,0,0,1,40
1459133,1225963,2022-08-31,Assembly,"SB 644 Leyva Senate Third Reading By Luz Rivas",68,7,0,5,80
1459135,1062773,2021-04-26,Senate,"Do pass, but first be re-referred to the Committee on [Appropriations]",14,0,0,0,14
1459135,1077520,2021-05-13,Senate,"Senate 3rd Reading SB646 Hertzberg",38,0,2,0,40
1459135,1104346,2021-07-06,Assembly,"Do pass and be re-referred to the Committee on [Judiciary]",7,0,0,0,7
1459135,1104702,2021-07-13,Assembly,"Do pass as amended and be re-referred to the Committee on [Appropriations]",9,1,1,0,11
1459135,1106906,2021-08-26,Assembly,"Do pass as amended",13,0,0,3,16
1459135,1107690,2021-09-02,Assembly,"SB 646 Hertzberg Senate Third Reading By Reyes",65,2,0,12,79
1459135,1108039,2021-09-08,Senate,"That the Assembly amendments be concurred in",4,1,0,0,5
1459135,1108333,2021-09-09,Senate,"Unfinished Business SB646 Hertzberg Concurrence",27,9,0,4,40
1459136,1047466,2021-04-06,Senate,"Do pass, but first be re-referred to the Committee on [Appropriations] with the recommendation: To Consent Calendar",11,0,0,0,11
1459136,1060879,2021-04-22,Senate,"Consent Calendar SB647",38,0,2,0,40
1459136,1216641,2022-06-16,Assembly,"Be re-referred to the Committee on [Public Employment and Retirement]",8,0,0,3,11
1459136,1218019,2022-06-22,Assembly,"Do pass and be re-referred to the Committee on [Appropriations]",7,0,0,0,7
1459136,1223000,2022-08-03,Assembly,"Do pass",12,0,0,4,16
1459137,1057717,2021-04-20,Senate,"Do pass, but first be re-referred to the Committee on [Appropriations] with the recommendation: To Consent Calendar",5,0,0,0,5
1459137,1078802,2021-05-17,Senate,"Placed on suspense file",7,0,0,0,7
1459137,1081826,2021-05-20,Senate,"Do pass as amended",7,0,0,0,7
1459138,1054711,2021-04-15,Senate,"Do pass as amended, but first amend, and re-refer to the Committee on [Judiciary]",9,0,0,0,9
1459138,1072278,2021-05-04,Senate,"Do pass",11,0,0,0,11
1459138,1075260,2021-05-10,Senate,"Senate 3rd Reading SB649 Cortese",37,0,3,0,40
1459138,1210201,2022-05-27,Assembly,"Be re-referred to the Committee on [Housing and Community Development]",7,0,0,4,11
1459138,1220873,2022-06-29,Assembly,"Do pass as amended",6,2,0,0,8
1459138,1224039,2022-08-11,Assembly,"Do pass as amended",12,3,0,1,16
1459138,1225034,2022-08-29,Assembly,"SB 649 Cortese Senate Third Reading By Kalra",59,15,0,6,80
1459138,1225209,2022-08-30,Senate,"Unfinished Business SB649 Cortese et al. Concurrence",39,0,0,1,40
1459139,1059355,2021-04-21,Senate,"Do pass as amended, but first amend, and re-refer to the Committee on [Appropriations]",8,2,1,0,11
1459139,1078722,2021-05-17,Senate,"Placed on suspense file",7,0,0,0,7
1459139,1082003,2021-05-20,Senate,"Do pass as amended",5,2,0,0,7
1459139,1090404,2021-06-02,Senate,"Senate 3rd Reading SB650 Stern",34,3,3,0,40
1459139,1104688,2021-07-13,Assembly,"Do pass as amended and be re-referred to the Committee on [Appropriations]",13,0,2,0,15
1459139,1106865,2021-08-26,Assembly,"Do pass",12,1,0,3,16
1459139,1108163,2021-09-08,Assembly,"SB 650 Stern Senate Third Reading By Muratsuchi",65,4,0,11,80
1459139,1108334,2021-09-09,Senate,"Unfinished Business SB650 Stern By Gonzalez Concurrence",32,6,0,2,40
1459141,1056355,2021-04-19,Senate,"Do pass, but first be re-referred to the Committee on [Appropriations]",12,0,2,0,14
1459141,1131281,2022-01-31,Senate,"Senate 3rd Reading SB652 Bates",37,0,0,3,40
1459143,1053437,2021-04-13,Senate,"Do pass, but first be re-referred to the Committee on [Appropriations]",10,0,1,0,11
1459143,1083819,2021-05-24,Senate,"Senate 3rd Reading SB654 Min et al",40,0,0,0,40
1459143,1100280,2021-06-22,Assembly,"Do pass and be re-referred to the Committee on [Appropriations]",10,0,1,0,11
1459143,1106648,2021-08-26,Assembly,"Do pass as amended",12,0,0,4,16
1459143,1107705,2021-09-02,Assembly,"SB 654 Min Senate Third Reading By Blanca Rubio",76,0,0,3,79
1459143,1107804,2021-09-03,Senate,"Unfinished Business SB654 Min et al. Concurrence",37,0,0,3,40
1459144,1037798,2021-03-25,Senate,"Do pass, but first be re-referred to the Committee on [Judiciary]",11,0,1,0,12
1459144,1072219,2021-05-04,Senate,"Do pass, but first be re-referred to the Committee on [Appropriations]",11,0,0,0,11
1459144,1083793,2021-05-24,Senate,"Senate 3rd Reading SB655 Bradford",40,0,0,0,40
1459144,1101662,2021-06-24,Assembly,"Do pass and be re-referred to the Committee on [Appropriations]",14,0,0,0,14
1459144,1104469,2021-07-07,Assembly,"Do pass",14,0,2,0,16
1459144,1106609,2021-08-26,Assembly,"SB 655 Bradford Senate Third Reading By Daly",71,0,0,8,79
1459145,1074155,2021-05-06,Senate,"Do pass",5,0,0,0,5
1459145,1124805,2022-01-18,Senate,"Senate 3rd Reading SB656 Eggman",32,0,0,8,40
1459145,1215018,2022-06-08,Assembly,"Do pass",8,0,0,0,8
1459145,1224943,2022-08-25,Assembly,"SB 656 Eggman Senate Third Reading By Flora",74,0,0,6,80
1459146,1046137,2021-04-05,Senate,"Do pass, but first be re-referred to the Committee on [Judiciary]",5,0,0,0,5
1459146,1059278,2021-04-20,Senate,"Do pass as amended, and be ordered to the Consent Calendar",11,0,0,0,11
1459146,1066758,2021-04-29,Senate,"Consent Calendar SB657",36,0,4,0,40
1459146,1095024,2021-06-08,Assembly,"Do pass and be re-referred to the Committee on [Judiciary] with recommendation: To Consent Calendar",7,0,0,0,7
1459146,1100275,2021-06-22,Assembly,"Do pass. To Consent Calendar",11,0,0,0,11
1459146,1102488,2021-06-28,Assembly,"SB 657 Ochoa Bogh Consent Calendar Second Day",77,0,2,0,79
1459147,1048943,2021-04-08,Senate,"Do pass, but first be re-referred to the Committee on [Military & Veterans Affairs]",5,0,0,0,5
1459147,1065292,2021-04-28,Senate,"Do pass, but first be re-referred to the Committee on [Appropriations]",7,0,0,0,7
1459147,1075318,2021-05-10,Senate,"Placed on suspense file",7,0,0,0,7
1459148,1053410,2021-04-14,Senate,"Do pass as amended, but first amend, and re-refer to the Committee on [Appropriations]",7,0,0,0,7
1459148,1068159,2021-05-03,Senate,"Placed on suspense file",6,0,1,0,7
1459149,1050783,2021-04-12,Senate,"Do pass, but first be re-referred to the Committee on [Judiciary]",3,2,0,0,5
1459149,1059288,2021-04-20,Senate,"Do pass, but first be re-referred to the Committee on [Appropriations]",8,2,1,0,11
1459149,1068175,2021-05-03,Senate,"Placed on suspense file",6,0,1,0,7
1459149,1081582,2021-05-20,Senate,"Do pass",5,2,0,0,7
1459149,1083855,2021-05-24,Senate,"Senate 3rd Reading SB660 Newman",28,11,1,0,40
1459149,1098664,2021-06-16,Assembly,"Do pass as amended and be re-referred to the Committee on [Judiciary]",5,1,1,0,7
1459149,1100298,2021-06-22,Assembly,"Do pass as amended and be re-referred to the Committee on [Appropriations]",8,3,0,0,11
1459149,1106772,2021-08-26,Assembly,"Do pass",12,4,0,0,16
1459149,1107665,2021-09-02,Assembly,"SB 660 Newman Senate Third Reading By Low",51,18,0,10,79
1459149,1108057,2021-09-08,Senate,"Unfinished Business SB660 Newman et al. Concurrence",26,11,0,3,40
1459150,1030802,2021-03-17,Senate,"Do pass, but first be re-referred to the Committee on [Appropriations]",7,0,0,0,7
1459150,1044976,2021-04-05,Senate,"Placed on suspense file",7,0,0,0,7
1459150,1081597,2021-05-20,Senate,"Do pass",7,0,0,0,7
1459150,1089494,2021-06-01,Senate,"Special Consent SB661",39,0,1,0,40
1459150,1104290,2021-07-06,Assembly,"Do pass and be re-referred to the Committee on [Appropriations] with recommendation: To Consent Calendar",11,0,0,0,11
1459150,1106351,2021-08-19,Assembly,"Do pass. To Consent Calendar",16,0,0,0,16
1459150,1106936,2021-08-26,Assembly,"SB 661 Newman Consent Calendar Second Day Regular Session",73,0,0,6,79
1459151,1050791,2021-04-12,Senate,"Do pass as amended, but first amend, and re-refer to the Committee on [Environmental Quality]",10,3,1,0,14
1459151,1066771,2021-04-29,Senate,"Do pass as amended, but first amend, and re-refer to the Committee on [Appropriations]",6,0,1,0,7
1459151,1078784,2021-05-17,Senate,"Placed on suspense file",7,0,0,0,7
1459152,1050835,2021-04-12,Senate,"Do pass, but first be re-referred to the Committee on [Judiciary]",4,1,0,0,5
1459153,1065209,2021-04-28,Senate,"Do pass, but first be re-referred to the Committee on [Appropriations]",10,0,1,0,11
1459153,1075310,2021-05-10,Senate,"Placed on suspense file",7,0,0,0,7
1459153,1081724,2021-05-20,Senate,"Do pass",5,2,0,0,7
1459153,1090447,2021-06-02,Senate,"Senate 3rd Reading SB664 Allen",32,4,4,0,40
1459153,1104267,2021-07-06,Assembly,"Do pass as amended and be re-referred to the Committee on [Appropriations]",14,0,1,0,15
1459153,1106302,2021-08-19,Assembly,"Do pass",15,0,0,1,16
1459153,1108202,2021-09-08,Assembly,"SB 664 Allen Senate Third Reading By Nazarian",66,7,0,7,80
1459153,1108457,2021-09-09,Senate,"Unfinished Business SB664 Allen Concurrence",31,3,0,6,40
1459154,1047566,2021-04-06,Senate,"Do pass, but first be re-referred to the Committee on [Military & Veterans Affairs]",8,2,1,0,11
1459154,1053493,2021-04-14,Senate,"Do pass, but first be re-referred to the Committee on [Appropriations]",7,0,0,0,7
1459154,1068217,2021-05-03,Senate,"Placed on suspense file",6,0,1,0,7
1459154,1081570,2021-05-20,Senate,"Do pass as amended",6,0,1,0,7
1459154,1089564,2021-06-01,Senate,"Senate 3rd Reading SB665 Umberg",32,0,8,0,40
1459154,1100335,2021-06-22,Assembly,"Do pass as amended and be re-referred to the Committee on [Military and Veterans Affairs]",7,0,0,0,7
1459154,1104263,2021-07-06,Assembly,"Do pass and be re-referred to the Committee on [Appropriations]",10,0,1,0,11
1459154,1106695,2021-08-26,Assembly,"Do pass as amended",12,0,0,4,16
1459154,1108197,2021-09-08,Assembly,"SB 665 Umberg Senate Third Reading By Boerner Horvath",76,0,0,4,80
1459154,1108309,2021-09-09,Senate,"Unfinished Business SB665 Umberg et al. Concurrence",38,0,0,2,40
1459155,1047549,2021-04-06,Senate,"Do pass, but first be re-referred to the Committee on [Appropriations] with the recommendation: To Consent Calendar",11,0,0,0,11
1459155,1056370,2021-04-19,Senate,"Placed on suspense file",7,0,0,0,7
1459155,1081690,2021-05-20,Senate,"Do pass as amended",7,0,0,0,7
1459156,1027191,2021-03-11,Senate,"Do pass, but first be re-referred to the Committee on [Military & Veterans Affairs] with the recommendation: To Consent Calendar",5,0,0,0,5
1459156,1053494,2021-04-14,Senate,"Do pass, but first be re-referred to the Committee on [Appropriations] with the recommendation: To Consent Calendar",7,0,0,0,7
1459156,1068163,2021-05-03,Senate,"Placed on suspense file",6,0,1,0,7
1459156,1081788,2021-05-20,Senate,"Do pass",7,0,0,0,7
1459156,1089503,2021-06-01,Senate,"Special Consent SB667",39,0,1,0,40
1459156,1104302,2021-07-05,Assembly,"Do pass and be re-referred to the Committee on [Appropriations] with recommendation: To Consent Calendar",11,0,0,0,11
1459156,1106951,2021-08-26,Assembly,"Do pass as amended",13,0,0,3,16
1459156,1108656,2021-09-10,Senate,"Unfinished Business SB667 Roth et al. Concurrence",37,0,0,3,40
1459156,1108657,2021-09-10,Assembly,"SB 667 Roth Senate Third Reading By Cervantes",78,0,0,2,80
1459159,1065169,2021-04-27,Senate,"Do pass as amended, but first amend, and re-refer to the Committee on [Appropriations]",7,0,4,0,11
1459159,1075392,2021-05-10,Senate,"Placed on suspense file",7,0,0,0,7
1459159,1081454,2021-05-20,Senate,"Do pass as amended",7,0,0,0,7
1459160,1051936,2021-04-13,Senate,"Do pass, but first be re-referred to the Committee on [Environmental Quality]",15,0,2,0,17
1459160,1062771,2021-04-26,Senate,"Do pass as amended, but first amend, and re-refer to the Committee on [Appropriations]",7,0,0,0,7
1459160,1078824,2021-05-17,Senate,"Placed on suspense file",7,0,0,0,7
1459160,1081573,2021-05-20,Senate,"Do pass",7,0,0,0,7
1459160,1086105,2021-05-26,Senate,"Senate 3rd Reading SB671 Gonzalez et al",40,0,0,0,40
1459160,1099745,2021-06-21,Assembly,"Do pass and be re-referred to the Committee on [Natural Resources] with recommendation: To Consent Calendar",15,0,0,0,15
1459160,1104372,2021-07-07,Assembly,"Do pass and be re-referred to the Committee on [Appropriations] with recommendation: To Consent Calendar",11,0,0,0,11
1459160,1107032,2021-08-26,Assembly,"Do pass",16,0,0,0,16
1459160,1107378,2021-09-01,Assembly,"SB 671 Gonzalez Senate Third Reading By Friedman",77,0,0,2,79
1459160,1107741,2021-09-02,Senate,"Unfinished Business SB671 Gonzalez et al. Concurrence",39,0,0,1,40
1459162,1036479,2021-03-24,Senate,"Do pass, but first be re-referred to the Committee on [Appropriations] with the recommendation: To Consent Calendar",6,0,1,0,7
1459162,1060901,2021-04-22,Senate,"Consent Calendar SB673",38,0,2,0,40
1459162,1216638,2022-06-16,Assembly,"Be re-referred to the Committee on [Education]",8,0,0,3,11
1459163,1038798,2021-03-22,Senate,"Do pass, but first be re-referred to the Committee on [Transportation]",4,1,0,0,5
1459163,1064029,2021-04-27,Senate,"Do pass as amended, but first amend, and re-refer to the Committee on [Appropriations]",12,2,3,0,17
1459163,1075341,2021-05-10,Senate,"Placed on suspense file",7,0,0,0,7
1459163,1081613,2021-05-20,Senate,"Do pass as amended",5,2,0,0,7
1459163,1089519,2021-06-01,Senate,"Senate 3rd Reading SB674 Durazo et al",31,7,2,0,40
1459163,1100324,2021-06-22,Assembly,"Do pass and be re-referred to the Committee on [Transportation]",5,0,2,0,7
1459163,1104320,2021-07-05,Assembly,"Do pass as amended and be re-referred to the Committee on [Appropriations]",11,3,1,0,15
1459163,1106770,2021-08-26,Assembly,"Do pass as amended",12,4,0,0,16
1459163,1223263,2022-08-08,Assembly,"Do pass and be re-referred to the Committee on [Appropriations]",5,1,0,1,7
1459163,1223546,2022-08-11,Assembly,"Do pass as amended",12,4,0,0,16
1459163,1225690,2022-08-31,Senate,"Unfinished Business SB674 Durazo et al. Concurrence",30,9,0,1,40
1459163,1225691,2022-08-31,Assembly,"SB 674 Durazo Senate Third Reading By Cervantes",61,15,0,4,80
1459164,1074180,2021-05-06,Senate,"Do pass",5,0,0,0,5
1459164,1090419,2021-06-02,Senate,"Senate 3rd Reading SB675 Ochoa Bogh",38,0,2,0,40
1459164,1104321,2021-07-05,Assembly,"Do pass",11,0,0,0,11
1459164,1106465,2021-08-23,Assembly,"SB 675 Ochoa Bogh Senate Third Reading By Mayes",69,0,0,10,79
1459167,1035154,2021-03-23,Senate,"Do pass, but first be re-referred to the Committee on [Housing]",5,0,0,0,5
1459167,1054613,2021-04-15,Senate,"Do pass, but first be re-referred to the Committee on [Appropriations]",9,0,0,0,9
1459167,1068164,2021-05-03,Senate,"Placed on suspense file",6,0,1,0,7
1459167,1081427,2021-05-20,Senate,"Do pass",7,0,0,0,7
1459167,1083846,2021-05-24,Senate,"Senate 3rd Reading SB678 Rubio et al",40,0,0,0,40
1459167,1100272,2021-06-22,Assembly,"Do pass and be re-referred to the Committee on [Human Services]",8,0,0,0,8
1459167,1103518,2021-06-30,Assembly,"Do pass and be re-referred to the Committee on [Appropriations] with recommendation: To Consent Calendar",8,0,0,0,8
1459168,1054631,2021-04-15,Senate,"Do pass, but first be re-referred to the Committee on [Governance and Finance]",6,1,2,0,9
1459168,1060926,2021-04-22,Senate,"Do pass, but first be re-referred to the Committee on [Appropriations]",4,0,1,0,5
1459168,1078805,2021-05-17,Senate,"Placed on suspense file",7,0,0,0,7
1459168,1081710,2021-05-20,Senate,"Do pass as amended",5,2,0,0,7
1459168,1089555,2021-06-01,Senate,"Senate 3rd Reading SB679 Kamlager et al",29,7,4,0,40
1459168,1220808,2022-06-29,Assembly,"Do pass and be re-referred to the Committee on [Appropriations]",5,2,0,1,8
1459168,1223365,2022-08-11,Assembly,"Do pass as amended",12,4,0,0,16
1459168,1224819,2022-08-24,Assembly,"SB 679 Kamlager Senate Third Reading By Gipson",42,19,0,19,80
1459168,1225732,2022-08-31,Senate,"Unfinished Business SB679 Kamlager et al. Concurrence",21,13,0,6,40
1459171,1047591,2021-04-07,Senate,"Do pass as amended, but first amend, and re-refer to the Committee on [Appropriations] with the recommendation: To Consent Calendar",11,0,0,0,11
1459171,1068201,2021-05-03,Senate,"Placed on suspense file",6,0,1,0,7
1459171,1081658,2021-05-20,Senate,"Do pass as amended",7,0,0,0,7
1459171,1090484,2021-06-02,Senate,"Senate 3rd Reading SB682 Rubio et al",38,0,2,0,40
1459171,1104701,2021-07-13,Assembly,"Do pass and be re-referred to the Committee on [Appropriations] with recommendation: To Consent Calendar",14,0,1,0,15
1459171,1107026,2021-08-26,Assembly,"Do pass as amended",12,0,0,4,16
1459171,1108044,2021-09-08,Assembly,"SB 682 Rubio Senate Third Reading By Akilah Weber",79,0,0,1,80
1459171,1108409,2021-09-09,Senate,"Unfinished Business SB682 Rubio et al. Concurrence",33,0,0,7,40
1459173,1035189,2021-03-23,Senate,"Do pass as amended, but first amend, and re-refer to the Committee on [Appropriations]",13,0,2,0,15
1459173,1056377,2021-04-19,Senate,"Placed on suspense file",7,0,0,0,7
1459173,1081962,2021-05-20,Senate,"Do pass",7,0,0,0,7
1459173,1089532,2021-06-01,Senate,"Special Consent SB684",39,0,1,0,40
1459173,1102841,2021-06-29,Assembly,"Do pass as amended and be re-referred to the Committee on [Appropriations]",7,0,0,0,7
1459173,1106746,2021-08-26,Assembly,"Do pass",13,0,0,3,16
1459173,1217457,2022-06-21,Assembly,"Do pass and be re-referred to the Committee on [Appropriations]",11,0,0,1,12
1459173,1223801,2022-08-11,Assembly,"Do pass",16,0,0,0,16
1459173,1224164,2022-08-18,Assembly,"SB 684 Hueso Senate Third Reading By Eduardo Garcia",77,0,0,3,80
1459173,1225868,2022-08-31,Senate,"Unfinished Business SB684 Hueso et al. Concurrence",40,0,0,0,40
1459173,1225869,2022-08-31,Assembly,"SB 684 Hueso Senate Third Reading By Eduardo Garcia",79,0,0,1,80
1459174,1038796,2021-03-22,Senate,"Do pass, but first be re-referred to the Committee on [Appropriations]",5,0,0,0,5
1459174,1050784,2021-04-12,Senate,"Senate 3rd Reading SB685 McGuire et al",39,0,1,0,40
1459174,1095020,2021-06-08,Assembly,"Do pass and be re-referred to the Committee on [Appropriations]",4,2,1,0,7
1459175,1050789,2021-04-12,Senate,"Do pass, but first be re-referred to the Committee on [Appropriations]",4,1,0,0,5
1459175,1068227,2021-05-03,Senate,"Placed on suspense file",6,0,1,0,7
1459175,1081940,2021-05-20,Senate,"Do pass",5,2,0,0,7
1459175,1090422,2021-06-02,Senate,"Senate 3rd Reading SB686 Glazer",32,6,2,0,40
1459175,1103416,2021-06-30,Assembly,"Do pass and be re-referred to the Committee on [Appropriations]",6,1,0,0,7
1459175,1106835,2021-08-26,Assembly,"Do pass",12,4,0,0,16
1459175,1108299,2021-09-09,Assembly,"SB 686 Glazer Senate Third Reading By Berman",59,17,0,4,80
1459175,1108551,2021-09-10,Senate,"Unfinished Business SB686 Glazer et al. Concurrence",28,6,0,6,40
1459176,1036529,2021-03-24,Senate,"Do pass, but first be re-referred to the Committee on [Judiciary] with the recommendation: To Consent Calendar",11,0,0,0,11
1459176,1047529,2021-04-06,Senate,"Do pass as amended, but first amend, and re-refer to the Committee on [Appropriations] with the recommendation: To Consent Calendar",11,0,0,0,11
1459176,1068219,2021-05-03,Senate,"Placed on suspense file",6,0,1,0,7
1459176,1081705,2021-05-20,Senate,"Do pass",7,0,0,0,7
1459176,1089541,2021-06-01,Senate,"Special Consent SB687",39,0,1,0,40
1459176,1104319,2021-07-06,Assembly,"Do pass and be re-referred to the Committee on [Judiciary]",14,0,1,0,15
1459176,1104759,2021-07-13,Assembly,"Do pass and be re-referred to the Committee on [Appropriations]",10,1,0,0,11
1459177,1047435,2021-04-06,Senate,"Do pass, but first be re-referred to the Committee on [Appropriations]",9,2,0,0,11
1459177,1068222,2021-05-03,Senate,"Senate 3rd Reading SB688 Wieckowski",29,7,4,0,40
1459177,1215287,2022-06-09,Assembly,"Be re-referred to the Committee on [Judiciary]",8,0,0,3,11
1459177,1219992,2022-06-28,Assembly,"Do pass as amended and be re-referred to the Committee on [Appropriations]",9,2,0,0,11
1459177,1223387,2022-08-11,Assembly,"Do pass",12,4,0,0,16
1459177,1224351,2022-08-22,Assembly,"SB 688 Wieckowski Senate Third Reading By HANEY",59,15,0,6,80
1459177,1224817,2022-08-24,Senate,"Unfinished Business SB688 Wieckowski Concurrence",31,9,0,0,40
1459178,1059340,2021-04-21,Senate,"Do pass, but first be re-referred to the Committee on [Appropriations] with the recommendation: To Consent Calendar",11,0,0,0,11
1459178,1078827,2021-05-17,Senate,"Placed on suspense file",7,0,0,0,7
1459180,1060964,2021-04-22,Senate,"Do pass, but first be re-referred to the Committee on [Appropriations]",4,0,1,0,5
1459180,1068273,2021-05-03,Senate,"Placed on suspense file",6,0,1,0,7
1459181,1053486,2021-04-14,Senate,"Do pass, but first be re-referred to the Committee on [Appropriations]",7,0,0,0,7
1459181,1068256,2021-05-03,Senate,"Placed on suspense file",6,0,1,0,7
1459181,1082191,2021-05-20,Senate,"Do pass",7,0,0,0,7
1459181,1089517,2021-06-01,Senate,"Special Consent SB692",39,0,1,0,40
1459181,1104433,2021-07-07,Assembly,"Do pass as amended and be re-referred to the Committee on [Appropriations]",7,0,0,0,7
1459181,1220660,2022-06-29,Assembly,"Do pass and be re-referred to the Committee on [Appropriations] with recommendation: To Consent Calendar",7,0,0,0,7
1459181,1222987,2022-08-03,Assembly,"Do pass as amended. To Consent Calendar",15,0,0,1,16
1459181,1223464,2022-08-11,Assembly,"SB 692 Cortese Consent Calendar Second Day Regular Session",76,0,0,4,80
1459181,1224097,2022-08-16,Senate,"Unfinished Business SB692 Cortese et al. Concurrence",36,0,0,4,40
1459182,1053560,2021-04-14,Senate,"Do pass, but first be re-referred to the Committee on [Appropriations]",7,0,0,0,7
1459182,1068168,2021-05-03,Senate,"Placed on suspense file",6,0,1,0,7
1459182,1081759,2021-05-20,Senate,"Do pass as amended",7,0,0,0,7
1459182,1089609,2021-06-01,Senate,"Senate 3rd Reading SB693 Stern et al",39,0,1,0,40
1459182,1100767,2021-06-23,Assembly,"Do pass as amended and be re-referred to the Committee on [Appropriations]",7,0,0,0,7
1459183,1056350,2021-04-19,Senate,"Do pass, but first be re-referred to the Committee on [Appropriations] with the recommendation: To Consent Calendar",14,0,0,0,14
1459183,1075296,2021-05-10,Senate,"Consent Calendar SB694",37,0,3,0,40
1459183,1103407,2021-06-30,Assembly,"Do pass and be re-referred to the Committee on [Appropriations]",15,0,0,0,15
1459183,1104935,2021-07-14,Assembly,"Do pass",13,0,3,0,16
1459183,1107959,2021-09-07,Assembly,"SB 694 Bradford Senate Third Reading By Holden",70,0,0,10,80
1459183,1108585,2021-09-10,Senate,"Unfinished Business SB694 Bradford Concurrence",37,0,0,3,40
1459186,1066783,2021-04-29,Senate,"Do pass as amended, but first amend, and re-refer to the Committee on [Appropriations]",5,2,0,0,7
1459186,1078830,2021-05-17,Senate,"Placed on suspense file",7,0,0,0,7
1459188,1047442,2021-04-07,Senate,"Do pass, but first be re-referred to the Committee on [Appropriations]",6,1,0,0,7
1459188,1056424,2021-04-19,Senate,"Placed on suspense file",7,0,0,0,7
1459188,1081720,2021-05-20,Senate,"Do pass",5,2,0,0,7
1459188,1089538,2021-06-01,Senate,"Senate 3rd Reading SB699 Eggman",33,6,1,0,40
1459189,1056337,2021-04-19,Senate,"Do pass, but first be re-referred to the Committee on [Appropriations]",5,0,0,0,5
1459189,1078829,2021-05-17,Senate,"Senate 3rd Reading SB700 Durazo",29,9,2,0,40
1459189,1100331,2021-06-22,Assembly,"Do pass and be re-referred to the Committee on [Insurance]",5,2,0,0,7
1459189,1101655,2021-06-24,Assembly,"Do pass and be re-referred to the Committee on [Appropriations]",10,3,1,0,14
1459189,1106327,2021-08-19,Assembly,"Do pass",12,4,0,0,16
1459189,1216800,2022-06-16,Assembly,"SB 700 Durazo Senate Third Reading By Kalra Amend By REYES Set #1",48,19,0,12,79
1459189,1223224,2022-08-08,Assembly,"Do pass and be re-referred to the Committee on [Appropriations]",5,1,0,1,7
1459190,1047475,2021-04-07,Senate,"Do pass, but first be re-referred to the Committee on [Judiciary] with the recommendation: To Consent Calendar",7,0,0,0,7
1459190,1075324,2021-05-10,Senate,"Consent Calendar SB701 ED",37,0,3,0,40
1459190,1098157,2021-06-15,Assembly,"Do pass and be re-referred to the Committee on [Appropriations]",12,0,0,0,12
1459190,1103478,2021-06-30,Assembly,"Do pass. To Consent Calendar",14,0,2,0,16
1459190,1104515,2021-07-08,Assembly,"SB 701 ED. Consent Calendar Second Day Regular Session",76,0,3,0,79
1459191,1057712,2021-04-20,Senate,"Do pass as amended, but first amend, and re-refer to the Committee on [Judiciary]",11,0,4,0,15
1459191,1065230,2021-04-27,Senate,"Do pass, but first be re-referred to the Committee on [Appropriations]",10,0,1,0,11
1459191,1075263,2021-05-10,Senate,"Placed on suspense file",7,0,0,0,7
1459191,1081927,2021-05-20,Senate,"Do pass as amended",7,0,0,0,7
1459191,1090406,2021-06-02,Senate,"Senate 3rd Reading SB702 Lim贸n et al",33,0,7,0,40
1459191,1103433,2021-06-30,Assembly,"Do pass as amended and be re-referred to the Committee on [Judiciary]",6,0,1,0,7
1459191,1104757,2021-07-13,Assembly,"Do pass and be re-referred to the Committee on [Appropriations]",9,1,1,0,11
1459191,1106756,2021-08-26,Assembly,"Do pass",13,2,0,1,16
1459191,1107819,2021-09-03,Assembly,"SB 702 Lim贸n Senate Third Reading By Carrillo Amend By CARRILLO Set #1",58,13,0,8,79
1459191,1108025,2021-09-08,Assembly,"SB 702 Lim贸n Senate Third Reading By Carrillo",62,5,0,13,80
1459191,1108324,2021-09-09,Senate,"Unfinished Business SB702 Lim贸n et al. Concurrence",32,0,0,8,40
1459192,1031908,2021-03-18,Senate,"Do pass, but first be re-referred to the Committee on [Judiciary]",5,0,0,0,5
1459192,1047436,2021-04-06,Senate,"Do pass as amended, but first amend, and re-refer to the Committee on [Appropriations] with the recommendation: To Consent Calendar",11,0,0,0,11
1459192,1060905,2021-04-22,Senate,"Consent Calendar SB703",38,0,2,0,40
1459192,1098632,2021-06-16,Assembly,"Do pass and be re-referred to the Committee on [Judiciary]",11,0,0,0,11
1459192,1104312,2021-07-06,Assembly,"Do pass as amended and be re-referred to the Committee on [Appropriations]",10,0,1,0,11
1459192,1106554,2021-08-26,Assembly,"Do pass",16,0,0,0,16
1459192,1107455,2021-09-01,Assembly,"SB 703 Hurtado Senate Third Reading By Salas",78,0,0,1,79
1459192,1107669,2021-09-02,Senate,"Unfinished Business SB703 Hurtado et al. Concurrence",39,0,0,1,40
1459194,1047440,2021-04-07,Senate,"Do pass, but first be re-referred to the Committee on [Labor, Public Employment and Retirement ]",6,0,1,0,7
1459194,1064127,2021-04-26,Senate,"Do pass, but first be re-referred to the Committee on [Appropriations]",5,0,0,0,5
1459194,1075330,2021-05-10,Senate,"Placed on suspense file",7,0,0,0,7
1459194,1081738,2021-05-20,Senate,"Do pass",7,0,0,0,7
1459194,1089622,2021-06-01,Senate,"Special Consent SB705",39,0,1,0,40
1459194,1100300,2021-06-22,Assembly,"Do pass and be re-referred to the Committee on [Education] with recommendation: To Consent Calendar",7,0,0,0,7
1459194,1104490,2021-07-07,Assembly,"Do pass and be re-referred to the Committee on [Appropriations] with recommendation: To Consent Calendar",7,0,0,0,7
1459195,1074127,2021-05-06,Senate,"Do pass, but first be re-referred to the Committee on [Appropriations]",1,3,1,0,5
1459195,1074128,2021-05-06,Senate,"[First] hearing set for [05-06-2021]: Failed passage in Committee. Reconsideration granted",4,0,1,0,5
1459196,1046121,2021-04-06,Senate,"Do pass as amended, but first amend, and re-refer to the Committee on [Appropriations]",5,0,0,0,5
1459196,1075364,2021-05-10,Senate,"Senate 3rd Reading SB707 Cortese",37,0,3,0,40
1459196,1210215,2022-05-27,Assembly,"Be re-referred to the Committee on [Human Services]",7,0,0,4,11
1459196,1219958,2022-06-28,Assembly,"Do pass and be re-referred to the Committee on [Appropriations]",6,0,0,2,8
1459196,1223317,2022-08-10,Assembly,"Do pass",15,0,0,1,16
1459196,1224219,2022-08-18,Assembly,"SB 707 Cortese Senate Third Reading By Nazarian",76,0,0,4,80
1459196,1224727,2022-08-24,Senate,"Unfinished Business SB707 Cortese Concurrence",40,0,0,0,40
1459197,1064010,2021-04-27,Senate,"Do pass and be ordered to the Consent Calendar",9,0,0,0,9
1459197,1068270,2021-05-03,Senate,"Consent Calendar SB708 Melendez",36,0,4,0,40
1459197,1099128,2021-06-17,Assembly,"Do pass. To Consent Calendar",15,0,0,0,15
1459197,1101617,2021-06-24,Assembly,"SB 708 Melendez Consent Calendar Second Day Regular Session",77,0,2,0,79
1459198,1054717,2021-04-15,Senate,"Do pass, but first be re-referred to the Committee on [Appropriations] with the recommendation: To Consent Calendar",9,0,0,0,9
1459198,1075297,2021-05-10,Senate,"Consent Calendar SB709",37,0,3,0,40
1459198,1096121,2021-06-09,Assembly,"Do pass and be re-referred to the Committee on [Appropriations] with recommendation: To Consent Calendar",11,0,0,0,11
1459198,1103369,2021-06-30,Assembly,"Do pass. To Consent Calendar",14,0,2,0,16
1459198,1106431,2021-08-23,Assembly,"SB 709 Dahle Third Reading Urgency By Megan Dahle",71,0,0,8,79
1459198,1107434,2021-09-01,Senate,"Unfinished Business SB709 Dahle Urgency Clause Concurrence",38,0,0,2,40
1459199,1046109,2021-04-06,Senate,"Do pass, but first be re-referred to the Committee on [Appropriations]",4,1,0,0,5
1459199,1056388,2021-04-19,Senate,"Placed on suspense file",7,0,0,0,7
1459199,1081914,2021-05-20,Senate,"Do pass as amended",5,2,0,0,7
1459199,1090373,2021-06-02,Senate,"Senate 3rd Reading SB710 Bradford et al",26,10,4,0,40
1459199,1102815,2021-06-29,Assembly,"Do pass and be re-referred to the Committee on [Appropriations]",5,2,1,0,8
1459201,1060915,2021-04-22,Senate,"Do pass, but first be re-referred to the Committee on [Appropriations]",3,1,1,0,5
1459201,1082091,2021-05-20,Senate,"Senate 3rd Reading SB712 Hueso et al",30,0,10,0,40
1459201,1103842,2021-06-30,Assembly,"Do pass as amended and be re-referred to the Committee on [Appropriations]",8,0,0,0,8
1459201,1106348,2021-08-19,Assembly,"Do pass",15,0,0,1,16
1459201,1108096,2021-09-08,Assembly,"SB 712 Hueso Senate Third Reading By Waldron",77,0,0,3,80
1459201,1108283,2021-09-09,Senate,"Unfinished Business SB712 Hueso et al. Concurrence",32,0,0,8,40
1459202,1037854,2021-03-25,Senate,"Do pass, but first be re-referred to the Committee on [Appropriations] with the recommendation: To Consent Calendar",12,0,0,0,12
1459202,1060873,2021-04-22,Senate,"Consent Calendar SB713",38,0,2,0,40
1459203,1062795,2021-04-26,Senate,"Do pass as amended",4,0,1,0,5
1459203,1082206,2021-05-20,Senate,"Senate 3rd Reading SB714 Caballero",27,1,12,0,40
1459203,1103370,2021-06-30,Assembly,"Do pass as amended and be re-referred to the Committee on [Appropriations]",5,0,2,0,7
1459203,1106350,2021-08-19,Assembly,"Do pass",12,4,0,0,16
1459203,1107416,2021-09-01,Assembly,"SB 714 Caballero Senate Third Reading By Carrillo",57,11,0,11,79
1459203,1107623,2021-09-02,Senate,"Unfinished Business SB714 Caballero et al. Concurrence",30,6,0,4,40
1459204,1057665,2021-04-20,Senate,"Do pass, but first be re-referred to the Committee on [Appropriations]",4,1,0,0,5
1459204,1068147,2021-05-03,Senate,"Placed on suspense file",6,0,1,0,7
1459204,1081645,2021-05-20,Senate,"Do pass as amended",5,2,0,0,7
1459204,1090412,2021-06-02,Senate,"Senate 3rd Reading SB715 Portantino et al",30,7,3,0,40
1459204,1104751,2021-07-13,Assembly,"Do pass and be re-referred to the Committee on [Appropriations]",6,1,1,0,8
1459204,1106801,2021-08-26,Assembly,"Do pass",12,4,0,0,16
1459204,1107831,2021-09-03,Assembly,"SB 715 Portantino Senate Third Reading By McCarty Amend By MCCARTY Set #1",52,12,0,15,79
1459204,1108588,2021-09-10,Senate,"Unfinished Business SB715 Portantino et al. Concurrence",26,9,0,5,40
1459204,1108589,2021-09-10,Assembly,"SB 715 Portantino Senate Third Reading By McCarty",54,22,0,4,80
1459205,1054687,2021-04-15,Senate,"Do pass, but first be re-referred to the Committee on [Appropriations] with the recommendation: To Consent Calendar",9,0,0,0,9
1459205,1068156,2021-05-03,Senate,"Placed on suspense file",6,0,1,0,7
1459205,1081892,2021-05-20,Senate,"Do pass",7,0,0,0,7
1459205,1089524,2021-06-01,Senate,"Special Consent SB716",39,0,1,0,40
1459205,1103834,2021-07-01,Assembly,"Do pass and be re-referred to the Committee on [Appropriations] with recommendation: To Consent Calendar",14,0,1,0,15
1459205,1106591,2021-08-26,Assembly,"Do pass",16,0,0,0,16
1459205,1108045,2021-09-08,Assembly,"SB 716 McGuire Senate Third Reading By Eduardo Garcia",80,0,0,0,80
1459205,1108321,2021-09-09,Senate,"Unfinished Business SB716 McGuire et al. Concurrence",38,0,0,2,40
1459206,1047483,2021-04-07,Senate,"Do pass, but first be re-referred to the Committee on [Appropriations]",11,0,0,0,11
1459206,1068183,2021-05-03,Senate,"Placed on suspense file",6,0,1,0,7
1459206,1081529,2021-05-20,Senate,"Do pass as amended",7,0,0,0,7
1459206,1120721,2022-01-06,Senate,"Senate 3rd Reading SB717 Dodd",32,0,0,8,40
1459206,1216307,2022-06-15,Assembly,"Do pass as amended and be re-referred to the Committee on [Natural Resources]",11,0,0,2,13
1459206,1219454,2022-06-27,Assembly,"Do pass as amended and be re-referred to the Committee on [Appropriations]",11,0,0,0,11
1459206,1223927,2022-08-11,Assembly,"Do pass as amended",14,0,0,2,16
1459206,1225131,2022-08-29,Assembly,"SB 717 Dodd Senate Third Reading By Quirk-Silva",78,0,0,2,80
1459206,1225164,2022-08-30,Senate,"That the Assembly amendments be concurred in",10,0,0,4,14
1459206,1225200,2022-08-31,Senate,"Unfinished Business SB717 Dodd et al. Concurrence",39,0,0,1,40
1459207,1065167,2021-04-28,Senate,"Do pass as amended, but first amend, and re-refer to the Committee on [Appropriations]",11,0,0,0,11
1459207,1078803,2021-05-17,Senate,"Placed on suspense file",7,0,0,0,7
1459207,1082065,2021-05-20,Senate,"Do pass",7,0,0,0,7
1459207,1089586,2021-06-01,Senate,"Special Consent SB718",39,0,1,0,40
1459207,1100788,2021-06-22,Assembly,"Do pass as amended and be re-referred to the Committee on [Appropriations]",15,0,0,0,15
1459207,1106755,2021-08-26,Assembly,"Do pass",16,0,0,0,16
1459207,1108158,2021-09-08,Assembly,"SB 718 Bates Senate Third Reading By Maienschein",80,0,0,0,80
1459207,1108405,2021-09-09,Senate,"Unfinished Business SB718 Bates Concurrence",38,0,0,2,40
1459208,1048928,2021-04-08,Senate,"Do pass as amended, but first amend, and re-refer to the Committee on [Appropriations]",5,0,0,0,5
1459208,1068176,2021-05-03,Senate,"Placed on suspense file",6,0,1,0,7
1459208,1082037,2021-05-20,Senate,"Do pass as amended",7,0,0,0,7
1459208,1090387,2021-06-02,Senate,"Senate 3rd Reading SB719 Min",38,0,2,0,40
1459209,1051904,2021-04-13,Senate,"Do pass, but first be re-referred to the Committee on [Appropriations] with the recommendation: To Consent Calendar",5,0,0,0,5
1459209,1075315,2021-05-10,Senate,"Consent Calendar SB720",37,0,3,0,40
1459210,1025098,2021-03-09,Senate,"Do pass",13,0,1,0,14
1459210,1066707,2021-04-29,Senate,"Senate 3rd Reading SB721 Hueso et al",36,0,4,0,40
1459210,1104719,2021-07-12,Assembly,"Do pass",22,0,0,0,22
1459210,1107720,2021-09-02,Assembly,"SB 721 Hueso Senate Third Reading By Eduardo Garcia",77,0,0,2,79
1459211,1036458,2021-03-24,Senate,"Do pass, but first be re-referred to the Committee on [Appropriations] with the recommendation: To Consent Calendar",6,0,1,0,7
1459211,1056391,2021-04-19,Senate,"Placed on suspense file",7,0,0,0,7
1459211,1081941,2021-05-20,Senate,"Do pass",7,0,0,0,7
1459211,1089461,2021-06-01,Senate,"Special Consent SB722",39,0,1,0,40
1459211,1104424,2021-07-07,Assembly,"Do pass as amended. To Consent Calendar",7,0,0,0,7
1459211,1106925,2021-08-26,Assembly,"Do pass. To Consent Calendar",16,0,0,0,16
1459211,1107740,2021-09-02,Senate,"Unfinished Business SB722 Melendez Concurrence",39,0,0,1,40
1459212,1065272,2021-04-28,Senate,"Do pass as amended, but first amend, and re-refer to the Committee on [Appropriations]",7,0,0,0,7
1459212,1078760,2021-05-17,Senate,"Placed on suspense file",7,0,0,0,7
1459213,1053476,2021-04-13,Senate,"Do pass as amended, but first amend, and re-refer to the Committee on [Appropriations] with the recommendation: To Consent Calendar",10,0,1,0,11
1459213,1068193,2021-05-03,Senate,"Placed on suspense file",6,0,1,0,7
1459213,1082080,2021-05-20,Senate,"Do pass as amended",7,0,0,0,7
1459214,1047565,2021-04-07,Senate,"Do pass as amended, but first amend, and re-refer to the Committee on [Appropriations] with the recommendation: To Consent Calendar",7,0,0,0,7
1459214,1068251,2021-05-03,Senate,"Placed on suspense file",6,0,1,0,7
1459214,1081750,2021-05-20,Senate,"Do pass as amended",7,0,0,0,7
1459214,1089505,2021-06-01,Senate,"Special Consent SB725",39,0,1,0,40
1459214,1104369,2021-07-07,Assembly,"Do pass as amended and be re-referred to the Committee on [Appropriations]",7,0,0,0,7
1459215,1050837,2021-04-12,Senate,"Do pass as amended, but first amend, and re-refer to the Committee on [Transportation]",5,1,1,0,7
1459215,1064079,2021-04-27,Senate,"Do pass, but first be re-referred to the Committee on [Appropriations]",13,1,3,0,17
1459215,1075248,2021-05-10,Senate,"Placed on suspense file",7,0,0,0,7
1459215,1081852,2021-05-20,Senate,"Do pass",5,2,0,0,7
1459215,1090501,2021-06-02,Senate,"Senate 3rd Reading SB726 Gonzalez et al",31,6,3,0,40
1459215,1100758,2021-06-23,Assembly,"Do pass and be re-referred to the Committee on [Transportation]",8,2,1,0,11
1459215,1104313,2021-07-05,Assembly,"Do pass and be re-referred to the Committee on [Appropriations]",8,4,3,0,15
1459215,1106607,2021-08-26,Assembly,"Do pass as amended",12,4,0,0,16
1459216,1056320,2021-04-19,Senate,"Do pass as amended, but first amend, and re-refer to the Committee on [Judiciary]",4,1,0,0,5
1459216,1065128,2021-04-27,Senate,"Do pass as amended, but first amend, and re-refer to the Committee on [Appropriations]",9,1,1,0,11
1459216,1075349,2021-05-10,Senate,"Placed on suspense file",7,0,0,0,7
1459216,1082148,2021-05-20,Senate,"Do pass",5,2,0,0,7
1459216,1089575,2021-06-01,Senate,"Senate 3rd Reading SB727 Leyva",29,9,2,0,40
1459216,1100249,2021-06-22,Assembly,"Do pass and be re-referred to the Committee on [Judiciary]",5,2,0,0,7
1459216,1104236,2021-07-06,Assembly,"Do pass and be re-referred to the Committee on [Appropriations]",8,2,1,0,11
1459216,1106973,2021-08-26,Assembly,"Do pass",12,4,0,0,16
1459216,1108434,2021-09-09,Assembly,"SB 727 Leyva Senate Third Reading By Lorena Gonzalez",60,18,0,2,80
1459216,1108685,2021-09-10,Senate,"Unfinished Business SB727 Leyva et al. Concurrence",27,9,0,4,40
1459217,1066689,2021-04-29,Senate,"Do pass, but first be re-referred to the Committee on [Appropriations] with the recommendation: To Consent Calendar",9,0,0,0,9
1459217,1075282,2021-05-10,Senate,"Placed on suspense file",7,0,0,0,7
1459217,1081781,2021-05-20,Senate,"Do pass",7,0,0,0,7
1459217,1089512,2021-06-01,Senate,"Special Consent SB728",39,0,1,0,40
1459217,1100317,2021-06-22,Assembly,"Do pass and be re-referred to the Committee on [Local Government]",8,0,0,0,8
1459217,1103818,2021-06-30,Assembly,"Do pass and be re-referred to the Committee on [Appropriations]",8,0,0,0,8
1459217,1104910,2021-07-14,Assembly,"Do pass. To Consent Calendar",13,0,3,0,16
1459217,1107960,2021-09-07,Assembly,"SB 728 Hertzberg Senate Third Reading By Robert Rivas",72,0,0,8,80
1459217,1108019,2021-09-08,Senate,"Unfinished Business SB728 Hertzberg Concurrence",38,0,0,2,40
1459218,1062750,2021-04-26,Senate,"Do pass and be ordered to the Consent Calendar",5,0,0,0,5
1459218,1066757,2021-04-29,Senate,"Consent Calendar SB729",36,0,4,0,40
1459220,1052020,2021-04-13,Senate,"Do pass as amended, but first amend, and re-refer to the Committee on [Appropriations]",4,1,0,0,5
1459220,1068279,2021-05-03,Senate,"Placed on suspense file",6,0,1,0,7
1459220,1082104,2021-05-20,Senate,"Do pass as amended",5,2,0,0,7
1459220,1090443,2021-06-02,Senate,"Senate 3rd Reading SB731 Durazo et al",30,7,3,0,40
1459220,1102800,2021-06-29,Assembly,"Do pass and be re-referred to the Committee on [Appropriations]",6,2,0,0,8
1459220,1106729,2021-08-26,Assembly,"Do pass as amended",12,4,0,0,16
1459220,1108560,2021-09-10,Assembly,"SB 731 Durazo Senate Third Reading By Ting",35,28,0,17,80
1459220,1218609,2022-06-23,Assembly,"SB 731 Durazo Senate Third Reading By Ting Amendment Set #1",49,17,0,14,80
1459220,1221577,2022-06-29,Assembly,"SB 731 Durazo Senate Third Reading By Ting",46,22,0,12,80
1459220,1224225,2022-08-18,Senate,"Unfinished Business SB731 Durazo et al. Concurrence",28,10,0,2,40
1459222,1062759,2021-04-26,Senate,"Do pass, but first be re-referred to the Committee on [Appropriations] with the recommendation: To Consent Calendar",14,0,0,0,14
1459222,1077573,2021-05-13,Senate,"Consent Calendar SB733",38,0,2,0,40
1459222,1215301,2022-06-09,Assembly,"Be re-referred to the Committees on [Utilities and Energy] and [Natural Resources]",8,0,0,3,11
1459222,1217993,2022-06-22,Assembly,"Do pass and be re-referred to the Committee on [Natural Resources]",9,2,0,4,15
1459222,1219483,2022-06-27,Assembly,"Do pass as amended and be re-referred to the Committee on [Appropriations]",7,1,0,3,11
1459223,1060974,2021-04-22,Senate,"Do pass, but first be re-referred to the Committee on [Appropriations]",4,0,1,0,5
1459223,1086095,2021-05-26,Senate,"Senate 3rd Reading SB734 Hueso",40,0,0,0,40
1459223,1101661,2021-06-23,Assembly,"Do pass and be re-referred to the Committee on [Housing and Community Development]",8,0,0,0,8
1459223,1104670,2021-07-12,Assembly,"Do pass and be re-referred to the Committee on [Appropriations]",8,0,0,0,8
1459223,1106353,2021-08-19,Assembly,"Do pass",16,0,0,0,16
1459223,1107961,2021-09-07,Assembly,"SB 734 Hueso Senate Third Reading By Santiago",73,0,0,7,80
1459223,1108066,2021-09-08,Senate,"Unfinished Business SB734 Hueso et al. Concurrence",38,0,0,2,40
1459226,1036463,2021-03-24,Senate,"Do pass, but first be re-referred to the Committee on [Appropriations]",5,1,1,0,7
1459226,1056331,2021-04-19,Senate,"Placed on suspense file",7,0,0,0,7
1459226,1082081,2021-05-20,Senate,"Do pass",5,2,0,0,7
1459226,1083792,2021-05-24,Senate,"Senate 3rd Reading SB737 Lim贸n",32,7,1,0,40
1459226,1098147,2021-06-15,Assembly,"Do pass and be re-referred to the Committee on [Appropriations]",10,0,2,0,12
1459226,1106652,2021-08-26,Assembly,"Do pass as amended",12,1,0,3,16
1459226,1108533,2021-09-10,Senate,"Unfinished Business SB737 Lim贸n Concurrence",29,7,0,4,40
1459226,1108534,2021-09-10,Assembly,"SB 737 Lim贸n Senate Third Reading By Medina",67,0,0,13,80
1459228,1057627,2021-04-20,Senate,"Do pass, but first be re-referred to the Committee on [Appropriations]",4,1,0,0,5
1459228,1075246,2021-05-10,Senate,"Placed on suspense file",7,0,0,0,7
1459228,1081685,2021-05-20,Senate,"Do pass",5,1,1,0,7
1459228,1091800,2021-06-03,Senate,"Senate 3rd Reading SB739 Cortese",31,4,5,0,40
1459228,1103366,2021-06-30,Assembly,"Do pass and be re-referred to the Committee on [Appropriations]",6,0,2,0,8
1459231,1057637,2021-04-20,Senate,"Do pass, but first be re-referred to the Committee on [Appropriations]",5,0,0,0,5
1459231,1068179,2021-05-03,Senate,"Placed on suspense file",6,0,1,0,7
1459231,1082151,2021-05-20,Senate,"Do pass",6,1,0,0,7
1459231,1090460,2021-06-02,Senate,"Senate 3rd Reading SB742 Pan Urgency Clause",33,4,3,0,40
1459231,1102795,2021-06-29,Assembly,"Do pass as amended and be re-referred to the Committee on [Appropriations]",6,2,0,0,8
1459231,1106818,2021-08-26,Assembly,"Do pass",12,4,0,0,16
1459231,1107834,2021-09-03,Assembly,"SB 742 Pan Third Reading Urgency By Bauer-Kahan Amend By BAUER-KAHAN Set #1",56,14,0,9,79
1459231,1108117,2021-09-08,Senate,"Unfinished Business SB742 Pan et al. Urgency Clause Concurrence",28,8,0,4,40
1459231,1108118,2021-09-08,Assembly,"SB 742 Pan Third Reading Urgency By Bauer-Kahan",59,6,0,15,80
1459232,1062776,2021-04-26,Senate,"Do pass, but first be re-referred to the Committee on [Appropriations]",14,0,0,0,14
1459232,1075370,2021-05-10,Senate,"Placed on suspense file",7,0,0,0,7
1459232,1081520,2021-05-20,Senate,"Do pass",7,0,0,0,7
1459232,1086103,2021-05-26,Senate,"Senate 3rd Reading SB743 Bradford",40,0,0,0,40
1459232,1100771,2021-06-23,Assembly,"Do pass and be re-referred to the Committee on [Housing and Community Development] with recommendation: To Consent Calendar",12,0,1,0,13
1459232,1104671,2021-07-12,Assembly,"Do pass and be re-referred to the Committee on [Appropriations] with recommendation: To Consent Calendar",8,0,0,0,8
1459233,1059327,2021-04-21,Senate,"Do pass, but first be re-referred to the Committee on [Judiciary]",9,0,2,0,11
1459233,1065067,2021-04-27,Senate,"Do pass as amended, but first amend, and re-refer to the Committee on [Appropriations]",11,0,0,0,11
1459233,1075326,2021-05-10,Senate,"Placed on suspense file",7,0,0,0,7
1459233,1081857,2021-05-20,Senate,"Do pass as amended",7,0,0,0,7
1459233,1090411,2021-06-02,Senate,"Senate 3rd Reading SB744 Glazer et al",37,1,2,0,40
1459233,1100796,2021-06-22,Assembly,"Do pass as amended and be re-referred to the Committee on [Judiciary]",11,0,4,0,15
1459233,1104777,2021-07-13,Assembly,"Do pass as amended and be re-referred to the Committee on [Appropriations]",11,0,0,0,11
1459235,1047555,2021-04-06,Senate,"Do pass, but first be re-referred to the Committee on [Appropriations]",9,1,1,0,11
1459235,1056379,2021-04-19,Senate,"Placed on suspense file",7,0,0,0,7
1459235,1081745,2021-05-20,Senate,"Do pass as amended",5,2,0,0,7
1459235,1127198,2022-01-24,Senate,"Senate 3rd Reading SB746 Skinner",29,6,0,5,40
1459235,1220764,2022-06-29,Assembly,"Do pass and be re-referred to the Committee on [Appropriations]",7,0,0,0,7
1459235,1223340,2022-08-10,Assembly,"Do pass",15,0,0,1,16
1459235,1224147,2022-08-17,Assembly,"Do pass as amended",6,0,0,1,7
1459235,1225494,2022-08-31,Senate,"Unfinished Business SB746 Skinner Concurrence",36,0,0,4,40
1459235,1225495,2022-08-31,Assembly,"SB 746 Skinner Senate Third Reading By Gabriel",78,0,0,2,80
1459237,1046125,2021-04-06,Senate,"Do pass, but first be re-referred to the Committee on [Appropriations]",5,0,0,0,5
1459237,1056365,2021-04-19,Senate,"Placed on suspense file",7,0,0,0,7
1459237,1082139,2021-05-20,Senate,"Do pass as amended",7,0,0,0,7
1459237,1124803,2022-01-18,Senate,"Senate 3rd Reading SB748 Portantino Urgency Clause",34,0,0,6,40
1459237,1211882,2022-06-01,Assembly,"Do pass and be re-referred to the Committee on [Appropriations] with recommendation: To Consent Calendar",7,0,0,0,7
1459237,1217878,2022-06-22,Assembly,"Do pass. To Consent Calendar",13,0,0,3,16
1459237,1221526,2022-06-29,Assembly,"SB 748 Portantino Consent Calendar Second Day Regular Session",78,0,0,2,80
1459238,1030794,2021-03-17,Senate,"Do pass, but first be re-referred to the Committee on [Appropriations]",11,0,0,0,11
1459238,1056430,2021-04-19,Senate,"Placed on suspense file",7,0,0,0,7
1459238,1081906,2021-05-20,Senate,"Do pass as amended",7,0,0,0,7
1459238,1090486,2021-06-02,Senate,"Senate 3rd Reading SB749 Glazer et al",38,0,2,0,40
1459238,1104338,2021-07-06,Assembly,"Do pass as amended and be re-referred to the Committee on [Appropriations]",15,0,0,0,15
1459238,1106800,2021-08-26,Assembly,"Do pass",16,0,0,0,16
1459241,1062787,2021-04-26,Senate,"Do pass, but first be re-referred to the Committee on [Appropriations]",4,1,0,0,5
1459241,1075333,2021-05-10,Senate,"Placed on suspense file",7,0,0,0,7
1459241,1082021,2021-05-20,Senate,"Do pass",5,2,0,0,7
1459241,1091697,2021-06-03,Senate,"Senate 3rd Reading SB752 Allen",35,0,5,0,40
1459241,1103468,2021-06-30,Assembly,"Do pass as amended and be re-referred to the Committee on [Appropriations]",6,0,1,0,7
1459242,1056366,2021-04-19,Senate,"Do pass, but first be re-referred to the Committee on [Appropriations] with the recommendation: To Consent Calendar",5,0,0,0,5
1459242,1077547,2021-05-13,Senate,"Consent Calendar SB753",38,0,2,0,40
1459242,1100288,2021-06-22,Assembly,"Do pass and be re-referred to the Committee on [Appropriations] with recommendation: To Consent Calendar",7,0,0,0,7
1459242,1106372,2021-08-19,Assembly,"Do pass. To Consent Calendar",16,0,0,0,16
1459242,1108103,2021-09-08,Assembly,"SB 753 Roth Senate Third Reading By Luz Rivas",79,0,0,1,80
1459242,1108428,2021-09-09,Senate,"Unfinished Business SB753 Roth Concurrence",38,0,0,2,40
1459244,1064159,2021-04-26,Senate,"Do pass, but first be re-referred to the Committee on [Appropriations]",5,0,0,0,5
1459244,1075356,2021-05-10,Senate,"Placed on suspense file",7,0,0,0,7
1459244,1081979,2021-05-20,Senate,"Do pass",7,0,0,0,7
1459244,1089566,2021-06-01,Senate,"Special Consent SB755",39,0,1,0,40
1459244,1217972,2022-06-22,Assembly,"Do pass and be re-referred to the Committee on [Appropriations] with recommendation: To Consent Calendar",7,0,0,0,7
1459244,1223602,2022-08-11,Assembly,"Do pass as amended",12,0,0,4,16
1459244,1225013,2022-08-25,Assembly,"SB 755 Roth Senate Third Reading By Kalra",75,0,0,5,80
1459244,1225801,2022-08-30,Senate,"Special Consent SB755",38,0,0,2,40
1459245,1056341,2021-04-19,Senate,"Do pass, but first be re-referred to the Committee on [Appropriations]",14,0,0,0,14
1459245,1083808,2021-05-24,Senate,"Senate 3rd Reading SB756 Hueso",40,0,0,0,40
1459245,1098640,2021-06-16,Assembly,"Do pass as amended, and be re-referred to the Committee on [Appropriations] with recommendation: To Consent Calendar",14,0,1,0,15
1459245,1104487,2021-07-07,Assembly,"Do pass as amended. To Consent Calendar",14,0,2,0,16
1459245,1105032,2021-07-15,Assembly,"SB 756 Hueso Consent Calendar Second Day Regular Session",70,0,9,0,79
1459245,1107182,2021-08-30,Senate,"Special Consent SB756",39,0,0,1,40
1459246,1044960,2021-04-05,Senate,"Do pass as amended, but first amend, and re-refer to the Committee on [Energy, Utilities and Communications]",13,1,0,0,14
1459246,1083809,2021-05-24,Senate,"Senate 3rd Reading SB757 Lim贸n",40,0,0,0,40
1459246,1104239,2021-07-06,Assembly,"Do pass and be re-referred to the Committee on [Appropriations]",19,0,0,0,19
1459246,1106330,2021-08-19,Assembly,"Do pass. To Consent Calendar",16,0,0,0,16
1459246,1106574,2021-08-26,Assembly,"SB 757 Lim贸n Consent Calendar Second Day Regular Session",73,0,0,6,79
1459246,1107159,2021-08-30,Senate,"Unfinished Business SB757 Lim贸n Concurrence",39,0,0,1,40
1459249,1064054,2021-04-27,Senate,"Do pass, but first be re-referred to the Committee on [Appropriations]",13,1,3,0,17
1459251,1047586,2021-04-06,Senate,"Do pass and be ordered to the Consent Calendar",11,0,0,0,11
1459251,1060841,2021-04-22,Senate,"Consent Calendar SB762",38,0,2,0,40
1459251,1100330,2021-06-22,Assembly,"Do pass",11,0,0,0,11
1459251,1106435,2021-08-23,Assembly,"SB 762 Wieckowski Senate Third Reading By Stone",69,0,0,10,79
1459251,1107251,2021-08-30,Senate,"Unfinished Business SB762 Wieckowski Concurrence",39,0,0,1,40
1459252,1057732,2021-04-20,Senate,"Do pass, but first be re-referred to the Committee on [Appropriations]",5,0,0,0,5
1459252,1068184,2021-05-03,Senate,"Placed on suspense file",6,0,1,0,7
1459256,1053480,2021-04-14,Senate,"Do pass, but first be re-referred to the Committee on [Appropriations]",7,0,0,0,7
1459256,1068234,2021-05-03,Senate,"Placed on suspense file",6,0,1,0,7
1459256,1081526,2021-05-20,Senate,"Do pass as amended",6,1,0,0,7
1459256,1090383,2021-06-02,Senate,"Senate 3rd Reading SB767 Becker",38,0,2,0,40
1459256,1100760,2021-06-23,Assembly,"Do pass as amended and be re-referred to the Committee on [Appropriations]",7,0,0,0,7
1459257,1035218,2021-03-23,Senate,"Do pass as amended, but first amend, and re-refer to the Committee on [Appropriations]",5,0,0,0,5
1459257,1068249,2021-05-03,Senate,"Senate 3rd Reading SB768 Glazer et al",37,0,3,0,40
1459257,1212430,2022-06-02,Assembly,"Be re-referred to the Committee on [Human Services]",8,0,0,3,11
1459257,1220059,2022-06-28,Assembly,"Do pass and be re-referred to the Committee on [Appropriations]",7,0,0,1,8
1459257,1222954,2022-08-03,Assembly,"Do pass. To Consent Calendar",15,0,0,1,16
1459257,1224388,2022-08-22,Assembly,"SB 768 Glazer Senate Third Reading By Gabriel",77,0,0,3,80
1459257,1224664,2022-08-24,Senate,"Unfinished Business SB768 Glazer et al. Concurrence",40,0,0,0,40
1459259,1065078,2021-04-28,Senate,"Do pass as amended, but first amend, and re-refer to the Committee on [Appropriations]",7,0,0,0,7
1459259,1078759,2021-05-17,Senate,"Placed on suspense file",7,0,0,0,7
1459259,1081748,2021-05-20,Senate,"Do pass as amended",5,1,1,0,7
1459259,1090382,2021-06-02,Senate,"Senate 3rd Reading SB770 Roth et al",36,0,4,0,40
1459260,1074188,2021-05-06,Senate,"Do pass as amended, but first amend, and re-refer to the Committee on [Appropriations]",4,0,1,0,5
1459260,1078755,2021-05-17,Senate,"Placed on suspense file",7,0,0,0,7
1459260,1081481,2021-05-20,Senate,"Do pass",5,2,0,0,7
1459260,1086119,2021-05-26,Senate,"Senate 3rd Reading SB771 Becker",34,4,2,0,40
1459260,1219925,2022-06-28,Assembly,"Do pass and be re-referred to the Committee on [Appropriations]",9,0,0,6,15
1459262,1053557,2021-04-14,Senate,"Do pass, but first be re-referred to the Committee on [Appropriations]",11,0,0,0,11
1459262,1068215,2021-05-03,Senate,"Placed on suspense file",6,0,1,0,7
1459262,1081922,2021-05-20,Senate,"Do pass",7,0,0,0,7
1459262,1089477,2021-06-01,Senate,"Special Consent SB773",39,0,1,0,40
1459263,1047457,2021-04-06,Senate,"Do pass",9,2,0,0,11
1459263,1060887,2021-04-22,Senate,"Senate 3rd Reading SB774 Hertzberg",27,10,3,0,40
1459263,1104779,2021-07-13,Assembly,"Do pass as amended",8,3,0,0,11
1459263,1107754,2021-09-03,Assembly,"SB 774 Hertzberg Senate Third Reading By Stone Amend By STONE Set #1",59,18,0,2,79
1459263,1225177,2022-08-30,Assembly,"Do pass",15,0,0,3,18
1459263,1225970,2022-08-31,Senate,"W/O REF. TO FILE SB774 Hertzberg",40,0,0,0,40
1459263,1225971,2022-08-31,Assembly,"SB 774 Hertzberg Senate Third Reading",76,0,0,4,80
1459264,1051979,2021-04-13,Senate,"Do pass, but first be re-referred to the Committee on [Appropriations]",4,1,0,0,5
1459264,1068174,2021-05-03,Senate,"Placed on suspense file",6,0,1,0,7
1459264,1081815,2021-05-20,Senate,"Do pass as amended",5,2,0,0,7
1459264,1090397,2021-06-02,Senate,"Senate 3rd Reading SB775 Becker",30,8,2,0,40
1459264,1104768,2021-07-13,Assembly,"Do pass and be re-referred to the Committee on [Appropriations]",6,2,0,0,8
1459264,1106774,2021-08-26,Assembly,"Do pass as amended",11,4,0,1,16
1459264,1108527,2021-09-10,Senate,"Unfinished Business SB775 Becker Concurrence",27,10,0,3,40
1459264,1108528,2021-09-10,Assembly,"SB 775 Becker Senate Third Reading By Bauer-Kahan",41,32,0,7,80
1459265,1050827,2021-04-12,Senate,"Do pass, but first be re-referred to the Committee on [Judiciary]",6,1,0,0,7
1459265,1065235,2021-04-27,Senate,"Do pass as amended, but first amend, and re-refer to the Committee on [Appropriations]",9,2,0,0,11
1459265,1078816,2021-05-17,Senate,"Placed on suspense file",7,0,0,0,7
1459265,1082074,2021-05-20,Senate,"Do pass",6,1,0,0,7
1459265,1089493,2021-06-01,Senate,"Senate 3rd Reading SB776 Gonzalez",32,8,0,0,40
1459265,1103424,2021-06-30,Assembly,"Do pass and be re-referred to the Committee on [Judiciary]",6,3,0,0,9
1459265,1104760,2021-07-13,Assembly,"Do pass as amended and be re-referred to the Committee on [Appropriations]",8,1,2,0,11
1459265,1106624,2021-08-26,Assembly,"Do pass as amended",12,4,0,0,16
1459265,1107647,2021-09-02,Assembly,"SB 776 Gonzalez Senate Third Reading By Eduardo Garcia",59,18,0,2,79
1459265,1107755,2021-09-03,Senate,"Unfinished Business SB776 Gonzalez Concurrence",29,8,0,3,40
1459266,1060982,2021-04-22,Senate,"Do pass as amended, but first amend, and re-refer to the Committee on [Appropriations]",4,0,1,0,5
1459266,1075316,2021-05-10,Senate,"Placed on suspense file",7,0,0,0,7
1459266,1081644,2021-05-20,Senate,"Do pass as amended",7,0,0,0,7
1459266,1090445,2021-06-02,Senate,"Senate 3rd Reading SB777 Bradford et al",38,0,2,0,40
1459266,1217332,2022-06-21,Assembly,"Do pass and be re-referred to the Committee on [Revenue and Taxation]",6,0,0,0,6
1459267,1054671,2021-04-15,Senate,"Do pass as amended, but first amend, and re-refer to the Committee on [Housing]",5,0,0,0,5
1459267,1066812,2021-04-29,Senate,"Do pass as amended, but first amend, and re-refer to the Committee on [Appropriations]",9,0,0,0,9
1459267,1081514,2021-05-20,Senate,"Senate 3rd Reading SB778 Becker",30,1,9,0,40
1459267,1216252,2022-06-15,Assembly,"Do pass and be re-referred to the Committee on [Natural Resources]",2,4,0,1,7
1459268,1046110,2021-04-05,Senate,"Do pass as amended, but first amend, and re-refer to the Committee on [Appropriations]",5,0,0,0,5
1459268,1068285,2021-05-03,Senate,"Senate 3rd Reading SB779 Becker",36,0,4,0,40
1459268,1095047,2021-06-08,Assembly,"Do pass and be re-referred to the Committee on [Appropriations] with recommendation: To Consent Calendar",7,0,0,0,7
1459268,1104441,2021-07-07,Assembly,"Do pass. To Consent Calendar",14,0,2,0,16
1459268,1107114,2021-08-30,Assembly,"SB 779 Becker Senate Third Reading By Chiu",76,0,0,3,79
1459268,1107532,2021-09-01,Senate,"Unfinished Business SB779 Becker Concurrence",39,0,0,1,40
1459269,1048884,2021-04-08,Senate,"Do pass as amended, but first amend, and re-refer to the Committee on [Housing]",5,0,0,0,5
1459269,1066703,2021-04-29,Senate,"Do pass as amended",8,0,1,0,9
1459269,1075346,2021-05-10,Senate,"Senate 3rd Reading SB780 Cortese",34,0,6,0,40
1459269,1096072,2021-06-09,Assembly,"Do pass and be re-referred to the Committee on [Housing and Community Development]",8,0,0,0,8
1459269,1104675,2021-07-12,Assembly,"Do pass",8,0,0,0,8
1459269,1107237,2021-08-30,Assembly,"SB 780 Cortese Senate Third Reading By Chiu",74,0,0,5,79
1459269,1107418,2021-09-01,Senate,"Unfinished Business SB780 Cortese Concurrence",39,0,0,1,40
1459271,1036440,2021-03-24,Senate,"Do pass as amended, but first amend, and re-refer to the Committee on [Judiciary]",11,0,0,0,11
1459271,1047437,2021-04-06,Senate,"Do pass, but first be re-referred to the Committee on [Appropriations]",11,0,0,0,11
1459271,1075245,2021-05-10,Senate,"Senate 3rd Reading SB782 Glazer et al",37,0,3,0,40
1459273,1035195,2021-03-23,Senate,"Do pass, but first be re-referred to the Committee on [Appropriations] with the recommendation: To Consent Calendar",14,0,1,0,15
1459273,1060969,2021-04-22,Senate,"Consent Calendar SB784",38,0,2,0,40
1459273,1098172,2021-06-15,Assembly,"Do pass and be re-referred to the Committee on [Appropriations]",6,0,1,0,7
1459273,1104400,2021-07-07,Assembly,"Do pass. To Consent Calendar",14,0,2,0,16
1459273,1107963,2021-09-07,Assembly,"SB 784 Glazer Senate Third Reading By Luz Rivas",72,0,0,8,80
1459274,1036417,2021-03-24,Senate,"Do pass, but first be re-referred to the Committee on [Appropriations]",6,0,1,0,7
1459274,1056402,2021-04-19,Senate,"Placed on suspense file",7,0,0,0,7
1459274,1082114,2021-05-20,Senate,"Do pass",7,0,0,0,7
1459274,1128999,2022-01-26,Senate,"Senate 3rd Reading SB785 Glazer et al",36,0,0,4,40
1459274,1215824,2022-06-14,Assembly,"Do pass as amended and be re-referred to the Committee on [Appropriations]",12,0,0,0,12
1459274,1223386,2022-08-11,Assembly,"Do pass",16,0,0,0,16
1459274,1225590,2022-08-31,Senate,"Unfinished Business SB785 Glazer et al. Concurrence",39,0,0,1,40
1459274,1225591,2022-08-31,Assembly,"SB 785 Glazer Senate Third Reading By Low",79,0,0,1,80
1459275,1074167,2021-05-06,Senate,"Do pass as amended",4,0,1,0,5
1459275,1078794,2021-05-17,Senate,"Senate 3rd Reading SB786 Becker",38,0,2,0,40
1459275,1217371,2022-06-21,Assembly,"Do pass and be re-referred to the Committee on [Privacy and Consumer Protection]",15,0,0,0,15
1459275,1220047,2022-06-28,Assembly,"Do pass as amended and be re-referred to the Committee on [Appropriations]",9,0,0,1,10
1459275,1222962,2022-08-03,Assembly,"Do pass. To Consent Calendar",15,0,0,1,16
1459275,1225749,2022-08-30,Senate,"Unfinished Business SB786 Hertzberg Concurrence",40,0,0,0,40
1459275,1225750,2022-08-30,Assembly,"SB 786 Hertzberg Senate Third Reading By Calderon",79,0,0,1,80
1459277,1038698,2021-03-22,Senate,"Do pass, but first be re-referred to the Committee on [Appropriations]",4,0,1,0,5
1459277,1056400,2021-04-19,Senate,"Placed on suspense file",7,0,0,0,7
1459277,1081806,2021-05-20,Senate,"Do pass",6,0,1,0,7
1459277,1090485,2021-06-02,Senate,"Senate 3rd Reading SB788 Bradford",37,0,3,0,40
1459277,1101608,2021-06-24,Assembly,"Do pass. To Consent Calendar",14,0,0,0,14
1459277,1103780,2021-07-01,Assembly,"SB 788 Bradford Consent Calendar Second Day Regular Session",77,0,2,0,79
1459277,1107781,2021-09-03,Senate,"Unfinished Business SB788 Bradford Concurrence",37,0,0,3,40
1459279,1051938,2021-04-13,Senate,"Do pass as amended, but first amend, and re-refer to the Committee on [Rules] with the recommendation: To Consent Calendar",16,0,1,0,17
1459279,1064023,2021-04-27,Senate,"Do pass, but first be re-referred to the Committee on [Appropriations]",9,0,0,0,9
1459279,1075355,2021-05-10,Senate,"Placed on suspense file",7,0,0,0,7
1459279,1081905,2021-05-20,Senate,"Do pass as amended",7,0,0,0,7
1459279,1089570,2021-06-01,Senate,"Special Consent SB790",39,0,1,0,40
1459279,1103828,2021-07-01,Assembly,"Do pass and be re-referred to the Committee on [Transportation]",13,0,2,0,15
1459279,1104238,2021-07-05,Assembly,"Do pass as amended and be re-referred to the Committee on [Appropriations]",15,0,0,0,15
1459279,1106728,2021-08-26,Assembly,"Do pass as amended",12,0,0,4,16
1459279,1107611,2021-09-02,Assembly,"SB 790 Stern Senate Third Reading By Eduardo Garcia",76,0,0,3,79
1459279,1107852,2021-09-07,Senate,"Unfinished Business SB790 Stern et al. Concurrence",37,0,0,3,40
1459280,1066823,2021-04-29,Senate,"Do pass, but first be re-referred to the Committee on [Governmental Organization]",8,0,1,0,9
1459280,1078788,2021-05-17,Senate,"Placed on suspense file",7,0,0,0,7
1459280,1081772,2021-05-20,Senate,"Do pass as amended",5,0,2,0,7
1459280,1090475,2021-06-02,Senate,"Senate 3rd Reading SB791 Cortese",29,1,10,0,40
1459280,1104586,2021-07-12,Assembly,"Do pass as amended and be re-referred to the Committee on [Appropriations]",6,2,0,0,8
1459280,1106557,2021-08-26,Assembly,"Do pass as amended",13,3,0,0,16
1459280,1108569,2021-09-10,Senate,"Unfinished Business SB791 Cortese et al. Concurrence",31,0,0,9,40
1459280,1108570,2021-09-10,Assembly,"SB 791 Cortese Senate Third Reading By Quirk-Silva",67,8,0,5,80
1459281,1037864,2021-03-25,Senate,"Do pass, but first be re-referred to the Committee on [Appropriations]",4,1,0,0,5
1459281,1056396,2021-04-19,Senate,"Placed on suspense file",7,0,0,0,7
1459281,1081791,2021-05-20,Senate,"Do pass as amended",5,2,0,0,7
1459281,1090464,2021-06-02,Senate,"Senate 3rd Reading SB792 Glazer et al",27,4,9,0,40
1459281,1104303,2021-07-05,Assembly,"Do pass as amended and be re-referred to the Committee on [Appropriations]",8,3,0,0,11
1459281,1106332,2021-08-19,Assembly,"Do pass",13,3,0,0,16
1459281,1108670,2021-09-10,Senate,"Unfinished Business SB792 Glazer et al. Concurrence",31,4,0,5,40
1459281,1108671,2021-09-10,Assembly,"SB 792 Glazer Senate Third Reading By Quirk",56,14,0,10,80
1459282,1057622,2021-04-20,Senate,"Do pass as amended, but first amend, and re-refer to the Committee on [Appropriations]",15,0,0,0,15
1459282,1068207,2021-05-03,Senate,"Placed on suspense file",6,0,1,0,7
1459282,1081943,2021-05-20,Senate,"Do pass as amended",6,1,0,0,7
1459282,1122867,2022-01-10,Senate,"Senate 3rd Reading SB793 Wiener",32,0,0,8,40
1459282,1220834,2022-06-29,Assembly,"Do pass as amended and be re-referred to the Committee on [Appropriations]",18,0,0,4,22
1459282,1223926,2022-08-11,Assembly,"Do pass as amended",12,0,0,4,16
1459282,1224940,2022-08-25,Assembly,"SB 793 Wiener Senate Third Reading By Boerner Horvath",74,0,0,6,80
1459282,1225593,2022-08-30,Senate,"Special Consent SB793",38,0,0,2,40
1459283,1062752,2021-04-26,Senate,"Do pass and be ordered to the Consent Calendar",5,0,0,0,5
1459283,1066778,2021-04-29,Senate,"Consent Calendar SB794",36,0,4,0,40
1459283,1216635,2022-06-16,Assembly,"Be re-referred to the Committee on [Elections]",8,0,0,3,11
1459283,1220633,2022-06-29,Assembly,"Do pass as amended",7,0,0,0,7
1459283,1224752,2022-08-24,Assembly,"SB 794 Glazer Senate Third Reading By Bryan",77,0,0,3,80
1459283,1225051,2022-08-29,Senate,"That the Assembly amendments be concurred in",5,0,0,0,5
1459283,1225201,2022-08-30,Senate,"Unfinished Business SB794 Glazer Concurrence",40,0,0,0,40
1459285,1064067,2021-04-27,Senate,"Do pass as amended, but first amend, and re-refer to the Committee on [Appropriations] with the recommendation: To Consent Calendar",9,0,0,0,9
1459285,1090489,2021-06-02,Senate,"Senate 3rd Reading SB796 Bradford et al. Urgency Clause",38,0,2,0,40
1459285,1103812,2021-07-01,Assembly,"Do pass as amended and be re-referred to the Committee on [Appropriations]",13,0,2,0,15
1459285,1106805,2021-08-26,Assembly,"Do pass",16,0,0,0,16
1459285,1108023,2021-09-08,Assembly,"SB 796 Bradford Third Reading Urgency By Burke",79,0,0,1,80
1459285,1108357,2021-09-09,Senate,"Unfinished Business SB796 Bradford et al. Urgency Clause Concurrence",38,0,0,2,40
1459288,1055494,2021-04-15,Senate,"Do pass, but first be re-referred to the Committee on [Appropriations]",4,2,1,0,7
1459288,1068272,2021-05-03,Senate,"Placed on suspense file",6,0,1,0,7
1459288,1081707,2021-05-20,Senate,"Do pass",5,2,0,0,7
1459289,1056401,2021-04-19,Senate,"Do pass as amended, but first amend, and re-refer to the Committee on [Appropriations]",13,0,1,0,14
1459289,1078753,2021-05-17,Senate,"Placed on suspense file",7,0,0,0,7
1459289,1081887,2021-05-20,Senate,"Do pass",7,0,0,0,7
1459289,1089475,2021-06-01,Senate,"Special Consent SB800",39,0,1,0,40
1459289,1104881,2021-07-14,Assembly,"Do pass and be re-referred to the Committee on [Appropriations] with recommendation: To Consent Calendar",19,0,0,0,19
1459289,1107016,2021-08-26,Assembly,"Do pass",16,0,0,0,16
1459289,1108340,2021-09-09,Assembly,"SB 800 Archuleta Senate Third Reading By Low",79,0,0,1,80
1459289,1108644,2021-09-10,Senate,"Unfinished Business SB800 Archuleta et al. By Roth Concurrence",37,0,0,3,40
1459290,1056372,2021-04-19,Senate,"Do pass, but first be re-referred to the Committee on [Appropriations]",13,0,1,0,14
1459290,1078795,2021-05-17,Senate,"Placed on suspense file",7,0,0,0,7
1459290,1081911,2021-05-20,Senate,"Do pass",7,0,0,0,7
1459290,1089563,2021-06-01,Senate,"Special Consent SB801",39,0,1,0,40
1459290,1104974,2021-07-14,Assembly,"Do pass as amended and be re-referred to the Committee on [Appropriations]",19,0,0,0,19
1459290,1106829,2021-08-26,Assembly,"Do pass",16,0,0,0,16
1459290,1108203,2021-09-08,Assembly,"SB 801 Archuleta Senate Third Reading By Low",79,0,0,1,80
1459290,1108346,2021-09-09,Senate,"Unfinished Business SB801 Archuleta et al. By Roth Concurrence",38,0,0,2,40
1459291,1056409,2021-04-19,Senate,"Do pass, but first be re-referred to the Committee on [Education]",13,0,1,0,14
1459291,1065074,2021-04-28,Senate,"Do pass as amended",7,0,0,0,7
1459291,1078724,2021-05-17,Senate,"Placed on suspense file",7,0,0,0,7
1459291,1082159,2021-05-20,Senate,"Do pass",7,0,0,0,7
1459291,1087611,2021-05-28,Senate,"Senate 3rd Reading SB802 Roth",38,0,2,0,40
1459291,1102801,2021-06-29,Assembly,"Do pass and be re-referred to the Committee on [Business and Professions]",12,0,0,0,12
1459291,1104964,2021-07-14,Assembly,"Do pass and be re-referred to the Committee on [Appropriations]",19,0,0,0,19
1459291,1106580,2021-08-26,Assembly,"Do pass as amended",13,0,0,3,16
1459291,1108567,2021-09-10,Senate,"Unfinished Business SB802 Roth Concurrence",37,0,0,3,40
1459291,1108568,2021-09-10,Assembly,"SB 802 Roth Senate Third Reading By Low",78,0,0,2,80
1459292,1056353,2021-04-19,Senate,"Do pass, but first be re-referred to the Committee on [Appropriations]",13,0,1,0,14
1459292,1078750,2021-05-17,Senate,"Placed on suspense file",7,0,0,0,7
1459292,1081703,2021-05-20,Senate,"Do pass",7,0,0,0,7
1459292,1091688,2021-06-03,Senate,"Senate 3rd Reading SB803 Roth",36,0,4,0,40
1459292,1104988,2021-07-14,Assembly,"Do pass as amended and be re-referred to the Committee on [Appropriations]",17,1,1,0,19
1459292,1106568,2021-08-26,Assembly,"Do pass",13,0,0,3,16
1459292,1107599,2021-09-02,Assembly,"SB 803 Roth Senate Third Reading By Low",66,1,0,12,79
1459292,1107779,2021-09-03,Senate,"Unfinished Business SB803 Roth Concurrence",35,1,0,4,40
1459293,1051920,2021-04-13,Senate,"Do pass as amended, but first amend, and re-refer to the Committee on [Public Safety]",8,0,1,0,9
1459293,1064121,2021-04-27,Senate,"Do pass, but first be re-referred to the Committee on [Appropriations] with the recommendation: To Consent Calendar",5,0,0,0,5
1459293,1075291,2021-05-10,Senate,"Placed on suspense file",7,0,0,0,7
1459293,1081535,2021-05-20,Senate,"Do pass as amended",7,0,0,0,7
1459293,1090462,2021-06-02,Senate,"Senate 3rd Reading SB804 Glazer et al",38,0,2,0,40
1459293,1100768,2021-06-23,Assembly,"Do pass and be re-referred to the Committee on [Public Safety]",11,0,0,0,11
1459293,1104683,2021-07-13,Assembly,"Do pass and be re-referred to the Committee on [Appropriations] with recommendation: To Consent Calendar",8,0,0,0,8
1459293,1106778,2021-08-26,Assembly,"Do pass",16,0,0,0,16
1459293,1107708,2021-09-02,Assembly,"SB 804 Glazer Senate Third Reading By Levine",75,0,0,4,79
1459294,1064002,2021-04-26,Senate,"Do pass, but first be re-referred to the Committee on [Appropriations]",4,1,0,0,5
1459294,1075343,2021-05-10,Senate,"Placed on suspense file",7,0,0,0,7
1459294,1082039,2021-05-20,Senate,"Do pass as amended",5,2,0,0,7
1459294,1086101,2021-05-26,Senate,"Senate 3rd Reading SB805 Rubio et al",34,5,1,0,40
1459294,1099737,2021-06-21,Assembly,"Do pass and be re-referred to the Committee on [Labor and Employment]",6,1,0,0,7
1459294,1100238,2021-06-22,Assembly,"Do pass as amended and be re-referred to the Committee on [Appropriations]",7,0,0,0,7
1459294,1107015,2021-08-26,Assembly,"Do pass",12,0,0,4,16
1459294,1108628,2021-09-10,Senate,"Unfinished Business SB805 Rubio et al. Concurrence",30,6,0,4,40
1459294,1108629,2021-09-10,Assembly,"SB 805 Rubio Senate Third Reading By Quirk-Silva",69,0,0,11,80
1459295,1056354,2021-04-19,Senate,"Do pass, but first be re-referred to the Committee on [Appropriations]",13,0,1,0,14
1459295,1078796,2021-05-17,Senate,"Placed on suspense file",7,0,0,0,7
1459295,1082101,2021-05-20,Senate,"Do pass as amended",6,0,1,0,7
1459295,1091687,2021-06-03,Senate,"Senate 3rd Reading SB806 Roth",32,4,4,0,40
1459295,1104950,2021-07-14,Assembly,"Do pass and be re-referred to the Committee on [Appropriations]",12,0,7,0,19
1459295,1106969,2021-08-26,Assembly,"Do pass as amended",13,0,0,3,16
1459295,1108545,2021-09-10,Senate,"Unfinished Business SB806 Roth Concurrence",32,3,0,5,40
1459295,1108546,2021-09-10,Assembly,"SB 806 Roth Senate Third Reading By Low",75,0,0,5,80
1459296,1047471,2021-04-06,Senate,"Do pass as amended, but first amend, and re-refer to the Committee on [Appropriations]",10,0,1,0,11
1459296,1056406,2021-04-19,Senate,"Placed on suspense file",7,0,0,0,7
1459296,1081822,2021-05-20,Senate,"Do pass",7,0,0,0,7
1459296,1089592,2021-06-01,Senate,"Special Consent SB807",39,0,1,0,40
1459296,1100242,2021-06-22,Assembly,"Do pass as amended and be re-referred to the Committee on [Appropriations]",9,1,1,0,11
1459296,1106941,2021-08-26,Assembly,"Do pass as amended",12,0,0,4,16
1459296,1107677,2021-09-02,Assembly,"SB 807 Wieckowski Senate Third Reading By Chiu",63,2,0,14,79
1459296,1107825,2021-09-03,Senate,"Unfinished Business SB807 Wieckowski Concurrence",37,0,0,3,40
1459297,1056362,2021-04-19,Senate,"Do pass, but first be re-referred to the Committee on [Appropriations] with the recommendation: To Consent Calendar",13,0,1,0,14
1459297,1075284,2021-05-10,Senate,"Consent Calendar SB808",37,0,3,0,40
1459297,1102845,2021-06-29,Assembly,"Do pass as amended and be re-referred to the Committee on [Appropriations]",7,0,0,0,7
1459299,1051978,2021-04-13,Senate,"Be adopted, but first be re-referred to the Committee on [Appropriations] with recommendation: To Consent Calendar",15,0,2,0,17
1459299,1075363,2021-05-10,Senate,"Consent Calendar SCR15",37,0,3,0,40
1459299,1104258,2021-07-05,Assembly,"Be adopted. To Consent Calendar",15,0,0,0,15
1459299,1104551,2021-07-08,Assembly,"SCR 15 Hueso Consent Calendar Second Day Regular Session",76,0,3,0,79
1459300,1023830,2021-03-08,Senate,"Senate 3rd Reading SCR16 Caballero et al",35,0,4,0,39
1459300,1031883,2021-03-18,Assembly,"Be adopted. To Consent Calendar",7,0,5,0,12
1459300,1037853,2021-03-25,Assembly,"SCR 16 Caballero Consent Calendar Second Day Regular Session",74,0,4,0,78
1459302,1049025,2021-04-07,Assembly,"Do pass as amended and be re-referred to the Committee on [Appropriations]",7,0,0,0,7
1459302,1081827,2021-05-20,Assembly,"Do pass",16,0,0,0,16
1459302,1092877,2021-06-01,Assembly,"AB 1363 Luz Rivas Assembly Third Reading",79,0,0,0,79
1459302,1103481,2021-06-30,Senate,"Do pass as amended, but first amend, and re-refer to the Committee on [Human Services] with the recommendation: To Consent Calendar",7,0,0,0,7
1459302,1104468,2021-07-06,Senate,"Do pass, but first be re-referred to the Committee on [Appropriations]",5,0,0,0,5
1459302,1106069,2021-08-16,Senate,"Placed on suspense file",7,0,0,0,7
1459302,1106848,2021-08-26,Senate,"Do pass as amended",7,0,0,0,7
1459302,1107726,2021-09-02,Senate,"Assembly 3rd Reading AB1363 Luz Rivas et al. By Leyva",39,0,0,1,40
1459302,1107901,2021-09-07,Assembly,"AB 1363 Luz Rivas Concurrence in Senate Amendments",73,0,0,7,80
1460743,1022336,2021-03-04,Assembly,"Be adopted. To third reading",11,0,1,0,12
1462479,1027183,2021-03-11,Senate,"Do pass and be ordered to the Consent Calendar",5,0,0,0,5
1462479,1033636,2021-03-22,Senate,"Consent Calendar SB810 GOV. & F. (McGuire) Urgency Clause",37,0,3,0,40
1462479,1096068,2021-06-09,Assembly,"Do pass. To Consent Calendar",8,0,0,0,8
1462479,1099156,2021-06-17,Assembly,"SB 810 GOV.& F. Consent Calendar Second Day Regular Session",72,0,7,0,79
1462480,1027192,2021-03-11,Senate,"Do pass and be ordered to the Consent Calendar",5,0,0,0,5
1462480,1033665,2021-03-22,Senate,"Consent Calendar SB811 GOV. & F. (McGuire) Urgency Clause",37,0,3,0,40
1462480,1096116,2021-06-09,Assembly,"Do pass. To Consent Calendar",8,0,0,0,8
1462480,1099142,2021-06-17,Assembly,"SB 811 GOV.& F. Consent Calendar Second Day Regular Session",72,0,7,0,79
1462481,1027168,2021-03-11,Senate,"Do pass and be ordered to the Consent Calendar",5,0,0,0,5
1462481,1033645,2021-03-22,Senate,"Consent Calendar SB812 GOV. & F",37,0,3,0,40
1462481,1096112,2021-06-09,Assembly,"Do pass. To Consent Calendar",8,0,0,0,8
1462481,1099136,2021-06-17,Assembly,"SB 812 GOV.& F. Consent Calendar Second Day Regular Session",72,0,7,0,79
1462482,1060945,2021-04-22,Senate,"Do pass, but first be re-referred to the Committee on [Appropriations] with the recommendation: To Consent Calendar",5,0,0,0,5
1462482,1077546,2021-05-13,Senate,"Consent Calendar SB813 GOV. & F",38,0,2,0,40
1462482,1103757,2021-06-30,Assembly,"Do pass and be re-referred to the Committee on [Appropriations] with recommendation: To Consent Calendar",8,0,0,0,8
1462482,1104936,2021-07-14,Assembly,"Do pass. To Consent Calendar",13,0,3,0,16
1462482,1106320,2021-08-19,Assembly,"SB 813 GOV.& F. Consent Calendar Second Day Regular Session",73,0,0,6,79
1462482,1107239,2021-08-30,Senate,"Special Consent SB813 GOV. & F",39,0,0,1,40
1464452,1022305,2021-03-04,Assembly,"Be adopted. To Consent Calendar",11,0,1,0,12
1464452,1050781,2021-04-12,Senate,"Assembly 3rd Reading ACR34 Luz Rivas et al",39,0,1,0,40
1464453,1033638,2021-03-22,Senate,"Senate 3rd Reading SCR17 Leyva et al",37,0,3,0,40
1464453,1054660,2021-04-15,Assembly,"Be adopted. To Consent Calendar",12,0,0,0,12
1464453,1060983,2021-04-22,Assembly,"SCR 17 Leyva Consent Calendar Second Day Regular Session",77,0,2,0,79
1466692,1048955,2021-04-08,Assembly,"Do pass and be re-referred to the Committee on [Appropriations] with recommendation: To Consent Calendar",7,0,0,0,7
1466692,1080410,2021-05-19,Assembly,"Do pass as amended. To Consent Calendar",15,0,1,0,16
1466692,1086970,2021-05-27,Assembly,"AB 1561 L. & E. Consent Calendar Second Day Regular Session",75,0,3,0,78
1466692,1104647,2021-07-12,Senate,"Do pass, but first be re-referred to the Committee on [Appropriations]",5,0,0,0,5
1466692,1108213,2021-09-08,Senate,"Assembly 3rd Reading AB1561 L. & E. (Kalra) By Cortese",38,0,0,2,40
1466692,1108440,2021-09-09,Assembly,"AB 1561 L. & E. Concurrence in Senate Amendments By KALRA",78,0,0,2,80
1466693,1176514,2022-03-23,Assembly,"Be adopted. To third reading",7,0,0,0,7
1466693,1224162,2022-08-18,Assembly,"AJR 8 Luz Rivas Assembly Third Reading",66,0,0,14,80
1470414,1054743,2021-04-15,Assembly,"Do pass and be re-referred to the Committee on [Appropriations] with recommendation: To Consent Calendar",13,0,0,0,13
1470415,1054730,2021-04-15,Assembly,"Do pass. To Consent Calendar",13,0,0,0,13
1470415,1060899,2021-04-22,Assembly,"AB 1563 INS. Consent Calendar Second Day Regular Session",77,0,2,0,79
1470416,1054719,2021-04-15,Assembly,"Do pass and be re-referred to the Committee on [Appropriations] with recommendation: To Consent Calendar",13,0,0,0,13
1470417,1037820,2021-03-25,Assembly,"Be adopted. To Consent Calendar",9,0,3,0,12
1470417,1048996,2021-04-08,Assembly,"ACR 35 Chau Consent Calendar Second Day Regular Session",74,0,4,0,78
1470417,1066710,2021-04-29,Senate,"Special Consent ACR35",36,0,4,0,40
1470418,1087595,2021-05-28,Assembly,"Be adopted. To Consent Calendar",10,0,2,0,12
1470418,1090488,2021-06-02,Assembly,"ACR 36 O'Donnell Consent Calendar Second Day",75,0,4,0,79
1470418,1101570,2021-06-24,Senate,"Special Consent ACR36",39,0,1,0,40
1470419,1105069,2021-07-15,Assembly,"Be adopted. To Consent Calendar",10,0,2,0,12
1470419,1106369,2021-08-19,Assembly,"ACR 37 Seyarto Consent Calendar Second Day Regular Session",73,0,0,6,79
1470419,1107876,2021-09-07,Senate,"Assembly 3rd Reading ACR37",37,0,0,3,40
1470420,1065131,2021-04-28,Assembly,"Be adopted. To third reading",11,0,0,0,11
1470420,1074150,2021-05-06,Assembly,"AJR 10 Choi Assembly Third Reading",76,0,2,0,78
1470420,1103462,2021-06-30,Senate,"Be adopted. Ordered to third reading",3,0,4,0,7
1470420,1103463,2021-06-30,Senate,"[06-30-2021] hearing: Motion to Reconsider. [Reconsideration Granted.]",6,0,1,0,7
1470420,1105126,2021-07-14,Senate,"Be adopted as amended",5,0,2,0,7
1470420,1107167,2021-08-30,Senate,"Special Consent AJR10",39,0,0,1,40
1470421,1054694,2021-04-15,Assembly,"Be adopted. To third reading",6,0,1,0,7
1470421,1097025,2021-06-10,Assembly,"AJR 9 Cooper Assembly Third Reading",67,0,12,0,79
1470421,1104221,2021-07-05,Senate,"Be adopted and be ordered to the Consent Calendar",5,0,0,0,5
1470421,1104644,2021-07-12,Senate,"Consent Calendar AJR9",39,0,1,0,40
1471514,1022326,2021-03-04,Assembly,"Be adopted. To third reading",11,0,1,0,12
1471514,1050844,2021-04-12,Senate,"Assembly 3rd Reading ACR38 Blanca Rubio et al",39,0,1,0,40
1471515,1037840,2021-03-25,Assembly,"Be adopted. To Consent Calendar",9,0,3,0,12
1471515,1048919,2021-04-08,Assembly,"ACR 39 Holden Consent Calendar Second Day Regular Session",74,0,4,0,78
1471515,1066782,2021-04-29,Senate,"Special Consent ACR39",36,0,4,0,40
1471516,1052027,2021-04-12,Assembly,"Be adopted. To Consent Calendar",15,0,0,0,15
1471516,1054619,2021-04-15,Assembly,"ACR 40 Mathis Consent Calendar Second Day Regular Session",75,0,3,0,78
1471516,1101677,2021-06-24,Senate,"Be adopted, but first be re-referred to the Committee on [Appropriations] with recommendation: To Consent Calendar",14,0,3,0,17
1471516,1107243,2021-08-30,Senate,"Special Consent ACR40",38,0,0,2,40
1471517,1064072,2021-04-27,Senate,"Do pass, but first be re-referred to the Committee on [Appropriations] with the recommendation: To Consent Calendar",15,0,2,0,17
1471517,1077540,2021-05-13,Senate,"Consent Calendar SB814 TRANS",38,0,2,0,40
1471517,1099748,2021-06-21,Assembly,"Do pass and be re-referred to the Committee on [Appropriations] with recommendation: To Consent Calendar",15,0,0,0,15
1471517,1104983,2021-07-14,Assembly,"Do pass. To Consent Calendar",13,0,3,0,16
1471517,1106344,2021-08-19,Assembly,"SB 814 TRANS. Consent Calendar Second Day Regular Session",73,0,0,6,79
1471518,1054618,2021-04-15,Senate,"Do pass, but first be re-referred to the Committee on [Appropriations] with the recommendation: To Consent Calendar",5,0,0,0,5
1471518,1075336,2021-05-10,Senate,"Consent Calendar SB815 AGRI",37,0,3,0,40
1471518,1098656,2021-06-16,Assembly,"Do pass and be re-referred to the Committee on [Appropriations] with recommendation: To Consent Calendar",11,0,0,0,11
1471518,1106980,2021-08-26,Assembly,"Do pass",16,0,0,0,16
1471518,1107597,2021-09-02,Assembly,"SB 815 AGRI. Senate Third Reading By RIVAS, R",77,0,0,2,79
1471519,1028417,2021-03-15,Senate,"Senate 3rd Reading SR13 Grove et al",39,0,1,0,40
1471520,1033607,2021-03-22,Senate,"Senate 3rd Reading SR14 Eggman",37,0,3,0,40
1471521,1028441,2021-03-15,Senate,"Senate 3rd Reading SR15 Skinner et al",39,0,1,0,40
1472772,1098135,2021-06-15,Assembly,"Do pass. To Consent Calendar",6,0,1,0,7
1472772,1099732,2021-06-21,Assembly,"AB 1565 Consent Calendar Second Day",71,0,8,0,79
1472772,1219981,2022-06-28,Senate,"Do pass, but first be re-referred to the Committee on [Appropriations] with the recommendation: To Consent Calendar",13,0,0,2,15
1472772,1222804,2022-08-01,Senate,"Placed on suspense file",7,0,0,0,7
1472772,1223640,2022-08-11,Senate,"Do pass as amended",7,0,0,0,7
1472772,1224478,2022-08-23,Senate,"Special Consent AB1565 E.M",40,0,0,0,40
1472772,1225100,2022-08-29,Assembly,"With recommendation: That Senate amendments be concurred in",6,0,0,1,7
1472772,1225202,2022-08-30,Assembly,"AB 1565 E.M. Concurrence in Senate Amendments By RODRIGUEZ",79,0,0,1,80
1472774,1057673,2021-04-19,Assembly,"Do pass. To Consent Calendar",6,0,1,0,7
1472775,1057689,2021-04-19,Assembly,"Do pass. To Consent Calendar",6,0,1,0,7
1472775,1082015,2021-05-20,Assembly,"Do pass",12,0,4,0,16
1472775,1090467,2021-06-02,Assembly,"AB 1568 E.M. Third Reading Urgency By RODRIGUEZ",78,0,1,0,79
1472775,1104300,2021-07-06,Senate,"Do pass, but first be re-referred to the Committee on [Appropriations] with the recommendation: To Consent Calendar",15,0,0,0,15
1472775,1105068,2021-07-15,Senate,"Placed on suspense file",7,0,0,0,7
1472775,1106972,2021-08-26,Senate,"Do pass",7,0,0,0,7
1472775,1107801,2021-09-03,Senate,"Special Consent AB1568 E.M. (Rodriguez) Urgency Clause",37,0,0,3,40
1472775,1150919,2022-02-22,Senate,"Assembly 3rd Reading AB1568 E.M. (Rodriguez) By Dodd Urgency Clause",37,0,0,3,40
1472775,1157033,2022-02-28,Assembly,"AB 1568 E.M. Concurrence in Senate Amendments By RODRIGUEZ",72,0,0,4,76
1472776,1044939,2021-04-05,Assembly,"Do pass. To Consent Calendar",7,0,0,0,7
1472777,1057745,2021-04-20,Senate,"Do pass and be ordered to the Consent Calendar",15,0,0,0,15
1472777,1066836,2021-04-29,Senate,"Consent Calendar SB816 G.O. (Dodd)",36,0,4,0,40
1472777,1098154,2021-06-15,Assembly,"Do pass. To Consent Calendar",6,0,1,0,7
1472777,1108364,2021-09-09,Assembly,"SB 816 G.O. Senate Third Reading By RODRIGUEZ",79,0,0,1,80
1472778,1035234,2021-03-23,Senate,"Do pass, but first be re-referred to the Committee on [Appropriations] with the recommendation: To Consent Calendar",14,0,1,0,15
1472778,1048900,2021-04-08,Senate,"Consent Calendar SB817 G.O",38,0,2,0,40
1472778,1098160,2021-06-15,Assembly,"Do pass and be re-referred to the Committee on [Appropriations] with recommendation: To Consent Calendar",6,0,1,0,7
1472778,1104430,2021-07-07,Assembly,"Do pass. To Consent Calendar",14,0,2,0,16
1472778,1105142,2021-07-15,Assembly,"SB 817 G.O. Consent Calendar Second Day Regular Session",70,0,9,0,79
1472779,1035254,2021-03-23,Senate,"Do pass, but first be re-referred to the Committee on [Appropriations] with the recommendation: To Consent Calendar",14,0,1,0,15
1472779,1045004,2021-04-05,Senate,"Do pass",7,0,0,0,7
1472779,1066738,2021-04-29,Senate,"Senate 3rd Reading SB818 G.O. (Dodd)",36,0,4,0,40
1472780,1057668,2021-04-20,Senate,"Do pass, but first be re-referred to the Committee on [Appropriations] with the recommendation: To Consent Calendar",15,0,0,0,15
1472780,1075243,2021-05-10,Senate,"Consent Calendar SB819 G.O",37,0,3,0,40
1472780,1102849,2021-06-29,Assembly,"Do pass and be re-referred to the Committee on [Appropriations] with recommendation: To Consent Calendar",21,0,1,0,22
1472780,1106335,2021-08-19,Assembly,"Do pass. To Consent Calendar",16,0,0,0,16
1472780,1106571,2021-08-26,Assembly,"SB 819 G.O. Consent Calendar Second Day Regular Session",73,0,0,6,79
1472781,1035164,2021-03-23,Senate,"Do pass, but first be re-referred to the Committee on [Governance and Finance] with the recommendation: To Consent Calendar",14,0,1,0,15
1472781,1060851,2021-04-22,Senate,"Do pass as amended, but first amend, and re-refer to the Committee on [Appropriations]",5,0,0,0,5
1472781,1075283,2021-05-10,Senate,"Placed on suspense file",7,0,0,0,7
1472781,1081982,2021-05-20,Senate,"Do pass",7,0,0,0,7
1472781,1089466,2021-06-01,Senate,"Special Consent SB820 G.O",39,0,1,0,40
1472781,1102822,2021-06-29,Assembly,"Do pass and be re-referred to the Committee on [Revenue and Taxation] with recommendation: To Consent Calendar",21,0,1,0,22
1472781,1104298,2021-07-05,Assembly,"Do pass and be re-referred to the Committee on [Appropriations] with recommendation: To Consent Calendar",11,0,0,0,11
1472781,1106551,2021-08-26,Assembly,"Do pass as amended",16,0,0,0,16
1472781,1108314,2021-09-09,Assembly,"SB 820 G.O. Senate Third Reading By BURKE",79,0,0,1,80
1472781,1108643,2021-09-10,Senate,"Unfinished Business SB820 G.O. (Dodd) Concurrence",37,0,0,3,40
1474176,1053464,2021-04-14,Assembly,"Do pass and be re-referred to the Committee on [Appropriations] with recommendation: To Consent Calendar",11,0,0,0,11
1474176,1065243,2021-04-28,Assembly,"Do pass. To Consent Calendar",16,0,0,0,16
1474176,1074152,2021-05-06,Assembly,"AB 1570 NAT. RES. Consent Calendar Second Day Regular Session",77,0,1,0,78
1474176,1102811,2021-06-29,Senate,"Do pass as amended, but first amend, and re-refer to the Committee on [Appropriations] with the recommendation: To Consent Calendar",9,0,0,0,9
1474176,1107583,2021-09-02,Senate,"Assembly 3rd Reading AB1570 NAT. RES. (Rivas, L.) By Allen",39,0,0,1,40
1474176,1107907,2021-09-07,Assembly,"AB 1570 NAT. RES. Concurrence in Senate Amendments By RIVAS, L",72,0,0,8,80
1474177,1051921,2021-04-13,Assembly,"Do pass and be re-referred to the Committee on [Accountability and Administrative Review]",7,0,0,0,7
1474177,1065073,2021-04-28,Assembly,"Do pass and be re-referred to the Committee on [Appropriations] with recommendation: To Consent Calendar",7,0,0,0,7
1474178,1051908,2021-04-13,Assembly,"Do pass and be re-referred to the Committee on [Revenue and Taxation] with recommendation: To Consent Calendar",7,0,0,0,7
1474178,1123347,2022-01-10,Assembly,"Do pass and be re-referred to the Committee on [Appropriations]",8,0,0,3,11
1474179,1064139,2021-04-27,Assembly,"Do pass and be re-referred to the Committee on [Appropriations] with recommendation: To Consent Calendar",6,0,1,0,7
1474179,1082009,2021-05-20,Assembly,"Do pass",16,0,0,0,16
1474179,1092968,2021-06-01,Assembly,"AB 1573 J., E.D. & E. Assembly Third Reading By CERVANTES",78,0,1,0,79
1474179,1104941,2021-07-14,Senate,"Do pass, but first be re-referred to the Committee on [Appropriations] with the recommendation: To Consent Calendar",13,0,1,0,14
1474179,1106136,2021-08-16,Senate,"Placed on suspense file",7,0,0,0,7
1474179,1223740,2022-08-11,Senate,"Do pass as amended",7,0,0,0,7
1474179,1224562,2022-08-23,Senate,"Special Consent AB1573 J., E.D., & E",40,0,0,0,40
1474179,1224848,2022-08-24,Assembly,"AB 1573 J., E.D. & E. Concurrence in Senate Amendments By CERVANTES",77,0,0,3,80
1474180,1051996,2021-04-13,Assembly,"Do pass and be re-referred to the Committee on [Judiciary] with recommendation: To Consent Calendar",7,0,0,0,7
1474180,1057658,2021-04-20,Assembly,"Do pass and be re-referred to the Committee on [Appropriations] with recommendation: To Consent Calendar",10,0,1,0,11
1474180,1073361,2021-05-05,Assembly,"Do pass. To Consent Calendar",16,0,0,0,16
1474180,1077596,2021-05-13,Assembly,"AB 1574 J., E.D. & E. Consent Calendar Second Day Regular Session",75,0,3,0,78
1474180,1095078,2021-06-08,Senate,"Do pass, but first be re-referred to the Committee on [Judiciary]",14,0,1,0,15
1474180,1103439,2021-06-29,Senate,"Do pass, but first be re-referred to the Committee on [Appropriations] with the recommendation: To Consent Calendar",11,0,0,0,11
1474180,1108211,2021-09-08,Senate,"Assembly 3rd Reading AB1574 J., E.D., & E . (Cervantes) By Archuleta",38,0,0,2,40
1474180,1108442,2021-09-09,Assembly,"AB 1574 J., E.D. & E. Concurrence in Senate Amendments By CERVANTES",78,0,0,2,80
1474181,1027171,2021-03-11,Assembly,"Be adopted. To Consent Calendar",8,0,4,0,12
1474181,1031891,2021-03-18,Assembly,"HR 27 Nguyen Consent Calendar Second Day Regular Session",69,0,9,0,78
1474182,1037837,2021-03-25,Senate,"Senate 3rd Reading SR16 Borgeas",38,0,2,0,40
1475792,1054700,2021-04-15,Assembly,"Do pass and be re-referred to the Committee on [Appropriations] with recommendation: To Consent Calendar",8,0,0,0,8
1475793,1052009,2021-04-13,Assembly,"Do pass and be re-referred to the Committee on [Appropriations] with recommendation: To Consent Calendar",11,0,0,0,11
1475793,1081773,2021-05-20,Assembly,"Do pass as amended",16,0,0,0,16
1475793,1092980,2021-06-01,Assembly,"AB 1576 JUD. Assembly Third Reading By STONE",78,0,1,0,79
1475793,1104477,2021-07-06,Senate,"Do pass, but first be re-referred to the Committee on [Appropriations] with the recommendation: To Consent Calendar",11,0,0,0,11
1475793,1106054,2021-08-16,Senate,"Placed on suspense file",7,0,0,0,7
1475793,1106820,2021-08-26,Senate,"Do pass",7,0,0,0,7
1475793,1107814,2021-09-03,Senate,"Special Consent AB1576 JUD",37,0,0,3,40
1475793,1223240,2022-08-08,Senate,"Special Consent AB1576 JUD",36,0,0,4,40
1475793,1223893,2022-08-11,Assembly,"AB 1576 JUD. Concurrence in Senate Amendments By STONE",76,0,0,4,80
1475794,1051891,2021-04-13,Assembly,"Do pass and be re-referred to the Committee on [Appropriations] with recommendation: To Consent Calendar",11,0,0,0,11
1475794,1059208,2021-04-21,Assembly,"Do pass. To Consent Calendar",14,0,2,0,16
1475794,1066739,2021-04-29,Assembly,"AB 1577 JUD. Consent Calendar Second Day Regular Session",77,0,1,0,78
1475794,1103456,2021-06-29,Senate,"Do pass, but first be re-referred to the Committee on [Appropriations] with the recommendation: To Consent Calendar",11,0,0,0,11
1475794,1218591,2022-06-22,Senate,"Do pass, but first be re-referred to the Committee on [Judiciary]",4,0,0,1,5
1475794,1220668,2022-06-28,Senate,"Do pass, but first be re-referred to the Committee on [Appropriations]",8,1,0,2,11
1475794,1222905,2022-08-01,Senate,"Placed on suspense file",7,0,0,0,7
1475794,1224035,2022-08-11,Senate,"Do pass as amended",5,2,0,0,7
1475794,1225190,2022-08-31,Assembly,"With recommendation: That Senate amendments be concurred in",2,3,0,2,7
1475794,1225191,2022-08-31,Assembly,Reconsideration,2,5,0,0,7
1475794,1225944,2022-08-30,Senate,"Assembly 3rd Reading AB1577 Stone et al. By Wiener",31,2,0,7,40
1475795,1057630,2021-04-20,Assembly,"Do pass and be re-referred to the Committee on [Appropriations]",9,1,1,0,11
1475795,1081687,2021-05-20,Assembly,"Do pass",13,1,2,0,16
1475795,1092936,2021-06-01,Assembly,"AB 1578 JUD. Assembly Third Reading By STONE",66,1,12,0,79
1475795,1104407,2021-07-06,Senate,"Do pass, but first be re-referred to the Committee on [Appropriations]",11,0,0,0,11
1475795,1108135,2021-09-08,Senate,"Assembly 3rd Reading AB1578 JUD. (Stone) By Umberg",36,1,0,3,40
1475795,1108402,2021-09-09,Assembly,"AB 1578 JUD. Concurrence in Senate Amendments By STONE",66,0,0,14,80
1475796,1052000,2021-04-13,Assembly,"Do pass. To Consent Calendar",11,0,0,0,11
1475796,1056485,2021-04-19,Assembly,"AB 1579 JUD. Consent Calendar Second Day Regular Session",78,0,1,0,79
1475796,1095051,2021-06-08,Senate,"Do pass and be ordered to the Consent Calendar",11,0,0,0,11
1475796,1106734,2021-08-26,Senate,"Assembly 3rd Reading AB1579 JUD. (Stone) By Umberg",36,0,0,4,40
1475796,1107432,2021-09-01,Assembly,"AB 1579 JUD. Concurrence in Senate Amendments By STONE",78,0,0,1,79
1475797,1051919,2021-04-13,Assembly,"Do pass. To Consent Calendar",11,0,0,0,11
1475797,1056486,2021-04-19,Assembly,"AB 1580 JUD. Consent Calendar Second Day Regular Session",78,0,1,0,79
1475797,1095034,2021-06-08,Senate,"Do pass and be ordered to the Consent Calendar",11,0,0,0,11
1475797,1099126,2021-06-17,Senate,"Consent Calendar AB1580 JUD",37,0,3,0,40
1475798,1077577,2021-05-13,Assembly,"Be adopted. To third reading",10,0,2,0,12
1475798,1101575,2021-06-24,Senate,"Special Consent ACR41",39,0,1,0,40
1475799,1074141,2021-05-06,Assembly,"Be adopted. To Consent Calendar",11,0,1,0,12
1475799,1077533,2021-05-13,Assembly,"ACR 42 Patterson Consent Calendar Second Day Regular Session",75,0,3,0,78
1475799,1089486,2021-06-01,Senate,"Special Consent ACR42",39,0,1,0,40
1475800,1062783,2021-04-26,Senate,"Senate 3rd Reading SCR18 Cortese",32,0,8,0,40
1475800,1106434,2021-08-23,Assembly,"Be adopted. To Consent Calendar",7,0,0,5,12
1475800,1106655,2021-08-26,Assembly,"SCR 18 Cortese Consent Calendar Second Day Regular Session",73,0,0,6,79
1475801,1033630,2021-03-22,Senate,"Senate 3rd Reading SCR19 Leyva et al",35,0,5,0,40
1475801,1054615,2021-04-15,Assembly,"Be adopted. To Consent Calendar",12,0,0,0,12
1475801,1060925,2021-04-22,Assembly,"SCR 19 Leyva Consent Calendar Second Day Regular Session",77,0,2,0,79
1475802,1044986,2021-04-05,Senate,"Senate 3rd Reading SCR20 Ochoa Bogh et al",38,0,2,0,40
1475802,1054733,2021-04-15,Assembly,"Be adopted. To Consent Calendar",12,0,0,0,12
1475802,1060861,2021-04-22,Assembly,"SCR 20 Ochoa Bogh Consent Calendar Second Day Regular Session",77,0,2,0,79
1475803,1028416,2021-03-15,Senate,"Senate 3rd Reading SCR21 Rubio et al",39,0,1,0,40
1475803,1066718,2021-04-29,Assembly,"Be adopted. To Consent Calendar",9,0,3,0,12
1475803,1074175,2021-05-06,Assembly,"SCR 21 Rubio Consent Calendar Second Day Regular Session",77,0,1,0,78
1475804,1047534,2021-04-06,Senate,"Be adopted. Ordered to third reading",9,0,2,0,11
1475804,1050793,2021-04-12,Senate,"Senate 3rd Reading SJR2 Hueso et al",32,2,6,0,40
1475804,1095055,2021-06-08,Assembly,"Be adopted. To third reading",8,1,2,0,11
1475804,1107163,2021-08-30,Assembly,"SJR 2 Hueso Senate Third Reading By REYES",60,2,0,17,79
1477148,1073409,2021-05-05,Assembly,"Do pass. To Consent Calendar",8,0,0,0,8
1477148,1077523,2021-05-13,Assembly,"AB 1581 L. GOV. Consent Calendar Second Day Regular Session",75,0,3,0,78
1477148,1097015,2021-06-10,Senate,"Do pass and be ordered to the Consent Calendar",5,0,0,0,5
1477148,1099118,2021-06-17,Senate,"Consent Calendar AB1581 L. GOV",37,0,3,0,40
1477149,1027165,2021-03-11,Assembly,"Be adopted. To Consent Calendar",8,0,4,0,12
1477149,1031918,2021-03-18,Assembly,"ACR 43 Mullin Consent Calendar Second Day",69,0,9,0,78
1477149,1050804,2021-04-12,Senate,"Assembly 3rd Reading ACR43 Mullin et al",39,0,1,0,40
1477150,1055492,2021-04-15,Senate,"Do pass, but first be re-referred to the Committee on [Appropriations] with the recommendation: To Consent Calendar",7,0,0,0,7
1477150,1075383,2021-05-10,Senate,"Consent Calendar SB821 N.R. & W",37,0,3,0,40
1477150,1103792,2021-07-01,Assembly,"Do pass as amended, and be re-referred to the Committee on [Appropriations] with recommendation: To Consent Calendar",14,0,1,0,15
1477150,1104409,2021-07-07,Assembly,"Do pass. To Consent Calendar",14,0,2,0,16
1477150,1105051,2021-07-15,Assembly,"SB 821 N.R. & W. Consent Calendar Second Day Regular Session",70,0,9,0,79
1477150,1107153,2021-08-30,Senate,"Special Consent SB821 N.R. & W. (Stern) Urgency Clause",39,0,0,1,40
1477151,1055495,2021-04-15,Senate,"Do pass, but first be re-referred to the Committee on [Appropriations] with the recommendation: To Consent Calendar",7,0,0,0,7
1477151,1075237,2021-05-10,Senate,"Consent Calendar SB822 N.R. & W",37,0,3,0,40
1477151,1099098,2021-06-17,Assembly,"Do pass as amended, and be re-referred to the Committee on [Appropriations] with recommendation: To Consent Calendar",15,0,0,0,15
1477151,1103442,2021-06-30,Assembly,"Do pass. To Consent Calendar",14,0,2,0,16
1477151,1104571,2021-07-08,Assembly,"SB 822 N.R. & W. Consent Calendar Second Day Regular Session",76,0,3,0,79
1477151,1107177,2021-08-30,Senate,"Special Consent SB822 N.R. & W",39,0,0,1,40
1478613,1051988,2021-04-12,Assembly,"Do pass and be re-referred to the Committee on [Appropriations] with recommendation: To Consent Calendar",9,0,2,0,11
1478613,1059276,2021-04-21,Assembly,"Do pass. To Consent Calendar",14,0,2,0,16
1478613,1066727,2021-04-29,Assembly,"AB 1582 REV. & TAX. Consent Calendar Second Day Regular Session",77,0,1,0,78
1478613,1097016,2021-06-10,Senate,"Do pass, but first be re-referred to the Committee on [Appropriations] with the recommendation: To Consent Calendar",5,0,0,0,5
1478613,1101602,2021-06-24,Senate,"Consent Calendar AB1582 REV. & TAX",39,0,1,0,40
1478614,1051967,2021-04-12,Assembly,"Do pass and be re-referred to the Committee on [Appropriations] with recommendation: To Consent Calendar",9,0,2,0,11
1478614,1059242,2021-04-21,Assembly,"Do pass. To Consent Calendar",14,0,2,0,16
1478614,1066687,2021-04-29,Assembly,"AB 1583 REV. & TAX. Consent Calendar Second Day Regular Session",77,0,1,0,78
1478614,1097034,2021-06-10,Senate,"Do pass, but first be re-referred to the Committee on [Appropriations] with the recommendation: To Consent Calendar",5,0,0,0,5
1478614,1101606,2021-06-24,Senate,"Consent Calendar AB1583 REV. & TAX",39,0,1,0,40
1478615,1067635,2021-04-29,Assembly,"Do pass and be re-referred to the Committee on [Appropriations] with recommendation: To Consent Calendar",8,0,0,0,8
1478615,1076963,2021-05-12,Assembly,"Do pass. To Consent Calendar",16,0,0,0,16
1478615,1081926,2021-05-20,Assembly,"AB 1584 H. & C.D. Consent Calendar Second Day Regular Session",76,0,2,0,78
1478615,1104543,2021-07-08,Senate,"Do pass, but first be re-referred to the Committee on [Judiciary] with the recommendation: To Consent Calendar",9,0,0,0,9
1478615,1104943,2021-07-13,Senate,"Do pass, but first be re-referred to the Committee on [Appropriations] with the recommendation: To Consent Calendar",11,0,0,0,11
1478615,1106181,2021-08-16,Senate,"Placed on suspense file",7,0,0,0,7
1478615,1106834,2021-08-26,Senate,"Do pass",7,0,0,0,7
1478615,1108107,2021-09-08,Senate,"Assembly 3rd Reading AB1584 H. & C.D. (Chiu) By Wiener",38,0,0,2,40
1478615,1108559,2021-09-10,Assembly,"AB 1584 H. & C.D. Concurrence in Senate Amendments By CHIU",78,0,0,2,80
1478616,1106323,2021-08-19,Assembly,"Be adopted. To Consent Calendar",11,0,0,1,12
1478616,1106719,2021-08-26,Assembly,"ACR 44 Boerner Horvath Consent Calendar Second Day Regular Session",73,0,0,6,79
1478616,1140900,2022-02-10,Senate,"Special Consent ACR44",37,0,0,3,40
1478617,1053523,2021-04-14,Senate,"Do pass, but first be re-referred to the Committee on [Appropriations] with the recommendation: To Consent Calendar",11,0,0,0,11
1478617,1075359,2021-05-10,Senate,"Consent Calendar SB823 HEALTH",37,0,3,0,40
1478617,1104233,2021-07-06,Assembly,"Do pass and be re-referred to the Committee on [Appropriations] with recommendation: To Consent Calendar",15,0,0,0,15
1478617,1106376,2021-08-19,Assembly,"Do pass",16,0,0,0,16
1478617,1107964,2021-09-07,Assembly,"SB 823 HEALTH Senate Third Reading By WOOD",71,0,0,9,80
1478617,1108134,2021-09-08,Senate,"Unfinished Business SB823 HEALTH (Pan) Concurrence",38,0,0,2,40
1478618,1048910,2021-04-08,Senate,"Senate 3rd Reading SCR22 Umberg",38,0,2,0,40
1478618,1103758,2021-07-01,Assembly,"Be adopted. To Consent Calendar",9,0,3,0,12
1478618,1104562,2021-07-08,Assembly,"SCR 22 Umberg Consent Calendar Second Day Regular Session",76,0,3,0,79
1478619,1037834,2021-03-25,Senate,"Senate 3rd Reading SR17 Gonzalez et al",38,0,2,0,40
1478620,1033628,2021-03-22,Senate,"Senate 3rd Reading SR18 Jones",35,0,5,0,40
1478621,1028410,2021-03-15,Senate,"Senate 3rd Reading SR19 Atkins",39,0,1,0,40
1480288,1051927,2021-04-13,Assembly,"Do pass and be re-referred to the Committee on [Appropriations] with recommendation: To Consent Calendar",15,0,0,0,15
1480288,1059172,2021-04-21,Assembly,"Do pass. To Consent Calendar",14,0,2,0,16
1480288,1066744,2021-04-29,Assembly,"AB 1585 HEALTH Consent Calendar Second Day Regular Session",77,0,1,0,78
1480288,1097017,2021-06-10,Senate,"Do pass, but first be re-referred to the Committee on [Appropriations] with the recommendation: To Consent Calendar",10,0,1,0,11
1480288,1099744,2021-06-21,Senate,"Do pass",7,0,0,0,7
1480288,1104209,2021-07-05,Senate,"Special Consent AB1585 HEALTH",38,0,2,0,40
1480288,1107185,2021-08-30,Senate,"Special Consent AB1585 HEALTH",39,0,0,1,40
1480288,1107511,2021-09-01,Assembly,"AB 1585 HEALTH Concurrence in Senate Amendments By WOOD",78,0,0,1,79
1480289,1060981,2021-04-22,Senate,"Do pass, but first be re-referred to the Committee on [Appropriations] with the recommendation: To Consent Calendar",5,0,0,0,5
1480289,1075303,2021-05-10,Senate,"Consent Calendar SB824 GOV. & F",37,0,3,0,40
1480289,1100327,2021-06-21,Assembly,"Do pass and be re-referred to the Committee on [Appropriations] with recommendation: To Consent Calendar",11,0,0,0,11
1480289,1104914,2021-07-14,Assembly,"Do pass. To Consent Calendar",13,0,3,0,16
1480289,1106304,2021-08-19,Assembly,"SB 824 GOV.& F. Consent Calendar Second Day Regular Session",73,0,0,6,79
1480289,1107127,2021-08-30,Senate,"Special Consent SB824 GOV. & F",39,0,0,1,40
1480290,1060896,2021-04-22,Senate,"Do pass, but first be re-referred to the Committee on [Appropriations] with the recommendation: To Consent Calendar",5,0,0,0,5
1480290,1075299,2021-05-10,Senate,"Consent Calendar SB825 GOV. & F",37,0,3,0,40
1480290,1104260,2021-07-05,Assembly,"Do pass and be re-referred to the Committee on [Appropriations] with recommendation: To Consent Calendar",11,0,0,0,11
1480290,1106666,2021-08-26,Assembly,"Do pass",16,0,0,0,16
1480290,1108683,2021-09-10,Senate,"Unfinished Business SB825 GOV. & F. (McGuire) Concurrence",37,0,0,3,40
1480290,1108684,2021-09-10,Assembly,"SB 825 GOV.& F. Senate Third Reading By BURKE",78,0,0,2,80
1480291,1077587,2021-05-13,Senate,"Senate 3rd Reading SCR23 Archuleta",38,0,2,0,40
1480291,1101601,2021-06-24,Assembly,"Be adopted. To Consent Calendar",11,0,1,0,12
1480291,1103751,2021-07-01,Assembly,"SCR 23 Archuleta Consent Calendar Second Day Regular Session",77,0,2,0,79
1482842,1054692,2021-04-15,Assembly,"Be adopted and re-referred to the Committee on [Appropriations]",7,0,0,0,7
1482842,1065077,2021-04-28,Assembly,"Be adopted. To Consent Calendar",16,0,0,0,16
1482842,1068213,2021-05-03,Assembly,"ACR 45 Cooper Consent Calendar Second Day Regular Session",76,0,2,0,78
1482842,1093661,2021-06-07,Senate,"Be adopted, but first be re-referred to the Committee on [Appropriations] with recommendation: To Consent Calendar",5,0,0,0,5
1482842,1107214,2021-08-30,Senate,"Consent Calendar ACR45",39,0,0,1,40
1482844,1051914,2021-04-12,Assembly,"Be adopted. To Consent Calendar",15,0,0,0,15
1482844,1054651,2021-04-15,Assembly,"ACR 47 Stone Consent Calendar Second Day Regular Session",75,0,3,0,78
1482844,1101612,2021-06-24,Senate,"Be adopted, but first be re-referred to the Committee on [Appropriations] with recommendation: To Consent Calendar",14,0,3,0,17
1482844,1107252,2021-08-30,Senate,"Special Consent ACR47",38,0,0,2,40
1482844,1107469,2021-09-01,Assembly,"ACR 47 Stone Concurrence in Senate Amendments",77,0,0,2,79
1482845,1031878,2021-03-18,Assembly,"Be adopted. To third reading",7,0,5,0,12
1482846,1031885,2021-03-18,Assembly,"Be adopted. To third reading",7,0,5,0,12
1482847,1068205,2021-05-03,Senate,"Senate 3rd Reading SR20 Archuleta",36,0,4,0,40
1482848,1062758,2021-04-26,Senate,"Senate 3rd Reading SR21 Pan",38,0,2,0,40
1483607,1031902,2021-03-18,Assembly,"Be adopted. To Consent Calendar",7,0,5,0,12
1483607,1037862,2021-03-25,Assembly,"ACR 48 Rodriguez Consent Calendar Second Day Regular Session",74,0,4,0,78
1483607,1066684,2021-04-29,Senate,"Special Consent ACR48",36,0,4,0,40
1483608,1031881,2021-03-18,Assembly,"Be adopted. To Consent Calendar",7,0,5,0,12
1483608,1037819,2021-03-25,Assembly,"HR 30 Gabriel Consent Calendar Second Day Regular Session",74,0,4,0,78
1483609,1051910,2021-04-13,Senate,"Be adopted, but first be re-referred to the Committee on [Appropriations] with recommendation: To Consent Calendar",15,0,2,0,17
1483609,1075350,2021-05-10,Senate,"Consent Calendar SCR24",37,0,3,0,40
1483609,1104248,2021-07-05,Assembly,"Be adopted. To Consent Calendar",15,0,0,0,15
1483609,1104498,2021-07-08,Assembly,"SCR 24 Stern Consent Calendar Second Day Regular Session",76,0,3,0,79
1484364,1060838,2021-04-22,Assembly,"Do pass and be re-referred to the Committee on [Appropriations] with recommendation: To Consent Calendar",21,0,1,0,22
1484364,1080453,2021-05-19,Assembly,"Do pass. To Consent Calendar",15,0,1,0,16
1484364,1086953,2021-05-27,Assembly,"AB 1586 G.O. Consent Calendar Second Day Regular Session",75,0,3,0,78
1484364,1100266,2021-06-22,Senate,"Do pass, but first be re-referred to the Committee on [Appropriations] with the recommendation: To Consent Calendar",15,0,0,0,15
1484365,1060852,2021-04-22,Assembly,"Do pass and be re-referred to the Committee on [Appropriations] with recommendation: To Consent Calendar",21,0,1,0,22
1484365,1080399,2021-05-19,Assembly,"Do pass. To Consent Calendar",15,0,1,0,16
1484365,1086989,2021-05-27,Assembly,"AB 1587 G.O. Consent Calendar Second Day Regular Session",75,0,3,0,78
1484365,1100236,2021-06-22,Senate,"Do pass, but first be re-referred to the Committee on [Appropriations] with the recommendation: To Consent Calendar",15,0,0,0,15
1484365,1107474,2021-09-01,Senate,"Assembly 3rd Reading AB1587 G.O. (Frazier) By Dodd",39,0,0,1,40
1484365,1107651,2021-09-02,Assembly,"AB 1587 G.O. Concurrence in Senate Amendments By FRAZIER",77,0,0,2,79
1484366,1060941,2021-04-22,Assembly,"Do pass and be re-referred to the Committee on [Appropriations] with recommendation: To Consent Calendar",21,0,1,0,22
1484366,1080400,2021-05-19,Assembly,"Do pass. To Consent Calendar",15,0,1,0,16
1484366,1086918,2021-05-27,Assembly,"AB 1588 G.O. Consent Calendar Second Day Regular Session",75,0,3,0,78
1484366,1100315,2021-06-22,Senate,"Do pass and be ordered to the Consent Calendar",15,0,0,0,15
1484367,1060970,2021-04-22,Assembly,"Do pass and be re-referred to the Committee on [Appropriations] with recommendation: To Consent Calendar",21,0,1,0,22
1484367,1080429,2021-05-19,Assembly,"Do pass. To Consent Calendar",15,0,1,0,16
1484367,1086922,2021-05-27,Assembly,"AB 1589 G.O. Consent Calendar Second Day Regular Session",75,0,3,0,78
1484367,1104345,2021-07-06,Senate,"Do pass, but first be re-referred to the Committee on [Appropriations] with the recommendation: To Consent Calendar",15,0,0,0,15
1484367,1107884,2021-09-07,Senate,"Assembly 3rd Reading AB1589 G.O. (Frazier) By Dodd",37,0,0,3,40
1484367,1108133,2021-09-08,Assembly,"AB 1589 G.O. Concurrence in Senate Amendments By FRAZIER",78,0,0,2,80
1484368,1031890,2021-03-18,Assembly,"Be adopted. To Consent Calendar",7,0,5,0,12
1484368,1037860,2021-03-25,Assembly,"ACR 49 Choi Consent Calendar Second Day Regular Session",74,0,4,0,78
1484368,1066780,2021-04-29,Senate,"Special Consent ACR49",36,0,4,0,40
1484369,1049012,2021-04-08,Senate,"Senate 3rd Reading SR22 Min",38,0,2,0,40
1484370,1068154,2021-05-03,Senate,"Senate 3rd Reading SR23 Durazo",37,0,3,0,40
1485405,1066729,2021-04-29,Assembly,"Do pass",6,0,1,0,7
1485405,1078810,2021-05-17,Assembly,"AB 1590 E. & R. Assembly Third Reading By BERMAN",63,0,15,0,78
1485405,1102506,2021-06-28,Senate,"Do pass",5,0,0,0,5
1485405,1107504,2021-09-01,Senate,"Assembly 3rd Reading AB1590 ELECTIONS (Berman) By Nielsen",39,0,0,1,40
1485406,1066747,2021-04-29,Assembly,"Do pass. To Consent Calendar",7,0,0,0,7
1485406,1074104,2021-05-06,Assembly,"AB 1591 E. & R. Consent Calendar Second Day Regular Session",77,0,1,0,78
1485406,1102504,2021-06-28,Senate,"Do pass and be ordered to the Consent Calendar",5,0,0,0,5
1485406,1104146,2021-07-05,Senate,"Consent Calendar AB1591 ELECTIONS",38,0,2,0,40
1485407,1049033,2021-04-08,Assembly,"Be adopted. To third reading",11,0,1,0,12
1485407,1066691,2021-04-29,Senate,"Special Consent ACR50",36,0,4,0,40
1485408,1056404,2021-04-19,Assembly,"Be adopted. To Consent Calendar",15,0,0,0,15
1485408,1060912,2021-04-22,Assembly,"ACR 51 Gabriel Consent Calendar Second Day Regular Session",77,0,2,0,79
1485408,1101565,2021-06-24,Senate,"Be adopted, but first be re-referred to the Committee on [Appropriations] with recommendation: To Consent Calendar",15,0,2,0,17
1485408,1107224,2021-08-30,Senate,"Consent Calendar ACR51",39,0,0,1,40
1485409,1060881,2021-04-22,Senate,"Senate 3rd Reading SCR25 Hurtado",38,0,2,0,40
1485409,1101563,2021-06-24,Assembly,"Be adopted. To Consent Calendar",11,0,1,0,12
1485409,1103794,2021-07-01,Assembly,"SCR 25 Hurtado Consent Calendar Second Day Regular Session",77,0,2,0,79
1486812,1064025,2021-04-26,Assembly,"Be adopted. To Consent Calendar",15,0,0,0,15
1486812,1066821,2021-04-29,Assembly,"ACR 52 Patterson Consent Calendar Second Day Regular Session",77,0,1,0,78
1486812,1101599,2021-06-24,Senate,"Be adopted, but first be re-referred to the Committee on [Appropriations] with recommendation: To Consent Calendar",14,0,3,0,17
1486812,1107223,2021-08-30,Senate,"Special Consent ACR52",38,0,0,2,40
1486812,1107540,2021-09-01,Assembly,"ACR 52 Patterson Concurrence in Senate Amendments",75,0,0,4,79
1486813,1048916,2021-04-07,Assembly,"Be adopted, and re-refer to the Committee on [Appropriations] with recommendation: To Consent Calendar",7,0,0,0,7
1486813,1059225,2021-04-21,Assembly,"Be adopted. To Consent Calendar",14,0,2,0,16
1486813,1062738,2021-04-26,Assembly,"ACR 53 Ward Consent Calendar Second Day",77,0,1,0,78
1486813,1096085,2021-06-09,Senate,"Be adopted, but first be re-referred to the Committee on [Appropriations] with recommendation: To Consent Calendar",7,0,0,0,7
1486813,1101603,2021-06-24,Senate,"Consent Calendar ACR53",39,0,1,0,40
1486814,1064070,2021-04-27,Senate,"Be adopted, but first be re-referred to the Committee on [Appropriations] with recommendation: To Consent Calendar",15,0,2,0,17
1486814,1077585,2021-05-13,Senate,"Consent Calendar SCR26 Gonzalez et al",37,0,3,0,40
1486814,1104286,2021-07-05,Assembly,"Be adopted. To Consent Calendar",15,0,0,0,15
1486814,1104499,2021-07-08,Assembly,"SCR 26 Gonzalez Consent Calendar Second Day Regular Session",76,0,3,0,79
1487409,1054679,2021-04-15,Assembly,"Be adopted. To third reading",12,0,0,0,12
1487409,1068289,2021-05-03,Senate,"Assembly 3rd Reading ACR54",36,0,4,0,40
1487410,1074176,2021-05-06,Assembly,"Be adopted. To third reading",11,0,1,0,12
1487410,1089525,2021-06-01,Senate,"Special Consent ACR55",39,0,1,0,40
1487411,1037827,2021-03-25,Assembly,"Be adopted. To third reading",9,0,3,0,12
1487411,1066750,2021-04-29,Senate,"Special Consent ACR56",36,0,4,0,40
1487412,1056390,2021-04-19,Senate,"Do pass, but first be re-referred to the Committee on [Governance and Finance] with the recommendation: To Consent Calendar",13,0,1,0,14
1487412,1083827,2021-05-24,Senate,"Consent Calendar SB826 B.P.&E.D",40,0,0,0,40
1487412,1104900,2021-07-14,Assembly,"Do pass and be re-referred to the Committee on [Appropriations] with recommendation: To Consent Calendar",19,0,0,0,19
1487412,1106378,2021-08-19,Assembly,"Do pass. To Consent Calendar",16,0,0,0,16
1487412,1106555,2021-08-26,Assembly,"SB 826 B., P. & E.D. Consent Calendar Second Day Regular Session",73,0,0,6,79
1487412,1107391,2021-09-01,Senate,"Unfinished Business SB826 B.P.&E.D. (Roth) Concurrence",39,0,0,1,40
1487413,1064128,2021-04-27,Senate,"Be adopted, but first be re-referred to the Committee on [Appropriations] with recommendation: To Consent Calendar",15,0,2,0,17
1487413,1077602,2021-05-13,Senate,"Consent Calendar SCR27 McGuire et al",37,0,3,0,40
1487413,1099741,2021-06-21,Assembly,"Be adopted. To Consent Calendar",15,0,0,0,15
1487413,1101576,2021-06-24,Assembly,"SCR 27 McGuire Consent Calendar Second Day Regular Session",77,0,2,0,79
1487414,1064017,2021-04-27,Senate,"Be adopted, but first be re-referred to the Committee on [Appropriations] with recommendation: To Consent Calendar",15,0,2,0,17
1487414,1077539,2021-05-13,Senate,"Consent Calendar SCR28",38,0,2,0,40
1487414,1099740,2021-06-21,Assembly,"Be adopted. To Consent Calendar",15,0,0,0,15
1487414,1101657,2021-06-24,Assembly,"SCR 28 Umberg Consent Calendar Second Day Regular Session",77,0,2,0,79
1487974,1104548,2021-07-08,Assembly,"Be adopted. To Consent Calendar",10,0,2,0,12
1487974,1105103,2021-07-15,Assembly,"ACR 58 Fong Consent Calendar Second Day",70,0,9,0,79
1487974,1107713,2021-09-02,Senate,"Assembly 3rd Reading ACR58 Fong et al. By Hurtado",39,0,0,1,40
1487975,1037821,2021-03-25,Assembly,"Be adopted. To Consent Calendar",9,0,3,0,12
1487975,1048980,2021-04-08,Assembly,"HR 31 Low Consent Calendar Second Day Regular Session",74,0,4,0,78
1487976,1048990,2021-04-08,Senate,"Senate 3rd Reading SCR29 Wiener et al",38,0,2,0,40
1487976,1101567,2021-06-24,Assembly,"Be adopted. To Consent Calendar",11,0,1,0,12
1487976,1103838,2021-07-01,Assembly,"SCR 29 Wiener Consent Calendar Second Day Regular Session",77,0,2,0,79
1488591,1065259,2021-04-28,Assembly,"Do pass. To Consent Calendar",8,0,0,0,8
1488591,1074106,2021-05-06,Assembly,"AB 1592 L. GOV. Consent Calendar Second Day Regular Session",77,0,1,0,78
1488591,1097040,2021-06-10,Senate,"Do pass and be ordered to the Consent Calendar",5,0,0,0,5
1488591,1099106,2021-06-17,Senate,"Consent Calendar AB1592 L. GOV",37,0,3,0,40
1488592,1091726,2021-06-03,Assembly,"Be adopted. To third reading",10,0,2,0,12
1488592,1104172,2021-07-05,Senate,"Special Consent ACR59",38,0,2,0,40
1488593,1054639,2021-04-15,Assembly,"Be adopted. To Consent Calendar",12,0,0,0,12
1488593,1060833,2021-04-22,Assembly,"ACR 60 Fong Consent Calendar Second Day Regular Session",77,0,2,0,79
1488593,1078730,2021-05-17,Senate,"Assembly 3rd Reading ACR60",38,0,2,0,40
1488594,1054604,2021-04-15,Assembly,"Be adopted. To third reading",12,0,0,0,12
1488594,1068151,2021-05-03,Senate,"Assembly 3rd Reading ACR61",36,0,4,0,40
1488595,1048888,2021-04-08,Assembly,"Be adopted. To third reading",11,0,1,0,12
1488596,1064112,2021-04-27,Senate,"Do pass, but first be re-referred to the Committee on [Appropriations] with the recommendation: To Consent Calendar",5,0,0,0,5
1488596,1077560,2021-05-13,Senate,"Consent Calendar SB827 PUB. S",38,0,2,0,40
1488596,1104746,2021-07-13,Assembly,"Do pass as amended, and be re-referred to the Committee on [Appropriations] with recommendation: To Consent Calendar",8,0,0,0,8
1488596,1106329,2021-08-19,Assembly,"Do pass. To Consent Calendar",16,0,0,0,16
1488596,1106587,2021-08-26,Assembly,"SB 827 PUB. S. Consent Calendar Second Day Regular Session",73,0,0,6,79
1488596,1107240,2021-08-30,Senate,"Unfinished Business SB827 PUB. S. (Bradford) Concurrence",39,0,0,1,40
1488597,1066743,2021-04-29,Senate,"Senate 3rd Reading SCR30 Dahle",36,0,4,0,40
1488597,1099122,2021-06-17,Assembly,"Be adopted. To Consent Calendar",9,0,3,0,12
1488597,1101595,2021-06-24,Assembly,"SCR 30 Dahle Consent Calendar Second Day Regular Session",77,0,2,0,79
1488598,1065109,2021-04-28,Senate,"Be adopted and be ordered to the Consent Calendar",7,0,0,0,7
1488598,1075317,2021-05-10,Senate,"Consent Calendar SJR3 Archuleta",37,0,3,0,40
1488598,1104350,2021-07-06,Assembly,"Be adopted. To Consent Calendar",11,0,0,0,11
1488598,1104668,2021-07-12,Assembly,"SJR 3 Archuleta Consent Calendar Second Day Regular Session",77,0,2,0,79
1488598,1107198,2021-08-30,Senate,"Special Consent SJR3",39,0,0,1,40
1491579,1076929,2021-05-12,Assembly,"Do pass",16,0,0,0,16
1491579,1078725,2021-05-17,Assembly,"AB 1593 Lorena Gonzalez Third Reading Urgency",73,0,5,0,78
1491579,1099755,2021-06-21,Senate,"Do pass",7,0,0,0,7
1491579,1104212,2021-07-05,Senate,"Assembly 3rd Reading AB1593 Lorena Gonzalez By Portantino Urgency Clause",39,0,1,0,40
1491579,1104653,2021-07-12,Assembly,"AB 1593 Lorena Gonzalez Concurrence in Senate Amendments",77,0,2,0,79
1491580,1048951,2021-04-08,Assembly,"Be adopted as amended",11,0,1,0,12
1491580,1068253,2021-05-03,Senate,"Assembly 3rd Reading ACR62",36,0,4,0,40
1491581,1048932,2021-04-08,Assembly,"Be adopted. To third reading",11,0,1,0,12
1491581,1066720,2021-04-29,Senate,"Special Consent ACR63",36,0,4,0,40
1491582,1056389,2021-04-19,Assembly,"Be adopted. To Consent Calendar",15,0,0,0,15
1491582,1062779,2021-04-26,Assembly,"ACR 64 Fong Assembly Third Reading",75,0,3,0,78
1491582,1101646,2021-06-24,Senate,"Be adopted, but first be re-referred to the Committee on [Appropriations] with recommendation: To Consent Calendar",14,0,3,0,17
1491582,1107227,2021-08-30,Senate,"Special Consent ACR64",38,0,0,2,40
1491582,1107518,2021-09-01,Assembly,"ACR 64 Fong Concurrence in Senate Amendments",77,0,0,2,79
1491583,1054658,2021-04-15,Assembly,"Be adopted. To third reading",12,0,0,0,12
1491583,1078763,2021-05-17,Senate,"Assembly 3rd Reading ACR65",38,0,2,0,40
1491584,1054695,2021-04-15,Assembly,"Be adopted. To Consent Calendar",12,0,0,0,12
1491584,1060811,2021-04-22,Assembly,"ACR 66 Cooley Consent Calendar Second Day Regular Session",77,0,2,0,79
1491584,1078793,2021-05-17,Senate,"Assembly 3rd Reading ACR66",38,0,2,0,40
1491586,1066702,2021-04-29,Senate,"Senate 3rd Reading SCR31 Newman",37,0,3,0,40
1491586,1101590,2021-06-24,Assembly,"Be adopted. To Consent Calendar",11,0,1,0,12
1491586,1103810,2021-07-01,Assembly,"SCR 31 Newman Consent Calendar Second Day Regular Session",77,0,2,0,79
1491587,1066832,2021-04-29,Senate,"Senate 3rd Reading SCR32 Gonzalez",37,0,3,0,40
1491587,1103820,2021-07-01,Assembly,"Be adopted. To Consent Calendar",9,0,3,0,12
1491587,1104496,2021-07-08,Assembly,"SCR 32 Gonzalez Consent Calendar Second Day Regular Session",76,0,3,0,79
1491588,1066793,2021-04-29,Senate,"Senate 3rd Reading SR24 Umberg",36,0,4,0,40
1491589,1054596,2021-04-15,Senate,"Senate 3rd Reading SR25 Wieckowski",38,0,2,0,40
1492082,1105129,2021-07-15,Assembly,"Be adopted. To Consent Calendar",10,0,2,0,12
1492082,1106389,2021-08-23,Assembly,"HR 35 Choi Consent Calendar Second Day Regular Session",70,0,0,9,79
1492083,1066746,2021-04-29,Assembly,"Be adopted. To third reading",9,0,3,0,12
1492084,1048981,2021-04-08,Assembly,"Be adopted. To third reading",11,0,1,0,12
1492085,1057715,2021-04-20,Senate,"Do pass, but first be re-referred to the Committee on [Appropriations] with the recommendation: To Consent Calendar",15,0,0,0,15
1492085,1068157,2021-05-03,Senate,"Placed on suspense file",6,0,1,0,7
1492085,1081591,2021-05-20,Senate,"Do pass",7,0,0,0,7
1492085,1089496,2021-06-01,Senate,"Special Consent SB828 G.O",39,0,1,0,40
1492085,1103502,2021-06-30,Assembly,"Do pass and be re-referred to the Committee on [Appropriations] with recommendation: To Consent Calendar",7,0,0,0,7
1492085,1106711,2021-08-26,Assembly,"Do pass",16,0,0,0,16
1492085,1107470,2021-09-01,Assembly,"SB 828 G.O. Senate Third Reading By PETRIE-NORRIS",77,0,0,2,79
1492420,1064061,2021-04-26,Assembly,"Be adopted. To Consent Calendar",15,0,0,0,15
1492420,1066719,2021-04-29,Assembly,"ACR 67 Quirk-Silva Consent Calendar Second Day Regular Session",77,0,1,0,78
1492420,1101614,2021-06-24,Senate,"Be adopted, but first be re-referred to the Committee on [Appropriations] with recommendation: To Consent Calendar",14,0,3,0,17
1492420,1107179,2021-08-30,Senate,"Special Consent ACR67",38,0,0,2,40
1492421,1074103,2021-05-06,Assembly,"Be adopted. To Consent Calendar",11,0,1,0,12
1492421,1077550,2021-05-13,Assembly,"ACR 68 O'Donnell Consent Calendar Second Day Regular Session",75,0,3,0,78
1492421,1104194,2021-07-05,Senate,"Assembly 3rd Reading ACR68 O'Donnell et al. By Leyva",40,0,0,0,40
1492422,1056415,2021-04-19,Senate,"Senate 3rd Reading SR26 Gonzalez",37,0,3,0,40
1492855,1075385,2021-05-10,Senate,"Senate 3rd Reading SCR33 Archuleta et al",36,0,4,0,40
1492855,1101593,2021-06-24,Assembly,"Be adopted. To Consent Calendar",11,0,1,0,12
1492855,1103835,2021-07-01,Assembly,"SCR 33 Archuleta Consent Calendar Second Day Regular Session",77,0,2,0,79
1492856,1104602,2021-07-12,Senate,"Senate 3rd Reading SCR34 Archuleta",39,0,1,0,40
1492856,1106370,2021-08-19,Assembly,"Be adopted. To Consent Calendar",11,0,0,1,12
1492856,1106879,2021-08-26,Assembly,"SCR 34 Archuleta Consent Calendar Second Day Regular Session",73,0,0,6,79
1493521,1074133,2021-05-06,Assembly,"Be adopted. To Consent Calendar",11,0,1,0,12
1493521,1077569,2021-05-13,Assembly,"ACR 69 Nguyen Consent Calendar Second Day Regular Session",75,0,3,0,78
1493521,1089523,2021-06-01,Senate,"Special Consent ACR69",39,0,1,0,40
1493522,1060997,2021-04-22,Assembly,"Be adopted. To third reading",12,0,0,0,12
1493524,1068188,2021-05-03,Senate,"Senate 3rd Reading SR27 Lim贸n",36,0,4,0,40
1495450,1087604,2021-05-28,Assembly,"Be adopted. To Consent Calendar",10,0,2,0,12
1495450,1090405,2021-06-02,Assembly,"ACR 70 Choi Consent Calendar Second Day Regular Session",75,0,4,0,79
1495450,1101643,2021-06-24,Senate,"Special Consent ACR70",39,0,1,0,40
1495451,1099145,2021-06-17,Senate,"Senate 3rd Reading SCR36 Melendez",37,0,3,0,40
1495451,1104563,2021-07-08,Assembly,"Be adopted. To Consent Calendar",10,0,2,0,12
1495451,1105135,2021-07-15,Assembly,"SCR 36 Melendez Consent Calendar Second Day Regular Session",70,0,9,0,79
1495452,1104661,2021-07-12,Senate,"Senate 3rd Reading SCR37 Archuleta et al",38,1,1,0,40
1495452,1106319,2021-08-19,Assembly,"Be adopted. To Consent Calendar",11,0,0,1,12
1495452,1106880,2021-08-26,Assembly,"SCR 37 Archuleta Consent Calendar Second Day Regular Session",73,0,0,6,79
1500881,1072227,2021-05-04,Assembly,"Be adopted. To Consent Calendar",11,0,0,0,11
1500881,1074168,2021-05-06,Assembly,"AJR 12 Stone Consent Calendar Second Day Regular Session",77,0,1,0,78
1500881,1104386,2021-07-06,Senate,"Be adopted. Ordered to third reading",11,0,0,0,11
1500881,1106901,2021-08-26,Senate,"Assembly 3rd Reading AJR12 Stone et al. By Borgeas",36,0,0,4,40
1500882,1096087,2021-06-09,Senate,"Be adopted, but first be re-referred to the Committee on [Elections and Constitutional Amendments]",6,0,1,0,7
1500882,1102472,2021-06-28,Senate,"Be adopted, but first be re-referred to the Committee on [Appropriations]",5,0,0,0,5
1500882,1104155,2021-07-05,Senate,"Placed on suspense file",6,0,1,0,7
1500882,1106858,2021-08-26,Senate,"Be adopted as amended",7,0,0,0,7
1500882,1129002,2022-01-26,Senate,"Senate 3rd Reading SCA5 Glazer et al",37,0,0,3,40
1500882,1217406,2022-06-21,Assembly,"Be adopted as amended, and re-refer to the Committee on [Appropriations]",12,0,0,0,12
1500883,1062800,2021-04-26,Senate,"Senate 3rd Reading SR28 Rubio et al",38,0,2,0,40
1500884,1062749,2021-04-26,Senate,"Senate 3rd Reading SR29 Archuleta et al",38,0,2,0,40
1501652,1066711,2021-04-29,Assembly,"Be adopted. To Consent Calendar",9,0,3,0,12
1501652,1074154,2021-05-06,Assembly,"ACR 71 Villapudua Consent Calendar Second Day Regular Session",77,0,1,0,78
1501652,1089567,2021-06-01,Senate,"Special Consent ACR71",39,0,1,0,40
1501653,1074136,2021-05-06,Senate,"Senate 3rd Reading SCR38 Pan",37,0,3,0,40
1501653,1103822,2021-07-01,Assembly,"Be adopted. To Consent Calendar",9,0,3,0,12
1501653,1104578,2021-07-08,Assembly,"SCR 38 Pan Consent Calendar Second Day Regular Session",76,0,3,0,79
1501654,1104474,2021-07-07,Senate,"Be adopted and be ordered to the Consent Calendar",7,0,0,0,7
1501654,1105150,2021-07-15,Senate,"Consent Calendar SJR4 Wilk",38,0,2,0,40
1501654,1216599,2022-06-15,Assembly,"Be adopted as amended. To Consent Calendar",6,0,0,1,7
1501654,1218647,2022-06-23,Assembly,"SJR 4 Wilk Consent Calendar Second Day Regular Session",74,0,0,6,80
1501654,1223265,2022-08-08,Senate,"Special Consent SJR4",36,0,0,4,40
1501655,1068178,2021-05-03,Senate,"Senate 3rd Reading SR30 Hueso",36,0,4,0,40
1502128,1091710,2021-06-03,Assembly,"Be adopted. To Consent Calendar",10,0,2,0,12
1502128,1097042,2021-06-10,Assembly,"ACR 72 Nguyen Consent Calendar Second Day",73,0,6,0,79
1502128,1104164,2021-07-05,Senate,"Special Consent ACR72",38,0,2,0,40
1502692,1060820,2021-04-22,Assembly,"Be adopted. To third reading",12,0,0,0,12
1502692,1078773,2021-05-17,Senate,"Assembly 3rd Reading ACR73",38,0,2,0,40
1503081,1095059,2021-06-08,Assembly,"Be adopted. To third reading",9,0,2,0,11
1503081,1097776,2021-06-14,Assembly,"AJR 14 Boerner Horvath Assembly Third Reading",69,0,10,0,79
1503081,1106104,2021-08-16,Senate,"Assembly 3rd Reading AJR14 Boerner Horvath et a By Leyva",39,0,0,1,40
1503081,1106416,2021-08-23,Assembly,"AJR 14 Boerner Horvath Concurrence in Senate Amendments",66,0,0,13,79
1503082,1097064,2021-06-10,Assembly,"Be adopted. To third reading",12,0,0,0,12
1503083,1104706,2021-07-13,Senate,"Be adopted, but first be re-referred to the Committee on [Appropriations] with recommendation: To Consent Calendar",15,0,2,0,17
1503083,1107170,2021-08-30,Senate,"Special Consent SCR39",38,0,0,2,40
1503083,1193183,2022-04-25,Assembly,"Be adopted. To Consent Calendar",15,0,0,0,15
1503083,1195767,2022-04-28,Assembly,"SCR 39 Allen Consent Calendar Second Day Regular Session",71,0,0,6,77
1503851,1122875,2022-01-10,Assembly,"Be adopted. To Consent Calendar",14,0,0,1,15
1503851,1124332,2022-01-14,Assembly,"ACR 74 Salas Consent Calendar Second Day Regular Session",62,0,0,14,76
1503851,1220664,2022-06-28,Senate,"Be adopted, but first be re-referred to the Committee on [Appropriations] with recommendation: To Consent Calendar",16,0,0,1,17
1503851,1223018,2022-08-04,Senate,"Special Consent ACR74 Salas",35,0,0,5,40
1503852,1074185,2021-05-06,Assembly,"Be adopted. To third reading",11,0,1,0,12
1503852,1089474,2021-06-01,Senate,"Special Consent ACR75",39,0,1,0,40
1503853,1077589,2021-05-13,Assembly,"Be adopted. To third reading",10,0,2,0,12
1503853,1089629,2021-06-01,Senate,"Special Consent ACR76",39,0,1,0,40
1503854,1074123,2021-05-06,Assembly,"Be adopted. To Consent Calendar",11,0,1,0,12
1503854,1077599,2021-05-13,Assembly,"ACR 77 Bennett Consent Calendar Second Day Regular Session",75,0,3,0,78
1503854,1107603,2021-09-02,Senate,"Assembly 3rd Reading ACR77 Bennett et al. By Allen",35,0,0,5,40
1503855,1066791,2021-04-29,Assembly,"Be adopted. To third reading",9,0,3,0,12
1503856,1075365,2021-05-10,Senate,"Senate 3rd Reading SCR40 Allen",37,0,3,0,40
1503856,1101686,2021-06-24,Assembly,"Be adopted. To Consent Calendar",11,0,1,0,12
1503856,1103819,2021-07-01,Assembly,"SCR 40 Allen Consent Calendar Second Day Regular Session",77,0,2,0,79
1504273,1066755,2021-04-29,Assembly,"Be adopted. To third reading",9,0,3,0,12
1504273,1078820,2021-05-17,Senate,"Assembly 3rd Reading ACR78",38,0,2,0,40
1504274,1077623,2021-05-13,Assembly,"Be adopted. To third reading",10,0,2,0,12
1504656,1104272,2021-07-05,Assembly,"Be adopted. To Consent Calendar",15,0,0,0,15
1504656,1104550,2021-07-08,Assembly,"ACR 79 Nazarian Consent Calendar Second Day",76,0,3,0,79
1504656,1220698,2022-06-28,Senate,"Be adopted, but first be re-referred to the Committee on [Appropriations] with recommendation: To Consent Calendar",16,0,0,1,17
1504656,1223155,2022-08-08,Senate,"Consent Calendar ACR79",36,0,0,4,40
1505162,1081988,2021-05-20,Assembly,"Be adopted. To third reading",11,0,1,0,12
1505163,1077595,2021-05-13,Assembly,"Be adopted. To third reading",10,0,2,0,12
1505164,1078757,2021-05-17,Senate,"Senate 3rd Reading SR31 Eggman et al",37,0,3,0,40
1505165,1083852,2021-05-24,Senate,"Senate 3rd Reading SR32 Pan et al",40,0,0,0,40
1505858,1097045,2021-06-10,Assembly,"Be adopted. To Consent Calendar",12,0,0,0,12
1505858,1099135,2021-06-17,Assembly,"ACR 80 Luz Rivas Consent Calendar Second Day",72,0,7,0,79
1505858,1105039,2021-07-15,Senate,"Special Consent ACR80",38,0,2,0,40
1505859,1074197,2021-05-06,Assembly,"Be adopted. To third reading",11,0,1,0,12
1505859,1089515,2021-06-01,Senate,"Special Consent ACR81",39,0,1,0,40
1505860,1081420,2021-05-20,Senate,"Senate 3rd Reading SR33 Eggman et al",35,0,5,0,40
1506341,1097039,2021-06-10,Assembly,"Be adopted. To third reading",12,0,0,0,12
1506341,1105100,2021-07-15,Senate,"Special Consent ACR82",38,0,2,0,40
1506342,1099114,2021-06-17,Senate,"Senate 3rd Reading SCR41 Bradford et al",38,0,2,0,40
1506342,1104565,2021-07-08,Assembly,"Be adopted. To Consent Calendar",10,0,2,0,12
1506342,1105053,2021-07-15,Assembly,"SCR 41 Bradford Consent Calendar Second Day Regular Session",70,0,9,0,79
1506757,1095058,2021-06-08,Assembly,"Be adopted. To Consent Calendar",11,0,0,0,11
1506757,1104216,2021-07-05,Senate,"Special Consent ACR83",38,0,2,0,40
1506758,1095072,2021-06-08,Assembly,"Be adopted. To Consent Calendar",11,0,0,0,11
1506758,1099747,2021-06-21,Assembly,"AJR 15 McCarty Assembly Third Reading",73,0,6,0,79
1506758,1104443,2021-07-06,Senate,"Be adopted and be ordered to the Consent Calendar",11,0,0,0,11
1506758,1105149,2021-07-15,Senate,"Consent Calendar AJR15",38,0,2,0,40
1506759,1077527,2021-05-13,Senate,"Senate 3rd Reading SR34 Grove et al",38,0,2,0,40
1506760,1077588,2021-05-13,Senate,"Senate 3rd Reading SR35 Grove",38,0,2,0,40
1507115,1078764,2021-05-17,Senate,"Senate 3rd Reading SCR42 Pan",38,0,2,0,40
1507115,1103849,2021-07-01,Assembly,"Be adopted. To Consent Calendar",9,0,3,0,12
1507115,1104534,2021-07-08,Assembly,"SCR 42 Pan Consent Calendar Second Day Regular Session",76,0,3,0,79
1507116,1093647,2021-06-07,Senate,"Be adopted and be ordered to the Consent Calendar",5,0,0,0,5
1507116,1099097,2021-06-17,Senate,"Consent Calendar SJR5 Wilk et al",37,0,3,0,40
1507116,1171443,2022-03-16,Assembly,"Be adopted. To Consent Calendar",6,0,0,0,6
1507116,1222619,2022-08-01,Assembly,"SJR 5 Wilk Senate Third Reading By Lackey",76,0,0,4,80
1507116,1225649,2022-08-30,Senate,"Special Consent SJR5 Wilk et al",38,0,0,2,40
1507739,1077590,2021-05-13,Assembly,"Be adopted. To third reading",10,0,2,0,12
1507739,1101688,2021-06-24,Senate,"Special Consent ACR84",39,0,1,0,40
1507740,1083838,2021-05-24,Senate,"Senate 3rd Reading SCR43 Newman",40,0,0,0,40
1507740,1103747,2021-07-01,Assembly,"Be adopted. To Consent Calendar",9,0,3,0,12
1507740,1104495,2021-07-08,Assembly,"SCR 43 Newman Consent Calendar Second Day Regular Session",76,0,3,0,79
1507741,1077574,2021-05-13,Senate,"Senate 3rd Reading SCR44 Atkins et al",38,0,2,0,40
1508138,1093662,2021-06-07,Senate,"Senate 3rd Reading SCR45 Dodd",40,0,0,0,40
1508138,1104552,2021-07-08,Assembly,"Be adopted. To Consent Calendar",10,0,2,0,12
1508138,1105096,2021-07-15,Assembly,"SCR 45 Dodd Consent Calendar Second Day Regular Session",70,0,9,0,79
1508139,1081628,2021-05-20,Senate,"Senate 3rd Reading SCR46 Umberg et al",35,0,5,0,40
1508139,1103796,2021-07-01,Assembly,"Be adopted. To Consent Calendar",9,0,3,0,12
1508139,1104502,2021-07-08,Assembly,"SCR 46 Umberg Consent Calendar Second Day Regular Session",76,0,3,0,79
1508533,1097057,2021-06-10,Assembly,"Be adopted. To Consent Calendar",12,0,0,0,12
1508533,1099150,2021-06-17,Assembly,"HR 44 Quirk Consent Calendar Second Day Regular Session",72,0,7,0,79
1508534,1097018,2021-06-10,Assembly,"Be adopted. To Consent Calendar",12,0,0,0,12
1508534,1099161,2021-06-17,Assembly,"HR 45 Levine Consent Calendar Second Day Regular Session",72,0,7,0,79
1508535,1081640,2021-05-20,Assembly,"Be adopted. To Consent Calendar",11,0,1,0,12
1508535,1087028,2021-05-27,Assembly,"HR 46 Gabriel Consent Calendar Second Day Regular Session",75,0,3,0,78
1508536,1082146,2021-05-20,Assembly,"Be adopted. To third reading",11,0,1,0,12
1508537,1097067,2021-06-10,Senate,"Senate 3rd Reading SCR47 Hertzberg et al",38,0,2,0,40
1508537,1104545,2021-07-08,Assembly,"Be adopted. To Consent Calendar",10,0,2,0,12
1508537,1105038,2021-07-15,Assembly,"SCR 47 Hertzberg Consent Calendar Second Day Regular Session",70,0,9,0,79
1508538,1093686,2021-06-07,Senate,"Senate 3rd Reading SCR48 McGuire",40,0,0,0,40
1508538,1101573,2021-06-24,Assembly,"Be adopted. To Consent Calendar",11,0,1,0,12
1508538,1103787,2021-07-01,Assembly,"SCR 48 McGuire Consent Calendar Second Day Regular Session",77,0,2,0,79
1509078,1097026,2021-06-10,Assembly,"Be adopted. To Consent Calendar",12,0,0,0,12
1509078,1099107,2021-06-17,Assembly,"ACR 85 Kalra Consent Calendar Second Day Regular Session",72,0,7,0,79
1509078,1105079,2021-07-15,Senate,"Special Consent ACR85",38,0,2,0,40
1509788,1093656,2021-06-07,Senate,"Senate 3rd Reading SR36 Rubio et al",40,0,0,0,40
1509789,1093677,2021-06-07,Senate,"Senate 3rd Reading SR37 Rubio et al",40,0,0,0,40
1509790,1093660,2021-06-07,Senate,"Senate 3rd Reading SR38 Ochoa Bogh",39,0,1,0,40
1510160,1100279,2021-06-22,Assembly,"Be adopted. To third reading",8,2,1,0,11
1510160,1102511,2021-06-28,Assembly,"AJR 16 Reyes Assembly Third Reading",63,2,14,0,79
1510160,1104965,2021-07-13,Senate,"Be adopted. Ordered to third reading",10,0,1,0,11
1510160,1107156,2021-08-30,Senate,"Assembly 3rd Reading AJR16 Reyes et al. By Hueso",33,0,0,7,40
1510161,1082213,2021-05-20,Assembly,"Be adopted. To Consent Calendar",11,0,1,0,12
1510161,1086932,2021-05-27,Assembly,"HR 48 Gabriel Consent Calendar Second Day Regular Session",75,0,3,0,78
1510162,1082166,2021-05-20,Assembly,"Be adopted. To Consent Calendar",11,0,1,0,12
1510162,1086957,2021-05-27,Assembly,"HR 49 Gabriel Consent Calendar Second Day Regular Session",75,0,3,0,78
1510652,1087608,2021-05-28,Assembly,"Be adopted. To Consent Calendar",10,0,2,0,12
1510652,1090441,2021-06-02,Assembly,"ACR 86 Gipson Consent Calendar Second Day Regular Session",75,0,4,0,79
1510652,1101636,2021-06-24,Senate,"Special Consent ACR86",39,0,1,0,40
1511168,1087591,2021-05-28,Assembly,"Be adopted. To third reading",10,0,2,0,12
1511168,1106160,2021-08-16,Senate,"Assembly 3rd Reading ACR87 Gipson et al. By Rubio",39,0,0,1,40
1511169,1099764,2021-06-21,Assembly,"Be adopted. To Consent Calendar",15,0,0,0,15
1511169,1101664,2021-06-24,Assembly,"ACR 88 O'Donnell Consent Calendar Second Day Regular Session",77,0,2,0,79
1511169,1104775,2021-07-13,Senate,"Be adopted, but first be re-referred to the Committee on [Appropriations] with recommendation: To Consent Calendar",16,0,1,0,17
1511169,1106426,2021-08-23,Senate,"Placed on suspense file",7,0,0,0,7
1511170,1106336,2021-08-19,Assembly,"Be adopted. To Consent Calendar",11,0,0,1,12
1511170,1106852,2021-08-26,Assembly,"HR 50 Seyarto Consent Calendar Second Day Regular Session",73,0,0,6,79
1511944,1099132,2021-06-17,Assembly,"Be adopted. To third reading",9,0,3,0,12
1511945,1099766,2021-06-21,Senate,"Senate 3rd Reading SR39 Eggman et al",35,0,5,0,40
1512257,1184653,2022-04-05,Assembly,"Be adopted. To third reading",8,0,0,1,9
1512257,1189328,2022-04-18,Assembly,"AJR 17 Waldron Assembly Third Reading",72,0,0,5,77
1512257,1215744,2022-06-14,Senate,"Be adopted and be ordered to the Consent Calendar",5,0,0,2,7
1512257,1217089,2022-06-20,Senate,"Consent Calendar AJR17 Waldron et al",38,0,0,2,40
1512258,1105152,2021-07-15,Assembly,"Be adopted. To third reading",10,0,2,0,12
1513340,1104261,2021-07-05,Assembly,"Be adopted. To Consent Calendar",15,0,0,0,15
1513340,1104507,2021-07-08,Assembly,"ACR 89 Bigelow Consent Calendar Second Day Regular Session",76,0,3,0,79
1513340,1220851,2022-06-28,Senate,"Be adopted, but first be re-referred to the Committee on [Appropriations] with recommendation: To Consent Calendar",16,0,0,1,17
1513340,1223038,2022-08-04,Senate,"Special Consent ACR89",35,0,0,5,40
1513341,1106427,2021-08-23,Senate,"Senate 3rd Reading SCR49 Hueso et al",37,0,0,3,40
1513341,1107259,2021-08-30,Assembly,"Be adopted. To Consent Calendar",8,0,0,4,12
1513920,1091705,2021-06-03,Assembly,"Be adopted. To Consent Calendar",10,0,2,0,12
1513920,1097062,2021-06-10,Assembly,"ACR 90 Mathis Consent Calendar Second Day Regular Session",73,0,6,0,79
1513920,1104211,2021-07-05,Senate,"Special Consent ACR90",38,0,2,0,40
1513920,1104617,2021-07-12,Assembly,"ACR 90 Mathis Concurrence in Senate Amendments",76,0,3,0,79
1514146,1097774,2021-06-14,Senate,"Senate 3rd Reading SCR50 Ochoa Bogh et al",39,0,1,0,40
1514146,1101569,2021-06-24,Assembly,"Be adopted. To Consent Calendar",11,0,1,0,12
1514146,1103813,2021-07-01,Assembly,"SCR 50 Ochoa Bogh Consent Calendar Second Day Regular Session",77,0,2,0,79
1514147,1099734,2021-06-21,Senate,"Senate 3rd Reading SR40 Leyva et al",39,0,1,0,40
1514945,1104558,2021-07-08,Assembly,"Be adopted. To Consent Calendar",10,0,2,0,12
1514945,1105059,2021-07-15,Assembly,"HR 53 Levine Consent Calendar Second Day Regular Session",70,0,9,0,79
1514946,1104631,2021-07-12,Senate,"Senate 3rd Reading SCR51 Pan et al",31,2,7,0,40
1514946,1106631,2021-08-26,Assembly,"Be adopted. To Consent Calendar",10,0,0,2,12
1515292,1099162,2021-06-17,Assembly,"Be adopted. To third reading",9,0,3,0,12
1515292,1105072,2021-07-15,Senate,"Special Consent ACR91",38,0,2,0,40
1515292,1106444,2021-08-23,Assembly,"ACR 91 Chiu Concurrence in Senate Amendments",71,0,0,8,79
1515293,1099160,2021-06-17,Assembly,"Be adopted. To Consent Calendar",9,0,3,0,12
1515293,1101586,2021-06-24,Assembly,"HR 54 Choi Consent Calendar Second Day",77,0,2,0,79
1515563,1104633,2021-07-12,Senate,"Senate 3rd Reading SR41 Caballero",39,0,1,0,40
1515971,1104636,2021-07-12,Senate,"Senate 3rd Reading SCR52 McGuire et al",39,0,1,0,40
1515971,1105136,2021-07-15,Assembly,"Be adopted. To Consent Calendar",10,0,2,0,12
1515971,1106357,2021-08-19,Assembly,"SCR 52 McGuire Consent Calendar Second Day Regular Session",73,0,0,6,79
1515972,1104603,2021-07-12,Senate,"Senate 3rd Reading SR43 Roth",39,0,1,0,40
1516968,1218621,2022-06-23,Assembly,"Be adopted. To Consent Calendar",8,0,0,4,12
1516968,1221568,2022-06-29,Assembly,"ACR 92 Petrie-Norris Consent Calendar Second Day Regular Session",78,0,0,2,80
1516968,1223608,2022-08-11,Senate,"Special Consent ACR92",38,0,0,2,40
1516969,1101632,2021-06-24,Assembly,"Be adopted. To Consent Calendar",11,0,1,0,12
1516969,1103776,2021-07-01,Assembly,"HR 55 Boerner Horvath Consent Calendar Second Day",77,0,2,0,79
1517129,1106343,2021-08-19,Assembly,"Be adopted. To Consent Calendar",11,0,0,1,12
1517129,1106687,2021-08-26,Assembly,"ACR 93 Choi Consent Calendar Second Day Regular Session",73,0,0,6,79
1517129,1140877,2022-02-10,Senate,"Special Consent ACR93",37,0,0,3,40
1517131,1122862,2022-01-10,Senate,"Be adopted. Ordered to third reading",5,0,0,2,7
1517131,1128991,2022-01-26,Senate,"Senate 3rd Reading SCR53 McGuire et al",30,4,0,6,40
1517131,1219469,2022-06-27,Assembly,"Be adopted. To third reading",10,0,0,1,11
1517131,1223877,2022-08-11,Senate,"Unfinished Business SCR53 McGuire et al. Concurrence",29,0,0,11,40
1517307,1103825,2021-07-01,Assembly,"Be adopted. To Consent Calendar",9,0,3,0,12
1517307,1104609,2021-07-12,Assembly,"ACR 94 Valladares Assembly Third Reading",53,5,21,0,79
1517307,1107213,2021-08-30,Senate,"Assembly 3rd Reading ACR94 Valladares By Wilk",32,4,0,4,40
1517308,1104506,2021-07-08,Senate,"Be adopted as amended, and be ordered to the Consent Calendar",9,0,0,0,9
1517308,1105075,2021-07-15,Senate,"Consent Calendar SJR6",38,0,2,0,40
1517308,1106486,2021-08-24,Assembly,"Be adopted. To Consent Calendar",8,0,0,0,8
1517308,1106982,2021-08-26,Assembly,"SJR 6 Wiener Consent Calendar Second Day Regular Session",73,0,0,6,79
1517617,1104315,2021-07-06,Assembly,"Be adopted as amended, and re-refer to the Committee on [Appropriations]",10,0,1,0,11
1517617,1106358,2021-08-19,Assembly,"Be adopted. To Consent Calendar",16,0,0,0,16
1517617,1106742,2021-08-26,Assembly,"ACR 95 Cunningham Consent Calendar Second Day Regular Session",73,0,0,6,79
1517617,1220793,2022-06-28,Senate,"Be adopted, but first be re-referred to the Committee on [Appropriations]",10,0,0,1,11
1517617,1224224,2022-08-18,Senate,"Assembly 3rd Reading ACR95 Cunningham et al. By Borgeas",38,0,0,2,40
1518019,1106361,2021-08-19,Assembly,"Be adopted. To Consent Calendar",11,0,0,1,12
1518019,1106857,2021-08-26,Assembly,"HR 56 Levine Consent Calendar Second Day Regular Session",73,0,0,6,79
1518020,1105108,2021-07-15,Assembly,"Be adopted. To Consent Calendar",10,0,2,0,12
1518020,1106428,2021-08-23,Assembly,"HR 57 Choi Consent Calendar Second Day Regular Session",70,0,0,9,79
1518128,1105131,2021-07-15,Assembly,"Be adopted. To third reading",10,0,2,0,12
1518224,1104948,2021-07-13,Senate,"Be adopted as amended",10,1,0,0,11
1518224,1106313,2021-08-19,Senate,"Senate 3rd Reading SJR7 Bradford et al",35,0,0,5,40
1518224,1124160,2022-01-13,Assembly,"Be adopted. To third reading",8,0,0,2,10
1518376,1105099,2021-07-15,Assembly,"Be adopted. To third reading",10,0,2,0,12
1518376,1140881,2022-02-10,Senate,"Special Consent ACR96",37,0,0,3,40
1518377,1105141,2021-07-15,Assembly,"Be adopted. To third reading",10,0,2,0,12
1518377,1107578,2021-09-02,Senate,"Assembly 3rd Reading ACR97 Kalra et al",39,0,0,1,40
1518450,1104561,2021-07-08,Assembly,"Be adopted. To third reading",10,0,2,0,12
1518451,1106439,2021-08-23,Senate,"Senate 3rd Reading SCR54 Ochoa Bogh et al",37,0,0,3,40
1518451,1107174,2021-08-30,Assembly,"Be adopted. To Consent Calendar",8,0,0,4,12
1518853,1183759,2022-04-05,Senate,"Be adopted. Ordered to third reading",5,0,0,0,5
1518853,1201361,2022-05-09,Senate,"Senate 3rd Reading SJR8 Caballero",33,0,0,7,40
1518853,1219930,2022-06-28,Assembly,"Be adopted. To third reading",7,0,0,1,8
1518853,1223990,2022-08-11,Assembly,"SJR 8 Caballero Senate Third Reading By Blanca Rubio",74,0,0,6,80
1519120,1105139,2021-07-15,Assembly,"Be adopted. To Consent Calendar",10,0,2,0,12
1519120,1106360,2021-08-19,Assembly,"ACR 98 Aguiar-Curry Consent Calendar Second Day Regular Session",73,0,0,6,79
1519121,1107453,2021-09-01,Senate,"Senate 3rd Reading SR44 Glazer",39,0,0,1,40
1519265,1179125,2022-03-29,Senate,"Be adopted. Ordered to third reading",9,0,0,2,11
1519265,1182546,2022-04-04,Senate,"Senate 3rd Reading SR45 Min",32,0,0,8,40
1519266,1106462,2021-08-23,Senate,"Senate 3rd Reading SR46 Eggman et al",37,0,0,3,40
1519353,1107853,2021-09-07,Senate,"Senate 3rd Reading SR47 Borgeas et al",37,0,0,3,40
1521744,1106374,2021-08-19,Assembly,"Be adopted. To Consent Calendar",11,0,0,1,12
1521744,1106773,2021-08-26,Assembly,"ACR 100 Carrillo Consent Calendar Second Day Regular Session",73,0,0,6,79
1521744,1140911,2022-02-10,Senate,"Special Consent ACR100",37,0,0,3,40
1521745,1106365,2021-08-19,Assembly,"Be adopted. To third reading",11,0,0,1,12
1521745,1107891,2021-09-07,Senate,"Assembly 3rd Reading ACR101",37,0,0,3,40
1521746,1106375,2021-08-19,Assembly,"Be adopted. To Consent Calendar",11,0,0,1,12
1521746,1106869,2021-08-26,Assembly,"ACR 102 Kalra Consent Calendar Second Day Regular Session",73,0,0,6,79
1521746,1140884,2022-02-10,Senate,"Special Consent ACR102",37,0,0,3,40
1521747,1106373,2021-08-19,Assembly,"Be adopted. To Consent Calendar",11,0,0,1,12
1521747,1106737,2021-08-26,Assembly,"ACR 103 Kalra Consent Calendar Second Day Regular Session",73,0,0,6,79
1521747,1140878,2022-02-10,Senate,"Special Consent ACR103",37,0,0,3,40
1521748,1106333,2021-08-19,Assembly,"Be adopted. To Consent Calendar",11,0,0,1,12
1521748,1106897,2021-08-26,Assembly,"ACR 99 Petrie-Norris Consent Calendar Second Day Regular Session",73,0,0,6,79
1521748,1140883,2022-02-10,Senate,"Special Consent ACR99",37,0,0,3,40
1521749,1106448,2021-08-23,Assembly,"Be adopted. To Consent Calendar",7,0,0,5,12
1521749,1106809,2021-08-26,Assembly,"HR 62 Akilah Weber Consent Calendar Second Day Regular Session",73,0,0,6,79
1521750,1106993,2021-08-26,Assembly,"Be adopted. To Consent Calendar",10,0,0,2,12
1521750,1107447,2021-09-01,Assembly,"HR 63 Seyarto Consent Calendar Second Day",77,0,0,2,79
1521751,1106425,2021-08-23,Assembly,"Be adopted. To Consent Calendar",7,0,0,5,12
1521751,1106812,2021-08-26,Assembly,"HR 64 Maienschein Consent Calendar Second Day Regular Session",73,0,0,6,79
1521752,1106308,2021-08-19,Assembly,"Be adopted. To Consent Calendar",11,0,0,1,12
1521752,1106667,2021-08-26,Assembly,"HR 65 Kiley Consent Calendar Second Day Regular Session",73,0,0,6,79
1521753,1106315,2021-08-19,Assembly,"Be adopted. To third reading",11,0,0,1,12
1521754,1106683,2021-08-26,Assembly,"Be adopted. To Consent Calendar",10,0,0,2,12
1521755,1107403,2021-09-01,Senate,"Senate 3rd Reading SCR55 Hurtado et al",39,0,0,1,40
1521755,1107679,2021-09-02,Assembly,"Be adopted. To Consent Calendar",10,0,0,2,12
1521755,1107966,2021-09-07,Assembly,"SCR 55 Hurtado Consent Calendar Second Day Regular Session",73,0,0,7,80
1521756,1107452,2021-09-01,Senate,"Senate 3rd Reading SCR56 Melendez et al",39,0,0,1,40
1521756,1107653,2021-09-02,Assembly,"Be adopted. To Consent Calendar",10,0,0,2,12
1521756,1107967,2021-09-07,Assembly,"SCR 56 Melendez Consent Calendar Second Day Regular Session",73,0,0,7,80
1521757,1107530,2021-09-01,Senate,"Senate 3rd Reading SR48 Lim贸n",39,0,0,1,40
1521758,1107438,2021-09-01,Senate,"Senate 3rd Reading SR49 Leyva et al",39,0,0,1,40
1521759,1107440,2021-09-01,Senate,"Senate 3rd Reading SR50 Caballero",39,0,0,1,40
1521803,1107692,2021-09-02,Assembly,"Be adopted. To Consent Calendar",7,0,0,0,7
1521803,1107940,2021-09-07,Assembly,"ACR 104 Holden Consent Calendar Second Day",73,0,0,7,80
1521803,1143397,2022-02-14,Senate,"Assembly 3rd Reading ACR104 Holden By Kamlager",36,0,0,4,40
1521804,1107732,2021-09-02,Assembly,"Be adopted as amended",7,0,0,0,7
1521804,1140904,2022-02-10,Senate,"Special Consent ACR105",37,0,0,3,40
1521805,1106696,2021-08-26,Assembly,"Be adopted. To Consent Calendar",10,0,0,2,12
1521867,1126268,2022-01-20,Assembly,"Be adopted. To Consent Calendar",9,0,0,3,12
1521867,1129918,2022-01-27,Assembly,"ACR 106 Kalra Consent Calendar Second Day",61,0,0,15,76
1521867,1173488,2022-03-21,Senate,"Special Consent ACR106 Kalra et al",37,0,0,3,40
1521868,1107449,2021-09-01,Senate,"Senate 3rd Reading SCR57 Hurtado",39,0,0,1,40
1521868,1107712,2021-09-02,Assembly,"Be adopted. To Consent Calendar",10,0,0,2,12
1521868,1107968,2021-09-07,Assembly,"SCR 57 Hurtado Consent Calendar Second Day Regular Session",73,0,0,7,80
1521869,1107465,2021-09-01,Senate,"Senate 3rd Reading SCR58 Hurtado et al",39,0,0,1,40
1521869,1107686,2021-09-02,Assembly,"Be adopted. To Consent Calendar",10,0,0,2,12
1521869,1107969,2021-09-07,Assembly,"SCR 58 Hurtado Consent Calendar Second Day Regular Session",73,0,0,7,80
1521871,1108678,2021-09-10,Senate,"Senate 3rd Reading SR52 Min",37,0,0,3,40
1521872,1107503,2021-09-01,Senate,"Senate 3rd Reading SR53 Durazo",39,0,0,1,40
1521873,1107489,2021-09-01,Senate,"Senate 3rd Reading SR54 Borgeas et al",39,0,0,1,40
1521874,1107862,2021-09-07,Senate,"Be adopted and be ordered to the Consent Calendar",4,0,0,3,7
1521874,1108679,2021-09-10,Senate,"Consent Calendar SR55 Portantino et al",37,0,0,3,40
1521963,1108680,2021-09-10,Senate,"Senate 3rd Reading SCR60 Nielsen et al",37,0,0,3,40
1521963,1200499,2022-05-05,Assembly,"Be adopted. To Consent Calendar",8,0,0,2,10
1521963,1204107,2022-05-12,Assembly,"SCR 60 Nielsen Consent Calendar Second Day Regular Session",65,0,0,13,78
1521963,1212435,2022-06-02,Senate,"Special Consent SCR60",33,0,0,7,40
1522050,1106766,2021-08-26,Assembly,"Be adopted. To Consent Calendar",10,0,0,2,12
1522051,1108658,2021-09-10,Senate,"Senate 3rd Reading SR58 Pan",37,0,0,3,40
1522113,1107865,2021-09-07,Senate,"Senate 3rd Reading SCR61 Dahle",37,0,0,3,40
1522113,1221302,2022-06-30,Assembly,"Be adopted. To Consent Calendar",7,0,0,4,11
1522113,1223021,2022-08-04,Assembly,"SCR 61 Dahle Consent Calendar Second Day Regular Session",76,0,0,4,80
1522113,1225931,2022-08-30,Senate,"Special Consent SCR61",38,0,0,2,40
1522302,1107255,2021-08-30,Assembly,"Be adopted. To Consent Calendar",8,0,0,4,12
1522303,1107192,2021-08-30,Assembly,"Be adopted. To Consent Calendar",8,0,0,4,12
1522305,1108648,2021-09-10,Senate,"Senate 3rd Reading SR59 Becker et al",36,0,0,4,40
1522604,1107618,2021-09-02,Assembly,"Be adopted. To Consent Calendar",10,0,0,2,12
1522604,1107941,2021-09-07,Assembly,"ACR 108 Lorena Gonzalez Consent Calendar Second Day Regular Session",73,0,0,7,80
1522605,1123311,2022-01-10,Assembly,"Be adopted as amended, and re-refer to the Committee on [Appropriations]",11,0,0,0,11
1522605,1126288,2022-01-20,Assembly,"ACR 109 Eduardo Garcia Consent Calendar Second Day",62,0,0,14,76
1522605,1211907,2022-06-01,Senate,"Be adopted as amended, and be ordered to the Consent Calendar",8,0,0,1,9
1522605,1215302,2022-06-09,Senate,"Consent Calendar ACR109",38,0,0,2,40
1522605,1219388,2022-06-27,Assembly,"ACR 109 Eduardo Garcia Concurrence in Senate Amendments",69,0,0,11,80
1522606,1184643,2022-04-05,Assembly,"Be adopted. To third reading",8,0,0,1,9
1522606,1210341,2022-05-26,Assembly,"AJR 19 Eduardo Garcia Assembly Third Reading",76,0,0,2,78
1522606,1219924,2022-06-28,Senate,"Be adopted and be ordered to the Consent Calendar",6,0,0,1,7
1522606,1223253,2022-08-08,Senate,"Consent Calendar AJR19",36,0,0,4,40
1522608,1107631,2021-09-02,Assembly,"Be adopted. To Consent Calendar",10,0,0,2,12
1522608,1107943,2021-09-07,Assembly,"HR 72 Gabriel Consent Calendar Second Day Regular Session",73,0,0,7,80
1522609,1140896,2022-02-10,Senate,"Senate 3rd Reading SR60 Rubio",38,0,0,2,40
1522685,1107657,2021-09-02,Assembly,"Be adopted. To Consent Calendar",10,0,0,2,12
1522685,1107944,2021-09-07,Assembly,"HR 73 Nguyen Consent Calendar Second Day Regular Session",73,0,0,7,80
1522686,1176528,2022-03-24,Senate,"Senate 3rd Reading SR61 Rubio",39,0,0,1,40
1522790,1107601,2021-09-02,Assembly,"Be adopted. To third reading",9,0,0,3,12
1522866,1107572,2021-09-02,Assembly,"Be adopted. To Consent Calendar",10,0,0,2,12
1522866,1107945,2021-09-07,Assembly,"HR 75 Patterson Consent Calendar Second Day Regular Session",73,0,0,7,80
1523145,1166910,2022-03-09,Senate,"Be adopted. Ordered to third reading",6,0,0,1,7
1523145,1179434,2022-03-28,Senate,"Senate 3rd Reading SJR9 Lim贸n",30,1,0,9,40
1523145,1179435,2022-03-28,Senate,"Senate 3rd Reading SJR9 Lim贸n",37,0,0,3,40
1523145,1179436,2022-03-28,Senate,"Senate 3rd Reading SJR9 Lim贸n",30,0,0,10,40
1523145,1215878,2022-06-14,Assembly,"Be adopted. To Consent Calendar",10,0,0,2,12
1523145,1223049,2022-08-04,Assembly,"SJR 9 Lim贸n Senate Third Reading By Medina",61,0,0,19,80
1523145,1224182,2022-08-18,Senate,"Unfinished Business SJR9 Lim贸n et al. Concurrence",31,1,0,8,40
1544974,1189903,2022-04-19,Assembly,"Do pass as amended and be re-referred to the Committee on [Appropriations]",7,2,0,2,11
1544974,1206956,2022-05-19,Assembly,"Do pass",12,4,0,0,16
1544974,1210431,2022-05-26,Assembly,"AB 1594 Ting Assembly Third Reading",50,20,0,8,78
1544974,1216357,2022-06-14,Senate,"Do pass, but first be re-referred to the Committee on [Appropriations]",8,2,0,1,11
1544974,1216647,2022-06-16,Senate,"Do pass",5,1,0,1,7
1544974,1219386,2022-06-27,Senate,"Assembly 3rd Reading AB1594 Ting et al. By Hertzberg",26,9,0,5,40
1544975,1193207,2022-04-26,Assembly,"Do pass and be re-referred to the Committee on [Appropriations]",9,0,0,0,9
1544975,1206846,2022-05-19,Assembly,"Do pass",16,0,0,0,16
1544975,1207774,2022-05-23,Assembly,"AB 1595 Quirk-Silva Third Reading Urgency",73,0,0,5,78
1544975,1220036,2022-06-28,Senate,"Do pass as amended, but first amend, and re-refer to the Committee on [Appropriations]",6,0,0,1,7
1544975,1223220,2022-08-08,Senate,"Placed on suspense file",7,0,0,0,7
1544975,1223889,2022-08-11,Senate,"Do pass as amended",7,0,0,0,7
1544975,1224769,2022-08-24,Senate,"Assembly 3rd Reading AB1595 Quirk-Silva et al. By Umberg Urgency Clause",40,0,0,0,40
1544975,1225020,2022-08-25,Assembly,"AB 1595 Quirk-Silva Concurrence in Senate Amendments",75,0,0,5,80
1544976,1190685,2022-04-20,Assembly,"Do pass and be re-referred to the Committee on [Appropriations]",4,0,0,10,14
1544977,1170627,2022-03-15,Assembly,"Do pass and be re-referred to the Committee on [Appropriations]",2,4,0,0,6
1544977,1193190,2022-04-26,Assembly,"Do pass and be re-referred to the Committee on [Appropriations]",2,5,0,0,7
1544978,1165743,2022-03-08,Assembly,"Do pass as amended. To Consent Calendar",7,0,0,0,7
1544978,1172355,2022-03-17,Assembly,"AB 1598 Davies Consent Calendar Second Day Regular Session",70,0,0,6,76
1544978,1215853,2022-06-14,Senate,"Do pass",5,0,0,0,5
1544978,1223298,2022-08-08,Senate,"Special Consent AB1598",36,0,0,4,40
1544978,1223636,2022-08-11,Assembly,"AB 1598 Davies Concurrence in Senate Amendments",75,0,0,5,80
1544979,1165727,2022-03-08,Assembly,"Do pass and be re-referred to the Committee on [Appropriations]",2,5,0,0,7
1544979,1165728,2022-03-08,Assembly,Reconsideration,5,0,0,2,7
1544979,1193192,2022-04-26,Assembly,"Do pass and be re-referred to the Committee on [Appropriations]",2,5,0,0,7
1544980,1194158,2022-04-27,Assembly,"Do pass and be re-referred to the Committee on [Appropriations]",7,0,0,0,7
1544980,1206389,2022-05-19,Assembly,"Do pass as amended",16,0,0,0,16
1544980,1210530,2022-05-26,Assembly,"AB 1600 Nguyen Assembly Third Reading",75,0,0,3,78
1544980,1219867,2022-06-28,Senate,"Do pass, but first be re-referred to the Committee on [Appropriations] with the recommendation: To Consent Calendar",13,0,0,2,15
1544980,1222682,2022-08-01,Senate,"Placed on suspense file",7,0,0,0,7
1544981,1171441,2022-03-16,Assembly,"Do pass and be re-referred to the Committee on [Appropriations]",5,2,0,0,7
1544981,1206504,2022-05-19,Assembly,"Do pass as amended",12,4,0,0,16
1544981,1210587,2022-05-26,Assembly,"AB 1601 Akilah Weber Assembly Third Reading",51,19,0,8,78
1544981,1215802,2022-06-13,Senate,"Do pass, but first be re-referred to the Committee on [Governmental Organization]",4,1,0,0,5
1544981,1219872,2022-06-28,Senate,"Do pass as amended, but first amend, and re-refer to the Committee on [Appropriations]",9,3,0,3,15
1544981,1222642,2022-08-01,Senate,"Placed on suspense file",7,0,0,0,7
1544981,1223494,2022-08-11,Senate,"Do pass as amended",5,2,0,0,7
1544981,1225804,2022-08-29,Senate,"Assembly 3rd Reading AB1601 Akilah Weber By Durazo",28,10,0,2,40
1544981,1225805,2022-08-30,Assembly,"AB 1601 Akilah Weber Concurrence in Senate Amendments",55,18,0,7,80
1544982,1170615,2022-03-15,Assembly,"Do pass and be re-referred to the Committee on [Appropriations]",11,0,0,1,12
1544982,1206358,2022-05-19,Assembly,"Do pass as amended",12,0,0,4,16
1544982,1210506,2022-05-26,Assembly,"AB 1602 McCarty Third Reading Urgency",67,0,0,11,78
1544982,1216308,2022-06-15,Senate,"Do pass, but first be re-referred to the Committee on [Labor, Public Employment and Retirement ]",5,0,0,2,7
1544982,1220623,2022-06-29,Senate,"Do pass, but first be re-referred to the Committee on [Appropriations]",5,0,0,0,5
1544982,1222831,2022-08-01,Senate,"Placed on suspense file",7,0,0,0,7
1544983,1174509,2022-03-22,Assembly,"Do pass and be re-referred to the Committee on [Appropriations]",2,4,0,1,7
1544984,1120728,2022-01-06,Assembly,"Be adopted. To Consent Calendar",11,0,0,1,12
1544984,1124334,2022-01-14,Assembly,"ACR 111 Choi Consent Calendar Second Day",62,0,0,14,76
1544984,1140891,2022-02-10,Senate,"Special Consent ACR111",37,0,0,3,40
1544985,1120730,2022-01-06,Assembly,"Be adopted. To third reading",11,0,0,1,12
1544985,1143393,2022-02-14,Senate,"Assembly 3rd Reading ACR112 Grayson et al. By Dodd",36,0,0,4,40
1544986,1181257,2022-03-31,Assembly,"Be adopted. To Consent Calendar",10,0,0,1,11
1544986,1186258,2022-04-07,Assembly,"ACR 113 Nguyen Consent Calendar Second Day Regular Session",65,0,0,12,77
1544986,1198287,2022-05-02,Senate,"Assembly 3rd Reading ACR113 Nguyen et al. By Dahle",36,0,0,4,40
1544987,1195745,2022-04-28,Assembly,"Be adopted. To Consent Calendar",8,0,0,3,11
1544987,1200694,2022-05-05,Assembly,"ACR 114 Nguyen Consent Calendar Second Day Regular Session",61,0,0,17,78
1544987,1207739,2022-05-23,Senate,"Special Consent ACR114",36,0,0,4,40
1544988,1195727,2022-04-28,Assembly,"Be adopted. To Consent Calendar",8,0,0,3,11
1544988,1210930,2022-05-31,Senate,"Assembly 3rd Reading ACR115 Nguyen et al",32,0,0,8,40
1544989,1221280,2022-06-30,Assembly,"Be adopted. To Consent Calendar",7,0,0,4,11
1544989,1223046,2022-08-04,Assembly,"ACR 116 Nguyen Consent Calendar Second Day",76,0,0,4,80
1544990,1120722,2022-01-06,Assembly,"Be adopted. To third reading",11,0,0,1,12
1544990,1140919,2022-02-10,Senate,"Special Consent ACR117",37,0,0,3,40
1544991,1183706,2022-04-05,Senate,"Do pass, but first be re-referred to the Committee on [Governmental Organization]",4,0,0,1,5
1544991,1193416,2022-04-26,Senate,"Do pass, but first be re-referred to the Committee on [Judiciary] with the recommendation: To Consent Calendar",13,0,0,2,15
1544991,1194385,2022-04-26,Senate,"Do pass, but first be re-referred to the Committee on [Appropriations] with the recommendation: To Consent Calendar",13,0,0,2,15
1544991,1204612,2022-05-16,Senate,"Placed on suspense file",6,0,0,1,7
1544992,1190672,2022-04-20,Senate,"Do pass, but first be re-referred to the Committee on [Appropriations]",5,1,0,1,7
1544992,1198261,2022-05-02,Senate,"Placed on suspense file",7,0,0,0,7
1544992,1206231,2022-05-19,Senate,"Do pass as amended",5,1,0,1,7
1544992,1208531,2022-05-24,Senate,"Senate 3rd Reading SB830 Portantino et al",28,5,0,7,40
1544993,1189886,2022-04-18,Senate,"Do pass as amended, but first amend, and re-refer to the Committee on [Judiciary]",5,0,0,0,5
1544993,1194172,2022-04-26,Senate,"Do pass, but first be re-referred to the Committee on [Appropriations]",9,2,0,0,11
1544993,1204691,2022-05-16,Senate,"Placed on suspense file",6,0,0,1,7
1544994,1183786,2022-04-05,Senate,"Do pass as amended, but first amend, and re-refer to the Committee on [Appropriations] with the recommendation: To Consent Calendar",8,0,0,1,9
1544994,1192204,2022-04-25,Senate,"Placed on suspense file",5,0,0,2,7
1544996,1124333,2022-01-14,Senate,"Senate 3rd Reading SCR62 Bradford et al",29,0,0,11,40
1544996,1134599,2022-02-03,Assembly,"Be adopted. To Consent Calendar",9,0,0,3,12
1544996,1140909,2022-02-10,Assembly,"SCR 62 Bradford Consent Calendar Second Day Regular Session",65,0,0,10,75
1544996,1162282,2022-03-03,Senate,"Unfinished Business SCR62 Bradford et al. Concurrence",38,0,0,2,40
1544997,1129008,2022-01-26,Senate,"Senate 3rd Reading SCR63 Hurtado et al",37,0,0,3,40
1544997,1154477,2022-02-24,Assembly,"Be adopted. To Consent Calendar",9,0,0,2,11
1544997,1162260,2022-03-03,Assembly,"SCR 63 Hurtado Consent Calendar Second Day Regular Session",70,0,0,6,76
1544998,1123768,2022-01-12,Senate,"Be adopted as amended",7,1,0,3,11
1544998,1126327,2022-01-20,Senate,"Senate 3rd Reading SR63 Skinner et al",26,5,0,9,40
1545614,1171439,2022-03-16,Assembly,"Do pass and be re-referred to the Committee on [Appropriations]",4,0,0,2,6
1545614,1206320,2022-05-19,Assembly,"Do pass",12,2,0,2,16
1545614,1210433,2022-05-26,Assembly,"AB 1604 Holden Assembly Third Reading",57,11,0,10,78
1545614,1218603,2022-06-22,Senate,"Do pass, but first be re-referred to the Committee on [Governmental Organization]",4,0,0,1,5
1545614,1219965,2022-06-28,Senate,"Do pass as amended, but first amend, and re-refer to the Committee on [Appropriations]",9,4,0,2,15
1545614,1222701,2022-08-01,Senate,"Placed on suspense file",7,0,0,0,7
1545614,1223953,2022-08-11,Senate,"Do pass as amended",5,2,0,0,7
1545614,1224746,2022-08-24,Senate,"Assembly 3rd Reading AB1604 Holden By Kamlager",30,8,0,2,40
1545614,1225024,2022-08-25,Assembly,"AB 1604 Holden Concurrence in Senate Amendments",59,1,0,20,80
1545616,1183664,2022-04-05,Assembly,"Do pass and be re-referred to the Committee on [Military and Veterans Affairs]",11,0,0,1,12
1545616,1193432,2022-04-26,Assembly,"Do pass and be re-referred to the Committee on [Appropriations]",9,0,0,0,9
1545618,1184747,2022-04-06,Assembly,"Do pass as amended and be re-referred to the Committee on [Public Safety]",5,2,0,1,8
1545618,1189851,2022-04-19,Assembly,"Do pass",5,2,0,0,7
1545618,1204686,2022-05-16,Assembly,"AB 1608 Gipson Assembly Third Reading",44,20,0,14,78
1545618,1217866,2022-06-22,Senate,"Do pass, but first be re-referred to the Committee on [Public Safety]",4,1,0,0,5
1545618,1220871,2022-06-28,Senate,"Do pass as amended",4,1,0,0,5
1545618,1223202,2022-08-08,Senate,"Placed on suspense file",7,0,0,0,7
1545618,1223836,2022-08-11,Senate,"Do pass",5,2,0,0,7
1545618,1225474,2022-08-30,Senate,"Assembly 3rd Reading AB1608 Gipson et al. By Pan",13,14,0,13,40
1545618,1225475,2022-08-30,Senate,"Assembly 3rd Reading AB1608 Gipson et al. By Pan Reconsider",39,0,0,1,40
1545620,1169415,2022-03-14,Senate,"Do pass as amended, but first amend, and re-refer to the Committee on [Appropriations]",13,0,0,1,14
1545620,1182499,2022-04-04,Senate,"Placed on suspense file",6,0,0,1,7
1545620,1206929,2022-05-19,Senate,"Do pass",7,0,0,0,7
1545620,1209273,2022-05-25,Senate,"Special Consent SB833 Dodd et al",39,0,0,1,40
1545620,1220874,2022-06-29,Assembly,"Do pass as amended, and be re-referred to the Committee on [Appropriations] with recommendation: To Consent Calendar",13,0,0,2,15
1546852,1179498,2022-03-21,Assembly,"Do pass and be re-referred to the Committee on [Judiciary]",11,0,0,0,11
1546852,1183833,2022-04-05,Assembly,"Do pass as amended and be re-referred to the Committee on [Appropriations]",10,0,0,0,10
1546852,1206319,2022-05-19,Assembly,"Do pass",16,0,0,0,16
1546852,1210644,2022-05-25,Assembly,"AB 1611 Davies Assembly Third Reading",76,0,0,2,78
1546852,1215827,2022-06-14,Senate,"Do pass as amended, but first amend, and re-refer to the Committee on [Judiciary]",5,0,0,4,9
1546852,1217875,2022-06-21,Senate,"Do pass as amended, but first amend, and re-refer to the Committee on [Appropriations]",8,1,0,2,11
1546852,1217876,2022-06-21,Senate,"[06-22-2022] set for [First] hearing: Reconsideration of favorable vote granted",11,0,0,0,11
1546852,1217877,2022-06-21,Senate,"Do pass as amended, but first amend, and re-refer to the Committee on [Appropriations]",4,0,0,7,11
1546852,1229563,2022-06-21,Senate,"[10-26-2022] set for [First] hearing: Reconsideration of favorable vote granted",11,0,0,0,11
1546852,1229872,2022-06-21,Senate,"[11-09-2022] set for [First] hearing: Reconsideration of favorable vote granted",11,0,0,0,11
1546855,1170613,2022-03-15,Assembly,"Do pass",2,1,0,3,6
1546855,1193276,2022-04-26,Assembly,"Do pass",7,0,0,0,7
1546855,1210285,2022-05-26,Assembly,"AB 1613 Irwin Assembly Third Reading",73,0,0,5,78
1546855,1217375,2022-06-21,Senate,"Do pass, but first be re-referred to the Committee on [Appropriations]",3,0,0,2,5
1546855,1222915,2022-08-01,Senate,"Placed on suspense file",7,0,0,0,7
1546855,1223919,2022-08-11,Senate,"Do pass",7,0,0,0,7
1546855,1224465,2022-08-23,Senate,"Special Consent AB1613",40,0,0,0,40
1546857,1175523,2022-03-23,Assembly,"Do pass and be re-referred to the Committee on [Human Services] with recommendation: To Consent Calendar",8,0,0,0,8
1546857,1193289,2022-04-26,Assembly,"Do pass and be re-referred to the Committee on [Appropriations] with recommendation: To Consent Calendar",7,0,0,1,8
1546857,1206264,2022-05-19,Assembly,"Do pass",16,0,0,0,16
1546857,1210413,2022-05-25,Assembly,"AB 1615 Ting Assembly Third Reading",76,0,0,2,78
1546857,1215860,2022-06-13,Senate,"Do pass, but first be re-referred to the Committee on [Housing]",5,0,0,0,5
1546857,1217936,2022-06-21,Senate,"Do pass, but first be re-referred to the Committee on [Appropriations] with the recommendation: To Consent Calendar",8,0,0,1,9
1546860,1122874,2022-01-10,Assembly,"AJR 22 GABRIEL Assembly Third Reading",54,2,0,20,76
1546860,1165723,2022-03-08,Senate,"Be adopted. Ordered to third reading",4,0,0,1,5
1546860,1225392,2022-08-29,Senate,"Assembly 3rd Reading AJR22 Gabriel et al. By Becker",27,0,0,13,40
1546861,1124163,2022-01-13,Assembly,"Be adopted. To third reading",7,2,0,1,10
1546862,1190536,2022-04-20,Senate,"Do pass, but first be re-referred to the Committee on [Public Safety]",4,0,0,1,5
1546862,1194400,2022-04-26,Senate,"Do pass, but first be re-referred to the Committee on [Appropriations]",4,0,0,1,5
1546862,1201506,2022-05-09,Senate,"Placed on suspense file",7,0,0,0,7
1546862,1206454,2022-05-19,Senate,"Do pass",5,2,0,0,7
1546862,1207872,2022-05-23,Senate,"Senate 3rd Reading SB834 Wiener et al",28,0,0,12,40
1546862,1215734,2022-06-13,Assembly,"Do pass and be re-referred to the Committee on [Public Safety]",7,0,0,4,11
1546862,1220078,2022-06-28,Assembly,"Do pass as amended and be re-referred to the Committee on [Appropriations]",5,0,0,2,7
1546862,1223550,2022-08-11,Assembly,"Do pass",12,0,0,4,16
1546862,1224335,2022-08-22,Assembly,"SB 834 Wiener Senate Third Reading By Haney",59,2,0,19,80
1546862,1224626,2022-08-23,Senate,"Unfinished Business SB834 Wiener et al. Concurrence",31,0,0,9,40
1548063,1180276,2022-03-30,Assembly,"Do pass and be re-referred to the Committee on [Appropriations]",19,0,0,3,22
1548063,1194193,2022-04-27,Assembly,"Do pass. To Consent Calendar",15,0,0,1,16
1548063,1200637,2022-05-05,Assembly,"AB 1617 Stone Consent Calendar Second Day Regular Session",61,0,0,17,78
1548064,1174539,2022-03-22,Assembly,"Do pass and be re-referred to the Committee on [Appropriations] with recommendation: To Consent Calendar",14,0,0,0,14
1548064,1206237,2022-05-19,Assembly,"Do pass",16,0,0,0,16
1548064,1210533,2022-05-25,Assembly,"AB 1618 Aguiar-Curry Assembly Third Reading",76,0,0,2,78
1548064,1215028,2022-06-08,Senate,"Do pass as amended, but first amend, and re-refer to the Committee on [Appropriations] with the recommendation: To Consent Calendar",9,0,0,2,11
1548064,1219464,2022-06-27,Senate,"Placed on suspense file",6,0,0,1,7
1548065,1162242,2022-03-03,Assembly,"Be adopted. To Consent Calendar",9,0,0,2,11
1548065,1169416,2022-03-14,Assembly,"ACR 119 Boerner Horvath Consent Calendar Second Day",68,0,0,8,76
1548065,1185693,2022-04-07,Senate,"Special Consent ACR119",37,0,0,3,40
1548066,1189911,2022-04-18,Senate,"Do pass, but first be re-referred to the Committee on [Appropriations] with the recommendation: To Consent Calendar",5,0,0,0,5
1548066,1201466,2022-05-09,Senate,"Consent Calendar SB835",33,0,0,7,40
1548066,1217991,2022-06-22,Assembly,"Do pass and be re-referred to the Committee on [Appropriations] with recommendation: To Consent Calendar",7,0,0,0,7
1548066,1223011,2022-08-03,Assembly,"Do pass. To Consent Calendar",15,0,0,1,16
1548066,1224014,2022-08-11,Assembly,"SB 835 Newman Consent Calendar Second Day Regular Session",76,0,0,4,80
1548067,1165734,2022-03-08,Senate,"Do pass, but first be re-referred to the Committee on [Judiciary]",4,0,0,1,5
1548067,1179136,2022-03-29,Senate,"Do pass",9,0,0,2,11
1548067,1198324,2022-05-02,Senate,"Senate 3rd Reading SB836 Wiener Urgency Clause",28,0,0,12,40
1548067,1211858,2022-06-01,Assembly,"Do pass and be re-referred to the Committee on [Judiciary]",5,0,0,2,7
1548067,1215062,2022-06-08,Assembly,"Do pass",9,0,0,1,10
1548067,1223050,2022-08-04,Assembly,"SB 836 Wiener Third Reading Urgency By Kalra",71,0,0,9,80
1548068,1174552,2022-03-22,Senate,"Do pass, but first be re-referred to the Committee on [Appropriations] with the recommendation: To Consent Calendar",17,0,0,0,17
1548068,1182521,2022-04-04,Senate,"Placed on suspense file",6,0,0,1,7
1548068,1206570,2022-05-19,Senate,"Do pass",7,0,0,0,7
1548068,1209226,2022-05-25,Senate,"Special Consent SB837",39,0,0,1,40
1548068,1217377,2022-06-20,Assembly,"Do pass and be re-referred to the Committee on [Appropriations] with recommendation: To Consent Calendar",14,0,0,1,15
1548068,1223628,2022-08-11,Assembly,"Do pass",16,0,0,0,16
1548068,1224274,2022-08-22,Assembly,"SB 837 Umberg Senate Third Reading By Ramos",77,0,0,3,80
1548068,1225241,2022-08-30,Senate,"Special Consent SB837",38,0,0,2,40
1548069,1195726,2022-04-27,Senate,"Do pass as amended, but first amend, and re-refer to the Committee on [Appropriations]",9,1,0,1,11
1548069,1204587,2022-05-16,Senate,"Placed on suspense file",6,0,0,1,7
1548069,1206580,2022-05-19,Senate,"Do pass",5,2,0,0,7
1548069,1208485,2022-05-24,Senate,"Senate 3rd Reading SB838 Pan et al",27,8,0,5,40
1548069,1219914,2022-06-28,Assembly,"Do pass as amended and be re-referred to the Committee on [Appropriations]",12,1,0,2,15
1548069,1221225,2022-06-28,Assembly,"Do pass and be re-referred to the Committee on [Appropriations]",12,1,0,2,15
1548069,1223827,2022-08-11,Assembly,"Do pass as amended",12,4,0,0,16
1548069,1225062,2022-08-29,Assembly,"SB 838 Pan Senate Third Reading By Blanca Rubio",61,10,0,9,80
1548069,1225270,2022-08-30,Senate,"Unfinished Business SB838 Pan et al. Concurrence",31,7,0,2,40
1550053,1169421,2022-03-14,Senate,"Do pass as amended, but first amend, and re-refer to the Committee on [Appropriations]",12,0,0,2,14
1550053,1182556,2022-04-04,Senate,"Placed on suspense file",6,0,0,1,7
1550054,1183653,2022-04-05,Senate,"Do pass, but first be re-referred to the Committee on [Appropriations]",1,3,0,1,5
1550054,1183654,2022-04-05,Senate,"[First] hearing set for [04-05-2022]: Failed passage in Committee. Reconsideration granted",4,0,0,1,5
1551313,1184718,2022-04-06,Assembly,"Do pass as amended, and be re-referred to the Committee on [Appropriations] with recommendation: To Consent Calendar",7,0,0,0,7
1551313,1194224,2022-04-27,Assembly,"Do pass. To Consent Calendar",15,0,0,1,16
1551313,1200638,2022-05-05,Assembly,"AB 1619 Cervantes Consent Calendar Second Day Regular Session",61,0,0,17,78
1551313,1215555,2022-06-13,Senate,"Do pass, but first be re-referred to the Committee on [Appropriations] with the recommendation: To Consent Calendar",4,0,0,1,5
1551313,1221206,2022-06-30,Senate,"Consent Calendar AB1619",37,0,0,3,40
1551314,1194407,2022-04-27,Assembly,"Do pass and be re-referred to the Committee on [Appropriations] with recommendation: To Consent Calendar",10,0,0,1,11
1551315,1189866,2022-04-19,Assembly,"Do pass and be re-referred to the Committee on [Appropriations]",5,2,0,0,7
1551315,1206532,2022-05-19,Assembly,"Do pass",12,4,0,0,16
1551315,1210490,2022-05-25,Assembly,"AB 1621 Gipson Assembly Third Reading",63,0,0,15,78
1551315,1214998,2022-06-08,Senate,"Do pass, but first be re-referred to the Committee on [Appropriations]",4,0,0,1,5
1551315,1216602,2022-06-16,Senate,"Do pass",6,0,0,1,7
1551315,1219432,2022-06-27,Senate,"Assembly 3rd Reading AB1621 Gipson et al. By Portantino Urgency Clause",31,0,0,9,40
1551315,1221560,2022-06-29,Assembly,"AB 1621 Gipson Concurrence - Urgency Added",62,14,0,4,80
1551317,1200483,2022-05-05,Assembly,"Do pass and be re-referred to the Committee on [Appropriations]",10,1,0,0,11
1551319,1158881,2022-03-01,Assembly,"Do pass and be re-referred to the Committee on [Appropriations]",12,0,0,0,12
1551319,1180277,2022-03-30,Assembly,"Do pass. To Consent Calendar",12,0,0,3,15
1551319,1186255,2022-04-07,Assembly,"AB 1625 Medina Consent Calendar Second Day Regular Session",65,0,0,12,77
1551319,1215034,2022-06-08,Senate,"Do pass, but first be re-referred to the Committee on [Appropriations] with the recommendation: To Consent Calendar",7,0,0,0,7
1551319,1219426,2022-06-27,Senate,"Consent Calendar AB1625",37,0,0,3,40
1551321,1179211,2022-03-29,Assembly,"Do pass as amended and be re-referred to the Committee on [Public Safety]",14,0,0,1,15
1551321,1206801,2022-05-19,Assembly,"Do pass",16,0,0,0,16
1551321,1210583,2022-05-25,Assembly,"AB 1627 Ramos Assembly Third Reading",76,0,0,2,78
1551321,1221338,2022-06-29,Senate,"Do pass, but first be re-referred to the Committee on [Appropriations] with the recommendation: To Consent Calendar",10,0,0,1,11
1551321,1222702,2022-08-01,Senate,"Placed on suspense file",7,0,0,0,7
1551322,1199123,2022-05-03,Assembly,"Do pass as amended",9,0,0,2,11
1551322,1204123,2022-05-12,Assembly,"AB 1628 Ramos Assembly Third Reading",64,0,0,14,78
1551322,1220662,2022-06-28,Senate,"Do pass as amended",10,0,0,1,11
1551322,1224287,2022-08-22,Senate,"Assembly 3rd Reading AB1628 Ramos et al. By Ochoa Bogh",40,0,0,0,40
1551322,1224595,2022-08-23,Assembly,"AB 1628 Ramos Concurrence in Senate Amendments",76,0,0,4,80
1551324,1165744,2022-03-08,Assembly,"Do pass as amended and be re-referred to the Committee on [Appropriations]",5,1,0,1,7
1551324,1206366,2022-05-19,Assembly,"Do pass as amended",12,4,0,0,16
1551324,1210291,2022-05-26,Assembly,"AB 1630 Akilah Weber Assembly Third Reading",47,21,0,10,78
1551324,1217392,2022-06-21,Senate,"Do pass, but first be re-referred to the Committee on [Appropriations]",4,0,0,1,5
1551324,1222821,2022-08-01,Senate,"Placed on suspense file",7,0,0,0,7
1551325,1194266,2022-04-27,Assembly,"Do pass and be re-referred to the Committee on [Appropriations] with recommendation: To Consent Calendar",6,0,0,1,7
1551325,1206775,2022-05-19,Assembly,"Do pass",16,0,0,0,16
1551325,1210599,2022-05-25,Assembly,"AB 1631 Cervantes Assembly Third Reading",76,0,0,2,78
1551325,1215533,2022-06-13,Senate,"Do pass, but first be re-referred to the Committee on [Appropriations]",4,0,0,1,5
1551325,1219510,2022-06-27,Senate,"Placed on suspense file",6,0,0,1,7
1551325,1223398,2022-08-11,Senate,"Do pass",7,0,0,0,7
1551325,1225842,2022-08-30,Senate,"Assembly 3rd Reading AB1631 Cervantes By Gonzalez",40,0,0,0,40
1551326,1179132,2022-03-29,Assembly,"Do pass and be re-referred to the Committee on [Health]",15,0,0,3,18
1551326,1193329,2022-04-26,Assembly,"Do pass and be re-referred to the Committee on [Appropriations]",12,0,0,3,15
1551326,1203348,2022-05-11,Assembly,"Do pass",12,0,0,4,16
1551326,1210399,2022-05-25,Assembly,"AB 1632 Akilah Weber Assembly Third Reading",62,0,0,16,78
1551326,1217308,2022-06-20,Senate,"Do pass, but first be re-referred to the Committee on [Health]",10,0,0,4,14
1551326,1221327,2022-06-29,Senate,"Do pass as amended, but first amend, and re-refer to the Committee on [Appropriations]",8,0,0,3,11
1551326,1224257,2022-08-22,Senate,"Assembly 3rd Reading AB1632 Akilah Weber et al. By Bates",39,0,0,1,40
1551326,1224519,2022-08-23,Assembly,"AB 1632 Akilah Weber Concurrence in Senate Amendments",75,0,0,5,80
1551327,1124331,2022-01-14,Assembly,"Be adopted. To Consent Calendar",11,0,0,1,12
1551327,1126338,2022-01-20,Assembly,"ACR 120 Bauer-Kahan Consent Calendar Second Day Regular Session",62,0,0,14,76
1551327,1140899,2022-02-10,Senate,"Special Consent ACR120",37,0,0,3,40
1551328,1218660,2022-06-23,Assembly,"Be adopted. To Consent Calendar",8,0,0,4,12
1551328,1221576,2022-06-29,Assembly,"ACR 121 Seyarto Consent Calendar Second Day Regular Session",78,0,0,2,80
1551328,1224021,2022-08-11,Senate,"Special Consent ACR121",38,0,0,2,40
1551329,1218619,2022-06-23,Assembly,"Be adopted. To Consent Calendar",8,0,0,4,12
1551329,1221700,2022-06-29,Assembly,"HR 79 Boerner Horvath Consent Calendar Second Day Regular Session",78,0,0,2,80
1551331,1179147,2022-03-29,Senate,"Do pass, but first be re-referred to the Committee on [Health] with the recommendation: To Consent Calendar",4,0,0,1,5
1551331,1191279,2022-04-20,Senate,"Do pass as amended, but first amend, and re-refer to the Committee on [Appropriations] with the recommendation: To Consent Calendar",9,0,0,2,11
1551331,1201473,2022-05-09,Senate,"Placed on suspense file",7,0,0,0,7
1551331,1206662,2022-05-19,Senate,"Do pass",7,0,0,0,7
1551331,1209389,2022-05-25,Senate,"Special Consent SB842",39,0,0,1,40
1551331,1215839,2022-06-14,Assembly,"Do pass and be re-referred to the Committee on [Health]",7,0,0,1,8
1551331,1219865,2022-06-28,Assembly,"Do pass and be re-referred to the Committee on [Appropriations] with recommendation: To Consent Calendar",15,0,0,0,15
1551331,1223650,2022-08-11,Assembly,"Do pass",16,0,0,0,16
1551331,1225663,2022-08-31,Senate,"Unfinished Business SB842 Dodd et al. Concurrence",39,0,0,1,40
1551331,1225664,2022-08-31,Assembly,"SB 842 Dodd Senate Third Reading By Aguiar-Curry",80,0,0,0,80
1551332,1181309,2022-03-31,Senate,"Do pass, but first be re-referred to the Committee on [Appropriations]",5,0,0,0,5
1551332,1189341,2022-04-18,Senate,"Placed on suspense file",7,0,0,0,7
1551332,1206744,2022-05-19,Senate,"Do pass",7,0,0,0,7
1551332,1208492,2022-05-24,Senate,"Senate 3rd Reading SB843 Glazer et al",37,0,0,3,40
1551332,1221292,2022-06-30,Assembly,"Do pass and be re-referred to the Committee on [Appropriations]",11,0,0,0,11
1551332,1223985,2022-08-11,Assembly,"Do pass as amended",16,0,0,0,16
1551332,1224964,2022-08-25,Assembly,"SB 843 Glazer Senate Third Reading Amend By VALLADARES Set #1 Motion to Lay on the Table",47,17,0,16,80
1554347,1158885,2022-03-01,Assembly,"Do pass and be re-referred to the Committee on [Privacy and Consumer Protection]",12,0,0,0,12
1554347,1193322,2022-04-26,Assembly,"Do pass and be re-referred to the Committee on [Appropriations]",9,0,0,0,9
1554347,1203392,2022-05-11,Assembly,"Do pass",16,0,0,0,16
1554347,1204651,2022-05-16,Assembly,"AB 1633 Seyarto Assembly Third Reading",70,0,0,8,78
1554347,1215007,2022-06-08,Senate,"Do pass, but first be re-referred to the Committee on [Military and Veterans Affairs] with the recommendation: To Consent Calendar",7,0,0,0,7
1554347,1219884,2022-06-28,Senate,"Do pass as amended, but first amend, and re-refer to the Committee on [Appropriations] with the recommendation: To Consent Calendar",6,0,0,1,7
1554347,1223171,2022-08-08,Senate,"Consent Calendar AB1633",36,0,0,4,40
1554347,1224032,2022-08-11,Assembly,"AB 1633 Seyarto Concurrence in Senate Amendments",76,0,0,4,80
1554349,1183815,2022-04-05,Assembly,"Do pass and be re-referred to the Committee on [Appropriations]",16,0,0,2,18
1554350,1189985,2022-04-19,Assembly,"Do pass as amended and be re-referred to the Committee on [Appropriations]",19,0,0,0,19
1554350,1203341,2022-05-11,Assembly,"Do pass",16,0,0,0,16
1554350,1210621,2022-05-25,Assembly,"AB 1636 Akilah Weber Assembly Third Reading",76,0,0,2,78
1554350,1217363,2022-06-20,Senate,"Do pass, but first be re-referred to the Committee on [Appropriations]",13,0,0,1,14
1554350,1224237,2022-08-18,Senate,"Assembly 3rd Reading AB1636 Akilah Weber et al. By Pan",38,0,0,2,40
1554351,1179563,2022-03-29,Assembly,"Do pass as amended, and be re-referred to the Committee on [Appropriations] with recommendation: To Consent Calendar",7,0,0,0,7
1554351,1194373,2022-04-27,Assembly,"Do pass. To Consent Calendar",15,0,0,1,16
1554351,1200639,2022-05-05,Assembly,"AB 1637 Cooper Consent Calendar Second Day Regular Session",61,0,0,17,78
1554351,1220767,2022-06-28,Senate,"Do pass as amended, but first amend, and re-refer to the Committee on [Appropriations]",4,0,0,1,5
1554351,1224284,2022-08-22,Senate,"Assembly 3rd Reading AB1637 Cooper By Glazer Urgency Clause",38,0,0,2,40
1554351,1224555,2022-08-23,Assembly,"AB 1637 Cooper Concurrence in Senate Amendments",77,0,0,3,80
1554352,1181264,2022-03-28,Assembly,"Do pass as amended and be re-referred to the Committee on [Appropriations]",9,4,0,2,15
1554354,1179336,2022-03-21,Assembly,"Do pass as amended and be re-referred to the Committee on [Appropriations]",8,1,0,2,11
1554354,1206349,2022-05-19,Assembly,"Do pass as amended",13,1,0,2,16
1554354,1210262,2022-05-26,Assembly,"AB 1640 Ward Assembly Third Reading",71,0,0,7,78
1554354,1217890,2022-06-22,Senate,"Do pass, but first be re-referred to the Committee on [Natural Resources and Water]",6,0,0,1,7
1554354,1220027,2022-06-28,Senate,"Do pass, but first be re-referred to the Committee on [Appropriations]",8,0,0,1,9
1554354,1222672,2022-08-01,Senate,"Placed on suspense file",7,0,0,0,7
1554355,1170628,2022-03-15,Assembly,"Do pass and be re-referred to the Committee on [Appropriations]",6,0,0,0,6
1554355,1180248,2022-03-30,Assembly,"Do pass. To Consent Calendar",12,0,0,3,15
1554355,1186265,2022-04-07,Assembly,"AB 1641 Maienschein Consent Calendar Second Day Regular Session",65,0,0,12,77
1554355,1210936,2022-05-31,Senate,"Do pass and be ordered to the Consent Calendar",5,0,0,0,5
1554355,1211863,2022-05-31,Senate,"Do pass, but first be re-referred to the Committee on [Appropriations] with the recommendation: To Consent Calendar",5,0,0,0,5
1554355,1219391,2022-06-27,Senate,"Consent Calendar AB1641",37,0,0,3,40
1554355,1221563,2022-06-29,Assembly,"AB 1641 Maienschein Concurrence in Senate Amendments",77,0,0,3,80
1554356,1179464,2022-03-21,Assembly,"Do pass as amended and be re-referred to the Committee on [Appropriations]",8,1,0,2,11
1554356,1194379,2022-04-27,Assembly,"Do pass",14,0,0,2,16
1554356,1200640,2022-05-05,Assembly,"AB 1642 Salas Assembly Third Reading",55,2,0,21,78
1554356,1220624,2022-06-29,Senate,"Do pass as amended, but first amend, and re-refer to the Committee on [Appropriations]",7,0,0,0,7
1554356,1224913,2022-08-25,Senate,"Assembly 3rd Reading AB1642 Salas By Glazer",40,0,0,0,40
1554356,1225035,2022-08-29,Assembly,"AB 1642 Salas Concurrence in Senate Amendments",67,2,0,11,80
1554357,1191338,2022-04-20,Assembly,"Do pass and be re-referred to the Committee on [Appropriations]",6,0,0,1,7
1554357,1206724,2022-05-19,Assembly,"Do pass as amended",13,0,0,3,16
1554357,1210289,2022-05-26,Assembly,"AB 1643 Robert Rivas Assembly Third Reading",65,0,0,13,78
1554357,1215902,2022-06-13,Senate,"Do pass as amended, but first amend, and re-refer to the Committee on [Appropriations]",5,0,0,0,5
1554357,1219503,2022-06-27,Senate,"Placed on suspense file",6,0,0,1,7
1554357,1223818,2022-08-11,Senate,"Do pass as amended",5,0,0,2,7
1554357,1224852,2022-08-24,Senate,"Assembly 3rd Reading AB1643 Robert Rivas et al. By Laird",33,1,0,6,40
1554357,1224873,2022-08-25,Assembly,"AB 1643 Robert Rivas Concurrence in Senate Amendments",68,0,0,12,80
1554358,1191303,2022-04-20,Assembly,"Do pass and be re-referred to the Committee on [Appropriations] with recommendation: To Consent Calendar",7,0,0,0,7
1554358,1199996,2022-05-04,Assembly,"Do pass. To Consent Calendar",14,0,0,2,16
1554358,1204090,2022-05-12,Assembly,"AB 1644 Flora Consent Calendar Second Day Regular Session",65,0,0,13,78
1554358,1215046,2022-06-08,Senate,"Do pass, but first be re-referred to the Committee on [Appropriations] with the recommendation: To Consent Calendar",5,0,0,0,5
1554358,1223191,2022-08-08,Senate,"Consent Calendar AB1644 Flora et al. Urgency Clause",36,0,0,4,40
1554358,1224089,2022-08-15,Assembly,"AB 1644 Flora Concurrence in Senate Amendments",76,0,0,4,80
1554359,1174555,2022-03-22,Assembly,"Do pass and be re-referred to the Committee on [Appropriations]",15,0,0,0,15
1554359,1194332,2022-04-27,Assembly,"Do pass. To Consent Calendar",15,0,0,1,16
1554359,1200641,2022-05-05,Assembly,"AB 1645 Petrie-Norris Consent Calendar Second Day Regular Session",61,0,0,17,78
1554359,1211842,2022-06-01,Senate,"Do pass as amended, but first amend, and re-refer to the Committee on [Appropriations] with the recommendation: To Consent Calendar",8,0,0,1,9
1554359,1219494,2022-06-27,Senate,"Consent Calendar AB1645 Petrie-Norris Urgency Clause",37,0,0,3,40
1554359,1221303,2022-06-30,Assembly,"AB 1645 Petrie-Norris Concurrence in Senate Amendments",78,0,0,2,80
1554360,1170580,2022-03-15,Assembly,"Be adopted. To third reading",9,0,0,1,10
1554360,1218618,2022-06-23,Assembly,"AJR 23 Boerner Horvath Assembly Third Reading",69,0,0,11,80
1554360,1224096,2022-08-16,Senate,"Assembly 3rd Reading AJR23 Boerner Horvath et a By Skinner",37,0,0,3,40
1554361,1193398,2022-04-26,Senate,"Do pass, but first be re-referred to the Committee on [Appropriations] with the recommendation: To Consent Calendar",13,0,0,2,15
1554361,1204079,2022-05-12,Senate,"Consent Calendar SB844",35,0,0,5,40
1554361,1219363,2022-06-27,Assembly,"Do pass and be re-referred to the Committee on [Appropriations]",7,0,0,0,7
1554361,1223930,2022-08-11,Assembly,"Do pass",16,0,0,0,16
1554361,1225748,2022-08-31,Assembly,"SB 844 Min Senate Third Reading By Aguiar-Curry",79,0,0,1,80
1559214,1179199,2022-03-29,Assembly,"Do pass as amended and be re-referred to the Committee on [Appropriations]",16,0,0,2,18
1559214,1194135,2022-04-27,Assembly,"Do pass. To Consent Calendar",15,0,0,1,16
1559214,1200642,2022-05-05,Assembly,"AB 1646 Chen Consent Calendar Second Day Regular Session",61,0,0,17,78
1559214,1214382,2022-06-06,Senate,"Do pass, but first be re-referred to the Committee on [Appropriations] with the recommendation: To Consent Calendar",12,0,0,2,14
1559214,1224783,2022-08-24,Senate,"Assembly 3rd Reading AB1646 Chen By Grove",40,0,0,0,40
1559214,1225002,2022-08-25,Assembly,"AB 1646 Chen Concurrence in Senate Amendments",72,0,0,8,80
1559216,1182577,2022-04-04,Assembly,"Do pass and be re-referred to the Committee on [Appropriations]",7,0,0,0,7
1559216,1206412,2022-05-19,Assembly,"Do pass as amended",12,0,0,4,16
1559216,1210539,2022-05-26,Assembly,"AB 1648 Maienschein Assembly Third Reading",73,0,0,5,78
1559216,1219894,2022-06-28,Senate,"Do pass, but first be re-referred to the Committee on [Appropriations]",10,1,0,4,15
1559216,1222713,2022-08-01,Senate,"Placed on suspense file",7,0,0,0,7
1559216,1223904,2022-08-11,Senate,"Do pass",6,0,0,1,7
1559216,1224701,2022-08-24,Senate,"Assembly 3rd Reading AB1648 Maienschein By Stern",34,0,0,6,40
1559217,1174550,2022-03-22,Assembly,"Do pass and be re-referred to the Committee on [Appropriations] with recommendation: To Consent Calendar",8,0,0,0,8
1559219,1191319,2022-04-20,Assembly,"Do pass and be re-referred to the Committee on [Privacy and Consumer Protection]",5,2,0,0,7
1559220,1129913,2022-01-27,Assembly,"Be adopted. To Consent Calendar",8,0,0,4,12
1559220,1134578,2022-02-03,Assembly,"HR 80 Kalra Consent Calendar Second Day Regular Session",70,0,0,5,75
1559222,1170650,2022-03-15,Senate,"Do pass as amended, but first amend, and re-refer to the Committee on [Appropriations]",13,0,0,2,15
1559222,1182566,2022-04-04,Senate,"Placed on suspense file",6,0,0,1,7
1559222,1206850,2022-05-19,Senate,"Do pass as amended",7,0,0,0,7
1559222,1209970,2022-05-26,Senate,"Senate 3rd Reading SB846 Dodd et al",32,0,0,8,40
1559222,1217946,2022-06-22,Assembly,"Do pass as amended and be re-referred to the Committee on [Appropriations]",20,0,0,2,22
1559222,1225517,2022-08-31,Senate,"W/O REF. TO FILE SB846 Dodd",31,1,0,8,40
1559222,1225518,2022-09-01,Assembly,"SB 846 Dodd Senate Third Reading By CUNNINGHAM",69,3,0,8,80
1559222,1229718,2022-09-01,Senate,"W/O REF. TO FILE SB846 Dodd",31,1,0,8,40
1559223,1176490,2022-03-24,Senate,"Do pass as amended, but first amend, and re-refer to the Committee on [Judiciary]",8,0,0,1,9
1559223,1194457,2022-04-26,Senate,"Do pass as amended, but first amend, and re-refer to the Committee on [Appropriations]",9,1,0,1,11
1559223,1204606,2022-05-16,Senate,"Placed on suspense file",6,0,0,1,7
1559223,1206618,2022-05-19,Senate,"Do pass",7,0,0,0,7
1559223,1209275,2022-05-25,Senate,"Senate 3rd Reading SB847 Hurtado",35,0,0,5,40
1559223,1215811,2022-06-14,Assembly,"Do pass as amended and be re-referred to the Committee on [Housing and Community Development]",10,0,0,1,11
1559223,1220636,2022-06-29,Assembly,"Do pass and be re-referred to the Committee on [Appropriations]",8,0,0,0,8
1559224,1184673,2022-04-05,Senate,"Do pass, but first be re-referred to the Committee on [Appropriations]",10,0,0,1,11
1559224,1208467,2022-05-24,Senate,"Senate 3rd Reading SB848 Umberg",37,0,0,3,40
1559224,1220066,2022-06-28,Assembly,"Do pass and be re-referred to the Committee on [Appropriations]",11,0,0,0,11
1559224,1223557,2022-08-11,Assembly,"Do pass as amended",12,0,0,4,16
1559224,1224957,2022-08-25,Assembly,"SB 848 Umberg Senate Third Reading By Stone",74,0,0,6,80
1559224,1225988,2022-08-30,Senate,"Unfinished Business SB848 Umberg Concurrence",0,38,0,2,40
1559225,1134608,2022-02-03,Senate,"Senate 3rd Reading SR64 Pan et al",35,0,0,5,40
1560014,1185728,2022-04-06,Assembly,"Do pass",7,0,0,0,7
1560014,1192209,2022-04-25,Assembly,"AB 1652 Medina Assembly Third Reading",60,0,0,17,77
1560014,1211851,2022-06-01,Senate,"Do pass, but first be re-referred to the Committee on [Elections and Constitutional Amendments]",6,0,0,1,7
1560015,1165726,2022-03-08,Assembly,"Do pass and be re-referred to the Committee on [Appropriations] with recommendation: To Consent Calendar",7,0,0,0,7
1560015,1180217,2022-03-30,Assembly,"Do pass. To Consent Calendar",12,0,0,3,15
1560015,1186260,2022-04-07,Assembly,"AB 1653 Patterson Consent Calendar Second Day Regular Session",65,0,0,12,77
1560015,1210906,2022-05-31,Senate,"Do pass and be ordered to the Consent Calendar",5,0,0,0,5
1560015,1211860,2022-05-31,Senate,"Do pass, but first be re-referred to the Committee on [Appropriations] with the recommendation: To Consent Calendar",5,0,0,0,5
1560015,1219487,2022-06-27,Senate,"Consent Calendar AB1653",37,0,0,3,40
1560016,1194403,2022-04-27,Assembly,"Do pass as amended and be re-referred to the Committee on [Appropriations]",8,0,0,0,8
1560016,1206243,2022-05-19,Assembly,"Do pass",16,0,0,0,16
1560016,1207821,2022-05-23,Assembly,"AB 1654 Robert Rivas Assembly Third Reading",74,0,0,4,78
1560016,1215854,2022-06-13,Senate,"Do pass, but first be re-referred to the Committee on [Governance and Finance]",9,0,0,0,9
1560016,1218036,2022-06-22,Senate,"Do pass, but first be re-referred to the Committee on [Appropriations] with the recommendation: To Consent Calendar",5,0,0,0,5
1560016,1222913,2022-08-01,Senate,"Placed on suspense file",7,0,0,0,7
1560016,1223731,2022-08-11,Senate,"Do pass as amended",7,0,0,0,7
1560016,1225828,2022-08-29,Senate,"Assembly 3rd Reading AB1654 Robert Rivas By Caballero",40,0,0,0,40
1560016,1225829,2022-08-30,Assembly,"AB 1654 Robert Rivas Concurrence in Senate Amendments",76,0,0,4,80
1560017,1180227,2022-03-30,Assembly,"Do pass and be re-referred to the Committee on [Higher Education]",19,0,0,3,22
1560017,1194120,2022-04-26,Assembly,"Do pass and be re-referred to the Committee on [Appropriations]",12,0,0,0,12
1560017,1206238,2022-05-19,Assembly,"Do pass as amended",12,0,0,4,16
1560017,1210534,2022-05-26,Assembly,"AB 1655 Jones-Sawyer Assembly Third Reading",75,0,0,3,78
1560017,1215776,2022-06-14,Senate,"Do pass, but first be re-referred to the Committee on [Rules]",14,0,0,1,15
1560017,1220848,2022-06-29,Senate,"Do pass, but first be re-referred to the Committee on [Appropriations]",6,0,0,1,7
1560017,1222880,2022-08-01,Senate,"Placed on suspense file",7,0,0,0,7
1560017,1223679,2022-08-11,Senate,"Do pass as amended",7,0,0,0,7
1560017,1225608,2022-08-31,Senate,"Special Consent AB1655",40,0,0,0,40
1560017,1225609,2022-08-31,Assembly,"AB 1655 Jones-Sawyer Concurrence in Senate Amendments",75,0,0,5,80
1560018,1179261,2022-03-29,Assembly,"Do pass",12,0,0,6,18
1560018,1189320,2022-04-18,Assembly,"AB 1656 Aguiar-Curry Assembly Third Reading",59,1,0,17,77
1560018,1214370,2022-06-06,Senate,"Do pass",9,0,0,5,14
1560019,1179373,2022-03-21,Assembly,"Do pass and be re-referred to the Committee on [Appropriations] with recommendation: To Consent Calendar",11,0,0,0,11
1560019,1194144,2022-04-27,Assembly,"Do pass as amended",15,0,0,1,16
1560019,1204554,2022-05-16,Assembly,"AB 1657 Nguyen Assembly Third Reading",71,0,0,7,78
1560019,1220022,2022-06-28,Senate,"Do pass, but first be re-referred to the Committee on [Appropriations]",3,5,0,1,9
1560019,1220023,2022-06-28,Senate,"[Second] hearing set for [06-28-2022]: Failed passage in Committee. Reconsideration granted",9,0,0,0,9
1560020,1179518,2022-03-21,Assembly,"Do pass and be re-referred to the Committee on [Appropriations] with recommendation: To Consent Calendar",11,0,0,0,11
1560020,1194329,2022-04-27,Assembly,"Do pass as amended",15,0,0,1,16
1560020,1204645,2022-05-16,Assembly,"AB 1658 Nguyen Assembly Third Reading",70,0,0,8,78
1560020,1215845,2022-06-14,Senate,"Do pass, but first be re-referred to the Committee on [Environmental Quality]",5,0,0,4,9
1560020,1220742,2022-06-29,Senate,"Do pass, but first be re-referred to the Committee on [Appropriations]",4,0,0,3,7
1560020,1224655,2022-08-24,Senate,"Assembly 3rd Reading AB1658 Nguyen et al. By Bates",25,8,0,7,40
1560022,1219406,2022-06-27,Assembly,"Be adopted. To Consent Calendar",7,0,0,0,7
1560022,1221213,2022-06-30,Assembly,"AJR 24 Nguyen Consent Calendar Second Day",79,0,0,1,80
1560023,1215563,2022-06-13,Assembly,"Be adopted. To Consent Calendar",14,0,0,1,15
1560023,1216815,2022-06-16,Assembly,"AJR 25 Nguyen Consent Calendar Second Day Regular Session",72,0,0,7,79
1560023,1223321,2022-08-10,Senate,"Be adopted and be ordered to the Consent Calendar",16,0,0,1,17
1560023,1224140,2022-08-17,Senate,"Consent Calendar AJR25 Nguyen et al",38,0,0,2,40
1560024,1191337,2022-04-21,Assembly,"Be adopted. To third reading",9,0,0,2,11
1562590,1194162,2022-04-27,Assembly,"Do pass and be re-referred to the Committee on [Appropriations]",2,3,0,2,7
1562591,1170619,2022-03-15,Assembly,"Do pass and be re-referred to the Committee on [Appropriations] with recommendation: To Consent Calendar",10,0,0,0,10
1562591,1180213,2022-03-30,Assembly,"Do pass. To Consent Calendar",12,0,0,3,15
1562591,1186259,2022-04-07,Assembly,"AB 1661 Davies Consent Calendar Second Day Regular Session",65,0,0,12,77
1562591,1210907,2022-05-31,Senate,"Do pass, but first be re-referred to the Committee on [Appropriations] with the recommendation: To Consent Calendar",8,0,0,3,11
1562591,1219460,2022-06-27,Senate,"Consent Calendar AB1661",37,0,0,3,40
1562592,1193296,2022-04-26,Assembly,"Do pass as amended and be re-referred to the Committee on [Appropriations]",15,1,0,2,18
1562592,1206551,2022-05-19,Assembly,"Do pass",14,2,0,0,16
1562592,1207841,2022-05-23,Assembly,"AB 1662 Gipson Assembly Third Reading",60,5,0,13,78
1562592,1215923,2022-06-13,Senate,"Do pass, but first be re-referred to the Committee on [Public Safety]",11,0,0,3,14
1562592,1220615,2022-06-28,Senate,"Do pass, but first be re-referred to the Committee on [Appropriations]",5,0,0,0,5
1562592,1223267,2022-08-08,Senate,"Placed on suspense file",7,0,0,0,7
1562593,1216642,2022-06-16,Assembly,"Be adopted. To third reading",8,0,0,3,11
1562593,1224049,2022-08-11,Senate,"Special Consent ACR122",38,0,0,2,40
1562594,1173495,2022-03-21,Senate,"Do pass, but first be re-referred to the Committee on [Appropriations] with the recommendation: To Consent Calendar",5,0,0,0,5
1562594,1182526,2022-04-04,Senate,"Placed on suspense file",6,0,0,1,7
1562594,1206343,2022-05-19,Senate,"Do pass",7,0,0,0,7
1562594,1209323,2022-05-25,Senate,"Special Consent SB850",39,0,0,1,40
1562594,1217958,2022-06-22,Assembly,"Do pass and be re-referred to the Committee on [Appropriations] with recommendation: To Consent Calendar",7,0,0,0,7
1562594,1222965,2022-08-03,Assembly,"Do pass. To Consent Calendar",15,0,0,1,16
1562594,1223806,2022-08-11,Assembly,"SB 850 Laird Consent Calendar Second Day Regular Session",76,0,0,4,80
1562595,1166908,2022-03-09,Senate,"Do pass, but first be re-referred to the Committee on [Appropriations]",7,0,0,0,7
1562595,1182523,2022-04-04,Senate,"Placed on suspense file",6,0,0,1,7
1562595,1206583,2022-05-19,Senate,"Do pass as amended",7,0,0,0,7
1562595,1209953,2022-05-26,Senate,"Special Consent SB851 Portantino et al",38,0,0,2,40
1562595,1217323,2022-06-21,Assembly,"Do pass and be re-referred to the Committee on [Appropriations]",12,0,0,0,12
1562595,1223607,2022-08-11,Assembly,"Do pass",16,0,0,0,16
1562595,1225154,2022-08-30,Assembly,"Do pass",9,0,0,2,11
1562595,1225313,2022-08-31,Senate,"Unfinished Business SB851 Portantino Concurrence",40,0,0,0,40
1562595,1225314,2022-08-31,Assembly,"SB 851 Portantino Senate Third Reading By Petrie-Norris",78,0,0,2,80
1562596,1185699,2022-04-07,Senate,"Do pass as amended, but first amend, and re-refer to the Committee on [Natural Resources and Water]",5,0,0,0,5
1562596,1193214,2022-04-26,Senate,"Do pass as amended, but first amend, and re-refer to the Committee on [Appropriations]",7,1,0,1,9
1562596,1208491,2022-05-24,Senate,"Senate 3rd Reading SB852 Dodd et al",29,7,0,4,40
1562596,1216601,2022-06-15,Assembly,"Do pass and be re-referred to the Committee on [Natural Resources]",6,2,0,0,8
1562596,1219436,2022-06-27,Assembly,"Do pass and be re-referred to the Committee on [Appropriations]",8,1,0,2,11
1562596,1222942,2022-08-03,Assembly,"Do pass",11,4,0,1,16
1562596,1224091,2022-08-15,Assembly,"SB 852 Dodd Senate Third Reading By Aguiar-Curry",51,14,0,15,80
1562596,1224094,2022-08-16,Senate,"Unfinished Business SB852 Dodd et al. Concurrence",27,8,0,5,40
1564455,1170626,2022-03-15,Assembly,"Do pass as amended and be re-referred to the Committee on [Appropriations]",10,0,0,0,10
1564455,1206911,2022-05-19,Assembly,"Do pass as amended",15,0,0,1,16
1564455,1210415,2022-05-25,Assembly,"AB 1663 Maienschein Assembly Third Reading",75,0,0,3,78
1564455,1217880,2022-06-21,Senate,"Do pass as amended, but first amend, and re-refer to the Committee on [Human Services]",11,0,0,0,11
1564455,1220045,2022-06-27,Senate,"Do pass, but first be re-referred to the Committee on [Appropriations]",5,0,0,0,5
1564455,1222639,2022-08-01,Senate,"Placed on suspense file",7,0,0,0,7
1564455,1223709,2022-08-11,Senate,"Do pass as amended",7,0,0,0,7
1564455,1225235,2022-08-29,Senate,"Assembly 3rd Reading AB1663 Maienschein By Kamlager",35,0,0,5,40
1564455,1225236,2022-08-30,Assembly,"AB 1663 Maienschein Concurrence in Senate Amendments",79,0,0,1,80
1564456,1182525,2022-04-04,Assembly,"Do pass and be re-referred to the Committee on [Appropriations] with recommendation: To Consent Calendar",7,0,0,0,7
1564456,1206554,2022-05-19,Assembly,"Do pass as amended",13,0,0,3,16
1564456,1210330,2022-05-26,Assembly,"AB 1664 Gabriel Assembly Third Reading",75,0,0,3,78
1564456,1219977,2022-06-28,Senate,"Do pass, but first be re-referred to the Committee on [Appropriations] with the recommendation: To Consent Calendar",13,0,0,2,15
1564456,1222704,2022-08-01,Senate,"Placed on suspense file",7,0,0,0,7
1564456,1223351,2022-08-11,Senate,"Do pass",7,0,0,0,7
1564456,1224473,2022-08-23,Senate,"Special Consent AB1664",40,0,0,0,40
1564456,1224802,2022-08-24,Assembly,"AB 1664 Gabriel Concurrence in Senate Amendments",76,0,0,4,80
1564457,1165758,2022-03-08,Assembly,"Do pass and be re-referred to the Committee on [Appropriations]",4,3,0,0,7
1564457,1165759,2022-03-08,Assembly,Reconsideration,7,0,0,0,7
1564457,1193430,2022-04-26,Assembly,"Do pass and be re-referred to the Committee on [Appropriations]",7,0,0,0,7
1564458,1170594,2022-03-15,Assembly,"Do pass as amended and be re-referred to the Committee on [Health]",7,2,0,1,10
1564458,1183665,2022-04-05,Assembly,"Do pass",11,2,0,2,15
1564458,1200643,2022-05-05,Assembly,"AB 1666 Bauer-Kahan Assembly Third Reading Amendment Set #1",49,11,0,18,78
1564458,1207860,2022-05-23,Assembly,"AB 1666 Bauer-Kahan Third Reading Urgency",56,15,0,7,78
1564458,1216250,2022-06-14,Senate,"Do pass",9,2,0,0,11
1564458,1218634,2022-06-23,Senate,"Assembly 3rd Reading AB1666 Bauer-Kahan et al. By Lim贸n Urgency Clause",29,9,0,2,40
1564459,1190627,2022-04-20,Assembly,"Do pass and be re-referred to the Committee on [Appropriations]",6,0,0,0,6
1564459,1206602,2022-05-19,Assembly,"Do pass as amended",12,0,0,4,16
1564459,1210570,2022-05-26,Assembly,"AB 1667 Cooper Assembly Third Reading",75,0,0,3,78
1564459,1218671,2022-06-22,Senate,"Do pass, but first be re-referred to the Committee on [Judiciary]",4,0,0,1,5
1564459,1220645,2022-06-28,Senate,"Do pass, but first be re-referred to the Committee on [Appropriations]",10,0,0,1,11
1564459,1223195,2022-08-08,Senate,"Placed on suspense file",7,0,0,0,7
1564459,1223695,2022-08-11,Senate,"Do pass",7,0,0,0,7
1564459,1225222,2022-08-29,Senate,"Assembly 3rd Reading AB1667 Cooper By Pan",39,0,0,1,40
1564459,1225223,2022-08-30,Assembly,"AB 1667 Cooper Concurrence in Senate Amendments",79,0,0,1,80
1564460,1174481,2022-03-22,Assembly,"Do pass and be re-referred to the Committee on [Appropriations]",14,0,0,0,14
1564460,1189358,2022-04-18,Assembly,"AB 1668 Patterson Assembly Third Reading",73,0,0,4,77
1564460,1211841,2022-06-01,Senate,"Do pass and be ordered to the Consent Calendar",9,0,0,2,11
1564460,1215305,2022-06-09,Senate,"Consent Calendar AB1668",38,0,0,2,40
1564462,1170629,2022-03-15,Assembly,"Do pass and be re-referred to the Committee on [Health]",4,2,0,0,6
1564462,1179292,2022-03-29,Assembly,"Do pass as amended and be re-referred to the Committee on [Appropriations]",13,2,0,0,15
1564463,1158890,2022-03-01,Assembly,"Do pass as amended and be re-referred to the Committee on [Human Services]",12,0,0,0,12
1564463,1174506,2022-03-22,Assembly,"Do pass and be re-referred to the Committee on [Appropriations] with recommendation: To Consent Calendar",8,0,0,0,8
1564463,1184676,2022-04-06,Assembly,"Do pass",13,0,0,3,16
1564463,1191277,2022-04-21,Assembly,"AB 1671 Patterson Assembly Third Reading",70,0,0,7,77
1564463,1211831,2022-06-01,Senate,"Do pass as amended, but first amend, and re-refer to the Committee on [Human Services] with the recommendation: To Consent Calendar",6,0,0,1,7
1564463,1215804,2022-06-13,Senate,"Do pass, but first be re-referred to the Committee on [Appropriations] with the recommendation: To Consent Calendar",5,0,0,0,5
1564463,1221265,2022-06-30,Senate,"Consent Calendar AB1671",37,0,0,3,40
1564464,1185716,2022-04-07,Assembly,"Be adopted. To third reading",8,0,0,3,11
1564464,1207697,2022-05-23,Senate,"Special Consent ACR123",36,0,0,4,40
1564465,1129952,2022-01-27,Assembly,"Be adopted. To Consent Calendar",8,0,0,4,12
1564465,1134577,2022-02-03,Assembly,"HR 82 Kiley Consent Calendar Second Day Regular Session",70,0,0,5,75
1564466,1191344,2022-04-20,Senate,"Do pass as amended, but first amend, and re-refer to the Committee on [Appropriations]",10,0,0,1,11
1564466,1201447,2022-05-09,Senate,"Placed on suspense file",7,0,0,0,7
1564466,1206575,2022-05-19,Senate,"Do pass",7,0,0,0,7
1564466,1209240,2022-05-25,Senate,"Special Consent SB853",39,0,0,1,40
1564466,1219931,2022-06-28,Assembly,"Do pass and be re-referred to the Committee on [Appropriations]",11,0,0,4,15
1564467,1179197,2022-03-29,Senate,"Do pass, but first be re-referred to the Committee on [Governance and Finance]",3,1,0,1,5
1564467,1190512,2022-04-20,Senate,"Do pass as amended, but first amend, and re-refer to the Committee on [Appropriations]",4,1,0,0,5
1564467,1201511,2022-05-09,Senate,"Placed on suspense file",7,0,0,0,7
1564468,1175534,2022-03-23,Senate,"Do pass as amended, but first amend, and re-refer to the Committee on [Appropriations]",11,0,0,0,11
1564468,1189323,2022-04-18,Senate,"Placed on suspense file",7,0,0,0,7
1564468,1206443,2022-05-19,Senate,"Do pass",7,0,0,0,7
1564468,1209396,2022-05-25,Senate,"Special Consent SB855",39,0,0,1,40
1564468,1217474,2022-06-21,Assembly,"Do pass and be re-referred to the Committee on [Appropriations] with recommendation: To Consent Calendar",15,0,0,0,15
1564468,1223403,2022-08-11,Assembly,"Do pass",16,0,0,0,16
1564468,1225896,2022-08-31,Senate,"Unfinished Business SB855 Newman et al. Concurrence",39,0,0,1,40
1564468,1225897,2022-08-31,Assembly,"SB 855 Newman Senate Third Reading By Akilah Weber",80,0,0,0,80
1564469,1165751,2022-03-08,Senate,"Do pass as amended, but first amend, and re-refer to the Committee on [Appropriations]",7,0,0,2,9
1564469,1182551,2022-04-04,Senate,"Placed on suspense file",6,0,0,1,7
1564469,1206848,2022-05-19,Senate,"Do pass as amended",5,1,0,1,7
1564469,1209946,2022-05-26,Senate,"Senate 3rd Reading SB856 Dodd",35,0,0,5,40
1564469,1219927,2022-06-28,Assembly,"Do pass as amended and be re-referred to the Committee on [Appropriations]",13,0,0,2,15
1564469,1223975,2022-08-11,Assembly,"Do pass as amended",12,0,0,4,16
1564469,1224329,2022-08-22,Assembly,"SB 856 Dodd Senate Third Reading By DAHLE",69,0,0,11,80
1564469,1224457,2022-08-23,Senate,"Unfinished Business SB856 Dodd et al. Concurrence",35,0,0,5,40
1564470,1169409,2022-03-14,Senate,"Do pass as amended, but first amend, and re-refer to the Committee on [Appropriations]",12,0,0,2,14
1564470,1182569,2022-04-04,Senate,"Placed on suspense file",6,0,0,1,7
1564470,1206921,2022-05-19,Senate,"Do pass",7,0,0,0,7
1564470,1207712,2022-05-23,Senate,"Senate 3rd Reading SB857 Hueso et al. Urgency Clause",37,0,0,3,40
1564470,1216273,2022-06-15,Assembly,"Do pass and be re-referred to the Committee on [Appropriations]",11,0,0,2,13
1564470,1223829,2022-08-11,Assembly,"Do pass",16,0,0,0,16
1564470,1224366,2022-08-22,Assembly,"SB 857 Hueso Third Reading Urgency By QUIRK-SILVA",77,0,0,3,80
1564471,1191301,2022-04-20,Senate,"Do pass, but first be re-referred to the Committee on [Judiciary]",8,1,0,2,11
1564471,1194392,2022-04-26,Senate,"Do pass as amended, but first amend, and re-refer to the Committee on [Appropriations]",8,1,0,2,11
1564471,1204578,2022-05-16,Senate,"Placed on suspense file",6,0,0,1,7
1564471,1206737,2022-05-19,Senate,"Do pass as amended",5,2,0,0,7
1564471,1208464,2022-05-24,Senate,"Senate 3rd Reading SB858 Wiener",27,9,0,4,40
1564471,1219946,2022-06-28,Assembly,"Do pass as amended and be re-referred to the Committee on [Appropriations]",11,3,0,1,15
1564471,1223575,2022-08-11,Assembly,"Do pass",12,4,0,0,16
1564471,1224245,2022-08-18,Assembly,"SB 858 Wiener Senate Third Reading By Aguiar-Curry Amendment Set #1",53,18,0,9,80
1564471,1224330,2022-08-22,Assembly,"SB 858 Wiener Senate Third Reading By Aguiar-Curry",51,18,0,11,80
1564471,1224965,2022-08-25,Senate,"Unfinished Business SB858 Wiener Concurrence",31,9,0,0,40
1564472,1216616,2022-06-16,Senate,"Special Consent SCR64",35,0,0,5,40
1564472,1221349,2022-06-30,Assembly,"Be adopted. To Consent Calendar",7,0,0,4,11
1564472,1223047,2022-08-04,Assembly,"SCR 64 Rubio Consent Calendar Second Day Regular Session",76,0,0,4,80
1567055,1174497,2022-03-22,Assembly,"Do pass and be re-referred to the Committee on [Appropriations]",14,0,0,0,14
1567055,1184626,2022-04-06,Assembly,"Do pass. To Consent Calendar",13,0,0,3,16
1567055,1198311,2022-05-02,Assembly,"AB 1672 Boerner Horvath Assembly Third Reading",68,0,0,9,77
1567055,1211906,2022-06-01,Senate,"Do pass as amended, but first amend, and re-refer to the Committee on [Appropriations]",9,0,0,2,11
1567055,1217055,2022-06-20,Senate,"Placed on suspense file",4,0,0,3,7
1567055,1223363,2022-08-11,Senate,"Do pass",6,0,0,1,7
1567055,1224920,2022-08-25,Senate,"Assembly 3rd Reading AB1672 Boerner Horvath et a By Allen",40,0,0,0,40
1567055,1224921,2022-08-25,Assembly,"AB 1672 Boerner Horvath Concurrence in Senate Amendments",75,0,0,5,80
1567057,1174491,2022-03-22,Assembly,"Do pass as amended and be re-referred to the Committee on [Public Safety]",14,0,0,0,14
1567057,1189891,2022-04-19,Assembly,"Do pass and be re-referred to the Committee on [Appropriations]",7,0,0,0,7
1567061,1184675,2022-04-06,Assembly,"Do pass as amended, and be re-referred to the Committee on [Natural Resources] with recommendation: To Consent Calendar",12,0,0,3,15
1567065,1184740,2022-04-06,Assembly,"Do pass and be re-referred to the Committee on [Appropriations]",9,0,0,2,11
1567067,1181245,2022-03-31,Assembly,"Do pass and be re-referred to the Committee on [Transportation] with recommendation: To Consent Calendar",6,0,0,0,6
1567067,1189935,2022-04-18,Assembly,"Do pass and be re-referred to the Committee on [Appropriations]",13,0,0,2,15
1567068,1129887,2022-01-27,Assembly,"Be adopted. To Consent Calendar",8,0,0,4,12
1567068,1134600,2022-02-03,Assembly,"ACR 124 Fong Consent Calendar Second Day",70,0,0,5,75
1567068,1154484,2022-02-24,Senate,"Assembly 3rd Reading ACR124",37,0,0,3,40
1567071,1181262,2022-03-31,Senate,"Do pass, but first be re-referred to the Committee on [Appropriations]",5,0,0,0,5
1567071,1189375,2022-04-18,Senate,"Placed on suspense file",7,0,0,0,7
1567071,1206678,2022-05-19,Senate,"Do pass as amended",5,0,0,2,7
1567071,1208465,2022-05-24,Senate,"Senate 3rd Reading SB860 Rubio et al",34,0,0,6,40
1567072,1179156,2022-03-29,Senate,"Do pass, but first be re-referred to the Committee on [Appropriations] with the recommendation: To Consent Calendar",4,0,0,1,5
1567072,1189345,2022-04-18,Senate,"Placed on suspense file",7,0,0,0,7
1567072,1206896,2022-05-19,Senate,"Do pass as amended",7,0,0,0,7
1567072,1210021,2022-05-26,Senate,"Special Consent SB861",38,0,0,2,40
1567072,1217423,2022-06-21,Assembly,"Do pass as amended and be re-referred to the Committee on [Appropriations]",7,0,0,0,7
1567072,1223378,2022-08-11,Assembly,"Do pass",16,0,0,0,16
1567072,1224167,2022-08-18,Assembly,"SB 861 Lim贸n Senate Third Reading By Aguiar-Curry",75,0,0,5,80
1567072,1225009,2022-08-25,Senate,"Unfinished Business SB861 Lim贸n et al. Concurrence",40,0,0,0,40
1567073,1200489,2022-05-04,Senate,"Do pass, but first be re-referred to the Committee on [Appropriations]",5,0,0,0,5
1567073,1204548,2022-05-16,Senate,"Placed on suspense file",6,0,0,1,7
1567076,1165733,2022-03-08,Senate,"Do pass, but first be re-referred to the Committee on [Judiciary]",5,0,0,0,5
1567076,1194326,2022-04-26,Senate,"Do pass as amended, but first amend, and re-refer to the Committee on [Appropriations]",11,0,0,0,11
1567076,1204670,2022-05-16,Senate,"Placed on suspense file",6,0,0,1,7
1567076,1206318,2022-05-19,Senate,"Do pass",7,0,0,0,7
1567076,1209353,2022-05-25,Senate,"Special Consent SB863",39,0,0,1,40
1567076,1215887,2022-06-14,Assembly,"Do pass as amended and be re-referred to the Committee on [Appropriations]",7,0,0,1,8
1567076,1223490,2022-08-11,Assembly,"Do pass as amended",12,0,0,4,16
1567076,1225509,2022-08-31,Senate,"Unfinished Business SB863 Min et al. Concurrence",39,0,0,1,40
1567076,1225510,2022-08-31,Assembly,"SB 863 Min Senate Third Reading By Akilah Weber",79,0,0,1,80
1567078,1175543,2022-03-23,Senate,"Do pass as amended, but first amend, and re-refer to the Committee on [Appropriations]",11,0,0,0,11
1567078,1201404,2022-05-09,Senate,"Senate 3rd Reading SB864 Melendez et al",33,0,0,7,40
1567078,1215777,2022-06-14,Assembly,"Do pass and be re-referred to the Committee on [Appropriations]",13,0,0,2,15
1567078,1220598,2022-06-29,Assembly,"Do pass. To Consent Calendar",14,0,0,2,16
1567078,1223067,2022-08-04,Assembly,"SB 864 Melendez Consent Calendar Second Day Regular Session",76,0,0,4,80
1567079,1165724,2022-03-08,Senate,"Do pass as amended, but first amend, and re-refer to the Committee on [Appropriations]",9,0,0,0,9
1567079,1182550,2022-04-04,Senate,"Placed on suspense file",6,0,0,1,7
1567079,1206379,2022-05-19,Senate,"Do pass",7,0,0,0,7
1567079,1209376,2022-05-25,Senate,"Special Consent SB865",39,0,0,1,40
1567079,1219960,2022-06-28,Assembly,"Do pass and be re-referred to the Committee on [Appropriations]",13,0,0,2,15
1567081,1200530,2022-05-05,Senate,"Do pass",7,0,0,4,11
1567081,1204081,2022-05-12,Senate,"Senate 3rd Reading SB866 Wiener et al",21,8,0,11,40
1567081,1211839,2022-06-01,Assembly,"Do pass",6,4,0,1,11
1567081,1216801,2022-06-16,Assembly,"SB 866 Wiener Senate Third Reading Amend By WICKS Set #1",38,22,0,19,79
1570759,1189813,2022-04-19,Assembly,"Do pass and be re-referred to the Committee on [Transportation] with recommendation: To Consent Calendar",7,0,0,0,7
1570759,1193303,2022-04-25,Assembly,"Do pass",15,0,0,0,15
1570759,1200644,2022-05-05,Assembly,"AB 1680 Lee Assembly Third Reading",61,0,0,17,78
1570759,1216274,2022-06-14,Senate,"Do pass, but first be re-referred to the Committee on [Public Safety]",13,0,0,4,17
1570759,1220854,2022-06-28,Senate,"Do pass and be ordered to the Consent Calendar",5,0,0,0,5
1570759,1224116,2022-08-17,Senate,"Assembly 3rd Reading AB1680 Lee By Wiener",38,0,0,2,40
1570759,1224345,2022-08-22,Assembly,"AB 1680 Lee Concurrence in Senate Amendments",75,0,0,5,80
1570760,1180244,2022-03-30,Assembly,"Do pass and be re-referred to the Committee on [Judiciary] with recommendation: To Consent Calendar",13,0,0,1,14
1570760,1189826,2022-04-19,Assembly,"Do pass and be re-referred to the Committee on [Appropriations] with recommendation: To Consent Calendar",9,0,0,2,11
1570760,1206752,2022-05-19,Assembly,"Do pass",16,0,0,0,16
1570760,1210401,2022-05-25,Assembly,"AB 1681 Daly Assembly Third Reading",76,0,0,2,78
1570760,1217969,2022-06-22,Senate,"Do pass, but first be re-referred to the Committee on [Judiciary] with the recommendation: To Consent Calendar",11,0,0,1,12
1570760,1220712,2022-06-28,Senate,"Do pass, but first be re-referred to the Committee on [Appropriations] with the recommendation: To Consent Calendar",10,0,0,1,11
1570760,1222698,2022-08-01,Senate,"Placed on suspense file",7,0,0,0,7
1570760,1223521,2022-08-11,Senate,"Do pass",7,0,0,0,7
1570760,1224569,2022-08-23,Senate,"Special Consent AB1681",40,0,0,0,40
1570760,1224793,2022-08-24,Assembly,"AB 1681 Daly Concurrence in Senate Amendments",75,0,0,5,80
1570761,1165749,2022-03-08,Assembly,"Do pass. To Consent Calendar",7,0,0,0,7
1570761,1172393,2022-03-17,Assembly,"AB 1682 Boerner Horvath Consent Calendar Second Day",70,0,0,6,76
1570761,1215731,2022-06-14,Senate,"Do pass",5,0,0,0,5
1570761,1223221,2022-08-08,Senate,"Special Consent AB1682",36,0,0,4,40
1570761,1223906,2022-08-11,Assembly,"AB 1682 Boerner Horvath Concurrence in Senate Amendments",75,0,0,5,80
1570763,1189971,2022-04-19,Assembly,"Do pass and be re-referred to the Committee on [Appropriations] with recommendation: To Consent Calendar",7,0,0,0,7
1570763,1206568,2022-05-19,Assembly,"Do pass",16,0,0,0,16
1570763,1210203,2022-05-27,Assembly,"AB 1684 Voepel Assembly Third Reading",76,0,0,2,78
1570763,1218610,2022-06-22,Senate,"Do pass, but first be re-referred to the Committee on [Appropriations] with the recommendation: To Consent Calendar",9,0,0,2,11
1570763,1222771,2022-08-01,Senate,"Placed on suspense file",7,0,0,0,7
1570764,1183836,2022-04-04,Assembly,"Do pass as amended and be re-referred to the Committee on [Housing and Community Development]",14,0,0,1,15
1570764,1194199,2022-04-27,Assembly,"Do pass and be re-referred to the Committee on [Appropriations]",7,0,0,1,8
1570764,1206995,2022-05-19,Assembly,"Do pass",16,0,0,0,16
1570764,1210536,2022-05-25,Assembly,"AB 1685 Bryan Assembly Third Reading",74,0,0,4,78
1570764,1216365,2022-06-14,Senate,"Do pass, but first be re-referred to the Committee on [Human Services]",13,1,0,3,17
1570764,1220056,2022-06-27,Senate,"Do pass, but first be re-referred to the Committee on [Appropriations]",4,0,0,1,5
1570764,1222741,2022-08-01,Senate,"Placed on suspense file",7,0,0,0,7
1570764,1223703,2022-08-11,Senate,"Do pass as amended",6,0,0,1,7
1570764,1225357,2022-08-29,Senate,"Assembly 3rd Reading AB1685 Bryan et al. By Wieckowski",31,3,0,6,40
1570764,1225358,2022-08-30,Assembly,"AB 1685 Bryan Concurrence in Senate Amendments",76,0,0,4,80
1570765,1170630,2022-03-15,Assembly,"Do pass and be re-referred to the Committee on [Human Services]",7,3,0,0,10
1570765,1193297,2022-04-26,Assembly,"Do pass and be re-referred to the Committee on [Appropriations]",6,1,0,1,8
1570765,1206895,2022-05-19,Assembly,"Do pass",12,4,0,0,16
1570765,1210311,2022-05-26,Assembly,"AB 1686 Bryan Assembly Third Reading",58,14,0,6,78
1570765,1218042,2022-06-21,Senate,"Do pass, but first be re-referred to the Committee on [Human Services]",10,1,0,0,11
1570765,1219870,2022-06-27,Senate,"Do pass, but first be re-referred to the Committee on [Appropriations]",5,0,0,0,5
1570765,1222700,2022-08-01,Senate,"Placed on suspense file",7,0,0,0,7
1570765,1223475,2022-08-11,Senate,"Do pass",6,0,0,1,7
1570765,1224743,2022-08-24,Senate,"Assembly 3rd Reading AB1686 Bryan et al. By Skinner",35,2,0,3,40
1570766,1192161,2022-04-25,Assembly,"Do pass",7,0,0,0,7
1570766,1198232,2022-05-02,Assembly,"AB 1687 Seyarto Assembly Third Reading",69,0,0,8,77
1570766,1220103,2022-06-28,Senate,"Do pass",12,1,0,2,15
1570766,1224841,2022-08-24,Senate,"Assembly 3rd Reading AB1687 Seyarto et al. By Ochoa Bogh",34,5,0,1,40
1570769,1183666,2022-04-05,Assembly,"Do pass as amended and be re-referred to the Committee on [Judiciary]",10,2,0,3,15
1570769,1189839,2022-04-19,Assembly,"Do pass as amended",7,2,0,2,11
1570770,1171446,2022-03-16,Assembly,"Do pass and be re-referred to the Committee on [Higher Education]",4,0,0,2,6
1570770,1190656,2022-04-19,Assembly,"Do pass as amended and be re-referred to the Committee on [Appropriations]",9,1,0,2,12
1570770,1206355,2022-05-19,Assembly,"Do pass as amended",12,4,0,0,16
1570770,1210529,2022-05-26,Assembly,"AB 1691 Medina Assembly Third Reading",55,11,0,12,78
1570770,1215880,2022-06-13,Senate,"Do pass, but first be re-referred to the Committee on [Appropriations]",5,0,0,0,5
1570770,1219429,2022-06-27,Senate,"Placed on suspense file",6,0,0,1,7
1570770,1223907,2022-08-11,Senate,"Do pass as amended",5,2,0,0,7
1570771,1221306,2022-06-30,Assembly,"Be adopted. To Consent Calendar",7,0,0,4,11
1570771,1223043,2022-08-04,Assembly,"ACR 125 Boerner Horvath Consent Calendar Second Day Regular Session",76,0,0,4,80
1570772,1165737,2022-03-08,Senate,"Do pass, but first be re-referred to the Committee on [Appropriations]",9,0,0,0,9
1570772,1191245,2022-04-21,Senate,"Senate 3rd Reading SB867 Laird et al",39,0,0,1,40
1570772,1214369,2022-06-06,Assembly,"Do pass as amended and be re-referred to the Committee on [Appropriations]",8,1,0,1,10
1570772,1223381,2022-08-11,Assembly,"Do pass as amended",13,2,0,1,16
1570772,1224283,2022-08-22,Assembly,"SB 867 Laird Senate Third Reading By Berman",67,0,0,13,80
1570772,1224653,2022-08-24,Senate,"That the Assembly amendments be concurred in",8,0,0,1,9
1570772,1225694,2022-08-30,Senate,"Unfinished Business SB867 Laird et al. Concurrence",38,0,0,2,40
1570773,1183711,2022-04-04,Senate,"Do pass, but first be re-referred to the Committee on [Appropriations]",4,0,0,1,5
1570773,1201497,2022-05-09,Senate,"Placed on suspense file",7,0,0,0,7
1570773,1206510,2022-05-19,Senate,"Do pass",5,1,0,1,7
1570773,1207765,2022-05-23,Senate,"Senate 3rd Reading SB868 Cortese et al",29,2,0,9,40
1570773,1217883,2022-06-22,Assembly,"Do pass and be re-referred to the Committee on [Appropriations]",6,0,0,1,7
1570773,1223644,2022-08-11,Assembly,"Do pass",13,1,0,2,16
1570773,1224195,2022-08-18,Assembly,"SB 868 Cortese Senate Third Reading By Cooper",62,2,0,16,80
1570774,1176482,2022-03-24,Senate,"Do pass as amended, but first amend, and re-refer to the Committee on [Public Safety]",5,2,0,2,9
1570774,1189334,2022-04-18,Senate,"Placed on suspense file",7,0,0,0,7
1570774,1206746,2022-05-19,Senate,"Do pass as amended",5,2,0,0,7
1570774,1209284,2022-05-25,Senate,"Senate 3rd Reading SB869 Leyva et al",29,9,0,2,40
1570774,1220719,2022-06-29,Assembly,"Do pass as amended and be re-referred to the Committee on [Appropriations]",6,2,0,0,8
1570774,1223932,2022-08-11,Assembly,"Do pass as amended",12,4,0,0,16
1570774,1225054,2022-08-29,Assembly,"SB 869 Leyva Senate Third Reading By Wicks",47,24,0,9,80
1570774,1225858,2022-08-30,Senate,"Unfinished Business SB869 Leyva et al. Concurrence",30,9,0,1,40
1570775,1179179,2022-03-29,Senate,"Do pass, but first be re-referred to the Committee on [Appropriations]",4,0,0,1,5
1570775,1189364,2022-04-18,Senate,"Placed on suspense file",7,0,0,0,7
1570775,1206654,2022-05-19,Senate,"Do pass",7,0,0,0,7
1570775,1209225,2022-05-25,Senate,"Special Consent SB870",39,0,0,1,40
1570775,1219969,2022-06-28,Assembly,"Do pass and be re-referred to the Committee on [Appropriations] with recommendation: To Consent Calendar",7,0,0,1,8
1570775,1224007,2022-08-11,Assembly,"Do pass",16,0,0,0,16
1570775,1225361,2022-08-31,Senate,"Unfinished Business SB870 Portantino et al. Concurrence",39,0,0,1,40
1570775,1225362,2022-08-31,Assembly,"SB 870 Portantino Senate Third Reading By Cristina Garcia",79,0,0,1,80
1570777,1183775,2022-04-04,Senate,"Do pass, but first be re-referred to the Committee on [Appropriations]",13,0,0,1,14
1570777,1189308,2022-04-18,Senate,"Placed on suspense file",7,0,0,0,7
1570777,1206479,2022-05-19,Senate,"Do pass",7,0,0,0,7
1570777,1209270,2022-05-25,Senate,"Special Consent SB872",39,0,0,1,40
1570777,1215829,2022-06-14,Assembly,"Do pass as amended and be re-referred to the Committee on [Appropriations]",16,0,0,2,18
1570777,1220823,2022-06-29,Assembly,"Do pass. To Consent Calendar",14,0,0,2,16
1570777,1223024,2022-08-04,Assembly,"SB 872 Dodd Consent Calendar Second Day Regular Session",76,0,0,4,80
1570777,1223233,2022-08-08,Senate,"Unfinished Business SB872 Dodd Concurrence",37,0,0,3,40
1570779,1183623,2022-04-04,Senate,"Do pass",4,0,0,1,5
1570779,1201379,2022-05-09,Senate,"Senate 3rd Reading SB874 Cortese et al",33,0,0,7,40
1570779,1217966,2022-06-22,Assembly,"Do pass",7,0,0,0,7
1570779,1222621,2022-08-01,Assembly,"SB 874 Cortese Senate Third Reading By Kalra",75,0,0,5,80
1570781,1140915,2022-02-10,Senate,"Senate 3rd Reading SCR65 Rubio et al",38,0,0,2,40
1570781,1154482,2022-02-24,Assembly,"Be adopted. To Consent Calendar",9,0,0,2,11
1570781,1162286,2022-03-03,Assembly,"SCR 65 Rubio Consent Calendar Second Day Regular Session",70,0,0,6,76
1572425,1184723,2022-04-05,Assembly,"Do pass and be re-referred to the Committee on [Appropriations]",8,0,0,1,9
1572425,1206680,2022-05-19,Assembly,"Do pass",16,0,0,0,16
1572425,1210279,2022-05-26,Assembly,"AB 1692 Voepel Assembly Third Reading",74,0,0,4,78
1572425,1220013,2022-06-28,Senate,"Do pass, but first be re-referred to the Committee on [Appropriations] with the recommendation: To Consent Calendar",6,0,0,1,7
1572425,1222745,2022-08-01,Senate,"Placed on suspense file",7,0,0,0,7
1572425,1223741,2022-08-11,Senate,"Do pass",7,0,0,0,7
1572425,1224612,2022-08-23,Senate,"Special Consent AB1692",40,0,0,0,40
1572428,1194248,2022-04-27,Assembly,"Do pass and be re-referred to the Committee on [Appropriations]",7,1,0,0,8
1572428,1205864,2022-05-18,Assembly,"Do pass",11,3,0,2,16
1572428,1210572,2022-05-25,Assembly,"AB 1695 Santiago Assembly Third Reading",54,12,0,12,78
1572428,1218037,2022-06-21,Senate,"Do pass, but first be re-referred to the Committee on [Appropriations]",7,0,0,2,9
1572428,1225709,2022-08-29,Senate,"Assembly 3rd Reading AB1695 Santiago By Stern",40,0,0,0,40
1572428,1225710,2022-08-30,Assembly,"AB 1695 Santiago Concurrence in Senate Amendments",77,0,0,3,80
1572428,1229711,2022-08-30,Senate,"Assembly 3rd Reading AB1695 Santiago By Stern",40,0,0,0,40
1572431,1165729,2022-03-08,Assembly,"Do pass as amended and be re-referred to the Committee on [Appropriations]",5,0,0,2,7
1572433,1165757,2022-03-08,Assembly,"Do pass and be re-referred to the Committee on [Appropriations]",7,0,0,0,7
1572433,1206260,2022-05-19,Assembly,"Do pass",15,0,0,1,16
1572433,1210292,2022-05-26,Assembly,"AB 1700 Maienschein Assembly Third Reading",75,0,0,3,78
1572433,1217344,2022-06-21,Senate,"Do pass as amended, but first amend, and re-refer to the Committee on [Appropriations]",4,0,0,1,5
1572433,1222844,2022-08-01,Senate,"Placed on suspense file",7,0,0,0,7
1572433,1223448,2022-08-11,Senate,"Do pass",6,0,0,1,7
1572433,1225824,2022-08-29,Senate,"Assembly 3rd Reading AB1700 Maienschein By Umberg",40,0,0,0,40
1572433,1225825,2022-08-30,Assembly,"AB 1700 Maienschein Concurrence in Senate Amendments",76,0,0,4,80
1572434,1170609,2022-03-15,Assembly,"Do pass and be re-referred to the Committee on [Appropriations]",9,0,0,3,12
1572435,1180250,2022-03-30,Senate,"Do pass, but first be re-referred to the Committee on [Appropriations]",7,0,0,0,7
1572435,1189384,2022-04-18,Senate,"Placed on suspense file",7,0,0,0,7
1572435,1206606,2022-05-19,Senate,"Do pass as amended",7,0,0,0,7
1572435,1210009,2022-05-26,Senate,"Special Consent SB876",38,0,0,2,40
1572435,1220621,2022-06-29,Assembly,"Do pass as amended, and be re-referred to the Committee on [Appropriations] with recommendation: To Consent Calendar",7,0,0,0,7
1572436,1170587,2022-03-15,Senate,"Do pass, but first be re-referred to the Committee on [Appropriations] with the recommendation: To Consent Calendar",5,0,0,0,5
1572436,1182505,2022-04-04,Senate,"Placed on suspense file",6,0,0,1,7
1572436,1206391,2022-05-19,Senate,"Do pass",7,0,0,0,7
1572436,1209328,2022-05-25,Senate,"Special Consent SB877",39,0,0,1,40
1572436,1215888,2022-06-14,Assembly,"Do pass and be re-referred to the Committee on [Appropriations] with recommendation: To Consent Calendar",7,0,0,1,8
1572436,1223517,2022-08-11,Assembly,"Do pass",16,0,0,0,16
1572436,1225443,2022-08-31,Senate,"Unfinished Business SB877 Eggman Concurrence",39,0,0,1,40
1572436,1225444,2022-08-31,Assembly,"SB 877 Eggman Senate Third Reading By Blanca Rubio",79,0,0,1,80
1572437,1180255,2022-03-30,Senate,"Do pass as amended, but first amend, and re-refer to the Committee on [Appropriations]",6,0,0,1,7
1572437,1192214,2022-04-25,Senate,"Placed on suspense file",5,0,0,2,7
1572437,1206961,2022-05-19,Senate,"Do pass",5,1,0,1,7
1572437,1207780,2022-05-23,Senate,"Senate 3rd Reading SB878 Skinner et al",28,1,0,11,40
1572437,1220734,2022-06-29,Assembly,"Do pass as amended and be re-referred to the Committee on [Appropriations]",7,0,0,0,7
1572437,1223649,2022-08-11,Assembly,"Do pass as amended",12,0,0,4,16
1574196,1176488,2022-03-23,Assembly,"Do pass and be re-referred to the Committee on [Appropriations]",7,0,0,0,7
1574196,1206982,2022-05-19,Assembly,"Do pass",16,0,0,0,16
1574196,1210509,2022-05-25,Assembly,"AB 1703 Ramos Assembly Third Reading",76,0,0,2,78
1574196,1216359,2022-06-15,Senate,"Do pass, but first be re-referred to the Committee on [Appropriations] with the recommendation: To Consent Calendar",6,0,0,1,7
1574196,1219422,2022-06-27,Senate,"Placed on suspense file",6,0,0,1,7
1574196,1223900,2022-08-11,Senate,"Do pass as amended",7,0,0,0,7
1574196,1224150,2022-08-17,Senate,"Assembly 3rd Reading AB1703 Ramos et al. By Lim贸n",38,0,0,2,40
1574196,1224332,2022-08-22,Assembly,"AB 1703 Ramos Concurrence in Senate Amendments",76,0,0,4,80
1574197,1183847,2022-04-05,Assembly,"Do pass as amended and be re-referred to the Committee on [Business and Professions]",14,0,0,1,15
1574197,1189912,2022-04-19,Assembly,"Do pass and be re-referred to the Committee on [Appropriations]",19,0,0,0,19
1574197,1205848,2022-05-18,Assembly,"Do pass",15,0,0,1,16
1574197,1210630,2022-05-25,Assembly,"AB 1704 Chen Assembly Third Reading",76,0,0,2,78
1574197,1216268,2022-06-15,Senate,"Do pass as amended, but first amend, and re-refer to the Committee on [Business, Professions and Economic Development]",9,0,0,2,11
1574197,1219376,2022-06-27,Senate,"Do pass, but first be re-referred to the Committee on [Appropriations]",14,0,0,0,14
1574197,1222674,2022-08-01,Senate,"Placed on suspense file",7,0,0,0,7
1574197,1223599,2022-08-11,Senate,"Do pass",7,0,0,0,7
1574197,1225978,2022-08-31,Senate,"Special Consent AB1704",40,0,0,0,40
1574197,1225979,2022-08-31,Assembly,"AB 1704 Chen Concurrence in Senate Amendments",78,0,0,2,80
1574198,1194450,2022-04-26,Assembly,"Do pass and be re-referred to the Committee on [Appropriations]",12,0,0,0,12
1574198,1206270,2022-05-19,Assembly,"Do pass",16,0,0,0,16
1574198,1210554,2022-05-25,Assembly,"AB 1705 Irwin Assembly Third Reading",76,0,0,2,78
1574198,1218021,2022-06-22,Senate,"Do pass, but first be re-referred to the Committee on [Appropriations]",6,0,0,1,7
1574198,1222677,2022-08-01,Senate,"Placed on suspense file",7,0,0,0,7
1574198,1223779,2022-08-11,Senate,"Do pass",7,0,0,0,7
1574198,1224872,2022-08-25,Senate,"Assembly 3rd Reading AB1705 Irwin et al. By Pan",40,0,0,0,40
1574198,1225072,2022-08-29,Assembly,"AB 1705 Irwin Concurrence in Senate Amendments",77,0,0,3,80
1574199,1165746,2022-03-08,Assembly,"Do pass as amended and be re-referred to the Committee on [Appropriations]",7,0,0,0,7
1574199,1206941,2022-05-19,Assembly,"Do pass as amended",12,0,0,4,16
1574199,1210543,2022-05-26,Assembly,"AB 1706 Mia Bonta Assembly Third Reading",67,0,0,11,78
1574199,1217431,2022-06-21,Senate,"Do pass, but first be re-referred to the Committee on [Appropriations] with the recommendation: To Consent Calendar",4,0,0,1,5
1574199,1222681,2022-08-01,Senate,"Placed on suspense file",7,0,0,0,7
1574199,1223450,2022-08-11,Senate,"Do pass as amended",6,0,0,1,7
1574199,1224239,2022-08-18,Senate,"Assembly 3rd Reading AB1706 Mia Bonta et al. By Wiener",38,0,0,2,40
1574199,1224259,2022-08-22,Assembly,"AB 1706 Mia Bonta Concurrence in Senate Amendments",71,0,0,9,80
1574200,1174535,2022-03-21,Assembly,"Do pass and be re-referred to the Committee on [Appropriations]",11,0,0,0,11
1574200,1206937,2022-05-19,Assembly,"Do pass",16,0,0,0,16
1574200,1207818,2022-05-23,Assembly,"AB 1707 Boerner Horvath Assembly Third Reading",73,0,0,5,78
1574200,1216305,2022-06-15,Senate,"Do pass, but first be re-referred to the Committee on [Appropriations] with the recommendation: To Consent Calendar",5,0,0,0,5
1574200,1219368,2022-06-27,Senate,"Placed on suspense file",6,0,0,1,7
1574200,1223444,2022-08-11,Senate,"Do pass",6,0,0,1,7
1574200,1224207,2022-08-18,Senate,"Assembly 3rd Reading AB1707 Boerner Horvath By Caballero",38,0,0,2,40
1574201,1189861,2022-04-19,Assembly,"Do pass and be re-referred to the Committee on [Judiciary]",2,5,0,0,7
1574204,1189810,2022-04-19,Assembly,"Do pass as amended and be re-referred to the Committee on [Appropriations]",10,0,0,1,11
1574204,1199970,2022-05-04,Assembly,"Do pass",14,0,0,2,16
1574204,1204129,2022-05-12,Assembly,"AB 1711 Seyarto Assembly Third Reading",65,0,0,13,78
1574204,1216244,2022-06-14,Senate,"Do pass, but first be re-referred to the Committee on [Appropriations]",6,0,0,5,11
1574204,1224485,2022-08-23,Senate,"Assembly 3rd Reading AB1711 Seyarto By Jones",26,2,0,12,40
1574204,1224705,2022-08-24,Assembly,"AB 1711 Seyarto Concurrence in Senate Amendments",74,1,0,5,80
1574205,1170585,2022-03-15,Assembly,"Do pass as amended and be re-referred to the Committee on [Appropriations]",10,0,0,2,12
1574205,1203382,2022-05-11,Assembly,"Do pass as amended",16,0,0,0,16
1574205,1210398,2022-05-25,Assembly,"AB 1712 Medina Assembly Third Reading",76,0,0,2,78
1574205,1218051,2022-06-22,Senate,"Do pass, but first be re-referred to the Committee on [Appropriations]",6,0,0,1,7
1574205,1224184,2022-08-18,Senate,"Assembly 3rd Reading AB1712 Medina By Lim贸n",38,0,0,2,40
1574206,1181287,2022-03-28,Assembly,"Do pass and be re-referred to the Committee on [Appropriations]",9,3,0,3,15
1574206,1199958,2022-05-04,Assembly,"Do pass",10,4,0,2,16
1574206,1210411,2022-05-25,Assembly,"AB 1713 Boerner Horvath Assembly Third Reading",49,20,0,9,78
1574206,1220635,2022-06-28,Senate,"Do pass, but first be re-referred to the Committee on [Appropriations]",15,2,0,0,17
1574207,1171445,2022-03-16,Assembly,"Do pass and be re-referred to the Committee on [Judiciary]",6,0,0,0,6
1574207,1179250,2022-03-29,Assembly,"Do pass and be re-referred to the Committee on [Appropriations]",10,0,0,0,10
1574207,1206717,2022-05-19,Assembly,"Do pass",16,0,0,0,16
1574207,1210302,2022-05-26,Assembly,"AB 1714 Cooper Assembly Third Reading",75,0,0,3,78
1574207,1215856,2022-06-13,Senate,"Do pass, but first be re-referred to the Committee on [Judiciary] with the recommendation: To Consent Calendar",5,0,0,0,5
1574207,1218022,2022-06-21,Senate,"Do pass, but first be re-referred to the Committee on [Appropriations] with the recommendation: To Consent Calendar",11,0,0,0,11
1574207,1222650,2022-08-01,Senate,"Placed on suspense file",7,0,0,0,7
1574207,1224051,2022-08-11,Senate,"Do pass",7,0,0,0,7
1574207,1224437,2022-08-23,Senate,"Special Consent AB1714",40,0,0,0,40
1574208,1184735,2022-04-05,Assembly,"Do pass and be re-referred to the Committee on [Appropriations]",8,0,0,1,9
1574208,1194363,2022-04-27,Assembly,"Do pass. To Consent Calendar",15,0,0,1,16
1574208,1200645,2022-05-05,Assembly,"AB 1715 Muratsuchi Consent Calendar Second Day Regular Session",61,0,0,17,78
1574208,1215796,2022-06-14,Senate,"Do pass as amended, but first amend, and re-refer to the Committee on [Appropriations] with the recommendation: To Consent Calendar",5,0,0,2,7
1574208,1225627,2022-08-29,Senate,"Assembly 3rd Reading AB1715 Muratsuchi By Archuleta",40,0,0,0,40
1574208,1225628,2022-08-30,Assembly,"AB 1715 Muratsuchi Concurrence in Senate Amendments",77,0,0,3,80
1574208,1229709,2022-08-30,Senate,"Assembly 3rd Reading AB1715 Muratsuchi By Archuleta",40,0,0,0,40
1574209,1193256,2022-04-25,Assembly,"Be adopted. To Consent Calendar",15,0,0,0,15
1574209,1195759,2022-04-28,Assembly,"ACR 126 Cunningham Consent Calendar Second Day Regular Session",71,0,0,6,77
1574209,1220699,2022-06-28,Senate,"Be adopted, but first be re-referred to the Committee on [Appropriations] with recommendation: To Consent Calendar",16,0,0,1,17
1574209,1223290,2022-08-08,Senate,"Consent Calendar ACR126",36,0,0,4,40
1574209,1224604,2022-08-23,Assembly,"ACR 126 Cunningham Concurrence in Senate Amendments",76,0,0,4,80
1574210,1129903,2022-01-27,Assembly,"Be adopted. To third reading",8,0,0,4,12
1574210,1154466,2022-02-24,Senate,"Assembly 3rd Reading ACR127 Akilah Weber et al. By Pan",37,0,0,3,40
1574211,1223060,2022-08-04,Assembly,"Be adopted. To Consent Calendar",9,0,0,3,12
1574211,1223722,2022-08-11,Assembly,"HR 83 Seyarto Consent Calendar Second Day Regular Session",76,0,0,4,80
1574212,1179246,2022-03-29,Senate,"Do pass, but first be re-referred to the Committee on [Appropriations] with the recommendation: To Consent Calendar",11,0,0,0,11
1574212,1192187,2022-04-25,Senate,"Placed on suspense file",5,0,0,2,7
1574212,1206567,2022-05-19,Senate,"Do pass as amended",7,0,0,0,7
1574212,1210002,2022-05-26,Senate,"Special Consent SB879",38,0,0,2,40
1574212,1215740,2022-06-14,Assembly,"Do pass and be re-referred to the Committee on [Appropriations] with recommendation: To Consent Calendar",10,0,0,1,11
1574212,1223488,2022-08-11,Assembly,"Do pass",16,0,0,0,16
1574212,1224214,2022-08-18,Assembly,"SB 879 Wiener Senate Third Reading By Bloom",75,0,0,5,80
1574213,1165738,2022-03-08,Senate,"Do pass, but first be re-referred to the Committee on [Appropriations] with the recommendation: To Consent Calendar",9,0,0,0,9
1574213,1182575,2022-04-04,Senate,"Placed on suspense file",6,0,0,1,7
1574213,1207006,2022-05-19,Senate,"Do pass",7,0,0,0,7
1574213,1209358,2022-05-25,Senate,"Special Consent SB880",39,0,0,1,40
1574213,1220082,2022-06-28,Assembly,"Do pass and be re-referred to the Committee on [Appropriations] with recommendation: To Consent Calendar",14,0,0,1,15
1574213,1223010,2022-08-03,Assembly,"Do pass. To Consent Calendar",15,0,0,1,16
1574213,1223838,2022-08-11,Assembly,"SB 880 Laird Consent Calendar Second Day Regular Session",76,0,0,4,80
1574214,1179182,2022-03-28,Senate,"Do pass, but first be re-referred to the Committee on [Appropriations]",9,0,0,5,14
1574214,1204649,2022-05-16,Senate,"Placed on suspense file",6,0,0,1,7
1574215,1170625,2022-03-15,Senate,"Do pass as amended, but first amend, and re-refer to the Committee on [Appropriations]",5,0,0,0,5
1574215,1198282,2022-05-02,Senate,"Placed on suspense file",7,0,0,0,7
1574215,1206642,2022-05-19,Senate,"Do pass as amended",7,0,0,0,7
1574215,1209964,2022-05-26,Senate,"Special Consent SB882",38,0,0,2,40
1574215,1215871,2022-06-14,Assembly,"Do pass and be re-referred to the Committee on [Appropriations] with recommendation: To Consent Calendar",7,0,0,1,8
1574215,1223967,2022-08-11,Assembly,"Do pass as amended",12,0,0,4,16
1574215,1224153,2022-08-18,Assembly,"SB 882 Eggman Senate Third Reading By Lackey",75,0,0,5,80
1574215,1224647,2022-08-24,Senate,"Unfinished Business SB882 Eggman et al. Concurrence",40,0,0,0,40
1574216,1175560,2022-03-23,Senate,"Do pass as amended, but first amend, and re-refer to the Committee on [Appropriations]",11,0,0,0,11
1574216,1189302,2022-04-18,Senate,"Placed on suspense file",7,0,0,0,7
1574216,1206417,2022-05-19,Senate,"Do pass",7,0,0,0,7
1574216,1208515,2022-05-24,Senate,"Senate 3rd Reading SB883 Roth et al",37,0,0,3,40
1574216,1217419,2022-06-21,Assembly,"Do pass and be re-referred to the Committee on [Appropriations] with recommendation: To Consent Calendar",15,0,0,0,15
1574216,1223625,2022-08-11,Assembly,"Do pass",16,0,0,0,16
1574216,1224379,2022-08-22,Assembly,"SB 883 Roth Senate Third Reading By Aguiar-Curry",77,0,0,3,80
1574217,1189854,2022-04-18,Senate,"Do pass, but first be re-referred to the Committee on [Governance and Finance]",10,0,0,4,14
1574217,1190649,2022-04-20,Senate,"Do pass as amended, but first amend, and re-refer to the Committee on [Appropriations]",4,1,0,0,5
1574217,1201391,2022-05-09,Senate,"Placed on suspense file",7,0,0,0,7
1574217,1206969,2022-05-19,Senate,"Do pass",5,2,0,0,7
1574217,1207762,2022-05-23,Senate,"Senate 3rd Reading SB884 McGuire",25,3,0,12,40
1574217,1218007,2022-06-22,Assembly,"Do pass and be re-referred to the Committee on [Natural Resources]",12,0,0,3,15
1574217,1223718,2022-08-11,Assembly,"Do pass as amended",11,2,0,3,16
1574217,1225623,2022-08-30,Senate,"Unfinished Business SB884 McGuire Concurrence",31,9,0,0,40
1574217,1225624,2022-08-30,Assembly,"SB 884 McGuire Senate Third Reading By Mullin",67,0,0,13,80
1574218,1143400,2022-02-14,Senate,"Senate 3rd Reading SR65 Grove",35,0,0,5,40
1575728,1170641,2022-03-15,Assembly,"Do pass. To Consent Calendar",10,0,0,0,10
1575728,1173475,2022-03-21,Assembly,"AB 1716 Maienschein Consent Calendar Second Day",72,0,0,4,76
1575728,1210913,2022-05-31,Senate,"Do pass and be ordered to the Consent Calendar",8,0,0,3,11
1575728,1215265,2022-06-09,Senate,"Consent Calendar AB1716",38,0,0,2,40
1575728,1215534,2022-06-13,Assembly,"AB 1716 Maienschein Concurrence in Senate Amendments",75,0,0,3,78
1575729,1171437,2022-03-16,Assembly,"Do pass and be re-referred to the Committee on [Appropriations]",6,0,0,1,7
1575729,1206245,2022-05-19,Assembly,"Do pass as amended",13,3,0,0,16
1575729,1210297,2022-05-26,Assembly,"AB 1717 Aguiar-Curry Assembly Third Reading",58,11,0,9,78
1575729,1215809,2022-06-13,Senate,"Do pass, but first be re-referred to the Committee on [Appropriations]",4,1,0,0,5
1575729,1219505,2022-06-27,Senate,"Placed on suspense file",6,0,0,1,7
1575729,1223440,2022-08-11,Senate,"Do pass",5,2,0,0,7
1575729,1225613,2022-08-29,Senate,"Assembly 3rd Reading AB1717 Aguiar-Curry By Cortese",27,10,0,3,40
1575729,1225614,2022-08-30,Assembly,"AB 1717 Aguiar-Curry Concurrence in Senate Amendments",62,10,0,8,80
1575730,1176491,2022-03-23,Assembly,"Do pass and be re-referred to the Committee on [Appropriations]",7,0,0,0,7
1575730,1206247,2022-05-19,Assembly,"Do pass",16,0,0,0,16
1575730,1210566,2022-05-25,Assembly,"AB 1718 Boerner Horvath Assembly Third Reading",75,0,0,3,78
1575730,1218006,2022-06-22,Senate,"Do pass, but first be re-referred to the Committee on [Appropriations] with the recommendation: To Consent Calendar",6,0,0,1,7
1575730,1222884,2022-08-01,Senate,"Placed on suspense file",7,0,0,0,7
1575731,1183755,2022-04-05,Assembly,"Do pass and be re-referred to the Committee on [Education]",6,1,0,1,8
1575731,1194285,2022-04-26,Assembly,"Do pass and be re-referred to the Committee on [Appropriations]",9,1,0,2,12
1575731,1206686,2022-05-19,Assembly,"Do pass",12,4,0,0,16
1575731,1207709,2022-05-23,Assembly,"AB 1719 Ward Assembly Third Reading",56,16,0,6,78
1575731,1215842,2022-06-13,Senate,"Do pass, but first be re-referred to the Committee on [Appropriations]",8,1,0,0,9
1575731,1215843,2022-06-13,Senate,"[06-14-2022] set for [First] hearing: Reconsideration of favorable vote granted",9,0,0,0,9
1575731,1215844,2022-06-13,Senate,"Do pass, but first be re-referred to the Committee on [Appropriations]",7,2,0,0,9
1575731,1217061,2022-06-20,Senate,"Placed on suspense file",4,0,0,3,7
1575731,1223532,2022-08-11,Senate,"Do pass",5,2,0,0,7
1575731,1225260,2022-08-30,Senate,"Assembly 3rd Reading AB1719 Ward By Cortese",29,9,0,2,40
1575732,1174586,2022-03-22,Assembly,"Do pass and be re-referred to the Committee on [Appropriations]",7,0,0,1,8
1575732,1206311,2022-05-19,Assembly,"Do pass",12,3,0,1,16
1575732,1210381,2022-05-26,Assembly,"AB 1720 Holden Assembly Third Reading",50,17,0,11,78
1575732,1217417,2022-06-20,Senate,"Do pass, but first be re-referred to the Committee on [Public Safety]",3,1,0,1,5
1575732,1220582,2022-06-28,Senate,"Do pass, but first be re-referred to the Committee on [Appropriations]",5,0,0,0,5
1575732,1225247,2022-08-29,Senate,"Assembly 3rd Reading AB1720 Holden By Skinner",29,8,0,3,40
1575732,1225248,2022-08-30,Assembly,"AB 1720 Holden Concurrence in Senate Amendments",54,19,0,7,80
1575733,1182498,2022-04-04,Assembly,"Do pass and be re-referred to the Committee on [Appropriations]",7,0,0,0,7
1575733,1206753,2022-05-19,Assembly,"Do pass as amended",12,0,0,4,16
1575733,1210247,2022-05-26,Assembly,"AB 1721 Rodriguez Assembly Third Reading",75,0,0,3,78
1575734,1171436,2022-03-16,Assembly,"Do pass and be re-referred to the Committee on [Appropriations]",6,0,0,0,6
1575734,1206868,2022-05-19,Assembly,"Do pass",16,0,0,0,16
1575734,1210338,2022-05-25,Assembly,"AB 1722 Cooper Assembly Third Reading",76,0,0,2,78
1575734,1220832,2022-06-29,Senate,"Do pass, but first be re-referred to the Committee on [Appropriations] with the recommendation: To Consent Calendar",5,0,0,0,5
1575734,1222762,2022-08-01,Senate,"Placed on suspense file",7,0,0,0,7
1575734,1224003,2022-08-11,Senate,"Do pass",7,0,0,0,7
1575734,1224502,2022-08-23,Senate,"Special Consent AB1722",40,0,0,0,40
1575735,1189892,2022-04-19,Assembly,"Do pass and be re-referred to the Committee on [Public Employment and Retirement] with recommendation: To Consent Calendar",9,0,0,2,11
1575735,1190576,2022-04-20,Assembly,"Do pass and be re-referred to the Committee on [Appropriations]",5,0,0,1,6
1575736,1197955,2022-04-26,Assembly,"Do pass and be re-referred to the Committee on [Appropriations]",7,2,0,0,9
1575738,1170595,2022-03-15,Assembly,"Do pass and be re-referred to the Committee on [Appropriations] with recommendation: To Consent Calendar",10,0,0,0,10
1575738,1184688,2022-04-06,Assembly,"Do pass. To Consent Calendar",13,0,0,3,16
1575738,1191246,2022-04-21,Assembly,"AB 1726 Aguiar-Curry Consent Calendar Second Day Regular Session",68,0,0,9,77
1575738,1210927,2022-05-31,Senate,"Do pass, but first be re-referred to the Committee on [Appropriations] with the recommendation: To Consent Calendar",8,0,0,3,11
1575738,1224143,2022-08-17,Senate,"Assembly 3rd Reading AB1726 Aguiar-Curry By Newman",38,0,0,2,40
1575738,1224299,2022-08-22,Assembly,"AB 1726 Aguiar-Curry Concurrence in Senate Amendments",76,0,0,4,80
1575739,1134582,2022-02-03,Assembly,"Be adopted. To third reading",9,0,0,3,12
1575739,1154481,2022-02-24,Senate,"Assembly 3rd Reading ACR128",37,0,0,3,40
1575740,1134604,2022-02-03,Assembly,"Be adopted. To Consent Calendar",9,0,0,3,12
1575740,1140901,2022-02-10,Assembly,"HR 84 Calderon Consent Calendar Second Day",65,0,0,10,75
1575741,1166915,2022-03-09,Senate,"Do pass, but first be re-referred to the Committee on [Human Services]",7,0,0,0,7
1575741,1179195,2022-03-29,Senate,"Do pass as amended, but first amend, and re-refer to the Committee on [Appropriations] with the recommendation: To Consent Calendar",4,0,0,1,5
1575741,1189327,2022-04-18,Senate,"Placed on suspense file",7,0,0,0,7
1575741,1206468,2022-05-19,Senate,"Do pass",7,0,0,0,7
1575741,1209361,2022-05-25,Senate,"Special Consent SB885",39,0,0,1,40
1575741,1215922,2022-06-14,Assembly,"Do pass and be re-referred to the Committee on [Human Services]",12,0,0,0,12
1575741,1219950,2022-06-28,Assembly,"Do pass and be re-referred to the Committee on [Appropriations] with recommendation: To Consent Calendar",7,0,0,1,8
1575742,1194466,2022-04-27,Senate,"Do pass as amended, but first amend, and re-refer to the Committee on [Appropriations]",6,0,0,1,7
1575742,1204673,2022-05-16,Senate,"Placed on suspense file",6,0,0,1,7
1575742,1206778,2022-05-19,Senate,"Do pass as amended",5,0,0,2,7
1575742,1208508,2022-05-24,Senate,"Senate 3rd Reading SB886 Wiener et al",33,1,0,6,40
1575742,1215557,2022-06-13,Assembly,"Do pass as amended and be re-referred to the Committee on [Appropriations]",6,1,0,4,11
1575742,1223523,2022-08-11,Assembly,"Do pass",14,0,0,2,16
1575742,1224264,2022-08-22,Assembly,"SB 886 Wiener Senate Third Reading By Robert Rivas",70,2,0,8,80
1575742,1224758,2022-08-24,Senate,"Unfinished Business SB886 Wiener et al. Concurrence",37,1,0,2,40
1575743,1179494,2022-03-28,Senate,"Do pass as amended, but first amend, and re-refer to the Committee on [Appropriations]",13,0,0,1,14
1575743,1189322,2022-04-18,Senate,"Placed on suspense file",7,0,0,0,7
1575743,1206798,2022-05-19,Senate,"Do pass as amended",5,2,0,0,7
1575743,1208513,2022-05-24,Senate,"Senate 3rd Reading SB887 Becker et al",29,6,0,5,40
1575743,1217885,2022-06-22,Assembly,"Do pass as amended and be re-referred to the Committee on [Appropriations]",15,0,0,0,15
1575743,1223501,2022-08-11,Assembly,"Do pass",16,0,0,0,16
1575743,1224188,2022-08-18,Assembly,"SB 887 Becker Senate Third Reading By Mayes",75,0,0,5,80
1575743,1225465,2022-08-29,Senate,"Unfinished Business SB887 Becker et al. Concurrence",40,0,0,0,40
1578034,1183822,2022-04-05,Assembly,"Do pass and be re-referred to the Committee on [Appropriations]",6,2,0,0,8
1578034,1206823,2022-05-19,Assembly,"Do pass as amended",12,4,0,0,16
1578034,1210552,2022-05-26,Assembly,"AB 1728 Robert Rivas Assembly Third Reading",56,16,0,6,78
1578034,1220108,2022-06-27,Senate,"Do pass, but first be re-referred to the Committee on [Appropriations]",4,0,0,1,5
1578034,1222783,2022-08-01,Senate,"Placed on suspense file",7,0,0,0,7
1578035,1200501,2022-05-05,Assembly,"Do pass and be re-referred to the Committee on [Appropriations]",11,0,0,0,11
1578036,1170606,2022-03-15,Assembly,"Do pass. To Consent Calendar",10,0,0,0,10
1578036,1173496,2022-03-21,Assembly,"AB 1730 Davies Consent Calendar Second Day Regular Session",72,0,0,4,76
1578036,1210929,2022-05-31,Senate,"Do pass, but first be re-referred to the Committee on [Military and Veterans Affairs] with the recommendation: To Consent Calendar",8,0,0,3,11
1578036,1215748,2022-06-14,Senate,"Do pass and be ordered to the Consent Calendar",5,0,0,2,7
1578036,1217113,2022-06-20,Senate,"Consent Calendar AB1730 Davies et al",38,0,0,2,40
1578037,1170621,2022-03-15,Assembly,"Do pass and be re-referred to the Committee on [Military and Veterans Affairs]",11,0,0,1,12
1578037,1184701,2022-04-05,Assembly,"Do pass and be re-referred to the Committee on [Appropriations]",8,0,0,1,9
1578037,1206807,2022-05-19,Assembly,"Do pass",16,0,0,0,16
1578037,1210318,2022-05-26,Assembly,"AB 1731 Davies Assembly Third Reading",76,0,0,2,78
1578037,1216317,2022-06-15,Senate,"Do pass, but first be re-referred to the Committee on [Military and Veterans Affairs]",6,0,0,1,7
1578037,1219883,2022-06-28,Senate,"Do pass, but first be re-referred to the Committee on [Appropriations] with the recommendation: To Consent Calendar",6,0,0,1,7
1578037,1223255,2022-08-08,Senate,"Placed on suspense file",7,0,0,0,7
1578037,1223601,2022-08-11,Senate,"Do pass",7,0,0,0,7
1578037,1224631,2022-08-23,Senate,"Special Consent AB1731",40,0,0,0,40
1578037,1224697,2022-08-24,Assembly,"AB 1731 Davies Concurrence in Senate Amendments",76,0,0,4,80
1578038,1165753,2022-03-08,Assembly,"Do pass and be re-referred to the Committee on [Transportation] with recommendation: To Consent Calendar",7,0,0,0,7
1578038,1174549,2022-03-21,Assembly,"Do pass and be re-referred to the Committee on [Appropriations]",15,0,0,0,15
1578038,1184670,2022-04-06,Assembly,"Do pass. To Consent Calendar",13,0,0,3,16
1578038,1191270,2022-04-21,Assembly,"AB 1732 Patterson Consent Calendar Second Day Regular Session",68,0,0,9,77
1578038,1210916,2022-05-31,Senate,"Do pass and be ordered to the Consent Calendar",5,0,0,0,5
1578038,1211952,2022-05-31,Senate,"Do pass, but first be re-referred to the Committee on [Appropriations] with the recommendation: To Consent Calendar",5,0,0,0,5
1578038,1219431,2022-06-27,Senate,"Consent Calendar AB1732",37,0,0,3,40
1578040,1190643,2022-04-20,Assembly,"Do pass and be re-referred to the Committee on [Appropriations] with recommendation: To Consent Calendar",20,0,0,2,22
1578040,1199933,2022-05-04,Assembly,"Do pass. To Consent Calendar",14,0,0,2,16
1578040,1204077,2022-05-12,Assembly,"AB 1734 Bennett Consent Calendar Second Day Regular Session",65,0,0,13,78
1578040,1215821,2022-06-14,Senate,"Do pass, but first be re-referred to the Committee on [Appropriations] with the recommendation: To Consent Calendar",14,0,0,1,15
1578040,1223497,2022-08-11,Senate,"Consent Calendar AB1734 Bennett",38,0,0,2,40
1578041,1174496,2022-03-22,Assembly,"Do pass and be re-referred to the Committee on [Judiciary]",8,0,0,0,8
1578041,1179291,2022-03-29,Assembly,"Do pass and be re-referred to the Committee on [Appropriations] with recommendation: To Consent Calendar",10,0,0,0,10
1578041,1206513,2022-05-19,Assembly,"Do pass",16,0,0,0,16
1578041,1207800,2022-05-23,Assembly,"AB 1735 Bryan Assembly Third Reading",69,0,0,9,78
1578041,1217345,2022-06-20,Senate,"Do pass, but first be re-referred to the Committee on [Judiciary] with the recommendation: To Consent Calendar",4,0,0,1,5
1578041,1220641,2022-06-28,Senate,"Do pass, but first be re-referred to the Committee on [Appropriations] with the recommendation: To Consent Calendar",10,0,0,1,11
1578041,1222768,2022-08-01,Senate,"Placed on suspense file",7,0,0,0,7
1578041,1223750,2022-08-11,Senate,"Do pass",7,0,0,0,7
1578041,1225476,2022-08-31,Senate,"Special Consent AB1735",40,0,0,0,40
1578041,1225477,2022-08-31,Assembly,"AB 1735 Bryan Concurrence in Senate Amendments",80,0,0,0,80
1578042,1170601,2022-03-15,Assembly,"Do pass as amended",11,0,0,1,12
1578042,1176511,2022-03-24,Assembly,"AB 1736 Choi Assembly Third Reading",74,0,0,2,76
1578042,1215004,2022-06-08,Senate,"Do pass and be ordered to the Consent Calendar",7,0,0,0,7
1578042,1216653,2022-06-16,Senate,"Consent Calendar AB1736",35,0,0,5,40
1578043,1183612,2022-04-05,Assembly,"Do pass and be re-referred to the Committee on [Public Safety]",10,0,0,5,15
1578043,1193338,2022-04-26,Assembly,"Do pass and be re-referred to the Committee on [Appropriations]",5,0,0,2,7
1578043,1206367,2022-05-19,Assembly,"Do pass as amended",12,1,0,3,16
1578043,1210522,2022-05-26,Assembly,"AB 1737 Holden Assembly Third Reading",52,3,0,23,78
1578043,1217403,2022-06-20,Senate,"Do pass, but first be re-referred to the Committee on [Public Safety]",3,1,0,1,5
1578043,1220639,2022-06-28,Senate,"Do pass as amended, but first amend, and re-refer to the Committee on [Appropriations]",5,0,0,0,5
1578043,1222735,2022-08-01,Senate,"Placed on suspense file",7,0,0,0,7
1578043,1223748,2022-08-11,Senate,"Do pass as amended",6,1,0,0,7
1578043,1224455,2022-08-23,Senate,"Assembly 3rd Reading AB1737 Holden By Hurtado",32,2,0,6,40
1578044,1183602,2022-04-05,Assembly,"Do pass as amended and be re-referred to the Committee on [Education]",6,1,0,1,8
1578044,1191339,2022-04-20,Assembly,"Do pass as amended and be re-referred to the Committee on [Appropriations]",5,1,0,1,7
1578044,1206647,2022-05-19,Assembly,"Do pass",12,4,0,0,16
1578044,1210538,2022-05-26,Assembly,"AB 1738 Boerner Horvath Assembly Third Reading",46,21,0,11,78
1578044,1215879,2022-06-13,Senate,"Do pass, but first be re-referred to the Committee on [Appropriations]",7,0,0,2,9
1578044,1217062,2022-06-20,Senate,"Placed on suspense file",4,0,0,3,7
1578044,1223980,2022-08-11,Senate,"Do pass as amended",4,2,0,1,7
1578044,1224767,2022-08-24,Senate,"Assembly 3rd Reading AB1738 Boerner Horvath et a By Becker",32,8,0,0,40
1578044,1224907,2022-08-25,Assembly,"AB 1738 Boerner Horvath Concurrence in Senate Amendments",54,15,0,11,80
1578046,1183650,2022-04-05,Assembly,"Do pass and be re-referred to the Committee on [Appropriations]",16,0,0,2,18
1578046,1194364,2022-04-27,Assembly,"Do pass. To Consent Calendar",15,0,0,1,16
1578046,1200646,2022-05-05,Assembly,"AB 1740 Muratsuchi Consent Calendar Second Day Regular Session",61,0,0,17,78
1578046,1215897,2022-06-13,Senate,"Do pass, but first be re-referred to the Committee on [Appropriations]",13,0,0,1,14
1578046,1219452,2022-06-27,Senate,"Placed on suspense file",6,0,0,1,7
1578046,1223582,2022-08-11,Senate,"Do pass",7,0,0,0,7
1578046,1225906,2022-08-29,Senate,"Assembly 3rd Reading AB1740 Muratsuchi By Gonzalez",40,0,0,0,40
1578046,1225907,2022-08-30,Assembly,"AB 1740 Muratsuchi Concurrence in Senate Amendments",79,0,0,1,80
1578047,1195834,2022-04-28,Assembly,"Do pass",20,0,0,2,22
1578047,1207789,2022-05-23,Assembly,"AB 1741 Low Assembly Third Reading",58,0,0,20,78
1578047,1215861,2022-06-14,Senate,"Do pass",9,0,0,6,15
1578047,1217121,2022-06-20,Senate,"Assembly 3rd Reading AB1741 Low et al. By Eggman",31,0,0,9,40
1578048,1190659,2022-04-20,Assembly,"Do pass and be re-referred to the Committee on [Judiciary]",14,5,0,3,22
1578048,1193180,2022-04-26,Assembly,"Do pass and be re-referred to the Committee on [Appropriations]",7,1,0,2,10
1578048,1203322,2022-05-11,Assembly,"Do pass",12,4,0,0,16
1578048,1204571,2022-05-16,Assembly,"AB 1742 Robert Rivas Assembly Third Reading",51,14,0,13,78
1578048,1217416,2022-06-20,Senate,"Do pass, but first be re-referred to the Committee on [Judiciary]",9,3,0,2,14
1578048,1220828,2022-06-28,Senate,"Do pass, but first be re-referred to the Committee on [Appropriations]",9,1,0,1,11
1578048,1222882,2022-08-01,Senate,"Placed on suspense file",7,0,0,0,7
1578048,1223735,2022-08-11,Senate,"Do pass",5,2,0,0,7
1578048,1224458,2022-08-23,Senate,"Assembly 3rd Reading AB1742 Robert Rivas By Umberg",31,9,0,0,40
1578048,1224794,2022-08-24,Assembly,"AB 1742 Robert Rivas Concurrence in Senate Amendments",58,16,0,6,80
1578049,1193218,2022-04-26,Assembly,"Do pass and be re-referred to the Committee on [Appropriations]",14,0,0,1,15
1578049,1203344,2022-05-11,Assembly,"Do pass. To Consent Calendar",16,0,0,0,16
1578049,1206784,2022-05-19,Assembly,"AB 1743 Medina Consent Calendar Second Day",72,0,0,6,78
1578049,1217949,2022-06-21,Senate,"Do pass as amended, but first amend, and re-refer to the Committee on [Appropriations]",7,0,0,2,9
1578049,1225249,2022-08-30,Senate,"Assembly 3rd Reading AB1743 McKinnor By Bradford",40,0,0,0,40
1578049,1225250,2022-08-31,Assembly,"AB 1743 McKinnor Concurrence in Senate Amendments",79,0,0,1,80
1578050,1165725,2022-03-08,Assembly,"Do pass",6,0,0,1,7
1578050,1172366,2022-03-17,Assembly,"AB 1744 Levine Assembly Third Reading",65,0,0,11,76
1578050,1210895,2022-05-31,Senate,"Do pass",2,0,0,3,5
1578050,1210896,2022-05-31,Senate,"[First] hearing set for [05-31-2022]: Failed passage in Committee. Reconsideration granted",5,0,0,0,5
1578050,1215937,2022-06-14,Senate,"Do pass",3,0,0,2,5
1578050,1224359,2022-08-22,Senate,"Assembly 3rd Reading AB1744 Levine By Wiener",37,3,0,0,40
1578050,1224433,2022-08-23,Assembly,"AB 1744 Levine Concurrence in Senate Amendments",75,0,0,5,80
1578051,1170582,2022-03-15,Assembly,"Do pass. To Consent Calendar",10,0,0,0,10
1578051,1173498,2022-03-21,Assembly,"AB 1745 Nguyen Consent Calendar Second Day Regular Session",72,0,0,4,76
1578051,1210917,2022-05-31,Senate,"Do pass and be ordered to the Consent Calendar",8,0,0,3,11
1578051,1215303,2022-06-09,Senate,"Consent Calendar AB1745",38,0,0,2,40
1578052,1190704,2022-04-19,Assembly,"Do pass as amended and be re-referred to the Committee on [Appropriations]",12,0,0,0,12
1578052,1206359,2022-05-19,Assembly,"Do pass",15,0,0,1,16
1578052,1210505,2022-05-26,Assembly,"AB 1746 Medina Assembly Third Reading",75,0,0,3,78
1578052,1221266,2022-06-30,Senate,"Do pass, but first be re-referred to the Committee on [Appropriations]",7,0,0,0,7
1578053,1179141,2022-03-29,Assembly,"Do pass and be re-referred to the Committee on [Appropriations]",16,0,0,2,18
1578053,1206890,2022-05-19,Assembly,"Do pass",16,0,0,0,16
1578053,1210607,2022-05-25,Assembly,"AB 1747 Quirk Assembly Third Reading",76,0,0,2,78
1578053,1215753,2022-06-13,Senate,"Do pass, but first be re-referred to the Committee on [Appropriations]",12,0,0,2,14
1578053,1219513,2022-06-27,Senate,"Do pass",5,1,0,1,7
1578053,1224266,2022-08-22,Senate,"Assembly 3rd Reading AB1747 Quirk By Dodd",38,1,0,1,40
1578054,1140887,2022-02-10,Assembly,"Be adopted. To Consent Calendar",10,0,0,2,12
1578054,1150947,2022-02-22,Assembly,"ACR 129 Medina Consent Calendar Second Day",69,0,0,7,76
1578054,1173489,2022-03-21,Senate,"Special Consent ACR129",37,0,0,3,40
1578055,1193285,2022-04-25,Assembly,"Be adopted. To Consent Calendar",15,0,0,0,15
1578055,1195743,2022-04-28,Assembly,"ACR 130 Patterson Consent Calendar Second Day Regular Session",71,0,0,6,77
1578055,1220626,2022-06-28,Senate,"Be adopted, but first be re-referred to the Committee on [Appropriations] with recommendation: To Consent Calendar",16,0,0,1,17
1578055,1223064,2022-08-04,Senate,"Special Consent ACR130",35,0,0,5,40
1578058,1165735,2022-03-08,Senate,"Do pass, but first be re-referred to the Committee on [Appropriations]",3,6,0,0,9
1578059,1181259,2022-03-31,Senate,"Do pass, but first be re-referred to the Committee on [Environmental Quality]",5,0,0,0,5
1578059,1194113,2022-04-27,Senate,"Do pass, but first be re-referred to the Committee on [Appropriations]",5,0,0,2,7
1578059,1207729,2022-05-23,Senate,"Senate 3rd Reading SB891 Hertzberg",27,2,0,11,40
1578059,1216970,2022-06-14,Assembly,"Do pass and be re-referred to the Committee on [Local Government]",8,1,0,0,9
1578059,1220594,2022-06-29,Assembly,"Do pass and be re-referred to the Committee on [Appropriations]",6,0,0,2,8
1578059,1222976,2022-08-03,Assembly,"Do pass",12,2,0,2,16
1578059,1224067,2022-08-15,Assembly,"SB 891 Hertzberg Senate Third Reading By Luz Rivas",62,5,0,13,80
1578059,1224397,2022-08-23,Senate,"Unfinished Business SB891 Hertzberg Concurrence",31,4,0,5,40
1578060,1183834,2022-04-05,Senate,"Do pass, but first be re-referred to the Committee on [Appropriations]",9,0,0,6,15
1578060,1189376,2022-04-18,Senate,"Placed on suspense file",7,0,0,0,7
1578060,1206742,2022-05-19,Senate,"Do pass",5,2,0,0,7
1578060,1208505,2022-05-24,Senate,"Senate 3rd Reading SB892 Hurtado",25,7,0,8,40
1578060,1219477,2022-06-27,Assembly,"Do pass and be re-referred to the Committee on [Appropriations]",6,0,0,1,7
1578060,1223717,2022-08-11,Assembly,"Do pass as amended",12,0,0,4,16
1578060,1224422,2022-08-23,Assembly,"SB 892 Hurtado Senate Third Reading By Salas",75,0,0,5,80
1578060,1225602,2022-08-29,Senate,"Unfinished Business SB892 Hurtado et al. Concurrence",40,0,0,0,40
1578061,1166916,2022-03-09,Senate,"Do pass as amended, but first amend, and re-refer to the Committee on [Appropriations]",7,0,0,0,7
1578061,1201409,2022-05-09,Senate,"Senate 3rd Reading SB893 Becker et al",33,0,0,7,40
1578061,1217340,2022-06-21,Assembly,"Do pass as amended and be re-referred to the Committee on [Appropriations]",12,0,0,0,12
1578061,1223677,2022-08-11,Assembly,"Do pass",16,0,0,0,16
1578061,1224285,2022-08-22,Assembly,"SB 893 Becker Senate Third Reading By Mullin",77,0,0,3,80
1578061,1224828,2022-08-24,Senate,"Unfinished Business SB893 Becker et al. Concurrence",40,0,0,0,40
1578062,1174468,2022-03-22,Senate,"Do pass as amended, but first amend, and re-refer to the Committee on [Natural Resources and Water]",17,0,0,0,17
1578062,1189902,2022-04-19,Senate,"Do pass, but first be re-referred to the Committee on [Appropriations] with the recommendation: To Consent Calendar",8,0,0,1,9
1578062,1198255,2022-05-02,Senate,"Placed on suspense file",7,0,0,0,7
1578062,1206577,2022-05-19,Senate,"Do pass",7,0,0,0,7
1578062,1209235,2022-05-25,Senate,"Special Consent SB894",39,0,0,1,40
1578062,1215548,2022-06-13,Assembly,"Do pass and be re-referred to the Committee on [Appropriations]",14,0,0,1,15
1578062,1223520,2022-08-11,Assembly,"Do pass",16,0,0,0,16
1578062,1225972,2022-08-30,Assembly,"SB 894 Jones Senate Third Reading By Eduardo Garcia",71,2,0,7,80
1578062,1225973,2022-08-31,Senate,"Unfinished Business SB894 Jones et al. Concurrence",40,0,0,0,40
1579401,1190566,2022-04-20,Assembly,"Do pass and be re-referred to the Committee on [Housing and Community Development]",6,0,0,2,8
1579401,1194116,2022-04-27,Assembly,"Do pass",2,5,0,1,8
1579402,1179312,2022-03-21,Assembly,"Do pass and be re-referred to the Committee on [Appropriations]",8,3,0,0,11
1579402,1206609,2022-05-19,Assembly,"Do pass as amended",12,4,0,0,16
1579402,1210549,2022-05-26,Assembly,"AB 1749 Cristina Garcia Assembly Third Reading",48,18,0,12,78
1579402,1220724,2022-06-29,Senate,"Do pass as amended, but first amend, and re-refer to the Committee on [Appropriations]",5,1,0,1,7
1579402,1225379,2022-08-29,Senate,"Assembly 3rd Reading AB1749 Cristina Garcia By Allen",31,9,0,0,40
1579402,1225380,2022-08-30,Assembly,"AB 1749 Cristina Garcia Concurrence in Senate Amendments",52,18,0,10,80
1579403,1170584,2022-03-15,Assembly,"Do pass as amended and be re-referred to the Committee on [Appropriations]",6,0,0,0,6
1579404,1180259,2022-03-30,Assembly,"Do pass and be re-referred to the Committee on [Appropriations]",10,1,0,3,14
1579404,1206527,2022-05-19,Assembly,"Do pass",12,3,0,1,16
1579404,1210295,2022-05-26,Assembly,"AB 1751 Daly Assembly Third Reading",58,10,0,10,78
1579404,1220593,2022-06-29,Senate,"Do pass, but first be re-referred to the Committee on [Appropriations]",4,1,0,0,5
1579404,1223218,2022-08-08,Senate,"Placed on suspense file",7,0,0,0,7
1579404,1223925,2022-08-11,Senate,"Do pass",5,2,0,0,7
1579404,1225586,2022-08-29,Senate,"Assembly 3rd Reading AB1751 Daly By Umberg",30,9,0,1,40
1579404,1225587,2022-08-30,Assembly,"AB 1751 Daly Concurrence in Senate Amendments",68,0,0,12,80
1579405,1183630,2022-04-05,Assembly,"Do pass and be re-referred to the Committee on [Appropriations]",10,0,0,2,12
1579409,1179711,2022-03-28,Senate,"Do pass, but first be re-referred to the Committee on [Appropriations] with the recommendation: To Consent Calendar",7,0,0,0,7
1579409,1189377,2022-04-18,Senate,"Placed on suspense file",7,0,0,0,7
1579409,1206826,2022-05-19,Senate,"Do pass",7,0,0,0,7
1579409,1209320,2022-05-25,Senate,"Special Consent SB895",39,0,0,1,40
1579409,1215539,2022-06-13,Assembly,"Do pass and be re-referred to the Committee on [Appropriations] with recommendation: To Consent Calendar",10,0,0,1,11
1579409,1223676,2022-08-11,Assembly,"Do pass",16,0,0,0,16
1579409,1224180,2022-08-18,Assembly,"SB 895 Laird Senate Third Reading By Stone",76,0,0,4,80
1579410,1165732,2022-03-08,Senate,"Do pass as amended, but first amend, and re-refer to the Committee on [Appropriations]",9,0,0,0,9
1579410,1204574,2022-05-16,Senate,"Senate 3rd Reading SB896 Dodd et al",32,0,0,8,40
1579410,1215526,2022-06-13,Assembly,"Do pass and be re-referred to the Committee on [Appropriations]",9,0,0,2,11
1579410,1222955,2022-08-03,Assembly,"Do pass. To Consent Calendar",15,0,0,1,16
1579410,1223383,2022-08-11,Assembly,"SB 896 Dodd Consent Calendar Second Day Regular Session",76,0,0,4,80
1579411,1176506,2022-03-24,Senate,"Do pass, but first be re-referred to the Committee on [Governance and Finance]",5,1,0,3,9
1579411,1185691,2022-04-07,Senate,"Do pass as amended, but first amend, and re-refer to the Committee on [Appropriations]",5,0,0,0,5
1579411,1192233,2022-04-25,Senate,"Placed on suspense file",5,0,0,2,7
1579411,1206540,2022-05-19,Senate,"Do pass as amended",5,2,0,0,7
1579411,1209224,2022-05-25,Senate,"Senate 3rd Reading SB897 Wieckowski",24,9,0,7,40
1579411,1216283,2022-06-15,Assembly,"Do pass as amended and be re-referred to the Committee on [Local Government]",7,0,0,1,8
1579411,1220795,2022-06-29,Assembly,"Do pass as amended and be re-referred to the Committee on [Appropriations]",5,3,0,0,8
1579411,1223310,2022-08-10,Assembly,"Do pass",10,4,0,2,16
1579411,1225532,2022-08-31,Senate,"Unfinished Business SB897 Wieckowski Concurrence",23,11,0,6,40
1579411,1225533,2022-08-31,Assembly,"SB 897 Wieckowski Senate Third Reading By Quirk-Silva",47,22,0,11,80
1579412,1185700,2022-04-07,Senate,"Senate 3rd Reading SB898 Dodd et al. Urgency Clause",37,0,0,3,40
1579412,1210212,2022-05-27,Assembly,"SB 898 Dodd Third Reading Urgency By Santiago",76,0,0,2,78
1579412,1210919,2022-05-31,Senate,"Unfinished Business SB898 Dodd et al. Urgency Clause Concurrence",32,0,0,8,40
1579413,1193204,2022-04-26,Senate,"Do pass, but first be re-referred to the Committee on [Appropriations] with the recommendation: To Consent Calendar",13,0,0,2,15
1579413,1204074,2022-05-12,Senate,"Consent Calendar SB899 G.O",35,0,0,5,40
1579413,1215061,2022-06-08,Assembly,"Do pass and be re-referred to the Committee on [Appropriations] with recommendation: To Consent Calendar",21,0,0,1,22
1579413,1217983,2022-06-22,Assembly,"Do pass. To Consent Calendar",13,0,0,3,16
1579414,1198237,2022-05-02,Senate,"Senate 3rd Reading SB900 Hurtado et al. Urgency Clause",36,0,0,4,40
1579414,1204586,2022-05-16,Assembly,"SB 900 Hurtado Third Reading Urgency By Aguiar-Curry",71,0,0,7,78
1579415,1165742,2022-03-08,Senate,"Do pass, but first be re-referred to the Committee on [Governance and Finance] with the recommendation: To Consent Calendar",9,0,0,0,9
1579415,1185682,2022-04-07,Senate,"Do pass, but first be re-referred to the Committee on [Appropriations]",5,0,0,0,5
1579415,1192164,2022-04-25,Senate,"Placed on suspense file",5,0,0,2,7
1579415,1206661,2022-05-19,Senate,"Do pass",7,0,0,0,7
1579415,1209266,2022-05-25,Senate,"Special Consent SB901",39,0,0,1,40
1579415,1219868,2022-06-28,Assembly,"Do pass and be re-referred to the Committee on [Appropriations] with recommendation: To Consent Calendar",14,0,0,1,15
1579415,1223845,2022-08-11,Assembly,"Do pass as amended",12,0,0,4,16
1579415,1224432,2022-08-23,Assembly,"SB 901 Pan Senate Third Reading By McCarty",77,0,0,3,80
1579415,1225932,2022-08-30,Senate,"Special Consent SB901",38,0,0,2,40
1579417,1165750,2022-03-08,Senate,"Do pass, but first be re-referred to the Committee on [Appropriations] with the recommendation: To Consent Calendar",5,0,0,0,5
1579417,1182554,2022-04-04,Senate,"Placed on suspense file",6,0,0,1,7
1579417,1206768,2022-05-19,Senate,"Do pass",7,0,0,0,7
1579417,1209379,2022-05-25,Senate,"Special Consent SB903",39,0,0,1,40
1579417,1215934,2022-06-14,Assembly,"Do pass as amended, and be re-referred to the Committee on [Appropriations] with recommendation: To Consent Calendar",7,0,0,1,8
1579417,1223759,2022-08-11,Assembly,"Do pass",16,0,0,0,16
1579417,1224390,2022-08-22,Assembly,"SB 903 Hertzberg Senate Third Reading By Gipson",77,0,0,3,80
1579417,1224804,2022-08-24,Senate,"Unfinished Business SB903 Hertzberg Concurrence",40,0,0,0,40
1579418,1194406,2022-04-26,Senate,"Do pass as amended, but first amend, and re-refer to the Committee on [Appropriations]",5,0,0,0,5
1579418,1204617,2022-05-16,Senate,"Placed on suspense file",6,0,0,1,7
1579418,1206278,2022-05-19,Senate,"Do pass as amended",7,0,0,0,7
1579418,1209944,2022-05-26,Senate,"Special Consent SB904",38,0,0,2,40
1579418,1215881,2022-06-14,Assembly,"Do pass and be re-referred to the Committee on [Appropriations]",7,0,0,1,8
1581302,1193317,2022-04-26,Assembly,"Do pass as amended, and be re-referred to the Committee on [Appropriations] with recommendation: To Consent Calendar",15,0,0,0,15
1581302,1203371,2022-05-11,Assembly,"Do pass. To Consent Calendar",16,0,0,0,16
1581302,1206977,2022-05-19,Assembly,"AB 1757 Haney Consent Calendar Second Day Regular Session",72,0,0,6,78
1581302,1225953,2022-08-31,Senate,"Assembly 3rd Reading AB1757 Cristina Garcia et al. By Becker",28,10,0,2,40
1581302,1225954,2022-08-31,Assembly,"AB 1757 Cristina Garcia Concurrence in Senate Amendments",53,15,0,12,80
1581303,1183584,2022-04-05,Assembly,"Do pass and be re-referred to the Committee on [Appropriations] with recommendation: To Consent Calendar",16,0,0,2,18
1581303,1194418,2022-04-27,Assembly,"Do pass. To Consent Calendar",15,0,0,1,16
1581303,1200647,2022-05-05,Assembly,"AB 1758 Aguiar-Curry Consent Calendar Second Day Regular Session",61,0,0,17,78
1581303,1214374,2022-06-06,Senate,"Do pass, but first be re-referred to the Committee on [Appropriations]",12,0,0,2,14
1581303,1224205,2022-08-18,Senate,"Assembly 3rd Reading AB1758 Aguiar-Curry By Archuleta Urgency Clause",38,0,0,2,40
1581304,1183583,2022-04-05,Assembly,"Do pass and be re-referred to the Committee on [Appropriations] with recommendation: To Consent Calendar",16,0,0,2,18
1581304,1194186,2022-04-27,Assembly,"Do pass. To Consent Calendar",15,0,0,1,16
1581304,1200648,2022-05-05,Assembly,"AB 1759 Aguiar-Curry Consent Calendar Second Day Regular Session",61,0,0,17,78
1581304,1214378,2022-06-06,Senate,"Do pass, but first be re-referred to the Committee on [Appropriations]",11,0,0,3,14
1581304,1224774,2022-08-24,Senate,"Assembly 3rd Reading AB1759 Aguiar-Curry By Wiener",40,0,0,0,40
1581305,1199190,2022-05-03,Assembly,"Do pass",10,0,0,1,11
1581305,1201489,2022-05-09,Assembly,"AB 1760 Rodriguez Assembly Third Reading",66,0,0,12,78
1581305,1214389,2022-06-06,Senate,"Do pass as amended",12,0,0,2,14
1581305,1217111,2022-06-20,Senate,"Placed on suspense file",4,0,0,3,7
1581305,1224047,2022-08-11,Senate,"Do pass",7,0,0,0,7
1581305,1224620,2022-08-23,Senate,"Special Consent AB1760",40,0,0,0,40
1581305,1224790,2022-08-24,Assembly,"AB 1760 Rodriguez Concurrence in Senate Amendments",75,0,0,5,80
1581307,1195758,2022-04-28,Assembly,"Do pass and be re-referred to the Committee on [Appropriations]",8,0,0,3,11
1581307,1203337,2022-05-11,Assembly,"Do pass. To Consent Calendar",16,0,0,0,16
1581307,1206945,2022-05-19,Assembly,"AB 1762 Mathis Consent Calendar Second Day Regular Session",72,0,0,6,78
1581307,1219919,2022-06-28,Senate,"Do pass, but first be re-referred to the Committee on [Appropriations] with the recommendation: To Consent Calendar",13,0,0,2,15
1581307,1223239,2022-08-08,Senate,"Consent Calendar AB1762",36,0,0,4,40
1581307,1224066,2022-08-15,Assembly,"AB 1762 Mathis Concurrence in Senate Amendments",76,0,0,4,80
1581309,1183771,2022-04-05,Assembly,"Do pass and be re-referred to the Committee on [Appropriations]",11,0,0,1,12
1581309,1206542,2022-05-19,Assembly,"Do pass as amended",12,0,0,4,16
1581309,1210272,2022-05-26,Assembly,"AB 1764 Medina Assembly Third Reading",74,0,0,4,78
1581309,1218008,2022-06-22,Senate,"Do pass, but first be re-referred to the Committee on [Appropriations] with the recommendation: To Consent Calendar",6,0,0,1,7
1581310,1195746,2022-04-27,Assembly,"Do pass and be re-referred to the Committee on [Appropriations]",6,0,0,2,8
1581310,1205847,2022-05-18,Assembly,"Do pass",13,0,0,3,16
1581310,1210603,2022-05-25,Assembly,"AB 1765 Nazarian Assembly Third Reading",62,0,0,16,78
1581310,1216276,2022-06-15,Senate,"Do pass, but first be re-referred to the Committee on [Appropriations] with the recommendation: To Consent Calendar",5,0,0,0,5
1581310,1224391,2022-08-22,Senate,"Assembly 3rd Reading AB1765 Nazarian By Stern",36,0,0,4,40
1581310,1224584,2022-08-23,Assembly,"AB 1765 Nazarian Concurrence in Senate Amendments",66,0,0,14,80
1581311,1174559,2022-03-21,Assembly,"Do pass and be re-referred to the Committee on [Appropriations]",11,3,0,1,15
1581311,1183586,2022-04-05,Assembly,"Do pass as amended and be re-referred to the Committee on [Appropriations]",8,0,0,2,10
1581311,1206284,2022-05-19,Assembly,"Do pass as amended",12,2,0,2,16
1581311,1210480,2022-05-26,Assembly,"AB 1766 Stone Assembly Third Reading",59,13,0,6,78
1581311,1216386,2022-06-14,Senate,"Do pass, but first be re-referred to the Committee on [Judiciary]",11,2,0,4,17
1581311,1220592,2022-06-28,Senate,"Do pass, but first be re-referred to the Committee on [Appropriations]",9,1,0,1,11
1581311,1222869,2022-08-01,Senate,"Placed on suspense file",7,0,0,0,7
1581311,1223371,2022-08-11,Senate,"Do pass as amended",5,2,0,0,7
1581311,1225775,2022-08-29,Senate,"Assembly 3rd Reading AB1766 Stone et al. By Rubio",31,6,0,3,40
1581311,1225776,2022-08-30,Assembly,"AB 1766 Stone Concurrence in Senate Amendments",60,14,0,6,80
1581313,1171456,2022-03-16,Assembly,"Do pass and be re-referred to the Committee on [Military and Veterans Affairs]",6,0,0,0,6
1581313,1184681,2022-04-05,Assembly,"Do pass and be re-referred to the Committee on [Appropriations]",8,0,0,1,9
1581313,1199966,2022-05-04,Assembly,"Do pass. To Consent Calendar",14,0,0,2,16
1581313,1204072,2022-05-12,Assembly,"AB 1768 Cooper Consent Calendar Second Day Regular Session",65,0,0,13,78
1581313,1214991,2022-06-08,Senate,"Do pass, but first be re-referred to the Committee on [Military and Veterans Affairs] with the recommendation: To Consent Calendar",5,0,0,0,5
1581313,1219967,2022-06-28,Senate,"Do pass, but first be re-referred to the Committee on [Appropriations] with the recommendation: To Consent Calendar",6,0,0,1,7
1581313,1223179,2022-08-08,Senate,"Consent Calendar AB1768",36,0,0,4,40
1581314,1165740,2022-03-08,Assembly,"Do pass and be re-referred to the Committee on [Appropriations]",5,2,0,0,7
1581314,1206670,2022-05-19,Assembly,"Do pass",12,4,0,0,16
1581314,1210461,2022-05-25,Assembly,"AB 1769 Bennett Assembly Third Reading",53,19,0,6,78
1581314,1214952,2022-06-08,Senate,"Do pass, but first be re-referred to the Committee on [Appropriations]",4,0,0,1,5
1581314,1215541,2022-06-13,Senate,"Do pass",5,2,0,0,7
1581314,1221580,2022-06-29,Senate,"Assembly 3rd Reading AB1769 Bennett et al. By Lim贸n",26,8,0,6,40
1581316,1182533,2022-04-04,Assembly,"Do pass and be re-referred to the Committee on [Health]",7,0,0,0,7
1581318,1140916,2022-02-10,Assembly,"Be adopted. To Consent Calendar",10,0,0,2,12
1581318,1150948,2022-02-22,Assembly,"ACR 131 Mia Bonta Consent Calendar Second Day Regular Session",69,0,0,7,76
1581318,1173503,2022-03-21,Senate,"Special Consent ACR131",37,0,0,3,40
1581319,1179465,2022-03-28,Senate,"Do pass, but first be re-referred to the Committee on [Education]",5,2,0,0,7
1581319,1190684,2022-04-20,Senate,"Do pass, but first be re-referred to the Committee on [Appropriations]",5,2,0,0,7
1581319,1198303,2022-05-02,Senate,"Placed on suspense file",7,0,0,0,7
1581319,1206292,2022-05-19,Senate,"Do pass as amended",5,2,0,0,7
1581319,1208500,2022-05-24,Senate,"Senate 3rd Reading SB905 Skinner et al",27,9,0,4,40
1581319,1217057,2022-06-20,Assembly,"Do pass as amended and be re-referred to the Committee on [Appropriations]",7,0,0,4,11
1581319,1223356,2022-08-11,Assembly,"Do pass as amended",12,4,0,0,16
1581319,1225447,2022-08-31,Senate,"Unfinished Business SB905 Caballero et al. Concurrence",29,9,0,2,40
1581319,1225448,2022-08-31,Assembly,"SB 905 Caballero Senate Third Reading",48,15,0,17,80
1581320,1180281,2022-03-30,Senate,"Do pass, but first be re-referred to the Committee on [Public Safety]",2,2,0,3,7
1581320,1180282,2022-03-30,Senate,"[First] hearing set for [03-30-2022]: Failed passage in Committee. Reconsideration granted",4,0,0,3,7
1581320,1190626,2022-04-20,Senate,"Do pass, but first be re-referred to the Committee on [Public Safety]",5,1,0,1,7
1581320,1194311,2022-04-26,Senate,"Do pass, but first be re-referred to the Committee on [Appropriations]",3,0,0,2,5
1581320,1201472,2022-05-09,Senate,"Placed on suspense file",7,0,0,0,7
1581320,1206304,2022-05-19,Senate,"Do pass",5,2,0,0,7
1581320,1208456,2022-05-24,Senate,"Senate 3rd Reading SB906 Portantino",26,6,0,8,40
1581320,1215750,2022-06-14,Assembly,"Do pass as amended and be re-referred to the Committee on [Appropriations]",6,0,0,2,8
1581320,1217853,2022-06-22,Assembly,"Do pass as amended",15,0,0,1,16
1581320,1221322,2022-06-30,Senate,"W/O REF. TO FILE SB906 Portantino",32,0,0,8,40
1581320,1221323,2022-06-30,Assembly,"SB 906 Portantino Senate Third Reading By Friedman",78,0,0,2,80
1581321,1179257,2022-03-29,Senate,"Do pass as amended, but first amend, and re-refer to the Committee on [Agriculture] with the recommendation: To Consent Calendar",4,0,0,1,5
1581321,1194478,2022-04-27,Senate,"Do pass as amended, but first amend, and re-refer to the Committee on [Appropriations] with the recommendation: To Consent Calendar",4,0,0,1,5
1581321,1204630,2022-05-16,Senate,"Placed on suspense file",6,0,0,1,7
1581321,1206314,2022-05-19,Senate,"Do pass",7,0,0,0,7
1581321,1209345,2022-05-25,Senate,"Special Consent SB907",39,0,0,1,40
1581321,1215736,2022-06-14,Assembly,"Do pass and be re-referred to the Committee on [Agriculture]",7,0,0,1,8
1581321,1220811,2022-06-29,Assembly,"Do pass and be re-referred to the Committee on [Appropriations]",8,0,0,3,11
1581321,1223966,2022-08-11,Assembly,"Do pass as amended",12,0,0,4,16
1581321,1224236,2022-08-18,Assembly,"SB 907 Pan Senate Third Reading By Calderon",76,0,0,4,80
1581321,1224301,2022-08-22,Senate,"Unfinished Business SB907 Pan et al. Concurrence",39,0,0,1,40
1581322,1166934,2022-03-09,Senate,"Do pass, but first be re-referred to the Committee on [Governmental Organization]",7,0,0,0,7
1581322,1179242,2022-03-29,Senate,"Do pass as amended, but first amend, and re-refer to the Committee on [Appropriations]",10,4,0,1,15
1581322,1189391,2022-04-18,Senate,"Placed on suspense file",7,0,0,0,7
1581324,1170602,2022-03-15,Senate,"Do pass, but first be re-referred to the Committee on [Appropriations] with the recommendation: To Consent Calendar",14,0,0,1,15
1581324,1185725,2022-04-07,Senate,"Consent Calendar SB910",37,0,0,3,40
1581324,1214966,2022-06-08,Assembly,"Do pass and be re-referred to the Committee on [Appropriations] with recommendation: To Consent Calendar",21,0,0,1,22
1581324,1218631,2022-06-23,Assembly,"SB 910 Hurtado Third Reading Urgency By Salas",73,0,0,7,80
1581324,1225941,2022-08-30,Assembly,"SB 910 Hurtado Third Reading Urgency By Salas",76,0,0,4,80
1581324,1225942,2022-08-31,Senate,"Unfinished Business SB910 Hurtado et al. Urgency Clause Concurrence",39,0,0,1,40
1581325,1179167,2022-03-29,Senate,"Do pass, but first be re-referred to the Committee on [Appropriations]",8,4,0,3,15
1581325,1189312,2022-04-18,Senate,"Placed on suspense file",7,0,0,0,7
1581325,1206431,2022-05-19,Senate,"Do pass as amended",5,2,0,0,7
1581325,1210034,2022-05-26,Senate,"Senate 3rd Reading SB911 Glazer et al",26,7,0,7,40
1581325,1220836,2022-06-29,Assembly,"Do pass and be re-referred to the Committee on [Appropriations]",4,3,0,0,7
1581326,1191336,2022-04-20,Senate,"Do pass as amended, but first amend, and re-refer to the Committee on [Appropriations]",10,0,0,1,11
1581326,1201474,2022-05-09,Senate,"Placed on suspense file",7,0,0,0,7
1581326,1206493,2022-05-19,Senate,"Do pass",7,0,0,0,7
1581326,1209279,2022-05-25,Senate,"Special Consent SB912",39,0,0,1,40
1581326,1217464,2022-06-21,Assembly,"Do pass and be re-referred to the Committee on [Appropriations]",14,0,0,1,15
1581326,1223933,2022-08-11,Assembly,"Do pass as amended",14,0,0,2,16
1581326,1225210,2022-08-30,Senate,"Unfinished Business SB912 Lim贸n et al. Concurrence",40,0,0,0,40
1581326,1225211,2022-08-30,Assembly,"SB 912 Lim贸n Senate Third Reading By Arambula",77,0,0,3,80
1581327,1166904,2022-03-09,Senate,"Do pass, but first be re-referred to the Committee on [Judiciary]",7,0,0,0,7
1581327,1179121,2022-03-29,Senate,"Do pass, but first be re-referred to the Committee on [Appropriations]",11,0,0,0,11
1581327,1195835,2022-04-28,Senate,"Senate 3rd Reading SB913 Hertzberg",37,0,0,3,40
1581327,1216657,2022-06-15,Assembly,"Do pass as amended, and be re-referred to the Committee on [Appropriations] with recommendation: To Consent Calendar",6,0,0,1,7
1581327,1220831,2022-06-29,Assembly,"Do pass. To Consent Calendar",14,0,0,2,16
1581327,1224364,2022-08-22,Assembly,"SB 913 Hertzberg Senate Third Reading By Bloom",76,0,0,4,80
1581327,1224826,2022-08-24,Senate,"Unfinished Business SB913 Hertzberg et al. Concurrence",40,0,0,0,40
1581328,1179213,2022-03-29,Senate,"Do pass, but first be re-referred to the Committee on [Housing]",4,0,0,1,5
1581328,1194211,2022-04-27,Senate,"Do pass, but first be re-referred to the Committee on [Appropriations]",9,0,0,0,9
1581328,1204607,2022-05-16,Senate,"Placed on suspense file",6,0,0,1,7
1581328,1206523,2022-05-19,Senate,"Do pass as amended",7,0,0,0,7
1581328,1208487,2022-05-24,Senate,"Senate 3rd Reading SB914 Rubio et al",37,0,0,3,40
1581328,1216285,2022-06-15,Assembly,"Do pass and be re-referred to the Committee on [Human Services] with recommendation: To Consent Calendar",8,0,0,0,8
1581328,1219945,2022-06-28,Assembly,"Do pass and be re-referred to the Committee on [Appropriations] with recommendation: To Consent Calendar",7,0,0,1,8
1581328,1223954,2022-08-11,Assembly,"Do pass as amended",12,0,0,4,16
1581328,1224161,2022-08-18,Assembly,"SB 914 Rubio Senate Third Reading By Aguiar-Curry",76,0,0,4,80
1581328,1224979,2022-08-25,Senate,"Unfinished Business SB914 Rubio et al. Concurrence",40,0,0,0,40
1581329,1165756,2022-03-08,Senate,"Do pass, but first be re-referred to the Committee on [Appropriations]",4,1,0,0,5
1581329,1182514,2022-04-04,Senate,"Placed on suspense file",6,0,0,1,7
1581329,1206607,2022-05-19,Senate,"Do pass",5,2,0,0,7
1581329,1208486,2022-05-24,Senate,"Senate 3rd Reading SB915 Min et al",25,9,0,6,40
1581329,1214969,2022-06-08,Assembly,"Do pass and be re-referred to the Committee on [Appropriations]",5,2,0,0,7
1581329,1218027,2022-06-22,Assembly,"Do pass",10,4,0,2,16
1581329,1219415,2022-06-27,Assembly,"SB 915 Min Senate Third Reading By Bennett",50,22,0,8,80
1581329,1221530,2022-06-29,Senate,"Unfinished Business SB915 Min et al. Concurrence",25,8,0,7,40
1581330,1170604,2022-03-15,Senate,"Do pass, but first be re-referred to the Committee on [Appropriations]",5,0,0,0,5
1581330,1182522,2022-04-04,Senate,"Placed on suspense file",6,0,0,1,7
1581330,1206597,2022-05-19,Senate,"Do pass",7,0,0,0,7
1581330,1209388,2022-05-25,Senate,"Special Consent SB916",39,0,0,1,40
1581330,1217492,2022-06-21,Assembly,"Do pass and be re-referred to the Committee on [Appropriations] with recommendation: To Consent Calendar",7,0,0,0,7
1581330,1224048,2022-08-11,Assembly,"Do pass",16,0,0,0,16
1581330,1225927,2022-08-31,Senate,"Unfinished Business SB916 Leyva et al. Concurrence",40,0,0,0,40
1581330,1225928,2022-08-31,Assembly,"SB 916 Leyva Senate Third Reading By Quirk",80,0,0,0,80
1582915,1184710,2022-04-06,Assembly,"Do pass and be re-referred to the Committee on [Local Government]",9,0,0,2,11
1582915,1190658,2022-04-20,Assembly,"Do pass and be re-referred to the Committee on [Appropriations]",8,0,0,0,8
1582918,1191335,2022-04-20,Assembly,"Do pass and be re-referred to the Committee on [Appropriations]",7,0,0,0,7
1582918,1206436,2022-05-19,Assembly,"Do pass as amended",13,3,0,0,16
1582918,1210299,2022-05-26,Assembly,"AB 1775 Ward Assembly Third Reading",65,8,0,5,78
1582918,1215910,2022-06-13,Senate,"Do pass, but first be re-referred to the Committee on [Judiciary]",4,0,0,1,5
1582918,1220727,2022-06-28,Senate,"Do pass, but first be re-referred to the Committee on [Appropriations]",9,1,0,1,11
1582918,1222721,2022-08-01,Senate,"Placed on suspense file",7,0,0,0,7
1582918,1223682,2022-08-11,Senate,"Do pass as amended",5,2,0,0,7
1582918,1224791,2022-08-24,Senate,"Assembly 3rd Reading AB1775 Ward By Newman",32,8,0,0,40
1582918,1224904,2022-08-25,Assembly,"AB 1775 Ward Concurrence in Senate Amendments",63,0,0,17,80
1582919,1175528,2022-03-23,Assembly,"Do pass as amended and be re-referred to the Committee on [Appropriations]",7,0,0,0,7
1582919,1206714,2022-05-19,Assembly,"Do pass",16,0,0,0,16
1582919,1210631,2022-05-25,Assembly,"AB 1776 Gallagher Assembly Third Reading",76,0,0,2,78
1582919,1219893,2022-06-28,Senate,"Do pass, but first be re-referred to the Committee on [Appropriations] with the recommendation: To Consent Calendar",13,0,0,2,15
1582919,1222640,2022-08-01,Senate,"Placed on suspense file",7,0,0,0,7
1582919,1224016,2022-08-11,Senate,"Do pass",7,0,0,0,7
1582919,1224190,2022-08-18,Senate,"Assembly 3rd Reading AB1776 Gallagher et al. By Nielsen",38,0,0,2,40
1582921,1191250,2022-04-20,Assembly,"Do pass as amended and be re-referred to the Committee on [Appropriations]",7,0,0,0,7
1582921,1206316,2022-05-19,Assembly,"Do pass",16,0,0,0,16
1582921,1210392,2022-05-25,Assembly,"AB 1777 Aguiar-Curry Assembly Third Reading",76,0,0,2,78
1582921,1220611,2022-06-29,Senate,"Do pass as amended, but first amend, and re-refer to the Committee on [Appropriations]",6,0,0,1,7
1582921,1222916,2022-08-01,Senate,"Placed on suspense file",7,0,0,0,7
1582921,1223510,2022-08-11,Senate,"Do pass",7,0,0,0,7
1582921,1224543,2022-08-23,Senate,"Special Consent AB1777",40,0,0,0,40
1582921,1224868,2022-08-24,Assembly,"AB 1777 Aguiar-Curry Concurrence in Senate Amendments",76,0,0,4,80
1582922,1190000,2022-04-18,Assembly,"Do pass and be re-referred to the Committee on [Appropriations]",9,3,0,3,15
1582922,1206902,2022-05-19,Assembly,"Do pass",12,4,0,0,16
1582922,1210553,2022-05-25,Assembly,"AB 1778 Cristina Garcia Assembly Third Reading",41,25,0,12,78
1582922,1220643,2022-06-28,Senate,"Do pass, but first be re-referred to the Committee on [Appropriations]",8,2,0,7,17
1582923,1189829,2022-04-19,Assembly,"Do pass and be re-referred to the Committee on [Business and Professions]",7,0,0,0,7
1582924,1179446,2022-03-28,Assembly,"Do pass as amended",10,0,0,2,12
1582924,1189392,2022-04-18,Assembly,"AB 1780 Chen Third Reading Urgency",72,0,0,5,77
1582924,1220584,2022-06-28,Senate,"Do pass as amended",10,0,0,1,11
1582924,1221698,2022-06-15,Senate,"Do pass as amended, but first amend, and re-refer to the Committee on [Judiciary]",9,0,0,0,9
1582924,1224733,2022-08-24,Senate,"Assembly 3rd Reading AB1780 Chen By Dahle",40,0,0,0,40
1582924,1224954,2022-08-25,Assembly,"AB 1780 Chen Concurrence in Senate Amendments",73,0,0,7,80
1582925,1193151,2022-04-26,Assembly,"Do pass. To Consent Calendar",17,0,0,1,18
1582925,1198226,2022-05-02,Assembly,"AB 1781 Blanca Rubio Consent Calendar Second Day",70,0,0,7,77
1582925,1214391,2022-06-06,Senate,"Do pass",12,0,0,2,14
1582925,1216595,2022-06-16,Senate,"Special Consent AB1781",35,0,0,5,40
1582927,1165722,2022-03-08,Assembly,"Do pass",5,1,0,1,7
1582927,1204097,2022-05-12,Assembly,"AB 1782 Jones-Sawyer Assembly Third Reading",45,10,0,23,78
1582927,1215729,2022-06-14,Senate,"Do pass",5,0,0,0,5
1582927,1224996,2022-08-25,Senate,"Assembly 3rd Reading AB1782 Jones-Sawyer By Skinner",30,7,0,3,40
1582928,1194408,2022-04-27,Assembly,"Do pass and be re-referred to the Committee on [Appropriations]",6,0,0,1,7
1582928,1206613,2022-05-19,Assembly,"Do pass",16,0,0,0,16
1582928,1210595,2022-05-25,Assembly,"AB 1783 Levine Assembly Third Reading",76,0,0,2,78
1582928,1215558,2022-06-13,Senate,"Do pass, but first be re-referred to the Committee on [Appropriations]",4,0,0,1,5
1582928,1219353,2022-06-27,Senate,"Placed on suspense file",6,0,0,1,7
1582928,1223427,2022-08-11,Senate,"Do pass",7,0,0,0,7
1582928,1224552,2022-08-23,Senate,"Special Consent AB1783",40,0,0,0,40
1582928,1224730,2022-08-24,Assembly,"AB 1783 Levine Concurrence in Senate Amendments",76,0,0,4,80
1582934,1175526,2022-03-22,Assembly,"Do pass and be re-referred to the Committee on [Appropriations]",9,0,0,0,9
1582934,1194319,2022-04-27,Assembly,"Do pass. To Consent Calendar",15,0,0,1,16
1582934,1200649,2022-05-05,Assembly,"AB 1787 Quirk Consent Calendar Second Day Regular Session",61,0,0,17,78
1582934,1211877,2022-06-01,Senate,"Do pass, but first be re-referred to the Committee on [Appropriations] with the recommendation: To Consent Calendar",6,0,0,1,7
1582934,1219365,2022-06-27,Senate,"Consent Calendar AB1787",37,0,0,3,40
1582935,1174556,2022-03-22,Assembly,"Do pass as amended",9,0,0,0,9
1582935,1181283,2022-03-31,Assembly,"AB 1788 Cunningham Assembly Third Reading",65,0,0,11,76
1582935,1214956,2022-06-08,Senate,"Do pass as amended, but first amend, and re-refer to the Committee on [Appropriations]",6,1,0,4,11
1582935,1219438,2022-06-27,Senate,"Placed on suspense file",6,0,0,1,7
1582935,1223673,2022-08-11,Senate,"Do pass as amended",7,0,0,0,7
1582935,1225258,2022-08-30,Senate,"Assembly 3rd Reading AB1788 Cunningham et al. By Wilk",32,2,0,6,40
1582935,1225259,2022-08-31,Assembly,"AB 1788 Cunningham Concurrence in Senate Amendments",77,1,0,2,80
1582936,1183740,2022-04-05,Assembly,"Do pass as amended and be re-referred to the Committee on [Appropriations]",13,0,0,2,15
1582936,1206301,2022-05-19,Assembly,"Do pass as amended",12,0,0,4,16
1582936,1210304,2022-05-26,Assembly,"AB 1789 Bennett Assembly Third Reading",75,0,0,3,78
1582936,1217105,2022-06-20,Senate,"Do pass as amended, but first amend, and re-refer to the Committee on [Appropriations] with the recommendation: To Consent Calendar",7,0,0,2,9
1582936,1223149,2022-08-08,Senate,"Placed on suspense file",7,0,0,0,7
1582936,1223754,2022-08-11,Senate,"Do pass as amended",6,0,0,1,7
1582936,1224531,2022-08-23,Senate,"Special Consent AB1789",40,0,0,0,40
1582936,1224853,2022-08-24,Assembly,"AB 1789 Bennett Concurrence in Senate Amendments",76,0,0,4,80
1582938,1193153,2022-04-26,Assembly,"Do pass",4,2,0,1,7
1582941,1175522,2022-03-22,Assembly,"Do pass and be re-referred to the Committee on [Appropriations] with recommendation: To Consent Calendar",9,0,0,0,9
1582941,1206286,2022-05-19,Assembly,"Do pass as amended",12,0,0,4,16
1582941,1210248,2022-05-26,Assembly,"AB 1793 Quirk Assembly Third Reading",75,0,0,3,78
1582941,1216263,2022-06-15,Senate,"Do pass as amended, but first amend, and re-refer to the Committee on [Appropriations]",7,0,0,0,7
1582941,1219392,2022-06-27,Senate,"Placed on suspense file",6,0,0,1,7
1582941,1223686,2022-08-11,Senate,"Do pass",7,0,0,0,7
1582941,1224521,2022-08-23,Senate,"Special Consent AB1793",40,0,0,0,40
1582941,1224724,2022-08-24,Assembly,"AB 1793 Quirk Concurrence in Senate Amendments",76,0,0,4,80
1582942,1174474,2022-03-22,Assembly,"Do pass and be re-referred to the Committee on [Human Services]",9,0,0,0,9
1582942,1193365,2022-04-26,Assembly,"Do pass and be re-referred to the Committee on [Appropriations]",7,0,0,1,8
1582942,1206415,2022-05-19,Assembly,"Do pass",15,1,0,0,16
1582942,1210407,2022-05-26,Assembly,"AB 1794 Gipson Assembly Third Reading",70,0,0,8,78
1582942,1217973,2022-06-21,Senate,"Do pass, but first be re-referred to the Committee on [Human Services]",11,0,0,0,11
1582942,1220061,2022-06-27,Senate,"Do pass, but first be re-referred to the Committee on [Appropriations]",5,0,0,0,5
1582942,1222675,2022-08-01,Senate,"Placed on suspense file",7,0,0,0,7
1582942,1223503,2022-08-11,Senate,"Do pass",7,0,0,0,7
1582942,1225515,2022-08-31,Senate,"Special Consent AB1794 Gipson By Cortese",38,0,0,2,40
1582942,1225516,2022-08-31,Assembly,"AB 1794 Gipson Concurrence in Senate Amendments",79,0,0,1,80
1582944,1194302,2022-04-26,Senate,"Do pass, but first be re-referred to the Committee on [Appropriations]",14,1,0,2,17
1582944,1201397,2022-05-09,Senate,"Placed on suspense file",7,0,0,0,7
1582944,1206442,2022-05-19,Senate,"Do pass",6,1,0,0,7
1582944,1207776,2022-05-23,Senate,"Senate 3rd Reading SB917 Becker et al",31,3,0,6,40
1582944,1220004,2022-06-27,Assembly,"Do pass and be re-referred to the Committee on [Appropriations]",14,0,0,1,15
1582945,1174476,2022-03-22,Senate,"Do pass",4,1,0,0,5
1582945,1189300,2022-04-18,Senate,"Senate 3rd Reading SB918 Portantino",28,6,0,6,40
1582945,1220111,2022-06-28,Assembly,"Do pass as amended and be re-referred to the Committee on [Appropriations]",5,2,0,0,7
1582945,1223604,2022-08-11,Assembly,"Do pass as amended",12,4,0,0,16
1582945,1224988,2022-08-25,Assembly,"SB 918 Portantino Third Reading Urgency By Jones-Sawyer Amend By JONES-SAWYER Set #1",51,17,0,12,80
1582945,1225316,2022-08-30,Assembly,"SB 918 Portantino Third Reading Urgency By Jones-Sawyer",52,21,0,7,80
1582945,1225317,2022-09-01,Assembly,"SB 918 Portantino Third Reading Urgency By Jones-Sawyer",53,23,0,4,80
1582946,1183577,2022-04-04,Senate,"Do pass, but first be re-referred to the Committee on [Public Safety]",13,0,0,1,14
1582946,1194118,2022-04-26,Senate,"Do pass, but first be re-referred to the Committee on [Appropriations]",2,0,0,3,5
1582946,1194119,2022-04-26,Senate,"[First] hearing set for [04-26-2022]: Failed passage in Committee. Reconsideration granted",5,0,0,0,5
1582949,1179492,2022-03-28,Senate,"Do pass as amended, but first amend, and re-refer to the Committee on [Judiciary]",4,0,0,1,5
1582949,1194382,2022-04-26,Senate,"Do pass as amended, but first amend, and re-refer to the Committee on [Appropriations]",9,1,0,1,11
1582949,1201383,2022-05-09,Senate,"Placed on suspense file",7,0,0,0,7
1582950,1179484,2022-03-28,Senate,"Do pass as amended, but first amend, and re-refer to the Committee on [Appropriations]",5,0,0,2,7
1582950,1204596,2022-05-16,Senate,"Senate 3rd Reading SB922 Wiener et al",24,1,0,15,40
1582950,1215537,2022-06-13,Assembly,"Do pass and be re-referred to the Committee on [Appropriations]",8,1,0,2,11
1582950,1220802,2022-06-29,Assembly,"Do pass",15,0,0,1,16
1582950,1223266,2022-08-08,Assembly,"SB 922 Wiener Senate Third Reading By Friedman",71,2,0,7,80
1582950,1224083,2022-08-15,Senate,"Unfinished Business SB922 Wiener et al. Concurrence",30,3,0,7,40
1582952,1184656,2022-04-06,Senate,"Do pass as amended, but first amend, and re-refer to the Committee on [Appropriations]",8,2,0,1,11
1582952,1204556,2022-05-16,Senate,"Placed on suspense file",6,0,0,1,7
1582952,1207016,2022-05-19,Senate,"Do pass",4,2,0,1,7
1582952,1207745,2022-05-23,Senate,"Senate 3rd Reading SB923 Wiener et al",28,7,0,5,40
1582952,1217346,2022-06-21,Assembly,"Do pass as amended and be re-referred to the Committee on [Appropriations]",11,1,0,3,15
1582952,1224002,2022-08-11,Assembly,"Do pass",12,4,0,0,16
1582952,1224197,2022-08-18,Assembly,"SB 923 Wiener Senate Third Reading By Cristina Garcia Amendment Set #1",55,13,0,12,80
1582952,1224258,2022-08-22,Assembly,"SB 923 Wiener Senate Third Reading By Cristina Garcia",60,11,0,9,80
1582952,1224948,2022-08-25,Senate,"Unfinished Business SB923 Wiener et al. Concurrence",31,9,0,0,40
1584577,1183784,2022-04-05,Assembly,"Do pass and be re-referred to the Committee on [Appropriations]",11,0,0,1,12
1584577,1194353,2022-04-27,Assembly,"Do pass. To Consent Calendar",15,0,0,1,16
1584577,1200650,2022-05-05,Assembly,"AB 1796 Choi Consent Calendar Second Day Regular Session",61,0,0,17,78
1584577,1216306,2022-06-15,Senate,"Do pass, but first be re-referred to the Committee on [Appropriations]",6,0,0,1,7
1584577,1224115,2022-08-17,Senate,"Assembly 3rd Reading AB1796 Choi et al. By Pan",35,0,0,5,40
1584578,1193395,2022-04-26,Assembly,"Do pass and be re-referred to the Committee on [Education]",10,3,0,2,15
1584578,1195762,2022-04-27,Assembly,"Do pass as amended and be re-referred to the Committee on [Appropriations]",5,2,0,0,7
1584578,1206819,2022-05-19,Assembly,"Do pass",12,4,0,0,16
1584578,1210290,2022-05-26,Assembly,"AB 1797 Akilah Weber Assembly Third Reading",54,20,0,4,78
1584578,1218656,2022-06-22,Senate,"Do pass, but first be re-referred to the Committee on [Education]",8,1,0,2,11
1584578,1221310,2022-06-30,Senate,"Do pass, but first be re-referred to the Committee on [Appropriations]",5,2,0,0,7
1584578,1222706,2022-08-01,Senate,"Placed on suspense file",7,0,0,0,7
1584578,1223879,2022-08-11,Senate,"Do pass",5,2,0,0,7
1584578,1225499,2022-08-29,Senate,"Assembly 3rd Reading AB1797 Akilah Weber et al. By Newman",29,9,0,2,40
1584578,1225500,2022-08-30,Assembly,"AB 1797 Akilah Weber Concurrence in Senate Amendments",57,20,0,3,80
1584579,1175537,2022-03-23,Assembly,"Do pass as amended. To Consent Calendar",7,0,0,0,7
1584579,1186256,2022-04-07,Assembly,"AB 1798 Bryan Consent Calendar Second Day",65,0,0,12,77
1584579,1215518,2022-06-13,Senate,"Do pass and be ordered to the Consent Calendar",4,0,0,1,5
1584579,1224763,2022-08-24,Senate,"Assembly 3rd Reading AB1798 Bryan By Glazer",40,0,0,0,40
1584579,1225023,2022-08-25,Assembly,"AB 1798 Bryan Concurrence in Senate Amendments",75,0,0,5,80
1584581,1174578,2022-03-21,Assembly,"Do pass and be re-referred to the Committee on [Appropriations]",15,0,0,0,15
1584581,1206317,2022-05-19,Assembly,"Do pass as amended",16,0,0,0,16
1584581,1210273,2022-05-26,Assembly,"AB 1800 Low Assembly Third Reading",75,0,0,3,78
1584581,1220739,2022-06-28,Senate,"Do pass, but first be re-referred to the Committee on [Appropriations] with the recommendation: To Consent Calendar",17,0,0,0,17
1584581,1222725,2022-08-01,Senate,"Placed on suspense file",7,0,0,0,7
1584581,1223766,2022-08-11,Senate,"Do pass",7,0,0,0,7
1584581,1224463,2022-08-23,Senate,"Special Consent AB1800",40,0,0,0,40
1584581,1224464,2022-08-23,Senate,"Special Consent AB1800 Low By Portantino Reconsider",40,0,0,0,40
1584581,1225373,2022-08-29,Senate,"Assembly 3rd Reading AB1800 Low By Portantino",40,0,0,0,40
1584581,1225374,2022-08-30,Assembly,"AB 1800 Low Concurrence in Senate Amendments",79,0,0,1,80
1584582,1190674,2022-04-20,Assembly,"Do pass and be re-referred to the Committee on [Higher Education]",20,0,0,2,22
1584582,1194219,2022-04-26,Assembly,"Do pass and be re-referred to the Committee on [Appropriations]",12,0,0,0,12
1584582,1206529,2022-05-19,Assembly,"Do pass as amended",12,0,0,4,16
1584582,1210416,2022-05-26,Assembly,"AB 1801 Nazarian Assembly Third Reading",75,0,0,3,78
1584582,1215840,2022-06-14,Senate,"Do pass, but first be re-referred to the Committee on [Education]",14,0,0,1,15
1584582,1220696,2022-06-29,Senate,"Do pass, but first be re-referred to the Committee on [Appropriations]",6,0,0,1,7
1584582,1222809,2022-08-01,Senate,"Placed on suspense file",7,0,0,0,7
1584582,1223917,2022-08-11,Senate,"Do pass as amended",7,0,0,0,7
1584582,1224428,2022-08-23,Senate,"Special Consent AB1801",40,0,0,0,40
1584582,1224659,2022-08-24,Assembly,"AB 1801 Nazarian Concurrence in Senate Amendments",77,0,0,3,80
1584583,1179394,2022-03-28,Assembly,"Do pass. To Consent Calendar",10,0,0,2,12
1584583,1182512,2022-04-04,Assembly,"AB 1802 Maienschein Consent Calendar Second Day",71,0,0,5,76
1584583,1210940,2022-05-31,Senate,"Do pass and be ordered to the Consent Calendar",8,0,0,3,11
1584583,1215281,2022-06-09,Senate,"Consent Calendar AB1802",38,0,0,2,40
1584584,1170618,2022-03-15,Assembly,"Do pass and be re-referred to the Committee on [Appropriations]",4,2,0,0,6
1584584,1206251,2022-05-19,Assembly,"Do pass as amended",12,4,0,0,16
1584584,1210327,2022-05-26,Assembly,"AB 1803 Jones-Sawyer Assembly Third Reading",51,17,0,10,78
1584584,1217461,2022-06-21,Senate,"Do pass, but first be re-referred to the Committee on [Appropriations]",4,0,0,1,5
1584584,1222648,2022-08-01,Senate,"Placed on suspense file",7,0,0,0,7
1584584,1223463,2022-08-11,Senate,"Do pass",5,2,0,0,7
1584584,1225835,2022-08-29,Senate,"Assembly 3rd Reading AB1803 Jones-Sawyer By Wiener",29,9,0,2,40
1584584,1225836,2022-08-30,Assembly,"AB 1803 Jones-Sawyer Concurrence in Senate Amendments",60,17,0,3,80
1584585,1175554,2022-03-23,Assembly,"Do pass as amended and be re-referred to the Committee on [Appropriations]",7,0,0,0,7
1584585,1206382,2022-05-19,Assembly,"Do pass as amended",12,0,0,4,16
1584585,1210261,2022-05-26,Assembly,"AB 1804 Salas Assembly Third Reading",75,0,0,3,78
1584585,1219888,2022-06-28,Senate,"Do pass, but first be re-referred to the Committee on [Appropriations] with the recommendation: To Consent Calendar",13,0,0,2,15
1584585,1222780,2022-08-01,Senate,"Placed on suspense file",7,0,0,0,7
1584585,1223862,2022-08-11,Senate,"Do pass",7,0,0,0,7
1584585,1224589,2022-08-23,Senate,"Special Consent AB1804",40,0,0,0,40
1584587,1180216,2022-03-30,Assembly,"Do pass and be re-referred to the Committee on [Appropriations] with recommendation: To Consent Calendar",13,0,0,1,14
1584587,1194493,2022-04-27,Assembly,"Do pass. To Consent Calendar",15,0,0,1,16
1584587,1200651,2022-05-05,Assembly,"AB 1805 Choi Consent Calendar Second Day Regular Session",61,0,0,17,78
1584587,1211880,2022-06-01,Senate,"Do pass, but first be re-referred to the Committee on [Appropriations] with the recommendation: To Consent Calendar",5,0,0,0,5
1584587,1219400,2022-06-27,Senate,"Consent Calendar AB1805",37,0,0,3,40
1584588,1189844,2022-04-19,Assembly,"Do pass as amended and be re-referred to the Committee on [Accountability and Administrative Review]",11,0,0,0,11
1584588,1194143,2022-04-27,Assembly,"Do pass and be re-referred to the Committee on [Appropriations]",7,0,0,0,7
1584591,1174480,2022-03-22,Assembly,"Do pass as amended and be re-referred to the Committee on [Judiciary]",10,0,0,4,14
1584591,1179184,2022-03-29,Assembly,"Do pass as amended and be re-referred to the Committee on [Appropriations]",7,0,0,3,10
1584591,1206403,2022-05-19,Assembly,"Do pass",13,1,0,2,16
1584591,1210278,2022-05-26,Assembly,"AB 1809 Aguiar-Curry Assembly Third Reading",57,0,0,21,78
1584591,1218596,2022-06-22,Senate,"Do pass as amended, but first amend, and re-refer to the Committee on [Judiciary]",9,0,0,2,11
1584591,1222699,2022-08-01,Senate,"Placed on suspense file",7,0,0,0,7
1584591,1223798,2022-08-11,Senate,"Do pass",7,0,0,0,7
1584591,1225326,2022-08-29,Senate,"Assembly 3rd Reading AB1809 Aguiar-Curry et al. By Eggman",40,0,0,0,40
1584591,1225327,2022-08-30,Assembly,"AB 1809 Aguiar-Curry Concurrence in Senate Amendments",77,0,0,3,80
1584592,1176550,2022-03-23,Assembly,"Do pass and be re-referred to the Committee on [Judiciary]",7,0,0,0,7
1584592,1179210,2022-03-29,Assembly,"Do pass as amended, and be re-referred to the Committee on [Appropriations] with recommendation: To Consent Calendar",10,0,0,0,10
1584592,1206565,2022-05-19,Assembly,"Do pass",16,0,0,0,16
1584592,1210418,2022-05-25,Assembly,"AB 1810 Levine Assembly Third Reading",76,0,0,2,78
1584592,1216343,2022-06-15,Senate,"Do pass, but first be re-referred to the Committee on [Judiciary]",6,0,0,1,7
1584592,1217914,2022-06-21,Senate,"Do pass, but first be re-referred to the Committee on [Appropriations]",8,0,0,3,11
1584592,1224118,2022-08-17,Senate,"Assembly 3rd Reading AB1810 Levine et al. By Umberg",38,0,0,2,40
1584593,1193295,2022-04-26,Assembly,"Do pass and be re-referred to the Committee on [Appropriations]",8,4,0,3,15
1584593,1203355,2022-05-11,Assembly,"Do pass",13,0,0,3,16
1584593,1210623,2022-05-25,Assembly,"AB 1811 Mike Fong Assembly Third Reading",69,1,0,8,78
1584593,1219964,2022-06-28,Senate,"Do pass and be ordered to the Consent Calendar",9,0,0,0,9
1584593,1223211,2022-08-08,Senate,"Consent Calendar AB1811 Mike Fong",36,0,0,4,40
1584593,1224076,2022-08-15,Assembly,"AB 1811 Mike Fong Concurrence in Senate Amendments",76,0,0,4,80
1584595,1199129,2022-05-03,Assembly,"Do pass and be re-referred to the Committee on [Judiciary]",7,0,0,0,7
1584595,1199130,2022-05-03,Assembly,"Do pass",10,0,0,0,10
1584595,1207736,2022-05-23,Assembly,"AB 1813 Medina Assembly Third Reading",74,0,0,4,78
1584595,1215759,2022-06-13,Senate,"Do pass, but first be re-referred to the Committee on [Judiciary] with the recommendation: To Consent Calendar",12,0,0,2,14
1584595,1220654,2022-06-28,Senate,"Do pass as amended, but first amend, and re-refer to the Committee on [Appropriations] with the recommendation: To Consent Calendar",10,0,0,1,11
1584595,1223276,2022-08-08,Senate,"Consent Calendar AB1813",36,0,0,4,40
1584595,1223810,2022-08-11,Assembly,"AB 1813 Medina Concurrence in Senate Amendments",76,0,0,4,80
1584597,1189830,2022-04-19,Assembly,"Do pass and be re-referred to the Committee on [Higher Education]",6,0,0,1,7
1584597,1194452,2022-04-26,Assembly,"Do pass and be re-referred to the Committee on [Appropriations]",9,1,0,2,12
1584598,1175512,2022-03-23,Assembly,"Do pass and be re-referred to the Committee on [Appropriations]",6,2,0,0,8
1584598,1206269,2022-05-19,Assembly,"Do pass",12,4,0,0,16
1584598,1210249,2022-05-26,Assembly,"AB 1816 Bryan Assembly Third Reading",58,17,0,3,78
1584598,1215875,2022-06-13,Senate,"Do pass, but first be re-referred to the Committee on [Appropriations]",9,0,0,0,9
1584598,1217072,2022-06-20,Senate,"Placed on suspense file",4,0,0,3,7
1584598,1223368,2022-08-11,Senate,"Do pass",7,0,0,0,7
1584599,1175513,2022-03-22,Assembly,"Do pass as amended",5,0,0,4,9
1584599,1207799,2022-05-23,Assembly,"AB 1817 Ting Assembly Third Reading",52,2,0,24,78
1584599,1220710,2022-06-29,Senate,"Do pass as amended",5,1,0,1,7
1584599,1225469,2022-08-29,Senate,"Assembly 3rd Reading AB1817 Ting et al. By McGuire",28,8,0,4,40
1584599,1225470,2022-08-30,Assembly,"AB 1817 Ting Concurrence in Senate Amendments",56,2,0,22,80
1584601,1194267,2022-04-27,Assembly,"Do pass as amended and be re-referred to the Committee on [Appropriations]",4,1,0,2,7
1584602,1171447,2022-03-16,Assembly,"Do pass and be re-referred to the Committee on [Public Safety]",7,0,0,0,7
1584602,1183849,2022-04-05,Assembly,"Do pass and be re-referred to the Committee on [Appropriations] with recommendation: To Consent Calendar",7,0,0,0,7
1584602,1207013,2022-05-19,Assembly,"Do pass",16,0,0,0,16
1584602,1210608,2022-05-25,Assembly,"AB 1820 Arambula Assembly Third Reading",76,0,0,2,78
1584602,1214947,2022-06-08,Senate,"Do pass, but first be re-referred to the Committee on [Public Safety] with the recommendation: To Consent Calendar",5,0,0,0,5
1584602,1220720,2022-06-28,Senate,"Do pass, but first be re-referred to the Committee on [Appropriations] with the recommendation: To Consent Calendar",5,0,0,0,5
1584602,1222890,2022-08-01,Senate,"Placed on suspense file",7,0,0,0,7
1584602,1223560,2022-08-11,Senate,"Do pass",7,0,0,0,7
1584602,1225874,2022-08-31,Senate,"Special Consent AB1820",40,0,0,0,40
1584602,1225875,2022-08-31,Assembly,"AB 1820 Arambula Concurrence in Senate Amendments",80,0,0,0,80
1584603,1180228,2022-03-30,Assembly,"Do pass and be re-referred to the Committee on [Appropriations] with recommendation: To Consent Calendar",13,0,0,1,14
1584605,1189896,2022-04-19,Assembly,"Do pass as amended and be re-referred to the Committee on [Appropriations]",14,0,0,1,15
1584605,1203389,2022-05-11,Assembly,"Do pass",16,0,0,0,16
1584605,1207785,2022-05-23,Assembly,"AB 1823 Bryan Assembly Third Reading",70,0,0,8,78
1584605,1221229,2022-06-29,Senate,"Do pass as amended, but first amend, and re-refer to the Committee on [Appropriations]",10,0,0,1,11
1584605,1223260,2022-08-08,Senate,"Do pass",7,0,0,0,7
1584605,1225703,2022-08-31,Senate,"Special Consent AB1823",40,0,0,0,40
1584605,1225704,2022-08-31,Assembly,"AB 1823 Bryan Concurrence in Senate Amendments",78,0,0,2,80
1584606,1171452,2022-03-16,Assembly,"Do pass and be re-referred to the Committee on [Appropriations] with recommendation: To Consent Calendar",6,0,0,0,6
1584606,1180223,2022-03-30,Assembly,"Do pass. To Consent Calendar",12,0,0,3,15
1584606,1186252,2022-04-07,Assembly,"AB 1824 P.E. & R. Consent Calendar Second Day Regular Session",65,0,0,12,77
1584606,1220879,2022-06-29,Senate,"Do pass as amended, but first amend, and re-refer to the Committee on [Appropriations] with the recommendation: To Consent Calendar",5,0,0,0,5
1584606,1223404,2022-08-11,Senate,"Consent Calendar AB1824 P. E. & R",38,0,0,2,40
1584606,1224192,2022-08-18,Assembly,"AB 1824 P.E. & R. Concurrence in Senate Amendments By COOPER",77,0,0,3,80
1584607,1194467,2022-04-27,Assembly,"Do pass and be re-referred to the Committee on [Appropriations] with recommendation: To Consent Calendar",10,0,0,1,11
1584607,1205875,2022-05-18,Assembly,"Do pass. To Consent Calendar",15,0,0,1,16
1584607,1210617,2022-05-25,Assembly,"AB 1825 AGRI. Consent Calendar Second Day By RIVAS, R",73,0,0,5,78
1584607,1217364,2022-06-21,Senate,"Do pass, but first be re-referred to the Committee on [Appropriations] with the recommendation: To Consent Calendar",5,0,0,0,5
1584607,1223167,2022-08-08,Senate,"Consent Calendar AB1825 AGRI",36,0,0,4,40
1584609,1189942,2022-04-19,Assembly,"Do pass and be re-referred to the Committee on [Appropriations]",2,4,0,1,7
1584610,1183677,2022-04-05,Assembly,"Do pass and be re-referred to the Committee on [Appropriations] with recommendation: To Consent Calendar",8,0,0,0,8
1584610,1206541,2022-05-19,Assembly,"Do pass",16,0,0,0,16
1584610,1210640,2022-05-25,Assembly,"AB 1828 Chen Assembly Third Reading",76,0,0,2,78
1584610,1217388,2022-06-20,Senate,"Do pass, but first be re-referred to the Committee on [Appropriations]",4,0,0,1,5
1584610,1222908,2022-08-01,Senate,"Placed on suspense file",7,0,0,0,7
1584614,1179404,2022-03-21,Assembly,"Do pass and be re-referred to the Committee on [Appropriations] with recommendation: To Consent Calendar",11,0,0,0,11
1584614,1194358,2022-04-27,Assembly,"Do pass as amended",15,0,0,1,16
1584614,1200652,2022-05-05,Assembly,"AB 1832 Luz Rivas Assembly Third Reading",62,0,0,16,78
1584614,1211916,2022-06-01,Senate,"Do pass, but first be re-referred to the Committee on [Appropriations]",8,0,0,1,9
1584614,1224982,2022-08-25,Senate,"Assembly 3rd Reading AB1832 Luz Rivas et al. By Laird",39,0,0,1,40
1584614,1224983,2022-08-25,Assembly,"AB 1832 Luz Rivas Concurrence in Senate Amendments",74,0,0,6,80
1584615,1190551,2022-04-20,Assembly,"Do pass and be re-referred to the Committee on [Transportation]",8,0,0,0,8
1584615,1193216,2022-04-25,Assembly,"Do pass as amended and be re-referred to the Committee on [Appropriations]",15,0,0,0,15
1584615,1204602,2022-05-16,Assembly,"AB 1833 Ward Assembly Third Reading",69,0,0,9,78
1584615,1216290,2022-06-14,Senate,"Do pass and be ordered to the Consent Calendar",15,0,0,2,17
1584615,1219485,2022-06-27,Senate,"Consent Calendar AB1833 Ward",37,0,0,3,40
1584616,1180251,2022-03-30,Assembly,"Do pass. To Consent Calendar",19,0,0,3,22
1584616,1186253,2022-04-07,Assembly,"AB 1834 Gipson Consent Calendar Second Day Regular Session",65,0,0,12,77
1584616,1219874,2022-06-28,Senate,"Do pass, but first be re-referred to the Committee on [Appropriations]",9,1,0,5,15
1584616,1222732,2022-08-01,Senate,"Placed on suspense file",7,0,0,0,7
1584618,1193155,2022-04-26,Assembly,"Do pass as amended, and be re-referred to the Committee on [Appropriations] with recommendation: To Consent Calendar",7,0,0,0,7
1584618,1206950,2022-05-19,Assembly,"Do pass",16,0,0,0,16
1584618,1210419,2022-05-25,Assembly,"AB 1836 Maienschein Assembly Third Reading",76,0,0,2,78
1584618,1217329,2022-06-21,Senate,"Do pass, but first be re-referred to the Committee on [Appropriations] with the recommendation: To Consent Calendar",4,0,0,1,5
1584618,1222739,2022-08-01,Senate,"Placed on suspense file",7,0,0,0,7
1584619,1170599,2022-03-15,Assembly,"Do pass as amended and be re-referred to the Committee on [Appropriations]",8,2,0,0,10
1584619,1206331,2022-05-19,Assembly,"Do pass as amended",12,4,0,0,16
1584619,1210250,2022-05-26,Assembly,"AB 1837 Mia Bonta Assembly Third Reading",55,18,0,5,78
1584619,1217904,2022-06-21,Senate,"Do pass as amended, but first amend, and re-refer to the Committee on [Appropriations]",9,2,0,0,11
1584619,1222646,2022-08-01,Senate,"Placed on suspense file",7,0,0,0,7
1584619,1223374,2022-08-11,Senate,"Do pass as amended",5,2,0,0,7
1584619,1225665,2022-08-29,Senate,"Assembly 3rd Reading AB1837 Mia Bonta et al. By Skinner",31,9,0,0,40
1584619,1225666,2022-08-30,Assembly,"AB 1837 Mia Bonta Concurrence in Senate Amendments",59,18,0,3,80
1584621,1193310,2022-04-25,Assembly,"Do pass and be re-referred to the Committee on [Appropriations]",3,3,0,5,11
1584622,1189815,2022-04-18,Assembly,"Do pass and be re-referred to the Committee on [Appropriations]",9,0,0,3,12
1584623,1189817,2022-04-18,Assembly,"Do pass and be re-referred to the Committee on [Appropriations]",12,0,0,0,12
1584624,1148966,2022-02-18,Assembly,"Be adopted. To Consent Calendar",10,0,0,2,12
1584624,1154463,2022-02-24,Assembly,"ACR 132 Luz Rivas Consent Calendar Second Day",70,0,0,6,76
1584624,1173485,2022-03-21,Senate,"Special Consent ACR132",37,0,0,3,40
1584625,1148963,2022-02-18,Assembly,"Be adopted. To third reading",10,0,0,2,12
1584625,1173531,2022-03-21,Senate,"Special Consent ACR133",37,0,0,3,40
1584626,1140886,2022-02-10,Assembly,"Be adopted. To third reading",10,0,0,2,12
1584627,1180253,2022-03-30,Senate,"Do pass, but first be re-referred to the Committee on [Appropriations]",7,0,0,0,7
1584627,1189393,2022-04-18,Senate,"Placed on suspense file",7,0,0,0,7
1584627,1206547,2022-05-19,Senate,"Do pass",7,0,0,0,7
1584627,1209959,2022-05-26,Senate,"Senate 3rd Reading SB924 Glazer et al",25,6,0,9,40
1584627,1216594,2022-06-15,Assembly,"Do pass as amended and be re-referred to the Committee on [Appropriations]",6,0,0,1,7
1584628,1183692,2022-04-05,Senate,"Do pass, but first be re-referred to the Committee on [Appropriations]",4,0,0,1,5
1584628,1198295,2022-05-02,Senate,"Senate 3rd Reading SB925 Bates",36,0,0,4,40
1584628,1211830,2022-06-01,Assembly,"Do pass as amended, and be re-referred to the Committee on [Appropriations] with recommendation: To Consent Calendar",7,0,0,0,7
1584628,1217848,2022-06-22,Assembly,"Do pass. To Consent Calendar",13,0,0,3,16
1584628,1221529,2022-06-29,Assembly,"SB 925 Bates Consent Calendar Second Day Regular Session",78,0,0,2,80
1584628,1223226,2022-08-08,Senate,"Special Consent SB925",36,0,0,4,40
1584629,1174473,2022-03-22,Senate,"Do pass, but first be re-referred to the Committee on [Governmental Organization] with the recommendation: To Consent Calendar",8,0,0,1,9
1584629,1183723,2022-04-05,Senate,"Do pass, but first be re-referred to the Committee on [Appropriations] with the recommendation: To Consent Calendar",13,0,0,2,15
1584629,1192149,2022-04-25,Senate,"Placed on suspense file",5,0,0,2,7
1584629,1206239,2022-05-19,Senate,"Do pass as amended",7,0,0,0,7
1584629,1209981,2022-05-26,Senate,"Special Consent SB926 Dodd et al. Urgency Clause",38,0,0,2,40
1584629,1217085,2022-06-20,Assembly,"Do pass and be re-referred to the Committee on [Judiciary]",10,0,0,1,11
1584629,1219912,2022-06-28,Assembly,"Do pass and be re-referred to the Committee on [Appropriations] with recommendation: To Consent Calendar",11,0,0,0,11
1584629,1223350,2022-08-11,Assembly,"Do pass as amended",12,0,0,4,16
1584629,1224233,2022-08-18,Assembly,"SB 926 Dodd Third Reading Urgency By Friedman",76,0,0,4,80
1584629,1224361,2022-08-22,Senate,"Unfinished Business SB926 Dodd et al. Urgency Clause Concurrence",39,0,0,1,40
1584630,1190699,2022-04-20,Senate,"Do pass as amended, but first amend, and re-refer to the Committee on [Appropriations]",8,4,0,0,12
1584630,1204561,2022-05-16,Senate,"Placed on suspense file",6,0,0,1,7
1584631,1179158,2022-03-29,Senate,"Do pass",11,0,0,0,11
1584631,1198314,2022-05-02,Senate,"Senate 3rd Reading SB928 Wieckowski",36,0,0,4,40
1584631,1211933,2022-06-01,Assembly,"Do pass",9,0,0,2,11
1584631,1222626,2022-08-01,Assembly,"SB 928 Wieckowski Senate Third Reading By Kalra",64,0,0,16,80
1584632,1175536,2022-03-23,Senate,"Do pass as amended, but first amend, and re-refer to the Committee on [Appropriations]",11,0,0,0,11
1584632,1189330,2022-04-18,Senate,"Placed on suspense file",7,0,0,0,7
1584632,1206324,2022-05-19,Senate,"Do pass as amended",7,0,0,0,7
1584632,1210014,2022-05-26,Senate,"Special Consent SB929",38,0,0,2,40
1584632,1220086,2022-06-28,Assembly,"Do pass and be re-referred to the Committee on [Appropriations] with recommendation: To Consent Calendar",15,0,0,0,15
1584632,1224011,2022-08-11,Assembly,"Do pass",16,0,0,0,16
1584632,1225523,2022-08-31,Senate,"Unfinished Business SB929 Eggman et al. Concurrence",39,0,0,1,40
1584632,1225524,2022-08-31,Assembly,"SB 929 Eggman Senate Third Reading By Wood",78,0,0,2,80
1584633,1194447,2022-04-27,Senate,"Do pass",9,0,0,0,9
1584633,1201416,2022-05-09,Senate,"Senate 3rd Reading SB930 Wiener",31,0,0,9,40
1584633,1217861,2022-06-22,Assembly,"Do pass and be re-referred to the Committee on [Appropriations]",12,4,0,6,22
1584633,1223841,2022-08-11,Assembly,"Do pass as amended",9,2,0,5,16
1584633,1224737,2022-08-24,Assembly,"SB 930 Wiener Senate Third Reading By Haney",25,31,0,24,80
1584634,1173516,2022-03-21,Senate,"Do pass, but first be re-referred to the Committee on [Judiciary]",4,1,0,0,5
1584634,1190616,2022-04-19,Senate,"Do pass as amended, but first amend, and re-refer to the Committee on [Appropriations]",9,2,0,0,11
1584634,1198249,2022-05-02,Senate,"Placed on suspense file",7,0,0,0,7
1584634,1206481,2022-05-19,Senate,"Do pass as amended",5,2,0,0,7
1584634,1208530,2022-05-24,Senate,"Senate 3rd Reading SB931 Leyva et al",25,9,0,6,40
1584634,1215933,2022-06-14,Assembly,"Do pass and be re-referred to the Committee on [Public Employment and Retirement]",8,1,0,2,11
1584634,1217849,2022-06-22,Assembly,"Do pass and be re-referred to the Committee on [Appropriations]",5,2,0,0,7
1584634,1223789,2022-08-11,Assembly,"Do pass as amended",12,4,0,0,16
1584634,1224693,2022-08-24,Assembly,"SB 931 Leyva Senate Third Reading By Cooper",59,14,0,7,80
1584634,1225892,2022-08-30,Senate,"Unfinished Business SB931 Leyva et al. Concurrence",29,9,0,2,40
1584635,1172340,2022-03-17,Senate,"Do pass as amended, but first amend, and re-refer to the Committee on [Transportation]",4,1,0,0,5
1584635,1194419,2022-04-26,Senate,"Do pass as amended, but first amend, and re-refer to the Committee on [Appropriations]",10,4,0,3,17
1584635,1204659,2022-05-16,Senate,"Placed on suspense file",6,0,0,1,7
1584635,1206433,2022-05-19,Senate,"Do pass",5,2,0,0,7
1584635,1209233,2022-05-25,Senate,"Senate 3rd Reading SB932 Portantino",25,10,0,5,40
1584635,1216608,2022-06-15,Assembly,"Do pass as amended and be re-referred to the Committee on [Transportation]",6,2,0,0,8
1584635,1219991,2022-06-27,Assembly,"Do pass and be re-referred to the Committee on [Appropriations]",10,2,0,3,15
1584635,1223912,2022-08-11,Assembly,"Do pass as amended",12,4,0,0,16
1584635,1225733,2022-08-30,Senate,"Unfinished Business SB932 Portantino et al. Concurrence",30,9,0,1,40
1584635,1225734,2022-08-30,Assembly,"SB 932 Portantino Senate Third Reading By Boerner Horvath",58,17,0,5,80
1584637,1180218,2022-03-30,Senate,"Do pass as amended, but first amend, and re-refer to the Committee on [Governmental Organization] with the recommendation: To Consent Calendar",11,0,0,0,11
1584637,1193349,2022-04-26,Senate,"Do pass, but first be re-referred to the Committee on [Appropriations] with the recommendation: To Consent Calendar",13,0,0,2,15
1584637,1198230,2022-05-02,Senate,"Placed on suspense file",7,0,0,0,7
1584637,1206500,2022-05-19,Senate,"Do pass as amended",7,0,0,0,7
1584637,1209988,2022-05-26,Senate,"Special Consent SB934",38,0,0,2,40
1584637,1217438,2022-06-21,Assembly,"Do pass and be re-referred to the Committee on [Appropriations] with recommendation: To Consent Calendar",15,0,0,0,15
1584638,1179183,2022-03-29,Senate,"Do pass and be ordered to the Consent Calendar",11,0,0,0,11
1584638,1185681,2022-04-07,Senate,"Consent Calendar SB935 Min et al",37,0,0,3,40
1584638,1211905,2022-06-01,Assembly,"Do pass. To Consent Calendar",10,0,0,1,11
1584638,1215311,2022-06-09,Assembly,"SB 935 Min Consent Calendar Second Day Regular Session",69,0,0,9,78
1584638,1216609,2022-06-16,Senate,"Special Consent SB935",35,0,0,5,40
1584639,1165752,2022-03-08,Senate,"Do pass, but first be re-referred to the Committee on [Public Safety]",9,0,0,0,9
1584639,1179172,2022-03-29,Senate,"Do pass, but first be re-referred to the Committee on [Appropriations] with the recommendation: To Consent Calendar",5,0,0,0,5
1584639,1189309,2022-04-18,Senate,"Placed on suspense file",7,0,0,0,7
1584639,1206444,2022-05-19,Senate,"Do pass",7,0,0,0,7
1584639,1209220,2022-05-25,Senate,"Special Consent SB936",39,0,0,1,40
1584639,1215554,2022-06-13,Assembly,"Do pass and be re-referred to the Committee on [Public Safety] with recommendation: To Consent Calendar",10,0,0,1,11
1584639,1219951,2022-06-28,Assembly,"Do pass and be re-referred to the Committee on [Appropriations] with recommendation: To Consent Calendar",7,0,0,0,7
1584639,1223685,2022-08-11,Assembly,"Do pass as amended",12,0,0,4,16
1584639,1224254,2022-08-22,Assembly,"SB 936 Glazer Senate Third Reading By BAUER-KAHAN",77,0,0,3,80
1584639,1224650,2022-08-24,Senate,"Unfinished Business SB936 Glazer et al. Concurrence",40,0,0,0,40
1584640,1179177,2022-03-29,Senate,"Do pass and be ordered to the Consent Calendar",11,0,0,0,11
1584640,1208476,2022-05-24,Senate,"Senate 3rd Reading SB937 Ochoa Bogh",37,0,0,3,40
1585803,1170640,2022-03-15,Assembly,"Do pass and be re-referred to the Committee on [Appropriations] with recommendation: To Consent Calendar",6,0,0,0,6
1585803,1180240,2022-03-30,Assembly,"Do pass. To Consent Calendar",12,0,0,3,15
1585803,1186251,2022-04-07,Assembly,"AB 1842 Rodriguez Consent Calendar Second Day Regular Session",65,0,0,12,77
1585803,1210897,2022-05-31,Senate,"Do pass, but first be re-referred to the Committee on [Appropriations]",5,0,0,0,5
1585803,1219364,2022-06-27,Senate,"Assembly 3rd Reading AB1842 Rodriguez By Hurtado",35,0,0,5,40
1585805,1183807,2022-04-05,Assembly,"Do pass as amended and be re-referred to the Committee on [Judiciary]",11,0,0,1,12
1585805,1189941,2022-04-19,Assembly,"Do pass as amended and be re-referred to the Committee on [Appropriations]",8,0,0,3,11
1585806,1176547,2022-03-23,Assembly,"Do pass as amended and be re-referred to the Committee on [Water, Parks, and Wildlife]",8,0,0,0,8
1585806,1193313,2022-04-26,Assembly,"Do pass and be re-referred to the Committee on [Appropriations]",12,0,0,3,15
1585806,1205855,2022-05-18,Assembly,"Do pass",12,1,0,3,16
1585806,1210267,2022-05-25,Assembly,"AB 1845 Calderon Assembly Third Reading",70,0,0,8,78
1585806,1221291,2022-06-29,Senate,"Do pass, but first be re-referred to the Committee on [Appropriations]",5,0,0,0,5
1585806,1224548,2022-08-23,Senate,"Assembly 3rd Reading AB1845 Calderon By Hertzberg",36,0,0,4,40
1585806,1224870,2022-08-24,Assembly,"AB 1845 Calderon Concurrence in Senate Amendments",76,0,0,4,80
1585807,1174557,2022-03-22,Assembly,"Do pass and be re-referred to the Committee on [Appropriations]",5,2,0,0,7
1585808,1174511,2022-03-22,Assembly,"Do pass and be re-referred to the Committee on [Appropriations]",5,0,0,2,7
1585808,1206920,2022-05-19,Assembly,"Do pass",16,0,0,0,16
1585808,1210658,2022-05-25,Assembly,"AB 1847 Valladares Assembly Third Reading",72,2,0,4,78
1585808,1217366,2022-06-21,Senate,"Do pass as amended, but first amend, and re-refer to the Committee on [Appropriations]",4,0,0,1,5
1585808,1222760,2022-08-01,Senate,"Placed on suspense file",7,0,0,0,7
1585809,1194148,2022-04-27,Assembly,"Do pass and be re-referred to the Committee on [Appropriations]",5,1,0,1,7
1585809,1205865,2022-05-18,Assembly,"Do pass",11,4,0,1,16
1585809,1210614,2022-05-25,Assembly,"AB 1848 Bryan Assembly Third Reading",57,19,0,2,78
1585809,1217396,2022-06-21,Senate,"Do pass, but first be re-referred to the Committee on [Appropriations]",4,1,0,0,5
1585809,1224534,2022-08-23,Senate,"Assembly 3rd Reading AB1848 Bryan By Newman",31,9,0,0,40
1585809,1224673,2022-08-24,Assembly,"AB 1848 Bryan Concurrence in Senate Amendments",59,17,0,4,80
1585811,1190585,2022-04-20,Assembly,"Do pass as amended",6,0,0,2,8
1585811,1198320,2022-05-02,Assembly,"AB 1850 Ward Assembly Third Reading",52,0,0,25,77
1585811,1218004,2022-06-21,Senate,"Do pass, but first be re-referred to the Committee on [Governance and Finance]",5,0,0,4,9
1585811,1221248,2022-06-29,Senate,"Do pass",2,2,0,1,5
1585811,1221249,2022-06-29,Senate,"[First] hearing set for [06-30-2022]: Failed passage in Committee. Reconsideration granted",5,0,0,0,5
1585812,1171438,2022-03-16,Assembly,"Do pass and be re-referred to the Committee on [Appropriations]",6,1,0,0,7
1585812,1206378,2022-05-19,Assembly,"Do pass",13,3,0,0,16
1585812,1210242,2022-05-26,Assembly,"AB 1851 Robert Rivas Assembly Third Reading",58,13,0,7,78
1585812,1215799,2022-06-13,Senate,"Do pass as amended, but first amend, and re-refer to the Committee on [Appropriations]",4,1,0,0,5
1585812,1222892,2022-08-01,Senate,"Placed on suspense file",7,0,0,0,7
1585812,1223860,2022-08-11,Senate,"Do pass",5,2,0,0,7
1585812,1225744,2022-08-29,Senate,"Assembly 3rd Reading AB1851 Robert Rivas By Gonzalez",28,9,0,3,40
1585812,1225745,2022-08-30,Assembly,"AB 1851 Robert Rivas Concurrence in Senate Amendments",61,13,0,6,80
1585813,1174518,2022-03-22,Assembly,"Do pass as amended, and be re-referred to the Committee on [Appropriations] with recommendation: To Consent Calendar",14,0,0,0,14
1585813,1184738,2022-04-06,Assembly,"Do pass. To Consent Calendar",13,0,0,3,16
1585813,1191272,2022-04-21,Assembly,"AB 1852 Patterson Consent Calendar Second Day Regular Session",68,0,0,9,77
1585813,1211945,2022-06-01,Senate,"Do pass, but first be re-referred to the Committee on [Appropriations] with the recommendation: To Consent Calendar",9,0,0,2,11
1585813,1219474,2022-06-27,Senate,"Consent Calendar AB1852",37,0,0,3,40
1585814,1185705,2022-04-06,Assembly,"Do pass as amended and be re-referred to the Committee on [Appropriations]",7,0,0,0,7
1585815,1180271,2022-03-30,Assembly,"Do pass and be re-referred to the Committee on [Appropriations] with recommendation: To Consent Calendar",13,0,0,1,14
1585815,1194122,2022-04-27,Assembly,"Do pass. To Consent Calendar",15,0,0,1,16
1585815,1200653,2022-05-05,Assembly,"AB 1854 Boerner Horvath Consent Calendar Second Day Regular Session",61,0,0,17,78
1585815,1211840,2022-06-01,Senate,"Do pass, but first be re-referred to the Committee on [Appropriations] with the recommendation: To Consent Calendar",5,0,0,0,5
1585815,1219377,2022-06-27,Senate,"Consent Calendar AB1854",37,0,0,3,40
1585816,1189814,2022-04-19,Assembly,"Do pass and be re-referred to the Committee on [Appropriations] with recommendation: To Consent Calendar",7,0,0,0,7
1585816,1199921,2022-05-04,Assembly,"Do pass. To Consent Calendar",14,0,0,2,16
1585816,1204117,2022-05-12,Assembly,"AB 1855 Nazarian Consent Calendar Second Day Regular Session",65,0,0,13,78
1585816,1215770,2022-06-13,Senate,"Do pass, but first be re-referred to the Committee on [Health]",5,0,0,0,5
1585816,1221312,2022-06-29,Senate,"Do pass as amended, but first amend, and re-refer to the Committee on [Appropriations] with the recommendation: To Consent Calendar",10,0,0,1,11
1585816,1224497,2022-08-23,Senate,"Assembly 3rd Reading AB1855 Nazarian By Dodd",40,0,0,0,40
1585816,1224694,2022-08-24,Assembly,"AB 1855 Nazarian Concurrence in Senate Amendments",76,0,0,4,80
1585817,1183680,2022-04-05,Assembly,"Do pass and be re-referred to the Committee on [Appropriations]",11,0,0,1,12
1585817,1206830,2022-05-19,Assembly,"Do pass",16,0,0,0,16
1585817,1210319,2022-05-26,Assembly,"AB 1856 Medina Assembly Third Reading",76,0,0,2,78
1585817,1217981,2022-06-22,Senate,"Do pass, but first be re-referred to the Committee on [Appropriations]",6,0,0,1,7
1585817,1222855,2022-08-01,Senate,"Placed on suspense file",7,0,0,0,7
1585817,1223755,2022-08-11,Senate,"Do pass",7,0,0,0,7
1585817,1225498,2022-08-31,Senate,"Special Consent AB1856",40,0,0,0,40
1585818,1179272,2022-03-21,Assembly,"Do pass and be re-referred to the Committee on [Appropriations]",8,3,0,0,11
1585818,1206644,2022-05-19,Assembly,"Do pass as amended",12,4,0,0,16
1585818,1210528,2022-05-25,Assembly,"AB 1857 Cristina Garcia Assembly Third Reading",52,19,0,7,78
1585818,1217938,2022-06-22,Senate,"Do pass as amended, but first amend, and re-refer to the Committee on [Appropriations]",5,2,0,0,7
1585818,1222686,2022-08-01,Senate,"Placed on suspense file",7,0,0,0,7
1585818,1223432,2022-08-11,Senate,"Do pass",5,2,0,0,7
1585818,1225650,2022-08-29,Senate,"Assembly 3rd Reading AB1857 Cristina Garcia By Eggman",25,10,0,5,40
1585818,1225651,2022-08-30,Assembly,"AB 1857 Cristina Garcia Concurrence in Senate Amendments",55,19,0,6,80
1585818,1229702,2022-08-30,Senate,"Assembly 3rd Reading AB1857 Cristina Garcia By Eggman",25,10,0,5,40
1585819,1190542,2022-04-20,Assembly,"Do pass and be re-referred to the Committee on [Appropriations]",6,1,0,1,8
1585820,1193245,2022-04-26,Assembly,"Do pass and be re-referred to the Committee on [Appropriations]",11,2,0,2,15
1585820,1206489,2022-05-19,Assembly,"Do pass",12,4,0,0,16
1585820,1210580,2022-05-26,Assembly,"AB 1859 Levine Assembly Third Reading",59,12,0,7,78
1585820,1218607,2022-06-22,Senate,"Do pass as amended, but first amend, and re-refer to the Committee on [Appropriations]",8,0,0,3,11
1585820,1222718,2022-08-01,Senate,"Placed on suspense file",7,0,0,0,7
1585820,1223624,2022-08-11,Senate,"Do pass",5,1,0,1,7
1585820,1224827,2022-08-24,Senate,"Assembly 3rd Reading AB1859 Levine By Wiener",32,6,0,2,40
1585820,1224953,2022-08-25,Assembly,"AB 1859 Levine Concurrence in Senate Amendments",60,6,0,14,80
1585821,1174529,2022-03-22,Assembly,"Do pass as amended",14,0,0,0,14
1585821,1206342,2022-05-19,Assembly,"Do pass",16,0,0,0,16
1585821,1207749,2022-05-23,Assembly,"AB 1860 Ward Assembly Third Reading",73,0,0,5,78
1585821,1214957,2022-06-08,Senate,"Do pass, but first be re-referred to the Committee on [Appropriations] with the recommendation: To Consent Calendar",9,0,0,2,11
1585821,1217103,2022-06-20,Senate,"Placed on suspense file",4,0,0,3,7
1585821,1223421,2022-08-11,Senate,"Do pass as amended",7,0,0,0,7
1585821,1225660,2022-08-31,Senate,"Special Consent AB1860",40,0,0,0,40
1585821,1225661,2022-08-31,Assembly,"AB 1860 Ward Concurrence in Senate Amendments By BERMAN",77,0,0,3,80
1585822,1190703,2022-04-18,Assembly,"Do pass and be re-referred to the Committee on [Human Services]",9,0,0,2,11
1585822,1193405,2022-04-26,Assembly,"Do pass and be re-referred to the Committee on [Appropriations]",7,0,0,1,8
1585823,1183588,2022-04-05,Assembly,"Do pass and be re-referred to the Committee on [Appropriations] with recommendation: To Consent Calendar",8,0,0,0,8
1585823,1206873,2022-05-19,Assembly,"Do pass",16,0,0,0,16
1585823,1210332,2022-05-25,Assembly,"AB 1862 Ramos Assembly Third Reading",76,0,0,2,78
1585823,1215774,2022-06-13,Senate,"Do pass, but first be re-referred to the Committee on [Judiciary] with the recommendation: To Consent Calendar",5,0,0,0,5
1585823,1217917,2022-06-21,Senate,"Do pass, but first be re-referred to the Committee on [Appropriations] with the recommendation: To Consent Calendar",11,0,0,0,11
1585823,1223151,2022-08-08,Senate,"Placed on suspense file",7,0,0,0,7
1585824,1193340,2022-04-25,Assembly,"Do pass and be re-referred to the Committee on [Appropriations]",8,1,0,2,11
1585824,1206770,2022-05-19,Assembly,"Do pass as amended",12,4,0,0,16
1585824,1210352,2022-05-26,Assembly,"AB 1863 Irwin Assembly Third Reading",59,3,0,16,78
1585824,1216356,2022-06-15,Senate,"Do pass, but first be re-referred to the Committee on [Appropriations]",5,0,0,0,5
1585824,1224328,2022-08-22,Senate,"Assembly 3rd Reading AB1863 Irwin By Caballero",40,0,0,0,40
1585824,1224503,2022-08-23,Assembly,"AB 1863 Irwin Concurrence in Senate Amendments",66,1,0,13,80
1585826,1170612,2022-03-15,Assembly,"Do pass as amended, and be re-referred to the Committee on [Water, Parks, and Wildlife] with recommendation: To Consent Calendar",10,0,0,0,10
1585826,1193260,2022-04-26,Assembly,"Do pass and be re-referred to the Committee on [Appropriations] with recommendation: To Consent Calendar",15,0,0,0,15
1585826,1206337,2022-05-19,Assembly,"Do pass",16,0,0,0,16
1585826,1210616,2022-05-25,Assembly,"AB 1865 Bennett Assembly Third Reading",76,0,0,2,78
1585826,1216300,2022-06-14,Senate,"Do pass, but first be re-referred to the Committee on [Appropriations] with the recommendation: To Consent Calendar",11,0,0,0,11
1585826,1222817,2022-08-01,Senate,"Placed on suspense file",7,0,0,0,7
1585827,1170651,2022-03-15,Assembly,"Do pass. To Consent Calendar",10,0,0,0,10
1585827,1173509,2022-03-21,Assembly,"AB 1866 Chen Consent Calendar Second Day Regular Session",72,0,0,4,76
1585827,1210914,2022-05-31,Senate,"Do pass and be ordered to the Consent Calendar",8,0,0,3,11
1585827,1215270,2022-06-09,Senate,"Consent Calendar AB1866",38,0,0,2,40
1585828,1185708,2022-04-06,Assembly,"Do pass as amended and be re-referred to the Committee on [Appropriations]",7,0,0,0,7
1585828,1206420,2022-05-19,Assembly,"Do pass",16,0,0,0,16
1585828,1210643,2022-05-25,Assembly,"AB 1867 Lee Assembly Third Reading",76,0,0,2,78
1585828,1216351,2022-06-15,Senate,"Do pass, but first be re-referred to the Committee on [Appropriations]",6,0,0,1,7
1585828,1222808,2022-08-01,Senate,"Placed on suspense file",7,0,0,0,7
1585828,1223533,2022-08-11,Senate,"Do pass as amended",7,0,0,0,7
1585828,1224442,2022-08-23,Senate,"Special Consent AB1867",40,0,0,0,40
1585828,1224754,2022-08-24,Assembly,"AB 1867 Lee Concurrence in Senate Amendments",77,0,0,3,80
1585829,1185722,2022-04-06,Assembly,"Do pass as amended and be re-referred to the Committee on [Appropriations]",7,0,0,0,7
1585829,1206829,2022-05-19,Assembly,"Do pass",16,0,0,0,16
1585829,1210486,2022-05-25,Assembly,"AB 1868 Luz Rivas Assembly Third Reading",76,0,0,2,78
1585829,1216332,2022-06-15,Senate,"Do pass as amended, but first amend, and re-refer to the Committee on [Appropriations] with the recommendation: To Consent Calendar",6,0,0,1,7
1585829,1222873,2022-08-01,Senate,"Placed on suspense file",7,0,0,0,7
1585829,1223458,2022-08-11,Senate,"Do pass",7,0,0,0,7
1585829,1224499,2022-08-23,Senate,"Special Consent AB1868",40,0,0,0,40
1585829,1224824,2022-08-24,Assembly,"AB 1868 Luz Rivas Concurrence in Senate Amendments",77,0,0,3,80
1585830,1170622,2022-03-15,Assembly,"Do pass and be re-referred to the Committee on [Appropriations]",1,2,0,3,6
1585830,1193379,2022-04-26,Assembly,"Do pass and be re-referred to the Committee on [Appropriations]",0,6,0,1,7
1585831,1194174,2022-04-27,Assembly,"Do pass and be re-referred to the Committee on [Appropriations] with recommendation: To Consent Calendar",10,0,0,1,11
1585831,1206957,2022-05-19,Assembly,"Do pass as amended",12,0,0,4,16
1585831,1210280,2022-05-26,Assembly,"AB 1870 Stone Assembly Third Reading",75,0,0,3,78
1585831,1218672,2022-06-22,Senate,"Do pass, but first be re-referred to the Committee on [Appropriations] with the recommendation: To Consent Calendar",9,0,0,2,11
1585831,1222841,2022-08-01,Senate,"Placed on suspense file",7,0,0,0,7
1585831,1223986,2022-08-11,Senate,"Do pass as amended",7,0,0,0,7
1585831,1224529,2022-08-23,Senate,"Special Consent AB1870",40,0,0,0,40
1585831,1224856,2022-08-24,Assembly,"AB 1870 Stone Concurrence in Senate Amendments",76,0,0,4,80
1585832,1183809,2022-04-05,Assembly,"Do pass",9,0,0,1,10
1585832,1192202,2022-04-25,Assembly,"AB 1871 Calderon Assembly Third Reading",55,1,0,21,77
1585832,1220838,2022-06-28,Senate,"Do pass, but first be re-referred to the Committee on [Appropriations]",9,1,0,1,11
1585832,1224382,2022-08-22,Senate,"Assembly 3rd Reading AB1871 Calderon By Umberg",34,4,0,2,40
1585832,1224558,2022-08-23,Assembly,"AB 1871 Calderon Concurrence in Senate Amendments",67,1,0,12,80
1585833,1175529,2022-03-23,Assembly,"Do pass and be re-referred to the Committee on [Governmental Organization]",5,2,0,0,7
1585833,1190622,2022-04-20,Assembly,"Do pass and be re-referred to the Committee on [Appropriations]",13,4,0,5,22
1585835,1179411,2022-03-29,Assembly,"Do pass and be re-referred to the Committee on [Appropriations]",4,10,0,4,18
1585837,1176502,2022-03-23,Assembly,"Do pass and be re-referred to the Committee on [Appropriations] with recommendation: To Consent Calendar",7,0,0,0,7
1585837,1184625,2022-04-06,Assembly,"Do pass. To Consent Calendar",13,0,0,3,16
1585837,1191324,2022-04-21,Assembly,"AB 1876 Seyarto Consent Calendar Second Day Regular Session",68,0,0,9,77
1585837,1211902,2022-06-01,Senate,"Do pass, but first be re-referred to the Committee on [Appropriations] with the recommendation: To Consent Calendar",6,0,0,1,7
1585837,1219397,2022-06-27,Senate,"Consent Calendar AB1876",37,0,0,3,40
1585839,1183728,2022-04-05,Assembly,"Do pass and be re-referred to the Committee on [Appropriations]",13,0,0,2,15
1585839,1206398,2022-05-19,Assembly,"Do pass",13,2,0,1,16
1585839,1210239,2022-05-26,Assembly,"AB 1878 Wood Assembly Third Reading",63,6,0,9,78
1585839,1221256,2022-06-29,Senate,"Do pass, but first be re-referred to the Committee on [Appropriations]",8,2,0,1,11
1585839,1222759,2022-08-01,Senate,"Placed on suspense file",7,0,0,0,7
1585840,1197953,2022-04-26,Assembly,"Do pass and be re-referred to the Committee on [Appropriations]",9,0,0,0,9
1585840,1206453,2022-05-19,Assembly,"Do pass",15,0,0,1,16
1585840,1210634,2022-05-25,Assembly,"AB 1879 Mathis Assembly Third Reading",69,3,0,6,78
1585840,1220693,2022-06-29,Senate,"Do pass as amended, but first amend, and re-refer to the Committee on [Appropriations]",4,1,0,2,7
1585840,1224576,2022-08-23,Senate,"Assembly 3rd Reading AB1879 Mathis By Wiener",34,2,0,4,40
1585840,1224577,2022-08-23,Senate,"Assembly 3rd Reading AB1879 Mathis By Wiener",40,0,0,0,40
1585840,1224578,2022-08-23,Senate,"Assembly 3rd Reading AB1879 Mathis By Wiener",32,2,0,6,40
1585840,1224639,2022-08-24,Assembly,"AB 1879 Mathis Concurrence in Senate Amendments",68,3,0,9,80
1585841,1183670,2022-04-05,Assembly,"Do pass as amended and be re-referred to the Committee on [Appropriations]",13,0,0,2,15
1585841,1207036,2022-05-19,Assembly,"Do pass",13,2,0,1,16
1585841,1210257,2022-05-26,Assembly,"AB 1880 Arambula Assembly Third Reading",62,9,0,7,78
1585841,1216378,2022-06-15,Senate,"Do pass as amended, but first amend, and re-refer to the Committee on [Appropriations]",7,2,0,2,11
1585841,1219475,2022-06-27,Senate,"Placed on suspense file",6,0,0,1,7
1585841,1223502,2022-08-11,Senate,"Do pass",5,1,0,1,7
1585841,1224867,2022-08-24,Senate,"Assembly 3rd Reading AB1880 Arambula et al. By Wiener",32,8,0,0,40
1585841,1224966,2022-08-25,Assembly,"AB 1880 Arambula Concurrence in Senate Amendments",61,0,0,19,80
1585842,1193366,2022-04-26,Assembly,"Do pass as amended and be re-referred to the Committee on [Appropriations]",14,0,0,4,18
1585842,1203380,2022-05-11,Assembly,"Do pass",12,3,0,1,16
1585842,1210395,2022-05-25,Assembly,"AB 1881 Santiago Assembly Third Reading",53,13,0,12,78
1585842,1217365,2022-06-20,Senate,"Do pass, but first be re-referred to the Committee on [Judiciary]",10,2,0,2,14
1585842,1220622,2022-06-28,Senate,"Do pass as amended, but first amend, and re-refer to the Committee on [Appropriations]",8,1,0,2,11
1585842,1225256,2022-08-29,Senate,"Assembly 3rd Reading AB1881 Santiago By Caballero",12,11,0,17,40
1585842,1225257,2022-08-29,Senate,"Assembly 3rd Reading AB1881 Santiago By Caballero Reconsider",40,0,0,0,40
1585842,1229712,2022-08-30,Senate,"Assembly 3rd Reading AB1881 Santiago By Caballero",12,11,0,17,40
1585842,1229713,2022-08-30,Senate,"Assembly 3rd Reading AB1881 Santiago By Caballero Reconsider",40,0,0,0,40
1585843,1193206,2022-04-26,Assembly,"Do pass as amended and be re-referred to the Committee on [Appropriations]",10,1,0,4,15
1585843,1203332,2022-05-11,Assembly,"Do pass",12,4,0,0,16
1585843,1204658,2022-05-16,Assembly,"AB 1882 Robert Rivas Assembly Third Reading",50,17,0,11,78
1585843,1214994,2022-06-08,Senate,"Do pass as amended, but first amend, and re-refer to the Committee on [Appropriations]",7,2,0,2,11
1585843,1219418,2022-06-27,Senate,"Do pass",4,1,0,2,7
1585843,1224762,2022-08-24,Senate,"Assembly 3rd Reading AB1882 Robert Rivas et al. By Leyva",31,5,0,4,40
1585843,1225021,2022-08-25,Assembly,"AB 1882 Robert Rivas Concurrence in Senate Amendments",59,10,0,11,80
1585844,1195774,2022-04-27,Assembly,"Do pass and be re-referred to the Committee on [Appropriations]",7,0,0,1,8
1585844,1206862,2022-05-19,Assembly,"Do pass",12,2,0,2,16
1585844,1210560,2022-05-26,Assembly,"AB 1883 Quirk-Silva Assembly Third Reading",59,15,0,4,78
1585844,1217908,2022-06-22,Senate,"Do pass as amended, but first amend, and re-refer to the Committee on [Appropriations]",4,1,0,0,5
1585844,1222836,2022-08-01,Senate,"Placed on suspense file",7,0,0,0,7
1585846,1189938,2022-04-19,Assembly,"Do pass and be re-referred to the Committee on [Appropriations]",19,0,0,0,19
1585846,1206543,2022-05-19,Assembly,"Do pass as amended",15,0,0,1,16
1585846,1210632,2022-05-25,Assembly,"AB 1885 Kalra Assembly Third Reading",73,0,0,5,78
1585846,1217415,2022-06-20,Senate,"Do pass, but first be re-referred to the Committee on [Appropriations]",13,0,0,1,14
1585846,1222867,2022-08-01,Senate,"Placed on suspense file",7,0,0,0,7
1585846,1223989,2022-08-11,Senate,"Do pass",7,0,0,0,7
1585846,1225672,2022-08-29,Senate,"Assembly 3rd Reading AB1885 Kalra By Roth",40,0,0,0,40
1585846,1225673,2022-08-30,Assembly,"AB 1885 Kalra Concurrence in Senate Amendments",76,0,0,4,80
1585847,1171449,2022-03-16,Assembly,"Do pass and be re-referred to the Committee on [Appropriations]",6,0,0,1,7
1585847,1184707,2022-04-06,Assembly,"Do pass",11,1,0,4,16
1585847,1210612,2022-05-25,Assembly,"AB 1886 Cooper Assembly Third Reading",67,9,0,2,78
1585847,1215019,2022-06-08,Senate,"Do pass, but first be re-referred to the Committee on [Appropriations]",4,0,0,1,5
1585847,1225457,2022-08-29,Senate,"Assembly 3rd Reading AB1886 Cooper By Newman",25,12,0,3,40
1585847,1225458,2022-08-31,Assembly,"AB 1886 Cooper Concurrence in Senate Amendments",39,12,0,29,80
1585847,1225459,2022-08-31,Assembly,"AB 1886 Cooper Concurrence in Senate Amendments",38,13,0,29,80
1585847,1229722,2022-08-30,Senate,"Assembly 3rd Reading AB1886 Cooper By Newman",25,12,0,3,40
1585849,1212432,2022-06-02,Assembly,"Be adopted. To third reading",8,0,0,3,11
1585849,1215284,2022-06-09,Assembly,"ACR 134 Nguyen Consent Calendar Second Day Regular Session",69,0,0,9,78
1585849,1221319,2022-06-30,Senate,"Special Consent ACR134",37,0,0,3,40
1585850,1181265,2022-03-31,Senate,"Do pass as amended",5,0,0,0,5
1585850,1192203,2022-04-25,Senate,"Senate 3rd Reading SB938 Hertzberg et al",38,0,0,2,40
1585850,1215049,2022-06-08,Assembly,"Do pass as amended",8,0,0,0,8
1585850,1216802,2022-06-16,Assembly,"SB 938 Hertzberg Senate Third Reading By Mayes",71,0,0,8,79
1585850,1218600,2022-06-23,Senate,"Unfinished Business SB938 Hertzberg et al. Concurrence",38,0,0,2,40
1585851,1175550,2022-03-23,Senate,"Do pass",9,1,0,1,11
1585851,1207808,2022-05-23,Senate,"Senate 3rd Reading SB939 Pan et al",24,9,0,7,40
1585852,1179267,2022-03-29,Senate,"Do pass as amended",8,2,0,1,11
1585852,1207773,2022-05-23,Senate,"Senate 3rd Reading SB940 Laird",24,10,0,6,40
1585852,1216364,2022-06-15,Assembly,"Do pass",6,0,0,2,8
1585852,1223169,2022-08-08,Assembly,"SB 940 Laird Senate Third Reading By Wicks",45,21,0,14,80
1585852,1224073,2022-08-15,Senate,"Unfinished Business SB940 Laird Concurrence",26,10,0,4,40
1585853,1175514,2022-03-23,Senate,"Do pass, but first be re-referred to the Committee on [Appropriations]",7,0,0,0,7
1585853,1191273,2022-04-21,Senate,"Senate 3rd Reading SB941 Portantino",39,0,0,1,40
1585853,1220850,2022-06-29,Assembly,"Do pass as amended, and be re-referred to the Committee on [Appropriations] with recommendation: To Consent Calendar",7,0,0,0,7
1585853,1223693,2022-08-11,Assembly,"Do pass",16,0,0,0,16
1585853,1224304,2022-08-22,Assembly,"SB 941 Portantino Senate Third Reading By Luz Rivas",77,0,0,3,80
1585853,1225678,2022-08-30,Senate,"Special Consent SB941",38,0,0,2,40
1585854,1174463,2022-03-22,Senate,"Do pass, but first be re-referred to the Committee on [Environmental Quality]",16,0,0,1,17
1585854,1179433,2022-03-28,Senate,"Do pass, but first be re-referred to the Committee on [Appropriations]",6,0,0,1,7
1585854,1201440,2022-05-09,Senate,"Senate 3rd Reading SB942 Newman",32,0,0,8,40
1585854,1220055,2022-06-27,Assembly,"Do pass as amended and be re-referred to the Committee on [Appropriations]",14,0,0,1,15
1585854,1223322,2022-08-10,Assembly,"Do pass. To Consent Calendar",15,0,0,1,16
1585854,1224215,2022-08-18,Assembly,"SB 942 Newman Consent Calendar Second Day Regular Session",73,0,0,7,80
1585854,1224575,2022-08-23,Senate,"Unfinished Business SB942 Newman et al. Concurrence",40,0,0,0,40
1585856,1175507,2022-03-23,Senate,"Do pass, but first be re-referred to the Committee on [Appropriations]",9,2,0,0,11
1585856,1189342,2022-04-18,Senate,"Placed on suspense file",7,0,0,0,7
1585856,1206800,2022-05-19,Senate,"Do pass",5,2,0,0,7
1585856,1207877,2022-05-23,Senate,"Senate 3rd Reading SB944 Pan",27,8,0,5,40
1585856,1220041,2022-06-28,Assembly,"Do pass and be re-referred to the Committee on [Appropriations]",13,2,0,0,15
1585856,1223515,2022-08-11,Assembly,"Do pass",12,4,0,0,16
1585856,1224303,2022-08-22,Assembly,"SB 944 Pan Senate Third Reading By Wood Amendment Set #1",59,14,0,7,80
1585856,1225480,2022-08-31,Senate,"Unfinished Business SB944 Pan et al. Concurrence",29,8,0,3,40
1585856,1225481,2022-08-31,Assembly,"SB 944 Pan Senate Third Reading By Wood",63,11,0,6,80
1585857,1174470,2022-03-22,Senate,"Do pass as amended, but first amend, and re-refer to the Committee on [Appropriations]",8,0,0,1,9
1585857,1192190,2022-04-25,Senate,"Placed on suspense file",5,0,0,2,7
1585857,1206437,2022-05-19,Senate,"Do pass",7,0,0,0,7
1585857,1209311,2022-05-25,Senate,"Special Consent SB945",39,0,0,1,40
1585857,1219922,2022-06-28,Assembly,"Do pass and be re-referred to the Committee on [Appropriations]",14,0,0,1,15
1585857,1223597,2022-08-11,Assembly,"Do pass as amended",12,0,0,4,16
1585857,1224202,2022-08-18,Assembly,"SB 945 Laird Senate Third Reading By Aguiar-Curry",75,0,0,5,80
1585857,1224394,2022-08-22,Senate,"Unfinished Business SB945 Laird Concurrence",39,0,0,1,40
1585858,1179247,2022-03-29,Senate,"Do pass, but first be re-referred to the Committee on [Appropriations] with the recommendation: To Consent Calendar",11,0,0,0,11
1585858,1189304,2022-04-18,Senate,"Placed on suspense file",7,0,0,0,7
1585858,1206674,2022-05-19,Senate,"Do pass",7,0,0,0,7
1585858,1209296,2022-05-25,Senate,"Special Consent SB946",39,0,0,1,40
1585859,1190532,2022-04-19,Senate,"Do pass as amended, but first amend, and re-refer to the Committee on [Appropriations] with the recommendation: To Consent Calendar",11,0,0,0,11
1585859,1201400,2022-05-09,Senate,"Placed on suspense file",7,0,0,0,7
1585859,1206841,2022-05-19,Senate,"Do pass",6,0,0,1,7
1585859,1210001,2022-05-26,Senate,"Senate 3rd Reading SB947 Wilk",36,0,0,4,40
1586973,1200525,2022-05-05,Assembly,"Do pass as amended and be re-referred to the Committee on [Appropriations]",10,1,0,0,11
1586976,1183627,2022-04-05,Assembly,"Do pass as amended and be re-referred to the Committee on [Appropriations]",14,0,0,1,15
1586976,1206893,2022-05-19,Assembly,"Do pass",16,0,0,0,16
1586976,1210654,2022-05-25,Assembly,"AB 1892 Flora Assembly Third Reading",76,0,0,2,78
1586976,1214955,2022-06-08,Senate,"Do pass, but first be re-referred to the Committee on [Appropriations] with the recommendation: To Consent Calendar",9,0,0,2,11
1586976,1217118,2022-06-20,Senate,"Placed on suspense file",4,0,0,3,7
1586977,1176527,2022-03-23,Assembly,"Do pass as amended and be re-referred to the Committee on [Appropriations]",7,0,0,0,7
1586977,1184628,2022-04-06,Assembly,"Do pass. To Consent Calendar",13,0,0,3,16
1586977,1191278,2022-04-21,Assembly,"AB 1893 Cunningham Consent Calendar Second Day Regular Session",68,0,0,9,77
1586977,1211912,2022-06-01,Senate,"Do pass, but first be re-referred to the Committee on [Appropriations] with the recommendation: To Consent Calendar",6,0,0,1,7
1586977,1219499,2022-06-27,Senate,"Consent Calendar AB1893",37,0,0,3,40
1586978,1193241,2022-04-26,Assembly,"Do pass as amended and be re-referred to the Committee on [Appropriations]",15,0,0,3,18
1586978,1205839,2022-05-18,Assembly,"Do pass",14,0,0,2,16
1586978,1210521,2022-05-25,Assembly,"AB 1894 Luz Rivas Assembly Third Reading",76,0,0,2,78
1586978,1219523,2022-06-27,Senate,"Do pass as amended, but first amend, and re-refer to the Committee on [Appropriations]",14,0,0,0,14
1586978,1225207,2022-08-29,Senate,"Assembly 3rd Reading AB1894 Luz Rivas et al. By Newman",40,0,0,0,40
1586978,1225208,2022-08-30,Assembly,"AB 1894 Luz Rivas Concurrence in Senate Amendments",78,0,0,2,80
1586979,1195739,2022-04-27,Assembly,"Do pass as amended and be re-referred to the Committee on [Appropriations]",7,0,0,0,7
1586980,1189823,2022-04-19,Assembly,"Do pass as amended, and be re-referred to the Committee on [Appropriations] with recommendation: To Consent Calendar",13,0,0,2,15
1586980,1206940,2022-05-19,Assembly,"Do pass",16,0,0,0,16
1586980,1210606,2022-05-25,Assembly,"AB 1896 Quirk Assembly Third Reading",75,1,0,2,78
1586980,1218674,2022-06-22,Senate,"Do pass, but first be re-referred to the Committee on [Appropriations]",9,0,0,2,11
1586980,1222788,2022-08-01,Senate,"Placed on suspense file",7,0,0,0,7
1586980,1223414,2022-08-11,Senate,"Do pass",7,0,0,0,7
1586980,1225852,2022-08-31,Senate,"Special Consent AB1896",40,0,0,0,40
1586980,1225853,2022-08-31,Assembly,"AB 1896 Quirk Concurrence in Senate Amendments",77,1,0,2,80
1586981,1189314,2022-04-18,Assembly,"Do pass as amended and be re-referred to the Committee on [Judiciary]",8,2,0,1,11
1586981,1193377,2022-04-26,Assembly,"Do pass as amended and be re-referred to the Committee on [Appropriations]",7,2,0,1,10
1586981,1206847,2022-05-19,Assembly,"Do pass",12,4,0,0,16
1586981,1210244,2022-05-26,Assembly,"AB 1897 Wicks Assembly Third Reading",41,25,0,12,78
1586981,1217873,2022-06-22,Senate,"Do pass as amended, but first amend, and re-refer to the Committee on [Judiciary]",5,1,0,1,7
1586981,1220755,2022-06-28,Senate,"Do pass, but first be re-referred to the Committee on [Appropriations]",9,1,0,1,11
1586981,1222656,2022-08-01,Senate,"Placed on suspense file",7,0,0,0,7
1586981,1224045,2022-08-11,Senate,"Do pass as amended",5,2,0,0,7
1586981,1225160,2022-08-30,Senate,"Do pass, but first be re-referred to the Committee on [Appropriations]",7,0,0,0,7
1586981,1225161,2022-08-30,Senate,"Do pass",7,0,0,0,7
1586981,1225615,2022-08-31,Senate,"Assembly 3rd Reading AB1897 Boerner Horvath et a By Allen",40,0,0,0,40
1586983,1170588,2022-03-15,Assembly,"Do pass as amended, and be re-referred to the Committee on [Appropriations] with recommendation: To Consent Calendar",6,0,0,0,6
1586983,1206699,2022-05-19,Assembly,"Do pass",16,0,0,0,16
1586983,1210412,2022-05-25,Assembly,"AB 1899 Mathis Assembly Third Reading",76,0,0,2,78
1586983,1217390,2022-06-21,Senate,"Do pass, but first be re-referred to the Committee on [Appropriations] with the recommendation: To Consent Calendar",4,0,0,1,5
1586983,1222906,2022-08-01,Senate,"Placed on suspense file",7,0,0,0,7
1586983,1223768,2022-08-11,Senate,"Do pass",7,0,0,0,7
1586983,1224533,2022-08-23,Senate,"Special Consent AB1899",40,0,0,0,40
1586984,1174514,2022-03-22,Assembly,"Do pass and be re-referred to the Committee on [Appropriations]",12,0,0,2,14
1586984,1206791,2022-05-19,Assembly,"Do pass",15,0,0,1,16
1586984,1210497,2022-05-25,Assembly,"AB 1900 Arambula Assembly Third Reading",74,0,0,4,78
1586984,1216347,2022-06-15,Senate,"Do pass as amended, but first amend, and re-refer to the Committee on [Appropriations] with the recommendation: To Consent Calendar",9,0,0,2,11
1586984,1219476,2022-06-27,Senate,"Placed on suspense file",6,0,0,1,7
1586985,1189976,2022-04-19,Assembly,"Do pass as amended and be re-referred to the Committee on [Judiciary]",13,5,0,1,19
1586985,1200654,2022-05-05,Assembly,"AB 1901 Nazarian Assembly Third Reading",50,11,0,17,78
1586985,1217482,2022-06-20,Senate,"Do pass, but first be re-referred to the Committee on [Judiciary]",9,3,0,2,14
1586985,1220659,2022-06-28,Senate,"Do pass as amended",9,1,0,1,11
1586985,1224837,2022-08-24,Senate,"Assembly 3rd Reading AB1901 Nazarian By Newman",31,6,0,3,40
1586985,1224902,2022-08-25,Assembly,"AB 1901 Nazarian Concurrence in Senate Amendments",57,14,0,9,80
1586986,1190510,2022-04-20,Assembly,"Do pass and be re-referred to the Committee on [Appropriations] with recommendation: To Consent Calendar",8,0,0,0,8
1586986,1205852,2022-05-18,Assembly,"Do pass. To Consent Calendar",15,0,0,1,16
1586986,1210642,2022-05-25,Assembly,"AB 1902 Aguiar-Curry Consent Calendar Second Day Regular Session",73,0,0,5,78
1586986,1216341,2022-06-15,Senate,"Do pass, but first be re-referred to the Committee on [Natural Resources and Water]",5,0,0,0,5
1586986,1219881,2022-06-28,Senate,"Do pass as amended, but first amend, and re-refer to the Committee on [Appropriations]",9,0,0,0,9
1586986,1224168,2022-08-18,Senate,"Assembly 3rd Reading AB1902 Aguiar-Curry By Jones",38,0,0,2,40
1586986,1224392,2022-08-22,Assembly,"AB 1902 Aguiar-Curry Concurrence in Senate Amendments",76,0,0,4,80
1586988,1179482,2022-03-28,Assembly,"Do pass and be re-referred to the Committee on [Privacy and Consumer Protection]",8,0,0,4,12
1586988,1189947,2022-04-19,Assembly,"Do pass as amended and be re-referred to the Committee on [Appropriations]",8,0,0,3,11
1586988,1206720,2022-05-19,Assembly,"Do pass as amended",12,0,0,4,16
1586988,1210527,2022-05-26,Assembly,"AB 1904 Grayson Assembly Third Reading",63,0,0,15,78
1586988,1218048,2022-06-21,Senate,"Do pass, but first be re-referred to the Committee on [Appropriations]",10,0,0,1,11
1586988,1222914,2022-08-01,Senate,"Placed on suspense file",7,0,0,0,7
1586988,1223451,2022-08-11,Senate,"Do pass as amended",7,0,0,0,7
1586988,1224683,2022-08-24,Senate,"Assembly 3rd Reading AB1904 Grayson et al. By Durazo",38,0,0,2,40
1586988,1225018,2022-08-25,Assembly,"AB 1904 Grayson Concurrence in Senate Amendments",67,0,0,13,80
1586990,1174524,2022-03-22,Assembly,"Do pass and be re-referred to the Committee on [Judiciary] with recommendation: To Consent Calendar",15,0,0,0,15
1586990,1179231,2022-03-29,Assembly,"Do pass and be re-referred to the Committee on [Appropriations] with recommendation: To Consent Calendar",10,0,0,0,10
1586990,1194344,2022-04-27,Assembly,"Do pass. To Consent Calendar",15,0,0,1,16
1586990,1200655,2022-05-05,Assembly,"AB 1906 Stone Consent Calendar Second Day Regular Session",61,0,0,17,78
1586990,1211911,2022-06-01,Senate,"Do pass, but first be re-referred to the Committee on [Judiciary] with the recommendation: To Consent Calendar",8,0,0,1,9
1586990,1215042,2022-06-08,Senate,"Do pass, but first be re-referred to the Committee on [Appropriations] with the recommendation: To Consent Calendar",9,0,0,2,11
1586990,1217068,2022-06-20,Senate,"Placed on suspense file",4,0,0,3,7
1586990,1223360,2022-08-11,Senate,"Do pass",7,0,0,0,7
1586990,1224545,2022-08-23,Senate,"Special Consent AB1906 Stone By Laird Urgency Clause",40,0,0,0,40
1586990,1224820,2022-08-24,Assembly,"AB 1906 Stone Concurrence in Senate Amendments",75,0,0,5,80
1586991,1174466,2022-03-22,Assembly,"Do pass and be re-referred to the Committee on [Appropriations] with recommendation: To Consent Calendar",14,0,0,0,14
1586991,1184694,2022-04-06,Assembly,"Do pass. To Consent Calendar",13,0,0,3,16
1586991,1191264,2022-04-21,Assembly,"AB 1907 Bauer-Kahan Consent Calendar Second Day Regular Session",68,0,0,9,77
1586991,1211898,2022-06-01,Senate,"Do pass, but first be re-referred to the Committee on [Appropriations] with the recommendation: To Consent Calendar",9,0,0,2,11
1586991,1224124,2022-08-17,Senate,"Assembly 3rd Reading AB1907 Bauer-Kahan By Rubio",38,0,0,2,40
1586991,1224125,2022-08-17,Senate,"Assembly 3rd Reading AB1907 Bauer-Kahan By Rubio",37,0,0,3,40
1586991,1224490,2022-08-23,Senate,"Assembly 3rd Reading AB1907 Bauer-Kahan By Rubio",40,0,0,0,40
1586991,1224678,2022-08-24,Assembly,"AB 1907 Bauer-Kahan Concurrence in Senate Amendments",75,0,0,5,80
1586993,1181253,2022-03-28,Assembly,"Do pass and be re-referred to the Committee on [Appropriations]",11,2,0,2,15
1586993,1194239,2022-04-27,Assembly,"Do pass",11,4,0,1,16
1586993,1198233,2022-05-02,Assembly,"AB 1909 Friedman Assembly Third Reading",53,12,0,12,77
1586993,1216291,2022-06-14,Senate,"Do pass, but first be re-referred to the Committee on [Appropriations]",12,1,0,4,17
1586993,1224363,2022-08-22,Senate,"Assembly 3rd Reading AB1909 Friedman et al. By Portantino",32,7,0,1,40
1586993,1224560,2022-08-23,Assembly,"AB 1909 Friedman Concurrence in Senate Amendments",60,15,0,5,80
1586994,1175549,2022-03-23,Assembly,"Do pass and be re-referred to the Committee on [Local Government]",6,2,0,0,8
1586994,1195845,2022-04-27,Assembly,"Do pass and be re-referred to the Committee on [Appropriations]",5,2,0,1,8
1586995,1200494,2022-05-05,Assembly,"Do pass and be re-referred to the Committee on [Appropriations]",11,0,0,0,11
1586996,1191290,2022-04-20,Assembly,"Do pass as amended and be re-referred to the Committee on [Appropriations]",7,0,0,0,7
1586996,1207004,2022-05-19,Assembly,"Do pass",16,0,0,0,16
1586996,1210259,2022-05-26,Assembly,"AB 1912 Mia Bonta Third Reading Urgency",76,0,0,2,78
1586996,1217899,2022-06-22,Senate,"Do pass, but first be re-referred to the Committee on [Appropriations]",6,0,0,1,7
1586996,1224132,2022-08-17,Senate,"Assembly 3rd Reading AB1912 Mia Bonta et al. By Leyva Urgency Clause",35,0,0,5,40
1586996,1224541,2022-08-23,Assembly,"AB 1912 Mia Bonta Concurrence in Senate Amendments",76,0,0,4,80
1586997,1190692,2022-04-19,Assembly,"Do pass and be re-referred to the Committee on [Appropriations]",11,0,0,1,12
1586997,1206381,2022-05-19,Assembly,"Do pass",16,0,0,0,16
1586997,1210394,2022-05-25,Assembly,"AB 1913 Bryan Assembly Third Reading",72,0,0,6,78
1586997,1216398,2022-06-15,Senate,"Do pass, but first be re-referred to the Committee on [Appropriations]",6,0,0,1,7
1586997,1219495,2022-06-27,Senate,"Placed on suspense file",6,0,0,1,7
1586998,1174478,2022-03-22,Assembly,"Do pass. To Consent Calendar",8,0,0,0,8
1586998,1181273,2022-03-31,Assembly,"AB 1914 Davies Consent Calendar Second Day",68,0,0,8,76
1586998,1215917,2022-06-13,Senate,"Do pass, but first be re-referred to the Committee on [Appropriations]",5,0,0,0,5
1586998,1224160,2022-08-18,Senate,"Assembly 3rd Reading AB1914 Davies By Bates",38,0,0,2,40
1586998,1224537,2022-08-23,Assembly,"AB 1914 Davies Concurrence in Senate Amendments By FLORA",76,0,0,4,80
1587001,1189943,2022-04-19,Assembly,"Do pass and be re-referred to the Committee on [Judiciary]",7,1,0,3,11
1587001,1193293,2022-04-26,Assembly,"Do pass and be re-referred to the Committee on [Appropriations]",7,2,0,1,10
1587001,1206857,2022-05-19,Assembly,"Do pass",12,4,0,0,16
1587001,1210414,2022-05-26,Assembly,"AB 1917 Levine Assembly Third Reading",53,16,0,9,78
1587001,1216370,2022-06-14,Senate,"Do pass, but first be re-referred to the Committee on [Public Safety]",9,2,0,0,11
1587001,1220705,2022-06-28,Senate,"Do pass, but first be re-referred to the Committee on [Appropriations]",4,1,0,0,5
1587001,1222818,2022-08-01,Senate,"Placed on suspense file",7,0,0,0,7
1587002,1193181,2022-04-26,Assembly,"Do pass and be re-referred to the Committee on [Higher Education]",9,3,0,3,15
1587002,1194253,2022-04-26,Assembly,"Do pass and be re-referred to the Committee on [Appropriations]",9,3,0,0,12
1587002,1206883,2022-05-19,Assembly,"Do pass",12,4,0,0,16
1587002,1210504,2022-05-26,Assembly,"AB 1918 Petrie-Norris Assembly Third Reading",56,16,0,6,78
1587002,1221227,2022-06-29,Senate,"Do pass, but first be re-referred to the Committee on [Appropriations]",8,2,0,1,11
1587002,1222909,2022-08-01,Senate,"Placed on suspense file",7,0,0,0,7
1587002,1223353,2022-08-11,Senate,"Do pass as amended",5,1,0,1,7
1587002,1224934,2022-08-25,Senate,"Assembly 3rd Reading AB1918 Petrie-Norris et al. By Becker",31,9,0,0,40
1587002,1224935,2022-08-25,Assembly,"AB 1918 Petrie-Norris Concurrence in Senate Amendments",58,12,0,10,80
1587003,1183658,2022-04-04,Assembly,"Do pass as amended and be re-referred to the Committee on [Appropriations]",14,0,0,1,15
1587003,1206797,2022-05-19,Assembly,"Do pass as amended",12,1,0,3,16
1587003,1210584,2022-05-26,Assembly,"AB 1919 Holden Assembly Third Reading",74,0,0,4,78
1587003,1220735,2022-06-28,Senate,"Do pass, but first be re-referred to the Committee on [Appropriations]",17,0,0,0,17
1587003,1222754,2022-08-01,Senate,"Placed on suspense file",7,0,0,0,7
1587003,1223870,2022-08-11,Senate,"Do pass as amended",7,0,0,0,7
1587003,1224554,2022-08-23,Senate,"Special Consent AB1919",40,0,0,0,40
1587003,1224672,2022-08-24,Assembly,"AB 1919 Holden Concurrence in Senate Amendments",77,0,0,3,80
1587005,1170590,2022-03-15,Assembly,"Do pass and be re-referred to the Committee on [Public Employment and Retirement] with recommendation: To Consent Calendar",6,0,0,0,6
1587005,1190492,2022-04-20,Assembly,"Do pass and be re-referred to the Committee on [Appropriations]",6,0,0,0,6
1587007,1185698,2022-04-06,Assembly,"Do pass as amended, and be re-referred to the Committee on [Appropriations] with recommendation: To Consent Calendar",7,0,0,0,7
1587007,1194485,2022-04-27,Assembly,"Do pass. To Consent Calendar",15,0,0,1,16
1587007,1200656,2022-05-05,Assembly,"AB 1923 Mathis Consent Calendar Second Day Regular Session",61,0,0,17,78
1587007,1214963,2022-06-08,Senate,"Do pass, but first be re-referred to the Committee on [Appropriations] with the recommendation: To Consent Calendar",7,0,0,0,7
1587007,1219451,2022-06-27,Senate,"Consent Calendar AB1923",37,0,0,3,40
1587008,1174485,2022-03-22,Assembly,"Do pass and be re-referred to the Committee on [Appropriations]",5,2,0,0,7
1587008,1206672,2022-05-19,Assembly,"Do pass as amended",12,4,0,0,16
1587008,1210333,2022-05-26,Assembly,"AB 1924 Gipson Assembly Third Reading",48,20,0,10,78
1587008,1220632,2022-06-28,Senate,"Do pass, but first be re-referred to the Committee on [Appropriations]",4,1,0,0,5
1587008,1222636,2022-08-01,Senate,"Placed on suspense file",7,0,0,0,7
1587008,1223996,2022-08-11,Senate,"Do pass",5,2,0,0,7
1587008,1224995,2022-08-25,Senate,"Assembly 3rd Reading AB1924 Gipson By Skinner",30,10,0,0,40
1587009,1195827,2022-04-27,Assembly,"Do pass and be re-referred to the Committee on [Appropriations]",6,2,0,0,8
1587009,1203378,2022-05-11,Assembly,"Do pass",12,4,0,0,16
1587009,1210627,2022-05-25,Assembly,"AB 1925 Santiago Assembly Third Reading",50,20,0,8,78
1587009,1221239,2022-06-29,Senate,"Do pass as amended, but first amend, and re-refer to the Committee on [Appropriations]",4,1,0,0,5
1587009,1224305,2022-08-22,Senate,"Assembly 3rd Reading AB1925 Santiago By Durazo",31,9,0,0,40
1587009,1224495,2022-08-23,Assembly,"AB 1925 Santiago Concurrence in Senate Amendments",56,19,0,5,80
1587010,1174479,2022-03-22,Assembly,"Do pass and be re-referred to the Committee on [Appropriations] with recommendation: To Consent Calendar",9,0,0,0,9
1587010,1184627,2022-04-06,Assembly,"Do pass. To Consent Calendar",13,0,0,3,16
1587010,1191251,2022-04-21,Assembly,"AB 1926 Choi Consent Calendar Second Day Regular Session",68,0,0,9,77
1587010,1210926,2022-05-31,Senate,"Do pass, but first be re-referred to the Committee on [Appropriations] with the recommendation: To Consent Calendar",8,0,0,3,11
1587010,1219434,2022-06-27,Senate,"Placed on suspense file",6,0,0,1,7
1587010,1223431,2022-08-11,Senate,"Do pass",7,0,0,0,7
1587010,1224461,2022-08-23,Senate,"Special Consent AB1926",40,0,0,0,40
1587010,1224670,2022-08-24,Assembly,"AB 1926 Choi Concurrence in Senate Amendments",75,0,0,5,80
1587012,1170616,2022-03-15,Assembly,"Do pass and be re-referred to the Committee on [Health]",4,0,0,2,6
1587012,1179239,2022-03-29,Assembly,"Do pass and be re-referred to the Committee on [Appropriations]",11,0,0,4,15
1587013,1218673,2022-06-23,Assembly,"Be adopted. To Consent Calendar",8,0,0,4,12
1587013,1221554,2022-06-29,Assembly,"ACR 135 Seyarto Consent Calendar Second Day Regular Session",78,0,0,2,80
1587013,1223678,2022-08-11,Senate,"Special Consent ACR135",38,0,0,2,40
1587014,1195878,2022-04-28,Assembly,"Be adopted. To third reading",8,0,0,3,11
1587014,1212438,2022-06-02,Senate,"Special Consent ACR136 Ramos et al",33,0,0,7,40
1587015,1183764,2022-04-05,Assembly,"Be adopted. To third reading",11,0,0,1,12
1587015,1191262,2022-04-21,Assembly,"AJR 26 Medina Assembly Third Reading",70,0,0,7,77
1587015,1211823,2022-06-01,Senate,"Be adopted as amended",7,0,0,0,7
1587015,1224700,2022-08-24,Senate,"Assembly 3rd Reading AJR26 Medina et al. By Leyva",40,0,0,0,40
1587015,1224967,2022-08-25,Assembly,"AJR 26 Medina Concurrence in Senate Amendments",76,0,0,4,80
1587016,1176487,2022-03-24,Senate,"Do pass, but first be re-referred to the Committee on [Appropriations]",7,0,0,2,9
1587016,1189340,2022-04-18,Senate,"Placed on suspense file",7,0,0,0,7
1587016,1206822,2022-05-19,Senate,"Do pass as amended",7,0,0,0,7
1587016,1208511,2022-05-24,Senate,"Senate 3rd Reading SB948 Becker",37,0,0,3,40
1587016,1220781,2022-06-29,Assembly,"Do pass and be re-referred to the Committee on [Appropriations]",8,0,0,0,8
1587016,1223780,2022-08-11,Assembly,"Do pass as amended",12,0,0,4,16
1587016,1224325,2022-08-22,Assembly,"SB 948 Becker Senate Third Reading By Gabriel",77,0,0,3,80
1587016,1224807,2022-08-24,Senate,"Unfinished Business SB948 Becker Concurrence",40,0,0,0,40
1587017,1193438,2022-04-26,Senate,"Do pass, but first be re-referred to the Committee on [Appropriations] with the recommendation: To Consent Calendar",5,0,0,2,7
1587017,1204084,2022-05-12,Senate,"Consent Calendar SB949",35,0,0,5,40
1587017,1215800,2022-06-14,Assembly,"Do pass and be re-referred to the Committee on [Appropriations]",7,0,0,2,9
1587017,1217980,2022-06-22,Assembly,"Do pass. To Consent Calendar",13,0,0,3,16
1587017,1221565,2022-06-29,Assembly,"SB 949 Laird Consent Calendar Second Day Regular Session",78,0,0,2,80
1587018,1190519,2022-04-19,Senate,"Do pass as amended, but first amend, and re-refer to the Committee on [Appropriations] with the recommendation: To Consent Calendar",4,0,0,1,5
1587018,1201362,2022-05-09,Senate,"Placed on suspense file",7,0,0,0,7
1587018,1206651,2022-05-19,Senate,"Do pass",7,0,0,0,7
1587018,1209295,2022-05-25,Senate,"Special Consent SB950",39,0,0,1,40
1587018,1220035,2022-06-28,Assembly,"Do pass and be re-referred to the Committee on [Appropriations]",7,0,0,1,8
1587018,1223729,2022-08-11,Assembly,"Do pass as amended",12,0,0,4,16
1587018,1224657,2022-08-24,Assembly,"SB 950 Archuleta Senate Third Reading By Chen",76,0,0,4,80
1587018,1225903,2022-08-30,Senate,"Special Consent SB950",38,0,0,2,40
1587019,1173483,2022-03-21,Senate,"Do pass, but first be re-referred to the Committee on [Appropriations]",4,1,0,0,5
1587019,1182535,2022-04-04,Senate,"Placed on suspense file",6,0,0,1,7
1587019,1206763,2022-05-19,Senate,"Do pass as amended",5,2,0,0,7
1587019,1208529,2022-05-24,Senate,"Senate 3rd Reading SB951 Durazo et al",28,9,0,3,40
1587019,1217992,2022-06-22,Assembly,"Do pass and be re-referred to the Committee on [Appropriations]",8,3,0,3,14
1587019,1223786,2022-08-11,Assembly,"Do pass as amended",12,4,0,0,16
1587019,1224315,2022-08-22,Assembly,"SB 951 Durazo Senate Third Reading By Cervantes",61,9,0,10,80
1587019,1224812,2022-08-24,Senate,"Unfinished Business SB951 Durazo et al. Concurrence",31,9,0,0,40
1587020,1180231,2022-03-30,Senate,"Do pass, but first be re-referred to the Committee on [Appropriations]",6,0,0,1,7
1587020,1189373,2022-04-18,Senate,"Placed on suspense file",7,0,0,0,7
1587020,1206796,2022-05-19,Senate,"Do pass",6,0,0,1,7
1587020,1207826,2022-05-23,Senate,"Senate 3rd Reading SB952 Lim贸n",36,0,0,4,40
1587020,1216607,2022-06-15,Assembly,"Do pass as amended, and be re-referred to the Committee on [Appropriations] with recommendation: To Consent Calendar",6,0,0,1,7
1587021,1193212,2022-04-26,Senate,"Do pass, but first be re-referred to the Committee on [Appropriations]",5,2,0,2,9
1587021,1201512,2022-05-09,Senate,"Placed on suspense file",7,0,0,0,7
1587022,1173514,2022-03-21,Senate,"Do pass, but first be re-referred to the Committee on [Appropriations]",4,1,0,0,5
1587022,1182509,2022-04-04,Senate,"Placed on suspense file",6,0,0,1,7
1587022,1206733,2022-05-19,Senate,"Do pass",5,2,0,0,7
1587022,1209359,2022-05-25,Senate,"Senate 3rd Reading SB954 Archuleta",30,9,0,1,40
1587022,1216387,2022-06-15,Assembly,"Do pass and be re-referred to the Committee on [Appropriations]",5,1,0,1,7
1587022,1223496,2022-08-11,Assembly,"Do pass as amended",12,4,0,0,16
1587022,1224322,2022-08-22,Assembly,"SB 954 Archuleta Senate Third Reading By Cooper",61,9,0,10,80
1587022,1224898,2022-08-25,Senate,"Unfinished Business SB954 Archuleta Concurrence",31,9,0,0,40
1587023,1184684,2022-04-06,Senate,"Do pass, but first be re-referred to the Committee on [Appropriations]",4,2,0,1,7
1587023,1198263,2022-05-02,Senate,"Placed on suspense file",7,0,0,0,7
1587023,1206277,2022-05-19,Senate,"Do pass",5,2,0,0,7
1587023,1208441,2022-05-24,Senate,"Senate 3rd Reading SB955 Leyva",27,10,0,3,40
1587023,1216619,2022-06-15,Assembly,"Do pass as amended and be re-referred to the Committee on [Appropriations]",4,2,0,1,7
1587023,1223830,2022-08-11,Assembly,"Do pass as amended",12,4,0,0,16
1587023,1224226,2022-08-18,Assembly,"SB 955 Leyva Senate Third Reading By Lee",56,16,0,8,80
1587023,1224324,2022-08-22,Senate,"Unfinished Business SB955 Leyva Concurrence",30,9,0,1,40
1587024,1179198,2022-03-29,Senate,"Do pass and be ordered to the Consent Calendar",11,0,0,0,11
1587024,1185707,2022-04-07,Senate,"Consent Calendar SB956",37,0,0,3,40
1587024,1211829,2022-06-01,Assembly,"Do pass. To Consent Calendar",10,0,0,1,11
1587024,1215271,2022-06-09,Assembly,"SB 956 Wieckowski Consent Calendar Second Day Regular Session",69,0,0,9,78
1587025,1189804,2022-04-18,Senate,"Do pass, but first be re-referred to the Committee on [Judiciary]",4,1,0,0,5
1587025,1189805,2022-04-18,Senate,"[04-19-2022] set for [First] hearing: Reconsideration of favorable vote granted",5,0,0,0,5
1587025,1189806,2022-04-18,Senate,"Do pass, but first be re-referred to the Committee on [Judiciary]",5,0,0,0,5
1587025,1194180,2022-04-26,Senate,"Do pass, but first be re-referred to the Committee on [Appropriations]",8,2,0,1,11
1587025,1201346,2022-05-09,Senate,"Placed on suspense file",7,0,0,0,7
1587025,1206780,2022-05-19,Senate,"Do pass",5,2,0,0,7
1587025,1207864,2022-05-23,Senate,"Senate 3rd Reading SB957 Laird",28,9,0,3,40
1587025,1217919,2022-06-22,Assembly,"Do pass as amended and be re-referred to the Committee on [Appropriations]",5,1,0,1,7
1587025,1222960,2022-08-03,Assembly,"Do pass",11,4,0,1,16
1587025,1223630,2022-08-11,Assembly,"SB 957 Laird Senate Third Reading By Stone",59,15,0,6,80
1587025,1224090,2022-08-15,Senate,"Unfinished Business SB957 Laird Concurrence",27,10,0,3,40
1587026,1185717,2022-04-06,Senate,"Do pass as amended, but first amend, and re-refer to the Committee on [Judiciary]",8,0,0,3,11
1587026,1198245,2022-05-02,Senate,"Placed on suspense file",7,0,0,0,7
1587026,1206404,2022-05-19,Senate,"Do pass",5,2,0,0,7
1587026,1209329,2022-05-25,Senate,"Senate 3rd Reading SB958 Lim贸n et al",30,9,0,1,40
1587027,1189862,2022-04-19,Senate,"Do pass, but first be re-referred to the Committee on [Appropriations]",12,1,0,4,17
1587027,1198271,2022-05-02,Senate,"Placed on suspense file",7,0,0,0,7
1587027,1206520,2022-05-19,Senate,"Do pass",5,1,0,1,7
1587027,1208438,2022-05-24,Senate,"Senate 3rd Reading SB959 Portantino",29,5,0,6,40
1587027,1220876,2022-06-29,Assembly,"Do pass and be re-referred to the Committee on [Appropriations] with recommendation: To Consent Calendar",8,0,0,0,8
1587027,1222961,2022-08-03,Assembly,"Do pass. To Consent Calendar",15,0,0,1,16
1587027,1225075,2022-08-29,Assembly,"Do pass",6,2,0,0,8
1587027,1225746,2022-08-31,Senate,"Unfinished Business SB959 Portantino et al. Concurrence",40,0,0,0,40
1587027,1225747,2022-08-31,Assembly,"SB 959 Portantino Senate Third Reading By Holden",68,9,0,3,80
1587028,1174462,2022-03-22,Senate,"Do pass, but first be re-referred to the Committee on [Appropriations]",4,1,0,0,5
1587028,1195812,2022-04-28,Senate,"Senate 3rd Reading SB960 Skinner",29,8,0,3,40
1587028,1211867,2022-06-01,Assembly,"Do pass and be re-referred to the Committee on [Appropriations]",5,2,0,0,7
1587028,1218041,2022-06-22,Assembly,"Do pass",11,4,0,1,16
1587028,1224084,2022-08-15,Assembly,"SB 960 Skinner Senate Third Reading By Cervantes",45,19,0,16,80
1587028,1224209,2022-08-18,Senate,"Unfinished Business SB960 Skinner et al. Concurrence",28,8,0,4,40
1587030,1189368,2022-04-18,Senate,"Do pass, but first be re-referred to the Committee on [Appropriations]",13,0,0,1,14
1587030,1198244,2022-05-02,Senate,"Placed on suspense file",7,0,0,0,7
1587031,1189807,2022-04-19,Senate,"Do pass, but first be re-referred to the Committee on [Appropriations]",8,0,0,1,9
1587031,1198299,2022-05-02,Senate,"Placed on suspense file",7,0,0,0,7
1587031,1206499,2022-05-19,Senate,"Do pass",7,0,0,0,7
1587031,1209372,2022-05-25,Senate,"Special Consent SB963",39,0,0,1,40
1587031,1216368,2022-06-15,Assembly,"Do pass and be re-referred to the Committee on [Appropriations]",7,0,0,0,7
1587031,1223361,2022-08-11,Assembly,"Do pass",16,0,0,0,16
1587031,1224198,2022-08-18,Assembly,"SB 963 Laird Senate Third Reading By Boerner Horvath",76,0,0,4,80
1587032,1180225,2022-03-30,Senate,"Do pass as amended, but first amend, and re-refer to the Committee on [Education]",11,0,0,0,11
1587032,1194292,2022-04-27,Senate,"Do pass, but first be re-referred to the Committee on [Appropriations]",7,0,0,0,7
1587032,1201518,2022-05-09,Senate,"Placed on suspense file",7,0,0,0,7
1587032,1206248,2022-05-19,Senate,"Do pass as amended",6,0,0,1,7
1587032,1208501,2022-05-24,Senate,"Senate 3rd Reading SB964 Wiener et al",37,0,0,3,40
1587032,1215794,2022-06-14,Assembly,"Do pass and be re-referred to the Committee on [Higher Education]",13,0,0,2,15
1587032,1217339,2022-06-21,Assembly,"Do pass as amended and be re-referred to the Committee on [Appropriations]",12,0,0,0,12
1587032,1223785,2022-08-11,Assembly,"Do pass as amended",12,0,0,4,16
1587032,1224206,2022-08-18,Assembly,"SB 964 Wiener Senate Third Reading By Waldron",76,0,0,4,80
1587032,1224263,2022-08-22,Senate,"Unfinished Business SB964 Wiener et al. Concurrence",40,0,0,0,40
1587033,1194316,2022-04-26,Senate,"Do pass as amended",11,0,0,0,11
1587033,1201388,2022-05-09,Senate,"Senate 3rd Reading SB965 Eggman",33,0,0,7,40
1587034,1175556,2022-03-23,Senate,"Do pass, but first be re-referred to the Committee on [Appropriations] with the recommendation: To Consent Calendar",11,0,0,0,11
1587034,1189347,2022-04-18,Senate,"Placed on suspense file",7,0,0,0,7
1587034,1206491,2022-05-19,Senate,"Do pass",7,0,0,0,7
1587034,1209348,2022-05-25,Senate,"Special Consent SB966",39,0,0,1,40
1587034,1215932,2022-06-14,Assembly,"Do pass and be re-referred to the Committee on [Appropriations] with recommendation: To Consent Calendar",13,0,0,2,15
1587034,1224020,2022-08-11,Assembly,"Do pass",16,0,0,0,16
1587034,1225618,2022-08-31,Senate,"Unfinished Business SB966 Lim贸n et al. Concurrence",39,0,0,1,40
1587034,1225619,2022-08-31,Assembly,"SB 966 Lim贸n Senate Third Reading By Salas",80,0,0,0,80
1587035,1150935,2022-02-22,Senate,"Senate 3rd Reading SCR66 Dodd et al",37,0,0,3,40
1587035,1154486,2022-02-24,Assembly,"Be adopted. To Consent Calendar",9,0,0,2,11
1587035,1162284,2022-03-03,Assembly,"SCR 66 Dodd Consent Calendar Second Day Regular Session",70,0,0,6,76
1587036,1164523,2022-03-07,Senate,"Senate 3rd Reading SR66 Lim贸n",37,0,0,3,40
1588092,1183637,2022-04-05,Assembly,"Do pass and be re-referred to the Committee on [Appropriations]",13,0,0,2,15
1588092,1206832,2022-05-19,Assembly,"Do pass",12,3,0,1,16
1588092,1210622,2022-05-25,Assembly,"AB 1929 Gabriel Assembly Third Reading",64,0,0,14,78
1588092,1214973,2022-06-08,Senate,"Do pass, but first be re-referred to the Committee on [Appropriations]",9,0,0,2,11
1588092,1216629,2022-06-16,Senate,"Do pass",6,0,0,1,7
1588092,1223187,2022-08-08,Senate,"Assembly 3rd Reading AB1929 Gabriel et al. By Portantino",33,0,0,7,40
1588092,1223720,2022-08-11,Assembly,"AB 1929 Gabriel Concurrence in Senate Amendments",63,0,0,17,80
1588093,1193224,2022-04-26,Assembly,"Do pass and be re-referred to the Committee on [Appropriations]",13,1,0,1,15
1588093,1206303,2022-05-19,Assembly,"Do pass",13,3,0,0,16
1588093,1210514,2022-05-26,Assembly,"AB 1930 Arambula Assembly Third Reading",66,4,0,8,78
1588093,1216280,2022-06-15,Senate,"Do pass, but first be re-referred to the Committee on [Appropriations]",9,0,0,2,11
1588093,1219385,2022-06-27,Senate,"Placed on suspense file",6,0,0,1,7
1588093,1223844,2022-08-11,Senate,"Do pass as amended",7,0,0,0,7
1588093,1225014,2022-08-25,Senate,"Assembly 3rd Reading AB1930 Arambula By Rubio",40,0,0,0,40
1588093,1225015,2022-08-25,Assembly,"AB 1930 Arambula Concurrence in Senate Amendments",64,5,0,11,80
1588094,1197949,2022-04-26,Assembly,"Do pass and be re-referred to the Committee on [Appropriations]",6,3,0,0,9
1588094,1206419,2022-05-19,Assembly,"Do pass as amended",12,4,0,0,16
1588094,1210547,2022-05-26,Assembly,"AB 1931 Luz Rivas Assembly Third Reading",52,15,0,11,78
1588094,1220610,2022-06-29,Senate,"Do pass as amended, but first amend, and re-refer to the Committee on [Appropriations]",5,0,0,2,7
1588094,1222661,2022-08-01,Senate,"Placed on suspense file",7,0,0,0,7
1588095,1176504,2022-03-23,Assembly,"Do pass",8,0,0,0,8
1588095,1179368,2022-03-28,Assembly,"AB 1932 Daly Assembly Third Reading",57,0,0,19,76
1588095,1211928,2022-06-01,Senate,"Do pass as amended",5,0,0,0,5
1588095,1224256,2022-08-22,Senate,"Assembly 3rd Reading AB1932 Daly By Caballero",32,2,0,6,40
1588095,1224491,2022-08-23,Assembly,"AB 1932 Daly Concurrence in Senate Amendments",73,0,0,7,80
1588096,1190577,2022-04-18,Assembly,"Do pass as amended and be re-referred to the Committee on [Housing and Community Development]",9,0,0,2,11
1588096,1194272,2022-04-27,Assembly,"Do pass and be re-referred to the Committee on [Appropriations]",8,0,0,0,8
1588096,1206593,2022-05-19,Assembly,"Do pass as amended",12,0,0,4,16
1588096,1210573,2022-05-26,Assembly,"AB 1933 Friedman Assembly Third Reading",76,0,0,2,78
1588096,1217870,2022-06-22,Senate,"Do pass as amended, but first amend, and re-refer to the Committee on [Appropriations]",5,0,0,0,5
1588096,1222921,2022-08-01,Senate,"Placed on suspense file",7,0,0,0,7
1588096,1223908,2022-08-11,Senate,"Do pass",7,0,0,0,7
1588096,1224572,2022-08-23,Senate,"Special Consent AB1933",40,0,0,0,40
1588096,1224640,2022-08-24,Assembly,"AB 1933 Friedman Concurrence in Senate Amendments",76,0,0,4,80
1588097,1182558,2022-04-04,Assembly,"Do pass and be re-referred to the Committee on [Communications and Conveyance] with recommendation: To Consent Calendar",7,0,0,0,7
1588097,1194386,2022-04-27,Assembly,"Do pass as amended, and be re-referred to the Committee on [Appropriations] with recommendation: To Consent Calendar",13,0,0,0,13
1588098,1192182,2022-04-25,Assembly,"Do pass and be re-referred to the Committee on [Appropriations] with recommendation: To Consent Calendar",10,0,0,1,11
1588098,1203356,2022-05-11,Assembly,"Do pass",14,0,0,2,16
1588098,1210633,2022-05-25,Assembly,"AB 1935 Grayson Assembly Third Reading",76,0,0,2,78
1588099,1194109,2022-04-26,Assembly,"Do pass and be re-referred to the Committee on [Appropriations]",12,0,0,0,12
1588099,1206813,2022-05-19,Assembly,"Do pass as amended",12,0,0,4,16
1588099,1210510,2022-05-26,Assembly,"AB 1936 Ramos Assembly Third Reading",75,0,0,3,78
1588099,1221238,2022-06-30,Senate,"Do pass, but first be re-referred to the Committee on [Appropriations]",6,0,0,1,7
1588099,1223264,2022-08-08,Senate,"Placed on suspense file",7,0,0,0,7
1588099,1223667,2022-08-11,Senate,"Do pass as amended",7,0,0,0,7
1588099,1224887,2022-08-25,Senate,"Assembly 3rd Reading AB1936 Ramos et al. By Umberg",38,0,0,2,40
1588099,1224888,2022-08-25,Assembly,"AB 1936 Ramos Concurrence in Senate Amendments",75,0,0,5,80
1588101,1183742,2022-04-04,Assembly,"Do pass and be re-referred to the Committee on [Appropriations]",13,0,0,2,15
1588101,1206290,2022-05-19,Assembly,"Do pass",16,0,0,0,16
1588101,1210610,2022-05-25,Assembly,"AB 1938 Friedman Assembly Third Reading",68,0,0,10,78
1588101,1220738,2022-06-28,Senate,"Do pass as amended, but first amend, and re-refer to the Committee on [Appropriations]",15,1,0,1,17
1588101,1225174,2022-08-30,Assembly,"With recommendation: That Senate amendments be concurred in",11,0,0,4,15
1588101,1225996,2022-08-29,Senate,"Assembly 3rd Reading AB1938 Friedman et al. By Rubio",32,0,0,8,40
1588101,1225997,2022-08-31,Assembly,"AB 1938 Friedman Concurrence in Senate Amendments",80,0,0,0,80
1588102,1185724,2022-04-06,Assembly,"Do pass as amended and be re-referred to the Committee on [Appropriations]",6,0,0,1,7
1588102,1194436,2022-04-27,Assembly,"Do pass",12,1,0,3,16
1588102,1200657,2022-05-05,Assembly,"AB 1939 Luz Rivas Assembly Third Reading",55,0,0,23,78
1588103,1193372,2022-04-26,Assembly,"Do pass and be re-referred to the Committee on [Education]",10,2,0,3,15
1588103,1195780,2022-04-27,Assembly,"Do pass and be re-referred to the Committee on [Appropriations]",5,1,0,1,7
1588103,1206321,2022-05-19,Assembly,"Do pass",12,4,0,0,16
1588103,1210478,2022-05-25,Assembly,"AB 1940 Salas Assembly Third Reading",56,10,0,12,78
1588103,1215032,2022-06-08,Senate,"Do pass, but first be re-referred to the Committee on [Education]",7,2,0,2,11
1588103,1221226,2022-06-30,Senate,"Do pass, but first be re-referred to the Committee on [Appropriations]",5,0,0,2,7
1588103,1222716,2022-08-01,Senate,"Placed on suspense file",7,0,0,0,7
1588103,1223715,2022-08-11,Senate,"Do pass as amended",5,1,0,1,7
1588103,1224646,2022-08-24,Senate,"Assembly 3rd Reading AB1940 Salas By Hurtado",31,9,0,0,40
1588103,1224952,2022-08-25,Assembly,"AB 1940 Salas Concurrence in Senate Amendments",59,11,0,10,80
1588104,1193179,2022-04-26,Assembly,"Do pass as amended and be re-referred to the Committee on [Appropriations]",6,0,0,2,8
1588105,1183649,2022-04-05,Assembly,"Do pass and be re-referred to the Committee on [Appropriations]",11,0,0,1,12
1588105,1206256,2022-05-19,Assembly,"Do pass",16,0,0,0,16
1588105,1210283,2022-05-25,Assembly,"AB 1942 Muratsuchi Assembly Third Reading",76,0,0,2,78
1588105,1218018,2022-06-22,Senate,"Do pass as amended, but first amend, and re-refer to the Committee on [Appropriations]",6,0,0,1,7
1588105,1222826,2022-08-01,Senate,"Placed on suspense file",7,0,0,0,7
1588105,1223809,2022-08-11,Senate,"Do pass",7,0,0,0,7
1588105,1225335,2022-08-31,Senate,"Special Consent AB1942",40,0,0,0,40
1588105,1225336,2022-08-31,Assembly,"AB 1942 Muratsuchi Concurrence in Senate Amendments",78,0,0,2,80
1588107,1199941,2022-05-04,Assembly,"Do pass",5,2,0,1,8
1588107,1210397,2022-05-26,Assembly,"AB 1944 Lee Assembly Third Reading",44,12,0,22,78
1588108,1175539,2022-03-23,Assembly,"Do pass and be re-referred to the Committee on [Appropriations]",8,0,0,0,8
1588109,1174486,2022-03-21,Assembly,"Do pass and be re-referred to the Committee on [Appropriations]",15,0,0,0,15
1588109,1184667,2022-04-06,Assembly,"Do pass. To Consent Calendar",13,0,0,3,16
1588109,1191315,2022-04-21,Assembly,"AB 1946 Boerner Horvath Consent Calendar Second Day Regular Session",68,0,0,9,77
1588109,1216322,2022-06-14,Senate,"Do pass, but first be re-referred to the Committee on [Appropriations] with the recommendation: To Consent Calendar",15,0,0,2,17
1588109,1221356,2022-06-30,Senate,"Consent Calendar AB1946",37,0,0,3,40
1588109,1222623,2022-08-01,Assembly,"AB 1946 Boerner Horvath Concurrence in Senate Amendments",73,0,0,7,80
1588110,1174465,2022-03-22,Assembly,"Do pass as amended and be re-referred to the Committee on [Appropriations]",7,0,0,0,7
1588110,1206978,2022-05-19,Assembly,"Do pass as amended",12,0,0,4,16
1588110,1210516,2022-05-26,Assembly,"AB 1947 Ting Assembly Third Reading",74,0,0,4,78
1588110,1217350,2022-06-21,Senate,"Do pass, but first be re-referred to the Committee on [Appropriations]",4,0,0,1,5
1588110,1222763,2022-08-01,Senate,"Placed on suspense file",7,0,0,0,7
1588110,1223509,2022-08-11,Senate,"Do pass as amended",7,0,0,0,7
1588111,1195804,2022-04-27,Assembly,"Do pass as amended and be re-referred to the Committee on [Appropriations]",7,0,0,0,7
1588111,1206524,2022-05-19,Assembly,"Do pass",16,0,0,0,16
1588111,1210615,2022-05-25,Assembly,"AB 1948 Ting Assembly Third Reading",76,0,0,2,78
1588112,1171435,2022-03-16,Assembly,"Do pass and be re-referred to the Committee on [Judiciary]",6,1,0,0,7
1588112,1179189,2022-03-29,Assembly,"Do pass as amended and be re-referred to the Committee on [Appropriations]",9,0,0,1,10
1588112,1206638,2022-05-19,Assembly,"Do pass",13,3,0,0,16
1588112,1210548,2022-05-26,Assembly,"AB 1949 Low Assembly Third Reading",59,9,0,10,78
1588112,1217859,2022-06-21,Senate,"Do pass, but first be re-referred to the Committee on [Labor, Public Employment and Retirement ]",9,1,0,1,11
1588112,1220614,2022-06-29,Senate,"Do pass as amended, but first amend, and re-refer to the Committee on [Appropriations]",4,0,0,1,5
1588112,1222664,2022-08-01,Senate,"Placed on suspense file",7,0,0,0,7
1588112,1223447,2022-08-11,Senate,"Do pass",5,2,0,0,7
1588112,1225218,2022-08-29,Senate,"Assembly 3rd Reading AB1949 Low By Caballero",34,0,0,6,40
1588112,1225219,2022-08-30,Assembly,"AB 1949 Low Concurrence in Senate Amendments",64,9,0,7,80
1588114,1200529,2022-05-05,Assembly,"Do pass and be re-referred to the Committee on [Appropriations]",11,0,0,0,11
1588114,1206703,2022-05-19,Assembly,"Do pass as amended",12,0,0,4,16
1588114,1210393,2022-05-25,Assembly,"AB 1951 Grayson Assembly Third Reading",74,0,0,4,78
1588114,1221243,2022-06-29,Senate,"Do pass as amended, but first amend, and re-refer to the Committee on [Appropriations]",5,0,0,0,5
1588114,1223293,2022-08-08,Senate,"Placed on suspense file",7,0,0,0,7
1588114,1223684,2022-08-11,Senate,"Do pass",7,0,0,0,7
1588114,1224975,2022-08-25,Senate,"Assembly 3rd Reading AB1951 Grayson et al. By Hertzberg",31,3,0,6,40
1588114,1224976,2022-08-25,Assembly,"AB 1951 Grayson Concurrence in Senate Amendments",69,0,0,11,80
1588116,1186486,2022-04-05,Assembly,"Do pass and be re-referred to the Committee on [Appropriations]",7,1,0,1,9
1588117,1189993,2022-04-19,Assembly,"Do pass as amended and be re-referred to the Committee on [Appropriations]",18,0,0,1,19
1588117,1203393,2022-05-11,Assembly,"Do pass",16,0,0,0,16
1588117,1210646,2022-05-25,Assembly,"AB 1954 Quirk Assembly Third Reading",76,0,0,2,78
1588117,1215893,2022-06-13,Senate,"Do pass, but first be re-referred to the Committee on [Appropriations]",13,0,0,1,14
1588117,1224142,2022-08-17,Senate,"Assembly 3rd Reading AB1954 Quirk By Eggman",38,0,0,2,40
1588118,1179248,2022-03-29,Assembly,"Do pass and be re-referred to the Committee on [Appropriations]",2,5,0,0,7
1588118,1193246,2022-04-26,Assembly,"Do pass and be re-referred to the Committee on [Appropriations]",2,5,0,0,7
1588119,1179553,2022-03-21,Assembly,"Do pass as amended and be re-referred to the Committee on [Appropriations]",10,1,0,0,11
1588120,1193292,2022-04-26,Assembly,"Do pass as amended, and be re-referred to the Committee on [Appropriations] with recommendation: To Consent Calendar",7,0,0,1,8
1588120,1206827,2022-05-19,Assembly,"Do pass",16,0,0,0,16
1588120,1210329,2022-05-26,Assembly,"AB 1957 Wilson Assembly Third Reading",76,0,0,2,78
1588120,1219955,2022-06-27,Senate,"Do pass, but first be re-referred to the Committee on [Appropriations]",5,0,0,0,5
1588120,1223209,2022-08-08,Senate,"Placed on suspense file",7,0,0,0,7
1588120,1223660,2022-08-11,Senate,"Do pass",7,0,0,0,7
1588120,1224598,2022-08-23,Senate,"Special Consent AB1957",40,0,0,0,40
1588120,1224685,2022-08-24,Assembly,"AB 1957 Wilson Concurrence in Senate Amendments",72,0,0,8,80
1588121,1190630,2022-04-19,Assembly,"Do pass as amended and be re-referred to the Committee on [Appropriations]",11,0,0,1,12
1588121,1206620,2022-05-19,Assembly,"Do pass",16,0,0,0,16
1588121,1210588,2022-05-25,Assembly,"AB 1958 Mike Fong Assembly Third Reading",76,0,0,2,78
1588121,1221216,2022-06-30,Senate,"Do pass as amended, but first amend, and re-refer to the Committee on [Appropriations]",6,0,0,1,7
1588121,1223286,2022-08-08,Senate,"Placed on suspense file",7,0,0,0,7
1588121,1223843,2022-08-11,Senate,"Do pass",5,1,0,1,7
1588121,1224989,2022-08-25,Senate,"Assembly 3rd Reading AB1958 Mike Fong By Pan",33,4,0,3,40
1588121,1224990,2022-08-25,Assembly,"AB 1958 Mike Fong Concurrence in Senate Amendments",74,0,0,6,80
1588122,1194357,2022-04-27,Assembly,"Do pass and be re-referred to the Committee on [Appropriations] with recommendation: To Consent Calendar",10,0,0,1,11
1588122,1206283,2022-05-19,Assembly,"Do pass as amended",12,0,0,4,16
1588122,1210276,2022-05-26,Assembly,"AB 1959 AGRI. Assembly Third Reading By RIVAS, R",75,0,0,3,78
1588122,1217445,2022-06-21,Senate,"Do pass, but first be re-referred to the Committee on [Judiciary] with the recommendation: To Consent Calendar",5,0,0,0,5
1588122,1220775,2022-06-28,Senate,"Do pass, but first be re-referred to the Committee on [Appropriations] with the recommendation: To Consent Calendar",10,0,0,1,11
1588122,1223596,2022-08-11,Senate,"Consent Calendar AB1959 AGRI",38,0,0,2,40
1588122,1224296,2022-08-22,Assembly,"AB 1959 AGRI. Concurrence in Senate Amendments By RIVAS, R",77,0,0,3,80
1588123,1180261,2022-03-30,Assembly,"Do pass. To Consent Calendar",12,0,0,2,14
1588123,1186261,2022-04-07,Assembly,"AB 1960 Villapudua Consent Calendar Second Day Regular Session",65,0,0,12,77
1588123,1210893,2022-05-31,Senate,"Do pass and be ordered to the Consent Calendar",11,0,0,3,14
1588123,1215285,2022-06-09,Senate,"Consent Calendar AB1960 Villapudua",38,0,0,2,40
1588124,1190501,2022-04-20,Assembly,"Do pass as amended and be re-referred to the Committee on [Appropriations]",8,0,0,0,8
1588124,1206550,2022-05-19,Assembly,"Do pass",16,0,0,0,16
1588124,1210391,2022-05-25,Assembly,"AB 1961 Gabriel Assembly Third Reading",76,0,0,2,78
1588124,1217945,2022-06-21,Senate,"Do pass, but first be re-referred to the Committee on [Appropriations] with the recommendation: To Consent Calendar",8,0,0,1,9
1588124,1222645,2022-08-01,Senate,"Placed on suspense file",7,0,0,0,7
1588126,1183790,2022-04-05,Assembly,"Do pass and be re-referred to the Committee on [Appropriations]",9,0,0,3,12
1588126,1194335,2022-04-27,Assembly,"Do pass",11,0,0,5,16
1588126,1200658,2022-05-05,Assembly,"AB 1963 Salas Assembly Third Reading",51,0,0,27,78
1588126,1214996,2022-06-08,Senate,"Do pass as amended, but first amend, and re-refer to the Committee on [Health]",7,0,0,0,7
1588126,1221296,2022-06-29,Senate,"Do pass, but first be re-referred to the Committee on [Appropriations] with the recommendation: To Consent Calendar",10,0,0,1,11
1588126,1223205,2022-08-08,Senate,"Consent Calendar AB1963",36,0,0,4,40
1588126,1223732,2022-08-11,Assembly,"AB 1963 Salas Concurrence in Senate Amendments",72,0,0,8,80
1588128,1174564,2022-03-22,Assembly,"Do pass and be re-referred to the Committee on [Appropriations]",8,0,0,0,8
1588128,1206561,2022-05-19,Assembly,"Do pass as amended",14,2,0,0,16
1588128,1210324,2022-05-26,Assembly,"AB 1965 Wicks Assembly Third Reading",63,3,0,12,78
1588128,1219985,2022-06-27,Senate,"Do pass, but first be re-referred to the Committee on [Appropriations]",4,0,0,1,5
1588128,1222687,2022-08-01,Senate,"Placed on suspense file",7,0,0,0,7
1588128,1223978,2022-08-11,Senate,"Do pass",5,0,0,2,7
1588128,1225837,2022-08-29,Senate,"Assembly 3rd Reading AB1965 Wicks et al. By Skinner",31,6,0,3,40
1588128,1225838,2022-08-30,Assembly,"AB 1965 Wicks Concurrence in Senate Amendments",67,2,0,11,80
1588128,1229732,2022-08-30,Senate,"Assembly 3rd Reading AB1965 Wicks et al. By Skinner",31,6,0,3,40
1588131,1170644,2022-03-15,Assembly,"Do pass as amended and be re-referred to the Committee on [Appropriations]",11,0,0,1,12
1588131,1180229,2022-03-30,Assembly,"Do pass. To Consent Calendar",12,0,0,3,15
1588131,1186262,2022-04-07,Assembly,"AB 1968 Seyarto Consent Calendar Second Day Regular Session",65,0,0,12,77
1588131,1215053,2022-06-08,Senate,"Do pass, but first be re-referred to the Committee on [Appropriations] with the recommendation: To Consent Calendar",7,0,0,0,7
1588131,1219470,2022-06-27,Senate,"Consent Calendar AB1968",37,0,0,3,40
1588134,1190654,2022-04-20,Assembly,"Do pass",4,0,0,2,6
1588134,1210625,2022-05-25,Assembly,"AB 1971 Cooper Assembly Third Reading",62,0,0,16,78
1588134,1220604,2022-06-29,Senate,"Do pass as amended, and be ordered to the Consent Calendar",5,0,0,0,5
1588134,1223252,2022-08-08,Senate,"Consent Calendar AB1971",36,0,0,4,40
1588134,1224277,2022-08-22,Assembly,"AB 1971 Cooper Concurrence in Senate Amendments",68,0,0,12,80
1588135,1170583,2022-03-15,Assembly,"Do pass as amended and be re-referred to the Committee on [Appropriations]",4,2,0,0,6
1588135,1206377,2022-05-19,Assembly,"Do pass as amended",12,4,0,0,16
1588135,1210284,2022-05-26,Assembly,"AB 1972 Ward Assembly Third Reading",53,17,0,8,78
1588135,1217480,2022-06-21,Senate,"Do pass, but first be re-referred to the Committee on [Judiciary]",4,0,0,1,5
1588135,1220825,2022-06-28,Senate,"Do pass, but first be re-referred to the Committee on [Appropriations]",8,1,0,2,11
1588135,1222733,2022-08-01,Senate,"Placed on suspense file",7,0,0,0,7
1588136,1195842,2022-04-27,Assembly,"Do pass as amended and be re-referred to the Committee on [Appropriations]",5,2,0,0,7
1588136,1203320,2022-05-11,Assembly,"Do pass",12,4,0,0,16
1588136,1204619,2022-05-16,Assembly,"AB 1973 McCarty Assembly Third Reading",51,13,0,14,78
1588136,1220703,2022-06-29,Senate,"Do pass as amended, but first amend, and re-refer to the Committee on [Appropriations]",4,1,0,2,7
1588136,1222872,2022-08-01,Senate,"Placed on suspense file",7,0,0,0,7
1588136,1223366,2022-08-11,Senate,"Do pass",5,2,0,0,7
1588136,1225365,2022-08-29,Senate,"Assembly 3rd Reading AB1973 McCarty By Rubio",29,9,0,2,40
1588136,1225366,2022-08-30,Assembly,"AB 1973 McCarty Concurrence in Senate Amendments",60,15,0,5,80
1588137,1189961,2022-04-19,Assembly,"Do pass and be re-referred to the Committee on [Appropriations] with recommendation: To Consent Calendar",7,0,0,0,7
1588137,1199988,2022-05-04,Assembly,"Do pass. To Consent Calendar",14,0,0,2,16
1588137,1204118,2022-05-12,Assembly,"AB 1974 Chen Consent Calendar Second Day Regular Session",65,0,0,13,78
1588137,1215921,2022-06-14,Senate,"Do pass as amended, but first amend, and re-refer to the Committee on [Appropriations]",5,0,0,0,5
1588137,1224268,2022-08-22,Senate,"Assembly 3rd Reading AB1974 Chen By Bates",40,0,0,0,40
1588137,1224561,2022-08-23,Assembly,"AB 1974 Chen Concurrence in Senate Amendments",74,0,0,6,80
1588138,1195711,2022-04-27,Assembly,"Do pass and be re-referred to the Committee on [Appropriations] with recommendation: To Consent Calendar",8,0,0,0,8
1588140,1179227,2022-03-29,Assembly,"Do pass and be re-referred to the Committee on [Appropriations] with recommendation: To Consent Calendar",7,0,0,0,7
1588141,1194112,2022-04-27,Assembly,"Do pass as amended and be re-referred to the Committee on [Appropriations]",7,0,0,1,8
1588141,1206725,2022-05-19,Assembly,"Do pass",16,0,0,0,16
1588141,1207806,2022-05-23,Assembly,"AB 1978 Ward Assembly Third Reading",74,0,0,4,78
1588141,1217951,2022-06-21,Senate,"Do pass, but first be re-referred to the Committee on [Appropriations] with the recommendation: To Consent Calendar",8,0,0,1,9
1588141,1222785,2022-08-01,Senate,"Placed on suspense file",7,0,0,0,7
1588141,1223423,2022-08-11,Senate,"Do pass as amended",7,0,0,0,7
1588141,1224526,2022-08-23,Senate,"Special Consent AB1978",40,0,0,0,40
1588141,1224702,2022-08-24,Assembly,"AB 1978 Ward Concurrence in Senate Amendments",76,0,0,4,80
1588144,1174475,2022-03-22,Assembly,"Do pass and be re-referred to the Committee on [Appropriations] with recommendation: To Consent Calendar",9,0,0,0,9
1588144,1206464,2022-05-19,Assembly,"Do pass as amended",12,0,0,4,16
1588144,1210349,2022-05-26,Assembly,"AB 1981 Lee Assembly Third Reading",75,0,0,3,78
1588144,1218043,2022-06-21,Senate,"Do pass, but first be re-referred to the Committee on [Appropriations] with the recommendation: To Consent Calendar",11,0,0,0,11
1588144,1222856,2022-08-01,Senate,"Placed on suspense file",7,0,0,0,7
1588144,1223858,2022-08-11,Senate,"Do pass",7,0,0,0,7
1588144,1224434,2022-08-23,Senate,"Special Consent AB1981",40,0,0,0,40
1588145,1183800,2022-04-05,Assembly,"Do pass as amended and be re-referred to the Committee on [Appropriations]",13,0,0,2,15
1588145,1207017,2022-05-19,Assembly,"Do pass",16,0,0,0,16
1588145,1210263,2022-05-25,Assembly,"AB 1982 Santiago Assembly Third Reading",75,0,0,3,78
1588145,1221273,2022-06-29,Senate,"Do pass as amended, but first amend, and re-refer to the Committee on [Appropriations] with the recommendation: To Consent Calendar",10,0,0,1,11
1588145,1223146,2022-08-08,Senate,"Placed on suspense file",7,0,0,0,7
1588145,1223605,2022-08-11,Senate,"Do pass",7,0,0,0,7
1588145,1225277,2022-08-31,Senate,"Special Consent AB1982",40,0,0,0,40
1588145,1225278,2022-08-31,Assembly,"AB 1982 Santiago Concurrence in Senate Amendments",78,0,0,2,80
1588146,1194398,2022-04-27,Assembly,"Do pass and be re-referred to the Committee on [Appropriations]",7,0,0,0,7
1588146,1206438,2022-05-19,Assembly,"Do pass",16,0,0,0,16
1588146,1210609,2022-05-25,Assembly,"AB 1983 Fong Assembly Third Reading",76,0,0,2,78
1588146,1215792,2022-06-14,Senate,"Do pass, but first be re-referred to the Committee on [Transportation] with the recommendation: To Consent Calendar",14,0,0,1,15
1588146,1220619,2022-06-28,Senate,"Do pass, but first be re-referred to the Committee on [Appropriations] with the recommendation: To Consent Calendar",17,0,0,0,17
1588146,1222774,2022-08-01,Senate,"Placed on suspense file",7,0,0,0,7
1588146,1223881,2022-08-11,Senate,"Do pass",7,0,0,0,7
1588146,1224395,2022-08-23,Senate,"Special Consent AB1983",40,0,0,0,40
1588148,1179330,2022-03-21,Assembly,"Do pass and be re-referred to the Committee on [Appropriations] with recommendation: To Consent Calendar",11,0,0,0,11
1588148,1206347,2022-05-19,Assembly,"Do pass",16,0,0,0,16
1588148,1210306,2022-05-26,Assembly,"AB 1985 Robert Rivas Assembly Third Reading",75,0,0,3,78
1588148,1220778,2022-06-29,Senate,"Do pass as amended, but first amend, and re-refer to the Committee on [Appropriations]",7,0,0,0,7
1588148,1223150,2022-08-08,Senate,"Placed on suspense file",7,0,0,0,7
1588148,1223598,2022-08-11,Senate,"Do pass",7,0,0,0,7
1588148,1224466,2022-08-23,Senate,"Special Consent AB1985",40,0,0,0,40
1588148,1224795,2022-08-24,Assembly,"AB 1985 Robert Rivas Concurrence in Senate Amendments",72,0,0,8,80
1588150,1183621,2022-04-05,Assembly,"Do pass as amended and be re-referred to the Committee on [Appropriations]",11,0,0,1,12
1588151,1175542,2022-03-23,Assembly,"Do pass as amended and be re-referred to the Committee on [Emergency Management]",13,0,0,0,13
1588151,1192180,2022-04-25,Assembly,"Do pass. To Consent Calendar",7,0,0,0,7
1588152,1180224,2022-03-30,Assembly,"Do pass and be re-referred to the Committee on [Appropriations] with recommendation: To Consent Calendar",13,0,0,1,14
1588152,1194354,2022-04-27,Assembly,"Do pass. To Consent Calendar",15,0,0,1,16
1588152,1200659,2022-05-05,Assembly,"AB 1989 Quirk Consent Calendar Second Day Regular Session",61,0,0,17,78
1588152,1217965,2022-06-22,Senate,"Do pass, but first be re-referred to the Committee on [Appropriations] with the recommendation: To Consent Calendar",11,0,0,1,12
1588152,1223262,2022-08-08,Senate,"Consent Calendar AB1989",36,0,0,4,40
1588153,1183810,2022-04-05,Assembly,"Do pass as amended and be re-referred to the Committee on [Appropriations]",9,0,0,1,10
1588154,1194246,2022-04-27,Assembly,"Do pass and be re-referred to the Committee on [Appropriations]",7,0,0,1,8
1588154,1205833,2022-05-18,Assembly,"Do pass",15,0,0,1,16
1588154,1210288,2022-05-25,Assembly,"AB 1991 Gabriel Assembly Third Reading",75,0,0,3,78
1588154,1220888,2022-06-28,Senate,"Do pass as amended, but first amend, and re-refer to the Committee on [Appropriations]",10,0,0,1,11
1588154,1224821,2022-08-24,Senate,"Assembly 3rd Reading AB1991 Gabriel By Kamlager",40,0,0,0,40
1588154,1224941,2022-08-25,Assembly,"AB 1991 Gabriel Concurrence in Senate Amendments",75,0,0,5,80
1588158,1174503,2022-03-22,Assembly,"Do pass as amended and be re-referred to the Committee on [Appropriations]",12,0,0,2,14
1588158,1206828,2022-05-19,Assembly,"Do pass",13,0,0,3,16
1588158,1210281,2022-05-26,Assembly,"AB 1995 Arambula Assembly Third Reading",67,0,0,11,78
1588158,1216245,2022-06-15,Senate,"Do pass, but first be re-referred to the Committee on [Appropriations]",7,0,0,4,11
1588158,1219399,2022-06-27,Senate,"Placed on suspense file",6,0,0,1,7
1588159,1175527,2022-03-23,Assembly,"Do pass and be re-referred to the Committee on [Appropriations]",5,0,0,2,7
1588160,1194166,2022-04-26,Assembly,"Do pass and be re-referred to the Committee on [Appropriations]",8,2,0,2,12
1588160,1203333,2022-05-11,Assembly,"Do pass",12,4,0,0,16
1588160,1207883,2022-05-23,Assembly,"AB 1997 Gipson Assembly Third Reading",50,15,0,13,78
1588160,1217860,2022-06-22,Senate,"Do pass as amended, but first amend, and re-refer to the Committee on [Appropriations]",5,1,0,1,7
1588160,1224675,2022-08-24,Senate,"Assembly 3rd Reading AB1997 Gipson By Leyva",31,9,0,0,40
1588160,1224906,2022-08-25,Assembly,"AB 1997 Gipson Concurrence in Senate Amendments",59,14,0,7,80
1588161,1194429,2022-04-26,Assembly,"Do pass and be re-referred to the Committee on [Appropriations]",12,0,0,0,12
1588161,1206743,2022-05-19,Assembly,"Do pass as amended",16,0,0,0,16
1588161,1210305,2022-05-26,Assembly,"AB 1998 Smith Assembly Third Reading",75,0,0,3,78
1588161,1217985,2022-06-22,Senate,"Do pass, but first be re-referred to the Committee on [Appropriations] with the recommendation: To Consent Calendar",6,0,0,1,7
1588161,1222859,2022-08-01,Senate,"Placed on suspense file",7,0,0,0,7
1588161,1223454,2022-08-11,Senate,"Do pass",7,0,0,0,7
1588161,1225861,2022-08-31,Senate,"Assembly 3rd Reading AB1998 Smith et al. By Grove",40,0,0,0,40
1588161,1225862,2022-08-31,Assembly,"AB 1998 Smith Concurrence in Senate Amendments",79,0,0,1,80
1588162,1193399,2022-04-26,Assembly,"Do pass as amended, and be re-referred to the Committee on [Appropriations] with recommendation: To Consent Calendar",14,0,0,1,15
1588162,1206635,2022-05-19,Assembly,"Do pass",16,0,0,0,16
1588162,1210639,2022-05-25,Assembly,"AB 1999 Arambula Assembly Third Reading",76,0,0,2,78
1588162,1216392,2022-06-15,Senate,"Do pass, but first be re-referred to the Committee on [Appropriations] with the recommendation: To Consent Calendar",9,0,0,2,11
1588162,1219514,2022-06-27,Senate,"Placed on suspense file",6,0,0,1,7
1588162,1223547,2022-08-11,Senate,"Do pass",7,0,0,0,7
1588162,1224429,2022-08-23,Senate,"Special Consent AB1999",40,0,0,0,40
1588163,1221341,2022-06-30,Assembly,"Be adopted. To third reading",7,0,0,4,11
1588164,1180254,2022-03-30,Senate,"Do pass as amended, but first amend, and re-refer to the Committee on [Governance and Finance] with the recommendation: To Consent Calendar",11,0,0,0,11
1588164,1190581,2022-04-20,Senate,"Do pass, but first be re-referred to the Committee on [Appropriations]",5,0,0,0,5
1588164,1198305,2022-05-02,Senate,"Placed on suspense file",7,0,0,0,7
1588164,1206616,2022-05-19,Senate,"Do pass",7,0,0,0,7
1588164,1209343,2022-05-25,Senate,"Special Consent SB967",39,0,0,1,40
1588164,1215810,2022-06-14,Assembly,"Do pass and be re-referred to the Committee on [Revenue and Taxation]",13,0,0,2,15
1588164,1219949,2022-06-27,Assembly,"Do pass and be re-referred to the Committee on [Appropriations]",10,0,0,1,11
1588164,1222963,2022-08-03,Assembly,"Do pass",15,0,0,1,16
1588164,1223472,2022-08-11,Assembly,"SB 967 Hertzberg Senate Third Reading By Arambula",76,0,0,4,80
1588166,1181285,2022-03-31,Senate,"Do pass",5,0,0,0,5
1588166,1191325,2022-04-21,Senate,"Senate 3rd Reading SB969 Laird",39,0,0,1,40
1588166,1215036,2022-06-08,Assembly,"Do pass. To Consent Calendar",8,0,0,0,8
1588166,1216817,2022-06-16,Assembly,"SB 969 Laird Consent Calendar Second Day Regular Session",72,0,0,7,79
1588167,1195811,2022-04-27,Senate,"Do pass as amended, but first amend, and re-refer to the Committee on [Appropriations]",10,0,0,1,11
1588167,1204559,2022-05-16,Senate,"Placed on suspense file",6,0,0,1,7
1588167,1206682,2022-05-19,Senate,"Do pass",7,0,0,0,7
1588167,1209264,2022-05-25,Senate,"Special Consent SB970",39,0,0,1,40
1588167,1217372,2022-06-21,Assembly,"Do pass as amended and be re-referred to the Committee on [Appropriations]",15,0,0,0,15
1588167,1223787,2022-08-11,Assembly,"Do pass",16,0,0,0,16
1588168,1176519,2022-03-24,Senate,"Do pass, but first be re-referred to the Committee on [Appropriations]",6,0,0,3,9
1588168,1208528,2022-05-24,Senate,"Senate 3rd Reading SB971 Newman",30,1,0,9,40
1588168,1220733,2022-06-29,Assembly,"Do pass and be re-referred to the Committee on [Appropriations]",7,0,0,1,8
1588168,1222971,2022-08-03,Assembly,"Do pass. To Consent Calendar",15,0,0,1,16
1588168,1223499,2022-08-11,Assembly,"SB 971 Newman Consent Calendar Second Day Regular Session",76,0,0,4,80
1588168,1224065,2022-08-15,Senate,"Unfinished Business SB971 Newman et al. Concurrence",31,3,0,6,40
1588169,1191348,2022-04-20,Senate,"Do pass as amended, but first amend, and re-refer to the Committee on [Appropriations]",9,1,0,1,11
1588169,1209951,2022-05-26,Senate,"Senate 3rd Reading SB972 Gonzalez et al",29,5,0,6,40
1588169,1220025,2022-06-28,Assembly,"Do pass as amended and be re-referred to the Committee on [Appropriations]",12,1,0,2,15
1588169,1222947,2022-08-03,Assembly,"Do pass",11,4,0,1,16
1588169,1224698,2022-08-24,Assembly,"SB 972 Gonzalez Senate Third Reading By Carrillo",63,0,0,17,80
1588169,1225234,2022-08-30,Senate,"Unfinished Business SB972 Gonzalez et al. Concurrence",35,3,0,2,40
1588170,1190522,2022-04-19,Senate,"Do pass, but first be re-referred to the Committee on [Appropriations]",5,0,0,0,5
1588170,1198283,2022-05-02,Senate,"Placed on suspense file",7,0,0,0,7
1588170,1206979,2022-05-19,Senate,"Do pass",7,0,0,0,7
1588170,1209304,2022-05-25,Senate,"Special Consent SB973",39,0,0,1,40
1588170,1219983,2022-06-28,Assembly,"Do pass and be re-referred to the Committee on [Appropriations]",7,0,0,1,8
1588170,1223756,2022-08-11,Assembly,"Do pass as amended",12,0,0,4,16
1588170,1224213,2022-08-18,Assembly,"SB 973 Hertzberg Senate Third Reading By Bryan",75,0,0,5,80
1588170,1224400,2022-08-23,Senate,"Unfinished Business SB973 Hertzberg et al. Concurrence",40,0,0,0,40
1588171,1191322,2022-04-20,Senate,"Do pass as amended, but first amend, and re-refer to the Committee on [Appropriations]",9,0,0,2,11
1588171,1201380,2022-05-09,Senate,"Placed on suspense file",7,0,0,0,7
1588171,1206840,2022-05-19,Senate,"Do pass",7,0,0,0,7
1588171,1209391,2022-05-25,Senate,"Special Consent SB974",39,0,0,1,40
1588171,1219986,2022-06-28,Assembly,"Do pass and be re-referred to the Committee on [Appropriations]",13,0,0,2,15
1588171,1223727,2022-08-11,Assembly,"Do pass",15,0,0,1,16
1588171,1225718,2022-08-31,Senate,"Unfinished Business SB974 Portantino et al. Concurrence",39,0,0,1,40
1588171,1225719,2022-08-31,Assembly,"SB 974 Portantino Senate Third Reading By Friedman",73,0,0,7,80
1588172,1194395,2022-04-26,Senate,"Do pass as amended, but first amend, and re-refer to the Committee on [Appropriations]",9,2,0,0,11
1588172,1204642,2022-05-16,Senate,"Placed on suspense file",6,0,0,1,7
1588172,1206639,2022-05-19,Senate,"Do pass as amended",5,2,0,0,7
1588172,1208514,2022-05-24,Senate,"Senate 3rd Reading SB975 Min",26,8,0,6,40
1588172,1220106,2022-06-28,Assembly,"Do pass as amended and be re-referred to the Committee on [Appropriations]",9,1,0,1,11
1588172,1223984,2022-08-11,Assembly,"Do pass as amended",12,3,0,1,16
1588172,1225707,2022-08-30,Senate,"Unfinished Business SB975 Min Concurrence",31,8,0,1,40
1588172,1225708,2022-08-30,Assembly,"SB 975 Min Senate Third Reading By Stone",59,15,0,6,80
1588173,1184692,2022-04-06,Senate,"Do pass as amended, but first amend, and re-refer to the Committee on [Human Services]",6,0,0,1,7
1588173,1190671,2022-04-19,Senate,"Do pass, but first be re-referred to the Committee on [Appropriations]",4,0,0,1,5
1588173,1201370,2022-05-09,Senate,"Placed on suspense file",7,0,0,0,7
1588173,1206546,2022-05-19,Senate,"Do pass as amended",5,1,0,1,7
1588173,1209356,2022-05-25,Senate,"Senate 3rd Reading SB976 Leyva et al",32,1,0,7,40
1588173,1220071,2022-06-28,Assembly,"Do pass and be re-referred to the Committee on [Education]",7,0,0,1,8
1588174,1189827,2022-04-19,Senate,"Do pass as amended, but first amend, and re-refer to the Committee on [Appropriations]",8,0,0,1,9
1588174,1198274,2022-05-02,Senate,"Placed on suspense file",7,0,0,0,7
1588174,1206962,2022-05-19,Senate,"Do pass",7,0,0,0,7
1588174,1209230,2022-05-25,Senate,"Special Consent SB977",39,0,0,1,40
1588174,1219932,2022-06-28,Assembly,"Do pass and be re-referred to the Committee on [Appropriations]",14,0,0,1,15
1588175,1194236,2022-04-27,Senate,"Do pass, but first be re-referred to the Committee on [Appropriations]",7,0,0,0,7
1588175,1201467,2022-05-09,Senate,"Placed on suspense file",7,0,0,0,7
1588175,1206747,2022-05-19,Senate,"Do pass",7,0,0,0,7
1588175,1209238,2022-05-25,Senate,"Senate 3rd Reading SB978 McGuire",39,0,0,1,40
1588175,1217117,2022-06-20,Assembly,"Do pass and be re-referred to the Committee on [Appropriations] with recommendation: To Consent Calendar",9,0,0,2,11
1588175,1223535,2022-08-11,Assembly,"Do pass as amended",12,0,0,4,16
1588175,1225990,2022-08-30,Senate,"Unfinished Business SB978 McGuire Concurrence",40,0,0,0,40
1588175,1225991,2022-08-30,Assembly,"SB 978 McGuire Senate Third Reading By Luz Rivas",79,0,0,1,80
1588176,1195764,2022-04-27,Senate,"Do pass as amended, but first amend, and re-refer to the Committee on [Appropriations]",10,0,0,1,11
1588176,1207879,2022-05-23,Senate,"Senate 3rd Reading SB979 Dodd",36,0,0,4,40
1588176,1217398,2022-06-21,Assembly,"Do pass and be re-referred to the Committee on [Appropriations] with recommendation: To Consent Calendar",15,0,0,0,15
1588176,1222998,2022-08-03,Assembly,"Do pass. To Consent Calendar",15,0,0,1,16
1588176,1224346,2022-08-22,Assembly,"SB 979 Dodd Senate Third Reading By Aguiar-Curry",77,0,0,3,80
1588176,1224600,2022-08-23,Senate,"Unfinished Business SB979 Dodd Concurrence",40,0,0,0,40
1588177,1193299,2022-04-26,Senate,"Do pass as amended, but first amend, and re-refer to the Committee on [Appropriations]",10,0,0,5,15
1588177,1201352,2022-05-09,Senate,"Placed on suspense file",7,0,0,0,7
1588178,1179139,2022-03-29,Senate,"Do pass, but first be re-referred to the Committee on [Appropriations] with the recommendation: To Consent Calendar",5,0,0,0,5
1588178,1195838,2022-04-28,Senate,"Consent Calendar SB981",37,0,0,3,40
1588178,1211837,2022-06-01,Assembly,"Do pass as amended, and be re-referred to the Committee on [Appropriations] with recommendation: To Consent Calendar",7,0,0,0,7
1588178,1220589,2022-06-29,Assembly,"Do pass. To Consent Calendar",14,0,0,2,16
1588178,1223025,2022-08-04,Assembly,"SB 981 Glazer Consent Calendar Second Day Regular Session",76,0,0,4,80
1588178,1224108,2022-08-16,Senate,"Unfinished Business SB981 Glazer et al. Concurrence",37,0,0,3,40
1588179,1176489,2022-03-24,Senate,"Do pass as amended, but first amend, and re-refer to the Committee on [Appropriations]",4,0,0,1,5
1588179,1198278,2022-05-02,Senate,"Senate 3rd Reading SB982 Laird et al",36,0,0,4,40
1588179,1220655,2022-06-29,Assembly,"Do pass and be re-referred to the Committee on [Appropriations] with recommendation: To Consent Calendar",8,0,0,3,11
1588179,1222948,2022-08-03,Assembly,"Do pass. To Consent Calendar",15,0,0,1,16
1588179,1223929,2022-08-11,Assembly,"SB 982 Laird Consent Calendar Second Day Regular Session",76,0,0,4,80
1588180,1201405,2022-05-09,Senate,"Senate 3rd Reading SR67 Archuleta",33,0,0,7,40
1590258,1183766,2022-04-04,Assembly,"Do pass and be re-referred to the Committee on [Appropriations]",12,0,0,3,15
1590258,1194171,2022-04-27,Assembly,"Do pass",15,0,0,1,16
1590258,1204638,2022-05-16,Assembly,"AB 2000 Gabriel Assembly Third Reading",69,0,0,9,78
1590258,1216367,2022-06-14,Senate,"Do pass, but first be re-referred to the Committee on [Public Safety]",14,0,0,3,17
1590258,1220853,2022-06-28,Senate,"Do pass, but first be re-referred to the Committee on [Appropriations]",4,0,0,1,5
1590258,1222787,2022-08-01,Senate,"Placed on suspense file",7,0,0,0,7
1590258,1223758,2022-08-11,Senate,"Do pass",7,0,0,0,7
1590258,1224456,2022-08-23,Senate,"Special Consent AB2000",40,0,0,0,40
1590258,1224779,2022-08-24,Assembly,"AB 2000 Gabriel Concurrence in Senate Amendments",71,0,0,9,80
1590261,1179520,2022-03-28,Assembly,"Do pass and be re-referred to the Committee on [Privacy and Consumer Protection]",9,0,0,3,12
1590261,1189864,2022-04-19,Assembly,"Do pass as amended and be re-referred to the Committee on [Appropriations]",11,0,0,0,11
1590261,1206263,2022-05-19,Assembly,"Do pass",16,0,0,0,16
1590261,1210241,2022-05-25,Assembly,"AB 2001 Grayson Assembly Third Reading",76,0,0,2,78
1590261,1218052,2022-06-22,Senate,"Do pass, but first be re-referred to the Committee on [Judiciary] with the recommendation: To Consent Calendar",7,0,0,2,9
1590261,1220630,2022-06-28,Senate,"Do pass, but first be re-referred to the Committee on [Appropriations] with the recommendation: To Consent Calendar",10,0,0,1,11
1590261,1223193,2022-08-08,Senate,"Consent Calendar AB2001",36,0,0,4,40
1590261,1223595,2022-08-11,Assembly,"AB 2001 Grayson Concurrence in Senate Amendments",74,0,0,6,80
1590263,1194249,2022-04-27,Assembly,"Do pass as amended and be re-referred to the Committee on [Appropriations]",8,0,0,0,8
1590263,1206409,2022-05-19,Assembly,"Do pass",16,0,0,0,16
1590263,1210593,2022-05-25,Assembly,"AB 2002 Villapudua Assembly Third Reading",76,0,0,2,78
1590263,1215820,2022-06-13,Senate,"Do pass as amended, but first amend, and re-refer to the Committee on [Appropriations]",8,0,0,1,9
1590263,1219456,2022-06-27,Senate,"Placed on suspense file",6,0,0,1,7
1590264,1191259,2022-04-20,Assembly,"Do pass and be re-referred to the Committee on [Appropriations]",6,0,0,1,7
1590264,1206944,2022-05-19,Assembly,"Do pass",15,0,0,1,16
1590264,1210325,2022-05-26,Assembly,"AB 2003 Mike Fong Assembly Third Reading",73,0,0,5,78
1590264,1215894,2022-06-13,Senate,"Do pass, but first be re-referred to the Committee on [Appropriations]",5,0,0,0,5
1590264,1219437,2022-06-27,Senate,"Placed on suspense file",6,0,0,1,7
1590264,1224012,2022-08-11,Senate,"Do pass",7,0,0,0,7
1590264,1224764,2022-08-24,Senate,"Assembly 3rd Reading AB2003 Mike Fong By Laird",40,0,0,0,40
1590265,1190713,2022-04-19,Assembly,"Do pass and be re-referred to the Committee on [Appropriations]",11,1,0,0,12
1590265,1200005,2022-05-04,Assembly,"Do pass",11,0,0,5,16
1590265,1201509,2022-05-09,Assembly,"AB 2004 Cristina Garcia Assembly Third Reading",54,5,0,19,78
1590265,1217982,2022-06-22,Senate,"Do pass, but first be re-referred to the Committee on [Appropriations]",5,1,0,1,7
1590265,1222801,2022-08-01,Senate,"Placed on suspense file",7,0,0,0,7
1590265,1223737,2022-08-11,Senate,"Do pass",5,2,0,0,7
1590265,1224949,2022-08-25,Senate,"Assembly 3rd Reading AB2004 Cristina Garcia et a By Durazo",33,7,0,0,40
1590265,1224950,2022-08-25,Assembly,"AB 2004 Cristina Garcia Concurrence in Senate Amendments",61,0,0,19,80
1590269,1183739,2022-04-05,Assembly,"Do pass and be re-referred to the Committee on [Appropriations] with recommendation: To Consent Calendar",7,0,0,1,8
1590269,1206625,2022-05-19,Assembly,"Do pass",16,0,0,0,16
1590269,1210605,2022-05-25,Assembly,"AB 2006 Berman Assembly Third Reading",76,0,0,2,78
1590269,1217927,2022-06-21,Senate,"Do pass, but first be re-referred to the Committee on [Appropriations] with the recommendation: To Consent Calendar",8,0,0,1,9
1590269,1222813,2022-08-01,Senate,"Placed on suspense file",7,0,0,0,7
1590269,1223465,2022-08-11,Senate,"Do pass as amended",6,0,0,1,7
1590269,1224507,2022-08-23,Senate,"Special Consent AB2006",40,0,0,0,40
1590269,1224707,2022-08-24,Assembly,"AB 2006 Berman Concurrence in Senate Amendments",77,0,0,3,80
1590276,1194152,2022-04-27,Assembly,"Do pass and be re-referred to the Committee on [Rules]",7,1,0,0,8
1590276,1206701,2022-05-19,Assembly,"Do pass",12,1,0,3,16
1590276,1207829,2022-05-23,Assembly,"AB 2011 Wicks Assembly Third Reading",48,11,0,19,78
1590276,1217930,2022-06-21,Senate,"Do pass, but first be re-referred to the Committee on [Governance and Finance]",6,1,0,2,9
1590276,1221271,2022-06-29,Senate,"Do pass, but first be re-referred to the Committee on [Appropriations]",5,0,0,0,5
1590276,1222707,2022-08-01,Senate,"Placed on suspense file",7,0,0,0,7
1590276,1223484,2022-08-11,Senate,"Do pass as amended",4,1,0,2,7
1590276,1223485,2022-08-11,Senate,"[08-11-2022] set for [First] hearing: Reconsideration of favorable vote granted",7,0,0,0,7
1590276,1223486,2022-08-11,Senate,"Do pass as amended",5,1,0,1,7
1590276,1225124,2022-08-29,Assembly,"AB 2011 WICKS Concurrence in Senate Amendments",67,4,0,9,80
1590276,1225419,2022-08-29,Senate,"Assembly 3rd Reading AB2011 Wicks et al. By Caballero",33,0,0,7,40
1590277,1190559,2022-04-20,Assembly,"Do pass and be re-referred to the Committee on [Appropriations] with recommendation: To Consent Calendar",20,0,0,2,22
1590277,1205831,2022-05-18,Assembly,"Do pass. To Consent Calendar",15,0,0,1,16
1590277,1210647,2022-05-25,Assembly,"AB 2012 Aguiar-Curry Consent Calendar Second Day Regular Session",73,0,0,5,78
1590277,1219974,2022-06-28,Senate,"Do pass, but first be re-referred to the Committee on [Appropriations] with the recommendation: To Consent Calendar",13,0,0,2,15
1590277,1223303,2022-08-08,Senate,"Consent Calendar AB2012",36,0,0,4,40
1590282,1184633,2022-04-06,Assembly,"Do pass and be re-referred to the Committee on [Public Employment and Retirement] with recommendation: To Consent Calendar",8,0,0,0,8
1590282,1190508,2022-04-20,Assembly,"Do pass and be re-referred to the Committee on [Appropriations] with recommendation: To Consent Calendar",6,0,0,0,6
1590282,1199976,2022-05-04,Assembly,"Do pass. To Consent Calendar",14,0,0,2,16
1590282,1204133,2022-05-12,Assembly,"AB 2015 Cooley Consent Calendar Second Day Regular Session",65,0,0,13,78
1590282,1216264,2022-06-14,Senate,"Do pass, but first be re-referred to the Committee on [Labor, Public Employment and Retirement ] with the recommendation: To Consent Calendar",15,0,0,2,17
1590282,1220586,2022-06-29,Senate,"Do pass, but first be re-referred to the Committee on [Appropriations] with the recommendation: To Consent Calendar",5,0,0,0,5
1590282,1223168,2022-08-08,Senate,"Consent Calendar AB2015",36,0,0,4,40
1590283,1183714,2022-04-05,Assembly,"Do pass and be re-referred to the Committee on [Appropriations] with recommendation: To Consent Calendar",13,0,0,2,15
1590283,1206370,2022-05-19,Assembly,"Do pass as amended",12,0,0,4,16
1590283,1210512,2022-05-26,Assembly,"AB 2016 Bauer-Kahan Assembly Third Reading",74,0,0,4,78
1590283,1217112,2022-06-20,Senate,"Do pass as amended, but first amend, and re-refer to the Committee on [Appropriations] with the recommendation: To Consent Calendar",7,0,0,2,9
1590283,1222820,2022-08-01,Senate,"Placed on suspense file",7,0,0,0,7
1590286,1183585,2022-04-05,Assembly,"Do pass and be re-referred to the Committee on [Judiciary]",2,3,0,2,7
1590286,1193407,2022-04-26,Assembly,"Do pass and be re-referred to the Committee on [Judiciary]",2,3,0,2,7
1590289,1193205,2022-04-26,Assembly,"Do pass as amended and be re-referred to the Committee on [Appropriations]",6,0,0,0,6
1590289,1206700,2022-05-19,Assembly,"Do pass",16,0,0,0,16
1590289,1210559,2022-05-25,Assembly,"AB 2019 Petrie-Norris Assembly Third Reading",76,0,0,2,78
1590289,1215841,2022-06-14,Senate,"Do pass, but first be re-referred to the Committee on [Business, Professions and Economic Development]",12,0,0,3,15
1590289,1219352,2022-06-27,Senate,"Do pass, but first be re-referred to the Committee on [Appropriations]",11,0,0,3,14
1590289,1222711,2022-08-01,Senate,"Placed on suspense file",7,0,0,0,7
1590289,1223884,2022-08-11,Senate,"Do pass as amended",5,0,0,2,7
1590289,1224728,2022-08-24,Senate,"Assembly 3rd Reading AB2019 Petrie-Norris et al. By Min",34,0,0,6,40
1590289,1224932,2022-08-25,Assembly,"AB 2019 Petrie-Norris Concurrence in Senate Amendments",74,0,0,6,80
1590291,1193277,2022-04-25,Assembly,"Do pass and be re-referred to the Committee on [Appropriations]",7,2,0,2,11
1590291,1206730,2022-05-19,Assembly,"Do pass as amended",12,4,0,0,16
1590291,1210253,2022-05-26,Assembly,"AB 2021 Wicks Assembly Third Reading",56,18,0,4,78
1590291,1217841,2022-06-22,Senate,"Do pass, but first be re-referred to the Committee on [Appropriations]",4,1,0,0,5
1590291,1222697,2022-08-01,Senate,"Placed on suspense file",7,0,0,0,7
1590292,1193409,2022-04-26,Assembly,"Do pass and be re-referred to the Committee on [Appropriations]",15,0,0,0,15
1590292,1206649,2022-05-19,Assembly,"Do pass as amended",12,0,0,4,16
1590292,1210437,2022-05-26,Assembly,"AB 2022 Ramos Assembly Third Reading",75,0,0,3,78
1590292,1217101,2022-06-20,Senate,"Do pass as amended, but first amend, and re-refer to the Committee on [Governmental Organization]",7,0,0,2,9
1590292,1220034,2022-06-28,Senate,"Do pass, but first be re-referred to the Committee on [Appropriations]",13,0,0,2,15
1590292,1223192,2022-08-08,Senate,"Placed on suspense file",7,0,0,0,7
1590292,1223392,2022-08-11,Senate,"Do pass",7,0,0,0,7
1590292,1224660,2022-08-24,Senate,"Assembly 3rd Reading AB2022 Ramos et al. By Skinner",40,0,0,0,40
1590292,1224947,2022-08-25,Assembly,"AB 2022 Ramos Concurrence in Senate Amendments",75,0,0,5,80
1590294,1174572,2022-03-22,Assembly,"Do pass and be re-referred to the Committee on [Appropriations] with recommendation: To Consent Calendar",7,0,0,0,7
1590294,1206843,2022-05-19,Assembly,"Do pass",16,0,0,0,16
1590294,1210386,2022-05-25,Assembly,"AB 2023 Bennett Assembly Third Reading",76,0,0,2,78
1590294,1217432,2022-06-21,Senate,"Do pass, but first be re-referred to the Committee on [Appropriations] with the recommendation: To Consent Calendar",4,0,0,1,5
1590294,1222779,2022-08-01,Senate,"Placed on suspense file",7,0,0,0,7
1590294,1223638,2022-08-11,Senate,"Do pass",6,0,0,1,7
1590294,1224409,2022-08-23,Senate,"Assembly 3rd Reading AB2023 Bennett By Skinner",39,0,0,1,40
1590295,1193433,2022-04-26,Assembly,"Do pass as amended and be re-referred to the Committee on [Appropriations]",12,1,0,2,15
1590295,1206584,2022-05-19,Assembly,"Do pass",13,3,0,0,16
1590295,1210434,2022-05-26,Assembly,"AB 2024 Friedman Assembly Third Reading",66,3,0,9,78
1590295,1221219,2022-06-29,Senate,"Do pass as amended, but first amend, and re-refer to the Committee on [Appropriations]",10,0,0,1,11
1590295,1223297,2022-08-08,Senate,"Placed on suspense file",7,0,0,0,7
1590298,1179491,2022-03-21,Assembly,"Do pass as amended and be re-referred to the Committee on [Judiciary]",8,3,0,0,11
1590298,1183683,2022-04-05,Assembly,"Do pass as amended and be re-referred to the Committee on [Appropriations]",7,2,0,1,10
1590298,1206897,2022-05-19,Assembly,"Do pass as amended",11,4,0,1,16
1590298,1210271,2022-05-26,Assembly,"AB 2026 Friedman Assembly Third Reading",41,26,0,11,78
1590298,1217905,2022-06-22,Senate,"Do pass, but first be re-referred to the Committee on [Judiciary]",5,1,0,1,7
1590298,1220653,2022-06-28,Senate,"Do pass, but first be re-referred to the Committee on [Appropriations]",9,1,0,1,11
1590298,1222875,2022-08-01,Senate,"Placed on suspense file",7,0,0,0,7
1590300,1174532,2022-03-22,Assembly,"Do pass and be re-referred to the Committee on [Appropriations]",2,5,0,0,7
1590300,1193356,2022-04-26,Assembly,"Do pass and be re-referred to the Committee on [Appropriations]",2,5,0,0,7
1590302,1176543,2022-03-23,Assembly,"Do pass as amended",7,0,0,0,7
1590302,1195786,2022-04-28,Assembly,"AB 2028 Davies Assembly Third Reading",70,0,0,7,77
1590302,1215037,2022-06-08,Senate,"Do pass as amended, and be ordered to the Consent Calendar",7,0,0,0,7
1590302,1216625,2022-06-16,Senate,"Consent Calendar AB2028 Davies",35,0,0,5,40
1590302,1219491,2022-06-27,Assembly,"AB 2028 Davies Concurrence in Senate Amendments",71,0,0,9,80
1590304,1193227,2022-04-26,Assembly,"Do pass as amended and be re-referred to the Committee on [Appropriations]",11,2,0,2,15
1590306,1175566,2022-03-23,Assembly,"Do pass and be re-referred to the Committee on [Local Government]",6,1,0,0,7
1590306,1190583,2022-04-20,Assembly,"Do pass and be re-referred to the Committee on [Appropriations]",6,0,0,2,8
1590306,1206788,2022-05-19,Assembly,"Do pass",12,4,0,0,16
1590306,1210254,2022-05-26,Assembly,"AB 2030 Arambula Assembly Third Reading",56,20,0,2,78
1590306,1217459,2022-06-21,Senate,"Do pass, but first be re-referred to the Committee on [Governance and Finance]",4,1,0,0,5
1590306,1221348,2022-06-29,Senate,"Do pass, but first be re-referred to the Committee on [Appropriations]",4,1,0,0,5
1590306,1222877,2022-08-01,Senate,"Placed on suspense file",7,0,0,0,7
1590306,1223505,2022-08-11,Senate,"Do pass",5,2,0,0,7
1590306,1225255,2022-08-30,Senate,"Assembly 3rd Reading AB2030 Arambula By Caballero",29,10,0,1,40
1590307,1194294,2022-04-27,Assembly,"Do pass as amended",5,2,0,1,8
1590307,1204636,2022-05-16,Assembly,"AB 2031 Lee Assembly Third Reading",66,3,0,9,78
1590307,1216309,2022-06-14,Senate,"Do pass as amended",11,0,0,0,11
1590307,1224133,2022-08-17,Senate,"Assembly 3rd Reading AB2031 Lee et al. By Gonzalez",38,0,0,2,40
1590307,1224276,2022-08-22,Assembly,"AB 2031 Lee Concurrence in Senate Amendments",76,0,0,4,80
1590308,1183696,2022-04-05,Assembly,"Do pass and be re-referred to the Committee on [Military and Veterans Affairs] with recommendation: To Consent Calendar",14,0,0,1,15
1590308,1193261,2022-04-26,Assembly,"Do pass and be re-referred to the Committee on [Appropriations]",9,0,0,0,9
1590308,1206820,2022-05-19,Assembly,"Do pass",16,0,0,0,16
1590308,1210303,2022-05-26,Assembly,"AB 2032 Eduardo Garcia Assembly Third Reading",76,0,0,2,78
1590308,1218628,2022-06-22,Senate,"Do pass, but first be re-referred to the Committee on [Military and Veterans Affairs] with the recommendation: To Consent Calendar",9,0,0,2,11
1590308,1219988,2022-06-28,Senate,"Do pass, but first be re-referred to the Committee on [Appropriations] with the recommendation: To Consent Calendar",6,0,0,1,7
1590308,1222752,2022-08-01,Senate,"Placed on suspense file",7,0,0,0,7
1590308,1224005,2022-08-11,Senate,"Do pass as amended",7,0,0,0,7
1590308,1224513,2022-08-23,Senate,"Special Consent AB2032",40,0,0,0,40
1590308,1224836,2022-08-24,Assembly,"AB 2032 Eduardo Garcia Concurrence in Senate Amendments",76,0,0,4,80
1590310,1174573,2022-03-22,Assembly,"Do pass",2,5,0,0,7
1590310,1193264,2022-04-26,Assembly,"Do pass and be re-referred to the Committee on [Appropriations]",2,5,0,0,7
1590312,1183762,2022-04-05,Assembly,"Do pass as amended and be re-referred to the Committee on [Appropriations]",14,0,0,1,15
1590312,1206992,2022-05-19,Assembly,"Do pass",16,0,0,0,16
1590312,1210523,2022-05-26,Assembly,"AB 2034 O'Donnell Assembly Third Reading By WOOD",76,0,0,2,78
1590312,1218651,2022-06-22,Senate,"Do pass, but first be re-referred to the Committee on [Education] with the recommendation: To Consent Calendar",9,0,0,2,11
1590316,1175546,2022-03-23,Assembly,"Do pass and be re-referred to the Committee on [Governmental Organization]",7,0,0,0,7
1590316,1190526,2022-04-20,Assembly,"Do pass",20,0,0,2,22
1590316,1206666,2022-05-19,Assembly,"AB 2037 Flora Assembly Third Reading",66,2,0,10,78
1590316,1215569,2022-06-13,Senate,"Do pass, but first be re-referred to the Committee on [Governmental Organization]",4,0,0,1,5
1590316,1220077,2022-06-28,Senate,"Do pass",13,0,0,2,15
1590316,1223279,2022-08-08,Senate,"Special Consent AB2037 Flora",33,0,0,7,40
1590316,1224079,2022-08-15,Assembly,"AB 2037 Flora Concurrence in Senate Amendments",74,0,0,6,80
1590318,1185672,2022-04-06,Assembly,"Do pass as amended and be re-referred to the Committee on [Appropriations]",7,0,0,0,7
1590318,1194189,2022-04-27,Assembly,"Do pass. To Consent Calendar",15,0,0,1,16
1590318,1200660,2022-05-05,Assembly,"AB 2038 Gipson Consent Calendar Second Day Regular Session",61,0,0,17,78
1590318,1215015,2022-06-08,Senate,"Do pass as amended, but first amend, and re-refer to the Committee on [Appropriations]",7,0,0,0,7
1590318,1224137,2022-08-17,Senate,"Assembly 3rd Reading AB2038 Gipson By Rubio",38,0,0,2,40
1590318,1224307,2022-08-22,Assembly,"AB 2038 Gipson Concurrence in Senate Amendments",76,0,0,4,80
1590320,1199953,2022-05-04,Assembly,"Do pass as amended",8,0,0,0,8
1590320,1204080,2022-05-12,Assembly,"AB 2039 Luz Rivas Assembly Third Reading",66,0,0,12,78
1590323,1174517,2022-03-22,Assembly,"Do pass as amended and be re-referred to the Committee on [Appropriations]",7,0,0,0,7
1590325,1197954,2022-04-26,Assembly,"Do pass and be re-referred to the Committee on [Appropriations]",9,0,0,0,9
1590326,1183643,2022-04-05,Assembly,"Do pass and be re-referred to the Committee on [Education]",8,0,0,0,8
1590326,1195733,2022-04-27,Assembly,"Do pass as amended and be re-referred to the Committee on [Appropriations]",6,0,0,1,7
1590326,1206334,2022-05-19,Assembly,"Do pass as amended",12,0,0,4,16
1590326,1210265,2022-05-26,Assembly,"AB 2042 Villapudua Assembly Third Reading By REYES",75,0,0,3,78
1590326,1216310,2022-06-15,Senate,"Do pass as amended, but first amend, and re-refer to the Committee on [Human Services]",6,0,0,1,7
1590326,1219913,2022-06-27,Senate,"Do pass, but first be re-referred to the Committee on [Appropriations]",5,0,0,0,5
1590326,1222746,2022-08-01,Senate,"Placed on suspense file",7,0,0,0,7
1590326,1224013,2022-08-11,Senate,"Do pass as amended",7,0,0,0,7
1590326,1224489,2022-08-23,Senate,"Special Consent AB2042",40,0,0,0,40
1590326,1224905,2022-08-25,Assembly,"AB 2042 Villapudua Concurrence in Senate Amendments",73,0,0,7,80
1590327,1189968,2022-04-19,Assembly,"Do pass and be re-referred to the Committee on [Insurance]",5,0,0,2,7
1590327,1190694,2022-04-20,Assembly,"Do pass and be re-referred to the Committee on [Appropriations]",13,0,0,1,14
1590327,1207021,2022-05-19,Assembly,"Do pass as amended",12,0,0,4,16
1590327,1210564,2022-05-26,Assembly,"AB 2043 Jones-Sawyer Assembly Third Reading",56,8,0,14,78
1590327,1217874,2022-06-22,Senate,"Do pass, but first be re-referred to the Committee on [Public Safety]",7,2,0,3,12
1590327,1220770,2022-06-28,Senate,"Do pass as amended, but first amend, and re-refer to the Committee on [Appropriations]",4,0,0,1,5
1590327,1222652,2022-08-01,Senate,"Placed on suspense file",7,0,0,0,7
1590327,1223411,2022-08-11,Senate,"Do pass",5,1,0,1,7
1590327,1224830,2022-08-24,Senate,"Assembly 3rd Reading AB2043 Jones-Sawyer et al. By Hertzberg",30,7,0,3,40
1590327,1224936,2022-08-25,Assembly,"AB 2043 Jones-Sawyer Concurrence in Senate Amendments",62,3,0,15,80
1590329,1195736,2022-04-27,Assembly,"Do pass and be re-referred to the Committee on [Appropriations] with recommendation: To Consent Calendar",7,0,0,0,7
1590329,1203364,2022-05-11,Assembly,"Do pass. To Consent Calendar",16,0,0,0,16
1590329,1206258,2022-05-19,Assembly,"AB 2044 O'Donnell Consent Calendar Second Day Regular Session",72,0,0,6,78
1590330,1180221,2022-03-30,Assembly,"Do pass and be re-referred to the Committee on [Higher Education]",6,0,0,0,6
1590330,1190646,2022-04-19,Assembly,"Do pass and be re-referred to the Committee on [Appropriations]",12,0,0,0,12
1590330,1206581,2022-05-19,Assembly,"Do pass",16,0,0,0,16
1590330,1210589,2022-05-26,Assembly,"AB 2045 Jones-Sawyer Assembly Third Reading",75,0,0,3,78
1590330,1218649,2022-06-22,Senate,"Do pass, but first be re-referred to the Committee on [Education]",4,0,0,1,5
1590330,1220826,2022-06-29,Senate,"Do pass as amended, but first amend, and re-refer to the Committee on [Appropriations]",5,0,0,2,7
1590331,1190560,2022-04-19,Assembly,"Do pass and be re-referred to the Committee on [Appropriations]",10,0,0,2,12
1590331,1206252,2022-05-19,Assembly,"Do pass as amended",12,0,0,4,16
1590331,1210426,2022-05-26,Assembly,"AB 2046 Medina Assembly Third Reading",74,0,0,4,78
1590331,1217932,2022-06-22,Senate,"Do pass as amended, but first amend, and re-refer to the Committee on [Appropriations]",6,0,0,1,7
1590331,1223210,2022-08-08,Senate,"Placed on suspense file",7,0,0,0,7
1590331,1223586,2022-08-11,Senate,"Do pass",7,0,0,0,7
1590331,1225782,2022-08-30,Senate,"Assembly 3rd Reading AB2046 Medina et al. By Leyva",40,0,0,0,40
1590331,1225783,2022-08-31,Assembly,"AB 2046 Medina Concurrence in Senate Amendments",76,0,0,4,80
1590334,1179442,2022-03-21,Assembly,"Do pass as amended and be re-referred to the Committee on [Appropriations]",11,0,0,0,11
1590334,1194269,2022-04-27,Assembly,"Do pass. To Consent Calendar",15,0,0,1,16
1590334,1200661,2022-05-05,Assembly,"AB 2048 Santiago Consent Calendar Second Day Regular Session",61,0,0,17,78
1590334,1215051,2022-06-08,Senate,"Do pass as amended, but first amend, and re-refer to the Committee on [Appropriations]",5,0,0,2,7
1590334,1224120,2022-08-17,Senate,"Assembly 3rd Reading AB2048 Santiago By Wieckowski",38,0,0,2,40
1590334,1224291,2022-08-22,Assembly,"AB 2048 Santiago Concurrence in Senate Amendments",75,0,0,5,80
1590338,1183635,2022-04-05,Assembly,"Do pass and be re-referred to the Committee on [Judiciary]",6,1,0,1,8
1590338,1189819,2022-04-19,Assembly,"Do pass and be re-referred to the Committee on [Appropriations]",6,2,0,3,11
1590338,1199920,2022-05-04,Assembly,"Do pass",10,4,0,2,16
1590339,1191308,2022-04-20,Assembly,"Do pass as amended and be re-referred to the Committee on [Appropriations]",7,0,0,0,7
1590339,1206637,2022-05-19,Assembly,"Do pass",16,0,0,0,16
1590339,1210656,2022-05-25,Assembly,"AB 2051 Cunningham Assembly Third Reading",76,0,0,2,78
1590339,1218009,2022-06-22,Senate,"Do pass, but first be re-referred to the Committee on [Appropriations] with the recommendation: To Consent Calendar",6,0,0,1,7
1590339,1222819,2022-08-01,Senate,"Placed on suspense file",7,0,0,0,7
1590341,1174471,2022-03-22,Assembly,"Do pass and be re-referred to the Committee on [Appropriations] with recommendation: To Consent Calendar",8,0,0,0,8
1590341,1207043,2022-05-19,Assembly,"Do pass",16,0,0,0,16
1590341,1210402,2022-05-25,Assembly,"AB 2052 Quirk-Silva Assembly Third Reading",76,0,0,2,78
1590341,1217316,2022-06-20,Senate,"Do pass, but first be re-referred to the Committee on [Appropriations]",4,0,0,1,5
1590341,1222715,2022-08-01,Senate,"Placed on suspense file",7,0,0,0,7
1590343,1190584,2022-04-20,Assembly,"Do pass and be re-referred to the Committee on [Appropriations]",6,2,0,0,8
1590343,1206973,2022-05-19,Assembly,"Do pass as amended",12,4,0,0,16
1590343,1210520,2022-05-25,Assembly,"AB 2053 Lee Assembly Third Reading",47,20,0,11,78
1590343,1217979,2022-06-21,Senate,"Do pass, but first be re-referred to the Committee on [Governance and Finance]",5,1,0,3,9
1590343,1221293,2022-06-29,Senate,"Do pass, but first be re-referred to the Committee on [Appropriations]",2,1,0,2,5
1590343,1221294,2022-06-29,Senate,"[First] hearing set for [06-30-2022]: Failed passage in Committee. Reconsideration granted",5,0,0,0,5
1590345,1193302,2022-04-25,Assembly,"Do pass and be re-referred to the Committee on [Appropriations]",11,0,0,0,11
1590346,1179269,2022-03-29,Assembly,"Do pass and be re-referred to the Committee on [Public Safety]",14,0,0,4,18
1590346,1193335,2022-04-26,Assembly,"Do pass and be re-referred to the Committee on [Appropriations]",7,0,0,0,7
1590348,1174504,2022-03-21,Assembly,"Do pass and be re-referred to the Committee on [Appropriations]",12,1,0,2,15
1590348,1184687,2022-04-06,Assembly,"Do pass",10,1,0,5,16
1590348,1204601,2022-05-16,Assembly,"AB 2056 Grayson Third Reading Urgency",56,0,0,22,78
1590348,1215805,2022-06-14,Senate,"Do pass, but first be re-referred to the Committee on [Appropriations]",11,2,0,2,15
1590348,1223156,2022-08-08,Senate,"Placed on suspense file",7,0,0,0,7
1590348,1223971,2022-08-11,Senate,"Do pass",6,0,0,1,7
1590348,1225692,2022-08-30,Senate,"Assembly 3rd Reading AB2056 Grayson By Dodd Urgency Clause",35,0,0,5,40
1590348,1225693,2022-08-31,Assembly,"AB 2056 Grayson Concurrence in Senate Amendments",69,0,0,11,80
1590349,1183674,2022-04-04,Assembly,"Do pass and be re-referred to the Committee on [Labor and Employment]",11,3,0,1,15
1590349,1191331,2022-04-20,Assembly,"Do pass and be re-referred to the Committee on [Appropriations]",4,2,0,1,7
1590349,1206924,2022-05-19,Assembly,"Do pass",12,4,0,0,16
1590349,1210309,2022-05-26,Assembly,"AB 2057 Carrillo Assembly Third Reading",53,19,0,6,78
1590349,1216275,2022-06-14,Senate,"Do pass, but first be re-referred to the Committee on [Labor, Public Employment and Retirement ]",11,3,0,3,17
1590349,1220809,2022-06-29,Senate,"Do pass, but first be re-referred to the Committee on [Appropriations]",4,1,0,0,5
1590349,1222926,2022-08-01,Senate,"Placed on suspense file",7,0,0,0,7
1590349,1223519,2022-08-11,Senate,"Do pass",5,2,0,0,7
1590349,1225833,2022-08-29,Senate,"Assembly 3rd Reading AB2057 Carrillo By Cortese",31,8,0,1,40
1590349,1225834,2022-08-30,Assembly,"AB 2057 Carrillo Concurrence in Senate Amendments",58,17,0,5,80
1590350,1176510,2022-03-23,Assembly,"Do pass and be re-referred to the Committee on [Appropriations]",7,0,0,0,7
1590350,1206967,2022-05-19,Assembly,"Do pass",16,0,0,0,16
1590350,1210483,2022-05-26,Assembly,"AB 2058 O'Donnell Third Reading Urgency By QUIRK-SILVA",76,0,0,2,78
1590352,1175505,2022-03-22,Assembly,"Do pass and be re-referred to the Committee on [Appropriations]",8,1,0,0,9
1590352,1206712,2022-05-19,Assembly,"Do pass",13,2,0,1,16
1590352,1210531,2022-05-26,Assembly,"AB 2059 Carrillo Assembly Third Reading",59,5,0,14,78
1590352,1217996,2022-06-22,Senate,"Do pass, but first be re-referred to the Committee on [Appropriations]",6,1,0,0,7
1590352,1222794,2022-08-01,Senate,"Placed on suspense file",7,0,0,0,7
1590352,1223883,2022-08-11,Senate,"Do pass as amended",7,0,0,0,7
1590352,1224970,2022-08-25,Senate,"Assembly 3rd Reading AB2059 Carrillo By Durazo",40,0,0,0,40
1590352,1224971,2022-08-25,Assembly,"AB 2059 Carrillo Concurrence in Senate Amendments",63,0,0,17,80
1590354,1189944,2022-04-19,Assembly,"Do pass as amended and be re-referred to the Committee on [Appropriations]",15,0,0,4,19
1590354,1199964,2022-05-04,Assembly,"Do pass",9,4,0,3,16
1590355,1181286,2022-03-28,Assembly,"Do pass and be re-referred to the Committee on [Utilities and Energy]",14,0,0,1,15
1590355,1184722,2022-04-06,Assembly,"Do pass as amended and be re-referred to the Committee on [Appropriations]",11,0,0,4,15
1590355,1206640,2022-05-19,Assembly,"Do pass",16,0,0,0,16
1590355,1210293,2022-05-26,Assembly,"AB 2061 Ting Assembly Third Reading",74,0,0,4,78
1590355,1217355,2022-06-21,Senate,"Do pass, but first be re-referred to the Committee on [Transportation]",13,0,0,1,14
1590355,1220864,2022-06-28,Senate,"Do pass, but first be re-referred to the Committee on [Appropriations] with the recommendation: To Consent Calendar",17,0,0,0,17
1590355,1223180,2022-08-08,Senate,"Placed on suspense file",7,0,0,0,7
1590355,1223723,2022-08-11,Senate,"Do pass",7,0,0,0,7
1590355,1224450,2022-08-23,Senate,"Special Consent AB2061",40,0,0,0,40
1590355,1224451,2022-08-23,Senate,"Special Consent AB2061 Ting et al. By Becker Reconsider",37,0,0,3,40
1590355,1225934,2022-08-29,Senate,"Assembly 3rd Reading AB2061 Ting et al. By Becker",40,0,0,0,40
1590355,1225935,2022-08-30,Assembly,"AB 2061 Ting Concurrence in Senate Amendments",79,0,0,1,80
1590355,1229721,2022-08-30,Senate,"Assembly 3rd Reading AB2061 Ting et al. By Becker",40,0,0,0,40
1590357,1179201,2022-03-29,Assembly,"Do pass and be re-referred to the Committee on [Appropriations] with recommendation: To Consent Calendar",7,0,0,0,7
1590359,1183663,2022-04-05,Assembly,"Do pass and be re-referred to the Committee on [Local Government]",7,0,0,1,8
1590359,1190625,2022-04-20,Assembly,"Do pass as amended and be re-referred to the Committee on [Appropriations]",7,0,0,1,8
1590361,1191244,2022-04-20,Assembly,"Do pass as amended and be re-referred to the Committee on [Appropriations]",7,0,0,0,7
1590364,1175532,2022-03-23,Assembly,"Do pass as amended, and be re-referred to the Committee on [Appropriations] with recommendation: To Consent Calendar",13,0,0,0,13
1590368,1194402,2022-04-27,Assembly,"Do pass and be re-referred to the Committee on [Local Government] with recommendation: To Consent Calendar",8,0,0,0,8
1590368,1195830,2022-04-27,Assembly,"Do pass and be re-referred to the Committee on [Appropriations] with recommendation: To Consent Calendar",8,0,0,0,8
1590368,1203376,2022-05-11,Assembly,"Do pass. To Consent Calendar",16,0,0,0,16
1590368,1206309,2022-05-19,Assembly,"AB 2068 Haney Consent Calendar Second Day Regular Session",72,0,0,6,78
1590368,1218644,2022-06-22,Senate,"Do pass, but first be re-referred to the Committee on [Appropriations]",4,0,0,1,5
1590368,1222726,2022-08-01,Senate,"Placed on suspense file",7,0,0,0,7
1590368,1223492,2022-08-11,Senate,"Do pass as amended",5,2,0,0,7
1590368,1224846,2022-08-24,Senate,"Assembly 3rd Reading AB2068 Haney et al. By Laird",31,8,0,1,40
1590368,1225071,2022-08-29,Assembly,"With recommendation: That Senate amendments be concurred in",5,2,0,0,7
1590368,1225393,2022-08-30,Assembly,"AB 2068 Haney Concurrence in Senate Amendments",62,17,0,1,80
1590370,1190528,2022-04-19,Assembly,"Do pass and be re-referred to the Committee on [Health]",12,0,0,0,12
1590370,1193387,2022-04-26,Assembly,"Do pass and be re-referred to the Committee on [Appropriations] with recommendation: To Consent Calendar",14,0,0,1,15
1590370,1206630,2022-05-19,Assembly,"Do pass",16,0,0,0,16
1590370,1210626,2022-05-25,Assembly,"AB 2069 Villapudua Assembly Third Reading",76,0,0,2,78
1590370,1216249,2022-06-15,Senate,"Do pass, but first be re-referred to the Committee on [Health]",6,0,0,1,7
1590370,1221250,2022-06-29,Senate,"Do pass as amended, but first amend, and re-refer to the Committee on [Appropriations] with the recommendation: To Consent Calendar",10,0,0,1,11
1590370,1223203,2022-08-08,Senate,"Placed on suspense file",7,0,0,0,7
1590370,1223903,2022-08-11,Senate,"Do pass",7,0,0,0,7
1590370,1224573,2022-08-23,Senate,"Special Consent AB2069",40,0,0,0,40
1590370,1224726,2022-08-24,Assembly,"AB 2069 Villapudua Concurrence in Senate Amendments",75,0,0,5,80
1590372,1190549,2022-04-20,Assembly,"Do pass as amended and be re-referred to the Committee on [Appropriations]",9,0,0,6,15
1590372,1205845,2022-05-18,Assembly,"Do pass as amended",11,0,0,5,16
1590372,1210296,2022-05-26,Assembly,"AB 2070 Bauer-Kahan Assembly Third Reading",58,0,0,20,78
1590373,1174523,2022-03-21,Assembly,"Do pass and be re-referred to the Committee on [Appropriations]",15,0,0,0,15
1590373,1206323,2022-05-19,Assembly,"Do pass",16,0,0,0,16
1590373,1210624,2022-05-25,Assembly,"AB 2071 Patterson Assembly Third Reading",76,0,0,2,78
1590373,1220618,2022-06-28,Senate,"Do pass, but first be re-referred to the Committee on [Appropriations] with the recommendation: To Consent Calendar",17,0,0,0,17
1590373,1222843,2022-08-01,Senate,"Placed on suspense file",7,0,0,0,7
1590374,1176492,2022-03-23,Assembly,"Do pass and be re-referred to the Committee on [Health]",7,0,0,0,7
1590374,1183601,2022-04-05,Assembly,"Do pass and be re-referred to the Committee on [Appropriations] with recommendation: To Consent Calendar",14,0,0,1,15
1590374,1206656,2022-05-19,Assembly,"Do pass",16,0,0,0,16
1590374,1210648,2022-05-25,Assembly,"AB 2072 Gabriel Assembly Third Reading",76,0,0,2,78
1590374,1216287,2022-06-15,Senate,"Do pass, but first be re-referred to the Committee on [Appropriations] with the recommendation: To Consent Calendar",6,0,0,1,7
1590374,1219517,2022-06-27,Senate,"Placed on suspense file",6,0,0,1,7
1590374,1223524,2022-08-11,Senate,"Do pass",7,0,0,0,7
1590374,1224483,2022-08-23,Senate,"Special Consent AB2072",40,0,0,0,40
1590374,1224765,2022-08-24,Assembly,"AB 2072 Gabriel Concurrence in Senate Amendments",74,0,0,6,80
1590378,1174522,2022-03-21,Assembly,"Do pass and be re-referred to the Committee on [Appropriations]",11,0,0,4,15
1590379,1179277,2022-03-21,Assembly,"Do pass and be re-referred to the Committee on [Utilities and Energy]",8,0,0,3,11
1590379,1194184,2022-04-27,Assembly,"Do pass as amended and be re-referred to the Committee on [Appropriations]",12,0,0,3,15
1590379,1203396,2022-05-11,Assembly,"Do pass",12,4,0,0,16
1590379,1210555,2022-05-25,Assembly,"AB 2075 Ting Assembly Third Reading",60,9,0,9,78
1590379,1215886,2022-06-13,Senate,"Do pass, but first be re-referred to the Committee on [Energy, Utilities and Communications] with the recommendation: To Consent Calendar",9,0,0,0,9
1590379,1219425,2022-06-27,Senate,"Do pass, but first be re-referred to the Committee on [Appropriations] with the recommendation: To Consent Calendar",13,0,0,1,14
1590379,1224200,2022-08-18,Senate,"Assembly 3rd Reading AB2075 Ting By Dahle",38,0,0,2,40
1590380,1179405,2022-03-21,Assembly,"Do pass as amended and be re-referred to the Committee on [Health]",10,0,0,1,11
1590380,1193369,2022-04-26,Assembly,"Do pass as amended and be re-referred to the Committee on [Appropriations]",13,0,0,2,15
1590380,1206689,2022-05-19,Assembly,"Do pass as amended",12,0,0,4,16
1590380,1210463,2022-05-25,Assembly,"AB 2076 Luz Rivas Assembly Third Reading",73,1,0,4,78
1590380,1214989,2022-06-08,Senate,"Do pass, but first be re-referred to the Committee on [Health]",4,0,0,3,7
1590380,1218615,2022-06-22,Senate,"Do pass, but first be re-referred to the Committee on [Appropriations]",8,0,0,3,11
1590380,1222923,2022-08-01,Senate,"Placed on suspense file",7,0,0,0,7
1590382,1174551,2022-03-22,Assembly,"Do pass as amended, and be re-referred to the Committee on [Appropriations] with recommendation: To Consent Calendar",14,0,0,0,14
1590382,1206808,2022-05-19,Assembly,"Do pass",16,0,0,0,16
1590382,1210492,2022-05-25,Assembly,"AB 2077 Calderon Assembly Third Reading",76,0,0,2,78
1590382,1214981,2022-06-08,Senate,"Do pass, but first be re-referred to the Committee on [Appropriations] with the recommendation: To Consent Calendar",9,0,0,2,11
1590382,1217069,2022-06-20,Senate,"Placed on suspense file",4,0,0,3,7
1590382,1223782,2022-08-11,Senate,"Do pass as amended",7,0,0,0,7
1590382,1224617,2022-08-23,Senate,"Special Consent AB2077",40,0,0,0,40
1590382,1224861,2022-08-24,Assembly,"AB 2077 Calderon Concurrence in Senate Amendments",77,0,0,3,80
1590384,1183852,2022-04-05,Assembly,"Do pass and be re-referred to the Committee on [Appropriations] with recommendation: To Consent Calendar",13,0,0,2,15
1590385,1179263,2022-03-29,Assembly,"Do pass as amended and be re-referred to the Committee on [Appropriations]",10,1,0,4,15
1590385,1206692,2022-05-19,Assembly,"Do pass",12,4,0,0,16
1590385,1210432,2022-05-25,Assembly,"AB 2079 Wood Assembly Third Reading",52,14,0,12,78
1590385,1221240,2022-06-29,Senate,"Do pass as amended, but first amend, and re-refer to the Committee on [Appropriations]",8,0,0,3,11
1590385,1223288,2022-08-08,Senate,"Placed on suspense file",7,0,0,0,7
1590385,1223711,2022-08-11,Senate,"Do pass",7,0,0,0,7
1590385,1224722,2022-08-24,Senate,"Assembly 3rd Reading AB2079 Wood By Stern",40,0,0,0,40
1590385,1225025,2022-08-25,Assembly,"AB 2079 Wood Concurrence in Senate Amendments",59,12,0,9,80
1590386,1193332,2022-04-26,Assembly,"Do pass and be re-referred to the Committee on [Judiciary]",11,3,0,1,15
1590386,1195781,2022-04-28,Assembly,"Do pass as amended and be re-referred to the Committee on [Appropriations]",7,3,0,0,10
1590386,1206406,2022-05-19,Assembly,"Do pass as amended",12,4,0,0,16
1590386,1210300,2022-05-26,Assembly,"AB 2080 Wood Assembly Third Reading",45,19,0,14,78
1590388,1176484,2022-03-23,Assembly,"Do pass and be re-referred to the Committee on [Appropriations]",8,0,0,0,8
1590388,1194230,2022-04-27,Assembly,"Do pass",15,0,0,1,16
1590388,1198240,2022-05-02,Assembly,"AB 2081 Eduardo Garcia Assembly Third Reading",70,0,0,7,77
1590388,1211894,2022-06-01,Senate,"Do pass, but first be re-referred to the Committee on [Appropriations]",5,0,0,0,5
1590388,1224587,2022-08-23,Senate,"Assembly 3rd Reading AB2081 Eduardo Garcia et al By Jones",40,0,0,0,40
1590388,1224742,2022-08-24,Assembly,"AB 2081 Eduardo Garcia Concurrence in Senate Amendments",75,0,0,5,80
1590390,1191349,2022-04-20,Assembly,"Do pass and be re-referred to the Committee on [Appropriations]",7,0,0,0,7
1590391,1183681,2022-04-05,Assembly,"Do pass and be re-referred to the Committee on [Utilities and Energy]",3,3,0,1,7
1590391,1194115,2022-04-27,Assembly,"Do pass as amended and be re-referred to the Committee on [Appropriations]",9,1,0,5,15
1590391,1205838,2022-05-18,Assembly,"Do pass",11,0,0,5,16
1590391,1210400,2022-05-25,Assembly,"AB 2083 Bauer-Kahan Assembly Third Reading",57,0,0,21,78
1590391,1217349,2022-06-21,Senate,"Do pass as amended, but first amend, and re-refer to the Committee on [Appropriations]",12,0,0,2,14
1590391,1224129,2022-08-17,Senate,"Assembly 3rd Reading AB2083 Bauer-Kahan By Dodd",38,0,0,2,40
1590391,1224352,2022-08-22,Assembly,"AB 2083 Bauer-Kahan Concurrence in Senate Amendments",68,0,0,12,80
1590394,1189917,2022-04-19,Assembly,"Do pass and be re-referred to the Committee on [Appropriations]",5,2,0,0,7
1590394,1207686,2022-05-23,Assembly,"AB 2085 Holden Assembly Third Reading",53,2,0,23,78
1590394,1217384,2022-06-21,Senate,"Do pass",4,0,0,1,5
1590394,1224313,2022-08-22,Senate,"Assembly 3rd Reading AB2085 Holden By Kamlager",31,1,0,8,40
1590394,1224567,2022-08-23,Assembly,"AB 2085 Holden Concurrence in Senate Amendments",62,5,0,13,80
1590397,1189915,2022-04-19,Assembly,"Do pass as amended and be re-referred to the Committee on [Appropriations]",15,1,0,3,19
1590399,1176512,2022-03-23,Assembly,"Do pass as amended and be re-referred to the Committee on [Appropriations]",7,0,0,0,7
1590400,1183737,2022-04-05,Assembly,"Do pass and be re-referred to the Committee on [Privacy and Consumer Protection]",12,1,0,2,15
1590400,1190002,2022-04-19,Assembly,"Do pass as amended",10,0,0,1,11
1590400,1206364,2022-05-19,Assembly,"Do pass",13,0,0,3,16
1590400,1210334,2022-05-26,Assembly,"AB 2089 Bauer-Kahan Assembly Third Reading",70,1,0,7,78
1590400,1217990,2022-06-21,Senate,"Do pass, but first be re-referred to the Committee on [Health]",11,0,0,0,11
1590400,1221342,2022-06-29,Senate,"Do pass, but first be re-referred to the Committee on [Appropriations]",10,0,0,1,11
1590400,1224126,2022-08-17,Senate,"Assembly 3rd Reading AB2089 Bauer-Kahan et al. By Eggman",38,0,0,2,40
1590400,1224387,2022-08-22,Assembly,"AB 2089 Bauer-Kahan Concurrence in Senate Amendments",75,0,0,5,80
1590401,1193228,2022-04-26,Assembly,"Do pass and be re-referred to the Committee on [Appropriations]",7,0,0,1,8
1590402,1183632,2022-04-05,Assembly,"Do pass as amended and be re-referred to the Committee on [Health]",7,2,0,1,10
1590402,1193166,2022-04-26,Assembly,"Do pass and be re-referred to the Committee on [Appropriations]",10,3,0,2,15
1590402,1203381,2022-05-11,Assembly,"Do pass",12,4,0,0,16
1590402,1204135,2022-05-12,Assembly,"AB 2091 BONTA, M. Assembly Third Reading Amend By BONTA, M. Set #1",50,14,0,14,78
1590402,1210417,2022-05-26,Assembly,"AB 2091 Mia Bonta Third Reading Urgency",54,16,0,8,78
1590402,1216381,2022-06-14,Senate,"Do pass, but first be re-referred to the Committee on [Health]",9,2,0,0,11
1590402,1221278,2022-06-29,Senate,"Do pass, but first be re-referred to the Committee on [Appropriations]",8,2,0,1,11
1590402,1225569,2022-08-31,Senate,"Assembly 3rd Reading AB2091 Mia Bonta et al. By Gonzalez Urgency Clause",30,9,0,1,40
1590402,1225570,2022-08-31,Assembly,"AB 2091 BONTA, M. Concurrence in Senate Amendments",61,15,0,4,80
1590404,1190569,2022-04-19,Assembly,"Do pass as amended and be re-referred to the Committee on [Appropriations]",12,0,0,0,12
1590405,1175544,2022-03-23,Assembly,"Do pass and be re-referred to the Committee on [Local Government] with recommendation: To Consent Calendar",8,0,0,0,8
1590405,1190632,2022-04-20,Assembly,"Do pass and be re-referred to the Committee on [Appropriations]",8,0,0,0,8
1590405,1200010,2022-05-04,Assembly,"Do pass",14,0,0,2,16
1590405,1201457,2022-05-09,Assembly,"AB 2094 Robert Rivas Assembly Third Reading",65,0,0,13,78
1590405,1211869,2022-05-31,Senate,"Do pass, but first be re-referred to the Committee on [Appropriations] with the recommendation: To Consent Calendar",8,0,0,1,9
1590405,1225390,2022-08-29,Senate,"Assembly 3rd Reading AB2094 Robert Rivas et al. By Cortese",39,0,0,1,40
1590405,1225391,2022-08-30,Assembly,"AB 2094 Robert Rivas Concurrence in Senate Amendments",75,0,0,5,80
1590406,1181302,2022-03-30,Assembly,"Do pass and be re-referred to the Committee on [Appropriations]",4,2,0,0,6
1590407,1193188,2022-04-26,Assembly,"Do pass and be re-referred to the Committee on [Appropriations] with recommendation: To Consent Calendar",14,0,0,1,15
1590407,1203316,2022-05-11,Assembly,"Do pass. To Consent Calendar",16,0,0,0,16
1590407,1206926,2022-05-19,Assembly,"AB 2096 Mullin Consent Calendar Second Day Regular Session",72,0,0,6,78
1590407,1221315,2022-06-29,Senate,"Do pass as amended, but first amend, and re-refer to the Committee on [Appropriations] with the recommendation: To Consent Calendar",10,0,0,1,11
1590407,1223885,2022-08-11,Senate,"Consent Calendar AB2096",38,0,0,2,40
1590407,1224216,2022-08-18,Assembly,"AB 2096 Mullin Concurrence in Senate Amendments",77,0,0,3,80
1590408,1190714,2022-04-20,Assembly,"Do pass and be re-referred to the Committee on [Housing and Community Development]",6,2,0,0,8
1590408,1194233,2022-04-27,Assembly,"Do pass and be re-referred to the Committee on [Appropriations]",6,1,0,1,8
1590408,1203334,2022-05-11,Assembly,"Do pass",13,3,0,0,16
1590408,1210406,2022-05-26,Assembly,"AB 2097 Friedman Assembly Third Reading",47,20,0,11,78
1590408,1216269,2022-06-15,Senate,"Do pass, but first be re-referred to the Committee on [Housing]",5,0,0,0,5
1590408,1217903,2022-06-21,Senate,"Do pass as amended, but first amend, and re-refer to the Committee on [Appropriations]",6,1,0,2,9
1590408,1223186,2022-08-08,Senate,"Placed on suspense file",7,0,0,0,7
1590408,1223721,2022-08-11,Senate,"Do pass as amended",5,2,0,0,7
1590408,1225645,2022-08-29,Senate,"Assembly 3rd Reading AB2097 Friedman et al. By Skinner",26,9,0,5,40
1590408,1225646,2022-08-30,Assembly,"AB 2097 Friedman Concurrence in Senate Amendments",52,17,0,11,80
1590409,1189933,2022-04-19,Assembly,"Do pass as amended and be re-referred to the Committee on [Appropriations]",12,5,0,2,19
1590409,1203329,2022-05-11,Assembly,"Do pass",12,4,0,0,16
1590409,1210445,2022-05-26,Assembly,"AB 2098 Low Assembly Third Reading",53,20,0,5,78
1590409,1219506,2022-06-27,Senate,"Do pass, but first be re-referred to the Committee on [Appropriations]",9,4,0,1,14
1590409,1222772,2022-08-01,Senate,"Placed on suspense file",7,0,0,0,7
1590409,1223357,2022-08-11,Senate,"Do pass",5,2,0,0,7
1590409,1225512,2022-08-29,Senate,"Assembly 3rd Reading AB2098 Low et al. By Pan",32,8,0,0,40
1590409,1225513,2022-08-30,Assembly,"AB 2098 Low Concurrence in Senate Amendments",56,20,0,4,80
1590409,1229728,2022-08-30,Senate,"Assembly 3rd Reading AB2098 Low et al. By Pan",32,8,0,0,40
1590411,1193278,2022-04-26,Assembly,"Do pass and be re-referred to the Committee on [Appropriations] with recommendation: To Consent Calendar",7,0,0,1,8
1590411,1206512,2022-05-19,Assembly,"Do pass",16,0,0,0,16
1590411,1210653,2022-05-25,Assembly,"AB 2100 Carrillo Assembly Third Reading",76,0,0,2,78
1590411,1217426,2022-06-20,Senate,"Do pass, but first be re-referred to the Committee on [Appropriations]",4,0,0,1,5
1590411,1222805,2022-08-01,Senate,"Placed on suspense file",7,0,0,0,7
1590412,1189351,2022-04-18,Assembly,"Do pass and be re-referred to the Committee on [Appropriations] with recommendation: To Consent Calendar",11,0,0,0,11
1590412,1203360,2022-05-11,Assembly,"Do pass. To Consent Calendar",16,0,0,0,16
1590412,1206871,2022-05-19,Assembly,"AB 2101 Flora Consent Calendar Second Day Regular Session",72,0,0,6,78
1590412,1215919,2022-06-14,Senate,"Do pass, but first be re-referred to the Committee on [Environmental Quality] with the recommendation: To Consent Calendar",9,0,0,0,9
1590412,1216409,2022-06-15,Senate,"Do pass, but first be re-referred to the Committee on [Appropriations] with the recommendation: To Consent Calendar",7,0,0,0,7
1590412,1221287,2022-06-30,Senate,"Consent Calendar AB2101",37,0,0,3,40
1590413,1179274,2022-03-29,Assembly,"Do pass as amended and be re-referred to the Committee on [Business and Professions]",10,0,0,0,10
1590413,1193423,2022-04-26,Assembly,"Do pass and be re-referred to the Committee on [Appropriations]",14,0,0,4,18
1590413,1203395,2022-05-11,Assembly,"Do pass",16,0,0,0,16
1590413,1210650,2022-05-25,Assembly,"AB 2102 Jones-Sawyer Assembly Third Reading",76,0,0,2,78
1590414,1189974,2022-04-19,Assembly,"Do pass and be re-referred to the Committee on [Appropriations] with recommendation: To Consent Calendar",7,0,0,0,7
1590416,1179228,2022-03-29,Assembly,"Do pass and be re-referred to the Committee on [Appropriations] with recommendation: To Consent Calendar",16,0,0,2,18
1590416,1194151,2022-04-27,Assembly,"Do pass. To Consent Calendar",15,0,0,1,16
1590416,1200662,2022-05-05,Assembly,"AB 2105 Smith Consent Calendar Second Day Regular Session",61,0,0,17,78
1590416,1214381,2022-06-06,Senate,"Do pass, but first be re-referred to the Committee on [Military and Veterans Affairs] with the recommendation: To Consent Calendar",12,0,0,2,14
1590416,1220081,2022-06-28,Senate,"Do pass, but first be re-referred to the Committee on [Appropriations] with the recommendation: To Consent Calendar",6,0,0,1,7
1590416,1223285,2022-08-08,Senate,"Consent Calendar AB2105",36,0,0,4,40
1590416,1223657,2022-08-11,Assembly,"AB 2105 Smith Concurrence in Senate Amendments",76,0,0,4,80
1590417,1175559,2022-03-22,Assembly,"Do pass and be re-referred to the Committee on [Appropriations]",6,2,0,1,9
1590417,1206946,2022-05-19,Assembly,"Do pass as amended",12,4,0,0,16
1590417,1210363,2022-05-25,Assembly,"AB 2106 Robert Rivas Assembly Third Reading",50,21,0,7,78
1590417,1220787,2022-06-29,Senate,"Do pass as amended, but first amend, and re-refer to the Committee on [Appropriations]",5,2,0,0,7
1590417,1222887,2022-08-01,Senate,"Placed on suspense file",7,0,0,0,7
1590417,1223921,2022-08-11,Senate,"Do pass as amended",5,2,0,0,7
1590417,1225915,2022-08-29,Senate,"Assembly 3rd Reading AB2106 Robert Rivas et al. By Hertzberg",27,11,0,2,40
1590417,1225916,2022-08-30,Assembly,"AB 2106 Robert Rivas Concurrence in Senate Amendments",52,21,0,7,80
1590418,1183622,2022-04-05,Assembly,"Do pass as amended and be re-referred to the Committee on [Appropriations]",16,0,0,2,18
1590418,1194129,2022-04-27,Assembly,"Do pass",15,0,0,1,16
1590418,1210371,2022-05-25,Assembly,"AB 2107 Flora Third Reading Urgency",76,0,0,2,78
1590418,1215831,2022-06-13,Senate,"Do pass, but first be re-referred to the Committee on [Appropriations]",13,0,0,1,14
1590418,1219412,2022-06-27,Senate,"Placed on suspense file",6,0,0,1,7
1590418,1223462,2022-08-11,Senate,"Do pass",7,0,0,0,7
1590418,1226001,2022-08-31,Senate,"Assembly 3rd Reading AB2107 Flora By Newman Urgency Clause",40,0,0,0,40
1590418,1226002,2022-08-31,Assembly,"AB 2107 FLORA Concurrence in Senate Amendments",77,0,0,3,80
1590419,1175538,2022-03-22,Assembly,"Do pass and be re-referred to the Committee on [Water, Parks, and Wildlife]",6,1,0,2,9
1590419,1193391,2022-04-26,Assembly,"Do pass and be re-referred to the Committee on [Appropriations]",11,3,0,1,15
1590419,1206838,2022-05-19,Assembly,"Do pass as amended",12,4,0,0,16
1590419,1210243,2022-05-25,Assembly,"AB 2108 Robert Rivas Assembly Third Reading",52,19,0,7,78
1590419,1216362,2022-06-15,Senate,"Do pass as amended, but first amend, and re-refer to the Committee on [Natural Resources and Water]",5,1,0,1,7
1590419,1219973,2022-06-28,Senate,"Do pass, but first be re-referred to the Committee on [Appropriations]",7,2,0,0,9
1590419,1222683,2022-08-01,Senate,"Placed on suspense file",7,0,0,0,7
1590419,1223692,2022-08-11,Senate,"Do pass as amended",5,2,0,0,7
1590419,1225324,2022-08-29,Senate,"Assembly 3rd Reading AB2108 Robert Rivas et al. By Lim贸n",31,9,0,0,40
1590419,1225325,2022-08-30,Assembly,"AB 2108 Robert Rivas Concurrence in Senate Amendments",55,18,0,7,80
1590420,1183597,2022-04-05,Assembly,"Do pass and be re-referred to the Committee on [Appropriations]",10,0,0,5,15
1590420,1194190,2022-04-27,Assembly,"Do pass",11,4,0,1,16
1590420,1210209,2022-05-27,Assembly,"AB 2109 Bennett Assembly Third Reading",58,6,0,14,78
1590420,1217090,2022-06-20,Senate,"Do pass, but first be re-referred to the Committee on [Appropriations]",7,0,0,2,9
1590420,1224419,2022-08-23,Senate,"Assembly 3rd Reading AB2109 Bennett et al. By Laird",34,2,0,4,40
1590420,1224834,2022-08-24,Assembly,"AB 2109 Bennett Concurrence in Senate Amendments",65,1,0,14,80
1590424,1175541,2022-03-22,Assembly,"Do pass and be re-referred to the Committee on [Appropriations]",9,0,0,0,9
1590425,1182557,2022-04-04,Assembly,"Do pass and be re-referred to the Committee on [Appropriations]",7,3,0,0,10
1590425,1194140,2022-04-27,Assembly,"Do pass",12,2,0,2,16
1590425,1200663,2022-05-05,Assembly,"AB 2114 Kalra Assembly Third Reading",53,7,0,18,78
1590425,1211843,2022-06-01,Senate,"Do pass as amended, but first amend, and re-refer to the Committee on [Appropriations]",7,1,0,1,9
1590425,1217077,2022-06-20,Senate,"Placed on suspense file",4,0,0,3,7
1590427,1195855,2022-04-27,Assembly,"Do pass as amended and be re-referred to the Committee on [Appropriations]",7,0,0,0,7
1590427,1206715,2022-05-19,Assembly,"Do pass",16,0,0,0,16
1590427,1210645,2022-05-25,Assembly,"AB 2116 McCarty Assembly Third Reading",76,0,0,2,78
1590427,1216390,2022-06-15,Senate,"Do pass, but first be re-referred to the Committee on [Appropriations] with the recommendation: To Consent Calendar",6,0,0,1,7
1590427,1222846,2022-08-01,Senate,"Placed on suspense file",7,0,0,0,7
1590428,1193197,2022-04-26,Assembly,"Do pass. To Consent Calendar",14,0,0,1,15
1590428,1200664,2022-05-05,Assembly,"AB 2117 Gipson Consent Calendar Second Day Regular Session",61,0,0,17,78
1590428,1218617,2022-06-22,Senate,"Do pass, but first be re-referred to the Committee on [Appropriations] with the recommendation: To Consent Calendar",9,0,0,2,11
1590428,1222730,2022-08-01,Senate,"Placed on suspense file",7,0,0,0,7
1590428,1223752,2022-08-11,Senate,"Do pass",7,0,0,0,7
1590428,1225311,2022-08-29,Senate,"Assembly 3rd Reading AB2117 Gipson By Rubio",40,0,0,0,40
1590428,1225312,2022-08-30,Assembly,"AB 2117 Gipson Concurrence in Senate Amendments",79,0,0,1,80
1590430,1184702,2022-04-05,Assembly,"Do pass and be re-referred to the Committee on [Appropriations]",8,0,0,1,9
1590430,1206690,2022-05-19,Assembly,"Do pass",16,0,0,0,16
1590430,1210619,2022-05-25,Assembly,"AB 2119 Flora Assembly Third Reading",76,0,0,2,78
1590430,1215760,2022-06-14,Senate,"Do pass, but first be re-referred to the Committee on [Human Services]",4,0,0,3,7
1590430,1220051,2022-06-27,Senate,"Do pass, but first be re-referred to the Committee on [Appropriations]",5,0,0,0,5
1590430,1222861,2022-08-01,Senate,"Placed on suspense file",7,0,0,0,7
1590430,1223390,2022-08-11,Senate,"Do pass as amended",7,0,0,0,7
1590430,1224613,2022-08-23,Senate,"Special Consent AB2119",40,0,0,0,40
1590430,1225159,2022-08-30,Assembly,"With recommendation: That Senate amendments be concurred in",8,0,0,0,8
1590430,1225923,2022-08-31,Assembly,"AB 2119 Flora Concurrence in Senate Amendments",80,0,0,0,80
1590431,1181293,2022-03-28,Assembly,"Do pass and be re-referred to the Committee on [Appropriations]",14,0,0,1,15
1590432,1176518,2022-03-23,Assembly,"Do pass and be re-referred to the Committee on [Appropriations]",7,0,0,0,7
1590432,1206287,2022-05-19,Assembly,"Do pass",16,0,0,0,16
1590432,1210629,2022-05-25,Assembly,"AB 2121 Eduardo Garcia Assembly Third Reading",76,0,0,2,78
1590432,1216327,2022-06-15,Senate,"Do pass, but first be re-referred to the Committee on [Appropriations] with the recommendation: To Consent Calendar",6,0,0,1,7
1590432,1219507,2022-06-27,Senate,"Placed on suspense file",6,0,0,1,7
1590432,1223969,2022-08-11,Senate,"Do pass",7,0,0,0,7
1590432,1224616,2022-08-23,Senate,"Special Consent AB2121",40,0,0,0,40
1590433,1183598,2022-04-05,Assembly,"Do pass and be re-referred to the Committee on [Appropriations]",10,0,0,2,12
1590433,1194183,2022-04-27,Assembly,"Do pass. To Consent Calendar",15,0,0,1,16
1590433,1200665,2022-05-05,Assembly,"AB 2122 Choi Consent Calendar Second Day Regular Session",61,0,0,17,78
1590433,1214990,2022-06-08,Senate,"Do pass, but first be re-referred to the Committee on [Appropriations] with the recommendation: To Consent Calendar",7,0,0,0,7
1590433,1223792,2022-08-11,Senate,"Consent Calendar AB2122",38,0,0,2,40
1590434,1193152,2022-04-25,Assembly,"Be adopted. To Consent Calendar",15,0,0,0,15
1590434,1195777,2022-04-28,Assembly,"ACR 138 Flora Consent Calendar Second Day Regular Session",71,0,0,6,77
1590434,1220702,2022-06-28,Senate,"Be adopted, but first be re-referred to the Committee on [Appropriations] with recommendation: To Consent Calendar",16,0,0,1,17
1590434,1223051,2022-08-04,Senate,"Special Consent ACR138",35,0,0,5,40
1590435,1170591,2022-03-15,Assembly,"Be adopted. To third reading",9,1,0,2,12
1590436,1191276,2022-04-21,Assembly,"Be adopted. To third reading",9,0,0,2,11
1590437,1189937,2022-04-19,Senate,"Do pass, but first be re-referred to the Committee on [Appropriations]",4,1,0,0,5
1590437,1201492,2022-05-09,Senate,"Placed on suspense file",7,0,0,0,7
1590437,1206352,2022-05-19,Senate,"Do pass as amended",5,2,0,0,7
1590437,1210015,2022-05-26,Senate,"Senate 3rd Reading SB1000 Becker",25,8,0,7,40
1590437,1217334,2022-06-21,Assembly,"Do pass and be re-referred to the Committee on [Appropriations]",5,2,0,0,7
1590438,1183619,2022-04-05,Senate,"Do pass, but first be re-referred to the Committee on [Judiciary]",11,0,0,4,15
1590438,1194216,2022-04-26,Senate,"Do pass, but first be re-referred to the Committee on [Appropriations] with the recommendation: To Consent Calendar",11,0,0,0,11
1590438,1201436,2022-05-09,Senate,"Placed on suspense file",7,0,0,0,7
1590438,1206483,2022-05-19,Senate,"Do pass",7,0,0,0,7
1590438,1209254,2022-05-25,Senate,"Special Consent SB1001",39,0,0,1,40
1590438,1215737,2022-06-14,Assembly,"Do pass and be re-referred to the Committee on [Appropriations]",9,0,0,2,11
1590438,1223578,2022-08-11,Assembly,"Do pass as amended",12,0,0,4,16
1590438,1225460,2022-08-31,Senate,"Unfinished Business SB1001 Min Concurrence",40,0,0,0,40
1590438,1225461,2022-08-31,Assembly,"SB 1001 Min Senate Third Reading By Petrie-Norris",78,0,0,2,80
1590439,1183656,2022-04-04,Senate,"Do pass, but first be re-referred to the Committee on [Appropriations]",5,0,0,0,5
1590439,1198312,2022-05-02,Senate,"Senate 3rd Reading SB1002 Portantino",36,0,0,4,40
1590439,1217984,2022-06-22,Assembly,"Do pass and be re-referred to the Committee on [Appropriations] with recommendation: To Consent Calendar",11,1,0,2,14
1590439,1219196,2022-06-22,Assembly,"Do pass and be re-referred to the Committee on [Appropriations]",11,1,0,2,14
1590439,1222950,2022-08-03,Assembly,"Do pass. To Consent Calendar",15,0,0,1,16
1590439,1223542,2022-08-11,Assembly,"SB 1002 Portantino Consent Calendar Second Day Regular Session",76,0,0,4,80
1590439,1225303,2022-08-31,Senate,"Unfinished Business SB1002 Portantino et al. Concurrence",40,0,0,0,40
1590439,1225304,2022-08-31,Assembly,"SB 1002 Portantino Senate Third Reading By Luz Rivas",79,0,0,1,80
1590440,1180222,2022-03-30,Senate,"Do pass, but first be re-referred to the Committee on [Appropriations]",11,0,0,0,11
1590440,1189324,2022-04-18,Senate,"Placed on suspense file",7,0,0,0,7
1590440,1206344,2022-05-19,Senate,"Do pass as amended",7,0,0,0,7
1590440,1209996,2022-05-26,Senate,"Special Consent SB1003",38,0,0,2,40
1590440,1220006,2022-06-28,Assembly,"Do pass and be re-referred to the Committee on [Appropriations] with recommendation: To Consent Calendar",15,0,0,0,15
1590442,1179259,2022-03-29,Senate,"Do pass and be ordered to the Consent Calendar",11,0,0,0,11
1590442,1185697,2022-04-07,Senate,"Consent Calendar SB1005",37,0,0,3,40
1590442,1211844,2022-06-01,Assembly,"Do pass. To Consent Calendar",10,0,0,1,11
1590442,1215307,2022-06-09,Assembly,"SB 1005 Wieckowski Consent Calendar Second Day Regular Session",69,0,0,9,78
1590442,1216622,2022-06-16,Senate,"Special Consent SB1005",35,0,0,5,40
1590443,1170614,2022-03-15,Senate,"Do pass, but first be re-referred to the Committee on [Appropriations]",3,0,0,2,5
1590443,1182543,2022-04-04,Senate,"Placed on suspense file",6,0,0,1,7
1590444,1170586,2022-03-15,Senate,"Do pass, but first be re-referred to the Committee on [Appropriations] with the recommendation: To Consent Calendar",14,0,0,1,15
1590444,1185706,2022-04-07,Senate,"Consent Calendar SB1007 Pan et al. Urgency Clause",37,0,0,3,40
1590444,1220732,2022-06-29,Assembly,"Do pass and be re-referred to the Committee on [Appropriations]",8,0,0,3,11
1590445,1194252,2022-04-26,Senate,"Do pass, but first be re-referred to the Committee on [Appropriations]",4,0,0,1,5
1590445,1201442,2022-05-09,Senate,"Placed on suspense file",7,0,0,0,7
1590445,1206608,2022-05-19,Senate,"Do pass as amended",5,2,0,0,7
1590445,1209952,2022-05-26,Senate,"Senate 3rd Reading SB1008 Becker",23,6,0,11,40
1590445,1215872,2022-06-14,Assembly,"Do pass as amended and be re-referred to the Committee on [Communications and Conveyance]",5,1,0,2,8
1590445,1220804,2022-06-29,Assembly,"Do pass as amended and be re-referred to the Committee on [Appropriations]",7,3,0,3,13
1590445,1223634,2022-08-11,Assembly,"Do pass as amended",12,4,0,0,16
1590445,1225728,2022-08-30,Senate,"Unfinished Business SB1008 Becker et al. Concurrence",27,7,0,6,40
1590445,1225729,2022-08-30,Assembly,"SB 1008 Becker Senate Third Reading By Mia Bonta",56,16,0,8,80
1590447,1179171,2022-03-29,Senate,"Do pass, but first be re-referred to the Committee on [Environmental Quality]",11,3,0,1,15
1590447,1190553,2022-04-20,Senate,"Do pass as amended, but first amend, and re-refer to the Committee on [Appropriations]",5,1,0,1,7
1590447,1201348,2022-05-09,Senate,"Placed on suspense file",7,0,0,0,7
1590447,1206426,2022-05-19,Senate,"Do pass as amended",5,2,0,0,7
1590447,1208473,2022-05-24,Senate,"Senate 3rd Reading SB1010 Skinner",30,7,0,3,40
1590447,1220737,2022-06-29,Assembly,"Do pass as amended and be re-referred to the Committee on [Appropriations]",5,2,0,0,7
1590447,1223651,2022-08-11,Assembly,"Do pass as amended",12,4,0,0,16
1590447,1225730,2022-08-30,Senate,"Unfinished Business SB1010 Skinner et al. Concurrence",28,9,0,3,40
1590447,1225731,2022-08-30,Assembly,"SB 1010 Skinner Senate Third Reading By Wilson",59,17,0,4,80
1590448,1179258,2022-03-29,Senate,"Do pass, but first be re-referred to the Committee on [Appropriations] with the recommendation: To Consent Calendar",14,0,0,1,15
1590448,1191304,2022-04-21,Senate,"Consent Calendar SB1011 G.O",39,0,0,1,40
1590448,1214976,2022-06-08,Assembly,"Do pass and be re-referred to the Committee on [Appropriations] with recommendation: To Consent Calendar",21,0,0,1,22
1590448,1217925,2022-06-22,Assembly,"Do pass. To Consent Calendar",13,0,0,3,16
1590448,1221571,2022-06-29,Assembly,"SB 1011 G.O. Consent Calendar Second Day Regular Session",78,0,0,2,80
1590449,1174577,2022-03-22,Senate,"Do pass as amended, but first amend, and re-refer to the Committee on [Appropriations] with the recommendation: To Consent Calendar",8,0,0,1,9
1590449,1182503,2022-04-04,Senate,"Placed on suspense file",6,0,0,1,7
1590449,1206566,2022-05-19,Senate,"Do pass",7,0,0,0,7
1590449,1209332,2022-05-25,Senate,"Special Consent SB1012",39,0,0,1,40
1590449,1220057,2022-06-28,Assembly,"Do pass and be re-referred to the Committee on [Appropriations]",14,0,0,1,15
1590450,1190638,2022-04-20,Senate,"Do pass as amended, but first amend, and re-refer to the Committee on [Appropriations]",6,0,0,1,7
1590450,1201477,2022-05-09,Senate,"Placed on suspense file",7,0,0,0,7
1590450,1206503,2022-05-19,Senate,"Do pass as amended",6,1,0,0,7
1590450,1209369,2022-05-25,Senate,"Senate 3rd Reading SB1013 Atkins et al",39,0,0,1,40
1590450,1219358,2022-06-27,Assembly,"Do pass and be re-referred to the Committee on [Appropriations] with recommendation: To Consent Calendar",10,0,0,1,11
1590450,1223849,2022-08-11,Assembly,"Do pass",16,0,0,0,16
1590450,1225069,2022-08-29,Assembly,"Do pass",11,0,0,0,11
1590450,1225521,2022-08-31,Senate,"Unfinished Business SB1013 Atkins et al. Concurrence",38,0,0,2,40
1590450,1225522,2022-08-31,Assembly,"SB 1013 Atkins Senate Third Reading By Ting",78,0,0,2,80
1590451,1191257,2022-04-20,Senate,"Do pass as amended, but first amend, and re-refer to the Committee on [Appropriations]",7,1,0,3,11
1590451,1198265,2022-05-02,Senate,"Placed on suspense file",7,0,0,0,7
1590451,1207005,2022-05-19,Senate,"Do pass",5,2,0,0,7
1590451,1208495,2022-05-24,Senate,"Senate 3rd Reading SB1014 Hertzberg et al",25,10,0,5,40
1590451,1220089,2022-06-28,Assembly,"Do pass as amended and be re-referred to the Committee on [Appropriations]",10,3,0,2,15
1590451,1223690,2022-08-11,Assembly,"Do pass",12,4,0,0,16
1590452,1189948,2022-04-18,Senate,"Do pass, but first be re-referred to the Committee on [Transportation]",11,0,0,3,14
1590452,1194341,2022-04-26,Senate,"Do pass as amended, but first amend, and re-refer to the Committee on [Appropriations]",12,3,0,2,17
1590452,1204653,2022-05-16,Senate,"Placed on suspense file",6,0,0,1,7
1590453,1175548,2022-03-23,Senate,"Do pass, but first be re-referred to the Committee on [Appropriations] with the recommendation: To Consent Calendar",7,0,0,0,7
1590453,1182530,2022-04-04,Senate,"Placed on suspense file",6,0,0,1,7
1590453,1206900,2022-05-19,Senate,"Do pass",7,0,0,0,7
1590453,1209314,2022-05-25,Senate,"Special Consent SB1016",39,0,0,1,40
1590453,1220642,2022-06-29,Assembly,"Do pass and be re-referred to the Committee on [Appropriations]",6,0,0,1,7
1590453,1223728,2022-08-11,Assembly,"Do pass",16,0,0,0,16
1590453,1224358,2022-08-22,Assembly,"SB 1016 Portantino Senate Third Reading By Petrie-Norris",77,0,0,3,80
1590453,1225536,2022-08-30,Senate,"Special Consent SB1016",38,0,0,2,40
1590454,1190709,2022-04-19,Senate,"Do pass as amended, but first amend, and re-refer to the Committee on [Appropriations]",9,1,0,1,11
1590454,1201460,2022-05-09,Senate,"Placed on suspense file",7,0,0,0,7
1590454,1206519,2022-05-19,Senate,"Do pass as amended",5,2,0,0,7
1590454,1208455,2022-05-24,Senate,"Senate 3rd Reading SB1017 Eggman et al",28,9,0,3,40
1590454,1217330,2022-06-21,Assembly,"Do pass as amended",7,1,0,2,10
1590454,1224310,2022-08-22,Assembly,"SB 1017 Eggman Senate Third Reading By Wilson",54,9,0,17,80
1590454,1224857,2022-08-24,Senate,"Unfinished Business SB1017 Eggman et al. Concurrence",31,9,0,0,40
1590455,1194275,2022-04-26,Senate,"Do pass as amended, but first amend, and re-refer to the Committee on [Appropriations]",9,2,0,0,11
1590455,1204575,2022-05-16,Senate,"Placed on suspense file",6,0,0,1,7
1590455,1206789,2022-05-19,Senate,"Do pass as amended",5,2,0,0,7
1590455,1209366,2022-05-25,Senate,"Senate 3rd Reading SB1018 Pan",30,9,0,1,40
1590455,1217325,2022-06-21,Assembly,"Do pass as amended and be re-referred to the Committee on [Judiciary]",9,2,0,0,11
1590455,1220015,2022-06-28,Assembly,"Do pass as amended and be re-referred to the Committee on [Appropriations]",9,2,0,0,11
1590455,1223794,2022-08-11,Assembly,"Do pass as amended",12,4,0,0,16
1590455,1225541,2022-08-30,Senate,"Unfinished Business SB1018 Pan Concurrence",28,9,0,3,40
1590455,1225542,2022-08-30,Assembly,"SB 1018 Pan Senate Third Reading By Gabriel",51,21,0,8,80
1590456,1184647,2022-04-06,Senate,"Do pass as amended, but first amend, and re-refer to the Committee on [Appropriations]",10,0,0,1,11
1590456,1192207,2022-04-25,Senate,"Placed on suspense file",5,0,0,2,7
1590456,1206522,2022-05-19,Senate,"Do pass as amended",7,0,0,0,7
1590456,1210007,2022-05-26,Senate,"Special Consent SB1019",38,0,0,2,40
1590456,1217425,2022-06-21,Assembly,"Do pass as amended, and be re-referred to the Committee on [Appropriations] with recommendation: To Consent Calendar",15,0,0,0,15
1590456,1223354,2022-08-11,Assembly,"Do pass as amended",12,0,0,4,16
1590456,1225583,2022-08-30,Senate,"Unfinished Business SB1019 Gonzalez Concurrence",37,0,0,3,40
1590456,1225584,2022-08-30,Assembly,"SB 1019 Gonzalez Senate Third Reading By Aguiar-Curry",79,0,0,1,80
1590457,1193327,2022-04-26,Senate,"Do pass, but first be re-referred to the Committee on [Appropriations]",10,2,0,2,14
1590457,1201377,2022-05-09,Senate,"Placed on suspense file",7,0,0,0,7
1590457,1206965,2022-05-19,Senate,"Do pass",5,2,0,0,7
1590457,1209968,2022-05-26,Senate,"Senate 3rd Reading SB1020 Laird et al",30,8,0,2,40
1590457,1217846,2022-06-22,Assembly,"Do pass and be re-referred to the Committee on [Natural Resources]",12,0,0,3,15
1590457,1219498,2022-06-27,Assembly,"Do pass and be re-referred to the Committee on [Appropriations]",8,3,0,0,11
1590457,1223839,2022-08-11,Assembly,"Do pass as amended",12,4,0,0,16
1590457,1225063,2022-08-29,Assembly,"SB 1020 Laird Senate Third Reading By Eduardo Garcia",54,17,0,9,80
1590457,1225514,2022-08-30,Senate,"Unfinished Business SB1020 Laird et al. Concurrence",31,9,0,0,40
1590458,1189878,2022-04-19,Senate,"Do pass, but first be re-referred to the Committee on [Appropriations]",4,0,0,1,5
1590458,1198301,2022-05-02,Senate,"Placed on suspense file",7,0,0,0,7
1590458,1206357,2022-05-19,Senate,"Do pass",5,2,0,0,7
1590458,1208527,2022-05-24,Senate,"Senate 3rd Reading SB1021 Bradford",22,10,0,8,40
1590459,1190695,2022-04-19,Senate,"Do pass as amended, but first amend, and re-refer to the Committee on [Appropriations]",8,1,0,2,11
1590459,1198337,2022-05-02,Senate,"Placed on suspense file",7,0,0,0,7
1590460,1173491,2022-03-21,Senate,"Do pass, but first be re-referred to the Committee on [Military and Veterans Affairs] with the recommendation: To Consent Calendar",5,0,0,0,5
1590460,1193229,2022-04-26,Senate,"Do pass, but first be re-referred to the Committee on [Appropriations] with the recommendation: To Consent Calendar",5,0,0,2,7
1590460,1201347,2022-05-09,Senate,"Placed on suspense file",7,0,0,0,7
1590460,1206579,2022-05-19,Senate,"Do pass",7,0,0,0,7
1590460,1209393,2022-05-25,Senate,"Special Consent SB984",39,0,0,1,40
1590460,1217944,2022-06-22,Assembly,"Do pass and be re-referred to the Committee on [Military and Veterans Affairs] with recommendation: To Consent Calendar",7,0,0,0,7
1590460,1219895,2022-06-28,Assembly,"Do pass and be re-referred to the Committee on [Appropriations]",10,0,0,1,11
1590460,1223751,2022-08-11,Assembly,"Do pass",16,0,0,0,16
1590460,1225917,2022-08-31,Senate,"Unfinished Business SB984 Archuleta Concurrence",39,0,0,1,40
1590460,1225918,2022-08-31,Assembly,"SB 984 Archuleta Senate Third Reading By Ramos",80,0,0,0,80
1590461,1194441,2022-04-26,Senate,"Do pass, but first be re-referred to the Committee on [Appropriations] with the recommendation: To Consent Calendar",16,0,0,1,17
1590461,1204126,2022-05-12,Senate,"Consent Calendar SB985",35,0,0,5,40
1590461,1217352,2022-06-20,Assembly,"Do pass and be re-referred to the Committee on [Appropriations] with recommendation: To Consent Calendar",14,0,0,1,15
1590461,1223734,2022-08-11,Assembly,"Do pass as amended",12,0,0,4,16
1590461,1225974,2022-08-30,Senate,"Unfinished Business SB985 Hueso et al. Concurrence",40,0,0,0,40
1590461,1225975,2022-08-30,Assembly,"SB 985 Hueso Senate Third Reading By Alvarez",78,0,0,2,80
1590462,1183777,2022-04-04,Senate,"Do pass, but first be re-referred to the Committee on [Public Safety]",14,0,0,0,14
1590462,1194303,2022-04-26,Senate,"Do pass, but first be re-referred to the Committee on [Appropriations]",4,0,0,1,5
1590462,1201407,2022-05-09,Senate,"Placed on suspense file",7,0,0,0,7
1590462,1206905,2022-05-19,Senate,"Do pass as amended",7,0,0,0,7
1590462,1210004,2022-05-26,Senate,"Senate 3rd Reading SB986 Umberg et al",36,0,0,4,40
1590462,1217476,2022-06-20,Assembly,"Do pass and be re-referred to the Committee on [Public Safety]",13,0,0,2,15
1590462,1220005,2022-06-28,Assembly,"Do pass and be re-referred to the Committee on [Appropriations]",6,0,0,1,7
1590462,1223491,2022-08-11,Assembly,"Do pass as amended",12,0,0,4,16
1590462,1224715,2022-08-24,Assembly,"SB 986 Umberg Senate Third Reading By Jones-Sawyer Amendment Set #1",46,12,0,22,80
1590462,1225890,2022-08-30,Assembly,"SB 986 Umberg Senate Third Reading By Jones-Sawyer",19,10,0,51,80
1590463,1191268,2022-04-20,Senate,"Do pass as amended, but first amend, and re-refer to the Committee on [Appropriations]",8,0,0,3,11
1590463,1201450,2022-05-09,Senate,"Placed on suspense file",7,0,0,0,7
1590463,1206812,2022-05-19,Senate,"Do pass",6,1,0,0,7
1590463,1208524,2022-05-24,Senate,"Senate 3rd Reading SB987 Portantino",34,0,0,6,40
1590463,1220085,2022-06-28,Assembly,"Do pass as amended and be re-referred to the Committee on [Appropriations]",14,0,0,1,15
1590463,1223504,2022-08-11,Assembly,"Do pass",14,0,0,2,16
1590463,1225058,2022-08-29,Assembly,"SB 987 Portantino Senate Third Reading By Blanca Rubio",78,0,0,2,80
1590463,1225354,2022-08-31,Senate,"Unfinished Business SB987 Portantino et al. Concurrence",40,0,0,0,40
1590464,1180212,2022-03-30,Senate,"Do pass, but first be re-referred to the Committee on [Appropriations]",11,0,0,0,11
1590464,1201487,2022-05-09,Senate,"Senate 3rd Reading SB988 Hueso",33,0,0,7,40
1590464,1215754,2022-06-14,Assembly,"Do pass and be re-referred to the Committee on [Judiciary] with recommendation: To Consent Calendar",13,0,0,2,15
1590464,1220744,2022-06-29,Assembly,"Do pass. To Consent Calendar",14,0,0,2,16
1590464,1223037,2022-08-04,Assembly,"SB 988 Hueso Consent Calendar Second Day Regular Session",76,0,0,4,80
1590464,1224099,2022-08-16,Senate,"Unfinished Business SB988 Hueso Concurrence",37,0,0,3,40
1590465,1194202,2022-04-27,Senate,"Do pass, but first be re-referred to the Committee on [Appropriations]",5,0,0,2,7
1590465,1201420,2022-05-09,Senate,"Placed on suspense file",7,0,0,0,7
1590465,1206971,2022-05-19,Senate,"Do pass",5,2,0,0,7
1590465,1208520,2022-05-24,Senate,"Senate 3rd Reading SB989 Hertzberg",29,7,0,4,40
1590465,1220021,2022-06-27,Assembly,"Do pass as amended and be re-referred to the Committee on [Appropriations]",10,0,0,1,11
1590465,1223410,2022-08-11,Assembly,"Do pass as amended",12,0,0,4,16
1590465,1225766,2022-08-31,Senate,"Unfinished Business SB989 Hertzberg Urgency Clause Concurrence",37,0,0,3,40
1590465,1225767,2022-08-31,Assembly,"SB 989 Hertzberg Third Reading Urgency By Mullin",80,0,0,0,80
1590466,1179260,2022-03-29,Senate,"Do pass, but first be re-referred to the Committee on [Appropriations]",4,0,0,1,5
1590466,1192231,2022-04-25,Senate,"Placed on suspense file",5,0,0,2,7
1590466,1206603,2022-05-19,Senate,"Do pass as amended",5,2,0,0,7
1590466,1208470,2022-05-24,Senate,"Senate 3rd Reading SB990 Hueso",29,5,0,6,40
1590466,1217422,2022-06-21,Assembly,"Do pass and be re-referred to the Committee on [Appropriations]",5,2,0,0,7
1590466,1224050,2022-08-11,Assembly,"Do pass",12,4,0,0,16
1590466,1225106,2022-08-29,Assembly,"SB 990 Hueso Senate Third Reading By Mia Bonta",61,13,0,6,80
1590466,1225473,2022-08-30,Senate,"Unfinished Business SB990 Hueso Concurrence",31,8,0,1,40
1590467,1181269,2022-03-31,Senate,"Do pass, but first be re-referred to the Committee on [Appropriations]",5,0,0,0,5
1590467,1201498,2022-05-09,Senate,"Senate 3rd Reading SB991 Newman",33,0,0,7,40
1590467,1216643,2022-06-15,Assembly,"Do pass as amended and be re-referred to the Committee on [Appropriations]",8,0,0,0,8
1590467,1222957,2022-08-03,Assembly,"Do pass. To Consent Calendar",15,0,0,1,16
1590467,1224085,2022-08-15,Assembly,"SB 991 Newman Senate Third Reading By Aguiar-Curry",75,0,0,5,80
1590467,1224111,2022-08-16,Senate,"Unfinished Business SB991 Newman Concurrence",36,0,0,4,40
1590469,1183624,2022-04-05,Senate,"Do pass, but first be re-referred to the Committee on [Public Safety]",12,0,0,3,15
1590469,1194300,2022-04-26,Senate,"Do pass, but first be re-referred to the Committee on [Appropriations]",5,0,0,0,5
1590469,1201523,2022-05-09,Senate,"Placed on suspense file",7,0,0,0,7
1590469,1206999,2022-05-19,Senate,"Do pass as amended",5,2,0,0,7
1590469,1209293,2022-05-25,Senate,"Senate 3rd Reading SB993 Skinner et al",30,5,0,5,40
1590469,1215822,2022-06-14,Assembly,"Do pass as amended and be re-referred to the Committee on [Appropriations]",5,2,0,1,8
1590469,1223797,2022-08-11,Assembly,"Do pass as amended",12,4,0,0,16
1590470,1189343,2022-04-18,Senate,"Do pass as amended, but first amend, and re-refer to the Committee on [Appropriations]",12,0,0,2,14
1590470,1201387,2022-05-09,Senate,"Senate 3rd Reading SB994 Jones",33,0,0,7,40
1590470,1215931,2022-06-14,Assembly,"Do pass and be re-referred to the Committee on [Appropriations]",16,0,0,2,18
1590470,1220788,2022-06-29,Assembly,"Do pass. To Consent Calendar",14,0,0,2,16
1590470,1225038,2022-08-29,Assembly,"SB 994 Jones Senate Third Reading By Vince Fong",77,0,0,3,80
1590470,1225319,2022-08-30,Senate,"Unfinished Business SB994 Jones Concurrence",39,0,0,1,40
1590472,1190610,2022-04-19,Senate,"Do pass, but first be re-referred to the Committee on [Appropriations]",4,0,0,1,5
1590472,1198250,2022-05-02,Senate,"Placed on suspense file",7,0,0,0,7
1590472,1207000,2022-05-19,Senate,"Do pass",5,0,0,2,7
1590472,1208477,2022-05-24,Senate,"Senate 3rd Reading SB996 Kamlager",27,0,0,13,40
1590472,1219975,2022-06-28,Assembly,"Do pass and be re-referred to the Committee on [Appropriations]",6,1,0,1,8
1590473,1175531,2022-03-23,Senate,"Do pass, but first be re-referred to the Committee on [Appropriations]",7,0,0,0,7
1590473,1204626,2022-05-16,Senate,"Senate 3rd Reading SB997 Pan",32,0,0,8,40
1590473,1220578,2022-06-29,Assembly,"Do pass as amended, and be re-referred to the Committee on [Appropriations] with recommendation: To Consent Calendar",7,0,0,0,7
1590473,1222969,2022-08-03,Assembly,"Do pass. To Consent Calendar",15,0,0,1,16
1590473,1224290,2022-08-22,Assembly,"SB 997 Pan Senate Third Reading By Lee",77,0,0,3,80
1590473,1224891,2022-08-25,Senate,"Unfinished Business SB997 Pan Concurrence",40,0,0,0,40
1590475,1191311,2022-04-20,Senate,"Do pass as amended, but first amend, and re-refer to the Committee on [Appropriations]",9,0,0,2,11
1590475,1204595,2022-05-16,Senate,"Placed on suspense file",6,0,0,1,7
1590475,1206984,2022-05-19,Senate,"Do pass",5,2,0,0,7
1590475,1209242,2022-05-25,Senate,"Senate 3rd Reading SB999 Cortese et al",30,9,0,1,40
1590475,1219948,2022-06-28,Assembly,"Do pass as amended and be re-referred to the Committee on [Appropriations]",12,1,0,2,15
1590475,1223626,2022-08-11,Assembly,"Do pass",12,3,0,1,16
1590475,1224196,2022-08-18,Assembly,"SB 999 Cortese Senate Third Reading By Haney",54,9,0,17,80
1590475,1224751,2022-08-24,Senate,"Unfinished Business SB999 Cortese et al. Concurrence",31,9,0,0,40
1590476,1154480,2022-02-24,Senate,"Senate 3rd Reading SCR67 Bradford et al",38,0,0,2,40
1590476,1176495,2022-03-24,Assembly,"Be adopted. To Consent Calendar",10,0,0,1,11
1590476,1181256,2022-03-31,Assembly,"SCR 67 Bradford Consent Calendar Second Day Regular Session",68,0,0,8,76
1590477,1189919,2022-04-19,Senate,"Be adopted, but first be re-referred to the Committee on [Appropriations] with recommendation: To Consent Calendar",15,0,0,2,17
1590477,1195798,2022-04-28,Senate,"Consent Calendar SCR68",37,0,0,3,40
1590477,1219876,2022-06-27,Assembly,"Be adopted. To Consent Calendar",13,0,0,2,15
1590477,1221224,2022-06-30,Assembly,"SCR 68 Archuleta Consent Calendar Second Day Regular Session",79,0,0,1,80
1592374,1176505,2022-03-23,Assembly,"Do pass as amended and be re-referred to the Committee on [Appropriations]",7,0,0,0,7
1592374,1206809,2022-05-19,Assembly,"Do pass",15,0,0,1,16
1592374,1207711,2022-05-23,Assembly,"AB 2124 Cristina Garcia Assembly Third Reading",72,0,0,6,78
1592374,1216266,2022-06-15,Senate,"Do pass, but first be re-referred to the Committee on [Appropriations] with the recommendation: To Consent Calendar",6,0,0,1,7
1592374,1219349,2022-06-27,Senate,"Placed on suspense file",6,0,0,1,7
1592374,1223358,2022-08-11,Senate,"Do pass as amended",7,0,0,0,7
1592374,1224618,2022-08-23,Senate,"Special Consent AB2124",40,0,0,0,40
1592374,1224859,2022-08-24,Assembly,"AB 2124 Cristina Garcia Concurrence in Senate Amendments",77,0,0,3,80
1592375,1189863,2022-04-18,Assembly,"Do pass and be re-referred to the Committee on [Appropriations]",14,0,0,1,15
1592375,1206346,2022-05-19,Assembly,"Do pass as amended",16,0,0,0,16
1592375,1210613,2022-05-25,Assembly,"AB 2125 Fong Assembly Third Reading",76,0,0,2,78
1592375,1220606,2022-06-28,Senate,"Do pass, but first be re-referred to the Committee on [Appropriations] with the recommendation: To Consent Calendar",17,0,0,0,17
1592375,1222662,2022-08-01,Senate,"Placed on suspense file",7,0,0,0,7
1592376,1179296,2022-03-29,Assembly,"Do pass as amended and be re-referred to the Committee on [Appropriations]",7,0,0,0,7
1592377,1183722,2022-04-05,Assembly,"Do pass and be re-referred to the Committee on [Appropriations] with recommendation: To Consent Calendar",14,0,0,1,15
1592377,1194492,2022-04-27,Assembly,"Do pass. To Consent Calendar",15,0,0,1,16
1592377,1200666,2022-05-05,Assembly,"AB 2127 Santiago Consent Calendar Second Day Regular Session",61,0,0,17,78
1592377,1211873,2022-06-01,Senate,"Do pass, but first be re-referred to the Committee on [Appropriations] with the recommendation: To Consent Calendar",9,0,0,2,11
1592377,1219501,2022-06-27,Senate,"Consent Calendar AB2127",37,0,0,3,40
1592378,1174566,2022-03-22,Assembly,"Do pass and be re-referred to the Committee on [Appropriations]",15,0,0,0,15
1592378,1206462,2022-05-19,Assembly,"Do pass",16,0,0,0,16
1592378,1210635,2022-05-25,Assembly,"AB 2128 Cooley Assembly Third Reading",76,0,0,2,78
1592378,1215882,2022-06-14,Senate,"Do pass as amended, but first amend, and re-refer to the Committee on [Appropriations] with the recommendation: To Consent Calendar",9,0,0,0,9
1592378,1222924,2022-08-01,Senate,"Placed on suspense file",7,0,0,0,7
1592379,1190557,2022-04-20,Assembly,"Do pass and be re-referred to the Committee on [Appropriations] with recommendation: To Consent Calendar",13,0,0,1,14
1592379,1199928,2022-05-04,Assembly,"Do pass. To Consent Calendar",14,0,0,2,16
1592379,1204078,2022-05-12,Assembly,"AB 2129 Carrillo Consent Calendar Second Day Regular Session",65,0,0,13,78
1592379,1215031,2022-06-08,Senate,"Do pass, but first be re-referred to the Committee on [Appropriations] with the recommendation: To Consent Calendar",5,0,0,0,5
1592379,1221262,2022-06-30,Senate,"Consent Calendar AB2129",37,0,0,3,40
1592380,1179185,2022-03-29,Assembly,"Do pass and be re-referred to the Committee on [Emergency Management]",15,0,0,0,15
1592380,1192199,2022-04-25,Assembly,"Do pass and be re-referred to the Committee on [Appropriations] with recommendation: To Consent Calendar",7,0,0,0,7
1592380,1203352,2022-05-11,Assembly,"Do pass. To Consent Calendar",16,0,0,0,16
1592380,1206578,2022-05-19,Assembly,"AB 2130 Cunningham Consent Calendar Second Day Regular Session",72,0,0,6,78
1592380,1216377,2022-06-15,Senate,"Do pass as amended, but first amend, and re-refer to the Committee on [Appropriations] with the recommendation: To Consent Calendar",9,0,0,2,11
1592380,1219346,2022-06-27,Senate,"Placed on suspense file",6,0,0,1,7
1592380,1223538,2022-08-11,Senate,"Do pass",7,0,0,0,7
1592380,1224438,2022-08-23,Senate,"Special Consent AB2130",40,0,0,0,40
1592380,1224823,2022-08-24,Assembly,"AB 2130 Cunningham Concurrence in Senate Amendments",75,0,0,5,80
1592381,1183741,2022-04-05,Assembly,"Do pass and be re-referred to the Committee on [Education] with recommendation: To Consent Calendar",8,0,0,0,8
1592381,1191345,2022-04-20,Assembly,"Do pass as amended, and be re-referred to the Committee on [Appropriations] with recommendation: To Consent Calendar",7,0,0,0,7
1592381,1206727,2022-05-19,Assembly,"Do pass",16,0,0,0,16
1592381,1210540,2022-05-26,Assembly,"AB 2131 Mullin Assembly Third Reading",75,0,0,3,78
1592381,1215912,2022-06-13,Senate,"Do pass as amended, but first amend, and re-refer to the Committee on [Appropriations]",5,0,0,0,5
1592381,1219367,2022-06-27,Senate,"Placed on suspense file",6,0,0,1,7
1592381,1223425,2022-08-11,Senate,"Do pass as amended",7,0,0,0,7
1592381,1224565,2022-08-23,Senate,"Special Consent AB2131",40,0,0,0,40
1592381,1224684,2022-08-24,Assembly,"AB 2131 Mullin Concurrence in Senate Amendments",76,0,0,4,80
1592383,1181319,2022-03-30,Assembly,"Do pass and be re-referred to the Committee on [Appropriations]",4,1,0,1,6
1592383,1203354,2022-05-11,Assembly,"Do pass",12,4,0,0,16
1592383,1204634,2022-05-16,Assembly,"AB 2133 Medina Assembly Third Reading",51,14,0,13,78
1592383,1220752,2022-06-29,Senate,"Do pass",4,0,0,1,5
1592383,1224883,2022-08-25,Senate,"Do pass, but first be re-referred to the Committee on [Appropriations]",4,2,0,1,7
1592383,1225110,2022-08-29,Senate,"Do pass",4,2,0,1,7
1592383,1225377,2022-08-31,Senate,"Assembly 3rd Reading AB2133 Quirk et al. By Hertzberg",21,10,0,9,40
1592383,1225378,2022-08-31,Assembly,"AB 2133 QUIRK Concurrence in Senate Amendments",37,22,0,21,80
1592384,1193404,2022-04-26,Assembly,"Do pass as amended and be re-referred to the Committee on [Appropriations]",10,3,0,2,15
1592384,1206265,2022-05-19,Assembly,"Do pass",12,4,0,0,16
1592384,1210410,2022-05-26,Assembly,"AB 2134 Akilah Weber Assembly Third Reading",53,19,0,6,78
1592384,1218635,2022-06-22,Senate,"Do pass, but first be re-referred to the Committee on [Judiciary]",8,1,0,2,11
1592384,1220640,2022-06-28,Senate,"Do pass, but first be re-referred to the Committee on [Appropriations]",9,1,0,1,11
1592384,1222845,2022-08-01,Senate,"Placed on suspense file",7,0,0,0,7
1592384,1223689,2022-08-11,Senate,"Do pass",5,2,0,0,7
1592384,1225332,2022-08-29,Senate,"Assembly 3rd Reading AB2134 Akilah Weber et al. By Caballero",31,9,0,0,40
1592384,1225333,2022-08-30,Assembly,"AB 2134 Akilah Weber Concurrence in Senate Amendments",57,18,0,5,80
1592385,1189893,2022-04-19,Assembly,"Do pass and be re-referred to the Committee on [Accountability and Administrative Review]",11,0,0,0,11
1592385,1194146,2022-04-27,Assembly,"Do pass and be re-referred to the Committee on [Appropriations]",7,0,0,0,7
1592385,1206970,2022-05-19,Assembly,"Do pass",16,0,0,0,16
1592385,1210359,2022-05-25,Assembly,"AB 2135 Irwin Assembly Third Reading",76,0,0,2,78
1592385,1215746,2022-06-14,Senate,"Do pass, but first be re-referred to the Committee on [Judiciary] with the recommendation: To Consent Calendar",14,0,0,1,15
1592385,1218020,2022-06-21,Senate,"Do pass, but first be re-referred to the Committee on [Appropriations] with the recommendation: To Consent Calendar",11,0,0,0,11
1592385,1222678,2022-08-01,Senate,"Placed on suspense file",7,0,0,0,7
1592385,1223487,2022-08-11,Senate,"Do pass",7,0,0,0,7
1592385,1224628,2022-08-23,Senate,"Special Consent AB2135",40,0,0,0,40
1592387,1183687,2022-04-05,Assembly,"Do pass. To Consent Calendar",7,0,0,0,7
1592387,1191292,2022-04-21,Assembly,"AB 2137 Maienschein Consent Calendar Second Day Regular Session",68,0,0,9,77
1592387,1210925,2022-05-31,Senate,"Do pass and be ordered to the Consent Calendar",5,0,0,0,5
1592387,1215267,2022-06-09,Senate,"Consent Calendar AB2137",38,0,0,2,40
1592389,1190550,2022-04-20,Assembly,"Do pass as amended",8,0,0,0,8
1592389,1205843,2022-05-18,Assembly,"Do pass. To Consent Calendar",15,0,0,1,16
1592389,1210638,2022-05-25,Assembly,"AB 2139 Gallagher Consent Calendar Second Day Regular Session",73,0,0,5,78
1592389,1218035,2022-06-21,Senate,"Do pass, but first be re-referred to the Committee on [Appropriations] with the recommendation: To Consent Calendar",8,0,0,1,9
1592389,1223158,2022-08-08,Senate,"Consent Calendar AB2139",36,0,0,4,40
1592390,1192225,2022-04-25,Assembly,"Do pass and be re-referred to the Committee on [Utilities and Energy]",7,3,0,1,11
1592390,1194397,2022-04-27,Assembly,"Do pass as amended and be re-referred to the Committee on [Appropriations]",8,3,0,4,15
1592391,1192170,2022-04-25,Assembly,"Do pass and be re-referred to the Committee on [Appropriations]",7,3,0,1,11
1592391,1206731,2022-05-19,Assembly,"Do pass",12,4,0,0,16
1592391,1207848,2022-05-23,Assembly,"AB 2141 Eduardo Garcia Assembly Third Reading",54,18,0,6,78
1592392,1200511,2022-05-05,Assembly,"Do pass and be re-referred to the Committee on [Appropriations]",11,0,0,0,11
1592392,1206922,2022-05-19,Assembly,"Do pass",16,0,0,0,16
1592392,1210649,2022-05-25,Assembly,"AB 2142 Gabriel Assembly Third Reading",76,0,0,2,78
1592392,1216292,2022-06-15,Senate,"Do pass, but first be re-referred to the Committee on [Appropriations]",5,0,0,0,5
1592392,1219455,2022-06-27,Senate,"Placed on suspense file",6,0,0,1,7
1592392,1223435,2022-08-11,Senate,"Do pass",7,0,0,0,7
1592392,1224496,2022-08-23,Senate,"Special Consent AB2142",40,0,0,0,40
1592393,1184636,2022-04-06,Assembly,"Do pass as amended and be re-referred to the Committee on [Labor and Employment]",12,0,0,3,15
1592393,1191321,2022-04-20,Assembly,"Do pass and be re-referred to the Committee on [Appropriations]",4,1,0,2,7
1592393,1206587,2022-05-19,Assembly,"Do pass",11,4,0,1,16
1592393,1210655,2022-05-25,Assembly,"AB 2143 Carrillo Assembly Third Reading",55,18,0,5,78
1592393,1216281,2022-06-15,Senate,"Do pass as amended, but first amend, and re-refer to the Committee on [Labor, Public Employment and Retirement ]",11,3,0,0,14
1592393,1220783,2022-06-29,Senate,"Do pass as amended, but first amend, and re-refer to the Committee on [Appropriations]",3,2,0,0,5
1592393,1222667,2022-08-01,Senate,"Placed on suspense file",7,0,0,0,7
1592393,1223694,2022-08-11,Senate,"Do pass",5,2,0,0,7
1592393,1225487,2022-08-31,Senate,"Assembly 3rd Reading AB2143 Carrillo et al. By Bradford",28,9,0,3,40
1592393,1225488,2022-08-31,Assembly,"AB 2143 Carrillo Concurrence in Senate Amendments",55,16,0,9,80
1592394,1174540,2022-03-22,Assembly,"Do pass and be re-referred to the Committee on [Appropriations]",14,0,0,0,14
1592394,1206707,2022-05-19,Assembly,"Do pass",16,0,0,0,16
1592394,1210405,2022-05-25,Assembly,"AB 2144 Ramos Assembly Third Reading",76,0,0,2,78
1592394,1216406,2022-06-15,Senate,"Do pass as amended, but first amend, and re-refer to the Committee on [Appropriations] with the recommendation: To Consent Calendar",9,0,0,2,11
1592394,1219423,2022-06-27,Senate,"Placed on suspense file",6,0,0,1,7
1592394,1223652,2022-08-11,Senate,"Do pass",7,0,0,0,7
1592394,1224608,2022-08-23,Senate,"Special Consent AB2144",40,0,0,0,40
1592394,1224832,2022-08-24,Assembly,"AB 2144 Ramos Concurrence in Senate Amendments",74,0,0,6,80
1592395,1174502,2022-03-22,Assembly,"Do pass and be re-referred to the Committee on [Appropriations] with recommendation: To Consent Calendar",14,0,0,0,14
1592395,1184659,2022-04-06,Assembly,"Do pass. To Consent Calendar",13,0,0,3,16
1592395,1191256,2022-04-21,Assembly,"AB 2145 Davies Consent Calendar Second Day Regular Session",68,0,0,9,77
1592395,1214980,2022-06-08,Senate,"Do pass as amended, but first amend, and re-refer to the Committee on [Appropriations] with the recommendation: To Consent Calendar",9,0,0,2,11
1592395,1221272,2022-06-30,Senate,"Consent Calendar AB2145",37,0,0,3,40
1592395,1223035,2022-08-04,Assembly,"AB 2145 Davies Concurrence in Senate Amendments",77,0,0,3,80
1592396,1186492,2022-04-05,Assembly,"Do pass and be re-referred to the Committee on [Appropriations]",6,2,0,1,9
1592396,1206806,2022-05-19,Assembly,"Do pass",12,4,0,0,16
1592396,1207719,2022-05-23,Assembly,"AB 2146 Bauer-Kahan Assembly Third Reading",48,17,0,13,78
1592396,1215000,2022-06-08,Senate,"Do pass as amended, but first amend, and re-refer to the Committee on [Appropriations]",4,1,0,2,7
1592396,1217084,2022-06-20,Senate,"Placed on suspense file",4,0,0,3,7
1592396,1223554,2022-08-11,Senate,"Do pass",4,2,0,1,7
1592396,1225400,2022-08-29,Senate,"Assembly 3rd Reading AB2146 Bauer-Kahan et al. By Allen",30,4,0,6,40
1592396,1225401,2022-08-30,Assembly,"AB 2146 Bauer-Kahan Concurrence in Senate Amendments",53,18,0,9,80
1592397,1181304,2022-03-28,Assembly,"Do pass and be re-referred to the Committee on [Appropriations]",10,3,0,2,15
1592397,1206399,2022-05-19,Assembly,"Do pass",12,4,0,0,16
1592397,1210628,2022-05-25,Assembly,"AB 2147 Ting Assembly Third Reading",50,18,0,10,78
1592397,1217421,2022-06-21,Senate,"Do pass as amended, but first amend, and re-refer to the Committee on [Appropriations]",4,0,0,1,5
1592397,1223164,2022-08-08,Senate,"Placed on suspense file",7,0,0,0,7
1592397,1223473,2022-08-11,Senate,"Do pass",5,2,0,0,7
1592397,1224889,2022-08-25,Senate,"Assembly 3rd Reading AB2147 Ting et al. By Gonzalez",29,7,0,4,40
1592397,1224890,2022-08-25,Assembly,"AB 2147 Ting Concurrence in Senate Amendments",51,16,0,13,80
1592398,1180257,2022-03-30,Assembly,"Do pass and be re-referred to the Committee on [Appropriations] with recommendation: To Consent Calendar",13,0,0,1,14
1592398,1199954,2022-05-04,Assembly,"Do pass. To Consent Calendar",14,0,0,2,16
1592398,1204073,2022-05-12,Assembly,"AB 2148 Calderon Consent Calendar Second Day Regular Session",65,0,0,13,78
1592398,1214975,2022-06-08,Senate,"Do pass, but first be re-referred to the Committee on [Appropriations] with the recommendation: To Consent Calendar",5,0,0,0,5
1592398,1221231,2022-06-30,Senate,"Consent Calendar AB2148",37,0,0,3,40
1592400,1193145,2022-04-26,Assembly,"Do pass and be re-referred to the Committee on [Appropriations] with recommendation: To Consent Calendar",17,0,0,1,18
1592400,1206390,2022-05-19,Assembly,"Do pass as amended",16,0,0,0,16
1592400,1210387,2022-05-25,Assembly,"AB 2150 Lackey Assembly Third Reading",76,0,0,2,78
1592400,1216372,2022-06-15,Senate,"Do pass, but first be re-referred to the Committee on [Business, Professions and Economic Development] with the recommendation: To Consent Calendar",6,0,0,1,7
1592401,1183842,2022-04-05,Assembly,"Do pass and be re-referred to the Committee on [Appropriations]",2,5,0,0,7
1592402,1189875,2022-04-18,Assembly,"Do pass and be re-referred to the Committee on [Appropriations]",14,0,0,1,15
1592402,1206461,2022-05-19,Assembly,"Do pass",16,0,0,0,16
1592402,1210339,2022-05-25,Assembly,"AB 2152 Smith Assembly Third Reading",76,0,0,2,78
1592402,1216339,2022-06-14,Senate,"Do pass, but first be re-referred to the Committee on [Natural Resources and Water] with the recommendation: To Consent Calendar",15,0,0,2,17
1592402,1220102,2022-06-28,Senate,"Do pass, but first be re-referred to the Committee on [Appropriations] with the recommendation: To Consent Calendar",9,0,0,0,9
1592402,1223232,2022-08-08,Senate,"Consent Calendar AB2152",36,0,0,4,40
1592403,1183669,2022-04-05,Assembly,"Do pass and be re-referred to the Committee on [Agriculture]",8,0,0,0,8
1592403,1194420,2022-04-27,Assembly,"Do pass and be re-referred to the Committee on [Appropriations]",10,0,0,1,11
1592404,1180252,2022-03-30,Assembly,"Do pass and be re-referred to the Committee on [Appropriations]",13,0,0,1,14
1592404,1194438,2022-04-27,Assembly,"Do pass",15,0,0,1,16
1592404,1204122,2022-05-12,Assembly,"AB 2154 Cooley Assembly Third Reading",65,0,0,13,78
1592404,1218025,2022-06-22,Senate,"Do pass, but first be re-referred to the Committee on [Appropriations]",8,0,0,4,12
1592404,1224875,2022-08-25,Senate,"Assembly 3rd Reading AB2154 Cooley By Rubio",36,0,0,4,40
1592404,1224876,2022-08-25,Assembly,"AB 2154 Cooley Concurrence in Senate Amendments",73,0,0,7,80
1592405,1179226,2022-03-29,Assembly,"Do pass. To Consent Calendar",16,0,0,2,18
1592405,1182555,2022-04-04,Assembly,"AB 2155 Villapudua Consent Calendar Second Day Regular Session",71,0,0,5,76
1592405,1214384,2022-06-06,Senate,"Do pass and be ordered to the Consent Calendar",12,0,0,2,14
1592405,1215527,2022-06-13,Senate,"Consent Calendar AB2155 Villapudua",37,0,0,3,40
1592406,1179238,2022-03-29,Assembly,"Do pass and be re-referred to the Committee on [Appropriations]",5,2,0,0,7
1592406,1206605,2022-05-19,Assembly,"Do pass",12,4,0,0,16
1592406,1210459,2022-05-25,Assembly,"AB 2156 Wicks Assembly Third Reading",54,16,0,8,78
1592406,1215035,2022-06-08,Senate,"Do pass, but first be re-referred to the Committee on [Appropriations]",4,1,0,0,5
1592406,1215576,2022-06-13,Senate,"Do pass",5,1,0,1,7
1592406,1221542,2022-06-29,Senate,"Assembly 3rd Reading AB2156 Wicks By Kamlager",27,9,0,4,40
1592408,1185709,2022-04-06,Assembly,"Do pass and be re-referred to the Committee on [Appropriations]",7,0,0,0,7
1592408,1194479,2022-04-27,Assembly,"Do pass. To Consent Calendar",15,0,0,1,16
1592408,1200667,2022-05-05,Assembly,"AB 2158 Mike Fong Consent Calendar Second Day Regular Session",61,0,0,17,78
1592408,1215048,2022-06-08,Senate,"Do pass, but first be re-referred to the Committee on [Appropriations] with the recommendation: To Consent Calendar",7,0,0,0,7
1592408,1217122,2022-06-20,Senate,"Placed on suspense file",4,0,0,3,7
1592408,1223691,2022-08-11,Senate,"Do pass",7,0,0,0,7
1592408,1224586,2022-08-23,Senate,"Special Consent AB2158",40,0,0,0,40
1592409,1174492,2022-03-22,Assembly,"Do pass and be re-referred to the Committee on [Human Services]",7,1,0,1,9
1592409,1193222,2022-04-26,Assembly,"Do pass and be re-referred to the Committee on [Appropriations]",6,0,0,2,8
1592409,1206350,2022-05-19,Assembly,"Do pass",13,3,0,0,16
1592409,1210403,2022-05-25,Assembly,"AB 2159 Bryan Assembly Third Reading",61,12,0,5,78
1592409,1216402,2022-06-14,Senate,"Do pass, but first be re-referred to the Committee on [Human Services]",9,2,0,0,11
1592409,1219956,2022-06-27,Senate,"Do pass, but first be re-referred to the Committee on [Appropriations]",4,0,0,1,5
1592409,1224267,2022-08-22,Senate,"Assembly 3rd Reading AB2159 Bryan et al. By Cortese",32,8,0,0,40
1592410,1182545,2022-04-04,Assembly,"Do pass and be re-referred to the Committee on [Appropriations]",7,3,0,0,10
1592410,1194167,2022-04-27,Assembly,"Do pass",11,4,0,1,16
1592410,1204098,2022-05-12,Assembly,"AB 2160 Bennett Assembly Third Reading",51,13,0,14,78
1592410,1215928,2022-06-14,Senate,"Do pass, but first be re-referred to the Committee on [Appropriations]",7,2,0,0,9
1592410,1224269,2022-08-22,Senate,"Assembly 3rd Reading AB2160 Bennett By Allen",31,9,0,0,40
1592413,1175524,2022-03-22,Assembly,"Do pass and be re-referred to the Committee on [Appropriations]",8,0,0,1,9
1592413,1194288,2022-04-27,Assembly,"Do pass",15,0,0,1,16
1592413,1201475,2022-05-09,Assembly,"AB 2163 Blanca Rubio Assembly Third Reading",67,0,0,11,78
1592413,1211872,2022-06-01,Senate,"Do pass, but first be re-referred to the Committee on [Appropriations]",6,0,0,1,7
1592413,1224113,2022-08-17,Senate,"Assembly 3rd Reading AB2163 Blanca Rubio By Rubio",38,0,0,2,40
1592414,1174538,2022-03-22,Assembly,"Do pass as amended and be re-referred to the Committee on [Appropriations]",8,1,0,0,9
1592414,1206706,2022-05-19,Assembly,"Do pass as amended",14,1,0,1,16
1592414,1210479,2022-05-25,Assembly,"AB 2164 Lee Assembly Third Reading",69,0,0,9,78
1592414,1215807,2022-06-14,Senate,"Do pass, but first be re-referred to the Committee on [Judiciary]",14,0,0,1,15
1592414,1220602,2022-06-28,Senate,"Do pass, but first be re-referred to the Committee on [Appropriations]",10,0,0,1,11
1592414,1224250,2022-08-22,Senate,"Assembly 3rd Reading AB2164 Lee et al. By Becker",36,0,0,4,40
1592417,1189967,2022-04-19,Assembly,"Do pass",5,2,0,0,7
1592417,1210448,2022-05-26,Assembly,"AB 2167 Kalra Assembly Third Reading",42,23,0,13,78
1592417,1220881,2022-06-28,Senate,"Do pass",4,1,0,0,5
1592417,1224377,2022-08-22,Senate,"Assembly 3rd Reading AB2167 Kalra et al. By Becker",27,9,0,4,40
1592419,1174541,2022-03-22,Assembly,"Do pass and be re-referred to the Committee on [Appropriations] with recommendation: To Consent Calendar",7,0,0,0,7
1592419,1206975,2022-05-19,Assembly,"Do pass",16,0,0,0,16
1592419,1210620,2022-05-25,Assembly,"AB 2169 Gipson Assembly Third Reading",76,0,0,2,78
1592419,1215806,2022-06-14,Senate,"Do pass, but first be re-referred to the Committee on [Appropriations]",5,0,0,0,5
1592419,1219459,2022-06-27,Senate,"Placed on suspense file",6,0,0,1,7
1592419,1223446,2022-08-11,Senate,"Do pass",7,0,0,0,7
1592419,1224439,2022-08-23,Senate,"Special Consent AB2169",40,0,0,0,40
1592420,1193346,2022-04-26,Assembly,"Do pass as amended, and be re-referred to the Committee on [Appropriations] with recommendation: To Consent Calendar",9,0,0,1,10
1592420,1203379,2022-05-11,Assembly,"Do pass",16,0,0,0,16
1592420,1210517,2022-05-25,Assembly,"AB 2170 Grayson Assembly Third Reading",76,0,0,2,78
1592420,1217855,2022-06-21,Senate,"Do pass as amended, but first amend, and re-refer to the Committee on [Appropriations] with the recommendation: To Consent Calendar",11,0,0,0,11
1592420,1222811,2022-08-01,Senate,"Placed on suspense file",7,0,0,0,7
1592420,1223791,2022-08-11,Senate,"Do pass",7,0,0,0,7
1592420,1224601,2022-08-23,Senate,"Special Consent AB2170",40,0,0,0,40
1592420,1224825,2022-08-24,Assembly,"AB 2170 Grayson Concurrence in Senate Amendments",75,0,0,5,80
1592422,1184638,2022-04-06,Assembly,"Do pass as amended and be re-referred to the Committee on [Appropriations]",7,0,0,0,7
1592422,1206834,2022-05-19,Assembly,"Do pass",12,0,0,4,16
1592422,1207793,2022-05-23,Assembly,"AB 2172 Cervantes Assembly Third Reading",74,0,0,4,78
1592422,1215525,2022-06-13,Senate,"Do pass as amended, but first amend, and re-refer to the Committee on [Appropriations]",4,0,0,1,5
1592422,1219439,2022-06-27,Senate,"Placed on suspense file",6,0,0,1,7
1592422,1223846,2022-08-11,Senate,"Do pass",7,0,0,0,7
1592422,1224540,2022-08-23,Senate,"Special Consent AB2172",40,0,0,0,40
1592422,1224871,2022-08-24,Assembly,"AB 2172 Cervantes Concurrence in Senate Amendments",76,0,0,4,80
1592423,1184729,2022-04-06,Assembly,"Do pass",7,0,0,0,7
1592423,1198253,2022-05-02,Assembly,"AB 2173 Petrie-Norris Assembly Third Reading",69,0,0,8,77
1592423,1215761,2022-06-14,Senate,"Do pass and be ordered to the Consent Calendar",14,0,0,1,15
1592423,1219442,2022-06-27,Senate,"Consent Calendar AB2173",37,0,0,3,40
1592424,1193196,2022-04-25,Assembly,"Do pass as amended and be re-referred to the Committee on [Appropriations]",14,0,0,1,15
1592424,1203335,2022-05-11,Assembly,"Do pass. To Consent Calendar",16,0,0,0,16
1592424,1206634,2022-05-19,Assembly,"AB 2174 Chen Consent Calendar Second Day Regular Session",72,0,0,6,78
1592424,1220768,2022-06-28,Senate,"Do pass, but first be re-referred to the Committee on [Appropriations] with the recommendation: To Consent Calendar",17,0,0,0,17
1592424,1223299,2022-08-08,Senate,"Consent Calendar AB2174",36,0,0,4,40
1592425,1189990,2022-04-19,Assembly,"Do pass and be re-referred to the Committee on [Appropriations] with recommendation: To Consent Calendar",7,0,0,0,7
1592426,1179148,2022-03-29,Assembly,"Do pass",14,0,0,1,15
1592426,1189348,2022-04-18,Assembly,"AB 2176 Wood Assembly Third Reading",74,0,0,3,77
1592426,1211925,2022-06-01,Senate,"Do pass and be ordered to the Consent Calendar",9,0,0,2,11
1592426,1215292,2022-06-09,Senate,"Consent Calendar AB2176",38,0,0,2,40
1592427,1179576,2022-03-21,Assembly,"Do pass as amended and be re-referred to the Committee on [Appropriations]",10,0,0,1,11
1592428,1179268,2022-03-29,Assembly,"Do pass and be re-referred to the Committee on [Appropriations] with recommendation: To Consent Calendar",16,0,0,2,18
1592428,1199936,2022-05-04,Assembly,"Do pass. To Consent Calendar",14,0,0,2,16
1592428,1204070,2022-05-12,Assembly,"AB 2178 Bloom Consent Calendar Second Day Regular Session",65,0,0,13,78
1592428,1217488,2022-06-20,Senate,"Do pass, but first be re-referred to the Committee on [Appropriations]",13,0,0,1,14
1592428,1224917,2022-08-25,Senate,"Assembly 3rd Reading AB2178 Bloom By Allen",40,0,0,0,40
1592428,1224918,2022-08-25,Assembly,"AB 2178 Bloom Concurrence in Senate Amendments",73,0,0,7,80
1592429,1179222,2022-03-28,Assembly,"Do pass as amended",9,0,0,1,10
1592429,1179223,2022-03-28,Assembly,"AB 2179 GRAYSON Third Reading Urgency",62,1,0,13,76
1592429,1179224,2022-03-29,Senate,"Do pass, but first be re-referred to the Committee on [Appropriations]",10,1,0,0,11
1592429,1180234,2022-03-30,Senate,"Do pass",6,1,0,0,7
1592429,1181295,2022-03-31,Senate,"Assembly 2nd Reading AB2179 Grayson et al. By Umberg Urgency Clause",36,1,0,3,40
1592430,1174547,2022-03-22,Assembly,"Do pass and be re-referred to the Committee on [Appropriations] with recommendation: To Consent Calendar",8,0,0,0,8
1592431,1195751,2022-04-27,Assembly,"Do pass as amended and be re-referred to the Committee on [Appropriations]",7,0,0,1,8
1592431,1205859,2022-05-18,Assembly,"Do pass. To Consent Calendar",15,0,0,1,16
1592431,1210255,2022-05-25,Assembly,"AB 2181 Berman By LOW",69,2,0,7,78
1592432,1181284,2022-03-30,Assembly,"Do pass and be re-referred to the Committee on [Judiciary]",4,2,0,0,6
1592432,1199159,2022-05-03,Assembly,"Do pass and be re-referred to the Committee on [Appropriations]",7,2,0,1,10
1592433,1191248,2022-04-20,Assembly,"Do pass and be re-referred to the Committee on [Appropriations]",5,2,0,0,7
1592433,1206880,2022-05-19,Assembly,"Do pass",12,4,0,0,16
1592433,1210315,2022-05-25,Assembly,"AB 2183 Stone Assembly Third Reading",49,22,0,7,78
1592433,1218640,2022-06-22,Senate,"Do pass, but first be re-referred to the Committee on [Judiciary]",4,0,0,1,5
1592433,1220820,2022-06-28,Senate,"Do pass, but first be re-referred to the Committee on [Appropriations]",8,1,0,2,11
1592433,1222798,2022-08-01,Senate,"Placed on suspense file",7,0,0,0,7
1592433,1223892,2022-08-11,Senate,"Do pass",5,2,0,0,7
1592433,1225088,2022-08-29,Assembly,"AB 2183 STONE Concurrence in Senate Amendments",55,18,0,7,80
1592433,1225945,2022-08-29,Senate,"Assembly 3rd Reading AB2183 Stone et al. By Durazo",26,10,0,4,40
1592435,1174554,2022-03-22,Assembly,"Do pass as amended and be re-referred to the Committee on [Appropriations]",7,0,0,0,7
1592435,1206659,2022-05-19,Assembly,"Do pass as amended",12,0,0,4,16
1592435,1210489,2022-05-25,Assembly,"AB 2185 Akilah Weber Assembly Third Reading",76,0,0,2,78
1592435,1217362,2022-06-21,Senate,"Do pass, but first be re-referred to the Committee on [Health] with the recommendation: To Consent Calendar",4,0,0,1,5
1592435,1221357,2022-06-29,Senate,"Do pass as amended, but first amend, and re-refer to the Committee on [Appropriations] with the recommendation: To Consent Calendar",10,0,0,1,11
1592435,1223254,2022-08-08,Senate,"Placed on suspense file",7,0,0,0,7
1592435,1223493,2022-08-11,Senate,"Do pass as amended",7,0,0,0,7
1592435,1224553,2022-08-23,Senate,"Special Consent AB2185",40,0,0,0,40
1592435,1224692,2022-08-24,Assembly,"AB 2185 Akilah Weber Concurrence in Senate Amendments",77,0,0,3,80
1592436,1183794,2022-04-05,Assembly,"Do pass and be re-referred to the Committee on [Local Government]",6,0,0,2,8
1592436,1195769,2022-04-27,Assembly,"Do pass as amended and be re-referred to the Committee on [Appropriations]",8,0,0,0,8
1592436,1206964,2022-05-19,Assembly,"Do pass",16,0,0,0,16
1592436,1207851,2022-05-23,Assembly,"AB 2186 Grayson Assembly Third Reading",74,0,0,4,78
1592436,1215868,2022-06-13,Senate,"Do pass, but first be re-referred to the Committee on [Governance and Finance]",9,0,0,0,9
1592436,1221317,2022-06-29,Senate,"Do pass as amended, but first amend, and re-refer to the Committee on [Appropriations]",5,0,0,0,5
1592436,1223216,2022-08-08,Senate,"Placed on suspense file",7,0,0,0,7
1592437,1190701,2022-04-19,Assembly,"Do pass and be re-referred to the Committee on [Appropriations]",12,0,0,0,12
1592438,1191334,2022-04-20,Assembly,"Do pass and be re-referred to the Committee on [Judiciary]",5,2,0,0,7
1592438,1193383,2022-04-26,Assembly,"Do pass and be re-referred to the Committee on [Appropriations]",6,2,0,2,10
1592438,1206705,2022-05-19,Assembly,"Do pass",11,4,0,1,16
1592438,1210496,2022-05-26,Assembly,"AB 2188 Quirk Assembly Third Reading",42,23,0,13,78
1592438,1217909,2022-06-21,Senate,"Do pass, but first be re-referred to the Committee on [Labor, Public Employment and Retirement ]",8,2,0,1,11
1592438,1220799,2022-06-29,Senate,"Do pass as amended, but first amend, and re-refer to the Committee on [Appropriations]",4,1,0,0,5
1592438,1222902,2022-08-01,Senate,"Placed on suspense file",7,0,0,0,7
1592438,1223555,2022-08-11,Senate,"Do pass",5,2,0,0,7
1592438,1225751,2022-08-29,Senate,"Assembly 3rd Reading AB2188 Quirk et al. By Wiener",28,11,0,1,40
1592438,1225752,2022-08-30,Assembly,"AB 2188 Quirk Concurrence in Senate Amendments",49,18,0,13,80
1592439,1183752,2022-04-05,Assembly,"Do pass and be re-referred to the Committee on [Judiciary]",8,0,0,0,8
1592439,1189951,2022-04-19,Assembly,"Do pass and be re-referred to the Committee on [Appropriations] with recommendation: To Consent Calendar",9,0,0,2,11
1592439,1206249,2022-05-19,Assembly,"Do pass as amended",12,0,0,4,16
1592439,1210258,2022-05-25,Assembly,"AB 2189 Friedman Assembly Third Reading",76,0,0,2,78
1592439,1215850,2022-06-13,Senate,"Do pass, but first be re-referred to the Committee on [Judiciary]",5,0,0,0,5
1592439,1217978,2022-06-21,Senate,"Do pass as amended, but first amend, and re-refer to the Committee on [Appropriations] with the recommendation: To Consent Calendar",11,0,0,0,11
1592439,1223278,2022-08-08,Senate,"Placed on suspense file",7,0,0,0,7
1592439,1223702,2022-08-11,Senate,"Do pass",7,0,0,0,7
1592439,1224407,2022-08-23,Senate,"Special Consent AB2189",40,0,0,0,40
1592439,1224864,2022-08-24,Assembly,"AB 2189 Friedman Concurrence in Senate Amendments",77,0,0,3,80
1592440,1189835,2022-04-19,Assembly,"Do pass and be re-referred to the Committee on [Appropriations]",11,0,0,0,11
1592440,1206495,2022-05-19,Assembly,"Do pass",16,0,0,0,16
1592440,1207807,2022-05-23,Assembly,"AB 2190 Irwin Assembly Third Reading",74,0,0,4,78
1592440,1215742,2022-06-14,Senate,"Do pass, but first be re-referred to the Committee on [Judiciary] with the recommendation: To Consent Calendar",14,0,0,1,15
1592440,1217900,2022-06-21,Senate,"Do pass, but first be re-referred to the Committee on [Appropriations] with the recommendation: To Consent Calendar",11,0,0,0,11
1592440,1222852,2022-08-01,Senate,"Placed on suspense file",7,0,0,0,7
1592442,1183782,2022-04-04,Assembly,"Do pass and be re-referred to the Committee on [Privacy and Consumer Protection]",9,0,0,6,15
1592443,1190520,2022-04-20,Assembly,"Do pass and be re-referred to the Committee on [Accountability and Administrative Review]",6,0,0,2,8
1592443,1194481,2022-04-27,Assembly,"Do pass and be re-referred to the Committee on [Appropriations]",5,0,0,2,7
1592443,1206471,2022-05-19,Assembly,"Do pass",13,3,0,0,16
1592443,1207836,2022-05-23,Assembly,"AB 2233 Quirk-Silva Assembly Third Reading",57,1,0,20,78
1592443,1215892,2022-06-14,Senate,"Do pass, but first be re-referred to the Committee on [Housing]",10,2,0,3,15
1592443,1217895,2022-06-21,Senate,"Do pass, but first be re-referred to the Committee on [Appropriations]",8,0,0,1,9
1592443,1222770,2022-08-01,Senate,"Placed on suspense file",7,0,0,0,7
1592443,1223898,2022-08-11,Senate,"Do pass as amended",6,1,0,0,7
1592443,1225408,2022-08-29,Senate,"Assembly 3rd Reading AB2233 Quirk-Silva et al. By Dodd",36,1,0,3,40
1592443,1225409,2022-08-30,Assembly,"AB 2233 Quirk-Silva Concurrence in Senate Amendments",63,4,0,13,80
1592444,1179159,2022-03-29,Assembly,"Do pass",9,0,0,1,10
1592444,1191263,2022-04-21,Assembly,"AB 2193 Gabriel Assembly Third Reading",64,0,0,13,77
1592444,1217923,2022-06-21,Senate,"Do pass as amended",9,0,0,2,11
1592444,1224775,2022-08-24,Senate,"Assembly 3rd Reading AB2193 Gabriel By Durazo",33,2,0,5,40
1592444,1224895,2022-08-25,Assembly,"AB 2193 Gabriel Concurrence in Senate Amendments",67,0,0,13,80
1592445,1179209,2022-03-29,Assembly,"Do pass and be re-referred to the Committee on [Appropriations]",16,0,0,2,18
1592445,1200007,2022-05-04,Assembly,"Do pass",11,0,0,5,16
1592445,1204637,2022-05-16,Assembly,"AB 2194 Ward Assembly Third Reading",63,0,0,15,78
1592445,1214371,2022-06-06,Senate,"Do pass, but first be re-referred to the Committee on [Appropriations]",8,0,0,6,14
1592445,1224454,2022-08-23,Senate,"Assembly 3rd Reading AB2194 Ward et al. By Laird",32,0,0,8,40
1592445,1224755,2022-08-24,Assembly,"AB 2194 Ward Concurrence in Senate Amendments",72,0,0,8,80
1592446,1179236,2022-03-29,Assembly,"Do pass and be re-referred to the Committee on [Appropriations]",5,1,0,1,7
1592446,1194409,2022-04-27,Assembly,"Do pass",11,4,0,1,16
1592446,1207858,2022-05-23,Assembly,"AB 2195 Jones-Sawyer Assembly Third Reading",43,24,0,11,78
1592446,1217348,2022-06-21,Senate,"Do pass, but first be re-referred to the Committee on [Appropriations]",4,0,0,1,5
1592446,1224845,2022-08-24,Senate,"Assembly 3rd Reading AB2195 Jones-Sawyer et al. By Becker",30,10,0,0,40
1592447,1183746,2022-04-05,Senate,"Do pass, but first be re-referred to the Committee on [Appropriations]",1,2,0,2,5
1592447,1183747,2022-04-05,Senate,"[First] hearing set for [04-05-2022]: Failed passage in Committee. Reconsideration granted",4,0,0,1,5
1592447,1194327,2022-04-26,Senate,"Do pass, but first be re-referred to the Committee on [Appropriations]",1,3,0,1,5
1592448,1183593,2022-04-05,Assembly,"Do pass as amended and be re-referred to the Committee on [Appropriations]",16,0,0,2,18
1592448,1194108,2022-04-27,Assembly,"Do pass",15,0,0,1,16
1592448,1200668,2022-05-05,Assembly,"AB 2196 Maienschein Assembly Third Reading",64,0,0,14,78
1592448,1219382,2022-06-27,Senate,"Do pass, but first be re-referred to the Committee on [Appropriations]",14,0,0,0,14
1592448,1224787,2022-08-24,Senate,"Assembly 3rd Reading AB2196 Maienschein By Min",40,0,0,0,40
1592450,1174526,2022-03-22,Assembly,"Do pass. To Consent Calendar",7,0,0,0,7
1592450,1181260,2022-03-31,Assembly,"AB 2198 Fong Consent Calendar Second Day Regular Session",68,0,0,8,76
1592450,1210911,2022-05-31,Senate,"Do pass and be ordered to the Consent Calendar",5,0,0,0,5
1592450,1215309,2022-06-09,Senate,"Consent Calendar AB2198",38,0,0,2,40
1592450,1217107,2022-06-20,Assembly,"AB 2198 Fong Concurrence in Senate Amendments",70,0,0,10,80
1592452,1179133,2022-03-29,Assembly,"Do pass as amended and be re-referred to the Committee on [Appropriations]",13,0,0,2,15
1592452,1206790,2022-05-19,Assembly,"Do pass",14,0,0,2,16
1592452,1210501,2022-05-25,Assembly,"AB 2199 Wicks Assembly Third Reading",67,0,0,11,78
1592452,1216324,2022-06-15,Senate,"Do pass, but first be re-referred to the Committee on [Appropriations]",7,1,0,3,11
1592452,1219403,2022-06-27,Senate,"Placed on suspense file",6,0,0,1,7
1592452,1223359,2022-08-11,Senate,"Do pass",7,0,0,0,7
1592452,1225349,2022-08-29,Senate,"Assembly 3rd Reading AB2199 Wicks et al. By Kamlager",36,0,0,4,40
1592452,1225350,2022-08-30,Assembly,"AB 2199 Wicks Concurrence in Senate Amendments",70,0,0,10,80
1592453,1181252,2022-03-31,Assembly,"Do pass as amended and be re-referred to the Committee on [Labor and Employment]",6,0,0,0,6
1592453,1191267,2022-04-20,Assembly,"Do pass and be re-referred to the Committee on [Appropriations] with recommendation: To Consent Calendar",7,0,0,0,7
1592454,1193309,2022-04-26,Assembly,"Do pass as amended and be re-referred to the Committee on [Appropriations]",8,5,0,2,15
1592454,1206388,2022-05-19,Assembly,"Do pass",12,4,0,0,16
1592454,1207847,2022-05-23,Assembly,"AB 2201 Bennett Assembly Third Reading",44,24,0,10,78
1592454,1215765,2022-06-14,Senate,"Do pass as amended, but first amend, and re-refer to the Committee on [Governance and Finance]",6,3,0,0,9
1592454,1221233,2022-06-29,Senate,"Do pass, but first be re-referred to the Committee on [Appropriations]",3,1,0,1,5
1592454,1223217,2022-08-08,Senate,"Placed on suspense file",7,0,0,0,7
1592454,1223706,2022-08-11,Senate,"Do pass as amended",4,2,0,1,7
1592454,1225246,2022-08-29,Senate,"Assembly 3rd Reading AB2201 Bennett et al. By Laird",22,16,0,2,40
1592454,1229720,2022-08-30,Senate,"Assembly 3rd Reading AB2201 Bennett et al. By Laird",22,16,0,2,40
1592455,1191265,2022-04-20,Assembly,"Do pass and be re-referred to the Committee on [Environmental Safety and Toxic Materials]",5,1,0,1,7
1592455,1197956,2022-04-26,Assembly,"Do pass and be re-referred to the Committee on [Appropriations]",6,3,0,0,9
1592455,1206312,2022-05-19,Assembly,"Do pass",12,4,0,0,16
1592455,1207767,2022-05-23,Assembly,"AB 2214 Cristina Garcia Assembly Third Reading",50,19,0,9,78
1592455,1217881,2022-06-22,Senate,"Do pass, but first be re-referred to the Committee on [Education]",5,1,0,1,7
1592455,1220665,2022-06-29,Senate,"Do pass, but first be re-referred to the Committee on [Appropriations]",4,2,0,1,7
1592455,1222862,2022-08-01,Senate,"Placed on suspense file",7,0,0,0,7
1592457,1175571,2022-03-23,Assembly,"Do pass and be re-referred to the Committee on [Judiciary]",5,2,0,1,8
1592457,1183592,2022-04-05,Assembly,"Do pass and be re-referred to the Committee on [Appropriations]",6,2,0,2,10
1592457,1206804,2022-05-19,Assembly,"Do pass",11,4,0,1,16
1592458,1181318,2022-03-30,Assembly,"Do pass and be re-referred to the Committee on [Utilities and Energy]",5,0,0,1,6
1592458,1190647,2022-04-20,Assembly,"Do pass as amended and be re-referred to the Committee on [Appropriations]",13,1,0,1,15
1592458,1191306,2022-04-20,Assembly,"Do pass and be re-referred to the Committee on [Appropriations]",13,1,0,1,15
1592458,1206235,2022-05-19,Assembly,"Do pass as amended",13,3,0,0,16
1592458,1210287,2022-05-26,Assembly,"AB 2204 Boerner Horvath Assembly Third Reading",63,11,0,4,78
1592458,1218653,2022-06-22,Senate,"Do pass, but first be re-referred to the Committee on [Energy, Utilities and Communications]",4,0,0,1,5
1592458,1219466,2022-06-27,Senate,"Do pass, but first be re-referred to the Committee on [Appropriations]",11,2,0,1,14
1592458,1223294,2022-08-08,Senate,"Placed on suspense file",7,0,0,0,7
1592458,1223945,2022-08-11,Senate,"Do pass as amended",4,2,0,1,7
1592458,1225355,2022-08-29,Senate,"Assembly 3rd Reading AB2204 Boerner Horvath et a By Becker",29,8,0,3,40
1592458,1225356,2022-08-30,Assembly,"AB 2204 Boerner Horvath Concurrence in Senate Amendments",66,10,0,4,80
1592460,1189980,2022-04-19,Assembly,"Do pass and be re-referred to the Committee on [Appropriations]",11,3,0,1,15
1592460,1205849,2022-05-18,Assembly,"Do pass",11,4,0,1,16
1592460,1210498,2022-05-25,Assembly,"AB 2205 Carrillo Assembly Third Reading",57,17,0,4,78
1592460,1215030,2022-06-08,Senate,"Do pass, but first be re-referred to the Committee on [Appropriations]",7,2,0,2,11
1592460,1224997,2022-08-25,Senate,"Assembly 3rd Reading AB2205 Carrillo et al. By Lim贸n",31,9,0,0,40
1592460,1224998,2022-08-25,Assembly,"AB 2205 Carrillo Concurrence in Senate Amendments",60,13,0,7,80
1592461,1189923,2022-04-18,Assembly,"Do pass as amended",11,3,0,1,15
1592461,1201505,2022-05-09,Assembly,"AB 2206 Lee Assembly Third Reading",47,15,0,16,78
1592461,1216405,2022-06-14,Senate,"Do pass, but first be re-referred to the Committee on [Judiciary]",11,3,0,3,17
1592461,1220680,2022-06-28,Senate,"Do pass as amended",9,1,0,1,11
1592461,1225811,2022-08-29,Senate,"Assembly 3rd Reading AB2206 Lee By Wieckowski",31,9,0,0,40
1592461,1225812,2022-08-30,Assembly,"AB 2206 Lee Concurrence in Senate Amendments",55,19,0,6,80
1592461,1229734,2022-08-30,Senate,"Assembly 3rd Reading AB2206 Lee By Wieckowski",31,9,0,0,40
1592463,1182520,2022-04-04,Assembly,"Do pass and be re-referred to the Committee on [Appropriations]",10,0,0,0,10
1592465,1197951,2022-04-26,Assembly,"Do pass",6,3,0,0,9
1592465,1201402,2022-05-09,Assembly,"AB 2208 Kalra Assembly Third Reading",51,15,0,12,78
1592465,1215001,2022-06-08,Senate,"Do pass",4,1,0,2,7
1592465,1224498,2022-08-23,Senate,"Assembly 3rd Reading AB2208 Kalra et al. By Becker",31,8,0,1,40
1592465,1224869,2022-08-24,Assembly,"AB 2208 Kalra Concurrence in Senate Amendments",54,17,0,9,80
1592466,1204096,2022-05-12,Assembly,"Do pass",9,0,0,2,11
1592466,1210375,2022-05-25,Assembly,"AB 2209 Cooley Assembly Third Reading",65,0,0,13,78
1592466,1219947,2022-06-28,Senate,"Do pass",10,1,0,4,15
1592467,1190543,2022-04-20,Assembly,"Do pass as amended and be re-referred to the Committee on [Business and Professions]",14,5,0,3,22
1592467,1193406,2022-04-26,Assembly,"Do pass as amended and be re-referred to the Committee on [Appropriations]",12,3,0,3,18
1592467,1206369,2022-05-19,Assembly,"Do pass",12,3,0,1,16
1592467,1210282,2022-05-26,Assembly,"AB 2210 Quirk Assembly Third Reading",59,13,0,6,78
1592467,1217453,2022-06-20,Senate,"Do pass, but first be re-referred to the Committee on [Governmental Organization]",9,3,0,2,14
1592467,1219990,2022-06-28,Senate,"Do pass, but first be re-referred to the Committee on [Appropriations]",9,1,0,5,15
1592467,1225280,2022-08-29,Senate,"Assembly 3rd Reading AB2210 Quirk et al. By Caballero",27,8,0,5,40
1592467,1225281,2022-08-30,Assembly,"AB 2210 Quirk Concurrence in Senate Amendments",61,6,0,13,80
1592469,1194381,2022-04-27,Assembly,"Do pass as amended and be re-referred to the Committee on [Appropriations]",8,0,0,0,8
1592472,1194306,2022-04-27,Assembly,"Do pass and be re-referred to the Committee on [Appropriations] with recommendation: To Consent Calendar",10,0,0,1,11
1592473,1174464,2022-03-22,Senate,"Do pass, but first be re-referred to the Committee on [Governance and Finance]",11,3,0,3,17
1592473,1190661,2022-04-20,Senate,"Do pass, but first be re-referred to the Committee on [Appropriations]",5,0,0,0,5
1592473,1198252,2022-05-02,Senate,"Placed on suspense file",7,0,0,0,7
1592473,1206954,2022-05-19,Senate,"Do pass",5,2,0,0,7
1592473,1210010,2022-05-26,Senate,"Senate 3rd Reading SB1050 Dodd",34,1,0,5,40
1592473,1220062,2022-06-27,Assembly,"Do pass as amended and be re-referred to the Committee on [Appropriations]",12,1,0,2,15
1592475,1191327,2022-04-20,Assembly,"Do pass as amended and be re-referred to the Committee on [Appropriations]",7,0,0,0,7
1592475,1206279,2022-05-19,Assembly,"Do pass",16,0,0,0,16
1592475,1210358,2022-05-25,Assembly,"AB 2215 Blanca Rubio Assembly Third Reading",75,0,0,3,78
1592476,1194137,2022-04-27,Senate,"Do pass, but first be re-referred to the Committee on [Appropriations] with the recommendation: To Consent Calendar",7,0,0,0,7
1592476,1204083,2022-05-12,Senate,"Consent Calendar SB1057 ED",35,0,0,5,40
1592476,1220750,2022-06-29,Assembly,"Do pass and be re-referred to the Committee on [Appropriations] with recommendation: To Consent Calendar",7,0,0,0,7
1592476,1222984,2022-08-03,Assembly,"Do pass. To Consent Calendar",15,0,0,1,16
1592476,1224024,2022-08-11,Assembly,"SB 1057 ED. Consent Calendar Second Day Regular Session",76,0,0,4,80
1592476,1224145,2022-08-17,Senate,"Unfinished Business SB1057 ED. (Leyva) Concurrence",38,0,0,2,40
1592477,1190502,2022-04-18,Assembly,"Do pass and be re-referred to the Committee on [Appropriations]",10,0,0,1,11
1592477,1200018,2022-05-04,Assembly,"Do pass. To Consent Calendar",14,0,0,2,16
1592477,1204089,2022-05-12,Assembly,"AB 2216 Irwin Consent Calendar Second Day Regular Session",65,0,0,13,78
1592477,1216286,2022-06-15,Senate,"Do pass, but first be re-referred to the Committee on [Appropriations] with the recommendation: To Consent Calendar",5,0,0,0,5
1592477,1219520,2022-06-27,Senate,"Placed on suspense file",6,0,0,1,7
1592477,1223482,2022-08-11,Senate,"Do pass",7,0,0,0,7
1592477,1224488,2022-08-23,Senate,"Special Consent AB2216",40,0,0,0,40
1592478,1183734,2022-04-05,Assembly,"Do pass and be re-referred to the Committee on [Appropriations]",6,1,0,1,8
1592478,1206274,2022-05-19,Assembly,"Do pass",12,3,0,1,16
1592478,1207678,2022-05-23,Assembly,"AB 2217 Reyes Assembly Third Reading",59,7,0,12,78
1592478,1215900,2022-06-13,Senate,"Do pass, but first be re-referred to the Committee on [Appropriations]",9,0,0,0,9
1592478,1223287,2022-08-08,Senate,"Assembly 3rd Reading AB2217 Reyes By Kamlager",35,0,0,5,40
1592478,1223600,2022-08-11,Assembly,"AB 2217 Reyes Concurrence in Senate Amendments",61,6,0,13,80
1592480,1174493,2022-03-22,Senate,"Do pass, but first be re-referred to the Committee on [Appropriations]",1,4,0,0,5
1592480,1174494,2022-03-22,Senate,"[First] hearing set for [03-22-2022]: Failed passage in Committee. Reconsideration granted",5,0,0,0,5
1592481,1182529,2022-04-04,Assembly,"Do pass and be re-referred to the Committee on [Appropriations]",4,4,0,2,10
1592482,1189836,2022-04-19,Assembly,"Do pass and be re-referred to the Committee on [Health]",7,0,0,4,11
1592482,1193234,2022-04-26,Assembly,"Do pass and be re-referred to the Committee on [Appropriations]",12,1,0,2,15
1592484,1183763,2022-04-05,Assembly,"Do pass and be re-referred to the Committee on [Local Government]",7,0,0,1,8
1592484,1195753,2022-04-27,Assembly,"Do pass as amended and be re-referred to the Committee on [Appropriations]",7,0,0,1,8
1592484,1205828,2022-05-18,Assembly,"Do pass",15,0,0,1,16
1592484,1210377,2022-05-25,Assembly,"AB 2221 Quirk-Silva Assembly Third Reading",74,0,0,4,78
1592484,1215775,2022-06-13,Senate,"Do pass, but first be re-referred to the Committee on [Governance and Finance]",8,0,0,1,9
1592484,1221267,2022-06-29,Senate,"Do pass as amended, but first amend, and re-refer to the Committee on [Appropriations]",5,0,0,0,5
1592484,1225560,2022-08-29,Senate,"Assembly 3rd Reading AB2221 Quirk-Silva By Wieckowski",37,1,0,2,40
1592484,1225561,2022-08-30,Assembly,"AB 2221 Quirk-Silva Concurrence in Senate Amendments",74,0,0,6,80
1592485,1193434,2022-04-26,Senate,"Do pass, but first be re-referred to the Committee on [Environmental Quality] with the recommendation: To Consent Calendar",13,0,0,2,15
1592485,1204569,2022-05-16,Senate,"Placed on suspense file",6,0,0,1,7
1592485,1206932,2022-05-19,Senate,"Do pass",7,0,0,0,7
1592485,1209232,2022-05-25,Senate,"Special Consent SB1069",39,0,0,1,40
1592485,1216382,2022-06-15,Assembly,"Do pass and be re-referred to the Committee on [Appropriations] with recommendation: To Consent Calendar",7,0,0,0,7
1592486,1190662,2022-04-19,Assembly,"Do pass and be re-referred to the Committee on [Appropriations]",11,0,0,1,12
1592486,1206653,2022-05-19,Assembly,"Do pass",16,0,0,0,16
1592486,1207812,2022-05-23,Assembly,"AB 2222 Reyes Assembly Third Reading",74,0,0,4,78
1592486,1221308,2022-06-30,Senate,"Do pass, but first be re-referred to the Committee on [Appropriations]",6,0,0,1,7
1592486,1222782,2022-08-01,Senate,"Placed on suspense file",7,0,0,0,7
1592486,1223769,2022-08-11,Senate,"Do pass as amended",5,0,0,2,7
1592486,1224593,2022-08-23,Senate,"Assembly 3rd Reading AB2222 Reyes et al. By McGuire",33,0,0,7,40
1592486,1224662,2022-08-24,Assembly,"AB 2222 Reyes Concurrence in Senate Amendments By MCKINNOR",75,0,0,5,80
1592487,1183733,2022-04-05,Assembly,"Do pass as amended and be re-referred to the Committee on [Health]",7,2,0,1,10
1592487,1189994,2022-04-19,Assembly,"Do pass and be re-referred to the Committee on [Appropriations]",11,3,0,1,15
1592487,1206563,2022-05-19,Assembly,"Do pass as amended",12,4,0,0,16
1592487,1210438,2022-05-26,Assembly,"AB 2223 Wicks Assembly Third Reading",48,21,0,9,78
1592487,1216404,2022-06-14,Senate,"Do pass, but first be re-referred to the Committee on [Health]",9,2,0,0,11
1592487,1221298,2022-06-30,Senate,"Do pass, but first be re-referred to the Committee on [Appropriations]",7,2,0,2,11
1592487,1222717,2022-08-01,Senate,"Placed on suspense file",7,0,0,0,7
1592487,1224004,2022-08-11,Senate,"Do pass",5,2,0,0,7
1592487,1225345,2022-08-29,Senate,"Assembly 3rd Reading AB2223 Wicks et al. By Skinner",30,9,0,1,40
1592487,1225346,2022-08-30,Assembly,"AB 2223 Wicks Concurrence in Senate Amendments",54,19,0,7,80
1592488,1193176,2022-04-26,Assembly,"Do pass as amended",13,1,0,4,18
1592488,1201364,2022-05-09,Assembly,"AB 2224 McCarty Assembly Third Reading",50,11,0,17,78
1592489,1189293,2022-04-18,Senate,"Do pass, but first be re-referred to the Committee on [Appropriations]",13,0,0,1,14
1592489,1198293,2022-05-02,Senate,"Placed on suspense file",7,0,0,0,7
1592490,1179670,2022-03-21,Assembly,"Do pass and be re-referred to the Committee on [Appropriations]",11,0,0,0,11
1592490,1206889,2022-05-19,Assembly,"Do pass as amended",12,0,0,4,16
1592490,1210370,2022-05-25,Assembly,"AB 2225 Ward Assembly Third Reading",76,0,0,2,78
1592491,1181276,2022-03-31,Assembly,"Do pass as amended, and be re-referred to the Committee on [Arts, Entertainment, Sports, Tourism, and Internet Media] with recommendation: To Consent Calendar",6,0,0,0,6
1592491,1189905,2022-04-19,Assembly,"Do pass and be re-referred to the Committee on [Appropriations] with recommendation: To Consent Calendar",7,0,0,0,7
1592492,1175533,2022-03-23,Senate,"Do pass, but first be re-referred to the Committee on [Agriculture]",11,0,0,0,11
1592492,1194157,2022-04-27,Senate,"Do pass, but first be re-referred to the Committee on [Appropriations] with the recommendation: To Consent Calendar",4,0,0,1,5
1592492,1201459,2022-05-09,Senate,"Placed on suspense file",7,0,0,0,7
1592492,1206677,2022-05-19,Senate,"Do pass",7,0,0,0,7
1592492,1209321,2022-05-25,Senate,"Special Consent SB1029",39,0,0,1,40
1592492,1217486,2022-06-21,Assembly,"Do pass and be re-referred to the Committee on [Agriculture] with recommendation: To Consent Calendar",15,0,0,0,15
1592492,1220675,2022-06-29,Assembly,"Do pass and be re-referred to the Committee on [Appropriations] with recommendation: To Consent Calendar",8,0,0,3,11
1592492,1223565,2022-08-11,Assembly,"Do pass as amended",12,0,0,4,16
1592492,1224420,2022-08-23,Assembly,"SB 1029 Hurtado Senate Third Reading By Vince Fong",77,0,0,3,80
1592492,1225493,2022-08-30,Senate,"Special Consent SB1029",38,0,0,2,40
1592495,1179301,2022-03-29,Assembly,"Do pass",6,0,0,1,7
1592495,1189318,2022-04-18,Assembly,"AB 2229 Luz Rivas Third Reading Urgency",68,0,0,9,77
1592495,1210920,2022-05-31,Senate,"Do pass and be ordered to the Consent Calendar",5,0,0,0,5
1592495,1211893,2022-05-31,Senate,"Do pass",5,0,0,0,5
1592495,1224386,2022-08-22,Senate,"Assembly 3rd Reading AB2229 Luz Rivas et al. By Gonzalez Urgency Clause",36,0,0,4,40
1592495,1224427,2022-08-23,Assembly,"AB 2229 Luz Rivas Concurrence in Senate Amendments",69,0,0,11,80
1592496,1183679,2022-04-05,Assembly,"Do pass as amended and be re-referred to the Committee on [Appropriations]",6,1,0,1,8
1592496,1206627,2022-05-19,Assembly,"Do pass as amended",12,4,0,0,16
1592496,1210474,2022-05-25,Assembly,"AB 2230 Gipson Assembly Third Reading",57,13,0,8,78
1592496,1215863,2022-06-13,Senate,"Do pass, but first be re-referred to the Committee on [Appropriations]",5,0,0,0,5
1592496,1219518,2022-06-27,Senate,"Placed on suspense file",6,0,0,1,7
1592496,1223396,2022-08-11,Senate,"Do pass as amended",5,1,0,1,7
1592496,1225641,2022-08-30,Senate,"Assembly 3rd Reading AB2230 Gipson et al. By Umberg",34,4,0,2,40
1592496,1225642,2022-08-31,Assembly,"AB 2230 Gipson Concurrence in Senate Amendments",62,13,0,5,80
1592497,1184635,2022-04-05,Senate,"Do pass as amended, but first amend, and re-refer to the Committee on [Agriculture] with the recommendation: To Consent Calendar",10,0,0,1,11
1592497,1194325,2022-04-27,Senate,"Do pass as amended, but first amend, and re-refer to the Committee on [Appropriations]",4,0,0,1,5
1592497,1204552,2022-05-16,Senate,"Placed on suspense file",6,0,0,1,7
1592497,1206411,2022-05-19,Senate,"Do pass",7,0,0,0,7
1592497,1208512,2022-05-24,Senate,"Senate 3rd Reading SB1084 Hurtado",31,0,0,9,40
1592497,1215779,2022-06-14,Assembly,"Do pass as amended and be re-referred to the Committee on [Agriculture]",10,0,0,1,11
1592497,1220701,2022-06-29,Assembly,"Do pass as amended and be re-referred to the Committee on [Appropriations]",8,0,0,3,11
1592497,1223902,2022-08-11,Assembly,"Do pass",16,0,0,0,16
1592497,1224294,2022-08-22,Assembly,"SB 1084 Hurtado Third Reading Urgency By Calderon",75,0,0,5,80
1592497,1225940,2022-08-31,Senate,"Unfinished Business SB1084 Hurtado Urgency Clause Concurrence",37,0,0,3,40
1592499,1185684,2022-04-06,Assembly,"Do pass and be re-referred to the Committee on [Higher Education]",5,1,0,1,7
1592499,1190679,2022-04-19,Assembly,"Do pass and be re-referred to the Committee on [Appropriations]",9,2,0,1,12
1592499,1206904,2022-05-19,Assembly,"Do pass as amended",12,4,0,0,16
1592499,1210326,2022-05-25,Assembly,"AB 2232 McCarty Assembly Third Reading",59,9,0,10,78
1592499,1217943,2022-06-22,Senate,"Do pass as amended, but first amend, and re-refer to the Committee on [Appropriations]",4,1,0,2,7
1592499,1222799,2022-08-01,Senate,"Placed on suspense file",7,0,0,0,7
1592499,1223924,2022-08-11,Senate,"Do pass",5,1,0,1,7
1592499,1225795,2022-08-30,Senate,"Assembly 3rd Reading AB2232 McCarty By Cortese",30,9,0,1,40
1592499,1225796,2022-08-31,Assembly,"AB 2232 McCarty Concurrence in Senate Amendments",62,10,0,8,80
1592501,1190497,2022-04-20,Assembly,"Do pass and be re-referred to the Committee on [Housing and Community Development]",7,0,0,1,8
1592501,1194235,2022-04-27,Assembly,"Do pass as amended and be re-referred to the Committee on [Appropriations]",7,0,0,1,8
1592501,1205824,2022-05-18,Assembly,"Do pass",15,0,0,1,16
1592501,1210524,2022-05-25,Assembly,"AB 2234 Robert Rivas Assembly Third Reading",74,0,0,4,78
1592501,1216374,2022-06-15,Senate,"Do pass, but first be re-referred to the Committee on [Housing]",5,0,0,0,5
1592501,1217894,2022-06-21,Senate,"Do pass as amended, but first amend, and re-refer to the Committee on [Appropriations]",8,0,0,1,9
1592501,1222925,2022-08-01,Senate,"Placed on suspense file",7,0,0,0,7
1592501,1223817,2022-08-11,Senate,"Do pass as amended",6,0,0,1,7
1592501,1224651,2022-08-24,Senate,"Assembly 3rd Reading AB2234 Robert Rivas et al. By Kamlager",36,1,0,3,40
1592501,1224980,2022-08-25,Assembly,"AB 2234 Robert Rivas Concurrence in Senate Amendments",72,0,0,8,80
1592504,1189982,2022-04-19,Assembly,"Do pass and be re-referred to the Committee on [Appropriations] with recommendation: To Consent Calendar",19,0,0,0,19
1592504,1199984,2022-05-04,Assembly,"Do pass. To Consent Calendar",14,0,0,2,16
1592504,1204112,2022-05-12,Assembly,"AB 2236 Low Consent Calendar Second Day Regular Session",65,0,0,13,78
1592504,1219468,2022-06-27,Senate,"Do pass as amended, but first amend, and re-refer to the Committee on [Appropriations]",9,1,0,4,14
1592504,1222863,2022-08-01,Senate,"Placed on suspense file",7,0,0,0,7
1592504,1223567,2022-08-11,Senate,"Do pass as amended",5,0,0,2,7
1592504,1223568,2022-08-11,Senate,"[08-11-2022] set for [First] hearing: Reconsideration of favorable vote granted",7,0,0,0,7
1592504,1223569,2022-08-11,Senate,"Do pass as amended",4,0,0,3,7
1592504,1225169,2022-08-30,Assembly,"With recommendation: That Senate amendments be concurred in",11,2,0,5,18
1592504,1225261,2022-08-29,Senate,"Assembly 3rd Reading AB2236 Low By Skinner",28,4,0,8,40
1592504,1225262,2022-08-31,Assembly,"AB 2236 Low Concurrence in Senate Amendments",41,11,0,28,80
1592504,1229719,2022-08-30,Senate,"Assembly 3rd Reading AB2236 Low By Skinner",28,4,0,8,40
1592505,1181314,2022-03-28,Assembly,"Do pass and be re-referred to the Committee on [Natural Resources]",8,4,0,3,15
1592505,1192163,2022-04-25,Assembly,"Do pass and be re-referred to the Committee on [Appropriations]",7,3,0,1,11
1592505,1206916,2022-05-19,Assembly,"Do pass as amended",12,4,0,0,16
1592505,1210473,2022-05-25,Assembly,"AB 2237 Friedman Assembly Third Reading",41,27,0,10,78
1592507,1179512,2022-03-21,Assembly,"Do pass as amended and be re-referred to the Committee on [Insurance]",11,0,0,0,11
1592507,1180214,2022-03-30,Assembly,"Do pass and be re-referred to the Committee on [Appropriations]",10,0,0,4,14
1592507,1206333,2022-05-19,Assembly,"Do pass",15,0,0,1,16
1592507,1207888,2022-05-23,Assembly,"AB 2238 Luz Rivas Assembly Third Reading",73,0,0,5,78
1592507,1215057,2022-06-08,Senate,"Do pass, but first be re-referred to the Committee on [Insurance]",5,0,0,2,7
1592507,1217868,2022-06-22,Senate,"Do pass, but first be re-referred to the Committee on [Appropriations] with the recommendation: To Consent Calendar",11,0,0,1,12
1592507,1222806,2022-08-01,Senate,"Placed on suspense file",7,0,0,0,7
1592507,1223816,2022-08-11,Senate,"Do pass as amended",7,0,0,0,7
1592507,1225683,2022-08-31,Senate,"Special Consent AB2238",40,0,0,0,40
1592507,1225684,2022-08-31,Assembly,"AB 2238 Luz Rivas Concurrence in Senate Amendments",79,0,0,1,80
1592508,1174512,2022-03-22,Senate,"Do pass, but first be re-referred to the Committee on [Appropriations]",17,0,0,0,17
1592508,1182513,2022-04-04,Senate,"Placed on suspense file",6,0,0,1,7
1592508,1206716,2022-05-19,Senate,"Do pass as amended",7,0,0,0,7
1592508,1209990,2022-05-26,Senate,"Special Consent SB1049",38,0,0,2,40
1592509,1193203,2022-04-26,Assembly,"Do pass as amended and be re-referred to the Committee on [Appropriations]",7,0,0,0,7
1592509,1206657,2022-05-19,Assembly,"Do pass as amended",12,0,0,4,16
1592509,1210581,2022-05-25,Assembly,"AB 2239 Maienschein Assembly Third Reading",76,0,0,2,78
1592509,1214988,2022-06-08,Senate,"Do pass, but first be re-referred to the Committee on [Appropriations]",5,0,0,0,5
1592509,1215559,2022-06-13,Senate,"Do pass",7,0,0,0,7
1592509,1219351,2022-06-27,Senate,"Assembly 3rd Reading AB2239 Maienschein By Durazo",34,0,0,6,40
1592509,1221564,2022-06-29,Assembly,"AB 2239 Maienschein Concurrence in Senate Amendments",78,0,0,2,80
1592512,1193353,2022-04-26,Assembly,"Do pass and be re-referred to the Committee on [Judiciary]",12,1,0,2,15
1592512,1195867,2022-04-28,Assembly,"Do pass and be re-referred to the Committee on [Appropriations]",9,0,0,1,10
1592512,1206400,2022-05-19,Assembly,"Do pass as amended",12,1,0,3,16
1592512,1210455,2022-05-26,Assembly,"AB 2242 Santiago Assembly Third Reading",63,1,0,14,78
1592512,1218620,2022-06-22,Senate,"Do pass as amended, but first amend, and re-refer to the Committee on [Judiciary]",8,0,0,3,11
1592512,1220617,2022-06-28,Senate,"Do pass, but first be re-referred to the Committee on [Appropriations]",10,0,0,1,11
1592512,1222796,2022-08-01,Senate,"Placed on suspense file",7,0,0,0,7
1592512,1223863,2022-08-11,Senate,"Do pass as amended",7,0,0,0,7
1592512,1225420,2022-08-30,Senate,"Assembly 3rd Reading AB2242 Santiago et al. By Glazer",38,0,0,2,40
1592512,1225421,2022-08-31,Assembly,"AB 2242 Santiago Concurrence in Senate Amendments",77,0,0,3,80
1592513,1174558,2022-03-22,Senate,"Do pass as amended, but first amend, and re-refer to the Committee on [Appropriations] with the recommendation: To Consent Calendar",8,0,0,1,9
1592513,1182536,2022-04-04,Senate,"Placed on suspense file",6,0,0,1,7
1592513,1206402,2022-05-19,Senate,"Do pass as amended",7,0,0,0,7
1592513,1209945,2022-05-26,Senate,"Special Consent SB1036",38,0,0,2,40
1592513,1215529,2022-06-13,Assembly,"Do pass and be re-referred to the Committee on [Appropriations]",9,0,0,2,11
1592513,1223412,2022-08-11,Assembly,"Do pass",16,0,0,0,16
1592513,1224193,2022-08-18,Assembly,"SB 1036 Newman Senate Third Reading By Petrie-Norris",75,0,0,5,80
1592513,1224468,2022-08-23,Senate,"Unfinished Business SB1036 Newman et al. Concurrence",40,0,0,0,40
1592514,1181292,2022-03-30,Assembly,"Do pass and be re-referred to the Committee on [Appropriations]",4,2,0,0,6
1592514,1206572,2022-05-19,Assembly,"Do pass as amended",12,4,0,0,16
1592514,1210537,2022-05-25,Assembly,"AB 2243 Eduardo Garcia Assembly Third Reading",47,19,0,12,78
1592514,1218662,2022-06-22,Senate,"Do pass, but first be re-referred to the Committee on [Appropriations]",3,0,0,2,5
1592514,1222680,2022-08-01,Senate,"Placed on suspense file",7,0,0,0,7
1592514,1223461,2022-08-11,Senate,"Do pass as amended",5,1,0,1,7
1592514,1225422,2022-08-29,Senate,"Assembly 3rd Reading AB2243 Eduardo Garcia et al By Stern",31,9,0,0,40
1592514,1225423,2022-08-30,Assembly,"AB 2243 Eduardo Garcia Concurrence in Senate Amendments",52,19,0,9,80
1592515,1176480,2022-03-23,Assembly,"Do pass as amended and be re-referred to the Committee on [Housing and Community Development]",8,0,0,0,8
1592515,1183804,2022-04-05,Assembly,"Do pass",7,0,0,1,8
1592515,1210567,2022-05-25,Assembly,"AB 2244 Wicks Assembly Third Reading",76,0,0,2,78
1592515,1217902,2022-06-22,Senate,"Do pass and be ordered to the Consent Calendar",5,0,0,0,5
1592515,1221245,2022-06-30,Senate,"Consent Calendar AB2244 Wicks",37,0,0,3,40
1592516,1179392,2022-03-28,Senate,"Do pass",6,0,0,1,7
1592516,1208517,2022-05-24,Senate,"Senate 3rd Reading SB1046 Eggman et al",29,7,0,4,40
1592516,1217106,2022-06-20,Assembly,"Do pass",7,3,0,1,11
1592516,1224176,2022-08-18,Assembly,"SB 1046 Eggman Senate Third Reading By Friedman",54,18,0,8,80
1592516,1224776,2022-08-24,Senate,"Unfinished Business SB1046 Eggman et al. Concurrence",32,8,0,0,40
1592517,1199199,2022-05-03,Assembly,"Do pass. To Consent Calendar",10,0,0,0,10
1592517,1201369,2022-05-09,Assembly,"AB 2245 Ramos Consent Calendar Second Day",67,0,0,11,78
1592517,1215005,2022-06-08,Senate,"Do pass and be ordered to the Consent Calendar",9,0,0,2,11
1592517,1216624,2022-06-16,Senate,"Consent Calendar AB2245",35,0,0,5,40
1592518,1189908,2022-04-19,Assembly,"Do pass and be re-referred to the Committee on [Appropriations]",2,3,0,2,7
1592520,1197958,2022-04-26,Assembly,"Do pass and be re-referred to the Committee on [Appropriations]",7,2,0,0,9
1592520,1206397,2022-05-19,Assembly,"Do pass as amended",12,4,0,0,16
1592520,1210408,2022-05-26,Assembly,"AB 2247 Bloom Assembly Third Reading",43,19,0,16,78
1592520,1217891,2022-06-22,Senate,"Do pass, but first be re-referred to the Committee on [Appropriations]",5,2,0,0,7
1592520,1222803,2022-08-01,Senate,"Placed on suspense file",7,0,0,0,7
1592520,1223882,2022-08-11,Senate,"Do pass as amended",4,2,0,1,7
1592520,1225445,2022-08-29,Senate,"Assembly 3rd Reading AB2247 Bloom et al. By Allen",24,12,0,4,40
1592520,1225446,2022-08-30,Assembly,"AB 2247 Bloom Concurrence in Senate Amendments",49,16,0,15,80
1592522,1186487,2022-04-05,Assembly,"Do pass and be re-referred to the Committee on [Water, Parks, and Wildlife] with recommendation: To Consent Calendar",9,0,0,0,9
1592522,1193417,2022-04-26,Assembly,"Do pass and be re-referred to the Committee on [Appropriations] with recommendation: To Consent Calendar",15,0,0,0,15
1592522,1206884,2022-05-19,Assembly,"Do pass",16,0,0,0,16
1592522,1207771,2022-05-23,Assembly,"AB 2248 Eduardo Garcia Assembly Third Reading",74,0,0,4,78
1592522,1220833,2022-06-29,Senate,"Do pass as amended, but first amend, and re-refer to the Committee on [Appropriations]",7,0,0,0,7
1592522,1222840,2022-08-01,Senate,"Placed on suspense file",7,0,0,0,7
1592522,1223992,2022-08-11,Senate,"Do pass as amended",7,0,0,0,7
1592522,1225856,2022-08-29,Senate,"Assembly 3rd Reading AB2248 Eduardo Garcia et al By Hueso",39,0,0,1,40
1592522,1225857,2022-08-30,Assembly,"AB 2248 Eduardo Garcia Concurrence in Senate Amendments",79,0,0,1,80
1592522,1229701,2022-08-30,Senate,"Assembly 3rd Reading AB2248 Eduardo Garcia et al By Hueso",39,0,0,1,40
1592524,1189821,2022-04-19,Assembly,"Do pass and be re-referred to the Committee on [Appropriations]",5,1,0,1,7
1592525,1173486,2022-03-21,Senate,"Do pass, but first be re-referred to the Committee on [Appropriations]",4,1,0,0,5
1592525,1182576,2022-04-04,Senate,"Placed on suspense file",6,0,0,1,7
1592525,1206676,2022-05-19,Senate,"Do pass",5,1,0,1,7
1592525,1208451,2022-05-24,Senate,"Senate 3rd Reading SB1058 Durazo",28,9,0,3,40
1592525,1217968,2022-06-22,Assembly,"Do pass and be re-referred to the Committee on [Appropriations]",9,2,0,3,14
1592525,1222997,2022-08-03,Assembly,"Do pass",11,4,0,1,16
1592525,1224064,2022-08-15,Assembly,"SB 1058 Durazo Senate Third Reading By Mia Bonta",63,12,0,5,80
1592525,1224385,2022-08-22,Senate,"Unfinished Business SB1058 Durazo et al. Concurrence",31,8,0,1,40
1592526,1182517,2022-04-04,Assembly,"Do pass as amended and be re-referred to the Committee on [Appropriations]",7,1,0,2,10
1592526,1206684,2022-05-19,Assembly,"Do pass as amended",12,1,0,3,16
1592526,1210390,2022-05-25,Assembly,"AB 2251 Calderon Assembly Third Reading",70,0,0,8,78
1592526,1217070,2022-06-20,Senate,"Do pass as amended, but first amend, and re-refer to the Committee on [Appropriations] with the recommendation: To Consent Calendar",7,0,0,2,9
1592526,1223184,2022-08-08,Senate,"Consent Calendar AB2251",36,0,0,4,40
1592526,1224087,2022-08-15,Assembly,"AB 2251 Calderon Concurrence in Senate Amendments",71,0,0,9,80
1592527,1175518,2022-03-23,Assembly,"Do pass and be re-referred to the Committee on [Emergency Management]",10,3,0,0,13
1592527,1192198,2022-04-25,Assembly,"Do pass and be re-referred to the Committee on [Appropriations]",5,2,0,0,7
1592528,1193371,2022-04-25,Assembly,"Be adopted. To Consent Calendar",15,0,0,0,15
1592528,1195732,2022-04-28,Assembly,"ACR 139 Ramos Consent Calendar Second Day Regular Session",71,0,0,6,77
1592528,1220746,2022-06-28,Senate,"Be adopted, but first be re-referred to the Committee on [Appropriations] with recommendation: To Consent Calendar",16,0,0,1,17
1592528,1223023,2022-08-04,Senate,"Special Consent ACR139",35,0,0,5,40
1592529,1193220,2022-04-26,Assembly,"Do pass as amended and be re-referred to the Committee on [Appropriations]",5,2,0,0,7
1592530,1189852,2022-04-18,Assembly,"Do pass and be re-referred to the Committee on [Appropriations]",14,0,0,1,15
1592530,1206960,2022-05-19,Assembly,"Do pass",16,0,0,0,16
1592530,1207679,2022-05-23,Assembly,"AB 2254 Muratsuchi Assembly Third Reading",74,0,0,4,78
1592530,1220650,2022-06-28,Senate,"Do pass, but first be re-referred to the Committee on [Appropriations] with the recommendation: To Consent Calendar",17,0,0,0,17
1592530,1222886,2022-08-01,Senate,"Placed on suspense file",7,0,0,0,7
1592530,1223965,2022-08-11,Senate,"Do pass",7,0,0,0,7
1592530,1224441,2022-08-23,Senate,"Special Consent AB2254",40,0,0,0,40
1592532,1190521,2022-04-19,Assembly,"Do pass and be re-referred to the Committee on [Appropriations]",9,1,0,2,12
1592533,1183606,2022-04-05,Senate,"Do pass, but first be re-referred to the Committee on [Appropriations]",5,0,0,0,5
1592533,1192150,2022-04-25,Senate,"Placed on suspense file",5,0,0,2,7
1592533,1206562,2022-05-19,Senate,"Do pass",7,0,0,0,7
1592533,1209268,2022-05-25,Senate,"Special Consent SB1083",39,0,0,1,40
1592533,1219889,2022-06-28,Assembly,"Do pass and be re-referred to the Committee on [Appropriations]",7,0,0,1,8
1592533,1223994,2022-08-11,Assembly,"Do pass as amended",12,0,0,4,16
1592533,1225264,2022-08-30,Senate,"Unfinished Business SB1083 Skinner Concurrence",36,0,0,4,40
1592533,1225265,2022-08-30,Assembly,"SB 1083 Skinner Senate Third Reading By Holden",79,0,0,1,80
1592534,1175517,2022-03-23,Assembly,"Do pass and be re-referred to the Committee on [Appropriations] with recommendation: To Consent Calendar",13,0,0,0,13
1592534,1184644,2022-04-06,Assembly,"Do pass. To Consent Calendar",13,0,0,3,16
1592534,1191274,2022-04-21,Assembly,"AB 2256 Quirk-Silva Consent Calendar Second Day Regular Session",68,0,0,9,77
1592534,1210937,2022-05-31,Senate,"Do pass as amended, but first amend, and re-refer to the Committee on [Appropriations]",11,0,0,3,14
1592534,1224232,2022-08-18,Senate,"Assembly 3rd Reading AB2256 Quirk-Silva By Caballero",38,0,0,2,40
1592534,1224260,2022-08-22,Assembly,"AB 2256 Quirk-Silva Concurrence in Senate Amendments",77,0,0,3,80
1592535,1182572,2022-04-04,Assembly,"Do pass and be re-referred to the Committee on [Appropriations]",7,1,0,2,10
1592535,1206281,2022-05-19,Assembly,"Do pass as amended",12,3,0,1,16
1592535,1210366,2022-05-25,Assembly,"AB 2257 Boerner Horvath Assembly Third Reading",54,12,0,12,78
1592535,1219936,2022-06-28,Senate,"Do pass as amended, but first amend, and re-refer to the Committee on [Appropriations]",7,2,0,0,9
1592535,1222853,2022-08-01,Senate,"Placed on suspense file",7,0,0,0,7
1592535,1223681,2022-08-11,Senate,"Do pass",5,1,0,1,7
1592535,1224929,2022-08-25,Senate,"Assembly 3rd Reading AB2257 Boerner Horvath et a By Lim贸n",32,6,0,2,40
1592535,1224930,2022-08-25,Assembly,"AB 2257 Boerner Horvath Concurrence in Senate Amendments",56,14,0,10,80
1592536,1190621,2022-04-20,Assembly,"Do pass as amended and be re-referred to the Committee on [Banking and Finance]",6,0,0,2,8
1592537,1179134,2022-03-29,Senate,"Do pass as amended, but first amend, and re-refer to the Committee on [Appropriations]",5,0,0,0,5
1592537,1189326,2022-04-18,Senate,"Placed on suspense file",7,0,0,0,7
1592537,1206447,2022-05-19,Senate,"Do pass as amended",7,0,0,0,7
1592537,1209976,2022-05-26,Senate,"Special Consent SB1081",38,0,0,2,40
1592537,1219877,2022-06-28,Assembly,"Do pass as amended and be re-referred to the Committee on [Appropriations]",7,0,0,0,7
1592537,1223467,2022-08-11,Assembly,"Do pass",16,0,0,0,16
1592537,1224865,2022-08-24,Assembly,"SB 1081 Rubio Senate Third Reading By BONTA, M",77,0,0,3,80
1592537,1225867,2022-08-30,Senate,"Special Consent SB1081",38,0,0,2,40
1592538,1183594,2022-04-05,Assembly,"Do pass and be re-referred to the Committee on [Health] with recommendation: To Consent Calendar",8,0,0,0,8
1592538,1189930,2022-04-19,Assembly,"Do pass and be re-referred to the Committee on [Appropriations] with recommendation: To Consent Calendar",13,0,0,2,15
1592538,1206915,2022-05-19,Assembly,"Do pass as amended",12,0,0,4,16
1592538,1210312,2022-05-25,Assembly,"AB 2259 Berman Assembly Third Reading By HANEY",75,0,0,3,78
1592538,1217411,2022-06-20,Senate,"Do pass, but first be re-referred to the Committee on [Health] with the recommendation: To Consent Calendar",4,0,0,1,5
1592538,1221251,2022-06-29,Senate,"Do pass, but first be re-referred to the Committee on [Appropriations] with the recommendation: To Consent Calendar",10,0,0,1,11
1592538,1222815,2022-08-01,Senate,"Placed on suspense file",7,0,0,0,7
1592539,1183699,2022-04-05,Assembly,"Do pass and be re-referred to the Committee on [Judiciary]",13,0,0,2,15
1592539,1189822,2022-04-19,Assembly,"Do pass and be re-referred to the Committee on [Appropriations]",8,0,0,3,11
1592539,1205874,2022-05-18,Assembly,"Do pass",13,0,0,3,16
1592539,1210350,2022-05-25,Assembly,"AB 2260 Rodriguez Assembly Third Reading",69,0,0,9,78
1592539,1214958,2022-06-08,Senate,"Do pass as amended, but first amend, and re-refer to the Committee on [Judiciary] with the recommendation: To Consent Calendar",9,0,0,2,11
1592539,1216375,2022-06-14,Senate,"Do pass, but first be re-referred to the Committee on [Appropriations] with the recommendation: To Consent Calendar",11,0,0,0,11
1592539,1221307,2022-06-30,Senate,"Consent Calendar AB2260",37,0,0,3,40
1592539,1224308,2022-08-22,Assembly,"AB 2260 Rodriguez Concurrence in Senate Amendments",71,0,0,9,80
1592541,1179150,2022-03-29,Senate,"Do pass as amended, but first amend, and re-refer to the Committee on [Judiciary] with the recommendation: To Consent Calendar",4,0,0,1,5
1592541,1190645,2022-04-19,Senate,"Do pass, but first be re-referred to the Committee on [Appropriations] with the recommendation: To Consent Calendar",11,0,0,0,11
1592541,1201381,2022-05-09,Senate,"Consent Calendar SB1054",33,0,0,7,40
1592541,1215890,2022-06-14,Assembly,"Do pass and be re-referred to the Committee on [Judiciary] with recommendation: To Consent Calendar",7,0,0,1,8
1592541,1217455,2022-06-21,Assembly,"Do pass and be re-referred to the Committee on [Appropriations] with recommendation: To Consent Calendar",10,0,0,0,10
1592541,1222977,2022-08-03,Assembly,"Do pass as amended. To Consent Calendar",15,0,0,1,16
1592541,1223479,2022-08-11,Assembly,"SB 1054 Ochoa Bogh Consent Calendar Second Day Regular Session",76,0,0,4,80
1592541,1225026,2022-08-25,Senate,"Unfinished Business SB1054 Ochoa Bogh et al. Concurrence",40,0,0,0,40
1592542,1174534,2022-03-22,Assembly,"Do pass and be re-referred to the Committee on [Appropriations] with recommendation: To Consent Calendar",8,0,0,0,8
1592543,1190624,2022-04-19,Assembly,"Do pass and be re-referred to the Committee on [Appropriations]",12,0,0,0,12
1592544,1181277,2022-03-28,Assembly,"Do pass and be re-referred to the Committee on [Appropriations]",14,0,0,1,15
1592544,1206631,2022-05-19,Assembly,"Do pass as amended",12,0,0,4,16
1592544,1210367,2022-05-25,Assembly,"AB 2264 Bloom Assembly Third Reading",75,0,0,3,78
1592544,1220784,2022-06-28,Senate,"Do pass, but first be re-referred to the Committee on [Appropriations] with the recommendation: To Consent Calendar",17,0,0,0,17
1592544,1223212,2022-08-08,Senate,"Placed on suspense file",7,0,0,0,7
1592544,1223948,2022-08-11,Senate,"Do pass as amended",6,0,0,1,7
1592544,1224475,2022-08-23,Senate,"Special Consent AB2264",40,0,0,0,40
1592544,1224811,2022-08-24,Assembly,"AB 2264 Bloom Concurrence in Senate Amendments",76,0,0,4,80
1592545,1174543,2022-03-22,Senate,"Do pass, but first be re-referred to the Committee on [Appropriations]",1,3,0,1,5
1592545,1174544,2022-03-22,Senate,"[First] hearing set for [03-22-2022]: Failed passage in Committee. Reconsideration granted",5,0,0,0,5
1592546,1179140,2022-03-29,Assembly,"Do pass as amended and be re-referred to the Committee on [Judiciary]",11,0,0,7,18
1592546,1183765,2022-04-05,Assembly,"Do pass as amended and be re-referred to the Committee on [Appropriations]",7,1,0,2,10
1592547,1190675,2022-04-19,Assembly,"Do pass as amended and be re-referred to the Committee on [Appropriations]",9,0,0,3,12
1592547,1206569,2022-05-19,Assembly,"Do pass",13,0,0,3,16
1592547,1210286,2022-05-26,Assembly,"AB 2266 Santiago Assembly Third Reading",68,1,0,9,78
1592547,1221345,2022-06-30,Senate,"Do pass, but first be re-referred to the Committee on [Appropriations]",6,0,0,1,7
1592547,1222773,2022-08-01,Senate,"Placed on suspense file",7,0,0,0,7
1592549,1181278,2022-03-31,Senate,"Do pass as amended, but first amend, and re-refer to the Committee on [Housing]",4,0,0,1,5
1592549,1194163,2022-04-27,Senate,"Do pass as amended, but first amend, and re-refer to the Committee on [Appropriations]",6,2,0,1,9
1592549,1204688,2022-05-16,Senate,"Placed on suspense file",6,0,0,1,7
1592549,1206818,2022-05-19,Senate,"Do pass as amended",5,2,0,0,7
1592549,1208452,2022-05-24,Senate,"Senate 3rd Reading SB1067 Portantino",23,8,0,9,40
1592549,1216277,2022-06-15,Assembly,"Do pass as amended and be re-referred to the Committee on [Local Government]",6,1,0,1,8
1592549,1220814,2022-06-29,Assembly,"Do pass as amended and be re-referred to the Committee on [Appropriations]",5,3,0,0,8
1592550,1174548,2022-03-22,Assembly,"Do pass and be re-referred to the Committee on [Appropriations]",7,0,0,2,9
1592550,1206685,2022-05-19,Assembly,"Do pass",12,1,0,3,16
1592550,1207748,2022-05-23,Assembly,"AB 2268 Gray Assembly Third Reading",59,0,0,19,78
1592550,1217962,2022-06-21,Senate,"Do pass, but first be re-referred to the Committee on [Appropriations]",10,0,0,1,11
1592550,1222894,2022-08-01,Senate,"Placed on suspense file",7,0,0,0,7
1592550,1223712,2022-08-11,Senate,"Do pass",5,0,0,2,7
1592550,1225912,2022-08-30,Senate,"Assembly 3rd Reading AB2268 Gray et al. By Wiener Urgency Clause",33,0,0,7,40
1592550,1225913,2022-08-31,Assembly,"AB 2268 Gray Concurrence - Urgency Added",66,0,0,14,80
1592551,1189945,2022-04-18,Assembly,"Do pass and be re-referred to the Committee on [Appropriations] with recommendation: To Consent Calendar",12,0,0,0,12
1592551,1199943,2022-05-04,Assembly,"Do pass. To Consent Calendar",14,0,0,2,16
1592551,1204102,2022-05-12,Assembly,"AB 2269 Grayson Consent Calendar Second Day Regular Session",65,0,0,13,78
1592551,1217872,2022-06-22,Senate,"Do pass as amended, but first amend, and re-refer to the Committee on [Judiciary]",6,0,0,3,9
1592551,1220697,2022-06-28,Senate,"Do pass as amended, but first amend, and re-refer to the Committee on [Appropriations]",9,1,0,1,11
1592551,1222834,2022-08-01,Senate,"Placed on suspense file",7,0,0,0,7
1592551,1223495,2022-08-11,Senate,"Do pass as amended",5,1,0,1,7
1592551,1225176,2022-08-30,Assembly,"With recommendation: That Senate amendments be concurred in",10,0,0,2,12
1592551,1225478,2022-08-29,Senate,"Assembly 3rd Reading AB2269 Grayson et al. By Lim贸n",31,6,0,3,40
1592551,1225479,2022-08-30,Assembly,"AB 2269 Grayson Concurrence in Senate Amendments",71,0,0,9,80
1592552,1174482,2022-03-21,Assembly,"Do pass and be re-referred to the Committee on [Appropriations]",15,0,0,0,15
1592552,1184683,2022-04-06,Assembly,"Do pass. To Consent Calendar",13,0,0,3,16
1592552,1191295,2022-04-21,Assembly,"AB 2270 Seyarto Consent Calendar Second Day Regular Session",68,0,0,9,77
1592552,1216389,2022-06-14,Senate,"Do pass, but first be re-referred to the Committee on [Appropriations] with the recommendation: To Consent Calendar",15,0,0,2,17
1592552,1224117,2022-08-17,Senate,"Assembly 3rd Reading AB2270 Seyarto By Jones",38,0,0,2,40
1592553,1175555,2022-03-23,Senate,"Do pass and be ordered to the Consent Calendar",7,0,0,0,7
1592553,1181328,2022-03-31,Senate,"Consent Calendar SB1080 Min",39,0,0,1,40
1592554,1199951,2022-05-04,Assembly,"Do pass as amended",8,0,0,0,8
1592554,1207710,2022-05-23,Assembly,"AB 2271 Gipson Assembly Third Reading",72,0,0,6,78
1592554,1220657,2022-06-28,Senate,"Do pass",16,0,0,1,17
1592554,1225008,2022-08-25,Senate,"Assembly 3rd Reading AB2271 Gipson By Hertzberg",39,0,0,1,40
1592555,1183725,2022-04-05,Assembly,"Do pass and be re-referred to the Committee on [Appropriations]",11,0,0,1,12
1592555,1194426,2022-04-27,Assembly,"Do pass. To Consent Calendar",15,0,0,1,16
1592555,1200669,2022-05-05,Assembly,"AB 2272 Low Consent Calendar Second Day Regular Session",61,0,0,17,78
1592555,1214964,2022-06-08,Senate,"Do pass, but first be re-referred to the Committee on [Appropriations] with the recommendation: To Consent Calendar",7,0,0,0,7
1592555,1219519,2022-06-27,Senate,"Consent Calendar AB2272",37,0,0,3,40
1592556,1189897,2022-04-19,Assembly,"Do pass as amended and be re-referred to the Committee on [Appropriations]",10,0,0,1,11
1592556,1206526,2022-05-19,Assembly,"Do pass",16,0,0,0,16
1592556,1210519,2022-05-26,Assembly,"AB 2273 Wicks Assembly Third Reading",72,0,0,6,78
1592556,1220690,2022-06-28,Senate,"Do pass as amended, but first amend, and re-refer to the Committee on [Appropriations]",9,1,0,1,11
1592556,1222866,2022-08-01,Senate,"Placed on suspense file",7,0,0,0,7
1592556,1223705,2022-08-11,Senate,"Do pass as amended",5,0,0,2,7
1592556,1225539,2022-08-29,Senate,"Assembly 3rd Reading AB2273 Wicks et al. By Newman",33,0,0,7,40
1592556,1225540,2022-08-30,Assembly,"AB 2273 Wicks Concurrence in Senate Amendments",75,0,0,5,80
1592556,1229730,2022-08-30,Senate,"Assembly 3rd Reading AB2273 Wicks et al. By Newman",33,0,0,7,40
1592557,1183600,2022-04-05,Senate,"Do pass, but first be re-referred to the Committee on [Appropriations]",4,0,0,1,5
1592557,1198279,2022-05-02,Senate,"Placed on suspense file",7,0,0,0,7
1592557,1206446,2022-05-19,Senate,"Do pass",7,0,0,0,7
1592557,1207724,2022-05-23,Senate,"Senate 3rd Reading SB1034 Atkins",37,0,0,3,40
1592557,1214949,2022-06-08,Assembly,"Do pass and be re-referred to the Committee on [Appropriations]",7,0,0,0,7
1592557,1223500,2022-08-11,Assembly,"Do pass as amended",13,0,0,3,16
1592557,1224580,2022-08-23,Assembly,"SB 1034 Atkins Senate Third Reading By Maienschein",70,0,0,10,80
1592557,1224931,2022-08-25,Senate,"Unfinished Business SB1034 Atkins Concurrence",40,0,0,0,40
1592558,1179557,2022-03-29,Assembly,"Do pass as amended",7,0,0,0,7
1592558,1201465,2022-05-09,Assembly,"AB 2274 Blanca Rubio Assembly Third Reading",66,0,0,12,78
1592558,1215786,2022-06-14,Senate,"Do pass, but first be re-referred to the Committee on [Appropriations]",5,0,0,0,5
1592558,1219419,2022-06-27,Senate,"Placed on suspense file",6,0,0,1,7
1592558,1224000,2022-08-11,Senate,"Do pass",7,0,0,0,7
1592558,1224625,2022-08-23,Senate,"Special Consent AB2274",40,0,0,0,40
1592559,1183731,2022-04-05,Assembly,"Do pass and be re-referred to the Committee on [Judiciary]",13,0,0,2,15
1592559,1189885,2022-04-19,Assembly,"Do pass as amended and be re-referred to the Committee on [Appropriations]",9,0,0,2,11
1592559,1206810,2022-05-19,Assembly,"Do pass",16,0,0,0,16
1592559,1210525,2022-05-25,Assembly,"AB 2275 Wood Assembly Third Reading",74,0,0,4,78
1592559,1218675,2022-06-22,Senate,"Do pass, but first be re-referred to the Committee on [Judiciary]",9,0,0,2,11
1592559,1220631,2022-06-28,Senate,"Do pass, but first be re-referred to the Committee on [Appropriations] with the recommendation: To Consent Calendar",10,0,0,1,11
1592559,1222850,2022-08-01,Senate,"Placed on suspense file",7,0,0,0,7
1592559,1223764,2022-08-11,Senate,"Do pass as amended",7,0,0,0,7
1592559,1225605,2022-08-31,Senate,"Special Consent AB2275",40,0,0,0,40
1592559,1225606,2022-08-31,Assembly,"AB 2275 Wood Concurrence in Senate Amendments",79,0,0,1,80
1592560,1183729,2022-04-05,Assembly,"Do pass as amended and be re-referred to the Committee on [Appropriations]",13,0,0,5,18
1592562,1183787,2022-04-05,Assembly,"Do pass and be re-referred to the Committee on [Appropriations] with recommendation: To Consent Calendar",8,0,0,0,8
1592562,1206604,2022-05-19,Assembly,"Do pass",15,0,0,1,16
1592562,1207688,2022-05-23,Assembly,"AB 2277 Reyes Assembly Third Reading",74,0,0,4,78
1592562,1215911,2022-06-13,Senate,"Do pass, but first be re-referred to the Committee on [Appropriations]",5,0,0,0,5
1592562,1219465,2022-06-27,Senate,"Placed on suspense file",6,0,0,1,7
1592562,1223556,2022-08-11,Senate,"Do pass",7,0,0,0,7
1592562,1224247,2022-08-18,Senate,"Assembly 3rd Reading AB2277 Reyes By Pan",38,0,0,2,40
1592563,1174528,2022-03-22,Senate,"Do pass as amended, but first amend, and re-refer to the Committee on [Appropriations]",7,0,0,2,9
1592563,1182519,2022-04-04,Senate,"Placed on suspense file",6,0,0,1,7
1592563,1206934,2022-05-19,Senate,"Do pass as amended",5,1,0,1,7
1592563,1208444,2022-05-24,Senate,"Senate 3rd Reading SB1078 Allen",28,5,0,7,40
1592563,1217079,2022-06-20,Assembly,"Do pass and be re-referred to the Committee on [Appropriations]",7,1,0,3,11
1592563,1223960,2022-08-11,Assembly,"Do pass",12,4,0,0,16
1592563,1225611,2022-08-31,Senate,"Unfinished Business SB1078 Allen Concurrence",30,6,0,4,40
1592563,1225612,2022-08-31,Assembly,"SB 1078 Allen Senate Third Reading By Bauer-Kahan",61,12,0,7,80
1592564,1192208,2022-04-25,Assembly,"Do pass and be re-referred to the Committee on [Appropriations] with recommendation: To Consent Calendar",10,0,0,1,11
1592564,1206711,2022-05-19,Assembly,"Do pass",16,0,0,0,16
1592564,1207828,2022-05-23,Assembly,"AB 2278 Kalra Assembly Third Reading",74,0,0,4,78
1592564,1220010,2022-06-28,Senate,"Do pass as amended, but first amend, and re-refer to the Committee on [Appropriations]",7,1,0,1,9
1592564,1222922,2022-08-01,Senate,"Placed on suspense file",7,0,0,0,7
1592564,1223664,2022-08-11,Senate,"Do pass as amended",6,0,0,1,7
1592564,1224736,2022-08-24,Senate,"Assembly 3rd Reading AB2278 Kalra By Allen",33,3,0,4,40
1592564,1224886,2022-08-25,Assembly,"AB 2278 Kalra Concurrence in Senate Amendments",73,0,0,7,80
1592565,1183848,2022-04-05,Assembly,"Do pass and be re-referred to the Committee on [Appropriations] with recommendation: To Consent Calendar",9,0,0,1,10
1592566,1174495,2022-03-22,Assembly,"Do pass as amended and be re-referred to the Committee on [Appropriations]",9,0,0,0,9
1592566,1206299,2022-05-19,Assembly,"Do pass as amended",12,0,0,4,16
1592566,1210376,2022-05-25,Assembly,"AB 2280 Reyes Assembly Third Reading",76,0,0,2,78
1592566,1216328,2022-06-14,Senate,"Do pass, but first be re-referred to the Committee on [Appropriations] with the recommendation: To Consent Calendar",11,0,0,0,11
1592566,1219512,2022-06-27,Senate,"Placed on suspense file",6,0,0,1,7
1592566,1223417,2022-08-11,Senate,"Do pass",7,0,0,0,7
1592566,1224119,2022-08-17,Senate,"Assembly 3rd Reading AB2280 Reyes By Umberg",38,0,0,2,40
1592567,1193167,2022-04-26,Assembly,"Do pass and be re-referred to the Committee on [Appropriations]",14,0,0,1,15
1592567,1206395,2022-05-19,Assembly,"Do pass",16,0,0,0,16
1592567,1210545,2022-05-25,Assembly,"AB 2281 Lackey Assembly Third Reading",76,0,0,2,78
1592567,1216253,2022-06-15,Senate,"Do pass, but first be re-referred to the Committee on [Appropriations]",9,0,0,2,11
1592567,1219492,2022-06-27,Senate,"Placed on suspense file",6,0,0,1,7
1592567,1223868,2022-08-11,Senate,"Do pass",7,0,0,0,7
1592567,1224835,2022-08-24,Senate,"Assembly 3rd Reading AB2281 Lackey et al. By Newman",40,0,0,0,40
1592567,1224968,2022-08-25,Assembly,"AB 2281 Lackey Concurrence in Senate Amendments",76,0,0,4,80
1592568,1174516,2022-03-22,Senate,"Do pass as amended, but first amend, and re-refer to the Committee on [Appropriations] with the recommendation: To Consent Calendar",8,0,0,1,9
1592568,1182516,2022-04-04,Senate,"Placed on suspense file",6,0,0,1,7
1592568,1206322,2022-05-19,Senate,"Do pass as amended",7,0,0,0,7
1592568,1209995,2022-05-26,Senate,"Special Consent SB1077",38,0,0,2,40
1592568,1219354,2022-06-27,Assembly,"Do pass and be re-referred to the Committee on [Appropriations] with recommendation: To Consent Calendar",10,0,0,1,11
1592569,1179186,2022-03-29,Assembly,"Do pass as amended and be re-referred to the Committee on [Appropriations]",7,0,0,0,7
1592569,1206688,2022-05-19,Assembly,"Do pass as amended",12,0,0,4,16
1592569,1210240,2022-05-26,Assembly,"AB 2282 Bauer-Kahan Assembly Third Reading",73,0,0,5,78
1592569,1217470,2022-06-21,Senate,"Do pass, but first be re-referred to the Committee on [Appropriations]",4,0,0,1,5
1592569,1222832,2022-08-01,Senate,"Placed on suspense file",7,0,0,0,7
1592569,1223683,2022-08-11,Senate,"Do pass",6,0,0,1,7
1592569,1224568,2022-08-23,Senate,"Assembly 3rd Reading AB2282 Bauer-Kahan et al. By Hertzberg",39,0,0,1,40
1592570,1190495,2022-04-20,Assembly,"Do pass and be re-referred to the Committee on [Appropriations] with recommendation: To Consent Calendar",15,0,0,0,15
1592570,1206509,2022-05-19,Assembly,"Do pass",16,0,0,0,16
1592570,1207766,2022-05-23,Assembly,"AB 2283 Gallagher Assembly Third Reading",74,0,0,4,78
1592570,1217307,2022-06-21,Senate,"Do pass, but first be re-referred to the Committee on [Appropriations]",12,1,0,1,14
1592570,1222900,2022-08-01,Senate,"Placed on suspense file",7,0,0,0,7
1592570,1223915,2022-08-11,Senate,"Do pass",7,0,0,0,7
1592570,1224908,2022-08-25,Senate,"Assembly 3rd Reading AB2283 Gallagher By McGuire",36,0,0,4,40
1592572,1191318,2022-04-20,Assembly,"Do pass as amended and be re-referred to the Committee on [Appropriations]",7,0,0,0,7
1592572,1206665,2022-05-19,Assembly,"Do pass",16,0,0,0,16
1592572,1210511,2022-05-25,Assembly,"AB 2284 Gabriel Assembly Third Reading",75,0,0,3,78
1592572,1218030,2022-06-22,Senate,"Do pass, but first be re-referred to the Committee on [Appropriations]",6,0,0,1,7
1592572,1222751,2022-08-01,Senate,"Placed on suspense file",7,0,0,0,7
1592573,1194134,2022-04-27,Senate,"Do pass, but first be re-referred to the Committee on [Appropriations]",4,1,0,0,5
1592573,1208468,2022-05-24,Senate,"Senate 3rd Reading SB1061 Laird et al",28,9,0,3,40
1592573,1216335,2022-06-15,Assembly,"Do pass as amended and be re-referred to the Committee on [Appropriations]",5,1,0,1,7
1592573,1223006,2022-08-03,Assembly,"Do pass",11,4,0,1,16
1592573,1223875,2022-08-11,Assembly,"SB 1061 Laird Senate Third Reading By Bryan",59,18,0,3,80
1592573,1224092,2022-08-16,Senate,"Unfinished Business SB1061 Laird et al. Concurrence",27,9,0,4,40
1592574,1179244,2022-03-29,Assembly,"Do pass",2,5,0,0,7
1592574,1193239,2022-04-26,Assembly,"Do pass",2,5,0,0,7
1592575,1190677,2022-04-19,Assembly,"Do pass and be re-referred to the Committee on [Appropriations]",12,0,0,0,12
1592575,1206482,2022-05-19,Assembly,"Do pass",16,0,0,0,16
1592575,1207752,2022-05-23,Assembly,"AB 2286 Irwin Assembly Third Reading",74,0,0,4,78
1592575,1217882,2022-06-22,Senate,"Do pass, but first be re-referred to the Committee on [Appropriations] with the recommendation: To Consent Calendar",6,0,0,1,7
1592575,1223258,2022-08-08,Senate,"Consent Calendar AB2286",36,0,0,4,40
1592576,1183591,2022-04-05,Assembly,"Do pass and be re-referred to the Committee on [Natural Resources] with recommendation: To Consent Calendar",13,0,0,2,15
1592576,1192165,2022-04-25,Assembly,"Do pass and be re-referred to the Committee on [Appropriations] with recommendation: To Consent Calendar",10,0,0,1,11
1592576,1206407,2022-05-19,Assembly,"Do pass as amended",12,0,0,4,16
1592576,1210659,2022-05-25,Assembly,"AB 2287 Stone Assembly Third Reading",76,0,0,2,78
1592576,1217110,2022-06-20,Senate,"Do pass as amended, but first amend, and re-refer to the Committee on [Appropriations] with the recommendation: To Consent Calendar",7,0,0,2,9
1592576,1223170,2022-08-08,Senate,"Consent Calendar AB2287",36,0,0,4,40
1592576,1223380,2022-08-11,Assembly,"AB 2287 Stone Concurrence in Senate Amendments",76,0,0,4,80
1592578,1174490,2022-03-22,Assembly,"Do pass and be re-referred to the Committee on [Health] with recommendation: To Consent Calendar",9,0,0,0,9
1592578,1189955,2022-04-19,Assembly,"Do pass. To Consent Calendar",13,0,0,2,15
1592578,1195719,2022-04-28,Assembly,"AB 2288 Choi Consent Calendar Second Day",71,0,0,6,77
1592578,1210912,2022-05-31,Senate,"Do pass and be ordered to the Consent Calendar",8,0,0,3,11
1592578,1215269,2022-06-09,Senate,"Consent Calendar AB2288",38,0,0,2,40
1592579,1173499,2022-03-21,Senate,"Do pass, but first be re-referred to the Committee on [Energy, Utilities and Communications]",12,0,0,2,14
1592579,1193233,2022-04-26,Senate,"Do pass as amended, but first amend, and re-refer to the Committee on [Appropriations]",12,0,0,2,14
1592579,1204661,2022-05-16,Senate,"Placed on suspense file",6,0,0,1,7
1592579,1206779,2022-05-19,Senate,"Do pass as amended",7,0,0,0,7
1592579,1210013,2022-05-26,Senate,"Special Consent SB1075",38,0,0,2,40
1592579,1217947,2022-06-22,Assembly,"Do pass and be re-referred to the Committee on [Natural Resources]",14,0,0,1,15
1592579,1219430,2022-06-27,Assembly,"Do pass as amended and be re-referred to the Committee on [Appropriations]",10,0,0,1,11
1592579,1223507,2022-08-11,Assembly,"Do pass as amended",12,0,0,4,16
1592579,1225769,2022-08-30,Senate,"Unfinished Business SB1075 Skinner et al. Concurrence",37,0,0,3,40
1592579,1225770,2022-08-30,Assembly,"SB 1075 Skinner Senate Third Reading By Holden",79,0,0,1,80
1592583,1184706,2022-04-06,Senate,"Do pass, but first be re-referred to the Committee on [Appropriations] with the recommendation: To Consent Calendar",10,0,0,1,11
1592583,1192245,2022-04-25,Senate,"Placed on suspense file",5,0,0,2,7
1592583,1206273,2022-05-19,Senate,"Do pass",7,0,0,0,7
1592583,1209380,2022-05-25,Senate,"Special Consent SB1023",39,0,0,1,40
1592585,1175504,2022-03-22,Assembly,"Do pass and be re-referred to the Committee on [Appropriations] with recommendation: To Consent Calendar",9,0,0,0,9
1592585,1206851,2022-05-19,Assembly,"Do pass",16,0,0,0,16
1592585,1207741,2022-05-23,Assembly,"AB 2293 E.S. & T.M. Assembly Third Reading By QUIRK",74,0,0,4,78
1592585,1215043,2022-06-08,Senate,"Do pass, but first be re-referred to the Committee on [Appropriations] with the recommendation: To Consent Calendar",5,0,0,2,7
1592585,1217100,2022-06-20,Senate,"Placed on suspense file",4,0,0,3,7
1592585,1223534,2022-08-11,Senate,"Do pass",7,0,0,0,7
1592585,1224430,2022-08-23,Senate,"Special Consent AB2293 E.S. & T.M",40,0,0,0,40
1592586,1189824,2022-04-19,Assembly,"Do pass and be re-referred to the Committee on [Appropriations]",5,2,0,0,7
1592586,1206658,2022-05-19,Assembly,"Do pass",12,3,0,1,16
1592586,1210550,2022-05-26,Assembly,"AB 2294 Jones-Sawyer Third Reading Urgency",54,15,0,9,78
1592586,1217321,2022-06-21,Senate,"Do pass, but first be re-referred to the Committee on [Appropriations]",4,0,0,1,5
1592586,1222644,2022-08-01,Senate,"Placed on suspense file",7,0,0,0,7
1592586,1223865,2022-08-11,Senate,"Do pass",6,1,0,0,7
1592586,1225639,2022-08-30,Senate,"Assembly 3rd Reading AB2294 Jones-Sawyer By Caballero Urgency Clause",30,8,0,2,40
1592586,1225640,2022-08-31,Assembly,"AB 2294 Jones-Sawyer Concurrence in Senate Amendments",59,13,0,8,80
1592588,1190707,2022-04-20,Assembly,"Do pass as amended and be re-referred to the Committee on [Local Government]",6,1,0,1,8
1592588,1195819,2022-04-27,Assembly,"Do pass as amended and be re-referred to the Committee on [Appropriations]",6,1,0,1,8
1592588,1203315,2022-05-11,Assembly,"Do pass",12,4,0,0,16
1592588,1210260,2022-05-26,Assembly,"AB 2295 Bloom Assembly Third Reading",50,19,0,9,78
1592588,1216278,2022-06-15,Senate,"Do pass, but first be re-referred to the Committee on [Housing]",5,0,0,0,5
1592588,1217952,2022-06-21,Senate,"Do pass as amended, but first amend, and re-refer to the Committee on [Appropriations]",6,1,0,2,9
1592588,1225668,2022-08-29,Senate,"Assembly 3rd Reading AB2295 Bloom et al. By Wiener",27,10,0,3,40
1592588,1225669,2022-08-30,Assembly,"AB 2295 Bloom Concurrence in Senate Amendments",55,17,0,8,80
1592589,1174483,2022-03-22,Assembly,"Do pass and be re-referred to the Committee on [Appropriations]",6,2,0,1,9
1592589,1206671,2022-05-19,Assembly,"Do pass",12,3,0,1,16
1592589,1210383,2022-05-25,Assembly,"AB 2296 Jones-Sawyer Assembly Third Reading",56,13,0,9,78
1592589,1216298,2022-06-14,Senate,"Do pass, but first be re-referred to the Committee on [Appropriations]",9,0,0,2,11
1592589,1219448,2022-06-27,Senate,"Placed on suspense file",6,0,0,1,7
1592589,1223697,2022-08-11,Senate,"Do pass as amended",5,1,0,1,7
1592589,1225779,2022-08-29,Senate,"Assembly 3rd Reading AB2296 Jones-Sawyer By Kamlager",32,6,0,2,40
1592589,1225780,2022-08-30,Assembly,"AB 2296 Jones-Sawyer Concurrence in Senate Amendments",59,13,0,8,80
1592589,1229726,2022-08-30,Senate,"Assembly 3rd Reading AB2296 Jones-Sawyer By Kamlager",32,6,0,2,40
1592590,1179178,2022-03-29,Senate,"Do pass, but first be re-referred to the Committee on [Judiciary]",4,0,0,1,5
1592590,1190554,2022-04-19,Senate,"Do pass, but first be re-referred to the Committee on [Appropriations] with the recommendation: To Consent Calendar",11,0,0,0,11
1592590,1201452,2022-05-09,Senate,"Consent Calendar SB1071",33,0,0,7,40
1592590,1215741,2022-06-14,Assembly,"Do pass and be re-referred to the Committee on [Judiciary] with recommendation: To Consent Calendar",7,0,0,1,8
1592590,1217412,2022-06-21,Assembly,"Do pass and be re-referred to the Committee on [Appropriations] with recommendation: To Consent Calendar",10,0,0,0,10
1592590,1223642,2022-08-11,Assembly,"Do pass as amended",12,0,0,4,16
1592590,1225759,2022-08-30,Senate,"Unfinished Business SB1071 Umberg Concurrence",37,0,0,3,40
1592590,1225760,2022-08-30,Assembly,"SB 1071 Umberg Senate Third Reading By Bryan",79,0,0,1,80
1592592,1183595,2022-04-05,Assembly,"Do pass and be re-referred to the Committee on [Appropriations] with recommendation: To Consent Calendar",14,0,0,1,15
1592592,1206761,2022-05-19,Assembly,"Do pass",16,0,0,0,16
1592592,1210425,2022-05-26,Assembly,"AB 2298 Mayes Assembly Third Reading",76,0,0,2,78
1592592,1218624,2022-06-22,Senate,"Do pass as amended, but first amend, and re-refer to the Committee on [Appropriations] with the recommendation: To Consent Calendar",9,0,0,2,11
1592592,1222712,2022-08-01,Senate,"Placed on suspense file",7,0,0,0,7
1592592,1223983,2022-08-11,Senate,"Do pass",7,0,0,0,7
1592592,1225815,2022-08-31,Senate,"Special Consent AB2298",40,0,0,0,40
1592592,1225816,2022-08-31,Assembly,"AB 2298 Mayes Concurrence in Senate Amendments",78,0,0,2,80
1592594,1200518,2022-05-04,Senate,"Do pass, but first be re-referred to the Committee on [Appropriations] with the recommendation: To Consent Calendar",5,0,0,0,5
1592594,1204622,2022-05-16,Senate,"Placed on suspense file",6,0,0,1,7
1592594,1206802,2022-05-19,Senate,"Do pass",7,0,0,0,7
1592594,1207842,2022-05-23,Senate,"Senate 3rd Reading SB1041 Atkins et al",37,0,0,3,40
1592594,1221218,2022-06-30,Assembly,"Do pass and be re-referred to the Committee on [Appropriations]",11,0,0,0,11
1592594,1222982,2022-08-03,Assembly,"Do pass. To Consent Calendar",15,0,0,1,16
1592594,1223609,2022-08-11,Assembly,"SB 1041 Atkins Consent Calendar Second Day Regular Session",76,0,0,4,80
1592595,1193170,2022-04-26,Assembly,"Do pass as amended and be re-referred to the Committee on [Appropriations]",7,0,0,1,8
1592595,1206254,2022-05-19,Assembly,"Do pass as amended",13,1,0,2,16
1592595,1210396,2022-05-25,Assembly,"AB 2300 Kalra Assembly Third Reading",59,6,0,13,78
1592595,1219890,2022-06-27,Senate,"Do pass, but first be re-referred to the Committee on [Appropriations]",4,1,0,0,5
1592595,1222666,2022-08-01,Senate,"Placed on suspense file",7,0,0,0,7
1592595,1223888,2022-08-11,Senate,"Do pass as amended",5,2,0,0,7
1592595,1225011,2022-08-25,Senate,"Assembly 3rd Reading AB2300 Kalra By Skinner",31,6,0,3,40
1592595,1225012,2022-08-25,Assembly,"AB 2300 Kalra Concurrence in Senate Amendments",60,0,0,20,80
1592596,1191320,2022-04-20,Assembly,"Do pass as amended and be re-referred to the Committee on [Appropriations]",20,0,0,2,22
1592596,1203342,2022-05-11,Assembly,"Do pass",16,0,0,0,16
1592596,1204655,2022-05-16,Assembly,"AB 2301 Wood Assembly Third Reading",71,0,0,7,78
1592596,1215885,2022-06-14,Senate,"Do pass, but first be re-referred to the Committee on [Appropriations]",14,0,0,1,15
1592596,1224337,2022-08-22,Senate,"Assembly 3rd Reading AB2301 Wood et al. By Jones",40,0,0,0,40
1592596,1224611,2022-08-23,Assembly,"AB 2301 Wood Concurrence in Senate Amendments",77,0,0,3,80
1592598,1180256,2022-03-30,Assembly,"Do pass as amended, and be re-referred to the Committee on [Natural Resources] with recommendation: To Consent Calendar",12,0,0,2,14
1592599,1180220,2022-03-30,Assembly,"Do pass and be re-referred to the Committee on [Appropriations]",19,0,0,3,22
1592599,1206641,2022-05-19,Assembly,"Do pass",15,0,0,1,16
1592599,1207778,2022-05-23,Assembly,"AB 2303 Aguiar-Curry Assembly Third Reading",74,0,0,4,78
1592599,1220076,2022-06-28,Senate,"Do pass, but first be re-referred to the Committee on [Appropriations]",13,0,0,2,15
1592599,1224114,2022-08-17,Senate,"Assembly 3rd Reading AB2303 Aguiar-Curry et al. By Dodd",38,0,0,2,40
1592599,1224375,2022-08-22,Assembly,"AB 2303 Aguiar-Curry Concurrence in Senate Amendments",75,0,0,5,80
1592600,1193147,2022-04-26,Senate,"Do pass, but first be re-referred to the Committee on [Appropriations]",10,2,0,3,15
1592600,1207779,2022-05-23,Senate,"Senate 3rd Reading SB1030 Lim贸n",27,10,0,3,40
1592600,1219401,2022-06-27,Assembly,"Do pass and be re-referred to the Committee on [Appropriations]",4,2,0,1,7
1592600,1223326,2022-08-10,Assembly,"Do pass",11,3,0,2,16
1592602,1190561,2022-04-20,Assembly,"Do pass and be re-referred to the Committee on [Appropriations]",8,0,0,0,8
1592602,1206451,2022-05-19,Assembly,"Do pass as amended",12,0,0,4,16
1592602,1210468,2022-05-25,Assembly,"AB 2305 Grayson Assembly Third Reading",76,0,0,2,78
1592603,1183820,2022-04-05,Assembly,"Do pass and be re-referred to the Committee on [Judiciary]",8,0,0,0,8
1592603,1189841,2022-04-19,Assembly,"Do pass as amended, and be re-referred to the Committee on [Appropriations] with recommendation: To Consent Calendar",9,0,0,2,11
1592603,1206782,2022-05-19,Assembly,"Do pass as amended",12,0,0,4,16
1592603,1210488,2022-05-25,Assembly,"AB 2306 Cooley Assembly Third Reading",76,0,0,2,78
1592603,1220044,2022-06-27,Senate,"Do pass, but first be re-referred to the Committee on [Appropriations] with the recommendation: To Consent Calendar",5,0,0,0,5
1592603,1223159,2022-08-08,Senate,"Placed on suspense file",7,0,0,0,7
1592603,1223700,2022-08-11,Senate,"Do pass",7,0,0,0,7
1592603,1225503,2022-08-31,Senate,"Special Consent AB2306",40,0,0,0,40
1592603,1225504,2022-08-31,Assembly,"AB 2306 Cooley Concurrence in Senate Amendments",80,0,0,0,80
1592605,1191302,2022-04-20,Assembly,"Do pass as amended and be re-referred to the Committee on [Appropriations]",20,0,0,2,22
1592605,1203370,2022-05-11,Assembly,"Do pass",16,0,0,0,16
1592605,1204609,2022-05-16,Assembly,"AB 2307 Berman Assembly Third Reading",71,0,0,7,78
1592605,1215873,2022-06-14,Senate,"Do pass, but first be re-referred to the Committee on [Appropriations]",14,0,0,1,15
1592605,1224218,2022-08-18,Senate,"Assembly 3rd Reading AB2307 Berman et al. By Jones",38,0,0,2,40
1592605,1224251,2022-08-22,Assembly,"AB 2307 Berman Concurrence in Senate Amendments",77,0,0,3,80
1592607,1174545,2022-03-22,Senate,"Do pass, but first be re-referred to the Committee on [Appropriations]",8,0,0,1,9
1592607,1182539,2022-04-04,Senate,"Placed on suspense file",6,0,0,1,7
1592607,1206262,2022-05-19,Senate,"Do pass as amended",7,0,0,0,7
1592607,1209955,2022-05-26,Senate,"Special Consent SB1052",38,0,0,2,40
1592607,1215544,2022-06-13,Assembly,"Do pass and be re-referred to the Committee on [Appropriations]",10,0,0,1,11
1592607,1223551,2022-08-11,Assembly,"Do pass",15,1,0,0,16
1592607,1224223,2022-08-18,Assembly,"SB 1052 Kamlager Senate Third Reading By Bryan",72,0,0,8,80
1592608,1174477,2022-03-22,Assembly,"Do pass and be re-referred to the Committee on [Human Services]",9,0,0,0,9
1592608,1193208,2022-04-26,Assembly,"Do pass and be re-referred to the Committee on [Appropriations]",7,0,0,1,8
1592608,1206298,2022-05-19,Assembly,"Do pass",14,0,0,2,16
1592608,1207738,2022-05-23,Assembly,"AB 2309 Friedman Assembly Third Reading",71,0,0,7,78
1592608,1216363,2022-06-14,Senate,"Do pass as amended, but first amend, and re-refer to the Committee on [Human Services]",11,0,0,0,11
1592608,1219953,2022-06-27,Senate,"Do pass, but first be re-referred to the Committee on [Appropriations]",5,0,0,0,5
1592608,1223204,2022-08-08,Senate,"Placed on suspense file",7,0,0,0,7
1592608,1223895,2022-08-11,Senate,"Do pass as amended",6,0,0,1,7
1592608,1225799,2022-08-30,Senate,"Assembly 3rd Reading AB2309 Friedman By Caballero",40,0,0,0,40
1592608,1225800,2022-08-31,Assembly,"AB 2309 Friedman Concurrence in Senate Amendments",76,0,0,4,80
1592610,1183745,2022-04-05,Assembly,"Do pass and be re-referred to the Committee on [Appropriations]",7,1,0,2,10
1592610,1194127,2022-04-27,Assembly,"Do pass",11,4,0,1,16
1592610,1210462,2022-05-25,Assembly,"AB 2311 Maienschein Assembly Third Reading",52,16,0,10,78
1592610,1220676,2022-06-28,Senate,"Do pass as amended, but first amend, and re-refer to the Committee on [Appropriations]",9,0,0,2,11
1592610,1224798,2022-08-24,Senate,"Assembly 3rd Reading AB2311 Maienschein By Eggman",32,0,0,8,40
1592610,1224958,2022-08-25,Assembly,"AB 2311 Maienschein Concurrence in Senate Amendments",60,3,0,17,80
1592612,1179137,2022-03-29,Assembly,"Do pass as amended and be re-referred to the Committee on [Water, Parks, and Wildlife]",10,0,0,0,10
1592612,1193209,2022-04-26,Assembly,"Do pass as amended and be re-referred to the Committee on [Appropriations]",15,0,0,0,15
1592612,1206558,2022-05-19,Assembly,"Do pass",16,0,0,0,16
1592612,1207717,2022-05-23,Assembly,"AB 2313 Bloom Assembly Third Reading",74,0,0,4,78
1592612,1220776,2022-06-28,Senate,"Do pass as amended, but first amend, and re-refer to the Committee on [Appropriations] with the recommendation: To Consent Calendar",10,0,0,1,11
1592612,1222825,2022-08-01,Senate,"Placed on suspense file",7,0,0,0,7
1592613,1189998,2022-04-18,Assembly,"Do pass as amended and be re-referred to the Committee on [Jobs, Economic Development, and the Economy]",12,0,0,0,12
1592613,1193221,2022-04-26,Assembly,"Do pass as amended and be re-referred to the Committee on [Appropriations]",6,0,0,0,6
1592613,1206837,2022-05-19,Assembly,"Do pass as amended",12,0,0,4,16
1592613,1210493,2022-05-25,Assembly,"AB 2314 Petrie-Norris Assembly Third Reading",76,0,0,2,78
1592613,1219370,2022-06-27,Senate,"Do pass as amended, but first amend, and re-refer to the Committee on [Banking and Financial Institutions]",14,0,0,0,14
1592613,1222851,2022-08-01,Senate,"Placed on suspense file",7,0,0,0,7
1592614,1194280,2022-04-26,Assembly,"Do pass and be re-referred to the Committee on [Appropriations]",10,0,0,2,12
1592614,1203330,2022-05-11,Assembly,"Do pass",12,0,0,4,16
1592614,1204616,2022-05-16,Assembly,"AB 2315 Arambula Assembly Third Reading",56,0,0,22,78
1592614,1216371,2022-06-15,Senate,"Do pass, but first be re-referred to the Committee on [Judiciary]",5,1,0,1,7
1592614,1217879,2022-06-21,Senate,"Do pass, but first be re-referred to the Committee on [Appropriations]",9,2,0,0,11
1592614,1224406,2022-08-23,Senate,"Assembly 3rd Reading AB2315 Arambula et al. By Laird",31,8,0,1,40
1592614,1224760,2022-08-24,Assembly,"AB 2315 Arambula Concurrence in Senate Amendments",60,0,0,20,80
1592615,1194208,2022-04-27,Assembly,"Do pass as amended and be re-referred to the Committee on [Appropriations]",9,3,0,3,15
1592615,1206373,2022-05-19,Assembly,"Do pass as amended",12,4,0,0,16
1592615,1210526,2022-05-25,Assembly,"AB 2316 Ward Assembly Third Reading",47,22,0,9,78
1592615,1219440,2022-06-27,Senate,"Do pass, but first be re-referred to the Committee on [Labor, Public Employment and Retirement ]",11,2,0,1,14
1592615,1220670,2022-06-29,Senate,"Do pass as amended, but first amend, and re-refer to the Committee on [Appropriations]",4,1,0,0,5
1592615,1223175,2022-08-08,Senate,"Placed on suspense file",7,0,0,0,7
1592615,1223668,2022-08-11,Senate,"Do pass as amended",5,2,0,0,7
1592615,1225552,2022-08-29,Senate,"Assembly 3rd Reading AB2316 Ward et al. By Hertzberg",31,9,0,0,40
1592615,1225553,2022-08-30,Assembly,"AB 2316 Ward Concurrence in Senate Amendments",51,16,0,13,80
1592617,1193189,2022-04-26,Assembly,"Do pass as amended and be re-referred to the Committee on [Appropriations]",14,0,0,1,15
1592617,1206469,2022-05-19,Assembly,"Do pass",16,0,0,0,16
1592617,1207825,2022-05-23,Assembly,"AB 2317 Ramos Assembly Third Reading",74,0,0,4,78
1592617,1218597,2022-06-22,Senate,"Do pass, but first be re-referred to the Committee on [Judiciary]",9,0,0,2,11
1592617,1222755,2022-08-01,Senate,"Placed on suspense file",7,0,0,0,7
1592617,1223606,2022-08-11,Senate,"Do pass",7,0,0,0,7
1592617,1225098,2022-08-29,Senate,"That the measure be returned to Senate Floor for consideration. Ordered to third reading",10,0,0,1,11
1592617,1225185,2022-08-31,Assembly,"With recommendation: That Senate amendments be concurred in",14,0,0,0,14
1592617,1225455,2022-08-31,Senate,"Assembly 3rd Reading AB2317 Ramos By Portantino",40,0,0,0,40
1592617,1225456,2022-08-31,Assembly,"AB 2317 Ramos Concurrence in Senate Amendments",76,1,0,3,80
1592620,1184678,2022-04-05,Senate,"Do pass as amended",9,0,0,2,11
1592620,1208469,2022-05-24,Senate,"Senate 3rd Reading SB1037 Umberg",37,0,0,3,40
1592620,1215757,2022-06-14,Assembly,"Do pass. To Consent Calendar",10,0,0,1,11
1592620,1217095,2022-06-20,Assembly,"SB 1037 Umberg Consent Calendar Second Day",72,0,0,8,80
1592621,1190506,2022-04-20,Assembly,"Do pass as amended and be re-referred to the Committee on [Housing and Community Development]",7,1,0,0,8
1592621,1194432,2022-04-27,Assembly,"Do pass and be re-referred to the Committee on [Appropriations]",7,0,0,1,8
1592621,1205826,2022-05-18,Assembly,"Do pass",11,3,0,2,16
1592621,1210494,2022-05-25,Assembly,"AB 2319 Mia Bonta Assembly Third Reading",64,3,0,11,78
1592621,1216400,2022-06-15,Senate,"Do pass, but first be re-referred to the Committee on [Housing]",5,0,0,0,5
1592621,1217935,2022-06-21,Senate,"Do pass as amended, but first amend, and re-refer to the Committee on [Appropriations]",7,0,0,2,9
1592621,1225793,2022-08-29,Senate,"Assembly 3rd Reading AB2319 Mia Bonta By Skinner",33,0,0,7,40
1592621,1225794,2022-08-30,Assembly,"AB 2319 Mia Bonta Concurrence in Senate Amendments",67,0,0,13,80
1592622,1183720,2022-04-05,Assembly,"Do pass as amended and be re-referred to the Committee on [Appropriations]",11,2,0,2,15
1592622,1206560,2022-05-19,Assembly,"Do pass",12,4,0,0,16
1592622,1207794,2022-05-23,Assembly,"AB 2320 Cristina Garcia Assembly Third Reading",54,15,0,9,78
1592622,1216397,2022-06-15,Senate,"Do pass as amended, but first amend, and re-refer to the Committee on [Appropriations]",7,2,0,2,11
1592622,1219457,2022-06-27,Senate,"Placed on suspense file",6,0,0,1,7
1592622,1223897,2022-08-11,Senate,"Do pass as amended",5,2,0,0,7
1592622,1224925,2022-08-25,Senate,"Assembly 3rd Reading AB2320 Cristina Garcia et a By Wiener",31,9,0,0,40
1592622,1224926,2022-08-25,Assembly,"AB 2320 Cristina Garcia Concurrence in Senate Amendments",57,14,0,9,80
1592623,1179410,2022-03-28,Senate,"Do pass, but first be re-referred to the Committee on [Public Safety]",6,0,0,1,7
1592623,1194117,2022-04-26,Senate,"Do pass, but first be re-referred to the Committee on [Appropriations]",5,0,0,0,5
1592623,1204643,2022-05-16,Senate,"Placed on suspense file",6,0,0,1,7
1592623,1206655,2022-05-19,Senate,"Do pass",5,1,0,1,7
1592623,1209298,2022-05-25,Senate,"Senate 3rd Reading SB1076 Archuleta",32,6,0,2,40
1592623,1216966,2022-06-14,Assembly,"Do pass and be re-referred to the Committee on [Judiciary]",9,0,0,0,9
1592623,1217413,2022-06-21,Assembly,"Do pass and be re-referred to the Committee on [Appropriations]",9,0,0,1,10
1592623,1223506,2022-08-11,Assembly,"Do pass as amended",12,0,0,4,16
1592623,1225059,2022-08-29,Assembly,"SB 1076 Archuleta Senate Third Reading By Reyes",75,0,0,5,80
1592623,1225308,2022-08-30,Senate,"Unfinished Business SB1076 Archuleta Concurrence",31,8,0,1,40
1592624,1179217,2022-03-29,Assembly,"Do pass and be re-referred to the Committee on [Appropriations]",7,0,0,0,7
1592624,1206598,2022-05-19,Assembly,"Do pass as amended",12,0,0,4,16
1592624,1210532,2022-05-26,Assembly,"AB 2321 Jones-Sawyer Assembly Third Reading",67,0,0,11,78
1592624,1220718,2022-06-28,Senate,"Do pass, but first be re-referred to the Committee on [Appropriations]",5,0,0,0,5
1592624,1222797,2022-08-01,Senate,"Placed on suspense file",7,0,0,0,7
1592624,1224006,2022-08-11,Senate,"Do pass",7,0,0,0,7
1592624,1224566,2022-08-23,Senate,"Special Consent AB2321",40,0,0,0,40
1592625,1193168,2022-04-26,Assembly,"Do pass as amended and be re-referred to the Committee on [Appropriations]",17,0,0,1,18
1592625,1205856,2022-05-18,Assembly,"Do pass",15,0,0,1,16
1592625,1210661,2022-05-25,Assembly,"AB 2322 Wood Assembly Third Reading",76,0,0,2,78
1592625,1219902,2022-06-28,Senate,"Do pass, but first be re-referred to the Committee on [Appropriations]",13,0,0,2,15
1592625,1224141,2022-08-17,Senate,"Assembly 3rd Reading AB2322 Wood By Dodd",38,0,0,2,40
1592627,1176522,2022-03-23,Assembly,"Do pass and be re-referred to the Committee on [Appropriations] with recommendation: To Consent Calendar",8,0,0,0,8
1592627,1184728,2022-04-06,Assembly,"Do pass. To Consent Calendar",13,0,0,3,16
1592627,1191269,2022-04-21,Assembly,"AB 2324 Irwin Consent Calendar Second Day Regular Session",68,0,0,9,77
1592627,1211915,2022-06-01,Senate,"Do pass, but first be re-referred to the Committee on [Appropriations] with the recommendation: To Consent Calendar",5,0,0,0,5
1592627,1219394,2022-06-27,Senate,"Consent Calendar AB2324",37,0,0,3,40
1592627,1221539,2022-06-29,Assembly,"AB 2324 Irwin Concurrence in Senate Amendments",78,0,0,2,80
1592628,1173515,2022-03-21,Senate,"Do pass, but first be re-referred to the Committee on [Labor, Public Employment and Retirement ]",12,0,0,2,14
1592628,1189946,2022-04-18,Senate,"Do pass, but first be re-referred to the Committee on [Appropriations] with the recommendation: To Consent Calendar",5,0,0,0,5
1592628,1201406,2022-05-09,Senate,"Consent Calendar SB1064",33,0,0,7,40
1592628,1215818,2022-06-14,Assembly,"Do pass and be re-referred to the Committee on [Insurance] with recommendation: To Consent Calendar",16,0,0,2,18
1592628,1217887,2022-06-22,Assembly,"Do pass and be re-referred to the Committee on [Appropriations] with recommendation: To Consent Calendar",11,1,0,2,14
1592628,1219198,2022-06-22,Assembly,"Do pass and be re-referred to the Committee on [Appropriations]",11,1,0,2,14
1592628,1222946,2022-08-03,Assembly,"Do pass. To Consent Calendar",15,0,0,1,16
1592628,1223738,2022-08-11,Assembly,"SB 1064 Newman Consent Calendar Second Day Regular Session",76,0,0,4,80
1592629,1190606,2022-04-20,Assembly,"Do pass as amended and be re-referred to the Committee on [Appropriations]",8,0,0,0,8
1592630,1193318,2022-04-26,Assembly,"Do pass as amended, and be re-referred to the Committee on [Appropriations] with recommendation: To Consent Calendar",14,0,0,1,15
1592630,1205871,2022-05-18,Assembly,"Do pass. To Consent Calendar",15,0,0,1,16
1592630,1210507,2022-05-25,Assembly,"AB 2326 Reyes Consent Calendar Second Day Regular Session",73,0,0,5,78
1592630,1214974,2022-06-08,Senate,"Do pass, but first be re-referred to the Committee on [Judiciary] with the recommendation: To Consent Calendar",9,0,0,2,11
1592630,1216326,2022-06-14,Senate,"Do pass, but first be re-referred to the Committee on [Appropriations] with the recommendation: To Consent Calendar",11,0,0,0,11
1592630,1224244,2022-08-18,Senate,"Assembly 3rd Reading AB2326 Reyes et al. By Leyva",38,0,0,2,40
1592630,1224356,2022-08-22,Assembly,"AB 2326 Reyes Concurrence in Senate Amendments",77,0,0,3,80
1592632,1194176,2022-04-26,Senate,"Do pass, but first be re-referred to the Committee on [Appropriations]",4,0,0,1,5
1592633,1176530,2022-03-23,Assembly,"Do pass and be re-referred to the Committee on [Judiciary]",7,0,0,0,7
1592633,1179163,2022-03-29,Assembly,"Do pass as amended, and be re-referred to the Committee on [Appropriations] with recommendation: To Consent Calendar",10,0,0,0,10
1592633,1194360,2022-04-27,Assembly,"Do pass. To Consent Calendar",15,0,0,1,16
1592633,1200670,2022-05-05,Assembly,"AB 2329 Carrillo Consent Calendar Second Day Regular Session",61,0,0,17,78
1592633,1216301,2022-06-15,Senate,"Do pass, but first be re-referred to the Committee on [Judiciary]",6,0,0,1,7
1592633,1217994,2022-06-21,Senate,"Do pass as amended, but first amend, and re-refer to the Committee on [Appropriations]",11,0,0,0,11
1592633,1225791,2022-08-29,Senate,"Assembly 3rd Reading AB2329 Carrillo et al. By Durazo",40,0,0,0,40
1592633,1225792,2022-08-30,Assembly,"AB 2329 Carrillo Concurrence in Senate Amendments",78,0,0,2,80
1592634,1189843,2022-04-18,Assembly,"Do pass and be re-referred to the Committee on [Appropriations]",14,0,0,1,15
1592634,1205842,2022-05-18,Assembly,"Do pass. To Consent Calendar",15,0,0,1,16
1592634,1210568,2022-05-25,Assembly,"AB 2330 Bigelow Consent Calendar Second Day Regular Session",73,0,0,5,78
1592634,1216361,2022-06-14,Senate,"Do pass, but first be re-referred to the Committee on [Appropriations] with the recommendation: To Consent Calendar",15,0,0,2,17
1592634,1221309,2022-06-30,Senate,"Consent Calendar AB2330",37,0,0,3,40
1592635,1189832,2022-04-19,Assembly,"Do pass and be re-referred to the Committee on [Appropriations] with recommendation: To Consent Calendar",7,0,0,0,7
1592635,1206619,2022-05-19,Assembly,"Do pass",16,0,0,0,16
1592635,1207744,2022-05-23,Assembly,"AB 2331 Calderon Assembly Third Reading",74,0,0,4,78
1592635,1215874,2022-06-13,Senate,"Do pass as amended, but first amend, and re-refer to the Committee on [Health]",5,0,0,0,5
1592635,1221288,2022-06-29,Senate,"Do pass, but first be re-referred to the Committee on [Appropriations] with the recommendation: To Consent Calendar",10,0,0,1,11
1592635,1222671,2022-08-01,Senate,"Placed on suspense file",7,0,0,0,7
1592636,1183614,2022-04-04,Senate,"Do pass as amended, but first amend, and re-refer to the Committee on [Public Safety]",14,0,0,0,14
1592636,1194203,2022-04-26,Senate,"Do pass as amended, but first amend, and re-refer to the Committee on [Appropriations] with the recommendation: To Consent Calendar",5,0,0,0,5
1592636,1201451,2022-05-09,Senate,"Placed on suspense file",7,0,0,0,7
1592636,1206310,2022-05-19,Senate,"Do pass as amended",7,0,0,0,7
1592636,1210025,2022-05-26,Senate,"Special Consent SB1087",38,0,0,2,40
1592636,1217466,2022-06-21,Assembly,"Do pass and be re-referred to the Committee on [Public Safety] with recommendation: To Consent Calendar",18,0,0,1,19
1592636,1219972,2022-06-28,Assembly,"Do pass and be re-referred to the Committee on [Appropriations] with recommendation: To Consent Calendar",7,0,0,0,7
1592636,1223861,2022-08-11,Assembly,"Do pass as amended",12,0,0,4,16
1592636,1225976,2022-08-30,Senate,"Unfinished Business SB1087 Gonzalez et al. Concurrence",37,0,0,3,40
1592636,1225977,2022-08-30,Assembly,"SB 1087 Gonzalez Senate Third Reading By Muratsuchi",79,0,0,1,80
1592637,1179707,2022-03-28,Assembly,"Do pass and be re-referred to the Committee on [Appropriations] with recommendation: To Consent Calendar",10,0,0,2,12
1592637,1184648,2022-04-06,Assembly,"Do pass. To Consent Calendar",13,0,0,3,16
1592637,1191309,2022-04-21,Assembly,"AB 2332 B. & F. Consent Calendar Second Day Regular Session",68,0,0,9,77
1592637,1215735,2022-06-14,Senate,"Do pass, but first be re-referred to the Committee on [Appropriations] with the recommendation: To Consent Calendar",14,0,0,1,15
1592637,1221263,2022-06-30,Senate,"Consent Calendar AB2332 B. & F",37,0,0,3,40
1592638,1174527,2022-03-22,Assembly,"Do pass and be re-referred to the Committee on [Appropriations]",2,5,0,0,7
1592639,1175509,2022-03-23,Assembly,"Do pass as amended and be re-referred to the Committee on [Local Government]",6,1,0,1,8
1592639,1195779,2022-04-27,Assembly,"Do pass as amended and be re-referred to the Committee on [Appropriations]",5,3,0,0,8
1592639,1205827,2022-05-18,Assembly,"Do pass",11,4,0,1,16
1592639,1210546,2022-05-26,Assembly,"AB 2334 Wicks Assembly Third Reading",49,22,0,7,78
1592639,1215889,2022-06-13,Senate,"Do pass, but first be re-referred to the Committee on [Governance and Finance]",8,1,0,0,9
1592639,1221346,2022-06-29,Senate,"Do pass as amended, but first amend, and re-refer to the Committee on [Appropriations]",4,1,0,0,5
1592639,1225244,2022-08-29,Senate,"Assembly 3rd Reading AB2334 Wicks et al. By Wiener",29,8,0,3,40
1592639,1225245,2022-08-30,Assembly,"AB 2334 Wicks Concurrence in Senate Amendments",53,21,0,6,80
1592641,1184672,2022-04-06,Senate,"Do pass as amended, but first amend, and re-refer to the Committee on [Judiciary]",10,0,0,1,11
1592641,1199922,2022-05-03,Senate,"Do pass",10,0,0,1,11
1592641,1207868,2022-05-23,Senate,"Senate 3rd Reading SB1035 Eggman",37,0,0,3,40
1592641,1215896,2022-06-14,Assembly,"Do pass and be re-referred to the Committee on [Judiciary]",14,0,0,1,15
1592641,1220042,2022-06-28,Assembly,"Do pass",11,0,0,0,11
1592641,1224261,2022-08-22,Assembly,"SB 1035 Eggman Senate Third Reading By Bloom",77,0,0,3,80
1592642,1181294,2022-03-28,Assembly,"Do pass and be re-referred to the Committee on [Privacy and Consumer Protection]",11,0,0,4,15
1592642,1189969,2022-04-19,Assembly,"Do pass as amended and be re-referred to the Committee on [Appropriations]",10,1,0,0,11
1592643,1185689,2022-04-06,Assembly,"Do pass. To Consent Calendar",7,0,0,0,7
1592643,1191258,2022-04-21,Assembly,"AB 2337 Megan Dahle Consent Calendar Second Day Regular Session",68,0,0,9,77
1592643,1215006,2022-06-08,Senate,"Do pass and be ordered to the Consent Calendar",7,0,0,0,7
1592643,1216611,2022-06-16,Senate,"Consent Calendar AB2337",35,0,0,5,40
1592644,1179206,2022-03-29,Assembly,"Do pass and be re-referred to the Committee on [Health]",9,0,0,1,10
1592644,1193344,2022-04-26,Assembly,"Do pass as amended",11,1,0,3,15
1592644,1207837,2022-05-23,Assembly,"AB 2338 Gipson Assembly Third Reading",63,0,0,15,78
1592644,1220889,2022-06-28,Senate,"Do pass",10,0,0,1,11
1592644,1224230,2022-08-18,Senate,"Assembly 3rd Reading AB2338 Gipson By Kamlager",38,0,0,2,40
1592644,1224265,2022-08-22,Assembly,"AB 2338 Gipson Concurrence in Senate Amendments",75,0,0,5,80
1592645,1200505,2022-05-04,Senate,"Do pass as amended, but first amend, and re-refer to the Committee on [Appropriations]",5,0,0,0,5
1592645,1204662,2022-05-16,Senate,"Placed on suspense file",6,0,0,1,7
1592645,1206728,2022-05-19,Senate,"Do pass",5,1,0,1,7
1592646,1190558,2022-04-20,Assembly,"Do pass and be re-referred to the Committee on [Local Government]",5,1,0,2,8
1592646,1195715,2022-04-27,Assembly,"Do pass as amended and be re-referred to the Committee on [Appropriations]",5,0,0,3,8
1592646,1205869,2022-05-18,Assembly,"Do pass",11,4,0,1,16
1592646,1210502,2022-05-25,Assembly,"AB 2339 Bloom Assembly Third Reading",55,16,0,7,78
1592646,1215924,2022-06-13,Senate,"Do pass as amended, but first amend, and re-refer to the Committee on [Appropriations]",8,1,0,0,9
1592646,1225716,2022-08-29,Senate,"Assembly 3rd Reading AB2339 Bloom By Wiener",30,7,0,3,40
1592646,1225717,2022-08-30,Assembly,"AB 2339 Bloom Concurrence in Senate Amendments",55,15,0,10,80
1592648,1193254,2022-04-26,Senate,"Do pass, but first be re-referred to the Committee on [Appropriations] with the recommendation: To Consent Calendar",8,0,0,1,9
1592648,1204104,2022-05-12,Senate,"Consent Calendar SB1051",35,0,0,5,40
1592649,1183698,2022-04-05,Assembly,"Do pass and be re-referred to the Committee on [Business and Professions]",11,0,0,1,12
1592649,1189940,2022-04-19,Assembly,"Do pass and be re-referred to the Committee on [Appropriations]",19,0,0,0,19
1592649,1199944,2022-05-04,Assembly,"Do pass. To Consent Calendar",14,0,0,2,16
1592649,1204068,2022-05-12,Assembly,"AB 2341 Medina Consent Calendar Second Day Regular Session",65,0,0,13,78
1592649,1217442,2022-06-20,Senate,"Do pass, but first be re-referred to the Committee on [Education]",13,0,0,1,14
1592650,1193294,2022-04-26,Assembly,"Do pass and be re-referred to the Committee on [Appropriations]",6,0,0,0,6
1592650,1205867,2022-05-18,Assembly,"Do pass. To Consent Calendar",15,0,0,1,16
1592650,1210314,2022-05-25,Assembly,"AB 2342 Cervantes Consent Calendar Second Day Regular Session",73,0,0,5,78
1592650,1215052,2022-06-08,Senate,"Do pass, but first be re-referred to the Committee on [Appropriations]",4,1,0,0,5
1592650,1224272,2022-08-22,Senate,"Assembly 3rd Reading AB2342 Cervantes By Durazo",31,9,0,0,40
1592650,1224632,2022-08-23,Assembly,"AB 2342 Cervantes Concurrence in Senate Amendments",75,0,0,5,80
1592652,1193186,2022-04-26,Assembly,"Do pass and be re-referred to the Committee on [Appropriations]",5,2,0,0,7
1592652,1206515,2022-05-19,Assembly,"Do pass",12,4,0,0,16
1592652,1210256,2022-05-26,Assembly,"AB 2343 Akilah Weber Assembly Third Reading",52,19,0,7,78
1592652,1220859,2022-06-28,Senate,"Do pass, but first be re-referred to the Committee on [Appropriations]",4,0,0,1,5
1592652,1222881,2022-08-01,Senate,"Placed on suspense file",7,0,0,0,7
1592652,1223905,2022-08-11,Senate,"Do pass",5,1,0,1,7
1592652,1225330,2022-08-29,Senate,"Assembly 3rd Reading AB2343 Akilah Weber et al. By Atkins",29,1,0,10,40
1592652,1225331,2022-08-30,Assembly,"AB 2343 Akilah Weber Concurrence in Senate Amendments",55,17,0,8,80
1592653,1173492,2022-03-21,Senate,"Do pass as amended, but first amend, and re-refer to the Committee on [Appropriations]",4,1,0,0,5
1592653,1182544,2022-04-04,Senate,"Placed on suspense file",6,0,0,1,7
1592653,1206842,2022-05-19,Senate,"Do pass as amended",5,2,0,0,7
1592653,1209271,2022-05-25,Senate,"Senate 3rd Reading SB1044 Durazo et al",24,10,0,6,40
1592653,1218010,2022-06-22,Assembly,"Do pass and be re-referred to the Committee on [Emergency Management]",5,2,0,0,7
1592653,1219462,2022-06-27,Assembly,"Do pass as amended and be re-referred to the Committee on [Appropriations]",4,2,0,1,7
1592653,1223592,2022-08-11,Assembly,"Do pass as amended",12,4,0,0,16
1592653,1224306,2022-08-22,Assembly,"SB 1044 Durazo Senate Third Reading By Calderon",50,18,0,12,80
1592653,1224792,2022-08-24,Senate,"Unfinished Business SB1044 Durazo et al. Concurrence",29,10,0,1,40
1592654,1183785,2022-04-05,Assembly,"Do pass as amended and be re-referred to the Committee on [Transportation]",11,2,0,2,15
1592654,1189986,2022-04-18,Assembly,"Do pass and be re-referred to the Committee on [Appropriations]",11,0,0,4,15
1592654,1206955,2022-05-19,Assembly,"Do pass as amended",12,2,0,2,16
1592654,1210331,2022-05-25,Assembly,"AB 2344 Friedman Assembly Third Reading",58,7,0,13,78
1592654,1217102,2022-06-20,Senate,"Do pass, but first be re-referred to the Committee on [Transportation]",6,0,0,3,9
1592654,1220785,2022-06-28,Senate,"Do pass, but first be re-referred to the Committee on [Appropriations]",15,0,0,2,17
1592654,1222684,2022-08-01,Senate,"Placed on suspense file",7,0,0,0,7
1592654,1223615,2022-08-11,Senate,"Do pass",6,0,0,1,7
1592654,1225351,2022-08-29,Senate,"Assembly 3rd Reading AB2344 Friedman et al. By Stern",36,0,0,4,40
1592654,1225352,2022-08-30,Assembly,"AB 2344 Friedman Concurrence in Senate Amendments",62,9,0,9,80
1592656,1193378,2022-04-26,Assembly,"Do pass and be re-referred to the Committee on [Appropriations]",14,0,0,1,15
1592657,1174487,2022-03-22,Senate,"Do pass as amended, but first amend, and re-refer to the Committee on [Judiciary]",12,1,0,4,17
1592657,1199989,2022-05-03,Senate,"Do pass",8,1,0,2,11
1592657,1210035,2022-05-26,Senate,"Senate 3rd Reading SB1079 Portantino et al",28,4,0,8,40
1592657,1217424,2022-06-20,Assembly,"Do pass as amended and be re-referred to the Committee on [Judiciary]",14,0,0,1,15
1592657,1219886,2022-06-28,Assembly,"Do pass as amended and be re-referred to the Committee on [Appropriations]",11,0,0,0,11
1592657,1223430,2022-08-11,Assembly,"Do pass",16,0,0,0,16
1592657,1224708,2022-08-24,Assembly,"SB 1079 Portantino Senate Third Reading By Petrie-Norris",76,0,0,4,80
1592657,1225989,2022-08-30,Senate,"Unfinished Business SB1079 Portantino et al. Concurrence",37,1,0,2,40
1592661,1190573,2022-04-19,Senate,"Do pass as amended, but first amend, and re-refer to the Committee on [Appropriations]",9,1,0,1,11
1592661,1204647,2022-05-16,Senate,"Placed on suspense file",6,0,0,1,7
1592662,1181316,2022-03-28,Assembly,"Do pass and be re-referred to the Committee on [Natural Resources]",14,0,0,1,15
1592662,1189374,2022-04-18,Assembly,"Do pass as amended and be re-referred to the Committee on [Appropriations]",11,0,0,0,11
1592662,1206821,2022-05-19,Assembly,"Do pass",16,0,0,0,16
1592662,1210277,2022-05-26,Assembly,"AB 2350 Wilson Assembly Third Reading",73,0,0,5,78
1592662,1218005,2022-06-22,Senate,"Do pass, but first be re-referred to the Committee on [Transportation]",7,0,0,0,7
1592662,1220716,2022-06-28,Senate,"Do pass, but first be re-referred to the Committee on [Appropriations] with the recommendation: To Consent Calendar",17,0,0,0,17
1592662,1223257,2022-08-08,Senate,"Placed on suspense file",7,0,0,0,7
1592665,1179262,2022-03-29,Assembly,"Do pass as amended and be re-referred to the Committee on [Appropriations]",13,0,0,2,15
1592665,1206394,2022-05-19,Assembly,"Do pass",15,1,0,0,16
1592665,1207865,2022-05-23,Assembly,"AB 2352 Nazarian Assembly Third Reading",70,1,0,7,78
1592665,1216338,2022-06-15,Senate,"Do pass as amended, but first amend, and re-refer to the Committee on [Appropriations]",9,0,0,2,11
1592665,1219472,2022-06-27,Senate,"Placed on suspense file",6,0,0,1,7
1592665,1223477,2022-08-11,Senate,"Do pass as amended",7,0,0,0,7
1592665,1225571,2022-08-31,Senate,"Special Consent AB2352",40,0,0,0,40
1592665,1225572,2022-08-31,Assembly,"AB 2352 Nazarian Concurrence in Senate Amendments",79,0,0,1,80
1592669,1185746,2022-04-06,Assembly,"Do pass as amended and be re-referred to the Committee on [Privacy and Consumer Protection]",7,0,0,0,7
1592669,1189927,2022-04-19,Assembly,"Do pass as amended and be re-referred to the Committee on [Appropriations]",11,0,0,0,11
1592669,1203375,2022-05-11,Assembly,"Do pass. To Consent Calendar",16,0,0,0,16
1592669,1206783,2022-05-19,Assembly,"AB 2355 Salas Consent Calendar Second Day Regular Session",72,0,0,6,78
1592669,1215025,2022-06-08,Senate,"Do pass, but first be re-referred to the Committee on [Governmental Organization] with the recommendation: To Consent Calendar",7,0,0,0,7
1592669,1219897,2022-06-28,Senate,"Do pass, but first be re-referred to the Committee on [Appropriations] with the recommendation: To Consent Calendar",13,0,0,2,15
1592669,1223282,2022-08-08,Senate,"Placed on suspense file",7,0,0,0,7
1592669,1223428,2022-08-11,Senate,"Do pass",7,0,0,0,7
1592669,1224630,2022-08-23,Senate,"Special Consent AB2355",40,0,0,0,40
1592670,1170593,2022-03-15,Senate,"Do pass",4,1,0,0,5
1592670,1209979,2022-05-26,Senate,"Senate 3rd Reading SB1038 Bradford",19,9,0,12,40
1592670,1209980,2022-05-26,Senate,"Senate 3rd Reading SB1038 Bradford Reconsider",38,0,0,2,40
1592671,1189881,2022-04-19,Assembly,"Do pass",6,0,0,1,7
1592671,1200671,2022-05-05,Assembly,"AB 2356 Rodriguez Assembly Third Reading",62,0,0,16,78
1592671,1210908,2022-05-31,Senate,"Do pass and be ordered to the Consent Calendar",5,0,0,0,5
1592671,1215298,2022-06-09,Senate,"Consent Calendar AB2356",38,0,0,2,40
1592672,1190615,2022-04-20,Assembly,"Do pass and be re-referred to the Committee on [Housing and Community Development]",6,2,0,0,8
1592672,1194352,2022-04-27,Assembly,"Do pass and be re-referred to the Committee on [Appropriations]",6,1,0,1,8
1592672,1206704,2022-05-19,Assembly,"Do pass",12,4,0,0,16
1592672,1210301,2022-05-25,Assembly,"AB 2357 Ting Assembly Third Reading",54,19,0,5,78
1592673,1193337,2022-04-25,Assembly,"Do pass and be re-referred to the Committee on [Appropriations]",15,0,0,0,15
1592673,1203346,2022-05-11,Assembly,"Do pass. To Consent Calendar",16,0,0,0,16
1592673,1206691,2022-05-19,Assembly,"AB 2358 O'Donnell Consent Calendar Second Day Regular Session",72,0,0,6,78
1592674,1190547,2022-04-19,Senate,"Do pass, but first be re-referred to the Committee on [Appropriations]",9,0,0,2,11
1592674,1201488,2022-05-09,Senate,"Placed on suspense file",7,0,0,0,7
1592674,1206351,2022-05-19,Senate,"Do pass",5,1,0,1,7
1592674,1209261,2022-05-25,Senate,"Senate 3rd Reading SB1056 Umberg",34,0,0,6,40
1592674,1217491,2022-06-21,Assembly,"Do pass as amended and be re-referred to the Committee on [Judiciary]",10,0,0,1,11
1592674,1219952,2022-06-28,Assembly,"Do pass as amended and be re-referred to the Committee on [Appropriations]",10,0,0,1,11
1592674,1223859,2022-08-11,Assembly,"Do pass as amended",12,0,0,4,16
1592674,1224414,2022-08-23,Assembly,"SB 1056 Umberg Senate Third Reading By Gabriel",70,0,0,10,80
1592674,1225585,2022-08-30,Senate,"Unfinished Business SB1056 Umberg et al. Concurrence",36,0,0,4,40
1592675,1190538,2022-04-19,Assembly,"Do pass as amended and be re-referred to the Committee on [Appropriations]",12,0,0,0,12
1592675,1205836,2022-05-18,Assembly,"Do pass",15,0,0,1,16
1592675,1210323,2022-05-26,Assembly,"AB 2359 Gipson Assembly Third Reading",76,0,0,2,78
1592675,1217918,2022-06-22,Senate,"Do pass as amended, but first amend, and re-refer to the Committee on [Appropriations]",6,0,0,1,7
1592675,1224635,2022-08-23,Senate,"Assembly 3rd Reading AB2359 Gipson By Bradford",40,0,0,0,40
1592675,1224759,2022-08-24,Assembly,"AB 2359 Gipson Concurrence in Senate Amendments",77,0,0,3,80
1592676,1193300,2022-04-26,Assembly,"Do pass and be re-referred to the Committee on [Appropriations]",13,0,0,2,15
1592676,1206418,2022-05-19,Assembly,"Do pass",15,0,0,1,16
1592676,1207810,2022-05-23,Assembly,"AB 2360 Arambula Assembly Third Reading",72,0,0,6,78
1592676,1216255,2022-06-15,Senate,"Do pass, but first be re-referred to the Committee on [Appropriations] with the recommendation: To Consent Calendar",9,0,0,2,11
1592676,1219410,2022-06-27,Senate,"Placed on suspense file",6,0,0,1,7
1592678,1183774,2022-04-05,Assembly,"Do pass and be re-referred to the Committee on [Appropriations]",5,2,0,0,7
1592678,1206624,2022-05-19,Assembly,"Do pass",12,4,0,0,16
1592678,1210477,2022-05-25,Assembly,"AB 2361 Mia Bonta Assembly Third Reading",54,19,0,5,78
1592678,1217448,2022-06-21,Senate,"Do pass, but first be re-referred to the Committee on [Appropriations]",4,0,0,1,5
1592678,1224436,2022-08-23,Senate,"Assembly 3rd Reading AB2361 Mia Bonta et al. By Kamlager",30,8,0,2,40
1592679,1181313,2022-03-31,Senate,"Do pass as amended, but first amend, and re-refer to the Committee on [Judiciary]",9,0,0,3,12
1592679,1190534,2022-04-19,Senate,"Do pass, but first be re-referred to the Committee on [Appropriations] with the recommendation: To Consent Calendar",11,0,0,0,11
1592679,1201371,2022-05-09,Senate,"Consent Calendar SB1040",33,0,0,7,40
1592679,1217886,2022-06-22,Assembly,"Do pass and be re-referred to the Committee on [Judiciary] with recommendation: To Consent Calendar",11,1,0,2,14
1592679,1219197,2022-06-22,Assembly,"Do pass and be re-referred to the Committee on [Judiciary]",11,1,0,2,14
1592679,1219928,2022-06-28,Assembly,"Do pass and be re-referred to the Committee on [Appropriations]",11,0,0,0,11
1592679,1223312,2022-08-10,Assembly,"Do pass. To Consent Calendar",15,0,0,1,16
1592679,1224220,2022-08-18,Assembly,"SB 1040 Rubio Consent Calendar Second Day Regular Session",73,0,0,7,80
1592680,1182541,2022-04-04,Assembly,"Do pass as amended and be re-referred to the Committee on [Appropriations]",9,0,0,1,10
1592680,1206448,2022-05-19,Assembly,"Do pass as amended",14,0,0,2,16
1592680,1210535,2022-05-26,Assembly,"AB 2362 Mullin Assembly Third Reading",72,0,0,6,78
1592680,1217071,2022-06-20,Senate,"Do pass as amended, but first amend, and re-refer to the Committee on [Environmental Quality]",7,0,0,2,9
1592680,1220689,2022-06-29,Senate,"Do pass as amended, but first amend, and re-refer to the Committee on [Appropriations]",7,0,0,0,7
1592680,1222864,2022-08-01,Senate,"Placed on suspense file",7,0,0,0,7
1592680,1223508,2022-08-11,Senate,"Do pass as amended",7,0,0,0,7
1592681,1200512,2022-05-05,Assembly,"Do pass and be re-referred to the Committee on [Appropriations]",11,0,0,0,11
1592682,1191293,2022-04-20,Assembly,"Do pass as amended and be re-referred to the Committee on [Appropriations]",7,0,0,0,7
1592684,1179190,2022-03-29,Assembly,"Do pass and be re-referred to the Committee on [Appropriations] with recommendation: To Consent Calendar",15,0,0,0,15
1592684,1206376,2022-05-19,Assembly,"Do pass",16,0,0,0,16
1592684,1210427,2022-05-25,Assembly,"AB 2365 Patterson Assembly Third Reading",76,0,0,2,78
1592684,1221214,2022-06-29,Senate,"Do pass, but first be re-referred to the Committee on [Appropriations] with the recommendation: To Consent Calendar",10,0,0,1,11
1592684,1222731,2022-08-01,Senate,"Placed on suspense file",7,0,0,0,7
1592684,1223821,2022-08-11,Senate,"Do pass",7,0,0,0,7
1592684,1224547,2022-08-23,Senate,"Special Consent AB2365",40,0,0,0,40
1592685,1174515,2022-03-22,Senate,"Do pass as amended, but first amend, and re-refer to the Committee on [Appropriations]",8,0,0,1,9
1592685,1182549,2022-04-04,Senate,"Placed on suspense file",6,0,0,1,7
1592685,1206628,2022-05-19,Senate,"Do pass as amended",7,0,0,0,7
1592685,1208480,2022-05-24,Senate,"Senate 3rd Reading SB1027 Atkins",35,0,0,5,40
1592685,1215549,2022-06-13,Assembly,"Do pass and be re-referred to the Committee on [Appropriations]",10,0,0,1,11
1592685,1223707,2022-08-11,Assembly,"Do pass",14,0,0,2,16
1592685,1224355,2022-08-22,Assembly,"SB 1027 Atkins Senate Third Reading By Alvarez",75,0,0,5,80
1592687,1190686,2022-04-20,Assembly,"Do pass and be re-referred to the Committee on [Transportation] with recommendation: To Consent Calendar",8,0,0,0,8
1592687,1193357,2022-04-25,Assembly,"Do pass as amended",15,0,0,0,15
1592687,1198225,2022-05-02,Assembly,"AB 2367 Ward Assembly Third Reading",70,0,0,7,77
1592687,1216340,2022-06-14,Senate,"Do pass and be ordered to the Consent Calendar",15,0,0,2,17
1592687,1219489,2022-06-27,Senate,"Consent Calendar AB2367",37,0,0,3,40
1592690,1183660,2022-04-05,Assembly,"Do pass",9,0,0,1,10
1592690,1207911,2022-05-23,Assembly,"AB 2369 Salas Assembly Third Reading",73,0,0,5,78
1592690,1218014,2022-06-21,Senate,"Do pass",10,1,0,0,11
1592690,1225398,2022-08-29,Senate,"Assembly 3rd Reading AB2369 Salas et al. By Rubio",36,0,0,4,40
1592690,1225399,2022-08-30,Assembly,"AB 2369 Salas Concurrence in Senate Amendments",77,0,0,3,80
1592691,1174469,2022-03-22,Assembly,"Do pass as amended, and be re-referred to the Committee on [Privacy and Consumer Protection] with recommendation: To Consent Calendar",9,0,0,0,9
1592691,1189936,2022-04-19,Assembly,"Do pass and be re-referred to the Committee on [Appropriations]",11,0,0,0,11
1592691,1206478,2022-05-19,Assembly,"Do pass",16,0,0,0,16
1592691,1207850,2022-05-23,Assembly,"AB 2370 Levine Assembly Third Reading",73,0,0,5,78
1592691,1216265,2022-06-14,Senate,"Do pass, but first be re-referred to the Committee on [Appropriations] with the recommendation: To Consent Calendar",11,0,0,0,11
1592691,1219433,2022-06-27,Senate,"Placed on suspense file",6,0,0,1,7
1592692,1183615,2022-04-05,Senate,"Do pass as amended, but first amend, and re-refer to the Committee on [Appropriations] with the recommendation: To Consent Calendar",8,0,0,1,9
1592692,1192201,2022-04-25,Senate,"Placed on suspense file",5,0,0,2,7
1592692,1206845,2022-05-19,Senate,"Do pass",7,0,0,0,7
1592692,1209297,2022-05-25,Senate,"Special Consent SB1028",39,0,0,1,40
1592692,1219899,2022-06-28,Assembly,"Do pass and be re-referred to the Committee on [Appropriations]",14,0,0,1,15
1592694,1190698,2022-04-20,Assembly,"Do pass and be re-referred to the Committee on [Appropriations]",13,0,0,1,14
1592694,1203331,2022-05-11,Assembly,"Do pass",16,0,0,0,16
1592694,1204660,2022-05-16,Assembly,"AB 2372 Calderon Assembly Third Reading",70,0,0,8,78
1592694,1218045,2022-06-22,Senate,"Do pass, but first be re-referred to the Committee on [Appropriations]",11,0,0,1,12
1592694,1220651,2022-06-28,Senate,"Do pass, but first be re-referred to the Committee on [Appropriations]",9,0,0,2,11
1592696,1185753,2022-04-06,Assembly,"Do pass as amended and be re-referred to the Committee on [Appropriations]",7,0,0,0,7
1592697,1183781,2022-04-05,Assembly,"Do pass as amended, and be re-referred to the Committee on [Business and Professions] with recommendation: To Consent Calendar",7,0,0,0,7
1592697,1193174,2022-04-26,Assembly,"Do pass and be re-referred to the Committee on [Appropriations] with recommendation: To Consent Calendar",17,0,0,1,18
1592697,1203397,2022-05-11,Assembly,"Do pass",16,0,0,0,16
1592697,1204669,2022-05-16,Assembly,"AB 2374 Bauer-Kahan Assembly Third Reading",69,0,0,9,78
1592697,1215866,2022-06-14,Senate,"Do pass, but first be re-referred to the Committee on [Appropriations]",5,0,0,0,5
1592697,1224128,2022-08-17,Senate,"Assembly 3rd Reading AB2374 Bauer-Kahan et al. By Glazer",38,0,0,2,40
1592699,1217343,2022-06-21,Assembly,"Be adopted, and re-refer to the Committee on [Appropriations] with recommendation: To Consent Calendar",6,0,0,0,6
1592699,1223314,2022-08-10,Assembly,"Be adopted. To Consent Calendar",15,0,0,1,16
1592699,1224080,2022-08-15,Assembly,"ACR 140 O'Donnell Consent Calendar Second Day",75,0,0,5,80
1592700,1183717,2022-04-04,Senate,"Do pass, but first be re-referred to the Committee on [Appropriations]",11,1,0,2,14
1592700,1189360,2022-04-18,Senate,"Placed on suspense file",7,0,0,0,7
1592701,1221281,2022-06-30,Assembly,"Be adopted. To third reading",7,0,0,4,11
1592702,1193381,2022-04-25,Assembly,"Be adopted. To Consent Calendar",15,0,0,0,15
1592702,1195754,2022-04-28,Assembly,"ACR 142 Patterson Consent Calendar Second Day Regular Session",71,0,0,6,77
1592702,1220601,2022-06-28,Senate,"Be adopted, but first be re-referred to the Committee on [Appropriations] with recommendation: To Consent Calendar",16,0,0,1,17
1592702,1223034,2022-08-04,Senate,"Special Consent ACR142",35,0,0,5,40
1592703,1148961,2022-02-18,Assembly,"Be adopted. To third reading",10,0,0,2,12
1592703,1173481,2022-03-21,Senate,"Special Consent ACR143",37,0,0,3,40
1592704,1199975,2022-05-03,Senate,"Do pass as amended",9,1,0,1,11
1592704,1204570,2022-05-16,Senate,"Senate 3rd Reading SB1085 Kamlager",24,1,0,15,40
1592704,1215728,2022-06-14,Assembly,"Do pass and be re-referred to the Committee on [Human Services]",8,1,0,2,11
1592704,1220008,2022-06-28,Assembly,"Do pass",6,1,0,1,8
1592704,1224900,2022-08-25,Assembly,"SB 1085 Kamlager Senate Third Reading By Wilson",56,11,0,13,80
1592704,1225957,2022-08-30,Senate,"Unfinished Business SB1085 Kamlager Concurrence",36,0,0,4,40
1592705,1148984,2022-02-18,Assembly,"Be adopted. To third reading",10,0,0,2,12
1592708,1199940,2022-05-03,Senate,"Do pass and be ordered to the Consent Calendar",11,0,0,0,11
1592708,1204114,2022-05-12,Senate,"Consent Calendar SB1024",35,0,0,5,40
1592708,1214992,2022-06-08,Assembly,"Do pass. To Consent Calendar",10,0,0,0,10
1592708,1223012,2022-08-03,Assembly,"Do pass. To Consent Calendar",15,0,0,1,16
1592708,1223982,2022-08-11,Assembly,"SB 1024 Jones Consent Calendar Second Day Regular Session",76,0,0,4,80
1592708,1226007,2022-08-30,Assembly,"SB 1024 Jones Senate Third Reading By Cooley",79,0,0,1,80
1592708,1226008,2022-08-31,Senate,"Unfinished Business SB1024 Jones Concurrence",40,0,0,0,40
1592709,1183703,2022-04-05,Senate,"Do pass, but first be re-referred to the Committee on [Judiciary]",9,0,0,0,9
1592709,1194270,2022-04-26,Senate,"Do pass as amended, but first amend, and re-refer to the Committee on [Appropriations] with the recommendation: To Consent Calendar",11,0,0,0,11
1592709,1204605,2022-05-16,Senate,"Placed on suspense file",6,0,0,1,7
1592709,1206272,2022-05-19,Senate,"Do pass",7,0,0,0,7
1592709,1209384,2022-05-25,Senate,"Special Consent SB1065",39,0,0,1,40
1592709,1217065,2022-06-20,Assembly,"Do pass as amended and be re-referred to the Committee on [Judiciary]",10,0,0,1,11
1592709,1219934,2022-06-28,Assembly,"Do pass and be re-referred to the Committee on [Appropriations] with recommendation: To Consent Calendar",11,0,0,0,11
1592709,1223935,2022-08-11,Assembly,"Do pass as amended",12,0,0,4,16
1592709,1225994,2022-08-30,Senate,"Unfinished Business SB1065 Eggman et al. Concurrence",37,0,0,3,40
1592709,1225995,2022-08-30,Assembly,"SB 1065 Eggman Senate Third Reading By Cooper",79,0,0,1,80
1592711,1184693,2022-04-05,Senate,"Do pass as amended, but first amend, and re-refer to the Committee on [Energy, Utilities and Communications]",8,2,0,1,11
1592711,1193288,2022-04-26,Senate,"Do pass as amended, but first amend, and re-refer to the Committee on [Appropriations]",9,2,0,3,14
1592711,1204657,2022-05-16,Senate,"Placed on suspense file",6,0,0,1,7
1592711,1206938,2022-05-19,Senate,"Do pass",5,2,0,0,7
1592711,1207822,2022-05-23,Senate,"Senate 3rd Reading SB1026 Wieckowski",22,10,0,8,40
1592711,1215913,2022-06-14,Assembly,"Do pass as amended and be re-referred to the Committee on [Utilities and Energy]",7,1,0,3,11
1592711,1220751,2022-06-29,Assembly,"Do pass and be re-referred to the Committee on [Appropriations]",8,3,0,4,15
1592717,1183713,2022-04-05,Senate,"Do pass as amended, but first amend, and re-refer to the Committee on [Appropriations]",9,0,0,0,9
1592717,1198227,2022-05-02,Senate,"Placed on suspense file",7,0,0,0,7
1592717,1206291,2022-05-19,Senate,"Do pass",7,0,0,0,7
1592717,1209277,2022-05-25,Senate,"Special Consent SB1062",39,0,0,1,40
1592717,1215546,2022-06-13,Assembly,"Do pass and be re-referred to the Committee on [Appropriations]",10,0,0,1,11
1592719,1189816,2022-04-18,Senate,"Do pass, but first be re-referred to the Committee on [Governance and Finance]",9,1,0,4,14
1592719,1204565,2022-05-16,Senate,"Placed on suspense file",6,0,0,1,7
1592719,1206854,2022-05-19,Senate,"Do pass",6,1,0,0,7
1592719,1207889,2022-05-23,Senate,"Senate 3rd Reading SB1032 Becker",35,0,0,5,40
1592719,1217937,2022-06-22,Assembly,"Do pass as amended and be re-referred to the Committee on [Appropriations]",15,0,0,0,15
1592720,1191333,2022-04-20,Senate,"Do pass, but first be re-referred to the Committee on [Appropriations]",9,0,0,2,11
1592720,1201519,2022-05-09,Senate,"Placed on suspense file",7,0,0,0,7
1592720,1206907,2022-05-19,Senate,"Do pass as amended",7,0,0,0,7
1592720,1209978,2022-05-26,Senate,"Special Consent SB1033",38,0,0,2,40
1592720,1219915,2022-06-28,Assembly,"Do pass and be re-referred to the Committee on [Appropriations]",12,2,0,1,15
1592723,1190628,2022-04-19,Senate,"Do pass, but first be re-referred to the Committee on [Appropriations]",4,1,0,0,5
1592723,1198309,2022-05-02,Senate,"Placed on suspense file",7,0,0,0,7
1592723,1206795,2022-05-19,Senate,"Do pass",5,2,0,0,7
1592723,1208442,2022-05-24,Senate,"Senate 3rd Reading SB1066 Hurtado",27,8,0,5,40
1592723,1219959,2022-06-28,Assembly,"Do pass and be re-referred to the Committee on [Appropriations]",6,0,0,2,8
1592723,1223988,2022-08-11,Assembly,"Do pass",12,3,0,1,16
1592723,1224273,2022-08-22,Assembly,"SB 1066 Hurtado Senate Third Reading By Arambula",61,5,0,14,80
1592723,1225371,2022-08-29,Senate,"Unfinished Business SB1066 Hurtado Concurrence",31,9,0,0,40
1592731,1194177,2022-04-27,Senate,"Do pass, but first be re-referred to the Committee on [Appropriations]",2,5,0,0,7
1592731,1194178,2022-04-27,Senate,"[Second] hearing set for [04-27-2022]: Failed passage in Committee. Reconsideration granted",5,0,0,2,7
1592736,1184691,2022-04-06,Senate,"Do pass, but first be re-referred to the Committee on [Human Services]",7,0,0,0,7
1592736,1190531,2022-04-19,Senate,"Do pass, but first be re-referred to the Committee on [Appropriations]",3,0,0,2,5
1592736,1198296,2022-05-02,Senate,"Placed on suspense file",7,0,0,0,7
1592736,1206475,2022-05-19,Senate,"Do pass",5,0,0,2,7
1592736,1207693,2022-05-23,Senate,"Senate 3rd Reading SB1047 Lim贸n",35,0,0,5,40
1592736,1215864,2022-06-14,Assembly,"Do pass and be re-referred to the Committee on [Education]",7,0,0,1,8
1592736,1220607,2022-06-29,Assembly,"Do pass as amended, and be re-referred to the Committee on [Appropriations] with recommendation: To Consent Calendar",7,0,0,0,7
1592736,1223476,2022-08-11,Assembly,"Do pass as amended",12,0,0,4,16
1592736,1224275,2022-08-22,Assembly,"SB 1047 Lim贸n Senate Third Reading By McCarty",76,0,0,4,80
1592736,1225546,2022-08-31,Senate,"Unfinished Business SB1047 Lim贸n Concurrence",40,0,0,0,40
1592736,1225547,2022-08-31,Assembly,"SB 1047 Lim贸n Senate Third Reading By McCarty",78,0,0,2,80
1592741,1193425,2022-04-26,Senate,"Do pass, but first be re-referred to the Committee on [Appropriations]",10,1,0,3,14
1592741,1207784,2022-05-23,Senate,"Senate 3rd Reading SB1063 Skinner",27,9,0,4,40
1592741,1215542,2022-06-13,Assembly,"Do pass and be re-referred to the Committee on [Utilities and Energy]",7,3,0,1,11
1592741,1220682,2022-06-29,Assembly,"Do pass and be re-referred to the Committee on [Appropriations]",11,2,0,2,15
1592741,1222983,2022-08-03,Assembly,"Do pass",11,4,0,1,16
1592741,1223910,2022-08-11,Assembly,"SB 1063 Skinner Senate Third Reading By Stone",55,18,0,7,80
1592741,1224088,2022-08-15,Senate,"Unfinished Business SB1063 Skinner Concurrence",28,9,0,3,40
1592746,1184634,2022-04-05,Senate,"Do pass as amended, but first amend, and re-refer to the Committee on [Appropriations]",8,2,0,1,11
1592746,1198321,2022-05-02,Senate,"Placed on suspense file",7,0,0,0,7
1592746,1206295,2022-05-19,Senate,"Do pass as amended",5,0,0,2,7
1592746,1208510,2022-05-24,Senate,"Senate 3rd Reading SB1055 Kamlager",34,0,0,6,40
1592746,1214962,2022-06-08,Assembly,"Do pass and be re-referred to the Committee on [Appropriations]",7,2,0,1,10
1592746,1223949,2022-08-11,Assembly,"Do pass as amended",12,4,0,0,16
1592746,1224780,2022-08-24,Assembly,"SB 1055 Kamlager Senate Third Reading By Friedman",55,4,0,21,80
1592746,1225885,2022-08-30,Senate,"Unfinished Business SB1055 Kamlager et al. Concurrence",39,1,0,0,40
1592753,1185702,2022-04-07,Senate,"Do pass, but first be re-referred to the Committee on [Military and Veterans Affairs]",5,0,0,0,5
1592753,1193144,2022-04-26,Senate,"Do pass, but first be re-referred to the Committee on [Appropriations] with the recommendation: To Consent Calendar",5,0,0,2,7
1592753,1201356,2022-05-09,Senate,"Placed on suspense file",7,0,0,0,7
1592784,1180226,2022-03-30,Senate,"Do pass as amended, but first amend, and re-refer to the Committee on [Public Safety]",10,0,0,1,11
1592784,1194324,2022-04-26,Senate,"Do pass, but first be re-referred to the Committee on [Appropriations]",4,0,0,1,5
1592784,1201378,2022-05-09,Senate,"Placed on suspense file",7,0,0,0,7
1592784,1206986,2022-05-19,Senate,"Do pass",6,0,0,1,7
1592784,1208504,2022-05-24,Senate,"Senate 3rd Reading SB1089 Wilk",37,0,0,3,40
1592784,1215834,2022-06-14,Assembly,"Do pass and be re-referred to the Committee on [Public Safety]",13,0,0,2,15
1592784,1220084,2022-06-28,Assembly,"Do pass and be re-referred to the Committee on [Appropriations]",7,0,0,0,7
1592784,1224055,2022-08-11,Assembly,"Do pass as amended",12,0,0,4,16
1592784,1225656,2022-08-30,Senate,"Unfinished Business SB1089 Wilk et al. Concurrence",37,0,0,3,40
1592784,1225657,2022-08-30,Assembly,"SB 1089 Wilk Senate Third Reading By Nazarian",72,0,0,8,80
1592785,1179203,2022-03-29,Senate,"Do pass, but first be re-referred to the Committee on [Judiciary] with the recommendation: To Consent Calendar",4,0,0,1,5
1592785,1184679,2022-04-05,Senate,"Do pass, but first be re-referred to the Committee on [Appropriations] with the recommendation: To Consent Calendar",10,0,0,1,11
1592785,1192152,2022-04-25,Senate,"Placed on suspense file",5,0,0,2,7
1592785,1206497,2022-05-19,Senate,"Do pass",7,0,0,0,7
1592785,1209267,2022-05-25,Senate,"Special Consent SB1090",39,0,0,1,40
1592785,1215925,2022-06-14,Assembly,"Do pass and be re-referred to the Committee on [Judiciary] with recommendation: To Consent Calendar",7,0,0,1,8
1592785,1217389,2022-06-21,Assembly,"Do pass and be re-referred to the Committee on [Appropriations] with recommendation: To Consent Calendar",10,0,0,0,10
1592785,1223655,2022-08-11,Assembly,"Do pass as amended",12,0,0,4,16
1592785,1224340,2022-08-22,Assembly,"SB 1090 Hurtado Senate Third Reading By Cooley",77,0,0,3,80
1592785,1225866,2022-08-30,Senate,"Special Consent SB1090",38,0,0,2,40
1592786,1179270,2022-03-29,Senate,"Do pass, but first be re-referred to the Committee on [Appropriations]",4,0,0,1,5
1592786,1189315,2022-04-18,Senate,"Placed on suspense file",7,0,0,0,7
1592786,1206536,2022-05-19,Senate,"Do pass",7,0,0,0,7
1592786,1209364,2022-05-25,Senate,"Special Consent SB1091",39,0,0,1,40
1592786,1220070,2022-06-28,Assembly,"Do pass and be re-referred to the Committee on [Appropriations] with recommendation: To Consent Calendar",7,0,0,1,8
1592787,1190527,2022-04-19,Senate,"Do pass, but first be re-referred to the Committee on [Judiciary]",5,0,0,0,5
1592787,1194238,2022-04-26,Senate,"Do pass as amended, but first amend, and re-refer to the Committee on [Appropriations] with the recommendation: To Consent Calendar",11,0,0,0,11
1592787,1204677,2022-05-16,Senate,"Placed on suspense file",6,0,0,1,7
1592787,1206332,2022-05-19,Senate,"Do pass",7,0,0,0,7
1592787,1209398,2022-05-25,Senate,"Special Consent SB1092",39,0,0,1,40
1592787,1215837,2022-06-14,Assembly,"Do pass and be re-referred to the Committee on [Judiciary] with recommendation: To Consent Calendar",7,0,0,1,8
1592787,1217451,2022-06-21,Assembly,"Do pass and be re-referred to the Committee on [Appropriations] with recommendation: To Consent Calendar",10,0,0,0,10
1592788,1179212,2022-03-29,Senate,"Do pass, but first be re-referred to the Committee on [Appropriations] with the recommendation: To Consent Calendar",4,0,0,1,5
1592788,1191288,2022-04-21,Senate,"Consent Calendar SB1093",39,0,0,1,40
1592788,1219878,2022-06-28,Assembly,"Do pass and be re-referred to the Committee on [Appropriations]",7,0,0,1,8
1592788,1222943,2022-08-03,Assembly,"Do pass. To Consent Calendar",15,0,0,1,16
1592788,1224077,2022-08-15,Assembly,"SB 1093 Hurtado Senate Third Reading By Calderon Amendment Set #1",66,7,0,7,80
1592788,1224323,2022-08-22,Assembly,"SB 1093 Hurtado Senate Third Reading By Calderon",69,0,0,11,80
1592788,1225949,2022-08-29,Senate,"Unfinished Business SB1093 Hurtado Concurrence",40,0,0,0,40
1592789,1194130,2022-04-27,Senate,"Do pass as amended, but first amend, and re-refer to the Committee on [Appropriations]",7,2,0,0,9
1592789,1204580,2022-05-16,Senate,"Placed on suspense file",6,0,0,1,7
1592790,1179221,2022-03-28,Senate,"Do pass as amended, but first amend, and re-refer to the Committee on [Appropriations]",4,2,0,1,7
1592790,1189365,2022-04-18,Senate,"Placed on suspense file",7,0,0,0,7
1592791,1179151,2022-03-29,Senate,"Do pass as amended, but first amend, and re-refer to the Committee on [Appropriations] with the recommendation: To Consent Calendar",11,0,0,0,11
1592791,1195870,2022-04-28,Senate,"Consent Calendar SB1096",37,0,0,3,40
1592791,1211923,2022-06-01,Assembly,"Do pass and be re-referred to the Committee on [Appropriations] with recommendation: To Consent Calendar",10,0,0,1,11
1592791,1217948,2022-06-22,Assembly,"Do pass. To Consent Calendar",13,0,0,3,16
1592791,1221572,2022-06-29,Assembly,"SB 1096 Lim贸n Consent Calendar Second Day Regular Session",78,0,0,2,80
1592791,1223251,2022-08-08,Senate,"Special Consent SB1096",36,0,0,4,40
1592792,1183813,2022-04-04,Senate,"Do pass, but first be re-referred to the Committee on [Appropriations]",8,0,0,6,14
1592792,1189307,2022-04-18,Senate,"Placed on suspense file",7,0,0,0,7
1592792,1206931,2022-05-19,Senate,"Do pass as amended",5,0,0,2,7
1592792,1209333,2022-05-25,Senate,"Senate 3rd Reading SB1097 Pan",25,3,0,12,40
1592792,1209334,2022-05-25,Senate,"Senate 3rd Reading SB1097 Pan Reconsider",39,0,0,1,40
1592792,1209335,2022-05-25,Senate,"Senate 3rd Reading SB1097 Pan",23,3,0,14,40
1592792,1217351,2022-06-21,Assembly,"Do pass as amended and be re-referred to the Committee on [Appropriations]",11,0,0,8,19
1592792,1223760,2022-08-11,Assembly,"Do pass",13,0,0,3,16
1592794,1184733,2022-04-05,Senate,"Do pass as amended, but first amend, and re-refer to the Committee on [Governance and Finance]",10,0,0,1,11
1592794,1190613,2022-04-20,Senate,"Do pass as amended, but first amend, and re-refer to the Committee on [Appropriations]",5,0,0,0,5
1592794,1204562,2022-05-16,Senate,"Placed on suspense file",6,0,0,1,7
1592794,1206257,2022-05-19,Senate,"Do pass as amended",5,2,0,0,7
1592794,1208458,2022-05-24,Senate,"Senate 3rd Reading SB1099 Wieckowski",28,7,0,5,40
1592794,1220064,2022-06-28,Assembly,"Do pass",9,2,0,0,11
1592794,1224341,2022-08-22,Assembly,"SB 1099 Wieckowski Senate Third Reading By Cunningham",53,12,0,15,80
1592794,1224810,2022-08-24,Senate,"Unfinished Business SB1099 Wieckowski Concurrence",31,9,0,0,40
1592795,1172370,2022-03-17,Senate,"Do pass as amended, but first amend, and re-refer to the Committee on [Judiciary]",4,1,0,0,5
1592795,1190623,2022-04-19,Senate,"Do pass as amended",9,2,0,0,11
1592795,1198325,2022-05-02,Senate,"Senate 3rd Reading SB1100 Cortese et al",29,7,0,4,40
1592795,1216652,2022-06-15,Assembly,"Do pass and be re-referred to the Committee on [Judiciary]",6,2,0,0,8
1592795,1217361,2022-06-21,Assembly,"Do pass",7,3,0,0,10
1592795,1222629,2022-08-01,Assembly,"SB 1100 Cortese Senate Third Reading By Low",57,18,0,5,80
1592795,1223048,2022-08-04,Senate,"Unfinished Business SB1100 Cortese et al. Concurrence",28,9,0,3,40
1592796,1190665,2022-04-20,Senate,"Do pass, but first be re-referred to the Committee on [Natural Resources and Water]",6,0,0,1,7
1592796,1193265,2022-04-26,Senate,"Do pass as amended, but first amend, and re-refer to the Committee on [Appropriations]",8,0,0,1,9
1592796,1204625,2022-05-16,Senate,"Placed on suspense file",6,0,0,1,7
1592796,1206487,2022-05-19,Senate,"Do pass",6,0,0,1,7
1592796,1209405,2022-05-25,Senate,"Senate 3rd Reading SB1101 Caballero et al",38,1,0,1,40
1592796,1217081,2022-06-20,Assembly,"Do pass as amended and be re-referred to the Committee on [Appropriations]",9,0,0,2,11
1592796,1223622,2022-08-11,Assembly,"Do pass",16,0,0,0,16
1592799,1173487,2022-03-21,Senate,"Do pass, but first be re-referred to the Committee on [Transportation]",12,0,0,2,14
1592799,1189799,2022-04-19,Senate,"Do pass, but first be re-referred to the Committee on [Appropriations]",14,0,0,3,17
1592799,1198294,2022-05-02,Senate,"Placed on suspense file",7,0,0,0,7
1592799,1207008,2022-05-19,Senate,"Do pass",7,0,0,0,7
1592799,1208479,2022-05-24,Senate,"Senate 3rd Reading SB1104 Gonzalez",35,0,0,5,40
1592799,1217447,2022-06-21,Assembly,"Do pass and be re-referred to the Committee on [Transportation] with recommendation: To Consent Calendar",6,0,0,0,6
1592799,1220109,2022-06-27,Assembly,"Do pass and be re-referred to the Committee on [Appropriations]",13,0,0,2,15
1592800,1176516,2022-03-24,Senate,"Do pass, but first be re-referred to the Committee on [Governance and Finance]",6,1,0,2,9
1592800,1190516,2022-04-20,Senate,"Do pass as amended, but first amend, and re-refer to the Committee on [Appropriations]",5,0,0,0,5
1592800,1201386,2022-05-09,Senate,"Placed on suspense file",7,0,0,0,7
1592800,1206266,2022-05-19,Senate,"Do pass",5,2,0,0,7
1592800,1207701,2022-05-23,Senate,"Senate 3rd Reading SB1105 Hueso",27,8,0,5,40
1592800,1220628,2022-06-29,Assembly,"Do pass as amended and be re-referred to the Committee on [Appropriations]",6,2,0,0,8
1592800,1220629,2022-06-29,Assembly,"Do pass and be re-referred to the Committee on [Local Government]",5,2,0,1,8
1592801,1174459,2022-03-22,Senate,"Do pass",4,1,0,0,5
1592801,1189329,2022-04-18,Senate,"Senate 3rd Reading SB1106 Wiener",27,8,0,5,40
1592801,1211918,2022-06-01,Assembly,"Do pass",5,2,0,0,7
1592801,1223245,2022-08-08,Assembly,"SB 1106 Wiener Senate Third Reading By WILSON",47,22,0,11,80
1592801,1224086,2022-08-15,Senate,"Unfinished Business SB1106 Wiener et al. Concurrence",26,11,0,3,40
1592802,1190575,2022-04-20,Senate,"Do pass as amended, but first amend, and re-refer to the Committee on [Appropriations]",8,3,0,1,12
1592802,1198272,2022-05-02,Senate,"Placed on suspense file",7,0,0,0,7
1592802,1206878,2022-05-19,Senate,"Do pass as amended",5,2,0,0,7
1592802,1209331,2022-05-25,Senate,"Senate 3rd Reading SB1107 Dodd et al",29,8,0,3,40
1592802,1218012,2022-06-22,Assembly,"Do pass and be re-referred to the Committee on [Appropriations]",10,0,0,4,14
1592802,1223389,2022-08-11,Assembly,"Do pass",13,1,0,2,16
1592802,1224243,2022-08-18,Assembly,"SB 1107 Dodd Senate Third Reading By Grayson",60,1,0,19,80
1592802,1224384,2022-08-22,Senate,"Unfinished Business SB1107 Dodd et al. Concurrence",31,8,0,1,40
1592803,1179398,2022-03-29,Senate,"Do pass, but first be re-referred to the Committee on [Appropriations]",1,4,0,0,5
1592803,1179399,2022-03-29,Senate,"[First] hearing set for [03-29-2022]: Failed passage in Committee. Reconsideration granted",5,0,0,0,5
1592804,1193185,2022-04-26,Senate,"Do pass as amended, but first amend, and re-refer to the Committee on [Appropriations]",9,0,0,5,14
1592804,1204582,2022-05-16,Senate,"Placed on suspense file",6,0,0,1,7
1592804,1206793,2022-05-19,Senate,"Do pass as amended",6,0,0,1,7
1592804,1209963,2022-05-26,Senate,"Senate 3rd Reading SB1109 Caballero",28,0,0,12,40
1592804,1220686,2022-06-29,Assembly,"Do pass as amended and be re-referred to the Committee on [Appropriations]",8,0,0,7,15
1592804,1223947,2022-08-11,Assembly,"Do pass",16,0,0,0,16
1592804,1225057,2022-08-29,Assembly,"SB 1109 Caballero Senate Third Reading By Salas",65,1,0,14,80
1592804,1225946,2022-08-30,Senate,"Unfinished Business SB1109 Caballero et al. Concurrence",34,2,0,4,40
1592805,1194192,2022-04-26,Senate,"Do pass as amended",5,0,0,0,5
1592805,1201455,2022-05-09,Senate,"Senate 3rd Reading SB1110 Melendez",33,0,0,7,40
1592805,1215013,2022-06-08,Assembly,"Do pass",7,0,0,0,7
1592805,1221279,2022-06-30,Assembly,"SB 1110 Melendez Senate Third Reading By Quirk",35,16,0,29,80
1592806,1174562,2022-03-22,Senate,"Do pass, but first be re-referred to the Committee on [Judiciary]",13,1,0,3,17
1592806,1190565,2022-04-19,Senate,"Do pass as amended, but first amend, and re-refer to the Committee on [Appropriations]",9,0,0,2,11
1592806,1209318,2022-05-25,Senate,"Senate 3rd Reading SB1111 Archuleta",35,0,0,5,40
1592806,1217456,2022-06-20,Assembly,"Do pass and be re-referred to the Committee on [Appropriations]",14,0,0,1,15
1592806,1223311,2022-08-10,Assembly,"Do pass. To Consent Calendar",15,0,0,1,16
1592806,1224157,2022-08-18,Assembly,"SB 1111 Archuleta Consent Calendar Second Day Regular Session",73,0,0,7,80
1592807,1193148,2022-04-26,Senate,"Do pass, but first be re-referred to the Committee on [Appropriations]",10,1,0,3,14
1592807,1201421,2022-05-09,Senate,"Placed on suspense file",7,0,0,0,7
1592807,1206814,2022-05-19,Senate,"Do pass as amended",5,2,0,0,7
1592807,1208448,2022-05-24,Senate,"Senate 3rd Reading SB1112 Becker",28,8,0,4,40
1592807,1217852,2022-06-22,Assembly,"Do pass as amended and be re-referred to the Committee on [Appropriations]",15,0,0,0,15
1592807,1224015,2022-08-11,Assembly,"Do pass",13,0,0,3,16
1592807,1224445,2022-08-23,Assembly,"SB 1112 Becker Senate Third Reading By Carrillo",69,0,0,11,80
1592807,1225722,2022-08-29,Senate,"Unfinished Business SB1112 Becker Concurrence",31,9,0,0,40
1592808,1184658,2022-04-06,Senate,"Do pass as amended, but first amend, and re-refer to the Committee on [Appropriations] with the recommendation: To Consent Calendar",7,0,0,0,7
1592808,1198270,2022-05-02,Senate,"Placed on suspense file",7,0,0,0,7
1592808,1206748,2022-05-19,Senate,"Do pass as amended",7,0,0,0,7
1592808,1209962,2022-05-26,Senate,"Special Consent SB1113",38,0,0,2,40
1592808,1216656,2022-06-15,Assembly,"Do pass and be re-referred to the Committee on [Appropriations]",6,0,0,1,7
1592808,1223483,2022-08-11,Assembly,"Do pass as amended",12,0,0,4,16
1592808,1225301,2022-08-30,Senate,"Unfinished Business SB1113 Ochoa Bogh et al. Concurrence",37,0,0,3,40
1592808,1225302,2022-08-30,Assembly,"SB 1113 Ochoa Bogh Senate Third Reading By Aguiar-Curry",79,0,0,1,80
1592810,1183788,2022-04-04,Senate,"Do pass, but first be re-referred to the Committee on [Appropriations]",5,0,0,0,5
1592810,1189383,2022-04-18,Senate,"Placed on suspense file",7,0,0,0,7
1592810,1206881,2022-05-19,Senate,"Do pass",5,2,0,0,7
1592810,1207856,2022-05-23,Senate,"Senate 3rd Reading SB1115 Skinner et al",29,1,0,10,40
1592810,1216330,2022-06-15,Assembly,"Do pass and be re-referred to the Committee on [Appropriations]",7,0,0,0,7
1592811,1183779,2022-04-04,Senate,"Do pass, but first be re-referred to the Committee on [Labor, Public Employment and Retirement ]",10,0,0,4,14
1592811,1194222,2022-04-27,Senate,"Do pass, but first be re-referred to the Committee on [Appropriations]",4,0,0,1,5
1592811,1201412,2022-05-09,Senate,"Placed on suspense file",7,0,0,0,7
1592811,1206741,2022-05-19,Senate,"Do pass as amended",5,2,0,0,7
1592811,1208484,2022-05-24,Senate,"Senate 3rd Reading SB1116 Portantino et al",29,5,0,6,40
1592811,1216279,2022-06-15,Assembly,"Do pass and be re-referred to the Committee on [Labor and Employment]",7,0,0,0,7
1592811,1218003,2022-06-22,Assembly,"Do pass and be re-referred to the Committee on [Appropriations]",6,0,0,1,7
1592811,1223643,2022-08-11,Assembly,"Do pass",14,2,0,0,16
1592811,1225085,2022-08-29,Assembly,"SB 1116 Portantino Senate Third Reading By Santiago",68,6,0,6,80
1592811,1225763,2022-08-30,Senate,"Unfinished Business SB1116 Portantino et al. Concurrence",32,8,0,0,40
1592812,1189922,2022-04-19,Senate,"Do pass, but first be re-referred to the Committee on [Appropriations]",5,0,0,0,5
1592812,1198275,2022-05-02,Senate,"Placed on suspense file",7,0,0,0,7
1592812,1206966,2022-05-19,Senate,"Do pass",5,2,0,0,7
1592812,1208490,2022-05-24,Senate,"Senate 3rd Reading SB1117 Becker",29,6,0,5,40
1592812,1214985,2022-06-08,Assembly,"Do pass and be re-referred to the Committee on [Appropriations]",5,1,0,1,7
1592812,1223942,2022-08-11,Assembly,"Do pass",12,4,0,0,16
1592812,1224679,2022-08-24,Assembly,"SB 1117 Becker Senate Third Reading By Kalra",62,11,0,7,80
1592813,1190570,2022-04-20,Senate,"Do pass as amended, but first amend, and re-refer to the Committee on [Judiciary]",4,0,0,3,7
1592813,1199985,2022-05-03,Senate,"Do pass as amended, but first amend, and re-refer to the Committee on [Appropriations]",6,0,0,5,11
1592813,1204635,2022-05-16,Senate,"Placed on suspense file",6,0,0,1,7
1592814,1193178,2022-04-26,Senate,"Do pass as amended, but first amend, and re-refer to the Committee on [Appropriations]",10,1,0,3,14
1592814,1204600,2022-05-16,Senate,"Placed on suspense file",6,0,0,1,7
1592815,1173504,2022-03-21,Senate,"Do pass, but first be re-referred to the Committee on [Judiciary] with the recommendation: To Consent Calendar",12,0,0,2,14
1592815,1190611,2022-04-19,Senate,"Do pass, but first be re-referred to the Committee on [Appropriations] with the recommendation: To Consent Calendar",11,0,0,0,11
1592815,1201363,2022-05-09,Senate,"Consent Calendar SB1120",33,0,0,7,40
1592815,1215758,2022-06-14,Assembly,"Do pass as amended and be re-referred to the Committee on [Appropriations]",16,0,0,2,18
1592815,1220649,2022-06-29,Assembly,"Do pass. To Consent Calendar",14,0,0,2,16
1592815,1223062,2022-08-04,Assembly,"SB 1120 Jones Consent Calendar Second Day Regular Session",76,0,0,4,80
1592815,1224068,2022-08-15,Senate,"Unfinished Business SB1120 Jones Concurrence",37,0,0,3,40
1592816,1189874,2022-04-19,Senate,"Do pass, but first be re-referred to the Committee on [Appropriations]",14,0,0,3,17
1592816,1198246,2022-05-02,Senate,"Placed on suspense file",7,0,0,0,7
1592816,1207031,2022-05-19,Senate,"Do pass",6,0,0,1,7
1592816,1207675,2022-05-23,Senate,"Senate 3rd Reading SB1121 Gonzalez",32,0,0,8,40
1592816,1217418,2022-06-20,Assembly,"Do pass and be re-referred to the Committee on [Appropriations] with recommendation: To Consent Calendar",14,0,0,1,15
1592816,1223530,2022-08-11,Assembly,"Do pass",16,0,0,0,16
1592816,1225033,2022-08-29,Assembly,"SB 1121 Gonzalez Senate Third Reading By Friedman",78,0,0,2,80
1592816,1225617,2022-08-30,Senate,"Unfinished Business SB1121 Gonzalez Concurrence",36,0,0,4,40
1592817,1174489,2022-03-22,Senate,"Do pass, but first be re-referred to the Committee on [Appropriations]",8,0,0,1,9
1592817,1182510,2022-04-04,Senate,"Placed on suspense file",6,0,0,1,7
1592817,1206858,2022-05-19,Senate,"Do pass",7,0,0,0,7
1592817,1207880,2022-05-23,Senate,"Senate 3rd Reading SB1122 Allen",36,0,0,4,40
1592817,1215535,2022-06-13,Assembly,"Do pass and be re-referred to the Committee on [Appropriations]",10,0,0,1,11
1592817,1223536,2022-08-11,Assembly,"Do pass as amended",12,0,0,4,16
1592817,1224514,2022-08-23,Assembly,"SB 1122 Allen Senate Third Reading By O'Donnell",76,0,0,4,80
1592817,1225878,2022-08-30,Senate,"Special Consent SB1122",38,0,0,2,40
1592818,1183778,2022-04-05,Senate,"Do pass as amended, but first amend, and re-refer to the Committee on [Environmental Quality]",9,0,0,0,9
1592818,1194258,2022-04-27,Senate,"Do pass as amended, but first amend, and re-refer to the Committee on [Appropriations] with the recommendation: To Consent Calendar",7,0,0,0,7
1592818,1204631,2022-05-16,Senate,"Placed on suspense file",6,0,0,1,7
1592818,1206492,2022-05-19,Senate,"Do pass as amended",6,0,0,1,7
1592818,1209326,2022-05-25,Senate,"Senate 3rd Reading SB1123 Caballero et al",39,0,0,1,40
1592818,1217119,2022-06-20,Assembly,"Do pass and be re-referred to the Committee on [Appropriations]",10,0,0,1,11
1592819,1179204,2022-03-28,Senate,"Do pass as amended, but first amend, and re-refer to the Committee on [Natural Resources and Water]",5,0,0,2,7
1592819,1192213,2022-04-25,Senate,"Placed on suspense file",5,0,0,2,7
1592819,1206750,2022-05-19,Senate,"Do pass as amended",6,1,0,0,7
1592819,1209344,2022-05-25,Senate,"Senate 3rd Reading SB1124 Archuleta",31,5,0,4,40
1592819,1219996,2022-06-28,Assembly,"Do pass and be re-referred to the Committee on [Appropriations]",6,2,0,0,8
1592820,1189956,2022-04-19,Senate,"Do pass, but first be re-referred to the Committee on [Appropriations]",3,6,0,0,9
1592820,1189957,2022-04-19,Senate,"[First] hearing set for [04-19-2022]: Failed passage in Committee. Reconsideration granted",9,0,0,0,9
1592821,1194445,2022-04-27,Senate,"Do pass, but first be re-referred to the Committee on [Appropriations]",4,1,0,0,5
1592821,1207737,2022-05-23,Senate,"Senate 3rd Reading SB1126 Cortese et al",28,9,0,3,40
1592821,1216294,2022-06-15,Assembly,"Do pass and be re-referred to the Committee on [Appropriations]",5,1,0,1,7
1592821,1222995,2022-08-03,Assembly,"Do pass",11,4,0,1,16
1592821,1223974,2022-08-11,Assembly,"SB 1126 Cortese Senate Third Reading By REYES",57,14,0,9,80
1592822,1173490,2022-03-21,Senate,"Do pass, but first be re-referred to the Committee on [Appropriations]",4,1,0,0,5
1592822,1182573,2022-04-04,Senate,"Placed on suspense file",6,0,0,1,7
1592822,1206762,2022-05-19,Senate,"Do pass",5,1,0,1,7
1592822,1208519,2022-05-24,Senate,"Senate 3rd Reading SB1127 Atkins et al",28,9,0,3,40
1592822,1218001,2022-06-22,Assembly,"Do pass and be re-referred to the Committee on [Appropriations]",10,2,0,2,14
1592822,1224037,2022-08-11,Assembly,"Do pass as amended",13,1,0,2,16
1592822,1225484,2022-08-30,Senate,"Unfinished Business SB1127 Atkins et al. Concurrence",28,9,0,3,40
1592822,1225485,2022-08-30,Assembly,"SB 1127 Atkins Senate Third Reading By Grayson",70,0,0,10,80
1592825,1200488,2022-05-04,Senate,"Do pass and be ordered to the Consent Calendar",5,0,0,0,5
1592825,1204082,2022-05-12,Senate,"Consent Calendar SB1130",35,0,0,5,40
1592825,1215059,2022-06-08,Assembly,"Do pass. To Consent Calendar",8,0,0,0,8
1592826,1179502,2022-03-28,Senate,"Do pass as amended, but first amend, and re-refer to the Committee on [Judiciary]",4,0,0,1,5
1592826,1194451,2022-04-26,Senate,"Do pass, but first be re-referred to the Committee on [Appropriations]",9,2,0,0,11
1592826,1201384,2022-05-09,Senate,"Placed on suspense file",7,0,0,0,7
1592826,1206592,2022-05-19,Senate,"Do pass",5,2,0,0,7
1592826,1209308,2022-05-25,Senate,"Senate 3rd Reading SB1131 Newman Urgency Clause",30,8,0,2,40
1592826,1216295,2022-06-15,Assembly,"Do pass as amended and be re-referred to the Committee on [Judiciary]",5,1,0,1,7
1592826,1219905,2022-06-28,Assembly,"Do pass and be re-referred to the Committee on [Appropriations]",9,0,0,2,11
1592826,1224044,2022-08-11,Assembly,"Do pass as amended",12,2,0,2,16
1592826,1224326,2022-08-22,Assembly,"SB 1131 Newman Third Reading Urgency By Bryan",62,0,0,18,80
1592826,1224806,2022-08-24,Senate,"That the Assembly amendments be concurred in",9,0,0,2,11
1592826,1225774,2022-08-31,Senate,"Unfinished Business SB1131 Newman Urgency Clause Concurrence",30,3,0,7,40
1592828,1183721,2022-04-05,Senate,"Do pass as amended, but first amend, and re-refer to the Committee on [Appropriations]",4,0,0,1,5
1592828,1209397,2022-05-25,Senate,"Senate 3rd Reading SB1133 Archuleta",37,1,0,2,40
1592828,1220049,2022-06-28,Assembly,"Do pass as amended and be re-referred to the Committee on [Appropriations]",6,0,0,1,7
1592829,1183587,2022-04-05,Senate,"Do pass, but first be re-referred to the Committee on [Housing] with the recommendation: To Consent Calendar",5,0,0,0,5
1592829,1194488,2022-04-27,Senate,"Do pass, but first be re-referred to the Committee on [Appropriations] with the recommendation: To Consent Calendar",9,0,0,0,9
1592829,1204099,2022-05-12,Senate,"Consent Calendar SB1134",35,0,0,5,40
1592830,1180233,2022-03-30,Senate,"Do pass as amended, but first amend, and re-refer to the Committee on [Appropriations]",6,0,0,1,7
1592830,1192154,2022-04-25,Senate,"Placed on suspense file",5,0,0,2,7
1592830,1206339,2022-05-19,Senate,"Do pass as amended",7,0,0,0,7
1592830,1210023,2022-05-26,Senate,"Senate 3rd Reading SB1135 Jones et al",33,0,0,7,40
1592830,1220692,2022-06-29,Assembly,"Do pass as amended and be re-referred to the Committee on [Appropriations]",6,0,0,1,7
1592831,1190690,2022-04-20,Senate,"Do pass, but first be re-referred to the Committee on [Labor, Public Employment and Retirement ]",6,0,0,1,7
1592831,1194416,2022-04-27,Senate,"Do pass, but first be re-referred to the Committee on [Appropriations]",5,0,0,0,5
1592831,1204671,2022-05-16,Senate,"Placed on suspense file",6,0,0,1,7
1592831,1206456,2022-05-19,Senate,"Do pass",7,0,0,0,7
1592831,1208466,2022-05-24,Senate,"Senate 3rd Reading SB1136 Portantino",36,0,0,4,40
1592831,1217104,2022-06-20,Assembly,"Do pass and be re-referred to the Committee on [Labor and Employment]",8,1,0,2,11
1592831,1218604,2022-06-22,Assembly,"Do pass as amended and be re-referred to the Committee on [Appropriations]",7,0,0,0,7
1592831,1224030,2022-08-11,Assembly,"Do pass",14,2,0,0,16
1592831,1225548,2022-08-31,Senate,"Unfinished Business SB1136 Portantino Concurrence",39,0,0,1,40
1592831,1225549,2022-08-31,Assembly,"SB 1136 Portantino Senate Third Reading By Blanca Rubio",76,1,0,3,80
1592832,1189859,2022-04-19,Senate,"Do pass, but first be re-referred to the Committee on [Appropriations] with the recommendation: To Consent Calendar",5,0,0,0,5
1592832,1204116,2022-05-12,Senate,"Consent Calendar SB1137",35,0,0,5,40
1592832,1215050,2022-06-08,Assembly,"Do pass and be re-referred to the Committee on [Appropriations] with recommendation: To Consent Calendar",7,0,0,0,7
1592832,1217998,2022-06-22,Assembly,"Do pass. To Consent Calendar",13,0,0,3,16
1592832,1224749,2022-08-24,Assembly,"SB 1137 Atkins Senate Third Reading By Bryan Amendment Set #1",57,15,0,8,80
1592832,1225117,2022-08-29,Assembly,"Do pass",8,3,0,0,11
1592832,1225194,2022-08-30,Assembly,"SB 1137 Gonzalez Senate Third Reading By BRYAN",46,24,0,10,80
1592832,1225195,2022-08-31,Senate,"Unfinished Business SB1137 Gonzalez et al. Concurrence",25,10,0,5,40
1592833,1194322,2022-04-27,Senate,"Do pass as amended, but first amend, and re-refer to the Committee on [Appropriations]",4,0,0,1,5
1592833,1201342,2022-05-09,Senate,"Placed on suspense file",7,0,0,0,7
1592833,1206981,2022-05-19,Senate,"Do pass",6,0,0,1,7
1592833,1208453,2022-05-24,Senate,"Senate 3rd Reading SB1138 Allen",31,5,0,4,40
1592833,1218029,2022-06-22,Assembly,"Do pass and be re-referred to the Committee on [Appropriations]",10,2,0,2,14
1592833,1224054,2022-08-11,Assembly,"Do pass",12,4,0,0,16
1592833,1224681,2022-08-24,Assembly,"SB 1138 Allen Senate Third Reading By Wicks",61,10,0,9,80
1592834,1179328,2022-03-29,Senate,"Do pass, but first be re-referred to the Committee on [Appropriations]",4,0,0,1,5
1592834,1192193,2022-04-25,Senate,"Placed on suspense file",5,0,0,2,7
1592834,1206573,2022-05-19,Senate,"Do pass as amended",5,0,0,2,7
1592834,1208457,2022-05-24,Senate,"Senate 3rd Reading SB1139 Kamlager",28,2,0,10,40
1592834,1215002,2022-06-08,Assembly,"Do pass as amended and be re-referred to the Committee on [Appropriations]",5,0,0,2,7
1592834,1223562,2022-08-11,Assembly,"Do pass as amended",12,3,0,1,16
1592834,1224479,2022-08-23,Assembly,"SB 1139 Kamlager Senate Third Reading By BONTA, M",56,0,0,24,80
1592834,1225551,2022-08-30,Senate,"Unfinished Business SB1139 Kamlager Concurrence",30,1,0,9,40
1592835,1190545,2022-04-19,Senate,"Do pass, but first be re-referred to the Committee on [Appropriations]",5,0,0,0,5
1592835,1198306,2022-05-02,Senate,"Placed on suspense file",7,0,0,0,7
1592835,1206571,2022-05-19,Senate,"Do pass",7,0,0,0,7
1592835,1209352,2022-05-25,Senate,"Special Consent SB1140",39,0,0,1,40
1592835,1220075,2022-06-28,Assembly,"Do pass and be re-referred to the Committee on [Appropriations] with recommendation: To Consent Calendar",7,0,0,1,8
1592835,1223489,2022-08-11,Assembly,"Do pass",16,0,0,0,16
1592835,1224178,2022-08-18,Assembly,"SB 1140 Umberg Senate Third Reading By Calderon",76,0,0,4,80
1592836,1180219,2022-03-30,Senate,"Do pass, but first be re-referred to the Committee on [Appropriations]",5,0,0,2,7
1592836,1189294,2022-04-18,Senate,"Placed on suspense file",7,0,0,0,7
1592836,1206502,2022-05-19,Senate,"Do pass",5,2,0,0,7
1592836,1208447,2022-05-24,Senate,"Senate 3rd Reading SB1141 Lim贸n",29,8,0,3,40
1592836,1215790,2022-06-14,Assembly,"Do pass and be re-referred to the Committee on [Appropriations]",9,0,0,3,12
1592836,1223852,2022-08-11,Assembly,"Do pass as amended",12,4,0,0,16
1592836,1224785,2022-08-24,Assembly,"SB 1141 Lim贸n Senate Third Reading By Nazarian",61,11,0,8,80
1592836,1225315,2022-08-30,Senate,"Unfinished Business SB1141 Lim贸n Concurrence",32,8,0,0,40
1592837,1184651,2022-04-06,Senate,"Do pass, but first be re-referred to the Committee on [Judiciary]",7,2,0,2,11
1592837,1190666,2022-04-19,Senate,"Do pass as amended, but first amend, and re-refer to the Committee on [Appropriations]",9,1,0,1,11
1592837,1201491,2022-05-09,Senate,"Placed on suspense file",7,0,0,0,7
1592837,1206538,2022-05-19,Senate,"Do pass as amended",4,2,0,1,7
1592837,1209222,2022-05-25,Senate,"Senate 3rd Reading SB1142 Caballero et al",29,9,0,2,40
1592837,1217496,2022-06-21,Assembly,"Do pass and be re-referred to the Committee on [Judiciary]",11,3,0,1,15
1592837,1220018,2022-06-28,Assembly,"Do pass as amended and be re-referred to the Committee on [Appropriations]",8,2,0,1,11
1592837,1223662,2022-08-11,Assembly,"Do pass",12,4,0,0,16
1592837,1225042,2022-08-29,Assembly,"SB 1142 Caballero Senate Third Reading By Akilah Weber",59,16,0,5,80
1592837,1225268,2022-08-30,Senate,"Unfinished Business SB1142 Caballero et al. Concurrence",31,9,0,0,40
1592838,1195735,2022-04-27,Senate,"Do pass as amended, but first amend, and re-refer to the Committee on [Appropriations]",10,0,0,1,11
1592838,1204604,2022-05-16,Senate,"Placed on suspense file",6,0,0,1,7
1592838,1206817,2022-05-19,Senate,"Do pass",7,0,0,0,7
1592838,1209269,2022-05-25,Senate,"Special Consent SB1143",39,0,0,1,40
1592838,1217473,2022-06-21,Assembly,"Do pass as amended, and be re-referred to the Committee on [Appropriations] with recommendation: To Consent Calendar",15,0,0,0,15
1592838,1223395,2022-08-11,Assembly,"Do pass as amended",12,0,0,4,16
1592838,1224321,2022-08-22,Assembly,"SB 1143 Roth Senate Third Reading By Wood",76,0,0,4,80
1592838,1225562,2022-08-30,Senate,"Special Consent SB1143",38,0,0,2,40
1592839,1183662,2022-04-05,Senate,"Do pass, but first be re-referred to the Committee on [Education]",10,1,0,4,15
1592839,1194405,2022-04-27,Senate,"Do pass, but first be re-referred to the Committee on [Appropriations]",6,0,0,1,7
1592839,1201350,2022-05-09,Senate,"Placed on suspense file",7,0,0,0,7
1592839,1206393,2022-05-19,Senate,"Do pass as amended",5,1,0,1,7
1592839,1208449,2022-05-24,Senate,"Senate 3rd Reading SB1144 Wiener",36,1,0,3,40
1592839,1216971,2022-06-14,Assembly,"Do pass and be re-referred to the Committee on [Education]",7,1,0,1,9
1592839,1220779,2022-06-29,Assembly,"Do pass as amended and be re-referred to the Committee on [Appropriations]",5,0,0,2,7
1592839,1223725,2022-08-11,Assembly,"Do pass as amended",12,0,0,4,16
1592839,1224373,2022-08-22,Assembly,"SB 1144 Wiener Senate Third Reading By McCarty",63,0,0,17,80
1592839,1224863,2022-08-24,Senate,"Unfinished Business SB1144 Wiener Concurrence",40,0,0,0,40
1592840,1179749,2022-03-28,Senate,"Do pass, but first be re-referred to the Committee on [Appropriations] with the recommendation: To Consent Calendar",7,0,0,0,7
1592840,1189305,2022-04-18,Senate,"Placed on suspense file",7,0,0,0,7
1592840,1206667,2022-05-19,Senate,"Do pass as amended",7,0,0,0,7
1592840,1210022,2022-05-26,Senate,"Special Consent SB1145",38,0,0,2,40
1592840,1217063,2022-06-20,Assembly,"Do pass and be re-referred to the Committee on [Appropriations] with recommendation: To Consent Calendar",9,0,0,2,11
1592840,1223951,2022-08-11,Assembly,"Do pass",16,0,0,0,16
1592840,1224166,2022-08-18,Assembly,"SB 1145 Laird Senate Third Reading By Eduardo Garcia",76,0,0,4,80
1592843,1183753,2022-04-04,Senate,"Do pass, but first be re-referred to the Committee on [Environmental Quality]",13,0,0,1,14
1592843,1194128,2022-04-27,Senate,"Do pass as amended, but first amend, and re-refer to the Committee on [Appropriations]",7,0,0,0,7
1592843,1209989,2022-05-26,Senate,"Senate 3rd Reading SB1148 Laird",38,0,0,2,40
1592843,1215819,2022-06-14,Assembly,"Do pass and be re-referred to the Committee on [Natural Resources]",16,0,0,2,18
1592843,1219516,2022-06-27,Assembly,"Do pass as amended and be re-referred to the Committee on [Appropriations]",6,1,0,4,11
1592844,1184632,2022-04-05,Senate,"Do pass as amended",6,2,0,3,11
1592844,1207783,2022-05-23,Senate,"Senate 3rd Reading SB1149 Leyva et al",26,10,0,4,40
1592844,1215847,2022-06-14,Assembly,"Do pass as amended",7,1,0,3,11
1592844,1225082,2022-08-29,Assembly,"SB 1149 Leyva Senate Third Reading By Stone",31,18,0,31,80
1592848,1190591,2022-04-20,Senate,"Do pass, but first be re-referred to the Committee on [Appropriations] with the recommendation: To Consent Calendar",7,0,0,0,7
1592848,1201502,2022-05-09,Senate,"Consent Calendar SB1153",33,0,0,7,40
1592848,1216964,2022-06-14,Assembly,"Do pass and be re-referred to the Committee on [Appropriations] with recommendation: To Consent Calendar",9,0,0,0,9
1592848,1220812,2022-06-29,Assembly,"Do pass. To Consent Calendar",14,0,0,2,16
1592849,1180264,2022-03-30,Senate,"Do pass, but first be re-referred to the Committee on [Appropriations]",11,0,0,0,11
1592849,1189297,2022-04-18,Senate,"Placed on suspense file",7,0,0,0,7
1592849,1206416,2022-05-19,Senate,"Do pass as amended",7,0,0,0,7
1592849,1209971,2022-05-26,Senate,"Special Consent SB1154",38,0,0,2,40
1592849,1217382,2022-06-21,Assembly,"Do pass and be re-referred to the Committee on [Appropriations] with recommendation: To Consent Calendar",15,0,0,0,15
1592850,1199956,2022-05-03,Senate,"Do pass as amended",10,0,0,1,11
1592850,1204557,2022-05-16,Senate,"Placed on suspense file",6,0,0,1,7
1592850,1206675,2022-05-19,Senate,"Do pass as amended",6,0,0,1,7
1592850,1210011,2022-05-26,Senate,"Special Consent SB1155",38,0,0,2,40
1592850,1217397,2022-06-21,Assembly,"Do pass",10,0,0,0,10
1592850,1224063,2022-08-15,Assembly,"SB 1155 Caballero Senate Third Reading By Grayson",76,0,0,4,80
1592850,1224159,2022-08-18,Senate,"Unfinished Business SB1155 Caballero Concurrence",38,0,0,2,40
1592851,1183748,2022-04-05,Senate,"Be adopted as amended, but first amend, and re-refer to the Committee on [Elections and Constitutional Amendments]",5,0,0,4,9
1592852,1162263,2022-03-03,Senate,"Senate 3rd Reading SR68 Lim贸n",38,0,0,2,40
1593506,1175520,2022-03-22,Assembly,"Do pass. To Consent Calendar",9,0,0,0,9
1593506,1181323,2022-03-31,Assembly,"AB 2327 E.S. & T.M. Consent Calendar Second Day Regular Session",68,0,0,8,76
1593506,1215014,2022-06-08,Senate,"Do pass and be ordered to the Consent Calendar",5,0,0,2,7
1593506,1224797,2022-08-24,Senate,"Assembly 3rd Reading AB2327 E.S. & T.M. (Quirk) By Allen",40,0,0,0,40
1593508,1185721,2022-04-06,Assembly,"Do pass as amended, and be re-referred to the Committee on [Appropriations] with recommendation: To Consent Calendar",7,0,0,0,7
1593508,1206947,2022-05-19,Assembly,"Do pass",16,0,0,0,16
1593508,1210344,2022-05-25,Assembly,"AB 2375 Luz Rivas Assembly Third Reading",76,0,0,2,78
1593508,1220652,2022-06-29,Senate,"Do pass, but first be re-referred to the Committee on [Appropriations] with the recommendation: To Consent Calendar",6,0,0,1,7
1593508,1222740,2022-08-01,Senate,"Placed on suspense file",7,0,0,0,7
1593508,1223842,2022-08-11,Senate,"Do pass",7,0,0,0,7
1593508,1224615,2022-08-23,Senate,"Special Consent AB2375",40,0,0,0,40
1593509,1193426,2022-04-26,Assembly,"Do pass as amended, and be re-referred to the Committee on [Appropriations] with recommendation: To Consent Calendar",6,0,0,0,6
1593510,1189313,2022-04-18,Assembly,"Do pass as amended and be re-referred to the Committee on [Appropriations]",11,0,0,0,11
1593510,1206276,2022-05-19,Assembly,"Do pass",16,0,0,0,16
1593510,1210378,2022-05-25,Assembly,"AB 2377 Muratsuchi Assembly Third Reading",76,0,0,2,78
1593510,1219963,2022-06-28,Senate,"Do pass as amended, but first amend, and re-refer to the Committee on [Appropriations]",9,0,0,0,9
1593510,1222660,2022-08-01,Senate,"Placed on suspense file",7,0,0,0,7
1593511,1200510,2022-05-05,Assembly,"Do pass and be re-referred to the Committee on [Appropriations]",11,0,0,0,11
1593514,1189809,2022-04-18,Assembly,"Do pass and be re-referred to the Committee on [Appropriations]",12,0,0,0,12
1593514,1199978,2022-05-04,Assembly,"Do pass. To Consent Calendar",14,0,0,2,16
1593514,1204136,2022-05-12,Assembly,"AB 2380 Maienschein Consent Calendar Second Day Regular Session",65,0,0,13,78
1593514,1219529,2022-06-27,Senate,"Do pass, but first be re-referred to the Committee on [Appropriations]",10,0,0,4,14
1593514,1224453,2022-08-23,Senate,"Assembly 3rd Reading AB2380 Maienschein By Allen",34,0,0,6,40
1593514,1225178,2022-08-30,Assembly,"With recommendation: That Senate amendments be concurred in",15,0,0,3,18
1593514,1226000,2022-08-31,Assembly,"AB 2380 Maienschein Concurrence in Senate Amendments",80,0,0,0,80
1593515,1179251,2022-03-29,Assembly,"Do pass and be re-referred to the Committee on [Appropriations]",10,0,0,0,10
1593517,1189975,2022-04-19,Assembly,"Do pass as amended and be re-referred to the Committee on [Appropriations]",19,0,0,0,19
1593517,1206496,2022-05-19,Assembly,"Do pass",16,0,0,0,16
1593517,1207754,2022-05-23,Assembly,"AB 2382 Lee Assembly Third Reading",72,0,0,6,78
1593517,1219923,2022-06-28,Senate,"Do pass as amended, but first amend, and re-refer to the Committee on [Appropriations]",10,3,0,2,15
1593517,1223194,2022-08-08,Senate,"Placed on suspense file",7,0,0,0,7
1593517,1223418,2022-08-11,Senate,"Do pass",6,1,0,0,7
1593517,1225813,2022-08-29,Senate,"Assembly 3rd Reading AB2382 Lee et al. By Allen",37,0,0,3,40
1593517,1225814,2022-08-30,Assembly,"AB 2382 Lee Concurrence in Senate Amendments",76,1,0,3,80
1593518,1175506,2022-03-23,Assembly,"Do pass as amended and be re-referred to the Committee on [Judiciary]",6,2,0,0,8
1593518,1183685,2022-04-05,Assembly,"Do pass and be re-referred to the Committee on [Appropriations]",7,3,0,0,10
1593518,1206749,2022-05-19,Assembly,"Do pass",12,4,0,0,16
1593518,1210577,2022-05-26,Assembly,"AB 2383 Jones-Sawyer Assembly Third Reading",43,20,0,15,78
1593518,1220613,2022-06-28,Senate,"Do pass as amended, but first amend, and re-refer to the Committee on [Appropriations]",9,1,0,1,11
1593518,1222784,2022-08-01,Senate,"Placed on suspense file",7,0,0,0,7
1593522,1190562,2022-04-20,Assembly,"Do pass as amended and be re-referred to the Committee on [Judiciary]",6,2,0,0,8
1593522,1199119,2022-05-03,Assembly,"Do pass as amended",7,2,0,1,10
1593523,1183636,2022-04-05,Assembly,"Do pass and be re-referred to the Committee on [Natural Resources]",11,2,0,2,15
1593523,1192195,2022-04-25,Assembly,"Do pass and be re-referred to the Committee on [Appropriations]",7,2,0,2,11
1593524,1181267,2022-03-28,Assembly,"Do pass and be re-referred to the Committee on [Appropriations]",10,0,0,5,15
1593527,1193248,2022-04-26,Assembly,"Do pass and be re-referred to the Committee on [Appropriations]",0,5,0,2,7
1593528,1174569,2022-03-22,Assembly,"Do pass. To Consent Calendar",9,0,0,0,9
1593528,1179713,2022-03-28,Assembly,"AB 2391 Cunningham Consent Calendar Second Day",68,0,0,8,76
1593528,1215023,2022-06-08,Senate,"Do pass and be ordered to the Consent Calendar",9,0,0,2,11
1593528,1216603,2022-06-16,Senate,"Consent Calendar AB2391",35,0,0,5,40
1593528,1217116,2022-06-20,Assembly,"AB 2391 Cunningham Concurrence in Senate Amendments",71,0,0,9,80
1593529,1189890,2022-04-19,Assembly,"Do pass",10,0,0,1,11
1593529,1198289,2022-05-02,Assembly,"AB 2392 Irwin Assembly Third Reading",62,0,0,15,77
1593529,1218011,2022-06-21,Senate,"Do pass as amended, but first amend, and re-refer to the Committee on [Appropriations]",10,0,0,1,11
1593529,1224772,2022-08-24,Senate,"Assembly 3rd Reading AB2392 Irwin By Hertzberg",33,0,0,7,40
1593529,1225107,2022-08-29,Assembly,"AB 2392 Irwin Concurrence in Senate Amendments",76,0,0,4,80
1593530,1183801,2022-04-05,Assembly,"Do pass. To Consent Calendar",8,0,0,0,8
1593530,1191316,2022-04-21,Assembly,"AB 2393 Mayes Consent Calendar Second Day",68,0,0,9,77
1593530,1215927,2022-06-13,Senate,"Do pass, but first be re-referred to the Committee on [Rules]",5,0,0,0,5
1593536,1179166,2022-03-29,Assembly,"Do pass and be re-referred to the Committee on [Appropriations]",2,4,0,1,7
1593536,1193396,2022-04-26,Assembly,"Do pass and be re-referred to the Committee on [Appropriations]",2,5,0,0,7
1593539,1193394,2022-04-26,Assembly,"Do pass as amended and be re-referred to the Committee on [Appropriations]",6,0,0,0,6
1593540,1185713,2022-04-06,Assembly,"Do pass as amended and be re-referred to the Committee on [Appropriations]",7,0,0,0,7
1593540,1206903,2022-05-19,Assembly,"Do pass",16,0,0,0,16
1593540,1207787,2022-05-23,Assembly,"AB 2401 McCarty Assembly Third Reading",73,0,0,5,78
1593540,1216376,2022-06-15,Senate,"Do pass, but first be re-referred to the Committee on [Appropriations] with the recommendation: To Consent Calendar",6,0,0,1,7
1593540,1222669,2022-08-01,Senate,"Placed on suspense file",7,0,0,0,7
1593541,1179289,2022-03-29,Assembly,"Do pass and be re-referred to the Committee on [Appropriations]",12,0,0,3,15
1593541,1206774,2022-05-19,Assembly,"Do pass",15,0,0,1,16
1593541,1210578,2022-05-25,Assembly,"AB 2402 Blanca Rubio Assembly Third Reading",72,0,0,6,78
1593541,1218633,2022-06-22,Senate,"Do pass as amended, but first amend, and re-refer to the Committee on [Appropriations]",8,0,0,3,11
1593541,1222657,2022-08-01,Senate,"Placed on suspense file",7,0,0,0,7
1593541,1223674,2022-08-11,Senate,"Do pass as amended",5,0,0,2,7
1593543,1193177,2022-04-26,Assembly,"Do pass and be re-referred to the Committee on [Appropriations] with recommendation: To Consent Calendar",7,0,0,1,8
1593544,1179243,2022-03-29,Assembly,"Do pass as amended and be re-referred to the Committee on [Appropriations]",14,0,0,1,15
1593544,1194201,2022-04-27,Assembly,"Do pass. To Consent Calendar",15,0,0,1,16
1593544,1200672,2022-05-05,Assembly,"AB 2404 Luz Rivas Consent Calendar Second Day Regular Session",60,0,0,18,78
1593544,1218639,2022-06-22,Senate,"Do pass, but first be re-referred to the Committee on [Appropriations]",9,0,0,2,11
1593544,1222857,2022-08-01,Senate,"Placed on suspense file",7,0,0,0,7
1593544,1223803,2022-08-11,Senate,"Do pass",7,0,0,0,7
1593544,1224738,2022-08-24,Senate,"Assembly 3rd Reading AB2404 Luz Rivas et al. By Hertzberg Urgency Clause",40,0,0,0,40
1593544,1224959,2022-08-25,Assembly,"AB 2404 Luz Rivas Concurrence in Senate Amendments",75,0,0,5,80
1593546,1193348,2022-04-25,Assembly,"Do pass as amended",14,1,0,0,15
1593546,1200673,2022-05-05,Assembly,"AB 2406 Aguiar-Curry Assembly Third Reading",63,1,0,14,78
1593546,1216299,2022-06-14,Senate,"Do pass as amended, but first amend, and re-refer to the Committee on [Judiciary]",15,0,0,2,17
1593546,1217954,2022-06-21,Senate,"Do pass as amended",11,0,0,0,11
1593546,1224768,2022-08-24,Senate,"Assembly 3rd Reading AB2406 Aguiar-Curry et al. By Eggman",40,0,0,0,40
1593546,1224924,2022-08-25,Assembly,"AB 2406 Aguiar-Curry Concurrence in Senate Amendments",73,0,0,7,80
1593548,1183618,2022-04-05,Assembly,"Do pass and be re-referred to the Committee on [Public Safety]",16,0,0,2,18
1593548,1193255,2022-04-26,Assembly,"Do pass and be re-referred to the Committee on [Appropriations] with recommendation: To Consent Calendar",7,0,0,0,7
1593548,1203349,2022-05-11,Assembly,"Do pass. To Consent Calendar",16,0,0,0,16
1593548,1206996,2022-05-19,Assembly,"AB 2407 O'Donnell Consent Calendar Second Day Regular Session",72,0,0,6,78
1593548,1219396,2022-06-27,Senate,"Do pass, but first be re-referred to the Committee on [Public Safety]",14,0,0,0,14
1593548,1220745,2022-06-28,Senate,"Do pass, but first be re-referred to the Committee on [Appropriations]",5,0,0,0,5
1593548,1222705,2022-08-01,Senate,"Placed on suspense file",7,0,0,0,7
1593549,1199250,2022-05-03,Assembly,"Do pass as amended",9,0,0,1,10
1593549,1207791,2022-05-23,Assembly,"AB 2408 Cunningham Assembly Third Reading",51,0,0,27,78
1593549,1220797,2022-06-28,Senate,"Do pass as amended, but first amend, and re-refer to the Committee on [Appropriations]",8,0,0,3,11
1593549,1222871,2022-08-01,Senate,"Placed on suspense file",7,0,0,0,7
1593550,1174575,2022-03-22,Assembly,"Do pass and be re-referred to the Committee on [Appropriations]",5,1,0,1,7
1593554,1184669,2022-04-06,Assembly,"Do pass and be re-referred to the Committee on [Water, Parks, and Wildlife]",9,0,0,2,11
1593554,1193262,2022-04-26,Assembly,"Do pass and be re-referred to the Committee on [Appropriations]",15,0,0,0,15
1593555,1180249,2022-03-30,Assembly,"Do pass and be re-referred to the Committee on [Higher Education]",5,1,0,0,6
1593555,1194196,2022-04-26,Assembly,"Do pass",10,1,0,1,12
1593555,1207682,2022-05-23,Assembly,"AB 2413 Carrillo Assembly Third Reading",61,3,0,14,78
1593555,1215039,2022-06-08,Senate,"Do pass",5,0,0,0,5
1593555,1224781,2022-08-24,Senate,"Assembly 3rd Reading AB2413 Carrillo By Leyva",31,9,0,0,40
1593555,1224878,2022-08-25,Assembly,"AB 2413 Carrillo Concurrence in Senate Amendments",63,4,0,13,80
1593557,1184640,2022-04-06,Assembly,"Do pass and be re-referred to the Committee on [Appropriations] with recommendation: To Consent Calendar",9,0,0,2,11
1593558,1193358,2022-04-25,Assembly,"Do pass and be re-referred to the Committee on [Appropriations]",15,0,0,0,15
1593558,1203347,2022-05-11,Assembly,"Do pass. To Consent Calendar",16,0,0,0,16
1593558,1206544,2022-05-19,Assembly,"AB 2415 Lackey Consent Calendar Second Day Regular Session",72,0,0,6,78
1593558,1220846,2022-06-28,Senate,"Do pass, but first be re-referred to the Committee on [Appropriations] with the recommendation: To Consent Calendar",17,0,0,0,17
1593558,1223207,2022-08-08,Senate,"Consent Calendar AB2415",36,0,0,4,40
1593561,1189977,2022-04-19,Assembly,"Do pass and be re-referred to the Committee on [Appropriations]",6,0,0,1,7
1593561,1206434,2022-05-19,Assembly,"Do pass",15,0,0,1,16
1593561,1207703,2022-05-23,Assembly,"AB 2417 Ting Assembly Third Reading",70,0,0,8,78
1593561,1217469,2022-06-21,Senate,"Do pass, but first be re-referred to the Committee on [Appropriations]",4,0,0,1,5
1593561,1222708,2022-08-01,Senate,"Placed on suspense file",7,0,0,0,7
1593561,1223563,2022-08-11,Senate,"Do pass as amended",7,0,0,0,7
1593561,1225637,2022-08-30,Senate,"Assembly 3rd Reading AB2417 Ting By Durazo",40,0,0,0,40
1593561,1225638,2022-08-31,Assembly,"AB 2417 Ting Concurrence in Senate Amendments",79,0,0,1,80
1593562,1189973,2022-04-19,Assembly,"Do pass as amended and be re-referred to the Committee on [Appropriations]",5,0,0,2,7
1593562,1206930,2022-05-19,Assembly,"Do pass",12,3,0,1,16
1593562,1210518,2022-05-26,Assembly,"AB 2418 Kalra Assembly Third Reading",51,15,0,12,78
1593562,1220882,2022-06-28,Senate,"Do pass as amended, but first amend, and re-refer to the Committee on [Appropriations]",4,0,0,1,5
1593562,1222810,2022-08-01,Senate,"Placed on suspense file",7,0,0,0,7
1593562,1223823,2022-08-11,Senate,"Do pass as amended",5,2,0,0,7
1593562,1225363,2022-08-29,Senate,"Assembly 3rd Reading AB2418 Kalra By Wiener",30,7,0,3,40
1593562,1225364,2022-08-30,Assembly,"AB 2418 Kalra Concurrence in Senate Amendments",58,12,0,10,80
1593563,1182506,2022-04-04,Assembly,"Do pass as amended and be re-referred to the Committee on [Environmental Safety and Toxic Materials]",6,2,0,2,10
1593563,1197952,2022-04-26,Assembly,"Do pass and be re-referred to the Committee on [Appropriations]",6,2,0,1,9
1593563,1206294,2022-05-19,Assembly,"Do pass as amended",12,4,0,0,16
1593563,1210499,2022-05-25,Assembly,"AB 2419 Bryan Assembly Third Reading",55,17,0,6,78
1593563,1217950,2022-06-22,Senate,"Do pass, but first be re-referred to the Committee on [Governmental Organization]",5,2,0,0,7
1593563,1220060,2022-06-28,Senate,"Do pass, but first be re-referred to the Committee on [Appropriations]",9,3,0,3,15
1593563,1222878,2022-08-01,Senate,"Placed on suspense file",7,0,0,0,7
1593564,1189909,2022-04-19,Assembly,"Do pass as amended, and be re-referred to the Committee on [Appropriations] with recommendation: To Consent Calendar",13,0,0,2,15
1593564,1206362,2022-05-19,Assembly,"Do pass",16,0,0,0,16
1593564,1207704,2022-05-23,Assembly,"AB 2420 Arambula Assembly Third Reading",74,0,0,4,78
1593564,1214997,2022-06-08,Senate,"Do pass, but first be re-referred to the Committee on [Appropriations] with the recommendation: To Consent Calendar",9,0,0,2,11
1593564,1217076,2022-06-20,Senate,"Placed on suspense file",4,0,0,3,7
1593564,1223701,2022-08-11,Senate,"Do pass",6,0,0,1,7
1593564,1224771,2022-08-24,Senate,"Assembly 3rd Reading AB2420 Arambula et al. By Stern",38,0,0,2,40
1593564,1224901,2022-08-25,Assembly,"AB 2420 Arambula Concurrence in Senate Amendments",74,0,0,6,80
1593566,1183634,2022-04-05,Assembly,"Do pass and be re-referred to the Committee on [Judiciary] with recommendation: To Consent Calendar",13,0,0,2,15
1593566,1189934,2022-04-19,Assembly,"Do pass as amended, and be re-referred to the Committee on [Appropriations] with recommendation: To Consent Calendar",9,0,0,2,11
1593566,1206549,2022-05-19,Assembly,"Do pass",16,0,0,0,16
1593566,1210388,2022-05-25,Assembly,"AB 2421 Blanca Rubio Assembly Third Reading",76,0,0,2,78
1593567,1194141,2022-04-26,Assembly,"Do pass and be re-referred to the Committee on [Appropriations]",12,0,0,0,12
1593567,1206585,2022-05-19,Assembly,"Do pass",16,0,0,0,16
1593567,1207706,2022-05-23,Assembly,"AB 2422 McCarty Assembly Third Reading",74,0,0,4,78
1593567,1221334,2022-06-30,Senate,"Do pass, but first be re-referred to the Committee on [Appropriations]",6,0,0,1,7
1593567,1222793,2022-08-01,Senate,"Placed on suspense file",7,0,0,0,7
1593567,1223962,2022-08-11,Senate,"Do pass",7,0,0,0,7
1593567,1224542,2022-08-23,Senate,"Special Consent AB2422",40,0,0,0,40
1593569,1179517,2022-03-28,Assembly,"Do pass as amended and be re-referred to the Committee on [Privacy and Consumer Protection]",9,0,0,3,12
1593569,1189847,2022-04-19,Assembly,"Do pass as amended and be re-referred to the Committee on [Appropriations]",10,0,0,1,11
1593569,1206611,2022-05-19,Assembly,"Do pass",14,0,0,2,16
1593569,1210475,2022-05-25,Assembly,"AB 2424 Blanca Rubio Assembly Third Reading",71,0,0,7,78
1593569,1220852,2022-06-28,Senate,"Do pass as amended, but first amend, and re-refer to the Committee on [Appropriations]",9,1,0,1,11
1593569,1222653,2022-08-01,Senate,"Placed on suspense file",7,0,0,0,7
1593569,1223552,2022-08-11,Senate,"Do pass",6,0,0,1,7
1593569,1224536,2022-08-23,Senate,"Assembly 3rd Reading AB2424 Blanca Rubio et al. By Caballero",40,0,0,0,40
1593569,1224851,2022-08-24,Assembly,"AB 2424 Blanca Rubio Concurrence in Senate Amendments",73,0,0,7,80
1593571,1190517,2022-04-19,Assembly,"Do pass and be re-referred to the Committee on [Appropriations]",12,0,0,0,12
1593571,1206617,2022-05-19,Assembly,"Do pass as amended",12,0,0,4,16
1593571,1210294,2022-05-26,Assembly,"AB 2425 Bryan Assembly Third Reading",73,0,0,5,78
1593572,1179174,2022-03-29,Assembly,"Do pass as amended and be re-referred to the Committee on [Appropriations]",15,0,0,0,15
1593572,1206467,2022-05-19,Assembly,"Do pass",16,0,0,0,16
1593572,1210308,2022-05-26,Assembly,"AB 2426 Gipson Assembly Third Reading",75,0,0,3,78
1593572,1218645,2022-06-22,Senate,"Do pass, but first be re-referred to the Committee on [Appropriations]",8,0,0,3,11
1593572,1222750,2022-08-01,Senate,"Placed on suspense file",7,0,0,0,7
1593572,1223370,2022-08-11,Senate,"Do pass as amended",5,0,0,2,7
1593572,1224423,2022-08-23,Senate,"Assembly 3rd Reading AB2426 Gipson et al. By Bradford",37,0,0,3,40
1593572,1224720,2022-08-24,Assembly,"AB 2426 Gipson Concurrence in Senate Amendments",76,0,0,4,80
1593573,1176513,2022-03-23,Assembly,"Do pass as amended and be re-referred to the Committee on [Appropriations]",7,0,0,0,7
1593576,1179298,2022-03-29,Assembly,"Do pass and be re-referred to the Committee on [Judiciary] with recommendation: To Consent Calendar",7,0,0,0,7
1593576,1183832,2022-04-05,Assembly,"Do pass as amended, and be re-referred to the Committee on [Appropriations] with recommendation: To Consent Calendar",9,0,0,1,10
1593576,1206693,2022-05-19,Assembly,"Do pass",16,0,0,0,16
1593576,1207846,2022-05-23,Assembly,"AB 2429 Quirk Assembly Third Reading",73,0,0,5,78
1593576,1215756,2022-06-14,Senate,"Do pass, but first be re-referred to the Committee on [Judiciary] with the recommendation: To Consent Calendar",5,0,0,0,5
1593576,1218039,2022-06-21,Senate,"Do pass, but first be re-referred to the Committee on [Appropriations] with the recommendation: To Consent Calendar",11,0,0,0,11
1593576,1222765,2022-08-01,Senate,"Placed on suspense file",7,0,0,0,7
1593579,1179664,2022-03-28,Assembly,"Do pass and be re-referred to the Committee on [Appropriations] with recommendation: To Consent Calendar",10,0,0,2,12
1593579,1184637,2022-04-06,Assembly,"Do pass. To Consent Calendar",13,0,0,3,16
1593579,1191275,2022-04-21,Assembly,"AB 2431 B. & F. Consent Calendar Second Day Regular Session",68,0,0,9,77
1593579,1210899,2022-05-31,Senate,"Do pass, but first be re-referred to the Committee on [Labor, Public Employment and Retirement ] with the recommendation: To Consent Calendar",8,0,0,3,11
1593579,1218622,2022-06-22,Senate,"Do pass, but first be re-referred to the Committee on [Appropriations]",4,0,0,1,5
1593579,1224165,2022-08-18,Senate,"Assembly 3rd Reading AB2431 B. & F. (Grayson) By Wieckowski",38,0,0,2,40
1593579,1224357,2022-08-22,Assembly,"AB 2431 B. & F. Concurrence in Senate Amendments By GRAYSON",77,0,0,3,80
1593580,1183718,2022-04-04,Assembly,"Do pass and be re-referred to the Committee on [Appropriations] with recommendation: To Consent Calendar",15,0,0,0,15
1593580,1194290,2022-04-27,Assembly,"Do pass. To Consent Calendar",15,0,0,1,16
1593580,1200674,2022-05-05,Assembly,"AB 2432 Muratsuchi Consent Calendar Second Day Regular Session",61,0,0,17,78
1593580,1216337,2022-06-14,Senate,"Do pass as amended, but first amend, and re-refer to the Committee on [Appropriations] with the recommendation: To Consent Calendar",15,0,0,2,17
1593580,1221336,2022-06-30,Senate,"Consent Calendar AB2432",37,0,0,3,40
1593580,1223056,2022-08-04,Assembly,"AB 2432 Muratsuchi Concurrence in Senate Amendments",77,0,0,3,80
1593581,1179647,2022-03-28,Assembly,"Do pass and be re-referred to the Committee on [Appropriations] with recommendation: To Consent Calendar",10,0,0,2,12
1593581,1184662,2022-04-06,Assembly,"Do pass. To Consent Calendar",13,0,0,3,16
1593581,1191346,2022-04-21,Assembly,"AB 2433 Grayson Consent Calendar Second Day Regular Session",68,0,0,9,77
1593581,1216289,2022-06-15,Senate,"Do pass, but first be re-referred to the Committee on [Judiciary] with the recommendation: To Consent Calendar",9,0,0,0,9
1593581,1217844,2022-06-21,Senate,"Do pass, but first be re-referred to the Committee on [Appropriations] with the recommendation: To Consent Calendar",11,0,0,0,11
1593581,1223189,2022-08-08,Senate,"Consent Calendar AB2433",36,0,0,4,40
1593584,1179192,2022-03-29,Assembly,"Do pass",5,2,0,0,7
1593584,1210485,2022-05-26,Assembly,"AB 2435 Lee Assembly Third Reading",35,30,0,13,78
1593585,1179285,2022-03-29,Assembly,"Do pass as amended and be re-referred to the Committee on [Appropriations]",13,0,0,2,15
1593585,1206557,2022-05-19,Assembly,"Do pass",12,0,0,4,16
1593585,1207677,2022-05-23,Assembly,"AB 2436 Bauer-Kahan Assembly Third Reading",59,0,0,19,78
1593585,1214948,2022-06-08,Senate,"Do pass, but first be re-referred to the Committee on [Appropriations]",7,2,0,2,11
1593585,1217083,2022-06-20,Senate,"Placed on suspense file",4,0,0,3,7
1593585,1223594,2022-08-11,Senate,"Do pass",4,0,0,3,7
1593585,1224849,2022-08-24,Senate,"Assembly 3rd Reading AB2436 Bauer-Kahan et al. By Laird",31,3,0,6,40
1593585,1224882,2022-08-25,Assembly,"AB 2436 Bauer-Kahan Concurrence in Senate Amendments",60,2,0,18,80
1593588,1181326,2022-03-28,Assembly,"Do pass and be re-referred to the Committee on [Appropriations]",8,4,0,3,15
1593588,1206335,2022-05-19,Assembly,"Do pass",12,4,0,0,16
1593588,1210246,2022-05-25,Assembly,"AB 2438 Friedman Assembly Third Reading",41,23,0,14,78
1593588,1220758,2022-06-28,Senate,"Do pass, but first be re-referred to the Committee on [Appropriations]",9,4,0,4,17
1593588,1223182,2022-08-08,Senate,"Placed on suspense file",7,0,0,0,7
1593588,1223419,2022-08-11,Senate,"Do pass as amended",5,2,0,0,7
1593588,1225688,2022-08-29,Senate,"Assembly 3rd Reading AB2438 Friedman By Hertzberg",26,12,0,2,40
1593588,1225689,2022-08-30,Assembly,"AB 2438 Friedman Concurrence in Senate Amendments",47,21,0,12,80
1593589,1184649,2022-04-06,Assembly,"Do pass and be re-referred to the Committee on [Transportation]",5,0,0,2,7
1593589,1193137,2022-04-25,Assembly,"Do pass as amended and be re-referred to the Committee on [Appropriations]",10,1,0,4,15
1593590,1186493,2022-04-05,Assembly,"Do pass and be re-referred to the Committee on [Natural Resources]",7,1,0,1,9
1593590,1192194,2022-04-25,Assembly,"Do pass as amended and be re-referred to the Committee on [Appropriations]",9,0,0,2,11
1593590,1206786,2022-05-19,Assembly,"Do pass",12,4,0,0,16
1593590,1207731,2022-05-23,Assembly,"AB 2440 Irwin Assembly Third Reading",58,7,0,13,78
1593590,1217960,2022-06-22,Senate,"Do pass, but first be re-referred to the Committee on [Appropriations]",5,2,0,0,7
1593590,1220818,2022-06-28,Senate,"Do pass, but first be re-referred to the Committee on [Appropriations]",9,1,0,1,11
1593590,1222736,2022-08-01,Senate,"Placed on suspense file",7,0,0,0,7
1593590,1223850,2022-08-11,Senate,"Do pass as amended",5,2,0,0,7
1593590,1225563,2022-08-29,Senate,"Assembly 3rd Reading AB2440 Irwin et al. By Newman",31,9,0,0,40
1593590,1225564,2022-08-31,Assembly,"AB 2440 Irwin Concurrence in Senate Amendments",63,10,0,7,80
1593591,1180238,2022-03-30,Assembly,"Do pass",4,1,0,1,6
1593591,1191266,2022-04-21,Assembly,"AB 2441 Kalra Assembly Third Reading",50,18,0,9,77
1593591,1211937,2022-06-01,Senate,"Do pass as amended",4,0,0,1,5
1593591,1224854,2022-08-24,Senate,"Assembly 3rd Reading AB2441 Kalra By Gonzalez",30,9,0,1,40
1593591,1225022,2022-08-25,Assembly,"AB 2441 Kalra Concurrence in Senate Amendments",54,16,0,10,80
1593593,1190697,2022-04-20,Assembly,"Do pass and be re-referred to the Committee on [Natural Resources]",6,2,0,0,8
1593593,1192217,2022-04-25,Assembly,"Do pass and be re-referred to the Committee on [Appropriations]",7,2,0,2,11
1593593,1205834,2022-05-18,Assembly,"Do pass",11,4,0,1,16
1593593,1210571,2022-05-25,Assembly,"AB 2442 Robert Rivas Assembly Third Reading",57,10,0,11,78
1593593,1215846,2022-06-14,Senate,"Do pass, but first be re-referred to the Committee on [Governance and Finance]",9,5,0,1,15
1593593,1221223,2022-06-29,Senate,"Do pass as amended, but first amend, and re-refer to the Committee on [Appropriations]",4,1,0,0,5
1593594,1180235,2022-03-30,Assembly,"Do pass and be re-referred to the Committee on [Appropriations]",6,0,0,0,6
1593594,1194301,2022-04-27,Assembly,"Do pass. To Consent Calendar",15,0,0,1,16
1593594,1200675,2022-05-05,Assembly,"AB 2443 Cooley Consent Calendar Second Day Regular Session",61,0,0,17,78
1593594,1220790,2022-06-29,Senate,"Do pass, but first be re-referred to the Committee on [Appropriations]",5,0,0,0,5
1593594,1223161,2022-08-08,Senate,"Placed on suspense file",7,0,0,0,7
1593594,1223680,2022-08-11,Senate,"Do pass",7,0,0,0,7
1593594,1225181,2022-08-31,Assembly,"With recommendation: That Senate amendments be concurred in",7,0,0,0,7
1593594,1225429,2022-08-30,Senate,"Assembly 3rd Reading AB2443 Cooley By Cortese",40,0,0,0,40
1593594,1225430,2022-08-31,Assembly,"AB 2443 Cooley Concurrence in Senate Amendments",78,0,0,2,80
1593597,1189385,2022-04-18,Assembly,"Do pass and be re-referred to the Committee on [Judiciary]",11,0,0,0,11
1593598,1182504,2022-04-04,Assembly,"Do pass as amended and be re-referred to the Committee on [Appropriations]",7,2,0,1,10
1593598,1206633,2022-05-19,Assembly,"Do pass",12,4,0,0,16
1593598,1207833,2022-05-23,Assembly,"AB 2446 Holden Assembly Third Reading",46,17,0,15,78
1593598,1216254,2022-06-15,Senate,"Do pass as amended, but first amend, and re-refer to the Committee on [Environmental Quality]",10,3,0,1,14
1593598,1220666,2022-06-29,Senate,"Do pass as amended, but first amend, and re-refer to the Committee on [Appropriations]",6,0,0,1,7
1593598,1222778,2022-08-01,Senate,"Placed on suspense file",7,0,0,0,7
1593598,1223511,2022-08-11,Senate,"Do pass as amended",5,2,0,0,7
1593598,1224415,2022-08-23,Senate,"Assembly 3rd Reading AB2446 Holden et al. By Becker",30,9,0,1,40
1593598,1224753,2022-08-24,Assembly,"AB 2446 Holden Concurrence in Senate Amendments",55,17,0,8,80
1593599,1189301,2022-04-18,Assembly,"Do pass and be re-referred to the Committee on [Appropriations]",8,3,0,0,11
1593599,1206424,2022-05-19,Assembly,"Do pass as amended",12,4,0,0,16
1593600,1183791,2022-04-05,Assembly,"Do pass and be re-referred to the Committee on [Labor and Employment]",9,0,0,1,10
1593600,1191326,2022-04-20,Assembly,"Do pass and be re-referred to the Committee on [Appropriations]",6,0,0,1,7
1593600,1206589,2022-05-19,Assembly,"Do pass as amended",14,0,0,2,16
1593600,1210472,2022-05-25,Assembly,"AB 2448 Ting Assembly Third Reading",68,0,0,10,78
1593600,1217864,2022-06-21,Senate,"Do pass, but first be re-referred to the Committee on [Labor, Public Employment and Retirement ]",11,0,0,0,11
1593600,1220844,2022-06-29,Senate,"Do pass as amended, but first amend, and re-refer to the Committee on [Appropriations]",5,0,0,0,5
1593600,1222777,2022-08-01,Senate,"Placed on suspense file",7,0,0,0,7
1593600,1223923,2022-08-11,Senate,"Do pass as amended",6,0,0,1,7
1593600,1225632,2022-08-29,Senate,"Assembly 3rd Reading AB2448 Ting et al. By Pan",38,0,0,2,40
1593600,1225633,2022-08-30,Assembly,"AB 2448 Ting Concurrence in Senate Amendments",75,0,0,5,80
1593602,1199946,2022-05-04,Assembly,"Do pass",7,1,0,0,8
1593602,1210465,2022-05-26,Assembly,"AB 2449 Blanca Rubio Assembly Third Reading",65,4,0,9,78
1593602,1217956,2022-06-22,Senate,"Do pass, but first be re-referred to the Committee on [Judiciary]",5,0,0,0,5
1593602,1220806,2022-06-28,Senate,"Do pass as amended, but first amend, and re-refer to the Committee on [Appropriations]",9,1,0,1,11
1593602,1224719,2022-08-24,Senate,"Assembly 3rd Reading AB2449 Blanca Rubio By Caballero",36,3,0,1,40
1593602,1224919,2022-08-25,Assembly,"AB 2449 Blanca Rubio Concurrence in Senate Amendments",67,2,0,11,80
1593603,1190637,2022-04-20,Assembly,"Do pass and be re-referred to the Committee on [Appropriations] with recommendation: To Consent Calendar",13,0,0,1,14
1593603,1206427,2022-05-19,Assembly,"Do pass",16,0,0,0,16
1593603,1210453,2022-05-25,Assembly,"AB 2450 Valladares Assembly Third Reading",76,0,0,2,78
1593603,1217977,2022-06-22,Senate,"Do pass, but first be re-referred to the Committee on [Appropriations] with the recommendation: To Consent Calendar",11,0,0,1,12
1593603,1222848,2022-08-01,Senate,"Placed on suspense file",7,0,0,0,7
1593603,1223629,2022-08-11,Senate,"Do pass as amended",7,0,0,0,7
1593603,1224413,2022-08-23,Senate,"Special Consent AB2450",40,0,0,0,40
1593603,1224782,2022-08-24,Assembly,"AB 2450 Valladares Concurrence in Senate Amendments",75,0,0,5,80
1593604,1193408,2022-04-26,Assembly,"Do pass and be re-referred to the Committee on [Appropriations]",11,1,0,3,15
1593604,1206255,2022-05-19,Assembly,"Do pass as amended",12,3,0,1,16
1593604,1210423,2022-05-26,Assembly,"AB 2451 Wood Assembly Third Reading",54,20,0,4,78
1593604,1217056,2022-06-20,Senate,"Do pass as amended, but first amend, and re-refer to the Committee on [Appropriations]",6,1,0,2,9
1593604,1223154,2022-08-08,Senate,"Placed on suspense file",7,0,0,0,7
1593605,1186489,2022-04-05,Assembly,"Do pass and be re-referred to the Committee on [Appropriations] with recommendation: To Consent Calendar",9,0,0,0,9
1593605,1194297,2022-04-27,Assembly,"Do pass. To Consent Calendar",15,0,0,1,16
1593605,1200676,2022-05-05,Assembly,"AB 2452 Chen Consent Calendar Second Day Regular Session",61,0,0,17,78
1593605,1214395,2022-06-06,Senate,"Do pass, but first be re-referred to the Committee on [Appropriations]",12,0,0,2,14
1593605,1224122,2022-08-17,Senate,"Assembly 3rd Reading AB2452 Chen By Ochoa Bogh",38,0,0,2,40
1593607,1184654,2022-04-06,Assembly,"Do pass and be re-referred to the Committee on [Revenue and Taxation]",5,2,0,1,8
1593607,1199173,2022-05-02,Assembly,"Do pass as amended",7,3,0,1,11
1593607,1210471,2022-05-25,Assembly,"AB 2453 Bennett Assembly Third Reading",48,23,0,7,78
1593607,1216251,2022-06-14,Senate,"Do pass, but first be re-referred to the Committee on [Governance and Finance]",11,3,0,3,17
1593607,1221211,2022-06-29,Senate,"Do pass",4,1,0,0,5
1593607,1224312,2022-08-22,Senate,"Assembly 3rd Reading AB2453 Bennett By Lim贸n",31,6,0,3,40
1593608,1194156,2022-04-27,Assembly,"Do pass and be re-referred to the Committee on [Appropriations]",5,1,0,1,7
1593608,1206450,2022-05-19,Assembly,"Do pass as amended",12,1,0,3,16
1593608,1210569,2022-05-25,Assembly,"AB 2454 Jones-Sawyer Assembly Third Reading",60,7,0,11,78
1593609,1190598,2022-04-20,Assembly,"Do pass and be re-referred to the Committee on [Appropriations] with recommendation: To Consent Calendar",20,0,0,2,22
1593609,1205846,2022-05-18,Assembly,"Do pass. To Consent Calendar",15,0,0,1,16
1593609,1210513,2022-05-25,Assembly,"AB 2455 Aguiar-Curry Consent Calendar Second Day Regular Session",73,0,0,5,78
1593609,1220100,2022-06-28,Senate,"Do pass, but first be re-referred to the Committee on [Appropriations] with the recommendation: To Consent Calendar",13,0,0,2,15
1593609,1223283,2022-08-08,Senate,"Consent Calendar AB2455",36,0,0,4,40
1593610,1194380,2022-04-26,Assembly,"Do pass and be re-referred to the Committee on [Appropriations]",11,0,0,1,12
1593613,1174484,2022-03-22,Assembly,"Do pass and be re-referred to the Committee on [Appropriations]",13,0,0,1,14
1593614,1194150,2022-04-26,Assembly,"Do pass as amended and be re-referred to the Committee on [Appropriations]",12,0,0,0,12
1593614,1206498,2022-05-19,Assembly,"Do pass as amended",12,0,0,4,16
1593614,1210556,2022-05-26,Assembly,"AB 2459 Cervantes Assembly Third Reading",75,0,0,3,78
1593614,1221329,2022-06-30,Senate,"Do pass as amended, but first amend, and re-refer to the Committee on [Appropriations]",7,0,0,0,7
1593614,1223284,2022-08-08,Senate,"Placed on suspense file",7,0,0,0,7
1593614,1223415,2022-08-11,Senate,"Do pass as amended",7,0,0,0,7
1593614,1225266,2022-08-29,Senate,"Assembly 3rd Reading AB2459 Cervantes By Glazer",40,0,0,0,40
1593614,1225267,2022-08-30,Assembly,"AB 2459 Cervantes Concurrence in Senate Amendments",79,0,0,1,80
1593614,1229714,2022-08-30,Senate,"Assembly 3rd Reading AB2459 Cervantes By Glazer",40,0,0,0,40
1593618,1183651,2022-04-04,Assembly,"Do pass and be re-referred to the Committee on [Appropriations] with recommendation: To Consent Calendar",15,0,0,0,15
1593618,1194145,2022-04-27,Assembly,"Do pass. To Consent Calendar",15,0,0,1,16
1593618,1200677,2022-05-05,Assembly,"AB 2462 Valladares Consent Calendar Second Day Regular Session",61,0,0,17,78
1593619,1181310,2022-03-30,Assembly,"Do pass and be re-referred to the Committee on [Appropriations] with recommendation: To Consent Calendar",6,0,0,0,6
1593619,1194313,2022-04-27,Assembly,"Do pass. To Consent Calendar",15,0,0,1,16
1593619,1200678,2022-05-05,Assembly,"AB 2463 Lee Consent Calendar Second Day Regular Session",61,0,0,17,78
1593619,1211930,2022-06-01,Senate,"Do pass, but first be re-referred to the Committee on [Appropriations] with the recommendation: To Consent Calendar",5,0,0,0,5
1593619,1223455,2022-08-11,Senate,"Consent Calendar AB2463",38,0,0,2,40
1593621,1190498,2022-04-19,Assembly,"Do pass and be re-referred to the Committee on [Appropriations]",9,3,0,0,12
1593621,1206669,2022-05-19,Assembly,"Do pass",12,4,0,0,16
1593621,1207681,2022-05-23,Assembly,"AB 2464 Cristina Garcia Assembly Third Reading",57,9,0,12,78
1593621,1215817,2022-06-13,Senate,"Do pass, but first be re-referred to the Committee on [Education]",5,0,0,0,5
1593621,1220869,2022-06-29,Senate,"Do pass, but first be re-referred to the Committee on [Appropriations]",5,1,0,1,7
1593621,1222891,2022-08-01,Senate,"Placed on suspense file",7,0,0,0,7
1593621,1223471,2022-08-11,Senate,"Do pass",5,2,0,0,7
1593621,1224474,2022-08-23,Senate,"Assembly 3rd Reading AB2464 Cristina Garcia By Skinner",30,9,0,1,40
1593622,1191247,2022-04-20,Assembly,"Do pass as amended and be re-referred to the Committee on [Appropriations]",7,0,0,0,7
1593622,1206766,2022-05-19,Assembly,"Do pass as amended",12,0,0,4,16
1593622,1210487,2022-05-25,Assembly,"AB 2465 Mia Bonta Assembly Third Reading",76,0,0,2,78
1593622,1217847,2022-06-22,Senate,"Do pass as amended, but first amend, and re-refer to the Committee on [Appropriations] with the recommendation: To Consent Calendar",6,0,0,1,7
1593622,1222897,2022-08-01,Senate,"Placed on suspense file",7,0,0,0,7
1593623,1183795,2022-04-05,Assembly,"Do pass",8,0,0,0,8
1593623,1204585,2022-05-16,Assembly,"AB 2466 Cervantes Assembly Third Reading",66,0,0,12,78
1593623,1215825,2022-06-13,Senate,"Do pass as amended, but first amend, and re-refer to the Committee on [Judiciary]",4,0,0,1,5
1593623,1217863,2022-06-21,Senate,"Do pass",9,0,0,2,11
1593623,1224289,2022-08-22,Senate,"Assembly 3rd Reading AB2466 Cervantes By Laird",35,0,0,5,40
1593623,1224535,2022-08-23,Assembly,"AB 2466 Cervantes Concurrence in Senate Amendments",74,0,0,6,80
1593632,1193390,2022-04-26,Assembly,"Do pass and be re-referred to the Committee on [Appropriations]",14,0,0,1,15
1593632,1206588,2022-05-19,Assembly,"Do pass",16,0,0,0,16
1593632,1207873,2022-05-23,Assembly,"AB 2473 Nazarian Assembly Third Reading",74,0,0,4,78
1593632,1221215,2022-06-29,Senate,"Do pass as amended, but first amend, and re-refer to the Committee on [Appropriations] with the recommendation: To Consent Calendar",10,0,0,1,11
1593632,1224788,2022-08-24,Senate,"Assembly 3rd Reading AB2473 Nazarian et al. By Eggman",40,0,0,0,40
1593632,1225010,2022-08-25,Assembly,"AB 2473 Nazarian Concurrence in Senate Amendments",75,0,0,5,80
1593634,1176496,2022-03-23,Assembly,"Do pass as amended, and be re-referred to the Committee on [Human Services] with recommendation: To Consent Calendar",7,0,0,0,7
1593634,1193199,2022-04-26,Assembly,"Do pass and be re-referred to the Committee on [Appropriations] with recommendation: To Consent Calendar",7,0,0,1,8
1593636,1192179,2022-04-25,Assembly,"Do pass and be re-referred to the Committee on [Appropriations] with recommendation: To Consent Calendar",7,0,0,0,7
1593636,1206455,2022-05-19,Assembly,"Do pass as amended",12,0,0,4,16
1593636,1210245,2022-05-26,Assembly,"AB 2477 Rodriguez Assembly Third Reading",74,0,0,4,78
1593636,1220024,2022-06-28,Senate,"Do pass, but first be re-referred to the Committee on [Appropriations] with the recommendation: To Consent Calendar",13,0,0,2,15
1593636,1222814,2022-08-01,Senate,"Placed on suspense file",7,0,0,0,7
1593639,1189331,2022-04-18,Assembly,"Do pass as amended and be re-referred to the Committee on [Appropriations]",9,1,0,1,11
1593640,1193330,2022-04-26,Assembly,"Do pass and be re-referred to the Committee on [Appropriations] with recommendation: To Consent Calendar",7,0,0,1,8
1593640,1206488,2022-05-19,Assembly,"Do pass",16,0,0,0,16
1593640,1207820,2022-05-23,Assembly,"AB 2480 Arambula Assembly Third Reading",74,0,0,4,78
1593640,1217360,2022-06-20,Senate,"Do pass, but first be re-referred to the Committee on [Appropriations]",4,0,0,1,5
1593640,1222822,2022-08-01,Senate,"Placed on suspense file",7,0,0,0,7
1593640,1223382,2022-08-11,Senate,"Do pass",6,0,0,1,7
1593640,1225453,2022-08-31,Senate,"Special Consent AB2480 Arambula By Newman",40,0,0,0,40
1593640,1225454,2022-08-31,Assembly,"AB 2480 Arambula Concurrence in Senate Amendments",79,0,0,1,80
1593641,1175567,2022-03-22,Assembly,"Do pass and be re-referred to the Committee on [Appropriations] with recommendation: To Consent Calendar",9,0,0,0,9
1593641,1194496,2022-04-27,Assembly,"Do pass. To Consent Calendar",15,0,0,1,16
1593641,1200679,2022-05-05,Assembly,"AB 2481 Smith Consent Calendar Second Day Regular Session",61,0,0,17,78
1593641,1211924,2022-06-01,Senate,"Do pass, but first be re-referred to the Committee on [Appropriations] with the recommendation: To Consent Calendar",6,0,0,1,7
1593641,1224183,2022-08-18,Senate,"Assembly 3rd Reading AB2481 Smith By Dahle",38,0,0,2,40
1593641,1224331,2022-08-22,Assembly,"AB 2481 Smith Concurrence in Senate Amendments",77,0,0,3,80
1593643,1183631,2022-04-05,Assembly,"Do pass and be re-referred to the Committee on [Appropriations]",9,0,0,3,12
1593643,1194165,2022-04-27,Assembly,"Do pass",11,4,0,1,16
1593643,1200680,2022-05-05,Assembly,"AB 2482 Calderon Assembly Third Reading",52,4,0,22,78
1593643,1218016,2022-06-22,Senate,"Do pass as amended, but first amend, and re-refer to the Committee on [Appropriations]",5,1,0,1,7
1593643,1224286,2022-08-22,Senate,"Assembly 3rd Reading AB2482 Calderon et al. By Leyva",31,8,0,1,40
1593643,1224402,2022-08-23,Assembly,"AB 2482 Calderon Concurrence in Senate Amendments",65,5,0,10,80
1593644,1183648,2022-04-05,Assembly,"Do pass and be re-referred to the Committee on [Appropriations]",7,0,0,1,8
1593644,1206948,2022-05-19,Assembly,"Do pass",16,0,0,0,16
1593644,1207816,2022-05-23,Assembly,"AB 2483 Maienschein Assembly Third Reading",74,0,0,4,78
1593644,1215926,2022-06-13,Senate,"Do pass, but first be re-referred to the Committee on [Human Services] with the recommendation: To Consent Calendar",9,0,0,0,9
1593644,1219887,2022-06-27,Senate,"Do pass as amended, but first amend, and re-refer to the Committee on [Appropriations] with the recommendation: To Consent Calendar",5,0,0,0,5
1593644,1222919,2022-08-01,Senate,"Placed on suspense file",7,0,0,0,7
1593644,1223856,2022-08-11,Senate,"Do pass as amended",7,0,0,0,7
1593644,1224556,2022-08-23,Senate,"Special Consent AB2483",40,0,0,0,40
1593644,1224644,2022-08-24,Assembly,"AB 2483 Maienschein Concurrence in Senate Amendments",77,0,0,3,80
1593645,1195721,2022-04-27,Assembly,"Do pass as amended and be re-referred to the Committee on [Appropriations]",5,2,0,0,7
1593645,1205832,2022-05-18,Assembly,"Do pass as amended",9,5,0,2,16
1593645,1210562,2022-05-26,Assembly,"AB 2484 Mia Bonta Assembly Third Reading",36,21,0,21,78
1593645,1210563,2022-05-27,Assembly,"AB 2484 Mia Bonta Assembly Third Reading",42,21,0,15,78
1593645,1220880,2022-06-29,Senate,"Do pass as amended, but first amend, and re-refer to the Committee on [Appropriations]",4,2,0,1,7
1593645,1222911,2022-08-01,Senate,"Placed on suspense file",7,0,0,0,7
1593648,1189828,2022-04-19,Assembly,"Do pass and be re-referred to the Committee on [Appropriations]",11,0,0,0,11
1593649,1184666,2022-04-06,Assembly,"Do pass and be re-referred to the Committee on [Appropriations] with recommendation: To Consent Calendar",9,0,0,2,11
1593649,1194225,2022-04-27,Assembly,"Do pass. To Consent Calendar",15,0,0,1,16
1593649,1200681,2022-05-05,Assembly,"AB 2487 Gray Consent Calendar Second Day Regular Session",61,0,0,17,78
1593649,1217312,2022-06-21,Senate,"Do pass, but first be re-referred to the Committee on [Appropriations] with the recommendation: To Consent Calendar",5,0,0,0,5
1593654,1194333,2022-04-26,Assembly,"Do pass and be re-referred to the Committee on [Appropriations]",12,0,0,0,12
1593656,1190592,2022-04-20,Assembly,"Do pass",6,0,0,0,6
1593656,1198291,2022-05-02,Assembly,"AB 2493 Chen Assembly Third Reading",68,0,0,9,77
1593656,1218646,2022-06-22,Senate,"Do pass, but first be re-referred to the Committee on [Judiciary]",4,0,0,1,5
1593656,1220777,2022-06-28,Senate,"Do pass as amended",10,0,0,1,11
1593656,1225631,2022-08-31,Senate,"Assembly 3rd Reading AB2493 Chen By Newman",40,0,0,0,40
1593658,1184668,2022-04-06,Assembly,"Do pass and be re-referred to the Committee on [Local Government]",6,1,0,0,7
1593658,1190552,2022-04-20,Assembly,"Do pass and be re-referred to the Committee on [Appropriations]",5,2,0,1,8
1593658,1206899,2022-05-19,Assembly,"Do pass",12,4,0,0,16
1593658,1207687,2022-05-23,Assembly,"AB 2494 Salas Assembly Third Reading",54,20,0,4,78
1593658,1215528,2022-06-13,Senate,"Do pass, but first be re-referred to the Committee on [Governance and Finance]",3,1,0,1,5
1593658,1217963,2022-06-22,Senate,"Do pass, but first be re-referred to the Committee on [Appropriations]",4,1,0,0,5
1593658,1222694,2022-08-01,Senate,"Placed on suspense file",7,0,0,0,7
1593658,1223973,2022-08-11,Senate,"Do pass",5,2,0,0,7
1593658,1225743,2022-08-29,Senate,"Assembly 3rd Reading AB2494 Salas By Durazo",30,10,0,0,40
1593659,1179253,2022-03-29,Assembly,"Do pass and be re-referred to the Committee on [Appropriations] with recommendation: To Consent Calendar",10,0,0,0,10
1593659,1194136,2022-04-27,Assembly,"Do pass. To Consent Calendar",15,0,0,1,16
1593659,1200682,2022-05-05,Assembly,"AB 2495 Patterson Consent Calendar Second Day Regular Session",61,0,0,17,78
1593659,1216319,2022-06-14,Senate,"Do pass as amended, but first amend, and re-refer to the Committee on [Appropriations] with the recommendation: To Consent Calendar",11,0,0,0,11
1593659,1221361,2022-06-30,Senate,"Consent Calendar AB2495",37,0,0,3,40
1593659,1223042,2022-08-04,Assembly,"AB 2495 Patterson Concurrence in Senate Amendments",77,0,0,3,80
1593660,1193230,2022-04-25,Assembly,"Do pass and be re-referred to the Committee on [Appropriations]",14,0,0,1,15
1593660,1206514,2022-05-19,Assembly,"Do pass as amended",12,0,0,4,16
1593660,1210428,2022-05-26,Assembly,"AB 2496 Petrie-Norris Assembly Third Reading",69,0,0,9,78
1593660,1220708,2022-06-28,Senate,"Do pass as amended, but first amend, and re-refer to the Committee on [Appropriations]",15,0,0,2,17
1593660,1223152,2022-08-08,Senate,"Placed on suspense file",7,0,0,0,7
1593660,1223543,2022-08-11,Senate,"Do pass as amended",6,1,0,0,7
1593660,1225958,2022-08-29,Senate,"Assembly 3rd Reading AB2496 Petrie-Norris et al. By Portantino",32,7,0,1,40
1593660,1225959,2022-08-30,Assembly,"AB 2496 Petrie-Norris Concurrence in Senate Amendments",76,0,0,4,80
1593664,1194185,2022-04-27,Assembly,"Do pass and be re-referred to the Committee on [Appropriations]",8,0,0,3,11
1593664,1206530,2022-05-19,Assembly,"Do pass as amended",12,3,0,1,16
1593664,1210618,2022-05-25,Assembly,"AB 2499 Maienschein Assembly Third Reading",57,5,0,16,78
1593664,1217328,2022-06-21,Senate,"Do pass as amended, but first amend, and re-refer to the Committee on [Business, Professions and Economic Development]",5,0,0,0,5
1593664,1219449,2022-06-27,Senate,"Do pass, but first be re-referred to the Committee on [Appropriations]",9,4,0,1,14
1593664,1222651,2022-08-01,Senate,"Placed on suspense file",7,0,0,0,7
1593665,1184715,2022-04-06,Assembly,"Do pass as amended and be re-referred to the Committee on [Health]",9,0,0,2,11
1593665,1193308,2022-04-26,Assembly,"Do pass as amended, and be re-referred to the Committee on [Appropriations] with recommendation: To Consent Calendar",14,0,0,1,15
1593667,1185692,2022-04-06,Assembly,"Do pass as amended, and be re-referred to the Committee on [Appropriations] with recommendation: To Consent Calendar",7,0,0,0,7
1593667,1206894,2022-05-19,Assembly,"Do pass as amended",12,1,0,3,16
1593667,1210476,2022-05-26,Assembly,"AB 2501 Carrillo Assembly Third Reading",74,0,0,4,78
1593667,1221254,2022-06-30,Senate,"Do pass, but first be re-referred to the Committee on [Appropriations]",6,0,0,1,7
1593667,1222865,2022-08-01,Senate,"Placed on suspense file",7,0,0,0,7
1593668,1183629,2022-04-05,Assembly,"Do pass and be re-referred to the Committee on [Judiciary] with recommendation: To Consent Calendar",8,0,0,0,8
1593668,1189949,2022-04-19,Assembly,"Do pass as amended, and be re-referred to the Committee on [Appropriations] with recommendation: To Consent Calendar",9,0,0,2,11
1593668,1206886,2022-05-19,Assembly,"Do pass",16,0,0,0,16
1593668,1207761,2022-05-23,Assembly,"AB 2502 Cervantes Assembly Third Reading",74,0,0,4,78
1593668,1217441,2022-06-20,Senate,"Do pass as amended, but first amend, and re-refer to the Committee on [Judiciary]",4,0,0,1,5
1593668,1220591,2022-06-28,Senate,"Do pass, but first be re-referred to the Committee on [Appropriations] with the recommendation: To Consent Calendar",10,0,0,1,11
1593668,1222829,2022-08-01,Senate,"Placed on suspense file",7,0,0,0,7
1593669,1199113,2022-05-03,Assembly,"Do pass as amended",9,1,0,0,10
1593669,1205821,2022-05-18,Assembly,"Do pass",11,4,0,1,16
1593669,1207869,2022-05-23,Assembly,"AB 2503 Cristina Garcia Assembly Third Reading",54,15,0,9,78
1593669,1218047,2022-06-21,Senate,"Do pass, but first be re-referred to the Committee on [Appropriations]",10,1,0,0,11
1593669,1224805,2022-08-24,Senate,"Assembly 3rd Reading AB2503 Cristina Garcia et a By Min",31,9,0,0,40
1593669,1224937,2022-08-25,Assembly,"AB 2503 Cristina Garcia Concurrence in Senate Amendments",59,10,0,11,80
1593672,1199965,2022-05-04,Assembly,"Do pass. To Consent Calendar",8,0,0,0,8
1593672,1204101,2022-05-12,Assembly,"AB 2505 Gray Consent Calendar Second Day Regular Session",65,0,0,13,78
1593672,1211871,2022-06-01,Senate,"Do pass and be ordered to the Consent Calendar",5,0,0,0,5
1593672,1215277,2022-06-09,Senate,"Consent Calendar AB2505",38,0,0,2,40
1593674,1185687,2022-04-06,Assembly,"Do pass and be re-referred to the Committee on [Appropriations]",7,0,0,0,7
1593674,1206293,2022-05-19,Assembly,"Do pass as amended",12,0,0,4,16
1593674,1210451,2022-05-25,Assembly,"AB 2507 McCarty Assembly Third Reading",76,0,0,2,78
1593674,1221359,2022-06-30,Senate,"Do pass as amended, but first amend, and re-refer to the Committee on [Appropriations]",6,0,0,1,7
1593674,1223174,2022-08-08,Senate,"Placed on suspense file",7,0,0,0,7
1593675,1191343,2022-04-20,Assembly,"Do pass as amended. To Consent Calendar",7,0,0,0,7
1593675,1200683,2022-05-05,Assembly,"AB 2508 Quirk-Silva Consent Calendar Second Day",61,0,0,17,78
1593675,1217901,2022-06-22,Senate,"Do pass and be ordered to the Consent Calendar",6,0,0,1,7
1593675,1221230,2022-06-30,Senate,"Consent Calendar AB2508",37,0,0,3,40
1593675,1223032,2022-08-04,Assembly,"AB 2508 Quirk-Silva Concurrence in Senate Amendments",77,0,0,3,80
1593677,1181320,2022-03-28,Assembly,"Do pass and be re-referred to the Committee on [Military and Veterans Affairs] with recommendation: To Consent Calendar",15,0,0,0,15
1593677,1193411,2022-04-26,Assembly,"Do pass and be re-referred to the Committee on [Appropriations]",9,0,0,0,9
1593677,1206702,2022-05-19,Assembly,"Do pass",16,0,0,0,16
1593677,1210657,2022-05-25,Assembly,"AB 2509 Fong Assembly Third Reading",76,0,0,2,78
1593677,1216258,2022-06-14,Senate,"Do pass, but first be re-referred to the Committee on [Military and Veterans Affairs] with the recommendation: To Consent Calendar",15,0,0,2,17
1593677,1219995,2022-06-28,Senate,"Do pass as amended, but first amend, and re-refer to the Committee on [Appropriations] with the recommendation: To Consent Calendar",6,0,0,1,7
1593677,1222695,2022-08-01,Senate,"Placed on suspense file",7,0,0,0,7
1593677,1223959,2022-08-11,Senate,"Do pass",7,0,0,0,7
1593677,1225786,2022-08-31,Senate,"Special Consent AB2509",40,0,0,0,40
1593677,1225787,2022-08-31,Assembly,"AB 2509 Fong Concurrence in Senate Amendments",80,0,0,0,80
1593678,1193210,2022-04-25,Assembly,"Do pass and be re-referred to the Committee on [Appropriations]",15,0,0,0,15
1593678,1206646,2022-05-19,Assembly,"Do pass",16,0,0,0,16
1593678,1210382,2022-05-25,Assembly,"AB 2510 Bennett Assembly Third Reading By WILSON",74,0,0,4,78
1593678,1220625,2022-06-28,Senate,"Do pass, but first be re-referred to the Committee on [Appropriations] with the recommendation: To Consent Calendar",17,0,0,0,17
1593678,1222743,2022-08-01,Senate,"Placed on suspense file",7,0,0,0,7
1593678,1224028,2022-08-11,Senate,"Do pass",7,0,0,0,7
1593678,1225806,2022-08-31,Senate,"Special Consent AB2510",40,0,0,0,40
1593678,1225807,2022-08-31,Assembly,"AB 2510 Wilson Concurrence in Senate Amendments",80,0,0,0,80
1593679,1189962,2022-04-19,Assembly,"Do pass and be re-referred to the Committee on [Appropriations] with recommendation: To Consent Calendar",13,0,0,2,15
1593679,1199998,2022-05-04,Assembly,"Do pass. To Consent Calendar",14,0,0,2,16
1593679,1204120,2022-05-12,Assembly,"AB 2511 Irwin Consent Calendar Second Day Regular Session",65,0,0,13,78
1593679,1214970,2022-06-08,Senate,"Do pass, but first be re-referred to the Committee on [Appropriations]",9,0,0,2,11
1593679,1219344,2022-06-27,Senate,"Placed on suspense file",6,0,0,1,7
1593679,1223920,2022-08-11,Senate,"Do pass",7,0,0,0,7
1593679,1224518,2022-08-23,Senate,"Special Consent AB2511",40,0,0,0,40
1593680,1183799,2022-04-05,Assembly,"Do pass and be re-referred to the Committee on [Judiciary]",10,2,0,3,15
1593680,1189981,2022-04-19,Assembly,"Do pass as amended and be re-referred to the Committee on [Appropriations]",7,1,0,3,11
1593683,1193347,2022-04-25,Assembly,"Do pass and be re-referred to the Committee on [Appropriations]",15,0,0,0,15
1593683,1206887,2022-05-19,Assembly,"Do pass as amended",16,0,0,0,16
1593683,1210351,2022-05-25,Assembly,"AB 2514 Megan Dahle Assembly Third Reading",75,0,0,3,78
1593683,1220760,2022-06-28,Senate,"Do pass, but first be re-referred to the Committee on [Appropriations] with the recommendation: To Consent Calendar",17,0,0,0,17
1593683,1222728,2022-08-01,Senate,"Placed on suspense file",7,0,0,0,7
1593683,1223848,2022-08-11,Senate,"Do pass",7,0,0,0,7
1593683,1224396,2022-08-23,Senate,"Special Consent AB2514",40,0,0,0,40
1593684,1189879,2022-04-19,Assembly,"Do pass and be re-referred to the Committee on [Appropriations]",18,0,0,1,19
1593684,1206582,2022-05-19,Assembly,"Do pass as amended",12,0,0,4,16
1593684,1210454,2022-05-25,Assembly,"AB 2515 Holden Assembly Third Reading",73,0,0,5,78
1593684,1217487,2022-06-20,Senate,"Do pass, but first be re-referred to the Committee on [Public Safety]",10,0,0,4,14
1593684,1220849,2022-06-28,Senate,"Do pass as amended, but first amend, and re-refer to the Committee on [Appropriations]",5,0,0,0,5
1593684,1222643,2022-08-01,Senate,"Placed on suspense file",7,0,0,0,7
1593684,1223663,2022-08-11,Senate,"Do pass as amended",5,0,0,2,7
1593684,1224858,2022-08-24,Senate,"Assembly 3rd Reading AB2515 Holden By Ochoa Bogh",33,0,0,7,40
1593684,1224992,2022-08-25,Assembly,"AB 2515 Holden Concurrence in Senate Amendments",73,0,0,7,80
1593686,1193316,2022-04-26,Assembly,"Do pass and be re-referred to the Committee on [Appropriations]",12,1,0,2,15
1593686,1206734,2022-05-19,Assembly,"Do pass",12,1,0,3,16
1593686,1210435,2022-05-25,Assembly,"AB 2516 Aguiar-Curry Assembly Third Reading",62,0,0,16,78
1593686,1221318,2022-06-29,Senate,"Do pass, but first be re-referred to the Committee on [Appropriations]",8,1,0,2,11
1593686,1222742,2022-08-01,Senate,"Placed on suspense file",7,0,0,0,7
1593686,1223744,2022-08-11,Senate,"Do pass",5,1,0,1,7
1593686,1225410,2022-08-29,Senate,"Assembly 3rd Reading AB2516 Aguiar-Curry By Skinner",30,4,0,6,40
1593686,1225411,2022-08-30,Assembly,"AB 2516 Aguiar-Curry Concurrence in Senate Amendments",67,0,0,13,80
1593687,1193175,2022-04-26,Assembly,"Do pass and be re-referred to the Committee on [Appropriations]",7,0,0,1,8
1593687,1206679,2022-05-19,Assembly,"Do pass",13,1,0,2,16
1593687,1210557,2022-05-25,Assembly,"AB 2517 Mia Bonta Assembly Third Reading",67,0,0,11,78
1593687,1217427,2022-06-20,Senate,"Do pass as amended, but first amend, and re-refer to the Committee on [Appropriations]",4,0,0,1,5
1593687,1222889,2022-08-01,Senate,"Placed on suspense file",7,0,0,0,7
1593687,1223656,2022-08-11,Senate,"Do pass as amended",6,0,0,1,7
1593687,1225286,2022-08-29,Senate,"Assembly 3rd Reading AB2517 Mia Bonta et al. By Hurtado",36,0,0,4,40
1593687,1225287,2022-08-30,Assembly,"AB 2517 Mia Bonta Concurrence in Senate Amendments",71,0,0,9,80
1593689,1204071,2022-05-12,Assembly,"Do pass",9,0,0,2,11
1593689,1210340,2022-05-25,Assembly,"AB 2519 Cooley Assembly Third Reading",65,0,0,13,78
1593689,1219903,2022-06-28,Senate,"Do pass",10,1,0,4,15
1593690,1189984,2022-04-19,Assembly,"Do pass as amended and be re-referred to the Committee on [Appropriations]",8,1,0,2,11
1593690,1206354,2022-05-19,Assembly,"Do pass",13,1,0,2,16
1593690,1210321,2022-05-25,Assembly,"AB 2520 Gabriel Assembly Third Reading",62,5,0,11,78
1593690,1217889,2022-06-21,Senate,"Do pass, but first be re-referred to the Committee on [Appropriations]",9,1,0,1,11
1593690,1222729,2022-08-01,Senate,"Placed on suspense file",7,0,0,0,7
1593690,1223899,2022-08-11,Senate,"Do pass as amended",5,1,0,1,7
1593690,1225016,2022-08-25,Senate,"Assembly 3rd Reading AB2520 Gabriel By Caballero",31,4,0,5,40
1593690,1225017,2022-08-25,Assembly,"AB 2520 Gabriel Concurrence in Senate Amendments",59,0,0,21,80
1593692,1183676,2022-04-05,Assembly,"Do pass as amended and be re-referred to the Committee on [Appropriations]",12,0,0,3,15
1593692,1205830,2022-05-18,Assembly,"Do pass",11,0,0,5,16
1593692,1210582,2022-05-26,Assembly,"AB 2521 Santiago Assembly Third Reading",57,0,0,21,78
1593692,1216304,2022-06-15,Senate,"Do pass as amended, but first amend, and re-refer to the Committee on [Judiciary]",7,2,0,2,11
1593692,1220772,2022-06-28,Senate,"Do pass",9,0,0,2,11
1593692,1224686,2022-08-24,Senate,"Assembly 3rd Reading AB2521 Santiago et al. By Eggman",32,3,0,5,40
1593692,1225027,2022-08-25,Assembly,"AB 2521 Santiago Concurrence in Senate Amendments",60,0,0,20,80
1593694,1193343,2022-04-26,Assembly,"Do pass and be re-referred to the Committee on [Higher Education]",13,0,0,2,15
1593694,1194305,2022-04-26,Assembly,"Do pass and be re-referred to the Committee on [Appropriations]",12,0,0,0,12
1593694,1206421,2022-05-19,Assembly,"Do pass",16,0,0,0,16
1593694,1207815,2022-05-23,Assembly,"AB 2522 Gray Assembly Third Reading",74,0,0,4,78
1593694,1218658,2022-06-22,Senate,"Do pass as amended, but first amend, and re-refer to the Committee on [Judiciary] with the recommendation: To Consent Calendar",9,0,0,2,11
1593694,1222879,2022-08-01,Senate,"Placed on suspense file",7,0,0,0,7
1593696,1190597,2022-04-20,Assembly,"Do pass and be re-referred to the Committee on [Appropriations]",4,2,0,0,6
1593696,1206824,2022-05-19,Assembly,"Do pass",12,4,0,0,16
1593696,1210322,2022-05-25,Assembly,"AB 2524 Kalra Assembly Third Reading",56,19,0,3,78
1593696,1218648,2022-06-22,Senate,"Do pass, but first be re-referred to the Committee on [Judiciary]",4,0,0,1,5
1593696,1220819,2022-06-28,Senate,"Do pass, but first be re-referred to the Committee on [Appropriations]",9,1,0,1,11
1593696,1222896,2022-08-01,Senate,"Placed on suspense file",7,0,0,0,7
1593696,1223745,2022-08-11,Senate,"Do pass",5,2,0,0,7
1593696,1225849,2022-08-29,Senate,"Assembly 3rd Reading AB2524 Kalra et al. By Laird",30,7,0,3,40
1593696,1225850,2022-08-30,Assembly,"AB 2524 Kalra Concurrence in Senate Amendments",59,18,0,3,80
1593698,1183743,2022-04-05,Assembly,"Do pass and be re-referred to the Committee on [Appropriations] with recommendation: To Consent Calendar",7,0,0,0,7
1593698,1206250,2022-05-19,Assembly,"Do pass",16,0,0,0,16
1593698,1210662,2022-05-25,Assembly,"AB 2526 Cooper Assembly Third Reading",76,0,0,2,78
1593698,1220725,2022-06-28,Senate,"Do pass, but first be re-referred to the Committee on [Appropriations] with the recommendation: To Consent Calendar",5,0,0,0,5
1593698,1222673,2022-08-01,Senate,"Placed on suspense file",7,0,0,0,7
1593698,1223436,2022-08-11,Senate,"Do pass",7,0,0,0,7
1593698,1224476,2022-08-23,Senate,"Special Consent AB2526",40,0,0,0,40
1593700,1194437,2022-04-27,Assembly,"Do pass as amended and be re-referred to the Committee on [Appropriations]",6,0,0,1,7
1593700,1206296,2022-05-19,Assembly,"Do pass",16,0,0,0,16
1593700,1207751,2022-05-23,Assembly,"AB 2528 Bigelow Assembly Third Reading",72,0,0,6,78
1593700,1217358,2022-06-21,Senate,"Do pass, but first be re-referred to the Committee on [Appropriations] with the recommendation: To Consent Calendar",5,0,0,0,5
1593700,1223274,2022-08-08,Senate,"Placed on suspense file",7,0,0,0,7
1593700,1223793,2022-08-11,Senate,"Do pass",6,0,0,1,7
1593700,1224699,2022-08-24,Senate,"Assembly 3rd Reading AB2528 Bigelow By Newman",40,0,0,0,40
1593700,1224885,2022-08-25,Assembly,"AB 2528 Bigelow Concurrence in Senate Amendments",75,0,0,5,80
1593701,1193368,2022-04-26,Assembly,"Do pass and be re-referred to the Committee on [Appropriations] with recommendation: To Consent Calendar",14,0,0,1,15
1593701,1206517,2022-05-19,Assembly,"Do pass",16,0,0,0,16
1593701,1210364,2022-05-25,Assembly,"AB 2529 Davies Assembly Third Reading",76,0,0,2,78
1593701,1218657,2022-06-22,Senate,"Do pass, but first be re-referred to the Committee on [Appropriations] with the recommendation: To Consent Calendar",9,0,0,2,11
1593702,1183824,2022-04-05,Assembly,"Do pass and be re-referred to the Committee on [Appropriations]",9,1,0,5,15
1593702,1206423,2022-05-19,Assembly,"Do pass",12,4,0,0,16
1593702,1207753,2022-05-23,Assembly,"AB 2530 Wood Assembly Third Reading",53,15,0,10,78
1593702,1221268,2022-06-29,Senate,"Do pass as amended, but first amend, and re-refer to the Committee on [Appropriations]",8,2,0,1,11
1593702,1223153,2022-08-08,Senate,"Placed on suspense file",7,0,0,0,7
1593702,1223913,2022-08-11,Senate,"Do pass",5,2,0,0,7
1593702,1224945,2022-08-25,Senate,"Assembly 3rd Reading AB2530 Wood et al. By Leyva",31,9,0,0,40
1593702,1224946,2022-08-25,Assembly,"AB 2530 Wood Concurrence in Senate Amendments",56,16,0,8,80
1593704,1182548,2022-04-04,Assembly,"Do pass as amended and be re-referred to the Committee on [Appropriations]",9,1,0,0,10
1593704,1206623,2022-05-19,Assembly,"Do pass",13,3,0,0,16
1593704,1207814,2022-05-23,Assembly,"AB 2532 Bennett Assembly Third Reading",60,10,0,8,78
1593704,1215918,2022-06-14,Senate,"Do pass, but first be re-referred to the Committee on [Environmental Quality]",9,4,0,2,15
1593704,1216303,2022-06-15,Senate,"Do pass, but first be re-referred to the Committee on [Appropriations]",5,0,0,2,7
1593704,1223190,2022-08-08,Senate,"Placed on suspense file",7,0,0,0,7
1593706,1183751,2022-04-05,Assembly,"Do pass and be re-referred to the Committee on [Health]",5,2,0,0,7
1593706,1193198,2022-04-26,Assembly,"Do pass as amended and be re-referred to the Committee on [Appropriations]",11,1,0,3,15
1593707,1193269,2022-04-26,Assembly,"Do pass as amended and be re-referred to the Committee on [Appropriations]",15,0,0,0,15
1593707,1206386,2022-05-19,Assembly,"Do pass",16,0,0,0,16
1593707,1207730,2022-05-23,Assembly,"AB 2535 Eduardo Garcia Assembly Third Reading",74,0,0,4,78
1593707,1215814,2022-06-14,Senate,"Do pass as amended, but first amend, and re-refer to the Committee on [Appropriations] with the recommendation: To Consent Calendar",9,0,0,0,9
1593707,1219355,2022-06-27,Senate,"Placed on suspense file",6,0,0,1,7
1593708,1199947,2022-05-04,Assembly,"Do pass",8,0,0,0,8
1593708,1204633,2022-05-16,Assembly,"AB 2536 Grayson Assembly Third Reading",70,0,0,8,78
1593708,1217892,2022-06-22,Senate,"Do pass and be ordered to the Consent Calendar",5,0,0,0,5
1593708,1221244,2022-06-30,Senate,"Consent Calendar AB2536",37,0,0,3,40
1593709,1189913,2022-04-18,Assembly,"Do pass and be re-referred to the Committee on [Public Safety]",14,0,0,1,15
1593709,1193352,2022-04-26,Assembly,"Do pass and be re-referred to the Committee on [Appropriations] with recommendation: To Consent Calendar",7,0,0,0,7
1593709,1206787,2022-05-19,Assembly,"Do pass",16,0,0,0,16
1593709,1210597,2022-05-26,Assembly,"AB 2537 Gipson Assembly Third Reading",74,0,0,4,78
1593709,1216293,2022-06-14,Senate,"Do pass, but first be re-referred to the Committee on [Public Safety] with the recommendation: To Consent Calendar",15,0,0,2,17
1593709,1220837,2022-06-28,Senate,"Do pass, but first be re-referred to the Committee on [Appropriations] with the recommendation: To Consent Calendar",5,0,0,0,5
1593709,1222734,2022-08-01,Senate,"Placed on suspense file",7,0,0,0,7
1593709,1223620,2022-08-11,Senate,"Do pass as amended",7,0,0,0,7
1593709,1224579,2022-08-23,Senate,"Special Consent AB2537",40,0,0,0,40
1593709,1224844,2022-08-24,Assembly,"AB 2537 Gipson Concurrence in Senate Amendments",76,0,0,4,80
1593710,1182565,2022-04-04,Assembly,"Do pass and be re-referred to the Committee on [Appropriations]",7,0,0,0,7
1593712,1189959,2022-04-18,Assembly,"Do pass as amended and be re-referred to the Committee on [Appropriations]",10,1,0,1,12
1593712,1199924,2022-05-04,Assembly,"Do pass",14,0,0,2,16
1593712,1204573,2022-05-16,Assembly,"AB 2540 Berman Assembly Third Reading",60,0,0,18,78
1593713,1185694,2022-04-06,Assembly,"Do pass as amended and be re-referred to the Committee on [Appropriations]",7,0,0,0,7
1593717,1189921,2022-04-19,Assembly,"Do pass and be re-referred to the Committee on [Appropriations]",2,2,0,3,7
1593718,1189848,2022-04-19,Assembly,"Do pass and be re-referred to the Committee on [Health]",6,0,0,1,7
1593718,1193211,2022-04-26,Assembly,"Do pass as amended and be re-referred to the Committee on [Appropriations]",14,0,0,1,15
1593718,1206859,2022-05-19,Assembly,"Do pass as amended",12,0,0,4,16
1593718,1210443,2022-05-25,Assembly,"AB 2546 Nazarian Assembly Third Reading",76,0,0,2,78
1593718,1217394,2022-06-21,Senate,"Do pass, but first be re-referred to the Committee on [Transportation]",2,0,0,3,5
1593718,1217395,2022-06-21,Senate,"[First] hearing set for [06-21-2022]: Failed passage in Committee. Reconsideration granted",4,0,0,1,5
1593718,1220810,2022-06-28,Senate,"Do pass, but first be re-referred to the Committee on [Transportation]",3,0,0,2,5
1593719,1183609,2022-04-05,Assembly,"Do pass and be re-referred to the Committee on [Aging and Long-Term Care]",5,1,0,2,8
1593719,1189825,2022-04-19,Assembly,"Do pass and be re-referred to the Committee on [Appropriations]",5,0,0,2,7
1593719,1206590,2022-05-19,Assembly,"Do pass",12,2,0,2,16
1593719,1207781,2022-05-23,Assembly,"AB 2547 Nazarian Assembly Third Reading",56,7,0,15,78
1593719,1220709,2022-06-28,Senate,"Do pass, but first be re-referred to the Committee on [Appropriations]",5,0,0,0,5
1593719,1222748,2022-08-01,Senate,"Placed on suspense file",7,0,0,0,7
1593720,1179122,2022-03-29,Assembly,"Do pass and be re-referred to the Committee on [Appropriations] with recommendation: To Consent Calendar",7,0,0,0,7
1593720,1206668,2022-05-19,Assembly,"Do pass as amended",16,0,0,0,16
1593720,1210470,2022-05-25,Assembly,"AB 2548 Nazarian Assembly Third Reading",76,0,0,2,78
1593720,1221242,2022-06-30,Senate,"Do pass, but first be re-referred to the Committee on [Appropriations]",6,0,0,1,7
1593720,1222649,2022-08-01,Senate,"Placed on suspense file",7,0,0,0,7
1593720,1223864,2022-08-11,Senate,"Do pass as amended",5,1,0,1,7
1593720,1224637,2022-08-24,Senate,"Assembly 3rd Reading AB2548 Nazarian By Durazo",38,0,0,2,40
1593720,1225001,2022-08-25,Assembly,"AB 2548 Nazarian Concurrence in Senate Amendments",75,0,0,5,80
1593721,1189888,2022-04-19,Assembly,"Do pass as amended, and be re-referred to the Committee on [Appropriations] with recommendation: To Consent Calendar",13,0,0,2,15
1593722,1192167,2022-04-25,Assembly,"Do pass as amended and be re-referred to the Committee on [Appropriations]",7,3,0,1,11
1593722,1206308,2022-05-19,Assembly,"Do pass",12,4,0,0,16
1593722,1210457,2022-05-25,Assembly,"AB 2550 Arambula Assembly Third Reading",45,19,0,14,78
1593722,1216354,2022-06-15,Senate,"Do pass as amended, but first amend, and re-refer to the Committee on [Appropriations]",5,2,0,0,7
1593722,1222654,2022-08-01,Senate,"Placed on suspense file",7,0,0,0,7
1593722,1223429,2022-08-11,Senate,"Do pass",4,2,0,1,7
1593722,1224993,2022-08-25,Senate,"Assembly 3rd Reading AB2550 Arambula et al. By Eggman",27,13,0,0,40
1593722,1224994,2022-08-25,Assembly,"AB 2550 Arambula Concurrence in Senate Amendments",48,15,0,17,80
1593723,1189834,2022-04-19,Assembly,"Do pass and be re-referred to the Committee on [Appropriations] with recommendation: To Consent Calendar",7,0,0,0,7
1593723,1199971,2022-05-04,Assembly,"Do pass",14,0,0,2,16
1593723,1201438,2022-05-09,Assembly,"AB 2551 McCarty Assembly Third Reading",63,0,0,15,78
1593723,1215012,2022-06-08,Senate,"Do pass, but first be re-referred to the Committee on [Appropriations] with the recommendation: To Consent Calendar",5,0,0,0,5
1593723,1215566,2022-06-13,Senate,"Do pass",7,0,0,0,7
1593723,1221331,2022-06-30,Assembly,"AB 2551 McCarty Concurrence in Senate Amendments",78,0,0,2,80
1593723,1221573,2022-06-29,Senate,"Assembly 3rd Reading AB2551 McCarty et al. By Nielsen",36,0,0,4,40
1593724,1183736,2022-04-05,Assembly,"Do pass as amended and be re-referred to the Committee on [Appropriations]",5,2,0,0,7
1593724,1206330,2022-05-19,Assembly,"Do pass",12,4,0,0,16
1593724,1210660,2022-05-25,Assembly,"AB 2552 McCarty Assembly Third Reading",57,14,0,7,78
1593724,1214946,2022-06-08,Senate,"Do pass, but first be re-referred to the Committee on [Appropriations]",5,0,0,0,5
1593724,1215543,2022-06-13,Senate,"Do pass",5,1,0,1,7
1593724,1224370,2022-08-22,Senate,"Assembly 3rd Reading AB2552 McCarty et al. By Min",31,5,0,4,40
1593724,1224405,2022-08-23,Assembly,"AB 2552 McCarty Concurrence in Senate Amendments",58,13,0,9,80
1593725,1193287,2022-04-26,Assembly,"Do pass and be re-referred to the Committee on [Appropriations] with recommendation: To Consent Calendar",7,0,0,0,7
1593725,1207014,2022-05-19,Assembly,"Do pass as amended",12,0,0,4,16
1593725,1210449,2022-05-25,Assembly,"AB 2553 Grayson Assembly Third Reading",76,0,0,2,78
1593725,1220661,2022-06-28,Senate,"Do pass, but first be re-referred to the Committee on [Appropriations] with the recommendation: To Consent Calendar",5,0,0,0,5
1593725,1222685,2022-08-01,Senate,"Placed on suspense file",7,0,0,0,7
1593726,1193270,2022-04-25,Assembly,"Do pass and be re-referred to the Committee on [Appropriations]",15,0,0,0,15
1593728,1180245,2022-03-30,Assembly,"Do pass and be re-referred to the Committee on [Appropriations]",5,0,0,1,6
1593728,1194336,2022-04-27,Assembly,"Do pass",12,0,0,4,16
1593728,1201372,2022-05-09,Assembly,"AB 2556 O'Donnell Assembly Third Reading",58,0,0,20,78
1593728,1220731,2022-06-29,Senate,"Do pass, but first be re-referred to the Committee on [Appropriations]",4,0,0,1,5
1593728,1223181,2022-08-08,Senate,"Placed on suspense file",7,0,0,0,7
1593728,1223581,2022-08-11,Senate,"Do pass",6,0,0,1,7
1593728,1225846,2022-08-29,Senate,"Assembly 3rd Reading AB2556 O'Donnell By Cortese",38,1,0,1,40
1593728,1225847,2022-08-30,Assembly,"AB 2556 O'Donnell Concurrence in Senate Amendments",71,0,0,9,80
1593729,1189960,2022-04-19,Assembly,"Do pass and be re-referred to the Committee on [Judiciary]",5,2,0,0,7
1593731,1179128,2022-03-29,Assembly,"Do pass and be re-referred to the Committee on [Privacy and Consumer Protection]",8,0,0,2,10
1593731,1199239,2022-05-03,Assembly,"Do pass as amended",9,0,0,2,11
1593731,1204656,2022-05-16,Assembly,"AB 2559 Ward Assembly Third Reading",54,8,0,16,78
1593731,1218028,2022-06-21,Senate,"Do pass as amended",9,2,0,0,11
1593731,1224362,2022-08-22,Senate,"Assembly 3rd Reading AB2559 Ward By Wiener",31,7,0,2,40
1593731,1224517,2022-08-23,Assembly,"AB 2559 Ward Concurrence in Senate Amendments",60,9,0,11,80
1593732,1195740,2022-04-27,Assembly,"Do pass as amended and be re-referred to the Committee on [Appropriations]",6,0,0,2,8
1593732,1205841,2022-05-18,Assembly,"Do pass",15,0,0,1,16
1593732,1210481,2022-05-25,Assembly,"AB 2560 Mia Bonta Assembly Third Reading",75,0,0,3,78
1593732,1221289,2022-06-29,Senate,"Do pass as amended, but first amend, and re-refer to the Committee on [Appropriations]",5,0,0,0,5
1593732,1223270,2022-08-08,Senate,"Placed on suspense file",7,0,0,0,7
1593734,1181290,2022-03-28,Assembly,"Do pass and be re-referred to the Committee on [Appropriations]",9,0,0,6,15
1593735,1183821,2022-04-04,Assembly,"Do pass and be re-referred to the Committee on [Natural Resources]",9,1,0,5,15
1593735,1192159,2022-04-25,Assembly,"Do pass as amended and be re-referred to the Committee on [Appropriations]",10,0,0,1,11
1593737,1185690,2022-04-06,Assembly,"Do pass as amended and be re-referred to the Committee on [Appropriations]",7,0,0,0,7
1593737,1206698,2022-05-19,Assembly,"Do pass",16,0,0,0,16
1593737,1210337,2022-05-25,Assembly,"AB 2565 Blanca Rubio Assembly Third Reading",76,0,0,2,78
1593738,1189388,2022-04-18,Assembly,"Do pass and be re-referred to the Committee on [Education]",10,0,0,1,11
1593738,1195848,2022-04-27,Assembly,"Do pass as amended, and be re-referred to the Committee on [Appropriations] with recommendation: To Consent Calendar",7,0,0,0,7
1593738,1206396,2022-05-19,Assembly,"Do pass",16,0,0,0,16
1593738,1210542,2022-05-26,Assembly,"AB 2566 Calderon Assembly Third Reading",75,0,0,3,78
1593738,1219962,2022-06-28,Senate,"Do pass as amended, but first amend, and re-refer to the Committee on [Appropriations]",9,0,0,0,9
1593738,1222744,2022-08-01,Senate,"Placed on suspense file",7,0,0,0,7
1593738,1224008,2022-08-11,Senate,"Do pass as amended",7,0,0,0,7
1593738,1224431,2022-08-23,Senate,"Special Consent AB2566",40,0,0,0,40
1593738,1224696,2022-08-24,Assembly,"AB 2566 Calderon Concurrence in Senate Amendments",77,0,0,3,80
1593739,1193272,2022-04-25,Assembly,"Be adopted. To Consent Calendar",15,0,0,0,15
1593739,1195722,2022-04-28,Assembly,"ACR 144 Gray Consent Calendar Second Day Regular Session",71,0,0,6,77
1593739,1220717,2022-06-28,Senate,"Be adopted, but first be re-referred to the Committee on [Appropriations] with recommendation: To Consent Calendar",16,0,0,1,17
1593739,1223016,2022-08-04,Senate,"Special Consent ACR144",35,0,0,5,40
1593740,1154472,2022-02-24,Assembly,"Be adopted. To Consent Calendar",9,0,0,2,11
1593740,1162245,2022-03-03,Assembly,"ACR 145 Reyes Consent Calendar Second Day",70,0,0,6,76
1593740,1173479,2022-03-21,Senate,"Special Consent ACR145",37,0,0,3,40
1593741,1167881,2022-03-10,Assembly,"Be adopted. To third reading",10,0,0,1,11
1593742,1154492,2022-02-24,Assembly,"Be adopted. To Consent Calendar",9,0,0,2,11
1593742,1162265,2022-03-03,Assembly,"HR 90 O'Donnell Consent Calendar Second Day Regular Session",70,0,0,6,76
1593743,1200484,2022-05-04,Senate,"Do pass, but first be re-referred to the Committee on [Appropriations]",2,2,0,1,5
1593743,1200485,2022-05-04,Senate,"[First] hearing set for [05-05-2022]: Failed passage in Committee. Reconsideration granted",5,0,0,0,5
1593744,1183838,2022-04-05,Senate,"Do pass, but first be re-referred to the Committee on [Appropriations]",7,2,0,0,9
1593744,1191312,2022-04-21,Senate,"Senate 3rd Reading SB1157 Hertzberg",28,9,0,3,40
1593744,1215795,2022-06-14,Assembly,"Do pass as amended and be re-referred to the Committee on [Appropriations]",8,4,0,3,15
1593744,1223576,2022-08-11,Assembly,"Do pass",12,4,0,0,16
1593744,1225046,2022-08-29,Assembly,"SB 1157 Hertzberg Senate Third Reading By Friedman",34,23,0,23,80
1593744,1225643,2022-08-31,Senate,"W/O REF. TO FILE SB1157 Hertzberg",29,10,0,1,40
1593744,1225644,2022-08-31,Assembly,"SB 1157 Hertzberg Senate Third Reading By Friedman",45,21,0,14,80
1593745,1193249,2022-04-26,Senate,"Do pass as amended, but first amend, and re-refer to the Committee on [Appropriations]",10,2,0,2,14
1593745,1204577,2022-05-16,Senate,"Placed on suspense file",6,0,0,1,7
1593745,1206380,2022-05-19,Senate,"Do pass as amended",5,2,0,0,7
1593745,1209299,2022-05-25,Senate,"Senate 3rd Reading SB1158 Becker et al",30,9,0,1,40
1593745,1217907,2022-06-22,Assembly,"Do pass and be re-referred to the Committee on [Natural Resources]",12,0,0,3,15
1593745,1219444,2022-06-27,Assembly,"Do pass and be re-referred to the Committee on [Appropriations]",8,3,0,0,11
1593745,1223804,2022-08-11,Assembly,"Do pass as amended",12,4,0,0,16
1593745,1225992,2022-08-30,Assembly,"SB 1158 Becker Senate Third Reading By Boerner Horvath",55,18,0,7,80
1593745,1225993,2022-08-31,Senate,"Unfinished Business SB1158 Becker et al. Concurrence",30,8,0,2,40
1593746,1199991,2022-05-03,Senate,"Do pass and be ordered to the Consent Calendar",11,0,0,0,11
1593746,1204125,2022-05-12,Senate,"Consent Calendar SB1159",35,0,0,5,40
1593747,1190530,2022-04-20,Senate,"Do pass as amended, but first amend, and re-refer to the Committee on [Appropriations]",6,0,0,1,7
1593747,1201500,2022-05-09,Senate,"Placed on suspense file",7,0,0,0,7
1593748,1189802,2022-04-19,Senate,"Do pass, but first be re-referred to the Committee on [Judiciary]",15,0,0,2,17
1593748,1198329,2022-05-02,Senate,"Placed on suspense file",7,0,0,0,7
1593748,1206872,2022-05-19,Senate,"Do pass",7,0,0,0,7
1593748,1209217,2022-05-25,Senate,"Special Consent SB1161",39,0,0,1,40
1593748,1220002,2022-06-27,Assembly,"Do pass as amended and be re-referred to the Committee on [Appropriations]",14,0,0,1,15
1593748,1224040,2022-08-11,Assembly,"Do pass",14,2,0,0,16
1593748,1225049,2022-08-29,Assembly,"SB 1161 Min Senate Third Reading By Mike Fong",78,0,0,2,80
1593748,1225863,2022-08-30,Senate,"Unfinished Business SB1161 Min et al. Concurrence",37,0,0,3,40
1593749,1183613,2022-04-04,Senate,"Do pass, but first be re-referred to the Committee on [Judiciary]",4,1,0,0,5
1593749,1194463,2022-04-26,Senate,"Do pass as amended, but first amend, and re-refer to the Committee on [Appropriations]",9,2,0,0,11
1593749,1204588,2022-05-16,Senate,"Placed on suspense file",6,0,0,1,7
1593749,1206908,2022-05-19,Senate,"Do pass as amended",5,2,0,0,7
1593749,1208489,2022-05-24,Senate,"Senate 3rd Reading SB1162 Lim贸n et al",27,9,0,4,40
1593749,1215855,2022-06-14,Assembly,"Do pass and be re-referred to the Committee on [Labor and Employment]",7,2,0,2,11
1593749,1217911,2022-06-22,Assembly,"Do pass and be re-referred to the Committee on [Appropriations]",5,2,0,0,7
1593749,1223438,2022-08-11,Assembly,"Do pass as amended",12,4,0,0,16
1593749,1225041,2022-08-29,Assembly,"SB 1162 Lim贸n Senate Third Reading By Cristina Garcia",54,14,0,12,80
1593749,1225337,2022-08-30,Senate,"Unfinished Business SB1162 Lim贸n et al. Concurrence",31,9,0,0,40
1593751,1179396,2022-03-28,Senate,"Do pass as amended, but first amend, and re-refer to the Committee on [Environmental Quality]",12,0,0,2,14
1593751,1190636,2022-04-20,Senate,"Do pass, but first be re-referred to the Committee on [Appropriations]",7,0,0,0,7
1593751,1198286,2022-05-02,Senate,"Placed on suspense file",7,0,0,0,7
1593751,1206430,2022-05-19,Senate,"Do pass",7,0,0,0,7
1593751,1207811,2022-05-23,Senate,"Senate 3rd Reading SB1164 Stern",36,0,0,4,40
1593751,1217986,2022-06-22,Assembly,"Do pass and be re-referred to the Committee on [Natural Resources]",13,0,0,2,15
1593751,1219515,2022-06-27,Assembly,"Do pass as amended and be re-referred to the Committee on [Appropriations]",11,0,0,0,11
1593752,1175511,2022-03-23,Senate,"Do pass, but first be re-referred to the Committee on [Appropriations] with the recommendation: To Consent Calendar",11,0,0,0,11
1593752,1191317,2022-04-21,Senate,"Consent Calendar SB1165",39,0,0,1,40
1593752,1215857,2022-06-14,Assembly,"Do pass and be re-referred to the Committee on [Appropriations] with recommendation: To Consent Calendar",13,0,0,2,15
1593752,1220877,2022-06-29,Assembly,"Do pass. To Consent Calendar",14,0,0,2,16
1593752,1223027,2022-08-04,Assembly,"SB 1165 Bates Consent Calendar Second Day Regular Session",76,0,0,4,80
1593754,1189831,2022-04-19,Senate,"Do pass, but first be re-referred to the Committee on [Appropriations]",7,1,0,1,9
1593754,1209969,2022-05-26,Senate,"Senate 3rd Reading SB1167 Allen",28,8,0,4,40
1593755,1189845,2022-04-18,Senate,"Do pass as amended, but first amend, and re-refer to the Committee on [Appropriations] with the recommendation: To Consent Calendar",5,0,0,0,5
1593755,1201357,2022-05-09,Senate,"Consent Calendar SB1168",33,0,0,7,40
1593755,1217851,2022-06-22,Assembly,"Do pass and be re-referred to the Committee on [Appropriations] with recommendation: To Consent Calendar",7,0,0,0,7
1593755,1222958,2022-08-03,Assembly,"Do pass. To Consent Calendar",15,0,0,1,16
1593755,1223527,2022-08-11,Assembly,"SB 1168 Cortese Consent Calendar Second Day Regular Session",76,0,0,4,80
1593756,1194160,2022-04-26,Senate,"Do pass, but first be re-referred to the Committee on [Appropriations]",14,1,0,2,17
1593756,1201508,2022-05-09,Senate,"Placed on suspense file",7,0,0,0,7
1593756,1206313,2022-05-19,Senate,"Do pass",6,0,0,1,7
1593756,1208507,2022-05-24,Senate,"Senate 3rd Reading SB1169 Hueso",35,0,0,5,40
1593756,1219941,2022-06-27,Assembly,"Do pass as amended and be re-referred to the Committee on [Appropriations]",14,0,0,1,15
1593758,1194314,2022-04-26,Senate,"Do pass, but first be re-referred to the Committee on [Judiciary]",3,0,0,2,5
1593758,1201414,2022-05-09,Senate,"Senate 3rd Reading SB1171 Caballero",33,0,0,7,40
1593759,1184652,2022-04-05,Senate,"Do pass, but first be re-referred to the Committee on [Appropriations]",8,2,0,1,11
1593759,1189299,2022-04-18,Senate,"Placed on suspense file",7,0,0,0,7
1593759,1206449,2022-05-19,Senate,"Do pass",5,2,0,0,7
1593759,1209219,2022-05-25,Senate,"Senate 3rd Reading SB1172 Pan",27,9,0,4,40
1593759,1215851,2022-06-14,Assembly,"Do pass as amended and be re-referred to the Committee on [Judiciary]",7,0,0,4,11
1593759,1219873,2022-06-28,Assembly,"Do pass as amended and be re-referred to the Committee on [Appropriations]",10,1,0,0,11
1593759,1222975,2022-08-03,Assembly,"Do pass",12,3,0,1,16
1593759,1224342,2022-08-22,Assembly,"SB 1172 Pan Senate Third Reading By Cunningham",64,0,0,16,80
1593759,1224750,2022-08-24,Senate,"Unfinished Business SB1172 Pan Concurrence",31,9,0,0,40
1593760,1183812,2022-04-04,Senate,"Do pass as amended, but first amend, and re-refer to the Committee on [Judiciary]",3,1,0,1,5
1593760,1190539,2022-04-19,Senate,"Do pass as amended, but first amend, and re-refer to the Committee on [Appropriations]",8,2,0,1,11
1593760,1198304,2022-05-02,Senate,"Placed on suspense file",7,0,0,0,7
1593760,1206591,2022-05-19,Senate,"Do pass",4,2,0,1,7
1593760,1209390,2022-05-25,Senate,"Senate 3rd Reading SB1173 Gonzalez et al",21,10,0,9,40
1593761,1179567,2022-03-28,Senate,"Do pass as amended, but first amend, and re-refer to the Committee on [Appropriations]",10,0,0,4,14
1593761,1192162,2022-04-25,Senate,"Placed on suspense file",5,0,0,2,7
1593761,1206361,2022-05-19,Senate,"Do pass as amended",6,0,0,1,7
1593761,1209316,2022-05-25,Senate,"Senate 3rd Reading SB1174 Hertzberg et al",39,0,0,1,40
1593761,1217933,2022-06-22,Assembly,"Do pass as amended and be re-referred to the Committee on [Appropriations]",15,0,0,0,15
1593761,1223478,2022-08-11,Assembly,"Do pass",16,0,0,0,16
1593761,1225073,2022-08-29,Assembly,"SB 1174 Hertzberg Senate Third Reading By Eduardo Garcia",79,0,0,1,80
1593761,1225251,2022-08-30,Senate,"Unfinished Business SB1174 Hertzberg et al. Concurrence",36,0,0,4,40
1593762,1189801,2022-04-19,Senate,"Do pass, but first be re-referred to the Committee on [Appropriations] with the recommendation: To Consent Calendar",16,0,0,1,17
1593762,1198256,2022-05-02,Senate,"Placed on suspense file",7,0,0,0,7
1593762,1206267,2022-05-19,Senate,"Do pass",7,0,0,0,7
1593762,1209252,2022-05-25,Senate,"Special Consent SB1175",39,0,0,1,40
1593762,1219869,2022-06-27,Assembly,"Do pass and be re-referred to the Committee on [Appropriations]",13,0,0,2,15
1593762,1223687,2022-08-11,Assembly,"Do pass",16,0,0,0,16
1593762,1225007,2022-08-25,Assembly,"SB 1175 McGuire Senate Third Reading By Aguiar-Curry",75,0,0,5,80
1593763,1190509,2022-04-20,Senate,"Do pass, but first be re-referred to the Committee on [Judiciary]",7,0,0,2,9
1593763,1194274,2022-04-26,Senate,"Do pass, but first be re-referred to the Committee on [Appropriations]",9,2,0,0,11
1593763,1201517,2022-05-09,Senate,"Placed on suspense file",7,0,0,0,7
1593763,1206537,2022-05-19,Senate,"Do pass as amended",5,1,0,1,7
1593763,1209278,2022-05-25,Senate,"Senate 3rd Reading SB1176 Lim贸n",31,8,0,1,40
1593764,1181297,2022-03-31,Senate,"Do pass as amended, but first amend, and re-refer to the Committee on [Housing]",5,0,0,0,5
1593764,1194132,2022-04-27,Senate,"Do pass and be ordered to the Consent Calendar",9,0,0,0,9
1593764,1201354,2022-05-09,Senate,"Consent Calendar SB1177",33,0,0,7,40
1593764,1215010,2022-06-08,Assembly,"Do pass and be re-referred to the Committee on [Housing and Community Development] with recommendation: To Consent Calendar",8,0,0,0,8
1593764,1220736,2022-06-29,Assembly,"Do pass. To Consent Calendar",8,0,0,0,8
1593764,1223029,2022-08-04,Assembly,"SB 1177 Portantino Consent Calendar Second Day Regular Session",76,0,0,4,80
1593765,1189931,2022-04-19,Senate,"Do pass, but first be re-referred to the Committee on [Appropriations]",4,1,0,0,5
1593765,1198332,2022-05-02,Senate,"Placed on suspense file",7,0,0,0,7
1593765,1206440,2022-05-19,Senate,"Do pass",5,2,0,0,7
1593765,1209983,2022-05-26,Senate,"Senate 3rd Reading SB1178 Bradford Urgency Clause",29,8,0,3,40
1593765,1215848,2022-06-14,Assembly,"Do pass",5,2,0,1,8
1593765,1225636,2022-08-31,Assembly,"SB 1178 Bradford Third Reading Urgency By Stone",36,21,0,23,80
1593766,1184631,2022-04-05,Senate,"Do pass and be ordered to the Consent Calendar",10,0,0,1,11
1593766,1191249,2022-04-21,Senate,"Consent Calendar SB1179",39,0,0,1,40
1593766,1211887,2022-06-01,Assembly,"Do pass. To Consent Calendar",10,0,0,1,11
1593766,1215293,2022-06-09,Assembly,"SB 1179 Glazer Consent Calendar Second Day Regular Session",69,0,0,9,78
1593767,1195841,2022-04-27,Senate,"Do pass, but first be re-referred to the Committee on [Appropriations] with the recommendation: To Consent Calendar",10,0,0,1,11
1593767,1204644,2022-05-16,Senate,"Placed on suspense file",6,0,0,1,7
1593767,1206958,2022-05-19,Senate,"Do pass",7,0,0,0,7
1593767,1209241,2022-05-25,Senate,"Special Consent SB1180",39,0,0,1,40
1593767,1219993,2022-06-28,Assembly,"Do pass and be re-referred to the Committee on [Appropriations] with recommendation: To Consent Calendar",15,0,0,0,15
1593767,1223753,2022-08-11,Assembly,"Do pass",16,0,0,0,16
1593768,1190620,2022-04-20,Senate,"Do pass, but first be re-referred to the Committee on [Transportation]",6,0,0,1,7
1593768,1194147,2022-04-26,Senate,"Do pass, but first be re-referred to the Committee on [Appropriations]",16,0,0,1,17
1593768,1201445,2022-05-09,Senate,"Placed on suspense file",7,0,0,0,7
1593768,1206372,2022-05-19,Senate,"Do pass",7,0,0,0,7
1593768,1207742,2022-05-23,Senate,"Senate 3rd Reading SB1181 Hueso",36,0,0,4,40
1593768,1215523,2022-06-13,Assembly,"Do pass as amended and be re-referred to the Committee on [Transportation]",10,0,0,1,11
1593768,1222970,2022-08-03,Assembly,"Do pass",15,0,0,1,16
1593768,1225984,2022-08-30,Senate,"Unfinished Business SB1181 Hueso Concurrence",40,0,0,0,40
1593768,1225985,2022-08-30,Assembly,"SB 1181 Hueso Senate Third Reading By Alvarez",79,0,0,1,80
1593769,1194234,2022-04-26,Senate,"Do pass as amended, but first amend, and re-refer to the Committee on [Appropriations] with the recommendation: To Consent Calendar",11,0,0,0,11
1593769,1207887,2022-05-23,Senate,"Consent Calendar SB1182 Eggman",36,0,0,4,40
1593769,1215876,2022-06-14,Assembly,"Do pass and be re-referred to the Committee on [Appropriations] with recommendation: To Consent Calendar",10,0,0,1,11
1593769,1220580,2022-06-29,Assembly,"Do pass. To Consent Calendar",14,0,0,2,16
1593769,1223052,2022-08-04,Assembly,"SB 1182 Eggman Consent Calendar Second Day Regular Session",76,0,0,4,80
1593769,1224102,2022-08-16,Senate,"Unfinished Business SB1182 Eggman Concurrence",37,0,0,3,40
1593770,1194321,2022-04-27,Senate,"Do pass as amended, but first amend, and re-refer to the Committee on [Appropriations] with the recommendation: To Consent Calendar",7,0,0,0,7
1593770,1204652,2022-05-16,Senate,"Placed on suspense file",6,0,0,1,7
1593770,1206849,2022-05-19,Senate,"Do pass",7,0,0,0,7
1593770,1209960,2022-05-26,Senate,"Senate 3rd Reading SB1183 Grove et al",38,0,0,2,40
1593770,1220792,2022-06-29,Assembly,"Do pass and be re-referred to the Committee on [Appropriations]",6,0,0,1,7
1593770,1223583,2022-08-11,Assembly,"Do pass",16,0,0,0,16
1593770,1225113,2022-08-29,Assembly,"SB 1183 Grove Third Reading Urgency By Megan Dahle",79,0,0,1,80
1593770,1225607,2022-08-30,Senate,"Unfinished Business SB1183 Grove et al. Urgency Clause Concurrence",38,0,0,2,40
1593771,1184696,2022-04-05,Senate,"Do pass",8,2,0,1,11
1593771,1207813,2022-05-23,Senate,"Senate 3rd Reading SB1184 Cortese et al",27,9,0,4,40
1593771,1217376,2022-06-21,Assembly,"Do pass and be re-referred to the Committee on [Health]",9,1,0,1,11
1593771,1219896,2022-06-28,Assembly,"Do pass",12,2,0,1,15
1593771,1224368,2022-08-22,Assembly,"SB 1184 Cortese Senate Third Reading By Lee",61,10,0,9,80
1593771,1224709,2022-08-24,Senate,"Unfinished Business SB1184 Cortese et al. Concurrence",31,9,0,0,40
1593773,1183732,2022-04-04,Senate,"Do pass, but first be re-referred to the Committee on [Governance and Finance]",8,4,0,2,14
1593773,1190548,2022-04-20,Senate,"Do pass as amended, but first amend, and re-refer to the Committee on [Appropriations]",4,1,0,0,5
1593773,1207740,2022-05-23,Senate,"Senate 3rd Reading SB1186 Wiener",22,9,0,9,40
1593773,1217433,2022-06-21,Assembly,"Do pass and be re-referred to the Committee on [Judiciary]",13,2,0,4,19
1593773,1219891,2022-06-28,Assembly,"Do pass as amended and be re-referred to the Committee on [Appropriations]",9,2,0,0,11
1593773,1223376,2022-08-11,Assembly,"Do pass as amended",12,4,0,0,16
1593773,1225230,2022-08-30,Senate,"Unfinished Business SB1186 Wiener et al. Concurrence",24,9,0,7,40
1593773,1225231,2022-08-30,Assembly,"SB 1186 Wiener Senate Third Reading By Kalra",46,17,0,17,80
1593774,1194227,2022-04-27,Senate,"Do pass as amended, but first amend, and re-refer to the Committee on [Appropriations]",7,0,0,0,7
1593774,1204568,2022-05-16,Senate,"Placed on suspense file",6,0,0,1,7
1593774,1206719,2022-05-19,Senate,"Do pass as amended",7,0,0,0,7
1593774,1209997,2022-05-26,Senate,"Special Consent SB1187",38,0,0,2,40
1593774,1217088,2022-06-20,Assembly,"Do pass as amended and be re-referred to the Committee on [Appropriations]",10,0,0,1,11
1593774,1223589,2022-08-11,Assembly,"Do pass as amended",12,0,0,4,16
1593774,1224314,2022-08-22,Assembly,"SB 1187 Kamlager Senate Third Reading By BENNETT",77,0,0,3,80
1593774,1224688,2022-08-24,Senate,"Unfinished Business SB1187 Kamlager et al. Concurrence",40,0,0,0,40
1593775,1179473,2022-03-28,Senate,"Do pass, but first be re-referred to the Committee on [Appropriations] with the recommendation: To Consent Calendar",7,0,0,0,7
1593775,1189306,2022-04-18,Senate,"Placed on suspense file",7,0,0,0,7
1593775,1206781,2022-05-19,Senate,"Do pass",7,0,0,0,7
1593775,1209319,2022-05-25,Senate,"Special Consent SB1188",39,0,0,1,40
1593775,1219900,2022-06-28,Assembly,"Do pass and be re-referred to the Committee on [Appropriations] with recommendation: To Consent Calendar",8,0,0,0,8
1593775,1223452,2022-08-11,Assembly,"Do pass",16,0,0,0,16
1593775,1224235,2022-08-18,Assembly,"SB 1188 Laird Senate Third Reading By Quirk",76,0,0,4,80
1593776,1184727,2022-04-05,Senate,"Do pass as amended, but first amend, and re-refer to the Committee on [Appropriations]",7,2,0,2,11
1593776,1192169,2022-04-25,Senate,"Placed on suspense file",5,0,0,2,7
1593777,1179207,2022-03-29,Senate,"Do pass, but first be re-referred to the Committee on [Education]",14,0,0,1,15
1593777,1198239,2022-05-02,Senate,"Placed on suspense file",7,0,0,0,7
1593778,1195791,2022-04-27,Senate,"Do pass as amended, but first amend, and re-refer to the Committee on [Appropriations] with the recommendation: To Consent Calendar",10,0,0,1,11
1593778,1204567,2022-05-16,Senate,"Placed on suspense file",6,0,0,1,7
1593778,1206432,2022-05-19,Senate,"Do pass",7,0,0,0,7
1593778,1209272,2022-05-25,Senate,"Special Consent SB1191",39,0,0,1,40
1593778,1220087,2022-06-28,Assembly,"Do pass and be re-referred to the Committee on [Appropriations] with recommendation: To Consent Calendar",15,0,0,0,15
1593778,1223355,2022-08-11,Assembly,"Do pass",16,0,0,0,16
1593778,1225045,2022-08-29,Assembly,"SB 1191 Bates Senate Third Reading By Akilah Weber",78,0,0,2,80
1593778,1225269,2022-08-30,Senate,"Unfinished Business SB1191 Bates Concurrence",40,0,0,0,40
1593779,1179165,2022-03-29,Senate,"Do pass and be ordered to the Consent Calendar",14,0,0,1,15
1593779,1182552,2022-04-04,Senate,"Consent Calendar SB1192 Ochoa Bogh",39,0,0,1,40
1593779,1216271,2022-06-15,Assembly,"Do pass and be re-referred to the Committee on [Appropriations] with recommendation: To Consent Calendar",7,0,0,0,7
1593779,1216596,2022-06-15,Assembly,"Do pass. To Consent Calendar",7,0,0,0,7
1593779,1218623,2022-06-23,Assembly,"SB 1192 Ochoa Bogh Consent Calendar Second Day Regular Session",74,0,0,6,80
1593780,1189855,2022-04-19,Senate,"Do pass, but first be re-referred to the Committee on [Appropriations] with the recommendation: To Consent Calendar",16,0,0,1,17
1593780,1201481,2022-05-09,Senate,"Consent Calendar SB1193",33,0,0,7,40
1593780,1220019,2022-06-27,Assembly,"Do pass and be re-referred to the Committee on [Appropriations]",13,0,0,2,15
1593780,1223334,2022-08-10,Assembly,"Do pass. To Consent Calendar",15,0,0,1,16
1593780,1224634,2022-08-23,Assembly,"SB 1193 Newman Senate Third Reading By Daly",77,0,0,3,80
1593780,1225965,2022-08-30,Senate,"Special Consent SB1193",38,0,0,2,40
1593781,1194291,2022-04-27,Senate,"Do pass",9,0,0,0,9
1593781,1207755,2022-05-23,Senate,"Senate 3rd Reading SB1194 Allen",37,0,0,3,40
1593781,1217485,2022-06-21,Assembly,"Do pass as amended",18,0,0,1,19
1593781,1225105,2022-08-29,Assembly,"SB 1194 Allen Senate Third Reading By Ward",70,0,0,10,80
1593781,1225595,2022-08-30,Senate,"Unfinished Business SB1194 Allen Concurrence",36,0,0,4,40
1593782,1193160,2022-04-26,Senate,"Do pass, but first be re-referred to the Committee on [Appropriations] with the recommendation: To Consent Calendar",5,0,0,2,7
1593782,1204109,2022-05-12,Senate,"Consent Calendar SB1195",35,0,0,5,40
1593782,1215899,2022-06-14,Assembly,"Do pass and be re-referred to the Committee on [Appropriations]",7,0,0,2,9
1593782,1223001,2022-08-03,Assembly,"Do pass. To Consent Calendar",15,0,0,1,16
1593782,1223976,2022-08-11,Assembly,"SB 1195 Grove Consent Calendar Second Day Regular Session",76,0,0,4,80
1593783,1194262,2022-04-26,Senate,"Do pass, but first be re-referred to the Committee on [Appropriations]",12,1,0,4,17
1593783,1201435,2022-05-09,Senate,"Placed on suspense file",7,0,0,0,7
1593783,1206452,2022-05-19,Senate,"Do pass",6,0,0,1,7
1593783,1209303,2022-05-25,Senate,"Senate 3rd Reading SB1196 Umberg",32,1,0,7,40
1593784,1189895,2022-04-19,Senate,"Do pass, but first be re-referred to the Committee on [Appropriations]",8,0,0,1,9
1593784,1198290,2022-05-02,Senate,"Placed on suspense file",7,0,0,0,7
1593785,1193331,2022-04-26,Senate,"Do pass, but first be re-referred to the Committee on [Appropriations]",9,0,0,6,15
1593785,1201437,2022-05-09,Senate,"Placed on suspense file",7,0,0,0,7
1593785,1206870,2022-05-19,Senate,"Do pass",4,0,0,3,7
1593785,1208503,2022-05-24,Senate,"Senate 3rd Reading SB1198 McGuire",32,0,0,8,40
1593786,1194106,2022-04-27,Senate,"Do pass, but first be re-referred to the Committee on [Appropriations]",7,0,0,0,7
1593786,1201389,2022-05-09,Senate,"Placed on suspense file",7,0,0,0,7
1593786,1206401,2022-05-19,Senate,"Do pass as amended",7,0,0,0,7
1593786,1209404,2022-05-25,Senate,"Senate 3rd Reading SB1199 Roth et al",39,0,0,1,40
1593787,1190499,2022-04-19,Senate,"Do pass as amended, but first amend, and re-refer to the Committee on [Appropriations]",9,2,0,0,11
1593787,1209386,2022-05-25,Senate,"Senate 3rd Reading SB1200 Skinner",29,8,0,3,40
1593787,1219908,2022-06-28,Assembly,"Do pass as amended",8,2,0,1,11
1593787,1224046,2022-08-11,Assembly,"SB 1200 Skinner Senate Third Reading By Bauer-Kahan Amendment Set #1",53,17,0,10,80
1593787,1224175,2022-08-18,Assembly,"SB 1200 Skinner Senate Third Reading By Bauer-Kahan",55,18,0,7,80
1593787,1224596,2022-08-23,Senate,"Unfinished Business SB1200 Skinner Concurrence",31,9,0,0,40
1593789,1179129,2022-03-29,Senate,"Do pass as amended, but first amend, and re-refer to the Committee on [Banking and Financial Institutions] with the recommendation: To Consent Calendar",11,0,0,0,11
1593789,1184642,2022-04-06,Senate,"Do pass as amended, but first amend, and re-refer to the Committee on [Appropriations] with the recommendation: To Consent Calendar",9,0,0,0,9
1593789,1195763,2022-04-28,Senate,"Consent Calendar SB1202",37,0,0,3,40
1593789,1215808,2022-06-14,Assembly,"Do pass and be re-referred to the Committee on [Banking and Finance] with recommendation: To Consent Calendar",10,0,0,1,11
1593789,1217087,2022-06-20,Assembly,"Do pass and be re-referred to the Committee on [Appropriations] with recommendation: To Consent Calendar",10,0,0,2,12
1593789,1223002,2022-08-03,Assembly,"Do pass. To Consent Calendar",15,0,0,1,16
1593789,1224462,2022-08-23,Assembly,"SB 1202 Lim贸n Senate Third Reading By Stone",77,0,0,3,80
1593789,1225529,2022-08-30,Senate,"Special Consent SB1202",38,0,0,2,40
1593790,1183749,2022-04-05,Senate,"Do pass, but first be re-referred to the Committee on [Environmental Quality]",9,3,0,3,15
1593790,1194423,2022-04-27,Senate,"Do pass, but first be re-referred to the Committee on [Appropriations]",5,2,0,0,7
1593790,1201470,2022-05-09,Senate,"Placed on suspense file",7,0,0,0,7
1593790,1206285,2022-05-19,Senate,"Do pass as amended",5,2,0,0,7
1593790,1209234,2022-05-25,Senate,"Senate 3rd Reading SB1203 Becker et al",30,9,0,1,40
1593790,1217082,2022-06-20,Assembly,"Do pass as amended and be re-referred to the Committee on [Accountability and Administrative Review]",7,1,0,3,11
1593790,1220867,2022-06-29,Assembly,"Do pass and be re-referred to the Committee on [Appropriations]",5,0,0,2,7
1593790,1223646,2022-08-11,Assembly,"Do pass as amended",12,3,0,1,16
1593790,1224446,2022-08-23,Assembly,"SB 1203 Becker Senate Third Reading By Ting",63,4,0,13,80
1593790,1225715,2022-08-30,Senate,"Unfinished Business SB1203 Becker et al. Concurrence",31,9,0,0,40
1593792,1189954,2022-04-19,Senate,"Do pass as amended, but first amend, and re-refer to the Committee on [Appropriations]",8,0,0,1,9
1593792,1201499,2022-05-09,Senate,"Placed on suspense file",7,0,0,0,7
1593792,1206328,2022-05-19,Senate,"Do pass",7,0,0,0,7
1593792,1209310,2022-05-25,Senate,"Senate 3rd Reading SB1205 Allen et al",34,0,0,6,40
1593792,1219866,2022-06-28,Assembly,"Do pass as amended and be re-referred to the Committee on [Appropriations]",10,0,0,5,15
1593792,1223373,2022-08-11,Assembly,"Do pass",12,0,0,4,16
1593792,1225879,2022-08-31,Senate,"Unfinished Business SB1205 Allen et al. Concurrence",33,0,0,7,40
1593792,1225880,2022-08-31,Assembly,"SB 1205 Allen Senate Third Reading By Friedman",65,1,0,14,80
1593793,1179264,2022-03-28,Senate,"Do pass as amended, but first amend, and re-refer to the Committee on [Appropriations]",5,2,0,0,7
1593793,1189370,2022-04-18,Senate,"Placed on suspense file",7,0,0,0,7
1593793,1206505,2022-05-19,Senate,"Do pass as amended",5,2,0,0,7
1593793,1209394,2022-05-25,Senate,"Senate 3rd Reading SB1206 Skinner",30,9,0,1,40
1593793,1215550,2022-06-13,Assembly,"Do pass as amended and be re-referred to the Committee on [Appropriations]",7,2,0,2,11
1593793,1223005,2022-08-03,Assembly,"Do pass",11,4,0,1,16
1593793,1224072,2022-08-15,Assembly,"SB 1206 Skinner Senate Third Reading By Irwin",58,8,0,14,80
1593793,1224169,2022-08-18,Senate,"Unfinished Business SB1206 Skinner et al. Concurrence",29,9,0,2,40
1593794,1195773,2022-04-27,Senate,"Do pass, but first be re-referred to the Committee on [Appropriations]",10,0,0,1,11
1593794,1201486,2022-05-09,Senate,"Placed on suspense file",7,0,0,0,7
1593794,1207015,2022-05-19,Senate,"Do pass",5,1,0,1,7
1593794,1208462,2022-05-24,Senate,"Senate 3rd Reading SB1207 Portantino",32,3,0,5,40
1593794,1217309,2022-06-21,Assembly,"Do pass and be re-referred to the Committee on [Appropriations]",14,0,0,1,15
1593794,1222992,2022-08-03,Assembly,"Do pass",12,0,0,4,16
1593794,1225122,2022-08-29,Assembly,"SB 1207 Portantino Senate Third Reading By Akilah Weber",72,0,0,8,80
1593794,1225334,2022-08-30,Senate,"Unfinished Business SB1207 Portantino Concurrence",36,0,0,4,40
1593795,1193342,2022-04-26,Senate,"Do pass as amended, but first amend, and re-refer to the Committee on [Appropriations]",10,0,0,4,14
1593795,1204558,2022-05-16,Senate,"Placed on suspense file",6,0,0,1,7
1593795,1206340,2022-05-19,Senate,"Do pass",7,0,0,0,7
1593795,1208472,2022-05-24,Senate,"Senate 3rd Reading SB1208 Hueso",36,0,0,4,40
1593795,1218033,2022-06-22,Assembly,"Do pass and be re-referred to the Committee on [Communications and Conveyance]",14,0,0,1,15
1593795,1220681,2022-06-29,Assembly,"Do pass as amended and be re-referred to the Committee on [Appropriations]",11,0,0,2,13
1593795,1223854,2022-08-11,Assembly,"Do pass as amended",12,0,0,4,16
1593795,1225937,2022-08-30,Assembly,"SB 1208 Hueso Senate Third Reading By Alvarez",75,0,0,5,80
1593795,1225938,2022-08-31,Senate,"Unfinished Business SB1208 Hueso et al. Concurrence",40,0,0,0,40
1593796,1189849,2022-04-19,Senate,"Do pass as amended, but first amend, and re-refer to the Committee on [Appropriations]",5,0,0,0,5
1593796,1198331,2022-05-02,Senate,"Placed on suspense file",7,0,0,0,7
1593796,1206459,2022-05-19,Senate,"Do pass as amended",7,0,0,0,7
1593796,1209309,2022-05-25,Senate,"Senate 3rd Reading SB1209 Eggman et al",36,1,0,3,40
1593796,1215773,2022-06-14,Assembly,"Do pass and be re-referred to the Committee on [Appropriations]",5,0,0,3,8
1593796,1223999,2022-08-11,Assembly,"Do pass",12,0,0,4,16
1593796,1224951,2022-08-25,Assembly,"SB 1209 Eggman Senate Third Reading By Ting",61,0,0,19,80
1593797,1194320,2022-04-26,Senate,"Do pass and be ordered to the Consent Calendar",11,0,0,0,11
1593797,1201448,2022-05-09,Senate,"Consent Calendar SB1210",33,0,0,7,40
1593797,1211862,2022-06-01,Assembly,"Do pass. To Consent Calendar",10,0,0,1,11
1593797,1215272,2022-06-09,Assembly,"SB 1210 Cortese Consent Calendar Second Day Regular Session",69,0,0,9,78
1593800,1189991,2022-04-18,Senate,"Do pass, but first be re-referred to the Committee on [Appropriations] with the recommendation: To Consent Calendar",12,0,0,2,14
1593800,1201425,2022-05-09,Senate,"Consent Calendar SB1213",33,0,0,7,40
1593800,1217953,2022-06-22,Assembly,"Do pass and be re-referred to the Committee on [Appropriations] with recommendation: To Consent Calendar",15,0,0,0,15
1593800,1223325,2022-08-10,Assembly,"Do pass. To Consent Calendar",15,0,0,1,16
1593800,1225102,2022-08-29,Assembly,"SB 1213 Hueso Senate Third Reading By Santiago",77,0,0,3,80
1593801,1181254,2022-03-31,Senate,"Do pass, but first be re-referred to the Committee on [Judiciary]",5,0,0,0,5
1593801,1194217,2022-04-26,Senate,"Do pass as amended, but first amend, and re-refer to the Committee on [Appropriations] with the recommendation: To Consent Calendar",11,0,0,0,11
1593801,1207723,2022-05-23,Senate,"Consent Calendar SB1214",36,0,0,4,40
1593801,1216644,2022-06-15,Assembly,"Do pass and be re-referred to the Committee on [Judiciary]",8,0,0,0,8
1593801,1217367,2022-06-21,Assembly,"Do pass and be re-referred to the Committee on [Appropriations] with recommendation: To Consent Calendar",10,0,0,0,10
1593801,1222941,2022-08-03,Assembly,"Do pass. To Consent Calendar",15,0,0,1,16
1593801,1223522,2022-08-11,Assembly,"SB 1214 Jones Consent Calendar Second Day Regular Session",76,0,0,4,80
1593802,1190660,2022-04-20,Senate,"Do pass as amended, but first amend, and re-refer to the Committee on [Appropriations]",5,2,0,0,7
1593802,1201544,2022-05-09,Senate,"Placed on suspense file",7,0,0,0,7
1593802,1206282,2022-05-19,Senate,"Do pass",5,2,0,0,7
1593802,1208475,2022-05-24,Senate,"Senate 3rd Reading SB1215 Newman et al",28,8,0,4,40
1593802,1216968,2022-06-14,Assembly,"Do pass and be re-referred to the Committee on [Natural Resources]",8,1,0,0,9
1593802,1219528,2022-06-27,Assembly,"Do pass as amended and be re-referred to the Committee on [Appropriations]",9,1,0,1,11
1593802,1224019,2022-08-11,Assembly,"Do pass as amended",12,4,0,0,16
1593802,1224349,2022-08-22,Assembly,"SB 1215 Newman Senate Third Reading By Irwin",61,1,0,18,80
1593802,1224778,2022-08-24,Senate,"That the Assembly amendments be concurred in",5,0,0,2,7
1593802,1225630,2022-08-30,Senate,"Unfinished Business SB1215 Newman et al. Concurrence",31,9,0,0,40
1593803,1179237,2022-03-29,Senate,"Do pass, but first be re-referred to the Committee on [Judiciary] with the recommendation: To Consent Calendar",14,0,0,1,15
1593803,1190524,2022-04-19,Senate,"Do pass, but first be re-referred to the Committee on [Appropriations] with the recommendation: To Consent Calendar",11,0,0,0,11
1593803,1198300,2022-05-02,Senate,"Placed on suspense file",7,0,0,0,7
1593803,1206925,2022-05-19,Senate,"Do pass",7,0,0,0,7
1593803,1209274,2022-05-25,Senate,"Special Consent SB1216",39,0,0,1,40
1593803,1215732,2022-06-14,Assembly,"Do pass as amended and be re-referred to the Committee on [Accountability and Administrative Review]",9,0,0,2,11
1593803,1220789,2022-06-29,Assembly,"Do pass and be re-referred to the Committee on [Appropriations]",7,0,0,0,7
1593803,1223413,2022-08-11,Assembly,"Do pass as amended",12,0,0,4,16
1593803,1224173,2022-08-18,Assembly,"SB 1216 Gonzalez Senate Third Reading By Berman",76,0,0,4,80
1593803,1224279,2022-08-22,Senate,"Unfinished Business SB1216 Gonzalez et al. Concurrence",40,0,0,0,40
1593804,1179428,2022-03-28,Senate,"Do pass, but first be re-referred to the Committee on [Transportation]",5,1,0,1,7
1593804,1194455,2022-04-26,Senate,"Do pass, but first be re-referred to the Committee on [Appropriations]",13,3,0,1,17
1593804,1204654,2022-05-16,Senate,"Placed on suspense file",6,0,0,1,7
1593804,1206429,2022-05-19,Senate,"Do pass",5,2,0,0,7
1593804,1208516,2022-05-24,Senate,"Senate 3rd Reading SB1217 Allen et al",28,9,0,3,40
1593806,1183638,2022-04-05,Senate,"Do pass as amended, but first amend, and re-refer to the Committee on [Environmental Quality]",6,0,0,3,9
1593806,1194375,2022-04-27,Senate,"Do pass, but first be re-referred to the Committee on [Appropriations]",5,0,0,2,7
1593806,1201495,2022-05-09,Senate,"Placed on suspense file",7,0,0,0,7
1593806,1206910,2022-05-19,Senate,"Do pass",6,0,0,1,7
1593806,1209236,2022-05-25,Senate,"Senate 3rd Reading SB1219 Hurtado et al",21,6,0,13,40
1593809,1180269,2022-03-30,Senate,"Do pass, but first be re-referred to the Committee on [Appropriations]",3,3,0,1,7
1593809,1180270,2022-03-30,Senate,"[Second] hearing set for [03-30-2022]: Failed passage in Committee. Reconsideration granted",4,0,0,3,7
1593809,1181261,2022-03-30,Senate,"[First] hearing set for [03-31-2022]: Failed passage in Committee. Reconsideration granted",4,0,0,3,7
1593810,1179205,2022-03-29,Senate,"Do pass as amended, but first amend, and re-refer to the Committee on [Appropriations]",4,0,0,1,5
1593810,1209231,2022-05-25,Senate,"Senate 3rd Reading SB1223 Becker",30,8,0,2,40
1593810,1220083,2022-06-28,Assembly,"Do pass as amended and be re-referred to the Committee on [Appropriations]",5,2,0,0,7
1593810,1223957,2022-08-11,Assembly,"Do pass",12,4,0,0,16
1593810,1225658,2022-08-31,Senate,"Unfinished Business SB1223 Becker et al. Concurrence",30,8,0,2,40
1593810,1225659,2022-08-31,Assembly,"SB 1223 Becker Senate Third Reading By Bauer-Kahan",48,17,0,15,80
1593811,1193150,2022-04-26,Senate,"Do pass, but first be re-referred to the Committee on [Appropriations] with the recommendation: To Consent Calendar",8,0,0,1,9
1593811,1201494,2022-05-09,Senate,"Placed on suspense file",7,0,0,0,7
1593811,1206764,2022-05-19,Senate,"Do pass as amended",7,0,0,0,7
1593811,1209950,2022-05-26,Senate,"Special Consent SB1224",38,0,0,2,40
1593811,1219940,2022-06-28,Assembly,"Do pass and be re-referred to the Committee on [Appropriations] with recommendation: To Consent Calendar",14,0,0,1,15
1593811,1223384,2022-08-11,Assembly,"Do pass",16,0,0,0,16
1593811,1224877,2022-08-25,Assembly,"SB 1224 Bates Senate Third Reading By Nguyen",74,0,0,6,80
1593813,1185711,2022-04-07,Senate,"Do pass as amended, but first amend, and re-refer to the Committee on [Transportation]",4,0,0,1,5
1593813,1194263,2022-04-26,Senate,"Do pass, but first be re-referred to the Committee on [Appropriations]",13,3,0,1,17
1593813,1207722,2022-05-23,Senate,"Senate 3rd Reading SB1226 Durazo",28,9,0,3,40
1593813,1216627,2022-06-15,Assembly,"Do pass and be re-referred to the Committee on [Transportation]",6,2,0,0,8
1593813,1219885,2022-06-27,Assembly,"Do pass and be re-referred to the Committee on [Appropriations]",11,3,0,1,15
1593813,1222996,2022-08-03,Assembly,"Do pass",11,4,0,1,16
1593813,1224082,2022-08-15,Assembly,"SB 1226 Durazo Senate Third Reading By Lee",62,14,0,4,80
1593813,1224594,2022-08-23,Senate,"Unfinished Business SB1226 Durazo et al. Concurrence",31,9,0,0,40
1593814,1184703,2022-04-06,Senate,"Do pass, but first be re-referred to the Committee on [Judiciary]",10,0,0,1,11
1593814,1194124,2022-04-26,Senate,"Do pass, but first be re-referred to the Committee on [Appropriations]",11,0,0,0,11
1593814,1201345,2022-05-09,Senate,"Placed on suspense file",7,0,0,0,7
1593814,1206836,2022-05-19,Senate,"Do pass",7,0,0,0,7
1593814,1209395,2022-05-25,Senate,"Senate 3rd Reading SB1227 Eggman",39,0,0,1,40
1593814,1217408,2022-06-21,Assembly,"Do pass and be re-referred to the Committee on [Judiciary]",15,0,0,0,15
1593814,1220079,2022-06-28,Assembly,"Do pass",11,0,0,0,11
1593814,1225101,2022-08-29,Assembly,"SB 1227 Eggman Senate Third Reading By Haney",78,0,0,2,80
1593814,1225292,2022-08-30,Senate,"Unfinished Business SB1227 Eggman et al. Concurrence",39,0,0,1,40
1593815,1194205,2022-04-26,Senate,"Do pass, but first be re-referred to the Committee on [Appropriations]",5,0,0,0,5
1593815,1201374,2022-05-09,Senate,"Placed on suspense file",7,0,0,0,7
1593815,1206865,2022-05-19,Senate,"Do pass",6,0,0,1,7
1593815,1207797,2022-05-23,Senate,"Senate 3rd Reading SB1228 Wiener et al",36,0,0,4,40
1593815,1215060,2022-06-08,Assembly,"Do pass and be re-referred to the Committee on [Appropriations]",7,0,0,0,7
1593815,1223704,2022-08-11,Assembly,"Do pass as amended",12,0,0,4,16
1593815,1224643,2022-08-24,Assembly,"SB 1228 Wiener Senate Third Reading By Ting",69,1,0,10,80
1593815,1225402,2022-08-30,Senate,"Unfinished Business SB1228 Wiener et al. Concurrence",40,0,0,0,40
1593816,1194387,2022-04-27,Senate,"Do pass as amended, but first amend, and re-refer to the Committee on [Appropriations]",7,0,0,0,7
1593816,1204591,2022-05-16,Senate,"Placed on suspense file",6,0,0,1,7
1593816,1206673,2022-05-19,Senate,"Do pass",7,0,0,0,7
1593816,1209244,2022-05-25,Senate,"Special Consent SB1229",39,0,0,1,40
1593817,1190507,2022-04-20,Senate,"Do pass, but first be re-referred to the Committee on [Transportation]",5,0,0,2,7
1593817,1194138,2022-04-26,Senate,"Do pass as amended, but first amend, and re-refer to the Committee on [Appropriations]",14,0,0,3,17
1593817,1204663,2022-05-16,Senate,"Placed on suspense file",6,0,0,1,7
1593817,1206963,2022-05-19,Senate,"Do pass as amended",5,1,0,1,7
1593817,1209355,2022-05-25,Senate,"Senate 3rd Reading SB1230 Lim贸n et al",33,6,0,1,40
1593817,1217354,2022-06-20,Assembly,"Do pass and be re-referred to the Committee on [Natural Resources]",11,0,0,4,15
1593817,1219416,2022-06-27,Assembly,"Do pass and be re-referred to the Committee on [Appropriations]",11,0,0,0,11
1593817,1223808,2022-08-11,Assembly,"Do pass as amended",13,0,0,3,16
1593817,1225297,2022-08-30,Senate,"Unfinished Business SB1230 Lim贸n et al. Concurrence",31,4,0,5,40
1593817,1225298,2022-08-30,Assembly,"SB 1230 Lim贸n Senate Third Reading By Berman",72,0,0,8,80
1593818,1195730,2022-04-27,Senate,"Do pass, but first be re-referred to the Committee on [Appropriations] with the recommendation: To Consent Calendar",10,0,0,1,11
1593818,1201516,2022-05-09,Senate,"Placed on suspense file",7,0,0,0,7
1593818,1206891,2022-05-19,Senate,"Do pass",6,0,0,1,7
1593818,1209283,2022-05-25,Senate,"Senate 3rd Reading SB1231 Caballero",38,0,0,2,40
1593818,1217386,2022-06-21,Assembly,"Do pass and be re-referred to the Committee on [Appropriations] with recommendation: To Consent Calendar",15,0,0,0,15
1593819,1179234,2022-03-28,Senate,"Do pass as amended, but first amend, and re-refer to the Committee on [Appropriations]",7,0,0,0,7
1593819,1192197,2022-04-25,Senate,"Placed on suspense file",5,0,0,2,7
1593820,1189860,2022-04-19,Senate,"Do pass as amended, but first amend, and re-refer to the Committee on [Appropriations]",13,1,0,3,17
1593820,1201444,2022-05-09,Senate,"Placed on suspense file",7,0,0,0,7
1593820,1206773,2022-05-19,Senate,"Do pass",5,1,0,1,7
1593820,1208460,2022-05-24,Senate,"Senate 3rd Reading SB1233 Gonzalez",30,4,0,6,40
1593820,1217356,2022-06-20,Assembly,"Do pass and be re-referred to the Committee on [Appropriations]",14,0,0,1,15
1593820,1223442,2022-08-11,Assembly,"Do pass",16,0,0,0,16
1593820,1224735,2022-08-24,Assembly,"SB 1233 Gonzalez Senate Third Reading By Lee",75,1,0,4,80
1593821,1175540,2022-03-23,Senate,"Do pass, but first be re-referred to the Committee on [Appropriations]",9,0,0,2,11
1593821,1189357,2022-04-18,Senate,"Placed on suspense file",7,0,0,0,7
1593821,1206345,2022-05-19,Senate,"Do pass as amended",5,2,0,0,7
1593821,1210031,2022-05-26,Senate,"Senate 3rd Reading SB1234 Pan",29,4,0,7,40
1593821,1219978,2022-06-28,Assembly,"Do pass as amended and be re-referred to the Committee on [Appropriations]",12,1,0,2,15
1593821,1223397,2022-08-11,Assembly,"Do pass",12,3,0,1,16
1593821,1225652,2022-08-31,Senate,"Unfinished Business SB1234 Pan et al. Concurrence",31,8,0,1,40
1593821,1225653,2022-08-31,Assembly,"SB 1234 Pan Senate Third Reading By Low",62,10,0,8,80
1593823,1190653,2022-04-20,Senate,"Do pass",6,1,0,0,7
1593823,1201480,2022-05-09,Senate,"Senate 3rd Reading SB1236 Glazer et al",28,5,0,7,40
1593824,1183647,2022-04-04,Senate,"Do pass, but first be re-referred to the Committee on [Military and Veterans Affairs] with the recommendation: To Consent Calendar",10,0,0,4,14
1593824,1193226,2022-04-26,Senate,"Do pass, but first be re-referred to the Committee on [Appropriations] with the recommendation: To Consent Calendar",5,0,0,2,7
1593824,1204061,2022-05-12,Senate,"Consent Calendar SB1237",35,0,0,5,40
1593824,1215891,2022-06-14,Assembly,"Do pass and be re-referred to the Committee on [Military and Veterans Affairs] with recommendation: To Consent Calendar",16,0,0,2,18
1593824,1220112,2022-06-28,Assembly,"Do pass and be re-referred to the Committee on [Appropriations]",10,0,0,1,11
1593824,1222956,2022-08-03,Assembly,"Do pass. To Consent Calendar",15,0,0,1,16
1593824,1223409,2022-08-11,Assembly,"SB 1237 Newman Consent Calendar Second Day Regular Session",76,0,0,4,80
1593825,1195728,2022-04-27,Senate,"Do pass as amended, but first amend, and re-refer to the Committee on [Appropriations] with the recommendation: To Consent Calendar",10,0,0,1,11
1593825,1204598,2022-05-16,Senate,"Placed on suspense file",6,0,0,1,7
1593825,1206305,2022-05-19,Senate,"Do pass",7,0,0,0,7
1593825,1209340,2022-05-25,Senate,"Special Consent SB1238",39,0,0,1,40
1593825,1217314,2022-06-21,Assembly,"Do pass and be re-referred to the Committee on [Appropriations]",15,0,0,0,15
1593825,1223831,2022-08-11,Assembly,"Do pass",16,0,0,0,16
1593825,1224201,2022-08-18,Assembly,"SB 1238 Eggman Senate Third Reading By Ramos",76,0,0,4,80
1593829,1181268,2022-03-31,Senate,"Do pass, but first be re-referred to the Committee on [Appropriations] with the recommendation: To Consent Calendar",9,0,0,3,12
1593829,1191332,2022-04-21,Senate,"Consent Calendar SB1242 INS",39,0,0,1,40
1593829,1217869,2022-06-22,Assembly,"Do pass and be re-referred to the Committee on [Appropriations] with recommendation: To Consent Calendar",11,1,0,2,14
1593829,1219203,2022-06-22,Assembly,"Do pass and be re-referred to the Committee on [Appropriations]",11,1,0,2,14
1593829,1223315,2022-08-10,Assembly,"Do pass. To Consent Calendar",15,0,0,1,16
1593829,1224238,2022-08-18,Assembly,"SB 1242 INS. Consent Calendar Second Day Regular Session",73,0,0,7,80
1593829,1225592,2022-08-30,Senate,"Special Consent SB1242 INS",38,0,0,2,40
1593831,1193392,2022-04-26,Senate,"Do pass, but first be re-referred to the Committee on [Appropriations] with the recommendation: To Consent Calendar",8,0,0,1,9
1593831,1204608,2022-05-16,Senate,"Placed on suspense file",6,0,0,1,7
1593832,1184724,2022-04-06,Senate,"Do pass, but first be re-referred to the Committee on [Judiciary]",8,2,0,1,11
1593832,1194139,2022-04-26,Senate,"Do pass, but first be re-referred to the Committee on [Appropriations]",9,2,0,0,11
1593832,1201456,2022-05-09,Senate,"Placed on suspense file",7,0,0,0,7
1593832,1206463,2022-05-19,Senate,"Do pass as amended",5,2,0,0,7
1593832,1209281,2022-05-25,Senate,"Senate 3rd Reading SB1245 Kamlager et al",30,9,0,1,40
1593832,1217385,2022-06-21,Assembly,"Do pass and be re-referred to the Committee on [Judiciary]",11,3,0,1,15
1593832,1219944,2022-06-28,Assembly,"Do pass as amended and be re-referred to the Committee on [Appropriations]",8,3,0,0,11
1593832,1223761,2022-08-11,Assembly,"Do pass",12,4,0,0,16
1593832,1225103,2022-08-29,Assembly,"SB 1245 Kamlager Senate Third Reading By Carrillo",54,18,0,8,80
1593832,1225531,2022-08-30,Senate,"Unfinished Business SB1245 Kamlager et al. Concurrence",31,9,0,0,40
1593833,1200531,2022-05-04,Senate,"Do pass as amended, but first amend, and re-refer to the Committee on [Appropriations]",4,0,0,1,5
1593833,1204614,2022-05-16,Senate,"Placed on suspense file",6,0,0,1,7
1593833,1206460,2022-05-19,Senate,"Do pass",7,0,0,0,7
1593833,1209370,2022-05-25,Senate,"Special Consent SB1246 Stern Urgency Clause",39,0,0,1,40
1593833,1221364,2022-06-30,Assembly,"Do pass and be re-referred to the Committee on [Appropriations]",11,0,0,0,11
1593833,1223851,2022-08-11,Assembly,"Do pass as amended",12,0,0,4,16
1593833,1224383,2022-08-22,Assembly,"SB 1246 Stern Third Reading Urgency By Irwin",77,0,0,3,80
1593833,1225943,2022-08-30,Senate,"Special Consent SB1246 Stern et al. Urgency Clause",38,0,0,2,40
1593834,1189303,2022-04-18,Senate,"Do pass as amended, but first amend, and re-refer to the Committee on [Appropriations]",10,0,0,4,14
1593834,1208523,2022-05-24,Senate,"Senate 3rd Reading SB1247 Hueso",29,0,0,11,40
1593834,1217336,2022-06-21,Assembly,"Do pass and be re-referred to the Committee on [Judiciary]",18,0,0,1,19
1593834,1220020,2022-06-28,Assembly,"Do pass as amended, and be re-referred to the Committee on [Appropriations] with recommendation: To Consent Calendar",11,0,0,0,11
1593834,1223364,2022-08-11,Assembly,"Do pass",15,0,0,1,16
1593834,1224706,2022-08-24,Assembly,"SB 1247 Hueso Senate Third Reading By Holden",67,0,0,13,80
1593834,1225891,2022-08-30,Senate,"Unfinished Business SB1247 Hueso Concurrence",37,0,0,3,40
1593835,1189865,2022-04-18,Senate,"Do pass, but first be re-referred to the Committee on [Judiciary]",2,1,0,2,5
1593836,1194279,2022-04-26,Senate,"Do pass as amended, but first amend, and re-refer to the Committee on [Appropriations]",15,0,0,2,17
1593836,1209305,2022-05-25,Senate,"Senate 3rd Reading SB1249 Archuleta",29,0,0,11,40
1593837,1199977,2022-05-03,Senate,"Do pass, but first be re-referred to the Committee on [Transportation]",10,0,0,1,11
1593837,1208488,2022-05-24,Senate,"Senate 3rd Reading SB1250 Lim贸n",37,0,0,3,40
1593837,1217472,2022-06-21,Assembly,"Do pass",11,0,0,0,11
1593838,1183811,2022-04-05,Senate,"Do pass, but first be re-referred to the Committee on [Transportation]",9,4,0,2,15
1593838,1189857,2022-04-19,Senate,"Do pass, but first be re-referred to the Committee on [Appropriations]",13,3,0,1,17
1593838,1198241,2022-05-02,Senate,"Placed on suspense file",7,0,0,0,7
1593838,1206664,2022-05-19,Senate,"Do pass as amended",5,2,0,0,7
1593838,1209307,2022-05-25,Senate,"Senate 3rd Reading SB1251 Gonzalez et al",30,9,0,1,40
1593838,1216348,2022-06-15,Assembly,"Do pass and be re-referred to the Committee on [Transportation]",5,0,0,2,7
1593838,1219906,2022-06-27,Assembly,"Do pass and be re-referred to the Committee on [Appropriations]",10,0,0,5,15
1593838,1223874,2022-08-11,Assembly,"Do pass as amended",12,0,0,4,16
1593838,1225388,2022-08-30,Senate,"Unfinished Business SB1251 Gonzalez et al. Concurrence",28,9,0,3,40
1593838,1225389,2022-08-30,Assembly,"SB 1251 Gonzalez Senate Third Reading By Kalra",60,9,0,11,80
1593839,1194299,2022-04-27,Senate,"Do pass, but first be re-referred to the Committee on [Appropriations]",9,0,0,0,9
1593839,1207805,2022-05-23,Senate,"Senate 3rd Reading SB1252 HOUSING (Wiener)",37,0,0,3,40
1593839,1220766,2022-06-29,Assembly,"Do pass and be re-referred to the Committee on [Appropriations] with recommendation: To Consent Calendar",8,0,0,0,8
1593839,1222978,2022-08-03,Assembly,"Do pass. To Consent Calendar",15,0,0,1,16
1593839,1223866,2022-08-11,Assembly,"SB 1252 HOUSING Consent Calendar Second Day Regular Session",76,0,0,4,80
1593839,1225296,2022-08-30,Senate,"Special Consent SB1252 HOUSING",38,0,0,2,40
1593840,1179131,2022-03-29,Senate,"Do pass, but first be re-referred to the Committee on [Natural Resources and Water] with the recommendation: To Consent Calendar",14,0,0,1,15
1593840,1193271,2022-04-26,Senate,"Do pass, but first be re-referred to the Committee on [Appropriations] with the recommendation: To Consent Calendar",8,0,0,1,9
1593840,1201458,2022-05-09,Senate,"Placed on suspense file",7,0,0,0,7
1593840,1206736,2022-05-19,Senate,"Do pass",7,0,0,0,7
1593840,1209246,2022-05-25,Senate,"Special Consent SB1253",39,0,0,1,40
1593840,1219909,2022-06-28,Assembly,"Do pass and be re-referred to the Committee on [Appropriations] with recommendation: To Consent Calendar",14,0,0,1,15
1593840,1222979,2022-08-03,Assembly,"Do pass. To Consent Calendar",15,0,0,1,16
1593840,1223807,2022-08-11,Assembly,"SB 1253 Melendez Consent Calendar Second Day Regular Session",76,0,0,4,80
1593841,1179571,2022-03-28,Senate,"Do pass, but first be re-referred to the Committee on [Judiciary]",7,0,0,0,7
1593841,1194446,2022-04-26,Senate,"Do pass as amended, but first amend, and re-refer to the Committee on [Appropriations] with the recommendation: To Consent Calendar",11,0,0,0,11
1593841,1207795,2022-05-23,Senate,"Consent Calendar SB1254",36,0,0,4,40
1593841,1216967,2022-06-14,Assembly,"Do pass and be re-referred to the Committee on [Judiciary]",9,0,0,0,9
1593841,1217326,2022-06-21,Assembly,"Do pass and be re-referred to the Committee on [Appropriations] with recommendation: To Consent Calendar",10,0,0,0,10
1593841,1222966,2022-08-03,Assembly,"Do pass. To Consent Calendar",15,0,0,1,16
1593841,1223590,2022-08-11,Assembly,"SB 1254 Hertzberg Consent Calendar Second Day Regular Session",76,0,0,4,80
1593841,1224511,2022-08-23,Senate,"Unfinished Business SB1254 Hertzberg Concurrence",40,0,0,0,40
1593842,1179500,2022-03-28,Senate,"Do pass, but first be re-referred to the Committee on [Education]",6,0,0,1,7
1593842,1194343,2022-04-27,Senate,"Do pass, but first be re-referred to the Committee on [Appropriations]",6,0,0,1,7
1593842,1204590,2022-05-16,Senate,"Placed on suspense file",6,0,0,1,7
1593842,1206356,2022-05-19,Senate,"Do pass",7,0,0,0,7
1593842,1209337,2022-05-25,Senate,"Special Consent SB1255",39,0,0,1,40
1593842,1220656,2022-06-29,Assembly,"Do pass and be re-referred to the Committee on [Appropriations] with recommendation: To Consent Calendar",7,0,0,0,7
1593842,1223819,2022-08-11,Assembly,"Do pass",16,0,0,0,16
1593842,1224288,2022-08-22,Assembly,"SB 1255 Portantino Senate Third Reading By Bauer-Kahan",77,0,0,3,80
1593842,1225893,2022-08-30,Senate,"Special Consent SB1255",38,0,0,2,40
1593843,1179479,2022-03-28,Senate,"Do pass, but first be re-referred to the Committee on [Judiciary]",5,2,0,0,7
1593843,1190564,2022-04-19,Senate,"Do pass",9,2,0,0,11
1593843,1207696,2022-05-23,Senate,"Senate 3rd Reading SB1256 Wieckowski",28,9,0,3,40
1593843,1215553,2022-06-13,Assembly,"Do pass as amended and be re-referred to the Committee on [Judiciary]",7,1,0,3,11
1593843,1219892,2022-06-28,Assembly,"Do pass as amended",9,2,0,0,11
1593843,1224074,2022-08-15,Assembly,"SB 1256 Wieckowski Senate Third Reading By Cristina Garcia",54,14,0,12,80
1593843,1224106,2022-08-16,Senate,"Unfinished Business SB1256 Wieckowski Concurrence",28,9,0,3,40
1593845,1189876,2022-04-18,Senate,"Do pass, but first be re-referred to the Committee on [Transportation]",11,0,0,3,14
1593845,1194440,2022-04-26,Senate,"Do pass as amended, but first amend, and re-refer to the Committee on [Appropriations]",16,0,0,1,17
1593845,1204629,2022-05-16,Senate,"Placed on suspense file",6,0,0,1,7
1593845,1206636,2022-05-19,Senate,"Do pass as amended",7,0,0,0,7
1593845,1209949,2022-05-26,Senate,"Special Consent SB1258",38,0,0,2,40
1593845,1220058,2022-06-27,Assembly,"Do pass as amended and be re-referred to the Committee on [Appropriations]",14,0,0,1,15
1593846,1190572,2022-04-19,Senate,"Do pass, but first be re-referred to the Committee on [Appropriations] with the recommendation: To Consent Calendar",11,0,0,0,11
1593846,1201385,2022-05-09,Senate,"Consent Calendar SB1259",33,0,0,7,40
1593846,1219961,2022-06-28,Assembly,"Do pass and be re-referred to the Committee on [Appropriations] with recommendation: To Consent Calendar",17,0,0,1,18
1593846,1222988,2022-08-03,Assembly,"Do pass. To Consent Calendar",15,0,0,1,16
1593846,1223439,2022-08-11,Assembly,"SB 1259 Laird Consent Calendar Second Day Regular Session",76,0,0,4,80
1593846,1224105,2022-08-16,Senate,"That the Assembly amendments be concurred in",11,0,0,3,14
1593846,1224130,2022-08-17,Senate,"Unfinished Business SB1259 Laird Concurrence",38,0,0,2,40
1593847,1183814,2022-04-04,Senate,"Do pass, but first be re-referred to the Committee on [Judiciary]",3,1,0,1,5
1593847,1199949,2022-05-03,Senate,"Do pass",8,2,0,1,11
1593847,1207823,2022-05-23,Senate,"Senate 3rd Reading SB1260 Durazo",27,9,0,4,40
1593847,1216369,2022-06-15,Assembly,"Do pass and be re-referred to the Committee on [Judiciary]",5,2,0,0,7
1593847,1217399,2022-06-21,Assembly,"Do pass",7,3,0,0,10
1593847,1224228,2022-08-18,Assembly,"SB 1260 Durazo Senate Third Reading By Ting Amendment Set #1",52,18,0,10,80
1593847,1225039,2022-08-29,Assembly,"SB 1260 Durazo Senate Third Reading By Ting",55,19,0,6,80
1593847,1225525,2022-08-30,Senate,"Unfinished Business SB1260 Durazo Concurrence",30,9,0,1,40
1593848,1179623,2022-03-28,Senate,"Do pass as amended, but first amend, and re-refer to the Committee on [Natural Resources and Water]",10,0,0,4,14
1593848,1193314,2022-04-26,Senate,"Do pass as amended, but first amend, and re-refer to the Committee on [Appropriations]",7,1,0,1,9
1593848,1201439,2022-05-09,Senate,"Placed on suspense file",7,0,0,0,7
1593848,1206234,2022-05-19,Senate,"Do pass as amended",5,1,0,1,7
1593848,1209947,2022-05-26,Senate,"Senate 3rd Reading SB1261 Stern et al",32,1,0,7,40
1593849,1194223,2022-04-26,Senate,"Do pass, but first be re-referred to the Committee on [Appropriations]",5,0,0,0,5
1593849,1208509,2022-05-24,Senate,"Senate 3rd Reading SB1262 Bradford",37,0,0,3,40
1593849,1220050,2022-06-28,Assembly,"Do pass and be re-referred to the Committee on [Appropriations]",5,0,0,2,7
1593849,1222952,2022-08-03,Assembly,"Do pass",15,0,0,1,16
1593849,1225594,2022-08-31,Assembly,"SB 1262 Bradford Senate Third Reading By Cervantes",53,9,0,18,80
1593852,1194370,2022-04-26,Senate,"Do pass as amended, but first amend, and re-refer to the Committee on [Appropriations]",10,0,0,1,11
1593852,1204624,2022-05-16,Senate,"Placed on suspense file",6,0,0,1,7
1593852,1206901,2022-05-19,Senate,"Do pass as amended",7,0,0,0,7
1593852,1210005,2022-05-26,Senate,"Senate 3rd Reading SB1265 Rubio",37,0,0,3,40
1593853,1179155,2022-03-29,Senate,"Be adopted, but first be re-referred to the Committee on [Appropriations] with recommendation: To Consent Calendar",14,0,0,1,15
1593853,1191261,2022-04-21,Senate,"Consent Calendar SCR70",39,0,0,1,40
1593853,1220587,2022-06-29,Assembly,"Be adopted and re-referred to the Committee on [Appropriations]",7,0,0,0,7
1593853,1223342,2022-08-10,Assembly,"Be adopted as amended. To Consent Calendar",15,0,0,1,16
1593853,1224187,2022-08-18,Assembly,"SCR 70 Caballero Consent Calendar Second Day Regular Session",73,0,0,7,80
1593853,1225872,2022-08-30,Senate,"Special Consent SCR70",38,0,0,2,40
1593854,1173501,2022-03-21,Senate,"Senate 3rd Reading SCR71 Bates et al",37,0,0,3,40
1593854,1181279,2022-03-31,Assembly,"Be adopted. To Consent Calendar",10,0,0,1,11
1593854,1186266,2022-04-07,Assembly,"SCR 71 Bates Consent Calendar Second Day Regular Session",65,0,0,12,77
1593855,1162236,2022-03-03,Senate,"Senate 3rd Reading SCR72 Portantino et al",38,0,0,2,40
1593855,1176507,2022-03-24,Assembly,"Be adopted. To Consent Calendar",10,0,0,1,11
1593855,1181327,2022-03-31,Assembly,"SCR 72 Portantino Consent Calendar Second Day Regular Session",68,0,0,8,76
1594399,1180236,2022-03-30,Assembly,"Do pass and be re-referred to the Committee on [Business and Professions]",11,0,0,3,14
1594399,1193326,2022-04-26,Assembly,"Do pass. To Consent Calendar",17,0,0,1,18
1594399,1198235,2022-05-02,Assembly,"AB 2568 Cooley Consent Calendar Second Day Regular Session",70,0,0,7,77
1594399,1214377,2022-06-06,Senate,"Do pass, but first be re-referred to the Committee on [Insurance]",11,0,0,3,14
1594399,1217857,2022-06-22,Senate,"Do pass",8,0,0,4,12
1594399,1224884,2022-08-25,Senate,"Assembly 3rd Reading AB2568 Cooley By Dodd",40,0,0,0,40
1594400,1190635,2022-04-20,Assembly,"Do pass and be re-referred to the Committee on [Human Services]",7,1,0,0,8
1594400,1193298,2022-04-26,Assembly,"Do pass and be re-referred to the Committee on [Appropriations] with recommendation: To Consent Calendar",7,0,0,1,8
1594401,1190600,2022-04-20,Assembly,"Do pass and be re-referred to the Committee on [Appropriations]",12,0,0,2,14
1594402,1189918,2022-04-19,Assembly,"Do pass and be re-referred to the Committee on [Judiciary]",7,1,0,3,11
1594402,1193215,2022-04-26,Assembly,"Do pass as amended and be re-referred to the Committee on [Appropriations]",7,2,0,1,10
1594402,1206242,2022-05-19,Assembly,"Do pass",12,4,0,0,16
1594402,1207768,2022-05-23,Assembly,"AB 2571 Bauer-Kahan Assembly Third Reading",48,16,0,14,78
1594402,1216261,2022-06-14,Senate,"Do pass, but first be re-referred to the Committee on [Appropriations]",9,1,0,1,11
1594402,1216614,2022-06-16,Senate,"Do pass",5,0,0,2,7
1594402,1221328,2022-06-30,Assembly,"AB 2571 Bauer-Kahan Concurrence - Urgency Added",57,15,0,8,80
1594402,1221559,2022-06-29,Senate,"Assembly 3rd Reading AB2571 Bauer-Kahan et al. By Hertzberg Urgency Clause",27,7,0,6,40
1594404,1176521,2022-03-23,Assembly,"Do pass as amended and be re-referred to the Committee on [Appropriations]",5,2,0,0,7
1594404,1206629,2022-05-19,Assembly,"Do pass",12,4,0,0,16
1594404,1210353,2022-05-25,Assembly,"AB 2573 McCarty Assembly Third Reading",47,18,0,13,78
1594404,1218002,2022-06-22,Senate,"Do pass, but first be re-referred to the Committee on [Appropriations]",4,1,0,2,7
1594404,1222791,2022-08-01,Senate,"Placed on suspense file",7,0,0,0,7
1594405,1183686,2022-04-05,Assembly,"Do pass and be re-referred to the Committee on [Appropriations] with recommendation: To Consent Calendar",16,0,0,2,18
1594405,1194123,2022-04-27,Assembly,"Do pass. To Consent Calendar",15,0,0,1,16
1594405,1200684,2022-05-05,Assembly,"AB 2574 Salas Consent Calendar Second Day Regular Session",61,0,0,17,78
1594405,1217319,2022-06-20,Senate,"Do pass, but first be re-referred to the Committee on [Appropriations] with the recommendation: To Consent Calendar",13,0,0,1,14
1594405,1225253,2022-08-29,Senate,"Assembly 3rd Reading AB2574 Salas By Min",39,0,0,1,40
1594405,1225254,2022-08-30,Assembly,"AB 2574 Salas Concurrence in Senate Amendments",79,0,0,1,80
1594405,1229717,2022-08-30,Senate,"Assembly 3rd Reading AB2574 Salas By Min",39,0,0,1,40
1594407,1184665,2022-04-06,Assembly,"Do pass as amended and be re-referred to the Committee on [Appropriations]",6,1,0,0,7
1594408,1194220,2022-04-27,Assembly,"Do pass and be re-referred to the Committee on [Appropriations] with recommendation: To Consent Calendar",5,0,0,2,7
1594408,1206595,2022-05-19,Assembly,"Do pass",16,0,0,0,16
1594408,1207876,2022-05-23,Assembly,"AB 2577 Bigelow Assembly Third Reading",72,0,0,6,78
1594408,1215568,2022-06-13,Senate,"Do pass, but first be re-referred to the Committee on [Appropriations] with the recommendation: To Consent Calendar",4,0,0,1,5
1594408,1221264,2022-06-30,Senate,"Consent Calendar AB2577",37,0,0,3,40
1594408,1222624,2022-08-01,Assembly,"AB 2577 Bigelow Concurrence in Senate Amendments",76,0,0,4,80
1594409,1184726,2022-04-06,Assembly,"Do pass and be re-referred to the Committee on [Natural Resources] with recommendation: To Consent Calendar",12,0,0,3,15
1594409,1192210,2022-04-25,Assembly,"Do pass as amended and be re-referred to the Committee on [Appropriations]",6,1,0,4,11
1594409,1206341,2022-05-19,Assembly,"Do pass as amended",16,0,0,0,16
1594409,1210466,2022-05-25,Assembly,"AB 2578 Cunningham Assembly Third Reading",66,1,0,11,78
1594410,1193142,2022-04-26,Assembly,"Do pass and be re-referred to the Committee on [Appropriations] with recommendation: To Consent Calendar",7,0,0,1,8
1594410,1206718,2022-05-19,Assembly,"Do pass",16,0,0,0,16
1594410,1207735,2022-05-23,Assembly,"AB 2579 Bennett Assembly Third Reading",74,0,0,4,78
1594410,1215935,2022-06-13,Senate,"Do pass, but first be re-referred to the Committee on [Appropriations]",5,0,0,0,5
1594410,1222885,2022-08-01,Senate,"Placed on suspense file",7,0,0,0,7
1594412,1193443,2022-04-26,Assembly,"Do pass and be re-referred to the Committee on [Appropriations] with recommendation: To Consent Calendar",14,0,0,1,15
1594412,1206882,2022-05-19,Assembly,"Do pass",16,0,0,0,16
1594412,1207845,2022-05-23,Assembly,"AB 2581 Salas Assembly Third Reading",74,0,0,4,78
1594412,1214944,2022-06-08,Senate,"Do pass as amended, but first amend, and re-refer to the Committee on [Appropriations] with the recommendation: To Consent Calendar",9,0,0,2,11
1594412,1219387,2022-06-27,Senate,"Placed on suspense file",6,0,0,1,7
1594412,1223890,2022-08-11,Senate,"Do pass",7,0,0,0,7
1594412,1224582,2022-08-23,Senate,"Special Consent AB2581",40,0,0,0,40
1594412,1224770,2022-08-24,Assembly,"AB 2581 Salas Concurrence in Senate Amendments",75,0,0,5,80
1594413,1194454,2022-04-27,Assembly,"Do pass as amended",5,1,0,1,7
1594413,1204103,2022-05-12,Assembly,"AB 2582 Bennett Assembly Third Reading",49,15,0,14,78
1594413,1217391,2022-06-21,Senate,"Do pass",4,1,0,0,5
1594413,1224482,2022-08-23,Senate,"Assembly 3rd Reading AB2582 Bennett et al. By Newman",30,10,0,0,40
1594413,1224649,2022-08-24,Assembly,"AB 2582 Bennett Concurrence in Senate Amendments",54,19,0,7,80
1594414,1183708,2022-04-05,Assembly,"Do pass as amended, and be re-referred to the Committee on [Appropriations] with recommendation: To Consent Calendar",7,0,0,0,7
1594415,1194312,2022-04-27,Assembly,"Do pass as amended and be re-referred to the Committee on [Appropriations]",5,1,0,1,7
1594415,1206835,2022-05-19,Assembly,"Do pass as amended",12,4,0,0,16
1594415,1210421,2022-05-26,Assembly,"AB 2584 Berman Assembly Third Reading By BENNETT",54,19,0,5,78
1594415,1217387,2022-06-21,Senate,"Do pass, but first be re-referred to the Committee on [Judiciary]",4,1,0,0,5
1594415,1220685,2022-06-28,Senate,"Do pass, but first be re-referred to the Committee on [Appropriations]",9,1,0,1,11
1594415,1222709,2022-08-01,Senate,"Placed on suspense file",7,0,0,0,7
1594415,1224010,2022-08-11,Senate,"Do pass",4,2,0,1,7
1594415,1224710,2022-08-24,Senate,"Assembly 3rd Reading AB2584 Berman et al. By Newman",31,9,0,0,40
1594415,1224981,2022-08-25,Assembly,"AB 2584 Berman Concurrence in Senate Amendments",59,15,0,6,80
1594416,1193375,2022-04-26,Assembly,"Do pass and be re-referred to the Committee on [Appropriations] with recommendation: To Consent Calendar",14,0,0,1,15
1594416,1205862,2022-05-18,Assembly,"Do pass. To Consent Calendar",15,0,0,1,16
1594416,1210379,2022-05-25,Assembly,"AB 2585 McCarty Consent Calendar Second Day Regular Session",73,0,0,5,78
1594416,1218627,2022-06-22,Senate,"Do pass as amended, but first amend, and re-refer to the Committee on [Appropriations]",9,0,0,2,11
1594416,1223295,2022-08-08,Senate,"Special Consent AB2585",36,0,0,4,40
1594416,1224070,2022-08-15,Assembly,"AB 2585 McCarty Concurrence in Senate Amendments",75,0,0,5,80
1594417,1189920,2022-04-19,Assembly,"Do pass as amended and be re-referred to the Committee on [Appropriations]",11,3,0,1,15
1594417,1206465,2022-05-19,Assembly,"Do pass",12,4,0,0,16
1594417,1207775,2022-05-23,Assembly,"AB 2586 Cristina Garcia Assembly Third Reading",52,17,0,9,78
1594417,1218652,2022-06-22,Senate,"Do pass, but first be re-referred to the Committee on [Appropriations]",8,1,0,2,11
1594417,1222918,2022-08-01,Senate,"Placed on suspense file",7,0,0,0,7
1594417,1223940,2022-08-11,Senate,"Do pass",5,2,0,0,7
1594417,1225699,2022-08-29,Senate,"Assembly 3rd Reading AB2586 Cristina Garcia et a By Skinner",31,8,0,1,40
1594417,1225700,2022-08-30,Assembly,"AB 2586 Cristina Garcia Concurrence in Senate Amendments",57,18,0,5,80
1594418,1184674,2022-04-06,Assembly,"Do pass as amended and be re-referred to the Committee on [Natural Resources]",13,0,0,2,15
1594418,1192153,2022-04-25,Assembly,"Do pass and be re-referred to the Committee on [Appropriations]",9,1,0,1,11
1594418,1206405,2022-05-19,Assembly,"Do pass as amended",14,0,0,2,16
1594418,1210458,2022-05-25,Assembly,"AB 2587 Eduardo Garcia Assembly Third Reading",74,0,0,4,78
1594418,1217327,2022-06-21,Senate,"Do pass, but first be re-referred to the Committee on [Appropriations]",13,0,0,1,14
1594418,1222858,2022-08-01,Senate,"Placed on suspense file",7,0,0,0,7
1594419,1189894,2022-04-19,Assembly,"Do pass and be re-referred to the Committee on [Appropriations] with recommendation: To Consent Calendar",7,0,0,0,7
1594419,1199987,2022-05-04,Assembly,"Do pass. To Consent Calendar",14,0,0,2,16
1594419,1204086,2022-05-12,Assembly,"AB 2588 Maienschein Consent Calendar Second Day Regular Session",65,0,0,13,78
1594419,1215785,2022-06-14,Senate,"Do pass, but first be re-referred to the Committee on [Appropriations] with the recommendation: To Consent Calendar",5,0,0,0,5
1594419,1219445,2022-06-27,Senate,"Placed on suspense file",6,0,0,1,7
1594419,1223470,2022-08-11,Senate,"Do pass",7,0,0,0,7
1594419,1224523,2022-08-23,Senate,"Special Consent AB2588",40,0,0,0,40
1594420,1193202,2022-04-25,Assembly,"Do pass and be re-referred to the Committee on [Appropriations]",10,0,0,1,11
1594420,1206326,2022-05-19,Assembly,"Do pass as amended",13,0,0,3,16
1594420,1210204,2022-05-27,Assembly,"AB 2589 Santiago Assembly Third Reading",71,0,0,7,78
1594421,1193242,2022-04-26,Assembly,"Do pass and be re-referred to the Committee on [Appropriations]",7,0,0,1,8
1594423,1184720,2022-04-06,Assembly,"Do pass as amended and be re-referred to the Committee on [Housing and Community Development]",6,1,0,0,7
1594423,1194159,2022-04-27,Assembly,"Do pass and be re-referred to the Committee on [Appropriations] with recommendation: To Consent Calendar",8,0,0,0,8
1594423,1205844,2022-05-18,Assembly,"Do pass",15,0,0,1,16
1594423,1210374,2022-05-25,Assembly,"AB 2592 McCarty Assembly Third Reading",76,0,0,2,78
1594423,1219989,2022-06-28,Senate,"Do pass, but first be re-referred to the Committee on [Appropriations] with the recommendation: To Consent Calendar",13,0,0,2,15
1594423,1223231,2022-08-08,Senate,"Placed on suspense file",7,0,0,0,7
1594423,1223878,2022-08-11,Senate,"Do pass",7,0,0,0,7
1594423,1224522,2022-08-23,Senate,"Special Consent AB2592",40,0,0,0,40
1594424,1182527,2022-04-04,Assembly,"Do pass as amended and be re-referred to the Committee on [Appropriations]",7,3,0,0,10
1594424,1194242,2022-04-27,Assembly,"Do pass",11,4,0,1,16
1594424,1198267,2022-05-02,Assembly,"AB 2593 Boerner Horvath Assembly Third Reading",51,11,0,15,77
1594424,1215733,2022-06-14,Senate,"Do pass as amended, but first amend, and re-refer to the Committee on [Appropriations]",9,0,0,0,9
1594424,1219405,2022-06-27,Senate,"Placed on suspense file",6,0,0,1,7
1594425,1193161,2022-04-25,Assembly,"Do pass and be re-referred to the Committee on [Appropriations]",15,0,0,0,15
1594425,1206477,2022-05-19,Assembly,"Do pass as amended",12,0,0,4,16
1594425,1210368,2022-05-25,Assembly,"AB 2594 Ting Assembly Third Reading",76,0,0,2,78
1594425,1220796,2022-06-28,Senate,"Do pass, but first be re-referred to the Committee on [Appropriations]",17,0,0,0,17
1594425,1225883,2022-08-29,Senate,"Assembly 3rd Reading AB2594 Ting et al. By Skinner",35,0,0,5,40
1594425,1225884,2022-08-30,Assembly,"AB 2594 Ting Concurrence in Senate Amendments",79,0,0,1,80
1594426,1179180,2022-03-29,Assembly,"Do pass as amended and be re-referred to the Committee on [Human Services]",8,0,0,2,10
1594426,1193258,2022-04-26,Assembly,"Do pass and be re-referred to the Committee on [Appropriations]",6,0,0,2,8
1594426,1203328,2022-05-11,Assembly,"Do pass",12,3,0,1,16
1594426,1210365,2022-05-25,Assembly,"AB 2595 Jones-Sawyer Assembly Third Reading",58,9,0,11,78
1594426,1215904,2022-06-13,Senate,"Do pass, but first be re-referred to the Committee on [Judiciary]",4,0,0,1,5
1594426,1218017,2022-06-21,Senate,"Do pass, but first be re-referred to the Committee on [Appropriations]",9,1,0,1,11
1594426,1224669,2022-08-24,Senate,"Assembly 3rd Reading AB2595 Jones-Sawyer By Caballero",31,4,0,5,40
1594427,1190629,2022-04-20,Assembly,"Do pass and be re-referred to the Committee on [Governmental Organization]",6,0,0,0,6
1594427,1195755,2022-04-28,Assembly,"Do pass and be re-referred to the Committee on [Appropriations]",22,0,0,0,22
1594427,1206511,2022-05-19,Assembly,"Do pass as amended",12,0,0,4,16
1594427,1210641,2022-05-25,Assembly,"AB 2596 Low Assembly Third Reading",76,0,0,2,78
1594427,1220115,2022-06-28,Senate,"Do pass, but first be re-referred to the Committee on [Appropriations]",12,0,0,3,15
1594427,1222663,2022-08-01,Senate,"Placed on suspense file",7,0,0,0,7
1594427,1223369,2022-08-11,Senate,"Do pass as amended",7,0,0,0,7
1594427,1225573,2022-08-31,Senate,"Special Consent AB2596",40,0,0,0,40
1594427,1225574,2022-08-31,Assembly,"AB 2596 Low Concurrence in Senate Amendments",77,0,0,3,80
1594428,1194207,2022-04-27,Assembly,"Do pass as amended and be re-referred to the Committee on [Appropriations]",7,1,0,0,8
1594428,1206952,2022-05-19,Assembly,"Do pass as amended",12,4,0,0,16
1594428,1210561,2022-05-26,Assembly,"AB 2597 Bloom Assembly Third Reading",48,21,0,9,78
1594429,1195806,2022-04-27,Assembly,"Do pass as amended and be re-referred to the Committee on [Appropriations]",7,0,0,0,7
1594429,1206428,2022-05-19,Assembly,"Do pass as amended",12,0,0,4,16
1594429,1210637,2022-05-25,Assembly,"AB 2598 Akilah Weber Assembly Third Reading",72,0,0,6,78
1594429,1221311,2022-06-30,Senate,"Do pass, but first be re-referred to the Committee on [Appropriations]",7,0,0,0,7
1594429,1222696,2022-08-01,Senate,"Placed on suspense file",7,0,0,0,7
1594429,1223352,2022-08-11,Senate,"Do pass as amended",7,0,0,0,7
1594429,1225634,2022-08-30,Senate,"Assembly 3rd Reading AB2598 Akilah Weber et al. By Kamlager",40,0,0,0,40
1594429,1225635,2022-08-31,Assembly,"AB 2598 Akilah Weber Concurrence in Senate Amendments",78,0,0,2,80
1594430,1183806,2022-04-04,Assembly,"Do pass and be re-referred to the Committee on [Appropriations] with recommendation: To Consent Calendar",15,0,0,0,15
1594430,1206993,2022-05-19,Assembly,"Do pass",16,0,0,0,16
1594430,1207694,2022-05-23,Assembly,"AB 2599 Cervantes Assembly Third Reading",74,0,0,4,78
1594430,1216388,2022-06-14,Senate,"Do pass, but first be re-referred to the Committee on [Appropriations] with the recommendation: To Consent Calendar",15,0,0,2,17
1594430,1219345,2022-06-27,Senate,"Placed on suspense file",6,0,0,1,7
1594432,1186488,2022-04-05,Assembly,"Do pass and be re-referred to the Committee on [Natural Resources]",6,2,0,1,9
1594432,1189332,2022-04-18,Assembly,"Do pass and be re-referred to the Committee on [Appropriations]",8,3,0,0,11
1594435,1179218,2022-03-29,Assembly,"Do pass and be re-referred to the Committee on [Insurance]",7,0,0,0,7
1594435,1190705,2022-04-20,Assembly,"Do pass and be re-referred to the Committee on [Appropriations] with recommendation: To Consent Calendar",13,0,0,1,14
1594435,1205829,2022-05-18,Assembly,"Do pass. To Consent Calendar",15,0,0,1,16
1594435,1210544,2022-05-25,Assembly,"AB 2604 Calderon Consent Calendar Second Day Regular Session",73,0,0,5,78
1594435,1218038,2022-06-22,Senate,"Do pass, but first be re-referred to the Committee on [Health] with the recommendation: To Consent Calendar",11,0,0,1,12
1594435,1221247,2022-06-29,Senate,"Do pass, but first be re-referred to the Committee on [Appropriations] with the recommendation: To Consent Calendar",10,0,0,1,11
1594435,1225288,2022-08-29,Senate,"Assembly 3rd Reading AB2604 Calderon By Dodd",40,0,0,0,40
1594435,1225289,2022-08-30,Assembly,"AB 2604 Calderon Concurrence in Senate Amendments",78,0,0,2,80
1594437,1193362,2022-04-26,Assembly,"Do pass and be re-referred to the Committee on [Appropriations]",11,1,0,6,18
1594437,1205817,2022-05-18,Assembly,"Do pass",11,0,0,5,16
1594437,1210264,2022-05-26,Assembly,"AB 2606 Carrillo Assembly Third Reading",60,5,0,13,78
1594438,1179306,2022-03-21,Assembly,"Do pass as amended and be re-referred to the Committee on [Appropriations]",11,0,0,0,11
1594438,1194210,2022-04-27,Assembly,"Do pass. To Consent Calendar",15,0,0,1,16
1594438,1207886,2022-05-23,Assembly,"AB 2607 Ting Third Reading Urgency",74,0,0,4,78
1594438,1217123,2022-06-20,Senate,"Do pass, but first be re-referred to the Committee on [Appropriations] with the recommendation: To Consent Calendar",7,0,0,2,9
1594438,1223244,2022-08-08,Senate,"Consent Calendar AB2607 Ting Urgency Clause",36,0,0,4,40
1594439,1184713,2022-04-06,Assembly,"Do pass as amended and be re-referred to the Committee on [Appropriations]",6,1,0,0,7
1594439,1194125,2022-04-27,Assembly,"Do pass",11,4,0,1,16
1594439,1210450,2022-05-25,Assembly,"AB 2608 Berman Third Reading Urgency By MULLIN",57,19,0,2,78
1594439,1217450,2022-06-21,Senate,"Do pass, but first be re-referred to the Committee on [Appropriations]",4,1,0,0,5
1594439,1224139,2022-08-17,Senate,"Assembly 3rd Reading AB2608 Berman By Umberg Urgency Clause",29,9,0,2,40
1594441,1183710,2022-04-05,Assembly,"Do pass and be re-referred to the Committee on [Natural Resources]",12,0,0,3,15
1594441,1192206,2022-04-25,Assembly,"Do pass and be re-referred to the Committee on [Appropriations]",10,0,0,1,11
1594442,1183704,2022-04-05,Assembly,"Do pass",16,0,0,2,18
1594442,1189310,2022-04-18,Assembly,"AB 2611 Daly Assembly Third Reading",71,0,0,6,77
1594442,1215782,2022-06-13,Senate,"Do pass",13,0,0,1,14
1594442,1223247,2022-08-08,Senate,"Special Consent AB2611",36,0,0,4,40
1594444,1189349,2022-04-18,Assembly,"Do pass as amended and be re-referred to the Committee on [Appropriations]",11,0,0,0,11
1594445,1181315,2022-03-30,Assembly,"Do pass and be re-referred to the Committee on [Insurance]",4,1,0,1,6
1594445,1190604,2022-04-20,Assembly,"Do pass and be re-referred to the Committee on [Appropriations]",12,0,0,2,14
1594445,1206709,2022-05-19,Assembly,"Do pass",12,0,0,4,16
1594445,1210464,2022-05-25,Assembly,"AB 2614 Rodriguez Assembly Third Reading",60,0,0,18,78
1594445,1215751,2022-06-13,Senate,"Do pass, but first be re-referred to the Committee on [Appropriations]",4,0,0,1,5
1594445,1219393,2022-06-27,Senate,"Placed on suspense file",6,0,0,1,7
1594447,1183825,2022-04-05,Assembly,"Do pass and be re-referred to the Committee on [Appropriations]",10,0,0,0,10
1594448,1183673,2022-04-05,Assembly,"Do pass as amended and be re-referred to the Committee on [Education]",11,0,0,1,12
1594448,1191313,2022-04-20,Assembly,"Do pass and be re-referred to the Committee on [Appropriations] with recommendation: To Consent Calendar",7,0,0,0,7
1594448,1206599,2022-05-19,Assembly,"Do pass",16,0,0,0,16
1594448,1207691,2022-05-23,Assembly,"AB 2617 Holden Assembly Third Reading",74,0,0,4,78
1594448,1216272,2022-06-15,Senate,"Do pass, but first be re-referred to the Committee on [Appropriations]",6,0,0,1,7
1594448,1219350,2022-06-27,Senate,"Placed on suspense file",6,0,0,1,7
1594452,1180239,2022-03-30,Assembly,"Do pass and be re-referred to the Committee on [Appropriations] with recommendation: To Consent Calendar",13,0,0,1,14
1594453,1200498,2022-05-05,Assembly,"Do pass and be re-referred to the Committee on [Appropriations]",11,0,0,0,11
1594453,1206410,2022-05-19,Assembly,"Do pass",16,0,0,0,16
1594453,1210275,2022-05-26,Assembly,"AB 2622 Mullin Assembly Third Reading",74,0,0,4,78
1594453,1221270,2022-06-29,Senate,"Do pass, but first be re-referred to the Committee on [Appropriations]",5,0,0,0,5
1594453,1222907,2022-08-01,Senate,"Placed on suspense file",7,0,0,0,7
1594453,1223618,2022-08-11,Senate,"Do pass",7,0,0,0,7
1594453,1224515,2022-08-23,Senate,"Special Consent AB2622",40,0,0,0,40
1594453,1224671,2022-08-24,Assembly,"AB 2622 Mullin Concurrence in Senate Amendments",77,0,0,3,80
1594455,1194169,2022-04-26,Assembly,"Do pass and be re-referred to the Committee on [Appropriations]",11,0,0,1,12
1594456,1199930,2022-05-04,Assembly,"Do pass as amended",8,0,0,0,8
1594456,1210342,2022-05-25,Assembly,"AB 2625 Ting Assembly Third Reading",75,0,0,3,78
1594456,1216262,2022-06-15,Senate,"Do pass and be ordered to the Consent Calendar",5,0,0,0,5
1594456,1223300,2022-08-08,Senate,"Special Consent AB2625",36,0,0,4,40
1594457,1183767,2022-04-05,Assembly,"Do pass as amended and be re-referred to the Committee on [Health]",11,3,0,4,18
1594457,1193163,2022-04-26,Assembly,"Do pass and be re-referred to the Committee on [Appropriations]",11,3,0,1,15
1594457,1203339,2022-05-11,Assembly,"Do pass",12,4,0,0,16
1594457,1204687,2022-05-16,Assembly,"AB 2626 Calderon Assembly Third Reading Amendment Set #1",51,16,0,11,78
1594457,1207713,2022-05-23,Assembly,"AB 2626 Calderon Third Reading Urgency",56,15,0,7,78
1594457,1215838,2022-06-13,Senate,"Do pass, but first be re-referred to the Committee on [Health]",9,3,0,2,14
1594457,1221295,2022-06-30,Senate,"Do pass, but first be re-referred to the Committee on [Appropriations]",8,2,0,1,11
1594457,1225581,2022-08-31,Senate,"Assembly 3rd Reading AB2626 Calderon et al. By Kamlager Urgency Clause",30,9,0,1,40
1594457,1225582,2022-08-31,Assembly,"AB 2626 CALDERON Concurrence in Senate Amendments",61,16,0,3,80
1594458,1189958,2022-04-19,Assembly,"Do pass and be re-referred to the Committee on [Higher Education]",10,0,0,1,11
1594458,1194410,2022-04-26,Assembly,"Do pass as amended and be re-referred to the Committee on [Appropriations]",11,0,0,1,12
1594458,1206972,2022-05-19,Assembly,"Do pass",13,2,0,1,16
1594458,1207862,2022-05-23,Assembly,"AB 2627 Bauer-Kahan Assembly Third Reading",64,6,0,8,78
1594458,1216331,2022-06-15,Senate,"Do pass, but first be re-referred to the Committee on [Judiciary]",5,0,0,2,7
1594458,1217906,2022-06-21,Senate,"Do pass as amended, but first amend, and re-refer to the Committee on [Appropriations]",9,2,0,0,11
1594458,1222689,2022-08-01,Senate,"Placed on suspense file",7,0,0,0,7
1594458,1223876,2022-08-11,Senate,"Do pass as amended",4,1,0,2,7
1594458,1224528,2022-08-23,Senate,"Assembly 3rd Reading AB2627 Bauer-Kahan et al. By Ochoa Bogh",32,8,0,0,40
1594458,1224703,2022-08-24,Assembly,"AB 2627 Bauer-Kahan Concurrence in Senate Amendments",66,6,0,8,80
1594459,1183730,2022-04-05,Assembly,"Do pass and be re-referred to the Committee on [Judiciary]",8,0,0,0,8
1594459,1189898,2022-04-19,Assembly,"Do pass as amended and be re-referred to the Committee on [Appropriations]",9,0,0,2,11
1594460,1193213,2022-04-26,Assembly,"Do pass",5,2,0,0,7
1594460,1210444,2022-05-26,Assembly,"AB 2629 Santiago Assembly Third Reading",51,20,0,7,78
1594460,1220627,2022-06-28,Senate,"Do pass",5,0,0,0,5
1594460,1224816,2022-08-24,Senate,"Assembly 3rd Reading AB2629 Santiago By Leyva",32,7,0,1,40
1594460,1225000,2022-08-25,Assembly,"AB 2629 Santiago Concurrence in Senate Amendments",56,14,0,10,80
1594461,1194187,2022-04-27,Assembly,"Do pass and be re-referred to the Committee on [Appropriations] with recommendation: To Consent Calendar",8,0,0,0,8
1594461,1206933,2022-05-19,Assembly,"Do pass as amended",12,0,0,4,16
1594461,1210598,2022-05-26,Assembly,"AB 2630 O'Donnell Assembly Third Reading By WICKS",75,0,0,3,78
1594463,1189966,2022-04-19,Assembly,"Do pass and be re-referred to the Committee on [Appropriations]",5,2,0,0,7
1594463,1206268,2022-05-19,Assembly,"Do pass",12,4,0,0,16
1594463,1210409,2022-05-25,Assembly,"AB 2632 Holden Assembly Third Reading",49,21,0,8,78
1594463,1220730,2022-06-28,Senate,"Do pass as amended, but first amend, and re-refer to the Committee on [Appropriations]",4,0,0,1,5
1594463,1222854,2022-08-01,Senate,"Placed on suspense file",7,0,0,0,7
1594463,1223635,2022-08-11,Senate,"Do pass",5,2,0,0,7
1594463,1225711,2022-08-29,Senate,"Assembly 3rd Reading AB2632 Holden et al. By Skinner",23,12,0,5,40
1594463,1225712,2022-08-30,Assembly,"AB 2632 Holden Concurrence in Senate Amendments",51,22,0,7,80
1594463,1229707,2022-08-30,Senate,"Assembly 3rd Reading AB2632 Holden et al. By Skinner",23,12,0,5,40
1594464,1193354,2022-04-26,Assembly,"Do pass as amended and be re-referred to the Committee on [Appropriations]",11,2,0,2,15
1594464,1206244,2022-05-19,Assembly,"Do pass as amended",12,0,0,4,16
1594464,1210348,2022-05-25,Assembly,"AB 2633 Cooley Assembly Third Reading",67,2,0,9,78
1594466,1175564,2022-03-23,Assembly,"Do pass and be re-referred to the Committee on [Appropriations]",9,3,0,1,13
1594466,1184705,2022-04-06,Assembly,"Do pass",9,4,0,3,16
1594466,1198339,2022-05-02,Assembly,"AB 2635 Levine Assembly Third Reading",18,18,0,41,77
1594467,1191254,2022-04-20,Assembly,"Do pass and be re-referred to the Committee on [Health] with recommendation: To Consent Calendar",7,0,0,0,7
1594467,1193138,2022-04-26,Assembly,"Do pass and be re-referred to the Committee on [Appropriations] with recommendation: To Consent Calendar",14,0,0,1,15
1594469,1191298,2022-04-20,Assembly,"Do pass and be re-referred to the Committee on [Environmental Safety and Toxic Materials]",7,0,0,0,7
1594469,1197960,2022-04-26,Assembly,"Do pass and be re-referred to the Committee on [Appropriations] with recommendation: To Consent Calendar",9,0,0,0,9
1594469,1206794,2022-05-19,Assembly,"Do pass",16,0,0,0,16
1594469,1207838,2022-05-23,Assembly,"AB 2638 Bloom Assembly Third Reading",72,0,0,6,78
1594469,1216358,2022-06-15,Senate,"Do pass, but first be re-referred to the Committee on [Environmental Quality]",6,0,0,1,7
1594469,1217959,2022-06-22,Senate,"Do pass, but first be re-referred to the Committee on [Appropriations]",7,0,0,0,7
1594469,1222714,2022-08-01,Senate,"Placed on suspense file",7,0,0,0,7
1594469,1223653,2022-08-11,Senate,"Do pass",6,0,0,1,7
1594469,1224506,2022-08-23,Senate,"Assembly 3rd Reading AB2638 Bloom et al. By Eggman",40,0,0,0,40
1594470,1183773,2022-04-05,Assembly,"Do pass and be re-referred to the Committee on [Environmental Safety and Toxic Materials]",9,4,0,2,15
1594470,1197963,2022-04-26,Assembly,"Do pass and be re-referred to the Committee on [Appropriations]",5,3,0,1,9
1594470,1206533,2022-05-19,Assembly,"Do pass",12,4,0,0,16
1594470,1210500,2022-05-26,Assembly,"AB 2639 Quirk Assembly Third Reading",34,26,0,18,78
1594471,1185704,2022-04-06,Assembly,"Do pass as amended and be re-referred to the Committee on [Appropriations]",7,0,0,0,7
1594471,1194250,2022-04-27,Assembly,"Do pass. To Consent Calendar",15,0,0,1,16
1594471,1200685,2022-05-05,Assembly,"AB 2640 Valladares Consent Calendar Second Day Regular Session",61,0,0,17,78
1594471,1216288,2022-06-15,Senate,"Do pass, but first be re-referred to the Committee on [Appropriations]",6,0,0,1,7
1594471,1224112,2022-08-17,Senate,"Assembly 3rd Reading AB2640 Valladares et al. By Archuleta",38,0,0,2,40
1594475,1183776,2022-04-05,Assembly,"Do pass as amended and be re-referred to the Committee on [Appropriations]",5,2,0,0,7
1594475,1206485,2022-05-19,Assembly,"Do pass as amended",12,4,0,0,16
1594475,1210585,2022-05-26,Assembly,"AB 2644 Holden Assembly Third Reading",41,25,0,12,78
1594475,1220691,2022-06-28,Senate,"Do pass, but first be re-referred to the Committee on [Appropriations]",4,1,0,0,5
1594475,1222823,2022-08-01,Senate,"Placed on suspense file",7,0,0,0,7
1594475,1223512,2022-08-11,Senate,"Do pass as amended",5,2,0,0,7
1594475,1225757,2022-08-29,Senate,"Assembly 3rd Reading AB2644 Holden et al. By Bradford",25,9,0,6,40
1594475,1225758,2022-08-30,Assembly,"AB 2644 Holden Concurrence in Senate Amendments",47,19,0,14,80
1594476,1192239,2022-04-25,Assembly,"Do pass and be re-referred to the Committee on [Appropriations]",7,0,0,0,7
1594476,1206622,2022-05-19,Assembly,"Do pass",16,0,0,0,16
1594476,1210356,2022-05-25,Assembly,"AB 2645 Rodriguez Assembly Third Reading",76,0,0,2,78
1594476,1219863,2022-06-28,Senate,"Do pass, but first be re-referred to the Committee on [Appropriations] with the recommendation: To Consent Calendar",13,0,0,2,15
1594476,1222690,2022-08-01,Senate,"Placed on suspense file",7,0,0,0,7
1594476,1224036,2022-08-11,Senate,"Do pass as amended",7,0,0,0,7
1594476,1224574,2022-08-23,Senate,"Special Consent AB2645",40,0,0,0,40
1594476,1224842,2022-08-24,Assembly,"AB 2645 Rodriguez Concurrence in Senate Amendments",77,0,0,3,80
1594478,1199926,2022-05-04,Assembly,"Do pass",6,0,0,2,8
1594478,1204067,2022-05-12,Assembly,"AB 2647 Levine Assembly Third Reading",62,0,0,16,78
1594478,1221241,2022-06-29,Senate,"Do pass as amended",5,0,0,0,5
1594478,1224121,2022-08-17,Senate,"Assembly 3rd Reading AB2647 Levine By Caballero",38,0,0,2,40
1594478,1224302,2022-08-22,Assembly,"AB 2647 Levine Concurrence in Senate Amendments By RIVAS, R",74,0,0,6,80
1594479,1183628,2022-04-05,Assembly,"Do pass and be re-referred to the Committee on [Appropriations] with recommendation: To Consent Calendar",14,0,0,1,15
1594479,1206338,2022-05-19,Assembly,"Do pass",16,0,0,0,16
1594479,1210565,2022-05-26,Assembly,"AB 2648 Wilson Assembly Third Reading",75,0,0,3,78
1594479,1218598,2022-06-22,Senate,"Do pass, but first be re-referred to the Committee on [Public Safety] with the recommendation: To Consent Calendar",9,0,0,2,11
1594479,1222737,2022-08-01,Senate,"Placed on suspense file",7,0,0,0,7
1594479,1223459,2022-08-11,Senate,"Do pass",7,0,0,0,7
1594479,1224563,2022-08-23,Senate,"Special Consent AB2648",40,0,0,0,40
1594480,1192174,2022-04-25,Assembly,"Do pass as amended and be re-referred to the Committee on [Appropriations]",7,3,0,1,11
1594480,1206329,2022-05-19,Assembly,"Do pass",12,4,0,0,16
1594480,1207680,2022-05-23,Assembly,"AB 2649 Cristina Garcia Assembly Third Reading",52,13,0,13,78
1594480,1215877,2022-06-14,Senate,"Do pass as amended, but first amend, and re-refer to the Committee on [Environmental Quality]",8,1,0,0,9
1594480,1220827,2022-06-29,Senate,"Do pass, but first be re-referred to the Committee on [Appropriations]",5,2,0,0,7
1594480,1222824,2022-08-01,Senate,"Placed on suspense file",7,0,0,0,7
1594482,1200495,2022-05-05,Assembly,"Do pass and be re-referred to the Committee on [Appropriations]",11,0,0,0,11
1594482,1206892,2022-05-19,Assembly,"Do pass as amended",12,0,0,4,16
1594482,1210467,2022-05-25,Assembly,"AB 2651 Petrie-Norris Assembly Third Reading",74,0,0,4,78
1594482,1221232,2022-06-29,Senate,"Do pass, but first be re-referred to the Committee on [Appropriations] with the recommendation: To Consent Calendar",5,0,0,0,5
1594482,1222849,2022-08-01,Senate,"Placed on suspense file",7,0,0,0,7
1594482,1223757,2022-08-11,Senate,"Do pass",7,0,0,0,7
1594482,1224443,2022-08-23,Senate,"Special Consent AB2651",40,0,0,0,40
1594483,1194104,2022-04-26,Assembly,"Do pass as amended and be re-referred to the Committee on [Appropriations]",9,0,0,3,12
1594484,1190525,2022-04-20,Assembly,"Do pass and be re-referred to the Committee on [Local Government]",6,2,0,0,8
1594484,1195847,2022-04-27,Assembly,"Do pass and be re-referred to the Committee on [Appropriations]",5,3,0,0,8
1594484,1206531,2022-05-19,Assembly,"Do pass",12,4,0,0,16
1594484,1210251,2022-05-26,Assembly,"AB 2653 Santiago Assembly Third Reading",55,19,0,4,78
1594484,1217931,2022-06-21,Senate,"Do pass, but first be re-referred to the Committee on [Appropriations]",7,1,0,1,9
1594484,1222898,2022-08-01,Senate,"Placed on suspense file",7,0,0,0,7
1594484,1223400,2022-08-11,Senate,"Do pass as amended",6,1,0,0,7
1594484,1225284,2022-08-29,Senate,"Assembly 3rd Reading AB2653 Santiago et al. By Durazo",31,9,0,0,40
1594484,1225285,2022-08-30,Assembly,"AB 2653 Santiago Concurrence in Senate Amendments",55,20,0,5,80
1594485,1179153,2022-03-29,Assembly,"Do pass and be re-referred to the Committee on [Human Services] with recommendation: To Consent Calendar",7,0,0,0,7
1594485,1193376,2022-04-26,Assembly,"Do pass and be re-referred to the Committee on [Appropriations] with recommendation: To Consent Calendar",7,0,0,1,8
1594486,1189883,2022-04-19,Assembly,"Do pass as amended. To Consent Calendar",13,0,0,2,15
1594486,1205860,2022-05-18,Assembly,"Do pass. To Consent Calendar",15,0,0,1,16
1594486,1210343,2022-05-25,Assembly,"AB 2655 Blanca Rubio Consent Calendar Second Day Regular Session",73,0,0,5,78
1594486,1215044,2022-06-08,Senate,"Do pass, but first be re-referred to the Committee on [Judiciary] with the recommendation: To Consent Calendar",9,0,0,2,11
1594486,1216329,2022-06-14,Senate,"Do pass, but first be re-referred to the Committee on [Appropriations] with the recommendation: To Consent Calendar",11,0,0,0,11
1594487,1190574,2022-04-20,Assembly,"Do pass and be re-referred to the Committee on [Natural Resources]",8,0,0,0,8
1594487,1192178,2022-04-25,Assembly,"Do pass and be re-referred to the Committee on [Appropriations]",7,2,0,2,11
1594487,1206425,2022-05-19,Assembly,"Do pass",16,0,0,0,16
1594487,1210252,2022-05-26,Assembly,"AB 2656 Ting Assembly Third Reading",68,3,0,7,78
1594487,1215832,2022-06-13,Senate,"Do pass, but first be re-referred to the Committee on [Governance and Finance]",8,0,0,1,9
1594487,1221350,2022-06-29,Senate,"Do pass as amended, but first amend, and re-refer to the Committee on [Appropriations]",4,0,0,1,5
1594487,1223198,2022-08-08,Senate,"Placed on suspense file",7,0,0,0,7
1594488,1183682,2022-04-05,Assembly,"Do pass as amended and be re-referred to the Committee on [Appropriations]",5,2,0,0,7
1594488,1203388,2022-05-11,Assembly,"Do pass",12,4,0,0,16
1594488,1210328,2022-05-25,Assembly,"AB 2657 Stone Assembly Third Reading",56,18,0,4,78
1594488,1217373,2022-06-21,Senate,"Do pass, but first be re-referred to the Committee on [Appropriations]",4,0,0,1,5
1594488,1224467,2022-08-23,Senate,"Assembly 3rd Reading AB2657 Stone By Skinner",30,10,0,0,40
1594488,1224714,2022-08-24,Assembly,"AB 2657 Stone Concurrence in Senate Amendments",56,17,0,7,80
1594489,1183756,2022-04-05,Assembly,"Do pass and be re-referred to the Committee on [Appropriations]",5,1,0,1,7
1594489,1206297,2022-05-19,Assembly,"Do pass",12,4,0,0,16
1594489,1207732,2022-05-23,Assembly,"AB 2658 Bauer-Kahan Assembly Third Reading",54,16,0,8,78
1594489,1217478,2022-06-21,Senate,"Do pass, but first be re-referred to the Committee on [Appropriations]",4,0,0,1,5
1594489,1222769,2022-08-01,Senate,"Placed on suspense file",7,0,0,0,7
1594489,1223658,2022-08-11,Senate,"Do pass",4,2,0,1,7
1594489,1224732,2022-08-24,Senate,"Assembly 3rd Reading AB2658 Bauer-Kahan By Wiener",28,10,0,2,40
1594489,1224991,2022-08-25,Assembly,"AB 2658 Bauer-Kahan Concurrence in Senate Amendments",56,12,0,12,80
1594491,1189989,2022-04-19,Assembly,"Do pass and be re-referred to the Committee on [Appropriations] with recommendation: To Consent Calendar",7,0,0,0,7
1594491,1206476,2022-05-19,Assembly,"Do pass",16,0,0,0,16
1594491,1207796,2022-05-23,Assembly,"AB 2660 Maienschein Assembly Third Reading",74,0,0,4,78
1594491,1217428,2022-06-21,Senate,"Do pass, but first be re-referred to the Committee on [Appropriations] with the recommendation: To Consent Calendar",4,0,0,1,5
1594491,1222776,2022-08-01,Senate,"Placed on suspense file",7,0,0,0,7
1594491,1223802,2022-08-11,Senate,"Do pass as amended",7,0,0,0,7
1594491,1224557,2022-08-23,Senate,"Special Consent AB2660",40,0,0,0,40
1594491,1224731,2022-08-24,Assembly,"AB 2660 Maienschein Concurrence in Senate Amendments",77,0,0,3,80
1594492,1190683,2022-04-20,Assembly,"Do pass. To Consent Calendar",13,0,0,1,14
1594492,1195825,2022-04-28,Assembly,"AB 2661 Waldron Consent Calendar Second Day Regular Session",71,0,0,6,77
1594492,1211886,2022-06-01,Senate,"Do pass and be ordered to the Consent Calendar",5,0,0,0,5
1594492,1215308,2022-06-09,Senate,"Consent Calendar AB2661",38,0,0,2,40
1594493,1179161,2022-03-29,Assembly,"Do pass",10,0,0,0,10
1594493,1192192,2022-04-25,Assembly,"AB 2662 Kalra Assembly Third Reading",66,0,0,11,77
1594493,1210931,2022-05-31,Senate,"Do pass and be ordered to the Consent Calendar",8,0,0,3,11
1594493,1215304,2022-06-09,Senate,"Consent Calendar AB2662",38,0,0,2,40
1594494,1193414,2022-04-26,Assembly,"Do pass and be re-referred to the Committee on [Appropriations]",6,0,0,2,8
1594494,1206681,2022-05-19,Assembly,"Do pass",12,4,0,0,16
1594494,1207817,2022-05-23,Assembly,"AB 2663 Ramos Assembly Third Reading",61,2,0,15,78
1594494,1219871,2022-06-27,Senate,"Do pass as amended, but first amend, and re-refer to the Committee on [Appropriations]",4,0,0,1,5
1594494,1223147,2022-08-08,Senate,"Placed on suspense file",7,0,0,0,7
1594494,1223377,2022-08-11,Senate,"Do pass",5,0,0,2,7
1594494,1224399,2022-08-23,Senate,"Assembly 3rd Reading AB2663 Ramos et al. By Wiener",34,0,0,6,40
1594494,1224704,2022-08-24,Assembly,"AB 2663 Ramos Concurrence in Senate Amendments",65,0,0,15,80
1594495,1189856,2022-04-19,Assembly,"Do pass and be re-referred to the Committee on [Higher Education]",7,0,0,0,7
1594496,1183705,2022-04-05,Assembly,"Do pass and be re-referred to the Committee on [Judiciary]",8,0,0,0,8
1594496,1189820,2022-04-19,Assembly,"Do pass and be re-referred to the Committee on [Appropriations] with recommendation: To Consent Calendar",9,0,0,2,11
1594496,1206289,2022-05-19,Assembly,"Do pass as amended",12,0,0,4,16
1594496,1210420,2022-05-25,Assembly,"AB 2665 Carrillo Assembly Third Reading",76,0,0,2,78
1594496,1215780,2022-06-13,Senate,"Do pass, but first be re-referred to the Committee on [Judiciary]",5,0,0,0,5
1594496,1220800,2022-06-28,Senate,"Do pass, but first be re-referred to the Committee on [Appropriations] with the recommendation: To Consent Calendar",10,0,0,1,11
1594496,1222930,2022-08-01,Senate,"Placed on suspense file",7,0,0,0,7
1594496,1223814,2022-08-11,Senate,"Do pass as amended",7,0,0,0,7
1594496,1224633,2022-08-23,Senate,"Special Consent AB2665",40,0,0,0,40
1594496,1224748,2022-08-24,Assembly,"AB 2665 Carrillo Concurrence in Senate Amendments",76,0,0,4,80
1594497,1183616,2022-04-05,Assembly,"Do pass and be re-referred to the Committee on [Higher Education]",14,0,0,1,15
1594497,1194494,2022-04-26,Assembly,"Do pass and be re-referred to the Committee on [Appropriations]",10,0,0,2,12
1594497,1206943,2022-05-19,Assembly,"Do pass",16,0,0,0,16
1594497,1207834,2022-05-23,Assembly,"AB 2666 Salas Assembly Third Reading",72,0,0,6,78
1594497,1218612,2022-06-22,Senate,"Do pass, but first be re-referred to the Committee on [Appropriations] with the recommendation: To Consent Calendar",9,0,0,2,11
1594497,1222691,2022-08-01,Senate,"Placed on suspense file",7,0,0,0,7
1594497,1223853,2022-08-11,Senate,"Do pass",7,0,0,0,7
1594497,1224480,2022-08-23,Senate,"Special Consent AB2666",40,0,0,0,40
1594498,1184714,2022-04-06,Assembly,"Do pass and be re-referred to the Committee on [Natural Resources]",10,0,0,5,15
1594498,1192215,2022-04-25,Assembly,"Do pass as amended and be re-referred to the Committee on [Appropriations]",7,1,0,3,11
1594498,1206879,2022-05-19,Assembly,"Do pass",12,2,0,2,16
1594498,1207832,2022-05-23,Assembly,"AB 2667 Friedman Assembly Third Reading",58,1,0,19,78
1594498,1219359,2022-06-27,Senate,"Do pass as amended, but first amend, and re-refer to the Committee on [Appropriations]",10,2,0,2,14
1594498,1222781,2022-08-01,Senate,"Placed on suspense file",7,0,0,0,7
1594498,1224042,2022-08-11,Senate,"Do pass as amended",5,2,0,0,7
1594498,1225788,2022-08-29,Senate,"Assembly 3rd Reading AB2667 Friedman By Hueso",20,10,0,10,40
1594498,1225789,2022-08-29,Senate,"Assembly 3rd Reading AB2667 Friedman By Hueso Reconsider",37,0,0,3,40
1594498,1225790,2022-08-30,Senate,"Assembly 3rd Reading AB2667 Friedman By Hueso",16,10,0,14,40
1594498,1229731,2022-08-30,Senate,"Assembly 3rd Reading AB2667 Friedman By Hueso Reconsider",37,0,0,3,40
1594499,1175570,2022-03-23,Assembly,"Do pass and be re-referred to the Committee on [Local Government]",8,0,0,0,8
1594499,1199939,2022-05-04,Assembly,"Do pass",7,0,0,1,8
1594499,1204581,2022-05-16,Assembly,"AB 2668 Grayson Assembly Third Reading",68,0,0,10,78
1594499,1215930,2022-06-13,Senate,"Do pass, but first be re-referred to the Committee on [Governance and Finance]",9,0,0,0,9
1594499,1221320,2022-06-29,Senate,"Do pass",5,0,0,0,5
1594499,1225600,2022-08-31,Senate,"Special Consent AB2668",40,0,0,0,40
1594499,1225601,2022-08-31,Assembly,"AB 2668 Grayson Concurrence in Senate Amendments",74,0,0,6,80
1594500,1193247,2022-04-26,Assembly,"Do pass as amended, and be re-referred to the Committee on [Appropriations] with recommendation: To Consent Calendar",7,0,0,0,7
1594500,1201343,2022-05-09,Assembly,"AB 2669 Nazarian Assembly Third Reading",66,0,0,12,78
1594500,1215767,2022-06-14,Senate,"Do pass and be ordered to the Consent Calendar",5,0,0,0,5
1594500,1224229,2022-08-18,Senate,"Assembly 3rd Reading AB2669 Nazarian By Kamlager Urgency Clause",38,0,0,2,40
1594500,1224282,2022-08-22,Assembly,"AB 2669 Nazarian Concurrence - Urgency Added",76,0,0,4,80
1594501,1191242,2022-04-20,Assembly,"Do pass and be re-referred to the Committee on [Appropriations]",7,0,0,0,7
1594502,1193267,2022-04-26,Assembly,"Do pass as amended",17,0,0,1,18
1594502,1206864,2022-05-19,Assembly,"Do pass",16,0,0,0,16
1594502,1210636,2022-05-25,Assembly,"AB 2671 B. & P. Assembly Third Reading By FLORA",76,0,0,2,78
1594502,1219411,2022-06-27,Senate,"Do pass, but first be re-referred to the Committee on [Appropriations]",13,0,0,1,14
1594502,1222807,2022-08-01,Senate,"Placed on suspense file",7,0,0,0,7
1594502,1223480,2022-08-11,Senate,"Do pass as amended",6,0,0,1,7
1594502,1224564,2022-08-23,Senate,"Special Consent AB2671",40,0,0,0,40
1594502,1224761,2022-08-24,Assembly,"AB 2671 Berman Concurrence in Senate Amendments",77,0,0,3,80
1594503,1189350,2022-04-18,Assembly,"Do pass and be re-referred to the Committee on [Appropriations] with recommendation: To Consent Calendar",11,0,0,0,11
1594503,1189884,2022-04-18,Assembly,"Do pass and be re-referred to the Committee on [Judiciary] with recommendation: To Consent Calendar",11,0,0,0,11
1594503,1193217,2022-04-26,Assembly,"Do pass as amended, and be re-referred to the Committee on [Appropriations] with recommendation: To Consent Calendar",9,0,0,1,10
1594504,1193427,2022-04-26,Assembly,"Do pass as amended and be re-referred to the Committee on [Appropriations]",14,0,0,1,15
1594504,1206474,2022-05-19,Assembly,"Do pass",16,0,0,0,16
1594504,1207692,2022-05-23,Assembly,"AB 2673 Irwin Assembly Third Reading",72,0,0,6,78
1594504,1216385,2022-06-15,Senate,"Do pass as amended, but first amend, and re-refer to the Committee on [Judiciary]",9,0,0,2,11
1594504,1220684,2022-06-28,Senate,"Do pass, but first be re-referred to the Committee on [Appropriations]",10,0,0,1,11
1594504,1222901,2022-08-01,Senate,"Placed on suspense file",7,0,0,0,7
1594504,1224034,2022-08-11,Senate,"Do pass",7,0,0,0,7
1594504,1225960,2022-08-31,Senate,"Special Consent AB2673",40,0,0,0,40
1594504,1225961,2022-08-31,Assembly,"AB 2673 Irwin Concurrence in Senate Amendments",79,1,0,0,80
1594508,1189871,2022-04-19,Assembly,"Do pass as amended and be re-referred to the Committee on [Appropriations]",10,0,0,1,11
1594508,1206831,2022-05-19,Assembly,"Do pass as amended",12,0,0,4,16
1594508,1210274,2022-05-25,Assembly,"AB 2677 Gabriel Assembly Third Reading",73,0,0,5,78
1594508,1220669,2022-06-28,Senate,"Do pass as amended, but first amend, and re-refer to the Committee on [Appropriations] with the recommendation: To Consent Calendar",10,0,0,1,11
1594508,1222838,2022-08-01,Senate,"Placed on suspense file",7,0,0,0,7
1594508,1223847,2022-08-11,Senate,"Do pass as amended",5,0,0,2,7
1594508,1224469,2022-08-23,Senate,"Special Consent AB2677",40,0,0,0,40
1594508,1224470,2022-08-23,Senate,"Special Consent AB2677 Gabriel et al. Reconsider",37,0,0,3,40
1594508,1225272,2022-08-29,Senate,"Assembly 3rd Reading AB2677 Gabriel et al. By Hertzberg",40,0,0,0,40
1594508,1225273,2022-08-30,Assembly,"AB 2677 Gabriel Concurrence in Senate Amendments",79,0,0,1,80
1594508,1229716,2022-08-30,Senate,"Assembly 3rd Reading AB2677 Gabriel et al. By Hertzberg",40,0,0,0,40
1594511,1193355,2022-04-26,Assembly,"Do pass and be re-referred to the Committee on [Appropriations]",11,0,0,4,15
1594511,1206754,2022-05-19,Assembly,"Do pass",12,2,0,2,16
1594511,1210269,2022-05-25,Assembly,"AB 2680 Arambula Assembly Third Reading",59,0,0,19,78
1594511,1221217,2022-06-30,Senate,"Do pass as amended, but first amend, and re-refer to the Committee on [Appropriations]",7,0,0,4,11
1594511,1223249,2022-08-08,Senate,"Placed on suspense file",7,0,0,0,7
1594511,1223964,2022-08-11,Senate,"Do pass as amended",4,0,0,3,7
1594512,1189906,2022-04-19,Assembly,"Do pass and be re-referred to the Committee on [Appropriations]",7,0,0,0,7
1594512,1199942,2022-05-04,Assembly,"Do pass. To Consent Calendar",14,0,0,2,16
1594512,1204121,2022-05-12,Assembly,"AB 2681 Bloom Consent Calendar Second Day Regular Session",65,0,0,13,78
1594512,1217854,2022-06-22,Senate,"Do pass, but first be re-referred to the Committee on [Appropriations] with the recommendation: To Consent Calendar",5,0,0,0,5
1594512,1223235,2022-08-08,Senate,"Consent Calendar AB2681",36,0,0,4,40
1594512,1224530,2022-08-23,Assembly,"AB 2681 Bloom Concurrence in Senate Amendments",75,0,0,5,80
1594513,1189811,2022-04-18,Assembly,"Do pass and be re-referred to the Committee on [Public Safety]",12,0,0,3,15
1594513,1193364,2022-04-26,Assembly,"Do pass and be re-referred to the Committee on [Appropriations]",6,0,0,1,7
1594513,1206888,2022-05-19,Assembly,"Do pass",15,0,0,1,16
1594513,1210206,2022-05-27,Assembly,"AB 2682 Gray Assembly Third Reading",69,0,0,9,78
1594513,1219524,2022-06-27,Senate,"Do pass, but first be re-referred to the Committee on [Public Safety]",12,0,0,2,14
1594513,1220884,2022-06-28,Senate,"Do pass as amended, but first amend, and re-refer to the Committee on [Appropriations]",5,0,0,0,5
1594513,1222659,2022-08-01,Senate,"Placed on suspense file",7,0,0,0,7
1594514,1183691,2022-04-05,Assembly,"Do pass and be re-referred to the Committee on [Appropriations]",11,0,0,1,12
1594514,1194111,2022-04-27,Assembly,"Do pass. To Consent Calendar",15,0,0,1,16
1594514,1200686,2022-05-05,Assembly,"AB 2683 Gabriel Consent Calendar Second Day Regular Session",61,0,0,17,78
1594514,1215024,2022-06-08,Senate,"Do pass, but first be re-referred to the Committee on [Appropriations]",6,0,0,1,7
1594514,1217066,2022-06-20,Senate,"Placed on suspense file",4,0,0,3,7
1594514,1223820,2022-08-11,Senate,"Do pass as amended",7,0,0,0,7
1594514,1224448,2022-08-23,Senate,"Special Consent AB2683",40,0,0,0,40
1594514,1224773,2022-08-24,Assembly,"AB 2683 Gabriel Concurrence in Senate Amendments",76,0,0,4,80
1594515,1193162,2022-04-26,Assembly,"Do pass as amended and be re-referred to the Committee on [Appropriations]",17,0,0,1,18
1594515,1206365,2022-05-19,Assembly,"Do pass",16,0,0,0,16
1594515,1210372,2022-05-25,Assembly,"AB 2684 B. & P. Assembly Third Reading By FLORA",76,0,0,2,78
1594515,1219404,2022-06-27,Senate,"Do pass as amended, but first amend, and re-refer to the Committee on [Appropriations]",13,0,0,1,14
1594515,1222792,2022-08-01,Senate,"Placed on suspense file",7,0,0,0,7
1594515,1223886,2022-08-11,Senate,"Do pass as amended",6,0,0,1,7
1594515,1225575,2022-08-30,Senate,"Assembly 3rd Reading AB2684 Berman et al. By Roth",39,0,0,1,40
1594515,1225576,2022-08-31,Assembly,"AB 2684 Berman Concurrence in Senate Amendments",80,0,0,0,80
1594516,1193156,2022-04-26,Assembly,"Do pass",17,0,0,1,18
1594516,1210574,2022-05-25,Assembly,"AB 2685 B. & P. Assembly Third Reading By FLORA",75,0,0,3,78
1594516,1219508,2022-06-27,Senate,"Do pass, but first be re-referred to the Committee on [Appropriations]",12,0,0,2,14
1594516,1222786,2022-08-01,Senate,"Placed on suspense file",7,0,0,0,7
1594516,1223840,2022-08-11,Senate,"Do pass as amended",6,0,0,1,7
1594516,1224624,2022-08-23,Senate,"Special Consent AB2685 B. & P",40,0,0,0,40
1594516,1225167,2022-08-30,Assembly,"With recommendation: That Senate amendments be concurred in",15,0,0,3,18
1594516,1225276,2022-08-31,Assembly,"AB 2685 B. & P. Concurrence in Senate Amendments By BERMAN",79,0,0,1,80
1594517,1193363,2022-04-26,Assembly,"Do pass as amended, and be re-referred to the Committee on [Appropriations] with recommendation: To Consent Calendar",17,0,0,1,18
1594517,1206861,2022-05-19,Assembly,"Do pass",16,0,0,0,16
1594517,1210652,2022-05-25,Assembly,"AB 2686 B. & P. Assembly Third Reading By FLORA",76,0,0,2,78
1594517,1219383,2022-06-27,Senate,"Do pass as amended, but first amend, and re-refer to the Committee on [Appropriations]",13,0,0,1,14
1594517,1222658,2022-08-01,Senate,"Placed on suspense file",7,0,0,0,7
1594517,1223616,2022-08-11,Senate,"Do pass",6,0,0,1,7
1594517,1225797,2022-08-30,Senate,"Assembly 3rd Reading AB2686 Berman et al. By Roth",40,0,0,0,40
1594517,1225798,2022-08-31,Assembly,"AB 2686 Berman Concurrence in Senate Amendments",80,0,0,0,80
1594518,1193154,2022-04-26,Assembly,"Do pass",16,0,0,2,18
1594518,1210345,2022-05-25,Assembly,"AB 2687 B. & P. Assembly Third Reading By FLORA",73,0,0,5,78
1594518,1219509,2022-06-27,Senate,"Do pass",14,0,0,0,14
1594518,1223237,2022-08-08,Senate,"Special Consent AB2687 B. & P",36,0,0,4,40
1594518,1224158,2022-08-18,Assembly,"AB 2687 B. & P. Concurrence in Senate Amendments By BERMAN",76,0,0,4,80
1594522,1193284,2022-04-26,Assembly,"Do pass as amended and be re-referred to the Committee on [Appropriations]",10,1,0,7,18
1594522,1206942,2022-05-19,Assembly,"Do pass as amended",12,2,0,2,16
1594524,1181281,2022-03-30,Assembly,"Do pass and be re-referred to the Committee on [Appropriations]",4,2,0,0,6
1594524,1194195,2022-04-27,Assembly,"Do pass",11,4,0,1,16
1594524,1207788,2022-05-23,Assembly,"AB 2693 Reyes Assembly Third Reading",47,20,0,11,78
1594524,1214979,2022-06-08,Senate,"Do pass, but first be re-referred to the Committee on [Appropriations]",4,1,0,0,5
1594524,1225534,2022-08-29,Senate,"Assembly 3rd Reading AB2693 Reyes By Cortese",31,8,0,1,40
1594524,1225535,2022-08-30,Assembly,"AB 2693 Reyes Concurrence in Senate Amendments",55,15,0,10,80
1594525,1185686,2022-04-06,Assembly,"Do pass as amended and be re-referred to the Committee on [Appropriations]",7,0,0,0,7
1594525,1206980,2022-05-19,Assembly,"Do pass as amended",12,0,0,4,16
1594525,1210268,2022-05-26,Assembly,"AB 2694 Blanca Rubio Assembly Third Reading",74,0,0,4,78
1594526,1194376,2022-04-26,Assembly,"Do pass and be re-referred to the Committee on [Appropriations]",10,0,0,2,12
1594527,1184655,2022-04-06,Assembly,"Do pass as amended and be re-referred to the Committee on [Natural Resources]",12,0,0,3,15
1594527,1206621,2022-05-19,Assembly,"Do pass as amended",12,3,0,1,16
1594527,1210456,2022-05-25,Assembly,"AB 2696 Eduardo Garcia Assembly Third Reading",75,0,0,3,78
1594527,1217368,2022-06-21,Senate,"Do pass, but first be re-referred to the Committee on [Appropriations]",13,0,0,1,14
1594527,1222888,2022-08-01,Senate,"Placed on suspense file",7,0,0,0,7
1594528,1193420,2022-04-26,Assembly,"Do pass and be re-referred to the Committee on [Appropriations]",11,2,0,2,15
1594528,1206863,2022-05-19,Assembly,"Do pass",12,4,0,0,16
1594528,1210446,2022-05-25,Assembly,"AB 2697 Aguiar-Curry Assembly Third Reading",59,12,0,7,78
1594528,1221221,2022-06-29,Senate,"Do pass as amended, but first amend, and re-refer to the Committee on [Appropriations]",8,1,0,2,11
1594528,1223213,2022-08-08,Senate,"Placed on suspense file",7,0,0,0,7
1594528,1223922,2022-08-11,Senate,"Do pass",5,1,0,1,7
1594528,1225019,2022-08-25,Senate,"Assembly 3rd Reading AB2697 Aguiar-Curry et al. By Rubio",31,5,0,4,40
1594528,1225381,2022-08-29,Senate,"Assembly 3rd Reading AB2697 Aguiar-Curry et al. By Rubio",32,7,0,1,40
1594528,1225382,2022-08-30,Assembly,"AB 2697 Aguiar-Curry Concurrence in Senate Amendments",64,11,0,5,80
1594530,1193236,2022-04-26,Assembly,"Do pass and be re-referred to the Committee on [Appropriations] with recommendation: To Consent Calendar",7,0,0,0,7
1594530,1204076,2022-05-12,Assembly,"AB 2699 Ting Assembly Third Reading",65,0,0,13,78
1594530,1215907,2022-06-14,Senate,"Do pass and be ordered to the Consent Calendar",5,0,0,0,5
1594531,1190529,2022-04-20,Assembly,"Do pass and be re-referred to the Committee on [Transportation]",13,0,0,2,15
1594531,1193431,2022-04-25,Assembly,"Do pass as amended and be re-referred to the Committee on [Appropriations]",11,0,0,4,15
1594531,1206594,2022-05-19,Assembly,"Do pass",12,0,0,4,16
1594531,1210484,2022-05-25,Assembly,"AB 2700 McCarty Assembly Third Reading",58,1,0,19,78
1594531,1217475,2022-06-21,Senate,"Do pass, but first be re-referred to the Committee on [Environmental Quality]",10,1,0,3,14
1594531,1220843,2022-06-29,Senate,"Do pass as amended, but first amend, and re-refer to the Committee on [Appropriations]",5,0,0,2,7
1594531,1223250,2022-08-08,Senate,"Placed on suspense file",7,0,0,0,7
1594531,1223648,2022-08-11,Senate,"Do pass",5,0,0,2,7
1594531,1225739,2022-08-29,Senate,"Assembly 3rd Reading AB2700 McCarty et al. By Allen",33,2,0,5,40
1594531,1225740,2022-08-30,Assembly,"AB 2700 McCarty Concurrence in Senate Amendments",60,2,0,18,80
1594533,1194415,2022-04-27,Assembly,"Do pass as amended and be re-referred to the Committee on [Appropriations]",13,0,0,0,13
1594533,1206860,2022-05-19,Assembly,"Do pass",16,0,0,0,16
1594533,1210422,2022-05-25,Assembly,"AB 2702 Gipson Assembly Third Reading",76,0,0,2,78
1594533,1216384,2022-06-15,Senate,"Do pass, but first be re-referred to the Committee on [Appropriations]",13,0,0,1,14
1594533,1219420,2022-06-27,Senate,"Placed on suspense file",6,0,0,1,7
1594534,1193187,2022-04-25,Assembly,"Do pass and be re-referred to the Committee on [Appropriations]",14,0,0,1,15
1594534,1206697,2022-05-19,Assembly,"Do pass",16,0,0,0,16
1594534,1210551,2022-05-25,Assembly,"AB 2703 Muratsuchi Assembly Third Reading",76,0,0,2,78
1594534,1217369,2022-06-21,Senate,"Do pass, but first be re-referred to the Committee on [Transportation]",10,2,0,2,14
1594534,1220807,2022-06-28,Senate,"Do pass as amended, but first amend, and re-refer to the Committee on [Appropriations]",14,2,0,1,17
1594534,1223157,2022-08-08,Senate,"Placed on suspense file",7,0,0,0,7
1594536,1190563,2022-04-20,Assembly,"Do pass as amended and be re-referred to the Committee on [Appropriations]",8,0,0,0,8
1594536,1206923,2022-05-19,Assembly,"Do pass",16,0,0,0,16
1594536,1210600,2022-05-26,Assembly,"AB 2705 Quirk-Silva Assembly Third Reading",73,0,0,5,78
1594536,1216248,2022-06-15,Senate,"Do pass, but first be re-referred to the Committee on [Housing]",5,0,0,0,5
1594536,1218032,2022-06-21,Senate,"Do pass, but first be re-referred to the Committee on [Appropriations]",6,0,0,3,9
1594536,1223166,2022-08-08,Senate,"Placed on suspense file",7,0,0,0,7
1594537,1179668,2022-03-29,Assembly,"Do pass as amended, and be re-referred to the Committee on [Appropriations] with recommendation: To Consent Calendar",7,0,0,0,7
1594541,1189858,2022-04-19,Assembly,"Do pass and be re-referred to the Committee on [Housing and Community Development]",6,2,0,3,11
1594542,1183646,2022-04-05,Assembly,"Do pass and be re-referred to the Committee on [Judiciary] with recommendation: To Consent Calendar",8,0,0,0,8
1594542,1189880,2022-04-19,Assembly,"Do pass and be re-referred to the Committee on [Appropriations] with recommendation: To Consent Calendar",9,0,0,2,11
1594542,1199935,2022-05-04,Assembly,"Do pass. To Consent Calendar",14,0,0,2,16
1594542,1204091,2022-05-12,Assembly,"AB 2711 Calderon Consent Calendar Second Day Regular Session",65,0,0,13,78
1594542,1215055,2022-06-08,Senate,"Do pass as amended, but first amend, and re-refer to the Committee on [Appropriations] with the recommendation: To Consent Calendar",9,0,0,2,11
1594542,1215283,2022-06-08,Senate,"Do pass as amended, but first amend, and re-refer to the Committee on [Human Services] with the recommendation: To Consent Calendar",9,0,0,2,11
1594542,1217452,2022-06-20,Senate,"Do pass, but first be re-referred to the Committee on [Appropriations]",4,0,0,1,5
1594542,1225306,2022-08-29,Senate,"Assembly 3rd Reading AB2711 Calderon By Hurtado",40,0,0,0,40
1594542,1225307,2022-08-30,Assembly,"AB 2711 Calderon Concurrence in Senate Amendments",79,0,0,1,80
1594544,1175515,2022-03-23,Assembly,"Do pass and be re-referred to the Committee on [Judiciary]",6,1,0,1,8
1594544,1190001,2022-04-19,Assembly,"Do pass",6,2,0,3,11
1594547,1194399,2022-04-27,Assembly,"Do pass and be re-referred to the Committee on [Appropriations]",13,0,0,0,13
1594547,1203353,2022-05-11,Assembly,"Do pass",16,0,0,0,16
1594547,1210362,2022-05-25,Assembly,"AB 2716 Grayson Assembly Third Reading",70,0,0,8,78
1594547,1216379,2022-06-14,Senate,"Do pass, but first be re-referred to the Committee on [Energy, Utilities and Communications]",13,0,0,4,17
1594547,1219369,2022-06-27,Senate,"Do pass as amended, but first amend, and re-refer to the Committee on [Appropriations]",13,0,0,1,14
1594547,1224559,2022-08-23,Senate,"Assembly 3rd Reading AB2716 Grayson By Dodd",28,1,0,11,40
1594547,1224677,2022-08-24,Assembly,"AB 2716 Grayson Concurrence in Senate Amendments",59,2,0,19,80
1594548,1189988,2022-04-19,Assembly,"Do pass and be re-referred to the Committee on [Appropriations] with recommendation: To Consent Calendar",7,0,0,0,7
1594548,1206877,2022-05-19,Assembly,"Do pass",16,0,0,0,16
1594548,1207728,2022-05-23,Assembly,"AB 2717 Waldron Assembly Third Reading",73,0,0,5,78
1594548,1220612,2022-06-28,Senate,"Do pass, but first be re-referred to the Committee on [Appropriations] with the recommendation: To Consent Calendar",5,0,0,0,5
1594548,1222870,2022-08-01,Senate,"Placed on suspense file",7,0,0,0,7
1594548,1223891,2022-08-11,Senate,"Do pass",7,0,0,0,7
1594548,1224426,2022-08-23,Senate,"Special Consent AB2717",40,0,0,0,40
1594548,1224652,2022-08-24,Assembly,"AB 2717 Waldron Concurrence in Senate Amendments",76,0,0,4,80
1594549,1193380,2022-04-26,Assembly,"Do pass and be re-referred to the Committee on [Appropriations]",2,5,0,0,7
1594552,1182524,2022-04-04,Assembly,"Do pass",10,0,0,0,10
1594552,1189371,2022-04-18,Assembly,"AB 2721 Lee Assembly Third Reading",67,3,0,7,77
1594552,1211921,2022-06-01,Senate,"Do pass, but first be re-referred to the Committee on [Governance and Finance]",5,0,0,2,7
1594552,1221236,2022-06-29,Senate,"Do pass as amended",4,1,0,0,5
1594552,1224354,2022-08-22,Senate,"Assembly 3rd Reading AB2721 Lee By Cortese",37,0,0,3,40
1594552,1224581,2022-08-23,Assembly,"AB 2721 Lee Concurrence in Senate Amendments",73,0,0,7,80
1594553,1189296,2022-04-18,Assembly,"Do pass and be re-referred to the Committee on [Appropriations] with recommendation: To Consent Calendar",11,0,0,0,11
1594554,1179176,2022-03-29,Assembly,"Do pass and be re-referred to the Committee on [Public Safety]",15,0,0,3,18
1594554,1203383,2022-05-11,Assembly,"Do pass. To Consent Calendar",16,0,0,0,16
1594554,1206439,2022-05-19,Assembly,"AB 2723 Holden Consent Calendar Second Day Regular Session",72,0,0,6,78
1594554,1215738,2022-06-13,Senate,"Do pass",12,0,0,2,14
1594554,1224123,2022-08-17,Senate,"Assembly 3rd Reading AB2723 Holden et al. By Newman",38,0,0,2,40
1594554,1224292,2022-08-22,Assembly,"AB 2723 Holden Concurrence in Senate Amendments",76,0,0,4,80
1594555,1189873,2022-04-19,Assembly,"Do pass as amended and be re-referred to the Committee on [Appropriations]",10,2,0,3,15
1594555,1206601,2022-05-19,Assembly,"Do pass",12,3,0,1,16
1594555,1210298,2022-05-26,Assembly,"AB 2724 Arambula Assembly Third Reading",41,18,0,19,78
1594555,1218632,2022-06-22,Senate,"Do pass, but first be re-referred to the Committee on [Appropriations]",8,1,0,2,11
1594555,1221550,2022-06-29,Senate,"Assembly 3rd Reading AB2724 Arambula By Eggman",25,7,0,8,40
1594555,1221551,2022-06-29,Assembly,"AB 2724 ARAMBULA Concurrence in Senate Amendments",48,15,0,17,80
1594557,1189882,2022-04-19,Assembly,"Do pass",5,0,0,2,7
1594557,1207759,2022-05-23,Assembly,"AB 2726 Lackey Assembly Third Reading",56,4,0,18,78
1594558,1179173,2022-03-29,Assembly,"Do pass",11,1,0,3,15
1594558,1201449,2022-05-09,Assembly,"AB 2727 Wood Assembly Third Reading",51,12,0,15,78
1594558,1211826,2022-06-01,Senate,"Do pass",8,0,0,3,11
1594558,1224327,2022-08-22,Senate,"Assembly 3rd Reading AB2727 Wood By Eggman",33,2,0,5,40
1594558,1224486,2022-08-23,Assembly,"AB 2727 Wood Concurrence in Senate Amendments",62,4,0,14,80
1594559,1183611,2022-04-05,Assembly,"Do pass and be re-referred to the Committee on [Judiciary]",15,0,0,3,18
1594559,1189929,2022-04-19,Assembly,"Do pass as amended and be re-referred to the Committee on [Appropriations]",9,0,0,2,11
1594559,1199957,2022-05-04,Assembly,"Do pass",13,0,0,3,16
1594559,1206726,2022-05-19,Assembly,"AB 2728 Smith Assembly Third Reading",66,0,0,12,78
1594559,1217380,2022-06-20,Senate,"Do pass, but first be re-referred to the Committee on [Judiciary]",13,0,0,1,14
1594559,1220740,2022-06-28,Senate,"Do pass, but first be re-referred to the Committee on [Appropriations]",3,2,0,6,11
1594559,1220741,2022-06-28,Senate,"[First] hearing set for [06-29-2022]: Failed passage in Committee. Reconsideration granted",10,0,0,1,11
1594560,1191297,2022-04-20,Assembly,"Do pass and be re-referred to the Committee on [Appropriations]",7,0,0,0,7
1594561,1193268,2022-04-26,Assembly,"Do pass as amended and be re-referred to the Committee on [Appropriations]",7,0,0,0,7
1594561,1206660,2022-05-19,Assembly,"Do pass as amended",12,0,0,4,16
1594561,1210440,2022-05-25,Assembly,"AB 2730 Villapudua Assembly Third Reading",76,0,0,2,78
1594561,1220647,2022-06-28,Senate,"Do pass as amended, but first amend, and re-refer to the Committee on [Appropriations]",5,0,0,0,5
1594561,1222764,2022-08-01,Senate,"Placed on suspense file",7,0,0,0,7
1594561,1223708,2022-08-11,Senate,"Do pass",7,0,0,0,7
1594561,1224745,2022-08-24,Senate,"Assembly 3rd Reading AB2730 Villapudua By Newman",39,0,0,1,40
1594561,1224894,2022-08-25,Assembly,"AB 2730 Villapudua Concurrence in Senate Amendments",75,0,0,5,80
1594562,1191285,2022-04-20,Assembly,"Do pass as amended and be re-referred to the Committee on [Appropriations]",7,0,0,0,7
1594562,1206751,2022-05-19,Assembly,"Do pass as amended",12,1,0,3,16
1594562,1210205,2022-05-27,Assembly,"AB 2731 Ting Assembly Third Reading",62,0,0,16,78
1594562,1217858,2022-06-22,Senate,"Do pass as amended, but first amend, and re-refer to the Committee on [Appropriations]",5,0,0,2,7
1594562,1222719,2022-08-01,Senate,"Placed on suspense file",7,0,0,0,7
1594563,1184650,2022-04-06,Assembly,"Do pass and be re-referred to the Committee on [Emergency Management] with recommendation: To Consent Calendar",12,0,0,1,13
1594565,1182501,2022-04-04,Assembly,"Do pass and be re-referred to the Committee on [Appropriations]",9,0,0,1,10
1594566,1183760,2022-04-05,Assembly,"Do pass. To Consent Calendar",7,0,0,0,7
1594566,1191307,2022-04-21,Assembly,"AB 2735 Gray Consent Calendar Second Day Regular Session",68,0,0,9,77
1594566,1210915,2022-05-31,Senate,"Do pass, but first be re-referred to the Committee on [Appropriations] with the recommendation: To Consent Calendar",5,0,0,0,5
1594566,1217115,2022-06-20,Senate,"Placed on suspense file",4,0,0,3,7
1594566,1223828,2022-08-11,Senate,"Do pass",7,0,0,0,7
1594566,1224500,2022-08-23,Senate,"Special Consent AB2735",40,0,0,0,40
1594567,1180232,2022-03-30,Assembly,"Do pass and be re-referred to the Committee on [Appropriations] with recommendation: To Consent Calendar",19,0,0,3,22
1594567,1205866,2022-05-18,Assembly,"Do pass. To Consent Calendar",15,0,0,1,16
1594567,1210389,2022-05-25,Assembly,"AB 2736 Santiago Consent Calendar Second Day Regular Session",73,0,0,5,78
1594567,1220040,2022-06-28,Senate,"Do pass, but first be re-referred to the Committee on [Appropriations] with the recommendation: To Consent Calendar",13,0,0,2,15
1594568,1191291,2022-04-20,Assembly,"Do pass and be re-referred to the Committee on [Transportation] with recommendation: To Consent Calendar",7,0,0,0,7
1594568,1193259,2022-04-25,Assembly,"Do pass and be re-referred to the Committee on [Appropriations]",15,0,0,0,15
1594568,1203317,2022-05-11,Assembly,"Do pass. To Consent Calendar",16,0,0,0,16
1594568,1206652,2022-05-19,Assembly,"AB 2737 Carrillo Consent Calendar Second Day Regular Session",72,0,0,6,78
1594568,1214984,2022-06-08,Senate,"Do pass, but first be re-referred to the Committee on [Environmental Quality] with the recommendation: To Consent Calendar",5,0,0,0,5
1594568,1217924,2022-06-22,Senate,"Do pass, but first be re-referred to the Committee on [Appropriations] with the recommendation: To Consent Calendar",7,0,0,0,7
1594568,1223229,2022-08-08,Senate,"Consent Calendar AB2737",36,0,0,4,40
1594569,1190544,2022-04-19,Assembly,"Do pass as amended and be re-referred to the Committee on [Appropriations]",12,0,0,0,12
1594569,1206302,2022-05-19,Assembly,"Do pass",16,0,0,0,16
1594569,1207843,2022-05-23,Assembly,"AB 2738 Reyes Assembly Third Reading",73,0,0,5,78
1594569,1217884,2022-06-22,Senate,"Do pass, but first be re-referred to the Committee on [Appropriations]",6,0,0,1,7
1594569,1222747,2022-08-01,Senate,"Placed on suspense file",7,0,0,0,7
1594576,1189803,2022-04-19,Assembly,"Do pass and be re-referred to the Committee on [Appropriations] with recommendation: To Consent Calendar",19,0,0,0,19
1594576,1199963,2022-05-04,Assembly,"Do pass. To Consent Calendar",14,0,0,2,16
1594576,1204640,2022-05-16,Assembly,"AB 2745 Irwin Consent Calendar Second Day",71,0,0,7,78
1594576,1215803,2022-06-13,Senate,"Do pass, but first be re-referred to the Committee on [Appropriations] with the recommendation: To Consent Calendar",12,0,0,2,14
1594576,1223188,2022-08-08,Senate,"Consent Calendar AB2745",36,0,0,4,40
1594576,1223739,2022-08-11,Assembly,"AB 2745 Irwin Concurrence in Senate Amendments",76,0,0,4,80
1594577,1183772,2022-04-04,Assembly,"Do pass and be re-referred to the Committee on [Public Safety]",11,3,0,1,15
1594577,1193279,2022-04-26,Assembly,"Do pass and be re-referred to the Committee on [Appropriations]",5,2,0,0,7
1594577,1206953,2022-05-19,Assembly,"Do pass as amended",12,4,0,0,16
1594577,1210346,2022-05-25,Assembly,"AB 2746 Friedman Assembly Third Reading",50,20,0,8,78
1594577,1220845,2022-06-28,Senate,"Do pass, but first be re-referred to the Committee on [Appropriations]",13,3,0,1,17
1594577,1222833,2022-08-01,Senate,"Placed on suspense file",7,0,0,0,7
1594577,1223437,2022-08-11,Senate,"Do pass",5,2,0,0,7
1594577,1226009,2022-08-29,Senate,"Assembly 3rd Reading AB2746 Friedman et al. By Kamlager",27,9,0,4,40
1594577,1226010,2022-08-30,Assembly,"AB 2746 Friedman Concurrence in Senate Amendments",54,21,0,5,80
1594578,1190668,2022-04-19,Assembly,"Do pass and be re-referred to the Committee on [Appropriations]",12,0,0,0,12
1594578,1206852,2022-05-19,Assembly,"Do pass",16,0,0,0,16
1594578,1207747,2022-05-23,Assembly,"AB 2747 Nazarian Assembly Third Reading",72,0,0,6,78
1594578,1221340,2022-06-30,Senate,"Do pass as amended, but first amend, and re-refer to the Committee on [Appropriations] with the recommendation: To Consent Calendar",6,0,0,1,7
1594578,1223236,2022-08-08,Senate,"Placed on suspense file",7,0,0,0,7
1594578,1223716,2022-08-11,Senate,"Do pass",7,0,0,0,7
1594578,1224418,2022-08-23,Senate,"Special Consent AB2747",40,0,0,0,40
1594578,1224661,2022-08-24,Assembly,"AB 2747 Nazarian Concurrence in Senate Amendments",76,0,0,4,80
1594579,1194126,2022-04-27,Assembly,"Do pass as amended and be re-referred to the Committee on [Appropriations]",10,3,0,0,13
1594579,1206803,2022-05-19,Assembly,"Do pass",12,3,0,1,16
1594579,1210469,2022-05-25,Assembly,"AB 2748 Holden Assembly Third Reading",48,18,0,12,78
1594580,1194340,2022-04-27,Assembly,"Do pass and be re-referred to the Committee on [Appropriations]",12,0,0,1,13
1594580,1206776,2022-05-19,Assembly,"Do pass as amended",12,0,0,4,16
1594580,1210452,2022-05-25,Assembly,"AB 2749 Quirk-Silva Third Reading Urgency",74,0,0,4,78
1594580,1219347,2022-06-27,Senate,"Do pass as amended, but first amend, and re-refer to the Committee on [Appropriations]",9,1,0,4,14
1594580,1223172,2022-08-08,Senate,"Placed on suspense file",7,0,0,0,7
1594580,1223580,2022-08-11,Senate,"Do pass",7,0,0,0,7
1594580,1224695,2022-08-24,Senate,"Assembly 3rd Reading AB2749 Quirk-Silva et al. By Dodd Urgency Clause",36,0,0,4,40
1594580,1224969,2022-08-25,Assembly,"AB 2749 Quirk-Silva Concurrence in Senate Amendments",75,0,0,5,80
1594581,1189812,2022-04-19,Assembly,"Do pass as amended and be re-referred to the Committee on [Communications and Conveyance]",11,0,0,0,11
1594581,1194168,2022-04-27,Assembly,"Do pass and be re-referred to the Committee on [Appropriations] with recommendation: To Consent Calendar",13,0,0,0,13
1594581,1206663,2022-05-19,Assembly,"Do pass",16,0,0,0,16
1594581,1207824,2022-05-23,Assembly,"AB 2750 Mia Bonta Assembly Third Reading By HANEY",73,0,0,5,78
1594581,1215826,2022-06-14,Senate,"Do pass, but first be re-referred to the Committee on [Energy, Utilities and Communications] with the recommendation: To Consent Calendar",14,0,0,1,15
1594581,1219478,2022-06-27,Senate,"Do pass as amended, but first amend, and re-refer to the Committee on [Appropriations]",13,0,0,1,14
1594581,1223256,2022-08-08,Senate,"Placed on suspense file",7,0,0,0,7
1594581,1223394,2022-08-11,Senate,"Do pass as amended",7,0,0,0,7
1594581,1224416,2022-08-23,Senate,"Special Consent AB2750",40,0,0,0,40
1594581,1224741,2022-08-24,Assembly,"AB 2750 Mia Bonta Concurrence in Senate Amendments By MCKINNOR",75,0,0,5,80
1594582,1194237,2022-04-27,Assembly,"Do pass as amended and be re-referred to the Committee on [Appropriations]",7,3,0,3,13
1594582,1206913,2022-05-19,Assembly,"Do pass",12,4,0,0,16
1594582,1210424,2022-05-25,Assembly,"AB 2751 Eduardo Garcia Assembly Third Reading",51,18,0,9,78
1594582,1215883,2022-06-14,Senate,"Do pass as amended, but first amend, and re-refer to the Committee on [Energy, Utilities and Communications]",3,5,0,7,15
1594582,1215884,2022-06-14,Senate,"[First] hearing set for [06-14-2022]: Failed passage in Committee. Reconsideration granted",14,0,0,1,15
1594583,1194372,2022-04-27,Assembly,"Do pass and be re-referred to the Committee on [Appropriations] with recommendation: To Consent Calendar",13,0,0,0,13
1594583,1206683,2022-05-19,Assembly,"Do pass",16,0,0,0,16
1594583,1207720,2022-05-23,Assembly,"AB 2752 Wood Assembly Third Reading",71,0,0,7,78
1594583,1219378,2022-06-27,Senate,"Do pass as amended, but first amend, and re-refer to the Committee on [Appropriations]",12,0,0,2,14
1594583,1224977,2022-08-25,Assembly,"With recommendation: That Senate amendments be concurred in, but first be re-referred to Com. on [Privacy and Consumer Protection]",7,0,0,6,13
1594583,1224978,2022-08-25,Senate,"Assembly 3rd Reading AB2752 Wood et al. By McGuire",40,0,0,0,40
1594583,1225173,2022-08-30,Assembly,"With recommendation: That Senate amendments be concurred in",7,0,0,4,11
1594583,1225394,2022-08-31,Assembly,"AB 2752 Wood Concurrence in Senate Amendments",71,0,0,9,80
1594584,1184630,2022-04-06,Assembly,"Do pass and be re-referred to the Committee on [Judiciary]",9,0,0,4,13
1594584,1193157,2022-04-26,Assembly,"Do pass as amended and be re-referred to the Committee on [Appropriations]",7,0,0,3,10
1594585,1193345,2022-04-26,Assembly,"Do pass as amended and be re-referred to the Committee on [Appropriations]",17,0,0,1,18
1594585,1203351,2022-05-11,Assembly,"Do pass. To Consent Calendar",16,0,0,0,16
1594585,1206987,2022-05-19,Assembly,"AB 2754 Bauer-Kahan Consent Calendar Second Day Regular Session",72,0,0,6,78
1594585,1215763,2022-06-13,Senate,"Do pass, but first be re-referred to the Committee on [Appropriations]",13,0,0,1,14
1594585,1223291,2022-08-08,Senate,"Assembly 3rd Reading AB2754 Bauer-Kahan et al. By Becker Urgency Clause",37,0,0,3,40
1594586,1194448,2022-04-27,Assembly,"Do pass as amended and be re-referred to the Committee on [Appropriations]",7,0,0,1,8
1594589,1197961,2022-04-26,Assembly,"Do pass and be re-referred to the Committee on [Appropriations] with recommendation: To Consent Calendar",9,0,0,0,9
1594589,1206988,2022-05-19,Assembly,"Do pass",16,0,0,0,16
1594589,1210592,2022-05-26,Assembly,"AB 2758 O'Donnell Assembly Third Reading By MURATSUCHI",75,0,0,3,78
1594589,1216395,2022-06-15,Senate,"Do pass, but first be re-referred to the Committee on [Appropriations] with the recommendation: To Consent Calendar",7,0,0,0,7
1594589,1222802,2022-08-01,Senate,"Placed on suspense file",7,0,0,0,7
1594592,1189899,2022-04-19,Assembly,"Do pass as amended and be re-referred to the Committee on [Appropriations]",5,0,0,2,7
1594592,1206576,2022-05-19,Assembly,"Do pass",13,2,0,1,16
1594592,1210594,2022-05-26,Assembly,"AB 2761 McCarty Assembly Third Reading",48,9,0,21,78
1594592,1217446,2022-06-21,Senate,"Do pass, but first be re-referred to the Committee on [Appropriations]",4,0,0,1,5
1594592,1223230,2022-08-08,Senate,"Placed on suspense file",7,0,0,0,7
1594592,1223909,2022-08-11,Senate,"Do pass as amended",5,2,0,0,7
1594592,1225338,2022-08-29,Senate,"Assembly 3rd Reading AB2761 McCarty By Durazo",30,10,0,0,40
1594592,1225339,2022-08-30,Assembly,"AB 2761 McCarty Concurrence in Senate Amendments",57,8,0,15,80
1594594,1199937,2022-05-04,Assembly,"Do pass as amended",8,0,0,0,8
1594594,1210354,2022-05-25,Assembly,"AB 2763 Kalra Assembly Third Reading",75,0,0,3,78
1594594,1220743,2022-06-28,Senate,"Do pass and be ordered to the Consent Calendar",17,0,0,0,17
1594594,1224179,2022-08-18,Senate,"Assembly 3rd Reading AB2763 Kalra By Cortese",38,0,0,2,40
1594594,1224262,2022-08-22,Assembly,"AB 2763 Kalra Concurrence in Senate Amendments",77,0,0,3,80
1594596,1190670,2022-04-20,Assembly,"Do pass as amended, and be re-referred to the Committee on [Appropriations] with recommendation: To Consent Calendar",15,0,0,0,15
1594597,1189838,2022-04-19,Assembly,"Do pass",8,1,0,2,11
1594597,1207716,2022-05-23,Assembly,"AB 2766 Maienschein Assembly Third Reading",47,19,0,12,78
1594597,1216312,2022-06-14,Senate,"Do pass as amended",9,2,0,0,11
1594597,1224866,2022-08-24,Senate,"Assembly 3rd Reading AB2766 Maienschein By Hertzberg",29,9,0,2,40
1594597,1224999,2022-08-25,Assembly,"AB 2766 Maienschein Concurrence in Senate Amendments",57,15,0,8,80
1594599,1193263,2022-04-26,Assembly,"Do pass and be re-referred to the Committee on [Appropriations] with recommendation: To Consent Calendar",14,0,0,1,15
1594599,1206236,2022-05-19,Assembly,"Do pass",16,0,0,0,16
1594599,1207827,2022-05-23,Assembly,"AB 2768 Waldron Assembly Third Reading",73,0,0,5,78
1594599,1216401,2022-06-15,Senate,"Do pass, but first be re-referred to the Committee on [Appropriations] with the recommendation: To Consent Calendar",9,0,0,2,11
1594599,1219424,2022-06-27,Senate,"Placed on suspense file",6,0,0,1,7
1594601,1200496,2022-05-05,Assembly,"Do pass and be re-referred to the Committee on [Appropriations]",11,0,0,0,11
1594602,1186491,2022-04-05,Assembly,"Do pass and be re-referred to the Committee on [Health]",6,1,0,2,9
1594602,1193159,2022-04-26,Assembly,"Do pass and be re-referred to the Committee on [Appropriations]",10,2,0,3,15
1594602,1210460,2022-05-26,Assembly,"AB 2771 Friedman Assembly Third Reading",51,13,0,14,78
1594602,1217971,2022-06-22,Senate,"Do pass, but first be re-referred to the Committee on [Health]",5,2,0,0,7
1594602,1221282,2022-06-29,Senate,"Do pass",8,1,0,2,11
1594602,1224343,2022-08-22,Senate,"Assembly 3rd Reading AB2771 Friedman et al. By Leyva",31,7,0,2,40
1594602,1224603,2022-08-23,Assembly,"AB 2771 Friedman Concurrence in Senate Amendments",60,7,0,13,80
1594604,1183652,2022-04-05,Assembly,"Do pass as amended and be re-referred to the Committee on [Transportation]",5,2,0,0,7
1594604,1193193,2022-04-25,Assembly,"Do pass and be re-referred to the Committee on [Appropriations]",10,4,0,1,15
1594604,1206927,2022-05-19,Assembly,"Do pass as amended",12,4,0,0,16
1594604,1210270,2022-05-25,Assembly,"AB 2773 Holden Assembly Third Reading",43,22,0,13,78
1594604,1217463,2022-06-21,Senate,"Do pass, but first be re-referred to the Committee on [Transportation]",4,0,0,1,5
1594604,1220588,2022-06-28,Senate,"Do pass, but first be re-referred to the Committee on [Appropriations]",13,3,0,1,17
1594604,1222758,2022-08-01,Senate,"Placed on suspense file",7,0,0,0,7
1594604,1223972,2022-08-11,Senate,"Do pass as amended",5,1,0,1,7
1594604,1225737,2022-08-29,Senate,"Assembly 3rd Reading AB2773 Holden By Skinner",28,10,0,2,40
1594604,1225738,2022-08-30,Assembly,"AB 2773 Holden Concurrence in Senate Amendments",49,24,0,7,80
1594605,1195757,2022-04-27,Assembly,"Do pass and be re-referred to the Committee on [Appropriations]",7,0,0,0,7
1594605,1206976,2022-05-19,Assembly,"Do pass",16,0,0,0,16
1594605,1210586,2022-05-26,Assembly,"AB 2774 Akilah Weber Assembly Third Reading",75,0,0,3,78
1594605,1221301,2022-06-30,Senate,"Do pass as amended, but first amend, and re-refer to the Committee on [Appropriations]",7,0,0,0,7
1594605,1223178,2022-08-08,Senate,"Placed on suspense file",7,0,0,0,7
1594605,1223873,2022-08-11,Senate,"Do pass as amended",7,0,0,0,7
1594605,1225721,2022-08-31,Senate,"Special Consent AB2774",40,0,0,0,40
1594606,1193291,2022-04-25,Assembly,"Do pass and be re-referred to the Committee on [Appropriations]",15,0,0,0,15
1594606,1206898,2022-05-19,Assembly,"Do pass",16,0,0,0,16
1594606,1210373,2022-05-25,Assembly,"AB 2775 Quirk-Silva Assembly Third Reading",76,0,0,2,78
1594606,1216344,2022-06-14,Senate,"Do pass, but first be re-referred to the Committee on [Human Services] with the recommendation: To Consent Calendar",15,0,0,2,17
1594606,1220073,2022-06-27,Senate,"Do pass as amended, but first amend, and re-refer to the Committee on [Appropriations]",4,1,0,0,5
1594606,1222917,2022-08-01,Senate,"Placed on suspense file",7,0,0,0,7
1594606,1223826,2022-08-11,Senate,"Do pass",6,1,0,0,7
1594606,1225881,2022-08-29,Senate,"Assembly 3rd Reading AB2775 Quirk-Silva By Cortese",33,2,0,5,40
1594606,1225882,2022-08-30,Assembly,"AB 2775 Quirk-Silva Concurrence in Senate Amendments",77,0,0,3,80
1594608,1199150,2022-05-03,Assembly,"Do pass as amended",8,0,0,2,10
1594608,1210360,2022-05-25,Assembly,"AB 2777 Wicks Assembly Third Reading",57,0,0,21,78
1594608,1216355,2022-06-14,Senate,"Do pass as amended, but first amend, and re-refer to the Committee on [Appropriations]",9,2,0,0,11
1594608,1219453,2022-06-27,Senate,"Placed on suspense file",6,0,0,1,7
1594608,1223391,2022-08-11,Senate,"Do pass as amended",5,1,0,1,7
1594608,1225005,2022-08-25,Senate,"Assembly 3rd Reading AB2777 Wicks By Lim贸n",35,4,0,1,40
1594608,1225006,2022-08-25,Assembly,"AB 2777 Wicks Concurrence in Senate Amendments",58,0,0,22,80
1594609,1189901,2022-04-19,Assembly,"Do pass as amended, and be re-referred to the Committee on [Appropriations] with recommendation: To Consent Calendar",7,0,0,0,7
1594609,1206363,2022-05-19,Assembly,"Do pass",16,0,0,0,16
1594609,1207786,2022-05-23,Assembly,"AB 2778 McCarty Assembly Third Reading",72,0,0,6,78
1594609,1215916,2022-06-14,Senate,"Do pass, but first be re-referred to the Committee on [Appropriations]",5,0,0,0,5
1594609,1222837,2022-08-01,Senate,"Placed on suspense file",7,0,0,0,7
1594609,1223952,2022-08-11,Senate,"Do pass",7,0,0,0,7
1594609,1225386,2022-08-29,Senate,"Assembly 3rd Reading AB2778 McCarty By Kamlager",39,0,0,1,40
1594609,1225387,2022-08-30,Assembly,"AB 2778 McCarty Concurrence in Senate Amendments",78,0,0,2,80
1594610,1189295,2022-04-18,Assembly,"Do pass and be re-referred to the Committee on [Appropriations] with recommendation: To Consent Calendar",11,0,0,0,11
1594610,1206280,2022-05-19,Assembly,"Do pass",16,0,0,0,16
1594610,1207721,2022-05-23,Assembly,"AB 2779 Irwin Assembly Third Reading",74,0,0,4,78
1594610,1215017,2022-06-08,Senate,"Do pass, but first be re-referred to the Committee on [Appropriations]",5,0,0,2,7
1594610,1217049,2022-06-20,Senate,"Placed on suspense file",4,0,0,3,7
1594611,1199982,2022-05-04,Assembly,"Do pass as amended",6,2,0,0,8
1594611,1204111,2022-05-12,Assembly,"AB 2780 Arambula Assembly Third Reading",51,11,0,16,78
1594611,1217843,2022-06-22,Senate,"Do pass",4,1,0,0,5
1594611,1225809,2022-08-29,Senate,"Assembly 3rd Reading AB2780 Arambula By Hurtado",31,8,0,1,40
1594611,1225810,2022-08-30,Assembly,"AB 2780 Arambula Concurrence in Senate Amendments",60,14,0,6,80
1594611,1229708,2022-08-30,Senate,"Assembly 3rd Reading AB2780 Arambula By Hurtado",31,8,0,1,40
1594612,1189869,2022-04-19,Assembly,"Do pass and be re-referred to the Committee on [Appropriations]",11,0,0,0,11
1594612,1206869,2022-05-19,Assembly,"Do pass",16,0,0,0,16
1594612,1210575,2022-05-26,Assembly,"AB 2781 Cunningham Assembly Third Reading",74,0,0,4,78
1594612,1215867,2022-06-14,Senate,"Do pass, but first be re-referred to the Committee on [Labor, Public Employment and Retirement ] with the recommendation: To Consent Calendar",14,0,0,1,15
1594612,1220862,2022-06-29,Senate,"Do pass, but first be re-referred to the Committee on [Appropriations]",5,0,0,0,5
1594612,1222688,2022-08-01,Senate,"Placed on suspense file",7,0,0,0,7
1594615,1182508,2022-04-04,Assembly,"Do pass and be re-referred to the Committee on [Appropriations]",7,3,0,0,10
1594615,1206771,2022-05-19,Assembly,"Do pass as amended",12,4,0,0,16
1594615,1210590,2022-05-26,Assembly,"AB 2784 Ting Assembly Third Reading",44,19,0,15,78
1594615,1217920,2022-06-22,Senate,"Do pass, but first be re-referred to the Committee on [Judiciary]",5,2,0,0,7
1594615,1220861,2022-06-28,Senate,"Do pass, but first be re-referred to the Committee on [Appropriations]",8,1,0,2,11
1594615,1223243,2022-08-08,Senate,"Placed on suspense file",7,0,0,0,7
1594615,1223665,2022-08-11,Senate,"Do pass",5,2,0,0,7
1594615,1225369,2022-08-29,Senate,"Assembly 3rd Reading AB2784 Ting et al. By Skinner",22,11,0,7,40
1594615,1225370,2022-08-30,Assembly,"AB 2784 Ting Concurrence in Senate Amendments",41,24,0,15,80
1594615,1229724,2022-08-30,Senate,"Assembly 3rd Reading AB2784 Ting et al. By Skinner",22,11,0,7,40
1594617,1183719,2022-04-05,Assembly,"Do pass and be re-referred to the Committee on [Health]",8,0,0,0,8
1594617,1193384,2022-04-26,Assembly,"Do pass and be re-referred to the Committee on [Appropriations] with recommendation: To Consent Calendar",14,0,0,1,15
1594617,1207018,2022-05-19,Assembly,"Do pass",16,0,0,0,16
1594617,1207809,2022-05-23,Assembly,"AB 2786 Stone Assembly Third Reading",73,0,0,5,78
1594617,1215797,2022-06-13,Senate,"Do pass, but first be re-referred to the Committee on [Health] with the recommendation: To Consent Calendar",5,0,0,0,5
1594618,1182497,2022-04-04,Assembly,"Do pass as amended and be re-referred to the Committee on [Environmental Safety and Toxic Materials]",7,3,0,0,10
1594618,1197962,2022-04-26,Assembly,"Do pass and be re-referred to the Committee on [Appropriations]",6,0,0,3,9
1594618,1203336,2022-05-11,Assembly,"Do pass",12,4,0,0,16
1594620,1195738,2022-04-27,Assembly,"Do pass and be re-referred to the Committee on [Appropriations]",8,0,0,0,8
1594620,1205854,2022-05-18,Assembly,"Do pass. To Consent Calendar",15,0,0,1,16
1594620,1210361,2022-05-25,Assembly,"AB 2789 Mullin Consent Calendar Second Day Regular Session",73,0,0,5,78
1594620,1221220,2022-06-29,Senate,"Do pass, but first be re-referred to the Committee on [Appropriations] with the recommendation: To Consent Calendar",5,0,0,0,5
1594620,1223177,2022-08-08,Senate,"Consent Calendar AB2789",36,0,0,4,40
1594621,1183689,2022-04-05,Assembly,"Do pass and be re-referred to the Committee on [Appropriations]",5,2,0,0,7
1594621,1199972,2022-05-04,Assembly,"Do pass",9,4,0,3,16
1594621,1210335,2022-05-26,Assembly,"AB 2790 Wicks Assembly Third Reading",42,23,0,13,78
1594621,1220700,2022-06-28,Senate,"Do pass as amended, but first amend, and re-refer to the Committee on [Appropriations]",4,1,0,0,5
1594621,1222800,2022-08-01,Senate,"Placed on suspense file",7,0,0,0,7
1594622,1183695,2022-04-05,Assembly,"Do pass as amended and be re-referred to the Committee on [Appropriations]",7,1,0,2,10
1594622,1206853,2022-05-19,Assembly,"Do pass",14,1,0,1,16
1594622,1207857,2022-05-23,Assembly,"AB 2791 Bloom Assembly Third Reading",59,1,0,18,78
1594622,1220822,2022-06-28,Senate,"Do pass, but first be re-referred to the Committee on [Appropriations]",10,0,0,1,11
1594622,1223275,2022-08-08,Senate,"Placed on suspense file",7,0,0,0,7
1594622,1224023,2022-08-11,Senate,"Do pass as amended",5,0,0,2,7
1594622,1225755,2022-08-29,Senate,"Assembly 3rd Reading AB2791 Bloom et al. By Rubio",33,1,0,6,40
1594622,1225756,2022-08-30,Assembly,"AB 2791 Bloom Concurrence in Senate Amendments",64,1,0,15,80
1594624,1192212,2022-04-25,Assembly,"Do pass and be re-referred to the Committee on [Appropriations]",7,3,0,1,11
1594624,1206348,2022-05-19,Assembly,"Do pass",12,4,0,0,16
1594624,1210266,2022-05-26,Assembly,"AB 2793 Muratsuchi Assembly Third Reading",33,27,0,18,78
1594625,1195833,2022-04-27,Assembly,"Do pass as amended and be re-referred to the Committee on [Appropriations]",7,0,0,0,7
1594625,1207032,2022-05-19,Assembly,"Do pass",12,2,0,2,16
1594625,1210430,2022-05-26,Assembly,"AB 2794 Gipson Assembly Third Reading",72,0,0,6,78
1594625,1221275,2022-06-30,Senate,"Do pass as amended, but first amend, and re-refer to the Committee on [Appropriations]",6,0,0,1,7
1594625,1223289,2022-08-08,Senate,"Placed on suspense file",7,0,0,0,7
1594628,1190541,2022-04-18,Assembly,"Do pass and be re-referred to the Committee on [Transportation]",9,1,0,1,11
1594628,1193146,2022-04-25,Assembly,"Do pass and be re-referred to the Committee on [Appropriations]",13,1,0,1,15
1594629,1190556,2022-04-20,Assembly,"Do pass as amended and be re-referred to the Committee on [Natural Resources]",8,0,0,0,8
1594629,1205873,2022-05-18,Assembly,"Do pass",15,0,0,1,16
1594629,1207705,2022-05-23,Assembly,"AB 2798 Fong Third Reading Urgency",74,0,0,4,78
1594629,1218034,2022-06-22,Senate,"Do pass as amended, but first amend, and re-refer to the Committee on [Appropriations]",5,0,0,0,5
1594629,1225558,2022-08-31,Senate,"Assembly 3rd Reading AB2798 Fong By Gonzalez Urgency Clause",40,0,0,0,40
1594629,1225559,2022-08-31,Assembly,"AB 2798 FONG, V. Concurrence in Senate Amendments",79,0,0,1,80
1594630,1193274,2022-04-26,Assembly,"Do pass. To Consent Calendar",7,0,0,0,7
1594630,1200687,2022-05-05,Assembly,"AB 2799 Jones-Sawyer Consent Calendar Second Day Regular Session",61,0,0,17,78
1594630,1215784,2022-06-14,Senate,"Do pass",5,0,0,0,5
1594630,1224249,2022-08-18,Senate,"Assembly 3rd Reading AB2799 Jones-Sawyer By Bradford",38,0,0,2,40
1594630,1224369,2022-08-22,Assembly,"AB 2799 Jones-Sawyer Concurrence in Senate Amendments",76,0,0,4,80
1594636,1193250,2022-04-26,Assembly,"Do pass and be re-referred to the Committee on [Appropriations]",15,0,0,0,15
1594636,1206484,2022-05-19,Assembly,"Do pass",14,0,0,2,16
1594636,1207715,2022-05-23,Assembly,"AB 2805 Bauer-Kahan Assembly Third Reading",71,0,0,7,78
1594636,1219970,2022-06-28,Senate,"Do pass as amended, but first amend, and re-refer to the Committee on [Appropriations] with the recommendation: To Consent Calendar",9,0,0,0,9
1594636,1222738,2022-08-01,Senate,"Placed on suspense file",7,0,0,0,7
1594636,1223813,2022-08-11,Senate,"Do pass",6,0,0,1,7
1594636,1224246,2022-08-18,Senate,"Assembly 3rd Reading AB2805 Bauer-Kahan By Stern",38,0,0,2,40
1594636,1224309,2022-08-22,Assembly,"AB 2805 Bauer-Kahan Concurrence in Senate Amendments",74,0,0,6,80
1594637,1183697,2022-04-05,Assembly,"Do pass and be re-referred to the Committee on [Education]",8,0,0,0,8
1594637,1195729,2022-04-27,Assembly,"Do pass as amended, and be re-referred to the Committee on [Appropriations] with recommendation: To Consent Calendar",7,0,0,0,7
1594637,1206586,2022-05-19,Assembly,"Do pass",16,0,0,0,16
1594637,1210355,2022-05-25,Assembly,"AB 2806 Blanca Rubio Assembly Third Reading",76,0,0,2,78
1594637,1216316,2022-06-15,Senate,"Do pass, but first be re-referred to the Committee on [Human Services]",6,0,0,1,7
1594637,1219979,2022-06-27,Senate,"Do pass, but first be re-referred to the Committee on [Appropriations]",5,0,0,0,5
1594637,1222670,2022-08-01,Senate,"Placed on suspense file",7,0,0,0,7
1594637,1223993,2022-08-11,Senate,"Do pass as amended",7,0,0,0,7
1594637,1225196,2022-08-29,Senate,"Assembly 3rd Reading AB2806 Blanca Rubio et al. By Rubio",40,0,0,0,40
1594637,1225197,2022-08-30,Assembly,"AB 2806 Blanca Rubio Concurrence in Senate Amendments",78,0,0,2,80
1594638,1189964,2022-04-18,Assembly,"Do pass as amended and be re-referred to the Committee on [Appropriations]",14,0,0,1,15
1594638,1203350,2022-05-11,Assembly,"Do pass. To Consent Calendar",16,0,0,0,16
1594638,1206325,2022-05-19,Assembly,"AB 2807 Mia Bonta Consent Calendar Second Day Regular Session",72,0,0,6,78
1594638,1216345,2022-06-14,Senate,"Do pass as amended, but first amend, and re-refer to the Committee on [Environmental Quality]",14,0,0,3,17
1594638,1220815,2022-06-29,Senate,"Do pass, but first be re-referred to the Committee on [Appropriations] with the recommendation: To Consent Calendar",7,0,0,0,7
1594638,1222703,2022-08-01,Senate,"Placed on suspense file",7,0,0,0,7
1594641,1190655,2022-04-19,Assembly,"Do pass and be re-referred to the Committee on [Human Services]",12,0,0,0,12
1594641,1193386,2022-04-26,Assembly,"Do pass and be re-referred to the Committee on [Appropriations] with recommendation: To Consent Calendar",7,0,0,1,8
1594641,1206458,2022-05-19,Assembly,"Do pass",16,0,0,0,16
1594641,1207764,2022-05-23,Assembly,"AB 2810 Arambula Assembly Third Reading",73,0,0,5,78
1594641,1216247,2022-06-15,Senate,"Do pass, but first be re-referred to the Committee on [Appropriations] with the recommendation: To Consent Calendar",6,0,0,1,7
1594641,1219522,2022-06-27,Senate,"Placed on suspense file",6,0,0,1,7
1594641,1224056,2022-08-11,Senate,"Do pass",6,0,0,1,7
1594641,1224725,2022-08-24,Senate,"Assembly 3rd Reading AB2810 Arambula et al. By Min",40,0,0,0,40
1594643,1180243,2022-03-30,Assembly,"Do pass. To Consent Calendar",19,0,0,3,22
1594643,1186264,2022-04-07,Assembly,"AB 2812 Bigelow Consent Calendar Second Day Regular Session",65,0,0,12,77
1594643,1215793,2022-06-14,Senate,"Do pass and be ordered to the Consent Calendar",14,0,0,1,15
1594645,1176499,2022-03-23,Assembly,"Do pass and be re-referred to the Committee on [Appropriations]",7,0,0,0,7
1594645,1206968,2022-05-19,Assembly,"Do pass",16,0,0,0,16
1594645,1207699,2022-05-23,Assembly,"AB 2814 Wood Assembly Third Reading",73,0,0,5,78
1594645,1217916,2022-06-22,Senate,"Do pass, but first be re-referred to the Committee on [Appropriations] with the recommendation: To Consent Calendar",6,0,0,1,7
1594645,1222710,2022-08-01,Senate,"Placed on suspense file",7,0,0,0,7
1594645,1224041,2022-08-11,Senate,"Do pass",7,0,0,0,7
1594645,1224551,2022-08-23,Senate,"Special Consent AB2814",40,0,0,0,40
1594646,1184697,2022-04-06,Assembly,"Do pass as amended and be re-referred to the Committee on [Appropriations]",6,0,0,1,7
1594646,1207002,2022-05-19,Assembly,"Do pass",12,4,0,0,16
1594646,1207690,2022-05-23,Assembly,"AB 2815 Berman Assembly Third Reading By LOW",54,14,0,10,78
1594646,1217483,2022-06-21,Senate,"Do pass, but first be re-referred to the Committee on [Appropriations]",4,1,0,0,5
1594646,1222692,2022-08-01,Senate,"Placed on suspense file",7,0,0,0,7
1594646,1223614,2022-08-11,Senate,"Do pass",4,1,0,2,7
1594646,1224923,2022-08-25,Senate,"Assembly 3rd Reading AB2815 Berman By Lim贸n",31,8,0,1,40
1594647,1189916,2022-04-18,Assembly,"Do pass and be re-referred to the Committee on [Natural Resources]",12,2,0,1,15
1594647,1192189,2022-04-25,Assembly,"Do pass as amended and be re-referred to the Committee on [Appropriations]",9,1,0,1,11
1594648,1194338,2022-04-27,Assembly,"Do pass and be re-referred to the Committee on [Appropriations]",6,1,0,1,8
1594648,1206480,2022-05-19,Assembly,"Do pass as amended",12,4,0,0,16
1594648,1210404,2022-05-25,Assembly,"AB 2817 Reyes Assembly Third Reading",57,12,0,9,78
1594648,1217850,2022-06-21,Senate,"Do pass, but first be re-referred to the Committee on [Human Services]",7,0,0,2,9
1594648,1219875,2022-06-27,Senate,"Do pass as amended, but first amend, and re-refer to the Committee on [Appropriations]",4,1,0,0,5
1594648,1222876,2022-08-01,Senate,"Placed on suspense file",7,0,0,0,7
1594648,1223474,2022-08-11,Senate,"Do pass",5,2,0,0,7
1594648,1224627,2022-08-23,Senate,"Assembly 3rd Reading AB2817 Reyes et al. By Wiener",31,9,0,0,40
1594648,1224739,2022-08-24,Assembly,"AB 2817 Reyes Concurrence in Senate Amendments By ALVAREZ",61,8,0,11,80
1594649,1193324,2022-04-26,Assembly,"Do pass as amended, and be re-referred to the Committee on [Appropriations] with recommendation: To Consent Calendar",14,0,0,1,15
1594650,1182511,2022-04-04,Assembly,"Do pass and be re-referred to the Committee on [Jobs, Economic Development, and the Economy]",7,0,0,0,7
1594650,1193240,2022-04-26,Assembly,"Do pass and be re-referred to the Committee on [Appropriations] with recommendation: To Consent Calendar",6,0,0,0,6
1594651,1194439,2022-04-26,Assembly,"Do pass and be re-referred to the Committee on [Appropriations]",9,0,0,3,12
1594651,1203318,2022-05-11,Assembly,"Do pass",15,0,0,1,16
1594651,1204589,2022-05-16,Assembly,"AB 2820 Medina Assembly Third Reading",60,0,0,18,78
1594652,1190494,2022-04-19,Assembly,"Do pass as amended and be re-referred to the Committee on [Appropriations]",12,0,0,0,12
1594652,1199923,2022-05-04,Assembly,"Do pass. To Consent Calendar",14,0,0,2,16
1594652,1204092,2022-05-12,Assembly,"AB 2821 Nazarian Consent Calendar Second Day Regular Session",65,0,0,13,78
1594652,1215011,2022-06-08,Senate,"Do pass, but first be re-referred to the Committee on [Appropriations]",6,0,0,1,7
1594652,1223160,2022-08-08,Senate,"Assembly 3rd Reading AB2821 Nazarian By Cortese Urgency Clause",37,0,0,3,40
1594654,1174542,2022-03-22,Assembly,"Do pass as amended and be re-referred to the Committee on [Appropriations]",13,0,0,1,14
1594654,1206525,2022-05-19,Assembly,"Do pass",15,0,0,1,16
1594654,1207884,2022-05-23,Assembly,"AB 2823 Levine Assembly Third Reading",72,0,0,6,78
1594654,1215040,2022-06-08,Senate,"Do pass as amended, but first amend, and re-refer to the Committee on [Appropriations] with the recommendation: To Consent Calendar",9,0,0,2,11
1594654,1219511,2022-06-27,Senate,"Placed on suspense file",6,0,0,1,7
1594658,1183604,2022-04-05,Assembly,"Do pass as amended, and be re-referred to the Committee on [Education] with recommendation: To Consent Calendar",8,0,0,0,8
1594658,1191323,2022-04-20,Assembly,"Do pass and be re-referred to the Committee on [Appropriations] with recommendation: To Consent Calendar",7,0,0,0,7
1594658,1206457,2022-05-19,Assembly,"Do pass",16,0,0,0,16
1594658,1207698,2022-05-23,Assembly,"AB 2827 Quirk-Silva Assembly Third Reading",73,0,0,5,78
1594658,1215764,2022-06-13,Senate,"Do pass, but first be re-referred to the Committee on [Education] with the recommendation: To Consent Calendar",5,0,0,0,5
1594658,1220706,2022-06-29,Senate,"Do pass, but first be re-referred to the Committee on [Appropriations] with the recommendation: To Consent Calendar",6,0,0,1,7
1594658,1222899,2022-08-01,Senate,"Placed on suspense file",7,0,0,0,7
1594658,1223774,2022-08-11,Senate,"Do pass",7,0,0,0,7
1594658,1224447,2022-08-23,Senate,"Special Consent AB2827",40,0,0,0,40
1594658,1224757,2022-08-24,Assembly,"AB 2827 Quirk-Silva Concurrence in Senate Amendments",76,0,0,4,80
1594660,1189963,2022-04-19,Assembly,"Do pass as amended, and be re-referred to the Committee on [Appropriations] with recommendation: To Consent Calendar",9,0,0,2,11
1594663,1193195,2022-04-26,Assembly,"Do pass and be re-referred to the Committee on [Appropriations]",7,0,0,1,8
1594663,1206696,2022-05-19,Assembly,"Do pass as amended",12,0,0,4,16
1594663,1210436,2022-05-26,Assembly,"AB 2832 Robert Rivas Assembly Third Reading",74,0,0,4,78
1594663,1217342,2022-06-20,Senate,"Do pass, but first be re-referred to the Committee on [Education] with the recommendation: To Consent Calendar",4,0,0,1,5
1594663,1220713,2022-06-29,Senate,"Do pass as amended, but first amend, and re-refer to the Committee on [Appropriations] with the recommendation: To Consent Calendar",6,0,0,1,7
1594663,1222835,2022-08-01,Senate,"Placed on suspense file",7,0,0,0,7
1594663,1223995,2022-08-11,Senate,"Do pass as amended",7,0,0,0,7
1594663,1224524,2022-08-23,Senate,"Assembly 3rd Reading AB2832 Robert Rivas et al. By Rubio",40,0,0,0,40
1594663,1224711,2022-08-24,Assembly,"AB 2832 Robert Rivas Concurrence in Senate Amendments",76,0,0,4,80
1594664,1193437,2022-04-26,Assembly,"Do pass as amended, and be re-referred to the Committee on [Appropriations] with recommendation: To Consent Calendar",14,0,0,1,15
1594664,1206374,2022-05-19,Assembly,"Do pass",16,0,0,0,16
1594664,1207758,2022-05-23,Assembly,"AB 2833 Irwin Assembly Third Reading",73,0,0,5,78
1594665,1193341,2022-04-26,Assembly,"Do pass as amended, and be re-referred to the Committee on [Appropriations] with recommendation: To Consent Calendar",9,0,0,1,10
1594667,1189999,2022-04-18,Assembly,"Do pass and be re-referred to the Committee on [Natural Resources]",12,0,0,3,15
1594667,1192219,2022-04-25,Assembly,"Do pass and be re-referred to the Committee on [Appropriations]",9,0,0,2,11
1594667,1206839,2022-05-19,Assembly,"Do pass as amended",13,0,0,3,16
1594667,1210508,2022-05-25,Assembly,"AB 2836 Eduardo Garcia Assembly Third Reading",65,0,0,13,78
1594667,1216352,2022-06-14,Senate,"Do pass, but first be re-referred to the Committee on [Environmental Quality]",14,0,0,3,17
1594667,1217988,2022-06-22,Senate,"Do pass, but first be re-referred to the Committee on [Appropriations]",7,0,0,0,7
1594667,1222827,2022-08-01,Senate,"Placed on suspense file",7,0,0,0,7
1594667,1223770,2022-08-11,Senate,"Do pass",7,0,0,0,7
1594667,1224903,2022-08-25,Senate,"Assembly 3rd Reading AB2836 Eduardo Garcia By Wieckowski",39,0,0,1,40
1594668,1184695,2022-04-05,Assembly,"Do pass and be re-referred to the Committee on [Transportation]",8,0,0,1,9
1594668,1193403,2022-04-25,Assembly,"Do pass and be re-referred to the Committee on [Appropriations]",15,0,0,0,15
1594669,1184721,2022-04-06,Assembly,"Do pass as amended, and be re-referred to the Committee on [Appropriations] with recommendation: To Consent Calendar",12,0,0,3,15
1594669,1194221,2022-04-27,Assembly,"Do pass. To Consent Calendar",15,0,0,1,16
1594669,1200688,2022-05-05,Assembly,"AB 2838 O'Donnell Consent Calendar Second Day Regular Session",61,0,0,17,78
1594669,1216267,2022-06-15,Senate,"Do pass as amended, but first amend, and re-refer to the Committee on [Appropriations]",12,0,0,2,14
1594669,1223214,2022-08-08,Senate,"Placed on suspense file",7,0,0,0,7
1594669,1223869,2022-08-11,Senate,"Do pass",7,0,0,0,7
1594669,1224571,2022-08-23,Senate,"Special Consent AB2838",40,0,0,0,40
1594669,1224648,2022-08-24,Assembly,"AB 2838 O'Donnell Concurrence in Senate Amendments",76,0,0,4,80
1594671,1190721,2022-04-20,Assembly,"Do pass as amended and be re-referred to the Committee on [Housing and Community Development]",5,1,0,2,8
1594671,1203338,2022-05-11,Assembly,"Do pass",12,4,0,0,16
1594671,1210384,2022-05-26,Assembly,"AB 2840 Reyes Assembly Third Reading",41,25,0,12,78
1594672,1184698,2022-04-06,Assembly,"Do pass and be re-referred to the Committee on [Appropriations]",6,1,0,0,7
1594672,1206713,2022-05-19,Assembly,"Do pass as amended",12,4,0,0,16
1594672,1210558,2022-05-25,Assembly,"AB 2841 Low Assembly Third Reading",56,17,0,5,78
1594672,1217449,2022-06-21,Senate,"Do pass, but first be re-referred to the Committee on [Judiciary]",4,1,0,0,5
1594672,1220620,2022-06-28,Senate,"Do pass, but first be re-referred to the Committee on [Appropriations]",9,1,0,1,11
1594672,1222912,2022-08-01,Senate,"Placed on suspense file",7,0,0,0,7
1594672,1223773,2022-08-11,Senate,"Do pass as amended",5,2,0,0,7
1594672,1225439,2022-08-29,Senate,"Assembly 3rd Reading AB2841 Low et al. By Newman",29,9,0,2,40
1594672,1225440,2022-08-30,Assembly,"AB 2841 Low Concurrence in Senate Amendments",59,18,0,3,80
1594674,1193424,2022-04-26,Assembly,"Do pass as amended, and be re-referred to the Committee on [Appropriations] with recommendation: To Consent Calendar",7,0,0,0,7
1594675,1183693,2022-04-05,Assembly,"Do pass as amended and be re-referred to the Committee on [Governmental Organization]",11,3,0,4,18
1594675,1195813,2022-04-28,Assembly,"Do pass as amended and be re-referred to the Committee on [Appropriations]",14,5,0,3,22
1594676,1183796,2022-04-05,Assembly,"Do pass and be re-referred to the Committee on [Appropriations] with recommendation: To Consent Calendar",9,0,0,1,10
1594676,1206413,2022-05-19,Assembly,"Do pass",16,0,0,0,16
1594676,1210579,2022-05-26,Assembly,"AB 2845 Patterson Assembly Third Reading",74,0,0,4,78
1594676,1217913,2022-06-21,Senate,"Do pass, but first be re-referred to the Committee on [Appropriations] with the recommendation: To Consent Calendar",11,0,0,0,11
1594676,1222679,2022-08-01,Senate,"Placed on suspense file",7,0,0,0,7
1594676,1223408,2022-08-11,Senate,"Do pass as amended",7,0,0,0,7
1594676,1224622,2022-08-23,Senate,"Special Consent AB2845",40,0,0,0,40
1594676,1224796,2022-08-24,Assembly,"AB 2845 Patterson Concurrence in Senate Amendments",76,0,0,4,80
1594678,1190555,2022-04-20,Assembly,"Do pass as amended and be re-referred to the Committee on [Appropriations]",11,2,0,1,14
1594678,1206811,2022-05-19,Assembly,"Do pass as amended",12,4,0,0,16
1594678,1210482,2022-05-26,Assembly,"AB 2847 Eduardo Garcia Assembly Third Reading",56,18,0,4,78
1594678,1218608,2022-06-22,Senate,"Do pass, but first be re-referred to the Committee on [Judiciary]",4,0,0,1,5
1594678,1220763,2022-06-28,Senate,"Do pass, but first be re-referred to the Committee on [Appropriations]",9,1,0,1,11
1594678,1222847,2022-08-01,Senate,"Placed on suspense file",7,0,0,0,7
1594678,1224009,2022-08-11,Senate,"Do pass as amended",5,2,0,0,7
1594678,1224487,2022-08-23,Senate,"Assembly 3rd Reading AB2847 Eduardo Garcia et al By Durazo",31,9,0,0,40
1594678,1224766,2022-08-24,Assembly,"AB 2847 Eduardo Garcia Concurrence in Senate Amendments",56,18,0,6,80
1594679,1180215,2022-03-30,Assembly,"Do pass and be re-referred to the Committee on [Appropriations]",12,0,0,2,14
1594679,1206375,2022-05-19,Assembly,"Do pass",16,0,0,0,16
1594679,1207803,2022-05-23,Assembly,"AB 2848 Santiago Assembly Third Reading",71,0,0,7,78
1594679,1218592,2022-06-22,Senate,"Do pass, but first be re-referred to the Committee on [Appropriations]",4,0,0,1,5
1594679,1224687,2022-08-24,Senate,"Assembly 3rd Reading AB2848 Santiago By Laird",40,0,0,0,40
1594680,1189850,2022-04-18,Assembly,"Do pass and be re-referred to the Committee on [Labor and Employment]",9,3,0,0,12
1594680,1191329,2022-04-20,Assembly,"Do pass and be re-referred to the Committee on [Appropriations]",5,1,0,1,7
1594680,1206612,2022-05-19,Assembly,"Do pass as amended",12,4,0,0,16
1594680,1210442,2022-05-25,Assembly,"AB 2849 Mia Bonta Assembly Third Reading",56,15,0,7,78
1594680,1218650,2022-06-22,Senate,"Do pass, but first be re-referred to the Committee on [Judiciary]",4,0,0,1,5
1594680,1220722,2022-06-28,Senate,"Do pass, but first be re-referred to the Committee on [Appropriations]",9,1,0,1,11
1594680,1222795,2022-08-01,Senate,"Placed on suspense file",7,0,0,0,7
1594680,1223688,2022-08-11,Senate,"Do pass as amended",5,2,0,0,7
1594680,1225228,2022-08-30,Senate,"Assembly 3rd Reading AB2849 Mia Bonta et al. By Becker",31,9,0,0,40
1594680,1225229,2022-08-31,Assembly,"AB 2849 Mia Bonta Concurrence in Senate Amendments",61,14,0,5,80
1594681,1193266,2022-04-26,Assembly,"Do pass and be re-referred to the Committee on [Appropriations] with recommendation: To Consent Calendar",7,0,0,0,7
1594682,1190715,2022-04-20,Assembly,"Do pass and be re-referred to the Committee on [Appropriations] with recommendation: To Consent Calendar",15,0,0,0,15
1594684,1183657,2022-04-05,Assembly,"Do pass as amended and be re-referred to the Committee on [Judiciary]",13,0,0,2,15
1594691,1190546,2022-04-20,Assembly,"Do pass and be re-referred to the Committee on [Appropriations]",4,2,0,0,6
1594694,1190587,2022-04-20,Assembly,"Do pass and be re-referred to the Committee on [Appropriations]",6,2,0,0,8
1594694,1199931,2022-05-04,Assembly,"Do pass",10,4,0,2,16
1594694,1210604,2022-05-26,Assembly,"AB 2863 Wilson Assembly Third Reading",56,17,0,5,78
1594694,1218049,2022-06-21,Senate,"Do pass, but first be re-referred to the Committee on [Appropriations]",7,0,0,2,9
1594694,1224532,2022-08-23,Senate,"Assembly 3rd Reading AB2863 Wilson et al. By Dodd",31,9,0,0,40
1594694,1224815,2022-08-24,Assembly,"AB 2863 Wilson Concurrence in Senate Amendments",58,15,0,7,80
1594695,1190579,2022-04-20,Assembly,"Do pass as amended, and be re-referred to the Committee on [Appropriations] with recommendation: To Consent Calendar",15,0,0,0,15
1594697,1179196,2022-03-29,Assembly,"Do pass and be re-referred to the Committee on [Human Services] with recommendation: To Consent Calendar",10,0,0,0,10
1594697,1193304,2022-04-26,Assembly,"Do pass. To Consent Calendar",7,0,0,1,8
1594697,1200689,2022-05-05,Assembly,"AB 2866 Cunningham Consent Calendar Second Day Regular Session",61,0,0,17,78
1594697,1214977,2022-06-08,Senate,"Do pass, but first be re-referred to the Committee on [Human Services] with the recommendation: To Consent Calendar",9,0,0,2,11
1594697,1217317,2022-06-20,Senate,"Do pass, but first be re-referred to the Committee on [Appropriations]",4,0,0,1,5
1594697,1223219,2022-08-08,Senate,"Special Consent AB2866",36,0,0,4,40
1594699,1190518,2022-04-20,Assembly,"Do pass and be re-referred to the Committee on [Utilities and Energy]",19,0,0,3,22
1594699,1194155,2022-04-27,Assembly,"Do pass and be re-referred to the Committee on [Appropriations]",10,2,0,3,15
1594699,1210491,2022-05-25,Assembly,"AB 2868 Choi Assembly Third Reading",27,8,0,43,78
1594701,1180278,2022-03-30,Assembly,"Do pass and be re-referred to the Committee on [Appropriations] with recommendation: To Consent Calendar",19,0,0,3,22
1594701,1205818,2022-05-18,Assembly,"Do pass. To Consent Calendar",15,0,0,1,16
1594701,1210313,2022-05-25,Assembly,"AB 2870 Santiago Consent Calendar Second Day Regular Session",73,0,0,5,78
1594701,1220577,2022-06-28,Senate,"Do pass as amended, but first amend, and re-refer to the Committee on [Appropriations]",3,1,0,1,5
1594701,1222761,2022-08-01,Senate,"Placed on suspense file",7,0,0,0,7
1594701,1223822,2022-08-11,Senate,"Do pass as amended",5,1,0,1,7
1594701,1224320,2022-08-22,Senate,"Assembly 3rd Reading AB2870 Santiago et al. By Stern",31,5,0,4,40
1594701,1225111,2022-08-29,Assembly,"With recommendation: That Senate amendments be concurred in",5,2,0,0,7
1594701,1225952,2022-08-30,Assembly,"AB 2870 Santiago Concurrence in Senate Amendments",63,14,0,3,80
1594703,1183671,2022-04-05,Assembly,"Do pass as amended, and be re-referred to the Committee on [Appropriations] with recommendation: To Consent Calendar",9,0,0,1,10
1594703,1194349,2022-04-27,Assembly,"Do pass. To Consent Calendar",15,0,0,1,16
1594703,1200690,2022-05-05,Assembly,"AB 2872 Akilah Weber Consent Calendar Second Day Regular Session",61,0,0,17,78
1594703,1214950,2022-06-08,Senate,"Do pass, but first be re-referred to the Committee on [Appropriations] with the recommendation: To Consent Calendar",9,0,0,2,11
1594703,1224444,2022-08-23,Senate,"Assembly 3rd Reading AB2872 Akilah Weber By Rubio",40,0,0,0,40
1594703,1224850,2022-08-24,Assembly,"AB 2872 Akilah Weber Concurrence in Senate Amendments",76,0,0,4,80
1594704,1190586,2022-04-20,Assembly,"Do pass and be re-referred to the Committee on [Jobs, Economic Development, and the Economy]",6,1,0,1,8
1594704,1193360,2022-04-26,Assembly,"Do pass as amended and be re-referred to the Committee on [Appropriations]",4,1,0,1,6
1594704,1206261,2022-05-19,Assembly,"Do pass",12,3,0,1,16
1594704,1207844,2022-05-23,Assembly,"AB 2873 Jones-Sawyer Assembly Third Reading",55,10,0,13,78
1594704,1215813,2022-06-13,Senate,"Do pass, but first be re-referred to the Committee on [Appropriations]",7,2,0,0,9
1594704,1219500,2022-06-27,Senate,"Placed on suspense file",6,0,0,1,7
1594704,1223772,2022-08-11,Senate,"Do pass as amended",5,2,0,0,7
1594704,1224607,2022-08-23,Senate,"Assembly 3rd Reading AB2873 Jones-Sawyer By Gonzalez",31,9,0,0,40
1594704,1224691,2022-08-24,Assembly,"AB 2873 Jones-Sawyer Concurrence in Senate Amendments",57,0,0,23,80
1594708,1197950,2022-04-26,Assembly,"Do pass and be re-referred to the Committee on [Appropriations]",9,0,0,0,9
1594708,1206918,2022-05-19,Assembly,"Do pass",16,0,0,0,16
1594708,1207770,2022-05-23,Assembly,"AB 2877 Eduardo Garcia Assembly Third Reading",72,0,0,6,78
1594708,1220786,2022-06-29,Senate,"Do pass as amended, but first amend, and re-refer to the Committee on [Appropriations] with the recommendation: To Consent Calendar",7,0,0,0,7
1594708,1222749,2022-08-01,Senate,"Placed on suspense file",7,0,0,0,7
1594708,1223776,2022-08-11,Senate,"Do pass",7,0,0,0,7
1594708,1225556,2022-08-30,Senate,"Assembly 3rd Reading AB2877 Eduardo Garcia et al By Allen",40,0,0,0,40
1594708,1225557,2022-08-31,Assembly,"AB 2877 Eduardo Garcia Concurrence in Senate Amendments",80,0,0,0,80
1594709,1189290,2022-04-18,Assembly,"Do pass as amended and be re-referred to the Committee on [Utilities and Energy]",11,0,0,0,11
1594709,1194366,2022-04-27,Assembly,"Do pass as amended, and be re-referred to the Committee on [Appropriations] with recommendation: To Consent Calendar",14,0,0,1,15
1594709,1206722,2022-05-19,Assembly,"Do pass as amended",12,0,0,4,16
1594709,1210439,2022-05-26,Assembly,"AB 2878 Aguiar-Curry Assembly Third Reading",74,0,0,4,78
1594709,1217058,2022-06-20,Senate,"Do pass, but first be re-referred to the Committee on [Energy, Utilities and Communications] with the recommendation: To Consent Calendar",7,0,0,2,9
1594709,1219384,2022-06-27,Senate,"Do pass as amended, but first amend, and re-refer to the Committee on [Appropriations]",12,0,0,2,14
1594709,1223296,2022-08-08,Senate,"Placed on suspense file",7,0,0,0,7
1594710,1189867,2022-04-19,Assembly,"Do pass as amended and be re-referred to the Committee on [Judiciary]",9,0,0,2,11
1594710,1193351,2022-04-26,Assembly,"Do pass",8,0,0,2,10
1594710,1200691,2022-05-05,Assembly,"AB 2879 Low Assembly Third Reading",55,0,0,23,78
1594710,1220605,2022-06-28,Senate,"Do pass as amended, but first amend, and re-refer to the Committee on [Appropriations]",9,0,0,2,11
1594710,1222766,2022-08-01,Senate,"Placed on suspense file",7,0,0,0,7
1594710,1224001,2022-08-11,Senate,"Do pass as amended",6,0,0,1,7
1594710,1225679,2022-08-29,Senate,"Assembly 3rd Reading AB2879 Low et al. By Wiener",38,0,0,2,40
1594710,1225680,2022-08-30,Assembly,"AB 2879 Low Concurrence in Senate Amendments",67,1,0,12,80
1594711,1190619,2022-04-18,Assembly,"Do pass and be re-referred to the Committee on [Higher Education]",9,0,0,2,11
1594711,1194241,2022-04-26,Assembly,"Do pass and be re-referred to the Committee on [Appropriations]",12,0,0,0,12
1594711,1206408,2022-05-19,Assembly,"Do pass",16,0,0,0,16
1594711,1207881,2022-05-23,Assembly,"AB 2880 Mia Bonta Assembly Third Reading By HANEY",73,0,0,5,78
1594711,1216296,2022-06-15,Senate,"Do pass as amended, but first amend, and re-refer to the Committee on [Appropriations]",5,0,0,0,5
1594711,1219446,2022-06-27,Senate,"Placed on suspense file",6,0,0,1,7
1594711,1223963,2022-08-11,Senate,"Do pass",7,0,0,0,7
1594711,1224493,2022-08-23,Senate,"Special Consent AB2880",40,0,0,0,40
1594711,1224800,2022-08-24,Assembly,"AB 2880 Mia Bonta Concurrence in Senate Amendments",76,0,0,4,80
1594712,1190669,2022-04-19,Assembly,"Do pass and be re-referred to the Committee on [Human Services]",12,0,0,0,12
1594712,1206518,2022-05-19,Assembly,"Do pass",16,0,0,0,16
1594712,1207867,2022-05-23,Assembly,"AB 2881 Berman Assembly Third Reading By MEDINA",73,0,0,5,78
1594712,1220715,2022-06-29,Senate,"Do pass, but first be re-referred to the Committee on [Appropriations] with the recommendation: To Consent Calendar",6,0,0,1,7
1594712,1223304,2022-08-08,Senate,"Placed on suspense file",7,0,0,0,7
1594712,1223558,2022-08-11,Senate,"Do pass as amended",6,0,0,1,7
1594712,1224481,2022-08-23,Senate,"Special Consent AB2881",40,0,0,0,40
1594712,1224801,2022-08-24,Assembly,"AB 2881 Berman Concurrence in Senate Amendments",75,0,0,5,80
1594714,1193385,2022-04-26,Assembly,"Do pass as amended, and be re-referred to the Committee on [Appropriations] with recommendation: To Consent Calendar",7,0,0,0,7
1594716,1184639,2022-04-06,Assembly,"Do pass and be re-referred to the Committee on [Emergency Management]",7,0,0,0,7
1594716,1192211,2022-04-25,Assembly,"Do pass and be re-referred to the Committee on [Appropriations] with recommendation: To Consent Calendar",7,0,0,0,7
1594718,1200493,2022-05-05,Assembly,"Do pass as amended and be re-referred to the Committee on [Appropriations]",11,0,0,0,11
1594718,1206466,2022-05-19,Assembly,"Do pass",16,0,0,0,16
1594718,1210503,2022-05-25,Assembly,"AB 2887 Eduardo Garcia Assembly Third Reading",76,0,0,2,78
1594718,1221352,2022-06-29,Senate,"Do pass, but first be re-referred to the Committee on [Appropriations]",5,0,0,0,5
1594718,1222929,2022-08-01,Senate,"Placed on suspense file",7,0,0,0,7
1594718,1223579,2022-08-11,Senate,"Do pass",7,0,0,0,7
1594718,1224592,2022-08-23,Senate,"Special Consent AB2887",40,0,0,0,40
1594720,1190537,2022-04-20,Assembly,"Do pass as amended and be re-referred to the Committee on [Appropriations]",14,0,0,1,15
1594721,1195801,2022-04-27,Assembly,"Do pass",6,0,0,2,8
1594721,1207718,2022-05-23,Assembly,"AB 2890 Bloom Assembly Third Reading",73,0,0,5,78
1594721,1217856,2022-06-22,Senate,"Do pass and be ordered to the Consent Calendar",5,0,0,0,5
1594721,1221337,2022-06-30,Senate,"Consent Calendar AB2890",37,0,0,3,40
1594724,1194337,2022-04-27,Assembly,"Do pass and be re-referred to the Committee on [Appropriations]",7,0,0,0,7
1594724,1206914,2022-05-19,Assembly,"Do pass",16,0,0,0,16
1594724,1210495,2022-05-25,Assembly,"AB 2893 Daly Assembly Third Reading",76,0,0,2,78
1594724,1219916,2022-06-28,Senate,"Do pass, but first be re-referred to the Committee on [Appropriations] with the recommendation: To Consent Calendar",13,0,0,2,15
1594724,1222839,2022-08-01,Senate,"Placed on suspense file",7,0,0,0,7
1594725,1183678,2022-04-05,Assembly,"Do pass and be re-referred to the Committee on [Insurance]",13,2,0,3,18
1594725,1190608,2022-04-20,Assembly,"Do pass and be re-referred to the Committee on [Appropriations]",13,0,0,1,14
1594725,1199948,2022-05-04,Assembly,"Do pass",12,2,0,2,16
1594725,1210515,2022-05-25,Assembly,"AB 2894 Cooper Assembly Third Reading",65,0,0,13,78
1594725,1219461,2022-06-27,Senate,"Do pass, but first be re-referred to the Committee on [Appropriations]",12,1,0,1,14
1594725,1222655,2022-08-01,Senate,"Placed on suspense file",7,0,0,0,7
1594726,1193244,2022-04-26,Assembly,"Do pass as amended and be re-referred to the Committee on [Appropriations]",11,0,0,4,15
1594726,1206275,2022-05-19,Assembly,"Do pass",12,2,0,2,16
1594726,1210602,2022-05-26,Assembly,"AB 2895 Arambula Assembly Third Reading",50,19,0,9,78
1594726,1217050,2022-06-20,Senate,"Do pass as amended, but first amend, and re-refer to the Committee on [Appropriations]",7,0,0,2,9
1594726,1225929,2022-08-29,Senate,"Assembly 3rd Reading AB2895 Arambula By Dodd",38,0,0,2,40
1594726,1225930,2022-08-30,Assembly,"AB 2895 Arambula Concurrence in Senate Amendments",69,1,0,10,80
1594726,1229725,2022-08-30,Senate,"Assembly 3rd Reading AB2895 Arambula By Dodd",38,0,0,2,40
1594729,1184708,2022-04-05,Assembly,"Do pass and be re-referred to the Committee on [Revenue and Taxation]",8,0,0,1,9
1594729,1200524,2022-05-05,Assembly,"Do pass and be re-referred to the Committee on [Appropriations]",11,0,0,0,11
1594730,1189904,2022-04-19,Assembly,"Do pass as amended, and be re-referred to the Committee on [Appropriations] with recommendation: To Consent Calendar",9,0,0,2,11
1594730,1199929,2022-05-04,Assembly,"Do pass. To Consent Calendar",14,0,0,2,16
1594730,1204131,2022-05-12,Assembly,"AB 2899 Ting Consent Calendar Second Day Regular Session",65,0,0,13,78
1594730,1214993,2022-06-08,Senate,"Do pass, but first be re-referred to the Committee on [Appropriations] with the recommendation: To Consent Calendar",9,0,0,2,11
1594730,1221299,2022-06-30,Senate,"Consent Calendar AB2899",37,0,0,3,40
1594731,1194240,2022-04-27,Assembly,"Do pass and be re-referred to the Committee on [Appropriations]",7,0,0,0,7
1594734,1191239,2022-04-20,Assembly,"Do pass and be re-referred to the Committee on [Appropriations]",6,0,0,1,7
1594735,1193361,2022-04-26,Assembly,"Do pass as amended and be re-referred to the Committee on [Appropriations]",13,0,0,2,15
1594735,1203358,2022-05-11,Assembly,"Do pass. To Consent Calendar",16,0,0,0,16
1594735,1206772,2022-05-19,Assembly,"AB 2904 Mia Bonta Consent Calendar Second Day Regular Session",72,0,0,6,78
1594735,1221332,2022-06-29,Senate,"Do pass as amended, but first amend, and re-refer to the Committee on [Appropriations] with the recommendation: To Consent Calendar",10,0,0,1,11
1594735,1223201,2022-08-08,Senate,"Placed on suspense file",7,0,0,0,7
1594735,1223623,2022-08-11,Senate,"Do pass",7,0,0,0,7
1594735,1224501,2022-08-23,Senate,"Special Consent AB2904",40,0,0,0,40
1594735,1224829,2022-08-24,Assembly,"AB 2904 Mia Bonta Concurrence in Senate Amendments",76,0,0,4,80
1594737,1184685,2022-04-06,Assembly,"Do pass. To Consent Calendar",12,0,0,1,13
1594737,1191310,2022-04-21,Assembly,"AB 2906 Patterson Consent Calendar Second Day Regular Session",68,0,0,9,77
1594737,1210948,2022-05-31,Senate,"Do pass and be ordered to the Consent Calendar",11,0,0,3,14
1594737,1215291,2022-06-09,Senate,"Consent Calendar AB2906",38,0,0,2,40
1594741,1189316,2022-04-18,Assembly,"Do pass as amended and be re-referred to the Committee on [Judiciary]",8,2,0,1,11
1594741,1193388,2022-04-26,Assembly,"Do pass and be re-referred to the Committee on [Appropriations]",8,1,0,1,10
1594741,1206710,2022-05-19,Assembly,"Do pass",13,3,0,0,16
1594741,1210576,2022-05-26,Assembly,"AB 2910 Santiago Assembly Third Reading",52,17,0,9,78
1594741,1217974,2022-06-22,Senate,"Do pass as amended, but first amend, and re-refer to the Committee on [Judiciary]",5,2,0,0,7
1594741,1220821,2022-06-28,Senate,"Do pass, but first be re-referred to the Committee on [Appropriations]",9,1,0,1,11
1594741,1222860,2022-08-01,Senate,"Placed on suspense file",7,0,0,0,7
1594741,1223997,2022-08-11,Senate,"Do pass as amended",5,2,0,0,7
1594742,1194444,2022-04-27,Assembly,"Do pass as amended and be re-referred to the Committee on [Appropriations]",13,0,0,2,15
1594743,1199102,2022-05-03,Assembly,"Do pass as amended",8,0,0,3,11
1594743,1204563,2022-05-16,Assembly,"AB 2912 Berman Assembly Third Reading",68,0,0,10,78
1594743,1216315,2022-06-14,Senate,"Do pass and be ordered to the Consent Calendar",11,0,0,0,11
1594743,1225822,2022-08-29,Senate,"Assembly 3rd Reading AB2912 Berman By Gonzalez",38,0,0,2,40
1594743,1225823,2022-08-30,Assembly,"AB 2912 Berman Concurrence in Senate Amendments",77,0,0,3,80
1594747,1189932,2022-04-19,Assembly,"Do pass as amended and be re-referred to the Committee on [Appropriations]",19,0,0,0,19
1594747,1199938,2022-05-04,Assembly,"Do pass",14,0,0,2,16
1594747,1204119,2022-05-12,Assembly,"AB 2916 McCarty Assembly Third Reading",65,0,0,13,78
1594747,1214385,2022-06-06,Senate,"Do pass, but first be re-referred to the Committee on [Appropriations]",10,0,0,4,14
1594747,1224833,2022-08-24,Senate,"Assembly 3rd Reading AB2916 McCarty By Roth",40,0,0,0,40
1594748,1183620,2022-04-05,Assembly,"Do pass and be re-referred to the Committee on [Appropriations] with recommendation: To Consent Calendar",9,0,0,1,10
1594748,1194259,2022-04-27,Assembly,"Do pass",14,0,0,2,16
1594748,1200692,2022-05-05,Assembly,"AB 2917 Mike Fong Assembly Third Reading",63,0,0,15,78
1594748,1214983,2022-06-08,Senate,"Do pass, but first be re-referred to the Committee on [Appropriations] with the recommendation: To Consent Calendar",9,0,0,2,11
1594748,1224127,2022-08-17,Senate,"Assembly 3rd Reading AB2917 Mike Fong By Umberg",38,0,0,2,40
1594748,1224252,2022-08-22,Assembly,"AB 2917 Mike Fong Concurrence in Senate Amendments",76,0,0,4,80
1594751,1194369,2022-04-26,Assembly,"Do pass and be re-referred to the Committee on [Appropriations]",12,0,0,0,12
1594752,1190605,2022-04-20,Assembly,"Do pass and be re-referred to the Committee on [Appropriations] with recommendation: To Consent Calendar",20,0,0,2,22
1594752,1205840,2022-05-18,Assembly,"Do pass. To Consent Calendar",15,0,0,1,16
1594752,1210441,2022-05-25,Assembly,"AB 2921 Santiago Consent Calendar Second Day Regular Session",73,0,0,5,78
1594752,1220069,2022-06-28,Senate,"Do pass, but first be re-referred to the Committee on [Appropriations] with the recommendation: To Consent Calendar",13,0,0,2,15
1594752,1222641,2022-08-01,Senate,"Placed on suspense file",7,0,0,0,7
1594752,1223443,2022-08-11,Senate,"Do pass",7,0,0,0,7
1594752,1225232,2022-08-29,Senate,"Assembly 3rd Reading AB2921 Santiago By Dodd",40,0,0,0,40
1594752,1225233,2022-08-30,Assembly,"AB 2921 Santiago Concurrence in Senate Amendments",78,0,0,2,80
1594756,1183835,2022-04-05,Assembly,"Do pass and be re-referred to the Committee on [Appropriations]",14,0,0,4,18
1594756,1206368,2022-05-19,Assembly,"Do pass as amended",13,1,0,2,16
1594756,1210336,2022-05-25,Assembly,"AB 2925 Cooper Assembly Third Reading",68,0,0,10,78
1594756,1221260,2022-06-29,Senate,"Do pass, but first be re-referred to the Committee on [Appropriations] with the recommendation: To Consent Calendar",10,0,0,1,11
1594756,1223272,2022-08-08,Senate,"Consent Calendar AB2925",36,0,0,4,40
1594756,1225341,2022-08-29,Senate,"Assembly 3rd Reading AB2925 Cooper By Leyva",40,0,0,0,40
1594756,1225342,2022-08-30,Assembly,"AB 2925 Cooper Concurrence in Senate Amendments",76,0,0,4,80
1594757,1181324,2022-03-30,Assembly,"Do pass and be re-referred to the Committee on [Arts, Entertainment, Sports, Tourism, and Internet Media]",4,2,0,0,6
1594760,1190535,2022-04-20,Assembly,"Do pass and be re-referred to the Committee on [Appropriations] with recommendation: To Consent Calendar",15,0,0,0,15
1594762,1192173,2022-04-25,Assembly,"Do pass and be re-referred to the Committee on [Appropriations]",4,3,0,0,7
1594762,1203359,2022-05-11,Assembly,"Do pass",12,3,0,1,16
1594762,1210596,2022-05-26,Assembly,"AB 2931 Bloom Assembly Third Reading",49,17,0,12,78
1594762,1219862,2022-06-28,Senate,"Do pass, but first be re-referred to the Committee on [Appropriations]",8,4,0,3,15
1594762,1224955,2022-08-25,Senate,"Assembly 3rd Reading AB2931 Bloom et al. By Lim贸n",30,8,0,2,40
1594762,1224956,2022-08-25,Assembly,"AB 2931 Bloom Concurrence in Senate Amendments",50,15,0,15,80
1594764,1195836,2022-04-27,Assembly,"Do pass as amended and be re-referred to the Committee on [Appropriations]",7,0,0,0,7
1594764,1206951,2022-05-19,Assembly,"Do pass",16,0,0,0,16
1594764,1210591,2022-05-26,Assembly,"AB 2933 O'Donnell Assembly Third Reading By MCCARTY",75,0,0,3,78
1594768,1190614,2022-04-20,Assembly,"Do pass as amended and be re-referred to the Committee on [Appropriations]",15,0,0,0,15
1594775,1192172,2022-04-25,Assembly,"Do pass as amended and be re-referred to the Committee on [Appropriations]",9,0,0,2,11
1594775,1206535,2022-05-19,Assembly,"Do pass",16,0,0,0,16
1594775,1207804,2022-05-23,Assembly,"AB 2944 Petrie-Norris Assembly Third Reading",70,0,0,8,78
1594775,1216284,2022-06-15,Senate,"Do pass as amended, but first amend, and re-refer to the Committee on [Judiciary]",7,0,0,0,7
1594776,1183792,2022-04-05,Assembly,"Do pass and be re-referred to the Committee on [Appropriations] with recommendation: To Consent Calendar",8,0,0,0,8
1594780,1189972,2022-04-18,Assembly,"Do pass and be re-referred to the Committee on [Military and Veterans Affairs]",14,0,0,1,15
1594780,1193201,2022-04-26,Assembly,"Do pass and be re-referred to the Committee on [Appropriations]",9,0,0,0,9
1594780,1207011,2022-05-19,Assembly,"Do pass",16,0,0,0,16
1594780,1207885,2022-05-23,Assembly,"AB 2949 Lee Assembly Third Reading",73,0,0,5,78
1594780,1216257,2022-06-14,Senate,"Do pass, but first be re-referred to the Committee on [Military and Veterans Affairs] with the recommendation: To Consent Calendar",15,0,0,2,17
1594780,1220012,2022-06-28,Senate,"Do pass as amended, but first amend, and re-refer to the Committee on [Appropriations]",6,0,0,1,7
1594780,1224896,2022-08-25,Senate,"Assembly 3rd Reading AB2949 Lee et al. By Archuleta",40,0,0,0,40
1594780,1224897,2022-08-25,Assembly,"AB 2949 Lee Concurrence in Senate Amendments",75,0,0,5,80
1594781,1200500,2022-05-05,Assembly,"Do pass and be re-referred to the Committee on [Appropriations]",11,0,0,0,11
1594782,1193389,2022-04-26,Assembly,"Do pass and be re-referred to the Committee on [Appropriations]",14,0,0,1,15
1594783,1184711,2022-04-05,Assembly,"Do pass and be re-referred to the Committee on [Transportation]",8,0,0,1,9
1594783,1193315,2022-04-25,Assembly,"Do pass and be re-referred to the Committee on [Appropriations]",10,0,0,5,15
1594784,1189840,2022-04-18,Assembly,"Do pass and be re-referred to the Committee on [Appropriations]",13,0,0,2,15
1594784,1206534,2022-05-19,Assembly,"Do pass",16,0,0,0,16
1594784,1207763,2022-05-23,Assembly,"AB 2953 Salas Assembly Third Reading",70,0,0,8,78
1594784,1216394,2022-06-14,Senate,"Do pass, but first be re-referred to the Committee on [Appropriations]",14,0,0,3,17
1594784,1219441,2022-06-27,Senate,"Placed on suspense file",6,0,0,1,7
1594784,1223987,2022-08-11,Senate,"Do pass as amended",7,0,0,0,7
1594784,1224899,2022-08-25,Senate,"Assembly 3rd Reading AB2953 Salas By Hueso",40,0,0,0,40
1594784,1225115,2022-08-29,Assembly,"AB 2953 Salas Concurrence in Senate Amendments",76,0,0,4,80
1594786,1162248,2022-03-03,Assembly,"Be adopted. To third reading",9,0,0,2,11
1594786,1173506,2022-03-21,Senate,"Special Consent ACR146",37,0,0,3,40
1594787,1217333,2022-06-21,Assembly,"Be adopted. To Consent Calendar",6,0,0,0,6
1594787,1218664,2022-06-23,Assembly,"ACR 147 Lackey Consent Calendar Second Day Regular Session",74,0,0,6,80
1594788,1193311,2022-04-25,Assembly,"Be adopted. To Consent Calendar",15,0,0,0,15
1594788,1195731,2022-04-28,Assembly,"ACR 148 O'Donnell Consent Calendar Second Day Regular Session",71,0,0,6,77
1594788,1220748,2022-06-28,Senate,"Be adopted, but first be re-referred to the Committee on [Appropriations] with recommendation: To Consent Calendar",16,0,0,1,17
1594788,1222756,2022-08-01,Senate,"Placed on suspense file",7,0,0,0,7
1594788,1223743,2022-08-11,Senate,"Be adopted. Ordered to third reading",7,0,0,0,7
1594788,1224504,2022-08-23,Senate,"Special Consent ACR148",40,0,0,0,40
1594789,1191282,2022-04-21,Assembly,"Be adopted. To third reading",9,0,0,2,11
1594789,1192230,2022-04-25,Assembly,"AJR 27 Nazarian Assembly Third Reading",68,0,0,9,77
1594789,1217865,2022-06-21,Senate,"Be adopted. Ordered to third reading",11,0,0,0,11
1594789,1223259,2022-08-08,Senate,"Special Consent AJR27",36,0,0,4,40
1594790,1200516,2022-05-04,Senate,"Do pass, but first be re-referred to the Committee on [Appropriations]",5,0,0,0,5
1594790,1204560,2022-05-16,Senate,"Placed on suspense file",6,0,0,1,7
1594790,1206643,2022-05-19,Senate,"Do pass as amended",7,0,0,0,7
1594790,1209966,2022-05-26,Senate,"Special Consent SB1266",38,0,0,2,40
1594791,1173493,2022-03-21,Senate,"Do pass, but first be re-referred to the Committee on [Appropriations]",12,0,0,2,14
1594791,1182532,2022-04-04,Senate,"Placed on suspense file",6,0,0,1,7
1594791,1206336,2022-05-19,Senate,"Do pass",7,0,0,0,7
1594791,1209373,2022-05-25,Senate,"Special Consent SB1267",39,0,0,1,40
1594791,1215789,2022-06-14,Assembly,"Do pass and be re-referred to the Committee on [Appropriations]",16,0,0,2,18
1594791,1223867,2022-08-11,Assembly,"Do pass as amended",12,0,0,4,16
1594791,1225982,2022-08-30,Senate,"Unfinished Business SB1267 Pan Concurrence",37,0,0,3,40
1594791,1225983,2022-08-30,Assembly,"SB 1267 Pan Senate Third Reading By Cervantes",74,0,0,6,80
1594792,1179266,2022-03-29,Senate,"Do pass, but first be re-referred to the Committee on [Appropriations] with the recommendation: To Consent Calendar",5,0,0,0,5
1594792,1195788,2022-04-28,Senate,"Consent Calendar SB1268",37,0,0,3,40
1594792,1211897,2022-06-01,Assembly,"Do pass as amended, and be re-referred to the Committee on [Appropriations] with recommendation: To Consent Calendar",7,0,0,0,7
1594792,1218000,2022-06-22,Assembly,"Do pass. To Consent Calendar",13,0,0,3,16
1594792,1221586,2022-06-29,Assembly,"SB 1268 Caballero Consent Calendar Second Day Regular Session",78,0,0,2,80
1594792,1223199,2022-08-08,Senate,"Special Consent SB1268",36,0,0,4,40
1594795,1193419,2022-04-26,Senate,"Do pass as amended, but first amend, and re-refer to the Committee on [Appropriations]",12,0,0,3,15
1594795,1201394,2022-05-09,Senate,"Placed on suspense file",7,0,0,0,7
1594795,1206928,2022-05-19,Senate,"Do pass as amended",6,0,0,1,7
1594795,1209991,2022-05-26,Senate,"Special Consent SB1271",38,0,0,2,40
1594795,1220714,2022-06-29,Assembly,"Do pass and be re-referred to the Committee on [Appropriations]",7,0,0,0,7
1594795,1223671,2022-08-11,Assembly,"Do pass as amended",12,0,0,4,16
1594795,1224319,2022-08-22,Assembly,"SB 1271 Wilk Senate Third Reading By Kiley",76,0,0,4,80
1594795,1225873,2022-08-30,Senate,"Special Consent SB1271",38,0,0,2,40
1594796,1194209,2022-04-26,Senate,"Do pass and be ordered to the Consent Calendar",5,0,0,0,5
1594796,1201367,2022-05-09,Senate,"Consent Calendar SB1272",33,0,0,7,40
1594796,1211850,2022-06-01,Assembly,"Do pass. To Consent Calendar",7,0,0,0,7
1594796,1215276,2022-06-09,Assembly,"SB 1272 Becker Consent Calendar Second Day Regular Session",69,0,0,9,78
1594797,1180241,2022-03-30,Senate,"Do pass, but first be re-referred to the Committee on [Public Safety]",3,2,0,2,7
1594797,1180242,2022-03-30,Senate,"[Second] hearing set for [03-30-2022]: Failed passage in Committee. Reconsideration granted",4,0,0,3,7
1594797,1181308,2022-03-30,Senate,"[Second] hearing set for [03-31-2022]: Failed passage in Committee. Reconsideration granted",4,0,0,3,7
1594797,1184657,2022-04-06,Senate,"Do pass, but first be re-referred to the Committee on [Public Safety]",4,2,0,1,7
1594797,1194218,2022-04-26,Senate,"Do pass as amended, but first amend, and re-refer to the Committee on [Appropriations]",4,1,0,0,5
1594797,1207801,2022-05-23,Senate,"Senate 3rd Reading SB1273 Bradford",18,13,0,9,40
1594797,1207802,2022-05-23,Senate,"Senate 3rd Reading SB1273 Bradford Reconsider",35,0,0,5,40
1594797,1210032,2022-05-26,Senate,"Senate 3rd Reading SB1273 Bradford",21,12,0,7,40
1594797,1219880,2022-06-28,Assembly,"Do pass and be re-referred to the Committee on [Education]",5,2,0,0,7
1594799,1183639,2022-04-05,Senate,"Do pass, but first be re-referred to the Committee on [Banking and Financial Institutions]",2,5,0,8,15
1594799,1183640,2022-04-05,Senate,"[First] hearing set for [04-05-2022]: Failed passage in Committee. Reconsideration granted",13,0,0,2,15
1594802,1173540,2022-03-21,Senate,"Do pass, but first be re-referred to the Committee on [Appropriations]",5,0,0,0,5
1594802,1191260,2022-04-21,Senate,"Senate 3rd Reading SB1278 Cortese",39,0,0,1,40
1594802,1216366,2022-06-15,Assembly,"Do pass and be re-referred to the Committee on [Appropriations] with recommendation: To Consent Calendar",7,0,0,0,7
1594803,1199950,2022-05-03,Senate,"Do pass as amended",10,0,0,1,11
1594803,1209263,2022-05-25,Senate,"Senate 3rd Reading SB1279 Ochoa Bogh",39,0,0,1,40
1594803,1219997,2022-06-28,Assembly,"Do pass. To Consent Calendar",11,0,0,0,11
1594803,1224347,2022-08-22,Assembly,"SB 1279 Ochoa Bogh Senate Third Reading By Bloom",77,0,0,3,80
1594803,1225920,2022-08-31,Senate,"Unfinished Business SB1279 Ochoa Bogh Concurrence",40,0,0,0,40
1594804,1179146,2022-03-29,Senate,"Do pass, but first be re-referred to the Committee on [Appropriations]",13,0,0,2,15
1594804,1201353,2022-05-09,Senate,"Senate 3rd Reading SB1280 Hueso et al. Urgency Clause",33,0,0,7,40
1594804,1214987,2022-06-08,Assembly,"Do pass and be re-referred to the Committee on [Appropriations]",21,0,0,1,22
1594804,1217999,2022-06-22,Assembly,"Do pass",15,0,0,1,16
1594804,1223222,2022-08-08,Assembly,"SB 1280 Hueso Third Reading Urgency By Akilah Weber",74,0,0,6,80
1594804,1224109,2022-08-16,Senate,"Unfinished Business SB1280 Hueso et al. Urgency Clause Concurrence",37,0,0,3,40
1594805,1200526,2022-05-04,Senate,"Do pass as amended, but first amend, and re-refer to the Committee on [Appropriations]",4,1,0,0,5
1594805,1204623,2022-05-16,Senate,"Placed on suspense file",6,0,0,1,7
1594805,1206983,2022-05-19,Senate,"Do pass",5,1,0,1,7
1594805,1209239,2022-05-25,Senate,"Senate 3rd Reading SB1281 Bradford",29,1,0,10,40
1594808,1190639,2022-04-19,Senate,"Do pass, but first be re-referred to the Committee on [Housing]",3,0,0,2,5
1594808,1194350,2022-04-27,Senate,"Do pass as amended, but first amend, and re-refer to the Committee on [Appropriations]",2,3,0,4,9
1594808,1194351,2022-04-27,Senate,"[First] hearing set for [04-27-2022]: Failed passage in Committee. Reconsideration granted",9,0,0,0,9
1594812,1184629,2022-04-06,Senate,"Do pass, but first be re-referred to the Committee on [Appropriations]",6,0,0,1,7
1594812,1198280,2022-05-02,Senate,"Placed on suspense file",7,0,0,0,7
1594812,1206855,2022-05-19,Senate,"Do pass",7,0,0,0,7
1594813,1180246,2022-03-30,Senate,"Do pass, but first be re-referred to the Committee on [Human Services]",5,0,0,2,7
1594813,1190496,2022-04-19,Senate,"Do pass, but first be re-referred to the Committee on [Appropriations]",4,0,0,1,5
1594813,1198322,2022-05-02,Senate,"Placed on suspense file",7,0,0,0,7
1594814,1200506,2022-05-04,Senate,"Do pass as amended, but first amend, and re-refer to the Committee on [Appropriations]",3,1,0,1,5
1594814,1204639,2022-05-16,Senate,"Placed on suspense file",6,0,0,1,7
1594814,1206564,2022-05-19,Senate,"Do pass",6,1,0,0,7
1594814,1209250,2022-05-25,Senate,"Senate 3rd Reading SB1290 Allen",23,4,0,13,40
1594814,1220765,2022-06-29,Assembly,"Do pass as amended and be re-referred to the Committee on [Appropriations]",7,0,0,1,8
1594815,1190594,2022-04-20,Senate,"Do pass, but first be re-referred to the Committee on [Transportation]",5,0,0,0,5
1594815,1194204,2022-04-26,Senate,"Do pass, but first be re-referred to the Committee on [Appropriations]",14,0,0,3,17
1594815,1209249,2022-05-25,Senate,"Senate 3rd Reading SB1291 Archuleta et al",37,0,0,3,40
1594815,1216620,2022-06-15,Assembly,"Do pass as amended and be re-referred to the Committee on [Transportation]",8,0,0,0,8
1594815,1219921,2022-06-27,Assembly,"Do pass as amended and be re-referred to the Committee on [Appropriations]",14,0,0,1,15
1594815,1223004,2022-08-03,Assembly,"Do pass. To Consent Calendar",15,0,0,1,16
1594815,1224333,2022-08-22,Assembly,"SB 1291 Archuleta Senate Third Reading By Aguiar-Curry",75,0,0,5,80
1594815,1225620,2022-08-30,Senate,"Special Consent SB1291",38,0,0,2,40
1594817,1200509,2022-05-04,Senate,"Do pass, but first be re-referred to the Committee on [Appropriations]",4,1,0,0,5
1594817,1204576,2022-05-16,Senate,"Placed on suspense file",6,0,0,1,7
1594817,1206545,2022-05-19,Senate,"Do pass",5,2,0,0,7
1594817,1209367,2022-05-25,Senate,"Senate 3rd Reading SB1293 Bradford",27,7,0,6,40
1594817,1217335,2022-06-20,Assembly,"Do pass as amended and be re-referred to the Committee on [Business and Professions]",9,2,0,0,11
1594817,1220080,2022-06-28,Assembly,"Do pass and be re-referred to the Committee on [Appropriations]",14,0,0,4,18
1594818,1194226,2022-04-27,Senate,"Do pass, but first be re-referred to the Committee on [Appropriations]",5,0,0,0,5
1594818,1204611,2022-05-16,Senate,"Placed on suspense file",6,0,0,1,7
1594818,1206974,2022-05-19,Senate,"Do pass",5,2,0,0,7
1594818,1208463,2022-05-24,Senate,"Senate 3rd Reading SB1294 Cortese",29,8,0,3,40
1594818,1216246,2022-06-15,Assembly,"Do pass and be re-referred to the Committee on [Appropriations]",6,0,0,1,7
1594818,1223559,2022-08-11,Assembly,"Do pass as amended",13,0,0,3,16
1594818,1224248,2022-08-18,Assembly,"SB 1294 Cortese Senate Third Reading By Kalra",74,0,0,6,80
1594818,1225003,2022-08-25,Senate,"Unfinished Business SB1294 Cortese et al. Concurrence",32,8,0,0,40
1594819,1183738,2022-04-05,Senate,"Do pass, but first be re-referred to the Committee on [Appropriations]",7,1,0,1,9
1594819,1189367,2022-04-18,Senate,"Placed on suspense file",7,0,0,0,7
1594819,1206695,2022-05-19,Senate,"Do pass as amended",5,2,0,0,7
1594819,1209381,2022-05-25,Senate,"Senate 3rd Reading SB1295 Lim贸n et al",24,9,0,7,40
1594819,1217080,2022-06-20,Assembly,"Do pass and be re-referred to the Committee on [Appropriations]",7,3,0,1,11
1594819,1223564,2022-08-11,Assembly,"Do pass",12,4,0,0,16
1594819,1225968,2022-08-31,Senate,"Unfinished Business SB1295 Lim贸n et al. Concurrence",29,9,0,2,40
1594819,1225969,2022-08-31,Assembly,"SB 1295 Lim贸n Senate Third Reading By Bennett",52,18,0,10,80
1594820,1191341,2022-04-20,Senate,"Do pass, but first be re-referred to the Committee on [Appropriations]",9,0,0,2,11
1594820,1198251,2022-05-02,Senate,"Placed on suspense file",7,0,0,0,7
1594820,1206767,2022-05-19,Senate,"Do pass",6,0,0,1,7
1594820,1208496,2022-05-24,Senate,"Senate 3rd Reading SB1296 Pan",37,0,0,3,40
1594820,1220097,2022-06-28,Assembly,"Do pass and be re-referred to the Committee on [Appropriations]",14,0,0,1,15
1594820,1223871,2022-08-11,Assembly,"Do pass",13,0,0,3,16
1594820,1224298,2022-08-22,Assembly,"SB 1296 Pan Senate Third Reading By Arambula",71,0,0,9,80
1594821,1179130,2022-03-28,Senate,"Do pass as amended, but first amend, and re-refer to the Committee on [Natural Resources and Water]",5,2,0,0,7
1594821,1193235,2022-04-26,Senate,"Do pass as amended, but first amend, and re-refer to the Committee on [Appropriations]",7,1,0,1,9
1594821,1204648,2022-05-16,Senate,"Placed on suspense file",6,0,0,1,7
1594821,1206815,2022-05-19,Senate,"Do pass",5,2,0,0,7
1594821,1208459,2022-05-24,Senate,"Senate 3rd Reading SB1297 Cortese",27,9,0,4,40
1594821,1217054,2022-06-20,Assembly,"Do pass as amended and be re-referred to the Committee on [Appropriations]",8,0,0,3,11
1594822,1191287,2022-04-20,Senate,"Do pass as amended, but first amend, and re-refer to the Committee on [Appropriations] with the recommendation: To Consent Calendar",9,0,0,2,11
1594822,1198258,2022-05-02,Senate,"Placed on suspense file",7,0,0,0,7
1594823,1175535,2022-03-23,Senate,"Do pass as amended",5,0,0,2,7
1594823,1198231,2022-05-02,Senate,"Senate 3rd Reading SB1299 Min et al",36,0,0,4,40
1594823,1216654,2022-06-15,Assembly,"Do pass as amended and be re-referred to the Committee on [Appropriations]",6,0,0,1,7
1594823,1222945,2022-08-03,Assembly,"Do pass. To Consent Calendar",15,0,0,1,16
1594823,1223943,2022-08-11,Assembly,"SB 1299 Min Consent Calendar Second Day Regular Session",76,0,0,4,80
1594823,1224939,2022-08-25,Senate,"Unfinished Business SB1299 Min et al. Concurrence",40,0,0,0,40
1594824,1179233,2022-03-29,Senate,"Do pass, but first be re-referred to the Committee on [Judiciary]",4,0,0,1,5
1594824,1184716,2022-04-05,Senate,"Do pass as amended, but first amend, and re-refer to the Committee on [Appropriations] with the recommendation: To Consent Calendar",10,0,0,1,11
1594824,1192235,2022-04-25,Senate,"Placed on suspense file",5,0,0,2,7
1594824,1206516,2022-05-19,Senate,"Do pass",7,0,0,0,7
1594824,1209371,2022-05-25,Senate,"Special Consent SB1300",39,0,0,1,40
1594824,1219910,2022-06-28,Assembly,"Do pass and be re-referred to the Committee on [Appropriations] with recommendation: To Consent Calendar",7,0,0,1,8
1594825,1200519,2022-05-04,Senate,"Do pass as amended, but first amend, and re-refer to the Committee on [Appropriations]",4,0,0,1,5
1594825,1204603,2022-05-16,Senate,"Placed on suspense file",6,0,0,1,7
1594825,1206508,2022-05-19,Senate,"Do pass as amended",7,0,0,0,7
1594825,1210028,2022-05-26,Senate,"Special Consent SB1301",38,0,0,2,40
1594826,1175519,2022-03-23,Senate,"Do pass, but first be re-referred to the Committee on [Appropriations]",7,0,0,0,7
1594826,1182547,2022-04-04,Senate,"Placed on suspense file",6,0,0,1,7
1594826,1206936,2022-05-19,Senate,"Do pass as amended",6,1,0,0,7
1594826,1209961,2022-05-26,Senate,"Senate 3rd Reading SB1302 Portantino",37,0,0,3,40
1594826,1220596,2022-06-29,Assembly,"Do pass as amended and be re-referred to the Committee on [Appropriations]",6,0,0,1,7
1594826,1223611,2022-08-11,Assembly,"Do pass as amended",12,0,0,4,16
1594826,1225771,2022-08-30,Senate,"Unfinished Business SB1302 Portantino et al. Concurrence",33,0,0,7,40
1594826,1225772,2022-08-30,Assembly,"SB 1302 Portantino Senate Third Reading By Blanca Rubio",78,0,0,2,80
1594828,1174508,2022-03-22,Senate,"Do pass, but first be re-referred to the Committee on [Appropriations]",5,0,0,0,5
1594828,1182502,2022-04-04,Senate,"Placed on suspense file",6,0,0,1,7
1594828,1206501,2022-05-19,Senate,"Do pass as amended",5,0,0,2,7
1594828,1210008,2022-05-26,Senate,"Senate 3rd Reading SB1304 Kamlager",33,0,0,7,40
1594828,1215766,2022-06-14,Assembly,"Do pass and be re-referred to the Committee on [Appropriations]",5,0,0,3,8
1594828,1223434,2022-08-11,Assembly,"Do pass",12,0,0,4,16
1594828,1224855,2022-08-24,Assembly,"SB 1304 Kamlager Senate Third Reading By Quirk",54,0,0,26,80
1594829,1179160,2022-03-29,Senate,"Do pass, but first be re-referred to the Committee on [Appropriations]",12,0,0,3,15
1594829,1201344,2022-05-09,Senate,"Senate 3rd Reading SB1305 Laird et al",30,0,0,10,40
1594829,1216260,2022-06-15,Assembly,"Do pass and be re-referred to the Committee on [Appropriations]",5,0,0,2,7
1594829,1220637,2022-06-29,Assembly,"Do pass",12,2,0,2,16
1594829,1222622,2022-08-01,Assembly,"SB 1305 Laird Senate Third Reading By Boerner Horvath",62,0,0,18,80
1594831,1194142,2022-04-27,Senate,"Do pass, but first be re-referred to the Committee on [Appropriations]",9,0,0,0,9
1594831,1201396,2022-05-09,Senate,"Placed on suspense file",7,0,0,0,7
1594831,1206885,2022-05-19,Senate,"Do pass as amended",7,0,0,0,7
1594831,1209985,2022-05-26,Senate,"Special Consent SB1307",38,0,0,2,40
1594831,1220754,2022-06-29,Assembly,"Do pass and be re-referred to the Committee on [Appropriations] with recommendation: To Consent Calendar",8,0,0,0,8
1594831,1222980,2022-08-03,Assembly,"Do pass. To Consent Calendar",15,0,0,1,16
1594831,1225753,2022-08-30,Senate,"Unfinished Business SB1307 Rubio Concurrence",40,0,0,0,40
1594831,1225754,2022-08-30,Assembly,"SB 1307 Rubio Senate Third Reading By Gabriel",79,0,0,1,80
1594832,1176549,2022-03-24,Senate,"Do pass, but first be re-referred to the Committee on [Governmental Organization]",4,0,0,1,5
1594832,1190578,2022-04-20,Senate,"Do pass, but first be re-referred to the Committee on [Appropriations]",7,0,0,0,7
1594832,1198288,2022-05-02,Senate,"Placed on suspense file",7,0,0,0,7
1594832,1206246,2022-05-19,Senate,"Do pass as amended",6,0,0,1,7
1594832,1210030,2022-05-26,Senate,"Special Consent SB1308",38,0,0,2,40
1594832,1218024,2022-06-22,Assembly,"Do pass and be re-referred to the Committee on [Education]",8,0,0,3,11
1594833,1189837,2022-04-19,Senate,"Do pass as amended, but first amend, and re-refer to the Committee on [Appropriations]",12,3,0,2,17
1594833,1201503,2022-05-09,Senate,"Placed on suspense file",7,0,0,0,7
1594833,1206315,2022-05-19,Senate,"Do pass as amended",5,2,0,0,7
1594833,1209984,2022-05-26,Senate,"Senate 3rd Reading SB1309 Durazo",25,5,0,10,40
1594833,1217898,2022-06-22,Assembly,"Do pass as amended and be re-referred to the Committee on [Appropriations]",19,0,0,3,22
1594833,1223941,2022-08-11,Assembly,"Do pass as amended",12,0,0,4,16
1594833,1226003,2022-08-30,Senate,"Unfinished Business SB1309 Durazo Concurrence",29,6,0,5,40
1594833,1226004,2022-08-30,Assembly,"SB 1309 Durazo Senate Third Reading By Santiago",73,0,0,7,80
1594835,1190634,2022-04-19,Senate,"Do pass, but first be re-referred to the Committee on [Military and Veterans Affairs]",10,0,0,1,11
1594835,1193191,2022-04-26,Senate,"Do pass as amended, but first amend, and re-refer to the Committee on [Appropriations]",5,0,0,2,7
1594835,1204583,2022-05-16,Senate,"Placed on suspense file",6,0,0,1,7
1594835,1206765,2022-05-19,Senate,"Do pass as amended",7,0,0,0,7
1594835,1209972,2022-05-26,Senate,"Special Consent SB1311",38,0,0,2,40
1594835,1217439,2022-06-21,Assembly,"Do pass and be re-referred to the Committee on [Military and Veterans Affairs]",8,0,0,2,10
1594835,1219999,2022-06-28,Assembly,"Do pass and be re-referred to the Committee on [Appropriations]",8,1,0,2,11
1594835,1223670,2022-08-11,Assembly,"Do pass",13,0,0,3,16
1594835,1224231,2022-08-18,Assembly,"SB 1311 Eggman Senate Third Reading By Irwin",70,0,0,10,80
1594835,1224645,2022-08-24,Senate,"Unfinished Business SB1311 Eggman et al. Concurrence",40,0,0,0,40
1594836,1181307,2022-03-31,Senate,"Do pass as amended, but first amend, and re-refer to the Committee on [Appropriations]",4,0,0,1,5
1594836,1201411,2022-05-09,Senate,"Senate 3rd Reading SB1312 Ochoa Bogh",33,0,0,7,40
1594836,1215747,2022-06-13,Assembly,"Do pass as amended and be re-referred to the Committee on [Appropriations]",10,0,0,1,11
1594836,1220646,2022-06-29,Assembly,"Do pass. To Consent Calendar",14,0,0,2,16
1594836,1223026,2022-08-04,Assembly,"SB 1312 Ochoa Bogh Consent Calendar Second Day Regular Session",76,0,0,4,80
1594836,1223148,2022-08-08,Senate,"Unfinished Business SB1312 Ochoa Bogh et al. Concurrence",37,0,0,3,40
1594837,1183735,2022-04-04,Senate,"Do pass, but first be re-referred to the Committee on [Judiciary]",3,1,0,1,5
1594837,1190710,2022-04-19,Senate,"Do pass as amended, but first amend, and re-refer to the Committee on [Appropriations]",9,2,0,0,11
1594837,1198228,2022-05-02,Senate,"Placed on suspense file",7,0,0,0,7
1594837,1206989,2022-05-19,Senate,"Do pass",5,2,0,0,7
1594837,1208494,2022-05-24,Senate,"Senate 3rd Reading SB1313 Hertzberg",26,9,0,5,40
1594837,1218013,2022-06-22,Assembly,"Do pass and be re-referred to the Committee on [Appropriations]",5,2,0,0,7
1594837,1223719,2022-08-11,Assembly,"Do pass",12,4,0,0,16
1594837,1224912,2022-08-25,Assembly,"SB 1313 Hertzberg Senate Third Reading By O'Donnell",56,14,0,10,80
1594837,1225320,2022-08-30,Senate,"Unfinished Business SB1313 Hertzberg Concurrence",28,10,0,2,40
1594838,1193445,2022-04-26,Senate,"Do pass, but first be re-referred to the Committee on [Appropriations]",7,1,0,1,9
1594838,1209276,2022-05-25,Senate,"Senate 3rd Reading SB1314 Lim贸n",24,9,0,7,40
1594838,1217098,2022-06-20,Assembly,"Do pass and be re-referred to the Committee on [Appropriations]",7,3,0,1,11
1594838,1223588,2022-08-11,Assembly,"Do pass",12,4,0,0,16
1594838,1225720,2022-08-30,Assembly,"SB 1314 Lim贸n Senate Third Reading By Cristina Garcia",47,23,0,10,80
1594839,1193367,2022-04-26,Senate,"Do pass as amended, but first amend, and re-refer to the Committee on [Appropriations]",13,0,0,2,15
1594839,1204632,2022-05-16,Senate,"Placed on suspense file",6,0,0,1,7
1594839,1206875,2022-05-19,Senate,"Do pass",7,0,0,0,7
1594839,1209223,2022-05-25,Senate,"Special Consent SB1315",39,0,0,1,40
1594839,1217893,2022-06-22,Assembly,"Do pass and be re-referred to the Committee on [Appropriations]",20,0,0,2,22
1594841,1183826,2022-04-04,Senate,"Do pass as amended, but first amend, and re-refer to the Committee on [Appropriations]",9,3,0,2,14
1594841,1192181,2022-04-25,Senate,"Placed on suspense file",5,0,0,2,7
1594841,1206991,2022-05-19,Senate,"Do pass",5,1,0,1,7
1594841,1208525,2022-05-24,Senate,"Senate 3rd Reading SB1317 Bradford",22,9,0,9,40
1594841,1217454,2022-06-21,Assembly,"Do pass and be re-referred to the Committee on [Appropriations]",12,2,0,5,19
1594841,1223955,2022-08-11,Assembly,"Do pass",12,4,0,0,16
1594841,1224297,2022-08-22,Assembly,"SB 1317 Bradford Senate Third Reading By Gipson",40,21,0,19,80
1594841,1224822,2022-08-24,Assembly,"SB 1317 Bradford Senate Third Reading By Gipson",41,17,0,22,80
1594843,1183798,2022-04-05,Senate,"Do pass as amended, but first amend, and re-refer to the Committee on [Environmental Quality]",9,0,0,0,9
1594843,1194404,2022-04-27,Senate,"Do pass as amended, but first amend, and re-refer to the Committee on [Appropriations]",7,0,0,0,7
1594843,1207769,2022-05-23,Senate,"Senate 3rd Reading SB1319 Grove et al",35,0,0,5,40
1594843,1215522,2022-06-13,Assembly,"Do pass and be re-referred to the Committee on [Appropriations] with recommendation: To Consent Calendar",10,0,0,1,11
1594845,1193280,2022-04-26,Senate,"Do pass as amended, but first amend, and re-refer to the Committee on [Appropriations]",13,0,0,2,15
1594845,1201423,2022-05-09,Senate,"Placed on suspense file",7,0,0,0,7
1594845,1206732,2022-05-19,Senate,"Do pass",7,0,0,0,7
1594845,1209387,2022-05-25,Senate,"Special Consent SB1321",39,0,0,1,40
1594845,1216403,2022-06-15,Assembly,"Do pass and be re-referred to the Committee on [Appropriations]",7,0,0,0,7
1594846,1193402,2022-04-26,Senate,"Do pass as amended, but first amend, and re-refer to the Committee on [Appropriations]",8,0,0,6,14
1594846,1207708,2022-05-23,Senate,"Senate 3rd Reading SB1322 Allen",22,4,0,14,40
1594846,1219447,2022-06-27,Assembly,"Do pass and be re-referred to the Committee on [Appropriations]",8,3,0,0,11
1594846,1223013,2022-08-03,Assembly,"Do pass",11,4,0,1,16
1594846,1225129,2022-08-29,Assembly,"SB 1322 Allen Senate Third Reading By Muratsuchi",42,23,0,15,80
1594846,1225368,2022-08-30,Senate,"Unfinished Business SB1322 Allen et al. Concurrence",30,9,0,1,40
1594847,1199962,2022-05-03,Senate,"Do pass",8,2,0,1,11
1594847,1209286,2022-05-25,Senate,"Senate 3rd Reading SB1323 Archuleta",30,9,0,1,40
1594847,1220054,2022-06-28,Assembly,"Do pass as amended and be re-referred to the Committee on [Appropriations]",7,3,0,1,11
1594847,1223416,2022-08-11,Assembly,"Do pass as amended",11,5,0,0,16
1594848,1184741,2022-04-06,Senate,"Do pass as amended, but first amend, and re-refer to the Committee on [Judiciary]",7,1,0,1,9
1594848,1190580,2022-04-19,Senate,"Do pass as amended, but first amend, and re-refer to the Committee on [Appropriations]",9,1,0,1,11
1594848,1198229,2022-05-02,Senate,"Placed on suspense file",7,0,0,0,7
1594849,1173502,2022-03-21,Senate,"Do pass, but first be re-referred to the Committee on [Appropriations]",12,0,0,2,14
1594849,1182538,2022-04-04,Senate,"Placed on suspense file",6,0,0,1,7
1594849,1206574,2022-05-19,Senate,"Do pass as amended",5,0,0,2,7
1594849,1210027,2022-05-26,Senate,"Senate 3rd Reading SB1325 Gonzalez",35,0,0,5,40
1594849,1217311,2022-06-21,Assembly,"Do pass as amended and be re-referred to the Committee on [Appropriations]",6,0,0,0,6
1594850,1189336,2022-04-18,Senate,"Do pass, but first be re-referred to the Committee on [Appropriations]",9,3,0,2,14
1594850,1198285,2022-05-02,Senate,"Placed on suspense file",7,0,0,0,7
1594850,1206844,2022-05-19,Senate,"Do pass",4,2,0,1,7
1594850,1209327,2022-05-25,Senate,"Senate 3rd Reading SB1326 Caballero",27,10,0,3,40
1594850,1215781,2022-06-14,Assembly,"Do pass as amended and be re-referred to the Committee on [Appropriations]",14,2,0,2,18
1594850,1223405,2022-08-11,Assembly,"Do pass",12,4,0,0,16
1594850,1224293,2022-08-22,Assembly,"SB 1326 Caballero Senate Third Reading By Berman",60,10,0,10,80
1594850,1224893,2022-08-25,Senate,"Unfinished Business SB1326 Caballero Concurrence",28,10,0,2,40
1594851,1184645,2022-04-05,Senate,"Do pass, but first be re-referred to the Committee on [Public Safety]",8,1,0,2,11
1594851,1194427,2022-04-26,Senate,"Do pass, but first be re-referred to the Committee on [Appropriations]",4,1,0,0,5
1594851,1201366,2022-05-09,Senate,"Placed on suspense file",7,0,0,0,7
1594851,1206392,2022-05-19,Senate,"Do pass",5,2,0,0,7
1594851,1208454,2022-05-24,Senate,"Senate 3rd Reading SB1327 Hertzberg et al",24,10,0,6,40
1594851,1215901,2022-06-14,Assembly,"Do pass as amended",8,2,0,1,11
1594851,1217955,2022-06-22,Assembly,"Do pass",11,4,0,1,16
1594851,1218641,2022-06-23,Assembly,"SB 1327 Hertzberg Senate Second Reading By Ting Amendment Set #1",51,16,0,13,80
1594851,1219480,2022-06-27,Assembly,"SB 1327 Hertzberg Senate Third Reading By TING",52,21,0,7,80
1594851,1221578,2022-06-29,Senate,"Unfinished Business SB1327 Hertzberg et al. Concurrence",26,9,0,5,40
1594852,1173523,2022-03-21,Senate,"Do pass as amended, but first amend, and re-refer to the Committee on [Governmental Organization]",5,0,0,0,5
1594852,1179202,2022-03-29,Senate,"Do pass, but first be re-referred to the Committee on [Appropriations]",13,0,0,2,15
1594852,1198276,2022-05-02,Senate,"Placed on suspense file",7,0,0,0,7
1594852,1206553,2022-05-19,Senate,"Do pass as amended",6,0,0,1,7
1594852,1210020,2022-05-26,Senate,"Senate 3rd Reading SB1328 McGuire et al. Urgency Clause",35,0,0,5,40
1594853,1189877,2022-04-18,Senate,"Do pass, but first be re-referred to the Committee on [Transportation]",9,1,0,4,14
1594853,1194424,2022-04-26,Senate,"Do pass as amended, but first amend, and re-refer to the Committee on [Appropriations]",14,0,0,3,17
1594853,1204685,2022-05-16,Senate,"Placed on suspense file",6,0,0,1,7
1594853,1206738,2022-05-19,Senate,"Do pass",7,0,0,0,7
1594853,1209378,2022-05-25,Senate,"Special Consent SB1329",39,0,0,1,40
1594853,1217410,2022-06-20,Assembly,"Do pass and be re-referred to the Committee on [Natural Resources]",14,0,0,1,15
1594853,1219488,2022-06-27,Assembly,"Do pass and be re-referred to the Committee on [Appropriations]",10,0,0,1,11
1594854,1183667,2022-04-05,Senate,"Do pass, but first be re-referred to the Committee on [Appropriations]",1,0,0,4,5
1594854,1183668,2022-04-05,Senate,"[First] hearing set for [04-05-2022]: Failed passage in Committee. Reconsideration granted",4,0,0,1,5
1594857,1183701,2022-04-05,Senate,"Do pass as amended, but first amend, and re-refer to the Committee on [Appropriations]",1,1,0,3,5
1594857,1183702,2022-04-05,Senate,"[First] hearing set for [04-05-2022]: Failed passage in Committee. Reconsideration granted",4,0,0,1,5
1594857,1194433,2022-04-26,Senate,"Do pass, but first be re-referred to the Committee on [Appropriations]",1,3,0,1,5
1594858,1183596,2022-04-04,Senate,"Do pass as amended, but first amend, and re-refer to the Committee on [Appropriations]",3,1,0,1,5
1594858,1192228,2022-04-25,Senate,"Placed on suspense file",5,0,0,2,7
1594858,1206816,2022-05-19,Senate,"Do pass",5,2,0,0,7
1594858,1208478,2022-05-24,Senate,"Senate 3rd Reading SB1334 Bradford",28,9,0,3,40
1594858,1216297,2022-06-15,Assembly,"Do pass and be re-referred to the Committee on [Appropriations]",6,1,0,0,7
1594858,1223385,2022-08-11,Assembly,"Do pass as amended",12,4,0,0,16
1594858,1225239,2022-08-30,Senate,"Unfinished Business SB1334 Bradford Concurrence",29,9,0,2,40
1594858,1225240,2022-08-30,Assembly,"SB 1334 Bradford Senate Third Reading By Kalra",59,14,0,7,80
1594859,1190588,2022-04-19,Senate,"Do pass as amended, but first amend, and re-refer to the Committee on [Appropriations]",9,2,0,0,11
1594859,1201510,2022-05-09,Senate,"Placed on suspense file",7,0,0,0,7
1594859,1207010,2022-05-19,Senate,"Do pass",5,2,0,0,7
1594859,1209975,2022-05-26,Senate,"Senate 3rd Reading SB1335 Eggman",29,5,0,6,40
1594860,1200528,2022-05-04,Senate,"Do pass as amended, but first amend, and re-refer to the Committee on [Appropriations]",4,0,0,1,5
1594860,1204584,2022-05-16,Senate,"Placed on suspense file",6,0,0,1,7
1594860,1206539,2022-05-19,Senate,"Do pass as amended",5,0,0,2,7
1594860,1209974,2022-05-26,Senate,"Senate 3rd Reading SB1336 Wiener",26,3,0,11,40
1594860,1216259,2022-06-15,Assembly,"Do pass as amended and be re-referred to the Committee on [Natural Resources]",7,1,0,0,8
1594861,1195712,2022-04-27,Senate,"Do pass as amended, but first amend, and re-refer to the Committee on [Appropriations]",9,0,0,2,11
1594861,1204641,2022-05-16,Senate,"Placed on suspense file",6,0,0,1,7
1594862,1194093,2022-04-26,Senate,"Do pass, but first be re-referred to the Committee on [Health]",10,0,0,1,11
1594862,1195871,2022-04-27,Senate,"Do pass, but first be re-referred to the Committee on [Appropriations]",9,0,0,2,11
1594862,1204664,2022-05-16,Senate,"Placed on suspense file",6,0,0,1,7
1594862,1206626,2022-05-19,Senate,"Do pass as amended",7,0,0,0,7
1594862,1209289,2022-05-25,Senate,"Senate 3rd Reading SB1338 Umberg et al",39,0,0,1,40
1594862,1217490,2022-06-21,Assembly,"Do pass and be re-referred to the Committee on [Health]",9,1,0,0,10
1594862,1220001,2022-06-28,Assembly,"Do pass as amended and be re-referred to the Committee on [Appropriations]",14,0,0,1,15
1594862,1224033,2022-08-11,Assembly,"Do pass as amended",13,0,0,3,16
1594862,1225505,2022-08-30,Assembly,"SB 1338 Umberg Senate Third Reading By Gipson",73,2,0,5,80
1594862,1225506,2022-08-31,Senate,"Unfinished Business SB1338 Umberg et al. Concurrence",40,0,0,0,40
1594863,1191255,2022-04-20,Senate,"Do pass, but first be re-referred to the Committee on [Appropriations]",8,0,0,3,11
1594863,1198277,2022-05-02,Senate,"Placed on suspense file",7,0,0,0,7
1594863,1206721,2022-05-19,Senate,"Do pass as amended",6,0,0,1,7
1594863,1209998,2022-05-26,Senate,"Senate 3rd Reading SB1339 Pan et al",37,0,0,3,40
1594863,1220048,2022-06-28,Assembly,"Do pass and be re-referred to the Committee on [Appropriations] with recommendation: To Consent Calendar",15,0,0,0,15
1594864,1200490,2022-05-04,Senate,"Do pass as amended, but first amend, and re-refer to the Committee on [Appropriations]",4,1,0,0,5
1594864,1204579,2022-05-16,Senate,"Placed on suspense file",6,0,0,1,7
1594864,1206353,2022-05-19,Senate,"Do pass",5,2,0,0,7
1594864,1209987,2022-05-26,Senate,"Senate 3rd Reading SB1340 Hertzberg",29,8,0,3,40
1594864,1221347,2022-06-30,Assembly,"Do pass as amended and be re-referred to the Committee on [Appropriations]",8,1,0,2,11
1594864,1223784,2022-08-11,Assembly,"Do pass as amended",12,4,0,0,16
1594864,1224227,2022-08-18,Assembly,"SB 1340 Hertzberg Senate Third Reading By Irwin",66,2,0,12,80
1594864,1224440,2022-08-23,Senate,"Unfinished Business SB1340 Hertzberg Concurrence",27,9,0,4,40
1594865,1184661,2022-04-06,Senate,"Do pass, but first be re-referred to the Committee on [Human Services]",5,1,0,1,7
1594865,1190706,2022-04-19,Senate,"Do pass, but first be re-referred to the Committee on [Appropriations]",3,1,0,1,5
1594865,1201410,2022-05-09,Senate,"Placed on suspense file",7,0,0,0,7
1594865,1207001,2022-05-19,Senate,"Do pass as amended",5,2,0,0,7
1594865,1210019,2022-05-26,Senate,"Senate 3rd Reading SB1341 Cortese",30,6,0,4,40
1594865,1217306,2022-06-21,Assembly,"Do pass and be re-referred to the Committee on [Human Services]",5,2,0,5,12
1594866,1183768,2022-04-05,Senate,"Do pass, but first be re-referred to the Committee on [Judiciary]",5,0,0,0,5
1594866,1194318,2022-04-26,Senate,"Do pass as amended, but first amend, and re-refer to the Committee on [Appropriations] with the recommendation: To Consent Calendar",11,0,0,0,11
1594866,1204628,2022-05-16,Senate,"Placed on suspense file",6,0,0,1,7
1594866,1206486,2022-05-19,Senate,"Do pass",7,0,0,0,7
1594866,1209228,2022-05-25,Senate,"Special Consent SB1342",39,0,0,1,40
1594866,1217322,2022-06-21,Assembly,"Do pass as amended and be re-referred to the Committee on [Appropriations]",7,0,0,0,7
1594866,1223516,2022-08-11,Assembly,"Do pass",16,0,0,0,16
1594866,1224676,2022-08-24,Assembly,"SB 1342 Bates Senate Third Reading By Quirk-Silva",76,0,0,4,80
1594866,1225279,2022-08-31,Senate,"Unfinished Business SB1342 Bates et al. Concurrence",40,0,0,0,40
1594867,1183845,2022-04-04,Senate,"Do pass, but first be re-referred to the Committee on [Education]",3,1,0,1,5
1594867,1190631,2022-04-20,Senate,"Do pass as amended, but first amend, and re-refer to the Committee on [Appropriations]",4,3,0,0,7
1594867,1204564,2022-05-16,Senate,"Placed on suspense file",6,0,0,1,7
1594867,1207012,2022-05-19,Senate,"Do pass",5,2,0,0,7
1594867,1208521,2022-05-24,Senate,"Senate 3rd Reading SB1343 Leyva",20,10,0,10,40
1594867,1208522,2022-05-24,Senate,"Senate 3rd Reading SB1343 Leyva Reconsider",37,0,0,3,40
1594867,1209382,2022-05-25,Senate,"Senate 3rd Reading SB1343 Leyva",21,10,0,9,40
1594867,1218015,2022-06-22,Assembly,"Do pass and be re-referred to the Committee on [Education]",5,2,0,0,7
1594867,1220711,2022-06-29,Assembly,"Do pass and be re-referred to the Committee on [Appropriations]",5,2,0,0,7
1594867,1223742,2022-08-11,Assembly,"Do pass as amended",12,4,0,0,16
1594867,1224656,2022-08-24,Assembly,"SB 1343 Leyva Senate Third Reading By Reyes",27,20,0,33,80
1594869,1173510,2022-03-21,Senate,"Do pass, but first be re-referred to the Committee on [Governance and Finance]",12,0,0,2,14
1594869,1181291,2022-03-31,Senate,"Do pass as amended, but first amend, and re-refer to the Committee on [Appropriations]",4,0,0,1,5
1594869,1192168,2022-04-25,Senate,"Placed on suspense file",5,0,0,2,7
1594870,1183684,2022-04-04,Senate,"Do pass, but first be re-referred to the Committee on [Health]",13,0,0,1,14
1594870,1195832,2022-04-27,Senate,"Do pass",10,0,0,1,11
1594870,1207757,2022-05-23,Senate,"Senate 3rd Reading SB1346 Becker et al",36,0,0,4,40
1594870,1215898,2022-06-14,Assembly,"Do pass as amended and be re-referred to the Committee on [Health]",16,0,0,2,18
1594870,1220046,2022-06-28,Assembly,"Do pass as amended and be re-referred to the Committee on [Appropriations]",15,0,0,0,15
1594870,1222990,2022-08-03,Assembly,"Do pass. To Consent Calendar",15,0,0,1,16
1594870,1223379,2022-08-11,Assembly,"SB 1346 Becker Consent Calendar Second Day Regular Session",76,0,0,4,80
1594870,1224295,2022-08-22,Senate,"Unfinished Business SB1346 Becker et al. Concurrence",40,0,0,0,40
1594871,1194105,2022-04-27,Senate,"Do pass as amended, but first amend, and re-refer to the Committee on [Appropriations] with the recommendation: To Consent Calendar",7,0,0,0,7
1594871,1204599,2022-05-16,Senate,"Placed on suspense file",6,0,0,1,7
1594871,1206998,2022-05-19,Senate,"Do pass",7,0,0,0,7
1594871,1209392,2022-05-25,Senate,"Special Consent SB1347",39,0,0,1,40
1594871,1219467,2022-06-27,Assembly,"Do pass as amended and be re-referred to the Committee on [Appropriations]",11,0,0,0,11
1594872,1184680,2022-04-06,Senate,"Do pass as amended, but first amend, and re-refer to the Committee on [Appropriations]",9,0,0,0,9
1594872,1207707,2022-05-23,Senate,"Senate 3rd Reading SB1348 Bradford",32,2,0,6,40
1594872,1217109,2022-06-20,Assembly,"Do pass and be re-referred to the Committee on [Appropriations]",9,1,0,2,12
1594872,1220868,2022-06-29,Assembly,"Do pass",15,0,0,1,16
1594872,1224638,2022-08-24,Assembly,"SB 1348 Bradford Senate Third Reading By Wilson",66,0,0,14,80
1594873,1181270,2022-03-31,Senate,"Do pass as amended, but first amend, and re-refer to the Committee on [Appropriations]",4,0,0,1,5
1594873,1189372,2022-04-18,Senate,"Placed on suspense file",7,0,0,0,7
1594873,1206757,2022-05-19,Senate,"Do pass as amended",4,0,0,3,7
1594873,1209965,2022-05-26,Senate,"Senate 3rd Reading SB1349 Caballero",29,0,0,11,40
1594873,1221257,2022-06-30,Assembly,"Do pass and be re-referred to the Committee on [Appropriations]",8,1,0,2,11
1594874,1194323,2022-04-26,Senate,"Do pass, but first be re-referred to the Committee on [Appropriations]",1,1,0,3,5
1594875,1189900,2022-04-18,Senate,"Do pass, but first be re-referred to the Committee on [Appropriations]",5,0,0,0,5
1594875,1198268,2022-05-02,Senate,"Placed on suspense file",7,0,0,0,7
1594875,1206935,2022-05-19,Senate,"Do pass as amended",5,0,0,2,7
1594875,1209999,2022-05-26,Senate,"Senate 3rd Reading SB1351 Durazo et al",30,0,0,10,40
1594875,1217975,2022-06-22,Assembly,"Do pass and be re-referred to the Committee on [Appropriations]",5,0,0,2,7
1594876,1194295,2022-04-27,Senate,"Do pass, but first be re-referred to the Committee on [Appropriations]",4,1,0,0,5
1594876,1201478,2022-05-09,Senate,"Placed on suspense file",7,0,0,0,7
1594876,1206360,2022-05-19,Senate,"Do pass",5,1,0,1,7
1594876,1209265,2022-05-25,Senate,"Senate 3rd Reading SB1352 Allen",32,2,0,6,40
1594876,1220875,2022-06-29,Assembly,"Do pass and be re-referred to the Committee on [Appropriations]",6,1,0,0,7
1594877,1185677,2022-04-07,Senate,"Do pass as amended, but first amend, and re-refer to the Committee on [Human Services]",5,0,0,0,5
1594877,1190593,2022-04-19,Senate,"Do pass, but first be re-referred to the Committee on [Appropriations]",4,0,0,1,5
1594877,1198269,2022-05-02,Senate,"Placed on suspense file",7,0,0,0,7
1594878,1172373,2022-03-17,Senate,"Do pass, but first be re-referred to the Committee on [Appropriations]",5,0,0,0,5
1594878,1192191,2022-04-25,Senate,"Senate 3rd Reading SB1354 Jones",38,0,0,2,40
1594878,1214999,2022-06-08,Assembly,"Do pass and be re-referred to the Committee on [Appropriations]",8,0,0,0,8
1594878,1217995,2022-06-22,Assembly,"Do pass. To Consent Calendar",13,0,0,3,16
1594878,1225130,2022-08-29,Assembly,"SB 1354 Jones Senate Third Reading By Aguiar-Curry",78,0,0,2,80
1594878,1225367,2022-08-30,Senate,"Unfinished Business SB1354 Jones Concurrence",40,0,0,0,40
1594879,1201490,2022-05-09,Senate,"Do pass as amended",7,0,0,0,7
1594879,1204615,2022-05-16,Senate,"Senate 3rd Reading SB1355 Portantino Urgency Clause",32,0,0,8,40
1594879,1218040,2022-06-22,Assembly,"Do pass",15,0,0,1,16
1594879,1221751,2022-06-29,Assembly,"SB 1355 Portantino Third Reading Urgency By Holden",78,0,0,2,80
1594880,1194131,2022-04-26,Senate,"Do pass, but first be re-referred to the Committee on [Appropriations]",3,5,0,9,17
1594881,1185683,2022-04-07,Senate,"Do pass as amended, but first amend, and re-refer to the Committee on [Military and Veterans Affairs]",5,0,0,0,5
1594881,1193275,2022-04-26,Senate,"Do pass, but first be re-referred to the Committee on [Appropriations] with the recommendation: To Consent Calendar",5,0,0,2,7
1594881,1201419,2022-05-09,Senate,"Placed on suspense file",7,0,0,0,7
1594881,1206472,2022-05-19,Senate,"Do pass",7,0,0,0,7
1594881,1209338,2022-05-25,Senate,"Special Consent SB1357",39,0,0,1,40
1594881,1217331,2022-06-20,Assembly,"Do pass and be re-referred to the Committee on [Military and Veterans Affairs]",11,0,0,0,11
1594881,1220017,2022-06-28,Assembly,"Do pass and be re-referred to the Committee on [Appropriations]",10,0,0,1,11
1594882,1219348,2022-06-27,Senate,"Do pass",6,0,0,1,7
1594882,1221354,2022-06-30,Senate,"Senate 3rd Reading SB1358 Portantino Urgency Clause",33,0,0,7,40
1594882,1223335,2022-08-10,Assembly,"Do pass",15,0,0,1,16
1594882,1225293,2022-08-31,Senate,"Unfinished Business SB1358 Portantino Urgency Clause Concurrence",39,0,0,1,40
1594882,1225294,2022-08-31,Assembly,"SB 1358 Portantino Third Reading Urgency By Holden",80,0,0,0,80
1594883,1189992,2022-04-19,Senate,"Do pass, but first be re-referred to the Committee on [Appropriations] with the recommendation: To Consent Calendar",5,0,0,0,5
1594883,1204592,2022-05-16,Senate,"Placed on suspense file",6,0,0,1,7
1594883,1206552,2022-05-19,Senate,"Do pass",6,0,0,1,7
1594883,1208461,2022-05-24,Senate,"Senate 3rd Reading SB1359 Hueso",37,0,0,3,40
1594883,1217401,2022-06-21,Assembly,"Do pass and be re-referred to the Committee on [Appropriations]",6,0,0,1,7
1594883,1223003,2022-08-03,Assembly,"Do pass",12,0,0,4,16
1594883,1225064,2022-08-29,Assembly,"SB 1359 Hueso Senate Third Reading By Santiago",69,0,0,11,80
1594883,1225217,2022-08-30,Senate,"Unfinished Business SB1359 Hueso Concurrence",40,0,0,0,40
1594884,1179475,2022-03-28,Senate,"Do pass as amended, but first amend, and re-refer to the Committee on [Appropriations]",4,1,0,0,5
1594884,1189382,2022-04-18,Senate,"Placed on suspense file",7,0,0,0,7
1594884,1206866,2022-05-19,Senate,"Do pass",5,2,0,0,7
1594884,1209255,2022-05-25,Senate,"Senate 3rd Reading SB1360 Umberg et al",34,3,0,3,40
1594884,1220723,2022-06-29,Assembly,"Do pass and be re-referred to the Committee on [Appropriations]",6,0,0,1,7
1594884,1223544,2022-08-11,Assembly,"Do pass",13,3,0,0,16
1594884,1224492,2022-08-23,Assembly,"SB 1360 Umberg Senate Third Reading By Berman",62,10,0,8,80
1594884,1225323,2022-08-30,Senate,"Unfinished Business SB1360 Umberg et al. Concurrence",33,4,0,3,40
1594885,1195761,2022-04-27,Senate,"Do pass as amended, but first amend, and re-refer to the Committee on [Business, Professions and Economic Development]",9,0,0,2,11
1594885,1204674,2022-05-16,Senate,"Placed on suspense file",6,0,0,1,7
1594887,1184660,2022-04-06,Senate,"Do pass",6,0,0,1,7
1594887,1204679,2022-05-16,Senate,"Senate 3rd Reading SB1363 Nielsen",25,0,0,15,40
1594888,1183610,2022-04-04,Senate,"Do pass, but first be re-referred to the Committee on [Judiciary]",3,1,0,1,5
1594888,1190640,2022-04-19,Senate,"Do pass as amended, but first amend, and re-refer to the Committee on [Appropriations]",9,2,0,0,11
1594888,1198238,2022-05-02,Senate,"Placed on suspense file",7,0,0,0,7
1594888,1206384,2022-05-19,Senate,"Do pass",5,1,0,1,7
1594888,1209351,2022-05-25,Senate,"Senate 3rd Reading SB1364 Durazo et al",27,11,0,2,40
1594888,1215858,2022-06-14,Assembly,"Do pass and be re-referred to the Committee on [Labor and Employment]",8,2,0,1,11
1594888,1217915,2022-06-22,Assembly,"Do pass and be re-referred to the Committee on [Appropriations]",5,2,0,0,7
1594888,1223406,2022-08-11,Assembly,"Do pass",11,5,0,0,16
1594888,1224668,2022-08-24,Assembly,"SB 1364 Durazo Senate Third Reading By Reyes",55,16,0,9,80
1594888,1225466,2022-08-30,Senate,"Unfinished Business SB1364 Durazo et al. Concurrence",25,11,0,4,40
1594889,1183808,2022-04-04,Senate,"Do pass, but first be re-referred to the Committee on [Public Safety]",13,0,0,1,14
1594889,1194334,2022-04-26,Senate,"Do pass, but first be re-referred to the Committee on [Appropriations]",4,0,0,1,5
1594889,1201417,2022-05-09,Senate,"Placed on suspense file",7,0,0,0,7
1594890,1193439,2022-04-26,Senate,"Do pass, but first be re-referred to the Committee on [Appropriations] with the recommendation: To Consent Calendar",13,0,0,2,15
1594891,1193373,2022-04-26,Senate,"Do pass, but first be re-referred to the Committee on [Elections and Constitutional Amendments]",4,0,0,11,15
1594891,1193374,2022-04-26,Senate,"[Second] hearing set for [04-26-2022]: Failed passage in Committee. Reconsideration granted",13,0,0,2,15
1594892,1193251,2022-04-26,Senate,"Do pass, but first be re-referred to the Committee on [Appropriations]",3,7,0,5,15
1594892,1193252,2022-04-26,Senate,"[First] hearing set for [04-26-2022]: Failed passage in Committee. Reconsideration granted",13,0,0,2,15
1594894,1179245,2022-03-29,Senate,"Do pass, but first be re-referred to the Committee on [Appropriations]",14,0,0,1,15
1594894,1204650,2022-05-16,Senate,"Senate 3rd Reading SB1370 Pan",32,0,0,8,40
1594894,1214968,2022-06-08,Assembly,"Do pass as amended and be re-referred to the Committee on [Appropriations]",21,0,0,1,22
1594894,1217921,2022-06-22,Assembly,"Do pass",15,0,0,1,16
1594894,1224317,2022-08-22,Assembly,"SB 1370 Pan Senate Third Reading By McCarty",75,0,0,5,80
1594894,1224799,2022-08-24,Senate,"Unfinished Business SB1370 Pan et al. Concurrence",39,0,0,1,40
1594895,1194133,2022-04-26,Senate,"Do pass, but first be re-referred to the Committee on [Appropriations]",5,0,0,0,5
1594895,1201413,2022-05-09,Senate,"Placed on suspense file",7,0,0,0,7
1594895,1206259,2022-05-19,Senate,"Do pass as amended",6,1,0,0,7
1594895,1209956,2022-05-26,Senate,"Senate 3rd Reading SB1371 Bradford",36,2,0,2,40
1594895,1217353,2022-06-21,Assembly,"Do pass and be re-referred to the Committee on [Appropriations]",7,0,0,0,7
1594895,1223795,2022-08-11,Assembly,"Do pass",15,1,0,0,16
1594895,1224721,2022-08-24,Assembly,"SB 1371 Bradford Senate Third Reading By Ting",70,0,0,10,80
1594896,1183694,2022-04-05,Senate,"Do pass and be ordered to the Consent Calendar",8,0,0,1,9
1594896,1189380,2022-04-18,Senate,"Consent Calendar SB1372 Stern",36,0,0,4,40
1594896,1215833,2022-06-14,Assembly,"Do pass",15,0,0,0,15
1594896,1224071,2022-08-15,Assembly,"SB 1372 Stern Senate Third Reading By Bauer-Kahan",76,0,0,4,80
1594897,1200508,2022-05-04,Senate,"Do pass",4,0,0,1,5
1594897,1207840,2022-05-23,Senate,"Senate 3rd Reading SB1373 Kamlager Urgency Clause",31,0,0,9,40
1594897,1216613,2022-06-15,Assembly,"Do pass as amended and be re-referred to the Committee on [Housing and Community Development]",7,0,0,1,8
1594897,1220683,2022-06-29,Assembly,"Do pass",6,1,0,1,8
1594897,1225053,2022-08-29,Assembly,"SB 1373 Kamlager Third Reading Urgency By Santiago",61,0,0,19,80
1594897,1225629,2022-08-31,Senate,"Unfinished Business SB1373 Kamlager et al. Urgency Clause Concurrence",33,0,0,7,40
1594898,1190589,2022-04-20,Senate,"Do pass, but first be re-referred to the Committee on [Appropriations]",5,0,0,0,5
1594898,1198302,2022-05-02,Senate,"Placed on suspense file",7,0,0,0,7
1594898,1206490,2022-05-19,Senate,"Do pass as amended",7,0,0,0,7
1594898,1209957,2022-05-26,Senate,"Special Consent SB1374",38,0,0,2,40
1594898,1221355,2022-06-30,Assembly,"Do pass and be re-referred to the Committee on [Appropriations]",11,0,0,0,11
1594898,1223540,2022-08-11,Assembly,"Do pass as amended",12,0,0,4,16
1594898,1224270,2022-08-22,Assembly,"SB 1374 Borgeas Senate Third Reading By Irwin",77,0,0,3,80
1594898,1224972,2022-08-25,Senate,"Unfinished Business SB1374 Borgeas Concurrence",40,0,0,0,40
1594899,1183688,2022-04-04,Senate,"Do pass, but first be re-referred to the Committee on [Judiciary]",9,4,0,1,14
1594899,1190540,2022-04-19,Senate,"Do pass, but first be re-referred to the Committee on [Appropriations]",9,1,0,1,11
1594899,1198266,2022-05-02,Senate,"Placed on suspense file",7,0,0,0,7
1594899,1206785,2022-05-19,Senate,"Do pass as amended",5,2,0,0,7
1594899,1209256,2022-05-25,Senate,"Senate 3rd Reading SB1375 Atkins et al",30,9,0,1,40
1594899,1217370,2022-06-21,Assembly,"Do pass as amended and be re-referred to the Committee on [Appropriations]",14,3,0,2,19
1594899,1222994,2022-08-03,Assembly,"Do pass",11,4,0,1,16
1594899,1225076,2022-08-29,Assembly,"SB 1375 Atkins Senate Third Reading By Cristina Garcia",58,16,0,6,80
1594899,1225340,2022-08-30,Senate,"Unfinished Business SB1375 Atkins et al. Concurrence",31,9,0,0,40
1594900,1193184,2022-04-26,Senate,"Do pass as amended, but first amend, and re-refer to the Committee on [Appropriations]",10,1,0,3,14
1594900,1204676,2022-05-16,Senate,"Placed on suspense file",6,0,0,1,7
1594901,1190595,2022-04-20,Senate,"Do pass, but first be re-referred to the Committee on [Appropriations]",4,1,0,0,5
1594901,1198259,2022-05-02,Senate,"Placed on suspense file",7,0,0,0,7
1594901,1206833,2022-05-19,Senate,"Do pass",5,2,0,0,7
1594901,1209245,2022-05-25,Senate,"Senate 3rd Reading SB1377 Newman et al",28,9,0,3,40
1594901,1221321,2022-06-30,Assembly,"Do pass and be re-referred to the Committee on [Appropriations]",9,1,0,1,11
1594904,1199955,2022-05-03,Senate,"Do pass as amended, and be ordered to the Consent Calendar",11,0,0,0,11
1594904,1204132,2022-05-12,Senate,"Consent Calendar SB1380 JUD. (Umberg)",35,0,0,5,40
1594904,1211948,2022-06-01,Assembly,"Do pass. To Consent Calendar",10,0,0,1,11
1594904,1215299,2022-06-09,Assembly,"SB 1380 JUD. Consent Calendar Second Day Regular Session",69,0,0,9,78
1594906,1190650,2022-04-20,Senate,"Do pass as amended, but first amend, and re-refer to the Committee on [Appropriations]",4,1,0,0,5
1594906,1190651,2022-04-20,Senate,"Do pass, but first be re-referred to the Committee on [Governance and Finance]",4,0,0,3,7
1594906,1201430,2022-05-09,Senate,"Placed on suspense file",7,0,0,0,7
1594906,1206521,2022-05-19,Senate,"Do pass as amended",5,2,0,0,7
1594906,1210017,2022-05-26,Senate,"Senate 3rd Reading SB1382 Gonzalez et al",33,5,0,2,40
1594906,1217357,2022-06-20,Assembly,"Do pass and be re-referred to the Committee on [Revenue and Taxation]",13,0,0,2,15
1594906,1221246,2022-06-30,Assembly,"Do pass and be re-referred to the Committee on [Appropriations]",10,1,0,0,11
1594906,1223372,2022-08-11,Assembly,"Do pass",16,0,0,0,16
1594906,1224374,2022-08-22,Assembly,"SB 1382 Gonzalez Senate Third Reading By Bennett",76,1,0,3,80
1594906,1224690,2022-08-24,Senate,"Unfinished Business SB1382 Gonzalez et al. Concurrence",32,6,0,2,40
1594907,1189925,2022-04-18,Senate,"Do pass as amended, but first amend, and re-refer to the Committee on [Appropriations] with the recommendation: To Consent Calendar",12,0,0,2,14
1594907,1201358,2022-05-09,Senate,"Placed on suspense file",7,0,0,0,7
1594907,1206555,2022-05-19,Senate,"Do pass",7,0,0,0,7
1594907,1209251,2022-05-25,Senate,"Special Consent SB1383",39,0,0,1,40
1594907,1217970,2022-06-22,Assembly,"Do pass and be re-referred to the Committee on [Appropriations] with recommendation: To Consent Calendar",15,0,0,0,15
1594907,1223857,2022-08-11,Assembly,"Do pass",16,0,0,0,16
1594907,1224784,2022-08-24,Assembly,"SB 1383 Hueso Senate Third Reading By Eduardo Garcia",75,0,0,5,80
1594908,1189887,2022-04-19,Senate,"Do pass as amended, but first amend, and re-refer to the Committee on [Appropriations]",4,1,0,0,5
1594908,1201443,2022-05-09,Senate,"Placed on suspense file",7,0,0,0,7
1594908,1206548,2022-05-19,Senate,"Do pass",5,2,0,0,7
1594908,1208482,2022-05-24,Senate,"Senate 3rd Reading SB1384 Min",27,9,0,4,40
1594908,1215029,2022-06-08,Assembly,"Do pass and be re-referred to the Committee on [Appropriations]",5,2,0,0,7
1594908,1217845,2022-06-22,Assembly,"Do pass as amended",11,4,0,1,16
1594908,1223961,2022-08-11,Assembly,"SB 1384 Min Senate Third Reading By McCarty",53,19,0,8,80
1594908,1224104,2022-08-16,Senate,"Unfinished Business SB1384 Min et al. Concurrence",27,9,0,4,40
1594909,1189928,2022-04-18,Senate,"Do pass as amended, but first amend, and re-refer to the Committee on [Appropriations]",9,1,0,4,14
1594909,1204627,2022-05-16,Senate,"Placed on suspense file",6,0,0,1,7
1594909,1206723,2022-05-19,Senate,"Do pass as amended",5,2,0,0,7
1594909,1209973,2022-05-26,Senate,"Senate 3rd Reading SB1385 Cortese",24,7,0,9,40
1594909,1220753,2022-06-29,Assembly,"Do pass as amended and be re-referred to the Committee on [Appropriations]",11,0,0,4,15
1594911,1183644,2022-04-05,Senate,"Do pass, but first be re-referred to the Committee on [Judiciary]",10,3,0,2,15
1594911,1190609,2022-04-19,Senate,"Do pass, but first be re-referred to the Committee on [Appropriations]",10,0,0,1,11
1594911,1198264,2022-05-02,Senate,"Placed on suspense file",7,0,0,0,7
1594911,1206559,2022-05-19,Senate,"Do pass",7,0,0,0,7
1594911,1208483,2022-05-24,Senate,"Senate 3rd Reading SB1387 Lim贸n",31,2,0,7,40
1594911,1216342,2022-06-15,Assembly,"Do pass and be re-referred to the Committee on [Judiciary]",5,1,0,1,7
1594911,1217481,2022-06-21,Assembly,"Do pass and be re-referred to the Committee on [Appropriations]",8,2,0,0,10
1594911,1224025,2022-08-11,Assembly,"Do pass as amended",13,3,0,0,16
1594911,1225998,2022-08-30,Assembly,"SB 1387 Lim贸n Senate Third Reading By Carrillo",64,9,0,7,80
1594911,1225999,2022-08-31,Senate,"Unfinished Business SB1387 Lim贸n Concurrence",33,5,0,2,40
1594913,1189907,2022-04-19,Senate,"Do pass, but first be re-referred to the Committee on [Appropriations]",4,1,0,0,5
1594913,1204551,2022-05-16,Senate,"Placed on suspense file",6,0,0,1,7
1594913,1206528,2022-05-19,Senate,"Do pass",5,2,0,0,7
1594915,1194182,2022-04-27,Senate,"Do pass, but first be re-referred to the Committee on [Appropriations]",4,2,0,1,7
1594915,1201359,2022-05-09,Senate,"Placed on suspense file",7,0,0,0,7
1594915,1206473,2022-05-19,Senate,"Do pass",5,2,0,0,7
1594915,1209958,2022-05-26,Senate,"Senate 3rd Reading SB1391 Kamlager",28,8,0,4,40
1594915,1217108,2022-06-20,Assembly,"Do pass and be re-referred to the Committee on [Appropriations]",7,3,0,1,11
1594915,1223936,2022-08-11,Assembly,"Do pass",12,4,0,0,16
1594915,1225047,2022-08-29,Assembly,"SB 1391 Kamlager Senate Third Reading By Stone",34,23,0,23,80
1594916,1189808,2022-04-19,Senate,"Do pass, but first be re-referred to the Committee on [Appropriations] with the recommendation: To Consent Calendar",8,0,0,1,9
1594916,1198260,2022-05-02,Senate,"Placed on suspense file",7,0,0,0,7
1594916,1207022,2022-05-19,Senate,"Do pass as amended",7,0,0,0,7
1594916,1209993,2022-05-26,Senate,"Special Consent SB1392 McGuire Urgency Clause",38,0,0,2,40
1594916,1220029,2022-06-28,Assembly,"Do pass and be re-referred to the Committee on [Appropriations]",12,0,0,3,15
1594916,1222968,2022-08-03,Assembly,"Do pass",15,0,0,1,16
1594916,1223637,2022-08-11,Assembly,"SB 1392 McGuire Senate Third Reading By Stone",70,0,0,10,80
1594916,1224098,2022-08-16,Senate,"That the Assembly amendments be concurred in",7,0,0,2,9
1594916,1224367,2022-08-22,Senate,"Unfinished Business SB1392 McGuire Concurrence",39,0,0,1,40
1594917,1179441,2022-03-28,Senate,"Do pass as amended, but first amend, and re-refer to the Committee on [Governance and Finance]",8,2,0,4,14
1594917,1190493,2022-04-20,Senate,"Do pass as amended, but first amend, and re-refer to the Committee on [Appropriations]",3,2,0,0,5
1594917,1201415,2022-05-09,Senate,"Placed on suspense file",7,0,0,0,7
1594917,1206240,2022-05-19,Senate,"Do pass as amended",5,2,0,0,7
1594917,1210016,2022-05-26,Senate,"Senate 3rd Reading SB1393 Archuleta et al",21,3,0,16,40
1594917,1217940,2022-06-22,Assembly,"Do pass and be re-referred to the Committee on [Local Government]",11,0,0,3,14
1594917,1220609,2022-06-29,Assembly,"Do pass as amended and be re-referred to the Committee on [Appropriations]",8,0,0,0,8
1594918,1179145,2022-03-29,Senate,"Do pass, but first be re-referred to the Committee on [Public Safety] with the recommendation: To Consent Calendar",11,0,0,0,11
1594918,1207777,2022-05-23,Senate,"Senate 3rd Reading SB1394 Eggman",36,0,0,4,40
1594918,1215769,2022-06-14,Assembly,"Do pass and be re-referred to the Committee on [Judiciary] with recommendation: To Consent Calendar",13,0,0,2,15
1594918,1217443,2022-06-21,Assembly,"Do pass. To Consent Calendar",10,0,0,0,10
1594918,1224403,2022-08-23,Assembly,"SB 1394 Eggman Senate Third Reading By Maienschein",77,0,0,3,80
1594919,1190678,2022-04-20,Senate,"Do pass as amended, but first amend, and re-refer to the Committee on [Appropriations]",5,0,0,0,5
1594919,1198298,2022-05-02,Senate,"Placed on suspense file",7,0,0,0,7
1594920,1190618,2022-04-19,Senate,"Do pass as amended, but first amend, and re-refer to the Committee on [Housing] with the recommendation: To Consent Calendar",11,0,0,0,11
1594920,1201483,2022-05-09,Senate,"Placed on suspense file",7,0,0,0,7
1594920,1206615,2022-05-19,Senate,"Do pass",7,0,0,0,7
1594920,1209365,2022-05-25,Senate,"Special Consent SB1396",39,0,0,1,40
1594920,1217381,2022-06-21,Assembly,"Do pass and be re-referred to the Committee on [Appropriations] with recommendation: To Consent Calendar",10,0,0,0,10
1594920,1223613,2022-08-11,Assembly,"Do pass",16,0,0,0,16
1594920,1225078,2022-08-29,Assembly,"SB 1396 Bradford Senate Third Reading By Mia Bonta",79,0,0,1,80
1594920,1225353,2022-08-30,Senate,"Unfinished Business SB1396 Bradford Concurrence",40,0,0,0,40
1594921,1184712,2022-04-06,Senate,"Do pass as amended, but first amend, and re-refer to the Committee on [Appropriations] with the recommendation: To Consent Calendar",7,0,0,0,7
1594921,1201479,2022-05-09,Senate,"Consent Calendar SB1397",33,0,0,7,40
1594921,1216605,2022-06-15,Assembly,"Do pass and be re-referred to the Committee on [Appropriations] with recommendation: To Consent Calendar",6,0,0,1,7
1594921,1220590,2022-06-29,Assembly,"Do pass. To Consent Calendar",14,0,0,2,16
1594921,1225080,2022-08-29,Assembly,"SB 1397 Borgeas Senate Third Reading By Cunningham",79,0,0,1,80
1594921,1225781,2022-08-30,Senate,"Unfinished Business SB1397 Borgeas et al. Concurrence",40,0,0,0,40
1594922,1189926,2022-04-19,Senate,"Do pass, but first be re-referred to the Committee on [Judiciary] with the recommendation: To Consent Calendar",16,0,0,1,17
1594922,1194449,2022-04-26,Senate,"Do pass, but first be re-referred to the Committee on [Appropriations] with the recommendation: To Consent Calendar",11,0,0,0,11
1594922,1207714,2022-05-23,Senate,"Senate 3rd Reading SB1398 Gonzalez",31,0,0,9,40
1594922,1217338,2022-06-20,Assembly,"Do pass and be re-referred to the Committee on [Judiciary]",13,0,0,2,15
1594922,1219911,2022-06-28,Assembly,"Do pass as amended and be re-referred to the Committee on [Appropriations]",10,1,0,0,11
1594922,1223931,2022-08-11,Assembly,"Do pass",14,0,0,2,16
1594922,1224606,2022-08-23,Assembly,"SB 1398 Gonzalez Senate Third Reading By Cunningham",70,0,0,10,80
1594922,1225864,2022-08-30,Senate,"Unfinished Business SB1398 Gonzalez Concurrence",39,0,0,1,40
1594923,1189979,2022-04-18,Senate,"Do pass as amended, but first amend, and re-refer to the Committee on [Appropriations]",9,0,0,5,14
1594923,1204547,2022-05-16,Senate,"Placed on suspense file",6,0,0,1,7
1594923,1206271,2022-05-19,Senate,"Do pass as amended",5,2,0,0,7
1594923,1209282,2022-05-25,Senate,"Senate 3rd Reading SB1399 Wieckowski",30,5,0,5,40
1594925,1190568,2022-04-20,Senate,"Do pass as amended, but first amend, and re-refer to the Committee on [Judiciary]",4,0,0,3,7
1594925,1194495,2022-04-26,Senate,"Do pass, but first be re-referred to the Committee on [Appropriations]",9,1,0,1,11
1594925,1201393,2022-05-09,Senate,"Placed on suspense file",7,0,0,0,7
1594926,1189853,2022-04-18,Senate,"Do pass, but first be re-referred to the Committee on [Appropriations] with the recommendation: To Consent Calendar",5,0,0,0,5
1594926,1201392,2022-05-09,Senate,"Consent Calendar SB1402",33,0,0,7,40
1594926,1217896,2022-06-22,Assembly,"Do pass and be re-referred to the Committee on [Appropriations] with recommendation: To Consent Calendar",7,0,0,0,7
1594926,1222986,2022-08-03,Assembly,"Do pass. To Consent Calendar",15,0,0,1,16
1594926,1223420,2022-08-11,Assembly,"SB 1402 Umberg Consent Calendar Second Day Regular Session",76,0,0,4,80
1594927,1193281,2022-04-26,Senate,"Do pass, but first be re-referred to the Committee on [Appropriations] with the recommendation: To Consent Calendar",13,0,0,2,15
1594927,1204115,2022-05-12,Senate,"Consent Calendar SB1403",35,0,0,5,40
1594927,1214961,2022-06-08,Assembly,"Do pass and be re-referred to the Committee on [Appropriations] with recommendation: To Consent Calendar",21,0,0,1,22
1594927,1217888,2022-06-22,Assembly,"Do pass. To Consent Calendar",13,0,0,3,16
1594928,1190673,2022-04-20,Senate,"Do pass, but first be re-referred to the Committee on [Natural Resources and Water]",5,2,0,0,7
1594928,1193286,2022-04-26,Senate,"Do pass as amended, but first amend, and re-refer to the Committee on [Appropriations]",7,1,0,1,9
1594928,1201360,2022-05-09,Senate,"Placed on suspense file",7,0,0,0,7
1594929,1185730,2022-04-07,Senate,"Do pass as amended, but first amend, and re-refer to the Committee on [Judiciary]",5,0,0,0,5
1594929,1199961,2022-05-03,Senate,"Do pass and be ordered to the Consent Calendar",11,0,0,0,11
1594929,1204088,2022-05-12,Senate,"Consent Calendar SB1405",35,0,0,5,40
1594929,1214982,2022-06-08,Assembly,"Do pass",7,0,0,1,8
1594929,1215778,2022-06-14,Assembly,"Do pass. To Consent Calendar",10,0,0,1,11
1594929,1225094,2022-08-29,Assembly,"SB 1405 Ochoa Bogh Senate Third Reading",79,0,0,1,80
1594930,1183750,2022-04-04,Senate,"Do pass, but first be re-referred to the Committee on [Judiciary] with the recommendation: To Consent Calendar",5,0,0,0,5
1594930,1190633,2022-04-19,Senate,"Do pass, but first be re-referred to the Committee on [Appropriations] with the recommendation: To Consent Calendar",11,0,0,0,11
1594930,1198297,2022-05-02,Senate,"Placed on suspense file",7,0,0,0,7
1594930,1206650,2022-05-19,Senate,"Do pass",7,0,0,0,7
1594930,1209280,2022-05-25,Senate,"Special Consent SB1406",39,0,0,1,40
1594930,1218046,2022-06-22,Assembly,"Do pass and be re-referred to the Committee on [Judiciary] with recommendation: To Consent Calendar",7,0,0,0,7
1594930,1220116,2022-06-28,Assembly,"Do pass and be re-referred to the Committee on [Appropriations] with recommendation: To Consent Calendar",11,0,0,0,11
1594930,1223918,2022-08-11,Assembly,"Do pass",16,0,0,0,16
1594930,1224803,2022-08-24,Assembly,"SB 1406 Durazo Senate Third Reading By Stone",75,1,0,4,80
1594931,1189317,2022-04-18,Senate,"Do pass, but first be re-referred to the Committee on [Appropriations]",12,0,0,2,14
1594931,1198247,2022-05-02,Senate,"Placed on suspense file",7,0,0,0,7
1594931,1206371,2022-05-19,Senate,"Do pass",7,0,0,0,7
1594931,1209377,2022-05-25,Senate,"Special Consent SB1407",39,0,0,1,40
1594931,1217407,2022-06-21,Assembly,"Do pass as amended, and be re-referred to the Committee on [Appropriations] with recommendation: To Consent Calendar",6,0,0,0,6
1594931,1223946,2022-08-11,Assembly,"Do pass as amended",12,0,0,4,16
1594931,1224344,2022-08-22,Assembly,"SB 1407 Becker Senate Third Reading By Cervantes",76,0,0,4,80
1594931,1225550,2022-08-30,Senate,"Special Consent SB1407",38,0,0,2,40
1594933,1194173,2022-04-27,Senate,"Do pass, but first be re-referred to the Committee on [Appropriations]",1,3,0,1,5
1594934,1194310,2022-04-27,Senate,"Do pass as amended, but first amend, and re-refer to the Committee on [Appropriations]",7,0,0,0,7
1594934,1204593,2022-05-16,Senate,"Placed on suspense file",6,0,0,1,7
1594934,1206632,2022-05-19,Senate,"Do pass",5,0,0,2,7
1594934,1209227,2022-05-25,Senate,"Senate 3rd Reading SB1410 Caballero et al",39,0,0,1,40
1594934,1217078,2022-06-20,Assembly,"Do pass and be re-referred to the Committee on [Appropriations] with recommendation: To Consent Calendar",9,0,0,2,11
1594935,1190504,2022-04-20,Senate,"Do pass as amended, but first amend, and re-refer to the Committee on [Appropriations]",5,0,0,0,5
1594935,1198330,2022-05-02,Senate,"Placed on suspense file",7,0,0,0,7
1594937,1190657,2022-04-19,Senate,"Do pass, but first be re-referred to the Committee on [Appropriations]",4,0,0,1,5
1594937,1198317,2022-05-02,Senate,"Placed on suspense file",7,0,0,0,7
1594937,1206739,2022-05-19,Senate,"Do pass",7,0,0,0,7
1594937,1209259,2022-05-25,Senate,"Special Consent SB1413",39,0,0,1,40
1594939,1190571,2022-04-20,Senate,"Do pass, but first be re-referred to the Committee on [Appropriations]",6,2,0,1,9
1594939,1207782,2022-05-23,Senate,"Senate 3rd Reading SB1415 Lim贸n",29,7,0,4,40
1594939,1217114,2022-06-20,Assembly,"Do pass and be re-referred to the Committee on [Appropriations]",9,0,0,3,12
1594939,1220835,2022-06-29,Assembly,"Do pass",11,2,0,3,16
1594939,1224880,2022-08-25,Assembly,"SB 1415 Lim贸n Senate Third Reading By GRAYSON",59,3,0,18,80
1594939,1225964,2022-08-30,Senate,"Unfinished Business SB1415 Lim贸n et al. Concurrence",31,9,0,0,40
1594940,1191347,2022-04-20,Senate,"Do pass as amended, but first amend, and re-refer to the Committee on [Judiciary]",9,0,0,2,11
1594940,1194107,2022-04-26,Senate,"Do pass, but first be re-referred to the Committee on [Appropriations]",10,0,0,1,11
1594940,1201461,2022-05-09,Senate,"Placed on suspense file",7,0,0,0,7
1594940,1206735,2022-05-19,Senate,"Do pass as amended",7,0,0,0,7
1594940,1210003,2022-05-26,Senate,"Senate 3rd Reading SB1416 Eggman",37,0,0,3,40
1594940,1217379,2022-06-21,Assembly,"Do pass and be re-referred to the Committee on [Judiciary]",15,0,0,0,15
1594942,1189939,2022-04-19,Senate,"Do pass, but first be re-referred to the Committee on [Appropriations]",5,0,0,0,5
1594942,1198262,2022-05-02,Senate,"Placed on suspense file",7,0,0,0,7
1594942,1206648,2022-05-19,Senate,"Do pass as amended",6,0,0,1,7
1594942,1209992,2022-05-26,Senate,"Senate 3rd Reading SB1418 Newman et al",36,0,0,4,40
1594942,1215762,2022-06-14,Assembly,"Do pass as amended, and be re-referred to the Committee on [Appropriations] with recommendation: To Consent Calendar",7,0,0,1,8
1594943,1184709,2022-04-06,Senate,"Do pass as amended, but first amend, and re-refer to the Committee on [Judiciary]",8,2,0,1,11
1594943,1190500,2022-04-19,Senate,"Do pass, but first be re-referred to the Committee on [Appropriations]",9,2,0,0,11
1594943,1198284,2022-05-02,Senate,"Placed on suspense file",7,0,0,0,7
1594943,1206825,2022-05-19,Senate,"Do pass",5,2,0,0,7
1594943,1208497,2022-05-24,Senate,"Senate 3rd Reading SB1419 Becker",28,8,0,4,40
1594943,1215914,2022-06-14,Assembly,"Do pass as amended and be re-referred to the Committee on [Judiciary]",10,3,0,2,15
1594943,1223572,2022-08-11,Assembly,"Do pass",12,4,0,0,16
1594943,1225125,2022-08-29,Assembly,"SB 1419 Becker Senate Third Reading By Arambula",53,22,0,5,80
1594943,1225442,2022-08-30,Senate,"Unfinished Business SB1419 Becker Concurrence",31,9,0,0,40
1594944,1194361,2022-04-27,Senate,"Do pass, but first be re-referred to the Committee on [Appropriations]",1,2,0,2,5
1594944,1194362,2022-04-27,Senate,"[First] hearing set for [04-27-2022]: Failed passage in Committee. Reconsideration granted",5,0,0,0,5
1594945,1183642,2022-04-05,Senate,"Do pass, but first be re-referred to the Committee on [Housing] with the recommendation: To Consent Calendar",5,0,0,0,5
1594945,1194212,2022-04-27,Senate,"Do pass, but first be re-referred to the Committee on [Appropriations] with the recommendation: To Consent Calendar",9,0,0,0,9
1594945,1204140,2022-05-12,Senate,"Consent Calendar SB1421",35,0,0,5,40
1594945,1216318,2022-06-15,Assembly,"Do pass and be re-referred to the Committee on [Human Services] with recommendation: To Consent Calendar",8,0,0,0,8
1594945,1219938,2022-06-28,Assembly,"Do pass and be re-referred to the Committee on [Appropriations]",7,0,0,1,8
1594945,1222951,2022-08-03,Assembly,"Do pass. To Consent Calendar",15,0,0,1,16
1594945,1223577,2022-08-11,Assembly,"SB 1421 Jones Consent Calendar Second Day Regular Session",76,0,0,4,80
1594945,1225784,2022-08-30,Assembly,"SB 1421 Jones Senate Third Reading By Flora",79,0,0,1,80
1594945,1225785,2022-08-31,Senate,"Unfinished Business SB1421 Jones Concurrence",40,0,0,0,40
1594946,1185747,2022-04-07,Senate,"Do pass as amended, but first amend, and re-refer to the Committee on [Governmental Organization]",5,0,0,0,5
1594946,1193158,2022-04-26,Senate,"Do pass, but first be re-referred to the Committee on [Appropriations]",10,0,0,5,15
1594946,1201485,2022-05-09,Senate,"Placed on suspense file",7,0,0,0,7
1594946,1206596,2022-05-19,Senate,"Do pass",6,0,0,1,7
1594946,1208450,2022-05-24,Senate,"Senate 3rd Reading SB1422 Hertzberg",30,0,0,10,40
1594946,1220694,2022-06-29,Assembly,"Do pass and be re-referred to the Committee on [Appropriations]",7,0,0,0,7
1594946,1223445,2022-08-11,Assembly,"Do pass",14,1,0,1,16
1594946,1224155,2022-08-18,Assembly,"SB 1422 Hertzberg Senate Third Reading By Santiago",68,0,0,12,80
1594946,1224831,2022-08-24,Senate,"Unfinished Business SB1422 Hertzberg Concurrence",36,0,0,4,40
1594947,1189983,2022-04-19,Senate,"Do pass, but first be re-referred to the Committee on [Appropriations]",6,1,0,2,9
1594947,1198281,2022-05-02,Senate,"Placed on suspense file",7,0,0,0,7
1594949,1185678,2022-04-07,Senate,"Do pass as amended, but first amend, and re-refer to the Committee on [Appropriations]",5,0,0,0,5
1594949,1207760,2022-05-23,Senate,"Senate 3rd Reading SB1425 Stern et al",31,5,0,4,40
1594949,1216648,2022-06-15,Assembly,"Do pass and be re-referred to the Committee on [Appropriations]",6,1,0,1,8
1594949,1220794,2022-06-29,Assembly,"Do pass",11,4,0,1,16
1594949,1224389,2022-08-22,Assembly,"SB 1425 Stern Senate Third Reading By Luz Rivas",58,14,0,8,80
1594950,1183675,2022-04-05,Senate,"Do pass, but first be re-referred to the Committee on [Natural Resources and Water]",4,0,0,1,5
1594950,1193418,2022-04-26,Senate,"Do pass as amended, but first amend, and re-refer to the Committee on [Appropriations]",8,0,0,1,9
1594950,1204613,2022-05-16,Senate,"Placed on suspense file",6,0,0,1,7
1594951,1183797,2022-04-05,Senate,"Do pass, but first be re-referred to the Committee on [Appropriations]",4,0,0,1,5
1594951,1189292,2022-04-18,Senate,"Placed on suspense file",7,0,0,0,7
1594951,1206729,2022-05-19,Senate,"Do pass",7,0,0,0,7
1594951,1209237,2022-05-25,Senate,"Special Consent SB1427",39,0,0,1,40
1594951,1220110,2022-06-28,Assembly,"Do pass and be re-referred to the Committee on [Appropriations] with recommendation: To Consent Calendar",7,0,0,0,7
1594952,1183672,2022-04-04,Senate,"Do pass, but first be re-referred to the Committee on [Appropriations]",12,0,0,2,14
1594952,1209977,2022-05-26,Senate,"Senate 3rd Reading SB1428 Archuleta et al",36,0,0,4,40
1594952,1220065,2022-06-28,Assembly,"Do pass and be re-referred to the Committee on [Appropriations]",17,0,0,1,18
1594952,1223778,2022-08-11,Assembly,"Do pass",16,0,0,0,16
1594952,1225083,2022-08-29,Assembly,"SB 1428 Archuleta Senate Third Reading By Salas",76,0,0,4,80
1594955,1190523,2022-04-20,Senate,"Do pass, but first be re-referred to the Committee on [Appropriations]",7,0,0,0,7
1594955,1198307,2022-05-02,Senate,"Placed on suspense file",7,0,0,0,7
1594955,1206939,2022-05-19,Senate,"Do pass as amended",7,0,0,0,7
1594955,1209986,2022-05-26,Senate,"Special Consent SB1431",38,0,0,2,40
1594956,1193359,2022-04-26,Senate,"Do pass, but first be re-referred to the Committee on [Appropriations]",12,0,0,2,14
1594956,1207871,2022-05-23,Senate,"Senate 3rd Reading SB1432 Hueso",36,0,0,4,40
1594956,1220830,2022-06-29,Assembly,"Do pass as amended, and be re-referred to the Committee on [Appropriations] with recommendation: To Consent Calendar",13,0,0,2,15
1594956,1223399,2022-08-11,Assembly,"Do pass",16,0,0,0,16
1594956,1225087,2022-08-29,Assembly,"SB 1432 Hueso Senate Third Reading By Eduardo Garcia",78,0,0,2,80
1594956,1225894,2022-08-30,Senate,"Unfinished Business SB1432 Hueso Concurrence",40,0,0,0,40
1594957,1189356,2022-04-18,Senate,"Do pass, but first be re-referred to the Committee on [Education]",12,0,0,2,14
1594957,1194304,2022-04-27,Senate,"Do pass, but first be re-referred to the Committee on [Appropriations]",7,0,0,0,7
1594957,1201408,2022-05-09,Senate,"Placed on suspense file",7,0,0,0,7
1594957,1206909,2022-05-19,Senate,"Do pass",7,0,0,0,7
1594957,1208437,2022-05-24,Senate,"Senate 3rd Reading SB1433 Roth",36,1,0,3,40
1594957,1217404,2022-06-21,Assembly,"Do pass and be re-referred to the Committee on [Business and Professions]",12,0,0,0,12
1594957,1219966,2022-06-28,Assembly,"Do pass and be re-referred to the Committee on [Appropriations]",13,0,0,5,18
1594957,1223424,2022-08-11,Assembly,"Do pass",12,0,0,4,16
1594957,1225108,2022-08-29,Assembly,"SB 1433 Roth Senate Third Reading By Berman",77,0,0,3,80
1594957,1225175,2022-08-30,Senate,"That the Assembly amendments be concurred in",10,0,0,4,14
1594957,1225610,2022-08-31,Senate,"Unfinished Business SB1433 Roth et al. Concurrence",40,0,0,0,40
1594958,1189394,2022-04-18,Senate,"Do pass as amended, but first amend, and re-refer to the Committee on [Appropriations]",12,0,0,2,14
1594958,1201382,2022-05-09,Senate,"Placed on suspense file",7,0,0,0,7
1594958,1206614,2022-05-19,Senate,"Do pass",7,0,0,0,7
1594958,1209354,2022-05-25,Senate,"Special Consent SB1434",39,0,0,1,40
1594958,1220026,2022-06-28,Assembly,"Do pass and be re-referred to the Committee on [Appropriations]",17,0,0,1,18
1594958,1223401,2022-08-11,Assembly,"Do pass",16,0,0,0,16
1594958,1224371,2022-08-22,Assembly,"SB 1434 Roth Senate Third Reading By Berman",76,0,0,4,80
1594958,1225855,2022-08-29,Senate,"Unfinished Business SB1434 Roth et al. Concurrence",40,0,0,0,40
1594959,1193393,2022-04-26,Senate,"Do pass, but first be re-referred to the Committee on [Appropriations] with the recommendation: To Consent Calendar",5,0,0,2,7
1594959,1204094,2022-05-12,Senate,"Consent Calendar SB1435 M.V.A",35,0,0,5,40
1594959,1215772,2022-06-14,Assembly,"Do pass and be re-referred to the Committee on [Appropriations]",7,0,0,2,9
1594959,1217867,2022-06-22,Assembly,"Do pass. To Consent Calendar",13,0,0,3,16
1594959,1221582,2022-06-29,Assembly,"SB 1435 M. & V. A. Consent Calendar Second Day Regular Session",78,0,0,2,80
1594960,1189366,2022-04-18,Senate,"Do pass as amended, but first amend, and re-refer to the Committee on [Appropriations]",12,0,0,2,14
1594960,1201469,2022-05-09,Senate,"Placed on suspense file",7,0,0,0,7
1594960,1206383,2022-05-19,Senate,"Do pass",7,0,0,0,7
1594960,1208440,2022-05-24,Senate,"Senate 3rd Reading SB1436 Roth",37,0,0,3,40
1594960,1220028,2022-06-28,Assembly,"Do pass and be re-referred to the Committee on [Appropriations]",17,0,0,1,18
1594960,1223612,2022-08-11,Assembly,"Do pass",16,0,0,0,16
1594960,1224316,2022-08-22,Assembly,"SB 1436 Roth Senate Third Reading By Berman",76,0,0,4,80
1594960,1225854,2022-08-30,Senate,"Special Consent SB1436",38,0,0,2,40
1594961,1189346,2022-04-18,Senate,"Do pass as amended",12,0,0,2,14
1594961,1208526,2022-05-24,Senate,"Senate 3rd Reading SB1437 Roth",37,0,0,3,40
1594961,1219942,2022-06-28,Assembly,"Do pass and be re-referred to the Committee on [Appropriations] with recommendation: To Consent Calendar",17,0,0,1,18
1594961,1222953,2022-08-03,Assembly,"Do pass. To Consent Calendar",15,0,0,1,16
1594961,1225040,2022-08-29,Assembly,"SB 1437 Roth Senate Third Reading By Berman",79,0,0,1,80
1594962,1189353,2022-04-18,Senate,"Do pass as amended, but first amend, and re-refer to the Committee on [Judiciary]",13,0,0,1,14
1594962,1201365,2022-05-09,Senate,"Placed on suspense file",7,0,0,0,7
1594962,1206435,2022-05-19,Senate,"Do pass",7,0,0,0,7
1594962,1209248,2022-05-25,Senate,"Special Consent SB1438",39,0,0,1,40
1594962,1219957,2022-06-28,Assembly,"Do pass as amended and be re-referred to the Committee on [Appropriations]",16,0,0,2,18
1594962,1223968,2022-08-11,Assembly,"Do pass",16,0,0,0,16
1594962,1224393,2022-08-22,Assembly,"SB 1438 Roth Senate Third Reading By Berman",77,0,0,3,80
1594962,1225841,2022-08-30,Senate,"Special Consent SB1438",38,0,0,2,40
1594963,1179374,2022-03-28,Senate,"Do pass, but first be re-referred to the Committee on [Appropriations]",5,0,0,0,5
1594963,1189337,2022-04-18,Senate,"Placed on suspense file",7,0,0,0,7
1594963,1206758,2022-05-19,Senate,"Do pass as amended",5,2,0,0,7
1594963,1206759,2022-05-19,Senate,"[05-19-2022] set for [First] hearing: Reconsideration of favorable vote granted",7,0,0,0,7
1594963,1206760,2022-05-19,Senate,"Do pass",5,0,0,2,7
1594963,1209258,2022-05-25,Senate,"Senate 3rd Reading SB1439 Glazer et al",34,0,0,6,40
1594963,1220634,2022-06-29,Assembly,"Do pass and be re-referred to the Committee on [Appropriations]",5,0,0,2,7
1594963,1223824,2022-08-11,Assembly,"Do pass as amended",13,0,0,3,16
1594963,1225966,2022-08-31,Senate,"Unfinished Business SB1439 Glazer et al. Concurrence",32,0,0,8,40
1594963,1225967,2022-08-31,Assembly,"SB 1439 Glazer Senate Third Reading By Bryan",66,0,0,14,80
1594964,1189359,2022-04-18,Senate,"Do pass, but first be re-referred to the Committee on [Appropriations] with the recommendation: To Consent Calendar",12,0,0,2,14
1594964,1201390,2022-05-09,Senate,"Consent Calendar SB1440",33,0,0,7,40
1594964,1220043,2022-06-28,Assembly,"Do pass and be re-referred to the Committee on [Appropriations] with recommendation: To Consent Calendar",17,0,0,1,18
1594964,1223313,2022-08-10,Assembly,"Do pass. To Consent Calendar",15,0,0,1,16
1594964,1225865,2022-08-31,Assembly,"SB 1440 Roth Senate Third Reading By Berman",80,0,0,0,80
1594965,1173482,2022-03-21,Senate,"Do pass, but first be re-referred to the Committee on [Appropriations] with the recommendation: To Consent Calendar",12,0,0,2,14
1594965,1185734,2022-04-07,Senate,"Consent Calendar SB1441",37,0,0,3,40
1594965,1220096,2022-06-28,Assembly,"Do pass and be re-referred to the Committee on [Appropriations] with recommendation: To Consent Calendar",17,0,0,1,18
1594965,1223316,2022-08-10,Assembly,"Do pass. To Consent Calendar",15,0,0,1,16
1594967,1189378,2022-04-18,Senate,"Do pass, but first be re-referred to the Committee on [Appropriations] with the recommendation: To Consent Calendar",12,0,0,2,14
1594967,1201501,2022-05-09,Senate,"Placed on suspense file",7,0,0,0,7
1594967,1207009,2022-05-19,Senate,"Do pass as amended",7,0,0,0,7
1594967,1210026,2022-05-26,Senate,"Senate 3rd Reading SB1443 Roth",38,0,0,2,40
1594967,1219882,2022-06-28,Assembly,"Do pass and be re-referred to the Committee on [Appropriations]",11,0,0,7,18
1594967,1223724,2022-08-11,Assembly,"Do pass",12,0,0,4,16
1594967,1225052,2022-08-29,Assembly,"SB 1443 Roth Senate Third Reading By Berman",62,0,0,18,80
1594967,1225936,2022-08-30,Senate,"Unfinished Business SB1443 Roth Concurrence",38,0,0,2,40
1594968,1190711,2022-04-20,Senate,"Do pass and be ordered to the Consent Calendar",12,0,0,0,12
1594968,1195795,2022-04-28,Senate,"Consent Calendar SB1444 Allen",37,0,0,3,40
1594968,1215026,2022-06-08,Assembly,"Do pass and be re-referred to the Committee on [Housing and Community Development] with recommendation: To Consent Calendar",8,0,0,0,8
1594968,1220865,2022-06-29,Assembly,"Do pass",7,0,0,1,8
1594968,1225089,2022-08-29,Assembly,"SB 1444 Allen Senate Third Reading By Muratsuchi",61,2,0,17,80
1594968,1225172,2022-08-30,Senate,"That the Assembly amendments be concurred in",3,1,0,1,5
1594968,1225919,2022-08-31,Senate,"Unfinished Business SB1444 Allen et al. Concurrence",30,2,0,8,40
1594970,1195858,2022-04-27,Senate,"Do pass, but first be re-referred to the Committee on [Appropriations]",7,1,0,3,11
1594970,1201514,2022-05-09,Senate,"Placed on suspense file",7,0,0,0,7
1594970,1206506,2022-05-19,Senate,"Do pass",5,2,0,0,7
1594970,1210018,2022-05-26,Senate,"Senate 3rd Reading SB1446 Stern et al",31,3,0,6,40
1594970,1217477,2022-06-21,Assembly,"Do pass as amended and be re-referred to the Committee on [Appropriations]",13,1,0,1,15
1594970,1223647,2022-08-11,Assembly,"Do pass as amended",12,2,0,2,16
1594970,1225741,2022-08-30,Assembly,"SB 1446 Stern Senate Third Reading By Santiago",61,5,0,14,80
1594970,1225742,2022-08-31,Senate,"Unfinished Business SB1446 Stern et al. Concurrence",30,7,0,3,40
1594973,1185679,2022-04-07,Senate,"Do pass as amended, but first amend, and re-refer to the Committee on [Appropriations]",4,0,0,1,5
1594973,1192224,2022-04-25,Senate,"Placed on suspense file",5,0,0,2,7
1594973,1206306,2022-05-19,Senate,"Do pass",6,0,0,1,7
1594973,1209349,2022-05-25,Senate,"Senate 3rd Reading SB1449 Caballero",39,0,0,1,40
1594973,1220839,2022-06-29,Assembly,"Do pass and be re-referred to the Committee on [Appropriations]",8,0,0,0,8
1594973,1223765,2022-08-11,Assembly,"Do pass",16,0,0,0,16
1594973,1225081,2022-08-29,Assembly,"SB 1449 Caballero Senate Third Reading By AGUIAR-CURRY",79,0,0,1,80
1594976,1179181,2022-03-29,Senate,"Do pass as amended, but first amend, and re-refer to the Committee on [Appropriations]",13,0,0,2,15
1594976,1207734,2022-05-23,Senate,"Senate 3rd Reading SB1452 Dahle",37,0,0,3,40
1594976,1214967,2022-06-08,Assembly,"Do pass as amended and be re-referred to the Committee on [Appropriations]",21,0,0,1,22
1594976,1220824,2022-06-29,Assembly,"Do pass",15,0,0,1,16
1594976,1223197,2022-08-08,Assembly,"SB 1452 Dahle Senate Third Reading By Bigelow",76,0,0,4,80
1594976,1224938,2022-08-25,Senate,"Unfinished Business SB1452 Dahle Concurrence",40,0,0,0,40
1594977,1189379,2022-04-18,Senate,"Do pass as amended, but first amend, and re-refer to the Committee on [Appropriations]",13,0,0,1,14
1594977,1207874,2022-05-23,Senate,"Senate 3rd Reading SB1453 Ochoa Bogh",37,0,0,3,40
1594977,1220007,2022-06-28,Assembly,"Do pass as amended and be re-referred to the Committee on [Appropriations]",17,0,0,1,18
1594977,1222967,2022-08-03,Assembly,"Do pass. To Consent Calendar",15,0,0,1,16
1594977,1225921,2022-08-30,Senate,"Unfinished Business SB1453 Ochoa Bogh Concurrence",40,0,0,0,40
1594977,1225922,2022-08-30,Assembly,"SB 1453 Ochoa Bogh Senate Third Reading By Holden",79,0,0,1,80
1594980,1190617,2022-04-20,Senate,"Do pass, but first be re-referred to the Committee on [Appropriations]",5,0,0,0,5
1594980,1198326,2022-05-02,Senate,"Placed on suspense file",7,0,0,0,7
1594980,1206769,2022-05-19,Senate,"Do pass",7,0,0,0,7
1594980,1209374,2022-05-25,Senate,"Special Consent SB1456",39,0,0,1,40
1594981,1176508,2022-03-24,Senate,"Do pass as amended, but first amend, and re-refer to the Committee on [Governance and Finance]",6,1,0,2,9
1594981,1185676,2022-04-07,Senate,"Do pass as amended, but first amend, and re-refer to the Committee on [Appropriations]",5,0,0,0,5
1594981,1192221,2022-04-25,Senate,"Placed on suspense file",5,0,0,2,7
1594981,1206600,2022-05-19,Senate,"Do pass",5,2,0,0,7
1594981,1209300,2022-05-25,Senate,"Senate 3rd Reading SB1457 Hertzberg et al. Urgency Clause",28,7,0,5,40
1594982,1194231,2022-04-27,Senate,"Do pass, but first be re-referred to the Committee on [Appropriations]",3,1,0,1,5
1594982,1201431,2022-05-09,Senate,"Placed on suspense file",7,0,0,0,7
1594986,1191271,2022-04-20,Senate,"Do pass as amended, but first amend, and re-refer to the Committee on [Appropriations] with the recommendation: To Consent Calendar",9,0,0,2,11
1594986,1198315,2022-05-02,Senate,"Placed on suspense file",7,0,0,0,7
1594992,1194232,2022-04-26,Senate,"Do pass, but first be re-referred to the Committee on [Appropriations]",5,0,0,0,5
1594992,1201424,2022-05-09,Senate,"Placed on suspense file",7,0,0,0,7
1594992,1206694,2022-05-19,Senate,"Do pass as amended",7,0,0,0,7
1594992,1210000,2022-05-26,Senate,"Senate 3rd Reading SB1468 Glazer et al",38,0,0,2,40
1594992,1220088,2022-06-28,Assembly,"Do pass as amended, and be re-referred to the Committee on [Appropriations] with recommendation: To Consent Calendar",7,0,0,0,7
1594992,1223545,2022-08-11,Assembly,"Do pass",16,0,0,0,16
1594992,1225120,2022-08-29,Assembly,"SB 1468 Glazer Senate Third Reading By Santiago",79,0,0,1,80
1594992,1225204,2022-08-30,Senate,"Unfinished Business SB1468 Glazer et al. Concurrence",40,0,0,0,40
1594993,1189965,2022-04-18,Senate,"Do pass as amended, but first amend, and re-refer to the Committee on [Appropriations]",11,0,0,3,14
1594993,1207882,2022-05-23,Senate,"Senate 3rd Reading SB1469 Bradford et al",36,0,0,4,40
1594993,1217941,2022-06-22,Assembly,"Do pass and be re-referred to the Committee on [Appropriations]",14,0,0,1,15
1594993,1223872,2022-08-11,Assembly,"Do pass",16,0,0,0,16
1594993,1225056,2022-08-29,Assembly,"SB 1469 Bradford Senate Third Reading By Holden",75,0,0,5,80
1594993,1225216,2022-08-30,Senate,"Unfinished Business SB1469 Bradford et al. Concurrence",40,0,0,0,40
1594996,1194421,2022-04-26,Senate,"Do pass as amended, but first amend, and re-refer to the Committee on [Appropriations]",4,0,0,1,5
1594996,1204549,2022-05-16,Senate,"Placed on suspense file",6,0,0,1,7
1594996,1206385,2022-05-19,Senate,"Do pass as amended",7,0,0,0,7
1594996,1210033,2022-05-26,Senate,"Special Consent SB1472",38,0,0,2,40
1594996,1217440,2022-06-21,Assembly,"Do pass as amended, and be re-referred to the Committee on [Appropriations] with recommendation: To Consent Calendar",7,0,0,0,7
1594996,1223585,2022-08-11,Assembly,"Do pass",16,0,0,0,16
1594996,1224484,2022-08-23,Assembly,"SB 1472 Stern Senate Third Reading By Gabriel",77,0,0,3,80
1594996,1225889,2022-08-30,Senate,"Special Consent SB1472",38,0,0,2,40
1594997,1180230,2022-03-30,Senate,"Do pass, but first be re-referred to the Committee on [Appropriations] with the recommendation: To Consent Calendar",11,0,0,0,11
1594997,1191253,2022-04-21,Senate,"Consent Calendar SB1473",39,0,0,1,40
1594997,1219917,2022-06-28,Assembly,"Do pass as amended and be re-referred to the Committee on [Appropriations]",11,3,0,1,15
1594997,1223388,2022-08-11,Assembly,"Do pass as amended",12,4,0,0,16
1594997,1225463,2022-08-31,Senate,"Unfinished Business SB1473 Pan Urgency Clause Concurrence",32,0,0,8,40
1594997,1225464,2022-08-31,Assembly,"SB 1473 Pan Third Reading Urgency By Akilah Weber",60,17,0,3,80
1594999,1184717,2022-04-06,Senate,"Do pass as amended",8,1,0,2,11
1594999,1195840,2022-04-28,Senate,"Senate 3rd Reading SB1475 Glazer et al",27,1,0,12,40
1594999,1215906,2022-06-14,Assembly,"Do pass as amended and be re-referred to the Committee on [Business and Professions]",9,0,0,6,15
1594999,1219918,2022-06-28,Assembly,"Do pass as amended",14,1,0,3,18
1594999,1225887,2022-08-30,Senate,"Unfinished Business SB1475 Glazer et al. Concurrence",33,4,0,3,40
1594999,1225888,2022-08-30,Assembly,"SB 1475 Glazer Senate Third Reading By Akilah Weber",60,3,0,17,80
1595000,1200492,2022-05-04,Senate,"Do pass as amended",5,0,0,0,5
1595000,1207702,2022-05-23,Senate,"Senate 3rd Reading SB1476 Bradford",37,0,0,3,40
1595000,1220581,2022-06-29,Assembly,"Do pass as amended",8,0,0,0,8
1595000,1223570,2022-08-11,Assembly,"SB 1476 Bradford Senate Third Reading By McKinnor",75,0,0,5,80
1595000,1224135,2022-08-17,Senate,"Unfinished Business SB1476 Bradford Concurrence",38,0,0,2,40
1595001,1184671,2022-04-05,Senate,"Do pass as amended",7,2,0,2,11
1595001,1207772,2022-05-23,Senate,"Senate 3rd Reading SB1477 Wieckowski et al",27,9,0,4,40
1595001,1215745,2022-06-14,Assembly,"Do pass",8,2,0,1,11
1595001,1224242,2022-08-18,Assembly,"SB 1477 Wieckowski Senate Third Reading By Luz Rivas Amendment Set #1",42,3,0,35,80
1595001,1225526,2022-08-30,Senate,"Unfinished Business SB1477 Wieckowski et al. Concurrence",29,9,0,2,40
1595001,1225527,2022-08-30,Assembly,"SB 1477 Wieckowski Senate Third Reading By Luz Rivas",52,19,0,9,80
1595002,1183700,2022-04-05,Senate,"Do pass, but first be re-referred to the Committee on [Military and Veterans Affairs]",11,1,0,3,15
1595002,1193169,2022-04-26,Senate,"Do pass, but first be re-referred to the Committee on [Appropriations]",5,0,0,2,7
1595002,1201418,2022-05-09,Senate,"Placed on suspense file",7,0,0,0,7
1595002,1206387,2022-05-19,Senate,"Do pass",6,0,0,1,7
1595002,1209294,2022-05-25,Senate,"Senate 3rd Reading SB1478 Archuleta",38,0,0,2,40
1595003,1180275,2022-03-30,Senate,"Do pass as amended, but first amend, and re-refer to the Committee on [Education]",9,2,0,0,11
1595003,1194281,2022-04-27,Senate,"Do pass, but first be re-referred to the Committee on [Appropriations]",5,2,0,0,7
1595003,1201395,2022-05-09,Senate,"Placed on suspense file",7,0,0,0,7
1595003,1206241,2022-05-19,Senate,"Do pass",5,2,0,0,7
1595003,1208471,2022-05-24,Senate,"Senate 3rd Reading SB1479 Pan et al",27,9,0,4,40
1595003,1217359,2022-06-21,Assembly,"Do pass and be re-referred to the Committee on [Education]",11,3,0,1,15
1595003,1220576,2022-06-29,Assembly,"Do pass as amended and be re-referred to the Committee on [Appropriations]",4,1,0,2,7
1595003,1223726,2022-08-11,Assembly,"Do pass as amended",12,4,0,0,16
1595003,1224154,2022-08-18,Assembly,"SB 1479 Pan Senate Third Reading By Aguiar-Curry",55,16,0,9,80
1595003,1224339,2022-08-22,Senate,"Unfinished Business SB1479 Pan et al. Concurrence",31,9,0,0,40
1595004,1194365,2022-04-27,Senate,"Do pass, but first be re-referred to the Committee on [Appropriations]",4,1,0,0,5
1595004,1201341,2022-05-09,Senate,"Placed on suspense file",7,0,0,0,7
1595004,1206867,2022-05-19,Senate,"Do pass",5,2,0,0,7
1595004,1209312,2022-05-25,Senate,"Senate 3rd Reading SB1480 Glazer et al",28,9,0,3,40
1595005,1180258,2022-03-30,Senate,"Do pass, but first be re-referred to the Committee on [Human Services]",7,0,0,0,7
1595005,1190676,2022-04-19,Senate,"Do pass, but first be re-referred to the Committee on [Appropriations]",3,0,0,2,5
1595005,1198273,2022-05-02,Senate,"Placed on suspense file",7,0,0,0,7
1595005,1206792,2022-05-19,Senate,"Do pass",5,0,0,2,7
1595005,1208443,2022-05-24,Senate,"Senate 3rd Reading SB1481 Becker et al",35,0,0,5,40
1595005,1215865,2022-06-14,Assembly,"Do pass and be re-referred to the Committee on [Education]",7,0,0,1,8
1595005,1220648,2022-06-29,Assembly,"Do pass as amended, and be re-referred to the Committee on [Appropriations] with recommendation: To Consent Calendar",7,0,0,0,7
1595006,1176539,2022-03-24,Senate,"Do pass, but first be re-referred to the Committee on [Transportation]",5,1,0,3,9
1595006,1194317,2022-04-26,Senate,"Do pass, but first be re-referred to the Committee on [Appropriations]",13,3,0,1,17
1595006,1201468,2022-05-09,Senate,"Placed on suspense file",7,0,0,0,7
1595006,1206441,2022-05-19,Senate,"Do pass as amended",5,2,0,0,7
1595006,1209994,2022-05-26,Senate,"Senate 3rd Reading SB1482 Allen et al",28,6,0,6,40
1595006,1220704,2022-06-29,Assembly,"Do pass as amended and be re-referred to the Committee on [Appropriations]",6,0,0,2,8
1595006,1223746,2022-08-11,Assembly,"Do pass as amended",13,3,0,0,16
1595006,1225723,2022-08-30,Assembly,"SB 1482 Allen Senate Third Reading By Kalra",53,15,0,12,80
1595006,1225724,2022-08-31,Senate,"Unfinished Business SB1482 Allen et al. Concurrence",31,9,0,0,40
1595007,1179378,2022-03-28,Senate,"Do pass, but first be re-referred to the Committee on [Appropriations] with the recommendation: To Consent Calendar",5,0,0,0,5
1595007,1189319,2022-04-18,Senate,"Placed on suspense file",7,0,0,0,7
1595008,1200527,2022-05-04,Senate,"Do pass as amended, but first amend, and re-refer to the Committee on [Appropriations]",5,0,0,0,5
1595008,1204566,2022-05-16,Senate,"Placed on suspense file",6,0,0,1,7
1595008,1206645,2022-05-19,Senate,"Do pass",7,0,0,0,7
1595008,1209243,2022-05-25,Senate,"Special Consent SB1484",39,0,0,1,40
1595010,1193232,2022-04-26,Senate,"Do pass as amended, but first amend, and re-refer to the Committee on [Appropriations]",8,1,0,5,14
1595010,1204594,2022-05-16,Senate,"Placed on suspense file",6,0,0,1,7
1595010,1206507,2022-05-19,Senate,"Do pass as amended",4,0,0,3,7
1595010,1209948,2022-05-26,Senate,"Senate 3rd Reading SB1486 Stern et al",5,12,0,23,40
1595011,1194309,2022-04-27,Senate,"Do pass as amended, but first amend, and re-refer to the Committee on [Appropriations] with the recommendation: To Consent Calendar",7,0,0,0,7
1595011,1204646,2022-05-16,Senate,"Placed on suspense file",6,0,0,1,7
1595011,1206253,2022-05-19,Senate,"Do pass",7,0,0,0,7
1595011,1209322,2022-05-25,Senate,"Special Consent SB1487",39,0,0,1,40
1595011,1220860,2022-06-29,Assembly,"Do pass and be re-referred to the Committee on [Appropriations] with recommendation: To Consent Calendar",7,0,0,0,7
1595011,1223783,2022-08-11,Assembly,"Do pass",16,0,0,0,16
1595011,1224212,2022-08-18,Assembly,"SB 1487 Rubio Senate Third Reading By McCarty",76,0,0,4,80
1595011,1225898,2022-08-30,Senate,"Special Consent SB1487",38,0,0,2,40
1595012,1189800,2022-04-19,Senate,"Do pass, but first be re-referred to the Committee on [Judiciary]",15,0,0,2,17
1595012,1194154,2022-04-26,Senate,"Do pass, but first be re-referred to the Committee on [Appropriations]",10,0,0,1,11
1595012,1208502,2022-05-24,Senate,"Senate 3rd Reading SB1488 Glazer",37,0,0,3,40
1595012,1215565,2022-06-13,Assembly,"Do pass and be re-referred to the Committee on [Judiciary]",12,0,0,3,15
1595012,1217405,2022-06-21,Assembly,"Do pass as amended and be re-referred to the Committee on [Appropriations]",9,0,0,1,10
1595012,1223327,2022-08-10,Assembly,"Do pass",15,0,0,1,16
1595012,1224281,2022-08-22,Assembly,"SB 1488 Glazer Senate Third Reading By Mayes",63,2,0,15,80
1595012,1224838,2022-08-24,Senate,"Unfinished Business SB1488 Glazer Concurrence",40,0,0,0,40
1595012,1224839,2022-08-24,Senate,"Unfinished Business SB1488 Glazer Concurrence Reconsider",40,0,0,0,40
1595012,1224840,2022-08-24,Senate,"Unfinished Business SB1488 Glazer Concurrence",36,0,0,4,40
1595015,1173494,2022-03-21,Senate,"Be adopted. Ordered to third reading",4,0,0,1,5
1595015,1185685,2022-04-07,Senate,"Senate 3rd Reading SJR11 Skinner",29,0,0,11,40
1595015,1217961,2022-06-22,Assembly,"Be adopted. To third reading",5,0,0,2,7
1595015,1224069,2022-08-15,Assembly,"SJR 11 Skinner Senate Third Reading By Kalra",60,0,0,20,80
1595851,1162247,2022-03-03,Assembly,"Be adopted. To Consent Calendar",9,0,0,2,11
1595851,1169414,2022-03-14,Assembly,"ACR 149 Rodriguez Consent Calendar Second Day Regular Session",68,0,0,8,76
1595851,1185696,2022-04-07,Senate,"Special Consent ACR149",37,0,0,3,40
1595852,1172346,2022-03-17,Assembly,"Be adopted. To third reading",10,0,0,1,11
1595852,1185675,2022-04-07,Senate,"Special Consent ACR150",37,0,0,3,40
1595853,1193200,2022-04-25,Assembly,"Be adopted. To Consent Calendar",15,0,0,0,15
1595853,1195805,2022-04-28,Assembly,"ACR 151 Berman Consent Calendar Second Day Regular Session",71,0,0,6,77
1595853,1220638,2022-06-28,Senate,"Be adopted, but first be re-referred to the Committee on [Appropriations] with recommendation: To Consent Calendar",16,0,0,1,17
1595853,1223053,2022-08-04,Senate,"Special Consent ACR151",35,0,0,5,40
1595854,1164531,2022-03-07,Senate,"Senate 3rd Reading SCR74 Pan",37,0,0,3,40
1595854,1176529,2022-03-24,Assembly,"Be adopted. To Consent Calendar",10,0,0,1,11
1595854,1181305,2022-03-31,Assembly,"SCR 74 Pan Consent Calendar Second Day Regular Session",68,0,0,8,76
1595856,1189889,2022-04-19,Senate,"Be adopted, but first be re-referred to the Committee on [Appropriations] with recommendation: To Consent Calendar",15,0,0,2,17
1595856,1216636,2022-06-16,Senate,"Senate 3rd Reading SCR75 Grove",35,0,0,5,40
1595856,1219920,2022-06-27,Assembly,"Be adopted. To Consent Calendar",13,0,0,2,15
1595856,1221314,2022-06-30,Assembly,"SCR 75 Grove Consent Calendar Second Day Regular Session",79,0,0,1,80
1595857,1179317,2022-03-28,Senate,"Senate 3rd Reading SR69 Eggman",37,0,0,3,40
1596751,1223028,2022-08-04,Assembly,"Be adopted. To third reading",9,0,0,3,12
1596752,1195766,2022-04-28,Assembly,"Be adopted. To third reading",8,0,0,3,11
1596752,1212436,2022-06-02,Senate,"Special Consent ACR153",33,0,0,7,40
1596753,1154476,2022-02-24,Assembly,"Be adopted. To Consent Calendar",9,0,0,2,11
1596753,1162262,2022-03-03,Assembly,"HR 91 Maienschein Consent Calendar Second Day Regular Session",70,0,0,6,76
1596754,1176509,2022-03-24,Senate,"Senate 3rd Reading SCR76 Hurtado et al",39,0,0,1,40
1596754,1181280,2022-03-31,Assembly,"Be adopted. To Consent Calendar",10,0,0,1,11
1596754,1186263,2022-04-07,Assembly,"SCR 76 Hurtado Consent Calendar Second Day Regular Session",65,0,0,12,77
1597350,1191283,2022-04-20,Assembly,"Do pass and be re-referred to the Committee on [Appropriations] with recommendation: To Consent Calendar",7,0,0,0,7
1597350,1203361,2022-05-11,Assembly,"Do pass. To Consent Calendar",16,0,0,0,16
1597350,1206755,2022-05-19,Assembly,"AB 2955 L. & E. Consent Calendar Second Day Regular Session",72,0,0,6,78
1597350,1220805,2022-06-29,Senate,"Do pass, but first be re-referred to the Committee on [Appropriations]",5,0,0,0,5
1597350,1224163,2022-08-18,Senate,"Assembly 3rd Reading AB2955 L. & E. (Kalra) By Cortese",38,0,0,2,40
1597350,1225095,2022-08-29,Assembly,"With recommendation: That Senate amendments be concurred in",7,0,0,0,7
1597350,1225840,2022-08-30,Assembly,"AB 2955 L. & E. Concurrence in Senate Amendments By KALRA",79,0,0,1,80
1597351,1173512,2022-03-21,Senate,"Senate 3rd Reading SR70 Dodd et al",37,0,0,3,40
1598793,1193312,2022-04-25,Assembly,"Do pass and be re-referred to the Committee on [Appropriations]",15,0,0,0,15
1598793,1203357,2022-05-11,Assembly,"Do pass. To Consent Calendar",16,0,0,0,16
1598793,1206912,2022-05-19,Assembly,"AB 2956 TRANS. Consent Calendar Second Day Regular Session",72,0,0,6,78
1598793,1220816,2022-06-28,Senate,"Do pass, but first be re-referred to the Committee on [Appropriations] with the recommendation: To Consent Calendar",17,0,0,0,17
1598793,1225819,2022-08-29,Senate,"Assembly 3rd Reading AB2956 TRANS. (Friedman) By Gonzalez",38,0,0,2,40
1598793,1225820,2022-08-30,Assembly,"AB 2956 TRANS. Concurrence in Senate Amendments By FRIEDMAN",78,0,0,2,80
1598794,1216631,2022-06-16,Assembly,"Be adopted. To Consent Calendar",8,0,0,3,11
1598794,1218669,2022-06-23,Assembly,"ACR 154 Seyarto Consent Calendar Second Day",74,0,0,6,80
1598794,1223749,2022-08-11,Senate,"Special Consent ACR154",38,0,0,2,40
1598795,1170605,2022-03-15,Assembly,"Be adopted. To Consent Calendar",6,0,0,0,6
1598795,1173500,2022-03-21,Assembly,"AJR 28 Cristina Garcia Assembly Third Reading",72,0,0,4,76
1598795,1193290,2022-04-26,Senate,"Be adopted and be ordered to the Consent Calendar",5,0,0,2,7
1598795,1201454,2022-05-09,Senate,"Consent Calendar AJR28",33,0,0,7,40
1598796,1190602,2022-04-20,Senate,"Do pass, but first be re-referred to the Committee on [Housing] with the recommendation: To Consent Calendar",5,0,0,0,5
1598796,1194487,2022-04-27,Senate,"Do pass, but first be re-referred to the Committee on [Appropriations] with the recommendation: To Consent Calendar",9,0,0,0,9
1598796,1204113,2022-05-12,Senate,"Consent Calendar SB1489 GOV. & F",35,0,0,5,40
1598796,1220798,2022-06-29,Assembly,"Do pass and be re-referred to the Committee on [Appropriations] with recommendation: To Consent Calendar",8,0,0,0,8
1598796,1222944,2022-08-03,Assembly,"Do pass. To Consent Calendar",15,0,0,1,16
1598796,1223894,2022-08-11,Assembly,"SB 1489 GOV.& F. Consent Calendar Second Day Regular Session",76,0,0,4,80
1598796,1225895,2022-08-30,Senate,"Special Consent SB1489 GOV. & F",38,0,0,2,40
1598797,1172339,2022-03-17,Senate,"Do pass and be ordered to the Consent Calendar",5,0,0,0,5
1598797,1176481,2022-03-24,Senate,"Consent Calendar SB1490 GOV. & F. (Caballero) Urgency Clause",39,0,0,1,40
1598797,1214965,2022-06-08,Assembly,"Do pass. To Consent Calendar",8,0,0,0,8
1598797,1216820,2022-06-16,Assembly,"SB 1490 GOV.& F. Consent Calendar Second Day Regular Session",72,0,0,7,79
1598798,1172358,2022-03-17,Senate,"Do pass and be ordered to the Consent Calendar",5,0,0,0,5
1598798,1176483,2022-03-24,Senate,"Consent Calendar SB1491 GOV. & F. (Caballero) Urgency Clause",39,0,0,1,40
1598798,1215016,2022-06-08,Assembly,"Do pass. To Consent Calendar",8,0,0,0,8
1598798,1216827,2022-06-16,Assembly,"SB 1491 GOV.& F. Consent Calendar Second Day Regular Session",72,0,0,7,79
1598799,1172350,2022-03-17,Senate,"Do pass and be ordered to the Consent Calendar",5,0,0,0,5
1598799,1176498,2022-03-24,Senate,"Consent Calendar SB1492 GOV. & F",39,0,0,1,40
1598799,1214978,2022-06-08,Assembly,"Do pass. To Consent Calendar",8,0,0,0,8
1598799,1216822,2022-06-16,Assembly,"SB 1492 GOV.& F. Consent Calendar Second Day Regular Session",72,0,0,7,79
1598800,1181306,2022-03-31,Senate,"Senate 3rd Reading SR71 Lim贸n et al",39,0,0,1,40
1598801,1173484,2022-03-21,Senate,"Senate 3rd Reading SR72 Jones",37,0,0,3,40
1599986,1162255,2022-03-03,Assembly,"Be adopted. To Consent Calendar",9,0,0,2,11
1599986,1169410,2022-03-14,Assembly,"HR 92 Choi Consent Calendar Second Day Regular Session",68,0,0,8,76
1599988,1162251,2022-03-03,Assembly,"Be adopted. To third reading",9,0,0,2,11
1599988,1162252,2022-03-03,Assembly,"HR 94 COOLEY Assembly Third Reading",70,0,0,6,76
1599989,1194175,2022-04-26,Senate,"Do pass as amended, but first amend, and re-refer to the Committee on [Appropriations] with the recommendation: To Consent Calendar",5,0,0,0,5
1599989,1204064,2022-05-12,Senate,"Consent Calendar SB1493 PUB. S",35,0,0,5,40
1599989,1217315,2022-06-21,Assembly,"Do pass and be re-referred to the Committee on [Appropriations] with recommendation: To Consent Calendar",7,0,0,0,7
1599989,1222964,2022-08-03,Assembly,"Do pass. To Consent Calendar",15,0,0,1,16
1599989,1223481,2022-08-11,Assembly,"SB 1493 PUB. S. Consent Calendar Second Day Regular Session",76,0,0,4,80
1599991,1189868,2022-04-19,Senate,"Be adopted, but first be re-referred to the Committee on [Appropriations] with recommendation: To Consent Calendar",15,0,0,2,17
1599991,1195794,2022-04-28,Senate,"Consent Calendar SCR78",37,0,0,3,40
1599991,1220053,2022-06-27,Assembly,"Be adopted. To Consent Calendar",13,0,0,2,15
1599991,1221344,2022-06-30,Assembly,"SCR 78 Durazo Consent Calendar Second Day Regular Session",79,0,0,1,80
1599992,1172335,2022-03-17,Senate,"Senate 3rd Reading SCR79 Ochoa Bogh et al",38,0,0,2,40
1599992,1181298,2022-03-31,Assembly,"Be adopted. To Consent Calendar",10,0,0,1,11
1599992,1186254,2022-04-07,Assembly,"SCR 79 Ochoa Bogh Consent Calendar Second Day Regular Session",65,0,0,12,77
1599993,1167872,2022-03-10,Senate,"Senate 3rd Reading SCR80 Cortese",36,0,0,4,40
1599993,1172362,2022-03-17,Assembly,"Be adopted. To Consent Calendar",10,0,0,1,11
1599993,1176494,2022-03-24,Assembly,"SCR 80 Cortese Consent Calendar Second Day Regular Session",74,0,0,2,76
1601236,1199986,2022-05-04,Assembly,"Do pass. To Consent Calendar",8,0,0,0,8
1601236,1204124,2022-05-12,Assembly,"AB 2957 L. GOV. Consent Calendar Second Day Regular Session",65,0,0,13,78
1601236,1211854,2022-06-01,Senate,"Do pass and be ordered to the Consent Calendar",5,0,0,0,5
1601236,1215266,2022-06-09,Senate,"Consent Calendar AB2957 L. GOV",38,0,0,2,40
1601237,1167916,2022-03-10,Senate,"Senate 3rd Reading SCR81 Rubio et al",34,0,0,6,40
1601237,1172379,2022-03-17,Assembly,"Be adopted. To Consent Calendar",10,0,0,1,11
1601237,1176503,2022-03-24,Assembly,"SCR 81 Rubio Consent Calendar Second Day Regular Session",74,0,0,2,76
1601238,1164535,2022-03-07,Senate,"WORF SCR82 Atkins",30,7,0,3,40
1601238,1169423,2022-03-14,Assembly,"SCR 82 Atkins Senate Third Reading By COOLEY",52,17,0,7,76
1601238,1172357,2022-03-17,Senate,"Unfinished Business SCR82 Atkins Concurrence",30,8,0,2,40
1601239,1167879,2022-03-10,Senate,"Senate 3rd Reading SCR83 Rubio et al",34,0,0,6,40
1601239,1172336,2022-03-17,Assembly,"Be adopted. To Consent Calendar",10,0,0,1,11
1601239,1176515,2022-03-24,Assembly,"SCR 83 Rubio Consent Calendar Second Day Regular Session",74,0,0,2,76
1602322,1167875,2022-03-10,Assembly,"Be adopted. To third reading",10,0,0,1,11
1602322,1185733,2022-04-07,Senate,"Special Consent ACR155",37,0,0,3,40
1602323,1172341,2022-03-17,Assembly,"Be adopted. To third reading",10,0,0,1,11
1602325,1179154,2022-03-29,Senate,"Be adopted. Ordered to third reading",9,0,0,2,11
1602325,1191286,2022-04-21,Senate,"Senate 3rd Reading SJR12 Skinner et al",31,0,0,9,40
1602325,1215022,2022-06-08,Assembly,"Be adopted. To third reading",8,0,0,2,10
1602325,1222627,2022-08-01,Assembly,"SJR 12 Skinner Senate Third Reading By Cristina Garcia",63,0,0,17,80
1604134,1167870,2022-03-10,Assembly,"Be adopted. To third reading",10,0,0,1,11
1604134,1185673,2022-04-07,Senate,"Special Consent ACR156",37,0,0,3,40
1604135,1172396,2022-03-17,Assembly,"Be adopted. To third reading",10,0,0,1,11
1604137,1176545,2022-03-24,Assembly,"Be adopted. To third reading",10,0,0,1,11
1604140,1184641,2022-04-05,Senate,"Be adopted and be ordered to the Consent Calendar",10,0,0,1,11
1604140,1191252,2022-04-21,Senate,"Consent Calendar SJR14 Allen",39,0,0,1,40
1604140,1211929,2022-06-01,Assembly,"Be adopted. To Consent Calendar",10,0,0,1,11
1604140,1214390,2022-06-06,Assembly,"SJR 14 Allen Consent Calendar Second Day",66,0,0,12,78
1604709,1199189,2022-05-03,Assembly,"Do pass as amended. To Consent Calendar",10,0,0,0,10
1604709,1204095,2022-05-12,Assembly,"AB 2958 JUD. Consent Calendar Second Day By STONE",65,0,0,13,78
1604709,1217862,2022-06-21,Senate,"Do pass",11,0,0,0,11
1604709,1224151,2022-08-17,Senate,"Assembly 3rd Reading AB2958 JUD. (Stone) By Umberg Urgency Clause",34,1,0,5,40
1604709,1224271,2022-08-22,Assembly,"AB 2958 JUD. Concurrence - Urgency Added By STONE",74,0,0,6,80
1604710,1189872,2022-04-19,Assembly,"Do pass and be re-referred to the Committee on [Appropriations] with recommendation: To Consent Calendar",9,0,0,2,11
1604710,1199960,2022-05-04,Assembly,"Do pass",14,0,0,2,16
1604710,1204110,2022-05-12,Assembly,"AB 2959 JUD. Assembly Third Reading By STONE",65,0,0,13,78
1604710,1215056,2022-06-08,Senate,"Do pass, but first be re-referred to the Committee on [Appropriations]",7,0,0,4,11
1604710,1224376,2022-08-22,Senate,"Assembly 3rd Reading AB2959 JUD. (Stone) By Wieckowski",40,0,0,0,40
1604711,1189846,2022-04-19,Assembly,"Do pass and be re-referred to the Committee on [Appropriations] with recommendation: To Consent Calendar",9,0,0,2,11
1604711,1199981,2022-05-04,Assembly,"Do pass. To Consent Calendar",14,0,0,2,16
1604711,1204085,2022-05-12,Assembly,"AB 2960 JUD. Consent Calendar Second Day Regular Session",65,0,0,13,78
1604711,1216350,2022-06-14,Senate,"Do pass, but first be re-referred to the Committee on [Appropriations] with the recommendation: To Consent Calendar",11,0,0,0,11
1604711,1221316,2022-06-30,Senate,"Consent Calendar AB2960 JUD",37,0,0,3,40
1604711,1225817,2022-08-29,Senate,"Assembly 3rd Reading AB2960 JUD. (Stone) By Umberg",40,0,0,0,40
1604711,1225818,2022-08-30,Assembly,"AB 2960 JUD. Concurrence in Senate Amendments By STONE",78,0,0,2,80
1604712,1189818,2022-04-19,Assembly,"Do pass as amended, and be re-referred to the Committee on [Appropriations] with recommendation: To Consent Calendar",9,0,0,2,11
1604712,1203369,2022-05-11,Assembly,"Do pass. To Consent Calendar",16,0,0,0,16
1604712,1206494,2022-05-19,Assembly,"AB 2961 JUD. Consent Calendar Second Day Regular Session",72,0,0,6,78
1604712,1216380,2022-06-14,Senate,"Do pass, but first be re-referred to the Committee on [Public Safety] with the recommendation: To Consent Calendar",11,0,0,0,11
1604712,1220817,2022-06-28,Senate,"Do pass, but first be re-referred to the Committee on [Appropriations] with the recommendation: To Consent Calendar",5,0,0,0,5
1604712,1223225,2022-08-08,Senate,"Consent Calendar AB2961 JUD",36,0,0,4,40
1604712,1223747,2022-08-11,Assembly,"AB 2961 JUD. Concurrence in Senate Amendments By STONE",76,0,0,4,80
1604713,1199131,2022-05-03,Assembly,"Do pass as amended. To Consent Calendar",10,0,0,0,10
1604713,1205835,2022-05-18,Assembly,"Do pass. To Consent Calendar",15,0,0,1,16
1604713,1210447,2022-05-25,Assembly,"AB 2962 JUD. Consent Calendar Second Day Regular Session",73,0,0,5,78
1604713,1220721,2022-06-28,Senate,"Do pass as amended, but first amend, and re-refer to the Committee on [Appropriations]",10,0,0,1,11
1604713,1223208,2022-08-08,Senate,"Placed on suspense file",7,0,0,0,7
1604714,1182553,2022-04-04,Senate,"Senate 3rd Reading SCR85 Umberg et al",39,0,0,1,40
1604714,1200504,2022-05-05,Assembly,"Be adopted. To Consent Calendar",8,0,0,2,10
1604714,1204105,2022-05-12,Assembly,"SCR 85 Umberg Consent Calendar Second Day Regular Session",65,0,0,13,78
1604715,1173538,2022-03-21,Senate,"Senate 3rd Reading SR73 Borgeas et al",37,0,0,3,40
1604716,1172409,2022-03-17,Senate,"Senate 3rd Reading SR74 Kamlager et al",38,0,0,2,40
1605377,1193237,2022-04-25,Assembly,"Be adopted. To Consent Calendar",15,0,0,0,15
1605377,1195797,2022-04-28,Assembly,"ACR 157 Salas Consent Calendar Second Day Regular Session",71,0,0,6,77
1605377,1220595,2022-06-28,Senate,"Be adopted, but first be re-referred to the Committee on [Appropriations] with recommendation: To Consent Calendar",16,0,0,1,17
1605377,1223040,2022-08-04,Senate,"Special Consent ACR157",35,0,0,5,40
1605377,1223301,2022-08-08,Assembly,"ACR 157 Salas Concurrence in Senate Amendments",71,0,0,9,80
1605378,1172360,2022-03-17,Assembly,"Be adopted. To third reading",10,0,0,1,11
1605378,1195822,2022-04-28,Senate,"Special Consent ACR158",37,0,0,3,40
1605379,1179799,2022-03-28,Senate,"Senate 3rd Reading SCR86 Grove et al",37,0,0,3,40
1605379,1181255,2022-03-31,Assembly,"Be adopted. To Consent Calendar",10,0,0,1,11
1605379,1186267,2022-04-07,Assembly,"SCR 86 Grove Consent Calendar Second Day Regular Session",65,0,0,12,77
1605380,1172394,2022-03-17,Senate,"Senate 3rd Reading SR75 Skinner et al",38,0,0,2,40
1606121,1193282,2022-04-26,Assembly,"Do pass and be re-referred to the Committee on [Appropriations]",9,0,0,0,9
1606121,1203321,2022-05-11,Assembly,"Do pass. To Consent Calendar",16,0,0,0,16
1606121,1206799,2022-05-19,Assembly,"AB 2963 M. & V. A. Consent Calendar Second Day Regular Session",72,0,0,6,78
1606121,1215852,2022-06-14,Senate,"Do pass, but first be re-referred to the Committee on [Appropriations] with the recommendation: To Consent Calendar",5,0,0,2,7
1606121,1221353,2022-06-30,Senate,"Consent Calendar AB2963 M. & V.A",37,0,0,3,40
1606122,1172347,2022-03-17,Assembly,"Be adopted. To Consent Calendar",10,0,0,1,11
1606122,1176531,2022-03-24,Assembly,"ACR 159 Chen Consent Calendar Second Day",74,0,0,2,76
1606122,1195714,2022-04-28,Senate,"Special Consent ACR159",37,0,0,3,40
1607560,1194121,2022-04-27,Assembly,"Do pass and be re-referred to the Committee on [Appropriations] with recommendation: To Consent Calendar",10,0,0,1,11
1607560,1206959,2022-05-19,Assembly,"Do pass",16,0,0,0,16
1607560,1210601,2022-05-26,Assembly,"AB 2964 AGRI. Assembly Third Reading By RIVAS, R",75,0,0,3,78
1607560,1217378,2022-06-21,Senate,"Do pass, but first be re-referred to the Committee on [Natural Resources and Water] with the recommendation: To Consent Calendar",5,0,0,0,5
1607560,1219976,2022-06-28,Senate,"Do pass as amended, but first amend, and re-refer to the Committee on [Appropriations] with the recommendation: To Consent Calendar",9,0,0,0,9
1607560,1222676,2022-08-01,Senate,"Placed on suspense file",7,0,0,0,7
1607560,1223541,2022-08-11,Senate,"Do pass",7,0,0,0,7
1607560,1225870,2022-08-31,Senate,"Special Consent AB2964 AGRI",40,0,0,0,40
1607560,1225871,2022-08-31,Assembly,"AB 2964 Agriculture Concurrence in Senate Amendments By RIVAS, R",80,0,0,0,80
1607561,1189352,2022-04-18,Assembly,"Do pass. To Consent Calendar",11,0,0,0,11
1607561,1192186,2022-04-25,Assembly,"AB 2965 NAT. RES. Consent Calendar Second Day By RIVAS, L",68,0,0,9,77
1607561,1211917,2022-06-01,Senate,"Do pass and be ordered to the Consent Calendar",6,0,0,1,7
1607561,1215286,2022-06-09,Senate,"Consent Calendar AB2965 NAT. RES",38,0,0,2,40
1607562,1189298,2022-04-18,Assembly,"Do pass and be re-referred to the Committee on [Appropriations] with recommendation: To Consent Calendar",11,0,0,0,11
1607562,1199980,2022-05-04,Assembly,"Do pass. To Consent Calendar",14,0,0,2,16
1607562,1204087,2022-05-12,Assembly,"AB 2966 NAT. RES. Consent Calendar Second Day Regular Session",65,0,0,13,78
1607562,1215768,2022-06-14,Senate,"Do pass, but first be re-referred to the Committee on [Appropriations] with the recommendation: To Consent Calendar",9,0,0,0,9
1607562,1221335,2022-06-30,Senate,"Consent Calendar AB2966 NAT. RES",37,0,0,3,40
1607563,1172342,2022-03-17,Assembly,"Be adopted. To third reading",10,0,0,1,11
1607563,1185674,2022-04-07,Senate,"Special Consent ACR160",37,0,0,3,40
1607564,1176479,2022-03-24,Assembly,"Be adopted. To third reading",10,0,0,1,11
1607564,1181272,2022-03-31,Senate,"Assembly 3rd Reading ACR161 Lee et al. By Eggman",31,0,0,9,40
1607565,1217310,2022-06-21,Assembly,"Be adopted as amended. To Consent Calendar",6,0,0,0,6
1607565,1221587,2022-06-29,Assembly,"AJR 29 Mathis Consent Calendar Second Day",78,0,0,2,80
1607565,1223332,2022-08-10,Senate,"Be adopted as amended, and be ordered to the Consent Calendar",16,0,0,1,17
1607565,1224138,2022-08-17,Senate,"Consent Calendar AJR29",38,0,0,2,40
1607565,1224621,2022-08-23,Assembly,"AJR 29 Mathis Concurrence in Senate Amendments",77,0,0,3,80
1607566,1190603,2022-04-20,Senate,"Do pass and be ordered to the Consent Calendar",5,0,0,0,5
1607566,1195783,2022-04-28,Senate,"Consent Calendar SB1494 GOV. & F",37,0,0,3,40
1607566,1217337,2022-06-20,Assembly,"Do pass",8,0,0,3,11
1607566,1224234,2022-08-18,Assembly,"SB 1494 GOV.& F. Senate Third Reading By IRWIN",76,0,0,4,80
1607566,1225886,2022-08-30,Senate,"Special Consent SB1494 GOV. & F",38,0,0,2,40
1607567,1182534,2022-04-04,Senate,"Senate 3rd Reading SCR87 Nielsen et al",38,0,0,2,40
1607567,1191299,2022-04-21,Assembly,"Be adopted. To Consent Calendar",9,0,0,2,11
1607567,1195776,2022-04-28,Assembly,"SCR 87 Nielsen Consent Calendar Second Day Regular Session",71,0,0,6,77
1607955,1189369,2022-04-18,Senate,"Do pass, but first be re-referred to the Committee on [Appropriations] with the recommendation: To Consent Calendar",12,0,0,2,14
1607955,1201355,2022-05-09,Senate,"Placed on suspense file",7,0,0,0,7
1607955,1207007,2022-05-19,Senate,"Do pass",7,0,0,0,7
1607955,1209362,2022-05-25,Senate,"Special Consent SB1495 B., P. & E.D",39,0,0,1,40
1607955,1219982,2022-06-28,Assembly,"Do pass as amended, and be re-referred to the Committee on [Appropriations] with recommendation: To Consent Calendar",17,0,0,1,18
1607955,1223009,2022-08-03,Assembly,"Do pass. To Consent Calendar",15,0,0,1,16
1607955,1225735,2022-08-30,Senate,"Unfinished Business SB1495 B., P. & E.D. (Roth) Concurrence",37,0,0,3,40
1607955,1225736,2022-08-30,Assembly,"SB 1495 B., P. & E.D. Senate Third Reading By BERMAN",79,0,0,1,80
1607956,1176497,2022-03-24,Senate,"Senate 3rd Reading SR76 Borgeas",39,0,0,1,40
1608376,1194388,2022-04-27,Assembly,"Do pass and be re-referred to the Committee on [Appropriations] with recommendation: To Consent Calendar",6,0,0,1,7
1608376,1205872,2022-05-18,Assembly,"Do pass. To Consent Calendar",15,0,0,1,16
1608376,1210357,2022-05-25,Assembly,"AB 2967 ELECTIONS Consent Calendar Second Day Regular Session",73,0,0,5,78
1608376,1217460,2022-06-21,Senate,"Do pass, but first be re-referred to the Committee on [Appropriations] with the recommendation: To Consent Calendar",5,0,0,0,5
1608376,1223261,2022-08-08,Senate,"Consent Calendar AB2967 ELECTIONS",36,0,0,4,40
1608378,1193231,2022-04-25,Assembly,"Be adopted. To Consent Calendar",15,0,0,0,15
1608378,1195756,2022-04-28,Assembly,"ACR 162 Nguyen Consent Calendar Second Day Regular Session",71,0,0,6,77
1608378,1220847,2022-06-28,Senate,"Be adopted, but first be re-referred to the Committee on [Appropriations] with recommendation: To Consent Calendar",16,0,0,1,17
1608378,1223030,2022-08-04,Senate,"Special Consent ACR162",35,0,0,5,40
1608379,1176526,2022-03-24,Assembly,"Be adopted. To Consent Calendar",10,0,0,1,11
1608379,1181301,2022-03-31,Assembly,"ACR 163 Medina Consent Calendar Second Day Regular Session",68,0,0,8,76
1608379,1195808,2022-04-28,Senate,"Special Consent ACR163",37,0,0,3,40
1608380,1193273,2022-04-25,Assembly,"Be adopted. To Consent Calendar",15,0,0,0,15
1608380,1195826,2022-04-28,Assembly,"ACR 164 Patterson Consent Calendar Second Day Regular Session",71,0,0,6,77
1608380,1220677,2022-06-28,Senate,"Be adopted, but first be re-referred to the Committee on [Appropriations] with recommendation: To Consent Calendar",16,0,0,1,17
1608380,1223054,2022-08-04,Senate,"Special Consent ACR164",35,0,0,5,40
1608381,1176486,2022-03-24,Assembly,"Be adopted. To third reading",10,0,0,1,11
1608381,1195828,2022-04-28,Senate,"Special Consent ACR165",37,0,0,3,40
1608382,1190644,2022-04-20,Senate,"Do pass, but first be re-referred to the Committee on [Appropriations] with the recommendation: To Consent Calendar",5,0,0,0,5
1608382,1201401,2022-05-09,Senate,"Consent Calendar SB1496 GOV. & F",33,0,0,7,40
1608382,1217341,2022-06-20,Assembly,"Do pass as amended, and be re-referred to the Committee on [Appropriations] with recommendation: To Consent Calendar",11,0,0,0,11
1608382,1223587,2022-08-11,Assembly,"Do pass as amended",12,0,0,4,16
1608382,1225901,2022-08-30,Assembly,"SB 1496 GOV.& F. Senate Third Reading By QUIRK",79,0,0,1,80
1608382,1225902,2022-08-31,Senate,"Unfinished Business SB1496 GOV. & F. (Caballero) Concurrence",40,0,0,0,40
1608925,1195803,2022-04-28,Assembly,"Do pass. To Consent Calendar",22,0,0,0,22
1608925,1200693,2022-05-05,Assembly,"AB 2969 G.O. Consent Calendar Second Day Regular Session",61,0,0,17,78
1608925,1215859,2022-06-14,Senate,"Do pass and be ordered to the Consent Calendar",14,0,0,1,15
1608925,1224914,2022-08-25,Senate,"Assembly 3rd Reading AB2969 G.O. (Santiago) By Dodd",40,0,0,0,40
1608925,1224915,2022-08-25,Assembly,"AB 2969 Governmental Organizatio Concurrence in Senate Amendments",73,0,0,7,80
1608926,1195844,2022-04-28,Assembly,"Do pass and be re-referred to the Committee on [Appropriations] with recommendation: To Consent Calendar",22,0,0,0,22
1608927,1195713,2022-04-28,Assembly,"Do pass and be re-referred to the Committee on [Appropriations] with recommendation: To Consent Calendar",22,0,0,0,22
1608927,1205853,2022-05-18,Assembly,"Do pass. To Consent Calendar",15,0,0,1,16
1608927,1210347,2022-05-25,Assembly,"AB 2971 G.O. Consent Calendar Second Day Regular Session",73,0,0,5,78
1608927,1219954,2022-06-28,Senate,"Do pass, but first be re-referred to the Committee on [Appropriations] with the recommendation: To Consent Calendar",13,0,0,2,15
1608927,1225831,2022-08-29,Senate,"Assembly 3rd Reading AB2971 G.O. (Santiago) By Dodd",40,0,0,0,40
1608927,1225832,2022-08-30,Assembly,"AB 2971 Governmental Organizatio Concurrence in Senate Amendments By SANTIAGO",79,0,0,1,80
1608927,1229733,2022-08-30,Senate,"Assembly 3rd Reading AB2971 G.O. (Santiago) By Dodd",40,0,0,0,40
1608929,1195720,2022-04-28,Senate,"Senate 3rd Reading SCR88 Dodd et al",37,0,0,3,40
1608929,1200503,2022-05-05,Assembly,"Be adopted. To Consent Calendar",8,0,0,2,10
1608929,1204065,2022-05-12,Assembly,"SCR 88 Dodd Consent Calendar Second Day Regular Session",65,0,0,13,78
1608930,1189321,2022-04-18,Senate,"Senate 3rd Reading SR77 Cortese et al",36,0,0,4,40
1609633,1193397,2022-04-26,Assembly,"Do pass and be re-referred to the Committee on [Appropriations] with recommendation: To Consent Calendar",6,0,0,0,6
1609633,1205837,2022-05-18,Assembly,"Do pass. To Consent Calendar",15,0,0,1,16
1609633,1210380,2022-05-25,Assembly,"AB 2972 J., E.D. & E. Consent Calendar Second Day Regular Session",73,0,0,5,78
1609633,1215895,2022-06-13,Senate,"Do pass, but first be re-referred to the Committee on [Appropriations] with the recommendation: To Consent Calendar",12,0,0,2,14
1609633,1224208,2022-08-18,Senate,"Assembly 3rd Reading AB2972 J., E.D., & E . (Cervantes) By Becker",38,0,0,2,40
1609633,1225826,2022-08-29,Senate,"Assembly 3rd Reading AB2972 J., E.D., & E . (Cervantes) By Becker",40,0,0,0,40
1609633,1225827,2022-08-30,Assembly,"AB 2972 Jobs, Economic Developme Concurrence in Senate Amendments By CERVANTES",78,0,0,2,80
1609634,1194261,2022-04-26,Assembly,"Do pass and be re-referred to the Committee on [Appropriations]",12,0,0,0,12
1609634,1203377,2022-05-11,Assembly,"Do pass. To Consent Calendar",16,0,0,0,16
1609634,1207003,2022-05-19,Assembly,"AB 2973 HIGHER ED. Consent Calendar Second Day Regular Session",72,0,0,6,78
1609634,1216334,2022-06-15,Senate,"Do pass, but first be re-referred to the Committee on [Appropriations] with the recommendation: To Consent Calendar",6,0,0,1,7
1609634,1224910,2022-08-25,Senate,"Assembly 3rd Reading AB2973 HIGHER ED. (Medina) By Lim贸n",40,0,0,0,40
1609634,1224911,2022-08-25,Assembly,"AB 2973 Higher Education Concurrence in Senate Amendments",74,0,0,6,80
1609635,1185731,2022-04-07,Assembly,"Be adopted. To Consent Calendar",8,0,0,3,11
1609635,1191330,2022-04-21,Assembly,"ACR 166 Calderon Consent Calendar Second Day Regular Session",68,0,0,9,77
1609635,1207875,2022-05-23,Senate,"Special Consent ACR166",36,0,0,4,40
1609636,1189870,2022-04-19,Senate,"Do pass and be ordered to the Consent Calendar",8,0,0,1,9
1609636,1192183,2022-04-25,Senate,"Consent Calendar SB1497 N.R. & W. (Stern)",38,0,0,2,40
1609636,1214386,2022-06-06,Assembly,"Do pass. To Consent Calendar",9,0,0,1,10
1609636,1216818,2022-06-16,Assembly,"SB 1497 N.R. & W. Consent Calendar Second Day Regular Session",72,0,0,7,79
1609637,1190511,2022-04-20,Senate,"Do pass, but first be re-referred to the Committee on [Appropriations] with the recommendation: To Consent Calendar",8,0,0,1,9
1609637,1201471,2022-05-09,Senate,"Consent Calendar SB1498 B. & F.I",33,0,0,7,40
1609637,1217074,2022-06-20,Assembly,"Do pass and be re-referred to the Committee on [Appropriations] with recommendation: To Consent Calendar",10,0,0,2,12
1609637,1220747,2022-06-29,Assembly,"Do pass. To Consent Calendar",14,0,0,2,16
1609637,1224619,2022-08-23,Assembly,"SB 1498 B. & F.I. Senate Third Reading By GRAYSON",77,0,0,3,80
1609637,1225662,2022-08-30,Senate,"Special Consent SB1498 B. & F.I",38,0,0,2,40
1609638,1193243,2022-04-26,Senate,"Be adopted and be ordered to the Consent Calendar",5,0,0,2,7
1609638,1201426,2022-05-09,Senate,"Consent Calendar SJR15 Glazer",33,0,0,7,40
1609638,1215749,2022-06-14,Assembly,"Be adopted. To Consent Calendar",7,0,0,2,9
1609638,1217097,2022-06-20,Assembly,"SJR 15 Glazer Consent Calendar Second Day Regular Session",72,0,0,8,80
1609638,1223061,2022-08-04,Senate,"Unfinished Business SJR15 Glazer et al. Concurrence",37,0,0,3,40
1609639,1189325,2022-04-18,Senate,"Senate 3rd Reading SR78 Gonzalez",36,0,0,4,40
1609979,1193164,2022-04-26,Assembly,"Do pass and be re-referred to the Committee on [Appropriations] with recommendation: To Consent Calendar",6,0,0,0,6
1609979,1206708,2022-05-19,Assembly,"Do pass",16,0,0,0,16
1609979,1207870,2022-05-23,Assembly,"AB 2974 J., E.D. & E. Assembly Third Reading By CERVANTES",72,0,0,6,78
1609979,1220098,2022-06-28,Senate,"Do pass, but first be re-referred to the Committee on [Appropriations]",10,1,0,4,15
1609979,1222665,2022-08-01,Senate,"Placed on suspense file",7,0,0,0,7
1609979,1223645,2022-08-11,Senate,"Do pass",6,0,0,1,7
1609979,1225844,2022-08-29,Senate,"Assembly 3rd Reading AB2974 J., E.D., & E . (Cervantes) By Bradford",38,0,0,2,40
1609979,1225845,2022-08-30,Assembly,"AB 2974 Jobs, Economic Developme Concurrence in Senate Amendments By CERVANTES",79,0,0,1,80
1609979,1229703,2022-08-30,Senate,"Assembly 3rd Reading AB2974 J., E.D., & E . (Cervantes) By Bradford",38,0,0,2,40
1609980,1206307,2022-05-19,Assembly,"Be adopted. To third reading",7,0,0,4,11
1609980,1216645,2022-06-16,Senate,"Special Consent ACR167",35,0,0,5,40
1610393,1181300,2022-03-31,Assembly,"Be adopted. To third reading",10,0,0,1,11
1610393,1198292,2022-05-02,Senate,"Assembly 3rd Reading ACR168",36,0,0,4,40
1610394,1185720,2022-04-07,Assembly,"Be adopted. To Consent Calendar",8,0,0,3,11
1610394,1191284,2022-04-21,Assembly,"HR 98 Gabriel Consent Calendar Second Day Regular Session",68,0,0,9,77
1610395,1210900,2022-05-31,Senate,"Senate 3rd Reading SCR89 Newman",31,0,0,9,40
1610395,1216626,2022-06-16,Assembly,"Be adopted. To Consent Calendar",8,0,0,3,11
1610395,1218666,2022-06-23,Assembly,"SCR 89 Newman Consent Calendar Second Day Regular Session",74,0,0,6,80
1610945,1193350,2022-04-26,Assembly,"Do pass and be re-referred to the Committee on [Appropriations] with recommendation: To Consent Calendar",15,0,0,0,15
1610945,1206856,2022-05-19,Assembly,"Do pass",16,0,0,0,16
1610945,1207790,2022-05-23,Assembly,"AB 2975 Committee on Water, Park Assembly Third Reading By BAUER-KAHAN",72,0,0,6,78
1610945,1215823,2022-06-14,Senate,"Do pass as amended, but first amend, and re-refer to the Committee on [Appropriations] with the recommendation: To Consent Calendar",9,0,0,0,9
1610945,1219414,2022-06-27,Senate,"Placed on suspense file",6,0,0,1,7
1610946,1192200,2022-04-25,Assembly,"Do pass and be re-referred to the Committee on [Appropriations] with recommendation: To Consent Calendar",7,0,0,0,7
1610947,1203363,2022-05-11,Assembly,"Be adopted as amended, and re-refer to the Committee on [Appropriations]",6,2,0,0,8
1612295,1195716,2022-04-28,Assembly,"Be adopted. To third reading",8,0,0,3,11
1612295,1207695,2022-05-23,Senate,"Special Consent ACR169",36,0,0,4,40
1612296,1181271,2022-03-31,Assembly,"Be adopted as amended",10,0,0,1,11
1612297,1198327,2022-05-02,Senate,"Senate 3rd Reading SR79 Durazo et al",36,0,0,4,40
1612313,1191300,2022-04-21,Senate,"Senate 3rd Reading SCR90 Gonzalez et al",39,0,0,1,40
1612313,1200523,2022-05-05,Assembly,"Be adopted. To Consent Calendar",8,0,0,2,10
1612313,1204063,2022-05-12,Assembly,"SCR 90 Gonzalez Consent Calendar Second Day Regular Session",65,0,0,13,78
1612332,1195799,2022-04-28,Assembly,"Be adopted. To Consent Calendar",8,0,0,3,11
1612332,1200697,2022-05-05,Assembly,"HR 99 Gabriel Consent Calendar Second Day Regular Session",61,0,0,17,78
1612632,1191243,2022-04-21,Assembly,"Be adopted. To third reading",9,0,0,2,11
1612632,1207743,2022-05-23,Senate,"Special Consent ACR170",36,0,0,4,40
1612633,1185688,2022-04-07,Assembly,"Be adopted. To Consent Calendar",8,0,0,3,11
1612633,1191281,2022-04-21,Assembly,"ACR 171 Nazarian Consent Calendar Second Day Regular Session",68,0,0,9,77
1612633,1207839,2022-05-23,Senate,"Special Consent ACR171",36,0,0,4,40
1612634,1195750,2022-04-28,Assembly,"Be adopted. To third reading",8,0,0,3,11
1612634,1207819,2022-05-23,Senate,"Special Consent ACR172",36,0,0,4,40
1612635,1191280,2022-04-20,Assembly,"Be adopted as amended. To Consent Calendar",7,0,0,0,7
1612636,1201349,2022-05-09,Senate,"Senate 3rd Reading SCR91 Hurtado",33,0,0,7,40
1612636,1206327,2022-05-19,Assembly,"Be adopted. To Consent Calendar",7,0,0,4,11
1612636,1210611,2022-05-25,Assembly,"SCR 91 Hurtado Consent Calendar Second Day Regular Session",73,0,0,5,78
1612636,1212427,2022-06-02,Senate,"Special Consent SCR91",33,0,0,7,40
1612637,1194161,2022-04-26,Senate,"Be adopted. Ordered to third reading",9,1,0,1,11
1612637,1218614,2022-06-23,Senate,"Senate 3rd Reading SCR92 Leyva et al",29,1,0,10,40
1612637,1223022,2022-08-04,Assembly,"Be adopted and re-referred to the Committee on [Appropriations]",8,0,0,2,10
1612637,1223308,2022-08-10,Assembly,"Be adopted. To third reading",12,2,0,2,16
1612637,1224348,2022-08-22,Assembly,"SCR 92 Leyva Senate Third Reading By Akilah Weber",64,0,0,16,80
1612927,1215556,2022-06-13,Assembly,"Be adopted. To Consent Calendar",14,0,0,1,15
1612927,1216814,2022-06-16,Assembly,"ACR 173 Low Consent Calendar Second Day Regular Session",72,0,0,7,79
1612927,1223339,2022-08-10,Senate,"Be adopted, but first be re-referred to the Committee on [Appropriations] with recommendation: To Consent Calendar",15,0,0,2,17
1612927,1224471,2022-08-23,Senate,"Consent Calendar ACR173 Low",39,0,0,1,40
1612928,1200514,2022-05-05,Assembly,"Be adopted. To third reading",8,0,0,2,10
1612929,1195839,2022-04-28,Senate,"Special Consent SCR93",37,0,0,3,40
1612929,1206756,2022-05-19,Assembly,"Be adopted. To Consent Calendar",7,0,0,4,11
1612929,1210541,2022-05-25,Assembly,"SCR 93 Dodd Consent Calendar Second Day Regular Session",73,0,0,5,78
1612930,1201368,2022-05-09,Senate,"Senate 3rd Reading SR80 Min et al",33,0,0,7,40
1613654,1185703,2022-04-07,Assembly,"Be adopted. To Consent Calendar",8,0,0,3,11
1613654,1191241,2022-04-21,Assembly,"HR 103 Kalra Consent Calendar Second Day Regular Session",68,0,0,9,77
1613655,1195793,2022-04-28,Assembly,"Be adopted. To third reading",8,0,0,3,11
1613656,1204672,2022-05-16,Senate,"Senate 3rd Reading SCR94 Pan",32,0,0,8,40
1613656,1210207,2022-05-27,Assembly,"Be adopted. To Consent Calendar",7,0,0,4,11
1613656,1212433,2022-06-02,Assembly,"SCR 94 Pan Consent Calendar Second Day Regular Session",69,0,0,9,78
1614129,1194102,2022-04-27,Senate,"Do pass, but first be re-referred to the Committee on [Appropriations] with the recommendation: To Consent Calendar",4,0,0,1,5
1614129,1204106,2022-05-12,Senate,"Consent Calendar SB1499 AGRI",35,0,0,5,40
1614129,1220773,2022-06-29,Assembly,"Do pass and be re-referred to the Committee on [Appropriations] with recommendation: To Consent Calendar",8,0,0,3,11
1614129,1223008,2022-08-03,Assembly,"Do pass. To Consent Calendar",15,0,0,1,16
1614129,1223928,2022-08-11,Assembly,"SB 1499 AGRI. Consent Calendar Second Day Regular Session",76,0,0,4,80
1614130,1195768,2022-04-28,Senate,"Senate 3rd Reading SCR95 Wiener et al",37,0,0,3,40
1614130,1204108,2022-05-12,Assembly,"Be adopted. To Consent Calendar",9,0,0,2,11
1614130,1206610,2022-05-19,Assembly,"SCR 95 Wiener Consent Calendar Second Day Regular Session",72,0,0,6,78
1614131,1198254,2022-05-02,Senate,"Senate 3rd Reading SCR96 Min et al",34,0,0,6,40
1614131,1204093,2022-05-12,Assembly,"Be adopted. To Consent Calendar",9,0,0,2,11
1614131,1206876,2022-05-19,Assembly,"SCR 96 Min Consent Calendar Second Day Regular Session",72,0,0,6,78
1614455,1199170,2022-05-03,Assembly,"Be adopted. To third reading",7,0,0,0,7
1614455,1215296,2022-06-09,Senate,"Special Consent ACR174",38,0,0,2,40
1614456,1216634,2022-06-16,Assembly,"Be adopted. To third reading",8,0,0,3,11
1614457,1216646,2022-06-16,Assembly,"Be adopted. To third reading",8,0,0,3,11
1614458,1194430,2022-04-26,Senate,"Be adopted, but first be re-referred to the Committee on [Appropriations] with recommendation: To Consent Calendar",15,0,0,2,17
1614458,1204066,2022-05-12,Senate,"Consent Calendar SCR97",35,0,0,5,40
1614458,1219864,2022-06-27,Assembly,"Be adopted. To Consent Calendar",13,0,0,2,15
1614458,1224185,2022-08-18,Assembly,"SCR 97 Nielsen Senate Third Reading By Megan Dahle",77,0,0,3,80
1614458,1225876,2022-08-30,Senate,"Special Consent SCR97",38,0,0,2,40
1614670,1204134,2022-05-12,Assembly,"Be adopted. To third reading",9,0,0,2,11
1614670,1212440,2022-06-02,Senate,"Special Consent ACR175",33,0,0,7,40
1614671,1194315,2022-04-26,Senate,"Be adopted, but first be re-referred to the Committee on [Appropriations] with recommendation: To Consent Calendar",15,0,0,2,17
1614671,1204130,2022-05-12,Senate,"Consent Calendar SCR98",35,0,0,5,40
1614671,1220033,2022-06-27,Assembly,"Be adopted. To Consent Calendar",13,0,0,2,15
1614671,1221255,2022-06-30,Assembly,"SCR 98 McGuire Consent Calendar Second Day Regular Session",79,0,0,1,80
1615797,1215573,2022-06-13,Assembly,"Be adopted. To Consent Calendar",14,0,0,1,15
1615797,1224217,2022-08-18,Senate,"Assembly 3rd Reading ACR176 Luz Rivas et al. By Hueso",38,0,0,2,40
1615797,1224380,2022-08-22,Assembly,"ACR 176 Luz Rivas Concurrence in Senate Amendments",77,0,0,3,80
1615798,1215561,2022-06-13,Assembly,"Be adopted. To third reading",12,0,0,3,15
1615798,1219435,2022-06-27,Assembly,"ACR 177 Bloom Assembly Third Reading",66,0,0,14,80
1615798,1223319,2022-08-10,Senate,"Be adopted, but first be re-referred to the Committee on [Appropriations]",14,0,0,3,17
1615798,1225910,2022-08-31,Senate,"Assembly 3rd Reading ACR177 Bloom et al. By Allen",31,3,0,6,40
1615798,1225911,2022-08-31,Assembly,"ACR 177 Bloom Concurrence in Senate Amendments",68,0,0,12,80
1615799,1201504,2022-05-09,Senate,"Senate 3rd Reading SCR100 Umberg",33,0,0,7,40
1615799,1206300,2022-05-19,Assembly,"Be adopted. To Consent Calendar",7,0,0,4,11
1615799,1210651,2022-05-25,Assembly,"SCR 100 Umberg Consent Calendar Second Day Regular Session",73,0,0,5,78
1615800,1214393,2022-06-06,Senate,"Senate 3rd Reading SCR101 Archuleta",30,1,0,9,40
1615800,1218625,2022-06-23,Assembly,"Be adopted. To Consent Calendar",8,0,0,4,12
1615800,1221583,2022-06-29,Assembly,"SCR 101 Archuleta Consent Calendar Second Day Regular Session",78,0,0,2,80
1615801,1201446,2022-05-09,Senate,"Senate 3rd Reading SCR102 Archuleta",33,0,0,7,40
1615801,1206874,2022-05-19,Assembly,"Be adopted. To Consent Calendar",7,0,0,4,11
1615801,1210307,2022-05-25,Assembly,"SCR 102 Archuleta Consent Calendar Second Day Regular Session",73,0,0,5,78
1615802,1204572,2022-05-16,Senate,"Senate 3rd Reading SCR103 Pan",32,0,0,8,40
1615802,1215279,2022-06-09,Assembly,"Be adopted. To Consent Calendar",8,0,0,3,11
1615802,1216823,2022-06-16,Assembly,"SCR 103 Pan Consent Calendar Second Day Regular Session",72,0,0,7,79
1615803,1195775,2022-04-28,Senate,"Senate 3rd Reading SCR99 Ochoa Bogh et al",37,0,0,3,40
1615803,1204139,2022-05-12,Assembly,"Be adopted. To Consent Calendar",9,0,0,2,11
1615803,1206445,2022-05-19,Assembly,"SCR 99 Ochoa Bogh Consent Calendar Second Day Regular Session",72,0,0,6,78
1615804,1192254,2022-04-25,Senate,"Senate 3rd Reading SR81 Lim贸n",38,0,0,2,40
1615805,1192229,2022-04-25,Senate,"Senate 3rd Reading SR82 Durazo et al",38,0,0,2,40
1616336,1195748,2022-04-28,Assembly,"Be adopted. To third reading",8,0,0,3,11
1616336,1207849,2022-05-23,Senate,"Special Consent ACR178",36,0,0,4,40
1616337,1195741,2022-04-28,Assembly,"Be adopted. To Consent Calendar",8,0,0,3,11
1616337,1200695,2022-05-05,Assembly,"ACR 179 O'Donnell Consent Calendar Second Day Regular Session",61,0,0,17,78
1616337,1224093,2022-08-16,Senate,"Assembly 3rd Reading ACR179 O'Donnell et al. By McGuire",37,0,0,3,40
1616338,1195744,2022-04-27,Senate,"Do pass, but first be re-referred to the Committee on [Appropriations] with the recommendation: To Consent Calendar",10,0,0,1,11
1616338,1201493,2022-05-09,Senate,"Placed on suspense file",7,0,0,0,7
1616338,1206777,2022-05-19,Senate,"Do pass",7,0,0,0,7
1616338,1209285,2022-05-25,Senate,"Special Consent SB1500 HEALTH",39,0,0,1,40
1616338,1220074,2022-06-28,Assembly,"Do pass and be re-referred to the Committee on [Appropriations] with recommendation: To Consent Calendar",15,0,0,0,15
1616338,1222974,2022-08-03,Assembly,"Do pass. To Consent Calendar",15,0,0,1,16
1616338,1223375,2022-08-11,Assembly,"SB 1500 HEALTH Consent Calendar Second Day Regular Session",76,0,0,4,80
1616338,1225859,2022-08-31,Senate,"Unfinished Business SB1500 HEALTH (Pan) Concurrence",40,0,0,0,40
1616338,1225860,2022-08-31,Assembly,"SB 1500 HEALTH Senate Third Reading By WOOD",78,0,0,2,80
1616339,1198257,2022-05-02,Senate,"Senate 3rd Reading SCR104 Lim贸n",36,0,0,4,40
1616339,1204069,2022-05-12,Assembly,"Be adopted. To Consent Calendar",9,0,0,2,11
1616339,1206994,2022-05-19,Assembly,"SCR 104 Lim贸n Consent Calendar Second Day Regular Session",72,0,0,6,78
1616340,1198236,2022-05-02,Senate,"Senate 3rd Reading SR83 Lim贸n",36,0,0,4,40
1616524,1204075,2022-05-12,Assembly,"Be adopted. To Consent Calendar",9,0,0,2,11
1616524,1206805,2022-05-19,Assembly,"ACR 180 Bauer-Kahan Consent Calendar Second Day Regular Session",72,0,0,6,78
1616524,1215278,2022-06-09,Senate,"Special Consent ACR180",38,0,0,2,40
1616525,1195787,2022-04-28,Assembly,"Be adopted. To third reading",8,0,0,3,11
1616525,1210909,2022-05-31,Assembly,"ACR 181 Bigelow Assembly Third Reading Substitute Motion By REYES",25,19,0,34,78
1616525,1216598,2022-06-16,Senate,"Special Consent ACR181",35,0,0,5,40
1616526,1195782,2022-04-28,Assembly,"Be adopted. To Consent Calendar",8,0,0,3,11
1616527,1217383,2022-06-21,Assembly,"Be adopted. To Consent Calendar",6,0,0,0,6
1616527,1218593,2022-06-23,Assembly,"AJR 30 Gipson Consent Calendar Second Day Regular Session",74,0,0,6,80
1616527,1223329,2022-08-10,Senate,"Be adopted and be ordered to the Consent Calendar",16,0,0,1,17
1616527,1224134,2022-08-17,Senate,"Consent Calendar AJR30",38,0,0,2,40
1616528,1222625,2022-08-01,Senate,"Senate 3rd Reading SR84 Leyva et al",40,0,0,0,40
1616887,1215516,2022-06-13,Assembly,"Be adopted. To Consent Calendar",14,0,0,1,15
1616887,1216813,2022-06-16,Assembly,"ACR 183 Cunningham Consent Calendar Second Day Regular Session",72,0,0,7,79
1616887,1223336,2022-08-10,Senate,"Be adopted, but first be re-referred to the Committee on [Appropriations] with recommendation: To Consent Calendar",15,0,0,2,17
1616887,1224411,2022-08-23,Senate,"Consent Calendar ACR183",39,0,0,1,40
1616888,1195772,2022-04-28,Assembly,"Be adopted. To Consent Calendar",8,0,0,3,11
1616888,1200696,2022-05-05,Assembly,"ACR 184 Cooper Consent Calendar Second Day Regular Session",61,0,0,17,78
1616888,1212441,2022-06-02,Senate,"Special Consent ACR184",33,0,0,7,40
1616889,1210198,2022-05-27,Assembly,"Be adopted. To third reading",7,0,0,4,11
1616890,1210898,2022-05-31,Senate,"Senate 3rd Reading SCR105 Newman",32,0,0,8,40
1616890,1216621,2022-06-16,Assembly,"Be adopted. To Consent Calendar",8,0,0,3,11
1616890,1218616,2022-06-23,Assembly,"SCR 105 Newman Consent Calendar Second Day Regular Session",74,0,0,6,80
1616891,1201399,2022-05-09,Senate,"Senate 3rd Reading SCR106 Newman",33,0,0,7,40
1616891,1206288,2022-05-19,Assembly,"Be adopted. To Consent Calendar",7,0,0,4,11
1616891,1210369,2022-05-25,Assembly,"SCR 106 Newman Consent Calendar Second Day Regular Session",73,0,0,5,78
1616892,1210029,2022-05-26,Senate,"Special Consent SR85",38,0,0,2,40
1617233,1195790,2022-04-28,Assembly,"Be adopted. To third reading",8,0,0,3,11
1617233,1207733,2022-05-23,Senate,"Special Consent ACR185",36,0,0,4,40
1617234,1206997,2022-05-19,Assembly,"Be adopted. To third reading",7,0,0,4,11
1617234,1216606,2022-06-16,Senate,"Special Consent ACR186",35,0,0,5,40
1617734,1215521,2022-06-13,Assembly,"Be adopted. To Consent Calendar",14,0,0,1,15
1617734,1216816,2022-06-16,Assembly,"ACR 187 Grayson Consent Calendar Second Day Regular Session",72,0,0,7,79
1617734,1223328,2022-08-10,Senate,"Be adopted, but first be re-referred to the Committee on [Appropriations] with recommendation: To Consent Calendar",15,0,0,2,17
1617734,1224610,2022-08-23,Senate,"Consent Calendar ACR187",39,0,0,1,40
1617736,1200507,2022-05-05,Assembly,"Be adopted. To third reading",8,0,0,2,10
1617737,1204618,2022-05-16,Senate,"Senate 3rd Reading SCR107 Skinner",32,0,0,8,40
1617737,1215273,2022-06-09,Assembly,"Be adopted. To Consent Calendar",8,0,0,3,11
1617737,1216825,2022-06-16,Assembly,"SCR 107 Skinner Consent Calendar Second Day Regular Session",72,0,0,7,79
1618492,1205819,2022-05-18,Assembly,"Be adopted. To Consent Calendar",12,0,0,2,14
1618492,1210320,2022-05-25,Assembly,"ACR 188 Holden Consent Calendar Second Day Regular Session",73,0,0,5,78
1618492,1216353,2022-06-15,Senate,"Be adopted as amended",14,0,0,0,14
1618492,1223302,2022-08-08,Senate,"Special Consent ACR188",36,0,0,4,40
1618492,1223539,2022-08-11,Assembly,"ACR 188 Holden Concurrence in Senate Amendments",75,0,0,5,80
1618675,1204062,2022-05-12,Assembly,"Be adopted. To third reading",9,0,0,2,11
1618676,1201375,2022-05-09,Senate,"Senate 3rd Reading SCR108 Ochoa Bogh et al",33,0,0,7,40
1618676,1206233,2022-05-19,Assembly,"Be adopted. To Consent Calendar",7,0,0,4,11
1618676,1210316,2022-05-25,Assembly,"SCR 108 Ochoa Bogh Consent Calendar Second Day Regular Session",73,0,0,5,78
1618677,1204553,2022-05-16,Senate,"Senate 3rd Reading SR86 Wiener et al",32,0,0,8,40
1618864,1200513,2022-05-05,Assembly,"Be adopted. To Consent Calendar",8,0,0,2,10
1618864,1204137,2022-05-12,Assembly,"HR 110 Valladares Consent Calendar Second Day Regular Session",65,0,0,13,78
1618865,1204100,2022-05-12,Senate,"Senate 3rd Reading SR87 Rubio et al",35,0,0,5,40
1618866,1208439,2022-05-24,Senate,"Senate 3rd Reading SR88 Eggman et al",33,0,0,7,40
1619046,1217420,2022-06-20,Assembly,"Be adopted. To Consent Calendar",10,1,0,4,15
1619046,1221252,2022-06-30,Assembly,"AJR 32 Nazarian Assembly Third Reading",61,0,0,19,80
1619572,1212431,2022-06-02,Senate,"Senate 3rd Reading SR89 Skinner et al",33,0,0,7,40
1619573,1210943,2022-05-31,Senate,"Senate 3rd Reading SR90 Durazo",32,0,0,8,40
1620378,1215295,2022-06-09,Assembly,"Be adopted. To third reading",8,0,0,3,11
1620378,1223163,2022-08-08,Senate,"Special Consent ACR190",36,0,0,4,40
1620379,1212429,2022-06-02,Assembly,"Be adopted. To Consent Calendar",8,0,0,3,11
1620379,1215282,2022-06-09,Assembly,"ACR 191 Kalra Consent Calendar Second Day",69,0,0,9,78
1620379,1221326,2022-06-30,Senate,"Special Consent ACR191",37,0,0,3,40
1620911,1206745,2022-05-19,Assembly,"Be adopted. To third reading",7,0,0,4,11
1620911,1216649,2022-06-16,Senate,"Special Consent ACR192",35,0,0,5,40
1620912,1206687,2022-05-19,Assembly,"Be adopted. To Consent Calendar",7,0,0,4,11
1620912,1210310,2022-05-25,Assembly,"ACR 193 Bloom Consent Calendar Second Day Regular Session",73,0,0,5,78
1620912,1215274,2022-06-09,Senate,"Special Consent ACR193",38,0,0,2,40
1620913,1215815,2022-06-14,Assembly,"Be adopted. To third reading",10,1,0,1,12
1620913,1217094,2022-06-20,Assembly,"AJR 33 Santiago Assembly Third Reading",56,0,0,24,80
1621092,1215551,2022-06-13,Assembly,"Be adopted. To Consent Calendar",14,0,0,1,15
1621092,1216819,2022-06-16,Assembly,"ACR 194 Cooper Consent Calendar Second Day Regular Session",72,0,0,7,79
1621092,1223320,2022-08-10,Senate,"Be adopted, but first be re-referred to the Committee on [Appropriations] with recommendation: To Consent Calendar",15,0,0,2,17
1621092,1224424,2022-08-23,Senate,"Consent Calendar ACR194",39,0,0,1,40
1621092,1224843,2022-08-24,Assembly,"ACR 194 Cooper Concurrence in Senate Amendments",76,0,0,4,80
1621093,1215562,2022-06-13,Assembly,"Be adopted. To Consent Calendar",14,0,0,1,15
1621093,1216797,2022-06-16,Assembly,"ACR 195 Villapudua Consent Calendar Second Day Regular Session",72,0,0,7,79
1621093,1223337,2022-08-10,Senate,"Be adopted, but first be re-referred to the Committee on [Appropriations] with recommendation: To Consent Calendar",15,0,0,2,17
1621093,1224509,2022-08-23,Senate,"Consent Calendar ACR195",39,0,0,1,40
1621094,1206556,2022-05-19,Assembly,"Be adopted. To third reading",7,0,0,4,11
1621094,1221237,2022-06-30,Senate,"Special Consent ACR196",37,0,0,3,40
1621430,1223280,2022-08-08,Senate,"Senate 3rd Reading SR91 Lim贸n et al",37,0,0,3,40
1621713,1215058,2022-06-08,Assembly,"Be adopted. To Consent Calendar",10,0,0,0,10
1621713,1221343,2022-06-30,Senate,"Special Consent ACR197",37,0,0,3,40
1621714,1215047,2022-06-08,Assembly,"Be adopted. To third reading",9,0,0,1,10
1621714,1218613,2022-06-23,Assembly,"AJR 34 McCarty Assembly Third Reading",74,0,0,6,80
1621715,1216639,2022-06-16,Senate,"Senate 3rd Reading SCR109 Bradford et al",35,0,0,5,40
1621715,1221269,2022-06-30,Assembly,"Be adopted. To Consent Calendar",7,0,0,4,11
1621715,1223036,2022-08-04,Assembly,"SCR 109 Bradford Consent Calendar Second Day Regular Session",76,0,0,4,80
1621716,1215306,2022-06-09,Senate,"Special Consent SCR110",38,0,0,2,40
1621716,1218663,2022-06-23,Assembly,"Be adopted. To Consent Calendar",8,0,0,4,12
1621716,1221585,2022-06-29,Assembly,"SCR 110 Caballero Consent Calendar Second Day Regular Session",78,0,0,2,80
1622209,1223045,2022-08-04,Assembly,"Be adopted. To Consent Calendar",9,0,0,3,12
1622209,1223525,2022-08-11,Assembly,"HR 111 Seyarto Consent Calendar Second Day Regular Session",76,0,0,4,80
1622959,1210213,2022-05-27,Assembly,"Be adopted. To Consent Calendar",7,0,0,4,11
1622959,1212434,2022-06-02,Assembly,"HR 112 Cristina Garcia Consent Calendar Second Day",69,0,0,9,78
1623100,1220688,2022-06-28,Senate,"Be adopted, but first be re-referred to the Committee on [Appropriations]",16,0,0,1,17
1623100,1223228,2022-08-08,Senate,"Senate 3rd Reading SCR111 Dodd et al",37,0,0,3,40
1623100,1225168,2022-08-30,Assembly,"Be adopted. To Consent Calendar",11,0,0,4,15
1623100,1225914,2022-08-31,Assembly,"SCR 111 Dodd Consent Calendar First Day",78,0,0,2,80
1623101,1215545,2022-06-13,Senate,"Senate 3rd Reading SCR112 Dodd",37,0,0,3,40
1623101,1218599,2022-06-23,Assembly,"Be adopted. To Consent Calendar",8,0,0,4,12
1623101,1221584,2022-06-29,Assembly,"SCR 112 Dodd Consent Calendar Second Day Regular Session",78,0,0,2,80
1623323,1216618,2022-06-15,Assembly,"Be adopted, and re-refer to the Committee on [Appropriations] with recommendation: To Consent Calendar",6,0,0,1,7
1623323,1220673,2022-06-29,Assembly,"Be adopted. To Consent Calendar",14,0,0,2,16
1623323,1222618,2022-08-01,Assembly,"HR 113 Mia Bonta Consent Calendar Second Day",75,0,0,5,80
1623324,1217052,2022-06-20,Senate,"Senate 3rd Reading SCR113 Ochoa Bogh et al",38,0,0,2,40
1623324,1221362,2022-06-30,Assembly,"Be adopted. To Consent Calendar",7,0,0,4,11
1623324,1223017,2022-08-04,Assembly,"SCR 113 Ochoa Bogh Consent Calendar Second Day Regular Session",76,0,0,4,80
1623325,1217073,2022-06-20,Senate,"Senate 3rd Reading SR92 Eggman et al",33,0,0,7,40
1623489,1215300,2022-06-09,Assembly,"Be adopted. To Consent Calendar",8,0,0,3,11
1623489,1216798,2022-06-16,Assembly,"ACR 199 Bauer-Kahan Consent Calendar Second Day",72,0,0,7,79
1623489,1223281,2022-08-08,Senate,"Special Consent ACR199",36,0,0,4,40
1623490,1216637,2022-06-16,Assembly,"Be adopted. To third reading",8,0,0,3,11
1623491,1223059,2022-08-04,Senate,"Senate 3rd Reading SCR114 Gonzalez et al",37,0,0,3,40
1623491,1223714,2022-08-11,Assembly,"Be adopted. To Consent Calendar",7,0,0,5,12
1623491,1224221,2022-08-18,Assembly,"SCR 114 Gonzalez Consent Calendar Second Day Regular Session",73,0,0,7,80
1623492,1223055,2022-08-04,Senate,"Senate 3rd Reading SCR115 Bates et al",37,0,0,3,40
1623492,1223911,2022-08-11,Assembly,"Be adopted. To Consent Calendar",7,0,0,5,12
1623492,1224222,2022-08-18,Assembly,"SCR 115 Bates Consent Calendar Second Day Regular Session",73,0,0,7,80
1623493,1217059,2022-06-20,Senate,"Senate 3rd Reading SCR116 Stern et al",37,0,0,3,40
1623493,1221330,2022-06-30,Assembly,"Be adopted. To Consent Calendar",7,0,0,4,11
1623493,1223015,2022-08-04,Assembly,"SCR 116 Stern Consent Calendar Second Day Regular Session",76,0,0,4,80
1623691,1218630,2022-06-23,Assembly,"Be adopted. To Consent Calendar",8,0,0,4,12
1623691,1221581,2022-06-29,Assembly,"ACR 200 Low Consent Calendar Second Day Regular Session",78,0,0,2,80
1623691,1223513,2022-08-11,Senate,"Special Consent ACR200",38,0,0,2,40
1623692,1223033,2022-08-04,Assembly,"Be adopted as amended. To Consent Calendar",7,0,0,3,10
1623926,1215538,2022-06-13,Assembly,"Be adopted. To Consent Calendar",14,0,0,1,15
1623926,1216826,2022-06-16,Assembly,"ACR 201 Robert Rivas Consent Calendar Second Day Regular Session",72,0,0,7,79
1623926,1223309,2022-08-10,Senate,"Be adopted, but first be re-referred to the Committee on [Appropriations] with recommendation: To Consent Calendar",15,0,0,2,17
1623926,1224417,2022-08-23,Senate,"Consent Calendar ACR201",39,0,0,1,40
1623927,1215514,2022-06-13,Assembly,"Be adopted. To Consent Calendar",14,0,0,1,15
1623927,1216824,2022-06-16,Assembly,"ACR 202 Robert Rivas Consent Calendar Second Day Regular Session",72,0,0,7,79
1623927,1223324,2022-08-10,Senate,"Be adopted, but first be re-referred to the Committee on [Appropriations] with recommendation: To Consent Calendar",15,0,0,2,17
1623927,1224421,2022-08-23,Senate,"Consent Calendar ACR202",39,0,0,1,40
1623927,1224744,2022-08-24,Assembly,"ACR 202 Robert Rivas Concurrence in Senate Amendments",75,0,0,5,80
1623929,1221339,2022-06-30,Assembly,"Be adopted. To third reading",7,0,0,4,11
1623930,1215275,2022-06-09,Assembly,"Be adopted. To Consent Calendar",8,0,0,3,11
1623930,1216868,2022-06-16,Assembly,"HR 117 Robert Rivas Consent Calendar Second Day Regular Session",72,0,0,7,79
1624067,1215564,2022-06-13,Assembly,"Be adopted. To Consent Calendar",14,0,0,1,15
1624067,1216799,2022-06-16,Assembly,"ACR 203 Stone Consent Calendar Second Day Regular Session",72,0,0,7,79
1624067,1223331,2022-08-10,Senate,"Be adopted, but first be re-referred to the Committee on [Appropriations] with recommendation: To Consent Calendar",15,0,0,2,17
1624067,1224452,2022-08-23,Senate,"Consent Calendar ACR203",39,0,0,1,40
1624068,1215571,2022-06-13,Assembly,"Be adopted. To Consent Calendar",14,0,0,1,15
1624068,1216821,2022-06-16,Assembly,"ACR 204 Stone Consent Calendar Second Day Regular Session",72,0,0,7,79
1624068,1223338,2022-08-10,Senate,"Be adopted, but first be re-referred to the Committee on [Appropriations] with recommendation: To Consent Calendar",15,0,0,2,17
1624068,1224435,2022-08-23,Senate,"Consent Calendar ACR204",39,0,0,1,40
1624069,1216615,2022-06-16,Assembly,"Be adopted. To third reading",8,0,0,3,11
1624069,1224038,2022-08-11,Senate,"Special Consent ACR205",38,0,0,2,40
1624070,1215869,2022-06-14,Senate,"Be adopted, but first be re-referred to the Committee on [Appropriations]",4,1,0,0,5
1624070,1215870,2022-06-14,Senate,"Be adopted, but first be re-referred to the Committee on [Elections and Constitutional Amendments]",9,1,0,1,11
1624070,1216628,2022-06-16,Senate,"Be adopted",5,2,0,0,7
1624070,1217075,2022-06-20,Senate,"Senate 3rd Reading SCA10 Atkins et al",29,8,0,3,40
1624070,1218611,2022-06-23,Assembly,"Be adopted",7,2,0,1,10
1624070,1219371,2022-06-27,Assembly,"SCA 10 Atkins Senate Third Reading By RENDON",58,17,0,5,80
1624505,1217347,2022-06-21,Assembly,"Be adopted. To Consent Calendar",12,0,0,0,12
1624506,1219443,2022-06-27,Senate,"Senate 3rd Reading SR94",37,0,0,3,40
1624613,1223058,2022-08-04,Assembly,"Be adopted. To third reading",9,0,0,3,12
1624772,1218636,2022-06-23,Assembly,"Be adopted. To third reading",8,0,0,4,12
1624772,1223939,2022-08-11,Senate,"Special Consent ACR207",38,0,0,2,40
1624773,1220107,2022-06-27,Assembly,"Be adopted. To Consent Calendar",13,0,0,2,15
1624773,1221351,2022-06-30,Assembly,"ACR 208 Davies Consent Calendar Second Day Regular Session",79,0,0,1,80
1624773,1223333,2022-08-10,Senate,"Be adopted, but first be re-referred to the Committee on [Appropriations] with recommendation: To Consent Calendar",15,0,0,2,17
1624773,1224494,2022-08-23,Senate,"Consent Calendar ACR208",39,0,0,1,40
1624773,1224808,2022-08-24,Assembly,"ACR 208 Davies Concurrence in Senate Amendments",76,0,0,4,80
1625027,1221277,2022-06-30,Assembly,"Be adopted. To Consent Calendar",7,0,0,4,11
1625027,1223031,2022-08-04,Assembly,"ACR 209 Kalra Consent Calendar Second Day Regular Session",76,0,0,4,80
1625028,1218629,2022-06-23,Assembly,"Be adopted. To Consent Calendar",8,0,0,4,12
1625028,1221701,2022-06-29,Assembly,"HR 119 Levine Consent Calendar Second Day Regular Session",78,0,0,2,80
1625232,1223044,2022-08-04,Assembly,"Be adopted. To third reading",9,0,0,3,12
1625285,1220095,2022-06-27,Assembly,"Be adopted. To Consent Calendar",13,0,0,2,15
1625285,1221234,2022-06-30,Assembly,"ACR 211 Fong Consent Calendar Second Day Regular Session",79,0,0,1,80
1625285,1223318,2022-08-10,Senate,"Be adopted, but first be re-referred to the Committee on [Appropriations] with recommendation: To Consent Calendar",15,0,0,2,17
1625285,1224404,2022-08-23,Senate,"Consent Calendar ACR211",39,0,0,1,40
1625285,1224814,2022-08-24,Assembly,"ACR 211 Fong Concurrence in Senate Amendments",77,0,0,3,80
1625286,1221284,2022-06-30,Assembly,"Be adopted. To third reading",7,0,0,4,11
1625287,1223330,2022-08-10,Senate,"Be adopted, but first be re-referred to the Committee on [Appropriations] with recommendation: To Consent Calendar",15,0,0,2,17
1625287,1224508,2022-08-23,Senate,"Consent Calendar SCR117 Nielsen",39,0,0,1,40
1625287,1225171,2022-08-30,Assembly,"Be adopted. To Consent Calendar",11,0,0,4,15
1625287,1225843,2022-08-31,Assembly,"SCR 117 Nielsen Consent Calendar First Day Regular Session",78,0,0,2,80
1625370,1221259,2022-06-30,Assembly,"Be adopted. To Consent Calendar",7,0,0,4,11
1625370,1223039,2022-08-04,Assembly,"ACR 212 Kalra Consent Calendar Second Day Regular Session",76,0,0,4,80
1625371,1223065,2022-08-04,Assembly,"Be adopted. To third reading",9,0,0,3,12
1625372,1223063,2022-08-04,Senate,"Senate 3rd Reading SR96 Lim贸n et al",37,0,0,3,40
1625570,1221253,2022-06-30,Assembly,"Be adopted. To Consent Calendar",7,0,0,4,11
1625570,1223019,2022-08-04,Assembly,"HR 122 Kalra Consent Calendar Second Day Regular Session",76,0,0,4,80
1625822,1225441,2022-08-30,Senate,"Senate 3rd Reading SR97 Caballero",40,0,0,0,40
1626084,1223269,2022-08-08,Senate,"Senate 3rd Reading SCR118 Ochoa Bogh et al",37,0,0,3,40
1626084,1223422,2022-08-11,Assembly,"Be adopted. To Consent Calendar",7,0,0,5,12
1626084,1224204,2022-08-18,Assembly,"SCR 118 Ochoa Bogh Consent Calendar Second Day Regular Session",73,0,0,7,80
1627676,1223041,2022-08-04,Assembly,"Be adopted. To third reading",9,0,0,3,12
1627677,1223066,2022-08-04,Assembly,"Be adopted. To Consent Calendar",9,0,0,3,12
1627677,1223469,2022-08-11,Assembly,"ACR 214 Fong Consent Calendar Second Day",76,0,0,4,80
1627678,1223762,2022-08-11,Senate,"Senate 3rd Reading SCR119 Dodd et al",37,0,0,3,40
1627678,1224177,2022-08-18,Assembly,"Be adopted. To Consent Calendar",10,0,0,2,12
1627678,1224588,2022-08-23,Assembly,"SCR 119 Dodd Consent Calendar Second Day",77,0,0,3,80
1627679,1225830,2022-08-30,Senate,"Senate 3rd Reading SCR120 Ochoa Bogh et al",40,0,0,0,40
1627705,1224052,2022-08-11,Assembly,"Be adopted. To Consent Calendar",7,0,0,5,12
1627705,1224174,2022-08-18,Assembly,"HR 123 Reyes Consent Calendar Second Day Regular Session",73,0,0,7,80
1627793,1223767,2022-08-11,Senate,"Senate 3rd Reading SR100 Pan",34,0,0,6,40
1627794,1223367,2022-08-11,Senate,"Senate 3rd Reading SR99 Pan",32,0,0,8,40
1627829,1223349,2022-08-11,Assembly,"Be adopted. To Consent Calendar",7,0,0,5,12
1627829,1224189,2022-08-18,Assembly,"ACR 215 Aguiar-Curry Consent Calendar Second Day",73,0,0,7,80
1627830,1223632,2022-08-11,Assembly,"Be adopted. To third reading",7,0,0,5,12
1627831,1224933,2022-08-25,Assembly,"Be adopted. To Consent Calendar",8,0,0,5,13
1627831,1225385,2022-08-30,Assembly,"HR 125 Reyes Consent Calendar Second Day",76,0,0,4,80
1627832,1225851,2022-08-30,Senate,"Senate 3rd Reading SCR121 Hurtado et al",40,0,0,0,40
1627833,1224623,2022-08-23,Senate,"Special Consent SR101",40,0,0,0,40
1627984,1223518,2022-08-11,Assembly,"Be adopted. To third reading",7,0,0,5,12
1627986,1223944,2022-08-11,Senate,"Senate 3rd Reading SR103 Kamlager",38,0,0,2,40
1627995,1223736,2022-08-11,Assembly,"Be adopted. To third reading",7,0,0,5,12
1628049,1224398,2022-08-23,Assembly,"Be adopted. To third reading",9,0,0,3,12
1628050,1224186,2022-08-18,Assembly,"Be adopted. To third reading",10,0,0,2,12
1628151,1224211,2022-08-18,Assembly,"Be adopted. To third reading",10,0,0,2,12
1628162,1224170,2022-08-18,Assembly,"Be adopted. To third reading",8,2,0,2,12
1628212,1224449,2022-08-23,Assembly,"Be adopted. To Consent Calendar",9,0,0,3,12
1628212,1224879,2022-08-25,Assembly,"HR 132 Fong Consent Calendar Second Day",73,0,0,7,80
1628240,1224425,2022-08-23,Assembly,"Be adopted. To Consent Calendar",9,0,0,3,12
1628240,1224985,2022-08-25,Assembly,"HR 133 Cooley Consent Calendar Second Day Regular Session",73,0,0,7,80
1628241,1224512,2022-08-23,Assembly,"Be adopted. To Consent Calendar",9,0,0,3,12
1628241,1224922,2022-08-25,Assembly,"HR 134 Nguyen Consent Calendar Second Day Regular Session",73,0,0,7,80
