bill_id,roll_call_id,date,chamber,description,yea,nay,nv,absent,total
660960,432536,2015-04-15,Assembly,"Do pass and be re-referred to the Committee on Local Government",6,1,0,0,7
660960,437175,2015-04-22,Assembly,"Do pass and be re-referred to the Committee on Appropriations",7,2,0,0,9
660960,443899,2015-05-06,Assembly,"Do pass",13,3,0,1,17
660960,445135,2015-05-11,Assembly,"AB2 ALEJO  Assembly Third Reading",63,13,0,4,80
660960,458549,2015-06-10,Senate,"Do pass as amended, and re-refer to the Committee on Transportation 	and Housing",5,1,0,1,7
660960,466029,2015-07-14,Senate,"Do pass, but re-refer to the Committee on Appropriations",9,2,0,0,11
660960,473678,2015-08-17,Senate,"Placed on Appropriations Suspense file",7,0,0,0,7
660960,474609,2015-08-27,Senate,"Do pass",5,2,0,0,7
660960,476081,2015-09-09,Senate,"Assembly 3rd Reading AB2 Alejo By Cannella",29,10,1,0,40
660960,476565,2015-09-12,Assembly,"AB2 ALEJO  Concurrence in Senate Amendments",58,15,0,7,80
660961,432597,2015-04-15,Senate,"Do pass, but re-refer to the Committee on Appropriations",2,5,0,0,7
660961,432598,2015-04-15,Senate,"Set, first hearing.  Failed passage in Committee.  Reconsideration 	granted",0,7,0,0,7
660962,428350,2015-04-08,Senate,"Do pass, but re-refer to the Committee on Appropriations",7,0,0,0,7
660962,435251,2015-04-20,Senate,"Placed on Appropriations Suspense file",7,0,0,0,7
660962,453689,2015-05-28,Senate,"Do pass",7,0,0,0,7
660962,455287,2015-06-01,Senate,"Senate 3rd Reading SB25 Roth",40,0,0,0,40
660962,466523,2015-07-15,Assembly,"Do pass and be re-referred to the Committee on Appropriations",9,0,0,0,9
660962,474373,2015-08-27,Assembly,"Do pass as amended",17,0,0,0,17
660962,475408,2015-09-01,Assembly,"SB 25 Roth  Senate Third Reading  By LINDER",79,0,0,1,80
660962,475640,2015-09-02,Senate,"Unfinished Business SB25 Roth Concurrence",40,0,0,0,40
660964,448486,2015-05-18,Assembly,"Do pass as amended and be re-referred to the Committee on 	Appropriations",9,0,0,0,9
660965,436225,2015-04-21,Assembly,"Do pass and be re-referred to the Committee on Appropriations",6,0,0,1,7
660966,448440,2015-05-18,Assembly,"Do pass as amended and be re-referred to the Committee on 	Appropriations",6,3,0,0,9
660966,453624,2015-05-28,Assembly,"Do pass as amended",12,0,0,5,17
660966,456642,2015-06-03,Assembly,"AB 43 STONE  Assembly Third Reading",69,3,0,8,80
660966,465631,2015-07-08,Senate,"Do pass, but re-refer to the Committee on Appropriations",6,0,1,0,7
660966,473725,2015-08-17,Senate,"Placed on Appropriations Suspense file",7,0,0,0,7
660967,428439,2015-04-08,Senate,"Do pass, but re-refer to the Committee on Appropriations",8,0,0,0,8
660967,445125,2015-05-11,Senate,"Placed on Appropriations Suspense file",7,0,0,0,7
660967,453780,2015-05-28,Senate,"Do pass",5,0,2,0,7
660967,455923,2015-06-02,Senate,"Senate 3rd Reading SB15 Block",37,1,2,0,40
660969,427889,2015-04-07,Senate,"Do pass as amended, and re-refer to the Committee on Appropriations",7,0,0,0,7
660969,445518,2015-05-11,Senate,"Placed on Appropriations Suspense file",7,0,0,0,7
660969,454082,2015-05-28,Senate,"Do pass as amended",7,0,0,0,7
660969,456617,2015-06-03,Senate,"Senate 3rd Reading SB29 Beall",40,0,0,0,40
660969,466140,2015-07-14,Assembly,"Do pass and be re-referred to the Committee on Appropriations",7,0,0,0,7
660969,474256,2015-08-27,Assembly,"Do pass as amended",16,1,0,0,17
660969,475676,2015-09-02,Assembly,"SB 29 Beall  Senate Third Reading  By MAIENSCHEIN",77,2,0,1,80
660969,475769,2015-09-03,Senate,"Unfinished Business SB29 Beall Concurrence",37,0,3,0,40
660971,432538,2015-04-15,Assembly,"Do pass as amended and be re-referred to the Committee on Revenue 	and Taxation",7,0,0,0,7
660971,448402,2015-05-18,Assembly,"Do pass as amended and be re-referred to the Committee on 	Appropriations",9,0,0,0,9
660971,454104,2015-05-28,Assembly,"Do pass",17,0,0,0,17
660971,457305,2015-06-04,Assembly,"AB 35 CHIU  Assembly Third Reading",78,0,0,2,80
660971,466101,2015-07-14,Senate,"Do pass, but re-refer to the Committee on Appropriations",10,0,1,0,11
660971,473706,2015-08-17,Senate,"Placed on Appropriations Suspense file",7,0,0,0,7
660971,474528,2015-08-27,Senate,"Do pass",6,0,1,0,7
660971,476485,2015-09-11,Senate,"Assembly 3rd Reading ( Supplemental File 1)AB 35 Ch iu By",38,2,0,0,40
660971,476486,2015-09-12,Assembly,"AB 35 CHIU  Concurrence in Senate Amendments",79,0,0,1,80
660972,415924,2015-03-24,Senate,"Do pass, but re-refer to the Committee on Environmental Quality",7,2,0,0,9
660972,432574,2015-04-15,Senate,"Do pass, but re-refer to the Committee on Appropriations",5,2,0,0,7
660972,453973,2015-05-28,Senate,"Do pass",5,2,0,0,7
660972,455426,2015-06-01,Senate,"Senate 3rd Reading SB20 Pavley",21,15,4,0,40
660972,463624,2015-04-27,Senate,"Placed on Appropriations Suspense file",7,0,0,0,7
660972,555256,2016-06-23,Assembly,"Be referred to Committee on Natural Resources",11,0,0,0,11
660972,556754,2016-06-30,Assembly,"Do pass as amended and be re-referred to the Committee on 	Appropriations",5,2,0,2,9
660972,559329,2016-08-11,Assembly,"Do pass as amended",11,3,0,6,20
660973,382249,2014-12-01,Assembly,"HR3 ATKINS  Assembly Third Reading",80,0,0,0,80
660974,432655,2015-04-15,Assembly,"Do pass and be re-referred to the Committee on Appropriations",6,0,0,1,7
660974,453990,2015-05-28,Assembly,"Do pass",17,0,0,0,17
660974,455977,2015-06-02,Assembly,"AB 10 GATTO  Assembly Third Reading",79,0,0,1,80
660974,465434,2015-07-07,Senate,"Do pass as amended, and re-refer to the Committee on Appropriations",4,0,1,0,5
660974,473669,2015-08-17,Senate,"Placed on Appropriations Suspense file",7,0,0,0,7
660974,474561,2015-08-27,Senate,"Do pass as amended",7,0,0,0,7
660974,476103,2015-09-09,Senate,"Assembly 3rd Reading AB10 Gatto By Lara",40,0,0,0,40
660974,476241,2015-09-10,Assembly,"AB 10 GATTO  Concurrence in Senate Amendments",80,0,0,0,80
660975,441182,2015-04-29,Assembly,"Do pass and be re-referred to the Committee on Appropriations",9,0,0,0,9
660975,453692,2015-05-28,Assembly,"Do pass",17,0,0,0,17
660975,455297,2015-06-01,Assembly,"AB 12 COOLEY  Assembly Third Reading",80,0,0,0,80
660975,466056,2015-07-14,Senate,"Do pass, but re-refer to the Committee on Appropriations",13,0,0,0,13
660975,474116,2015-08-24,Senate,"Placed on Appropriations Suspense file",7,0,0,0,7
660976,430754,2015-04-13,Senate,"Be adopted",4,1,0,0,5
660976,434113,2015-04-16,Senate,"Senate 3rd Reading SJR1 Beall",33,5,1,0,39
660976,462565,2015-06-24,Assembly,"From committee:  Be adopted.  To third reading",6,0,0,1,7
660976,464910,2015-07-02,Assembly,"SJR1 Beall  Senate Third Reading  By O'DONNELL",66,10,0,4,80
660978,412406,2015-03-17,Assembly,"Do pass",6,0,0,1,7
660978,418752,2015-03-26,Assembly,"AB 39 MEDINA  Assembly Third Reading",76,0,0,4,80
660978,460175,2015-06-16,Senate,"Do pass",7,0,0,0,7
660978,465130,2015-07-06,Senate,"Special Consent #4 AB39 Medina",39,0,1,0,40
660979,403976,2015-03-03,Assembly,"Do pass as amended and be re-referred to the Committee on Veterans 	Affairs",13,0,0,0,13
660979,409498,2015-03-10,Assembly,"Do pass and be re-referred to the Committee on Appropriations",9,0,0,0,9
660979,454065,2015-05-28,Assembly,"Do pass as amended",17,0,0,0,17
660979,457258,2015-06-04,Assembly,"AB 13 CHAVEZ  Third Reading Urgency",79,0,0,1,80
660980,428787,2015-04-08,Senate,"Do pass, but re-refer to the Committee on Appropriations",7,0,0,0,7
660980,435210,2015-04-20,Senate,"Do pass",6,1,0,0,7
660980,438341,2015-04-23,Senate,"Senate 3rd Reading SB17 Monning",35,2,2,0,39
660980,462076,2015-06-22,Assembly,"Do pass and be re-referred to the Committee on Appropriations",9,0,0,0,9
660980,465699,2015-07-08,Assembly,"Do pass, to Consent Calendar",14,0,0,3,17
660980,466457,2015-07-16,Assembly,"SB 17 Monning  Consent Calendar Second Day  Regular Session",79,0,0,1,80
660982,436022,2015-04-20,Assembly,"Do pass and be re-referred to the Committee on Appropriations",14,0,0,2,16
660982,443847,2015-05-06,Assembly,"Do pass",14,3,0,0,17
660982,445116,2015-05-11,Assembly,"AB 53 GARCIA, C.  Assembly Third Reading",65,13,0,2,80
660982,465425,2015-07-07,Senate,"Do pass, but re-refer to the Committee on Appropriations",10,1,0,0,11
660982,474110,2015-08-24,Senate,"Assembly 3rd Reading AB53 Cristina Garcia By Pan",32,7,1,0,40
660983,383961,2015-01-08,Assembly,"From committee:  Be adopted.  To third reading",10,0,0,1,11
660983,396724,2015-02-17,Senate,"Assembly 3rd Reading ACR3 Kim By Pan",36,0,1,0,37
660984,443411,2015-05-05,Assembly,"Do pass as amended",10,0,0,0,10
660984,446781,2015-05-14,Assembly,"AB 15 HOLDEN  Assembly Third Reading",79,0,0,1,80
660984,465685,2015-07-07,Senate,"Do pass, but re-refer to the Committee on Appropriations",6,0,1,0,7
660984,465686,2015-07-07,Senate,"Set, first hearing.  Held in Committee.  Reconsideration of 	favorable vote granted",5,0,2,0,7
660984,465687,2015-07-07,Senate,"Do pass as amended, and re-refer to the Committee on Appropriations",6,0,1,0,7
660984,473693,2015-08-17,Senate,"Placed on Appropriations Suspense file",7,0,0,0,7
660984,474640,2015-08-27,Senate,"Do pass as amended",7,0,0,0,7
660984,476038,2015-09-08,Senate,"Assembly 3rd Reading AB15 Holden By Jackson",40,0,0,0,40
660984,476156,2015-09-09,Assembly,"AB 15 HOLDEN  Concurrence in Senate Amendments",79,0,0,1,80
660985,466010,2015-04-14,Assembly,"Do pass and be re-referred to the Committee on Appropriations",7,0,0,0,7
660986,412586,2015-03-17,Assembly,"Do pass as amended and be re-referred to the Committee on 	Appropriations",11,0,0,2,13
660986,453902,2015-05-28,Assembly,"Do pass",17,0,0,0,17
660986,455879,2015-06-02,Assembly,"AB 25 GIPSON  Assembly Third Reading",79,0,0,1,80
660986,462651,2015-06-24,Senate,"Do pass, but re-refer to the Committee on Appropriations",9,0,0,0,9
660986,465157,2015-07-06,Senate,"Placed on Appropriations Suspense file",7,0,0,0,7
660986,474724,2015-08-27,Senate,"Do pass",7,0,0,0,7
660986,475692,2015-09-02,Senate,"Assembly 3rd Reading AB25 Gipson By Hall",40,0,0,0,40
660987,433903,2015-04-16,Assembly,"From committee:  Be adopted.  To third reading",11,0,0,0,11
660987,435206,2015-04-20,Senate,"W/O REF. TO FILE AJR2 Nazarian By De Le",37,0,2,0,39
660987,435207,2015-04-20,Assembly,"AJR2 NAZARIAN  Assembly Third Reading",80,0,0,0,80
660989,422413,2015-03-25,Assembly,"Do pass as amended and be re-referred to the Committee on Arts, 	Entertain, Sports, Tourism, & Internet Media",7,0,0,0,7
660989,436330,2015-04-21,Assembly,"Do pass and be re-referred to the Committee on Appropriations",6,0,0,1,7
660989,441022,2015-04-29,Assembly,"Do pass",12,3,0,2,17
660989,442856,2015-05-04,Assembly,"AB 30 ALEJO  Assembly Third Reading",60,9,0,11,80
660989,460638,2015-06-17,Senate,"Do pass, but re-refer to the Committee on Appropriations",6,1,2,0,9
660989,463899,2015-06-29,Senate,"Placed on Appropriations Suspense file",6,0,1,0,7
660989,474611,2015-08-27,Senate,"Do pass as amended",5,2,0,0,7
660989,475948,2015-09-08,Senate,"Assembly 3rd Reading AB30 Alejo By Block",25,10,5,0,40
660989,476358,2015-09-10,Assembly,"AB 30 ALEJO  Concurrence in Senate Amendments",60,10,0,10,80
660990,427815,2015-04-07,Senate,"Do pass, but re-refer to the Committee on Appropriations",3,1,1,0,5
660990,435229,2015-04-20,Senate,"Placed on Appropriations Suspense file",7,0,0,0,7
660990,454073,2015-05-28,Senate,"Do pass",7,0,0,0,7
660990,455286,2015-06-01,Senate,"Senate 3rd Reading SB21 Hill",36,1,3,0,40
660990,464703,2015-07-01,Assembly,"Do pass and be re-referred to the Committee on Appropriations",6,0,0,1,7
660990,474398,2015-08-27,Assembly,"Do pass",17,0,0,0,17
660990,475988,2015-09-08,Assembly,"SB 21 Hill  Senate Third Reading  By GORDON",78,0,0,2,80
660990,476312,2015-09-10,Senate,"Unfinished Business SB21 Hill Concurrence",37,1,2,0,40
660990,476858,2015-09-10,Senate,"Unfinished Business SB21 Hill Concurrence",36,0,4,0,40
660990,476859,2015-09-10,Senate,"Unfinished Business SB21 Hill Reconsider",39,0,1,0,40
660991,382197,2014-12-01,Senate,"W/O REF. TO FILE SCR1 Huff",38,0,1,0,39
660991,382273,2014-12-01,Assembly,"SCR1 Huff  Senate Third Reading",80,0,0,0,80
660992,428711,2015-04-08,Assembly,"Do pass and be re-referred to the Committee on Appropriations",21,0,0,0,21
660992,454429,2015-05-28,Assembly,"Do pass",17,0,0,0,17
660992,455565,2015-06-01,Assembly,"AB 18 DODD  Third Reading Urgency",80,0,0,0,80
660992,463906,2015-06-29,Senate,"Do pass, but re-refer to the Committee on Appropriations",12,0,1,0,13
660992,465884,2015-07-13,Senate,"Placed on Appropriations Suspense file",7,0,0,0,7
660994,429366,2015-04-08,Senate,"Do pass, but re-refer to the Committee on Judiciary",9,0,0,0,9
660994,439991,2015-04-28,Senate,"Do pass as amended, and re-refer to the Committee on Appropriations",6,0,1,0,7
660994,453740,2015-05-28,Senate,"Do pass as amended",7,0,0,0,7
660994,456621,2015-06-03,Senate,"Senate 3rd Reading SB19 Wolk",40,0,0,0,40
660994,463566,2015-05-18,Senate,"Placed on Appropriations Suspense file",7,0,0,0,7
660994,465455,2015-07-07,Assembly,"Do pass and be re-referred to the Committee on Judiciary",19,0,0,0,19
660994,473548,2015-07-14,Assembly,"Do pass as amended and be re-referred to the Committee on 	Appropriations",10,0,0,0,10
660994,474310,2015-08-27,Assembly,"Do pass as amended",17,0,0,0,17
660994,475591,2015-09-02,Assembly,"SB 19 Wolk  Senate Third Reading  By DABABNEH",67,10,0,3,80
660994,475956,2015-09-08,Assembly,"SB 19 Wolk  Senate Third Reading  By DABABNEH",64,11,0,5,80
660994,476232,2015-09-10,Senate,"Unfinished Business SB19 Wolk Concurrence",39,0,1,0,40
660995,432664,2015-04-13,Assembly,"Do pass and be re-referred to the Committee on Privacy and Consumer 	Protection",5,9,0,2,16
660995,432665,2015-04-13,Assembly,"Reconsideration granted",16,0,0,0,16
660996,428353,2015-04-08,Assembly,"Do pass",9,0,0,0,9
660996,438155,2015-04-23,Assembly,"AB1 BROWN  Assembly Third Reading",78,0,0,2,80
660996,458666,2015-06-10,Senate,"Do pass as amended",7,0,0,0,7
660996,461843,2015-06-22,Senate,"Special Consent #3 AB1 Brown",37,0,3,0,40
660996,462924,2015-06-25,Assembly,"AB1 BROWN  Concurrence in Senate Amendments",80,0,0,0,80
660997,428519,2015-04-08,Senate,"Do pass, but re-refer to the Committee on Appropriations",4,1,0,0,5
660997,435248,2015-04-20,Senate,"Placed on Appropriations Suspense file",7,0,0,0,7
660997,453983,2015-05-28,Senate,"Do pass",5,2,0,0,7
660997,455404,2015-06-01,Senate,"Senate 3rd Reading SB3 Leno",23,15,2,0,40
660997,473546,2015-07-08,Assembly,"Do pass and be re-referred to the Committee on Appropriations",5,2,0,0,7
660997,526208,2016-03-30,Assembly,"Do pass",12,7,0,1,20
660997,526747,2016-03-31,Senate,"From committee:  That the Assembly Amendments be concurred in",4,1,0,0,5
660997,526748,2016-03-31,Senate,"Unfinished Business (S upplemental File 1)SB3 Len o, et al. Con",26,12,2,0,40
660997,526749,2016-03-31,Assembly,"SB3 Leno  Senate Third Reading  By HERNANDEZ",48,26,0,5,79
660998,484749,2016-01-12,Assembly,"Do pass as amended and be re-referred to the Committee on 	Appropriations",13,0,0,1,14
660998,485046,2016-01-05,Assembly,"Be referred to Committee on Business and Professions",7,4,0,0,11
660998,486293,2016-01-21,Assembly,"Do pass as amended",13,0,0,4,17
660998,488383,2016-01-27,Assembly,"AB 26 JONES-SAWYER  Assembly Third Reading",63,1,0,15,79
660998,555532,2016-06-27,Senate,"Do pass as amended, and re-refer to the Committee on Appropriations",7,1,1,0,9
660998,559547,2016-08-11,Senate,"Do pass as amended",5,2,0,0,7
660999,417439,2015-03-25,Senate,"Do pass as amended, and re-refer to the Committee on Appropriations",8,0,1,0,9
660999,445197,2015-05-11,Senate,"Placed on Appropriations Suspense file",7,0,0,0,7
660999,453825,2015-05-28,Senate,"Do pass",5,0,2,0,7
660999,457297,2015-06-04,Senate,"Senate 3rd Reading SB33 Hernandez",37,0,3,0,40
660999,465468,2015-07-07,Assembly,"Do pass and be re-referred to the Committee on Appropriations",18,1,0,0,19
660999,474342,2015-08-27,Assembly,"Do pass as amended",17,0,0,0,17
661000,436277,2015-04-21,Senate,"Do pass, but re-refer to the Committee on Appropriations",9,1,1,0,11
661000,444373,2015-05-07,Senate,"Senate 3rd Reading SB39 Pavley Urgency Clause",29,7,3,0,39
661002,442859,2015-05-04,Senate,"Senate 3rd Reading SB7 Wolk",28,7,4,0,39
661002,460634,2015-06-17,Assembly,"Do pass as amended and be re-referred to the Committee on Water, 	Parks and Wildlife",7,0,0,0,7
661002,463607,2015-04-27,Senate,"Do pass",4,1,2,0,7
661002,466306,2015-07-14,Assembly,"Do pass as amended and be re-referred to the Committee on 	Appropriations",10,4,0,1,15
661002,474325,2015-08-27,Assembly,"Do pass as amended",12,4,0,1,17
661002,475972,2015-09-08,Assembly,"SB7 Wolk  Senate Third Reading  By WILLIAMS",29,28,0,23,80
661002,560368,2016-08-19,Assembly,"SB7 Wolk  Motion to Reconsider  By WILLIAMS",48,18,0,14,80
661002,561131,2016-08-25,Assembly,"SB7 Wolk  Senate Third Reading  By WILLIAMS",51,24,0,5,80
661002,561559,2016-08-30,Senate,"From committee:  That the Assembly Amendments be concurred in",11,0,0,0,11
661002,561768,2016-08-31,Senate,"Unfinished Business SB7 Wolk Concurrence",36,3,0,0,39
661003,414933,2015-03-23,Assembly,"Do pass and be re-referred to the Committee on Public Safety",16,0,0,0,16
661003,440039,2015-04-28,Assembly,"Do pass and be re-referred to the Committee on Appropriations",7,0,0,0,7
661003,453903,2015-05-28,Assembly,"Do pass",17,0,0,0,17
661003,456020,2015-06-02,Assembly,"AB8 GATTO  Assembly Third Reading",79,0,0,1,80
661003,464274,2015-06-30,Senate,"Do pass as amended, and re-refer to the Committee on Public Safety",11,0,0,0,11
661003,466229,2015-07-14,Senate,"Do pass, but re-refer to the Committee on Appropriations",7,0,0,0,7
661003,473619,2015-08-17,Senate,"Do pass",7,0,0,0,7
661003,474294,2015-08-27,Senate,"Assembly 3rd Reading AB8 Gatto By Allen",40,0,0,0,40
661003,475298,2015-08-31,Assembly,"AB8 GATTO  Concurrence in Senate Amendments",80,0,0,0,80
661005,415893,2015-03-24,Assembly,"Do pass as amended",10,0,0,0,10
661005,429251,2015-04-09,Assembly,"AB 29 CAMPOS  Assembly Third Reading",78,0,0,2,80
661008,440098,2015-04-28,Assembly,"Do pass as amended and be re-referred to the Committee on 	Appropriations",9,4,0,1,14
661008,454042,2015-05-28,Assembly,"Amend, and re-refer to the Committee on Appropriations",12,0,0,5,17
661010,437189,2015-04-22,Assembly,"Do pass as amended and be re-referred to the Committee on 	Appropriations",9,0,0,0,9
661010,446209,2015-05-13,Assembly,"Do pass",16,1,0,0,17
661010,447697,2015-05-18,Assembly,"AB 36 CAMPOS  Assembly Third Reading",56,12,0,12,80
661010,475594,2015-09-02,Senate,"Assembly 3rd Reading AB36 Campos By Leno",32,4,4,0,40
661010,476105,2015-09-09,Senate,"Assembly 3rd Reading AB36 Campos By Leno",33,3,4,0,40
661010,476307,2015-09-10,Assembly,"AB 36 CAMPOS  Concurrence in Senate Amendments",78,0,0,2,80
661011,416033,2015-03-24,Senate,"Do pass, but re-refer to the Committee on Appropriations",9,0,0,0,9
661011,434155,2015-04-16,Senate,"Senate 3rd Reading SB37 Nielsen Urgency Clause",37,0,2,0,39
661011,545815,2016-05-16,Assembly,"Be referred to Committee on Local Government",10,0,0,1,11
661011,553400,2016-06-15,Assembly,"Do pass and be re-referred to the Committee on Water, Parks and 	Wildlife",8,0,0,1,9
661011,555949,2016-06-28,Assembly,"Do pass as amended and be re-referred to the Committee on 	Appropriations",14,0,0,1,15
661011,559647,2016-08-10,Assembly,"Do pass, to Consent Calendar",19,0,0,1,20
661011,560856,2016-08-23,Assembly,"SB 37 Vidak  Senate Third Reading  By MATHIS",78,0,0,2,80
661011,561258,2016-08-25,Senate,"From committee:  That the Assembly Amendments be concurred in",8,0,1,0,9
661011,561446,2016-08-29,Senate,"Unfinished Business SB37 Vidak Concurrence",38,0,1,0,39
661012,441020,2015-04-29,Assembly,"Do pass as amended and be re-referred to the Committee on 	Appropriations",8,0,0,1,9
661014,382213,2014-12-01,Assembly,"HR2 ATKINS  Assembly Third Reading",80,0,0,0,80
661017,415932,2015-03-24,Senate,"Do pass, but re-refer to the Committee on Appropriations",8,1,0,0,9
661017,442350,2015-04-30,Senate,"Senate 3rd Reading SB13 Pavley",36,0,3,0,39
661017,464457,2015-06-30,Assembly,"Amend, and do pass as amended and be re-referred to the Committee 	on Appropriations with the recommendation:  To Consent Calendar",15,0,0,0,15
661017,466345,2015-07-15,Assembly,"Do pass, to Consent Calendar",16,0,0,1,17
661017,474040,2015-08-20,Assembly,"SB 13 Pavley  Consent Calendar Second Day",79,0,0,1,80
661017,474399,2015-08-27,Senate,"Special Consent #7 SB13 Pavley",40,0,0,0,40
661019,438212,2015-04-22,Assembly,"Do pass and be re-referred to the Committee on Judiciary",6,1,0,0,7
661019,440117,2015-04-28,Assembly,"Do pass as amended and be re-referred to the Committee on 	Appropriations",9,0,0,1,10
661019,453869,2015-05-28,Assembly,"Do pass as amended",13,0,0,4,17
661019,457251,2015-06-04,Assembly,"AB 20 ALEJO  Assembly Third Reading",69,2,0,9,80
661019,462624,2015-06-24,Senate,"Do pass, but re-refer to the Committee on Agriculture",5,0,0,0,5
661019,465359,2015-07-07,Senate,"Do pass as amended, and re-refer to the Committee on Appropriations",3,0,2,0,5
661019,465360,2015-07-07,Senate,"Set, first hearing.  Held in Committee.  Reconsideration of 	favorable vote granted",5,0,0,0,5
661019,465361,2015-07-07,Senate,"Do pass as amended, and re-refer to the Committee on Appropriations",5,0,0,0,5
661019,473598,2015-08-17,Senate,"Placed on Appropriations Suspense file",7,0,0,0,7
661020,440077,2015-04-27,Assembly,"Do pass and be re-referred to the Committee on Appropriations",9,0,0,0,9
661020,453811,2015-05-28,Assembly,"Do pass as amended",12,0,0,5,17
661020,456582,2015-06-03,Assembly,"AB 33 QUIRK  Assembly Third Reading",71,5,0,4,80
661020,465355,2015-07-07,Senate,"Do pass, but re-refer to the Committee on Environmental Quality",11,0,0,0,11
661020,466209,2015-07-15,Senate,"Do pass as amended, and re-refer to the Committee on Appropriations",7,0,0,0,7
661020,474077,2015-08-24,Senate,"Placed on Appropriations Suspense file",7,0,0,0,7
661020,474631,2015-08-27,Senate,"Do pass",6,1,0,0,7
661020,552447,2016-06-13,Senate,"Do pass as amended, and re-refer to the Committee on Environmental 	Quality",11,0,0,0,11
661020,559846,2016-08-15,Senate,"Assembly 3rd Reading AB33 Quirk By Hueso",37,0,2,0,39
661020,559847,2016-08-15,Senate,"Assembly 3rd Reading AB33 Quirk By Hueso",37,0,2,0,39
661020,560661,2016-08-23,Senate,"Assembly 3rd Reading AB33 Quirk By Hueso",39,0,0,0,39
661020,561551,2016-08-30,Assembly,"Senate amendments be concurred in",14,0,0,1,15
661020,561743,2016-08-31,Assembly,"AB 33 QUIRK  Concurrence in Senate Amendments",79,0,0,1,80
661021,442292,2015-04-29,Senate,"Do pass, but re-refer to the Committee on Appropriations",9,0,0,0,9
661021,445192,2015-05-11,Senate,"Placed on Appropriations Suspense file",7,0,0,0,7
661021,453778,2015-05-28,Senate,"Do pass as amended",7,0,0,0,7
661021,488398,2016-01-27,Senate,"Senate 3rd Reading SB22 Roth",39,0,1,0,40
661022,437902,2015-04-14,Assembly,"Do pass as amended and be re-referred to the Committee on 	Appropriations",16,0,0,3,19
661022,453896,2015-05-28,Assembly,"Do pass",17,0,0,0,17
661022,456035,2015-06-02,Assembly,"AB 50 MULLIN  Assembly Third Reading",79,0,0,1,80
661022,465785,2015-07-08,Senate,"Do pass, but re-refer to the Committee on Appropriations",8,0,1,0,9
661022,473659,2015-08-17,Senate,"Placed on Appropriations Suspense file",7,0,0,0,7
661022,474619,2015-08-27,Senate,"Do pass as amended",7,0,0,0,7
661022,476332,2015-09-10,Senate,"Assembly 3rd Reading AB50 Mullin By Monning",40,0,0,0,40
661022,476467,2015-09-11,Assembly,"AB 50 MULLIN  Concurrence in Senate Amendments",79,0,0,1,80
661023,427848,2015-04-06,Assembly,"Do pass and be re-referred to the Committee on Appropriations",13,1,0,2,16
661023,441160,2015-04-29,Assembly,"Do pass",16,1,0,0,17
661023,453853,2015-05-28,Assembly,"AB 51 QUIRK  Assembly Third Reading",58,14,0,8,80
661023,552698,2016-06-14,Senate,"Do pass, but re-refer to the Committee on Appropriations",11,0,0,0,11
661023,558627,2016-08-01,Senate,"Assembly 3rd Reading AB51 Quirk By Cannella",38,0,1,0,39
661023,559102,2016-08-04,Assembly,"AB 51 QUIRK  Concurrence in Senate Amendments",74,0,0,6,80
661024,432567,2015-04-15,Assembly,"Do pass as amended and be re-referred to the Committee on 	Appropriations",6,0,0,1,7
661024,454214,2015-05-28,Assembly,"Do pass",17,0,0,0,17
661024,455967,2015-06-02,Assembly,"AB 44 MULLIN  Assembly Third Reading",74,4,0,2,80
661024,464380,2015-06-30,Senate,"Do pass, but re-refer to the Committee on Appropriations",4,0,1,0,5
661024,473690,2015-08-17,Senate,"Placed on Appropriations Suspense file",7,0,0,0,7
661024,474612,2015-08-27,Senate,"Do pass as amended",5,2,0,0,7
661024,475740,2015-09-03,Senate,"Assembly 3rd Reading AB44 Mullin By Hertzberg",35,4,1,0,40
661024,476110,2015-09-09,Assembly,"AB 44 MULLIN  Concurrence in Senate Amendments",73,5,0,2,80
661025,435979,2015-04-20,Assembly,"Do pass and be re-referred to the Committee on Transportation",8,2,0,5,15
661025,440137,2015-04-27,Assembly,"Do pass and be re-referred to the Committee on Appropriations",11,5,0,0,16
661026,436074,2015-04-20,Assembly,"Do pass and be re-referred to the Committee on Education",5,10,0,1,16
661026,436075,2015-04-20,Assembly,"Reconsideration granted",15,0,0,1,16
661029,415791,2015-03-24,Assembly,"Do pass as amended",7,0,0,0,7
661029,429247,2015-04-09,Assembly,"AB 32 WALDRON  Assembly Third Reading",78,0,0,2,80
661029,465421,2015-07-07,Senate,"Do pass as amended, and re-refer to the Committee on Appropriations",6,0,1,0,7
661029,475289,2015-08-31,Senate,"Special Consent #8 AB32 Waldron By Glazer",40,0,0,0,40
661029,475471,2015-09-01,Assembly,"AB 32 WALDRON  Concurrence in Senate Amendments",79,0,0,1,80
661030,441212,2015-04-29,Senate,"Do pass as amended, and re-refer to the Committee on Appropriations",6,0,1,0,7
661030,453802,2015-05-28,Senate,"Do pass as amended",5,2,0,0,7
661030,456574,2015-06-03,Senate,"Senate 3rd Reading SB38 Liu",37,1,2,0,40
661030,463558,2015-05-18,Senate,"Placed on Appropriations Suspense file",7,0,0,0,7
661032,437125,2015-04-22,Assembly,"Do pass and be re-referred to the Committee on Environmental Safety 	and Toxic Materials",6,3,0,0,9
661032,440083,2015-04-28,Assembly,"Do pass as amended and be re-referred to the Committee on 	Appropriations",4,2,0,1,7
661032,486302,2016-01-21,Assembly,"Do pass as amended",12,0,0,5,17
661032,488397,2016-01-27,Assembly,"AB 45 MULLIN  Assembly Third Reading",50,18,0,11,79
661033,413124,2015-03-18,Senate,"Do pass as amended, and re-refer to the Committee on Transportation 	and Housing",7,0,0,0,7
661033,440054,2015-04-28,Senate,"Do pass as amended, and re-refer to the Committee on Appropriations",10,0,1,0,11
661033,454081,2015-05-28,Senate,"Do pass as amended",7,0,0,0,7
661033,456669,2015-06-03,Senate,"Senate 3rd Reading SB9 Beall",37,1,2,0,40
661033,463552,2015-05-18,Senate,"Placed on Appropriations Suspense file",7,0,0,0,7
661033,463819,2015-06-29,Assembly,"Do pass as amended and be re-referred to the Committee on Natural 	Resources",16,0,0,0,16
661033,466071,2015-07-13,Assembly,"Do pass as amended and be re-referred to the Committee on 	Appropriations",9,0,0,0,9
661033,473889,2015-08-19,Assembly,"Do pass",16,1,0,0,17
661033,475732,2015-09-03,Assembly,"SB9 Beall  Senate Third Reading  By FRAZIER",74,1,0,5,80
661033,475846,2015-09-04,Senate,"Unfinished Business SB9 Beall Concurrence",39,0,1,0,40
661034,432623,2015-04-13,Assembly,"Do pass as amended",13,2,0,1,16
661034,453751,2015-05-28,Assembly,"Do pass",13,4,0,0,17
661034,455946,2015-06-02,Assembly,"AB 40 TING  Assembly Third Reading",64,13,0,3,80
661034,462166,2015-06-23,Senate,"Do pass, but re-refer to the Committee on Appropriations",10,1,0,0,11
661034,465184,2015-07-06,Senate,"Placed on Appropriations Suspense file",7,0,0,0,7
661034,474600,2015-08-27,Senate,"Do pass",5,2,0,0,7
661034,476046,2015-09-08,Senate,"Assembly 3rd Reading AB40 Ting By Wolk",29,11,0,0,40
661034,476174,2015-09-09,Assembly,"AB 40 TING  Concurrence in Senate Amendments",65,13,0,2,80
661035,403240,2015-03-02,Assembly,"From committee:  Be adopted.  To third reading",10,0,0,1,11
661035,433941,2015-04-16,Senate,"Assembly 3rd Reading ACR2 Nazarian By Allen",38,0,1,0,39
661036,435972,2015-04-21,Assembly,"Do pass as amended and be re-referred to the Committee on Revenue 	and Taxation",10,0,0,0,10
661036,485025,2016-01-15,Assembly,"Do pass and be re-referred to the Committee on Appropriations to 	Consent Calendar",9,0,0,1,10
661036,485070,2016-01-05,Assembly,"Be referred to Committee on Judiciary",11,0,0,0,11
661036,486311,2016-01-21,Assembly,"Do pass, to Consent Calendar",17,0,0,0,17
661036,488327,2016-01-27,Assembly,"AB 54 OLSEN  Consent Calendar Second Day",78,0,0,1,79
661036,553089,2016-06-14,Senate,"Do pass, but re-refer to the Committee on Appropriations Recommend 	Consent",7,0,0,0,7
661036,555531,2016-06-27,Senate,"Placed on Appropriations Suspense file",6,0,1,0,7
661036,559614,2016-08-11,Senate,"Do pass",7,0,0,0,7
661036,559927,2016-08-16,Senate,"Assembly 3rd Reading AB54 Olsen By Roth",38,0,1,0,39
661036,560489,2016-08-22,Assembly,"AB 54 OLSEN  Concurrence in Senate Amendments",78,0,0,2,80
661037,428031,2015-04-07,Senate,"Do pass as amended, and re-refer to the Committee on Appropriations",7,0,0,0,7
661037,445482,2015-05-11,Senate,"Placed on Appropriations Suspense file",7,0,0,0,7
661037,453759,2015-05-28,Senate,"Do pass as amended",7,0,0,0,7
661037,455939,2015-06-02,Senate,"Senate 3rd Reading SB11 Beall",38,0,2,0,40
661037,462995,2015-06-23,Senate,"Do pass as amended, and re-refer to the Committee on Appropriations",3,2,0,0,5
661037,474048,2015-07-14,Assembly,"Do pass and be re-referred to the Committee on Appropriations",7,0,0,0,7
661037,474304,2015-08-27,Assembly,"Do pass as amended",17,0,0,0,17
661037,475452,2015-09-01,Assembly,"SB 11 Beall  Senate Third Reading  By MAIENSCHEIN",79,1,0,0,80
661037,475697,2015-09-02,Senate,"Unfinished Business SB11 Beall Concurrence",40,0,0,0,40
661040,440904,2015-04-29,Senate,"Do pass as amended, and re-refer to the Committee on Appropriations",5,2,0,0,7
661040,454033,2015-05-28,Senate,"Do pass",5,2,0,0,7
661040,456648,2015-06-03,Senate,"Senate 3rd Reading SB32 Pavley",24,15,1,0,40
661040,463613,2015-05-18,Senate,"Placed on Appropriations Suspense file",7,0,0,0,7
661040,465988,2015-07-13,Assembly,"Do pass and be re-referred to the Committee on Appropriations",6,3,0,0,9
661040,474272,2015-08-27,Assembly,"Do pass as amended",12,5,0,0,17
661040,475830,2015-09-04,Assembly,"SB 32 Pavley  Senate Third Reading  Amend By WILLIAMS  Set #1",45,28,0,7,80
661040,476012,2015-09-08,Assembly,"SB 32 Pavley  Senate Third Reading  By RIDLEY-THOMAS",30,35,0,15,80
661040,476153,2015-09-09,Assembly,"SB 32 Pavley  Motion to Reconsider",43,29,0,8,80
661040,559230,2016-08-11,Assembly,"Do pass",11,4,0,5,20
661040,559889,2016-06-27,Assembly,"Do pass as amended and be re-referred to the Committee on 	Appropriations",6,2,0,1,9
661040,560346,2016-08-19,Assembly,"SB 32 Pavley  Senate Third Reading  Amend By GARCIA, E.  Set #1",44,21,0,15,80
661040,560702,2016-08-23,Assembly,"SB 32 Pavley  Senate Third Reading  By GARCIA, E",49,30,0,1,80
661040,560903,2016-08-24,Senate,"Unfinished Business (S upplemental File 1)SB3 2 Pav ley Con",25,13,1,0,39
661041,440191,2015-04-27,Assembly,"Do pass and be re-referred to the Committee on Appropriations",16,0,0,0,16
661041,443875,2015-05-06,Assembly,"Do pass, to Consent Calendar",17,0,0,0,17
661041,446690,2015-05-14,Assembly,"AB 28 CHU  Consent Calendar Second Day  Regular Session",78,0,0,2,80
661041,460164,2015-06-16,Senate,"Do pass, but re-refer to the Committee on Appropriations",11,0,0,0,11
661041,475588,2015-09-02,Senate,"Assembly 3rd Reading AB28 Chu By Beall",40,0,0,0,40
661041,475760,2015-09-03,Assembly,"AB 28 CHU  Concurrence in Senate Amendments",80,0,0,0,80
661042,458537,2015-04-14,Senate,"Do pass, but re-refer to the Committee on Appropriations",4,1,0,2,7
661042,463576,2015-04-27,Senate,"Placed on Appropriations Suspense file",7,0,0,0,7
661042,486316,2016-01-21,Senate,"Do pass",7,0,0,0,7
661042,488321,2016-01-27,Senate,"Senate 3rd Reading SB6 Galgiani",35,1,4,0,40
661042,554678,2016-06-21,Assembly,"Do pass as amended and be re-referred to the Committee on 	Appropriations",7,0,0,0,7
661042,559335,2016-08-11,Assembly,"Do pass as amended",20,0,0,0,20
661042,560381,2016-08-19,Assembly,"SB6 Galgiani  Senate Third Reading  Amendment  Set #1",73,0,0,7,80
661042,560670,2016-08-23,Assembly,"SB6 Galgiani  Senate Third Reading  By GONZALEZ",78,0,0,2,80
661042,560992,2016-08-24,Senate,"Unfinished Business SB6 Galgiani Concurrence",36,1,2,0,39
661043,422268,2015-03-25,Assembly,"Do pass as amended",7,0,0,0,7
661043,429387,2015-04-09,Assembly,"AB7 BONTA  Assembly Third Reading",71,0,0,9,80
661043,458809,2015-06-10,Senate,"Do pass and be placed on the Consent Calendar",8,0,1,0,9
661043,461178,2015-06-18,Senate,"Consent Calendar 2nd AB7 Bonta",37,0,3,0,40
661044,440222,2015-04-28,Senate,"Do pass, but re-refer to the Committee on Appropriations",7,0,4,0,11
661044,445161,2015-05-11,Senate,"Placed on Appropriations Suspense file",7,0,0,0,7
661044,454024,2015-05-28,Senate,"Do pass as amended",5,2,0,0,7
661044,456677,2015-06-03,Senate,"Senate 3rd Reading SB10 Lara",28,9,3,0,40
661044,533130,2016-04-14,Assembly,"Be referred to Committee on Health",11,0,0,0,11
661044,538460,2016-04-26,Assembly,"Do pass as amended and be re-referred to the Committee on 	Appropriations",12,3,0,3,18
661044,546580,2016-05-18,Assembly,"Do pass",14,6,0,0,20
661044,549919,2016-05-31,Assembly,"SB 10 Lara  Third Reading Urgency  By WOOD",55,20,0,5,80
661044,550892,2016-06-02,Senate,"Unfinished Business SB10 Lara Urgency Clause Concurr",28,10,2,0,40
661045,433942,2015-04-15,Senate,"Do pass, but re-refer to the Committee on Appropriations",7,0,2,0,9
661045,442840,2015-05-04,Senate,"Placed on Appropriations Suspense file",7,0,0,0,7
661045,453620,2015-05-28,Senate,"Do pass as amended",5,2,0,0,7
661045,455985,2015-06-02,Senate,"Senate 3rd Reading SB4 Lara",28,11,1,0,40
661045,466060,2015-07-14,Assembly,"Do pass as amended and be re-referred to the Committee on 	Appropriations",12,6,0,1,19
661045,474397,2015-08-27,Assembly,"Do pass as amended",12,5,0,0,17
661045,476069,2015-09-09,Assembly,"Do pass as amended",13,5,0,1,19
661045,476473,2015-09-11,Assembly,"SB4 Lara  Senate Third Reading  By BONTA",52,23,0,5,80
661045,476474,2015-09-11,Senate,"Unfinished Business (S upplemental File 5)SB4 Lar a Con",28,11,1,0,40
661046,427775,2015-04-07,Senate,"Do pass, but re-refer to the Committee on Judiciary",8,2,1,0,11
661046,432558,2015-04-14,Senate,"Do pass as amended, and re-refer to the Committee on Appropriations",4,2,1,0,7
661046,442883,2015-05-04,Senate,"Do pass",5,2,0,0,7
661046,444437,2015-05-07,Senate,"Senate 3rd Reading SB34 Hill",25,12,2,0,39
661046,461844,2015-06-22,Assembly,"Do pass and be re-referred to the Committee on Privacy and Consumer 	Protection",13,1,0,2,16
661046,473856,2015-08-19,Assembly,"Do pass",14,3,0,0,17
661046,474171,2015-07-07,Assembly,"Do pass as amended and be re-referred to the Committee on 	Appropriations",11,0,0,0,11
661046,475765,2015-09-03,Assembly,"SB 34 Hill  Senate Third Reading  By GATTO",71,5,0,4,80
661046,475858,2015-09-04,Senate,"Unfinished Business SB34 Hill Concurrence",25,11,4,0,40
661047,415877,2015-03-24,Senate,"Do pass, but re-refer to the Committee on Appropriations",4,0,1,0,5
661047,430688,2015-04-13,Senate,"Placed on Appropriations Suspense file",7,0,0,0,7
661047,453677,2015-05-28,Senate,"Do pass",5,1,1,0,7
661047,455312,2015-06-01,Senate,"Senate 3rd Reading SB23 Mitchell",27,6,7,0,40
661047,466253,2015-07-14,Assembly,"Do pass and be re-referred to the Committee on Appropriations",5,2,0,0,7
661047,474258,2015-08-27,Assembly,"Do pass",14,0,0,3,17
661051,416105,2015-03-24,Senate,"Do pass as amended, and re-refer to the Committee on Judiciary",5,0,0,0,5
661051,432624,2015-04-14,Senate,"Do pass as amended, and re-refer to the Committee on Appropriations",6,0,1,0,7
661051,445157,2015-05-11,Senate,"Placed on Appropriations Suspense file",7,0,0,0,7
661051,454020,2015-05-28,Senate,"Do pass as amended",7,0,0,0,7
661051,457333,2015-06-04,Senate,"Senate 3rd Reading SB12 Beall",35,0,5,0,40
661051,462952,2015-06-23,Senate,"Do pass as amended, but re-refer to the Committee on Public 	Employment and Retirement Recommend Consent",5,0,0,0,5
661051,464448,2015-06-30,Assembly,"Do pass and be re-referred to the Committee on Judiciary",7,0,0,0,7
661051,466121,2015-07-14,Assembly,"Do pass and be re-referred to the Committee on Appropriations",10,0,0,0,10
661053,382212,2014-12-01,Assembly,"HR1 GORDON  Assembly Third Reading",52,28,0,0,80
661055,437166,2015-04-22,Senate,"Do pass, but re-refer to the Committee on Judiciary",7,0,2,0,9
661055,440099,2015-04-28,Senate,"Do pass as amended, and re-refer to the Committee on Appropriations",6,0,1,0,7
661055,463621,2015-05-18,Senate,"Placed on Appropriations Suspense file",7,0,0,0,7
661056,441161,2015-04-28,Assembly,"Do pass and be re-referred to the Committee on Appropriations",18,0,0,1,19
661057,443544,2015-05-05,Senate,"Do pass as amended. To Consent Calendar",7,0,0,0,7
661057,447752,2015-05-18,Senate,"Consent Calendar 2nd SB28 Wieckowski",36,0,3,0,39
661057,460353,2015-06-16,Assembly,"Do pass",10,0,0,0,10
661057,466520,2015-07-16,Assembly,"SB 28 Wieckowski  Senate Third Reading  By WAGNER",79,0,0,1,80
661058,442207,2015-04-29,Assembly,"Do pass as amended and be re-referred to the Committee on 	Appropriations",6,0,0,1,7
661058,453696,2015-05-28,Assembly,"Do pass as amended",12,3,0,2,17
661058,456682,2015-06-03,Assembly,"AB 47 MCCARTY  Assembly Third Reading",56,22,0,2,80
661058,473581,2015-08-17,Senate,"Placed on Appropriations Suspense file",7,0,0,0,7
661058,474633,2015-08-27,Senate,"Do pass",5,2,0,0,7
661058,476278,2015-09-10,Senate,"Assembly 3rd Reading AB47 McCarty By Leno",29,11,0,0,40
661058,476558,2015-09-11,Assembly,"AB 47 MCCARTY  Concurrence in Senate Amendments",69,4,0,7,80
661059,428839,2015-04-08,Assembly,"Do pass and be re-referred to the Committee on Appropriations",21,0,0,0,21
661059,453660,2015-05-28,Assembly,"Do pass",17,0,0,0,17
661059,455414,2015-06-01,Assembly,"AB 22 RODRIGUEZ  Assembly Third Reading",80,0,0,0,80
661059,473716,2015-08-17,Senate,"Placed on Appropriations Suspense file",7,0,0,0,7
661062,413046,2015-03-18,Assembly,"Do pass and be re-referred to the Committee on Appropriations",5,2,0,0,7
661063,440047,2015-04-27,Assembly,"Do pass as amended and be re-referred to the Committee on 	Appropriations",7,0,0,2,9
661063,446140,2015-05-13,Assembly,"Do pass",17,0,0,0,17
661063,447642,2015-05-18,Assembly,"AB 21 PEREA  Assembly Third Reading",73,0,0,7,80
661063,460723,2015-06-17,Senate,"Do pass, but re-refer to the Committee on Appropriations",7,0,0,0,7
661063,485057,2016-01-13,Senate,"Do pass, but re-refer to the Committee on Health",6,0,1,0,7
661063,485880,2016-01-20,Senate,"Do pass as amended",7,0,2,0,9
661063,487023,2016-01-25,Senate,"Assembly 3rd Reading AB21 Wood By McGuire Urgency Cla",35,3,2,0,40
661063,488400,2016-01-27,Assembly,"Senate amendments be concurred in",9,0,0,0,9
661063,488967,2016-01-28,Assembly,"AB 21 WOOD  Concurrence- Urgency Added",73,0,0,6,79
661064,415880,2015-03-23,Assembly,"Do pass and be re-referred to the Committee on Appropriations",3,6,0,0,9
661064,415881,2015-03-23,Assembly,"Reconsideration granted",9,0,0,0,9
661065,446160,2015-05-13,Assembly,"Do pass and be re-referred to the Committee on Appropriations",6,1,0,2,9
661065,453472,2015-05-27,Assembly,"Do pass",13,4,0,0,17
661065,456627,2015-06-03,Assembly,"AB3 WILLIAMS  Assembly Third Reading",51,26,0,3,80
661065,465659,2015-07-08,Senate,"Do pass, but re-refer to the Committee on Appropriations",5,2,0,0,7
661065,476517,2015-09-11,Senate,"Assembly 3rd Reading AB3 Williams By Jackson",25,14,1,0,40
661065,476518,2015-09-11,Assembly,"AB3 WILLIAMS  Concurrence in Senate Amendments By GONZALEZ",48,27,0,5,80
661066,430679,2015-04-09,Assembly,"Be referred to Committee on Judiciary",11,0,0,0,11
661067,428710,2015-04-07,Assembly,"Do pass and be re-referred to the Committee on Appropriations",12,1,0,0,13
661067,453729,2015-05-28,Assembly,"Do pass",16,1,0,0,17
661067,455960,2015-06-02,Assembly,"AB 38 EGGMAN  Assembly Third Reading",70,5,0,5,80
661067,555288,2016-06-22,Senate,"Do pass, but re-refer to the Committee on Appropriations",9,0,0,0,9
661067,558888,2016-08-01,Senate,"Placed on Appropriations Suspense file",7,0,0,0,7
661067,561482,2016-08-29,Senate,"Assembly 3rd Reading AB38 Eggman By Lara",39,0,0,0,39
661067,561653,2016-08-30,Assembly,"Senate amendments be concurred in",16,0,0,2,18
661067,561790,2016-08-31,Assembly,"AB 38 EGGMAN  Concurrence in Senate Amendments",79,0,0,1,80
661068,404590,2015-03-03,Assembly,"Do pass as amended and be re-referred to the Committee on Veterans 	Affairs",13,0,0,0,13
661068,409556,2015-03-10,Assembly,"Do pass and be re-referred to the Committee on Appropriations",9,0,0,0,9
661068,416856,2015-03-25,Assembly,"Do pass, to Consent Calendar",16,0,0,1,17
661068,429362,2015-04-09,Assembly,"AB 27 CHAVEZ  Consent Calendar Second Day  Regular Session",78,0,0,2,80
661069,432687,2015-04-15,Senate,"Do pass, but re-refer to the Committee on Appropriations",7,0,0,0,7
661069,453643,2015-05-28,Senate,"Do pass",7,0,0,0,7
661069,455249,2015-06-01,Senate,"Senate 3rd Reading SB2 Anderson",40,0,0,0,40
661070,401554,2015-02-25,Senate,"Do pass as amended, and re-refer to the Committee on Appropriations",6,0,1,0,7
661070,429311,2015-04-09,Senate,"Senate 3rd Reading SB35 Wolk",38,0,1,0,39
661070,461792,2015-06-22,Assembly,"Do pass and be re-referred to the Committee on Appropriations",9,0,0,0,9
661070,465646,2015-07-08,Assembly,"Do pass, to Consent Calendar",14,0,0,3,17
661070,466460,2015-07-16,Assembly,"SB 35 Wolk  Consent Calendar Second Day  Regular Session",79,0,0,1,80
661070,473828,2015-08-17,Senate,"Unfinished Business SB35 Wolk Concurrence",38,0,2,0,40
661071,429317,2015-04-08,Senate,"Do pass, but re-refer to the Committee on Appropriations",9,0,0,0,9
661071,435753,2015-04-20,Senate,"Do pass",7,0,0,0,7
661071,439496,2015-04-27,Senate,"Senate 3rd Reading SB36 Hernandez Urgency Clause",35,0,4,0,39
661071,466149,2015-07-14,Assembly,"Do pass and be re-referred to the Committee on Appropriations",18,0,0,1,19
661071,473939,2015-08-19,Assembly,"Do pass",17,0,0,0,17
661071,476200,2015-09-09,Assembly,"Do pass",18,0,0,1,19
661071,476577,2015-09-11,Senate,"From committee:  That the Assembly Amendments be concurred in",9,0,0,0,9
661071,476578,2015-09-11,Senate,"Unfinished Business (S upplemental File 2)SB3 6 Her nandez Urg",40,0,0,0,40
661071,476579,2015-09-11,Assembly,"SB 36 Hernandez  Third Reading Urgency  By BONTA",78,0,0,2,80
661073,440216,2015-04-28,Senate,"Do pass, but re-refer to the Committee on Rules",6,1,4,0,11
661073,443924,2015-05-06,Senate,"Do pass as amended, and re-refer to the Committee on Appropriations",5,1,1,0,7
661073,451957,2015-05-26,Senate,"Placed on Appropriations Suspense file",7,0,0,0,7
661073,453964,2015-05-28,Senate,"Do pass as amended",5,2,0,0,7
661075,415047,2015-03-23,Assembly,"Be adopted and re-referred to the Committee on Appropriations with 	recommendation:  To Consent Calendar",16,0,0,0,16
661075,433926,2015-04-15,Assembly,"Be adopted, to Consent Calendar",16,0,0,1,17
661075,438044,2015-04-23,Assembly,"ACR1 LEVINE  Assembly Third Reading",77,0,0,3,80
661075,458954,2015-06-09,Senate,"Be adopted, but re-refer to the Committee on Appropriations 	Recommend Consent",11,0,0,0,11
661075,462985,2015-06-25,Senate,"Consent Calendar 2nd ACR1 Levine",37,0,3,0,40
661077,436169,2015-04-21,Senate,"Do pass, but re-refer to the Committee on Appropriations",3,0,2,0,5
661077,442889,2015-05-04,Senate,"Placed on Appropriations Suspense file",7,0,0,0,7
661077,454131,2015-05-28,Senate,"Do pass as amended",5,2,0,0,7
661077,456074,2015-06-02,Senate,"Senate 3rd Reading SB27 Hill",25,10,5,0,40
661077,474045,2015-07-01,Assembly,"Do pass as amended and be re-referred to the Committee on 	Appropriations",7,1,0,2,10
661077,474284,2015-08-27,Assembly,"Do pass as amended",15,0,0,2,17
661077,476127,2015-09-09,Assembly,"Do pass as amended",7,0,0,3,10
661077,476562,2015-09-11,Assembly,"SB 27 Hill  Senate Third Reading  By GARCIA, E",71,6,0,3,80
661077,476563,2015-09-11,Senate,"Unfinished Business (S upplemental File 5)SB2 7 Hil l",37,1,2,0,40
661079,428349,2015-04-07,Senate,"Do pass as amended",6,0,1,0,7
661079,433958,2015-04-16,Senate,"Senate 3rd Reading SB14 Lara",38,0,1,0,39
661079,460158,2015-06-16,Assembly,"Do pass",10,0,0,0,10
661079,465141,2015-07-06,Assembly,"SB 14 Lara  Senate Third Reading  By STONE",78,0,0,2,80
661080,433986,2015-04-15,Senate,"Do pass as amended, and re-refer to the Committee on Appropriations",6,0,3,0,9
661080,442817,2015-05-04,Senate,"Placed on Appropriations Suspense file",7,0,0,0,7
661080,453702,2015-05-28,Senate,"Do pass as amended",6,1,0,0,7
661080,455878,2015-06-02,Senate,"Senate 3rd Reading SB24 Hill Reconsider",40,0,0,0,40
661080,458615,2015-06-02,Senate,"Senate 3rd Reading SB24 Hill Reconsider",40,0,0,0,40
661080,484966,2016-01-14,Senate,"Do pass, but re-refer to the Committee on Appropriations",3,0,2,0,5
661080,485576,2016-01-19,Senate,"Placed on Appropriations Suspense file",7,0,0,0,7
661080,486333,2016-01-21,Senate,"Do pass",5,0,2,0,7
661080,487750,2016-01-26,Senate,"Senate 3rd Reading SB24 Hill",29,4,7,0,40
661080,554936,2016-06-22,Assembly,"Do pass and be re-referred to the Committee on Appropriations",6,0,0,1,7
661080,559300,2016-08-11,Assembly,"Do pass",19,0,0,1,20
661080,560744,2016-08-23,Assembly,"SB 24 Hill  Senate Third Reading  By MULLIN",77,1,0,2,80
661080,561191,2016-08-25,Senate,"Unfinished Business SB24 Hill Concurrence",32,5,2,0,39
661081,436114,2015-04-21,Senate,"Do pass as amended, and re-refer to the Committee on Appropriations",10,0,1,0,11
661081,454408,2015-05-28,Senate,"Senate 3rd Reading SB18 Hill",39,0,1,0,40
661081,462177,2015-06-22,Assembly,"Do pass, to Consent Calendar",13,0,0,1,14
661081,465569,2015-07-08,Assembly,"Do pass as amended, to Consent Calendar",14,0,0,3,17
661081,476344,2015-09-10,Assembly,"SB 18 Hill  Senate Third Reading  By MULLIN",80,0,0,0,80
661081,476484,2015-09-11,Senate,"Unfinished Business SB18 Hill Concurrence",36,0,4,0,40
661082,388652,2015-02-02,Senate,"Senate 3rd Reading SR7 Lara",37,0,0,0,37
661343,416734,2015-03-25,Senate,"Do pass as amended, and re-refer to the Committee on Appropriations",8,0,0,0,8
661343,445106,2015-05-11,Senate,"Placed on Appropriations Suspense file",7,0,0,0,7
661343,453948,2015-05-28,Senate,"Do pass",6,1,0,0,7
661343,455293,2015-06-01,Senate,"Senate 3rd Reading SB42 Liu",38,1,1,0,40
661343,465469,2015-07-07,Assembly,"Do pass as amended and be re-referred to the Committee on 	Appropriations",11,2,0,0,13
661343,474266,2015-08-27,Assembly,"Do pass as amended",12,0,0,5,17
661343,475996,2015-09-08,Assembly,"SB 42 Liu  Senate Third Reading  By MEDINA",73,4,0,3,80
661343,476305,2015-09-10,Senate,"Unfinished Business SB42 Liu Concurrence",38,0,2,0,40
661344,429240,2015-04-08,Assembly,"Amend, and do pass as amended and be re-referred to the Committee 	on Appropriations with the recommendation:  To Consent Calendar",7,0,0,0,7
661344,453966,2015-05-28,Assembly,"Do pass as amended",17,0,0,0,17
661344,456000,2015-06-02,Assembly,"AB 58 RODRIGUEZ  Assembly Third Reading",78,0,0,2,80
661344,464695,2015-07-01,Senate,"Do pass as amended, but re-refer to the Committee on Appropriations 	Recommend Consent",7,0,2,0,9
661344,473604,2015-08-17,Senate,"Placed on Appropriations Suspense file",7,0,0,0,7
661345,430555,2015-04-13,Assembly,"Be referred to Committee on Local Government",11,0,0,0,11
661345,446220,2015-05-13,Assembly,"Do pass",7,0,0,2,9
661345,450172,2015-05-22,Assembly,"AB 57 QUIRK  Assembly Third Reading",66,4,0,10,80
661345,460219,2015-06-16,Senate,"Do pass as amended, and re-refer to the Committee on Governance and 	Finance",8,1,2,0,11
661345,466208,2015-07-15,Senate,"Do pass as amended",6,1,0,0,7
661345,474103,2015-08-24,Senate,"Assembly 3rd Reading AB57 Quirk By Hueso",28,6,6,0,40
661345,474306,2015-08-27,Assembly,"AB 57 QUIRK  Concurrence in Senate Amendments",66,8,0,6,80
661346,442279,2015-04-30,Assembly,"Do pass and be re-referred to the Committee on Appropriations",9,1,0,1,11
661346,446190,2015-05-13,Assembly,"Do pass",17,0,0,0,17
661346,451386,2015-05-26,Assembly,"AB 56 QUIRK  Assembly Third Reading",61,12,0,7,80
661346,465419,2015-07-07,Senate,"Do pass, but re-refer to the Committee on Judiciary",4,2,1,0,7
661346,466093,2015-04-14,Assembly,"Do pass and be re-referred to the Committee on Privacy and Consumer 	Protection",6,0,0,1,7
661346,466343,2015-07-14,Senate,"Do pass as amended, and re-refer to the Committee on Appropriations",5,2,0,0,7
661346,473646,2015-08-17,Senate,"Placed on Appropriations Suspense file",7,0,0,0,7
661346,474606,2015-08-27,Senate,"Do pass as amended",5,2,0,0,7
661756,536110,2016-04-20,Senate,"Be adopted, but re-refer to the Committee on Elections and 	Constitutional Amendments",6,0,3,0,9
661756,544308,2016-05-10,Senate,"Be adopted as amended, and re-refer to the Committee on 	Appropriations",5,0,0,0,5
661756,547566,2016-05-23,Senate,"Placed on Appropriations Suspense file",7,0,0,0,7
661756,549133,2016-05-27,Senate,"Be adopted",5,2,0,0,7
661756,549134,2016-05-27,Senate,"Set, first hearing.  Held in Committee.  Reconsideration of 	favorable vote granted",7,0,0,0,7
661911,427846,2015-04-07,Senate,"Be adopted, but re-refer to the Committee on Appropriations 	Recommend Consent",11,0,0,0,11
661911,437932,2015-04-23,Senate,"Consent Calendar 2nd SCR2 Gaines",37,0,0,2,39
661911,461977,2015-06-22,Assembly,"Be adopted and re-referred to the Committee on Appropriations with 	recommendation:  To Consent Calendar",16,0,0,0,16
661911,465614,2015-07-08,Assembly,"Be adopted, to Consent Calendar",14,0,0,3,17
661911,465920,2015-07-13,Assembly,"SCR2 Gaines  Consent Calendar Second Day",79,0,0,1,80
661912,442221,2015-04-29,Senate,"Do pass, but re-refer to the Committee on Appropriations",9,0,0,0,9
661912,445112,2015-05-11,Senate,"Placed on Appropriations Suspense file",7,0,0,0,7
661912,453733,2015-05-28,Senate,"Do pass",7,0,0,0,7
661912,455328,2015-06-01,Senate,"Senate 3rd Reading SB43 Hernandez",37,0,3,0,40
661912,465968,2015-07-14,Assembly,"Do pass as amended and be re-referred to the Committee on 	Appropriations",17,1,0,1,19
661912,474243,2015-08-27,Assembly,"Do pass",17,0,0,0,17
661912,475514,2015-09-01,Assembly,"SB 43 Hernandez  Senate Third Reading  By BONTA",79,0,0,1,80
661912,475618,2015-09-02,Senate,"Unfinished Business SB43 Hernandez Concurrence",40,0,0,0,40
661994,384378,2015-01-16,Senate,"Senate 3rd Reading SCR3 Mendoza",31,0,6,0,37
661994,385549,2015-01-22,Assembly,"From committee:  Be adopted.  To third reading",11,0,0,0,11
661994,387707,2015-01-29,Senate,"Unfinished Business SCR3 Mendoza Concurrence",35,0,2,0,37
662533,427812,2015-04-06,Assembly,"Be adopted and re-referred to the Committee on Appropriations with 	recommendation:  To Consent Calendar",15,0,0,1,16
662533,433850,2015-04-15,Assembly,"Be adopted, to Consent Calendar",16,0,0,1,17
662533,435173,2015-04-20,Assembly,"ACR4 WALDRON  Consent Calendar Second Day  Regular Session",80,0,0,0,80
662533,460224,2015-06-16,Senate,"Be adopted, but re-refer to the Committee on Appropriations 	Recommend Consent",11,0,0,0,11
662533,464900,2015-07-02,Senate,"Consent Calendar 2nd ACR4 Waldron",38,0,2,0,40
662533,465149,2015-07-06,Assembly,"ACR4 WALDRON  Concurrence in Senate Amendments",79,0,0,1,80
662534,395082,2015-02-13,Senate,"Senate 3rd Reading SJR2 Vidak",31,0,6,0,37
662534,412376,2015-03-17,Assembly,"Be adopted as amended",9,1,0,0,10
662534,418691,2015-03-26,Assembly,"SJR2 Vidak  Senate Third Reading  By LACKEY",65,1,0,14,80
662534,429254,2015-04-09,Senate,"Unfinished Business SJR2 Vidak Concurrence",39,0,0,0,39
662535,438000,2015-04-14,Assembly,"Do pass as amended and be re-referred to the Committee on Judiciary",16,0,0,3,19
662535,439943,2015-04-28,Assembly,"Do pass and be re-referred to the Committee on Appropriations",3,4,0,3,10
662535,485072,2016-01-12,Assembly,"Do pass and be re-referred to the Committee on Appropriations",7,0,0,3,10
662535,486281,2016-01-21,Assembly,"Do pass, to Consent Calendar",17,0,0,0,17
662535,488343,2016-01-27,Assembly,"AB 59 WALDRON  Assembly Third Reading",77,0,0,2,79
662535,552032,2016-06-08,Senate,"Do pass, but re-refer to the Committee on Appropriations",6,0,3,0,9
662535,559805,2016-08-15,Senate,"Assembly 3rd Reading AB59 Waldron By Hall",38,0,1,0,39
662535,560186,2016-08-18,Assembly,"AB 59 WALDRON  Concurrence in Senate Amendments",79,0,0,1,80
662763,412414,2015-03-17,Assembly,"Do pass as amended and be re-referred to the Committee on 	Appropriations",10,0,0,0,10
662763,416888,2015-03-25,Assembly,"Do pass as amended, to Consent Calendar",16,0,0,1,17
662763,430570,2015-04-13,Assembly,"AB 60 GONZALEZ  Third Reading Urgency",77,0,0,3,80
662763,443668,2015-05-05,Senate,"Do pass, but re-refer to the Committee on Appropriations",7,0,0,0,7
662763,454404,2015-05-28,Senate,"Assembly 3rd Reading AB60 Gonzalez By Hill",37,0,3,0,40
662763,456047,2015-06-02,Assembly,"AB 60 GONZALEZ  Concurrence in Senate Amendments",79,0,0,1,80
663308,416900,2015-03-25,Senate,"Do pass, but re-refer to the Committee on Appropriations",5,0,0,0,5
663308,433964,2015-04-16,Senate,"Senate 3rd Reading SB45 Mendoza",38,0,1,0,39
663596,428558,2015-04-08,Assembly,"Do pass and be re-referred to the Committee on Appropriations to 	Consent Calendar",6,0,0,1,7
663726,418761,2015-03-25,Assembly,"Do pass as amended and be re-referred to the Committee on 	Transportation",6,0,0,1,7
663726,432606,2015-04-13,Assembly,"Do pass and be re-referred to the Committee on Appropriations",16,0,0,0,16
663726,453931,2015-05-28,Assembly,"Do pass as amended",17,0,0,0,17
663726,455953,2015-06-02,Assembly,"AB 63 BONILLA  Assembly Third Reading",76,0,0,4,80
663726,462561,2015-06-24,Senate,"Do pass, but re-refer to the Committee on Transportation and 	Housing",8,0,1,0,9
663726,465416,2015-07-07,Senate,"Do pass, but re-refer to the Committee on Appropriations",11,0,0,0,11
663726,473713,2015-08-17,Senate,"Placed on Appropriations Suspense file",7,0,0,0,7
663741,413023,2015-03-18,Senate,"Do pass as amended, and re-refer to the Committee on Appropriations",5,0,2,0,7
663741,430601,2015-04-13,Senate,"Placed on Appropriations Suspense file",7,0,0,0,7
663741,484886,2016-01-13,Senate,"Do pass as amended",3,2,4,0,9
663741,484887,2016-01-13,Senate,"Set, first hearing.  Failed passage in Committee.  Reconsideration 	granted",6,0,3,0,9
663742,413080,2015-03-18,Assembly,"Do pass and be re-referred to the Committee on Appropriations",5,2,0,0,7
663742,453726,2015-05-28,Assembly,"Do pass as amended",10,5,0,2,17
663742,457271,2015-06-04,Assembly,"AB 67 GONZALEZ  Assembly Third Reading",29,34,0,17,80
663742,488341,2016-01-27,Assembly,"AB 67 GONZALEZ  Assembly Third Reading",43,32,0,4,79
663742,552050,2016-06-08,Senate,"Do pass as amended, and re-refer to the Committee on Appropriations",3,1,1,0,5
663742,561353,2016-08-29,Senate,"Assembly 3rd Reading AB67 Gonzalez By Allen",22,14,3,0,39
663742,561750,2016-08-31,Assembly,"AB 67 GONZALEZ  Concurrence in Senate Amendments",31,37,0,12,80
663743,442164,2015-04-30,Assembly,"Do pass as amended and be re-referred to the Committee on 	Appropriations",6,0,0,5,11
663743,466113,2015-04-14,Assembly,"Do pass as amended and be re-referred to the Committee on Privacy 	and Consumer Protection",5,1,0,1,7
663744,415906,2015-03-24,Assembly,"Do pass and be re-referred to the Committee on Appropriations to 	Consent Calendar",6,0,0,1,7
663745,384013,2015-01-12,Assembly,"From committee:  Be adopted.  To third reading",11,0,0,0,11
663745,411804,2015-03-16,Senate,"Assembly 3rd Reading ACR5 Jones-Sawyer By Hall",34,0,3,0,37
664591,415799,2015-03-24,Assembly,"Amend, and do pass as amended and be re-referred to the Committee 	on Appropriations with the recommendation:  To Consent Calendar",7,0,0,0,7
664591,454046,2015-05-28,Assembly,"Do pass",17,0,0,0,17
664591,455406,2015-06-01,Assembly,"AB 71 RODRIGUEZ  Assembly Third Reading",80,0,0,0,80
664591,466203,2015-07-14,Senate,"Do pass, but re-refer to the Committee on Appropriations",7,0,0,0,7
664591,473667,2015-08-17,Senate,"Placed on Appropriations Suspense file",7,0,0,0,7
664591,474569,2015-08-27,Senate,"Do pass",6,0,1,0,7
664591,475975,2015-09-08,Senate,"Assembly 3rd Reading AB71 Rodriguez By Allen",40,0,0,0,40
664591,476107,2015-09-09,Assembly,"AB 71 RODRIGUEZ  Concurrence in Senate Amendments",79,0,0,1,80
664594,439422,2015-04-27,Senate,"Do pass as amended, and re-refer to the Committee on Appropriations",9,0,2,0,11
664594,453771,2015-05-28,Senate,"Do pass",7,0,0,0,7
664594,455326,2015-06-01,Senate,"Senate 3rd Reading SB48 Hill",39,0,1,0,40
664594,463563,2015-05-18,Senate,"Placed on Appropriations Suspense file",7,0,0,0,7
664594,463820,2015-06-29,Assembly,"Do pass and be re-referred to the Committee on Appropriations",14,0,0,1,15
664594,474309,2015-08-27,Assembly,"Do pass as amended",17,0,0,0,17
664594,476549,2015-09-11,Senate,"Unfinished Business (S upplemental File 2)SB4 8 Hil l",38,1,1,0,40
664594,476550,2015-09-11,Assembly,"SB 48 Hill  Senate Third Reading  By RENDON",79,0,0,1,80
664599,427844,2015-04-07,Assembly,"Do pass and be re-referred to the Committee on Privacy and Consumer 	Protection",7,0,0,0,7
664599,442250,2015-04-30,Assembly,"Do pass as amended",11,0,0,0,11
664599,453635,2015-05-28,Assembly,"AB 69 RODRIGUEZ  Assembly Third Reading",75,1,0,4,80
664599,466312,2015-07-14,Senate,"Do pass as amended, and re-refer to the Committee on Appropriations",7,0,0,0,7
664599,474127,2015-08-24,Senate,"Placed on Appropriations Suspense file",7,0,0,0,7
664599,474501,2015-08-27,Senate,"Do pass",7,0,0,0,7
664599,475619,2015-09-02,Senate,"Assembly 3rd Reading AB69 Rodriguez By Hueso",40,0,0,0,40
664599,475736,2015-09-03,Assembly,"AB 69 RODRIGUEZ  Concurrence in Senate Amendments",79,0,0,1,80
664602,427793,2015-04-07,Assembly,"Do pass and be re-referred to the Committee on Appropriations",18,0,0,1,19
664602,433902,2015-04-15,Assembly,"Do pass, to Consent Calendar",16,0,0,1,17
664602,438051,2015-04-23,Assembly,"AB 72 BONTA  Consent Calendar Second Day",78,0,0,2,80
664602,466484,2015-07-15,Senate,"Do pass, but re-refer to the Committee on Appropriations Recommend 	Consent",9,0,0,0,9
664602,473638,2015-08-17,Senate,"Do pass",6,0,1,0,7
664602,476327,2015-09-10,Senate,"Do pass",4,3,0,0,7
664602,556782,2016-06-29,Senate,"Do pass as amended, and re-refer to the Committee on Appropriations",7,1,1,0,9
664602,559616,2016-08-11,Senate,"Do pass",5,0,2,0,7
664602,561398,2016-08-29,Senate,"Assembly 3rd Reading AB72 Bonta By Hernandez",35,1,3,0,39
664602,561588,2016-08-30,Assembly,"Senate amendments be concurred in",15,0,0,3,18
664602,561695,2016-08-31,Assembly,"AB 72 BONTA  Concurrence in Senate Amendments",79,0,0,1,80
664605,437399,2015-04-21,Assembly,"Do pass as amended and be re-referred to the Committee on 	Appropriations",19,0,0,0,19
664605,453838,2015-05-28,Assembly,"Do pass as amended",17,0,0,0,17
664605,456790,2015-06-03,Assembly,"AB 68 WALDRON  Assembly Third Reading",78,0,0,2,80
664605,466578,2015-07-15,Senate,"Do pass as amended, and re-refer to the Committee on Appropriations",9,0,0,0,9
664605,474096,2015-08-24,Senate,"Placed on Appropriations Suspense file",7,0,0,0,7
664605,474524,2015-08-27,Senate,"Do pass",7,0,0,0,7
664605,475703,2015-09-02,Senate,"Assembly 3rd Reading AB68 Waldron By Hall",40,0,0,0,40
664605,475820,2015-09-03,Assembly,"AB 68 WALDRON  Concurrence in Senate Amendments",80,0,0,0,80
664607,441273,2015-04-28,Assembly,"Do pass as amended and be re-referred to the Committee on 	Appropriations",19,0,0,0,19
664607,486431,2016-01-21,Assembly,"Do pass",17,0,0,0,17
664607,486999,2016-01-25,Assembly,"AB 73 WALDRON  Assembly Third Reading",77,0,0,2,79
664607,559209,2016-08-09,Senate,"Do pass as amended",6,0,1,0,7
664607,560826,2016-08-23,Senate,"Assembly 3rd Reading AB73 Waldron By Monning Urgency Cla",39,0,0,0,39
664607,560827,2016-08-23,Senate,"Assembly 3rd Reading AB73 Waldron By Monning Urgency Cla",39,0,0,0,39
664607,560828,2016-08-23,Senate,"Assembly 3rd Reading AB73 Waldron By Monning Urgency Cla",39,0,0,0,39
664607,561291,2016-08-25,Assembly,"Senate amendments be concurred in",9,0,0,1,10
664607,561625,2016-08-30,Assembly,"AB 73 WALDRON  Concurrence- Urgency Added",80,0,0,0,80
664843,460341,2015-06-16,Senate,"Do pass as amended, and re-refer to the Committee on Appropriations",5,0,0,0,5
664843,465752,2015-07-09,Senate,"Senate 3rd Reading SB49 Runner Urgency Clause",38,0,2,0,40
664843,545109,2015-08-24,Assembly,"Do pass and be re-referred to the Committee on Appropriations",4,2,0,1,7
664843,545110,2016-05-11,Assembly,"Do pass",20,0,0,0,20
664843,555881,2016-06-27,Assembly,"SB 49 Runner  Third Reading Urgency  By WILK",70,4,0,6,80
664847,464467,2015-06-30,Senate,"Do pass, but re-refer to the Committee on Rules",2,3,2,0,7
664847,464468,2015-06-30,Senate,"Set, first hearing.  Failed passage in Committee.  Reconsideration 	granted",7,0,0,0,7
665753,415823,2015-03-24,Senate,"Do pass as amended, and re-refer to the Committee on Appropriations",7,0,0,0,7
665753,453979,2015-05-28,Senate,"Do pass",7,0,0,0,7
665753,455260,2015-06-01,Senate,"Senate 3rd Reading SB61 Hill",40,0,0,0,40
665753,463584,2015-04-27,Senate,"Placed on Appropriations Suspense file",7,0,0,0,7
665753,465849,2015-07-13,Assembly,"Do pass and be re-referred to the Committee on Appropriations to 	Consent Calendar",16,0,0,0,16
665753,474299,2015-08-27,Assembly,"Do pass",17,0,0,0,17
665753,475312,2015-08-31,Assembly,"SB 61 Hill  Senate Third Reading  By COOLEY",78,0,0,2,80
666032,416766,2015-03-25,Senate,"Do pass as amended, and re-refer to the Committee on Appropriations",8,0,0,0,8
666032,445168,2015-05-11,Senate,"Placed on Appropriations Suspense file",7,0,0,0,7
666032,454040,2015-05-28,Senate,"Do pass as amended",7,0,0,0,7
666032,456585,2015-06-03,Senate,"Senate 3rd Reading SB62 Pavley",40,0,0,0,40
666032,465494,2015-07-07,Assembly,"Do pass and be re-referred to the Committee on Appropriations",12,0,0,1,13
666032,559022,2016-08-03,Assembly,"Do pass, to Consent Calendar",20,0,0,0,20
666032,560355,2016-08-19,Assembly,"SB 62 Pavley  Senate Third Reading  Amendment  Set #1",73,0,0,7,80
666032,561563,2016-08-30,Assembly,"Do pass as amended",14,0,0,1,15
666032,561772,2016-08-31,Senate,"From committee:  That the Assembly Amendments be concurred in",10,0,1,0,11
666032,561773,2016-08-31,Assembly,"SB 62 Hill  Senate Third Reading  By HADLEY",78,0,0,2,80
666032,561774,2016-08-31,Senate,"W/O REF. TO FILE SB62 Hill",39,0,0,0,39
666901,416781,2015-03-25,Assembly,"Do pass and be re-referred to the Committee on Appropriations",8,0,0,1,9
666901,454294,2015-05-28,Assembly,"Do pass",16,1,0,0,17
666901,457348,2015-06-04,Assembly,"AB 80 CAMPOS  Assembly Third Reading",77,0,0,3,80
666901,465997,2015-07-14,Senate,"Do pass, but re-refer to the Committee on Appropriations",13,0,0,0,13
666901,473571,2015-08-17,Senate,"Placed on Appropriations Suspense file",7,0,0,0,7
666901,474581,2015-08-27,Senate,"Do pass",7,0,0,0,7
666901,475648,2015-09-02,Senate,"Assembly 3rd Reading AB80 Campos By Hall",39,0,1,0,40
666901,475716,2015-09-03,Assembly,"AB 80 CAMPOS  Concurrence in Senate Amendments",79,0,0,1,80
666902,435163,2015-04-20,Assembly,"From committee:  Be adopted.  To third reading",10,0,0,1,11
666905,432620,2015-04-15,Senate,"Do pass, but re-refer to the Committee on Appropriations",6,1,0,0,7
666905,453779,2015-05-28,Senate,"Do pass as amended",5,2,0,0,7
666905,455957,2015-06-02,Senate,"Senate 3rd Reading SB63 Hall",36,2,2,0,40
666905,463724,2015-04-27,Senate,"Placed on Appropriations Suspense file",7,0,0,0,7
666905,466567,2015-07-15,Assembly,"Do pass and be re-referred to the Committee on Appropriations",9,0,0,0,9
666905,473914,2015-08-19,Assembly,"Do pass",17,0,0,0,17
666905,475751,2015-09-03,Assembly,"SB 63 Hall  Senate Third Reading  By O'DONNELL",76,2,0,2,80
666905,475981,2015-09-08,Senate,"Unfinished Business SB63 Hall Concurrence",34,1,5,0,40
666907,440446,2015-04-28,Senate,"Do pass as amended, and re-refer to the Committee on Appropriations",10,1,0,0,11
666907,450288,2015-05-22,Senate,"Senate 3rd Reading SB64 Liu",36,2,1,0,39
666907,461815,2015-06-22,Assembly,"Do pass as amended and be re-referred to the Committee on 	Appropriations",16,0,0,0,16
666907,463587,2015-05-18,Senate,"Do pass",6,0,1,0,7
666907,474242,2015-08-27,Assembly,"Do pass",17,0,0,0,17
666907,475420,2015-09-01,Assembly,"SB 64 Liu  Senate Third Reading  By FRAZIER",80,0,0,0,80
666907,475656,2015-09-02,Senate,"Unfinished Business SB64 Liu Concurrence",40,0,0,0,40
666908,555527,2016-06-21,Assembly,"Be adopted as amended",7,2,0,0,9
666908,559156,2016-08-04,Assembly,"AJR3 ALEJO  Assembly Third Reading",55,13,0,12,80
666908,560712,2016-08-23,Senate,"Assembly 3rd Reading AJR3 Alejo By Hueso",29,8,2,0,39
666908,561248,2016-08-25,Assembly,"AJR3 ALEJO  Concurrence in Senate Amendments",58,14,0,8,80
666909,428178,2015-04-07,Assembly,"Do pass and be re-referred to the Committee on Appropriations to 	Consent Calendar",18,0,0,1,19
666909,433963,2015-04-15,Assembly,"Do pass, to Consent Calendar",16,0,0,1,17
666909,438078,2015-04-23,Assembly,"AB 81 WOOD  Consent Calendar Second Day  Regular Session",78,0,0,2,80
666909,458857,2015-06-10,Senate,"Do pass, but re-refer to the Committee on Appropriations Recommend 	Consent",9,0,0,0,9
666909,462947,2015-06-25,Senate,"Consent Calendar 2nd AB81 Wood Urgency Clause",37,0,3,0,40
666910,388659,2015-02-02,Assembly,"From committee:  Be adopted.  To third reading",11,0,0,0,11
666910,411796,2015-03-16,Senate,"Assembly 3rd Reading ACR6 Jones-Sawyer By Hall",34,0,3,0,37
666911,416546,2015-03-24,Assembly,"Do pass as amended and be re-referred to the Committee on Aging and 	Long",7,0,0,0,7
666911,436019,2015-04-21,Assembly,"Do pass and be re-referred to the Committee on Appropriations to 	Consent Calendar",7,0,0,0,7
666911,454373,2015-05-28,Assembly,"Do pass",17,0,0,0,17
666911,455336,2015-06-01,Assembly,"AB 74 CALDERON  Assembly Third Reading",80,0,0,0,80
666911,462161,2015-06-23,Senate,"Do pass as amended, but re-refer to the Committee on Appropriations 	Recommend Consent",5,0,0,0,5
666911,465897,2015-07-13,Senate,"Placed on Appropriations Suspense file",7,0,0,0,7
666911,474496,2015-08-27,Senate,"Do pass as amended",7,0,0,0,7
666911,475936,2015-09-08,Senate,"Assembly 3rd Reading AB74 Calderon By Beall",40,0,0,0,40
666911,476116,2015-09-09,Assembly,"AB 74 CALDERON  Concurrence in Senate Amendments",78,0,0,2,80
666912,441156,2015-04-28,Assembly,"Do pass and be re-referred to the Committee on Appropriations",8,0,0,1,9
667992,466013,2015-04-14,Assembly,"Do pass as amended and be re-referred to the Committee on 	Appropriations",6,1,0,0,7
667993,440178,2015-04-27,Assembly,"Do pass and be re-referred to the Committee on Appropriations",15,1,0,0,16
667993,453879,2015-05-28,Assembly,"Do pass as amended",17,0,0,0,17
667993,455887,2015-06-02,Assembly,"AB 82 GARCIA, C.  Assembly Third Reading",73,2,0,5,80
667993,464295,2015-06-30,Senate,"Do pass as amended, and re-refer to the Committee on Appropriations",9,0,2,0,11
667993,473699,2015-08-17,Senate,"Placed on Appropriations Suspense file",7,0,0,0,7
667993,474578,2015-08-27,Senate,"Do pass as amended",7,0,0,0,7
667993,475580,2015-09-02,Senate,"Assembly 3rd Reading AB82 Cristina Garcia By Hall",40,0,0,0,40
667993,475725,2015-09-03,Assembly,"AB 82 GARCIA, C.  Concurrence in Senate Amendments",79,0,0,1,80
667994,427839,2015-04-07,Senate,"Do pass, but re-refer to the Committee on Health",5,0,0,0,5
667994,437117,2015-04-22,Senate,"Do pass, but re-refer to the Committee on Appropriations Recommend 	Consent",8,0,1,0,9
667994,445216,2015-05-11,Senate,"Consent Calendar 2nd SB65 Wolk",36,0,3,0,39
667994,464829,2015-07-01,Assembly,"Do pass and be re-referred to the Committee on Appropriations to 	Consent Calendar",9,0,0,1,10
667994,465669,2015-07-08,Assembly,"Do pass, to Consent Calendar",14,0,0,3,17
667994,466512,2015-07-16,Assembly,"SB 65 Wolk  Consent Calendar Second Day  Regular Session",79,0,0,1,80
667995,440005,2015-04-28,Assembly,"Do pass and be re-referred to the Committee on Appropriations",5,2,0,0,7
667996,428820,2015-04-08,Assembly,"Do pass as amended and be re-referred to the Committee on 	Appropriations",21,0,0,0,21
667996,454102,2015-05-28,Assembly,"Do pass",17,0,0,0,17
667996,455521,2015-06-01,Assembly,"AB 85 WILK  Third Reading Urgency",80,0,0,0,80
667996,473698,2015-08-17,Senate,"Do pass",7,0,0,0,7
667996,475387,2015-08-31,Senate,"Assembly 3rd Reading AB85 Wilk By Vidak",40,0,0,0,40
667997,465795,2015-07-09,Assembly,"From committee:  Be adopted.  To third reading",11,0,0,0,11
667997,475293,2015-08-31,Senate,"Special Consent #8 ACR7 Rodriguez By Hall",40,0,0,0,40
667998,392369,2015-02-09,Senate,"Senate 3rd Reading SCR5 Gaines",34,0,3,0,37
667998,473752,2015-08-17,Assembly,"Be adopted, to Consent Calendar",11,0,0,0,11
667998,473968,2015-08-20,Assembly,"SCR5 Gaines  Consent Calendar Second Day  Regular Session",79,0,0,1,80
667999,442296,2015-04-30,Assembly,"Do pass",9,1,0,1,11
667999,444387,2015-05-07,Assembly,"AB 83 GATTO  Assembly Third Reading",66,4,0,10,80
667999,465577,2015-07-07,Senate,"Do pass as amended",5,1,1,0,7
667999,560942,2016-08-24,Senate,"From Committee:  That the measure be returned to the Senate floor 	for consideration",2,2,3,0,7
668000,384375,2015-01-16,Senate,"Senate 3rd Reading SCR4 Pan",31,0,6,0,37
668000,393171,2015-02-09,Assembly,"Be adopted, to Consent Calendar",10,0,0,1,11
668000,395113,2015-02-13,Assembly,"SCR4 Pan  Consent Calendar Second Day",70,0,0,10,80
669210,415019,2015-03-23,Assembly,"AB 91 BUDGET  Assembly Third Reading  By WEBER",51,27,0,2,80
669210,416936,2015-03-25,Senate,"Do pass",13,0,3,0,16
669210,416937,2015-03-25,Senate,"Assembly 3rd Reading ( Supplemental File 1)AB 91 Co mmittee on 	Budget By",36,1,3,0,40
669210,418652,2015-03-26,Assembly,"AB 91 BUDGET  Concurrence in Senate Amendments By WEBER",74,0,0,6,80
669257,448566,2015-05-18,Assembly,"Do pass as amended and be re-referred to the Committee on 	Appropriations",9,0,0,0,9
669257,453865,2015-05-28,Assembly,"Do pass",17,0,0,0,17
669257,455334,2015-06-01,Assembly,"AB 88 GOMEZ  Assembly Third Reading",78,0,0,2,80
669257,465617,2015-07-08,Senate,"Do pass as amended, and re-refer to the Committee on Appropriations",6,1,0,0,7
669257,473599,2015-08-17,Senate,"Placed on Appropriations Suspense file",7,0,0,0,7
669257,474541,2015-08-27,Senate,"Do pass",6,1,0,0,7
669257,475434,2015-09-01,Senate,"Assembly 3rd Reading AB88 Gomez By Hall",35,5,0,0,40
669257,475611,2015-09-02,Assembly,"AB 88 GOMEZ  Concurrence in Senate Amendments",80,0,0,0,80
669301,432571,2015-04-15,Assembly,"Do pass and be re-referred to the Committee on Appropriations",7,0,0,0,7
669301,453745,2015-05-28,Assembly,"Do pass",17,0,0,0,17
669301,457277,2015-06-04,Assembly,"AB 90 CHAU  Assembly Third Reading",80,0,0,0,80
669301,464293,2015-06-30,Senate,"Do pass, but re-refer to the Committee on Appropriations Recommend 	Consent",11,0,0,0,11
669301,465855,2015-07-13,Senate,"Placed on Appropriations Suspense file",7,0,0,0,7
669301,474485,2015-08-27,Senate,"Do pass",7,0,0,0,7
669301,475603,2015-09-02,Senate,"Assembly 3rd Reading AB90 Chau By Beall",40,0,0,0,40
669301,475776,2015-09-03,Assembly,"AB 90 CHAU  Concurrence in Senate Amendments",80,0,0,0,80
669349,415132,2015-03-23,Assembly,"AB 95 BUDGET  Assembly Third Reading  By WEBER",51,27,0,2,80
669349,459767,2015-06-15,Senate,"Do pass",11,2,3,0,16
669349,459768,2015-06-15,Senate,"Assembly 3rd Reading ( Supplemental File 1)AB 95 Co mmittee on 	Budget Am",26,12,2,0,40
669349,459769,2015-06-15,Senate,"Assembly 3rd Reading ( Supplemental File 1)AB 95 Co mmittee on 	Budget Am",26,12,2,0,40
669349,459770,2015-06-15,Senate,"Assembly 3rd Reading ( Supplemental File 1)AB 95 Co mmittee on 	Budget By",26,12,2,0,40
669349,459771,2015-06-15,Assembly,"AB 95 BUDGET  Concurrence in Senate Amendments By WEBER",50,28,0,2,80
669395,415000,2015-03-23,Assembly,"AB 92 BUDGET  Assembly Third Reading  By WEBER",51,27,0,2,80
669395,416749,2015-03-25,Senate,"Do pass",11,4,1,0,16
669395,416750,2015-03-25,Senate,"Assembly 3rd Reading ( Supplemental File 1)AB 92 Co mmittee on 	Budget By",25,14,1,0,40
669395,418885,2015-03-26,Assembly,"AB 92 BUDGET  Concurrence in Senate Amendments By WEBER",50,27,0,3,80
669486,415001,2015-03-23,Assembly,"AB 93 BUDGET  Assembly Third Reading  By WEBER",51,27,0,2,80
669486,454138,2015-05-28,Senate,"Assembly 3rd Reading AB93 Committee On BUDGET (Weber) By Leno",24,13,2,0,39
669486,454139,2015-05-28,Assembly,"AB 93 BUDGET  Concurrence in Senate Amendments By WEBER",1,74,0,5,80
669486,459777,2015-06-15,Assembly,"AB 93 WEBER  Conference Report",52,28,0,0,80
669486,459778,2015-06-15,Senate,"In Conference AB93 Committee On BUDGET (Weber) By Leno",26,13,1,0,40
669530,408653,2015-03-10,Assembly,"Do pass and be re-referred to the Committee on Appropriations",10,2,0,3,15
669530,453667,2015-05-28,Assembly,"Do pass",12,4,0,1,17
669530,455881,2015-06-02,Assembly,"AB 96 ATKINS  Assembly Third Reading",62,14,0,4,80
669530,462175,2015-06-23,Senate,"Do pass, but re-refer to the Committee on Appropriations",7,2,0,0,9
669530,465169,2015-07-06,Senate,"Placed on Appropriations Suspense file",7,0,0,0,7
669530,474604,2015-08-27,Senate,"Do pass",5,2,0,0,7
669530,475614,2015-09-02,Senate,"Assembly 3rd Reading AB96 Atkins By Lara",26,13,1,0,40
669530,475860,2015-09-04,Assembly,"AB 96 ATKINS  Concurrence in Senate Amendments",54,21,0,5,80
669577,412778,2015-03-17,Assembly,"Do pass",9,1,0,0,10
669577,413989,2015-03-19,Assembly,"AB 87 STONE  Assembly Third Reading",68,2,0,10,80
669577,458720,2015-06-09,Senate,"Do pass",6,1,0,0,7
669577,463297,2015-06-25,Senate,"Assembly 3rd Reading AB87 Mark Stone By Leno",32,5,3,0,40
669577,463924,2015-06-29,Assembly,"AB 87 STONE  Concurrence in Senate Amendments",67,4,0,9,80
669622,414994,2015-03-23,Assembly,"AB 94 BUDGET  Assembly Third Reading  By WEBER",51,27,0,2,80
669622,461123,2015-06-18,Senate,"Do pass",11,5,0,0,16
669667,485050,2016-01-13,Senate,"Do pass, but re-refer to the Committee on Appropriations",6,0,3,0,9
669667,485577,2016-01-19,Senate,"Do pass",7,0,0,0,7
669667,487034,2016-01-25,Senate,"Senate 3rd Reading SB66 Leyva",38,0,2,0,40
669667,554674,2016-06-21,Assembly,"Do pass as amended and be re-referred to the Committee on Business 	and Professions",13,0,0,0,13
669667,555979,2016-06-28,Assembly,"Do pass and be re-referred to the Committee on Appropriations",16,0,0,0,16
669667,559632,2016-08-10,Assembly,"Do pass",19,0,0,1,20
669667,561531,2016-08-30,Assembly,"SB 66 Leyva  Senate Third Reading  By THURMOND",78,1,0,1,80
669667,561729,2016-08-31,Senate,"Unfinished Business SB66 Leyva Concurrence",39,0,0,0,39
671317,462162,2015-06-23,Assembly,"From committee:  Be adopted.  To third reading",9,0,0,0,9
671317,465735,2015-07-09,Assembly,"HR5 GARCIA, C.  Assembly Third Reading",77,0,0,3,80
671325,418672,2015-03-25,Assembly,"Do pass and be re-referred to the Committee on Appropriations",6,1,0,0,7
671325,453625,2015-05-28,Assembly,"Do pass as amended",12,1,0,4,17
671325,456639,2015-06-03,Assembly,"AB 101 ALEJO  Assembly Third Reading",59,20,0,1,80
671325,473608,2015-08-17,Senate,"Placed on Appropriations Suspense file",7,0,0,0,7
671325,474563,2015-08-27,Senate,"Do pass as amended",5,2,0,0,7
671325,475931,2015-09-08,Senate,"Assembly 3rd Reading AB101 Alejo By Lara",29,10,1,0,40
671325,476065,2015-09-09,Assembly,"AB 101 ALEJO  Concurrence in Senate Amendments",61,15,0,4,80
671334,428380,2015-04-07,Senate,"Do pass, but re-refer to the Committee on Appropriations",7,0,0,0,7
671334,442896,2015-05-04,Senate,"Placed on Appropriations Suspense file",7,0,0,0,7
671334,454002,2015-05-28,Senate,"Do pass as amended",7,0,0,0,7
671334,456655,2015-06-03,Senate,"Senate 3rd Reading SB68 Liu",40,0,0,0,40
671334,462276,2015-06-23,Assembly,"Amend, and do pass as amended and be re-referred to the Committee 	on Human Services with the recommendation:  To Consent Calendar",10,0,0,0,10
671334,466369,2015-07-14,Assembly,"Do pass, to Consent Calendar",7,0,0,0,7
671334,474030,2015-08-20,Assembly,"SB 68 Liu  Consent Calendar Second Day  Regular Session",79,0,0,1,80
671334,474363,2015-08-27,Senate,"Special Consent #7 SB68 Liu",40,0,0,0,40
671343,393091,2015-02-10,Assembly,"From committee:  Be adopted.  To third reading",10,4,0,1,15
671343,396553,2015-02-17,Assembly,"AJR4 DODD  Assembly Third Reading",54,20,0,6,80
671343,416069,2015-03-24,Senate,"Be adopted",7,2,0,0,9
671343,427689,2015-04-06,Senate,"Assembly 3rd Reading AJR4 Dodd By Wolk",23,12,4,0,39
671352,483892,2016-01-05,Assembly,"Be referred to Committee on Education",11,0,0,0,11
671361,448368,2015-05-18,Assembly,"Do pass and be re-referred to the Committee on Appropriations",9,0,0,0,9
671361,453758,2015-05-28,Assembly,"Do pass",17,0,0,0,17
671361,455345,2015-06-01,Assembly,"AB 99 PEREA  Third Reading Urgency",80,0,0,0,80
671361,460674,2015-06-17,Senate,"Do pass, but re-refer to the Committee on Appropriations",7,0,0,0,7
671361,463853,2015-06-29,Senate,"Placed on Appropriations Suspense file",6,0,1,0,7
671361,474523,2015-08-27,Senate,"Do pass",7,0,0,0,7
671361,475435,2015-09-01,Senate,"Assembly 3rd Reading AB99 Perea By Cannella",40,0,0,0,40
671371,441164,2015-04-28,Assembly,"Do pass and be re-referred to the Committee on Appropriations",7,0,0,0,7
671371,453723,2015-05-28,Assembly,"Do pass",17,0,0,0,17
671371,455346,2015-06-01,Assembly,"AB 97 WEBER  Assembly Third Reading",79,0,0,1,80
671371,462107,2015-06-23,Senate,"Do pass, but re-refer to the Committee on Appropriations Recommend 	Consent",5,0,0,0,5
671371,465129,2015-07-06,Senate,"Placed on Appropriations Suspense file",7,0,0,0,7
671371,474589,2015-08-27,Senate,"Do pass as amended",7,0,0,0,7
671371,475423,2015-09-01,Senate,"Assembly 3rd Reading AB97 Weber By Pan",40,0,0,0,40
671371,475723,2015-09-03,Assembly,"AB 97 WEBER  Concurrence in Senate Amendments",80,0,0,0,80
672502,414974,2015-03-23,Assembly,"AB 127 BUDGET  Assembly Third Reading  By WEBER",51,27,0,2,80
672502,474412,2015-08-27,Senate,"Do pass",10,4,2,0,16
672503,414876,2015-03-23,Assembly,"AB 104 BUDGET  Assembly Third Reading  By WEBER",51,27,0,2,80
672503,461132,2015-06-18,Senate,"Do pass",15,1,0,0,16
672503,461692,2015-06-19,Senate,"Assembly 3rd Reading AB104 Committee On BUDGET (Weber) Amend by 	Fuller",22,14,4,0,40
672503,461693,2015-06-19,Senate,"Assembly 3rd Reading AB104 Committee On BUDGET (Weber) By Leno",38,0,2,0,40
672503,461694,2015-06-19,Assembly,"AB 104 BUDGET  Concurrence in Senate Amendments By WEBER",71,8,0,1,80
672504,414930,2015-03-23,Assembly,"AB 135 BUDGET  Assembly Third Reading  By WEBER",51,27,0,2,80
672505,414971,2015-03-23,Assembly,"AB 130 BUDGET  Assembly Third Reading  By WEBER",51,27,0,2,80
672506,415115,2015-03-23,Senate,"Senate 3rd Reading SB109 Committee On B. & F.R. (Leno)",23,13,3,0,39
672507,414898,2015-03-23,Assembly,"AB 118 BUDGET  Assembly Third Reading  By WEBER",51,27,0,2,80
672507,528779,2016-04-06,Senate,"Do pass",13,0,4,0,17
672507,529461,2016-04-07,Senate,"Assembly 2nd Reading AB118 Santiago By De Le",38,0,2,0,40
672507,533487,2016-04-14,Assembly,"AB 118 SANTIAGO  Concurrence in Senate Amendments",75,0,0,5,80
672508,415164,2015-03-23,Senate,"Senate 3rd Reading SB95 Committee On B. & F.R. (Leno)",23,13,3,0,39
672508,538086,2016-04-25,Assembly,"SB 95 B.& F. R.  Senate Third Reading  By TING",74,0,0,6,80
672508,539983,2016-04-28,Senate,"Unfinished Business SB95 Committee On B. & F.R. (Leno) Concurrence",31,2,7,0,40
672509,412411,2015-03-17,Assembly,"Do pass and be re-referred to the Committee on Appropriations",10,0,0,0,10
672509,416933,2015-03-25,Assembly,"Do pass, to Consent Calendar",16,0,0,1,17
672509,429243,2015-04-09,Assembly,"AB 139 GATTO  Consent Calendar Second Day  Regular Session",78,0,0,2,80
672509,465602,2015-07-07,Senate,"Do pass as amended, and re-refer to the Committee on Appropriations",6,0,1,0,7
672509,475282,2015-08-31,Senate,"Assembly 3rd Reading AB139 Gatto By Leno",40,0,0,0,40
672509,475412,2015-09-01,Assembly,"AB 139 GATTO  Concurrence in Senate Amendments",78,0,0,2,80
672510,415096,2015-03-23,Senate,"Senate 3rd Reading SB94 Committee On B. & F.R. (Leno)",23,13,3,0,39
672511,415085,2015-03-23,Senate,"Senate 3rd Reading SB92 Committee On B. & F.R. (Leno)",23,13,3,0,39
672513,414923,2015-03-23,Assembly,"AB 109 BUDGET  Assembly Third Reading  By WEBER",51,27,0,2,80
672513,461134,2015-06-18,Senate,"Do pass",14,1,1,0,16
672514,414964,2015-03-23,Assembly,"AB 123 BUDGET  Assembly Third Reading  By WEBER",51,27,0,2,80
672514,461259,2015-06-18,Senate,"Do pass",11,4,1,0,16
672515,447656,2015-05-18,Senate,"Senate 3rd Reading SB110 Fuller",36,0,3,0,39
672515,458674,2015-04-14,Senate,"Do pass as amended, and re-refer to the Committee on Appropriations",6,0,0,1,7
672515,464310,2015-06-30,Assembly,"Do pass and be re-referred to the Committee on Appropriations",7,0,0,0,7
672515,465634,2015-07-08,Assembly,"Do pass, to Consent Calendar",14,0,0,3,17
672515,473967,2015-08-20,Assembly,"SB 110 Fuller  Senate Third Reading  By WALDRON",75,3,0,2,80
672515,474280,2015-08-27,Senate,"Special Consent #7 SB110 Fuller",40,0,0,0,40
672516,414995,2015-03-23,Assembly,"AB 112 BUDGET  Assembly Third Reading  By WEBER",51,27,0,2,80
672516,461228,2015-06-18,Senate,"Do pass",11,4,1,0,16
672517,414984,2015-03-23,Assembly,"AB 137 BUDGET  Assembly Third Reading  By WEBER",51,27,0,2,80
672518,415145,2015-03-23,Senate,"Senate 3rd Reading SB105 Committee On B. & F.R. (Leno)",23,13,3,0,39
672518,474437,2015-08-27,Assembly,"Do pass",16,11,0,0,27
672519,415114,2015-03-23,Senate,"Senate 3rd Reading SB102 Committee On B. & F.R. (Leno)",23,13,3,0,39
672519,474423,2015-08-27,Assembly,"Do pass",16,11,0,0,27
672519,476593,2015-09-11,Assembly,"SB 102 B.& F. R.  Senate Third Reading  By WEBER",50,29,0,1,80
672519,476594,2015-09-11,Senate,"Unfinished Business (S upplemental File 2)SB1 02 Com mittee on 	B.&F.R. Con",26,14,0,0,40
672520,415044,2015-03-23,Assembly,"AB 122 BUDGET  Assembly Third Reading  By WEBER",51,27,0,2,80
672521,415376,2015-03-23,Senate,"Senate 3rd Reading SB96 Committee On B. & F.R. (Leno)",23,13,3,0,39
672522,415088,2015-03-23,Senate,"Senate 3rd Reading SB106 Committee On B. & F.R. (Leno)",23,13,3,0,39
672522,474430,2015-08-27,Assembly,"Do pass",16,11,0,0,27
672522,475854,2015-09-04,Assembly,"SB 106 B.& F. R.  Senate Third Reading  Amend By WEBER  Set #1",51,27,0,2,80
672522,476649,2015-09-11,Assembly,"SB 106 B.& F. R.  Senate Third Reading  By WEBER",77,0,0,3,80
672523,414914,2015-03-23,Assembly,"AB 132 BUDGET  Assembly Third Reading  By WEBER",51,27,0,2,80
672526,414911,2015-03-23,Assembly,"AB 131 BUDGET  Assembly Third Reading  By WEBER",51,27,0,2,80
672526,476617,2015-09-11,Senate,"Do pass",11,5,0,0,16
672527,415018,2015-03-23,Assembly,"AB 114 BUDGET  Assembly Third Reading  By WEBER",51,27,0,2,80
672527,459863,2015-06-15,Senate,"Do pass",15,0,1,0,16
672527,459864,2015-06-15,Senate,"Assembly 3rd Reading ( Supplemental File 1)AB 114 Co mmittee on 	Budget By",36,3,1,0,40
672527,459865,2015-06-15,Assembly,"AB 114 BUDGET  Concurrence in Senate Amendments By WEBER",78,2,0,0,80
672528,415432,2015-03-23,Senate,"Senate 3rd Reading SB81 Committee On B. & F.R. (Leno)",23,13,3,0,39
672528,461668,2015-06-19,Assembly,"SB 81 B.& F. R.  Senate Third Reading  By WEBER",79,0,0,1,80
672528,461669,2015-06-19,Senate,"W/O REF. TO FILE SB81 Committee on Budget an d Fiscal ReviewBy Leno",40,0,0,0,40
672530,414934,2015-03-23,Assembly,"AB 105 BUDGET  Assembly Third Reading  By WEBER",51,27,0,2,80
672530,461247,2015-06-18,Senate,"Do pass",16,0,0,0,16
672532,415241,2015-03-23,Senate,"Senate 3rd Reading SB97 Committee On B. & F.R. (Leno)",23,13,3,0,39
672532,461700,2015-06-19,Assembly,"SB 97 B.& F. R.  Senate Third Reading  By WEBER",53,27,0,0,80
672532,461701,2015-06-19,Senate,"W/O REF. TO FILE SB97 Committee on Budget an d Fiscal ReviewBy Leno",30,9,1,0,40
672533,415236,2015-03-23,Senate,"Senate 3rd Reading SB91 Committee On B. & F.R. (Leno)",23,13,3,0,39
672533,474462,2015-08-27,Assembly,"Do pass",16,11,0,0,27
672534,415075,2015-03-23,Senate,"Senate 3rd Reading SB89 Committee On B. & F.R. (Leno)",23,13,3,0,39
672535,414884,2015-03-23,Assembly,"AB 106 BUDGET  Assembly Third Reading  By WEBER",51,27,0,2,80
672535,461129,2015-06-18,Senate,"Do pass",13,3,0,0,16
672536,418626,2015-03-25,Assembly,"Do pass as amended and be re-referred to the Committee on 	Appropriations",6,0,0,1,7
672536,453750,2015-05-28,Assembly,"Do pass as amended",12,4,0,1,17
672536,456611,2015-06-03,Assembly,"AB 141 BONILLA  Assembly Third Reading",53,26,0,1,80
672536,466346,2015-07-15,Senate,"Do pass, but re-refer to the Committee on Appropriations",9,0,0,0,9
672536,473575,2015-08-17,Senate,"Placed on Appropriations Suspense file",7,0,0,0,7
672536,474549,2015-08-27,Senate,"Do pass",6,1,0,0,7
672536,476111,2015-09-09,Senate,"Assembly 3rd Reading AB141 Bonilla By Wolk",35,4,1,0,40
672536,476267,2015-09-10,Assembly,"AB 141 BONILLA  Concurrence in Senate Amendments",66,12,0,2,80
672537,415049,2015-03-23,Assembly,"AB 125 BUDGET  Assembly Third Reading  By WEBER",51,27,0,2,80
672538,414951,2015-03-23,Assembly,"AB 107 BUDGET  Assembly Third Reading  By WEBER",51,27,0,2,80
672538,461284,2015-06-18,Senate,"Do pass",15,1,0,0,16
672539,415079,2015-03-23,Senate,"Senate 3rd Reading SB108 Committee On B. & F.R. (Leno)",23,13,3,0,39
672540,414887,2015-03-23,Assembly,"AB 121 BUDGET  Assembly Third Reading  By WEBER",51,27,0,2,80
672541,415143,2015-03-23,Senate,"Senate 3rd Reading SB78 Committee On B. & F.R. (Leno)",23,13,3,0,39
672541,461676,2015-06-19,Senate,"W/O REF. TO FILE SB78 Committee on Budget an d Fiscal ReviewBy Leno",36,0,4,0,40
672541,461677,2015-06-19,Assembly,"SB 78 B.& F. R.  Senate Third Reading  By WEBER",77,0,0,3,80
672542,414886,2015-03-23,Assembly,"AB 126 BUDGET  Assembly Third Reading  By WEBER",51,27,0,2,80
672542,474275,2015-08-27,Senate,"Do pass",12,3,1,0,16
672543,415271,2015-03-23,Senate,"Senate 3rd Reading SB90 Committee On B. & F.R. (Leno)",23,13,3,0,39
672545,415427,2015-03-23,Senate,"Senate 3rd Reading SB80 Committee On B. & F.R. (Leno)",23,13,3,0,39
672545,461680,2015-06-19,Assembly,"SB 80 B.& F. R.  Senate Third Reading  By WEBER",75,3,0,2,80
672545,461681,2015-06-19,Senate,"W/O REF. TO FILE SB80 Committee on Budget an d Fiscal ReviewBy Leno",38,1,1,0,40
672546,415097,2015-03-23,Senate,"Senate 3rd Reading SB85 Committee On B. & F.R. (Leno)",23,13,3,0,39
672546,461671,2015-06-19,Senate,"W/O REF. TO FILE SB85 Committee on Budget an d Fiscal ReviewBy Leno",27,12,1,0,40
672546,461672,2015-06-19,Assembly,"SB 85 B.& F. R.  Senate Third Reading  By WEBER",52,28,0,0,80
672547,414906,2015-03-23,Assembly,"AB 111 BUDGET  Assembly Third Reading  By WEBER",51,27,0,2,80
672547,461188,2015-06-18,Senate,"Do pass",11,5,0,0,16
672548,415004,2015-03-23,Assembly,"AB 108 BUDGET  Assembly Third Reading  By WEBER",51,27,0,2,80
672548,461143,2015-06-18,Senate,"Do pass",16,0,0,0,16
672549,414986,2015-03-23,Assembly,"AB 110 BUDGET  Assembly Third Reading  By WEBER",51,27,0,2,80
672549,461285,2015-06-18,Senate,"Do pass",10,5,1,0,16
672550,415078,2015-03-23,Assembly,"AB 116 BUDGET  Assembly Third Reading  By WEBER",51,27,0,2,80
672550,459842,2015-06-15,Senate,"Do pass",11,4,1,0,16
672550,459843,2015-06-15,Senate,"Assembly 3rd Reading ( Supplemental File 1)AB 116 Co mmittee on 	Budget By",26,13,1,0,40
672550,459844,2015-06-15,Assembly,"AB 116 BUDGET  Concurrence in Senate Amendments By WEBER",61,18,0,1,80
672551,415100,2015-03-23,Senate,"Senate 3rd Reading SB75 Committee On B. & F.R. (Leno)",23,13,3,0,39
672551,461685,2015-06-19,Assembly,"SB 75 B.& F. R.  Senate Third Reading  By WEBER  Amend By CHANG 	Set #1  Motion to  Lay on the Table  By HOLDEN",53,27,0,0,80
672551,461686,2015-06-19,Assembly,"SB 75 B.& F. R.  Senate Third Reading  By WEBER",52,27,0,1,80
672551,461687,2015-06-19,Senate,"W/O REF. TO FILE SB75 Committee on Budget an d Fiscal ReviewBy Leno",28,12,0,0,40
672552,415017,2015-03-23,Assembly,"AB 128 BUDGET  Assembly Third Reading  By WEBER",51,27,0,2,80
672552,474332,2015-08-27,Senate,"Do pass",15,0,1,0,16
672553,415133,2015-03-23,Senate,"Senate 3rd Reading SB103 Committee On B. & F.R. (Leno)",23,13,3,0,39
672553,474447,2015-08-27,Assembly,"Do pass",20,7,0,0,27
672553,476523,2015-09-11,Assembly,"SB 103 B.& F. R.  Senate Third Reading  By WEBER",68,11,0,1,80
672553,476524,2015-09-11,Senate,"Unfinished Business (S upplemental File 2)SB1 03 Com mittee on 	B.&F.R. Con",39,1,0,0,40
672554,415169,2015-03-23,Senate,"Senate 3rd Reading SB101 Committee On B. & F.R. (Leno)",23,13,3,0,39
672554,474467,2015-08-27,Assembly,"Do pass",25,2,0,0,27
672554,475885,2015-09-04,Assembly,"SB 101 B.& F. R.  Senate Third Reading  Amend By WEBER  Set #1",51,28,0,1,80
672554,476642,2015-09-11,Assembly,"SB 101 B.& F. R.  Senate Third Reading  By WEBER",50,29,0,1,80
672554,476643,2015-09-11,Senate,"Unfinished Business (S upplemental File 2)SB1 01 Com mittee on 	B.F.&R. Con",25,14,1,0,40
672555,415141,2015-03-23,Assembly,"AB 134 BUDGET  Assembly Third Reading  By WEBER",51,27,0,2,80
672556,409629,2015-03-11,Senate,"Do pass, but re-refer to the Committee on Appropriations",6,0,2,0,8
672556,453763,2015-05-28,Senate,"Do pass as amended",7,0,0,0,7
672556,456637,2015-06-03,Senate,"Senate 3rd Reading SB111 Fuller",40,0,0,0,40
672556,464933,2015-07-01,Assembly,"Do pass and be re-referred to the Committee on Appropriations to 	Consent Calendar",6,0,0,1,7
672556,474366,2015-08-27,Assembly,"Do pass",17,0,0,0,17
672556,475638,2015-09-02,Assembly,"SB 111 Fuller  Senate Third Reading  By LACKEY",80,0,0,0,80
672557,414996,2015-03-23,Assembly,"AB 117 BUDGET  Assembly Third Reading  By WEBER",51,27,0,2,80
672557,461242,2015-06-18,Senate,"Do pass",11,4,1,0,16
672557,461673,2015-06-19,Senate,"Assembly 3rd Reading AB117 Committee On BUDGET (Weber) Amend by 	Vidak",25,14,1,0,40
672557,461674,2015-06-19,Senate,"Assembly 3rd Reading AB117 Committee On BUDGET (Weber) By Leno",23,13,4,0,40
672557,461675,2015-06-19,Assembly,"AB 117 BUDGET  Concurrence in Senate Amendments By WEBER",62,14,0,4,80
672558,415293,2015-03-23,Senate,"Senate 3rd Reading SB87 Committee On B. & F.R. (Leno)",23,13,3,0,39
672559,415020,2015-03-23,Assembly,"AB 124 BUDGET  Assembly Third Reading  By WEBER",51,27,0,2,80
672559,461158,2015-06-18,Senate,"Do pass",10,5,1,0,16
672561,415286,2015-03-23,Senate,"Senate 3rd Reading SB98 Committee On B. & F.R. (Leno)",23,13,3,0,39
672561,461688,2015-06-19,Senate,"W/O REF. TO FILE SB98 Committee on Budget an d Fiscal ReviewBy Leno",26,14,0,0,40
672561,461689,2015-06-19,Assembly,"SB 98 B.& F. R.  Senate Third Reading  By WEBER",72,3,0,5,80
672562,415082,2015-03-23,Senate,"Senate 3rd Reading SB88 Committee On B. & F.R. (Leno)",23,13,3,0,39
672562,461666,2015-06-19,Assembly,"SB 88 B.& F. R.  Senate Third Reading  By WEBER",52,28,0,0,80
672562,461667,2015-06-19,Senate,"W/O REF. TO FILE SB88 Committee on Budget an d Fiscal ReviewBy Leno",24,14,2,0,40
672564,414976,2015-03-23,Assembly,"AB 120 BUDGET  Assembly Third Reading  By WEBER",51,27,0,2,80
672564,538761,2016-04-26,Senate,"Do pass",16,0,1,0,17
672564,539629,2016-04-28,Senate,"Assembly 3rd Reading AB120 Committee On BUDGET (Ting) By Leno",37,0,3,0,40
672564,539630,2016-04-28,Assembly,"AB 120 BUDGET  Concurrence in Senate Amendments By TING",77,0,0,3,80
672565,415323,2015-03-23,Senate,"Senate 3rd Reading SB86 Committee On B. & F.R. (Leno)",23,13,3,0,39
672565,505401,2016-02-23,Assembly,"Do pass",24,0,0,3,27
672565,509313,2016-02-29,Assembly,"SB 86 B.& F. R.  Senate Third Reading  By WEBER",77,0,0,2,79
672566,415261,2015-03-23,Senate,"Senate 3rd Reading SB93 Committee On B. & F.R. (Leno)",23,13,3,0,39
672566,533390,2016-04-14,Assembly,"SB 93 De Leon  Senate Third Reading",76,0,0,4,80
672566,534164,2016-04-18,Senate,"Unfinished Business SB93 De Le",39,0,1,0,40
672567,415556,2015-03-23,Senate,"Senate 3rd Reading SB77 Committee On B. & F.R. (Leno)",23,13,3,0,39
672568,414875,2015-03-23,Assembly,"AB 113 BUDGET  Assembly Third Reading  By WEBER",51,27,0,2,80
672569,415118,2015-03-23,Senate,"Senate 3rd Reading SB83 Committee On B. & F.R. (Leno)",23,13,3,0,39
672569,461704,2015-06-19,Assembly,"SB 83 B.& F. R.  Senate Third Reading  By WEBER",52,28,0,0,80
672569,461705,2015-06-19,Senate,"W/O REF. TO FILE SB83 Committee on Budget an d Fiscal ReviewBy Leno",25,14,1,0,40
672570,415084,2015-03-23,Senate,"Senate 3rd Reading SB107 Committee On B. & F.R. (Leno)",23,13,3,0,39
672570,474372,2015-08-27,Assembly,"Do pass",16,11,0,0,27
672570,476545,2015-09-11,Senate,"Unfinished Business (S upplemental File 1)SB1 07 B.& F.R. (Leno) Con",24,15,1,0,40
672570,476546,2015-09-11,Assembly,"SB 107 B.& F. R.  Senate Third Reading  By WEBER",45,31,0,4,80
672570,485058,2015-09-11,Senate,"From committee:  That the Assembly Amendments be concurred in",9,5,2,0,16
672571,414938,2015-03-23,Assembly,"AB 136 BUDGET  Assembly Third Reading  By WEBER",51,27,0,2,80
672572,414981,2015-03-23,Assembly,"AB 133 BUDGET  Assembly Third Reading  By WEBER",51,27,0,2,80
672572,505167,2016-02-23,Senate,"Do pass",14,0,2,0,16
672572,509876,2016-02-29,Senate,"Assembly 3rd Reading AB133 Committee On BUDGET (Weber) By Leno",40,0,0,0,40
672572,509877,2016-02-29,Assembly,"AB 133 BUDGET  Concurrence in Senate Amendments By WEBER",78,0,0,1,79
672573,415108,2015-03-23,Senate,"Senate 3rd Reading SB100 Committee On B. & F.R. (Leno)",23,13,3,0,39
672574,415200,2015-03-23,Senate,"Senate 3rd Reading SB79 Committee On B. & F.R. (Leno)",23,13,3,0,39
672574,461702,2015-06-19,Assembly,"SB 79 B.& F. R.  Senate Third Reading  By WEBER",66,12,0,2,80
672574,461703,2015-06-19,Senate,"W/O REF. TO FILE SB79 Committee on Budget an d Fiscal ReviewBy Leno",32,7,1,0,40
672575,415159,2015-03-23,Senate,"Senate 3rd Reading SB84 Committee On B. & F.R. (Leno)",23,13,3,0,39
672575,461683,2015-06-19,Assembly,"SB 84 B.& F. R.  Senate Third Reading  By WEBER",52,26,0,2,80
672575,461684,2015-06-19,Senate,"W/O REF. TO FILE SB84 Committee on Budget an d Fiscal ReviewBy Leno",28,12,0,0,40
672576,415010,2015-03-23,Assembly,"AB 138 BUDGET  Assembly Third Reading  By WEBER",51,27,0,2,80
672577,415064,2015-03-23,Assembly,"AB 115 BUDGET  Assembly Third Reading  By WEBER",51,27,0,2,80
672577,461164,2015-06-18,Senate,"Do pass",10,5,1,0,16
672578,415274,2015-03-23,Senate,"Senate 3rd Reading SB99 Committee On B. & F.R. (Leno)",23,13,3,0,39
672578,474410,2015-08-27,Assembly,"Do pass",27,0,0,0,27
672578,476530,2015-09-11,Assembly,"SB 99 B.& F. R.  Senate Third Reading  By WEBER",51,26,0,3,80
672578,476531,2015-09-11,Senate,"Unfinished Business (S upplemental File 2)SB9 9 B.& F.R. (Leno) Con",26,14,0,0,40
672579,415091,2015-03-23,Assembly,"AB 119 BUDGET  Assembly Third Reading  By WEBER",51,27,0,2,80
672579,459869,2015-06-15,Senate,"Do pass",14,1,1,0,16
672579,459870,2015-06-15,Senate,"Assembly 3rd Reading ( Supplemental File 1)AB 119 Co mmittee on 	Budget By",35,3,2,0,40
672579,459871,2015-06-15,Assembly,"AB 119 BUDGET  Concurrence in Senate Amendments By WEBER",78,1,0,1,80
672580,415076,2015-03-23,Senate,"Senate 3rd Reading SB82 Committee On B. & F.R. (Leno)",23,13,3,0,39
672580,461663,2015-06-19,Senate,"W/O REF. TO FILE SB82 Committee on Budget an d Fiscal ReviewBy Leno",35,0,5,0,40
672580,461664,2015-06-19,Assembly,"SB 82 B.& F. R.  Senate Third Reading  By WEBER  Amend By GROVE 	Set #1  Motion to  Lay on the Table  By HOLDEN",51,28,0,1,80
672580,461665,2015-06-19,Assembly,"SB 82 B.& F. R.  Senate Third Reading  By WEBER",79,0,0,1,80
672581,415210,2015-03-23,Senate,"Senate 3rd Reading SB76 Committee On B. & F.R. (Leno)",23,13,3,0,39
672582,415012,2015-03-23,Assembly,"AB 129 BUDGET  Assembly Third Reading  By WEBER",51,27,0,2,80
672582,474247,2015-08-27,Senate,"Do pass as amended",14,0,2,0,16
672583,415498,2015-03-23,Senate,"Senate 3rd Reading SB104 Committee On B. & F.R. (Leno)",23,13,3,0,39
672583,474245,2015-08-27,Assembly,"Do pass",27,0,0,0,27
674531,392491,2015-02-09,Senate,"Senate 3rd Reading SCR6 Monning",33,0,4,0,37
674531,462143,2015-06-23,Assembly,"From committee:  Be adopted.  To third reading",9,0,0,0,9
674531,464881,2015-07-02,Senate,"Unfinished Business SCR6 Monning Concurrence",38,0,2,0,40
674532,384384,2015-01-16,Senate,"Senate 3rd Reading SR8 De Le",31,0,6,0,37
674533,384376,2015-01-16,Senate,"Senate 3rd Reading SR9 Mitchell",30,0,7,0,37
674534,485158,2016-01-12,Senate,"Do pass as amended",5,0,0,0,5
674534,487030,2016-01-25,Senate,"Senate 3rd Reading SB112 Roth",38,0,2,0,40
674535,416036,2015-03-23,Assembly,"Do pass as amended and be re-referred to the Committee on 	Appropriations",8,1,0,0,9
674535,454195,2015-05-28,Assembly,"Do pass",17,0,0,0,17
674535,455538,2015-06-01,Assembly,"AB 142 BIGELOW  Assembly Third Reading",71,3,0,6,80
674535,466144,2015-07-14,Senate,"Do pass as amended, and re-refer to the Committee on Appropriations",9,0,0,0,9
674535,473767,2015-08-17,Senate,"Placed on Appropriations Suspense file",7,0,0,0,7
674535,474513,2015-08-27,Senate,"Do pass as amended",5,0,2,0,7
674535,476118,2015-09-09,Senate,"Assembly 3rd Reading AB142 Bigelow By Berryhill",39,0,1,0,40
674535,476422,2015-09-10,Assembly,"AB 142 BIGELOW  Concurrence in Senate Amendments",74,1,0,5,80
674536,437995,2015-04-14,Assembly,"Amend, and do pass as amended and be re-referred to the Committee 	on Appropriations with the recommendation:  To Consent Calendar",16,0,0,3,19
674536,441178,2015-04-29,Assembly,"Do pass, to Consent Calendar",17,0,0,0,17
674536,444369,2015-05-07,Assembly,"AB 143 WOOD  Consent Calendar Second Day  Regular Session",77,0,0,3,80
674536,458648,2015-06-10,Senate,"Do pass, but re-refer to the Committee on Appropriations Recommend 	Consent",9,0,0,0,9
674536,464926,2015-07-02,Senate,"Consent Calendar 2nd AB143 Wood",38,0,2,0,40
674536,465165,2015-07-06,Assembly,"AB 143 WOOD  Concurrence in Senate Amendments",79,0,0,1,80
678173,388620,2015-02-02,Senate,"Senate 3rd Reading SCR9 Fuller",36,0,1,0,37
678173,396528,2015-02-17,Assembly,"Be adopted, to Consent Calendar",11,0,0,0,11
678173,398403,2015-02-19,Assembly,"SCR9 Fuller  Consent Calendar Second Day",73,0,0,7,80
678184,416996,2015-03-25,Senate,"Do pass as amended, and re-refer to the Committee on Governance and 	Finance",6,0,2,0,8
678184,437094,2015-04-22,Senate,"Do pass, but re-refer to the Committee on Appropriations",5,1,1,0,7
678184,445164,2015-05-11,Senate,"Placed on Appropriations Suspense file",7,0,0,0,7
678184,453859,2015-05-28,Senate,"Do pass",5,2,0,0,7
678184,455897,2015-06-02,Senate,"Senate 3rd Reading SB114 Liu Reconsider",40,0,0,0,40
678184,458686,2015-06-02,Senate,"Senate 3rd Reading SB114 Liu Reconsider",40,0,0,0,40
678195,413086,2015-03-18,Assembly,"Do pass and be re-referred to the Committee on Appropriations to 	Consent Calendar",7,0,0,0,7
678195,416806,2015-03-25,Assembly,"Do pass, to Consent Calendar",16,0,0,1,17
678195,429246,2015-04-09,Assembly,"AB 145 GOMEZ  Consent Calendar Second Day  Regular Session",78,0,0,2,80
678195,458567,2015-06-10,Senate,"Do pass, but re-refer to the Committee on Appropriations",9,0,0,0,9
678195,475409,2015-09-01,Senate,"Assembly 3rd Reading AB145 Gomez By Hernandez",38,0,2,0,40
678195,475584,2015-09-02,Assembly,"AB 145 GOMEZ  Concurrence in Senate Amendments",80,0,0,0,80
678207,442420,2015-04-29,Senate,"Do pass, but re-refer to the Committee on Appropriations",9,0,0,0,9
678207,445228,2015-05-11,Senate,"Placed on Appropriations Suspense file",7,0,0,0,7
678207,453834,2015-05-28,Senate,"Do pass",7,0,0,0,7
678207,455264,2015-06-01,Senate,"Senate 3rd Reading SB115 Fuller",39,0,1,0,40
678207,462176,2015-06-23,Assembly,"Do pass and be re-referred to the Committee on Appropriations",19,0,0,0,19
678218,418713,2015-03-25,Assembly,"Do pass and be re-referred to the Committee on Appropriations",6,0,0,1,7
678218,453895,2015-05-28,Assembly,"Do pass",13,1,0,3,17
678218,455911,2015-06-02,Assembly,"AB 146 GARCIA, C.  Assembly Third Reading",62,9,0,9,80
678218,464733,2015-07-01,Senate,"Do pass, but re-refer to the Committee on Appropriations",6,0,3,0,9
678218,465866,2015-07-13,Senate,"Placed on Appropriations Suspense file",7,0,0,0,7
678218,474647,2015-08-27,Senate,"Do pass as amended",5,2,0,0,7
678218,475577,2015-09-02,Senate,"Assembly 3rd Reading AB146 Cristina Garcia By Lara",29,7,4,0,40
678218,475842,2015-09-04,Assembly,"AB 146 GARCIA, C.  Concurrence in Senate Amendments",62,10,0,8,80
678239,461951,2015-06-22,Senate,"Senate 3rd Reading SCR7 Fuller",38,0,2,0,40
678239,465813,2015-07-09,Assembly,"Be adopted, to Consent Calendar",11,0,0,0,11
678239,466452,2015-07-16,Assembly,"SCR7 Fuller  Consent Calendar Second Day  Regular Session",79,0,0,1,80
678247,444004,2015-05-06,Assembly,"Do pass, to Consent Calendar",17,0,0,0,17
678247,446675,2015-05-14,Assembly,"AB 144 MATHIS  Consent Calendar Second Day  Regular Session",78,0,0,2,80
678247,458413,2015-06-09,Senate,"Do pass, but re-refer to the Committee on Appropriations",7,0,0,0,7
678247,461999,2015-06-22,Senate,"Placed on Appropriations Suspense file",6,0,1,0,7
678247,466184,2015-04-14,Assembly,"Do pass as amended and be re-referred to the Committee on 	Appropriations",7,0,0,0,7
678247,474717,2015-08-27,Senate,"Do pass",7,0,0,0,7
678247,475927,2015-09-08,Senate,"Assembly 3rd Reading AB144 Mathis By Vidak",40,0,0,0,40
678247,476089,2015-09-09,Assembly,"AB 144 MATHIS  Concurrence in Senate Amendments",78,0,0,2,80
678258,465822,2015-07-09,Senate,"Senate 3rd Reading SCR8 Fuller",38,0,2,0,40
678258,473794,2015-08-17,Assembly,"Be adopted, to Consent Calendar",11,0,0,0,11
678258,474010,2015-08-20,Assembly,"SCR8 Fuller  Consent Calendar Second Day  Regular Session",79,0,0,1,80
680707,432540,2015-04-14,Senate,"Do pass, but re-refer to the Committee on Judiciary",9,2,0,0,11
680707,440127,2015-04-28,Senate,"Do pass as amended, and re-refer to the Committee on Appropriations",5,1,1,0,7
680707,446614,2015-04-06,Senate,"Do pass, but re-refer to the Committee on Governmental Organization",8,0,1,0,9
680707,451460,2015-05-26,Senate,"Placed on Appropriations Suspense file",7,0,0,0,7
680707,453671,2015-05-28,Senate,"Do pass as amended",5,2,0,0,7
680707,455991,2015-06-02,Senate,"Senate 3rd Reading SB119 Hill",24,11,5,0,40
680707,466057,2015-07-14,Assembly,"Do pass and be re-referred to the Committee on Appropriations",8,1,0,1,10
680707,466334,2015-07-06,Assembly,"Do pass and be re-referred to the Committee on Judiciary",13,0,0,2,15
680707,474252,2015-08-27,Assembly,"Do pass as amended",12,3,0,2,17
680707,475921,2015-09-08,Assembly,"SB 119 Hill  Senate Third Reading  By RENDON",74,3,0,3,80
680707,476253,2015-09-10,Senate,"Unfinished Business SB119 Hill Concurrence",37,3,0,0,40
680719,409480,2015-03-11,Senate,"Do pass, but re-refer to the Committee on Health",8,0,0,0,8
680719,417237,2015-03-25,Senate,"Do pass as amended, and re-refer to the Committee on Appropriations",9,0,0,0,9
680719,453921,2015-05-28,Senate,"Do pass",7,0,0,0,7
680719,455417,2015-06-01,Senate,"Senate 3rd Reading SB118 Liu",38,1,1,0,40
680719,462111,2015-06-23,Assembly,"Do pass and be re-referred to the Committee on Education",17,0,0,2,19
680719,463595,2015-04-27,Senate,"Placed on Appropriations Suspense file",7,0,0,0,7
680719,466382,2015-07-15,Assembly,"Do pass and be re-referred to the Committee on Appropriations to 	Consent Calendar",7,0,0,0,7
680732,392192,2015-02-09,Senate,"Senate 3rd Reading SCR10 Huff",33,0,4,0,37
680732,399833,2015-02-23,Assembly,"Be adopted, to Consent Calendar",11,0,0,0,11
680732,405968,2015-03-05,Assembly,"SCR 10 Huff  Consent Calendar Second Day",78,0,0,2,80
680732,407726,2015-03-09,Senate,"Unfinished Business SCR10 Huff Concurrence",35,0,2,0,37
683189,404016,2015-03-03,Assembly,"Do pass and be re-referred to the Committee on Appropriations",11,1,0,1,13
683189,416803,2015-03-25,Assembly,"Do pass",16,0,0,1,17
683189,429326,2015-04-09,Assembly,"AB 147 DABABNEH  Assembly Third Reading",76,1,0,3,80
683189,460637,2015-06-17,Senate,"Do pass as amended, and re-refer to the Committee on Appropriations",7,1,1,0,9
683189,473984,2015-08-20,Senate,"Assembly 3rd Reading AB147 Dababneh By Leno",36,0,4,0,40
683189,474307,2015-08-27,Assembly,"AB 147 DABABNEH  Concurrence in Senate Amendments",78,1,0,1,80
683190,440835,2015-04-28,Assembly,"Do pass as amended, to Consent Calendar",15,0,0,0,15
683190,444423,2015-05-07,Assembly,"AB 149 CHAVEZ  Consent Calendar Second Day",77,0,0,3,80
683190,458419,2015-06-09,Senate,"Do pass as amended. To Consent Calendar",9,0,0,0,9
683190,461196,2015-06-18,Senate,"Consent Calendar 2nd AB149 Ch",37,0,3,0,40
683190,461894,2015-06-22,Assembly,"AB 149 CHAVEZ  Concurrence in Senate Amendments",76,1,0,3,80
683191,415918,2015-03-24,Assembly,"Do pass and be re-referred to the Committee on Appropriations",7,0,0,0,7
683193,440880,2015-04-29,Senate,"Do pass as amended, and re-refer to the Committee on Appropriations",6,0,1,0,7
683193,463625,2015-05-18,Senate,"Placed on Appropriations Suspense file",7,0,0,0,7
683194,442213,2015-04-29,Assembly,"Do pass as amended and be re-referred to the Committee on 	Appropriations",5,0,0,2,7
683195,448403,2015-05-18,Assembly,"Do pass as amended and be re-referred to the Committee on 	Appropriations",9,0,0,0,9
683196,415375,2015-03-23,Assembly,"Be adopted and re-referred to the Committee on Appropriations with 	recommendation:  To Consent Calendar",16,0,0,0,16
683196,433912,2015-04-15,Assembly,"Be adopted, to Consent Calendar",16,0,0,1,17
683196,435360,2015-04-20,Assembly,"ACR8 WOOD  Consent Calendar Second Day  Regular Session",80,0,0,0,80
683196,462109,2015-06-23,Senate,"Be adopted, but re-refer to the Committee on Appropriations 	Recommend Consent",11,0,0,0,11
683196,465771,2015-07-09,Senate,"Consent Calendar 2nd ACR8 Wood",39,0,1,0,40
683196,466499,2015-07-16,Assembly,"ACR8 WOOD  Concurrence in Senate Amendments",79,0,0,1,80
683197,432749,2015-04-15,Senate,"Do pass as amended, and re-refer to the Committee on Appropriations",5,1,1,0,7
683197,442814,2015-05-04,Senate,"Placed on Appropriations Suspense file",7,0,0,0,7
683197,453607,2015-05-28,Senate,"Do pass as amended",5,2,0,0,7
683197,456570,2015-06-03,Senate,"Senate 3rd Reading SB122 Jackson",24,15,1,0,40
683197,463890,2015-06-29,Assembly,"Do pass and be re-referred to the Committee on Appropriations",7,1,0,1,9
683197,559226,2016-08-11,Assembly,"Do pass as amended",11,3,0,6,20
683197,560701,2016-08-23,Assembly,"SB 122 Jackson  Senate Third Reading  By THURMOND",55,18,0,7,80
683197,560908,2016-08-24,Senate,"Unfinished Business SB122 Jackson Concurrence",25,14,0,0,39
683198,437251,2015-04-22,Senate,"Do pass, but re-refer to the Committee on Health Recommend Consent",9,0,0,0,9
683198,442124,2015-04-29,Senate,"Do pass, but re-refer to the Committee on Appropriations Recommend 	Consent",9,0,0,0,9
683198,453969,2015-05-28,Senate,"Do pass",7,0,0,0,7
683198,455457,2015-06-01,Senate,"Senate 3rd Reading SB123 Liu",39,0,1,0,40
683198,462436,2015-06-23,Assembly,"Do pass and be re-referred to the Committee on Education to Consent 	Calendar",19,0,0,0,19
683198,463627,2015-05-18,Senate,"Placed on Appropriations Suspense file",7,0,0,0,7
683198,551378,2016-06-06,Assembly,"Be referred to Committee on Health",9,0,0,2,11
683198,553255,2016-06-14,Assembly,"Do pass and be re-referred to the Committee on Education",11,0,0,7,18
683198,555280,2016-06-22,Assembly,"Do pass as amended and be re-referred to the Committee on 	Appropriations",5,0,0,2,7
683198,559438,2016-08-11,Assembly,"Do pass as amended",20,0,0,0,20
683198,560840,2016-08-23,Assembly,"SB 123 Liu  Senate Third Reading  By SANTIAGO",79,0,0,1,80
683198,561342,2016-08-26,Senate,"From committee:  That the Assembly Amendments be concurred in",9,0,0,0,9
683198,561461,2016-08-29,Senate,"Unfinished Business SB123 Liu Concurrence",39,0,0,0,39
684625,417246,2015-03-25,Senate,"Do pass as amended, and re-refer to the Committee on Appropriations",8,0,1,0,9
684625,430596,2015-04-13,Senate,"Do pass",6,0,1,0,7
684625,434024,2015-04-16,Senate,"Senate 3rd Reading SB125 Hernandez Urgency Clause",38,0,1,0,39
684625,446116,2015-05-12,Assembly,"Do pass as amended and be re-referred to the Committee on 	Appropriations",19,0,0,0,19
684625,453051,2015-05-27,Assembly,"Do pass, to Consent Calendar",17,0,0,0,17
684625,456005,2015-06-02,Assembly,"SB 125 Hernandez  Consent Calendar Second Day  Regular Session",78,0,0,2,80
684625,457283,2015-06-04,Senate,"Unfinished Business SB125 Hernandez Urgency Clause",39,0,1,0,40
684626,483925,2016-01-07,Assembly,"From committee:  Be adopted.  To third reading",11,0,0,0,11
684626,489845,2016-02-01,Senate,"Assembly 3rd Reading ACR9 McCarty By Pan",38,0,2,0,40
684629,461979,2015-06-22,Senate,"Senate 3rd Reading SCR11 Fuller",37,0,3,0,40
684629,465749,2015-07-09,Assembly,"Be adopted, to Consent Calendar",11,0,0,0,11
684629,466478,2015-07-16,Assembly,"SCR 11 Fuller  Consent Calendar Second Day  Regular Session",79,0,0,1,80
684632,448472,2015-05-18,Assembly,"Do pass as amended and be re-referred to the Committee on 	Appropriations",6,0,0,3,9
684632,454141,2015-05-28,Assembly,"Do pass as amended",15,0,0,2,17
684632,456653,2015-06-03,Assembly,"AB 154 TING  Third Reading Urgency",75,0,0,5,80
684632,465613,2015-07-08,Senate,"Do pass, but re-refer to the Committee on Appropriations",6,0,1,0,7
684632,473666,2015-08-17,Senate,"Do pass",5,0,2,0,7
684632,475341,2015-08-31,Senate,"Assembly 3rd Reading AB154 Ting By Hertzberg",39,0,1,0,40
684632,475558,2015-09-02,Assembly,"AB 154 TING  Concurrence in Senate Amendments",75,0,0,5,80
684638,427763,2015-04-07,Senate,"Do pass as amended, and re-refer to the Committee on Appropriations",5,2,0,0,7
684638,445121,2015-05-11,Senate,"Placed on Appropriations Suspense file",7,0,0,0,7
684638,453772,2015-05-28,Senate,"Do pass as amended",5,2,0,0,7
684638,455916,2015-06-02,Senate,"Senate 3rd Reading SB124 Leno",26,13,1,0,40
684638,464270,2015-06-30,Assembly,"Do pass as amended and be re-referred to the Committee on 	Appropriations",5,2,0,0,7
687643,415217,2015-03-23,Assembly,"Do pass",15,0,0,1,16
687643,422204,2015-03-26,Assembly,"AB 157 LEVINE  Third Reading Urgency",75,0,0,5,80
687643,465526,2015-07-07,Senate,"Do pass, but re-refer to the Committee on Environmental Quality",11,0,0,0,11
687643,466332,2015-07-15,Senate,"Do pass",6,0,1,0,7
687643,475321,2015-08-31,Senate,"Assembly 3rd Reading AB157 Levine By McGuire",40,0,0,0,40
687643,475416,2015-09-01,Assembly,"AB 157 LEVINE  Concurrence in Senate Amendments",74,3,0,3,80
687656,431491,2015-04-13,Assembly,"Do pass as amended and be re-referred to the Committee on 	Appropriations",8,0,0,1,9
687656,453841,2015-05-28,Assembly,"Do pass as amended",17,0,0,0,17
687656,456666,2015-06-03,Assembly,"AB 156 PEREA  Assembly Third Reading",76,0,0,4,80
687656,466214,2015-07-15,Senate,"Do pass as amended, and re-refer to the Committee on Appropriations",6,1,0,0,7
687656,474084,2015-08-24,Senate,"Placed on Appropriations Suspense file",7,0,0,0,7
687656,544332,2016-05-10,Senate,"Do pass, but re-refer to the Committee on Appropriations",5,2,0,0,7
687656,545790,2016-05-16,Senate,"Placed on Appropriations Suspense file",2,4,1,0,7
687656,545791,2016-05-16,Senate,"Do pass as amended",5,2,0,0,7
687656,547036,2016-05-19,Senate,"Assembly 3rd Reading AB156 McCarty By De Le",24,15,1,0,40
687668,418661,2015-03-25,Assembly,"Do pass",7,0,0,0,7
687668,429374,2015-04-09,Assembly,"AB 158 O'DONNELL  Assembly Third Reading  By MCCARTY",77,0,0,3,80
687668,432986,2015-04-15,Senate,"Do pass, but re-refer to the Committee on Appropriations Recommend 	Consent",8,0,0,0,8
687668,438053,2015-04-23,Senate,"Assembly 3rd Reading AB158 O'Donnell By De Le",37,0,0,2,39
687675,417042,2015-03-25,Senate,"Do pass, but re-refer to the Committee on Judiciary",6,2,1,0,9
687675,428440,2015-04-07,Senate,"Do pass as amended, and re-refer to the Committee on Appropriations",5,2,0,0,7
687675,445111,2015-05-11,Senate,"Placed on Appropriations Suspense file",7,0,0,0,7
687675,454030,2015-05-28,Senate,"Do pass as amended",5,2,0,0,7
687675,457295,2015-06-04,Senate,"Senate 3rd Reading SB128 Wolk",23,15,2,0,40
687681,427843,2015-04-07,Senate,"Be adopted, but re-refer to the Committee on Appropriations 	Recommend Consent",11,0,0,0,11
687681,438158,2015-04-23,Senate,"Consent Calendar 2nd SCR12 Jackson",37,0,0,2,39
687681,461845,2015-06-22,Assembly,"Be adopted and re-referred to the Committee on Appropriations with 	recommendation:  To Consent Calendar",16,0,0,0,16
687681,465677,2015-07-08,Assembly,"Be adopted, to Consent Calendar",14,0,0,3,17
687681,465930,2015-07-13,Assembly,"SCR 12 Jackson  Consent Calendar Second Day  Regular Session",79,0,0,1,80
691063,415911,2015-03-24,Senate,"Be adopted",7,2,0,0,9
691063,429386,2015-04-09,Senate,"Senate 3rd Reading SJR3 McGuire",25,12,2,0,39
691063,461835,2015-06-22,Assembly,"From committee:  Be adopted.  To third reading",5,1,0,3,9
691063,462972,2015-06-25,Assembly,"SJR3 McGuire  Senate Third Reading  By WOOD",52,19,0,9,80
691063,464934,2015-07-02,Senate,"Unfinished Business SJR3 McGuire Concurrence",25,12,3,0,40
691066,433954,2015-04-15,Assembly,"Do pass",16,0,0,1,17
691066,435318,2015-04-20,Assembly,"AB 165 GOMEZ  Third Reading Urgency",80,0,0,0,80
691066,452024,2015-05-26,Senate,"Do pass",7,0,0,0,7
691066,457983,2015-06-08,Senate,"Assembly 3rd Reading AB165 Gomez By Lara",40,0,0,0,40
691067,427772,2015-04-07,Assembly,"Do pass as amended and be re-referred to the Committee on Revenue 	and Taxation",7,0,0,0,7
691067,439964,2015-04-27,Assembly,"Do pass as amended and be re-referred to the Committee on 	Appropriations",9,0,0,0,9
691067,448966,2015-05-20,Assembly,"Do pass",15,0,0,2,17
691067,453937,2015-05-28,Assembly,"AB 160 DABABNEH  Assembly Third Reading",77,0,0,3,80
691067,464296,2015-06-30,Senate,"Do pass, but re-refer to the Committee on Governance and Finance",7,0,0,0,7
691067,466310,2015-07-15,Senate,"Do pass, but re-refer to the Committee on Appropriations",6,0,1,0,7
691067,475368,2015-08-31,Senate,"Assembly 3rd Reading AB160 Dababneh By Wieckowski",40,0,0,0,40
691067,475615,2015-09-02,Assembly,"AB 160 DABABNEH  Concurrence in Senate Amendments",79,0,0,1,80
691069,442295,2015-04-30,Assembly,"From committee:  Be adopted.  To third reading",10,0,0,1,11
691069,459524,2015-06-11,Senate,"Assembly 3rd Reading ACR10 Rodriguez By Hall",37,0,3,0,40
691070,432566,2015-04-14,Assembly,"Do pass, to Consent Calendar",14,0,0,0,14
691070,435157,2015-04-20,Assembly,"AB 161 CHAU  Consent Calendar Second Day  Regular Session",80,0,0,0,80
691070,457924,2015-06-08,Senate,"Do pass",9,0,0,0,9
691070,475715,2015-09-03,Senate,"Assembly 3rd Reading AB161 Chau By Hernandez",40,0,0,0,40
691070,475831,2015-09-04,Assembly,"AB 161 CHAU  Concurrence in Senate Amendments",80,0,0,0,80
691072,418786,2015-03-25,Assembly,"Do pass and be re-referred to the Committee on Appropriations to 	Consent Calendar",6,0,0,1,7
691072,434016,2015-04-15,Assembly,"Do pass, to Consent Calendar",16,0,0,1,17
691072,438411,2015-04-23,Assembly,"AB 163 WILLIAMS  Consent Calendar Second Day  Regular Session",78,0,0,2,80
691072,458634,2015-06-10,Senate,"Do pass, but re-refer to the Committee on Appropriations Recommend 	Consent",8,0,0,1,9
691072,463020,2015-06-25,Senate,"Consent Calendar 2nd AB163 Williams",37,0,3,0,40
691073,427783,2015-04-06,Assembly,"Do pass and be re-referred to the Committee on Appropriations to 	Consent Calendar",15,0,0,1,16
691073,437164,2015-04-22,Assembly,"Do pass, to Consent Calendar",17,0,0,0,17
691073,442142,2015-04-30,Assembly,"AB 162 RODRIGUEZ  Consent Calendar Second Day",77,0,0,3,80
691073,458816,2015-06-09,Senate,"Do pass, but re-refer to the Committee on Appropriations",11,0,0,0,11
691073,463036,2015-06-25,Senate,"Assembly 3rd Reading AB162 Rodriguez By Pan",38,0,2,0,40
691073,463951,2015-06-29,Assembly,"AB 162 RODRIGUEZ  Concurrence- Urgency Added",77,0,0,3,80
691075,427851,2015-04-07,Assembly,"Do pass as amended and be re-referred to the Committee on Business 	and Professions",17,0,0,2,19
691075,436025,2015-04-21,Assembly,"Do pass as amended and be re-referred to the Committee on 	Appropriations",14,0,0,0,14
691075,446229,2015-05-13,Assembly,"Do pass",15,0,0,2,17
691075,447702,2015-05-18,Assembly,"AB 159 CALDERON  Assembly Third Reading",74,2,0,4,80
691075,458548,2015-06-10,Senate,"Do pass as amended, and re-refer to the Committee on Business, 	Professions and Economic Development",8,0,0,1,9
691075,464320,2015-06-29,Senate,"Do pass, but re-refer to the Committee on Appropriations",8,0,1,0,9
691075,465860,2015-07-13,Senate,"Placed on Appropriations Suspense file",7,0,0,0,7
691075,474504,2015-08-27,Senate,"Do pass",7,0,0,0,7
691075,475473,2015-09-01,Senate,"Assembly 3rd Reading AB159 Calderon By Stone",40,0,0,0,40
691075,475634,2015-09-02,Assembly,"AB 159 CALDERON  Concurrence in Senate Amendments",76,2,0,2,80
691076,473866,2015-08-19,Assembly,"Do pass",17,0,0,0,17
691076,474154,2015-08-24,Assembly,"AB 164 GOMEZ  Third Reading Urgency",80,0,0,0,80
691076,475902,2015-09-04,Senate,"Do pass",7,0,0,0,7
691076,476184,2015-09-09,Senate,"Assembly 3rd Reading AB164 Gomez By Lara",40,0,0,0,40
691076,476367,2015-09-10,Assembly,"AB 164 GOMEZ  Concurrence in Senate Amendments",80,0,0,0,80
694514,414935,2015-03-23,Assembly,"Do pass",16,0,0,0,16
694514,427246,2015-04-06,Assembly,"AB 173 HOLDEN  Assembly Third Reading",78,0,0,2,80
694514,458778,2015-06-09,Senate,"Do pass",10,0,1,0,11
694514,461799,2015-06-22,Senate,"Special Consent #3 AB173 Holden By Liu",37,0,3,0,40
694533,390768,2015-02-05,Senate,"Senate 3rd Reading SCR13 Jackson",34,0,3,0,37
694533,417877,2015-03-26,Assembly,"Be adopted, to Consent Calendar",11,0,0,0,11
694533,429496,2015-04-09,Assembly,"SCR 13 Jackson  Consent Calendar Second Day  Regular Session",78,0,0,2,80
694540,416544,2015-03-24,Senate,"Do pass, but re-refer to the Committee on Health",10,0,1,0,11
694540,444436,2015-05-07,Senate,"Senate 3rd Reading SB133 McGuire",36,0,3,0,39
694540,465640,2015-07-08,Assembly,"Do pass and be re-referred to the Committee on Appropriations to 	Consent Calendar",20,0,0,1,21
694540,553657,2016-06-16,Assembly,"Be referred to Committee on Local Government",10,0,0,1,11
694546,443876,2015-05-05,Senate,"Do pass as amended",7,0,0,0,7
694546,451378,2015-05-26,Senate,"Placed on Appropriations Suspense file",7,0,0,0,7
694546,453618,2015-05-28,Senate,"Do pass as amended",7,0,0,0,7
694546,456717,2015-06-03,Senate,"Senate 3rd Reading SB134 Hertzberg",37,0,3,0,40
694546,465465,2015-07-07,Assembly,"Do pass and be re-referred to the Committee on Appropriations",9,1,0,0,10
694546,474220,2015-08-26,Assembly,"Do pass",17,0,0,0,17
694546,475935,2015-09-08,Assembly,"SB 134 Hertzberg  Senate Third Reading  By ALEJO",65,13,0,2,80
694546,476270,2015-09-10,Senate,"Unfinished Business SB134 Hertzberg Concurrence",39,0,1,0,40
694559,393066,2015-02-09,Assembly,"From committee:  Be adopted.  To third reading",10,0,0,1,11
694559,410450,2015-03-12,Senate,"Assembly 3rd Reading ACR11 Lackey By Bates",35,0,2,0,37
694571,484823,2016-01-12,Assembly,"Do pass and be re-referred to the Committee on Appropriations",19,0,0,0,19
694571,486331,2016-01-21,Assembly,"Do pass, to Consent Calendar",17,0,0,0,17
694571,488345,2016-01-27,Assembly,"AB 168 MAIENSCHEIN  Consent Calendar Second Day  Regular Session",78,0,0,1,79
694571,556768,2016-06-29,Senate,"Do pass, but re-refer to the Committee on Appropriations Recommend 	Consent",8,0,1,0,9
694571,560482,2016-08-22,Senate,"Assembly 3rd Reading AB168 Maienschein By Beall",39,0,0,0,39
694571,561212,2016-08-25,Assembly,"AB 168 MAIENSCHEIN  Concurrence in Senate Amendments",79,0,0,1,80
694577,432630,2015-04-15,Assembly,"Do pass and be re-referred to the Committee on Appropriations",9,0,0,0,9
694577,441790,2015-04-29,Assembly,"Do pass, to Consent Calendar",17,0,0,0,17
694577,444365,2015-05-07,Assembly,"AB 169 MAIENSCHEIN  Consent Calendar Second Day  Regular Session",77,0,0,3,80
694577,464690,2015-06-30,Senate,"Do pass, but re-refer to the Committee on Appropriations",7,0,0,0,7
694577,474170,2015-08-24,Senate,"Assembly 3rd Reading AB169 Maienschein By Hertzberg",40,0,0,0,40
694577,475327,2015-08-31,Assembly,"AB 169 MAIENSCHEIN  Concurrence in Senate Amendments",80,0,0,0,80
694585,409611,2015-03-10,Assembly,"Do pass as amended and be re-referred to the Committee on 	Appropriations",9,0,0,0,9
694585,454279,2015-05-28,Assembly,"Do pass as amended",17,0,0,0,17
694585,456115,2015-06-02,Assembly,"AB 171 IRWIN  Third Reading Urgency",78,0,0,2,80
694585,462121,2015-06-23,Senate,"Do pass, but re-refer to the Committee on Appropriations",5,0,0,0,5
694585,465939,2015-07-13,Senate,"Placed on Appropriations Suspense file",7,0,0,0,7
694585,474697,2015-08-27,Senate,"Do pass as amended",5,0,2,0,7
694598,404310,2015-03-03,Assembly,"Do pass and be re-referred to the Committee on Appropriations",12,1,0,0,13
694598,454453,2015-05-28,Assembly,"Do pass as amended",16,1,0,0,17
694598,456586,2015-06-03,Assembly,"AB 174 GRAY  Assembly Third Reading",72,2,0,6,80
694598,473694,2015-08-17,Senate,"Placed on Appropriations Suspense file",7,0,0,0,7
694603,437273,2015-04-22,Senate,"Do pass as amended, and re-refer to the Committee on Appropriations",9,0,0,0,9
694603,463700,2015-05-18,Senate,"Placed on Appropriations Suspense file",7,0,0,0,7
694611,416946,2015-03-25,Assembly,"Do pass and be re-referred to the Committee on Arts, Entertain, 	Sports, Tourism, & Internet Media",9,0,0,0,9
694611,427801,2015-04-07,Assembly,"Do pass and be re-referred to the Committee on Appropriations",6,0,0,1,7
694611,437312,2015-04-22,Assembly,"Do pass, to Consent Calendar",17,0,0,0,17
694611,442298,2015-04-30,Assembly,"AB 166 GAINES  Consent Calendar Second Day  Regular Session",77,0,0,3,80
694611,458465,2015-06-09,Senate,"Do pass, but re-refer to the Committee on Appropriations",13,0,0,0,13
694611,465743,2015-07-09,Senate,"Assembly 3rd Reading AB166 Beth Gaines By Gaines",39,0,1,0,40
694618,412436,2015-03-17,Assembly,"Do pass as amended and be re-referred to the Committee on Health",9,2,0,0,11
694618,441125,2015-04-28,Assembly,"Do pass as amended and be re-referred to the Committee on 	Appropriations",17,0,0,2,19
694618,453823,2015-05-28,Assembly,"Do pass as amended",17,0,0,0,17
694618,456576,2015-06-03,Assembly,"AB 170 GATTO  Assembly Third Reading",66,11,0,3,80
694624,412437,2015-03-17,Assembly,"Do pass and be re-referred to the Committee on Appropriations",6,0,0,1,7
694624,453789,2015-05-28,Assembly,"Do pass as amended",17,0,0,0,17
694624,455884,2015-06-02,Assembly,"AB 172 RODRIGUEZ  Assembly Third Reading",78,0,0,2,80
694624,465357,2015-07-07,Senate,"Do pass, but re-refer to the Committee on Appropriations",6,0,1,0,7
694624,473679,2015-08-17,Senate,"Placed on Appropriations Suspense file",7,0,0,0,7
694624,474615,2015-08-27,Senate,"Do pass",7,0,0,0,7
694624,475980,2015-09-08,Senate,"Assembly 3rd Reading AB172 Rodriguez By Mendoza",40,0,0,0,40
694624,476059,2015-09-09,Assembly,"AB 172 RODRIGUEZ  Concurrence in Senate Amendments",78,0,0,2,80
700066,416112,2015-03-24,Senate,"Do pass, but re-refer to the Committee on Rules Recommend Consent",9,0,0,0,9
700066,450229,2015-05-22,Senate,"Consent Calendar 2nd SB141 McGuire",38,0,1,0,39
700066,464717,2015-07-01,Assembly,"Do pass and be re-referred to the Committee on Appropriations",7,1,0,1,9
700066,466434,2015-07-15,Assembly,"Do pass",11,5,0,1,17
700066,473649,2015-08-17,Assembly,"SB 141 McGuire  Senate Third Reading  By WOOD",54,25,0,1,80
700066,473950,2015-08-20,Senate,"Unfinished Business SB141 McGuire Concurrence",27,11,2,0,40
700069,440268,2015-04-28,Assembly,"Do pass as amended and be re-referred to the Committee on 	Appropriations",14,0,0,0,14
700069,454175,2015-05-28,Assembly,"Do pass",17,0,0,0,17
700069,455331,2015-06-01,Assembly,"AB 179 BONILLA  Assembly Third Reading",60,17,0,3,80
700069,465429,2015-07-06,Senate,"Do pass, but re-refer to the Committee on Appropriations",7,1,1,0,9
700069,473618,2015-08-17,Senate,"Placed on Appropriations Suspense file",7,0,0,0,7
700069,474685,2015-08-27,Senate,"Do pass as amended",6,1,0,0,7
700069,476430,2015-09-10,Senate,"Assembly 3rd Reading AB179 Bonilla By Hill",32,5,3,0,40
700069,476601,2015-09-11,Assembly,"AB 179 BONILLA  Concurrence in Senate Amendments",66,11,0,3,80
700071,466236,2015-07-14,Senate,"Do pass as amended, and re-refer to the Committee on Appropriations",7,0,0,0,7
700071,475402,2015-09-01,Senate,"Senate 3rd Reading SB139 Galgiani Urgency Clause",40,0,0,0,40
700071,555984,2016-06-28,Assembly,"Do pass and be re-referred to the Committee on Appropriations",6,0,0,1,7
700071,559028,2016-08-03,Assembly,"Do pass",20,0,0,0,20
700071,560481,2016-08-22,Assembly,"SB 139 Galgiani  Third Reading Urgency  By JONES-SAWYER",77,0,0,3,80
700071,561697,2016-08-31,Senate,"Unfinished Business SB139 Galgiani Urgency Clause Concurr",39,0,0,0,39
700075,388603,2015-02-02,Assembly,"From committee:  Be adopted.  To third reading",11,0,0,0,11
700075,466073,2015-07-14,Senate,"Be adopted, but re-refer to the Committee on Appropriations 	Recommend Consent",11,0,0,0,11
700075,474004,2015-08-20,Senate,"Consent Calendar 2nd ACR12 O'Donnell",38,0,2,0,40
700075,474365,2015-08-27,Assembly,"ACR 12 O'DONNELL  Concurrence in Senate Amendments",77,0,0,3,80
700079,440235,2015-04-28,Assembly,"Do pass and be re-referred to the Committee on Appropriations to 	Consent Calendar",14,0,0,0,14
700079,454118,2015-05-28,Assembly,"Do pass",17,0,0,0,17
700079,455333,2015-06-01,Assembly,"AB 180 BONILLA  Assembly Third Reading",80,0,0,0,80
700079,465408,2015-07-06,Senate,"Do pass, but re-refer to the Committee on Appropriations",9,0,0,0,9
700079,473647,2015-08-17,Senate,"Do pass",7,0,0,0,7
700079,476175,2015-09-09,Senate,"Assembly 3rd Reading AB180 Bonilla By Hill",40,0,0,0,40
700079,476343,2015-09-10,Assembly,"AB 180 BONILLA  Concurrence in Senate Amendments",80,0,0,0,80
700081,387723,2015-01-29,Senate,"W/O REF. TO FILE SR10 Stone",35,0,2,0,37
700084,416972,2015-03-25,Senate,"Do pass",6,0,2,0,8
700084,427298,2015-04-06,Senate,"Senate 3rd Reading SB138 Fuller",36,0,3,0,39
700084,464919,2015-07-01,Assembly,"Do pass",2,4,0,1,7
700084,464920,2015-07-01,Assembly,"Reconsideration granted",6,0,0,1,7
700088,441110,2015-04-29,Assembly,"Do pass and be re-referred to the Committee on Revenue and Taxation",8,0,0,1,9
700088,448406,2015-05-18,Assembly,"Do pass as amended and be re-referred to the Committee on 	Appropriations",9,0,0,0,9
700090,439973,2015-04-28,Assembly,"Do pass and be re-referred to the Committee on Appropriations to 	Consent Calendar",14,0,0,0,14
700090,454132,2015-05-28,Assembly,"Do pass",17,0,0,0,17
700090,455472,2015-06-01,Assembly,"AB 181 BONILLA  Assembly Third Reading",79,0,0,1,80
700090,465423,2015-07-06,Senate,"Do pass, but re-refer to the Committee on Appropriations",9,0,0,0,9
700090,473641,2015-08-17,Senate,"Placed on Appropriations Suspense file",7,0,0,0,7
700090,474567,2015-08-27,Senate,"Do pass as amended",7,0,0,0,7
700090,476195,2015-09-09,Senate,"Assembly 3rd Reading AB181 Bonilla By Hill",40,0,0,0,40
700090,476242,2015-09-10,Assembly,"AB 181 BONILLA  Concurrence in Senate Amendments",78,0,0,2,80
700094,428478,2015-04-07,Assembly,"Do pass and be re-referred to the Committee on Health",12,1,0,0,13
700094,437047,2015-04-21,Assembly,"Do pass and be re-referred to the Committee on Appropriations",18,0,0,1,19
700094,453975,2015-05-28,Assembly,"Do pass as amended",17,0,0,0,17
700094,455965,2015-06-02,Assembly,"AB 176 BONTA  Assembly Third Reading",77,1,0,2,80
700094,462638,2015-06-24,Senate,"Do pass as amended, and re-refer to the Committee on Health",9,0,0,0,9
700094,465801,2015-07-08,Senate,"Do pass as amended, and re-refer to the Committee on Appropriations",8,0,1,0,9
700094,473569,2015-08-17,Senate,"Placed on Appropriations Suspense file",7,0,0,0,7
700094,474495,2015-08-27,Senate,"Do pass as amended",7,0,0,0,7
700094,475593,2015-09-02,Senate,"Assembly 3rd Reading AB176 Bonta By Lara",40,0,0,0,40
700094,475950,2015-09-08,Assembly,"AB 176 BONTA  Concurrence in Senate Amendments",77,1,0,2,80
700097,428759,2015-04-07,Senate,"Do pass as amended",5,1,1,0,7
700097,442808,2015-05-04,Senate,"Senate 3rd Reading SB142 Jackson",24,9,6,0,39
700097,465354,2015-07-07,Assembly,"Do pass and be re-referred to the Committee on Judiciary",11,0,0,0,11
700097,473549,2015-07-14,Assembly,"Do pass",9,1,0,0,10
700097,474104,2015-08-24,Assembly,"SB 142 Jackson  Senate Third Reading  By GATTO",56,13,0,11,80
700097,474320,2015-08-27,Senate,"Unfinished Business SB142 Jackson Concurrence",21,12,7,0,40
700100,440451,2015-04-28,Assembly,"Do pass and be re-referred to the Committee on Appropriations to 	Consent Calendar",14,0,0,0,14
700100,454146,2015-05-28,Assembly,"Do pass",17,0,0,0,17
700100,455477,2015-06-01,Assembly,"AB 177 BONILLA  Assembly Third Reading",80,0,0,0,80
700100,465418,2015-07-06,Senate,"Do pass, but re-refer to the Committee on Appropriations",9,0,0,0,9
700100,473722,2015-08-17,Senate,"Placed on Appropriations Suspense file",7,0,0,0,7
700100,474602,2015-08-27,Senate,"Do pass as amended",7,0,0,0,7
700100,476169,2015-09-09,Senate,"Assembly 3rd Reading AB177 Bonilla By Hill",40,0,0,0,40
700100,476256,2015-09-10,Assembly,"AB 177 BONILLA  Concurrence in Senate Amendments",80,0,0,0,80
700103,429276,2015-04-08,Senate,"Do pass as amended, and re-refer to the Committee on Appropriations",6,1,2,0,9
700103,453801,2015-05-28,Senate,"Do pass as amended",5,2,0,0,7
700103,456048,2015-06-02,Senate,"Senate 3rd Reading SB140 Leno",25,12,3,0,40
700106,437556,2015-04-22,Assembly,"Do pass and be re-referred to the Committee on Appropriations",7,0,0,0,7
700106,454473,2015-05-28,Assembly,"Do pass",17,0,0,0,17
700106,455551,2015-06-01,Assembly,"AB 186 RENDON  Third Reading Urgency",77,0,0,3,80
700113,440034,2015-04-28,Assembly,"Do pass as amended and be re-referred to the Committee on 	Appropriations",14,0,0,0,14
700113,453837,2015-05-28,Assembly,"Do pass",17,0,0,0,17
700113,455307,2015-06-01,Assembly,"AB 178 BONILLA  Third Reading Urgency",80,0,0,0,80
700113,464373,2015-06-29,Senate,"Do pass, but re-refer to the Committee on Appropriations",7,0,2,0,9
700113,465842,2015-07-13,Senate,"Placed on Appropriations Suspense file",7,0,0,0,7
700113,474558,2015-08-27,Senate,"Do pass as amended",7,0,0,0,7
700113,475587,2015-09-02,Senate,"Assembly 3rd Reading AB178 Bonilla By Hill",38,1,1,0,40
700113,475761,2015-09-03,Assembly,"AB 178 BONILLA  Concurrence in Senate Amendments",79,0,0,1,80
700116,433806,2015-04-15,Senate,"Do pass as amended, and re-refer to the Committee on Appropriations",8,0,1,0,9
700116,442876,2015-05-04,Senate,"Placed on Appropriations Suspense file",7,0,0,0,7
700116,453850,2015-05-28,Senate,"Do pass as amended",6,0,1,0,7
700116,456687,2015-06-03,Senate,"Senate 3rd Reading SB137 Hernandez",35,0,5,0,40
700116,466017,2015-07-14,Assembly,"Do pass as amended and be re-referred to the Committee on 	Appropriations",17,2,0,0,19
700116,474289,2015-08-27,Assembly,"Do pass as amended",12,2,0,3,17
700116,476235,2015-09-10,Assembly,"SB 137 Hernandez  Senate Third Reading  By WOOD",69,9,0,2,80
700116,476519,2015-09-11,Senate,"Unfinished Business SB137 Hernandez Concurrence",38,2,0,0,40
700118,436551,2015-04-21,Assembly,"Do pass as amended and be re-referred to the Committee on 	Appropriations",9,0,0,0,9
700121,441636,2015-04-29,Assembly,"Do pass and be re-referred to the Committee on Judiciary",5,2,0,0,7
700121,443455,2015-05-05,Assembly,"Do pass",7,3,0,0,10
700121,445193,2015-05-11,Assembly,"AB 182 ALEJO  Assembly Third Reading",53,25,0,2,80
700121,460406,2015-06-16,Senate,"Do pass as amended",4,1,0,0,5
700121,475787,2015-09-03,Senate,"Assembly 3rd Reading AB182 Alejo By Hueso",26,14,0,0,40
700121,475951,2015-09-08,Assembly,"AB 182 ALEJO  Concurrence in Senate Amendments",53,24,0,3,80
701362,437396,2015-04-22,Senate,"Do pass, but re-refer to the Committee on Judiciary",5,2,2,0,9
701362,440048,2015-04-28,Senate,"Do pass as amended, and re-refer to the Committee on Appropriations",4,1,2,0,7
701362,451921,2015-05-26,Senate,"Senate 3rd Reading SB145 Pan",21,15,3,0,39
701362,462190,2015-06-23,Assembly,"Do pass and be re-referred to the Committee on Judiciary",13,5,0,1,19
701362,466042,2015-07-14,Assembly,"Do pass and be re-referred to the Committee on Appropriations",8,2,0,0,10
701362,474232,2015-08-26,Assembly,"Do pass",12,5,0,0,17
701362,475366,2015-08-31,Assembly,"SB 145 Pan  Senate Third Reading  By BONTA  Amend By BONTA  Set #1",52,27,0,1,80
701362,476192,2015-09-09,Assembly,"Do pass as amended and be re-referred to the Committee on 	Appropriations",12,4,0,3,19
701362,476567,2015-09-11,Assembly,"Do pass",11,5,0,1,17
701362,476568,2015-09-11,Assembly,"SB 145 Pan  Senate Third Reading  By BONTA",51,28,0,1,80
701362,476569,2015-09-11,Senate,"Unfinished Business (S upplemental File 4)SB1 45 Pan Con",26,14,0,0,40
701362,485439,2015-09-11,Senate,"From committee:  That the Assembly Amendments be concurred in",7,2,0,0,9
701373,392232,2015-02-09,Senate,"Senate 3rd Reading SR11 Hall",35,0,2,0,37
701383,431533,2015-04-13,Assembly,"Do pass and be re-referred to the Committee on Appropriations",3,6,0,0,9
701383,463599,2015-04-13,Assembly,"Reconsideration granted",9,0,0,0,9
701394,403325,2015-03-02,Senate,"Senate 3rd Reading SCR14 Fuller",32,0,5,0,37
701394,415237,2015-03-23,Assembly,"Be adopted, to Consent Calendar",11,0,0,0,11
701394,418768,2015-03-26,Assembly,"SCR 14 Fuller  Consent Calendar Second Day",76,0,0,4,80
701404,416043,2015-03-24,Assembly,"Do pass and be re-referred to the Committee on Appropriations",6,0,0,1,7
701414,428043,2015-04-07,Assembly,"Do pass and be re-referred to the Committee on Appropriations",16,0,0,3,19
701414,453734,2015-05-28,Assembly,"Do pass as amended",17,0,0,0,17
701414,456042,2015-06-02,Assembly,"AB 187 BONTA  Assembly Third Reading",78,0,0,2,80
701414,465823,2015-07-08,Senate,"Do pass, but re-refer to the Committee on Appropriations",8,0,1,0,9
701414,473780,2015-08-17,Senate,"Placed on Appropriations Suspense file",7,0,0,0,7
701414,474714,2015-08-27,Senate,"Do pass",7,0,0,0,7
701414,475742,2015-09-03,Senate,"Assembly 3rd Reading AB187 Bonta By Hernandez",40,0,0,0,40
701433,431517,2015-04-13,Assembly,"Do pass and be re-referred to the Committee on Appropriations",2,7,0,0,9
701433,463582,2015-04-13,Assembly,"Reconsideration granted",9,0,0,0,9
701442,427835,2015-04-07,Assembly,"Do pass and be re-referred to the Committee on Local Government",6,0,0,1,7
701442,432610,2015-04-15,Assembly,"Do pass and be re-referred to the Committee on Appropriations",9,0,0,0,9
701442,441054,2015-04-29,Assembly,"Do pass, to Consent Calendar",17,0,0,0,17
701442,444420,2015-05-07,Assembly,"AB 189 BLOOM  Consent Calendar Second Day  Regular Session",77,0,0,3,80
701442,475590,2015-09-02,Senate,"Assembly 3rd Reading AB189 Bloom By Allen",31,9,0,0,40
701442,475977,2015-09-08,Assembly,"AB 189 BLOOM  Concurrence in Senate Amendments",79,0,0,1,80
701452,416092,2015-03-24,Senate,"Do pass, but re-refer to the Committee on Appropriations Recommend 	Consent",9,0,0,0,9
701452,430678,2015-04-13,Senate,"Placed on Appropriations Suspense file",7,0,0,0,7
701452,453687,2015-05-28,Senate,"Do pass",7,0,0,0,7
701452,455383,2015-06-01,Senate,"Senate 3rd Reading SB144 Pan",40,0,0,0,40
701452,464461,2015-06-30,Assembly,"Do pass and be re-referred to the Committee on Appropriations to 	Consent Calendar",15,0,0,0,15
701452,474267,2015-08-27,Assembly,"Do pass",17,0,0,0,17
701452,475793,2015-09-03,Assembly,"SB 144 Pan  Senate Third Reading  By GALLAGHER",80,0,0,0,80
704218,415112,2015-03-23,Assembly,"Do pass",15,0,0,1,16
704218,422008,2015-03-26,Assembly,"AB 198 FRAZIER  Assembly Third Reading",75,0,0,5,80
704218,458810,2015-06-09,Senate,"Do pass and be placed on the Consent Calendar",11,0,0,0,11
704218,461135,2015-06-18,Senate,"Consent Calendar 2nd AB198 Frazier",37,0,3,0,40
704218,461813,2015-06-22,Assembly,"AB 198 FRAZIER  Concurrence in Senate Amendments",78,0,0,2,80
704224,433945,2015-04-15,Senate,"Do pass as amended, and re-refer to the Committee on Appropriations",9,0,0,0,9
704224,442826,2015-05-04,Senate,"Placed on Appropriations Suspense file",7,0,0,0,7
704224,453774,2015-05-28,Senate,"Do pass",7,0,0,0,7
704224,455253,2015-06-01,Senate,"Senate 3rd Reading SB147 Hernandez",40,0,0,0,40
704224,466019,2015-07-14,Assembly,"Do pass and be re-referred to the Committee on Appropriations",18,0,0,1,19
704224,474411,2015-08-27,Assembly,"Do pass as amended",17,0,0,0,17
704224,475651,2015-09-02,Assembly,"SB 147 Hernandez  Senate Third Reading  By WOOD",80,0,0,0,80
704224,476408,2015-09-10,Senate,"Unfinished Business SB147 Hernandez Concurrence",39,0,1,0,40
704229,440163,2015-04-27,Assembly,"Do pass and be re-referred to the Committee on Appropriations to 	Consent Calendar",16,0,0,0,16
704229,454243,2015-05-28,Assembly,"Do pass as amended",17,0,0,0,17
704229,455970,2015-06-02,Assembly,"AB 192 ALLEN  Assembly Third Reading",71,4,0,5,80
704229,466036,2015-07-14,Senate,"Do pass as amended, but re-refer to the Committee on Appropriations 	Recommend Consent",11,0,0,0,11
704229,473801,2015-08-17,Senate,"Placed on Appropriations Suspense file",7,0,0,0,7
704229,474686,2015-08-27,Senate,"Do pass as amended",7,0,0,0,7
704229,476077,2015-09-09,Senate,"Assembly 3rd Reading AB192 Travis Allen By Bates",40,0,0,0,40
704229,476429,2015-09-10,Assembly,"AB 192 ALLEN  Concurrence in Senate Amendments",78,0,0,2,80
704235,464987,2015-07-02,Senate,"Senate 3rd Reading SCR15 Fuller",38,0,2,0,40
704235,466115,2015-07-13,Assembly,"From committee:  Be adopted.  To third reading",10,0,0,1,11
704235,476017,2015-09-08,Senate,"Unfinished Business SCR15 Fuller Concurrence",40,0,0,0,40
704240,432876,2015-04-13,Assembly,"Do pass and be re-referred to the Committee on Appropriations",14,1,0,1,16
704240,454208,2015-05-28,Assembly,"Do pass as amended",11,3,0,3,17
704240,456657,2015-06-03,Assembly,"AB 194 FRAZIER  Assembly Third Reading",62,17,0,1,80
704240,466181,2015-07-14,Senate,"Do pass, but re-refer to the Committee on Appropriations",10,0,1,0,11
704240,473734,2015-08-17,Senate,"Placed on Appropriations Suspense file",7,0,0,0,7
704240,474538,2015-08-27,Senate,"Do pass as amended",5,1,1,0,7
704240,476376,2015-09-10,Senate,"Assembly 3rd Reading AB194 Frazier By Beall",27,10,3,0,40
704240,476566,2015-09-11,Assembly,"AB 194 FRAZIER  Concurrence in Senate Amendments",58,20,0,2,80
704251,429450,2015-04-09,Senate,"Consent Calendar 2nd SB146 Galgiani Urgency Clause",38,0,1,0,39
704251,446649,2015-04-06,Senate,"Do pass and be placed on the Consent Calendar",9,0,0,0,9
704251,462180,2015-06-23,Assembly,"Do pass, to Consent Calendar",14,0,0,0,14
704251,463923,2015-06-29,Assembly,"SB 146 Galgiani  Consent Calendar Second Day  Regular Session",76,0,0,4,80
704251,465213,2015-07-06,Senate,"Special Consent #4 SB146 Galgiani Urgency Clause",39,0,1,0,40
704256,427746,2015-04-07,Assembly,"Do pass as amended and be re-referred to the Committee on Judiciary",16,0,0,3,19
704256,435970,2015-04-21,Assembly,"Do pass and be re-referred to the Committee on Appropriations",10,0,0,0,10
704256,453886,2015-05-28,Assembly,"Do pass as amended",17,0,0,0,17
704256,456028,2015-06-02,Assembly,"AB 193 MAIENSCHEIN  Assembly Third Reading",77,0,0,3,80
704256,464748,2015-06-30,Senate,"Do pass as amended, and re-refer to the Committee on Appropriations",7,0,0,0,7
704256,473697,2015-08-17,Senate,"Placed on Appropriations Suspense file",7,0,0,0,7
704256,474499,2015-08-27,Senate,"Do pass",7,0,0,0,7
704256,476008,2015-09-08,Senate,"Assembly 3rd Reading AB193 Maienschein By Hertzberg",39,0,1,0,40
704256,476083,2015-09-09,Assembly,"AB 193 MAIENSCHEIN  Concurrence in Senate Amendments",79,0,0,1,80
704262,436160,2015-04-20,Assembly,"Do pass and be re-referred to the Committee on Natural Resources",10,3,0,2,15
704262,440262,2015-04-27,Assembly,"Do pass as amended and be re-referred to the Committee on 	Appropriations",6,2,0,1,9
704262,454043,2015-05-28,Assembly,"Do pass",12,4,0,1,17
704262,455912,2015-06-02,Assembly,"AB 197 GARCIA, E.  Assembly Third Reading",55,21,0,4,80
704262,464265,2015-06-30,Senate,"Do pass, but re-refer to the Committee on Appropriations",7,1,3,0,11
704262,465839,2015-07-13,Senate,"Placed on Appropriations Suspense file",7,0,0,0,7
704262,556295,2016-06-29,Senate,"Do pass as amended, and re-refer to the Committee on Appropriations",5,2,0,0,7
704262,559530,2016-08-11,Senate,"Do pass",5,2,0,0,7
704262,560533,2016-08-22,Senate,"Assembly 2nd Reading AB197 Eduardo Garcia By Pavley",23,13,3,0,39
704262,560983,2016-08-24,Assembly,"Senate amendments be concurred in",6,1,0,2,9
704262,560984,2016-08-24,Assembly,"AB 197 GARCIA, E.  Concurrence in Senate Amendments",45,30,0,5,80
704267,412619,2015-03-17,Assembly,"Do pass and be re-referred to the Committee on Privacy and Consumer 	Protection",6,0,0,1,7
704267,427891,2015-04-07,Assembly,"Do pass and be re-referred to the Committee on Appropriations",10,0,0,1,11
704267,433909,2015-04-15,Assembly,"Do pass, to Consent Calendar",16,0,0,1,17
704267,437956,2015-04-23,Assembly,"AB 195 CHAU  Assembly Third Reading",75,0,0,5,80
704267,458409,2015-06-09,Senate,"Do pass, but re-refer to the Committee on Appropriations",7,0,0,0,7
704267,475901,2015-09-04,Senate,"Assembly 3rd Reading AB195 Chau By Hancock",39,0,1,0,40
704267,475910,2015-09-08,Assembly,"AB 195 CHAU  Concurrence in Senate Amendments",79,0,0,1,80
706088,428327,2015-04-08,Assembly,"Do pass and be re-referred to the Committee on Housing and 	Community Development",9,0,0,0,9
706088,440893,2015-04-29,Assembly,"Do pass",6,0,0,1,7
706088,442858,2015-05-04,Assembly,"AB 204 O'DONNELL  Assembly Third Reading",78,0,0,2,80
706088,458597,2015-06-10,Senate,"Do pass as amended",6,0,0,1,7
706091,437103,2015-04-22,Senate,"Do pass, but re-refer to the Committee on Business, Professions and 	Economic Development",7,0,2,0,9
706091,440162,2015-04-27,Senate,"Do pass as amended, and re-refer to the Committee on Appropriations",9,0,0,0,9
706091,453989,2015-05-28,Senate,"Do pass",7,0,0,0,7
706091,456056,2015-06-02,Senate,"Senate 3rd Reading SB149 Stone",39,0,1,0,40
706091,463673,2015-05-18,Senate,"Placed on Appropriations Suspense file",7,0,0,0,7
706091,464895,2015-06-30,Assembly,"Do pass and be re-referred to the Committee on Business and 	Professions",17,0,0,2,19
706095,428360,2015-04-07,Assembly,"Do pass as amended and be re-referred to the Committee on 	Appropriations",9,2,0,2,13
706102,440106,2015-04-27,Assembly,"Do pass, to Consent Calendar",16,0,0,0,16
706102,442887,2015-05-04,Assembly,"AB 208 BIGELOW  Consent Calendar Second Day  Regular Session",78,0,0,2,80
706102,465348,2015-07-07,Senate,"Do pass as amended. To Consent Calendar",11,0,0,0,11
706102,466522,2015-07-16,Senate,"Consent Calendar 2nd AB208 Bigelow",38,0,2,0,40
706102,473689,2015-08-17,Assembly,"AB 208 BIGELOW  Concurrence in Senate Amendments",77,0,0,3,80
706106,416793,2015-03-25,Senate,"Do pass as amended, and re-refer to the Committee on Appropriations",8,0,0,0,8
706106,454092,2015-05-28,Senate,"Do pass as amended",7,0,0,0,7
706106,457302,2015-06-04,Senate,"Senate 3rd Reading SB148 McGuire",40,0,0,0,40
706106,463580,2015-04-27,Senate,"Placed on Appropriations Suspense file",7,0,0,0,7
706106,466329,2015-07-15,Assembly,"Amend, and do pass as amended and be re-referred to the Committee 	on Appropriations with the recommendation:  To Consent Calendar",7,0,0,0,7
706106,474227,2015-08-26,Assembly,"Do pass as amended, to Consent Calendar",17,0,0,0,17
706106,475567,2015-09-02,Assembly,"SB 148 McGuire  Consent Calendar Second Day",79,0,0,1,80
706106,475836,2015-09-04,Senate,"Unfinished Business SB148 McGuire Concurrence",40,0,0,0,40
706106,485045,2015-09-03,Senate,"From committee:  That the Assembly Amendments be concurred in",9,0,0,0,9
706109,415215,2015-03-23,Assembly,"Be adopted and be re-referred to the Committee on Appropriations",16,0,0,0,16
706109,433892,2015-04-15,Assembly,"Be adopted, to Consent Calendar",16,0,0,1,17
706109,435169,2015-04-20,Assembly,"ACR 14 IRWIN  Consent Calendar Second Day  Regular Session",80,0,0,0,80
706109,460486,2015-06-16,Senate,"Be adopted, but re-refer to the Committee on Appropriations 	Recommend Consent",11,0,0,0,11
706109,465205,2015-07-06,Senate,"Consent Calendar 2nd ACR14 Irwin",39,0,1,0,40
706109,465780,2015-07-09,Assembly,"ACR 14 IRWIN  Concurrence in Senate Amendments",77,0,0,3,80
706114,416022,2015-03-23,Assembly,"Do pass and be re-referred to the Committee on Revenue and Taxation",9,0,0,0,9
706114,466081,2015-07-13,Assembly,"Do pass as amended and be re-referred to the Committee on 	Appropriations",9,0,0,0,9
706114,473881,2015-08-19,Assembly,"Do pass as amended",17,0,0,0,17
706114,474350,2015-08-27,Assembly,"AB 199 EGGMAN  Third Reading Urgency",77,0,0,3,80
706114,476382,2015-09-10,Senate,"Do pass as amended",6,1,0,0,7
706114,476501,2015-09-11,Senate,"Assembly 3rd Reading AB199 Eggman Urgency Clause",40,0,0,0,40
706114,476502,2015-09-11,Assembly,"AB 199 EGGMAN  Concurrence in Senate Amendments",78,0,0,2,80
706118,418653,2015-03-25,Assembly,"Do pass and be re-referred to the Committee on Appropriations",2,4,0,1,7
706121,416095,2015-03-24,Senate,"Be adopted",10,0,1,0,11
706121,430631,2015-04-13,Senate,"Senate 3rd Reading SJR4 Lara Amend by Bates",23,12,4,0,39
706121,430632,2015-04-13,Senate,"Senate 3rd Reading SJR4 Lara",22,10,7,0,39
706121,464572,2015-06-30,Assembly,"From committee:  Be adopted.  To third reading",6,0,0,1,7
706125,429298,2015-04-08,Senate,"Do pass, but re-refer to the Committee on Appropriations",9,0,0,0,9
706125,453861,2015-05-28,Senate,"Do pass",5,2,0,0,7
706125,455882,2015-06-02,Senate,"Senate 3rd Reading SB151 Hernandez",29,9,2,0,40
706129,429329,2015-04-08,Assembly,"Do pass and be re-referred to the Committee on Arts, Entertain, 	Sports, Tourism, & Internet Media",5,2,0,0,7
706129,435967,2015-04-21,Assembly,"Do pass and be re-referred to the Committee on Appropriations",5,2,0,0,7
706129,443877,2015-05-06,Assembly,"Do pass",12,5,0,0,17
706129,445130,2015-05-11,Assembly,"AB 202 GONZALEZ  Assembly Third Reading",56,23,0,1,80
706129,458680,2015-06-10,Senate,"Do pass, but re-refer to the Committee on Appropriations",3,1,0,1,5
706129,463907,2015-06-29,Senate,"Assembly 3rd Reading AB202 Gonzalez By Leyva",26,6,8,0,40
706132,465942,2015-07-13,Senate,"Placed on Appropriations Suspense file",7,0,0,0,7
706132,474626,2015-08-27,Senate,"Do pass",7,0,0,0,7
706132,475529,2015-09-01,Senate,"Senate 3rd Reading SB150 Nguyen",39,0,1,0,40
706132,476559,2015-09-11,Assembly,"Do pass as amended",16,0,0,1,17
706132,476560,2015-09-11,Assembly,"SB 150 Nguyen  Senate Third Reading  By GARCIA, C",79,0,0,1,80
706132,476561,2015-09-11,Senate,"Unfinished Business (S upplemental File 4)SB1 50 Ngu yen Con",40,0,0,0,40
706136,415565,2015-03-23,Assembly,"Be adopted and re-referred to the Committee on Appropriations with 	recommendation:  To Consent Calendar",16,0,0,0,16
706136,434000,2015-04-15,Assembly,"Be adopted, to Consent Calendar",16,0,0,1,17
706136,435277,2015-04-20,Assembly,"ACR 16 WILK  Consent Calendar Second Day  Regular Session",80,0,0,0,80
706136,458671,2015-06-09,Senate,"Be adopted, but re-refer to the Committee on Appropriations 	Recommend Consent",11,0,0,0,11
706136,462983,2015-06-25,Senate,"Consent Calendar 2nd ACR16 Wilk",37,0,3,0,40
706141,412421,2015-03-17,Assembly,"Do pass and be re-referred to the Committee on Appropriations",12,0,0,1,13
706141,453668,2015-05-28,Assembly,"Do pass as amended",17,0,0,0,17
706141,455962,2015-06-02,Assembly,"AB 200 ALEJO  Assembly Third Reading",78,0,0,2,80
706148,396688,2015-02-17,Assembly,"From committee:  Be adopted.  To third reading",11,0,0,0,11
706148,427228,2015-04-06,Senate,"Assembly 3rd Reading ACR13 Williams By Liu",36,0,3,0,39
706148,429372,2015-04-09,Assembly,"ACR 13 WILLIAMS  Concurrence in Senate Amendments",76,0,0,4,80
706152,415011,2015-03-23,Assembly,"From committee:  Be adopted.  To third reading",11,0,0,0,11
706152,476310,2015-09-10,Senate,"Assembly 3rd Reading ACR15 Levine By Stone",40,0,0,0,40
706152,476590,2015-09-11,Assembly,"ACR 15 LEVINE  Concurrence in Senate Amendments",79,0,0,1,80
706155,415897,2015-03-23,Assembly,"Do pass and be re-referred to the Committee on Appropriations to 	Consent Calendar",9,0,0,0,9
706155,453820,2015-05-28,Assembly,"Do pass as amended",17,0,0,0,17
706159,441070,2015-04-29,Assembly,"Do pass and be re-referred to the Committee on Public Safety",7,0,0,2,9
706159,484751,2016-01-12,Assembly,"Do pass",2,3,0,2,7
709288,412689,2015-03-17,Assembly,"Do pass, to Consent Calendar",10,0,0,0,10
709288,414998,2015-03-23,Assembly,"AB 217 MAIENSCHEIN  Consent Calendar Second Day",78,0,0,2,80
709288,458541,2015-06-09,Senate,"Do pass and be placed on the Consent Calendar",7,0,0,0,7
709288,461345,2015-06-18,Senate,"Consent Calendar 2nd AB217 Maienschein",37,0,3,0,40
709299,406728,2015-03-05,Assembly,"From committee:  Be adopted.  To third reading",11,0,0,0,11
709299,429238,2015-04-09,Senate,"Assembly 3rd Reading ACR17 Chang By Fuller",38,0,1,0,39
709306,403353,2015-03-02,Senate,"Senate 3rd Reading SCR16 Block",32,0,5,0,37
709306,414919,2015-03-23,Assembly,"Be adopted, to Consent Calendar",11,0,0,0,11
709306,418856,2015-03-26,Assembly,"SCR 16 Block  Consent Calendar Second Day  Regular Session",76,0,0,4,80
709306,427279,2015-04-06,Senate,"Unfinished Business SCR16 Block Concurrence",36,0,3,0,39
709324,415771,2015-03-24,Assembly,"Do pass and be re-referred to the Committee on Appropriations",6,0,0,1,7
709324,454003,2015-05-28,Assembly,"Do pass",13,3,0,1,17
709324,455893,2015-06-02,Assembly,"AB 211 GOMEZ  Assembly Third Reading",58,20,0,2,80
709324,462104,2015-06-23,Senate,"Do pass, but re-refer to the Committee on Appropriations",3,1,1,0,5
709324,465187,2015-07-06,Senate,"Placed on Appropriations Suspense file",7,0,0,0,7
709324,474512,2015-08-27,Senate,"Do pass",5,2,0,0,7
709330,414982,2015-03-23,Assembly,"Do pass and be re-referred to the Committee on Appropriations to 	Consent Calendar",16,0,0,0,16
709330,453911,2015-05-28,Assembly,"Do pass",17,0,0,0,17
709330,455452,2015-06-01,Assembly,"AB 218 MELENDEZ  Assembly Third Reading",80,0,0,0,80
709330,462138,2015-06-23,Senate,"Do pass, but re-refer to the Committee on Appropriations Recommend 	Consent",11,0,0,0,11
709330,465259,2015-07-06,Senate,"Placed on Appropriations Suspense file",7,0,0,0,7
709330,474588,2015-08-27,Senate,"Do pass",7,0,0,0,7
709330,476396,2015-09-10,Senate,"Assembly 3rd Reading AB218 Melendez By Stone",40,0,0,0,40
709336,437244,2015-04-22,Assembly,"Do pass and be re-referred to the Committee on Appropriations",20,0,0,1,21
709336,441148,2015-04-29,Assembly,"Do pass",17,0,0,0,17
709336,442846,2015-05-04,Assembly,"AB 216 GARCIA, C.  Assembly Third Reading",77,0,0,3,80
709336,462984,2015-06-24,Senate,"Do pass as amended, and re-refer to the Committee on Appropriations",8,0,1,0,9
709336,474123,2015-08-24,Senate,"Assembly 3rd Reading AB216 Cristina Garcia By Hernandez",35,2,3,0,40
709336,475311,2015-08-31,Assembly,"AB 216 GARCIA, C.  Concurrence in Senate Amendments",77,1,0,2,80
709342,441494,2015-04-29,Senate,"Do pass as amended, and re-refer to the Committee on Appropriations",6,0,1,0,7
709342,463705,2015-05-18,Senate,"Placed on Appropriations Suspense file",7,0,0,0,7
709353,437981,2015-04-22,Assembly,"Do pass and be re-referred to the Committee on Appropriations",5,2,0,0,7
709353,454044,2015-05-28,Assembly,"Do pass as amended",12,5,0,0,17
709353,456728,2015-06-03,Assembly,"AB 219 DALY  Assembly Third Reading",52,27,0,1,80
709353,462597,2015-06-24,Senate,"Do pass, but re-refer to the Committee on Appropriations",4,1,0,0,5
709353,465161,2015-07-06,Senate,"Placed on Appropriations Suspense file",7,0,0,0,7
709353,474580,2015-08-27,Senate,"Do pass as amended",4,2,1,0,7
709353,475450,2015-09-01,Senate,"Assembly 3rd Reading AB219 Daly By Mendoza",24,13,3,0,40
709353,475780,2015-09-03,Assembly,"AB 219 DALY  Concurrence in Senate Amendments",51,27,0,2,80
709359,447723,2015-05-13,Assembly,"Do pass",6,1,0,0,7
709359,457306,2015-06-04,Assembly,"AB 215 ALEJO  Assembly Third Reading",78,2,0,0,80
709359,465652,2015-07-08,Senate,"Do pass",8,0,1,0,9
709359,473763,2015-08-17,Senate,"Assembly 3rd Reading AB215 Alejo By Leyva",36,0,4,0,40
709365,415388,2015-03-23,Assembly,"Do pass and be re-referred to the Committee on Appropriations",15,0,0,1,16
709365,454194,2015-05-28,Assembly,"Do pass",16,0,0,1,17
709365,455270,2015-06-01,Assembly,"AB 210 GATTO  Assembly Third Reading",77,1,0,2,80
709365,462085,2015-06-23,Senate,"Do pass, but re-refer to the Committee on Appropriations",11,0,0,0,11
709365,465261,2015-07-06,Senate,"Placed on Appropriations Suspense file",7,0,0,0,7
709365,474682,2015-08-27,Senate,"Do pass",7,0,0,0,7
709365,475731,2015-09-03,Senate,"Assembly 3rd Reading AB210 Gatto By Liu",40,0,0,0,40
709371,399890,2015-02-23,Assembly,"From committee:  Be adopted.  To third reading",11,0,0,0,11
709376,431494,2015-04-13,Assembly,"Do pass and be re-referred to the Committee on Natural Resources",7,4,0,4,15
710996,412595,2015-03-17,Assembly,"Do pass and be re-referred to the Committee on Appropriations",3,3,0,1,7
710996,463577,2015-03-17,Assembly,"Reconsideration granted",6,0,0,1,7
711006,432626,2015-04-15,Senate,"Do pass, but re-refer to the Committee on Appropriations",3,3,1,0,7
711006,440914,2015-04-29,Senate,"Do pass as amended, and re-refer to the Committee on Appropriations",7,0,0,0,7
711006,453914,2015-05-28,Senate,"Do pass",7,0,0,0,7
711006,455416,2015-06-01,Senate,"Senate 3rd Reading SB162 Galgiani",38,0,2,0,40
711006,463581,2015-05-18,Senate,"Placed on Appropriations Suspense file",7,0,0,0,7
711006,464416,2015-06-30,Assembly,"Do pass and be re-referred to the Committee on Appropriations",7,0,0,0,7
711006,474432,2015-08-27,Assembly,"Do pass",17,0,0,0,17
711006,475496,2015-09-01,Assembly,"SB 162 Galgiani  Senate Third Reading  By GRAY",80,0,0,0,80
711006,475604,2015-09-02,Senate,"Unfinished Business SB162 Galgiani Concurrence",40,0,0,0,40
711015,427998,2015-04-06,Assembly,"Do pass and be re-referred to the Committee on Appropriations",14,0,0,2,16
711015,437213,2015-04-22,Assembly,"Do pass, to Consent Calendar",17,0,0,0,17
711015,442187,2015-04-30,Assembly,"AB 222 ACHADJIAN  Consent Calendar Second Day  Regular Session",77,0,0,3,80
711015,458606,2015-06-09,Senate,"Do pass, but re-refer to the Committee on Appropriations",7,0,0,0,7
711015,462013,2015-06-22,Senate,"Placed on Appropriations Suspense file",6,0,1,0,7
711025,432859,2015-04-13,Assembly,"Do pass as amended and be re-referred to the Committee on Budget",16,0,0,0,16
711035,440463,2015-04-27,Assembly,"Do pass as amended and be re-referred to the Committee on 	Appropriations",14,2,0,0,16
711035,454177,2015-05-28,Assembly,"Do pass as amended",13,1,0,3,17
711035,456813,2015-06-03,Assembly,"AB 221 DABABNEH  Assembly Third Reading",74,5,0,1,80
711035,464278,2015-06-30,Senate,"Do pass as amended, and re-refer to the Committee on Appropriations",9,2,0,0,11
711035,473643,2015-08-17,Senate,"Placed on Appropriations Suspense file",7,0,0,0,7
711035,474543,2015-08-27,Senate,"Do pass",5,2,0,0,7
711035,475929,2015-09-08,Senate,"Assembly 3rd Reading AB221 Dababneh By Hertzberg",28,12,0,0,40
711035,476091,2015-09-09,Assembly,"AB 221 DABABNEH  Concurrence in Senate Amendments",74,4,0,2,80
711053,440231,2015-04-28,Senate,"Do pass, but re-refer to the Committee on Veterans Affairs 	Recommend Consent",7,0,4,0,11
711053,445747,2015-05-12,Senate,"Do pass and be placed on the Consent Calendar",5,0,0,0,5
711053,450255,2015-05-22,Senate,"Consent Calendar 2nd SB159 Nielsen",38,0,1,0,39
711053,462217,2015-06-23,Assembly,"Do pass as amended and be re-referred to the Committee on Veterans 	Affairs",9,0,0,0,9
711053,553166,2016-06-14,Assembly,"Do pass",8,0,0,1,9
711053,560384,2016-08-19,Assembly,"SB 159 Nielsen  Third Reading Urgency  Amendment  Set #1",73,0,0,7,80
711062,427858,2015-04-06,Assembly,"Do pass and be re-referred to the Committee on Appropriations to 	Consent Calendar",15,0,0,1,16
711062,437217,2015-04-22,Assembly,"Do pass, to Consent Calendar",17,0,0,0,17
711062,442355,2015-04-30,Assembly,"AB 223 DAHLE  Consent Calendar Second Day  Regular Session",77,0,0,3,80
711062,462205,2015-06-23,Senate,"Do pass, but re-refer to the Committee on Appropriations",11,0,0,0,11
711062,465761,2015-07-09,Senate,"Assembly 3rd Reading AB223 Dahle By Gaines",39,0,1,0,40
711062,465865,2015-07-13,Assembly,"AB 223 DAHLE  Concurrence in Senate Amendments",78,0,0,2,80
711072,437936,2015-04-14,Assembly,"Do pass as amended and be re-referred to the Committee on 	Appropriations",17,0,0,2,19
711072,441278,2015-04-29,Assembly,"Do pass, to Consent Calendar",17,0,0,0,17
711072,444487,2015-05-07,Assembly,"AB 226 ATKINS  Consent Calendar Second Day  Regular Session",77,0,0,3,80
711072,463001,2015-06-24,Senate,"Do pass as amended, but re-refer to the Committee on Appropriations 	Recommend Consent",8,0,1,0,9
711072,476193,2015-09-09,Senate,"Assembly 3rd Reading AB226 Atkins By Hueso",39,0,1,0,40
711072,476318,2015-09-10,Assembly,"AB 226 ATKINS  Concurrence in Senate Amendments",79,0,0,1,80
711082,418664,2015-03-25,Assembly,"Amend, and do pass as amended and be re-referred to the Committee 	on Appropriations with the recommendation:  To Consent Calendar",6,0,0,1,7
711082,433919,2015-04-15,Assembly,"Do pass, to Consent Calendar",16,0,0,1,17
711082,438300,2015-04-23,Assembly,"AB 220 HOLDEN  Consent Calendar Second Day  Regular Session",78,0,0,2,80
711082,458769,2015-06-10,Senate,"Do pass, but re-refer to the Committee on Appropriations Recommend 	Consent",8,0,1,0,9
711082,461992,2015-06-22,Senate,"Do pass",6,0,1,0,7
711082,465190,2015-07-06,Senate,"Special Consent #4 AB220 Holden",39,0,1,0,40
711091,422622,2015-03-25,Assembly,"Do pass as amended and be re-referred to the Committee on 	Appropriations",6,0,0,1,7
711091,433930,2015-04-15,Assembly,"Do pass, to Consent Calendar",16,0,0,1,17
711091,438199,2015-04-23,Assembly,"AB 224 JONES-SAWYER  Consent Calendar Second Day  Regular Session",78,0,0,2,80
711091,462647,2015-06-24,Senate,"Do pass, but re-refer to the Committee on Appropriations Recommend 	Consent",9,0,0,0,9
711091,465189,2015-07-06,Senate,"Placed on Appropriations Suspense file",7,0,0,0,7
711091,474712,2015-08-27,Senate,"Do pass as amended",7,0,0,0,7
711091,476037,2015-09-08,Senate,"Assembly 3rd Reading AB224 Jones-Sawyer By Beall",40,0,0,0,40
711091,476190,2015-09-09,Assembly,"AB 224 JONES-SAWYER  Concurrence in Senate Amendments",80,0,0,0,80
711101,437226,2015-04-21,Senate,"Do pass and be placed on the Consent Calendar",7,0,0,0,7
711101,442174,2015-04-30,Senate,"Consent Calendar 2nd SB161 Vidak",34,0,5,0,39
711101,460261,2015-06-16,Assembly,"Do pass, to Consent Calendar",10,0,0,0,10
711101,461891,2015-06-22,Assembly,"SB 161 Vidak  Consent Calendar Second Day",77,0,0,3,80
712463,432913,2015-04-14,Assembly,"Do pass and be re-referred to the Committee on Education",7,0,0,0,7
712463,442316,2015-04-29,Assembly,"Do pass as amended and be re-referred to the Committee on 	Appropriations",7,0,0,0,7
712473,441263,2015-04-29,Assembly,"Do pass and be re-referred to the Committee on Appropriations",9,0,0,0,9
712473,446475,2015-05-13,Assembly,"Do pass, to Consent Calendar",17,0,0,0,17
712473,450196,2015-05-22,Assembly,"AB 229 CHANG  Consent Calendar Second Day  Regular Session",74,0,0,6,80
712473,476389,2015-09-10,Senate,"Assembly 3rd Reading AB229 Chang By Glazer",25,11,4,0,40
712473,476504,2015-09-11,Assembly,"AB 229 CHANG  Concurrence in Senate Amendments",74,3,0,3,80
712494,415756,2015-03-24,Senate,"Do pass as amended, and re-refer to the Committee on Appropriations",7,0,0,0,7
712494,435182,2015-04-20,Senate,"Placed on Appropriations Suspense file",7,0,0,0,7
712505,440258,2015-04-28,Assembly,"Do pass and be re-referred to the Committee on Appropriations to 	Consent Calendar",15,0,0,0,15
712505,443889,2015-05-06,Assembly,"Do pass",17,0,0,0,17
712505,446759,2015-05-14,Assembly,"AB 232 ALLEN  Assembly Third Reading",80,0,0,0,80
712505,462340,2015-06-23,Senate,"Do pass, but re-refer to the Committee on Appropriations Recommend 	Consent",9,0,0,0,9
712505,476411,2015-09-10,Senate,"Do pass, but re-refer to the Committee on Appropriations",9,0,0,0,9
712505,476412,2015-09-10,Senate,"W/O REF. TO FILE AB232 Obernolte By Fuller",40,0,0,0,40
712505,476586,2015-09-11,Assembly,"Senate amendments be concurred in",15,0,0,4,19
712505,476587,2015-09-11,Assembly,"AB 232 OBERNOLTE  Concurrence- Urgency Added",79,0,0,1,80
712517,398389,2015-02-19,Senate,"Senate 3rd Reading SCR17 Block",35,0,2,0,37
712517,399964,2015-02-23,Assembly,"From committee:  Be adopted.  To third reading",11,0,0,0,11
712550,427887,2015-04-07,Assembly,"Do pass and be re-referred to the Committee on Appropriations",16,1,0,2,19
712550,434102,2015-04-15,Assembly,"Do pass",15,0,0,2,17
712550,445176,2015-05-11,Assembly,"AB 234 GORDON  Assembly Third Reading",62,10,0,8,80
712550,463202,2015-06-24,Senate,"Do pass, but re-refer to the Committee on Appropriations",8,0,1,0,9
712550,476283,2015-09-10,Senate,"Assembly 3rd Reading AB234 Gordon By Wolk",27,13,0,0,40
712550,476629,2015-09-11,Assembly,"AB 234 GORDON  Concurrence in Senate Amendments",63,15,0,2,80
712560,427864,2015-04-07,Senate,"Do pass as amended, and re-refer to the Committee on Appropriations",7,0,0,0,7
712560,442244,2015-04-30,Senate,"Senate 3rd Reading SB165 Monning",36,0,3,0,39
712560,460154,2015-06-16,Assembly,"Do pass and be re-referred to the Committee on Water, Parks and 	Wildlife to Consent Calendar",7,0,0,0,7
712560,464334,2015-06-30,Assembly,"Do pass and be re-referred to the Committee on Appropriations to 	Consent Calendar",15,0,0,0,15
712560,465661,2015-07-08,Assembly,"Do pass, to Consent Calendar",14,0,0,3,17
712560,466454,2015-07-16,Assembly,"SB 165 Monning  Consent Calendar Second Day  Regular Session",79,0,0,1,80
712572,416097,2015-03-24,Assembly,"Do pass and be re-referred to the Committee on Appropriations to 	Consent Calendar",7,0,0,0,7
712572,437472,2015-04-22,Assembly,"Do pass, to Consent Calendar",17,0,0,0,17
712572,442224,2015-04-30,Assembly,"AB 231 EGGMAN  Consent Calendar Second Day  Regular Session",77,0,0,3,80
712572,458373,2015-06-09,Senate,"Do pass, but re-refer to the Committee on Appropriations",7,0,0,0,7
712572,462025,2015-06-22,Senate,"Placed on Appropriations Suspense file",6,0,1,0,7
712572,474684,2015-08-27,Senate,"Do pass",7,0,0,0,7
712572,475687,2015-09-02,Senate,"Assembly 3rd Reading AB231 Eggman By Monning",39,0,1,0,40
712572,475773,2015-09-03,Assembly,"AB 231 EGGMAN  Concurrence in Senate Amendments",78,0,0,2,80
712584,414170,2015-03-19,Assembly,"From committee:  Be adopted.  To third reading",11,0,0,0,11
712584,461801,2015-06-22,Senate,"Special Consent #3 ACR18 Gordon",37,0,3,0,40
712594,436036,2015-04-21,Senate,"Do pass, but re-refer to the Committee on Appropriations",4,1,0,0,5
712594,442945,2015-05-04,Senate,"Placed on Appropriations Suspense file",7,0,0,0,7
712594,453736,2015-05-28,Senate,"Do pass as amended",5,2,0,0,7
712594,456688,2015-06-03,Senate,"Senate 3rd Reading SB163 Hertzberg",28,12,0,0,40
712594,551396,2016-06-06,Assembly,"Be referred to Committee on Environmental Safety and Toxic 	Materials",9,0,0,2,11
714203,442852,2015-05-04,Senate,"Placed on Appropriations Suspense file",7,0,0,0,7
714203,454193,2015-05-28,Senate,"Do pass as amended",7,0,0,0,7
714203,457342,2015-06-04,Senate,"Senate 3rd Reading SB170 Gaines",40,0,0,0,40
714203,458664,2015-04-14,Senate,"Do pass as amended, and re-refer to the Committee on Appropriations",6,0,0,1,7
714203,466139,2015-07-14,Assembly,"Do pass and be re-referred to the Committee on Appropriations",7,0,0,0,7
714203,473933,2015-08-19,Assembly,"Do pass, to Consent Calendar",17,0,0,0,17
714203,474190,2015-07-07,Assembly,"Do pass and be re-referred to the Committee on Public Safety",11,0,0,0,11
714203,475744,2015-09-03,Assembly,"SB 170 Gaines  Senate Third Reading  By GATTO",80,0,0,0,80
714203,475889,2015-09-04,Senate,"Unfinished Business SB170 Gaines Concurrence",39,0,1,0,40
714211,429123,2015-04-08,Assembly,"Do pass and be re-referred to the Committee on Privacy and Consumer 	Protection",9,0,0,0,9
714211,436266,2015-04-21,Assembly,"Do pass as amended and be re-referred to the Committee on 	Appropriations",11,0,0,0,11
714211,486277,2016-01-21,Assembly,"Do pass",13,4,0,0,17
714211,488351,2016-01-27,Assembly,"AB 241 GORDON  Assembly Third Reading",61,14,0,4,79
714211,552056,2016-06-08,Senate,"Do pass as amended, and re-refer to the Committee on Appropriations",5,0,2,0,7
714211,559831,2016-08-15,Senate,"Assembly 3rd Reading AB241 Gordon By Wolk",27,11,1,0,39
714211,560143,2016-08-18,Assembly,"AB 241 GORDON  Concurrence in Senate Amendments",65,11,0,4,80
714220,432731,2015-04-15,Senate,"Do pass, but re-refer to the Committee on Appropriations",6,2,0,0,8
714220,442845,2015-05-04,Senate,"Placed on Appropriations Suspense file",7,0,0,0,7
714220,453756,2015-05-28,Senate,"Do pass",5,2,0,0,7
714220,455318,2015-06-01,Senate,"Senate 3rd Reading SB172 Liu",25,14,1,0,40
714220,464917,2015-07-01,Assembly,"Do pass as amended and be re-referred to the Committee on 	Appropriations",5,0,0,2,7
714220,474442,2015-08-27,Assembly,"Do pass as amended",12,5,0,0,17
714220,475872,2015-09-04,Assembly,"SB 172 Liu  Senate Third Reading  By BONILLA  Amend By BONILLA  Set 	#1",51,27,0,2,80
714220,475964,2015-09-08,Assembly,"SB 172 Liu  Senate Third Reading  By BONILLA",49,25,0,6,80
714220,476281,2015-09-10,Senate,"Unfinished Business SB172 Liu Concurrence",24,14,2,0,40
714229,416122,2015-03-24,Senate,"Do pass, but re-refer to the Committee on Appropriations",2,7,0,0,9
714229,463642,2015-03-24,Senate,"Set, first hearing.  Failed passage in Committee.  Reconsideration 	granted",9,0,0,0,9
714238,415956,2015-03-23,Assembly,"Do pass and be re-referred to the Committee on Appropriations",2,7,0,0,9
714238,463578,2015-03-23,Assembly,"Reconsideration granted",9,0,0,0,9
714247,432734,2015-04-15,Assembly,"Do pass as amended and be re-referred to the Committee on Education",8,0,0,1,9
714256,396607,2015-02-17,Assembly,"From committee:  Be adopted.  To third reading",11,0,0,0,11
714256,406208,2015-03-05,Senate,"Assembly 3rd Reading ACR19 Low By Pan",37,0,0,0,37
714273,416354,2015-03-24,Senate,"Do pass as amended, and re-refer to the Committee on Appropriations",5,0,0,0,5
714273,435220,2015-04-20,Senate,"Placed on Appropriations Suspense file",7,0,0,0,7
714300,433206,2015-04-14,Assembly,"Do pass and be re-referred to the Committee on Water, Parks and 	Wildlife",9,0,0,0,9
714300,440436,2015-04-28,Assembly,"Do pass and be re-referred to the Committee on Appropriations to 	Consent Calendar",15,0,0,0,15
714300,443897,2015-05-06,Assembly,"Do pass, to Consent Calendar",17,0,0,0,17
714300,446775,2015-05-14,Assembly,"AB 240 WILK  Consent Calendar Second Day  Regular Session",78,0,0,2,80
714300,462285,2015-06-23,Senate,"Do pass, but re-refer to the Committee on Appropriations Recommend 	Consent",9,0,0,0,9
714300,465217,2015-07-06,Senate,"Placed on Appropriations Suspense file",7,0,0,0,7
714309,485357,2016-01-05,Assembly,"Be referred to Committee on Utilities and Commerce",11,0,0,0,11
714317,432632,2015-04-15,Assembly,"Do pass and be re-referred to the Committee on Environmental Safety 	and Toxic Materials",6,2,0,2,10
714317,440212,2015-04-28,Assembly,"Do pass and be re-referred to the Committee on Appropriations",6,0,0,1,7
714317,453665,2015-05-28,Assembly,"Do pass as amended",13,1,0,3,17
714317,456572,2015-06-03,Assembly,"AB 243 WOOD  Assembly Third Reading",60,15,0,5,80
714317,465610,2015-07-08,Senate,"Do pass, but re-refer to the Committee on Environmental Quality",5,0,2,0,7
714317,466337,2015-07-15,Senate,"Do pass, but re-refer to the Committee on Appropriations",5,0,2,0,7
714317,473720,2015-08-17,Senate,"Placed on Appropriations Suspense file",7,0,0,0,7
714317,474658,2015-08-27,Senate,"Do pass as amended",5,0,2,0,7
714317,476543,2015-09-11,Senate,"Assembly 3rd Reading ( Supplemental File 3)AB 243 Wo od By",30,8,2,0,40
714317,476544,2015-09-11,Assembly,"AB 243 WOOD  Concurrence in Senate Amendments",60,13,0,7,80
714326,474646,2015-08-27,Senate,"Do pass, but re-refer to the Committee on Appropriations",7,0,0,0,7
714326,475280,2015-08-31,Senate,"Senate 3rd Reading SB168 Gaines Urgency Clause",39,0,1,0,40
714326,476644,2015-09-11,Assembly,"Do pass",10,0,0,1,11
714326,476645,2015-09-11,Assembly,"SB 168 Gaines  Third Reading Urgency  By GATTO",79,0,0,1,80
714326,476646,2015-09-11,Senate,"Unfinished Business (S upplemental File 6)SB1 68 Gai nes Urg",40,0,0,0,40
714335,414892,2015-03-23,Assembly,"Do pass and be re-referred to the Committee on Appropriations",14,0,0,2,16
714335,454090,2015-05-28,Assembly,"Do pass",16,0,0,1,17
714335,455246,2015-06-01,Assembly,"AB 235 FRAZIER  Assembly Third Reading",63,12,0,5,80
714335,462160,2015-06-23,Senate,"Do pass, but re-refer to the Committee on Appropriations",10,1,0,0,11
714335,465197,2015-07-06,Senate,"Placed on Appropriations Suspense file",7,0,0,0,7
714344,436142,2015-04-21,Assembly,"Do pass and be re-referred to the Committee on Appropriations",14,0,0,0,14
714344,443894,2015-05-06,Assembly,"Do pass, to Consent Calendar",17,0,0,0,17
714344,446758,2015-05-14,Assembly,"AB 236 LACKEY  Consent Calendar Second Day  Regular Session",78,0,0,2,80
714344,460033,2015-06-15,Senate,"Do pass, but re-refer to the Committee on Appropriations Recommend 	Consent",9,0,0,0,9
714344,464943,2015-07-02,Senate,"Consent Calendar 2nd AB236 Lackey",38,0,2,0,40
716650,432743,2015-04-14,Assembly,"Do pass as amended and be re-referred to the Committee on 	Accountability and Administrative Review",8,1,0,0,9
716650,440952,2015-04-29,Assembly,"Do pass and be re-referred to the Committee on Appropriations",9,0,0,0,9
716653,431582,2015-04-13,Senate,"Do pass, but re-refer to the Committee on Judiciary Recommend 	Consent",9,0,0,0,9
716653,440203,2015-04-28,Senate,"Do pass as amended, and re-refer to the Committee on Appropriations",6,0,1,0,7
716653,451948,2015-05-26,Senate,"Senate 3rd Reading SB177 Wieckowski",38,0,1,0,39
716653,462131,2015-06-23,Assembly,"Do pass and be re-referred to the Committee on Appropriations to 	Consent Calendar",14,0,0,0,14
716653,465606,2015-07-08,Assembly,"Do pass, to Consent Calendar",14,0,0,3,17
716653,466535,2015-07-16,Assembly,"SB 177 Wieckowski  Consent Calendar Second Day  Regular Session",79,0,0,1,80
716656,415904,2015-03-24,Assembly,"Do pass as amended and be re-referred to the Committee on 	Appropriations",7,0,0,0,7
716656,433925,2015-04-15,Assembly,"Do pass",16,0,0,1,17
716656,445179,2015-05-11,Assembly,"AB 256 JONES-SAWYER  Assembly Third Reading",79,0,0,1,80
716656,462125,2015-06-23,Senate,"Do pass, but re-refer to the Committee on Appropriations",7,0,0,0,7
716656,465148,2015-07-06,Senate,"Placed on Appropriations Suspense file",7,0,0,0,7
716656,474701,2015-08-27,Senate,"Do pass",7,0,0,0,7
716656,475601,2015-09-02,Senate,"Assembly 3rd Reading AB256 Jones-Sawyer By Leyva",40,0,0,0,40
716656,475891,2015-09-04,Assembly,"AB 256 JONES-SAWYER  Concurrence in Senate Amendments",79,0,0,1,80
716659,412708,2015-03-17,Assembly,"Do pass as amended and be re-referred to the Committee on 	Appropriations",6,0,0,1,7
716659,433867,2015-04-15,Assembly,"Do pass, to Consent Calendar",16,0,0,1,17
716659,437905,2015-04-23,Assembly,"AB 249 OBERNOLTE  Consent Calendar Second Day  Regular Session",78,0,0,2,80
716659,458528,2015-06-09,Senate,"Do pass, but re-refer to the Committee on Appropriations",7,0,0,0,7
716659,465260,2015-07-06,Senate,"Assembly 3rd Reading AB249 Obernolte By Anderson",39,0,1,0,40
716661,442254,2015-04-30,Senate,"Senate 3rd Reading SB175 Huff",36,0,3,0,39
716661,458689,2015-04-14,Senate,"Do pass as amended",6,0,0,1,7
716661,460209,2015-06-16,Assembly,"Amend, and do pass as amended and be re-referred to the Committee 	on Privacy and Consumer Protection with the recommendation:  To 	Consent Calendar",7,0,0,0,7
716661,465428,2015-07-07,Assembly,"Do pass, to Consent Calendar",11,0,0,0,11
716661,474059,2015-08-24,Assembly,"SB 175 Huff  Senate Third Reading  By LACKEY",34,3,0,43,80
716667,428545,2015-04-08,Senate,"Do pass and be placed on the Consent Calendar",7,0,0,0,7
716667,433924,2015-04-16,Senate,"Consent Calendar 2nd SB181 Committee On GOV. & F. (Hertzberg)",37,0,2,0,39
716667,446448,2015-05-13,Assembly,"Do pass, to Consent Calendar",9,0,0,0,9
716667,450222,2015-05-22,Assembly,"SB 181 GOV.& F.  Consent Calendar Second Day  Regular Session",74,0,0,6,80
716670,437862,2015-04-22,Assembly,"Do pass as amended and be re-referred to the Committee on 	Appropriations",6,1,0,0,7
716670,453835,2015-05-28,Assembly,"Do pass as amended",13,4,0,0,17
716670,457228,2015-06-04,Assembly,"AB 252 HOLDEN  Assembly Third Reading",64,14,0,2,80
716670,473660,2015-08-17,Senate,"Placed on Appropriations Suspense file",7,0,0,0,7
716674,427829,2015-04-07,Senate,"Do pass as amended, and re-refer to the Committee on Environmental 	Quality",8,3,0,0,11
716674,440941,2015-04-29,Senate,"Do pass as amended, and re-refer to the Committee on Appropriations",5,2,0,0,7
716674,463614,2015-05-18,Senate,"Placed on Appropriations Suspense file",7,0,0,0,7
716679,485073,2016-01-05,Assembly,"Be referred to Committee on Public Safety",11,0,0,0,11
716683,428448,2015-04-08,Senate,"Do pass as amended, and re-refer to the Committee on Judiciary",7,0,0,0,7
716683,437253,2015-04-21,Senate,"Do pass, but re-refer to the Committee on Appropriations",6,1,0,0,7
716683,442913,2015-05-04,Senate,"Do pass",7,0,0,0,7
716683,446899,2015-05-14,Senate,"Senate 3rd Reading SB188 Hancock",31,4,4,0,39
716683,460626,2015-06-17,Assembly,"Do pass and be re-referred to the Committee on Judiciary",9,0,0,0,9
716683,464553,2015-06-30,Assembly,"Do pass and be re-referred to the Committee on Appropriations",9,1,0,0,10
716683,466333,2015-07-15,Assembly,"Do pass",12,4,0,1,17
716683,474033,2015-08-20,Assembly,"SB 188 Hancock  Senate Third Reading  By BONILLA",68,6,0,6,80
716686,415570,2015-03-23,Assembly,"Be adopted and re-referred to the Committee on Appropriations with 	recommendation:  To Consent Calendar",16,0,0,0,16
716686,434052,2015-04-15,Assembly,"Be adopted, to Consent Calendar",16,0,0,1,17
716686,435232,2015-04-20,Assembly,"ACR 21 OBERNOLTE  Consent Calendar Second Day  Regular Session",80,0,0,0,80
716686,458533,2015-06-09,Senate,"Be adopted, but re-refer to the Committee on Appropriations 	Recommend Consent",11,0,0,0,11
716686,462961,2015-06-25,Senate,"Consent Calendar 2nd ACR21 Obernolte",37,0,3,0,40
716690,432576,2015-04-15,Senate,"Do pass, but re-refer to the Committee on Appropriations",5,1,1,0,7
716690,446669,2015-04-06,Senate,"Do pass, but re-refer to the Committee on Environmental Quality",7,1,1,0,9
716690,453608,2015-05-28,Senate,"Do pass as amended",5,2,0,0,7
716690,456589,2015-06-03,Senate,"Senate 3rd Reading SB189 Hueso",26,14,0,0,40
716690,462157,2015-06-23,Assembly,"Do pass as amended and be re-referred to the Committee on Natural 	Resources",6,2,0,1,9
716690,463541,2015-04-27,Senate,"Placed on Appropriations Suspense file",7,0,0,0,7
716690,466090,2015-07-13,Assembly,"Do pass as amended and be re-referred to the Committee on 	Appropriations",6,1,0,2,9
716694,432679,2015-04-15,Assembly,"Do pass and be re-referred to the Committee on Health",4,0,0,3,7
716694,441678,2015-04-28,Assembly,"Do pass as amended and be re-referred to the Committee on 	Appropriations",19,0,0,0,19
716694,453121,2015-05-27,Assembly,"Do pass",16,1,0,0,17
716694,455395,2015-06-01,Assembly,"AB 253 HERNANDEZ  Assembly Third Reading",79,0,0,1,80
716694,463127,2015-06-24,Senate,"Do pass, but re-refer to the Committee on Transportation and 	Housing",8,0,1,0,9
716696,415804,2015-03-24,Senate,"Do pass, but re-refer to the Committee on Appropriations",6,1,0,0,7
716696,453836,2015-05-28,Senate,"Do pass as amended",7,0,0,0,7
716696,456664,2015-06-03,Senate,"Senate 3rd Reading SB178 Leno",39,0,1,0,40
716696,462098,2015-06-23,Assembly,"Do pass as amended and be re-referred to the Committee on Public 	Safety",9,0,0,2,11
716696,463544,2015-04-27,Senate,"Placed on Appropriations Suspense file",7,0,0,0,7
716696,466004,2015-07-14,Assembly,"Do pass and be re-referred to the Committee on Appropriations",5,0,0,2,7
716696,474334,2015-08-27,Assembly,"Do pass as amended",15,0,0,2,17
716696,475974,2015-09-08,Assembly,"SB 178 Leno  Senate Third Reading  By OBERNOLTE",57,13,0,10,80
716696,476102,2015-09-09,Senate,"Unfinished Business SB178 Leno Concurrence",34,4,2,0,40
716701,427901,2015-04-07,Assembly,"Do pass and be re-referred to the Committee on Health",14,0,0,0,14
716701,443673,2015-05-05,Assembly,"Do pass as amended, to Consent Calendar",17,0,0,2,19
716701,446601,2015-05-14,Assembly,"AB 250 OBERNOLTE  Consent Calendar Second Day  Regular Session",78,0,0,2,80
716701,459862,2015-06-15,Senate,"Do pass as amended. To Consent Calendar",9,0,0,0,9
716701,461152,2015-06-18,Senate,"Consent Calendar 2nd AB250 Obernolte",37,0,3,0,40
716701,461906,2015-06-22,Assembly,"AB 250 OBERNOLTE  Concurrence in Senate Amendments",78,0,0,2,80
716702,412346,2015-03-17,Assembly,"Do pass and be re-referred to the Committee on Appropriations",11,0,0,0,11
716702,453882,2015-05-28,Assembly,"Do pass",17,0,0,0,17
716702,455429,2015-06-01,Assembly,"AB 259 DABABNEH  Assembly Third Reading",80,0,0,0,80
716702,466244,2015-07-14,Senate,"Do pass, but re-refer to the Committee on Appropriations",6,0,1,0,7
716702,473648,2015-08-17,Senate,"Placed on Appropriations Suspense file",7,0,0,0,7
716705,436646,2015-04-21,Assembly,"Do pass",2,5,0,0,7
716705,436647,2015-04-21,Assembly,"Reconsideration granted",6,0,0,1,7
716711,427915,2015-04-07,Senate,"Do pass",7,0,0,0,7
716711,430585,2015-04-13,Senate,"Senate 3rd Reading SB176 Mitchell",35,0,4,0,39
716711,460255,2015-06-16,Assembly,"Do pass",6,0,0,1,7
716711,465170,2015-07-06,Assembly,"SB 176 Mitchell  Senate Third Reading  By LACKEY",78,0,0,2,80
716711,465791,2015-07-09,Senate,"Unfinished Business SB176 Mitchell Concurrence",35,0,5,0,40
716712,427766,2015-04-07,Assembly,"Do pass as amended and be re-referred to the Committee on 	Appropriations",12,3,0,4,19
716712,437078,2015-04-22,Assembly,"Do pass",12,5,0,0,17
716712,442275,2015-04-30,Assembly,"AB 248 HERNANDEZ  Assembly Third Reading",51,27,0,2,80
716712,462965,2015-06-24,Senate,"Do pass as amended, and re-refer to the Committee on Appropriations",6,2,1,0,9
716712,474086,2015-08-24,Senate,"Assembly 3rd Reading AB248 Roger Hern",24,15,1,0,40
716712,474283,2015-08-27,Assembly,"AB 248 HERNANDEZ  Concurrence in Senate Amendments",52,27,0,1,80
716717,428866,2015-04-08,Senate,"Do pass and be placed on the Consent Calendar",7,0,0,0,7
716717,434092,2015-04-16,Senate,"Consent Calendar 2nd SB182 Committee On GOV. & F. (Hertzberg)",37,0,2,0,39
716717,446177,2015-05-13,Assembly,"Do pass, to Consent Calendar",9,0,0,0,9
716717,474406,2015-08-27,Assembly,"SB 182 GOV.& F.  Senate Third Reading  By MAIENSCHEIN",78,0,0,2,80
716720,416864,2015-03-25,Assembly,"Do pass as amended and be re-referred to the Committee on 	Appropriations",5,2,0,0,7
716720,453870,2015-05-28,Assembly,"Do pass as amended",12,5,0,0,17
716720,456649,2015-06-03,Assembly,"AB 254 HERNANDEZ  Assembly Third Reading",44,31,0,5,80
716720,464404,2015-06-30,Senate,"Do pass, but re-refer to the Committee on Appropriations",3,1,1,0,5
716720,475708,2015-09-02,Senate,"Assembly 3rd Reading AB254 Roger Hern",25,15,0,0,40
716724,427808,2015-04-07,Assembly,"Do pass and be re-referred to the Committee on Appropriations",6,0,0,1,7
716728,441225,2015-04-29,Senate,"Do pass, but re-refer to the Committee on Appropriations Recommend 	Consent",6,0,1,0,7
716728,445221,2015-05-11,Senate,"Do pass",7,0,0,0,7
716728,447774,2015-05-18,Senate,"Special Consent #1 SB184 Committee On GOV. & F. (Hertzberg)",36,0,3,0,39
716728,465609,2015-07-08,Assembly,"Do pass, to Consent Calendar",14,0,0,3,17
716728,466570,2015-07-16,Assembly,"SB 184 GOV.& F.  Consent Calendar Second Day  Regular Session",79,0,0,1,80
716728,473926,2015-07-01,Assembly,"Do pass and be re-referred to the Committee on Appropriations to 	Consent Calendar",9,0,0,0,9
716728,473963,2015-08-20,Senate,"Special Consent #6 SB184 Committee On GOV. & F. (Hertzberg)",38,0,2,0,40
716729,416895,2015-03-25,Senate,"Do pass, but re-refer to the Committee on Rules",7,0,1,0,8
716729,439392,2015-04-27,Senate,"Senate 3rd Reading SB186 Jackson",35,0,4,0,39
716729,462155,2015-06-23,Assembly,"Do pass",11,0,0,2,13
716729,473637,2015-08-17,Assembly,"SB 186 Jackson  Senate Third Reading  By MAIENSCHEIN",66,0,0,14,80
716733,439975,2015-04-28,Senate,"Do pass and be placed on the Consent Calendar",7,0,4,0,11
716733,442867,2015-05-04,Senate,"Consent Calendar 2nd SB187 Hall",35,0,4,0,39
716733,465748,2015-07-08,Assembly,"Do pass, to Consent Calendar",20,0,0,1,21
716733,560573,2016-08-22,Assembly,"SB 187 Hall  Third Reading Urgency  By GRAY",78,0,0,2,80
716733,561092,2016-08-24,Senate,"Unfinished Business SB187 Hall Urgency Clause Concurr",39,0,0,0,39
716736,413153,2015-03-18,Assembly,"Do pass and be re-referred to the Committee on Appropriations",5,2,0,0,7
716736,416999,2015-03-25,Assembly,"Do pass",12,4,0,1,17
716736,427232,2015-04-06,Assembly,"AB 251 LEVINE  Assembly Third Reading",50,28,0,2,80
716736,458905,2015-06-10,Senate,"Do pass, but re-refer to the Committee on Appropriations",4,1,0,0,5
716736,465871,2015-07-13,Senate,"Assembly 3rd Reading AB251 Levine By Leyva",24,13,3,0,40
716736,466472,2015-07-16,Assembly,"AB 251 LEVINE  Concurrence in Senate Amendments",53,26,0,1,80
716740,415928,2015-03-24,Assembly,"Do pass and be re-referred to the Committee on Appropriations",5,1,0,1,7
716742,432686,2015-04-14,Assembly,"Do pass and be re-referred to the Committee on Judiciary",5,0,0,2,7
716742,435995,2015-04-21,Assembly,"Do pass and be re-referred to the Committee on Appropriations",10,0,0,0,10
716742,453828,2015-05-28,Assembly,"Do pass",17,0,0,0,17
716742,455978,2015-06-02,Assembly,"AB 260 LOPEZ  Assembly Third Reading",78,0,0,2,80
716742,462260,2015-06-23,Senate,"Do pass, but re-refer to the Committee on Judiciary",5,0,0,0,5
716742,464763,2015-06-30,Senate,"Do pass as amended, but re-refer to the Committee on Appropriations 	Recommend Consent",7,0,0,0,7
716742,473761,2015-08-17,Senate,"Placed on Appropriations Suspense file",7,0,0,0,7
716742,474617,2015-08-27,Senate,"Do pass",7,0,0,0,7
716742,476075,2015-09-09,Senate,"Assembly 3rd Reading AB260 Lopez By Mitchell",40,0,0,0,40
716742,476381,2015-09-10,Assembly,"AB 260 LOPEZ  Concurrence in Senate Amendments",79,0,0,1,80
716745,427865,2015-04-07,Assembly,"Do pass",13,3,0,3,19
716745,442331,2015-04-30,Assembly,"AB 258 LEVINE  Assembly Third Reading",64,12,0,4,80
716745,458704,2015-06-10,Senate,"Do pass",8,0,0,1,9
716745,461858,2015-06-22,Senate,"Assembly 3rd Reading AB258 Levine By Leno",33,1,6,0,40
716749,428377,2015-04-08,Senate,"Do pass and be placed on the Consent Calendar",7,0,0,0,7
716749,433983,2015-04-16,Senate,"Consent Calendar 2nd SB183 Committee On GOV. & F. (Hertzberg)",37,0,2,0,39
716749,461062,2015-06-17,Assembly,"Do pass, to Consent Calendar",9,0,0,0,9
716749,461795,2015-06-22,Assembly,"SB 183 GOV.& F.  Consent Calendar Second Day  Regular Session",77,0,0,3,80
716751,430667,2015-04-13,Senate,"Do pass, but re-refer to the Committee on Appropriations",3,2,0,0,5
716751,454028,2015-05-28,Senate,"Do pass as amended",5,2,0,0,7
716751,456606,2015-06-03,Senate,"Senate 3rd Reading SB185 De Le",24,14,2,0,40
716751,462601,2015-06-24,Assembly,"Do pass and be re-referred to the Committee on Appropriations",5,1,0,1,7
716751,474268,2015-08-27,Assembly,"Do pass",12,5,0,0,17
716751,475626,2015-09-02,Assembly,"SB 185 De Leon  Senate Third Reading  By BONTA",47,30,0,3,80
716752,396530,2015-02-17,Assembly,"From committee:  Be adopted.  To third reading",11,0,0,0,11
716752,413900,2015-03-19,Senate,"Assembly 3rd Reading ACR20 Mark Stone By Jackson",35,0,3,0,38
719330,415939,2015-03-24,Assembly,"Do pass as amended",6,0,0,1,7
719330,439351,2015-04-27,Assembly,"AB 267 JONES-SAWYER  Assembly Third Reading",57,21,0,2,80
719330,460203,2015-06-16,Senate,"Do pass",5,1,1,0,7
719330,475605,2015-09-02,Senate,"Assembly 3rd Reading AB267 Jones-Sawyer By Monning",31,8,1,0,40
719330,475853,2015-09-04,Assembly,"AB 267 JONES-SAWYER  Concurrence in Senate Amendments",63,12,0,5,80
719335,440881,2015-04-29,Senate,"Do pass, but re-refer to the Committee on Appropriations",6,0,1,0,7
719335,447677,2015-05-18,Senate,"Senate 3rd Reading SB197 Block",36,0,3,0,39
719335,462139,2015-06-22,Assembly,"Do pass as amended and be re-referred to the Committee on 	Appropriations",12,0,0,0,12
719335,466251,2015-07-15,Assembly,"Do pass, to Consent Calendar",16,0,0,1,17
719335,475592,2015-09-02,Assembly,"SB 197 Block  Senate Third Reading  By DABABNEH",78,0,0,2,80
719335,476231,2015-09-10,Senate,"Unfinished Business SB197 Block Concurrence",39,0,1,0,40
719340,485038,2016-01-11,Senate,"Do pass, but re-refer to the Committee on Judiciary",8,0,1,0,9
719351,414872,2015-03-23,Assembly,"Do pass and be re-referred to the Committee on Appropriations to 	Consent Calendar",16,0,0,0,16
719351,453920,2015-05-28,Assembly,"Do pass",17,0,0,0,17
719351,455559,2015-06-01,Assembly,"AB 270 NAZARIAN  Assembly Third Reading",79,0,0,1,80
719351,465525,2015-07-07,Senate,"Do pass, but re-refer to the Committee on Appropriations",11,0,0,0,11
719351,473790,2015-08-17,Senate,"Placed on Appropriations Suspense file",7,0,0,0,7
719366,462956,2015-06-25,Assembly,"From committee:  Be adopted.  To third reading",11,0,0,0,11
719366,475299,2015-08-31,Senate,"Special Consent #8 ACR22 Dahle By Gaines",40,0,0,0,40
719366,475476,2015-09-01,Assembly,"ACR 22 DAHLE  Concurrence in Senate Amendments",80,0,0,0,80
719371,432706,2015-04-15,Assembly,"Do pass and be re-referred to the Committee on Appropriations",10,0,0,0,10
719371,441542,2015-04-29,Assembly,"Do pass, to Consent Calendar",17,0,0,0,17
719371,446797,2015-05-14,Assembly,"AB 264 DAHLE  Assembly Third Reading",80,0,0,0,80
719371,464621,2015-06-30,Senate,"Do pass, but re-refer to the Committee on Judiciary",3,0,2,0,5
719371,466416,2015-07-14,Senate,"Do pass as amended, but re-refer to the Committee on Appropriations 	Recommend Consent",7,0,0,0,7
719371,473723,2015-08-17,Senate,"Do pass",7,0,0,0,7
719371,475343,2015-08-31,Senate,"Special Consent #8 AB264 Dahle By Galgiani",40,0,0,0,40
719371,475526,2015-09-01,Assembly,"AB 264 DAHLE  Concurrence in Senate Amendments",80,0,0,0,80
719377,427902,2015-04-07,Assembly,"Do pass and be re-referred to the Committee on Appropriations",11,0,0,0,11
719377,437067,2015-04-22,Assembly,"Do pass",17,0,0,0,17
719377,442249,2015-04-30,Assembly,"AB 265 HOLDEN  Assembly Third Reading",77,0,0,3,80
719377,461046,2015-06-16,Senate,"Do pass as amended, and re-refer to the Committee on Appropriations",6,0,1,0,7
719377,465867,2015-07-13,Senate,"Assembly 3rd Reading AB265 Holden By Wieckowski",38,0,2,0,40
719377,466492,2015-07-16,Assembly,"AB 265 HOLDEN  Concurrence in Senate Amendments",79,0,0,1,80
719382,416127,2015-03-24,Assembly,"Do pass as amended and be re-referred to the Committee on 	Appropriations",7,0,0,0,7
719382,453684,2015-05-28,Assembly,"Do pass as amended",17,0,0,0,17
719382,456734,2015-06-03,Assembly,"AB 271 OBERNOLTE  Assembly Third Reading",80,0,0,0,80
719382,465683,2015-07-08,Senate,"Do pass, but re-refer to the Committee on Human Services Recommend 	Consent",9,0,0,0,9
719382,465982,2015-07-14,Senate,"Do pass, but re-refer to the Committee on Appropriations Recommend 	Consent",5,0,0,0,5
719382,473747,2015-08-17,Senate,"Placed on Appropriations Suspense file",7,0,0,0,7
719382,474540,2015-08-27,Senate,"Do pass",7,0,0,0,7
719382,475505,2015-09-01,Senate,"Assembly 3rd Reading AB271 Obernolte By McGuire",40,0,0,0,40
719395,440427,2015-04-28,Assembly,"Do pass as amended and be re-referred to the Committee on 	Appropriations",13,0,0,1,14
719395,453827,2015-05-28,Assembly,"Do pass as amended",12,0,0,5,17
719395,457281,2015-06-04,Assembly,"AB 266 BONTA  Assembly Third Reading",62,8,0,10,80
719395,466271,2015-07-15,Senate,"Do pass, but re-refer to the Committee on Health",4,0,3,0,7
719395,473657,2015-08-17,Senate,"Placed on Appropriations Suspense file",7,0,0,0,7
719395,474517,2015-08-27,Senate,"Do pass as amended",5,0,2,0,7
719395,476505,2015-09-11,Senate,"Assembly 3rd Reading ( Supplemental File 3)AB 266 Bo nta By",30,9,1,0,40
719395,476506,2015-09-11,Assembly,"AB 266 BONTA  Concurrence in Senate Amendments",59,14,0,7,80
719400,484738,2016-01-11,Assembly,"Do pass and be re-referred to the Committee on Appropriations",10,0,0,2,12
719400,486280,2016-01-21,Assembly,"Do pass",13,0,0,4,17
719400,488355,2016-01-27,Assembly,"AB 268 DABABNEH  Assembly Third Reading",76,0,0,3,79
719410,432647,2015-04-14,Senate,"Do pass and be placed on the Consent Calendar",5,0,0,0,5
719410,435221,2015-04-20,Senate,"Consent Calendar 2nd SB193 Committee On V.A. (Nielsen)",37,0,2,0,39
719410,464770,2015-06-30,Assembly,"Do pass",8,0,0,1,9
719410,475380,2015-08-31,Assembly,"SB 193 V. A.  Senate Third Reading  By IRWIN",80,0,0,0,80
719410,475438,2015-09-01,Senate,"Unfinished Business SB193 Committee On V.A. (Nielsen) Concurrence",40,0,0,0,40
719415,413140,2015-03-18,Senate,"Do pass as amended, and re-refer to the Committee on Appropriations",8,0,0,0,8
719415,442262,2015-04-30,Senate,"Senate 3rd Reading SB200 Lara",35,0,4,0,39
719415,460689,2015-06-17,Assembly,"Do pass and be re-referred to the Committee on Appropriations to 	Consent Calendar",7,0,0,0,7
719415,463572,2015-04-27,Senate,"Do pass as amended",6,0,1,0,7
719415,463573,2015-04-27,Senate,"Do pass",6,0,1,0,7
719415,465580,2015-07-08,Assembly,"Do pass, to Consent Calendar",14,0,0,3,17
719415,466515,2015-07-16,Assembly,"SB 200 Lara  Senate Third Reading  By BONILLA",78,0,0,2,80
719419,439952,2015-04-28,Senate,"Do pass as amended, and re-refer to the Committee on Appropriations",9,2,0,0,11
719419,463583,2015-05-18,Senate,"Placed on Appropriations Suspense file",7,0,0,0,7
719425,415902,2015-03-24,Senate,"Do pass as amended, and re-refer to the Committee on Appropriations",5,0,0,0,5
719425,435161,2015-04-20,Senate,"Placed on Appropriations Suspense file",7,0,0,0,7
719425,454094,2015-05-28,Senate,"Do pass as amended",7,0,0,0,7
719425,456563,2015-06-03,Senate,"Senate 3rd Reading SB199 Hall",40,0,0,0,40
719425,464318,2015-06-30,Assembly,"Do pass and be re-referred to the Committee on Appropriations",7,0,0,0,7
719425,474259,2015-08-27,Assembly,"Do pass as amended",17,0,0,0,17
719425,475495,2015-09-01,Assembly,"SB 199 Hall  Senate Third Reading  By WALDRON",80,0,0,0,80
719425,475606,2015-09-02,Senate,"Unfinished Business SB199 Hall Concurrence",40,0,0,0,40
719430,415900,2015-03-24,Senate,"Do pass, but re-refer to the Committee on Governance and Finance",2,7,0,0,9
719430,463553,2015-03-24,Senate,"Set, first hearing.  Failed passage in Committee.  Reconsideration 	granted",9,0,0,0,9
719441,422090,2015-03-25,Assembly,"Be adopted, to Consent Calendar",6,0,0,1,7
719441,429542,2015-04-09,Assembly,"AJR5 DAHLE  Consent Calendar Second Day  Regular Session",78,0,0,2,80
719447,413063,2015-03-18,Senate,"Do pass, but re-refer to the Committee on Appropriations",8,0,0,0,8
719447,453737,2015-05-28,Senate,"Do pass as amended",7,0,0,0,7
719447,456647,2015-06-03,Senate,"Senate 3rd Reading SB191 Block",40,0,0,0,40
719451,446509,2015-05-12,Senate,"Do pass as amended",7,0,0,0,7
719451,451631,2015-05-26,Senate,"Senate 3rd Reading SB196 Hancock",38,0,1,0,39
719451,462173,2015-06-23,Assembly,"Do pass as amended and be re-referred to the Committee on Aging and 	Long",10,0,0,0,10
719451,465404,2015-07-07,Assembly,"Do pass",7,0,0,0,7
719451,473958,2015-08-20,Assembly,"SB 196 Hancock  Senate Third Reading  By BROWN",79,0,0,1,80
719451,474249,2015-08-27,Senate,"Special Consent #7 SB196 Hancock",40,0,0,0,40
721859,415757,2015-03-24,Senate,"Do pass, but re-refer to the Committee on Appropriations",7,2,0,0,9
721859,451557,2015-05-26,Senate,"Do pass",5,2,0,0,7
721859,454409,2015-05-28,Senate,"Senate 3rd Reading SB209 Pavley",25,13,2,0,40
721859,466070,2015-07-13,Assembly,"Do pass as amended and be re-referred to the Committee on 	Appropriations",7,1,0,1,9
721859,474431,2015-08-27,Assembly,"Do pass as amended",12,4,0,1,17
721859,525044,2016-03-28,Assembly,"SB 209 Pavley  Senate Third Reading  By GRAY",54,20,0,5,79
721859,526735,2016-03-31,Senate,"Unfinished Business SB209 Pavley Concurrence",28,8,4,0,40
721863,415888,2015-03-24,Assembly,"Do pass and be re-referred to the Committee on Appropriations",6,0,0,1,7
721863,433980,2015-04-15,Assembly,"Do pass, to Consent Calendar",16,0,0,1,17
721863,437991,2015-04-23,Assembly,"AB 274 E.S.& T.M.  Consent Calendar Second Day  Regular Session",78,0,0,2,80
721863,460639,2015-06-17,Senate,"Do pass as amended, and re-refer to the Committee on Appropriations",7,0,0,0,7
721863,475359,2015-08-31,Senate,"Assembly 3rd Reading AB274 Committee On E.S. & T.M. (Alejo) By 	Jackson",40,0,0,0,40
721863,475401,2015-09-01,Assembly,"AB 274 E.S.& T.M.  Concurrence in Senate Amendments By ALEJO",80,0,0,0,80
721867,442150,2015-04-29,Senate,"Do pass, but re-refer to the Committee on Appropriations",4,1,4,0,9
721867,463567,2015-04-29,Senate,"Set, first hearing.  Failed passage in Committee.  Reconsideration 	granted",9,0,0,0,9
721871,399864,2015-02-23,Assembly,"From committee:  Be adopted.  To third reading",11,0,0,0,11
721871,465132,2015-07-06,Senate,"Special Consent #4 ACR23 Salas",39,0,1,0,40
721875,416751,2015-03-25,Assembly,"Do pass as amended and be re-referred to the Committee on Local 	Government",4,1,0,2,7
721875,441521,2015-04-29,Assembly,"Do pass and be re-referred to the Committee on Appropriations",5,1,0,3,9
721875,453645,2015-05-28,Assembly,"Do pass as amended",12,0,0,5,17
721875,456718,2015-06-03,Assembly,"AB 278 HERNANDEZ  Assembly Third Reading",43,32,0,5,80
721875,465422,2015-07-07,Senate,"Set, first hearing.  Failed passage in Committee.  Reconsideration 	granted",4,0,1,0,5
721875,484782,2015-07-07,Senate,"Do pass, but re-refer to the Committee on Governance and Finance",2,0,3,0,5
721875,552082,2016-06-08,Senate,"Do pass as amended, and re-refer to the Committee on Governance and 	Finance",5,0,0,0,5
721875,556472,2016-06-29,Senate,"Do pass",7,0,0,0,7
721875,560060,2016-08-17,Senate,"Assembly 3rd Reading AB278 Roger Hern",33,5,1,0,39
721875,561453,2016-08-29,Assembly,"Senate amendments be concurred in",5,2,0,0,7
721875,561796,2016-08-31,Assembly,"AB 278 HERNANDEZ  Concurrence in Senate Amendments",54,21,0,5,80
721879,437087,2015-04-21,Senate,"Do pass as amended",6,1,0,0,7
721879,447722,2015-05-18,Senate,"Senate 3rd Reading SB213 Block",34,1,4,0,39
721883,417110,2015-03-25,Assembly,"Do pass as amended",5,2,0,0,7
721883,442933,2015-05-04,Assembly,"AB 277 HERNANDEZ  Assembly Third Reading",55,22,0,3,80
721883,460276,2015-06-16,Senate,"Do pass",4,1,0,0,5
721883,475827,2015-09-03,Senate,"Assembly 3rd Reading AB277 Roger Hern",28,12,0,0,40
721886,432497,2015-04-13,Assembly,"Do pass and be re-referred to the Committee on Privacy and Consumer 	Protection",16,0,0,0,16
721886,436107,2015-04-21,Assembly,"Do pass as amended and be re-referred to the Committee on 	Appropriations",11,0,0,0,11
721886,453995,2015-05-28,Assembly,"Do pass as amended",16,0,0,1,17
721886,455921,2015-06-02,Assembly,"AB 287 GORDON  Assembly Third Reading",76,0,0,4,80
721886,554675,2016-06-21,Senate,"Do pass, but re-refer to the Committee on Judiciary",11,0,0,0,11
721886,556297,2016-06-28,Senate,"Do pass as amended, and re-refer to the Committee on Appropriations",7,0,0,0,7
721886,559631,2016-08-11,Senate,"Do pass as amended",7,0,0,0,7
721886,560636,2016-08-23,Senate,"Assembly 3rd Reading AB287 Gordon By Beall",39,0,0,0,39
721886,561602,2016-08-30,Assembly,"AB 287 GORDON  Concurrence in Senate Amendments",80,0,0,0,80
721893,415845,2015-03-24,Assembly,"Do pass and be re-referred to the Committee on Appropriations",6,0,0,1,7
721893,454402,2015-05-28,Assembly,"Do pass as amended",17,0,0,0,17
721893,456696,2015-06-03,Assembly,"AB 276 E.S.& T.M.  Assembly Third Reading  By ALEJO",78,0,0,2,80
721893,460698,2015-06-17,Senate,"Do pass, but re-refer to the Committee on Appropriations",7,0,0,0,7
721893,463880,2015-06-29,Senate,"Placed on Appropriations Suspense file",6,0,1,0,7
721893,474484,2015-08-27,Senate,"Do pass as amended",5,0,2,0,7
721893,475480,2015-09-01,Senate,"Assembly 3rd Reading AB276 Committee On E.S. & T.M. (Alejo) By 	Jackson",38,0,2,0,40
721893,475652,2015-09-02,Assembly,"AB 276 E.S.& T.M.  Concurrence in Senate Amendments By ALEJO",80,0,0,0,80
721897,416567,2015-03-24,Assembly,"Do pass and be re-referred to the Committee on Appropriations",4,0,0,3,7
721897,434134,2015-04-15,Assembly,"Do pass",11,0,0,6,17
721897,435249,2015-04-20,Assembly,"AB 275 E.S.& T.M.  Assembly Third Reading  By ALEJO",63,5,0,12,80
721897,460751,2015-06-17,Senate,"Do pass, but re-refer to the Committee on Appropriations",6,1,0,0,7
721897,475333,2015-08-31,Senate,"Assembly 3rd Reading AB275 Committee On E.S. & T.M. (Alejo) By 	Jackson",28,9,3,0,40
721897,475688,2015-09-02,Assembly,"AB 275 E.S.& T.M.  Concurrence in Senate Amendments By ALEJO",72,0,0,8,80
721900,445202,2015-05-11,Senate,"Placed on Appropriations Suspense file",7,0,0,0,7
721900,453787,2015-05-28,Senate,"Do pass as amended",7,0,0,0,7
721900,453788,2015-05-28,Senate,"Do pass as amended",7,0,0,0,7
721900,456652,2015-06-03,Senate,"Senate 3rd Reading SB212 Mendoza",40,0,0,0,40
721900,458669,2015-04-14,Senate,"Do pass as amended, and re-refer to the Committee on Appropriations",6,0,0,1,7
721900,464335,2015-06-30,Assembly,"Do pass as amended",7,0,0,0,7
721900,465806,2015-07-09,Assembly,"SB 212 Mendoza  Senate Third Reading  By LACKEY",78,0,0,2,80
721900,466560,2015-07-16,Senate,"Unfinished Business SB212 Mendoza Concurrence",36,0,4,0,40
721904,428499,2015-04-07,Assembly,"Do pass and be re-referred to the Committee on Education",12,0,0,1,13
721904,442222,2015-04-29,Assembly,"Do pass and be re-referred to the Committee on Appropriations to 	Consent Calendar",6,0,0,1,7
721904,454006,2015-05-28,Assembly,"Do pass",17,0,0,0,17
721904,455342,2015-06-01,Assembly,"AB 288 HOLDEN  Assembly Third Reading",80,0,0,0,80
721904,464710,2015-07-01,Senate,"Do pass as amended, and re-refer to the Committee on Appropriations",7,0,2,0,9
721904,473580,2015-08-17,Senate,"Placed on Appropriations Suspense file",7,0,0,0,7
721904,474635,2015-08-27,Senate,"Do pass as amended",7,0,0,0,7
721904,476066,2015-09-09,Senate,"Assembly 3rd Reading AB288 Holden By Leyva",40,0,0,0,40
721904,476287,2015-09-10,Assembly,"AB 288 HOLDEN  Concurrence in Senate Amendments",80,0,0,0,80
721907,415958,2015-03-24,Senate,"Do pass, but re-refer to the Committee on Appropriations",8,1,0,0,9
721907,438141,2015-04-23,Senate,"Senate 3rd Reading SB204 Pavley",35,2,0,2,39
721907,464277,2015-06-30,Assembly,"Do pass and be re-referred to the Committee on Natural Resources",12,2,0,1,15
721907,474402,2015-08-27,Assembly,"Do pass as amended",17,0,0,0,17
721907,475750,2015-09-03,Assembly,"SB 204 Pavley  Senate Third Reading  By LEVINE",79,0,0,1,80
721907,475843,2015-09-04,Senate,"Unfinished Business SB204 Pavley Concurrence",39,0,1,0,40
721914,415810,2015-03-24,Assembly,"Do pass and be re-referred to the Committee on Appropriations",5,0,0,2,7
721914,433979,2015-04-15,Assembly,"Do pass",11,0,0,6,17
721914,435240,2015-04-20,Assembly,"AB 273 E.S.& T.M.  Assembly Third Reading  By ALEJO",64,9,0,7,80
721914,460624,2015-06-17,Senate,"Do pass, but re-refer to the Committee on Appropriations",6,0,1,0,7
721914,475332,2015-08-31,Senate,"Assembly 3rd Reading AB273 Committee On E.S. & T.M. (Alejo) By 	Jackson",25,10,5,0,40
721914,475489,2015-09-01,Assembly,"AB 273 E.S.& T.M.  Concurrence in Senate Amendments By ALEJO",77,2,0,1,80
721919,436598,2015-04-21,Assembly,"Do pass as amended and be re-referred to the Committee on Human 	Services",11,0,0,3,14
721919,441105,2015-04-28,Assembly,"Do pass and be re-referred to the Committee on Appropriations",5,2,0,0,7
721919,453930,2015-05-28,Assembly,"Do pass as amended",12,5,0,0,17
721919,456660,2015-06-03,Assembly,"AB 282 EGGMAN  Assembly Third Reading",51,27,0,2,80
721923,432631,2015-04-15,Senate,"Do pass, but re-refer to the Committee on Appropriations Recommend 	Consent",7,0,0,0,7
721923,442120,2015-04-30,Senate,"Consent Calendar 2nd SB207 Wieckowski",34,0,5,0,39
721927,432612,2015-04-15,Senate,"Do pass, but re-refer to the Committee on Judiciary",6,1,0,0,7
721927,440072,2015-04-28,Senate,"Do pass, but re-refer to the Committee on Appropriations",6,0,1,0,7
721927,445097,2015-05-11,Senate,"Placed on Appropriations Suspense file",7,0,0,0,7
721931,415976,2015-03-24,Senate,"Do pass, but re-refer to the Committee on Environmental Quality",7,2,0,0,9
721931,432843,2015-04-15,Senate,"Do pass, but re-refer to the Committee on Appropriations",5,0,2,0,7
721931,453924,2015-05-28,Senate,"Do pass as amended",5,0,2,0,7
721931,456059,2015-06-02,Senate,"Senate 3rd Reading SB208 Lara",31,5,4,0,40
721931,464476,2015-06-30,Assembly,"Do pass and be re-referred to the Committee on Appropriations",15,0,0,0,15
721931,474254,2015-08-27,Assembly,"Do pass",17,0,0,0,17
721931,475493,2015-09-01,Assembly,"SB 208 Lara  Senate Third Reading  By RENDON",79,0,0,1,80
721935,432133,2015-04-13,Assembly,"Do pass as amended and be re-referred to the Committee on 	Appropriations",9,0,0,0,9
721935,437282,2015-04-22,Assembly,"Do pass as amended, to Consent Calendar",17,0,0,0,17
721935,442259,2015-04-30,Assembly,"AB 291 MEDINA  Consent Calendar Second Day  Regular Session",77,0,0,3,80
721935,559935,2016-08-16,Senate,"Assembly 3rd Reading AB291 Atkins By Hueso Urgency Claus",38,0,1,0,39
721935,560566,2016-08-22,Assembly,"AB 291 ATKINS  Concurrence- Urgency Added",78,0,0,2,80
721939,412339,2015-03-17,Assembly,"Do pass as amended and be re-referred to the Committee on Rules",10,0,0,0,10
721939,437914,2015-04-23,Assembly,"Do pass, to Consent Calendar",10,0,0,1,11
721939,443865,2015-05-06,Assembly,"Do pass as amended, to Consent Calendar",17,0,0,0,17
721939,447693,2015-05-18,Assembly,"AB 289 MELENDEZ  Consent Calendar Second Day",77,0,0,3,80
721939,461019,2015-06-16,Senate,"Do pass as amended, and re-refer to the Committee on Appropriations",7,0,0,0,7
721939,473719,2015-08-17,Senate,"Placed on Appropriations Suspense file",7,0,0,0,7
721947,429442,2015-04-08,Assembly,"Do pass and be re-referred to the Committee on Judiciary",7,0,0,0,7
721947,432614,2015-04-14,Assembly,"Amend, and do pass as amended and be re-referred to the Committee 	on Appropriations with the recommendation:  To Consent Calendar",10,0,0,0,10
721947,441119,2015-04-29,Assembly,"Do pass",17,0,0,0,17
721947,444496,2015-05-07,Assembly,"AB 272 LACKEY  Assembly Third Reading",75,0,0,5,80
721947,462637,2015-06-24,Senate,"Do pass, but re-refer to the Committee on Appropriations",5,0,0,0,5
721947,473613,2015-08-17,Senate,"Assembly 3rd Reading AB272 Lackey By Hertzberg",37,0,3,0,40
721951,440027,2015-04-27,Assembly,"Do pass and be re-referred to the Committee on Appropriations",6,3,0,0,9
721951,443910,2015-05-06,Assembly,"Do pass",16,1,0,0,17
721951,446722,2015-05-14,Assembly,"AB 279 DODD  Assembly Third Reading",67,9,0,4,80
721951,460721,2015-06-17,Senate,"Do pass, but re-refer to the Committee on Appropriations",6,1,0,0,7
721951,465738,2015-07-09,Senate,"Assembly 3rd Reading AB279 Dodd By Beall",33,6,1,0,40
721955,436491,2015-04-21,Assembly,"Do pass as amended and be re-referred to the Committee on Local 	Government",10,0,0,0,10
721955,440924,2015-04-29,Assembly,"Do pass and be re-referred to the Committee on Appropriations to 	Consent Calendar",9,0,0,0,9
721955,448931,2015-05-20,Assembly,"Do pass, to Consent Calendar",15,0,0,2,17
721955,451893,2015-05-26,Assembly,"AB 285 GALLAGHER  Consent Calendar Second Day  Regular Session",76,0,0,4,80
721955,466367,2015-07-14,Senate,"Do pass, but re-refer to the Committee on Appropriations",7,0,0,0,7
721955,474396,2015-08-27,Senate,"Assembly 3rd Reading AB285 Gallagher By Nielsen",38,0,2,0,40
721955,475331,2015-08-31,Assembly,"AB 285 GALLAGHER  Concurrence in Senate Amendments",80,0,0,0,80
721959,428804,2015-04-08,Assembly,"Do pass and be re-referred to the Committee on Banking and Finance 	to Consent Calendar",9,0,0,0,9
721959,430600,2015-04-13,Assembly,"Do pass, to Consent Calendar",11,0,0,1,12
721959,435233,2015-04-20,Assembly,"AB 283 DABABNEH  Consent Calendar Second Day  Regular Session",80,0,0,0,80
721959,460840,2015-06-17,Senate,"Do pass as amended, and re-refer to the Committee on Governance and 	Finance",7,0,0,0,7
721959,465793,2015-07-09,Senate,"Consent Calendar 2nd AB283 Dababneh",39,0,1,0,40
721959,465850,2015-07-13,Assembly,"AB 283 DABABNEH  Concurrence in Senate Amendments",79,0,0,1,80
721967,418654,2015-03-25,Assembly,"Do pass as amended and be re-referred to the Committee on 	Appropriations",5,1,0,1,7
721967,454480,2015-05-28,Assembly,"Do pass as amended",12,4,0,1,17
721967,457253,2015-06-04,Assembly,"AB 292 SANTIAGO  Assembly Third Reading",54,24,0,2,80
721967,473742,2015-08-17,Senate,"Placed on Appropriations Suspense file",7,0,0,0,7
721971,412425,2015-03-17,Assembly,"Do pass and be re-referred to the Committee on Appropriations",6,0,0,1,7
721971,416858,2015-03-25,Assembly,"Do pass, to Consent Calendar",16,0,0,1,17
721971,429428,2015-04-09,Assembly,"AB 293 LEVINE  Consent Calendar Second Day  Regular Session",78,0,0,2,80
721971,458348,2015-06-09,Senate,"Do pass, but re-refer to the Committee on Appropriations",7,0,0,0,7
721971,465182,2015-07-06,Senate,"Assembly 3rd Reading AB293 Levine By Vidak",39,0,1,0,40
721971,465762,2015-07-09,Assembly,"AB 293 LEVINE  Concurrence- Urgency Added",79,0,0,1,80
721975,441196,2015-04-29,Senate,"Do pass as amended, and re-refer to the Committee on Appropriations",7,0,2,0,9
721975,453738,2015-05-28,Senate,"Do pass as amended",7,0,0,0,7
721975,456605,2015-06-03,Senate,"Senate 3rd Reading SB210 Galgiani",40,0,0,0,40
721975,463574,2015-05-18,Senate,"Placed on Appropriations Suspense file",7,0,0,0,7
721975,466206,2015-07-15,Assembly,"Do pass and be re-referred to the Committee on Appropriations",7,0,0,0,7
721975,474369,2015-08-27,Assembly,"Do pass as amended",17,0,0,0,17
721975,475729,2015-09-03,Assembly,"SB 210 Galgiani  Senate Third Reading  By GALLAGHER",80,0,0,0,80
721975,476000,2015-09-08,Senate,"Unfinished Business SB210 Galgiani Concurrence",40,0,0,0,40
721979,440571,2015-04-28,Senate,"Do pass, but re-refer to the Committee on Appropriations",7,0,0,0,7
721979,445393,2015-05-11,Senate,"Placed on Appropriations Suspense file",7,0,0,0,7
721983,443644,2015-05-06,Assembly,"Do pass, to Consent Calendar",7,0,0,0,7
721983,446805,2015-05-14,Assembly,"AB 284 BROUGH  Consent Calendar Second Day  Regular Session",78,0,0,2,80
721983,457933,2015-06-08,Senate,"Do pass and be placed on the Consent Calendar",4,0,1,0,5
721983,461195,2015-06-18,Senate,"Consent Calendar 2nd AB284 Brough",37,0,3,0,40
721983,463048,2015-06-25,Assembly,"AB 284 BROUGH  Concurrence in Senate Amendments",80,0,0,0,80
721987,436105,2015-04-21,Assembly,"Do pass as amended and be re-referred to the Committee on 	Appropriations",14,0,0,0,14
721987,443893,2015-05-06,Assembly,"Do pass, to Consent Calendar",17,0,0,0,17
721987,446791,2015-05-14,Assembly,"AB 281 GALLAGHER  Consent Calendar Second Day  Regular Session",78,0,0,2,80
721987,459801,2015-06-15,Senate,"Do pass as amended, and re-refer to the Committee on Appropriations",9,0,0,0,9
721987,473573,2015-08-17,Senate,"Do pass",7,0,0,0,7
721987,476259,2015-09-10,Senate,"Assembly 3rd Reading AB281 Gallagher By Bates",40,0,0,0,40
721987,476619,2015-09-11,Assembly,"AB 281 GALLAGHER  Concurrence in Senate Amendments",79,0,0,1,80
724568,485052,2016-01-13,Senate,"Do pass, but re-refer to the Committee on Appropriations",10,0,1,0,11
724568,485572,2016-01-19,Senate,"Placed on Appropriations Suspense file",7,0,0,0,7
724568,486317,2016-01-21,Senate,"Do pass",7,0,0,0,7
724568,487738,2016-01-26,Senate,"Senate 3rd Reading SB215 Leno",37,0,3,0,40
724568,556771,2016-06-29,Assembly,"Do pass as amended and be re-referred to the Committee on 	Appropriations",14,0,0,1,15
724568,559325,2016-08-11,Assembly,"Do pass",15,0,0,5,20
724568,560530,2016-08-22,Assembly,"SB 215 Leno  Senate Third Reading  By GATTO",79,0,0,1,80
724568,561158,2016-08-25,Senate,"Unfinished Business SB215 Leno Concurrence",36,0,3,0,39
724581,416010,2015-03-23,Assembly,"Do pass as amended and be re-referred to the Committee on 	Appropriations",8,0,0,1,9
724581,454064,2015-05-28,Assembly,"Do pass as amended",17,0,0,0,17
724581,455935,2015-06-02,Assembly,"AB 300 ALEJO  Assembly Third Reading",77,0,0,3,80
724581,462094,2015-06-23,Senate,"Do pass as amended, and re-refer to the Committee on Environmental 	Quality",9,0,0,0,9
724581,466272,2015-07-15,Senate,"Do pass, but re-refer to the Committee on Appropriations",7,0,0,0,7
724581,473664,2015-08-17,Senate,"Placed on Appropriations Suspense file",7,0,0,0,7
724595,432573,2015-04-14,Senate,"Do pass, but re-refer to the Committee on Public Employment and 	Retirement",5,0,0,0,5
724595,439488,2015-04-27,Senate,"Do pass, but re-refer to the Committee on Appropriations",5,0,0,0,5
724595,445198,2015-05-11,Senate,"Placed on Appropriations Suspense file",7,0,0,0,7
724595,453819,2015-05-28,Senate,"Do pass",7,0,0,0,7
724595,455363,2015-06-01,Senate,"Senate 3rd Reading SB221 Jackson",40,0,0,0,40
724595,462568,2015-06-24,Assembly,"Do pass and be re-referred to the Committee on Veterans Affairs to 	Consent Calendar",6,0,0,1,7
724595,464684,2015-06-30,Assembly,"Do pass and be re-referred to the Committee on Appropriations",8,0,0,1,9
724595,474331,2015-08-27,Assembly,"Do pass",17,0,0,0,17
724595,475481,2015-09-01,Assembly,"SB 221 Jackson  Senate Third Reading  By IRWIN",80,0,0,0,80
724595,475653,2015-09-02,Senate,"Unfinished Business SB221 Jackson Concurrence",40,0,0,0,40
724609,442205,2015-04-29,Assembly,"Amend, and do pass as amended and be re-referred to the Committee 	on Appropriations with the recommendation:  To Consent Calendar",6,0,0,1,7
724609,448918,2015-05-20,Assembly,"Do pass",15,0,0,2,17
724609,453701,2015-05-28,Assembly,"AB 306 HADLEY  Assembly Third Reading",78,0,0,2,80
724609,464740,2015-07-01,Senate,"Do pass as amended, but re-refer to the Committee on Appropriations 	Recommend Consent",7,0,2,0,9
724609,474158,2015-08-24,Senate,"Assembly 3rd Reading AB306 Hadley By Allen",40,0,0,0,40
724609,474459,2015-08-27,Assembly,"AB 306 HADLEY  Concurrence in Senate Amendments",79,0,0,1,80
724679,443959,2015-05-06,Assembly,"Do pass, to Consent Calendar",9,0,0,0,9
724679,446901,2015-05-14,Assembly,"AB 313 ATKINS  Consent Calendar Second Day  Regular Session",78,0,0,2,80
724679,465619,2015-07-08,Senate,"Do pass, but re-refer to the Committee on Transportation and 	Housing Recommend Consent",7,0,0,0,7
724679,466064,2015-07-14,Senate,"Do pass and be placed on the Consent Calendar",11,0,0,0,11
724679,475313,2015-08-31,Senate,"Assembly 3rd Reading AB313 Atkins By Beall",40,0,0,0,40
724679,475488,2015-09-01,Assembly,"AB 313 ATKINS  Concurrence in Senate Amendments",80,0,0,0,80
724693,428357,2015-04-08,Senate,"Do pass as amended",6,0,1,0,7
724693,437929,2015-04-23,Senate,"Senate 3rd Reading SB222 Block",38,0,0,1,39
724693,460659,2015-06-17,Assembly,"Do pass",9,0,0,0,9
724693,462935,2015-06-25,Assembly,"SB 222 Block  Senate Third Reading  By MAIENSCHEIN",79,0,0,1,80
724693,463835,2015-06-29,Senate,"Unfinished Business SB222 Block Concurrence",37,0,3,0,40
724707,427777,2015-04-07,Assembly,"Amend, and do pass as amended and be re-referred to the Committee 	on Appropriations with the recommendation:  To Consent Calendar",18,0,0,1,19
724707,437118,2015-04-22,Assembly,"Do pass, to Consent Calendar",17,0,0,0,17
724707,442357,2015-04-30,Assembly,"AB 294 LACKEY  Consent Calendar Second Day  Regular Session",77,0,0,3,80
724707,458362,2015-06-09,Senate,"Do pass, but re-refer to the Committee on Appropriations",5,0,0,0,5
724707,473946,2015-08-20,Senate,"Assembly 3rd Reading AB294 Lackey By Runner",38,0,2,0,40
724707,474100,2015-08-24,Assembly,"AB 294 LACKEY  Concurrence in Senate Amendments",79,0,0,1,80
724721,416111,2015-03-23,Assembly,"Do pass and be re-referred to the Committee on Water, Parks and 	Wildlife",2,7,0,0,9
724721,440280,2015-04-27,Assembly,"Do pass and be re-referred to the Committee on Appropriations",3,6,0,0,9
724721,463665,2015-03-23,Assembly,"Reconsideration granted",9,0,0,0,9
724735,432886,2015-04-14,Assembly,"Do pass, to Consent Calendar",15,0,0,0,15
724735,435170,2015-04-20,Assembly,"AB 298 GONZALEZ  Consent Calendar Second Day  Regular Session",80,0,0,0,80
724735,458508,2015-06-09,Senate,"Do pass as amended. To Consent Calendar",9,0,0,0,9
724735,461324,2015-06-18,Senate,"Consent Calendar 2nd AB298 Gonzalez",37,0,3,0,40
724735,461820,2015-06-22,Assembly,"AB 298 GONZALEZ  Concurrence in Senate Amendments",76,1,0,3,80
724749,412380,2015-03-17,Assembly,"Do pass and be re-referred to the Committee on Appropriations",10,0,0,1,11
724749,416728,2015-03-25,Assembly,"Do pass",15,0,0,2,17
724749,429273,2015-04-09,Assembly,"AB 296 DODD  Assembly Third Reading",74,0,0,6,80
724749,457917,2015-06-08,Senate,"Do pass, but re-refer to the Committee on Appropriations",9,0,0,0,9
724749,463823,2015-06-29,Senate,"Do pass",6,0,1,0,7
724749,465156,2015-07-06,Senate,"Assembly 3rd Reading AB296 Dodd By Galgiani",38,0,2,0,40
724763,429399,2015-04-08,Assembly,"Do pass as amended and be re-referred to the Committee on 	Appropriations",6,1,0,0,7
724763,454069,2015-05-28,Assembly,"Do pass as amended",12,4,0,1,17
724763,456618,2015-06-03,Assembly,"AB 302 GARCIA, C.  Assembly Third Reading",60,17,0,3,80
724763,465616,2015-07-08,Senate,"Do pass as amended, and re-refer to the Committee on Appropriations",7,1,1,0,9
724763,473739,2015-08-17,Senate,"Placed on Appropriations Suspense file",7,0,0,0,7
724763,474618,2015-08-27,Senate,"Do pass",5,2,0,0,7
724763,475517,2015-09-01,Senate,"Assembly 3rd Reading AB302 Cristina Garcia By Liu",28,9,3,0,40
724763,475812,2015-09-03,Assembly,"AB 302 GARCIA, C.  Concurrence in Senate Amendments",62,14,0,4,80
724790,437162,2015-04-21,Assembly,"Do pass as amended and be re-referred to the Committee on 	Appropriations",19,0,0,0,19
724805,482972,2015-12-09,Assembly,"Be referred to Committee on Water, Parks and Wildlife",8,0,0,3,11
724805,485024,2016-01-12,Assembly,"Do pass and be re-referred to the Committee on Appropriations",7,3,0,5,15
724819,432309,2015-04-13,Assembly,"Do pass as amended and be re-referred to the Committee on 	Appropriations",9,0,0,0,9
724819,437220,2015-04-22,Assembly,"Do pass, to Consent Calendar",17,0,0,0,17
724819,442219,2015-04-30,Assembly,"AB 301 BIGELOW  Consent Calendar Second Day  Regular Session",77,0,0,3,80
724819,458316,2015-06-09,Senate,"Do pass, but re-refer to the Committee on Appropriations Recommend 	Consent",9,0,0,0,9
724819,463921,2015-06-29,Senate,"Consent Calendar 2nd AB301 Bigelow",39,0,1,0,40
724819,464937,2015-07-02,Assembly,"AB 301 BIGELOW  Concurrence in Senate Amendments",78,0,0,2,80
724833,427903,2015-04-07,Assembly,"Do pass",6,1,0,4,11
724833,450233,2015-05-22,Assembly,"AB 312 JONES  Assembly Third Reading",49,15,0,16,80
724875,427805,2015-04-07,Senate,"Do pass, but re-refer to the Committee on Appropriations",5,2,0,0,7
724875,435272,2015-04-20,Senate,"Placed on Appropriations Suspense file",7,0,0,0,7
724875,454054,2015-05-28,Senate,"Do pass as amended",5,2,0,0,7
724875,455913,2015-06-02,Senate,"Senate 3rd Reading SB219 Liu",24,14,2,0,40
724875,464410,2015-06-30,Assembly,"Do pass and be re-referred to the Committee on Appropriations",7,0,0,0,7
724875,473880,2015-08-19,Assembly,"Do pass",12,5,0,0,17
724875,474288,2015-08-27,Assembly,"SB 219 Liu  Senate Third Reading  By QUIRK",61,15,0,4,80
724875,475390,2015-09-01,Senate,"Unfinished Business SB219 Liu Concurrence",25,14,1,0,40
724889,436230,2015-04-21,Senate,"Do pass, but re-refer to the Committee on Natural Resources and 	Water",9,1,1,0,11
724889,445763,2015-05-12,Senate,"Do pass",2,2,5,0,9
724889,445764,2015-05-12,Senate,"Set, first hearing.  Failed passage in Committee.  Reconsideration 	granted",9,0,0,0,9
724903,432611,2015-04-15,Assembly,"Do pass and be re-referred to the Committee on Appropriations to 	Consent Calendar",10,0,0,0,10
724903,437293,2015-04-22,Assembly,"Do pass, to Consent Calendar",17,0,0,0,17
724903,442387,2015-04-30,Assembly,"AB 315 BIGELOW  Consent Calendar Second Day  Regular Session",77,0,0,3,80
724903,474293,2015-08-27,Senate,"Assembly 3rd Reading AB315 Bigelow By Nielsen",34,0,6,0,40
724903,475258,2015-08-31,Assembly,"AB 315 BIGELOW  Concurrence- Urgency Added",80,0,0,0,80
724931,436138,2015-04-21,Assembly,"Do pass and be re-referred to the Committee on Appropriations to 	Consent Calendar",7,0,0,0,7
724931,441026,2015-04-29,Assembly,"Do pass, to Consent Calendar",17,0,0,0,17
724931,444449,2015-05-07,Assembly,"AB 303 GONZALEZ  Consent Calendar Second Day  Regular Session",77,0,0,3,80
724931,458353,2015-06-09,Senate,"Do pass, but re-refer to the Committee on Appropriations",7,0,0,0,7
724931,462014,2015-06-22,Senate,"Placed on Appropriations Suspense file",6,0,1,0,7
724931,474690,2015-08-27,Senate,"Do pass as amended",7,0,0,0,7
724931,475694,2015-09-02,Senate,"Assembly 3rd Reading AB303 Gonzalez By Nguyen",38,0,2,0,40
724931,475811,2015-09-03,Assembly,"AB 303 GONZALEZ  Concurrence in Senate Amendments",77,0,0,3,80
724945,443658,2015-05-06,Assembly,"Do pass",9,4,0,0,13
724945,445175,2015-05-11,Assembly,"AB 305 GONZALEZ  Assembly Third Reading",59,18,0,3,80
724945,462608,2015-06-24,Senate,"Do pass, but re-refer to the Committee on Rules",4,1,0,0,5
724945,465854,2015-07-13,Senate,"Placed on Appropriations Suspense file",7,0,0,0,7
724945,474585,2015-08-27,Senate,"Do pass",5,2,0,0,7
724945,475943,2015-09-08,Senate,"Assembly 3rd Reading AB305 Gonzalez By Block",24,15,1,0,40
724945,476137,2015-09-09,Assembly,"AB 305 GONZALEZ  Concurrence in Senate Amendments",60,20,0,0,80
724973,431240,2015-04-13,Senate,"Do pass, but re-refer to the Committee on Appropriations Recommend 	Consent",5,0,0,0,5
724973,442338,2015-04-30,Senate,"Consent Calendar 2nd SB216 Pan",34,0,5,0,39
724973,462785,2015-06-24,Assembly,"Do pass and be re-referred to the Committee on Appropriations to 	Consent Calendar",6,0,0,1,7
724973,465720,2015-07-08,Assembly,"Do pass, to Consent Calendar",14,0,0,3,17
724973,466489,2015-07-16,Assembly,"SB 216 Pan  Consent Calendar Second Day  Regular Session",79,0,0,1,80
724973,473982,2015-08-20,Senate,"Special Consent #6 SB216 Pan",38,0,2,0,40
725001,438201,2015-04-22,Assembly,"Do pass as amended and be re-referred to the Committee on 	Appropriations",5,1,0,1,7
725001,453011,2015-05-27,Assembly,"Do pass as amended",11,5,0,1,17
725001,461798,2015-06-22,Assembly,"AB 304 GONZALEZ  Third Reading Urgency",69,0,0,11,80
725001,465876,2015-07-13,Senate,"Assembly 3rd Reading AB304 Gonzalez By Mendoza",39,0,1,0,40
726090,438305,2015-04-22,Assembly,"Do pass and be re-referred to the Committee on Appropriations",6,1,0,0,7
726090,453681,2015-05-28,Assembly,"Do pass",12,5,0,0,17
726090,455886,2015-06-02,Assembly,"AB 329 WEBER  Assembly Third Reading",51,25,0,4,80
726090,464696,2015-07-01,Senate,"Do pass, but re-refer to the Committee on Appropriations",5,2,2,0,9
726090,465882,2015-07-13,Senate,"Placed on Appropriations Suspense file",7,0,0,0,7
726090,474632,2015-08-27,Senate,"Do pass as amended",5,2,0,0,7
726090,476265,2015-09-10,Senate,"Assembly 3rd Reading AB329 Weber By Liu",26,14,0,0,40
726090,476548,2015-09-11,Assembly,"AB 329 WEBER  Concurrence in Senate Amendments",51,26,0,3,80
726094,436038,2015-04-21,Assembly,"Do pass as amended and be re-referred to the Committee on 	Appropriations",14,0,0,0,14
726094,443904,2015-05-06,Assembly,"Do pass, to Consent Calendar",17,0,0,0,17
726094,447782,2015-05-18,Assembly,"AB 317 MAIENSCHEIN  Assembly Third Reading",77,0,0,3,80
726094,465466,2015-07-06,Senate,"Do pass, but re-refer to the Committee on Appropriations",8,0,1,0,9
726094,475429,2015-09-01,Senate,"Assembly 3rd Reading AB317 Maienschein By Block",38,0,2,0,40
726094,475596,2015-09-02,Assembly,"AB 317 MAIENSCHEIN  Concurrence in Senate Amendments",80,0,0,0,80
726095,483909,2016-01-06,Assembly,"Do pass",7,0,0,0,7
726095,485030,2016-01-15,Assembly,"AB 326 FRAZIER  Assembly Third Reading",70,0,0,9,79
726095,552196,2016-06-08,Senate,"Do pass as amended, and re-refer to the Committee on Appropriations",4,0,1,0,5
726095,559924,2016-08-15,Senate,"Assembly 3rd Reading AB326 Frazier By Cannella",38,0,1,0,39
726095,560251,2016-08-18,Assembly,"AB 326 FRAZIER  Concurrence in Senate Amendments",79,0,0,1,80
726098,415806,2015-03-24,Assembly,"Do pass as amended and be re-referred to the Committee on 	Appropriations",5,1,0,1,7
726099,427824,2015-04-07,Assembly,"Do pass as amended and be re-referred to the Committee on 	Appropriations",10,0,0,0,10
726099,440929,2015-04-29,Assembly,"Do pass, to Consent Calendar",17,0,0,0,17
726099,445206,2015-05-11,Assembly,"AB 318 CHAU  Assembly Third Reading",74,2,0,4,80
726101,416947,2015-03-25,Senate,"Do pass, but re-refer to the Committee on Appropriations",8,0,0,0,8
726101,442218,2015-04-30,Senate,"Senate 3rd Reading SB232 Hall",35,0,4,0,39
726101,461126,2015-06-17,Assembly,"Do pass and be re-referred to the Committee on Appropriations to 	Consent Calendar",7,0,0,0,7
726101,465621,2015-07-08,Assembly,"Do pass, to Consent Calendar",14,0,0,3,17
726101,466456,2015-07-16,Assembly,"SB 232 Hall  Consent Calendar Second Day  Regular Session",79,0,0,1,80
726104,448396,2015-05-18,Assembly,"Do pass as amended and be re-referred to the Committee on 	Appropriations",8,0,0,1,9
726105,416120,2015-03-23,Assembly,"Do pass as amended and be re-referred to the Committee on 	Transportation",9,0,0,0,9
726105,436162,2015-04-20,Assembly,"Do pass, to Consent Calendar",15,0,0,1,16
726105,439440,2015-04-27,Assembly,"AB 323 OLSEN  Consent Calendar Second Day  Regular Session",79,0,0,1,80
726105,460619,2015-06-17,Senate,"Do pass and be placed on the Consent Calendar",7,0,0,0,7
726105,461898,2015-06-22,Senate,"Consent Calendar 2nd AB323 Olsen",37,0,3,0,40
726107,440351,2015-04-28,Senate,"Do pass, but re-refer to the Committee on Appropriations",6,1,2,0,9
726107,445364,2015-05-11,Senate,"Placed on Appropriations Suspense file",7,0,0,0,7
726107,453816,2015-05-28,Senate,"Do pass as amended",7,0,0,0,7
726107,456731,2015-06-03,Senate,"Senate 3rd Reading SB233 Hertzberg",37,2,1,0,40
726107,466326,2015-07-14,Assembly,"Do pass as amended and be re-referred to the Committee on 	Appropriations",12,0,0,3,15
726108,440096,2015-04-28,Senate,"Do pass as amended, and re-refer to the Committee on Appropriations",7,1,1,0,9
726108,445248,2015-05-11,Senate,"Placed on Appropriations Suspense file",7,0,0,0,7
726108,453685,2015-05-28,Senate,"Do pass",5,2,0,0,7
726108,455524,2015-06-01,Senate,"Senate 3rd Reading SB223 Galgiani Urgency Clause",29,11,0,0,40
726108,466226,2015-07-14,Assembly,"Do pass and be re-referred to the Committee on Appropriations",10,4,0,1,15
726112,436131,2015-04-21,Assembly,"Do pass as amended and be re-referred to the Committee on 	Appropriations",14,0,0,0,14
726112,443954,2015-05-06,Assembly,"Do pass, to Consent Calendar",17,0,0,0,17
726112,447757,2015-05-18,Assembly,"AB 316 MAIENSCHEIN  Assembly Third Reading",77,0,0,3,80
726112,465433,2015-07-06,Senate,"Do pass, but re-refer to the Committee on Appropriations",6,0,3,0,9
726112,473809,2015-08-17,Senate,"Placed on Appropriations Suspense file",7,0,0,0,7
726112,474509,2015-08-27,Senate,"Do pass as amended",6,0,1,0,7
726112,475689,2015-09-02,Senate,"Assembly 3rd Reading AB316 Maienschein By Galgiani",36,2,2,0,40
726112,475803,2015-09-03,Assembly,"AB 316 MAIENSCHEIN  Concurrence in Senate Amendments",78,0,0,2,80
726114,440311,2015-04-28,Senate,"Do pass, but re-refer to the Committee on Appropriations",5,2,0,0,7
726114,451756,2015-05-26,Senate,"Senate 3rd Reading SB230 Hancock",21,15,3,0,39
726114,460166,2015-06-16,Assembly,"Do pass and be re-referred to the Committee on Appropriations",4,1,0,2,7
726114,465571,2015-07-08,Assembly,"Do pass",10,4,0,3,17
726114,475352,2015-08-31,Assembly,"SB 230 Hancock  Senate Third Reading  By QUIRK",41,35,0,4,80
726114,475620,2015-09-02,Senate,"Unfinished Business SB230 Hancock Concurrence",23,15,2,0,40
726115,437215,2015-04-22,Assembly,"Do pass and be re-referred to the Committee on Transportation",6,3,0,0,9
726115,439987,2015-04-27,Assembly,"Do pass and be re-referred to the Committee on Appropriations",11,5,0,0,16
726115,443846,2015-05-06,Assembly,"Do pass",12,5,0,0,17
726115,445224,2015-05-11,Assembly,"AB 338 HERNANDEZ  Assembly Third Reading",49,29,0,2,80
726117,444249,2015-05-06,Assembly,"Do pass, to Consent Calendar",9,0,0,0,9
726117,446813,2015-05-14,Assembly,"AB 347 CHANG  Consent Calendar Second Day  Regular Session",78,0,0,2,80
726117,465679,2015-07-08,Senate,"Do pass",7,0,0,0,7
726117,475322,2015-08-31,Senate,"Special Consent #8 AB347 Chang By Huff",40,0,0,0,40
726117,475498,2015-09-01,Assembly,"AB 347 CHANG  Concurrence in Senate Amendments",79,0,0,1,80
726118,440017,2015-04-28,Senate,"Do pass, but re-refer to the Committee on Appropriations",11,0,0,0,11
726118,454117,2015-05-28,Senate,"Do pass as amended",7,0,0,0,7
726118,457368,2015-06-04,Senate,"Senate 3rd Reading SB231 Gaines",36,0,4,0,40
726118,463732,2015-05-18,Senate,"Placed on Appropriations Suspense file",7,0,0,0,7
726118,463993,2015-06-29,Assembly,"Do pass and be re-referred to the Committee on Natural Resources",16,0,0,0,16
726118,466122,2015-07-13,Assembly,"Do pass and be re-referred to the Committee on Appropriations to 	Consent Calendar",9,0,0,0,9
726118,473896,2015-08-19,Assembly,"Do pass, to Consent Calendar",17,0,0,0,17
726118,474448,2015-08-27,Assembly,"SB 231 Gaines  Consent Calendar Second Day  Regular Session",78,0,0,2,80
726119,436156,2015-04-21,Assembly,"Do pass as amended and be re-referred to the Committee on 	Appropriations",14,0,0,0,14
726119,443926,2015-05-06,Assembly,"Do pass",17,0,0,0,17
726119,445207,2015-05-11,Assembly,"AB 320 WOOD  Assembly Third Reading",79,0,0,1,80
726119,465518,2015-07-06,Senate,"Do pass as amended, and re-refer to the Committee on Appropriations",6,2,1,0,9
726119,473708,2015-08-17,Senate,"Placed on Appropriations Suspense file",7,0,0,0,7
726121,441186,2015-04-28,Assembly,"Do pass as amended and be re-referred to the Committee on 	Appropriations",12,5,0,2,19
726121,454005,2015-05-28,Assembly,"Do pass as amended",12,5,0,0,17
726121,456622,2015-06-03,Assembly,"AB 339 GORDON  Assembly Third Reading",48,30,0,2,80
726121,466517,2015-07-15,Senate,"Do pass as amended, and re-refer to the Committee on Appropriations",7,2,0,0,9
726121,473700,2015-08-17,Senate,"Placed on Appropriations Suspense file",7,0,0,0,7
726121,474576,2015-08-27,Senate,"Do pass as amended",5,2,0,0,7
726121,476415,2015-09-10,Senate,"Assembly 3rd Reading AB339 Gordon By Monning",25,13,2,0,40
726121,476482,2015-09-11,Assembly,"AB 339 GORDON  Concurrence in Senate Amendments",50,27,0,3,80
726122,428713,2015-04-08,Assembly,"Do pass and be re-referred to the Committee on Aging and Long",9,4,0,0,13
726122,436161,2015-04-21,Assembly,"Do pass as amended and be re-referred to the Committee on 	Appropriations",7,0,0,0,7
726122,443832,2015-05-06,Assembly,"Do pass",12,5,0,0,17
726122,445147,2015-05-11,Assembly,"AB 332 CALDERON  Assembly Third Reading",59,16,0,5,80
726122,462602,2015-06-24,Senate,"Do pass, but re-refer to the Committee on Appropriations",6,1,2,0,9
726122,465183,2015-07-06,Senate,"Do pass as amended",5,0,2,0,7
726122,475464,2015-09-01,Senate,"Assembly 3rd Reading AB332 Calderon By Liu",26,12,2,0,40
726122,475766,2015-09-03,Assembly,"AB 332 CALDERON  Concurrence in Senate Amendments",60,18,0,2,80
726124,411817,2015-03-16,Assembly,"From committee:  Be adopted.  To third reading",11,0,0,0,11
726124,437801,2015-04-23,Senate,"Assembly 3rd Reading ACR24 Chu By Beall",37,0,0,2,39
726128,437371,2015-04-21,Senate,"Do pass, but re-refer to the Committee on Appropriations",7,0,0,0,7
726128,442874,2015-05-04,Senate,"Placed on Appropriations Suspense file",7,0,0,0,7
726128,454181,2015-05-28,Senate,"Do pass as amended",7,0,0,0,7
726128,456550,2015-06-03,Senate,"Senate 3rd Reading SB229 Roth",40,0,0,0,40
726128,462106,2015-06-23,Assembly,"Do pass and be re-referred to the Committee on Appropriations",9,0,0,1,10
726128,474360,2015-08-27,Assembly,"Do pass as amended",16,0,0,1,17
726128,475677,2015-09-02,Assembly,"SB 229 Roth  Senate Third Reading  By BROWN",80,0,0,0,80
726128,475800,2015-09-03,Senate,"Unfinished Business SB229 Roth Concurrence",38,0,2,0,40
726129,440015,2015-04-28,Assembly,"Do pass as amended and be re-referred to the Committee on 	Appropriations",14,0,0,0,14
726129,446264,2015-05-13,Assembly,"Do pass, to Consent Calendar",17,0,0,0,17
726129,450143,2015-05-22,Assembly,"AB 333 MELENDEZ  Consent Calendar Second Day  Regular Session",74,0,0,6,80
726129,461794,2015-06-22,Senate,"Do pass as amended, and re-refer to the Committee on Appropriations",9,0,0,0,9
726129,475370,2015-08-31,Senate,"Assembly 3rd Reading AB333 Melendez By Jackson",40,0,0,0,40
726129,475414,2015-09-01,Assembly,"AB 333 MELENDEZ  Concurrence in Senate Amendments",79,0,0,1,80
726131,440956,2015-04-28,Assembly,"Do pass and be re-referred to the Committee on Appropriations",10,2,0,1,13
726131,453874,2015-05-28,Assembly,"Do pass as amended",12,5,0,0,17
726131,456646,2015-06-03,Assembly,"AB 340 WEBER  Assembly Third Reading",63,16,0,1,80
726131,466298,2015-07-15,Senate,"Do pass, but re-refer to the Committee on Appropriations",8,0,1,0,9
726131,473651,2015-08-17,Senate,"Placed on Appropriations Suspense file",7,0,0,0,7
726131,474664,2015-08-27,Senate,"Do pass",5,2,0,0,7
726131,475724,2015-09-03,Senate,"Assembly 3rd Reading AB340 Weber By Block",30,10,0,0,40
726131,475908,2015-09-08,Assembly,"AB 340 WEBER  Concurrence in Senate Amendments",63,15,0,2,80
726132,432596,2015-04-13,Assembly,"Do pass",16,0,0,0,16
726132,433886,2015-04-16,Assembly,"AB 346 WILK  Assembly Third Reading",78,1,0,1,80
726132,458355,2015-06-09,Senate,"Do pass",7,0,0,0,7
726132,461832,2015-06-22,Senate,"Special Consent #3 AB346 Wilk",37,0,3,0,40
726135,446260,2015-05-13,Assembly,"Do pass, to Consent Calendar",9,0,0,0,9
726135,450206,2015-05-22,Assembly,"AB 341 ACHADJIAN  Consent Calendar Second Day  Regular Session",74,0,0,6,80
726135,458772,2015-06-10,Senate,"Do pass and be placed on the Consent Calendar",7,0,0,0,7
726135,461141,2015-06-18,Senate,"Consent Calendar 2nd AB341 Achadjian",37,0,3,0,40
726136,437287,2015-04-21,Senate,"Do pass as amended",5,2,0,0,7
726136,444469,2015-05-07,Senate,"Senate 3rd Reading SB227 Mitchell",23,12,4,0,39
726136,460190,2015-06-16,Assembly,"Do pass",5,2,0,0,7
726136,466486,2015-07-16,Assembly,"SB 227 Mitchell  Senate Third Reading  By QUIRK",41,33,0,6,80
726138,444421,2015-05-06,Assembly,"Do pass, to Consent Calendar",7,0,0,0,7
726138,446608,2015-05-14,Assembly,"AB 327 GORDON  Consent Calendar Second Day  Regular Session",78,0,0,2,80
726138,458698,2015-06-10,Senate,"Do pass",5,0,0,0,5
726138,461814,2015-06-22,Senate,"Special Consent #3 AB327 Gordon",37,0,3,0,40
726139,431718,2015-04-13,Assembly,"Do pass and be re-referred to the Committee on Appropriations",3,6,0,0,9
726141,432584,2015-04-15,Senate,"Do pass, but re-refer to the Committee on Appropriations",5,2,0,0,7
726141,442891,2015-05-04,Senate,"Senate 3rd Reading SB225 Wieckowski",24,11,4,0,39
726141,459838,2015-06-15,Assembly,"Be referred to Committee on Environmental Safety and Toxic 	Materials",10,0,0,1,11
726141,464382,2015-06-30,Assembly,"Do pass as amended and be re-referred to the Committee on 	Appropriations",7,0,0,0,7
726141,473893,2015-08-19,Assembly,"Do pass, to Consent Calendar",17,0,0,0,17
726141,474308,2015-08-27,Assembly,"SB 225 Wieckowski  Consent Calendar Second Day",78,0,0,2,80
726141,475882,2015-09-04,Senate,"Unfinished Business SB225 Wieckowski Urgency Clause",36,0,4,0,40
726141,485060,2015-09-03,Senate,"From committee:  That the Assembly Amendments be concurred in",7,0,0,0,7
726142,418775,2015-03-25,Assembly,"Amend, and do pass as amended and be re-referred to the Committee 	on Appropriations with the recommendation:  To Consent Calendar",6,0,0,1,7
726142,437661,2015-04-22,Assembly,"Do pass, to Consent Calendar",17,0,0,0,17
726142,442166,2015-04-30,Assembly,"AB 331 LEVINE  Consent Calendar Second Day  Regular Session",77,0,0,3,80
726142,458743,2015-06-10,Senate,"Do pass, but re-refer to the Committee on Appropriations Recommend 	Consent",8,0,0,1,9
726142,462000,2015-06-22,Senate,"Do pass",6,0,1,0,7
726142,463839,2015-06-29,Senate,"Assembly 3rd Reading AB331 Levine By Runner",39,0,1,0,40
726144,427847,2015-04-07,Senate,"Do pass, but re-refer to the Committee on Appropriations",5,2,0,0,7
726144,435225,2015-04-20,Senate,"Placed on Appropriations Suspense file",7,0,0,0,7
726144,453806,2015-05-28,Senate,"Do pass as amended",5,2,0,0,7
726145,416009,2015-03-24,Senate,"Do pass, but re-refer to the Committee on Appropriations Recommend 	Consent",9,0,0,0,9
726145,430617,2015-04-13,Senate,"Placed on Appropriations Suspense file",7,0,0,0,7
726146,441536,2015-04-29,Assembly,"Do pass and be re-referred to the Committee on Appropriations",6,0,0,1,7
726146,454072,2015-05-28,Assembly,"Do pass as amended",17,0,0,0,17
726146,456149,2015-06-02,Assembly,"AB 325 WOOD  Assembly Third Reading",77,0,0,3,80
726146,465403,2015-07-07,Senate,"Do pass, but re-refer to the Committee on Appropriations Recommend 	Consent",11,0,0,0,11
726146,473956,2015-08-20,Senate,"Consent Calendar 2nd AB325 Wood",38,0,2,0,40
726146,475433,2015-09-01,Assembly,"AB 325 WOOD  Concurrence in Senate Amendments",79,0,0,1,80
726148,437232,2015-04-21,Assembly,"Do pass and be re-referred to the Committee on Appropriations to 	Consent Calendar",18,0,0,1,19
726149,438037,2015-04-22,Assembly,"Do pass as amended and be re-referred to the Committee on 	Appropriations",6,1,0,0,7
726151,432811,2015-04-14,Senate,"Do pass, but re-refer to the Committee on Judiciary",6,2,1,0,9
726151,440070,2015-04-28,Senate,"Do pass as amended, and re-refer to the Committee on Appropriations",5,1,1,0,7
726151,451657,2015-05-26,Senate,"Senate 3rd Reading SB226 Pavley",23,14,2,0,39
726151,464588,2015-06-30,Assembly,"Do pass and be re-referred to the Committee on Judiciary",8,5,0,2,15
726151,465484,2015-07-07,Assembly,"Do pass and be re-referred to the Committee on Appropriations",7,3,0,0,10
726151,474278,2015-08-27,Assembly,"Do pass as amended",12,0,0,5,17
726151,476230,2015-09-10,Assembly,"SB 226 Pavley  Senate Third Reading  By ALEJO",74,3,0,3,80
726151,476488,2015-09-11,Senate,"Unfinished Business SB226 Pavley Concurrence",40,0,0,0,40
726152,432599,2015-04-14,Assembly,"Do pass and be re-referred to the Committee on Appropriations to 	Consent Calendar",14,0,0,0,14
726152,441065,2015-04-29,Assembly,"Do pass, to Consent Calendar",17,0,0,0,17
726152,444532,2015-05-07,Assembly,"AB 345 FRAZIER  Consent Calendar Second Day  Regular Session",77,0,0,3,80
726152,458035,2015-06-08,Senate,"Do pass, but re-refer to the Committee on Appropriations",9,0,0,0,9
726152,462973,2015-06-25,Senate,"Assembly 3rd Reading AB345 Frazier By Galgiani",37,0,3,0,40
728008,446222,2015-05-13,Assembly,"Do pass as amended",7,0,0,0,7
728008,453067,2015-05-27,Assembly,"Do pass, to Consent Calendar",17,0,0,0,17
728008,456049,2015-06-02,Assembly,"AB 363 STEINORTH  Consent Calendar Second Day",78,0,0,2,80
728008,464446,2015-06-30,Senate,"Do pass, but re-refer to the Committee on Appropriations Recommend 	Consent",4,0,1,0,5
728008,473718,2015-08-17,Senate,"Placed on Appropriations Suspense file",7,0,0,0,7
728008,474608,2015-08-27,Senate,"Do pass",7,0,0,0,7
728008,475698,2015-09-02,Senate,"Assembly 3rd Reading AB363 Steinorth By Stone",40,0,0,0,40
728008,475813,2015-09-03,Assembly,"AB 363 STEINORTH  Concurrence in Senate Amendments",79,0,0,1,80
728009,416021,2015-03-24,Assembly,"Do pass as amended and be re-referred to the Committee on 	Appropriations",7,0,0,0,7
728009,453809,2015-05-28,Assembly,"Do pass",17,0,0,0,17
728009,456007,2015-06-02,Assembly,"AB 371 MULLIN  Assembly Third Reading",79,0,0,1,80
728009,462101,2015-06-23,Senate,"Do pass as amended, but re-refer to the Committee on Appropriations 	Recommend Consent",5,0,0,0,5
728009,465905,2015-07-13,Senate,"Placed on Appropriations Suspense file",7,0,0,0,7
728009,474491,2015-08-27,Senate,"Do pass as amended",7,0,0,0,7
728009,476094,2015-09-09,Senate,"Assembly 3rd Reading AB371 Mullin By Liu",40,0,0,0,40
728009,476404,2015-09-10,Assembly,"AB 371 MULLIN  Concurrence in Senate Amendments",80,0,0,0,80
728011,432607,2015-04-14,Assembly,"Do pass as amended and be re-referred to the Committee on 	Appropriations",11,4,0,0,15
728013,444402,2015-05-06,Assembly,"Do pass and be re-referred to the Committee on Judiciary",5,2,0,0,7
728013,445744,2015-05-12,Assembly,"Do pass as amended",7,3,0,0,10
728013,451498,2015-05-26,Assembly,"AB 359 GONZALEZ  Assembly Third Reading",46,27,0,7,80
728013,462560,2015-06-24,Senate,"Do pass",4,1,0,0,5
728013,465847,2015-07-13,Senate,"Assembly 3rd Reading AB359 Gonzalez By Leyva",22,14,4,0,40
728014,427950,2015-04-07,Senate,"Do pass, but re-refer to the Committee on Appropriations Recommend 	Consent",11,0,0,0,11
728014,438404,2015-04-23,Senate,"Consent Calendar 2nd SB241 Bates",37,0,2,0,39
728014,464022,2015-06-29,Assembly,"Do pass and be re-referred to the Committee on Appropriations",16,0,0,0,16
728014,465612,2015-07-08,Assembly,"Do pass, to Consent Calendar",14,0,0,3,17
728014,466543,2015-07-16,Assembly,"SB 241 Bates  Consent Calendar Second Day  Regular Session",79,0,0,1,80
728016,437782,2015-04-22,Assembly,"Do pass as amended and be re-referred to the Committee on 	Appropriations",4,3,0,0,7
728016,454047,2015-05-28,Assembly,"Do pass as amended",11,6,0,0,17
728018,441449,2015-04-29,Senate,"Do pass, but re-refer to the Committee on Appropriations",5,0,2,0,7
728018,453794,2015-05-28,Senate,"Do pass as amended",5,2,0,0,7
728018,456072,2015-06-02,Senate,"Senate 3rd Reading SB239 Hertzberg",26,12,2,0,40
728018,463706,2015-05-18,Senate,"Placed on Appropriations Suspense file",7,0,0,0,7
728018,466544,2015-07-15,Assembly,"Do pass and be re-referred to the Committee on Appropriations",8,1,0,0,9
728018,474312,2015-08-27,Assembly,"Do pass as amended",12,4,0,1,17
728018,476005,2015-09-08,Assembly,"SB 239 Hertzberg  Senate Third Reading  By CHIU",54,23,0,3,80
728018,476263,2015-09-10,Senate,"Unfinished Business SB239 Hertzberg Concurrence",24,13,3,0,40
728019,437878,2015-04-14,Assembly,"Do pass and be re-referred to the Committee on Appropriations",16,0,0,3,19
728019,453947,2015-05-28,Assembly,"Do pass as amended",17,0,0,0,17
728019,455919,2015-06-02,Assembly,"AB 366 BONTA  Assembly Third Reading",77,0,0,3,80
728019,466518,2015-07-15,Senate,"Do pass, but re-refer to the Committee on Appropriations Recommend 	Consent",9,0,0,0,9
728019,473596,2015-08-17,Senate,"Placed on Appropriations Suspense file",7,0,0,0,7
728019,556286,2016-06-29,Senate,"Do pass",5,2,0,0,7
728019,559823,2016-08-15,Senate,"Assembly 3rd Reading AB366 Bonta By Hancock",25,11,3,0,39
728019,561199,2016-08-25,Assembly,"Senate amendments be concurred in",5,3,0,1,9
728019,561614,2016-08-30,Assembly,"AB 366 BONTA  Concurrence in Senate Amendments",50,30,0,0,80
728021,416535,2015-03-24,Assembly,"Do pass and be re-referred to the Committee on Appropriations",9,1,0,0,10
728021,434141,2015-04-15,Assembly,"Do pass",16,0,0,1,17
728021,437873,2015-04-23,Assembly,"AB 365 GARCIA, C.  Assembly Third Reading",73,1,0,6,80
728021,458556,2015-06-09,Senate,"Do pass, but re-refer to the Committee on Appropriations",7,0,0,0,7
728021,462950,2015-06-25,Senate,"Assembly 3rd Reading AB365 Cristina Garcia By Vidak",38,0,2,0,40
728022,416747,2015-03-25,Assembly,"Do pass and be re-referred to the Committee on Appropriations",9,0,0,0,9
728022,433899,2015-04-15,Assembly,"Do pass, to Consent Calendar",16,0,0,1,17
728022,438128,2015-04-23,Assembly,"AB 354A& A.R.  Consent Calendar Second Day  Regular Session",78,0,0,2,80
728022,458496,2015-06-09,Senate,"Do pass, but re-refer to the Committee on Appropriations Recommend 	Consent",13,0,0,0,13
728026,446196,2015-05-13,Assembly,"Do pass",7,0,0,0,7
728026,453944,2015-05-28,Assembly,"AB 349 GONZALEZ  Third Reading Urgency",73,3,0,4,80
728026,462179,2015-06-23,Senate,"Do pass, but re-refer to the Committee on Judiciary",11,0,0,0,11
728026,466242,2015-07-14,Senate,"Do pass as amended",7,0,0,0,7
728026,474078,2015-08-24,Senate,"Assembly 3rd Reading AB349 Gonzalez Urgency Clause",38,0,2,0,40
728026,474311,2015-08-27,Assembly,"AB 349 GONZALEZ  Concurrence in Senate Amendments",74,3,0,3,80
728029,433375,2015-04-15,Assembly,"Do pass as amended",4,2,0,1,7
728030,402269,2015-02-26,Senate,"Senate 3rd Reading SR12 Cannella",36,0,1,0,37
728032,437245,2015-04-21,Senate,"Do pass, but re-refer to the Committee on Judiciary",5,0,0,0,5
728032,440084,2015-04-28,Senate,"Do pass, but re-refer to the Committee on Appropriations",6,0,1,0,7
728032,445134,2015-05-11,Senate,"Placed on Appropriations Suspense file",7,0,0,0,7
728032,453880,2015-05-28,Senate,"Do pass as amended",7,0,0,0,7
728032,456579,2015-06-03,Senate,"Senate 3rd Reading SB238 Mitchell",40,0,0,0,40
728032,464327,2015-06-30,Assembly,"Do pass and be re-referred to the Committee on Human Services",10,0,0,0,10
728032,466211,2015-07-14,Assembly,"Do pass and be re-referred to the Committee on Appropriations to 	Consent Calendar",7,0,0,0,7
728032,474417,2015-08-27,Assembly,"Do pass as amended",17,0,0,0,17
728032,475955,2015-09-08,Assembly,"SB 238 Mitchell  Senate Third Reading  By CHIU",79,0,0,1,80
728032,476317,2015-09-10,Senate,"Unfinished Business SB238 Mitchell Concurrence",39,0,1,0,40
728034,443353,2015-05-05,Senate,"Do pass and be placed on the Consent Calendar",9,0,2,0,11
728034,445170,2015-05-11,Senate,"Consent Calendar 2nd SB236 Beall",36,0,3,0,39
728034,465916,2015-07-13,Assembly,"Do pass",15,0,0,1,16
728034,474444,2015-08-27,Assembly,"SB 236 Beall  Senate Third Reading  By CAMPOS",71,4,0,5,80
728034,475272,2015-08-31,Senate,"Unfinished Business SB236 Beall Concurrence",39,0,1,0,40
728037,416964,2015-03-25,Assembly,"Do pass and be re-referred to the Committee on Appropriations",9,0,0,0,9
728037,434181,2015-04-15,Assembly,"Do pass, to Consent Calendar",16,0,0,1,17
728037,438417,2015-04-23,Assembly,"AB 362 WALDRON  Consent Calendar Second Day  Regular Session",78,0,0,2,80
728037,458326,2015-06-09,Senate,"Do pass, but re-refer to the Committee on Appropriations",13,0,0,0,13
728037,475364,2015-08-31,Senate,"Assembly 3rd Reading AB362 Waldron By Leyva",40,0,0,0,40
728037,475405,2015-09-01,Assembly,"AB 362 WALDRON  Concurrence in Senate Amendments",80,0,0,0,80
728039,436051,2015-04-21,Assembly,"Do pass and be re-referred to the Committee on Accountability and 	Administrative Review",8,0,0,1,9
728039,441072,2015-04-29,Assembly,"Do pass and be re-referred to the Committee on Appropriations",9,0,0,0,9
728041,427774,2015-04-07,Assembly,"Do pass as amended and be re-referred to the Committee on Aging and 	Long",18,0,0,1,19
728041,435973,2015-04-21,Assembly,"Do pass as amended and be re-referred to the Committee on 	Appropriations",7,0,0,0,7
728041,453894,2015-05-28,Assembly,"Do pass as amended",17,0,0,0,17
728041,456706,2015-06-03,Assembly,"AB 348 BROWN  Assembly Third Reading",80,0,0,0,80
728041,468138,2015-07-15,Senate,"Do pass, but re-refer to the Committee on Appropriations",9,0,0,0,9
728041,473810,2015-08-17,Senate,"Placed on Appropriations Suspense file",7,0,0,0,7
728044,441676,2015-04-28,Assembly,"Do pass as amended and be re-referred to the Committee on 	Appropriations",14,4,0,1,19
728044,453993,2015-05-28,Assembly,"Do pass",12,5,0,0,17
728044,456116,2015-06-02,Assembly,"AB 374 NAZARIAN  Assembly Third Reading",63,14,0,3,80
728044,466503,2015-07-15,Senate,"Do pass as amended, and re-refer to the Committee on Appropriations",7,2,0,0,9
728044,473658,2015-08-17,Senate,"Placed on Appropriations Suspense file",7,0,0,0,7
728044,474516,2015-08-27,Senate,"Do pass as amended",5,2,0,0,7
728044,475922,2015-09-08,Senate,"Assembly 3rd Reading AB374 Nazarian By Monning",35,4,1,0,40
728044,476084,2015-09-09,Assembly,"AB 374 NAZARIAN  Concurrence in Senate Amendments",77,1,0,2,80
728046,443851,2015-05-06,Assembly,"Do pass",18,0,0,3,21
728046,450080,2015-05-22,Assembly,"AB 364 GIPSON  Assembly Third Reading",75,0,0,5,80
728046,465971,2015-07-14,Senate,"Do pass and be placed on the Consent Calendar",13,0,0,0,13
728046,544286,2016-05-10,Senate,"Do pass, but re-refer to the Committee on Appropriations",10,0,3,0,13
728046,558637,2016-08-01,Senate,"Assembly 3rd Reading AB364 Gipson By Hall Urgency Clause",38,0,1,0,39
728046,559174,2016-08-08,Assembly,"AB 364 GIPSON  Concurrence- Urgency Added",76,0,0,4,80
728049,440249,2015-04-27,Assembly,"Do pass as amended and be re-referred to the Committee on 	Appropriations",6,2,0,1,9
728049,453839,2015-05-28,Assembly,"Do pass as amended",11,6,0,0,17
728049,457248,2015-06-04,Assembly,"AB 356 WILLIAMS  Assembly Third Reading",28,33,0,19,80
728051,441013,2015-04-29,Senate,"Do pass, but re-refer to the Committee on Appropriations",2,5,0,0,7
728051,463557,2015-04-29,Senate,"Set, first hearing.  Failed passage in Committee.  Reconsideration 	granted",7,0,0,0,7
728052,440308,2015-04-28,Assembly,"Do pass and be re-referred to the Committee on Appropriations to 	Consent Calendar",15,0,0,0,15
728052,443853,2015-05-06,Assembly,"Do pass, to Consent Calendar",17,0,0,0,17
728052,446723,2015-05-14,Assembly,"AB 353 LACKEY  Consent Calendar Second Day  Regular Session",78,0,0,2,80
728052,466003,2015-07-14,Senate,"Do pass as amended, and re-refer to the Committee on Appropriations",9,0,0,0,9
728052,476186,2015-09-09,Senate,"Assembly 3rd Reading AB353 Lackey By Pavley",39,0,1,0,40
728052,476354,2015-09-10,Assembly,"AB 353 LACKEY  Concurrence- Urgency Added",80,0,0,0,80
728054,416291,2015-03-24,Senate,"Do pass, but re-refer to the Committee on Appropriations",6,0,1,0,7
728054,430589,2015-04-13,Senate,"Placed on Appropriations Suspense file",7,0,0,0,7
728055,433570,2015-04-15,Senate,"Do pass, but re-refer to the Committee on Judiciary",7,0,0,0,7
728055,440284,2015-04-28,Senate,"Do pass as amended, and re-refer to the Committee on Appropriations",6,0,1,0,7
728055,450205,2015-05-22,Senate,"Senate 3rd Reading SB235 Block",39,0,0,0,39
728055,473550,2015-07-14,Assembly,"Do pass as amended and be re-referred to the Committee on 	Appropriations",10,0,0,0,10
728055,473890,2015-08-19,Assembly,"Do pass, to Consent Calendar",17,0,0,0,17
728055,474274,2015-08-27,Assembly,"SB 235 Block  Consent Calendar Second Day  Regular Session",78,0,0,2,80
728055,475449,2015-09-01,Senate,"Special Consent #9 SB235 Block",40,0,0,0,40
728057,415917,2015-03-24,Assembly,"Do pass and be re-referred to the Committee on Appropriations",6,1,0,0,7
728059,437582,2015-04-22,Assembly,"Do pass and be re-referred to the Committee on Utilities and 	Commerce to Consent Calendar",20,0,0,1,21
728059,440447,2015-04-27,Assembly,"Amend, and do pass as amended and be re-referred to the Committee 	on Appropriations with the recommendation:  To Consent Calendar",15,0,0,0,15
728059,454148,2015-05-28,Assembly,"Do pass as amended",17,0,0,0,17
728059,456120,2015-06-02,Assembly,"AB 361 ACHADJIAN  Assembly Third Reading",75,0,0,5,80
728059,463957,2015-06-29,Senate,"Do pass, but re-refer to the Committee on Energy, Utilities and 	Communications Recommend Consent",12,0,1,0,13
728059,465498,2015-07-07,Senate,"Do pass, but re-refer to the Committee on Appropriations",11,0,0,0,11
728059,473710,2015-08-17,Senate,"Placed on Appropriations Suspense file",7,0,0,0,7
728059,474489,2015-08-27,Senate,"Do pass",7,0,0,0,7
728059,475946,2015-09-08,Senate,"Assembly 3rd Reading AB361 Achadjian By Monning",40,0,0,0,40
728059,476470,2015-09-11,Assembly,"AB 361 ACHADJIAN  Concurrence- Urgency Added",76,0,0,4,80
728060,485063,2016-01-05,Assembly,"Be referred to Committee on Elections and Redistricting",11,0,0,0,11
728060,485064,2016-01-13,Assembly,"Do pass and be re-referred to the Committee on Judiciary",4,2,0,1,7
728060,485803,2016-01-19,Assembly,"Do pass",7,3,0,0,10
728060,487063,2016-01-25,Assembly,"AB 350 ALEJO  Assembly Third Reading",50,25,0,4,79
728060,554852,2016-06-21,Senate,"Do pass, but re-refer to the Committee on Judiciary",4,1,0,0,5
728060,558946,2016-08-01,Senate,"Placed on Appropriations Suspense file",7,0,0,0,7
728060,559790,2016-08-11,Senate,"Do pass as amended",5,2,0,0,7
728060,560547,2016-08-22,Senate,"Assembly 3rd Reading AB350 Alejo By Hueso",27,12,0,0,39
728060,561300,2016-08-25,Assembly,"Be referred to Committee on Elections and Redistricting",6,3,0,1,10
728060,561471,2016-08-29,Assembly,"Senate amendments be concurred in",5,2,0,0,7
728060,561801,2016-08-31,Assembly,"AB 350 ALEJO  Concurrence in Senate Amendments",57,22,0,1,80
728062,416902,2015-03-25,Senate,"Do pass as amended, and re-refer to the Committee on Public Safety",7,1,0,0,8
728062,437157,2015-04-21,Senate,"Do pass",6,1,0,0,7
728062,442264,2015-04-30,Senate,"Senate 3rd Reading SB242 Monning",31,5,3,0,39
728062,460722,2015-06-17,Assembly,"Do pass as amended",6,1,0,0,7
728062,462941,2015-06-25,Assembly,"SB 242 Monning  Senate Third Reading  By WEBER",64,14,0,2,80
728062,463859,2015-06-29,Senate,"Unfinished Business SB242 Monning Concurrence",34,4,2,0,40
728064,415819,2015-03-24,Assembly,"Do pass",10,0,0,0,10
728064,418665,2015-03-26,Assembly,"AB 355 GARCIA, E.  Assembly Third Reading",76,0,0,4,80
728064,460593,2015-06-16,Senate,"Do pass as amended, but re-refer to the Committee on Appropriations 	Recommend Consent",7,0,0,0,7
728064,475277,2015-08-31,Senate,"Assembly 3rd Reading AB355 Eduardo Garcia By Anderson",40,0,0,0,40
728064,475468,2015-09-01,Assembly,"AB 355 GARCIA, E.  Concurrence in Senate Amendments",80,0,0,0,80
728065,408733,2015-03-09,Assembly,"From committee:  Be adopted.  To third reading",11,0,0,0,11
728065,434245,2015-04-16,Senate,"Assembly 3rd Reading ACR25 Obernolte By Liu",38,0,1,0,39
728067,417603,2015-03-25,Assembly,"Do pass and be re-referred to the Committee on Appropriations",7,0,0,0,7
728067,433991,2015-04-15,Assembly,"Do pass, to Consent Calendar",16,0,0,1,17
728067,438151,2015-04-23,Assembly,"AB 370 BROWN  Consent Calendar Second Day  Regular Session",78,0,0,2,80
728067,460191,2015-06-16,Senate,"Do pass, but re-refer to the Committee on Appropriations Recommend 	Consent",5,0,0,0,5
728067,464916,2015-07-02,Senate,"Consent Calendar 2nd AB370 Brown",38,0,2,0,40
728068,437469,2015-04-22,Senate,"Do pass, but re-refer to the Committee on Appropriations",8,0,1,0,9
728068,463649,2015-05-18,Senate,"Placed on Appropriations Suspense file",7,0,0,0,7
729521,428779,2015-04-08,Assembly,"Do pass and be re-referred to the Committee on Appropriations",21,0,0,0,21
729521,434033,2015-04-15,Assembly,"Do pass, to Consent Calendar",16,0,0,1,17
729521,438224,2015-04-23,Assembly,"AB 394 STONE  Consent Calendar Second Day  Regular Session",78,0,0,2,80
729521,458756,2015-06-09,Senate,"Do pass, but re-refer to the Committee on Appropriations",13,0,0,0,13
729521,465765,2015-07-09,Senate,"Assembly 3rd Reading AB394 Mark Stone By Monning",39,0,1,0,40
729521,465911,2015-07-13,Assembly,"AB 394 STONE  Concurrence in Senate Amendments",79,0,0,1,80
729522,440131,2015-04-28,Senate,"Do pass, but re-refer to the Committee on Appropriations",5,2,0,0,7
729522,445160,2015-05-11,Senate,"Placed on Appropriations Suspense file",7,0,0,0,7
729522,453664,2015-05-28,Senate,"Do pass as amended",5,1,1,0,7
729522,455894,2015-06-02,Senate,"Senate 3rd Reading SB261 Hancock",21,15,4,0,40
729522,464319,2015-06-30,Assembly,"Do pass and be re-referred to the Committee on Appropriations",5,2,0,0,7
729522,474305,2015-08-27,Assembly,"Do pass",12,5,0,0,17
729522,475395,2015-09-01,Assembly,"SB 261 Hancock  Senate Third Reading  By QUIRK",45,31,0,4,80
729524,428490,2015-04-07,Senate,"Do pass and be placed on the Consent Calendar",7,0,0,0,7
729524,433894,2015-04-16,Senate,"Consent Calendar 2nd SB244 Vidak",37,0,2,0,39
729524,460198,2015-06-16,Assembly,"Do pass and be re-referred to the Committee on Housing and 	Community Development to Consent Calendar",10,0,0,0,10
729524,464731,2015-07-01,Assembly,"Do pass, to Consent Calendar",7,0,0,0,7
729524,465800,2015-07-09,Assembly,"SB 244 Vidak  Consent Calendar Second Day",79,0,0,1,80
729526,428483,2015-04-07,Assembly,"Do pass and be re-referred to the Committee on Veterans Affairs",12,0,0,1,13
729526,440963,2015-04-28,Assembly,"Do pass and be re-referred to the Committee on Appropriations",8,0,0,1,9
729528,436147,2015-04-21,Assembly,"Do pass and be re-referred to the Committee on Appropriations",5,1,0,1,7
729528,453657,2015-05-28,Assembly,"Do pass as amended",15,0,0,2,17
729528,455968,2015-06-02,Assembly,"AB 390 COOPER  Assembly Third Reading",74,2,0,4,80
729528,466230,2015-07-14,Senate,"Do pass, but re-refer to the Committee on Appropriations",3,4,0,0,7
729528,466536,2015-07-14,Senate,"Reconsideration granted",7,0,0,0,7
729530,441370,2015-04-29,Assembly,"Do pass and be re-referred to the Committee on Appropriations",1,5,0,1,7
729532,427876,2015-04-07,Assembly,"Amend, and do pass as amended and be re-referred to the Committee 	on Appropriations with the recommendation:  To Consent Calendar",18,0,0,1,19
729532,437206,2015-04-22,Assembly,"Do pass, to Consent Calendar",17,0,0,0,17
729532,442199,2015-04-30,Assembly,"AB 389 CHAU  Consent Calendar Second Day  Regular Session",77,0,0,3,80
729532,460700,2015-06-17,Senate,"Do pass as amended, and re-refer to the Committee on Appropriations",9,0,0,0,9
729532,463862,2015-06-29,Senate,"Placed on Appropriations Suspense file",6,0,1,0,7
729532,474590,2015-08-27,Senate,"Do pass as amended",7,0,0,0,7
729532,475905,2015-09-08,Senate,"Assembly 3rd Reading AB389 Chau By Pan",40,0,0,0,40
729532,476099,2015-09-09,Assembly,"AB 389 CHAU  Concurrence in Senate Amendments",78,0,0,2,80
729534,440146,2015-04-27,Assembly,"Do pass as amended and be re-referred to the Committee on 	Appropriations",9,0,0,0,9
729534,454328,2015-05-28,Assembly,"Do pass",17,0,0,0,17
729534,455549,2015-06-01,Assembly,"AB 392 ATKINS  Assembly Third Reading",79,0,0,1,80
729534,462218,2015-06-23,Senate,"Do pass, but re-refer to the Committee on Appropriations",9,0,0,0,9
729534,465202,2015-07-06,Senate,"Placed on Appropriations Suspense file",7,0,0,0,7
729534,474506,2015-08-27,Senate,"Do pass",7,0,0,0,7
729534,475508,2015-09-01,Senate,"Assembly 3rd Reading AB392 Atkins By Hueso",39,0,1,0,40
729538,432545,2015-04-15,Assembly,"Do pass and be re-referred to the Committee on Veterans Affairs",7,0,0,0,7
729538,441545,2015-04-28,Assembly,"Do pass and be re-referred to the Committee on Appropriations",9,0,0,0,9
729538,448981,2015-05-20,Assembly,"Do pass",15,0,0,2,17
729538,453793,2015-05-28,Assembly,"AB 388 CHANG  Assembly Third Reading",76,0,0,4,80
729538,465478,2015-07-07,Senate,"Do pass, but re-refer to the Committee on Appropriations Recommend 	Consent",11,0,0,0,11
729538,475303,2015-08-31,Senate,"Assembly 3rd Reading AB388 Chang By Bates",40,0,0,0,40
729538,476117,2015-09-09,Senate,"Assembly 3rd Reading AB388 Chang By Bates",39,0,1,0,40
729538,476275,2015-09-10,Assembly,"AB 388 CHANG  Concurrence in Senate Amendments",80,0,0,0,80
729540,422197,2015-03-25,Assembly,"Do pass as amended and be re-referred to the Committee on 	Appropriations",6,0,0,1,7
729540,453826,2015-05-28,Assembly,"Do pass as amended",17,0,0,0,17
729540,455926,2015-06-02,Assembly,"AB 379 GORDON  Assembly Third Reading",78,0,0,2,80
729540,462654,2015-06-24,Senate,"Do pass, but re-refer to the Committee on Appropriations Recommend 	Consent",9,0,0,0,9
729540,465163,2015-07-06,Senate,"Placed on Appropriations Suspense file",7,0,0,0,7
729540,474678,2015-08-27,Senate,"Do pass",7,0,0,0,7
729540,476366,2015-09-10,Senate,"Assembly 3rd Reading AB379 Gordon By Mitchell",40,0,0,0,40
729540,476552,2015-09-11,Assembly,"AB 379 GORDON  Concurrence in Senate Amendments",79,0,0,1,80
729544,416854,2015-03-25,Senate,"Do pass as amended, and re-refer to the Committee on Appropriations",8,0,0,0,8
729544,442854,2015-05-04,Senate,"Placed on Appropriations Suspense file",7,0,0,0,7
729544,453770,2015-05-28,Senate,"Do pass as amended",6,0,1,0,7
729544,456594,2015-06-03,Senate,"Senate 3rd Reading SB252 Leno",40,0,0,0,40
729544,466375,2015-07-15,Assembly,"Do pass as amended and be re-referred to the Committee on 	Appropriations",7,0,0,0,7
729544,474361,2015-08-27,Assembly,"Do pass as amended",17,0,0,0,17
729544,475578,2015-09-02,Assembly,"SB 252 Leno  Senate Third Reading  By CHIU",78,0,0,2,80
729544,475746,2015-09-03,Senate,"Unfinished Business SB252 Leno Concurrence",38,0,2,0,40
729546,422475,2015-03-25,Assembly,"Do pass and be re-referred to the Committee on Appropriations to 	Consent Calendar",6,0,0,1,7
729552,440879,2015-04-29,Senate,"Do pass as amended, and re-refer to the Committee on Appropriations",6,0,1,0,7
729552,454089,2015-05-28,Senate,"Do pass as amended",5,2,0,0,7
729552,456658,2015-06-03,Senate,"Senate 3rd Reading SB246 Wieckowski",26,11,3,0,40
729552,463631,2015-05-18,Senate,"Placed on Appropriations Suspense file",7,0,0,0,7
729552,466150,2015-07-13,Assembly,"Do pass and be re-referred to the Committee on Appropriations",8,1,0,0,9
729552,474384,2015-08-27,Assembly,"Do pass as amended",12,5,0,0,17
729552,475848,2015-09-04,Assembly,"SB 246 Wieckowski  Senate Third Reading  By GORDON  Amend By GORDON 	Set #1",53,27,0,0,80
729552,475913,2015-09-08,Assembly,"SB 246 Wieckowski  Senate Third Reading  By GORDON",56,23,0,1,80
729552,476234,2015-09-10,Senate,"Unfinished Business SB246 Wieckowski Concurrence",25,13,2,0,40
729554,443823,2015-05-06,Assembly,"Do pass, to Consent Calendar",13,0,0,0,13
729554,446656,2015-05-14,Assembly,"AB 387 MCCARTY  Consent Calendar Second Day  Regular Session",78,0,0,2,80
729554,465684,2015-07-08,Senate,"Do pass, but re-refer to the Committee on Appropriations",8,0,1,0,9
729554,473796,2015-08-17,Senate,"Placed on Appropriations Suspense file",7,0,0,0,7
729554,474601,2015-08-27,Senate,"Do pass as amended",7,0,0,0,7
729554,475992,2015-09-08,Senate,"Assembly 3rd Reading AB387 McCarty By Roth",40,0,0,0,40
729554,476306,2015-09-10,Assembly,"Senate amendments be concurred in",8,0,0,5,13
729554,476635,2015-09-11,Assembly,"AB 387 MCCARTY  Concurrence in Senate Amendments",79,0,0,1,80
729556,440448,2015-04-28,Senate,"Do pass, but re-refer to the Committee on Appropriations",11,0,0,0,11
729556,454111,2015-05-28,Senate,"Do pass as amended",7,0,0,0,7
729556,457279,2015-06-04,Senate,"Senate 3rd Reading SB257 Bates",40,0,0,0,40
729556,463676,2015-05-18,Senate,"Placed on Appropriations Suspense file",7,0,0,0,7
729556,474182,2015-07-13,Assembly,"Do pass and be re-referred to the Committee on Appropriations to 	Consent Calendar",16,0,0,0,16
729558,447713,2015-05-13,Assembly,"Do pass and be re-referred to the Committee on Appropriations",6,0,0,1,7
729558,453045,2015-05-27,Assembly,"Do pass",12,4,0,1,17
729558,455413,2015-06-01,Assembly,"AB 375 CAMPOS  Assembly Third Reading",58,22,0,0,80
729558,462607,2015-06-24,Senate,"Do pass, but re-refer to the Committee on Appropriations",8,1,0,0,9
729558,473729,2015-08-17,Senate,"Placed on Appropriations Suspense file",7,0,0,0,7
729558,474624,2015-08-27,Senate,"Do pass",5,2,0,0,7
729558,475816,2015-09-03,Senate,"Assembly 3rd Reading AB375 Campos By Leyva",28,12,0,0,40
729558,475965,2015-09-08,Assembly,"AB 375 CAMPOS  Concurrence in Senate Amendments",55,24,0,1,80
729560,458860,2015-04-14,Senate,"Do pass, but re-refer to the Committee on Judiciary",5,1,1,0,7
729562,437382,2015-04-21,Senate,"Do pass, but re-refer to the Committee on Judiciary",5,0,0,0,5
729562,440336,2015-04-28,Senate,"Do pass as amended, and re-refer to the Committee on Appropriations",6,0,1,0,7
729562,454034,2015-05-28,Senate,"Do pass as amended",7,0,0,0,7
729562,456678,2015-06-03,Senate,"Senate 3rd Reading SB253 Monning",40,0,0,0,40
729562,463733,2015-05-18,Senate,"Placed on Appropriations Suspense file",7,0,0,0,7
729562,464460,2015-06-30,Assembly,"Do pass as amended and be re-referred to the Committee on Human 	Services",10,0,0,0,10
729562,466342,2015-07-14,Assembly,"Do pass and be re-referred to the Committee on Appropriations",7,0,0,0,7
729562,474341,2015-08-27,Assembly,"Do pass as amended",12,0,0,5,17
729562,560158,2016-08-18,Assembly,"SB 253 Monning  Senate Third Reading  By CHIU",75,0,0,5,80
729562,561049,2016-08-24,Senate,"Unfinished Business SB253 Monning Concurrence",34,5,0,0,39
729564,485055,2016-01-13,Senate,"Do pass as amended, and re-refer to the Committee on Appropriations",6,0,1,0,7
729564,485573,2016-01-19,Senate,"Placed on Appropriations Suspense file",7,0,0,0,7
729566,428042,2015-04-07,Senate,"Do pass, but re-refer to the Committee on Judiciary",11,0,0,0,11
729566,437360,2015-04-21,Senate,"Do pass as amended, and re-refer to the Committee on Appropriations",5,2,0,0,7
729566,454075,2015-05-28,Senate,"Do pass",7,0,0,0,7
729566,455327,2015-06-01,Senate,"Senate 3rd Reading SB249 Hueso",36,3,1,0,40
729566,463588,2015-05-18,Senate,"Placed on Appropriations Suspense file",7,0,0,0,7
729566,463913,2015-06-29,Assembly,"Do pass and be re-referred to the Committee on Judiciary",15,0,0,1,16
729566,466054,2015-07-14,Assembly,"Do pass as amended and be re-referred to the Committee on 	Appropriations",10,0,0,0,10
729566,474377,2015-08-27,Assembly,"Do pass as amended",17,0,0,0,17
729566,475512,2015-09-01,Assembly,"SB 249 Hueso  Senate Third Reading  By FRAZIER",75,2,0,3,80
729566,475915,2015-09-08,Assembly,"Do pass as amended and be re-referred to the Committee on 	Appropriations",10,0,0,0,10
729566,476599,2015-09-11,Senate,"Unfinished Business (S upplemental File 2)SB2 49 Hue so",38,1,1,0,40
729566,476600,2015-09-11,Assembly,"SB 249 Hueso  Senate Third Reading  By ALEJO",73,2,0,5,80
729568,428818,2015-04-08,Senate,"Do pass, but re-refer to the Committee on Appropriations Recommend 	Consent",7,0,1,0,8
729568,438423,2015-04-23,Senate,"Consent Calendar 2nd SB260 Monning",37,0,2,0,39
729568,459776,2015-06-15,Assembly,"Be referred to Committee on Health",10,0,0,1,11
729568,465414,2015-07-07,Assembly,"Do pass as amended and be re-referred to the Committee on 	Appropriations",12,5,0,2,19
729568,474346,2015-08-27,Assembly,"Do pass",12,5,0,0,17
729568,475678,2015-09-02,Assembly,"SB 260 Monning  Senate Third Reading  By BONTA",23,43,0,14,80
729570,416959,2015-03-25,Senate,"Do pass as amended, and re-refer to the Committee on Appropriations",8,0,0,0,8
729570,445418,2015-05-11,Senate,"Placed on Appropriations Suspense file",7,0,0,0,7
729570,484892,2016-01-13,Senate,"Do pass, but re-refer to the Committee on Appropriations",8,0,3,0,11
729570,485065,2016-01-12,Senate,"Do pass, but re-refer to the Committee on Energy, Utilities and 	Communications",8,0,3,0,11
729570,485586,2016-01-19,Senate,"Placed on Appropriations Suspense file",7,0,0,0,7
729570,486445,2016-01-21,Senate,"Do pass as amended",7,0,0,0,7
729570,488567,2016-01-27,Senate,"Senate 3rd Reading SB247 Lara",26,4,10,0,40
729570,552490,2016-06-13,Assembly,"Do pass and be re-referred to the Committee on Appropriations",13,0,0,3,16
729570,556619,2016-06-29,Assembly,"Do pass",13,5,0,2,20
729570,560583,2016-08-22,Assembly,"SB 247 Lara  Senate Third Reading  By GARCIA, E",60,17,0,3,80
729570,561088,2016-08-24,Senate,"Unfinished Business SB247 Lara Concurrence",27,10,2,0,39
729576,432608,2015-04-14,Senate,"Do pass, but re-refer to the Committee on Appropriations",6,2,1,0,9
729576,445165,2015-05-11,Senate,"Placed on Appropriations Suspense file",7,0,0,0,7
729576,454059,2015-05-28,Senate,"Do pass as amended",5,2,0,0,7
729576,457301,2015-06-04,Senate,"Senate 3rd Reading SB248 Pavley",22,18,0,0,40
729576,466102,2015-07-13,Assembly,"Do pass as amended and be re-referred to the Committee on 	Appropriations",6,2,0,1,9
729578,428366,2015-04-08,Senate,"Do pass, but re-refer to the Committee on Appropriations",7,0,0,0,7
729578,435266,2015-04-20,Senate,"Placed on Appropriations Suspense file",7,0,0,0,7
729584,445766,2015-05-12,Senate,"Do pass, but re-refer to the Committee on Governance and Finance",6,0,1,0,7
729584,446139,2015-05-13,Senate,"Do pass as amended, and re-refer to the Committee on Appropriations",7,0,0,0,7
729584,451854,2015-05-26,Senate,"Placed on Appropriations Suspense file",7,0,0,0,7
729584,454078,2015-05-28,Senate,"Do pass as amended",7,0,0,0,7
729584,456629,2015-06-03,Senate,"Senate 3rd Reading SB251 Roth",40,0,0,0,40
729584,466037,2015-07-14,Assembly,"Do pass and be re-referred to the Committee on Revenue and Taxation",10,0,0,0,10
729584,466654,2015-07-16,Assembly,"Do pass as amended and be re-referred to the Committee on 	Appropriations",9,0,0,0,9
729584,474370,2015-08-27,Assembly,"Do pass",17,0,0,0,17
729584,476325,2015-09-10,Assembly,"SB 251 Roth  Senate Third Reading  By STONE",70,6,0,4,80
729584,476479,2015-09-11,Senate,"Unfinished Business SB251 Roth Concurrence",40,0,0,0,40
729586,438291,2015-04-14,Assembly,"Do pass and be re-referred to the Committee on Appropriations",17,0,0,2,19
729586,453768,2015-05-28,Assembly,"Do pass",17,0,0,0,17
729586,455528,2015-06-01,Assembly,"AB 384 PEREA  Assembly Third Reading",78,2,0,0,80
729586,465784,2015-07-08,Senate,"Do pass, but re-refer to the Committee on Appropriations",7,1,1,0,9
729586,473650,2015-08-17,Senate,"Placed on Appropriations Suspense file",7,0,0,0,7
729586,474650,2015-08-27,Senate,"Do pass",7,0,0,0,7
729586,475824,2015-09-03,Senate,"Assembly 3rd Reading AB384 Perea By Galgiani",38,1,1,0,40
729588,440987,2015-04-28,Assembly,"Do pass as amended and be re-referred to the Committee on 	Appropriations",19,0,0,0,19
729592,440464,2015-04-28,Senate,"Do pass, but re-refer to the Committee on Appropriations",11,0,0,0,11
729592,445229,2015-05-11,Senate,"Placed on Appropriations Suspense file",7,0,0,0,7
729592,453782,2015-05-28,Senate,"Do pass as amended",7,0,0,0,7
729592,457291,2015-06-04,Senate,"Senate 3rd Reading SB254 Allen",37,0,3,0,40
729592,529323,2016-04-07,Assembly,"Be referred to Committee on Elections and Redistricting",9,0,0,2,11
729592,538936,2016-04-27,Assembly,"Do pass and be re-referred to the Committee on Appropriations",5,2,0,0,7
729592,542237,2016-05-04,Assembly,"Do pass as amended",14,6,0,0,20
729592,545220,2016-05-12,Assembly,"SB 254 Allen  Senate Third Reading  By WILLIAMS",51,26,0,3,80
729592,546577,2016-05-18,Senate,"From committee:  That the Assembly Amendments be concurred in",4,1,0,0,5
729592,548967,2016-05-27,Senate,"Unfinished Business SB254 Allen Concurrence",26,12,2,0,40
729594,432577,2015-04-14,Assembly,"Amend, and do pass as amended and be re-referred to the Committee 	on Appropriations with the recommendation:  To Consent Calendar",7,0,0,0,7
729594,441115,2015-04-29,Assembly,"Do pass, to Consent Calendar",17,0,0,0,17
729594,444459,2015-05-07,Assembly,"AB 376 LOPEZ  Consent Calendar Second Day  Regular Session",77,0,0,3,80
729594,458365,2015-06-09,Senate,"Do pass, but re-refer to the Committee on Appropriations",5,0,0,0,5
729594,463865,2015-06-29,Senate,"Placed on Appropriations Suspense file",6,0,1,0,7
729594,474628,2015-08-27,Senate,"Do pass as amended",7,0,0,0,7
729594,475768,2015-09-03,Senate,"Assembly 3rd Reading AB376 Lopez By McGuire",40,0,0,0,40
729594,475914,2015-09-08,Assembly,"AB 376 LOPEZ  Concurrence in Senate Amendments",78,0,0,2,80
729596,446052,2015-05-12,Senate,"Do pass and be placed on the Consent Calendar",9,0,2,0,11
729596,447659,2015-05-18,Senate,"Consent Calendar 2nd SB255 Liu",36,0,3,0,39
729596,464927,2015-07-01,Assembly,"Do pass and be re-referred to the Committee on Appropriations",8,0,0,1,9
729596,474233,2015-08-26,Assembly,"Do pass",17,0,0,0,17
729596,475369,2015-08-31,Assembly,"SB 255 Liu  Senate Third Reading  By GARCIA, C",77,1,0,2,80
729596,475413,2015-09-01,Senate,"Unfinished Business SB255 Liu Concurrence",40,0,0,0,40
729598,427908,2015-04-07,Assembly,"Do pass, to Consent Calendar",10,0,0,0,10
729598,430874,2015-04-13,Assembly,"AB 380 WALDRON  Consent Calendar Second Day",79,0,0,1,80
729598,461073,2015-06-16,Senate,"Do pass",7,0,0,0,7
729598,465212,2015-07-06,Senate,"Special Consent #4 AB380 Waldron",39,0,1,0,40
729598,465807,2015-07-09,Assembly,"AB 380 WALDRON  Concurrence in Senate Amendments",79,0,0,1,80
729602,437288,2015-04-22,Assembly,"Do pass and be re-referred to the Committee on Natural Resources",9,0,0,0,9
729602,440205,2015-04-27,Assembly,"Do pass as amended and be re-referred to the Committee on 	Appropriations",9,0,0,0,9
729602,449072,2015-05-20,Assembly,"Do pass, to Consent Calendar",15,0,0,2,17
729602,451841,2015-05-26,Assembly,"AB 385 CHU  Consent Calendar Second Day  Regular Session",76,0,0,4,80
729602,466376,2015-07-15,Senate,"Do pass, but re-refer to the Committee on Appropriations",2,4,1,0,7
729602,466377,2015-07-15,Senate,"Set, first hearing.  Failed passage in Committee.  Reconsideration 	granted",7,0,0,0,7
729602,552458,2016-06-13,Senate,"Do pass, but re-refer to the Committee on Appropriations",9,2,0,0,11
729602,558718,2016-08-01,Senate,"Placed on Appropriations Suspense file",7,0,0,0,7
729602,559601,2016-08-11,Senate,"Do pass",6,1,0,0,7
729602,560690,2016-08-23,Senate,"Assembly 3rd Reading AB385 Chu By Gaines",17,17,5,0,39
729602,560691,2016-08-23,Senate,"Assembly 3rd Reading AB385 Chu By Gaines",39,0,0,0,39
729602,561553,2016-08-30,Senate,"Assembly 3rd Reading AB385 Chu By Gaines",15,19,5,0,39
730826,439357,2015-04-27,Assembly,"Do pass as amended and be re-referred to the Committee on 	Appropriations",20,0,0,1,21
730826,453623,2015-05-28,Assembly,"Do pass",14,0,0,3,17
730827,436017,2015-04-21,Assembly,"Do pass and be re-referred to the Committee on Appropriations",9,0,0,0,9
730827,444288,2015-05-06,Assembly,"Do pass as amended, to Consent Calendar",17,0,0,0,17
730827,446898,2015-05-14,Assembly,"AB 413 CHAVEZ  Consent Calendar Second Day  Regular Session",78,0,0,2,80
730827,462213,2015-06-23,Senate,"Do pass as amended, and re-refer to the Committee on Appropriations",5,0,0,0,5
730827,465950,2015-07-13,Senate,"Placed on Appropriations Suspense file",7,0,0,0,7
730827,474568,2015-08-27,Senate,"Do pass",7,0,0,0,7
730827,475467,2015-09-01,Senate,"Assembly 3rd Reading AB413 Ch",39,0,1,0,40
730827,475637,2015-09-02,Assembly,"AB 413 CHAVEZ  Concurrence in Senate Amendments",78,0,0,2,80
730828,428352,2015-04-07,Assembly,"Do pass as amended and be re-referred to the Committee on Veterans 	Affairs",12,0,0,1,13
730828,441032,2015-04-28,Assembly,"Do pass and be re-referred to the Committee on Appropriations",8,0,0,1,9
730829,440457,2015-04-27,Assembly,"Do pass and be re-referred to the Committee on Appropriations",8,0,0,1,9
730830,432593,2015-04-15,Senate,"Do pass as amended, and re-refer to the Committee on Public Safety",7,0,0,0,7
730831,440274,2015-04-27,Assembly,"Do pass as amended and be re-referred to the Committee on 	Appropriations",9,0,0,0,9
730831,453858,2015-05-28,Assembly,"Do pass as amended",17,0,0,0,17
730831,456134,2015-06-02,Assembly,"AB 437 ATKINS  Assembly Third Reading",79,0,0,1,80
730831,465664,2015-07-08,Senate,"Do pass as amended, and re-refer to the Committee on Appropriations",6,0,1,0,7
730831,473795,2015-08-17,Senate,"Placed on Appropriations Suspense file",7,0,0,0,7
730831,474639,2015-08-27,Senate,"Do pass as amended",7,0,0,0,7
730831,475533,2015-09-01,Senate,"Assembly 3rd Reading AB437 Atkins By Hertzberg",32,0,8,0,40
730831,475702,2015-09-02,Assembly,"AB 437 ATKINS  Concurrence in Senate Amendments",80,0,0,0,80
730832,444399,2015-05-07,Senate,"Senate 3rd Reading SB271 Gaines",37,0,2,0,39
730832,458545,2015-04-14,Senate,"Do pass as amended, and re-refer to the Committee on Appropriations",6,0,0,1,7
730832,466212,2015-07-15,Assembly,"Do pass and be re-referred to the Committee on Appropriations",7,0,0,0,7
730832,473873,2015-08-19,Assembly,"Do pass, to Consent Calendar",17,0,0,0,17
730832,474177,2015-07-07,Assembly,"Do pass and be re-referred to the Committee on Education",11,0,0,0,11
730832,475784,2015-09-03,Assembly,"SB 271 Gaines  Senate Third Reading  By GATTO",80,0,0,0,80
730832,475847,2015-09-04,Senate,"Unfinished Business SB271 Gaines Concurrence",40,0,0,0,40
730833,434230,2015-04-15,Senate,"Do pass, but re-refer to the Committee on Judiciary",9,0,0,0,9
730833,446266,2015-05-12,Senate,"Do pass",4,2,1,0,7
730833,451907,2015-05-26,Senate,"Senate 3rd Reading SB287 Hueso",28,3,8,0,39
730833,466020,2015-07-14,Assembly,"Do pass as amended and be re-referred to the Committee on 	Appropriations",9,0,0,1,10
730833,473888,2015-08-19,Assembly,"Do pass",17,0,0,0,17
730833,474391,2015-08-27,Assembly,"SB 287 Hueso  Senate Third Reading  By BIGELOW",75,1,0,4,80
730833,475251,2015-08-31,Senate,"Unfinished Business SB287 Hueso Concurrence",38,0,2,0,40
730834,429687,2015-04-08,Senate,"Do pass, but re-refer to the Committee on Appropriations",7,0,2,0,9
730834,435401,2015-04-20,Senate,"Do pass",5,0,2,0,7
730834,439423,2015-04-27,Senate,"Senate 3rd Reading SB275 Hernandez",23,5,11,0,39
730835,429252,2015-04-08,Senate,"Do pass, but re-refer to the Committee on Education",6,2,1,0,9
730835,437130,2015-04-22,Senate,"Do pass, but re-refer to the Committee on Judiciary",7,2,0,0,9
730835,440237,2015-04-28,Senate,"Do pass as amended, and re-refer to the Committee on Appropriations",5,1,1,0,7
730835,446644,2015-05-14,Senate,"Senate 3rd Reading SB277 Pan Amend by Anderson",25,10,4,0,39
730835,446645,2015-05-14,Senate,"Senate 3rd Reading SB277 Pan and Allen",25,11,3,0,39
730835,458333,2015-06-09,Assembly,"Do pass as amended",12,6,0,1,19
730835,462978,2015-06-25,Assembly,"SB 277 Pan  Senate Third Reading  By GONZALEZ",46,31,0,3,80
730835,463827,2015-06-29,Senate,"Unfinished Business SB277 Pan Concurrence",24,14,2,0,40
730837,440998,2015-04-28,Assembly,"Do pass and be re-referred to the Committee on Appropriations",7,0,0,0,7
730837,453899,2015-05-28,Assembly,"Do pass as amended",17,0,0,0,17
730837,456712,2015-06-03,Assembly,"AB 403 STONE  Assembly Third Reading",79,0,0,1,80
730837,466001,2015-07-14,Senate,"Do pass as amended, and re-refer to the Committee on Appropriations",5,0,0,0,5
730837,473622,2015-08-17,Senate,"Placed on Appropriations Suspense file",7,0,0,0,7
730837,474571,2015-08-27,Senate,"Do pass as amended",6,0,1,0,7
730837,476321,2015-09-10,Senate,"Assembly 3rd Reading AB403 Mark Stone By McGuire",40,0,0,0,40
730837,476478,2015-09-11,Assembly,"AB 403 STONE  Concurrence in Senate Amendments",79,0,0,1,80
730839,415871,2015-03-24,Assembly,"Do pass as amended",10,0,0,0,10
730839,437867,2015-04-23,Assembly,"AB 418 CHIU  Assembly Third Reading",78,0,0,2,80
730839,461014,2015-06-16,Senate,"Do pass",7,0,0,0,7
730839,462996,2015-06-25,Senate,"Assembly 3rd Reading AB418 Chiu By Leno",38,0,2,0,40
730840,432903,2015-04-15,Assembly,"Do pass and be re-referred to the Committee on Appropriations",9,0,0,0,9
730840,441845,2015-04-29,Assembly,"Do pass, to Consent Calendar",17,0,0,0,17
730840,445151,2015-05-11,Assembly,"AB 429 DAHLE  Assembly Third Reading",78,0,0,2,80
730840,466091,2015-07-14,Senate,"Do pass, but re-refer to the Committee on Appropriations",5,0,4,0,9
730840,473661,2015-08-17,Senate,"Placed on Appropriations Suspense file",7,0,0,0,7
730840,474551,2015-08-27,Senate,"Do pass as amended",7,0,0,0,7
730840,475650,2015-09-02,Senate,"Assembly 3rd Reading AB429 Dahle By McGuire",36,0,4,0,40
730840,475718,2015-09-03,Assembly,"AB 429 DAHLE  Concurrence in Senate Amendments",78,0,0,2,80
730841,437205,2015-04-22,Senate,"Do pass, but re-refer to the Committee on Appropriations",8,0,1,0,9
730841,443105,2015-05-04,Senate,"Placed on Appropriations Suspense file",7,0,0,0,7
730841,453943,2015-05-28,Senate,"Do pass",7,0,0,0,7
730841,455356,2015-06-01,Senate,"Senate 3rd Reading SB282 Hernandez",40,0,0,0,40
730841,466118,2015-07-14,Assembly,"Do pass and be re-referred to the Committee on Appropriations to 	Consent Calendar",19,0,0,0,19
730841,474271,2015-08-27,Assembly,"Do pass",17,0,0,0,17
730841,475835,2015-09-04,Assembly,"SB 282 Hernandez  Senate Third Reading  By SANTIAGO",78,0,0,2,80
730841,476028,2015-09-08,Senate,"Unfinished Business SB282 Hernandez Concurrence",40,0,0,0,40
730842,428404,2015-04-07,Assembly,"Do pass as amended and be re-referred to the Committee on 	Appropriations",12,0,0,1,13
730842,440917,2015-04-29,Assembly,"Do pass, to Consent Calendar",17,0,0,0,17
730842,446687,2015-05-14,Assembly,"AB 404 CHIU  Assembly Third Reading",78,0,0,2,80
730842,464738,2015-07-01,Senate,"Do pass, but re-refer to the Committee on Appropriations",7,0,2,0,9
730842,465901,2015-07-13,Senate,"Placed on Appropriations Suspense file",7,0,0,0,7
730842,474666,2015-08-27,Senate,"Do pass",7,0,0,0,7
730842,475599,2015-09-02,Senate,"Assembly 3rd Reading AB404 Chiu By Leno",40,0,0,0,40
730842,475879,2015-09-04,Assembly,"AB 404 CHIU  Concurrence in Senate Amendments",79,0,0,1,80
730843,436088,2015-04-21,Senate,"Do pass as amended, and re-refer to the Committee on Appropriations",11,0,0,0,11
730843,442839,2015-05-04,Senate,"Placed on Appropriations Suspense file",7,0,0,0,7
730843,453690,2015-05-28,Senate,"Do pass as amended",5,1,1,0,7
730843,456551,2015-06-03,Senate,"Senate 3rd Reading SB286 Hertzberg",34,2,4,0,40
730845,435265,2015-04-20,Senate,"Do pass, but re-refer to the Committee on Judiciary",9,0,0,0,9
730845,440421,2015-04-28,Senate,"Do pass as amended, and re-refer to the Committee on Appropriations",6,0,1,0,7
730845,450282,2015-05-22,Senate,"Senate 3rd Reading SB284 Cannella",39,0,0,0,39
730845,462286,2015-06-23,Assembly,"Do pass and be re-referred to the Committee on Appropriations to 	Consent Calendar",14,0,0,0,14
730845,465719,2015-07-08,Assembly,"Do pass, to Consent Calendar",14,0,0,3,17
730845,466545,2015-07-16,Assembly,"SB 284 Cannella  Consent Calendar Second Day  Regular Session",79,0,0,1,80
730846,414074,2015-03-19,Assembly,"From committee:  Be adopted.  To third reading",11,0,0,0,11
730848,416853,2015-03-25,Assembly,"Do pass and be re-referred to the Committee on Appropriations",9,0,0,0,9
730848,453982,2015-05-28,Assembly,"Do pass as amended",17,0,0,0,17
730848,455992,2015-06-02,Assembly,"AB 435 CHANG  Assembly Third Reading",78,0,0,2,80
730848,462255,2015-06-23,Senate,"Do pass as amended, but re-refer to the Committee on Environmental 	Quality Recommend Consent",9,0,0,0,9
730848,466429,2015-07-15,Senate,"Do pass as amended, and re-refer to the Committee on Appropriations",7,0,0,0,7
730848,474064,2015-08-24,Senate,"Placed on Appropriations Suspense file",7,0,0,0,7
730851,446157,2015-05-13,Assembly,"Do pass as amended",6,3,0,0,9
730851,454122,2015-05-28,Assembly,"AB 402 DODD  Assembly Third Reading",54,23,0,3,80
730851,462648,2015-06-24,Senate,"Do pass as amended",6,0,1,0,7
730851,475394,2015-09-01,Senate,"Assembly 3rd Reading AB402 Dodd By Hertzberg",39,0,1,0,40
730851,475821,2015-09-03,Assembly,"AB 402 DODD  Concurrence in Senate Amendments",59,17,0,4,80
730852,437341,2015-04-22,Assembly,"Do pass and be re-referred to the Committee on Appropriations",9,3,0,1,13
730854,435226,2015-04-20,Senate,"Do pass, but re-refer to the Committee on Rules",9,0,0,0,9
730854,440326,2015-04-28,Senate,"Do pass as amended, and re-refer to the Committee on Appropriations",5,1,1,0,7
730854,450234,2015-05-22,Senate,"Senate 3rd Reading SB270 Mendoza",29,9,1,0,39
730854,463644,2015-05-18,Senate,"Do pass",7,0,0,0,7
730854,464352,2015-06-30,Assembly,"Do pass and be re-referred to the Committee on Judiciary",6,6,0,2,14
730854,464353,2015-06-30,Assembly,"Reconsideration granted",14,0,0,0,14
730854,554748,2016-06-21,Assembly,"Do pass as amended and be re-referred to the Committee on Judiciary",9,6,0,1,16
730854,556082,2016-06-28,Assembly,"Do pass as amended and be re-referred to the Committee on 	Appropriations",7,3,0,0,10
730854,559638,2016-08-10,Assembly,"Do pass",14,5,0,1,20
730854,560448,2016-08-19,Assembly,"SB 270 Mendoza  Senate Third Reading  By REV.& TAX.  Amendment  Set 	#1",73,0,0,7,80
730855,441133,2015-04-28,Assembly,"Do pass and be re-referred to the Committee on Appropriations",7,0,0,0,7
730855,446491,2015-05-13,Assembly,"Do pass, to Consent Calendar",17,0,0,0,17
730855,450207,2015-05-22,Assembly,"AB 433 CHU  Consent Calendar Second Day  Regular Session",74,0,0,6,80
730855,466160,2015-07-14,Senate,"Do pass, but re-refer to the Committee on Appropriations Recommend 	Consent",5,0,0,0,5
730855,473779,2015-08-17,Senate,"Placed on Appropriations Suspense file",7,0,0,0,7
730855,474679,2015-08-27,Senate,"Do pass",7,0,0,0,7
730855,476051,2015-09-08,Senate,"Assembly 3rd Reading AB433 Chu By Hancock",40,0,0,0,40
730856,408682,2015-03-09,Assembly,"From committee:  Be adopted.  To third reading",11,0,0,0,11
730856,418741,2015-03-26,Senate,"Assembly 3rd Reading ACR26 Levine By McGuire",31,0,8,0,39
730857,415366,2015-03-23,Assembly,"Do pass and be re-referred to the Committee on Appropriations",9,3,0,3,15
730857,454485,2015-05-28,Assembly,"Do pass",12,5,0,0,17
730857,455896,2015-06-02,Assembly,"AB 401 DODD  Assembly Third Reading",55,22,0,3,80
730857,464507,2015-06-30,Senate,"Do pass as amended, and re-refer to the Committee on Appropriations",8,1,2,0,11
730857,473692,2015-08-17,Senate,"Placed on Appropriations Suspense file",7,0,0,0,7
730857,474649,2015-08-27,Senate,"Do pass as amended",6,1,0,0,7
730857,475969,2015-09-08,Senate,"Assembly 3rd Reading AB401 Dodd By McGuire",28,12,0,0,40
730857,476151,2015-09-09,Assembly,"AB 401 DODD  Concurrence in Senate Amendments",55,24,0,1,80
730859,441114,2015-04-29,Assembly,"Do pass and be re-referred to the Committee on Appropriations",9,0,0,0,9
730859,446400,2015-05-13,Assembly,"Do pass, to Consent Calendar",17,0,0,0,17
730859,450214,2015-05-22,Assembly,"AB 410 OBERNOLTE  Consent Calendar Second Day  Regular Session",74,0,0,6,80
730859,463852,2015-06-29,Senate,"Do pass, but re-refer to the Committee on Appropriations Recommend 	Consent",12,0,1,0,13
730859,475353,2015-08-31,Senate,"Assembly 3rd Reading AB410 Obernolte By Runner",40,0,0,0,40
730859,475459,2015-09-01,Assembly,"AB 410 OBERNOLTE  Concurrence in Senate Amendments",80,0,0,0,80
730861,431535,2015-04-13,Assembly,"Do pass and be re-referred to the Committee on Appropriations to 	Consent Calendar",9,0,0,0,9
730861,437294,2015-04-22,Assembly,"Do pass, to Consent Calendar",17,0,0,0,17
730861,442128,2015-04-30,Assembly,"AB 417 DAHLE  Consent Calendar Second Day  Regular Session",77,0,0,3,80
730861,458378,2015-06-09,Senate,"Do pass as amended, but re-refer to the Committee on Appropriations 	Recommend Consent",9,0,0,0,9
730861,464902,2015-07-02,Senate,"Consent Calendar 2nd AB417 Dahle",38,0,2,0,40
730861,465152,2015-07-06,Assembly,"AB 417 DAHLE  Concurrence in Senate Amendments",80,0,0,0,80
730863,415092,2015-03-23,Assembly,"Do pass and be re-referred to the Committee on Local Government",13,3,0,0,16
730863,432586,2015-04-15,Assembly,"Do pass as amended",7,0,0,2,9
730863,444435,2015-05-07,Assembly,"AB 422 MCCARTY  Assembly Third Reading",56,19,0,5,80
730863,466058,2015-07-14,Senate,"Do pass as amended",11,0,0,0,11
730863,474159,2015-08-24,Senate,"Assembly 3rd Reading AB422 McCarty By Leyva",35,5,0,0,40
730863,474241,2015-08-27,Assembly,"AB 422 MCCARTY  Concurrence in Senate Amendments",58,20,0,2,80
730864,441575,2015-04-28,Assembly,"Do pass and be re-referred to the Committee on Appropriations",18,1,0,0,19
730867,440309,2015-04-27,Assembly,"Do pass and be re-referred to the Committee on Appropriations",5,11,0,0,16
730867,484755,2016-01-11,Assembly,"Do pass and be re-referred to the Committee on Appropriations",5,11,0,0,16
730869,432669,2015-04-14,Senate,"Do pass, but re-refer to the Committee on Appropriations Recommend 	Consent",6,0,1,0,7
730869,437780,2015-04-23,Senate,"Senate 3rd Reading SB269 Vidak",37,0,0,2,39
730869,485570,2016-01-19,Assembly,"Do pass as amended and be re-referred to the Committee on 	Appropriations",10,0,0,0,10
730869,532187,2016-04-13,Assembly,"Do pass, to Consent Calendar",20,0,0,0,20
730869,537132,2016-04-21,Assembly,"SB 269 Roth  Consent Calendar Second Day  Regular Session",79,0,0,1,80
730869,537965,2016-04-25,Senate,"Unfinished Business SB269 Roth Urgency Clause Concurr",38,0,2,0,40
730870,448372,2015-05-18,Assembly,"Do pass as amended and be re-referred to the Committee on 	Appropriations",9,0,0,0,9
730870,454056,2015-05-28,Assembly,"Do pass",17,0,0,0,17
730870,455255,2015-06-01,Assembly,"AB 428 NAZARIAN  Assembly Third Reading",78,0,0,2,80
730870,465879,2015-07-13,Senate,"Placed on Appropriations Suspense file",7,0,0,0,7
730870,474564,2015-08-27,Senate,"Do pass as amended",7,0,0,0,7
730870,476002,2015-09-08,Senate,"Assembly 3rd Reading AB428 Nazarian By Allen",38,1,1,0,40
730870,476074,2015-09-09,Assembly,"AB 428 NAZARIAN  Concurrence in Senate Amendments",77,0,0,3,80
730871,433638,2015-04-15,Senate,"Do pass, but re-refer to the Committee on Judiciary",7,0,0,0,7
730871,440255,2015-04-28,Senate,"Do pass as amended, and re-refer to the Committee on Appropriations",6,0,1,0,7
730871,450202,2015-05-22,Senate,"Senate 3rd Reading SB285 Block",39,0,0,0,39
730871,462328,2015-06-22,Assembly,"Do pass and be re-referred to the Committee on Appropriations",12,0,0,0,12
730871,465615,2015-07-08,Assembly,"Do pass, to Consent Calendar",14,0,0,3,17
730871,466558,2015-07-16,Assembly,"SB 285 Block  Consent Calendar Second Day  Regular Session",79,0,0,1,80
730871,473993,2015-08-20,Senate,"Special Consent #6 SB285 Block",38,0,2,0,40
730873,416222,2015-03-24,Assembly,"Do pass, to Consent Calendar",10,0,0,0,10
730873,429371,2015-04-09,Assembly,"AB 436 JONES  Assembly Third Reading",78,0,0,2,80
730873,460966,2015-06-16,Senate,"Do pass",7,0,0,0,7
730873,465216,2015-07-06,Senate,"Assembly 3rd Reading AB436 Jones By Vidak",39,0,1,0,40
730876,441808,2015-04-28,Assembly,"Amend, and do pass as amended and be re-referred to the Committee 	on Appropriations with the recommendation:  To Consent Calendar",7,0,0,0,7
730876,453024,2015-05-27,Assembly,"Do pass, to Consent Calendar",17,0,0,0,17
730876,455956,2015-06-02,Assembly,"AB 427 WEBER  Consent Calendar Second Day  Regular Session",78,0,0,2,80
730876,462611,2015-06-24,Senate,"Do pass, but re-refer to the Committee on Appropriations Recommend 	Consent",9,0,0,0,9
730876,465158,2015-07-06,Senate,"Placed on Appropriations Suspense file",7,0,0,0,7
730877,445705,2015-05-12,Senate,"Do pass, but re-refer to the Committee on Appropriations",9,0,2,0,11
730877,454410,2015-05-28,Senate,"Senate 3rd Reading SB273 Hueso Urgency Clause",39,0,1,0,40
730877,464806,2015-07-01,Assembly,"Do pass and be re-referred to the Committee on Appropriations",9,0,0,0,9
730877,466292,2015-07-15,Assembly,"Do pass, to Consent Calendar",16,0,0,1,17
730877,474039,2015-08-20,Assembly,"SB 273 Hueso  Consent Calendar Second Day  Regular Session",79,0,0,1,80
730879,433082,2015-04-14,Assembly,"Do pass and be re-referred to the Committee on Appropriations to 	Consent Calendar",7,0,0,0,7
730879,437304,2015-04-22,Assembly,"Do pass, to Consent Calendar",17,0,0,0,17
730879,442140,2015-04-30,Assembly,"AB 434 GARCIA, E.  Consent Calendar Second Day  Regular Session",77,0,0,3,80
730879,460941,2015-06-17,Senate,"Do pass as amended, and re-refer to the Committee on Appropriations",7,0,0,0,7
730879,475381,2015-08-31,Senate,"Assembly 3rd Reading AB434 Eduardo Garcia By Hueso",40,0,0,0,40
730879,475442,2015-09-01,Assembly,"AB 434 GARCIA, E.  Concurrence in Senate Amendments",80,0,0,0,80
730880,436154,2015-04-21,Assembly,"Do pass and be re-referred to the Committee on Judiciary",5,1,0,1,7
730882,432748,2015-04-15,Senate,"Do pass, but re-refer to the Committee on Judiciary",7,0,0,0,7
730882,437165,2015-04-21,Senate,"Do pass, but re-refer to the Committee on Appropriations",7,0,0,0,7
730882,442811,2015-05-04,Senate,"Do pass",7,0,0,0,7
730882,444429,2015-05-07,Senate,"Senate 3rd Reading SB272 Hertzberg",37,0,2,0,39
730882,464391,2015-06-30,Assembly,"Do pass and be re-referred to the Committee on Local Government",10,0,0,0,10
730882,466491,2015-07-15,Assembly,"Do pass and be re-referred to the Committee on Appropriations",9,0,0,0,9
730882,473894,2015-08-19,Assembly,"Do pass",17,0,0,0,17
730882,475880,2015-09-04,Assembly,"SB 272 Hertzberg  Senate Third Reading  By MAIENSCHEIN",79,0,0,1,80
730882,475960,2015-09-08,Senate,"Unfinished Business SB272 Hertzberg Concurrence",40,0,0,0,40
730884,416103,2015-03-24,Assembly,"Do pass as amended, to Consent Calendar",10,0,0,0,10
730884,429639,2015-04-09,Assembly,"AB 432 CHANG  Consent Calendar Second Day",78,0,0,2,80
730884,458678,2015-06-09,Senate,"Do pass and be placed on the Consent Calendar",7,0,0,0,7
730884,461120,2015-06-18,Senate,"Consent Calendar 2nd AB432 Chang",37,0,3,0,40
730887,441018,2015-04-28,Assembly,"Do pass and be re-referred to the Committee on Appropriations",7,0,0,0,7
730887,453864,2015-05-28,Assembly,"Do pass as amended",17,0,0,0,17
730887,455936,2015-06-02,Assembly,"AB 423 COOLEY  Assembly Third Reading",78,0,0,2,80
730887,466161,2015-07-14,Senate,"Do pass as amended, but re-refer to the Committee on Appropriations 	Recommend Consent",5,0,0,0,5
730887,473731,2015-08-17,Senate,"Placed on Appropriations Suspense file",7,0,0,0,7
730888,436504,2015-04-21,Assembly,"Do pass as amended and be re-referred to the Committee on 	Appropriations",9,0,0,0,9
730888,446292,2015-05-13,Assembly,"Do pass, to Consent Calendar",17,0,0,0,17
730888,450249,2015-05-22,Assembly,"AB 419 KIM  Consent Calendar Second Day  Regular Session",74,0,0,6,80
730889,415042,2015-03-23,Assembly,"Do pass as amended and be re-referred to the Committee on 	Appropriations",13,2,0,1,16
730889,434010,2015-04-15,Assembly,"Do pass",11,5,0,1,17
730889,435316,2015-04-20,Assembly,"AB 400 ALEJO  Assembly Third Reading",59,21,0,0,80
730889,462116,2015-06-23,Senate,"Do pass, but re-refer to the Committee on Appropriations",9,2,0,0,11
730889,475573,2015-09-02,Senate,"Assembly 3rd Reading AB400 Alejo By Mendoza",27,10,3,0,40
730889,475869,2015-09-04,Assembly,"AB 400 ALEJO  Concurrence in Senate Amendments",58,19,0,3,80
730891,440902,2015-04-29,Senate,"Do pass, but re-refer to the Committee on Appropriations",6,0,1,0,7
730891,445287,2015-05-11,Senate,"Placed on Appropriations Suspense file",7,0,0,0,7
730892,441041,2015-04-29,Assembly,"Do pass as amended and be re-referred to the Committee on 	Appropriations",4,2,0,1,7
730893,415903,2015-03-24,Senate,"Do pass as amended",7,0,0,0,7
730893,429227,2015-04-09,Senate,"Senate 3rd Reading SB266 Block",36,1,2,0,39
730893,554654,2016-06-21,Assembly,"Do pass as amended",7,0,0,0,7
730893,560146,2016-08-18,Assembly,"SB 266 Block  Senate Third Reading  By STONE",79,0,0,1,80
730893,560937,2016-08-24,Senate,"Unfinished Business SB266 Block Concurrence",39,0,0,0,39
730894,415907,2015-03-24,Assembly,"Do pass and be re-referred to the Committee on Appropriations to 	Consent Calendar",10,0,0,0,10
730894,433995,2015-04-15,Assembly,"Do pass, to Consent Calendar",16,0,0,1,17
730894,437807,2015-04-23,Assembly,"AB 424 GAINES  Consent Calendar Second Day  Regular Session",78,0,0,2,80
730894,458620,2015-06-09,Senate,"Do pass, but re-refer to the Committee on Appropriations Recommend 	Consent",7,0,0,0,7
730894,462988,2015-06-25,Senate,"Consent Calendar 2nd AB424 Beth Gaines",37,0,3,0,40
730895,433932,2015-04-15,Senate,"Do pass as amended, and re-refer to the Committee on Appropriations",8,0,1,0,9
730895,442834,2015-05-04,Senate,"Placed on Appropriations Suspense file",7,0,0,0,7
730895,454071,2015-05-28,Senate,"Do pass",7,0,0,0,7
730895,455295,2015-06-01,Senate,"Senate 3rd Reading SB276 Wolk",40,0,0,0,40
730895,462181,2015-06-23,Assembly,"Do pass and be re-referred to the Committee on Education to Consent 	Calendar",19,0,0,0,19
730895,466199,2015-07-15,Assembly,"Do pass and be re-referred to the Committee on Appropriations to 	Consent Calendar",7,0,0,0,7
730895,474451,2015-08-27,Assembly,"Do pass",17,0,0,0,17
730895,475374,2015-08-31,Assembly,"SB 276 Wolk  Senate Third Reading  By BAKER",78,0,0,2,80
730895,475421,2015-09-01,Senate,"Unfinished Business SB276 Wolk Concurrence",40,0,0,0,40
733749,427866,2015-04-07,Assembly,"Do pass and be re-referred to the Committee on Appropriations",7,0,0,0,7
733749,434178,2015-04-15,Assembly,"Do pass, to Consent Calendar",16,0,0,1,17
733749,437811,2015-04-23,Assembly,"AB 489 GONZALEZ  Assembly Third Reading",77,0,0,3,80
733749,463903,2015-06-29,Senate,"Do pass, but re-refer to the Committee on Appropriations",12,0,1,0,13
733749,474150,2015-08-24,Senate,"Assembly 3rd Reading AB489 Gonzalez By Block",40,0,0,0,40
733749,474319,2015-08-27,Assembly,"AB 489 GONZALEZ  Concurrence in Senate Amendments",77,0,0,3,80
733751,444409,2015-05-07,Senate,"Senate 3rd Reading SB303 Hueso",35,0,4,0,39
733751,458803,2015-04-14,Senate,"Do pass as amended",6,0,1,0,7
733751,464576,2015-06-30,Assembly,"Do pass as amended",7,0,0,0,7
733751,473863,2015-08-19,Assembly,"Do pass, to Consent Calendar",17,0,0,0,17
733751,475262,2015-08-31,Assembly,"SB 303 Hueso  Senate Third Reading  By GARCIA, E",79,0,0,1,80
733751,475441,2015-09-01,Senate,"Unfinished Business SB303 Hueso Concurrence",39,0,1,0,40
733752,428006,2015-04-07,Assembly,"Do pass",10,0,0,0,10
733752,429295,2015-04-09,Assembly,"AB 548 GARCIA, C.  Assembly Third Reading",76,0,0,4,80
733752,458563,2015-06-09,Senate,"Do pass",7,0,0,0,7
733752,461853,2015-06-22,Senate,"Special Consent #3 AB548 Cristina Garcia",37,0,3,0,40
733759,435977,2015-04-21,Assembly,"Do pass and be re-referred to the Committee on Appropriations",8,1,0,0,9
733764,484967,2016-01-14,Senate,"Do pass, but re-refer to the Committee on Appropriations",3,0,2,0,5
733764,486995,2016-01-25,Senate,"Senate 3rd Reading SB294 Pan",38,0,2,0,40
733764,554993,2016-06-22,Assembly,"Do pass and be re-referred to the Committee on Appropriations to 	Consent Calendar",6,0,0,1,7
733764,559005,2016-08-03,Assembly,"Do pass, to Consent Calendar",20,0,0,0,20
733764,559297,2016-08-11,Assembly,"SB 294 Pan  Consent Calendar Second Day  Regular Session",78,0,0,2,80
733764,560164,2016-08-18,Senate,"Special Consent SB294 Pan",36,0,3,0,39
733765,438167,2015-04-22,Assembly,"Amend, and do pass as amended and be re-referred to the Committee 	on Appropriations with the recommendation:  To Consent Calendar",7,0,0,0,7
733765,453615,2015-05-28,Assembly,"Do pass as amended",17,0,0,0,17
733765,456756,2015-06-03,Assembly,"AB 496 RENDON  Assembly Third Reading",80,0,0,0,80
733765,465608,2015-07-08,Senate,"Do pass, but re-refer to the Committee on Environmental Quality 	Recommend Consent",9,0,0,0,9
733765,466319,2015-07-15,Senate,"Do pass, but re-refer to the Committee on Appropriations",7,0,0,0,7
733765,475621,2015-09-02,Senate,"Assembly 3rd Reading AB496 Rendon By Leyva",40,0,0,0,40
733765,475753,2015-09-03,Assembly,"AB 496 RENDON  Concurrence in Senate Amendments",80,0,0,0,80
733767,440227,2015-04-28,Senate,"Do pass, but re-refer to the Committee on Appropriations Recommend 	Consent",10,0,1,0,11
733767,445123,2015-05-11,Senate,"Placed on Appropriations Suspense file",7,0,0,0,7
733768,432556,2015-04-14,Assembly,"Do pass",14,0,0,1,15
733768,433922,2015-04-16,Assembly,"AB 453 BIGELOW  Assembly Third Reading",78,1,0,1,80
733768,466026,2015-07-14,Senate,"Do pass, but re-refer to the Committee on Appropriations",5,4,0,0,9
733768,466027,2015-07-14,Senate,"Set, first hearing.  Held in Committee.  Reconsideration of 	favorable vote granted",7,0,2,0,9
733768,466028,2015-07-14,Senate,"Do pass as amended, and re-refer to the Committee on Appropriations",9,0,0,0,9
733768,552646,2016-06-14,Senate,"Do pass",7,1,1,0,9
733768,559892,2016-08-16,Senate,"From Committee:  That the measure be returned to the Senate floor 	for consideration",8,0,0,1,9
733768,560144,2016-08-18,Senate,"Assembly 3rd Reading AB453 Salas By Vidak Urgency Claus",35,2,2,0,39
733768,561209,2016-08-25,Assembly,"Senate amendments be concurred in",12,0,0,3,15
733768,561607,2016-08-30,Assembly,"AB 453 SALAS  Concurrence- Urgency Added",75,5,0,0,80
733772,428169,2015-04-07,Assembly,"Do pass as amended and be re-referred to the Committee on 	Appropriations",10,0,0,0,10
733772,437316,2015-04-22,Assembly,"Do pass, to Consent Calendar",17,0,0,0,17
733772,442243,2015-04-30,Assembly,"AB 439 BLOOM  Consent Calendar Second Day  Regular Session",77,0,0,3,80
733772,458555,2015-06-09,Senate,"Do pass, but re-refer to the Committee on Appropriations Recommend 	Consent",7,0,0,0,7
733772,462945,2015-06-25,Senate,"Consent Calendar 2nd AB439 Bloom",37,0,3,0,40
733773,428370,2015-04-07,Assembly,"Do pass and be re-referred to the Committee on Appropriations",13,0,0,0,13
733773,453616,2015-05-28,Assembly,"Do pass",17,0,0,0,17
733773,455247,2015-06-01,Assembly,"AB 542 WILK  Assembly Third Reading",80,0,0,0,80
733773,464706,2015-07-01,Senate,"Do pass as amended, and re-refer to the Committee on Appropriations",7,0,2,0,9
733773,473624,2015-08-17,Senate,"Placed on Appropriations Suspense file",7,0,0,0,7
733775,418472,2015-03-25,Senate,"Do pass, but re-refer to the Committee on Appropriations Recommend 	Consent",8,0,1,0,9
733775,429322,2015-04-08,Senate,"Do pass, but re-refer to the Committee on Appropriations Recommend 	Consent",9,0,0,0,9
733775,438294,2015-04-23,Senate,"Consent Calendar 2nd SB299 Monning Urgency Clause",37,0,2,0,39
733775,464795,2015-06-30,Assembly,"Do pass and be re-referred to the Committee on Appropriations to 	Consent Calendar",18,0,0,1,19
733775,465682,2015-07-08,Assembly,"Do pass, to Consent Calendar",14,0,0,3,17
733775,466548,2015-07-16,Assembly,"SB 299 Monning  Consent Calendar Second Day  Regular Session",79,0,0,1,80
733775,473959,2015-08-20,Senate,"Special Consent #6 SB299 Monning Urgency Clause",38,0,2,0,40
733778,440648,2015-04-28,Assembly,"Do pass, to Consent Calendar",15,0,0,0,15
733778,442893,2015-05-04,Assembly,"AB 549 LEVINE  Consent Calendar Second Day  Regular Session",78,0,0,2,80
733778,462144,2015-06-23,Senate,"Do pass as amended, and re-refer to the Committee on Appropriations",9,0,0,0,9
733778,465888,2015-07-13,Senate,"Placed on Appropriations Suspense file",7,0,0,0,7
733778,474702,2015-08-27,Senate,"Do pass as amended",6,1,0,0,7
733778,475507,2015-09-01,Senate,"Assembly 3rd Reading AB549 Levine By Pavley",40,0,0,0,40
733778,475683,2015-09-02,Assembly,"AB 549 LEVINE  Concurrence in Senate Amendments",80,0,0,0,80
733781,440286,2015-04-28,Senate,"Do pass as amended, and re-refer to the Committee on Appropriations",5,1,1,0,7
733781,450187,2015-05-22,Senate,"Senate 3rd Reading SB308 Wieckowski",23,13,3,0,39
733781,464305,2015-06-30,Assembly,"Do pass as amended and be re-referred to the Committee on 	Appropriations",6,3,0,1,10
733781,474223,2015-08-26,Assembly,"Do pass",12,5,0,0,17
733781,476112,2015-09-09,Assembly,"SB 308 Wieckowski  Senate Third Reading  By BLOOM",21,35,0,24,80
733781,551382,2016-06-06,Assembly,"SB 308 Wieckowski  Senate Third Reading  Amend By STONE  Set #1",40,24,0,16,80
733781,552443,2016-06-13,Assembly,"SB 308 Wieckowski  Senate Third Reading  By STONE",33,24,0,23,80
733781,560391,2016-08-19,Assembly,"SB 308 Wieckowski  Motion to Reconsider  By STONE",48,22,0,10,80
733781,561176,2016-08-25,Assembly,"SB 308 Wieckowski  Senate Third Reading  By STONE",31,32,0,17,80
733784,446176,2015-05-13,Assembly,"Do pass",5,2,0,0,7
733784,450106,2015-05-22,Assembly,"AB 554 MULLIN  Assembly Third Reading",53,21,0,6,80
733784,460314,2015-06-16,Senate,"Do pass",4,1,0,0,5
733784,465815,2015-07-09,Senate,"Assembly 3rd Reading AB554 Mullin By Allen",28,11,1,0,40
733785,433044,2015-04-14,Assembly,"Do pass and be re-referred to the Committee on Appropriations",14,0,0,0,14
733785,453628,2015-05-28,Assembly,"Do pass",17,0,0,0,17
733785,456598,2015-06-03,Assembly,"AB 507 OLSEN  Third Reading Urgency",80,0,0,0,80
733789,444251,2015-05-06,Assembly,"Do pass",6,3,0,0,9
733789,446815,2015-05-14,Assembly,"AB 504 GONZALEZ  Assembly Third Reading",53,27,0,0,80
733789,466430,2015-07-15,Senate,"Do pass as amended",5,2,0,0,7
733789,476187,2015-09-09,Senate,"Assembly 3rd Reading AB504 Gonzalez By Block",26,14,0,0,40
733789,476369,2015-09-10,Assembly,"AB 504 GONZALEZ  Concurrence in Senate Amendments",52,28,0,0,80
733792,433015,2015-04-14,Assembly,"Do pass and be re-referred to the Committee on Judiciary to Consent 	Calendar",15,0,0,0,15
733792,436294,2015-04-21,Assembly,"Do pass as amended and be re-referred to the Committee on 	Appropriations",10,0,0,0,10
733792,486290,2016-01-21,Assembly,"Do pass as amended",17,0,0,0,17
733792,488452,2016-01-27,Assembly,"AB 501 LEVINE  Assembly Third Reading",76,1,0,2,79
733792,559833,2016-08-15,Senate,"Assembly 3rd Reading AB501 Levine By Leno",38,0,1,0,39
733792,561606,2016-08-30,Assembly,"Senate amendments be concurred in",16,0,0,5,21
733792,561706,2016-08-31,Assembly,"AB 501 LEVINE  Concurrence in Senate Amendments",68,3,0,9,80
733794,432823,2015-04-15,Assembly,"Do pass and be re-referred to the Committee on Judiciary",9,0,0,0,9
733794,436344,2015-04-21,Assembly,"Do pass as amended and be re-referred to the Committee on 	Appropriations",10,0,0,0,10
733794,443878,2015-05-06,Assembly,"Do pass",17,0,0,0,17
733794,445131,2015-05-11,Assembly,"AB 552 O'DONNELL  Assembly Third Reading",79,0,0,1,80
733794,458386,2015-06-09,Senate,"Do pass, but re-refer to the Committee on Judiciary",13,0,0,0,13
733794,466401,2015-07-14,Senate,"Do pass as amended, and re-refer to the Committee on Appropriations",7,0,0,0,7
733794,476138,2015-09-09,Senate,"Assembly 3rd Reading AB552 O'Donnell By Jackson",40,0,0,0,40
733794,476279,2015-09-10,Assembly,"AB 552 O'DONNELL  Concurrence in Senate Amendments",78,0,0,2,80
733795,484777,2016-01-12,Assembly,"Do pass and be re-referred to the Committee on Appropriations",5,1,0,1,7
733795,486286,2016-01-21,Assembly,"Do pass as amended",12,5,0,0,17
733795,488942,2016-01-28,Assembly,"AB 492 GONZALEZ  Assembly Third Reading",64,9,0,6,79
733795,544262,2016-05-10,Senate,"Do pass, but re-refer to the Committee on Appropriations",4,0,1,0,5
733795,558766,2016-08-01,Senate,"Placed on Appropriations Suspense file",7,0,0,0,7
733795,559549,2016-08-11,Senate,"Do pass as amended",7,0,0,0,7
733795,560166,2016-08-18,Senate,"Assembly 3rd Reading AB492 Gonzalez By Mitchell",37,0,2,0,39
733795,561526,2016-08-30,Assembly,"AB 492 GONZALEZ  Concurrence in Senate Amendments",65,15,0,0,80
733797,430563,2015-04-13,Assembly,"Do pass and be re-referred to the Committee on Local Government",5,3,0,1,9
733797,441155,2015-04-29,Assembly,"Do pass",5,3,0,1,9
733797,446688,2015-05-14,Assembly,"AB 464 MULLIN  Assembly Third Reading",45,31,0,4,80
733797,458677,2015-06-10,Senate,"Do pass as amended",4,2,0,1,7
733797,465868,2015-07-13,Senate,"Assembly 3rd Reading AB464 Mullin By Hill",22,15,3,0,40
733797,466468,2015-07-16,Assembly,"AB 464 MULLIN  Concurrence in Senate Amendments",46,32,0,2,80
733798,432703,2015-04-14,Assembly,"Do pass as amended",8,2,0,0,10
733798,439352,2015-04-27,Assembly,"AB 560 GOMEZ  Assembly Third Reading",54,22,0,4,80
733798,460661,2015-06-16,Senate,"Do pass as amended",5,2,0,0,7
733798,465852,2015-07-13,Senate,"Assembly 3rd Reading AB560 Gomez By Hueso",30,4,6,0,40
733798,466561,2015-07-16,Assembly,"AB 560 GOMEZ  Concurrence in Senate Amendments",56,21,0,3,80
733800,440707,2015-04-28,Assembly,"Reconsideration granted",7,0,0,0,7
733803,445303,2015-05-11,Senate,"Placed on Appropriations Suspense file",7,0,0,0,7
733803,458792,2015-04-14,Senate,"Do pass as amended, and re-refer to the Committee on Appropriations",6,0,1,0,7
733804,440238,2015-04-28,Assembly,"Do pass, to Consent Calendar",15,0,0,0,15
733804,442863,2015-05-04,Assembly,"AB 499 COOLEY  Consent Calendar Second Day  Regular Session",78,0,0,2,80
733804,555029,2016-06-22,Senate,"Do pass and be placed on the Consent Calendar",8,0,1,0,9
733804,556801,2016-06-30,Senate,"Consent Calendar 2nd AB499 Cooley",37,0,3,0,40
733804,561322,2016-08-25,Assembly,"Senate amendments be concurred in",12,0,0,1,13
733804,561609,2016-08-30,Assembly,"AB 499 COOLEY  Concurrence in Senate Amendments",80,0,0,0,80
733812,414001,2015-03-19,Assembly,"From committee:  Be adopted.  To third reading",11,0,0,0,11
733812,447675,2015-05-18,Senate,"Special Consent #1 ACR29 Frazier",36,0,3,0,39
733813,443970,2015-05-05,Senate,"Do pass",7,0,0,0,7
733813,450323,2015-05-22,Senate,"Senate 3rd Reading SB340 Anderson",34,0,5,0,39
733813,460168,2015-06-16,Assembly,"Do pass, to Consent Calendar",10,0,0,0,10
733813,461904,2015-06-22,Assembly,"SB 340 Anderson  Consent Calendar Second Day  Regular Session",77,0,0,3,80
733814,445208,2015-05-11,Senate,"Placed on Appropriations Suspense file",7,0,0,0,7
733814,453614,2015-05-28,Senate,"Do pass as amended",6,0,1,0,7
733814,456709,2015-06-03,Senate,"Senate 3rd Reading SB288 McGuire",40,0,0,0,40
733814,458785,2015-04-14,Senate,"Do pass as amended, and re-refer to the Committee on Appropriations",6,0,1,0,7
733814,464427,2015-06-30,Assembly,"Do pass and be re-referred to the Committee on Appropriations to 	Consent Calendar",7,0,0,0,7
733814,465611,2015-07-08,Assembly,"Do pass, to Consent Calendar",14,0,0,3,17
733814,466521,2015-07-16,Assembly,"SB 288 McGuire  Consent Calendar Second Day  Regular Session",79,0,0,1,80
733814,473949,2015-08-20,Senate,"Special Consent #6 SB288 McGuire",38,0,2,0,40
733816,444450,2015-05-06,Assembly,"Do pass",5,2,0,0,7
733816,446718,2015-05-14,Assembly,"AB 465 HERNANDEZ  Assembly Third Reading",45,30,0,5,80
733816,458544,2015-06-10,Senate,"Do pass, but re-refer to the Committee on Judiciary",4,1,0,0,5
733816,462627,2015-06-23,Senate,"Do pass",5,2,0,0,7
733816,474057,2015-08-24,Senate,"Assembly 3rd Reading AB465 Roger Hern",22,15,3,0,40
733816,474270,2015-08-27,Assembly,"AB 465 HERNANDEZ  Concurrence in Senate Amendments",46,31,0,3,80
733818,440192,2015-04-28,Senate,"Do pass and be placed on the Consent Calendar",7,0,4,0,11
733818,442973,2015-05-04,Senate,"Consent Calendar 2nd SB327 Hall",35,0,4,0,39
733818,466402,2015-07-15,Assembly,"Do pass, to Consent Calendar",18,0,0,3,21
733818,476020,2015-09-08,Assembly,"Do pass as amended",6,0,0,1,7
733818,476508,2015-09-11,Senate,"From Committee:  That the measure be returned to the Senate floor 	for consideration",4,0,1,0,5
733818,476509,2015-09-11,Senate,"Unfinished Business (S upplemental File 2)SB3 27 Her nandez Urg",36,0,4,0,40
733818,476510,2015-09-11,Assembly,"SB 327 Hernandez  Third Reading Urgency  By LOW",78,0,0,2,80
733819,458762,2015-04-14,Senate,"Do pass, but re-refer to the Committee on Appropriations",6,0,0,1,7
733819,463633,2015-04-27,Senate,"Placed on Appropriations Suspense file",7,0,0,0,7
733821,440248,2015-04-27,Assembly,"Do pass and be re-referred to the Committee on Appropriations",9,0,0,0,9
733821,454263,2015-05-28,Assembly,"Do pass",17,0,0,0,17
733821,455389,2015-06-01,Assembly,"AB 446 RIDLEY-THOMAS  Assembly Third Reading",77,0,0,3,80
733821,465979,2015-07-14,Senate,"Do pass, but re-refer to the Committee on Appropriations",9,0,0,0,9
733821,473807,2015-08-17,Senate,"Placed on Appropriations Suspense file",7,0,0,0,7
733821,474652,2015-08-27,Senate,"Do pass as amended",7,0,0,0,7
733821,475608,2015-09-02,Senate,"Assembly 3rd Reading AB446 Ridley-Thomas By Mitchell",40,0,0,0,40
733821,475743,2015-09-03,Assembly,"AB 446 RIDLEY-THOMAS  Concurrence in Senate Amendments",78,0,0,2,80
733822,429523,2015-04-08,Senate,"Do pass, but re-refer to the Committee on Appropriations",8,0,1,0,9
733822,435345,2015-04-20,Senate,"Placed on Appropriations Suspense file",7,0,0,0,7
733822,453892,2015-05-28,Senate,"Do pass as amended",7,0,0,0,7
733822,456667,2015-06-03,Senate,"Senate 3rd Reading SB326 Beall",31,5,4,0,40
733822,464728,2015-06-30,Assembly,"Do pass and be re-referred to the Committee on Appropriations",18,0,0,1,19
733822,474471,2015-08-27,Assembly,"Do pass as amended",17,0,0,0,17
733822,476246,2015-09-10,Assembly,"SB 326 Beall  Senate Third Reading  By WOOD",74,0,0,6,80
733822,476616,2015-09-11,Senate,"Unfinished Business SB326 Beall Concurrence",39,1,0,0,40
733824,429323,2015-04-08,Assembly,"Do pass and be re-referred to the Committee on Appropriations",5,0,0,2,7
733824,437211,2015-04-22,Assembly,"Do pass",12,0,0,5,17
733824,439388,2015-04-27,Assembly,"AB 520 LEVINE  Assembly Third Reading",60,0,0,20,80
733824,552054,2016-06-08,Senate,"Do pass, but re-refer to the Committee on Appropriations",3,0,2,0,5
733824,560036,2016-08-17,Senate,"From Committee:  That the measure be returned to the Senate floor 	for consideration",4,1,0,0,5
733824,560472,2016-08-22,Senate,"Assembly 3rd Reading AB520 Levine By Mendoza",27,12,0,0,39
733824,561371,2016-08-29,Assembly,"Senate amendments be concurred in",5,2,0,0,7
733826,432569,2015-04-14,Assembly,"Do pass and be re-referred to the Committee on Appropriations",10,4,0,1,15
733826,437476,2015-04-22,Assembly,"Do pass",12,4,0,1,17
733826,442323,2015-04-30,Assembly,"AB 559 LOPEZ  Assembly Third Reading",58,18,0,4,80
733826,462174,2015-06-23,Senate,"Do pass, but re-refer to the Committee on Appropriations",7,2,0,0,9
733826,465276,2015-07-06,Senate,"Do pass",5,2,0,0,7
733826,475300,2015-08-31,Senate,"Assembly 3rd Reading AB559 Lopez By Jackson",28,12,0,0,40
733826,476388,2015-09-10,Senate,"Assembly 3rd Reading AB559 Lopez By Jackson",27,11,2,0,40
733826,476570,2015-09-11,Assembly,"AB 559 LOPEZ  Concurrence in Senate Amendments",63,13,0,4,80
733827,432724,2015-04-14,Assembly,"Do pass as amended and be re-referred to the Committee on Health",10,4,0,0,14
733827,441204,2015-04-28,Assembly,"Do pass as amended and be re-referred to the Committee on 	Appropriations",11,7,0,1,19
733827,446267,2015-05-13,Assembly,"Do pass",13,3,0,1,17
733827,457284,2015-06-04,Assembly,"AB 502 CHAU  Assembly Third Reading",80,0,0,0,80
733827,465424,2015-07-06,Senate,"Do pass, but re-refer to the Committee on Health Recommend Consent",9,0,0,0,9
733827,476333,2015-09-10,Senate,"Assembly 3rd Reading AB502 Chau By Hill",40,0,0,0,40
733827,476651,2015-09-11,Assembly,"AB 502 CHAU  Concurrence in Senate Amendments",79,0,0,1,80
733829,430588,2015-04-13,Assembly,"Be referred to Committee on Human Services",11,0,0,0,11
733829,441152,2015-04-28,Assembly,"Do pass and be re-referred to the Committee on Budget",7,0,0,0,7
733831,441290,2015-04-29,Senate,"Do pass, but re-refer to the Committee on Appropriations",5,1,1,0,7
733831,450257,2015-05-22,Senate,"Senate 3rd Reading SB331 Mendoza",25,14,0,0,39
733831,464689,2015-07-01,Assembly,"Do pass and be re-referred to the Committee on Appropriations",5,4,0,0,9
733831,474251,2015-08-27,Assembly,"Do pass",12,5,0,0,17
733831,476041,2015-09-08,Assembly,"SB 331 Mendoza  Senate Third Reading  By GONZALEZ",48,29,0,3,80
733831,476374,2015-09-10,Senate,"Unfinished Business SB331 Mendoza Concurrence",22,15,3,0,40
733832,427885,2015-04-07,Assembly,"Do pass as amended and be re-referred to the Committee on 	Appropriations",7,0,0,0,7
733832,437278,2015-04-22,Assembly,"Do pass, to Consent Calendar",17,0,0,0,17
733832,442935,2015-05-04,Assembly,"AB 487 GONZALEZ  Assembly Third Reading",77,0,0,3,80
733832,462355,2015-06-23,Senate,"Do pass as amended, and re-refer to the Committee on Appropriations",7,0,0,0,7
733832,474163,2015-08-24,Senate,"Assembly 3rd Reading AB487 Gonzalez By Hancock",40,0,0,0,40
733832,474359,2015-08-27,Assembly,"AB 487 GONZALEZ  Concurrence in Senate Amendments",78,0,0,2,80
733834,437340,2015-04-22,Senate,"Do pass as amended, and re-refer to the Committee on Appropriations",7,0,2,0,9
733834,445108,2015-05-11,Senate,"Placed on Appropriations Suspense file",7,0,0,0,7
733834,454109,2015-05-28,Senate,"Do pass",7,0,0,0,7
733834,455379,2015-06-01,Senate,"Senate 3rd Reading SB291 Lara",36,1,3,0,40
733834,466145,2015-07-14,Assembly,"Do pass as amended and be re-referred to the Committee on 	Appropriations",18,0,0,1,19
733834,473875,2015-08-19,Assembly,"Do pass, to Consent Calendar",17,0,0,0,17
733834,476179,2015-09-09,Assembly,"SB 291 Lara  Senate Third Reading  By O'DONNELL",80,0,0,0,80
733834,476296,2015-09-10,Senate,"Unfinished Business SB291 Lara Concurrence",37,1,2,0,40
733835,440202,2015-04-28,Senate,"Do pass as amended, and re-refer to the Committee on Governance and 	Finance",7,1,1,0,9
733835,443907,2015-05-06,Senate,"Do pass, but re-refer to the Committee on Appropriations",5,1,1,0,7
733835,453974,2015-05-28,Senate,"Do pass",5,1,1,0,7
733835,463571,2015-05-18,Senate,"Placed on Appropriations Suspense file",7,0,0,0,7
733838,427868,2015-04-07,Assembly,"Do pass and be re-referred to the Committee on Appropriations to 	Consent Calendar",7,0,0,0,7
733838,433928,2015-04-15,Assembly,"Do pass, to Consent Calendar",16,0,0,1,17
733838,438153,2015-04-23,Assembly,"AB 546 GONZALEZ  Consent Calendar Second Day  Regular Session",78,0,0,2,80
733838,462195,2015-06-23,Senate,"Do pass, but re-refer to the Committee on Appropriations",7,0,0,0,7
733838,465885,2015-07-13,Senate,"Assembly 3rd Reading AB546 Gonzalez By Glazer",40,0,0,0,40
733838,466505,2015-07-16,Assembly,"AB 546 GONZALEZ  Concurrence in Senate Amendments",78,0,0,2,80
733840,442131,2015-04-30,Senate,"Senate 3rd Reading SCR20 Galgiani",37,0,2,0,39
733840,453938,2015-05-28,Assembly,"Be adopted, to Consent Calendar",11,0,0,0,11
733840,456112,2015-06-02,Assembly,"SCR 20 Galgiani  Consent Calendar Second Day  Regular Session",78,0,0,2,80
733841,432559,2015-04-15,Senate,"Do pass, but re-refer to the Committee on Judiciary",7,0,0,0,7
733841,437413,2015-04-21,Senate,"Do pass as amended, and re-refer to the Committee on Appropriations",7,0,0,0,7
733841,450256,2015-05-22,Senate,"Senate 3rd Reading SB300 Mendoza",39,0,0,0,39
733841,462184,2015-06-22,Assembly,"Do pass and be re-referred to the Committee on Privacy and Consumer 	Protection",12,0,0,0,12
733841,465413,2015-07-07,Assembly,"Do pass and be re-referred to the Committee on Appropriations",11,0,0,0,11
733841,466322,2015-07-15,Assembly,"Do pass as amended, to Consent Calendar",16,0,0,1,17
733841,475958,2015-09-08,Assembly,"SB 300 Mendoza  Senate Third Reading",78,0,0,2,80
733841,476299,2015-09-10,Senate,"Unfinished Business SB300 Mendoza Concurrence",40,0,0,0,40
733843,427816,2015-04-07,Assembly,"Do pass, to Consent Calendar",10,0,0,0,10
733843,430650,2015-04-13,Assembly,"AB 468 JONES  Consent Calendar Second Day  Regular Session",79,0,0,1,80
733843,463107,2015-06-24,Senate,"Do pass and be placed on the Consent Calendar",8,0,1,0,9
733843,464924,2015-07-02,Senate,"Consent Calendar 2nd AB468 Jones",38,0,2,0,40
733844,432857,2015-04-14,Assembly,"Do pass and be re-referred to the Committee on Appropriations",8,7,0,0,15
733846,441432,2015-04-28,Assembly,"Do pass and be re-referred to the Committee on Appropriations",9,3,0,1,13
733848,484032,2016-01-06,Assembly,"Do pass",7,0,0,0,7
733848,485032,2016-01-15,Assembly,"AB 488 GONZALEZ  Assembly Third Reading",69,0,0,10,79
733848,553107,2016-06-14,Senate,"Do pass as amended",5,2,0,0,7
733848,559792,2016-08-15,Senate,"Assembly 3rd Reading AB488 Gonzalez By Hueso",26,11,2,0,39
733848,561596,2016-08-30,Assembly,"AB 488 GONZALEZ  Concurrence in Senate Amendments",79,0,0,1,80
733849,439446,2015-04-27,Senate,"Do pass",3,2,0,0,5
733849,442957,2015-05-04,Senate,"Senate 3rd Reading SB292 Pan",25,10,4,0,39
733849,462672,2015-06-24,Assembly,"Do pass as amended",5,0,0,2,7
733849,476639,2015-09-11,Assembly,"SB 292 Pan  Senate Third Reading  By BONTA",48,25,0,7,80
733849,476640,2015-09-11,Senate,"Unfinished Business (S upplemental File 4)SB2 92 Pan Con",27,12,1,0,40
733851,427845,2015-04-07,Assembly,"Do pass and be re-referred to the Committee on Appropriations to 	Consent Calendar",18,0,0,1,19
733851,434059,2015-04-15,Assembly,"Do pass, to Consent Calendar",16,0,0,1,17
733851,437907,2015-04-23,Assembly,"AB 444 GIPSON  Consent Calendar Second Day  Regular Session",78,0,0,2,80
733851,460684,2015-06-17,Senate,"Do pass, but re-refer to the Committee on Appropriations Recommend 	Consent",9,0,0,0,9
733851,464940,2015-07-02,Senate,"Consent Calendar 2nd AB444 Gipson",38,0,2,0,40
733851,465808,2015-07-09,Assembly,"AB 444 GIPSON  Concurrence in Senate Amendments",79,0,0,1,80
733855,432635,2015-04-15,Assembly,"Do pass and be re-referred to the Committee on Appropriations",4,2,0,1,7
733855,441571,2015-04-29,Assembly,"Do pass",12,5,0,0,17
733855,446783,2015-05-14,Assembly,"AB 477 MULLIN  Assembly Third Reading",50,29,0,1,80
733855,465480,2015-07-07,Senate,"Do pass, but re-refer to the Committee on Appropriations",4,0,1,0,5
733855,473653,2015-08-17,Senate,"Placed on Appropriations Suspense file",7,0,0,0,7
733855,474505,2015-08-27,Senate,"Do pass as amended",5,2,0,0,7
733855,475822,2015-09-03,Senate,"Assembly 3rd Reading AB477 Mullin By Allen",26,14,0,0,40
733855,476141,2015-09-09,Assembly,"Senate amendments be concurred in",4,2,0,1,7
733855,476254,2015-09-10,Assembly,"AB 477 MULLIN  Concurrence in Senate Amendments",50,30,0,0,80
733858,437305,2015-04-22,Assembly,"Do pass as amended and be re-referred to the Committee on 	Appropriations",20,0,0,1,21
733858,449110,2015-05-20,Assembly,"Do pass, to Consent Calendar",15,0,0,2,17
733858,451864,2015-05-26,Assembly,"AB 527 DODD  Consent Calendar Second Day  Regular Session",76,0,0,4,80
733858,463985,2015-06-29,Senate,"Do pass, but re-refer to the Committee on Appropriations",12,0,1,0,13
733858,476330,2015-09-10,Senate,"Assembly 3rd Reading AB527 Dodd By Wolk",40,0,0,0,40
733858,476481,2015-09-11,Assembly,"AB 527 DODD  Concurrence in Senate Amendments",78,0,0,2,80
733860,437247,2015-04-22,Senate,"Do pass, but re-refer to the Committee on Appropriations",9,0,0,0,9
733860,445158,2015-05-11,Senate,"Placed on Appropriations Suspense file",7,0,0,0,7
733860,453972,2015-05-28,Senate,"Do pass",6,1,0,0,7
733860,455250,2015-06-01,Senate,"Senate 3rd Reading SB320 Lara",39,0,1,0,40
733860,466373,2015-07-15,Assembly,"Do pass and be re-referred to the Committee on Appropriations to 	Consent Calendar",7,0,0,0,7
733860,474318,2015-08-27,Assembly,"Do pass",17,0,0,0,17
733860,475976,2015-09-08,Assembly,"SB 320 Lara  Senate Third Reading  By THURMOND",78,0,0,2,80
733860,476341,2015-09-10,Senate,"Unfinished Business SB320 Lara Concurrence",40,0,0,0,40
733861,427833,2015-04-07,Assembly,"Do pass and be re-referred to the Committee on Appropriations",2,1,0,4,7
733861,463746,2015-04-07,Assembly,"Reconsideration granted",7,0,0,0,7
733863,484760,2016-01-12,Assembly,"Do pass and be re-referred to the Committee on Appropriations",19,0,0,0,19
733863,486314,2016-01-21,Assembly,"Do pass as amended",17,0,0,0,17
733863,488331,2016-01-27,Assembly,"AB 508 GARCIA, C.  Assembly Third Reading",77,0,0,2,79
733865,429058,2015-04-08,Assembly,"Do pass",9,0,0,0,9
733865,434103,2015-04-16,Assembly,"AB 451 BONILLA  Assembly Third Reading",79,0,0,1,80
733865,460284,2015-06-16,Senate,"Do pass as amended",11,0,0,0,11
733865,465209,2015-07-06,Senate,"Special Consent #4 AB451 Bonilla",39,0,1,0,40
733865,465786,2015-07-09,Assembly,"AB 451 BONILLA  Concurrence in Senate Amendments",79,0,0,1,80
733868,483997,2016-01-06,Assembly,"Do pass",1,5,0,1,7
733870,427928,2015-04-07,Assembly,"Do pass",7,0,0,0,7
733870,434101,2015-04-16,Assembly,"AB 539 LEVINE  Assembly Third Reading",79,0,0,1,80
733870,458635,2015-06-09,Senate,"Do pass",7,0,0,0,7
733870,462931,2015-06-25,Senate,"Assembly 3rd Reading AB539 Levine By Monning",38,0,2,0,40
733870,463932,2015-06-29,Assembly,"AB 539 LEVINE  Concurrence in Senate Amendments",76,0,0,4,80
733871,427855,2015-04-07,Assembly,"Amend, and do pass as amended and be re-referred to the Committee 	on Appropriations with the recommendation:  To Consent Calendar",10,0,0,0,10
733871,437612,2015-04-22,Assembly,"Do pass, to Consent Calendar",17,0,0,0,17
733871,442293,2015-04-30,Assembly,"AB 536 BLOOM  Consent Calendar Second Day  Regular Session",77,0,0,3,80
733871,458817,2015-06-09,Senate,"Do pass, but re-refer to the Committee on Appropriations Recommend 	Consent",7,0,0,0,7
733871,462993,2015-06-25,Senate,"Consent Calendar 2nd AB536 Bloom",37,0,3,0,40
733874,441253,2015-04-29,Assembly,"Do pass and be re-referred to the Committee on Appropriations",9,0,0,0,9
733874,446486,2015-05-13,Assembly,"Do pass as amended, to Consent Calendar",17,0,0,0,17
733874,451729,2015-05-26,Assembly,"AB 532 MCCARTY  Consent Calendar Second Day",76,0,0,4,80
733874,463905,2015-06-29,Senate,"Do pass, but re-refer to the Committee on Appropriations",10,2,1,0,13
733874,473774,2015-08-17,Senate,"Placed on Appropriations Suspense file",7,0,0,0,7
733874,474662,2015-08-27,Senate,"Do pass as amended",6,1,0,0,7
733874,476011,2015-09-08,Senate,"Assembly 3rd Reading AB532 McCarty By Hall",40,0,0,0,40
733874,476170,2015-09-09,Assembly,"AB 532 MCCARTY  Concurrence in Senate Amendments",77,0,0,3,80
733875,440151,2015-04-27,Assembly,"Do pass as amended and be re-referred to the Committee on 	Appropriations",9,0,0,0,9
733875,454155,2015-05-28,Assembly,"Do pass",17,0,0,0,17
733875,455563,2015-06-01,Assembly,"AB 515 EGGMAN  Assembly Third Reading",78,0,0,2,80
733875,473792,2015-08-17,Senate,"Placed on Appropriations Suspense file",7,0,0,0,7
733875,474691,2015-08-27,Senate,"Do pass",7,0,0,0,7
733875,475444,2015-09-01,Senate,"Assembly 3rd Reading AB515 Eggman By Hertzberg",40,0,0,0,40
733875,475610,2015-09-02,Assembly,"AB 515 EGGMAN  Concurrence in Senate Amendments",80,0,0,0,80
733877,408713,2015-03-09,Assembly,"From committee:  Be adopted.  To third reading",11,0,0,0,11
733877,447610,2015-05-18,Senate,"Special Consent #1 ACR28 Mullin",36,0,3,0,39
733878,437381,2015-04-21,Senate,"Do pass as amended, and re-refer to the Committee on Appropriations",3,1,1,0,5
733878,445233,2015-05-11,Senate,"Placed on Appropriations Suspense file",7,0,0,0,7
733879,428528,2015-04-07,Assembly,"Do pass and be re-referred to the Committee on Appropriations",11,1,0,1,13
733881,440335,2015-04-27,Assembly,"Do pass and be re-referred to the Committee on Appropriations",16,0,0,0,16
733881,454045,2015-05-28,Assembly,"Do pass as amended",12,0,0,5,17
733881,457331,2015-06-04,Assembly,"AB 516 MULLIN  Assembly Third Reading",74,1,0,5,80
733881,465482,2015-07-07,Senate,"Do pass, but re-refer to the Committee on Public Safety",10,0,1,0,11
733881,466245,2015-07-14,Senate,"Do pass as amended, and re-refer to the Committee on Appropriations",5,2,0,0,7
733881,474148,2015-08-24,Senate,"Placed on Appropriations Suspense file",7,0,0,0,7
733881,474643,2015-08-27,Senate,"Do pass",6,1,0,0,7
733881,556737,2016-06-30,Senate,"Assembly 3rd Reading AB516 Mullin By Hill",30,6,4,0,40
733881,556738,2016-06-30,Assembly,"AB 516 MULLIN  Concurrence in Senate Amendments",73,0,0,7,80
733882,437070,2015-04-22,Senate,"Do pass as amended, and re-refer to the Committee on Appropriations",7,2,0,0,9
733882,463629,2015-05-18,Senate,"Placed on Appropriations Suspense file",7,0,0,0,7
733884,429096,2015-04-08,Assembly,"Do pass",9,0,0,0,9
733884,433976,2015-04-16,Assembly,"AB 495 GORDON  Assembly Third Reading",79,0,0,1,80
733884,458976,2015-06-10,Senate,"Do pass as amended",7,0,0,0,7
733884,465818,2015-07-09,Senate,"Assembly 3rd Reading AB495 Gordon By Hancock",39,0,1,0,40
733886,433399,2015-04-15,Senate,"Do pass as amended, and re-refer to the Committee on Appropriations",7,0,0,0,7
733886,455391,2015-06-01,Senate,"Senate 3rd Reading SB321 Beall",40,0,0,0,40
733886,466105,2015-07-13,Assembly,"Do pass as amended and be re-referred to the Committee on 	Appropriations",9,0,0,0,9
733886,474222,2015-08-26,Assembly,"Do pass, to Consent Calendar",17,0,0,0,17
733886,476261,2015-09-10,Assembly,"SB 321 Beall  Senate Third Reading  By TING",80,0,0,0,80
733887,438242,2015-04-23,Assembly,"Be referred to Committee on Judiciary",10,0,0,1,11
733887,483904,2016-01-05,Assembly,"Be referred to Committee on Human Services",11,0,0,0,11
733889,430839,2015-04-13,Assembly,"Do pass and be re-referred to the Committee on Revenue and Taxation",11,0,0,1,12
733889,440407,2015-04-27,Assembly,"Do pass and be re-referred to the Committee on Appropriations",9,0,0,0,9
733889,453918,2015-05-28,Assembly,"Do pass as amended",17,0,0,0,17
733889,456163,2015-06-02,Assembly,"AB 557 IRWIN  Assembly Third Reading",78,0,0,2,80
733889,466395,2015-07-15,Senate,"Do pass, but re-refer to the Committee on Appropriations Recommend 	Consent",6,0,1,0,7
733889,473945,2015-08-20,Senate,"Consent Calendar 2nd AB557 Irwin",38,0,2,0,40
733889,474425,2015-08-27,Assembly,"AB 557 IRWIN  Concurrence in Senate Amendments",78,0,0,2,80
733890,433624,2015-04-14,Assembly,"Do pass and be re-referred to the Committee on Appropriations",7,7,0,1,15
733892,433351,2015-04-15,Assembly,"Do pass and be re-referred to the Committee on Appropriations",4,1,0,2,7
733894,432929,2015-04-15,Senate,"Do pass, but re-refer to the Committee on Appropriations",8,0,0,0,8
733894,445200,2015-05-11,Senate,"Placed on Appropriations Suspense file",7,0,0,0,7
733894,453631,2015-05-28,Senate,"Do pass as amended",7,0,0,0,7
733894,455944,2015-06-02,Senate,"Senate 3rd Reading SB311 Beall Urgency Clause",40,0,0,0,40
733894,464880,2015-07-01,Assembly,"Do pass as amended and be re-referred to the Committee on 	Appropriations",6,0,0,1,7
733895,442220,2015-04-29,Senate,"Do pass as amended, and re-refer to the Committee on Appropriations",8,1,0,0,9
733895,453796,2015-05-28,Senate,"Do pass",5,2,0,0,7
733895,455421,2015-06-01,Senate,"Senate 3rd Reading SB315 Monning",29,10,1,0,40
733895,463635,2015-05-18,Senate,"Placed on Appropriations Suspense file",7,0,0,0,7
733895,464928,2015-06-30,Assembly,"Do pass and be re-referred to the Committee on Appropriations",18,0,0,1,19
733895,474421,2015-08-27,Assembly,"Do pass as amended",17,0,0,0,17
733897,437864,2015-04-22,Assembly,"Do pass as amended and be re-referred to the Committee on 	Appropriations",7,0,0,0,7
733897,454217,2015-05-28,Assembly,"Do pass",17,0,0,0,17
733897,455348,2015-06-01,Assembly,"AB 491 GONZALEZ  Assembly Third Reading",80,0,0,0,80
733897,553403,2016-06-15,Senate,"Do pass as amended, and re-refer to the Committee on Appropriations",9,0,0,0,9
733897,558836,2016-08-01,Senate,"Placed on Appropriations Suspense file",7,0,0,0,7
733897,559705,2016-08-11,Senate,"Do pass as amended",7,0,0,0,7
733897,559954,2016-08-16,Senate,"Assembly 3rd Reading AB491 Gonzalez By Lara",38,0,1,0,39
733897,561023,2016-08-24,Senate,"Assembly 3rd Reading AB491 Gonzalez By Lara",39,0,0,0,39
733897,561672,2016-08-29,Assembly,"Senate amendments be concurred in",6,0,0,1,7
733897,561819,2016-08-31,Assembly,"AB 491 GONZALEZ  Concurrence in Senate Amendments",78,0,0,2,80
733898,433201,2015-04-14,Assembly,"Do pass and be re-referred to the Committee on Appropriations",9,0,0,0,9
733898,437241,2015-04-22,Assembly,"Do pass, to Consent Calendar",17,0,0,0,17
733898,442344,2015-04-30,Assembly,"AB 442 IRWIN  Consent Calendar Second Day  Regular Session",77,0,0,3,80
733898,462222,2015-06-23,Senate,"Do pass, but re-refer to the Committee on Appropriations Recommend 	Consent",5,0,0,0,5
733898,473701,2015-08-17,Senate,"Do pass",7,0,0,0,7
733898,475337,2015-08-31,Senate,"Special Consent #8 AB442 Irwin",40,0,0,0,40
733903,427976,2015-04-07,Assembly,"Do pass as amended",10,0,0,0,10
733903,434169,2015-04-16,Assembly,"AB 494 MAIENSCHEIN  Assembly Third Reading",79,0,0,1,80
733903,458603,2015-06-09,Senate,"Do pass and be placed on the Consent Calendar",7,0,0,0,7
733903,475544,2015-09-01,Senate,"Assembly 3rd Reading AB494 Maienschein By Jackson",38,0,2,0,40
733903,475585,2015-09-02,Assembly,"AB 494 MAIENSCHEIN  Concurrence in Senate Amendments",79,0,0,1,80
733904,443912,2015-05-06,Senate,"Do pass, but re-refer to the Committee on Appropriations Recommend 	Consent",7,0,0,0,7
733904,450279,2015-05-22,Senate,"Special Consent #2 SB295 De Le",38,0,1,0,39
733904,463570,2015-05-18,Senate,"Do pass",7,0,0,0,7
733904,466059,2015-07-14,Assembly,"Do pass and be re-referred to the Committee on Governmental 	Organization",6,1,0,0,7
733904,466323,2015-07-15,Assembly,"Do pass as amended and be re-referred to the Committee on 	Appropriations",18,0,0,3,21
733904,474433,2015-08-27,Assembly,"Do pass",16,1,0,0,17
733904,475458,2015-09-01,Assembly,"SB 295 Jackson  Senate Third Reading  By WILLIAMS",73,1,0,6,80
733904,476229,2015-09-10,Senate,"Unfinished Business SB295 Jackson Concurrence",27,9,4,0,40
733904,485074,2015-09-03,Senate,"From committee:  That the Assembly Amendments be concurred in",10,1,2,0,13
733906,435154,2015-04-20,Assembly,"Do pass as amended and be re-referred to the Committee on 	Appropriations",7,0,0,2,9
733906,441240,2015-04-29,Assembly,"Do pass, to Consent Calendar",17,0,0,0,17
733906,444447,2015-05-07,Assembly,"AB 485 WILLIAMS  Consent Calendar Second Day  Regular Session",77,0,0,3,80
733906,473636,2015-08-17,Senate,"Placed on Appropriations Suspense file",7,0,0,0,7
733906,474689,2015-08-27,Senate,"Do pass",7,0,0,0,7
733906,476132,2015-09-09,Senate,"Assembly 3rd Reading AB485 Williams By Allen",39,0,1,0,40
733906,476427,2015-09-10,Assembly,"AB 485 WILLIAMS  Concurrence in Senate Amendments",80,0,0,0,80
733909,437119,2015-04-22,Senate,"Do pass as amended, but re-refer to the Committee on Governance and 	Finance Recommend Consent",9,0,0,0,9
733909,443934,2015-05-06,Senate,"Do pass as amended",7,0,0,0,7
733909,487035,2016-01-25,Senate,"Senate 3rd Reading SB313 Monning",29,3,8,0,40
733911,465889,2015-07-13,Senate,"Do pass",7,0,0,0,7
733911,466509,2015-07-16,Senate,"Senate 3rd Reading SB304 Lara Urgency Clause",36,0,4,0,40
733911,474219,2015-08-26,Assembly,"Do pass",17,0,0,0,17
733911,475259,2015-08-31,Assembly,"SB 304 Lara  Third Reading Urgency  By GOMEZ",79,0,0,1,80
733912,436579,2015-04-21,Assembly,"Do pass",6,0,0,1,7
733912,442265,2015-04-30,Assembly,"AB 526 HOLDEN  Assembly Third Reading",77,0,0,3,80
733912,462345,2015-06-23,Senate,"Do pass",7,0,0,0,7
733912,560643,2016-08-23,Senate,"Do pass",6,0,1,0,7
733912,561244,2016-08-25,Senate,"Assembly 3rd Reading AB526 Holden By Fuller Urgency Clau",39,0,0,0,39
733912,561802,2016-08-31,Assembly,"AB 526 HOLDEN  Concurrence- Urgency Added",79,0,0,1,80
733914,428068,2015-04-07,Assembly,"Do pass and be re-referred to the Committee on Appropriations",17,0,0,2,19
733914,433883,2015-04-15,Assembly,"Do pass, to Consent Calendar",16,0,0,1,17
733914,438207,2015-04-23,Assembly,"AB 503 RODRIGUEZ  Assembly Third Reading",78,0,0,2,80
733914,464781,2015-07-01,Senate,"Do pass as amended, and re-refer to the Committee on Judiciary",8,0,1,0,9
733914,466241,2015-07-14,Senate,"Do pass, but re-refer to the Committee on Appropriations",7,0,0,0,7
733914,474356,2015-08-27,Senate,"Assembly 3rd Reading AB503 Rodriguez By Hernandez",38,0,2,0,40
733914,475358,2015-08-31,Assembly,"AB 503 RODRIGUEZ  Concurrence in Senate Amendments",80,0,0,0,80
733916,432711,2015-04-14,Senate,"Do pass, but re-refer to the Committee on Appropriations Recommend 	Consent",10,0,1,0,11
733916,442195,2015-04-30,Senate,"Consent Calendar 2nd SB325 Hall",34,0,5,0,39
733916,466249,2015-07-15,Assembly,"Do pass and be re-referred to the Committee on Appropriations to 	Consent Calendar",18,0,0,3,21
733916,473874,2015-08-19,Assembly,"Do pass, to Consent Calendar",17,0,0,0,17
733916,474382,2015-08-27,Assembly,"SB 325 Hall  Consent Calendar Second Day  Regular Session",78,0,0,2,80
733917,446337,2015-05-13,Assembly,"Do pass as amended",4,3,0,0,7
733917,450071,2015-05-22,Assembly,"AB 547 GONZALEZ  Assembly Third Reading",51,24,0,5,80
733917,465460,2015-07-07,Senate,"Do pass",4,0,1,0,5
733917,474137,2015-08-24,Senate,"Assembly 3rd Reading AB547 Gonzalez By Allen",28,11,1,0,40
733919,433167,2015-04-15,Assembly,"Do pass and be re-referred to the Committee on Appropriations",9,0,0,0,9
733919,453941,2015-05-28,Assembly,"Do pass as amended",17,0,0,0,17
733919,455963,2015-06-02,Assembly,"AB 522 BURKE  Assembly Third Reading",78,0,0,2,80
733919,473748,2015-08-17,Senate,"Placed on Appropriations Suspense file",7,0,0,0,7
733919,474614,2015-08-27,Senate,"Do pass as amended",5,2,0,0,7
733919,476197,2015-09-09,Senate,"Assembly 3rd Reading AB522 Burke By Hall",28,10,2,0,40
733919,476392,2015-09-10,Assembly,"AB 522 BURKE  Concurrence in Senate Amendments",80,0,0,0,80
733920,440133,2015-04-27,Assembly,"Do pass as amended and be re-referred to the Committee on 	Appropriations",9,0,0,0,9
733920,453844,2015-05-28,Assembly,"Do pass",17,0,0,0,17
733920,456160,2015-06-02,Assembly,"AB 449 IRWIN  Assembly Third Reading",79,0,0,1,80
733920,462599,2015-06-24,Senate,"Do pass as amended, and re-refer to the Committee on Appropriations",7,0,0,0,7
733920,465954,2015-07-13,Senate,"Placed on Appropriations Suspense file",7,0,0,0,7
733920,474514,2015-08-27,Senate,"Do pass",7,0,0,0,7
733920,475912,2015-09-08,Senate,"Assembly 3rd Reading AB449 Irwin By Pavley",39,0,1,0,40
733920,476070,2015-09-09,Assembly,"AB 449 IRWIN  Concurrence in Senate Amendments",80,0,0,0,80
733922,428323,2015-04-08,Assembly,"Do pass and be re-referred to the Committee on Appropriations",21,0,0,0,21
733922,434057,2015-04-15,Assembly,"Do pass, to Consent Calendar",16,0,0,1,17
733922,438041,2015-04-23,Assembly,"AB 467 CHANG  Consent Calendar Second Day  Regular Session",78,0,0,2,80
733922,458289,2015-06-09,Senate,"Do pass, but re-refer to the Committee on Appropriations Recommend 	Consent",13,0,0,0,13
733922,463009,2015-06-25,Senate,"Consent Calendar 2nd AB467 Chang",37,0,3,0,40
733922,464921,2015-07-02,Assembly,"AB 467 CHANG  Concurrence in Senate Amendments",78,0,0,2,80
733925,437202,2015-04-21,Assembly,"Do pass as amended and be re-referred to the Committee on 	Appropriations",13,5,0,1,19
733925,453922,2015-05-28,Assembly,"Do pass as amended",12,5,0,0,17
733925,457269,2015-06-04,Assembly,"AB 521 NAZARIAN  Assembly Third Reading",51,21,0,8,80
733925,465803,2015-07-08,Senate,"Do pass, but re-refer to the Committee on Judiciary",6,2,1,0,9
733925,473746,2015-08-17,Senate,"Placed on Appropriations Suspense file",7,0,0,0,7
733925,474605,2015-08-27,Senate,"Do pass",5,2,0,0,7
733925,476435,2015-09-10,Senate,"Assembly 3rd Reading AB521 Nazarian By Hall",27,11,2,0,40
733925,476604,2015-09-11,Assembly,"AB 521 NAZARIAN  Concurrence in Senate Amendments",53,20,0,7,80
733927,441017,2015-04-29,Assembly,"Do pass as amended and be re-referred to the Committee on 	Appropriations",6,2,0,1,9
733927,448936,2015-05-20,Assembly,"Do pass",11,4,0,2,17
733927,450181,2015-05-22,Assembly,"AB 514 WILLIAMS  Assembly Third Reading",47,27,0,6,80
733927,465662,2015-07-08,Senate,"Do pass as amended, and re-refer to the Committee on Appropriations",5,1,1,0,7
733927,475316,2015-08-31,Senate,"Assembly 3rd Reading AB514 Williams By Pavley",25,15,0,0,40
733927,475661,2015-09-02,Assembly,"AB 514 WILLIAMS  Concurrence in Senate Amendments",52,28,0,0,80
733928,441725,2015-04-28,Senate,"Do pass as amended, and re-refer to the Committee on Appropriations",4,1,0,0,5
733928,463653,2015-05-18,Senate,"Placed on Appropriations Suspense file",7,0,0,0,7
733930,428420,2015-04-08,Assembly,"Do pass and be re-referred to the Committee on Judiciary to Consent 	Calendar",12,0,0,1,13
733930,436086,2015-04-21,Assembly,"Amend, and do pass as amended and be re-referred to the Committee 	on Appropriations with the recommendation:  To Consent Calendar",10,0,0,0,10
733930,443902,2015-05-06,Assembly,"Do pass, to Consent Calendar",17,0,0,0,17
733930,446654,2015-05-14,Assembly,"AB 553 DALY  Consent Calendar Second Day  Regular Session",78,0,0,2,80
733930,459398,2015-06-10,Senate,"Do pass, but re-refer to the Committee on Judiciary Recommend 	Consent",9,0,0,0,9
733930,462596,2015-06-23,Senate,"Do pass, but re-refer to the Committee on Appropriations Recommend 	Consent",7,0,0,0,7
733930,465779,2015-07-09,Senate,"Consent Calendar 2nd AB553 Daly Urgency Clause",39,0,1,0,40
733933,406088,2015-03-05,Assembly,"From committee:  Be adopted.  To third reading",11,0,0,0,11
733935,432923,2015-04-15,Assembly,"Do pass and be re-referred to the Committee on Privacy and Consumer 	Protection",9,0,0,0,9
733935,435975,2015-04-21,Assembly,"Do pass and be re-referred to the Committee on Appropriations to 	Consent Calendar",11,0,0,0,11
733935,443957,2015-05-06,Assembly,"Do pass, to Consent Calendar",17,0,0,0,17
733935,446890,2015-05-14,Assembly,"AB 558 LOW  Consent Calendar Second Day  Regular Session",78,0,0,2,80
733935,463983,2015-06-29,Senate,"Do pass, but re-refer to the Committee on Appropriations Recommend 	Consent",12,0,1,0,13
733935,474016,2015-08-20,Senate,"Consent Calendar 2nd AB558 Low",38,0,2,0,40
733935,505549,2016-02-23,Senate,"Do pass, but re-refer to the Committee on Appropriations",10,0,3,0,13
733935,513630,2016-03-03,Senate,"Assembly 3rd Reading AB558 Low By Hall Urgency Clause",38,0,2,0,40
733935,518093,2016-03-10,Assembly,"Senate amendments be concurred in",20,0,0,1,21
733935,521082,2016-03-17,Assembly,"AB 558 LOW  Concurrence- Urgency Added  By GRAY",67,0,0,12,79
733940,428347,2015-04-08,Assembly,"Do pass and be re-referred to the Committee on Appropriations",9,4,0,0,13
733940,437678,2015-04-22,Assembly,"Do pass",13,4,0,0,17
733940,446692,2015-05-14,Assembly,"AB 438 CHIU  Assembly Third Reading",60,19,0,1,80
733940,462592,2015-06-24,Senate,"Do pass, but re-refer to the Committee on Appropriations",5,0,0,0,5
733940,476161,2015-09-09,Senate,"Assembly 3rd Reading AB438 Chiu By Pan",37,0,3,0,40
733940,476284,2015-09-10,Assembly,"AB 438 CHIU  Concurrence in Senate Amendments",78,0,0,2,80
733941,443466,2015-05-04,Assembly,"Do pass",12,0,0,0,12
733941,444376,2015-05-07,Assembly,"AB 506 MAIENSCHEIN  Assembly Third Reading",76,0,0,4,80
733941,465581,2015-07-07,Senate,"Do pass as amended. To Consent Calendar",6,0,1,0,7
733941,474250,2015-08-27,Senate,"Assembly 3rd Reading AB506 Maienschein By Hill",40,0,0,0,40
733941,475375,2015-08-31,Assembly,"AB 506 MAIENSCHEIN  Concurrence in Senate Amendments",80,0,0,0,80
733943,447755,2015-05-13,Assembly,"Do pass as amended",7,0,0,0,7
733945,445703,2015-05-12,Assembly,"Do pass and be re-referred to the Committee on Appropriations",10,0,0,0,10
733945,449036,2015-05-20,Assembly,"Do pass, to Consent Calendar",15,0,0,2,17
733945,453939,2015-05-28,Assembly,"AB 538 CAMPOS  Assembly Third Reading",75,0,0,5,80
733945,464486,2015-06-30,Senate,"Do pass, but re-refer to the Committee on Judiciary",5,0,2,0,7
733945,466398,2015-07-14,Senate,"Do pass as amended, and re-refer to the Committee on Appropriations",7,0,0,0,7
733945,475357,2015-08-31,Senate,"Assembly 3rd Reading AB538 Campos By Moorlach",40,0,0,0,40
733945,475388,2015-09-01,Assembly,"AB 538 CAMPOS  Concurrence in Senate Amendments",79,0,0,1,80
733948,431574,2015-04-13,Assembly,"Do pass",9,0,0,0,9
733948,442132,2015-04-30,Assembly,"AB 450 MCCARTY  Assembly Third Reading",77,0,0,3,80
733948,556372,2016-06-28,Senate,"Do pass as amended",5,2,0,0,7
733948,560052,2016-08-17,Senate,"Assembly 3rd Reading AB450 McCarty By De Le",23,16,0,0,39
733948,560660,2016-08-23,Assembly,"Senate amendments be concurred in",4,2,0,0,6
733948,561555,2016-08-30,Assembly,"AB 450 MCCARTY  Concurrence in Senate Amendments",42,35,0,3,80
733951,437174,2015-04-22,Senate,"Do pass and be placed on the Consent Calendar",7,0,1,0,8
733951,442291,2015-04-30,Senate,"Consent Calendar 2nd SB335 Roth",34,0,5,0,39
733951,462612,2015-06-24,Assembly,"Do pass, to Consent Calendar",13,0,0,0,13
733951,464931,2015-07-02,Assembly,"SB 335 Roth  Consent Calendar Second Day",78,0,0,2,80
733953,432895,2015-04-15,Senate,"Do pass as amended, and re-refer to the Committee on Appropriations",7,0,1,0,8
733953,445270,2015-05-11,Senate,"Placed on Appropriations Suspense file",7,0,0,0,7
733954,437214,2015-04-21,Senate,"Do pass, but re-refer to the Committee on Appropriations",3,1,1,0,5
733954,442847,2015-05-04,Senate,"Placed on Appropriations Suspense file",7,0,0,0,7
733956,437769,2015-04-21,Assembly,"Do pass as amended and be re-referred to the Committee on 	Appropriations",13,0,0,0,13
733956,443928,2015-05-06,Assembly,"Do pass, to Consent Calendar",17,0,0,0,17
733956,446611,2015-05-14,Assembly,"AB 509 PEREA  Consent Calendar Second Day  Regular Session",78,0,0,2,80
733956,461983,2015-06-22,Senate,"Do pass, but re-refer to the Committee on Education",8,0,1,0,9
733956,475354,2015-08-31,Senate,"Assembly 3rd Reading AB509 Perea By Mendoza",27,13,0,0,40
733956,475633,2015-09-02,Assembly,"AB 509 PEREA  Concurrence in Senate Amendments",53,25,0,2,80
733959,427958,2015-04-07,Senate,"Do pass as amended, and re-refer to the Committee on Appropriations",7,0,0,0,7
733959,463662,2015-04-27,Senate,"Placed on Appropriations Suspense file",7,0,0,0,7
733962,428599,2015-04-08,Senate,"Do pass as amended, and re-refer to the Committee on Appropriations",7,0,0,0,7
733962,454142,2015-05-28,Senate,"Do pass",7,0,0,0,7
733962,455357,2015-06-01,Senate,"Senate 3rd Reading SB324 Pavley",40,0,0,0,40
733962,463561,2015-04-27,Senate,"Placed on Appropriations Suspense file",7,0,0,0,7
733962,466151,2015-07-13,Assembly,"Do pass as amended and be re-referred to the Committee on 	Appropriations",9,0,0,0,9
733962,474375,2015-08-27,Assembly,"Do pass",17,0,0,0,17
733962,475911,2015-09-08,Assembly,"SB 324 Pavley  Senate Third Reading  By IRWIN",79,0,0,1,80
733962,476258,2015-09-10,Senate,"Unfinished Business SB324 Pavley Concurrence",40,0,0,0,40
733963,432824,2015-04-14,Assembly,"Do pass and be re-referred to the Committee on Appropriations",8,5,0,2,15
733963,443943,2015-05-06,Assembly,"Do pass",12,5,0,0,17
733963,453741,2015-05-28,Assembly,"AB 498 LEVINE  Assembly Third Reading",52,24,0,4,80
733963,466146,2015-07-14,Senate,"Do pass, but re-refer to the Committee on Appropriations",8,1,0,0,9
733963,475631,2015-09-02,Senate,"Assembly 3rd Reading AB498 Levine By Pavley",25,13,2,0,40
733963,475857,2015-09-04,Assembly,"AB 498 LEVINE  Concurrence in Senate Amendments",54,25,0,1,80
733965,432890,2015-04-15,Assembly,"Do pass and be re-referred to the Committee on Appropriations",9,0,0,0,9
733966,437100,2015-04-21,Assembly,"Do pass as amended and be re-referred to the Committee on 	Appropriations",17,0,0,2,19
733966,453890,2015-05-28,Assembly,"Do pass",17,0,0,0,17
733966,456030,2015-06-02,Assembly,"AB 533 BONTA  Assembly Third Reading",74,1,0,5,80
733966,466444,2015-07-15,Senate,"Do pass as amended, and re-refer to the Committee on Appropriations",6,2,1,0,9
733966,474102,2015-08-24,Senate,"Placed on Appropriations Suspense file",7,0,0,0,7
733966,474556,2015-08-27,Senate,"Do pass",5,2,0,0,7
733966,476098,2015-09-09,Senate,"From Committee:  That the measure be returned to the Senate floor 	for consideration",7,1,1,0,9
733966,476285,2015-09-10,Senate,"Assembly 3rd Reading AB533 Bonta By Hernandez",25,10,5,0,40
733966,476528,2015-09-12,Assembly,"AB 533 BONTA  Concurrence in Senate Amendments",38,10,0,32,80
733968,446173,2015-05-12,Senate,"Do pass",5,2,0,0,7
733968,455994,2015-06-02,Senate,"Senate 3rd Reading SB328 Hueso",23,15,2,0,40
733968,466111,2015-07-14,Assembly,"Do pass as amended",10,0,0,0,10
733968,473948,2015-08-20,Assembly,"SB 328 Hueso  Senate Third Reading",78,0,0,2,80
733968,474144,2015-08-24,Senate,"Unfinished Business SB328 Hueso Concurrence",39,1,0,0,40
733970,432878,2015-04-14,Assembly,"Do pass and be re-referred to the Committee on Appropriations",7,0,0,0,7
733970,454360,2015-05-28,Assembly,"Do pass as amended",12,0,0,5,17
733970,456800,2015-06-03,Assembly,"AB 470 CHU  Assembly Third Reading",74,3,0,3,80
733970,552768,2016-06-14,Senate,"Do pass, but re-refer to the Committee on Appropriations",11,0,0,0,11
733970,559876,2016-08-15,Senate,"Assembly 3rd Reading AB470 Chu By Beall",38,0,1,0,39
733970,561289,2016-08-25,Assembly,"Senate amendments be concurred in",6,1,0,0,7
733970,561618,2016-08-30,Assembly,"AB 470 CHU  Concurrence in Senate Amendments",62,17,0,1,80
733971,437512,2015-04-21,Assembly,"Do pass and be re-referred to the Committee on Business and 	Professions",19,0,0,0,19
733971,440013,2015-04-28,Assembly,"Do pass and be re-referred to the Committee on Appropriations to 	Consent Calendar",14,0,0,0,14
733971,444031,2015-05-06,Assembly,"Do pass, to Consent Calendar",17,0,0,0,17
733971,446610,2015-05-14,Assembly,"AB 486 BONILLA  Consent Calendar Second Day  Regular Session",78,0,0,2,80
733971,457919,2015-06-08,Senate,"Do pass, but re-refer to the Committee on Appropriations",9,0,0,0,9
733971,473829,2015-08-17,Senate,"Assembly 3rd Reading AB486 Bonilla By Block",38,0,2,0,40
733973,454170,2015-05-28,Assembly,"AB 475 BIGELOW  Third Reading Urgency",76,0,0,4,80
733973,457929,2015-06-08,Senate,"Assembly 3rd Reading AB475 Bigelow By Berryhill",40,0,0,0,40
733975,440030,2015-04-28,Assembly,"Do pass and be re-referred to the Committee on Appropriations to 	Consent Calendar",15,0,0,0,15
733975,454311,2015-05-28,Assembly,"Do pass as amended",17,0,0,0,17
733975,456752,2015-06-03,Assembly,"AB 530 RENDON  Assembly Third Reading",79,0,0,1,80
733975,466052,2015-07-14,Senate,"Do pass, but re-refer to the Committee on Appropriations Recommend 	Consent",9,0,0,0,9
733975,473724,2015-08-17,Senate,"Placed on Appropriations Suspense file",7,0,0,0,7
733975,474676,2015-08-27,Senate,"Do pass as amended",7,0,0,0,7
733975,475671,2015-09-02,Senate,"Assembly 3rd Reading AB530 Rendon By Lara",39,0,1,0,40
733975,475748,2015-09-03,Assembly,"AB 530 RENDON  Concurrence in Senate Amendments",80,0,0,0,80
733978,437129,2015-04-22,Assembly,"Do pass and be re-referred to the Committee on Appropriations",5,2,0,0,7
733978,443895,2015-05-06,Assembly,"Do pass",12,5,0,0,17
733978,450078,2015-05-22,Assembly,"AB 466 MCCARTY  Assembly Third Reading",47,27,0,6,80
733978,465900,2015-07-13,Senate,"Do pass, but re-refer to the Committee on Appropriations",3,1,1,0,5
733978,560748,2016-08-23,Senate,"Assembly 3rd Reading ( Supplemental File 1)AB 466 Br own By",39,0,0,0,39
733978,560917,2016-08-24,Assembly,"AB 466 BROWN  Concurrence in Senate Amendments",80,0,0,0,80
733979,437817,2015-04-22,Assembly,"Do pass as amended and be re-referred to the Committee on 	Appropriations",5,2,0,0,7
733981,440141,2015-04-28,Assembly,"Subject matter be referred",5,0,0,2,7
733983,432862,2015-04-15,Assembly,"Do pass and be re-referred to the Committee on Appropriations",9,0,0,0,9
733983,454370,2015-05-28,Assembly,"Do pass",17,0,0,0,17
733983,456087,2015-06-02,Assembly,"AB 448 BROWN  Third Reading Urgency",79,0,0,1,80
733983,460640,2015-06-17,Senate,"Do pass, but re-refer to the Committee on Appropriations",7,0,0,0,7
733983,464134,2015-06-29,Senate,"Placed on Appropriations Suspense file",6,0,1,0,7
733984,437076,2015-04-22,Senate,"Do pass, but re-refer to the Committee on Appropriations",5,0,0,0,5
733984,445138,2015-05-11,Senate,"Senate 3rd Reading SB342 Jackson",35,0,4,0,39
733984,465751,2015-07-08,Assembly,"Do pass and be re-referred to the Committee on Appropriations",7,0,0,0,7
733984,473887,2015-08-19,Assembly,"Do pass, to Consent Calendar",17,0,0,0,17
733984,475285,2015-08-31,Assembly,"SB 342 Jackson  Senate Third Reading  By GARCIA, E",80,0,0,0,80
733984,475469,2015-09-01,Senate,"Unfinished Business SB342 Jackson Concurrence",40,0,0,0,40
733987,437838,2015-04-14,Assembly,"Do pass as amended and be re-referred to the Committee on 	Appropriations",17,0,0,2,19
733987,440908,2015-04-29,Assembly,"Do pass",17,0,0,0,17
733987,447129,2015-05-14,Assembly,"AB 461 MULLIN  Assembly Third Reading",79,0,0,1,80
733987,458655,2015-06-10,Senate,"Do pass, but re-refer to the Committee on Appropriations",9,0,0,0,9
733987,465827,2015-07-09,Senate,"Assembly 3rd Reading AB461 Mullin By Hill",39,0,1,0,40
733987,466495,2015-07-16,Assembly,"AB 461 MULLIN  Concurrence in Senate Amendments",79,0,0,1,80
733989,429407,2015-04-08,Assembly,"Do pass and be re-referred to the Committee on Appropriations",1,5,0,1,7
733989,442223,2015-04-29,Assembly,"Reconsideration granted",7,0,0,0,7
733992,443925,2015-05-06,Assembly,"Do pass and be re-referred to the Committee on Appropriations",9,4,0,0,13
733995,440044,2015-04-28,Assembly,"Do pass as amended and be re-referred to the Committee on 	Appropriations",4,0,0,3,7
733995,448950,2015-05-20,Assembly,"Do pass",14,0,0,3,17
733995,453715,2015-05-28,Assembly,"AB 443 ALEJO  Assembly Third Reading",71,5,0,4,80
733995,466378,2015-07-14,Senate,"Do pass as amended, and re-refer to the Committee on Appropriations",7,0,0,0,7
733995,474129,2015-08-24,Senate,"Placed on Appropriations Suspense file",7,0,0,0,7
733998,428778,2015-04-08,Assembly,"Do pass and be re-referred to the Committee on Appropriations",21,0,0,0,21
733998,453744,2015-05-28,Assembly,"Do pass",17,0,0,0,17
733998,455332,2015-06-01,Assembly,"AB 510 RODRIGUEZ  Assembly Third Reading",80,0,0,0,80
734000,448391,2015-05-18,Assembly,"Do pass as amended and be re-referred to the Committee on 	Appropriations",9,0,0,0,9
734001,432555,2015-04-14,Assembly,"Do pass and be re-referred to the Committee on Privacy and Consumer 	Protection",10,0,0,0,10
734001,436104,2015-04-21,Assembly,"Do pass and be re-referred to the Committee on Appropriations",11,0,0,0,11
734001,444069,2015-05-06,Assembly,"Do pass, to Consent Calendar",17,0,0,0,17
734001,446651,2015-05-14,Assembly,"AB 556 IRWIN  Consent Calendar Second Day  Regular Session",78,0,0,2,80
734001,464852,2015-06-30,Senate,"Do pass, but re-refer to the Committee on Appropriations Recommend 	Consent",7,0,0,0,7
734001,466494,2015-07-16,Senate,"Consent Calendar 2nd AB556 Irwin",38,0,2,0,40
734001,474466,2015-08-27,Assembly,"AB 556 IRWIN  Concurrence in Senate Amendments",78,0,0,2,80
734004,442905,2015-05-04,Senate,"Do pass as amended",7,0,0,0,7
734004,445167,2015-05-11,Senate,"Senate 3rd Reading SB302 Lara Urgency Clause",35,0,4,0,39
734004,453047,2015-05-27,Assembly,"Do pass",17,0,0,0,17
734004,455569,2015-06-01,Assembly,"SB 302 Lara  Third Reading Urgency  By GOMEZ",80,0,0,0,80
734006,433577,2015-04-14,Senate,"Do pass, but re-refer to the Committee on Appropriations",6,0,1,0,7
734006,453935,2015-05-28,Senate,"Do pass",7,0,0,0,7
734006,455325,2015-06-01,Senate,"Senate 3rd Reading SB316 Mitchell",39,0,1,0,40
734006,463685,2015-04-27,Senate,"Placed on Appropriations Suspense file",7,0,0,0,7
734006,554661,2016-06-21,Assembly,"Do pass as amended and be re-referred to the Committee on Human 	Services",10,0,0,0,10
734008,440220,2015-04-28,Senate,"Do pass, but re-refer to the Committee on Appropriations",7,0,0,0,7
734008,453803,2015-05-28,Senate,"Do pass",7,0,0,0,7
734008,456587,2015-06-03,Senate,"Senate 3rd Reading SB333 Galgiani",40,0,0,0,40
734008,463709,2015-05-18,Senate,"Placed on Appropriations Suspense file",7,0,0,0,7
734008,464432,2015-06-30,Assembly,"Do pass and be re-referred to the Committee on Appropriations",6,0,0,1,7
734008,474473,2015-08-27,Assembly,"Do pass as amended",11,0,0,6,17
734008,475681,2015-09-02,Assembly,"SB 333 Galgiani  Senate Third Reading  By LACKEY",78,0,0,2,80
734008,475797,2015-09-03,Senate,"Unfinished Business SB333 Galgiani Concurrence",39,0,1,0,40
734009,428907,2015-04-08,Senate,"Do pass as amended, and re-refer to the Committee on Environmental 	Quality",7,0,1,0,8
734009,441077,2015-04-29,Senate,"Do pass, but re-refer to the Committee on Appropriations",7,0,0,0,7
734009,454172,2015-05-28,Senate,"Do pass as amended",7,0,0,0,7
734009,457370,2015-06-04,Senate,"Senate 3rd Reading SB334 Leyva",40,0,0,0,40
734009,463678,2015-05-18,Senate,"Placed on Appropriations Suspense file",7,0,0,0,7
734009,464979,2015-07-01,Assembly,"Do pass as amended and be re-referred to the Committee on 	Environmental Safety and Toxic Materials",6,0,0,1,7
734009,466072,2015-07-14,Assembly,"Do pass as amended and be re-referred to the Committee on 	Appropriations",7,0,0,0,7
734009,474454,2015-08-27,Assembly,"Do pass as amended",17,0,0,0,17
734009,475949,2015-09-08,Assembly,"SB 334 Leyva  Senate Third Reading  By RENDON",78,0,0,2,80
734009,476393,2015-09-10,Senate,"Unfinished Business SB334 Leyva Concurrence",39,0,1,0,40
734011,435198,2015-04-20,Senate,"Do pass as amended, and re-refer to the Committee on Appropriations",7,0,2,0,9
734011,442821,2015-05-04,Senate,"Do pass",5,0,2,0,7
734011,444393,2015-05-07,Senate,"Senate 3rd Reading SB323 Hernandez",25,5,9,0,39
734011,464348,2015-06-30,Assembly,"Do pass as amended and be re-referred to the Committee on 	Appropriations",4,9,0,1,14
734013,435974,2015-04-21,Assembly,"Do pass and be re-referred to the Committee on Appropriations to 	Consent Calendar",14,0,0,0,14
734013,454166,2015-05-28,Assembly,"Do pass as amended",17,0,0,0,17
734013,455904,2015-06-02,Assembly,"AB 483 PATTERSON  Assembly Third Reading",78,0,0,2,80
734013,464400,2015-06-29,Senate,"Do pass, but re-refer to the Committee on Appropriations",8,0,1,0,9
734013,473805,2015-08-17,Senate,"Do pass as amended",7,0,0,0,7
734013,475934,2015-09-08,Senate,"Assembly 3rd Reading AB483 Patterson By Hill",40,0,0,0,40
734013,476095,2015-09-09,Assembly,"AB 483 PATTERSON  Concurrence in Senate Amendments",78,0,0,2,80
734014,443936,2015-05-06,Assembly,"Do pass",17,0,0,0,17
734014,455384,2015-06-01,Assembly,"AB 545 MELENDEZ  Assembly Third Reading",80,0,0,0,80
734014,466062,2015-04-14,Assembly,"Do pass as amended and be re-referred to the Committee on 	Appropriations",6,0,0,1,7
734014,466338,2015-07-14,Senate,"Do pass, but re-refer to the Committee on Appropriations",7,0,0,0,7
734014,473760,2015-08-17,Senate,"Placed on Appropriations Suspense file",7,0,0,0,7
734014,474525,2015-08-27,Senate,"Do pass",7,0,0,0,7
734014,476194,2015-09-09,Senate,"Assembly 3rd Reading AB545 Melendez By Leyva",39,0,1,0,40
734014,476386,2015-09-10,Assembly,"AB 545 MELENDEZ  Concurrence in Senate Amendments",80,0,0,0,80
734017,442198,2015-04-29,Assembly,"Do pass and be re-referred to the Committee on Appropriations",6,0,0,1,7
734017,446488,2015-05-13,Assembly,"Do pass, to Consent Calendar",17,0,0,0,17
734017,450169,2015-05-22,Assembly,"AB 531 O'DONNELL  Consent Calendar Second Day  Regular Session",74,0,0,6,80
734017,460713,2015-06-17,Senate,"Do pass, but re-refer to the Committee on Appropriations Recommend 	Consent",8,0,1,0,9
734017,465207,2015-07-06,Senate,"Do pass",6,0,1,0,7
734018,438176,2015-04-23,Senate,"Senate 3rd Reading SB307 Pavley",37,0,0,2,39
734018,458707,2015-04-14,Senate,"Do pass",6,0,0,1,7
734018,460197,2015-06-16,Assembly,"Do pass as amended, to Consent Calendar",7,0,0,0,7
734018,461849,2015-06-22,Assembly,"SB 307 Pavley  Consent Calendar Second Day  Regular Session",77,0,0,3,80
734018,462990,2015-06-25,Senate,"Unfinished Business SB307 Pavley Concurrence",35,0,5,0,40
734020,429492,2015-04-08,Assembly,"Do pass and be re-referred to the Committee on Appropriations",1,5,0,1,7
734020,442178,2015-04-29,Assembly,"Do pass as amended and be re-referred to the Committee on 	Appropriations",7,0,0,0,7
734020,448907,2015-05-20,Assembly,"Do pass",15,0,0,2,17
734020,451497,2015-05-26,Assembly,"AB 517 GALLAGHER  Assembly Third Reading",69,3,0,8,80
734020,460617,2015-06-17,Senate,"Do pass, but re-refer to the Committee on Appropriations",7,0,2,0,9
734020,463606,2015-04-08,Assembly,"Reconsideration granted",7,0,0,0,7
734020,476148,2015-09-09,Senate,"Assembly 3rd Reading AB517 Gallagher By Runner",16,20,4,0,40
734020,476149,2015-09-09,Senate,"Assembly 3rd Reading AB517 Gallagher By Runner Reconsider",40,0,0,0,40
734020,561721,2016-08-31,Senate,"Assembly 3rd Reading AB517 Gallagher By Nielsen",14,23,2,0,39
734022,408663,2015-03-09,Assembly,"From committee:  Be adopted.  To third reading",11,0,0,0,11
734022,447637,2015-05-18,Senate,"Special Consent #1 ACR27 Beth Gaines",36,0,3,0,39
734023,442403,2015-04-29,Senate,"Do pass as amended, and re-refer to the Committee on Appropriations",6,0,3,0,9
734023,463660,2015-05-18,Senate,"Placed on Appropriations Suspense file",7,0,0,0,7
734025,437422,2015-04-22,Senate,"Do pass as amended, and re-refer to the Committee on Appropriations",7,2,0,0,9
734025,454188,2015-05-28,Senate,"Do pass as amended",5,2,0,0,7
734025,455907,2015-06-02,Senate,"Senate 3rd Reading SB322 Leno",24,15,1,0,40
734025,463609,2015-05-18,Senate,"Placed on Appropriations Suspense file",7,0,0,0,7
734025,466363,2015-07-15,Assembly,"Do pass and be re-referred to the Committee on Appropriations",5,2,0,0,7
734025,559488,2016-08-11,Assembly,"Do pass as amended",14,6,0,0,20
734025,561597,2016-08-30,Assembly,"SB 322 Leno  Senate Third Reading  By O'DONNELL",31,34,0,15,80
734026,448819,2015-05-18,Assembly,"Do pass as amended and be re-referred to the Committee on 	Appropriations",9,0,0,0,9
734028,443722,2015-05-06,Assembly,"Do pass",11,1,0,1,13
734028,457265,2015-06-04,Assembly,"AB 447 MAIENSCHEIN  Assembly Third Reading",75,4,0,1,80
734028,465627,2015-07-08,Senate,"Do pass",6,1,2,0,9
734028,475377,2015-08-31,Senate,"Assembly 3rd Reading AB447 Maienschein By Lara",30,2,8,0,40
734028,475607,2015-09-02,Assembly,"AB 447 MAIENSCHEIN  Concurrence in Senate Amendments",72,6,0,2,80
734030,445731,2015-05-12,Assembly,"Do pass as amended",7,0,0,3,10
734030,456941,2015-06-03,Assembly,"AB 551 NAZARIAN  Assembly Third Reading",63,11,0,6,80
734030,465703,2015-07-07,Senate,"Do pass as amended",5,1,1,0,7
734030,560721,2016-08-23,Senate,"Assembly 3rd Reading AB551 Nazarian By Jackson",29,10,0,0,39
734030,561379,2016-08-29,Assembly,"AB 551 NAZARIAN  Concurrence in Senate Amendments",65,15,0,0,80
734031,430647,2015-04-13,Assembly,"Be referred to Committee on Judiciary",11,0,0,0,11
734031,436407,2015-04-21,Assembly,"Do pass and be re-referred to the Committee on Business and 	Professions",7,2,0,1,10
734031,440449,2015-04-28,Assembly,"Do pass as amended",11,0,0,3,14
734031,446734,2015-05-14,Assembly,"AB 525 HOLDEN  Assembly Third Reading",56,12,0,12,80
734031,464347,2015-06-29,Senate,"Do pass as amended, and re-refer to the Committee on Judiciary",6,1,2,0,9
734031,466386,2015-07-14,Senate,"Do pass as amended",7,0,0,0,7
734031,474461,2015-08-27,Senate,"Assembly 3rd Reading AB525 Holden By Jackson",37,0,3,0,40
734031,475346,2015-08-31,Assembly,"AB 525 HOLDEN  Concurrence in Senate Amendments",79,0,0,1,80
734033,428331,2015-04-08,Assembly,"Do pass and be re-referred to the Committee on Judiciary to Consent 	Calendar",12,0,0,1,13
734033,436223,2015-04-21,Assembly,"Do pass",10,0,0,0,10
734033,439566,2015-04-27,Assembly,"AB 459 DALY  Assembly Third Reading",79,0,0,1,80
734033,459495,2015-06-10,Senate,"Do pass, but re-refer to the Committee on Judiciary Recommend 	Consent",9,0,0,0,9
734033,556681,2016-06-28,Senate,"Do pass as amended",7,0,0,0,7
734034,437376,2015-04-21,Senate,"Do pass, but re-refer to the Committee on Health",5,0,0,0,5
734034,442382,2015-04-29,Senate,"Do pass, but re-refer to the Committee on Appropriations",9,0,0,0,9
734034,454157,2015-05-28,Senate,"Do pass as amended",7,0,0,0,7
734034,456722,2015-06-03,Senate,"Senate 3rd Reading SB319 Beall",40,0,0,0,40
734034,463542,2015-05-18,Senate,"Placed on Appropriations Suspense file",7,0,0,0,7
734034,464485,2015-06-30,Assembly,"Do pass and be re-referred to the Committee on Health",7,0,0,0,7
734034,465981,2015-07-14,Assembly,"Do pass and be re-referred to the Committee on Appropriations to 	Consent Calendar",19,0,0,0,19
734034,474358,2015-08-27,Assembly,"Do pass as amended",17,0,0,0,17
734034,475995,2015-09-08,Assembly,"SB 319 Beall  Senate Third Reading  By CHIU",79,0,0,1,80
734034,476269,2015-09-10,Senate,"Unfinished Business SB319 Beall Concurrence",40,0,0,0,40
734036,437158,2015-04-22,Senate,"Do pass and be placed on the Consent Calendar",7,0,1,0,8
734036,442193,2015-04-30,Senate,"Consent Calendar 2nd SB336 Roth",34,0,5,0,39
734038,427832,2015-04-07,Assembly,"Do pass, to Consent Calendar",10,0,0,0,10
734038,430798,2015-04-13,Assembly,"AB 555 ALEJO  Consent Calendar Second Day  Regular Session",79,0,0,1,80
734038,466371,2015-07-14,Senate,"Do pass, but re-refer to the Committee on Appropriations",6,1,0,0,7
734038,475515,2015-09-01,Senate,"Assembly 3rd Reading AB555 Alejo By Hertzberg",40,0,0,0,40
734038,475700,2015-09-02,Assembly,"AB 555 ALEJO  Concurrence in Senate Amendments",80,0,0,0,80
734039,435200,2015-04-20,Senate,"Do pass, but re-refer to the Committee on Appropriations",9,0,0,0,9
734039,451932,2015-05-26,Senate,"Senate 3rd Reading SB337 Pavley",38,0,1,0,39
734039,462142,2015-06-23,Assembly,"Do pass and be re-referred to the Committee on Appropriations",14,0,0,0,14
734039,465729,2015-07-08,Assembly,"Do pass, to Consent Calendar",14,0,0,3,17
734039,466481,2015-07-16,Assembly,"SB 337 Pavley  Consent Calendar Second Day  Regular Session",79,0,0,1,80
734039,475770,2015-09-03,Assembly,"SB 337 Pavley  Senate Third Reading  By ALEJO",80,0,0,0,80
734039,475886,2015-09-04,Senate,"Unfinished Business SB337 Pavley Concurrence",40,0,0,0,40
734041,406115,2015-03-05,Senate,"Senate 3rd Reading SCR19 Nguyen",36,0,1,0,37
734041,414978,2015-03-23,Assembly,"Be adopted, to Consent Calendar",11,0,0,0,11
734041,418682,2015-03-26,Assembly,"SCR 19 Nguyen  Consent Calendar Second Day  Regular Session",76,0,0,4,80
734046,434013,2015-04-15,Senate,"Do pass as amended, and re-refer to the Committee on Appropriations",9,0,0,0,9
734046,442875,2015-05-04,Senate,"Placed on Appropriations Suspense file",7,0,0,0,7
734046,453957,2015-05-28,Senate,"Do pass",7,0,0,0,7
734046,455455,2015-06-01,Senate,"Senate 3rd Reading SB296 Cannella",40,0,0,0,40
734046,464879,2015-06-30,Assembly,"Amend, and do pass as amended and be re-referred to the Committee 	on Appropriations with the recommendation:  To Consent Calendar",18,0,0,1,19
734046,474348,2015-08-27,Assembly,"Do pass as amended",17,0,0,0,17
734046,475636,2015-09-02,Assembly,"SB 296 Cannella  Senate Third Reading  By WOOD",79,0,0,1,80
734049,432844,2015-04-15,Senate,"Do pass, but re-refer to the Committee on Appropriations",7,0,0,0,7
734049,453783,2015-05-28,Senate,"Do pass as amended",7,0,0,0,7
734049,456012,2015-06-02,Senate,"Senate 3rd Reading SB330 Mendoza",40,0,0,0,40
734049,463551,2015-04-27,Senate,"Placed on Appropriations Suspense file",7,0,0,0,7
734049,466349,2015-07-15,Assembly,"Do pass and be re-referred to the Committee on Local Government",5,0,0,2,7
734049,466549,2015-07-15,Assembly,MOTIONDCX153**,7,0,0,2,9
734049,466550,2015-07-15,Assembly,"Do pass as amended and be re-referred to the Committee on 	Appropriations",6,0,0,3,9
734050,427814,2015-04-07,Assembly,"Do pass as amended and be re-referred to the Committee on 	Appropriations",5,2,0,0,7
735318,484761,2016-01-12,Assembly,"Do pass as amended and be re-referred to the Committee on 	Appropriations",7,0,0,0,7
735318,486320,2016-01-21,Assembly,"Do pass as amended",17,0,0,0,17
735318,488399,2016-01-27,Assembly,"AB 598 CALDERON  Assembly Third Reading",78,0,0,1,79
735318,553172,2016-06-15,Senate,"Do pass, but re-refer to the Committee on Appropriations Recommend 	Consent",9,0,0,0,9
735318,558799,2016-08-01,Senate,"Placed on Appropriations Suspense file",7,0,0,0,7
735320,484679,2016-01-11,Assembly,"Do pass",9,3,0,4,16
735320,488972,2016-01-28,Assembly,"AB 620 HERNANDEZ  Assembly Third Reading",51,26,0,2,79
735320,558967,2016-08-01,Senate,"Do pass",5,2,0,0,7
735320,560518,2016-08-22,Senate,"Assembly 3rd Reading AB620 Roger Hern",28,11,0,0,39
735322,416023,2015-03-24,Senate,"Do pass as amended, and re-refer to the Committee on Appropriations",7,2,0,0,9
735322,432720,2015-04-14,Senate,"Do pass, but re-refer to the Committee on Appropriations",6,2,1,0,9
735322,442365,2015-04-30,Senate,"Senate 3rd Reading SB355 Lara",24,12,3,0,39
735322,461936,2015-06-22,Assembly,"Do pass as amended and be re-referred to the Committee on 	Appropriations",7,0,0,2,9
735322,465670,2015-07-08,Assembly,"Do pass, to Consent Calendar",14,0,0,3,17
735322,474409,2015-08-27,Assembly,"SB 355 Lara  Senate Third Reading  By RENDON",78,0,0,2,80
735322,475278,2015-08-31,Senate,"Unfinished Business SB355 Lara Concurrence",39,0,1,0,40
735323,443812,2015-05-06,Assembly,"Do pass, to Consent Calendar",13,0,0,0,13
735323,446739,2015-05-14,Assembly,"AB 565 COOLEY  Consent Calendar Second Day  Regular Session",78,0,0,2,80
735323,554955,2016-06-22,Senate,"Do pass as amended",8,0,1,0,9
735323,559953,2016-08-16,Senate,"Assembly 3rd Reading AB565 Cooley By Roth",39,0,0,0,39
735323,560689,2016-08-23,Assembly,"AB 565 COOLEY  Concurrence in Senate Amendments",80,0,0,0,80
735325,427860,2015-04-06,Assembly,"Do pass as amended and be re-referred to the Committee on Aging and 	Long",15,0,0,1,16
735325,436064,2015-04-21,Assembly,"Do pass and be re-referred to the Committee on Appropriations",7,0,0,0,7
735325,443898,2015-05-06,Assembly,"Do pass",17,0,0,0,17
735325,447635,2015-05-18,Assembly,"AB 643 NAZARIAN  Assembly Third Reading",76,0,0,4,80
735325,462124,2015-06-23,Senate,"Do pass, but re-refer to the Committee on Appropriations",11,0,0,0,11
735325,475385,2015-08-31,Senate,"Assembly 3rd Reading AB643 Nazarian By Beall",39,0,1,0,40
735326,437339,2015-04-22,Senate,"Do pass as amended, and re-refer to the Committee on Appropriations",7,0,0,0,7
735326,453728,2015-05-28,Senate,"Do pass as amended",6,1,0,0,7
735326,455873,2015-06-02,Senate,"Senate 3rd Reading SB377 Beall",38,1,1,0,40
735326,463564,2015-05-18,Senate,"Placed on Appropriations Suspense file",7,0,0,0,7
735326,464922,2015-07-01,Assembly,"Do pass and be re-referred to the Committee on Revenue and Taxation",7,0,0,0,7
735326,473964,2015-08-17,Assembly,"Do pass as amended and be re-referred to the Committee on 	Appropriations",8,0,0,1,9
735326,476475,2015-09-11,Assembly,"Do pass as amended",16,0,0,1,17
735326,476476,2015-09-11,Assembly,"SB 377 Beall  Senate Third Reading  By CHIU",79,0,0,1,80
735326,476477,2015-09-11,Senate,"Unfinished Business (S upplemental File 4)SB3 77 Bea ll Con",38,0,2,0,40
735328,436103,2015-04-21,Assembly,"Do pass as amended and be re-referred to the Committee on 	Appropriations",11,0,0,3,14
735328,453845,2015-05-28,Assembly,"Do pass as amended",12,4,0,1,17
735328,456581,2015-06-03,Assembly,"AB 662 BONILLA  Assembly Third Reading",50,23,0,7,80
735328,464444,2015-06-30,Senate,"Do pass as amended, and re-refer to the Committee on Appropriations",9,2,0,0,11
735328,473683,2015-08-17,Senate,"Placed on Appropriations Suspense file",7,0,0,0,7
735328,474670,2015-08-27,Senate,"Do pass as amended",5,2,0,0,7
735328,475990,2015-09-08,Senate,"Assembly 3rd Reading AB662 Bonilla By Beall",26,12,2,0,40
735328,476150,2015-09-09,Assembly,"AB 662 BONILLA  Concurrence in Senate Amendments",50,25,0,5,80
735329,428326,2015-04-07,Assembly,"Do pass and be re-referred to the Committee on Appropriations",12,0,0,1,13
735329,437186,2015-04-22,Assembly,"Do pass",17,0,0,0,17
735329,439439,2015-04-27,Assembly,"AB 653 LEVINE  Assembly Third Reading",77,0,0,3,80
735329,462589,2015-06-24,Senate,"Do pass as amended, and re-refer to the Committee on Appropriations",8,0,1,0,9
735329,474070,2015-08-24,Senate,"Assembly 3rd Reading AB653 Levine By Block",40,0,0,0,40
735329,474450,2015-08-27,Assembly,"AB 653 LEVINE  Concurrence in Senate Amendments",78,0,0,2,80
735330,428517,2015-04-08,Assembly,"Do pass and be re-referred to the Committee on Rules",6,0,0,1,7
735332,432868,2015-04-15,Senate,"Do pass, but re-refer to the Committee on Appropriations",7,0,0,0,7
735332,463640,2015-04-27,Senate,"Placed on Appropriations Suspense file",7,0,0,0,7
735333,441193,2015-04-28,Assembly,"Do pass and be re-referred to the Committee on Appropriations to 	Consent Calendar",7,0,0,0,7
735333,446371,2015-05-13,Assembly,"Do pass, to Consent Calendar",17,0,0,0,17
735333,450285,2015-05-22,Assembly,"AB 592 STONE  Consent Calendar Second Day  Regular Session",74,0,0,6,80
735333,462236,2015-06-23,Senate,"Do pass, but re-refer to the Committee on Appropriations Recommend 	Consent",5,0,0,0,5
735333,465777,2015-07-09,Senate,"Consent Calendar 2nd AB592 Mark Stone Urgency Clause",39,0,1,0,40
735333,465887,2015-07-13,Assembly,"AB 592 STONE  Concurrence in Senate Amendments",79,0,0,1,80
735336,448417,2015-05-18,Assembly,"Do pass as amended and be re-referred to the Committee on 	Appropriations",9,0,0,0,9
735338,432961,2015-04-15,Senate,"Do pass, but re-refer to the Committee on Appropriations Recommend 	Consent",7,0,0,0,7
735338,442844,2015-05-04,Senate,"Senate 3rd Reading SB348 Galgiani",35,0,4,0,39
735338,461923,2015-06-22,Assembly,"Do pass and be re-referred to the Committee on Appropriations",6,0,0,3,9
735338,465715,2015-07-08,Assembly,"Do pass",10,0,0,7,17
735338,466551,2015-07-16,Assembly,"SB 348 Galgiani  Senate Third Reading  By EGGMAN",73,0,0,7,80
735341,432580,2015-04-15,Senate,"Do pass, but re-refer to the Committee on Judiciary Recommend 	Consent",7,0,0,0,7
735341,437412,2015-04-21,Senate,"Do pass as amended, but re-refer to the Committee on Appropriations 	Recommend Consent",7,0,0,0,7
735341,450184,2015-05-22,Senate,"Consent Calendar 2nd SB351 Committee On B. & F.I. (Block)",38,0,1,0,39
735341,462145,2015-06-22,Assembly,"Do pass, to Consent Calendar",12,0,0,0,12
735341,463920,2015-06-29,Assembly,"SB 351 B.&.F.I.  Consent Calendar Second Day  Regular Session",76,0,0,4,80
735341,465140,2015-07-06,Senate,"Special Consent #4 SB351 Committee On B. & F.I. (Block)",39,0,1,0,40
735342,432690,2015-04-14,Assembly,"Do pass as amended and be re-referred to the Committee on 	Appropriations",7,0,0,0,7
735342,441085,2015-04-29,Assembly,"Do pass, to Consent Calendar",17,0,0,0,17
735342,444382,2015-05-07,Assembly,"AB 649 PATTERSON  Consent Calendar Second Day  Regular Session",77,0,0,3,80
735342,460636,2015-06-17,Senate,"Do pass as amended, and re-refer to the Committee on Appropriations",6,0,1,0,7
735342,473733,2015-08-17,Senate,"Placed on Appropriations Suspense file",7,0,0,0,7
735343,432688,2015-04-15,Assembly,"Do pass and be re-referred to the Committee on Appropriations",10,0,0,0,10
735343,437068,2015-04-22,Assembly,"Do pass",17,0,0,0,17
735343,439452,2015-04-27,Assembly,"AB 655 QUIRK  Assembly Third Reading",75,1,0,4,80
735343,554755,2016-06-21,Senate,"Do pass, but re-refer to the Committee on Appropriations",4,0,1,0,5
735343,556468,2016-06-29,Senate,"Do pass as amended, and re-refer to the Committee on Appropriations",7,0,0,0,7
735343,560065,2016-08-17,Senate,"Assembly 3rd Reading AB655 Quirk By Wolk",36,1,2,0,39
735343,560884,2016-08-23,Assembly,"AB 655 QUIRK  Concurrence in Senate Amendments",75,4,0,1,80
735345,489006,2016-01-28,Senate,"Do pass",7,0,0,0,7
735345,489007,2016-01-28,Senate,"W/O REF. TO FILE SB380 Pavley Urgency Clause",40,0,0,0,40
735345,509374,2016-02-22,Assembly,"Do pass as amended and be re-referred to the Committee on 	Appropriations",13,0,0,2,15
735345,532280,2016-04-13,Assembly,"Do pass as amended",15,0,0,5,20
735345,539574,2016-04-28,Assembly,"SB 380 Pavley  Third Reading Urgency  By WILK",70,2,0,8,80
735345,540788,2016-05-02,Senate,"Unfinished Business SB380 Pavley Urgency Clause Concurr",37,0,3,0,40
735346,485034,2016-01-12,Assembly,"Do pass and be re-referred to the Committee on Appropriations",13,0,0,2,15
735346,485077,2016-01-05,Assembly,"Be referred to Committee on Water, Parks and Wildlife",11,0,0,0,11
735346,486461,2016-01-21,Assembly,"Do pass",17,0,0,0,17
735346,487048,2016-01-25,Assembly,"AB 581 GOMEZ  Assembly Third Reading",75,0,0,4,79
735348,429360,2015-04-08,Assembly,"Do pass and be re-referred to the Committee on Appropriations",7,0,0,0,7
735350,428044,2015-04-07,Assembly,"Do pass and be re-referred to the Committee on Appropriations",7,0,0,0,7
735351,440297,2015-04-28,Senate,"Do pass, but re-refer to the Committee on Appropriations",7,0,0,0,7
735351,445196,2015-05-11,Senate,"Placed on Appropriations Suspense file",7,0,0,0,7
735353,436314,2015-04-20,Assembly,"Do pass and be re-referred to the Committee on Natural Resources",10,5,0,0,15
735353,440377,2015-04-27,Assembly,"Do pass and be re-referred to the Committee on Appropriations",6,3,0,0,9
735353,453994,2015-05-28,Assembly,"Do pass",12,5,0,0,17
735353,456684,2015-06-03,Assembly,"AB 645 WILLIAMS  Assembly Third Reading  Motion to  Appeal the 	Decision  of the Chair  By JONES",25,52,0,3,80
735353,456685,2015-06-03,Assembly,"AB 645 WILLIAMS  Assembly Third Reading",46,29,0,5,80
735353,465488,2015-07-07,Senate,"Do pass, but re-refer to the Committee on Appropriations",8,3,0,0,11
735353,473695,2015-08-17,Senate,"Placed on Appropriations Suspense file",7,0,0,0,7
735355,446769,2015-05-14,Assembly,"Do pass",5,3,0,1,9
735355,454253,2015-05-28,Assembly,"AB 567 GIPSON  Assembly Third Reading",47,29,0,4,80
735355,465628,2015-07-08,Senate,"Do pass",4,3,0,0,7
735355,552439,2016-06-13,Senate,"Do pass as amended, and re-refer to the Committee on Governance and 	Finance",8,1,0,0,9
735355,555032,2016-06-22,Senate,"Do pass, but re-refer to the Committee on Appropriations",5,1,1,0,7
735355,559604,2016-08-11,Senate,"Do pass",5,2,0,0,7
735355,560735,2016-08-23,Senate,"Assembly 3rd Reading AB567 Gipson By McGuire",32,7,0,0,39
735355,561419,2016-08-29,Assembly,"Senate amendments be concurred in",5,2,0,2,9
735355,561615,2016-08-30,Assembly,"AB 567 GIPSON  Concurrence in Senate Amendments",56,16,0,8,80
735357,437168,2015-04-21,Assembly,"Do pass as amended and be re-referred to the Committee on Business 	and Professions",15,4,0,0,19
735357,440264,2015-04-28,Assembly,"Do pass as amended and be re-referred to the Committee on 	Appropriations",13,1,0,0,14
735358,428886,2015-04-08,Assembly,"Do pass as amended",9,0,0,0,9
735358,442122,2015-04-30,Assembly,"AB 644 WOOD  Assembly Third Reading",77,0,0,3,80
735358,458834,2015-06-10,Senate,"Do pass as amended, and re-refer to the Committee on Rules",7,0,0,0,7
735358,465978,2015-07-14,Senate,"Do pass as amended, but re-refer to the Committee on Appropriations 	Recommend Consent",9,0,0,0,9
735358,474036,2015-08-20,Senate,"Consent Calendar 2nd AB644 Wood",38,0,2,0,40
735358,474119,2015-08-24,Assembly,"AB 644 WOOD  Concurrence in Senate Amendments",78,0,0,2,80
735359,442319,2015-04-29,Assembly,"Amend, and do pass as amended and be re-referred to the Committee 	on Appropriations with the recommendation:  To Consent Calendar",6,0,0,1,7
735359,448883,2015-05-20,Assembly,"Do pass, to Consent Calendar",15,0,0,2,17
735359,451737,2015-05-26,Assembly,"AB 625 BONTA  Consent Calendar Second Day  Regular Session",76,0,0,4,80
735359,462640,2015-06-24,Senate,"Do pass, but re-refer to the Committee on Appropriations Recommend 	Consent",9,0,0,0,9
735359,465773,2015-07-09,Senate,"Consent Calendar 2nd AB625 Bonta",39,0,1,0,40
735359,475253,2015-08-31,Assembly,"AB 625 BONTA  Concurrence in Senate Amendments",80,0,0,0,80
735360,446307,2015-05-13,Assembly,"Do pass, to Consent Calendar",7,0,0,0,7
735360,450125,2015-05-22,Assembly,"AB 562 HOLDEN  Consent Calendar Second Day  Regular Session",74,0,0,6,80
735360,460221,2015-06-16,Senate,"Do pass and be placed on the Consent Calendar",5,0,0,0,5
735360,476057,2015-09-08,Senate,"Assembly 3rd Reading AB562 Holden By Liu",40,0,0,0,40
735361,437089,2015-04-22,Senate,"Do pass, but re-refer to the Committee on Appropriations",7,2,0,0,9
735361,442822,2015-05-04,Senate,"Placed on Appropriations Suspense file",7,0,0,0,7
735361,453601,2015-05-28,Senate,"Do pass as amended",5,2,0,0,7
735361,455947,2015-06-02,Senate,"Senate 3rd Reading SB376 Lara",24,14,2,0,40
735361,465472,2015-07-07,Assembly,"Do pass and be re-referred to the Committee on Accountability and 	Administrative Review",9,3,0,1,13
735361,466294,2015-07-15,Assembly,"Do pass as amended and be re-referred to the Committee on 	Appropriations",6,3,0,0,9
735361,474261,2015-08-27,Assembly,"Do pass",12,5,0,0,17
735361,476244,2015-09-10,Assembly,"SB 376 Lara  Senate Third Reading  By GONZALEZ",51,27,0,2,80
735361,476527,2015-09-11,Senate,"Unfinished Business SB376 Lara Concurrence",24,15,1,0,40
735363,427854,2015-04-07,Assembly,"Do pass and be re-referred to the Committee on Appropriations to 	Consent Calendar",7,0,0,0,7
735365,485054,2016-01-13,Senate,"Do pass as amended, and re-refer to the Committee on Appropriations",7,0,0,0,7
735365,485574,2016-01-19,Senate,"Placed on Appropriations Suspense file",7,0,0,0,7
735368,428238,2015-04-07,Assembly,"Do pass and be re-referred to the Committee on Appropriations",14,0,0,0,14
735368,437626,2015-04-22,Assembly,"Do pass, to Consent Calendar",17,0,0,0,17
735368,442228,2015-04-30,Assembly,"AB 576 TING  Consent Calendar Second Day  Regular Session",77,0,0,3,80
735369,443352,2015-05-05,Assembly,"Do pass",11,0,0,0,11
735369,445257,2015-05-11,Assembly,"AB 634 CALDERON  Assembly Third Reading",79,0,0,1,80
735369,556684,2016-06-28,Senate,"Do pass as amended",7,0,0,0,7
735371,438076,2015-04-14,Assembly,"Do pass and be re-referred to the Committee on Appropriations",16,0,0,3,19
735371,454210,2015-05-28,Assembly,"Do pass",13,1,0,3,17
735371,455932,2015-06-02,Assembly,"AB 635 ATKINS  Assembly Third Reading",72,2,0,6,80
735371,462962,2015-06-24,Senate,"Do pass, but re-refer to the Committee on Appropriations",7,1,1,0,9
735371,465915,2015-07-13,Senate,"Placed on Appropriations Suspense file",7,0,0,0,7
735371,474709,2015-08-27,Senate,"Do pass",5,2,0,0,7
735371,560982,2016-08-24,Senate,"From Committee:  That the measure be returned to the Senate floor 	for consideration",7,0,2,0,9
735371,561150,2016-08-25,Senate,"Assembly 3rd Reading AB635 Atkins By Pan",31,7,1,0,39
735371,561557,2016-08-30,Assembly,"AB 635 ATKINS  Concurrence in Senate Amendments",69,5,0,6,80
735372,440406,2015-04-27,Assembly,"Do pass and be re-referred to the Committee on Judiciary",2,7,0,0,9
735374,432575,2015-04-14,Assembly,"Do pass and be re-referred to the Committee on Appropriations to 	Consent Calendar",7,0,0,0,7
735374,437108,2015-04-22,Assembly,"Do pass, to Consent Calendar",17,0,0,0,17
735374,442226,2015-04-30,Assembly,"AB 608 GORDON  Consent Calendar Second Day  Regular Session",77,0,0,3,80
735374,458364,2015-06-09,Senate,"Do pass, but re-refer to the Committee on Appropriations",5,0,0,0,5
735374,461804,2015-06-22,Senate,"Placed on Appropriations Suspense file",6,0,1,0,7
735376,408827,2015-03-09,Assembly,"From committee:  Be adopted.  To third reading",11,0,0,0,11
735376,443054,2015-05-04,Senate,"Assembly 3rd Reading ACR31 Perea By Galgiani",35,0,4,0,39
735378,438506,2015-04-22,Assembly,"Do pass as amended and be re-referred to the Committee on 	Appropriations",5,2,0,0,7
735378,453851,2015-05-28,Assembly,"Do pass as amended",11,5,0,1,17
735378,457335,2015-06-04,Assembly,"AB 575 O'DONNELL  Assembly Third Reading",41,31,0,8,80
735378,556466,2016-06-29,Senate,"Do pass as amended, and re-refer to the Committee on Appropriations",9,0,0,0,9
735378,559702,2016-08-11,Senate,"Do pass as amended",7,0,0,0,7
735378,560235,2016-08-18,Senate,"Assembly 3rd Reading AB575 O'Donnell By Liu",38,0,1,0,39
735378,561658,2016-08-29,Assembly,"Senate amendments be concurred in",6,0,0,1,7
735378,561805,2016-08-31,Assembly,"AB 575 O'DONNELL  Concurrence in Senate Amendments",79,0,0,1,80
735379,442869,2015-05-04,Senate,"Placed on Appropriations Suspense file",7,0,0,0,7
735379,454013,2015-05-28,Senate,"Do pass as amended",5,1,1,0,7
735379,456679,2015-06-03,Senate,"Senate 3rd Reading SB347 Jackson",24,15,1,0,40
735379,458593,2015-04-14,Senate,"Do pass as amended, and re-refer to the Committee on Appropriations",4,2,0,1,7
735379,464309,2015-06-30,Assembly,"Do pass as amended and be re-referred to the Committee on 	Appropriations",5,2,0,0,7
735379,474383,2015-08-27,Assembly,"Do pass",12,5,0,0,17
735379,476009,2015-09-08,Assembly,"SB 347 Jackson  Senate Third Reading  By EGGMAN",46,30,0,4,80
735379,476313,2015-09-10,Senate,"Unfinished Business SB347 Jackson Concurrence",24,14,2,0,40
735381,441159,2015-04-29,Assembly,"Do pass and be re-referred to the Committee on Appropriations",9,0,0,0,9
735382,441124,2015-04-28,Assembly,"Do pass and be re-referred to the Committee on Appropriations",7,0,0,0,7
735382,446135,2015-05-13,Assembly,"Do pass",12,0,0,5,17
735382,447640,2015-05-18,Assembly,"AB 601 EGGMAN  Assembly Third Reading",66,7,0,7,80
735382,462163,2015-06-23,Senate,"Do pass as amended, and re-refer to the Committee on Appropriations",5,0,0,0,5
735382,465893,2015-07-13,Senate,"Placed on Appropriations Suspense file",7,0,0,0,7
735382,474554,2015-08-27,Senate,"Do pass as amended",6,1,0,0,7
735382,475564,2015-09-02,Senate,"Assembly 3rd Reading AB601 Eggman By Block",39,0,1,0,40
735382,475733,2015-09-03,Assembly,"AB 601 EGGMAN  Concurrence in Senate Amendments",78,0,0,2,80
735384,441487,2015-04-28,Assembly,"Amend, and do pass as amended and be re-referred to the Committee 	on Appropriations with the recommendation:  To Consent Calendar",7,0,0,0,7
735384,453009,2015-05-27,Assembly,"Do pass, to Consent Calendar",17,0,0,0,17
735384,456132,2015-06-02,Assembly,"AB 564 EGGMAN  Consent Calendar Second Day  Regular Session",78,0,0,2,80
735384,466087,2015-07-14,Senate,"Do pass as amended, and re-refer to the Committee on Appropriations",5,0,0,0,5
735384,473758,2015-08-17,Senate,"Placed on Appropriations Suspense file",7,0,0,0,7
735384,474644,2015-08-27,Senate,"Do pass as amended",7,0,0,0,7
735384,476022,2015-09-08,Senate,"Assembly 3rd Reading AB564 Eggman By McGuire",40,0,0,0,40
735384,476173,2015-09-09,Assembly,"AB 564 EGGMAN  Concurrence in Senate Amendments",79,0,0,1,80
735385,442830,2015-05-04,Senate,"Placed on Appropriations Suspense file",7,0,0,0,7
735385,453805,2015-05-28,Senate,"Do pass as amended",7,0,0,0,7
735385,457304,2015-06-04,Senate,"Senate 3rd Reading SB344 Monning",38,1,1,0,40
735385,463860,2015-06-29,Assembly,"Do pass and be re-referred to the Committee on Education",16,0,0,0,16
735387,432757,2015-04-15,Senate,"Do pass, but re-refer to the Committee on Judiciary",7,0,0,0,7
735387,446149,2015-05-12,Senate,"Do pass as amended, and re-refer to the Committee on Appropriations",7,0,0,0,7
735387,454411,2015-05-28,Senate,"Senate 3rd Reading SB385 Hueso Urgency Clause",39,0,1,0,40
735387,464377,2015-06-30,Assembly,"Do pass and be re-referred to the Committee on Judiciary to Consent 	Calendar",7,0,0,0,7
735387,465410,2015-07-07,Assembly,"Do pass and be re-referred to the Committee on Appropriations to 	Consent Calendar",10,0,0,0,10
735387,466311,2015-07-15,Assembly,"Do pass, to Consent Calendar",16,0,0,1,17
735387,473980,2015-08-20,Assembly,"SB 385 Hueso  Consent Calendar Second Day  Regular Session",79,0,0,1,80
735387,474074,2015-08-24,Senate,"Unfinished Business SB385 Hueso Urgency Clause",40,0,0,0,40
735388,437615,2015-04-22,Assembly,"Do pass as amended and be re-referred to the Committee on 	Appropriations",9,0,0,0,9
735388,443874,2015-05-06,Assembly,"Do pass, to Consent Calendar",17,0,0,0,17
735388,446676,2015-05-14,Assembly,"AB 630 LINDER  Consent Calendar Second Day  Regular Session",78,0,0,2,80
735388,465623,2015-07-08,Senate,"Do pass, but re-refer to the Committee on Appropriations Recommend 	Consent",7,0,0,0,7
735388,474013,2015-08-20,Senate,"Consent Calendar 2nd AB630 Linder",38,0,2,0,40
735388,474143,2015-08-24,Assembly,"AB 630 LINDER  Concurrence in Senate Amendments",79,0,0,1,80
735389,466182,2015-07-13,Assembly,"Do pass as amended and be re-referred to the Committee on 	Appropriations",9,0,0,0,9
735391,432588,2015-04-15,Assembly,"Do pass and be re-referred to the Committee on Appropriations to 	Consent Calendar",6,0,0,1,7
735391,441037,2015-04-29,Assembly,"Do pass, to Consent Calendar",17,0,0,0,17
735391,444366,2015-05-07,Assembly,"AB 646 MCCARTY  Consent Calendar Second Day  Regular Session",77,0,0,3,80
735391,466022,2015-07-14,Senate,"Do pass, but re-refer to the Committee on Appropriations Recommend 	Consent",13,0,0,0,13
735391,473996,2015-08-20,Senate,"Consent Calendar 2nd AB646 McCarty Urgency Clause",38,0,2,0,40
735391,475287,2015-08-31,Assembly,"AB 646 MCCARTY  Concurrence- Urgency Added",80,0,0,0,80
735392,443885,2015-05-06,Assembly,"Do pass, to Consent Calendar",7,0,0,0,7
735392,446761,2015-05-14,Assembly,"AB 663 IRWIN  Consent Calendar Second Day  Regular Session",78,0,0,2,80
735392,457968,2015-06-08,Senate,"Do pass and be placed on the Consent Calendar",4,0,1,0,5
735392,461149,2015-06-18,Senate,"Consent Calendar 2nd AB663 Irwin",37,0,3,0,40
735397,438030,2015-04-22,Senate,"Do pass, but re-refer to the Committee on Rules",4,0,1,0,5
735397,440213,2015-04-28,Senate,"Do pass as amended, and re-refer to the Committee on Appropriations",5,1,1,0,7
735397,451397,2015-05-26,Senate,"Senate 3rd Reading SB358 Jackson",38,0,1,0,39
735397,462940,2015-06-24,Assembly,"Do pass and be re-referred to the Committee on Judiciary",6,1,0,0,7
735397,463597,2015-05-18,Senate,"Do pass",5,0,2,0,7
735397,465476,2015-07-07,Assembly,"Do pass as amended and be re-referred to the Committee on 	Appropriations",10,0,0,0,10
735397,473857,2015-08-19,Assembly,"Do pass",17,0,0,0,17
735397,474426,2015-08-27,Assembly,"SB 358 Jackson  Senate Third Reading  By GARCIA, C",76,2,0,2,80
735397,475340,2015-08-31,Senate,"Unfinished Business SB358 Jackson Concurrence",40,0,0,0,40
735397,476860,2015-08-31,Senate,"Unfinished Business SB358 Jackson Reconsider",40,0,0,0,40
735397,476861,2015-08-31,Senate,"Unfinished Business SB358 Jackson Concurrence",39,0,1,0,40
735398,485041,2016-01-05,Assembly,"Be referred to Committee on Public Safety",11,0,0,0,11
735399,432737,2015-04-15,Senate,"Do pass as amended, and re-refer to the Committee on Appropriations",8,0,0,0,8
735399,445231,2015-05-11,Senate,"Placed on Appropriations Suspense file",7,0,0,0,7
735399,454186,2015-05-28,Senate,"Do pass as amended",7,0,0,0,7
735399,457303,2015-06-04,Senate,"Senate 3rd Reading SB359 Mitchell",40,0,0,0,40
735399,466422,2015-07-15,Assembly,"Do pass and be re-referred to the Committee on Appropriations",7,0,0,0,7
735399,474324,2015-08-27,Assembly,"Do pass as amended",17,0,0,0,17
735399,475815,2015-09-03,Assembly,"SB 359 Mitchell  Senate Third Reading  By JONES-SAWYER",77,0,0,3,80
735399,475878,2015-09-04,Senate,"Unfinished Business SB359 Mitchell Concurrence",39,1,0,0,40
735401,432807,2015-04-13,Assembly,"Do pass",16,0,0,0,16
735401,434137,2015-04-16,Assembly,"AB 638 FRAZIER  Assembly Third Reading",76,0,0,4,80
735401,458473,2015-06-09,Senate,"Do pass as amended",9,0,0,0,9
735401,461897,2015-06-22,Senate,"Special Consent #3 AB638 Frazier",37,0,3,0,40
735401,462971,2015-06-25,Assembly,"AB 638 FRAZIER  Concurrence in Senate Amendments",76,0,0,4,80
735402,432991,2015-04-14,Assembly,"Do pass and be re-referred to the Committee on Judiciary",9,0,0,0,9
735402,436003,2015-04-21,Assembly,"Do pass and be re-referred to the Committee on Appropriations to 	Consent Calendar",10,0,0,0,10
735402,441213,2015-04-29,Assembly,"Do pass, to Consent Calendar",17,0,0,0,17
735402,444539,2015-05-07,Assembly,"AB 583 CHAVEZ  Consent Calendar Second Day  Regular Session",77,0,0,3,80
735402,458444,2015-06-09,Senate,"Do pass, but re-refer to the Committee on Appropriations",5,0,0,0,5
735402,461957,2015-06-22,Senate,"Do pass",5,0,2,0,7
735402,465178,2015-07-06,Senate,"Special Consent #4 AB583 Ch",39,0,1,0,40
735405,437098,2015-04-22,Assembly,"Do pass",14,0,0,3,17
735405,444430,2015-05-07,Assembly,"AB 651 COOPER  Assembly Third Reading",70,3,0,7,80
735405,466005,2015-04-14,Assembly,"Do pass and be re-referred to the Committee on Appropriations",7,0,0,0,7
735407,444261,2015-05-06,Assembly,"Do pass",18,0,0,3,21
735407,446838,2015-05-14,Assembly,"AB 650 PEREA  Assembly Third Reading",80,0,0,0,80
735407,458363,2015-06-09,Senate,"Do pass and be placed on the Consent Calendar",13,0,0,0,13
735407,552475,2016-06-13,Senate,"Do pass as amended, and re-refer to the Committee on Transportation 	and Housing",9,0,2,0,11
735407,559637,2016-08-11,Senate,"Do pass as amended",5,0,2,0,7
735407,561810,2016-08-31,Assembly,"Senate amendments be concurred in",9,2,0,5,16
735407,561811,2016-08-31,Senate,"W/O REF. TO FILE AB650 Low By Cannella",27,7,5,0,39
735407,561812,2016-08-31,Assembly,"AB 650 LOW  Concurrence in Senate Amendments",57,12,0,11,80
735408,432854,2015-04-14,Senate,"Do pass, but re-refer to the Committee on Transportation and 	Housing",5,0,0,0,5
735408,484739,2016-01-12,Senate,"Do pass, but re-refer to the Committee on Appropriations",9,0,2,0,11
735408,485569,2016-01-19,Senate,"Placed on Appropriations Suspense file",7,0,0,0,7
735408,486321,2016-01-21,Senate,"Do pass",6,0,1,0,7
735408,487732,2016-01-26,Senate,"Senate 3rd Reading SB384 Leyva",38,0,2,0,40
735408,553149,2016-06-14,Assembly,"Do pass as amended and be re-referred to the Committee on Housing 	and Community Development",8,0,0,1,9
735408,556346,2016-06-29,Assembly,"Do pass as amended and be re-referred to the Committee on 	Appropriations",7,0,0,0,7
735410,428344,2015-04-07,Assembly,"Do pass and be re-referred to the Committee on Public Safety",12,0,0,1,13
735410,443434,2015-05-05,Assembly,"Do pass, to Consent Calendar",7,0,0,0,7
735410,445141,2015-05-11,Assembly,"AB 636 MEDINA  Consent Calendar Second Day  Regular Session",79,0,0,1,80
735410,458684,2015-06-10,Senate,"Do pass, but re-refer to the Committee on Public Safety",8,0,0,1,9
735410,466233,2015-07-14,Senate,"Do pass",7,0,0,0,7
735410,475328,2015-08-31,Senate,"Assembly 3rd Reading AB636 Medina By Liu",39,0,1,0,40
735411,446123,2015-05-12,Senate,"Do pass",7,0,0,0,7
735411,450260,2015-05-22,Senate,"Special Consent #2 SB387 Jackson",38,0,1,0,39
735411,466095,2015-07-14,Assembly,"Do pass as amended",10,0,0,0,10
735411,474390,2015-08-27,Assembly,"Do pass as amended",17,0,0,0,17
735411,476394,2015-09-10,Assembly,"SB 387 Jackson  Senate Third Reading  By STONE",80,0,0,0,80
735411,476653,2015-09-11,Senate,"Unfinished Business SB387 Jackson Concurrence",40,0,0,0,40
735412,427827,2015-04-07,Assembly,"Do pass and be re-referred to the Committee on Aging and Long",17,0,0,2,19
735412,436692,2015-04-21,Assembly,"Do pass and be re-referred to the Committee on Appropriations",7,0,0,0,7
735412,453762,2015-05-28,Assembly,"Do pass",17,0,0,0,17
735412,455509,2015-06-01,Assembly,"AB 664 DODD  Assembly Third Reading",80,0,0,0,80
735412,465817,2015-07-08,Senate,"Do pass, but re-refer to the Committee on Appropriations",8,0,1,0,9
735412,473656,2015-08-17,Senate,"Placed on Appropriations Suspense file",7,0,0,0,7
735412,474584,2015-08-27,Senate,"Do pass as amended",7,0,0,0,7
735412,475406,2015-09-01,Senate,"Assembly 3rd Reading AB664 Dodd By Hancock",37,0,3,0,40
735412,475565,2015-09-02,Assembly,"AB 664 DODD  Concurrence in Senate Amendments",79,0,0,1,80
735413,442129,2015-04-29,Senate,"Do pass, but re-refer to the Committee on Appropriations",4,2,3,0,9
735413,463643,2015-04-29,Senate,"Set, first hearing.  Failed passage in Committee.  Reconsideration 	granted",9,0,0,0,9
735416,446201,2015-05-12,Assembly,"Do pass, to Consent Calendar",19,0,0,0,19
735416,450221,2015-05-22,Assembly,"AB 658 WILK  Consent Calendar Second Day",74,0,0,6,80
735416,460878,2015-06-17,Senate,"Do pass as amended. To Consent Calendar",9,0,0,0,9
735416,462949,2015-06-25,Senate,"Consent Calendar 2nd AB658 Wilk",37,0,3,0,40
735416,464941,2015-07-02,Assembly,"AB 658 WILK  Concurrence in Senate Amendments",78,0,0,2,80
735417,432609,2015-04-14,Assembly,"Do pass and be re-referred to the Committee on Appropriations",14,0,0,0,14
735417,441087,2015-04-29,Assembly,"Do pass, to Consent Calendar",17,0,0,0,17
735417,444541,2015-05-07,Assembly,"AB 607 DODD  Consent Calendar Second Day  Regular Session",77,0,0,3,80
735417,460812,2015-06-17,Senate,"Do pass as amended, and re-refer to the Committee on Appropriations",7,0,0,0,7
735417,465775,2015-07-09,Senate,"Assembly 3rd Reading AB607 Dodd By McGuire",39,0,1,0,40
735417,465877,2015-07-13,Assembly,"AB 607 DODD  Concurrence in Senate Amendments",79,0,0,1,80
735419,427834,2015-04-07,Senate,"Do pass, but re-refer to the Committee on Environmental Quality",8,3,0,0,11
735419,440985,2015-04-29,Senate,"Do pass, but re-refer to the Committee on Appropriations",5,2,0,0,7
735419,453961,2015-05-28,Senate,"Do pass",5,2,0,0,7
735419,456604,2015-06-03,Senate,"Senate 3rd Reading SB350 De Le",24,14,2,0,40
735419,463555,2015-05-18,Senate,"Placed on Appropriations Suspense file",7,0,0,0,7
735419,465987,2015-07-13,Assembly,"Do pass as amended and be re-referred to the Committee on 	Appropriations",6,2,0,1,9
735419,474180,2015-07-06,Assembly,"Do pass as amended and be re-referred to the Committee on Natural 	Resources",9,5,0,1,15
735419,474327,2015-08-27,Assembly,"Do pass",12,5,0,0,17
735419,475834,2015-09-04,Assembly,"SB 350 De Leon  Senate Third Reading  Amend By WILLIAMS  Set #1",41,27,0,12,80
735419,476315,2015-09-10,Assembly,"Do pass as amended",5,2,0,2,9
735419,476494,2015-09-11,Assembly,"SB 350 De Leon  Senate Third Reading  By ATKINS",52,27,0,1,80
735419,476495,2015-09-11,Senate,"Unfinished Business (S upplemental File 6)SB3 50 De Le",26,14,0,0,40
735420,440011,2015-04-27,Assembly,"Do pass and be re-referred to the Committee on Appropriations",11,0,0,5,16
735420,453916,2015-05-28,Assembly,"Do pass as amended",16,0,0,1,17
735420,455898,2015-06-02,Assembly,"AB 652 COOLEY  Assembly Third Reading",77,0,0,3,80
735420,462118,2015-06-23,Senate,"Do pass, but re-refer to the Committee on Appropriations",10,0,1,0,11
735420,465146,2015-07-06,Senate,"Placed on Appropriations Suspense file",7,0,0,0,7
735420,474526,2015-08-27,Senate,"Do pass as amended",5,1,1,0,7
735420,475630,2015-09-02,Senate,"Assembly 3rd Reading AB652 Cooley By Pan",37,0,3,0,40
735420,475892,2015-09-04,Assembly,"AB 652 COOLEY  Concurrence in Senate Amendments",56,24,0,0,80
735422,446181,2015-05-13,Assembly,"Do pass",7,0,0,0,7
735422,447749,2015-05-18,Assembly,"AB 596 DALY  Assembly Third Reading",77,0,0,3,80
735422,460242,2015-06-16,Senate,"Do pass",11,0,0,0,11
735422,465179,2015-07-06,Senate,"Special Consent #4 AB596 Daly",39,0,1,0,40
735422,465759,2015-07-09,Assembly,"AB 596 DALY  Concurrence in Senate Amendments",78,0,0,2,80
735423,428469,2015-04-08,Assembly,"Be adopted, to Consent Calendar",12,0,0,1,13
735423,430670,2015-04-13,Assembly,"AJR6 COOLEY  Consent Calendar Second Day  Regular Session",79,0,0,1,80
735423,459483,2015-06-10,Senate,"Be adopted",9,0,0,0,9
735423,461862,2015-06-22,Senate,"Special Consent #3 AJR6 Cooley",37,0,3,0,40
735424,443887,2015-05-06,Senate,"Do pass",5,1,1,0,7
735424,446732,2015-05-14,Senate,"Senate 3rd Reading SB371 Hancock",30,3,6,0,39
735424,461956,2015-06-22,Assembly,"Do pass",6,1,0,2,9
735424,463908,2015-06-29,Assembly,"SB 371 Hancock  Senate Third Reading  By TING",53,16,0,11,80
735426,430671,2015-04-13,Assembly,"Be referred to Committee on Natural Resources",11,0,0,0,11
735426,440323,2015-04-27,Assembly,"Do pass as amended and be re-referred to the Committee on 	Appropriations",9,0,0,0,9
735426,453953,2015-05-28,Assembly,"Do pass as amended",17,0,0,0,17
735426,456038,2015-06-02,Assembly,"AB 577 BONILLA  Assembly Third Reading",77,1,0,2,80
735426,464417,2015-06-30,Senate,"Do pass as amended, and re-refer to the Committee on Environmental 	Quality",7,0,4,0,11
735426,466379,2015-07-15,Senate,"Do pass, but re-refer to the Committee on Appropriations",7,0,0,0,7
735426,473578,2015-08-17,Senate,"Placed on Appropriations Suspense file",7,0,0,0,7
735427,440241,2015-04-28,Senate,"Do pass and be placed on the Consent Calendar",7,0,4,0,11
735427,442930,2015-05-04,Senate,"Consent Calendar 2nd SB374 Hall",35,0,4,0,39
735427,466403,2015-07-15,Assembly,"Do pass, to Consent Calendar",18,0,0,3,21
735427,475991,2015-09-08,Assembly,"Do pass",9,0,0,0,9
735427,476425,2015-09-10,Assembly,"SB 374 Hueso  Senate Third Reading  By MAIENSCHEIN",80,0,0,0,80
735427,476591,2015-09-11,Senate,"From committee:  That the Assembly Amendments be concurred in",9,0,2,0,11
735427,476592,2015-09-11,Senate,"Unfinished Business (S upplemental File 1)SB3 74 Hue so Con",40,0,0,0,40
735429,428391,2015-04-08,Assembly,"Do pass and be re-referred to the Committee on Utilities and 	Commerce",9,0,0,0,9
735429,445217,2015-05-11,Assembly,"Do pass as amended",15,0,0,0,15
735429,450266,2015-05-22,Assembly,"AB 568 DODD  Assembly Third Reading",75,0,0,5,80
735429,460323,2015-06-16,Senate,"Do pass",10,0,1,0,11
735429,465266,2015-07-06,Senate,"Assembly 3rd Reading AB568 Dodd By Nielsen",35,1,4,0,40
735430,432657,2015-04-14,Assembly,"Do pass and be re-referred to the Committee on Appropriations",14,0,0,0,14
735430,437321,2015-04-22,Assembly,"Do pass, to Consent Calendar",17,0,0,0,17
735430,442154,2015-04-30,Assembly,"AB 599 BONILLA  Consent Calendar Second Day  Regular Session",77,0,0,3,80
735430,457993,2015-06-08,Senate,"Do pass, but re-refer to the Committee on Appropriations",9,0,0,0,9
735430,461839,2015-06-22,Senate,"Do pass",6,0,1,0,7
735430,475404,2015-09-01,Senate,"Assembly 3rd Reading AB599 Bonilla By Hill",40,0,0,0,40
735430,475673,2015-09-02,Assembly,"AB 599 BONILLA  Concurrence in Senate Amendments",80,0,0,0,80
735432,440261,2015-04-27,Assembly,"Do pass and be re-referred to the Committee on Appropriations",16,0,0,0,16
735432,443900,2015-05-06,Assembly,"Do pass",17,0,0,0,17
735432,446883,2015-05-14,Assembly,"AB 605 GATTO  Assembly Third Reading",80,0,0,0,80
735432,462242,2015-06-23,Senate,"Do pass, but re-refer to the Committee on Appropriations",9,0,2,0,11
735432,465215,2015-07-06,Senate,"Do pass",6,0,1,0,7
735432,475959,2015-09-08,Senate,"Assembly 3rd Reading AB605 Gatto By Beall",36,1,3,0,40
735432,476114,2015-09-09,Assembly,"AB 605 GATTO  Concurrence in Senate Amendments",78,0,0,2,80
735434,445820,2015-05-12,Senate,"Do pass as amended",5,2,0,0,7
735434,451863,2015-05-26,Senate,"Senate 3rd Reading SB382 Lara Motions",24,13,2,0,39
735434,464271,2015-06-30,Assembly,"Do pass as amended",5,0,0,2,7
735434,466473,2015-07-16,Assembly,"SB 382 Lara  Senate Third Reading  By SANTIAGO",61,15,0,4,80
735434,473822,2015-08-17,Senate,"Unfinished Business SB382 Lara Concurrence",26,12,2,0,40
735436,440247,2015-04-28,Assembly,"Do pass and be re-referred to the Committee on Appropriations",14,0,0,1,15
735436,453718,2015-05-28,Assembly,"Do pass as amended",17,0,0,0,17
735436,456027,2015-06-02,Assembly,"AB 617 PEREA  Assembly Third Reading",77,1,0,2,80
735436,466011,2015-07-14,Senate,"Do pass as amended, and re-refer to the Committee on Appropriations",9,0,0,0,9
735436,473597,2015-08-17,Senate,"Placed on Appropriations Suspense file",7,0,0,0,7
735436,474659,2015-08-27,Senate,"Do pass as amended",7,0,0,0,7
735436,476063,2015-09-09,Senate,"Assembly 3rd Reading AB617 Perea By Pavley",40,0,0,0,40
735436,476319,2015-09-10,Assembly,"AB 617 PEREA  Concurrence in Senate Amendments",79,0,0,1,80
735437,429320,2015-04-08,Senate,"Do pass as amended, and re-refer to the Committee on Appropriations",9,0,0,0,9
735437,442245,2015-04-30,Senate,"Senate 3rd Reading SB361 Hill Urgency Clause",35,0,4,0,39
735437,462130,2015-06-23,Assembly,"Do pass and be re-referred to the Committee on Appropriations",19,0,0,0,19
735437,465811,2015-07-09,Assembly,"Be referred to Committee on Business and Professions",11,0,0,0,11
735437,473911,2015-08-19,Assembly,"Do pass, to Consent Calendar",17,0,0,0,17
735437,475266,2015-08-31,Assembly,"SB 361 Hill  Third Reading Urgency  By WALDRON",79,0,0,1,80
735437,475642,2015-09-02,Senate,"Unfinished Business SB361 Hill Urgency Clause",40,0,0,0,40
735443,432866,2015-04-14,Assembly,"Do pass as amended and be re-referred to the Committee on 	Appropriations",10,1,0,4,15
735443,441492,2015-04-29,Assembly,"Do pass as amended",12,1,0,4,17
735443,457466,2015-06-04,Assembly,"AB 647 EGGMAN  Assembly Third Reading",61,10,0,9,80
735445,437784,2015-04-22,Assembly,"Do pass as amended and be re-referred to the Committee on 	Appropriations",6,1,0,0,7
735445,446197,2015-05-13,Assembly,"Do pass",12,5,0,0,17
735445,450086,2015-05-22,Assembly,"AB 622 HERNANDEZ  Assembly Third Reading",50,25,0,5,80
735445,462579,2015-06-24,Senate,"Do pass, but re-refer to the Committee on Appropriations",4,1,0,0,5
735445,475632,2015-09-02,Senate,"Assembly 3rd Reading AB622 Roger Hern",23,12,5,0,40
735445,475897,2015-09-04,Assembly,"AB 622 HERNANDEZ  Concurrence in Senate Amendments",51,26,0,3,80
735446,438539,2015-04-22,Assembly,"Do pass and be re-referred to the Committee on Appropriations",5,2,0,0,7
735446,443884,2015-05-06,Assembly,"Do pass",12,5,0,0,17
735446,445100,2015-05-11,Assembly,"AB 566 O'DONNELL  Assembly Third Reading",53,26,0,1,80
735446,458622,2015-06-10,Senate,"Do pass as amended, and re-refer to the Committee on Appropriations",6,2,0,1,9
735446,465173,2015-07-06,Senate,"Do pass",5,2,0,0,7
735446,465890,2015-07-13,Senate,"Assembly 3rd Reading AB566 O'Donnell By Block",26,13,1,0,40
735446,466557,2015-07-16,Assembly,"AB 566 O'DONNELL  Concurrence in Senate Amendments",53,26,0,1,80
735447,432603,2015-04-14,Assembly,"Do pass as amended and be re-referred to the Committee on Aging and 	Long",7,0,0,0,7
735447,442184,2015-04-30,Assembly,"Do pass as amended and be re-referred to the Committee on 	Appropriations",6,0,0,1,7
735447,453754,2015-05-28,Assembly,"Do pass",17,0,0,0,17
735447,455929,2015-06-02,Assembly,"AB 563 LOPEZ  Assembly Third Reading",79,0,0,1,80
735449,440126,2015-04-27,Assembly,"Do pass and be re-referred to the Committee on Appropriations",11,3,0,2,16
735449,443896,2015-05-06,Assembly,"Do pass",17,0,0,0,17
735449,447598,2015-05-18,Assembly,"AB 604 OLSEN  Assembly Third Reading",61,8,0,11,80
735449,460217,2015-06-16,Senate,"Do pass as amended, and re-refer to the Committee on Appropriations",10,1,0,0,11
735449,465753,2015-07-09,Senate,"Assembly 3rd Reading AB604 Olsen By Beall",32,1,7,0,40
735449,466487,2015-07-16,Assembly,"AB 604 OLSEN  Concurrence in Senate Amendments",76,1,0,3,80
735449,476465,2015-09-11,Senate,"Assembly 3rd Reading ( Supplemental File 1)AB 604 Ol sen By",37,0,3,0,40
735449,476466,2015-09-11,Assembly,"AB 604 OLSEN  Concurrence in Senate Amendments",75,1,0,4,80
735450,446224,2015-05-12,Senate,"Do pass and be placed on the Consent Calendar",7,0,0,0,7
735450,450236,2015-05-22,Senate,"Consent Calendar 2nd SB363 Morrell",38,0,1,0,39
735450,462092,2015-06-23,Assembly,"Do pass, to Consent Calendar",10,0,0,0,10
735450,463854,2015-06-29,Assembly,"SB 363 Morrell  Consent Calendar Second Day",76,0,0,4,80
735452,414033,2015-03-19,Senate,"Senate 3rd Reading SCR21 Jackson",35,0,3,0,38
735452,433946,2015-04-16,Assembly,"Be adopted, to Consent Calendar",11,0,0,0,11
735452,438415,2015-04-23,Assembly,"SCR 21 Jackson  Consent Calendar Second Day  Regular Session",78,0,0,2,80
735453,436173,2015-04-21,Assembly,"Do pass and be re-referred to the Committee on Revenue and Taxation",8,0,0,1,9
735453,440291,2015-04-27,Assembly,"Do pass as amended and be re-referred to the Committee on 	Appropriations",9,0,0,0,9
735453,454161,2015-05-28,Assembly,"Do pass",17,0,0,0,17
735453,455298,2015-06-01,Assembly,"AB 582 CALDERON  Assembly Third Reading",80,0,0,0,80
735453,558983,2016-08-01,Senate,"Placed on Appropriations Suspense file",7,0,0,0,7
735455,438312,2015-04-14,Assembly,"Do pass and be re-referred to the Committee on Business and 	Professions",16,0,0,3,19
735455,443370,2015-05-05,Assembly,"Do pass",14,0,0,0,14
735455,444475,2015-05-07,Assembly,"AB 627 GOMEZ  Assembly Third Reading",77,0,0,3,80
735455,459955,2015-06-15,Senate,"Do pass as amended",9,0,0,0,9
735455,461856,2015-06-22,Senate,"Special Consent #3 AB627 Gomez",37,0,3,0,40
735455,463007,2015-06-25,Assembly,"AB 627 GOMEZ  Concurrence in Senate Amendments",80,0,0,0,80
735456,441108,2015-04-29,Assembly,"Do pass as amended and be re-referred to the Committee on 	Appropriations",9,0,0,0,9
735456,448930,2015-05-20,Assembly,"Do pass",14,1,0,2,17
735456,450088,2015-05-22,Assembly,"AB 656 GARCIA, C.  Assembly Third Reading",68,1,0,11,80
735456,460676,2015-06-17,Senate,"Do pass as amended, and re-refer to the Committee on Appropriations",7,0,0,0,7
735456,473595,2015-08-17,Senate,"Assembly 3rd Reading AB656 Cristina Garcia By Hertzberg",37,0,3,0,40
735456,473976,2015-08-20,Assembly,"AB 656 GARCIA, C.  Concurrence in Senate Amendments",77,1,0,2,80
735458,439941,2015-04-28,Assembly,"Do pass",6,1,0,0,7
735458,444442,2015-05-07,Assembly,"AB 628 BLOOM  Assembly Third Reading",60,16,0,4,80
735459,438217,2015-04-14,Assembly,"Do pass as amended and be re-referred to the Committee on 	Appropriations",17,0,0,2,19
735459,454032,2015-05-28,Assembly,"Do pass",17,0,0,0,17
735459,455263,2015-06-01,Assembly,"AB 572 GAINES  Assembly Third Reading",80,0,0,0,80
735459,466445,2015-07-15,Senate,"Do pass, but re-refer to the Committee on Appropriations",9,0,0,0,9
735459,473670,2015-08-17,Senate,"Placed on Appropriations Suspense file",7,0,0,0,7
735460,461392,2015-06-18,Assembly,"From committee:  Be adopted.  To third reading",11,0,0,0,11
735461,407742,2015-03-09,Senate,"Senate 3rd Reading SR13 Jackson",36,0,1,0,37
735462,440948,2015-04-29,Assembly,"Do pass and be re-referred to the Committee on Appropriations",7,0,0,0,7
735462,446167,2015-05-13,Assembly,"Do pass, to Consent Calendar",17,0,0,0,17
735462,450232,2015-05-22,Assembly,"AB 609 GARCIA, C.  Consent Calendar Second Day  Regular Session",74,0,0,6,80
735462,465493,2015-07-07,Senate,"Do pass as amended, and re-refer to the Committee on Appropriations",4,0,1,0,5
735462,473743,2015-08-17,Senate,"Placed on Appropriations Suspense file",7,0,0,0,7
735464,433021,2015-04-15,Assembly,"Do pass and be re-referred to the Committee on Appropriations",5,0,0,2,7
735464,441886,2015-04-29,Assembly,"Do pass",17,0,0,0,17
735464,444510,2015-05-07,Assembly,"AB 594 GORDON  Assembly Third Reading",77,0,0,3,80
735464,465492,2015-07-07,Senate,"Do pass, but re-refer to the Committee on Appropriations",4,0,1,0,5
735464,475257,2015-08-31,Senate,"Assembly 3rd Reading AB594 Gordon By Allen",40,0,0,0,40
735464,475436,2015-09-01,Assembly,"AB 594 GORDON  Concurrence in Senate Amendments",79,0,0,1,80
735466,428753,2015-04-08,Senate,"Do pass, but re-refer to the Committee on Appropriations Recommend 	Consent",8,0,0,0,8
735466,435223,2015-04-20,Senate,"Placed on Appropriations Suspense file",7,0,0,0,7
735466,453752,2015-05-28,Senate,"Do pass",7,0,0,0,7
735466,455337,2015-06-01,Senate,"Senate 3rd Reading SB369 Block",40,0,0,0,40
735466,466354,2015-07-15,Assembly,"Do pass and be re-referred to the Committee on Appropriations",7,0,0,0,7
735466,474298,2015-08-27,Assembly,"Do pass",17,0,0,0,17
735466,475305,2015-08-31,Assembly,"SB 369 Block  Senate Third Reading  By CHAVEZ",79,0,0,1,80
735466,475443,2015-09-01,Senate,"Unfinished Business SB369 Block Concurrence",40,0,0,0,40
735467,441255,2015-04-29,Assembly,"Do pass and be re-referred to the Committee on Appropriations",9,0,0,0,9
735467,448968,2015-05-20,Assembly,"Do pass, to Consent Calendar",15,0,0,2,17
735467,451878,2015-05-26,Assembly,"AB 606 LEVINE  Consent Calendar Second Day  Regular Session",76,0,0,4,80
735467,463834,2015-06-29,Senate,"Do pass, but re-refer to the Committee on Appropriations",12,0,1,0,13
735467,473750,2015-08-17,Senate,"Do pass",7,0,0,0,7
735467,475324,2015-08-31,Senate,"Assembly 3rd Reading AB606 Levine By Wolk",40,0,0,0,40
735467,475499,2015-09-01,Assembly,"AB 606 LEVINE  Concurrence in Senate Amendments",79,0,0,1,80
735470,442105,2015-04-28,Assembly,"Do pass and be re-referred to the Committee on Appropriations",12,0,0,1,13
735470,443984,2015-05-06,Assembly,"Do pass",17,0,0,0,17
735470,445835,2015-05-12,Assembly,"Do pass",11,0,0,2,13
735470,446834,2015-05-14,Assembly,"AB 573 MEDINA  Third Reading Urgency",74,0,0,6,80
735470,464438,2015-06-29,Senate,"Do pass as amended, and re-refer to the Committee on Education",7,0,2,0,9
735470,466328,2015-07-15,Senate,"Do pass as amended, and re-refer to the Committee on Appropriations",7,0,2,0,9
735470,474135,2015-08-24,Senate,"Placed on Appropriations Suspense file",7,0,0,0,7
735470,474586,2015-08-27,Senate,"Do pass as amended",5,0,2,0,7
735470,476627,2015-09-11,Senate,"Assembly 3rd Reading AB573 Medina By Block",36,0,4,0,40
735470,476628,2015-09-11,Assembly,"AB 573 MEDINA  Concurrence in Senate Amendments",79,0,0,1,80
735471,432642,2015-04-14,Assembly,"Do pass as amended and be re-referred to the Committee on 	Appropriations",15,0,0,0,15
735471,437196,2015-04-22,Assembly,"Do pass, to Consent Calendar",17,0,0,0,17
735471,442173,2015-04-30,Assembly,"AB 665 FRAZIER  Consent Calendar Second Day  Regular Session",77,0,0,3,80
735471,462182,2015-06-23,Senate,"Do pass as amended, and re-refer to the Committee on Appropriations",7,0,2,0,9
735471,475971,2015-09-08,Senate,"Assembly 3rd Reading AB665 Frazier By Berryhill",26,11,3,0,40
735474,444348,2015-05-06,Assembly,"Do pass",8,0,0,1,9
735474,450245,2015-05-22,Assembly,"AB 661 MATHIS  Assembly Third Reading",75,0,0,5,80
735474,460679,2015-06-17,Senate,"Do pass and be placed on the Consent Calendar",7,0,0,0,7
735474,461819,2015-06-22,Senate,"Consent Calendar 2nd AB661 Mathis",37,0,3,0,40
735474,463035,2015-06-25,Assembly,"AB 661 MATHIS  Concurrence in Senate Amendments",80,0,0,0,80
735476,427862,2015-04-07,Assembly,"Do pass as amended",9,1,0,0,10
735476,441154,2015-04-29,Assembly,"Do pass",16,1,0,0,17
735476,444383,2015-05-07,Assembly,"AB 610 JONES-SAWYER  Third Reading Urgency",69,4,0,7,80
735476,466291,2015-07-14,Senate,"Do pass as amended, and re-refer to the Committee on Appropriations",7,0,0,0,7
735476,473757,2015-08-17,Senate,"Placed on Appropriations Suspense file",7,0,0,0,7
735476,474708,2015-08-27,Senate,"Do pass as amended",7,0,0,0,7
735476,475785,2015-09-03,Senate,"Assembly 3rd Reading AB610 Jones-Sawyer By Wieckowski",40,0,0,0,40
735476,475919,2015-09-08,Assembly,"AB 610 JONES-SAWYER  Concurrence in Senate Amendments",72,5,0,3,80
735477,484898,2016-01-13,Senate,"Do pass, but re-refer to the Committee on Appropriations Recommend 	Consent",1,4,0,0,5
735479,440441,2015-04-27,Assembly,"Do pass as amended and be re-referred to the Committee on 	Appropriations",9,0,0,0,9
735479,446179,2015-05-13,Assembly,"Do pass, to Consent Calendar",17,0,0,0,17
735479,454182,2015-05-28,Assembly,"AB 571 BROWN  Assembly Third Reading",77,0,0,3,80
735479,466510,2015-07-16,Senate,"Special Consent #5 AB571 Brown",38,0,2,0,40
735479,475710,2015-09-03,Senate,"Assembly 3rd Reading AB571 Brown By Cannella",40,0,0,0,40
735479,475890,2015-09-04,Assembly,"AB 571 BROWN  Concurrence in Senate Amendments",80,0,0,0,80
735480,429394,2015-04-08,Assembly,"Do pass and be re-referred to the Committee on Appropriations",5,2,0,0,7
735480,454446,2015-05-28,Assembly,"Do pass as amended",12,5,0,0,17
735480,456602,2015-06-03,Assembly,"AB 621 HERNANDEZ  Assembly Third Reading",47,29,0,4,80
735480,462609,2015-06-24,Senate,"Do pass, but re-refer to the Committee on Judiciary",4,1,0,0,5
735480,465647,2015-07-07,Senate,"Do pass, but re-refer to the Committee on Appropriations",6,0,1,0,7
735480,473630,2015-08-17,Senate,"Placed on Appropriations Suspense file",7,0,0,0,7
735480,474488,2015-08-27,Senate,"Do pass as amended",5,2,0,0,7
735480,476073,2015-09-09,Senate,"Assembly 3rd Reading AB621 Roger Hern",27,13,0,0,40
735480,476390,2015-09-10,Assembly,"AB 621 HERNANDEZ  Concurrence in Senate Amendments",49,29,0,2,80
735483,442810,2015-05-04,Assembly,"From committee:  Be adopted.  To third reading",8,0,0,3,11
735483,461909,2015-06-22,Senate,"Special Consent #3 ACR30 Irwin",37,0,3,0,40
735484,427842,2015-04-07,Senate,"Do pass as amended, and re-refer to the Committee on Environmental 	Quality",5,0,0,0,5
735484,441158,2015-04-29,Senate,"Do pass as amended, and re-refer to the Committee on Appropriations",7,0,0,0,7
735484,453610,2015-05-28,Senate,"Do pass as amended",7,0,0,0,7
735484,456564,2015-06-03,Senate,"Senate 3rd Reading SB367 Wolk",35,3,2,0,40
735484,463620,2015-05-18,Senate,"Placed on Appropriations Suspense file",7,0,0,0,7
735484,466039,2015-07-13,Assembly,"Do pass as amended and be re-referred to the Committee on 	Appropriations",8,1,0,0,9
735484,474046,2015-07-01,Assembly,"Do pass as amended and be re-referred to the Committee on Natural 	Resources",7,0,0,3,10
735486,437308,2015-04-21,Senate,"Do pass, but re-refer to the Committee on Appropriations",6,1,0,0,7
735486,443104,2015-05-04,Senate,"Placed on Appropriations Suspense file",7,0,0,0,7
735486,453883,2015-05-28,Senate,"Do pass as amended",5,2,0,0,7
735486,455924,2015-06-02,Senate,"Senate 3rd Reading SB343 Hancock",39,1,0,0,40
735486,464420,2015-06-30,Assembly,"Do pass and be re-referred to the Committee on Appropriations",7,0,0,0,7
735486,474339,2015-08-27,Assembly,"Do pass",16,1,0,0,17
735486,475781,2015-09-03,Assembly,"SB 343 Hancock  Senate Third Reading  By SANTIAGO",76,0,0,4,80
735490,436120,2015-04-21,Assembly,"Do pass and be re-referred to the Committee on Appropriations",5,2,0,0,7
735491,431889,2015-04-13,Assembly,"Do pass as amended and be re-referred to the Committee on Utilities 	and Commerce",9,0,0,0,9
735491,440350,2015-04-27,Assembly,"Do pass as amended and be re-referred to the Committee on 	Appropriations",15,0,0,0,15
735491,453691,2015-05-28,Assembly,"Do pass as amended",17,0,0,0,17
735491,455918,2015-06-02,Assembly,"AB 590 DAHLE  Assembly Third Reading",78,0,0,2,80
735491,464381,2015-06-30,Senate,"Do pass as amended, and re-refer to the Committee on Environmental 	Quality",10,0,1,0,11
735491,466243,2015-07-15,Senate,"Do pass, but re-refer to the Committee on Appropriations",7,0,0,0,7
735491,473676,2015-08-17,Senate,"Placed on Appropriations Suspense file",7,0,0,0,7
735493,427830,2015-04-07,Assembly,"Do pass",10,0,0,0,10
735493,433875,2015-04-16,Assembly,"AB 637 CAMPOS  Assembly Third Reading",75,0,0,5,80
735493,458676,2015-06-10,Senate,"Do pass",8,0,0,1,9
735493,465186,2015-07-06,Senate,"Assembly 3rd Reading AB637 Campos By Monning",37,2,1,0,40
735495,446398,2015-05-12,Senate,"Do pass and be placed on the Consent Calendar",7,0,0,0,7
735495,450170,2015-05-22,Senate,"Consent Calendar 2nd SB386 Allen",38,0,1,0,39
735495,465456,2015-07-07,Assembly,"Do pass, to Consent Calendar",11,0,0,0,11
735495,466577,2015-07-16,Assembly,"SB 386 Allen  Consent Calendar Second Day  Regular Session",79,0,0,1,80
735495,473999,2015-08-20,Senate,"Special Consent #6 SB386 Allen",38,0,2,0,40
735498,436052,2015-04-21,Assembly,"Do pass as amended and be re-referred to the Committee on 	Appropriations",14,0,0,0,14
735498,443932,2015-05-06,Assembly,"Do pass, to Consent Calendar",17,0,0,0,17
735498,446680,2015-05-14,Assembly,"AB 624 WILK  Consent Calendar Second Day  Regular Session",78,0,0,2,80
735498,464383,2015-06-29,Senate,"Do pass, but re-refer to the Committee on Appropriations",6,1,2,0,9
735498,465895,2015-07-13,Senate,"Placed on Appropriations Suspense file",7,0,0,0,7
735499,437223,2015-04-21,Assembly,"Do pass and be re-referred to the Committee on Appropriations",11,2,0,0,13
735499,453958,2015-05-28,Assembly,"Do pass as amended",12,4,0,1,17
735499,456612,2015-06-03,Assembly,"AB 626 LOW  Assembly Third Reading",55,24,0,1,80
735499,556271,2016-06-28,Senate,"Do pass, but re-refer to the Committee on Appropriations",7,0,0,0,7
735499,558752,2016-08-01,Senate,"Placed on Appropriations Suspense file",7,0,0,0,7
735499,559558,2016-08-11,Senate,"Do pass",7,0,0,0,7
735499,560777,2016-08-23,Senate,"Assembly 3rd Reading AB626 Chiu By Hertzberg",39,0,0,0,39
735499,561616,2016-08-30,Assembly,"AB 626 CHIU  Concurrence in Senate Amendments",79,0,0,1,80
735500,427811,2015-04-07,Assembly,"Do pass and be re-referred to the Committee on Appropriations",19,0,0,0,19
735500,453604,2015-05-28,Assembly,"Do pass",17,0,0,0,17
735500,455292,2015-06-01,Assembly,"AB 648 LOW  Assembly Third Reading",79,0,0,1,80
735500,462960,2015-06-24,Senate,"Do pass as amended, and re-refer to the Committee on Appropriations",8,0,1,0,9
735500,465899,2015-07-13,Senate,"Placed on Appropriations Suspense file",7,0,0,0,7
735500,474510,2015-08-27,Senate,"Do pass as amended",7,0,0,0,7
735501,442253,2015-04-29,Assembly,"Do pass as amended and be re-referred to the Committee on 	Appropriations",6,0,0,1,7
735501,453926,2015-05-28,Assembly,"Do pass as amended",15,0,0,2,17
735501,455906,2015-06-02,Assembly,"AB 580 O'DONNELL  Assembly Third Reading",77,0,0,3,80
735501,464677,2015-07-01,Senate,"Do pass, but re-refer to the Committee on Health Recommend Consent",7,0,2,0,9
735501,465756,2015-07-08,Senate,"Do pass, but re-refer to the Committee on Appropriations Recommend 	Consent",7,0,2,0,9
735501,473797,2015-08-17,Senate,"Placed on Appropriations Suspense file",7,0,0,0,7
735501,474583,2015-08-27,Senate,"Do pass",7,0,0,0,7
735501,475525,2015-09-01,Senate,"Assembly 3rd Reading AB580 O'Donnell By Hancock",39,0,1,0,40
735501,475814,2015-09-03,Assembly,"AB 580 O'DONNELL  Concurrence in Senate Amendments",80,0,0,0,80
735505,439602,2015-04-27,Senate,"Do pass, but re-refer to the Committee on Appropriations Recommend 	Consent",5,0,0,0,5
735505,447815,2015-05-18,Senate,"Consent Calendar 2nd SB354 Huff",36,0,3,0,39
735505,462746,2015-06-24,Assembly,"Do pass and be re-referred to the Committee on Appropriations to 	Consent Calendar",6,0,0,1,7
735505,465604,2015-07-08,Assembly,"Do pass, to Consent Calendar",14,0,0,3,17
735505,466573,2015-07-16,Assembly,"SB 354 Huff  Consent Calendar Second Day  Regular Session",79,0,0,1,80
735506,428501,2015-04-08,Senate,"Do pass, but re-refer to the Committee on Appropriations",5,2,1,0,8
735506,442868,2015-05-04,Senate,"Placed on Appropriations Suspense file",7,0,0,0,7
735507,440233,2015-04-28,Assembly,"Do pass and be re-referred to the Committee on Appropriations",11,4,0,0,15
735507,453940,2015-05-28,Assembly,"Do pass as amended",12,5,0,0,17
735507,457300,2015-06-04,Assembly,"AB 615 RENDON  Assembly Third Reading",79,0,0,1,80
735509,446392,2015-05-12,Senate,"Do pass as amended. To Consent Calendar",7,0,0,0,7
735509,450142,2015-05-22,Senate,"Consent Calendar 2nd SB383 Wieckowski",38,0,1,0,39
735509,466075,2015-07-14,Assembly,"Do pass and be re-referred to the Committee on Appropriations",10,0,0,0,10
735509,473885,2015-08-19,Assembly,"Do pass",14,2,0,1,17
735509,475871,2015-09-04,Assembly,"SB 383 Wieckowski  Senate Third Reading  By BONTA",49,20,0,11,80
735509,475941,2015-09-08,Senate,"Unfinished Business SB383 Wieckowski Concurrence",27,13,0,0,40
735512,428263,2015-04-07,Assembly,"Do pass, to Consent Calendar",10,0,0,0,10
735512,430853,2015-04-13,Assembly,"AB 593 LEVINE  Consent Calendar Second Day  Regular Session",79,0,0,1,80
735512,458296,2015-06-09,Senate,"Do pass",7,0,0,0,7
735512,461929,2015-06-22,Senate,"Special Consent #3 AB593 Levine",37,0,3,0,40
735513,443385,2015-05-05,Assembly,"Do pass, to Consent Calendar",14,0,0,0,14
735513,445269,2015-05-11,Assembly,"AB 632 EGGMAN  Consent Calendar Second Day  Regular Session",79,0,0,1,80
735513,459804,2015-06-15,Senate,"Do pass, but re-refer to the Committee on Appropriations Recommend 	Consent",9,0,0,0,9
735513,464923,2015-07-02,Senate,"Consent Calendar 2nd AB632 Eggman",38,0,2,0,40
735513,465201,2015-07-06,Assembly,"AB 632 EGGMAN  Concurrence in Senate Amendments",80,0,0,0,80
735514,440272,2015-04-28,Senate,"Do pass, but re-refer to the Committee on Appropriations",7,0,0,0,7
735514,447724,2015-05-18,Senate,"Senate 3rd Reading SB352 Block",36,0,3,0,39
735514,460211,2015-06-16,Assembly,"Amend, and do pass as amended and be re-referred to the Committee 	on Appropriations with the recommendation:  To Consent Calendar",7,0,0,0,7
735514,465675,2015-07-08,Assembly,"Do pass, to Consent Calendar",14,0,0,3,17
735514,466571,2015-07-16,Assembly,"SB 352 Block  Consent Calendar Second Day  Regular Session",79,0,0,1,80
735514,473995,2015-08-20,Senate,"Special Consent #6 SB352 Block",38,0,2,0,40
735516,440186,2015-04-28,Senate,"Do pass as amended, and re-refer to the Committee on Appropriations",8,0,1,0,9
735516,454158,2015-05-28,Senate,"Do pass as amended",5,0,2,0,7
735516,457282,2015-06-04,Senate,"Senate 3rd Reading SB345 Berryhill",39,0,1,0,40
735516,463611,2015-05-18,Senate,"Placed on Appropriations Suspense file",7,0,0,0,7
735516,556172,2016-06-28,Assembly,"Do pass and be re-referred to the Committee on Appropriations to 	Consent Calendar",15,0,0,0,15
735517,427770,2015-04-07,Senate,"Do pass, but re-refer to the Committee on Appropriations",3,1,1,0,5
735517,445280,2015-05-11,Senate,"Placed on Appropriations Suspense file",7,0,0,0,7
735517,454125,2015-05-28,Senate,"Do pass",5,2,0,0,7
735517,455252,2015-06-01,Senate,"Senate 3rd Reading SB365 Pavley",26,12,2,0,40
735517,464856,2015-07-01,Assembly,"Do pass and be re-referred to the Committee on Appropriations",5,1,0,1,7
735517,465660,2015-07-08,Assembly,"Do pass",10,4,0,3,17
735517,476223,2015-09-09,Assembly,"SB 365 Pavley  Senate Third Reading  By MULLIN",56,23,0,1,80
735519,432683,2015-04-15,Assembly,"Do pass and be re-referred to the Committee on Judiciary",7,0,0,0,7
735519,440168,2015-04-28,Assembly,"Do pass as amended and be re-referred to the Committee on 	Appropriations",10,0,0,0,10
735519,453693,2015-05-28,Assembly,"Do pass",17,0,0,0,17
735519,455251,2015-06-01,Assembly,"AB 587 CHAU  Assembly Third Reading",78,0,0,2,80
735519,552880,2016-06-14,Senate,"Do pass, but re-refer to the Committee on Judiciary",10,0,1,0,11
735519,556389,2016-06-28,Senate,"Do pass, but re-refer to the Committee on Appropriations",6,1,0,0,7
735519,558725,2016-08-01,Senate,"Placed on Appropriations Suspense file",7,0,0,0,7
735519,559786,2016-08-11,Senate,"Do pass as amended",7,0,0,0,7
735519,560571,2016-08-22,Senate,"Assembly 3rd Reading AB587 Chau By Leyva",35,3,1,0,39
735519,561254,2016-08-25,Assembly,"AB 587 CHAU  Concurrence in Senate Amendments",78,0,0,2,80
735522,438252,2015-04-14,Assembly,"Do pass as amended and be re-referred to the Committee on 	Appropriations",16,0,0,3,19
735522,441191,2015-04-29,Assembly,"Do pass, to Consent Calendar",17,0,0,0,17
735522,444408,2015-05-07,Assembly,"AB 614 BROWN  Consent Calendar Second Day  Regular Session",77,0,0,3,80
735522,463082,2015-06-24,Senate,"Do pass, but re-refer to the Committee on Appropriations",8,0,1,0,9
735522,473640,2015-08-17,Senate,"Assembly 3rd Reading AB614 Brown By Hancock",37,0,3,0,40
735522,475828,2015-09-03,Assembly,"AB 614 BROWN  Concurrence in Senate Amendments",79,0,0,1,80
735525,441843,2015-04-29,Assembly,"Do pass",12,5,0,0,17
735525,456400,2015-06-02,Assembly,"AB 666 STONE  Assembly Third Reading",42,33,0,5,80
735525,465463,2015-07-07,Senate,"Do pass as amended, and re-refer to the Committee on Appropriations",5,1,1,0,7
735525,466186,2015-04-14,Assembly,"Do pass and be re-referred to the Committee on Appropriations",5,2,0,0,7
735525,473799,2015-08-17,Senate,"Placed on Appropriations Suspense file",7,0,0,0,7
735525,474570,2015-08-27,Senate,"Do pass as amended",5,2,0,0,7
735525,476288,2015-09-10,Senate,"Assembly 3rd Reading AB666 Mark Stone By Leno",24,16,0,0,40
735525,476631,2015-09-11,Assembly,"AB 666 STONE  Concurrence in Senate Amendments",42,34,0,4,80
735526,429400,2015-04-08,Assembly,"Do pass as amended and be re-referred to the Committee on 	Appropriations",5,2,0,0,7
735526,454428,2015-05-28,Assembly,"Do pass",12,5,0,0,17
735526,455890,2015-06-02,Assembly,"AB 561 CAMPOS  Assembly Third Reading",42,30,0,8,80
735526,465940,2015-07-13,Senate,"Do pass, but re-refer to the Committee on Appropriations",4,1,0,0,5
735526,473631,2015-08-17,Senate,"Placed on Appropriations Suspense file",7,0,0,0,7
735526,474508,2015-08-27,Senate,"Do pass as amended",5,2,0,0,7
735526,475727,2015-09-03,Senate,"Assembly 3rd Reading AB561 Campos By Mendoza",21,15,4,0,40
735526,475983,2015-09-08,Assembly,"AB 561 CAMPOS  Concurrence in Senate Amendments",43,30,0,7,80
735527,440965,2015-04-29,Assembly,"Do pass and be re-referred to the Committee on Appropriations to 	Consent Calendar",9,0,0,1,10
735527,446165,2015-05-13,Assembly,"Do pass, to Consent Calendar",17,0,0,0,17
735527,450286,2015-05-22,Assembly,"AB 629 PEREA  Consent Calendar Second Day  Regular Session",74,0,0,6,80
735527,556727,2016-06-30,Senate,"Assembly 3rd Reading AB629 Gonzalez By Block Urgency Claus",38,0,2,0,40
735527,559137,2016-08-04,Assembly,"AB 629 GONZALEZ  Concurrence- Urgency Added",77,0,0,3,80
735529,432667,2015-04-15,Senate,"Do pass, but re-refer to the Committee on Environmental Quality",5,2,0,0,7
735529,441859,2015-04-29,Senate,"Do pass as amended, and re-refer to the Committee on Appropriations",5,0,2,0,7
735529,456634,2015-06-03,Senate,"Senate 3rd Reading SB379 Jackson",23,16,1,0,40
735529,473900,2015-07-01,Assembly,"Do pass as amended and be re-referred to the Committee on 	Appropriations",8,0,0,1,9
735529,473901,2015-08-19,Assembly,"Do pass",12,5,0,0,17
735529,475309,2015-08-31,Assembly,"SB 379 Jackson  Senate Third Reading  By GORDON",55,25,0,0,80
735529,475486,2015-09-01,Senate,"Unfinished Business SB379 Jackson Concurrence",25,15,0,0,40
735530,440479,2015-04-28,Senate,"Do pass as amended, and re-refer to the Committee on Appropriations",7,0,0,0,7
735530,463603,2015-05-18,Senate,"Placed on Appropriations Suspense file",7,0,0,0,7
735532,427765,2015-04-07,Senate,"Do pass and be placed on the Consent Calendar",4,0,1,0,5
735532,433858,2015-04-16,Senate,"Consent Calendar 2nd SB366 Nguyen",37,0,2,0,39
735532,464803,2015-07-01,Assembly,"Do pass, to Consent Calendar",6,0,0,1,7
735532,465799,2015-07-09,Assembly,"SB 366 Nguyen  Consent Calendar Second Day  Regular Session",79,0,0,1,80
735533,435357,2015-04-20,Assembly,"Do pass and be re-referred to the Committee on Appropriations",11,1,0,0,12
735533,454265,2015-05-28,Assembly,"Do pass",17,0,0,0,17
735533,455989,2015-06-02,Assembly,"AB 667 WAGNER  Assembly Third Reading",76,0,0,4,80
735533,464742,2015-07-01,Senate,"Do pass as amended, and re-refer to the Committee on Appropriations",7,0,0,0,7
735533,473635,2015-08-17,Senate,"Placed on Appropriations Suspense file",7,0,0,0,7
735533,474675,2015-08-27,Senate,"Do pass",7,0,0,0,7
735533,475978,2015-09-08,Senate,"Assembly 3rd Reading AB667 Wagner By Berryhill",39,0,1,0,40
735533,476139,2015-09-09,Assembly,"AB 667 WAGNER  Concurrence in Senate Amendments",78,0,0,2,80
735535,441614,2015-04-29,Assembly,"Be adopted and be re-referred to the Committee on Appropriations",4,2,0,1,7
735535,453764,2015-05-28,Assembly,"Be adopted",12,5,0,0,17
735536,429397,2015-04-08,Assembly,"Do pass as amended and be re-referred to the Committee on 	Appropriations",5,2,0,0,7
735536,454264,2015-05-28,Assembly,"Do pass",12,5,0,0,17
735536,456129,2015-06-02,Assembly,"AB 578 LOW  Assembly Third Reading",52,27,0,1,80
735536,462604,2015-06-24,Senate,"Do pass, but re-refer to the Committee on Appropriations",4,1,0,0,5
735536,465185,2015-07-06,Senate,"Placed on Appropriations Suspense file",7,0,0,0,7
735536,474723,2015-08-27,Senate,"Do pass",5,2,0,0,7
735536,475973,2015-09-08,Senate,"Assembly 3rd Reading AB578 Low By Leno",23,16,1,0,40
737330,437105,2015-04-22,Assembly,"Do pass and be re-referred to the Committee on Appropriations",6,3,0,0,9
737330,444246,2015-05-06,Assembly,"Do pass",12,5,0,0,17
737330,447690,2015-05-18,Assembly,"AB 746 TING  Assembly Third Reading",51,24,0,5,80
737330,460642,2015-06-17,Senate,"Do pass as amended, and re-refer to the Committee on Appropriations",5,2,0,0,7
737330,473621,2015-08-17,Senate,"Assembly 3rd Reading AB746 Ting By Hancock",26,11,3,0,40
737330,473975,2015-08-20,Assembly,"AB 746 TING  Concurrence in Senate Amendments",49,28,0,3,80
737331,436029,2015-04-20,Assembly,"Do pass and be re-referred to the Committee on Natural Resources",15,0,0,1,16
737331,440230,2015-04-27,Assembly,"Do pass and be re-referred to the Committee on Appropriations",9,0,0,0,9
737331,454049,2015-05-28,Assembly,"Do pass as amended",12,0,0,5,17
737331,456569,2015-06-03,Assembly,"AB 779 GARCIA, C.  Assembly Third Reading",77,1,0,2,80
737331,556558,2016-06-29,Senate,"Do pass as amended, and re-refer to the Committee on Appropriations",7,0,0,0,7
737331,559858,2016-08-15,Senate,"Assembly 3rd Reading AB779 Cristina Garcia By Hertzberg",30,8,1,0,39
737331,561275,2016-08-25,Assembly,"Senate amendments be concurred in",8,0,0,1,9
737331,561632,2016-08-30,Assembly,"AB 779 GARCIA, C.  Concurrence in Senate Amendments",79,0,0,1,80
737333,437771,2015-04-22,Assembly,"Do pass and be re-referred to the Committee on Appropriations",20,0,0,1,21
737333,441090,2015-04-29,Assembly,"Do pass, to Consent Calendar",17,0,0,0,17
737333,444477,2015-05-07,Assembly,"AB 780 WILLIAMS  Consent Calendar Second Day  Regular Session",77,0,0,3,80
737333,464054,2015-06-29,Senate,"Do pass, but re-refer to the Committee on Appropriations Recommend 	Consent",12,0,1,0,13
737333,473957,2015-08-20,Senate,"Consent Calendar 2nd AB780 Williams",38,0,2,0,40
737333,474357,2015-08-27,Assembly,"AB 780 WILLIAMS  Concurrence in Senate Amendments",78,0,0,2,80
737343,441084,2015-04-29,Assembly,"Do pass and be re-referred to the Committee on Appropriations",5,1,0,1,7
737343,449077,2015-05-20,Assembly,"Do pass",15,0,0,2,17
737343,450150,2015-05-22,Assembly,"AB 682 WILLIAMS  Assembly Third Reading",75,0,0,5,80
737343,462325,2015-06-23,Senate,"Do pass, but re-refer to the Committee on Energy, Utilities and 	Communications",10,0,1,0,11
737343,465857,2015-07-13,Senate,"Do pass",7,0,0,0,7
737343,475329,2015-08-31,Senate,"Special Consent #8 AB682 Williams By Leyva",40,0,0,0,40
737343,475511,2015-09-01,Assembly,"AB 682 WILLIAMS  Concurrence- Urgency Added",80,0,0,0,80
737345,439359,2015-04-27,Assembly,"Do pass and be re-referred to the Committee on Appropriations",20,0,0,1,21
737345,448939,2015-05-20,Assembly,"Do pass, to Consent Calendar",15,0,0,2,17
737345,452013,2015-05-26,Assembly,"AB 776 COOPER  Consent Calendar Second Day  Regular Session",76,0,0,4,80
737345,466177,2015-07-14,Senate,"Do pass, but re-refer to the Committee on Appropriations",13,0,0,0,13
737345,476274,2015-09-10,Senate,"Assembly 3rd Reading AB776 Cooper By Hall",39,1,0,0,40
737345,476553,2015-09-11,Assembly,"Senate amendments be concurred in",19,0,0,2,21
737345,476554,2015-09-11,Assembly,"AB 776 COOPER  Concurrence in Senate Amendments",76,0,0,4,80
737347,446506,2015-05-12,Senate,"Do pass",1,2,4,0,7
737349,437079,2015-04-21,Assembly,"Do pass as amended and be re-referred to the Committee on 	Appropriations",13,0,0,0,13
737349,454004,2015-05-28,Assembly,"Do pass",17,0,0,0,17
737349,455259,2015-06-01,Assembly,"AB 770 IRWIN  Assembly Third Reading",78,0,0,2,80
737349,466290,2015-07-15,Senate,"Do pass as amended, and re-refer to the Committee on Appropriations",9,0,0,0,9
737349,474114,2015-08-24,Senate,"Placed on Appropriations Suspense file",7,0,0,0,7
737350,432515,2015-04-14,Assembly,"Do pass and be re-referred to the Committee on Appropriations",5,2,0,0,7
737350,453719,2015-05-28,Assembly,"Do pass as amended",12,5,0,0,17
737350,456600,2015-06-03,Assembly,"AB 743 EGGMAN  Assembly Third Reading",53,25,0,2,80
737350,466030,2015-07-14,Senate,"Do pass as amended, and re-refer to the Committee on Appropriations",3,0,2,0,5
737350,473789,2015-08-17,Senate,"Placed on Appropriations Suspense file",7,0,0,0,7
737351,431655,2015-04-13,Assembly,"Do pass as amended and be re-referred to the Committee on 	Transportation",9,0,0,0,9
737351,440130,2015-04-27,Assembly,"Do pass and be re-referred to the Committee on Appropriations",16,0,0,0,16
737351,453968,2015-05-28,Assembly,"Do pass as amended",17,0,0,0,17
737351,456031,2015-06-02,Assembly,"AB 678 O'DONNELL  Assembly Third Reading",77,0,0,3,80
737351,464393,2015-06-30,Senate,"Do pass as amended, and re-refer to the Committee on Environmental 	Quality",8,0,3,0,11
737351,466228,2015-07-15,Senate,"Do pass as amended, and re-refer to the Committee on Appropriations",7,0,0,0,7
737351,474124,2015-08-24,Senate,"Placed on Appropriations Suspense file",7,0,0,0,7
737353,428374,2015-04-07,Assembly,"Do pass and be re-referred to the Committee on Appropriations",12,0,0,1,13
737353,437095,2015-04-22,Assembly,"Do pass as amended, to Consent Calendar",17,0,0,0,17
737353,442217,2015-04-30,Assembly,"AB 767 SANTIAGO  Consent Calendar Second Day  Regular Session",77,0,0,3,80
737353,458631,2015-06-10,Senate,"Do pass, but re-refer to the Committee on Appropriations Recommend 	Consent",8,0,0,1,9
737353,462992,2015-06-25,Senate,"Consent Calendar 2nd AB767 Santiago",37,0,3,0,40
737354,427939,2015-04-07,Senate,"Do pass",7,0,0,0,7
737354,430797,2015-04-13,Senate,"Senate 3rd Reading SB411 Lara",31,3,5,0,39
737354,464538,2015-06-30,Assembly,"Do pass",6,0,0,1,7
737354,465760,2015-07-09,Assembly,"SB 411 Lara  Senate Third Reading  By GARCIA, C",74,2,0,4,80
737355,429245,2015-04-08,Assembly,"Do pass and be re-referred to the Committee on Appropriations",6,1,0,0,7
737355,453717,2015-05-28,Assembly,"Do pass as amended",12,4,0,1,17
737355,456636,2015-06-03,Assembly,"AB 713 WEBER  Assembly Third Reading",58,21,0,1,80
737355,465637,2015-07-08,Senate,"Do pass, but re-refer to the Committee on Appropriations",7,2,0,0,9
737355,473778,2015-08-17,Senate,"Placed on Appropriations Suspense file",7,0,0,0,7
737357,440165,2015-04-28,Senate,"Do pass, but re-refer to the Committee on Appropriations",11,0,0,0,11
737357,454412,2015-05-28,Senate,"Senate 3rd Reading SB413 Wieckowski",40,0,0,0,40
737357,463884,2015-06-29,Assembly,"Do pass as amended and be re-referred to the Committee on Public 	Safety",16,0,0,0,16
737357,465985,2015-07-14,Assembly,"Do pass and be re-referred to the Committee on Appropriations",7,0,0,0,7
737357,473940,2015-08-19,Assembly,"Do pass, to Consent Calendar",17,0,0,0,17
737357,475993,2015-09-08,Assembly,"SB 413 Wieckowski  Senate Third Reading  By CHIU",78,0,0,2,80
737357,476316,2015-09-10,Senate,"Unfinished Business SB413 Wieckowski Concurrence",40,0,0,0,40
737359,437436,2015-04-22,Senate,"Do pass and be placed on the Consent Calendar",7,0,0,0,7
737359,442332,2015-04-30,Senate,"Consent Calendar 2nd SB422 Monning",34,0,5,0,39
737359,460820,2015-06-17,Assembly,"Do pass as amended",9,0,0,0,9
737359,463976,2015-06-29,Assembly,"SB 422 Monning  Senate Third Reading",72,0,0,8,80
737359,465204,2015-07-06,Senate,"Special Consent #4 SB422 Monning",39,0,1,0,40
737360,446282,2015-05-13,Assembly,"Do pass as amended",6,1,0,2,9
737360,453126,2015-05-27,Assembly,"Do pass",16,0,0,1,17
737360,455402,2015-06-01,Assembly,"AB 679 ALLEN  Assembly Third Reading",52,14,0,14,80
737360,465644,2015-07-08,Senate,"Do pass, but re-refer to the Committee on Appropriations",7,0,0,0,7
737360,476572,2015-09-11,Senate,"From Committee:  That the measure be returned to the Senate floor 	for consideration",8,0,1,0,9
737360,476573,2015-09-11,Senate,"Assembly 3rd Reading ( Supplemental File 1)AB 679 Tr avis Allen By",40,0,0,0,40
737360,476574,2015-09-11,Assembly,"AB 679 ALLEN  Concurrence- Urgency Added",78,0,0,2,80
737361,440097,2015-04-28,Senate,"Do pass, but re-refer to the Committee on Appropriations",7,0,0,0,7
737361,453877,2015-05-28,Senate,"Do pass as amended",5,1,1,0,7
737361,455948,2015-06-02,Senate,"Senate 3rd Reading SB405 Hertzberg",39,1,0,0,40
737361,463615,2015-05-18,Senate,"Placed on Appropriations Suspense file",7,0,0,0,7
737361,464397,2015-06-30,Assembly,"Do pass and be re-referred to the Committee on Transportation",6,0,0,1,7
737361,465864,2015-07-13,Assembly,"Do pass and be re-referred to the Committee on Appropriations",16,0,0,0,16
737361,476090,2015-09-09,Assembly,"SB 405 Hertzberg  Third Reading Urgency  By ATKINS",78,0,0,2,80
737361,476272,2015-09-10,Senate,"From committee:  That the Assembly Amendments be concurred in",7,0,0,0,7
737361,476547,2015-09-11,Senate,"Unfinished Business SB405 Hertzberg Urgency Clause",40,0,0,0,40
737362,437216,2015-04-22,Senate,"Do pass, but re-refer to the Committee on Appropriations",8,0,1,0,9
737362,443089,2015-05-04,Senate,"Placed on Appropriations Suspense file",7,0,0,0,7
737362,453933,2015-05-28,Senate,"Do pass",7,0,0,0,7
737362,455434,2015-06-01,Senate,"Senate 3rd Reading SB388 Mitchell",40,0,0,0,40
737362,464882,2015-06-30,Assembly,"Do pass as amended and be re-referred to the Committee on 	Appropriations",18,0,0,1,19
737362,474326,2015-08-27,Assembly,"Do pass",17,0,0,0,17
737362,475791,2015-09-03,Assembly,"SB 388 Mitchell  Senate Third Reading  By KIM",79,0,0,1,80
737362,475862,2015-09-04,Senate,"Unfinished Business SB388 Mitchell Concurrence",40,0,0,0,40
737364,466300,2015-07-14,Senate,"Do pass as amended, and re-refer to the Committee on Appropriations",7,0,0,0,7
737364,474136,2015-08-24,Senate,"Placed on Appropriations Suspense file",7,0,0,0,7
737364,474671,2015-08-27,Senate,"Do pass",7,0,0,0,7
737364,475475,2015-09-01,Senate,"Senate 3rd Reading SB448 Hueso Urgency Clause",39,0,1,0,40
737364,554636,2016-06-21,Assembly,"Do pass as amended",7,0,0,0,7
737364,558628,2016-08-01,Assembly,"SB 448 Hueso  Senate Third Reading  Amend By JONES-SAWYER  Set #1",74,0,0,6,80
737364,559262,2016-08-11,Assembly,"Do pass as amended",20,0,0,0,20
737364,560632,2016-08-23,Assembly,"SB 448 Hueso  Senate Third Reading  By JONES-SAWYER",79,0,0,1,80
737364,560950,2016-08-24,Senate,"Unfinished Business SB448 Hueso Concurrence",39,0,0,0,39
737365,428460,2015-04-08,Senate,"Do pass, but re-refer to the Committee on Appropriations Recommend 	Consent",8,0,0,0,8
737365,438171,2015-04-23,Senate,"Consent Calendar 2nd SB436 Committee On ED. (Liu)",37,0,0,2,39
737365,466248,2015-07-15,Assembly,"Do pass and be re-referred to the Committee on Appropriations to 	Consent Calendar",7,0,0,0,7
737365,473867,2015-08-19,Assembly,"Do pass, to Consent Calendar",17,0,0,0,17
737365,474351,2015-08-27,Assembly,"SB 436 ED.  Consent Calendar Second Day  Regular Session",78,0,0,2,80
737365,475520,2015-09-01,Senate,"Special Consent #9 SB436 Committee On ED. (Liu)",40,0,0,0,40
737367,428788,2015-04-08,Senate,"Do pass as amended",7,0,1,0,8
737367,439436,2015-04-27,Senate,"Senate 3rd Reading SB426 Leyva",36,0,3,0,39
737367,462663,2015-06-24,Assembly,"Do pass, to Consent Calendar",13,0,0,0,13
737367,464929,2015-07-02,Assembly,"SB 426 Leyva  Consent Calendar Second Day  Regular Session",78,0,0,2,80
737367,465174,2015-07-06,Senate,"Unfinished Business SB426 Leyva Concurrence",37,0,3,0,40
737368,447700,2015-05-13,Assembly,"Do pass as amended",7,0,0,0,7
737368,450083,2015-05-22,Assembly,"AB 715 DALY  Assembly Third Reading",72,3,0,5,80
737368,460658,2015-06-17,Senate,"Do pass as amended",8,0,1,0,9
737368,462944,2015-06-25,Senate,"Assembly 3rd Reading AB715 Daly By Liu",38,0,2,0,40
737368,463836,2015-06-29,Assembly,"AB 715 DALY  Concurrence in Senate Amendments",74,2,0,4,80
737369,434371,2015-04-15,Senate,"Do pass, but re-refer to the Committee on Appropriations",9,0,0,0,9
737369,445246,2015-05-11,Senate,"Placed on Appropriations Suspense file",7,0,0,0,7
737369,453709,2015-05-28,Senate,"Do pass as amended",5,1,1,0,7
737369,455940,2015-06-02,Senate,"Senate 3rd Reading SB447 Allen",27,4,9,0,40
737369,465470,2015-07-07,Assembly,"Do pass and be re-referred to the Committee on Appropriations",18,0,0,1,19
737371,440217,2015-04-27,Assembly,"Do pass and be re-referred to the Committee on Local Government",12,1,0,3,16
737371,446273,2015-05-13,Assembly,"Do pass as amended",7,1,0,1,9
737371,455360,2015-06-01,Assembly,"AB 718 CHU  Assembly Third Reading",56,15,0,9,80
737371,465674,2015-07-08,Senate,"Do pass as amended",4,1,2,0,7
737371,475317,2015-08-31,Senate,"Assembly 3rd Reading AB718 Chu By Hueso",18,14,8,0,40
737371,475318,2015-08-31,Senate,"Assembly 3rd Reading AB718 Chu By Hueso",40,0,0,0,40
737372,435153,2015-04-20,Senate,"Do pass, but re-refer to the Committee on Health",9,0,0,0,9
737372,442118,2015-04-29,Senate,"Do pass as amended, and re-refer to the Committee on Appropriations",9,0,0,0,9
737372,453746,2015-05-28,Senate,"Do pass",7,0,0,0,7
737372,455320,2015-06-01,Senate,"Senate 3rd Reading SB396 Hill",40,0,0,0,40
737372,463565,2015-05-18,Senate,"Placed on Appropriations Suspense file",7,0,0,0,7
737372,466237,2015-07-15,Assembly,"Do pass, to Consent Calendar",16,0,0,1,17
737372,473952,2015-08-20,Assembly,"SB 396 Hill  Consent Calendar Second Day  Regular Session",79,0,0,1,80
737372,474297,2015-08-27,Senate,"Special Consent #7 SB396 Hill",40,0,0,0,40
737373,437131,2015-04-22,Assembly,"Do pass and be re-referred to the Committee on Appropriations",20,0,0,1,21
737373,441080,2015-04-29,Assembly,"Do pass, to Consent Calendar",17,0,0,0,17
737373,445124,2015-05-11,Assembly,"AB 774 LEVINE  Assembly Third Reading",79,0,0,1,80
737373,458314,2015-06-09,Senate,"Do pass, but re-refer to the Committee on Appropriations",13,0,0,0,13
737373,462974,2015-06-25,Senate,"Assembly 3rd Reading AB774 Levine By Hall",37,0,3,0,40
737373,463883,2015-06-29,Assembly,"AB 774 LEVINE  Concurrence in Senate Amendments",77,0,0,3,80
737376,439993,2015-04-28,Senate,"Do pass as amended, and re-refer to the Committee on Appropriations",6,1,0,0,7
737377,440916,2015-04-29,Senate,"Do pass, but re-refer to the Committee on Appropriations Recommend 	Consent",7,0,2,0,9
737377,463589,2015-05-18,Senate,"Placed on Appropriations Suspense file",7,0,0,0,7
737379,431613,2015-04-13,Assembly,"Do pass and be re-referred to the Committee on Appropriations",6,3,0,0,9
737380,440207,2015-04-27,Senate,"Do pass, but re-refer to the Committee on Appropriations",9,0,0,0,9
737380,445227,2015-05-11,Senate,"Placed on Appropriations Suspense file",7,0,0,0,7
737380,453829,2015-05-28,Senate,"Do pass",7,0,0,0,7
737380,455415,2015-06-01,Senate,"Senate 3rd Reading SB467 Hill",40,0,0,0,40
737380,465489,2015-07-07,Assembly,"Do pass and be re-referred to the Committee on Appropriations",13,1,0,0,14
737380,474440,2015-08-27,Assembly,"Do pass as amended",12,0,0,5,17
737380,476026,2015-09-08,Assembly,"SB 467 Hill  Senate Third Reading  By BONILLA",76,0,0,4,80
737380,476350,2015-09-10,Senate,"Unfinished Business SB467 Hill Concurrence",40,0,0,0,40
737381,432528,2015-04-14,Senate,"Do pass as amended. To Consent Calendar",6,0,1,0,7
737381,439507,2015-04-27,Senate,"Consent Calendar 2nd SB470 Jackson",35,0,4,0,39
737381,460542,2015-06-16,Assembly,"Do pass, to Consent Calendar",10,0,0,0,10
737381,465921,2015-07-13,Assembly,"SB 470 Jackson  Senate Third Reading",78,0,0,2,80
737381,466569,2015-07-16,Senate,"Unfinished Business SB470 Jackson Concurrence",37,0,3,0,40
737383,441324,2015-04-28,Assembly,"Do pass",19,0,0,0,19
737383,444455,2015-05-07,Assembly,"AB 724 DODD  Assembly Third Reading",76,0,0,4,80
737383,553563,2016-06-15,Senate,"Do pass, but re-refer to the Committee on Appropriations",7,0,0,0,7
737383,558657,2016-08-01,Senate,"Assembly 3rd Reading AB724 Dodd By Nielsen",39,0,0,0,39
737383,560863,2016-08-23,Assembly,"Senate amendments be concurred in",9,0,0,0,9
737383,561034,2016-08-24,Assembly,"AB 724 DODD  Concurrence in Senate Amendments",79,0,0,1,80
737384,440108,2015-04-28,Senate,"Do pass, but re-refer to the Committee on Appropriations",7,0,0,0,7
737384,445149,2015-05-11,Senate,"Placed on Appropriations Suspense file",7,0,0,0,7
737384,453905,2015-05-28,Senate,"Do pass",7,0,0,0,7
737384,455930,2015-06-02,Senate,"Senate 3rd Reading SB424 Pan",35,0,5,0,40
737384,464284,2015-06-30,Assembly,"Do pass and be re-referred to the Committee on Privacy and Consumer 	Protection to Consent Calendar",7,0,0,0,7
737384,466542,2015-07-16,Assembly,"SB 424 Pan  Consent Calendar Second Day  Regular Session",79,0,0,1,80
737384,474173,2015-07-07,Assembly,"Do pass, to Consent Calendar",11,0,0,0,11
737385,440960,2015-04-29,Assembly,"Do pass and be re-referred to the Committee on Appropriations",4,2,0,1,7
737385,448961,2015-05-20,Assembly,"Amend, and re-refer to the Committee on Appropriations",11,0,0,6,17
737385,486298,2016-01-21,Assembly,"Do pass",12,0,0,5,17
737385,488362,2016-01-27,Assembly,"AB 700 GOMEZ  Assembly Third Reading",60,15,0,4,79
737385,554649,2016-06-21,Senate,"Do pass as amended, and re-refer to the Committee on Appropriations",4,1,0,0,5
737385,558807,2016-08-01,Senate,"Placed on Appropriations Suspense file",7,0,0,0,7
737385,559529,2016-08-11,Senate,"Do pass as amended",5,2,0,0,7
737385,561544,2016-08-30,Senate,"Assembly 3rd Reading AB700 Gomez By Allen",26,12,1,0,39
737385,561545,2016-08-30,Senate,"Assembly 3rd Reading AB700 Gomez By Allen",27,8,4,0,39
737385,561749,2016-08-31,Senate,"Assembly 3rd Reading AB700 Gomez By Allen",26,11,2,0,39
737387,432739,2015-04-14,Assembly,"Do pass as amended and be re-referred to the Committee on 	Appropriations",14,0,0,0,14
737389,427983,2015-04-07,Assembly,"Do pass as amended and be re-referred to the Committee on Insurance",14,0,0,0,14
737389,437300,2015-04-22,Assembly,"Do pass and be re-referred to the Committee on Appropriations to 	Consent Calendar",12,0,0,1,13
737389,443880,2015-05-06,Assembly,"Do pass, to Consent Calendar",17,0,0,0,17
737389,446691,2015-05-14,Assembly,"AB 764 QUIRK  Consent Calendar Second Day  Regular Session",78,0,0,2,80
737389,460167,2015-06-16,Senate,"Do pass, but re-refer to the Committee on Insurance",10,0,1,0,11
737389,465573,2015-07-08,Senate,"Do pass, but re-refer to the Committee on Appropriations Recommend 	Consent",8,0,1,0,9
737389,476003,2015-09-08,Senate,"Assembly 3rd Reading AB764 Quirk By Mendoza",40,0,0,0,40
737389,476071,2015-09-09,Assembly,"AB 764 QUIRK  Concurrence in Senate Amendments",78,0,0,2,80
737390,432975,2015-04-15,Assembly,"Do pass and be re-referred to the Committee on Appropriations",9,0,0,0,9
737390,453997,2015-05-28,Assembly,"Do pass",17,0,0,0,17
737390,455486,2015-06-01,Assembly,"AB 706 BONILLA  Assembly Third Reading",80,0,0,0,80
737390,473751,2015-08-17,Senate,"Placed on Appropriations Suspense file",7,0,0,0,7
737390,474623,2015-08-27,Senate,"Do pass as amended",6,0,1,0,7
737390,475817,2015-09-03,Senate,"Assembly 3rd Reading AB706 Bonilla By Gaines",40,0,0,0,40
737390,475883,2015-09-04,Assembly,"AB 706 BONILLA  Concurrence in Senate Amendments",80,0,0,0,80
737391,446234,2015-05-12,Senate,"Do pass as amended. To Consent Calendar",7,0,0,0,7
737391,450267,2015-05-22,Senate,"Consent Calendar 2nd SB419 McGuire",38,0,1,0,39
737391,466210,2015-07-15,Assembly,"Do pass",7,0,0,0,7
737391,473986,2015-08-20,Assembly,"SB 419 McGuire  Senate Third Reading  By CHAU",79,0,0,1,80
737391,474282,2015-08-27,Senate,"Special Consent #7 SB419 McGuire",40,0,0,0,40
737393,432633,2015-04-15,Assembly,"Do pass and be re-referred to the Committee on Appropriations",9,0,0,0,9
737393,440907,2015-04-29,Assembly,"Do pass, to Consent Calendar",17,0,0,0,17
737393,444454,2015-05-07,Assembly,"AB 728 HADLEY  Consent Calendar Second Day  Regular Session",77,0,0,3,80
737393,458360,2015-06-09,Senate,"Do pass, but re-refer to the Committee on Appropriations Recommend 	Consent",13,0,0,0,13
737393,465814,2015-07-09,Senate,"Consent Calendar 2nd AB728 Hadley",39,0,1,0,40
737393,465914,2015-07-13,Assembly,"AB 728 HADLEY  Concurrence in Senate Amendments",79,0,0,1,80
737393,475503,2015-09-01,Senate,"Assembly 3rd Reading AB728 Hadley By Morrell",40,0,0,0,40
737393,475675,2015-09-02,Assembly,"AB 728 HADLEY  Concurrence in Senate Amendments",80,0,0,0,80
737394,432602,2015-04-15,Assembly,"Do pass and be re-referred to the Committee on Local Government",6,1,0,0,7
737394,440895,2015-04-29,Assembly,"Do pass and be re-referred to the Committee on Appropriations",7,2,0,0,9
737394,452886,2015-05-27,Assembly,"Do pass",12,4,0,1,17
737394,457247,2015-06-04,Assembly,"AB 744 CHAU  Assembly Third Reading",52,24,0,4,80
737394,465435,2015-07-07,Senate,"Do pass, but re-refer to the Committee on Governance and Finance",7,4,0,0,11
737394,466195,2015-07-15,Senate,"Do pass, but re-refer to the Committee on Appropriations",4,2,1,0,7
737394,475290,2015-08-31,Senate,"Assembly 3rd Reading AB744 Chau By Wieckowski",22,15,3,0,40
737394,475582,2015-09-02,Assembly,"AB 744 CHAU  Concurrence in Senate Amendments",54,25,0,1,80
737395,441056,2015-04-28,Assembly,"From committee:  Be adopted.  To third reading",9,0,0,0,9
737395,450218,2015-05-22,Assembly,"AJR7 MATHIS  Assembly Third Reading",75,0,0,5,80
737395,462183,2015-06-23,Senate,"Be adopted",5,0,0,0,5
737395,465139,2015-07-06,Senate,"Special Consent #4 AJR7 Mathis",39,0,1,0,40
737397,436256,2015-04-21,Senate,"Do pass as amended",4,1,0,0,5
737397,444467,2015-05-07,Senate,"Senate 3rd Reading SB415 Hueso",24,13,2,0,39
737397,464753,2015-07-01,Assembly,"Do pass",4,1,0,2,7
737397,466583,2015-07-16,Assembly,"SB 415 Hueso  Senate Third Reading  By ALEJO",45,30,0,5,80
737397,473835,2015-08-17,Senate,"Unfinished Business SB415 Hueso Concurrence",26,12,2,0,40
737401,443754,2015-05-04,Assembly,"Do pass",12,0,0,0,12
737401,447937,2015-05-18,Assembly,"AB 792 CHIU  Assembly Third Reading",77,0,0,3,80
737401,460657,2015-06-17,Senate,"Do pass and be placed on the Consent Calendar",7,0,0,0,7
737401,461922,2015-06-22,Senate,"Consent Calendar 2nd AB792 Chiu",37,0,3,0,40
737405,446404,2015-05-13,Assembly,"Do pass, to Consent Calendar",9,0,0,0,9
737405,450281,2015-05-22,Assembly,"AB 783 DALY  Consent Calendar Second Day  Regular Session",74,0,0,6,80
737405,466417,2015-07-15,Senate,"Do pass as amended, and re-refer to the Committee on Appropriations",5,1,1,0,7
737407,445182,2015-05-11,Senate,"Senate 3rd Reading SB408 Morrell",36,0,3,0,39
737407,446665,2015-04-06,Senate,"Do pass, but re-refer to the Committee on Appropriations",9,0,0,0,9
737407,462114,2015-06-23,Assembly,"Do pass and be re-referred to the Committee on Appropriations",14,0,0,0,14
737407,466221,2015-07-15,Assembly,"Do pass, to Consent Calendar",16,0,0,1,17
737407,473983,2015-08-20,Assembly,"SB 408 Morrell  Consent Calendar Second Day  Regular Session",79,0,0,1,80
737408,432557,2015-04-14,Senate,"Do pass, but re-refer to the Committee on Appropriations",11,0,0,0,11
737408,463596,2015-04-27,Senate,"Placed on Appropriations Suspense file",7,0,0,0,7
737411,442842,2015-05-04,Senate,"Do pass and be placed on the Consent Calendar",8,0,1,0,9
737411,445162,2015-05-11,Senate,"Consent Calendar 2nd SB412 De Le",36,0,3,0,39
737411,552452,2016-06-13,Assembly,"Be referred to Committee on Education",11,0,0,0,11
737411,554669,2016-06-21,Assembly,"Do pass as amended and be re-referred to the Committee on 	Appropriations",13,0,0,0,13
737411,559264,2016-08-11,Assembly,"Do pass as amended",20,0,0,0,20
737411,560362,2016-08-19,Assembly,"SB 412 Glazer  Senate Third Reading  Amendment  Set #1",73,0,0,7,80
737411,560745,2016-08-23,Assembly,"SB 412 Glazer  Senate Third Reading  By GONZALEZ",78,0,0,2,80
737411,561338,2016-08-26,Senate,"From committee:  That the Assembly Amendments be concurred in",9,0,0,0,9
737411,561580,2016-08-30,Senate,"Unfinished Business SB412 Glazer Concurrence",39,0,0,0,39
737412,428913,2015-04-08,Senate,"Do pass as amended, and re-refer to the Committee on Appropriations",7,1,0,0,8
737412,442898,2015-05-04,Senate,"Placed on Appropriations Suspense file",7,0,0,0,7
737413,448405,2015-05-18,Assembly,"Do pass and be re-referred to the Committee on Appropriations",9,0,0,0,9
737415,432544,2015-04-13,Assembly,"Do pass as amended and be re-referred to the Committee on Water, 	Parks and Wildlife",8,1,0,0,9
737415,440310,2015-04-28,Assembly,"Do pass and be re-referred to the Committee on Appropriations",13,2,0,0,15
737415,453697,2015-05-28,Assembly,"Do pass as amended",13,0,0,4,17
737415,457332,2015-06-04,Assembly,"AB 761 LEVINE  Assembly Third Reading",67,11,0,2,80
737415,464272,2015-06-30,Senate,"Do pass, but re-refer to the Committee on Environmental Quality",3,0,2,0,5
737415,466218,2015-07-15,Senate,"Do pass, but re-refer to the Committee on Appropriations",7,0,0,0,7
737415,473727,2015-08-17,Senate,"Placed on Appropriations Suspense file",7,0,0,0,7
737416,432814,2015-04-14,Assembly,"Do pass and be re-referred to the Committee on Appropriations to 	Consent Calendar",7,0,0,0,7
737416,453632,2015-05-28,Assembly,"Do pass",17,0,0,0,17
737416,455304,2015-06-01,Assembly,"AB 702 MAIENSCHEIN  Assembly Third Reading",80,0,0,0,80
737416,462093,2015-06-23,Senate,"Do pass, but re-refer to the Committee on Appropriations",5,0,0,0,5
737416,465151,2015-07-06,Senate,"Placed on Appropriations Suspense file",7,0,0,0,7
737419,438492,2015-04-22,Assembly,"Do pass and be re-referred to the Committee on Appropriations",6,1,0,0,7
737419,454491,2015-05-28,Assembly,"Do pass",17,0,0,0,17
737419,455279,2015-06-01,Assembly,"AB 795 LOW  Assembly Third Reading",79,1,0,0,80
737419,476100,2015-09-09,Senate,"Assembly 3rd Reading AB795 Atkins By Hall",40,0,0,0,40
737419,476245,2015-09-10,Assembly,"AB 795 ATKINS  Concurrence- Urgency Added",80,0,0,0,80
737420,437097,2015-04-21,Senate,"Do pass as amended, and re-refer to the Committee on Appropriations",7,0,0,0,7
737420,447736,2015-05-18,Senate,"Senate 3rd Reading SB453 Pan",36,0,3,0,39
737420,460299,2015-06-16,Assembly,"Amend, and do pass as amended and be re-referred to the Committee 	on Business and Professions with the recommendation:  To Consent 	Calendar",7,0,0,0,7
737420,465522,2015-07-07,Assembly,"Do pass as amended and be re-referred to the Committee on 	Appropriations",14,0,0,0,14
737420,466266,2015-07-15,Assembly,"Do pass, to Consent Calendar",16,0,0,1,17
737420,473943,2015-08-20,Assembly,"SB 453 Pan  Consent Calendar Second Day  Regular Session",79,0,0,1,80
737420,474276,2015-08-27,Senate,"Special Consent #7 SB453 Pan",40,0,0,0,40
737423,437350,2015-04-22,Senate,"Do pass, but re-refer to the Committee on Appropriations",6,0,1,0,7
737423,452316,2015-05-26,Senate,"Senate 3rd Reading SB433 Berryhill",38,0,1,0,39
737424,443432,2015-05-05,Senate,"Do pass and be placed on the Consent Calendar",9,0,2,0,11
737424,445178,2015-05-11,Senate,"Consent Calendar 2nd SB404 De Le",36,0,3,0,39
737424,463999,2015-06-29,Assembly,"Do pass, to Consent Calendar",16,0,0,0,16
737424,559825,2016-08-15,Assembly,"SB 404 De Leon  Third Reading Urgency  By GATTO",78,0,0,2,80
737424,560006,2016-08-16,Senate,"Unfinished Business (S upplemental File 1)SB4 04 De Le",38,0,1,0,39
737425,437309,2015-04-21,Senate,"Do pass, but re-refer to the Committee on Appropriations",5,2,0,0,7
737425,442878,2015-05-04,Senate,"Placed on Appropriations Suspense file",7,0,0,0,7
737425,453653,2015-05-28,Senate,"Do pass as amended",5,1,1,0,7
737425,456632,2015-06-03,Senate,"Senate 3rd Reading SB443 Mitchell",38,1,1,0,40
737425,466103,2015-07-14,Assembly,"Do pass as amended and be re-referred to the Committee on 	Appropriations",7,0,0,0,7
737425,474345,2015-08-27,Assembly,"Do pass as amended",10,2,0,5,17
737425,476266,2015-09-10,Assembly,"SB 443 Mitchell  Senate Third Reading  By HADLEY",24,44,0,12,80
737425,559839,2016-08-15,Assembly,"SB 443 Mitchell  Senate Third Reading  By HADLEY",69,7,0,4,80
737425,560928,2016-08-24,Senate,"Unfinished Business SB443 Mitchell Concurrence",39,0,0,0,39
737428,427841,2015-04-07,Assembly,"Do pass as amended and be re-referred to the Committee on 	Appropriations",14,0,0,0,14
737428,437411,2015-04-22,Assembly,"Do pass, to Consent Calendar",17,0,0,0,17
737428,442270,2015-04-30,Assembly,"AB 685 IRWIN  Consent Calendar Second Day  Regular Session",77,0,0,3,80
737428,555558,2016-06-27,Senate,"Do pass, but re-refer to the Committee on Appropriations Recommend 	Consent",9,0,0,0,9
737428,559319,2016-08-11,Senate,"Consent Calendar 2nd AB685 Irwin",37,0,2,0,39
737428,559798,2016-08-15,Assembly,"AB 685 IRWIN  Concurrence in Senate Amendments",77,0,0,3,80
737429,431578,2015-04-13,Assembly,"Do pass as amended and be re-referred to the Committee on 	Accountability and Administrative Review",6,3,0,0,9
737429,441299,2015-04-29,Assembly,"Do pass and be re-referred to the Committee on Appropriations",6,3,0,0,9
737429,453627,2015-05-28,Assembly,"Do pass as amended",12,5,0,0,17
737429,457330,2015-06-04,Assembly,"AB 692 QUIRK  Assembly Third Reading",52,27,0,1,80
737429,464366,2015-06-30,Senate,"Do pass, but re-refer to the Committee on Environmental Quality",8,2,1,0,11
737429,466420,2015-07-15,Senate,"Do pass, but re-refer to the Committee on Appropriations",5,2,0,0,7
737429,473721,2015-08-17,Senate,"Placed on Appropriations Suspense file",7,0,0,0,7
737429,474603,2015-08-27,Senate,"Do pass as amended",5,2,0,0,7
737429,476093,2015-09-09,Senate,"Assembly 3rd Reading AB692 Quirk By Wieckowski",25,14,1,0,40
737429,476352,2015-09-10,Assembly,"AB 692 QUIRK  Concurrence in Senate Amendments",52,27,0,1,80
737431,433036,2015-04-14,Assembly,"Do pass as amended and be re-referred to the Committee on 	Appropriations",7,3,0,0,10
737432,437250,2015-04-22,Senate,"Do pass, but re-refer to the Committee on Appropriations",9,0,0,0,9
737432,442815,2015-05-04,Senate,"Placed on Appropriations Suspense file",7,0,0,0,7
737432,453849,2015-05-28,Senate,"Do pass as amended",7,0,0,0,7
737432,457245,2015-06-04,Senate,"Senate 3rd Reading SB460 Allen",40,0,0,0,40
737432,464932,2015-07-01,Assembly,"Do pass and be re-referred to the Committee on Appropriations to 	Consent Calendar",6,0,0,1,7
737433,429385,2015-04-08,Assembly,"Do pass as amended and be re-referred to the Committee on 	Appropriations",7,0,0,0,7
737433,454015,2015-05-28,Assembly,"Do pass",13,4,0,0,17
737433,456010,2015-06-02,Assembly,"AB 740 WEBER  Assembly Third Reading",62,17,0,1,80
737433,466239,2015-07-15,Senate,"Do pass as amended, and re-refer to the Committee on Appropriations",8,0,1,0,9
737435,427940,2015-04-07,Assembly,"Do pass, to Consent Calendar",7,0,0,0,7
737435,434038,2015-04-16,Assembly,"AB 673 SANTIAGO  Consent Calendar Second Day  Regular Session",79,0,0,1,80
737435,462330,2015-06-23,Senate,"Do pass as amended",7,0,0,0,7
737435,466554,2015-07-16,Senate,"Special Consent #5 AB673 Santiago",38,0,2,0,40
737435,474027,2015-08-20,Assembly,"AB 673 SANTIAGO  Concurrence in Senate Amendments",78,0,0,2,80
737438,428975,2015-04-08,Assembly,"Do pass and be re-referred to the Committee on Appropriations to 	Consent Calendar",6,0,0,1,7
737438,453987,2015-05-28,Assembly,"Do pass",17,0,0,0,17
737438,455352,2015-06-01,Assembly,"AB 736 COOLEY  Assembly Third Reading",80,0,0,0,80
737438,552584,2016-06-13,Senate,"Do pass, but re-refer to the Committee on Appropriations",5,0,0,0,5
737438,555727,2016-06-27,Senate,"Placed on Appropriations Suspense file",6,0,1,0,7
737438,559710,2016-08-11,Senate,"Do pass",6,1,0,0,7
737438,560995,2016-08-24,Senate,"Assembly 3rd Reading AB736 Cooley By Morrell",39,0,0,0,39
737438,561595,2016-08-30,Assembly,"AB 736 COOLEY  Concurrence in Senate Amendments",80,0,0,0,80
737439,428520,2015-04-07,Assembly,"Do pass and be re-referred to the Committee on Appropriations",12,0,0,1,13
737439,437354,2015-04-22,Assembly,"Do pass",17,0,0,0,17
737439,442161,2015-04-30,Assembly,"AB 716 LOW  Assembly Third Reading",77,0,0,3,80
737439,462690,2015-06-24,Senate,"Do pass, but re-refer to the Committee on Appropriations",8,0,1,0,9
737439,473663,2015-08-17,Senate,"Assembly 3rd Reading AB716 Low By Block",38,0,2,0,40
737440,441742,2015-04-28,Assembly,"Do pass and be re-referred to the Committee on Appropriations",5,2,0,0,7
737442,437065,2015-04-22,Assembly,"Do pass and be re-referred to the Committee on Appropriations",12,0,0,1,13
737442,443953,2015-05-06,Assembly,"Do pass, to Consent Calendar",17,0,0,0,17
737442,450283,2015-05-22,Assembly,"AB 704 COOLEY  Assembly Third Reading",75,0,0,5,80
737442,462623,2015-06-24,Senate,"Do pass, but re-refer to the Committee on Banking and Financial 	Institution",8,0,1,0,9
737442,466360,2015-07-15,Senate,"Do pass, but re-refer to the Committee on Appropriations",7,0,0,0,7
737442,473735,2015-08-17,Senate,"Placed on Appropriations Suspense file",7,0,0,0,7
737442,474613,2015-08-27,Senate,"Do pass",7,0,0,0,7
737442,475521,2015-09-01,Senate,"Assembly 3rd Reading AB704 Cooley By Gaines",40,0,0,0,40
737442,475629,2015-09-02,Assembly,"AB 704 COOLEY  Concurrence in Senate Amendments",80,0,0,0,80
737443,448404,2015-05-18,Assembly,"Do pass as amended and be re-referred to the Committee on 	Appropriations",9,0,0,0,9
737443,486313,2016-01-21,Assembly,"Do pass as amended",17,0,0,0,17
737443,488970,2016-01-28,Assembly,"AB 717 GONZALEZ  Assembly Third Reading",76,0,0,3,79
737443,544832,2016-05-11,Senate,"Do pass, but re-refer to the Committee on Appropriations",7,0,0,0,7
737443,554423,2016-06-20,Senate,"Placed on Appropriations Suspense file",7,0,0,0,7
737443,559555,2016-08-11,Senate,"Do pass",7,0,0,0,7
737443,559950,2016-08-16,Senate,"Assembly 3rd Reading AB717 Gonzalez By Pan",38,0,1,0,39
737444,446323,2015-05-12,Senate,"Do pass, but re-refer to the Committee on Appropriations Recommend 	Consent",7,0,0,0,7
737444,455424,2015-06-01,Senate,"Consent Calendar 2nd SB421 Hancock",40,0,0,0,40
737444,466126,2015-07-14,Assembly,"Do pass and be re-referred to the Committee on Appropriations",10,0,0,0,10
737444,473927,2015-08-19,Assembly,"Do pass, to Consent Calendar",17,0,0,0,17
737444,474445,2015-08-27,Assembly,"SB 421 Hancock  Consent Calendar Second Day  Regular Session",78,0,0,2,80
737444,475439,2015-09-01,Senate,"Special Consent #9 SB421 Hancock",40,0,0,0,40
737446,432629,2015-04-15,Assembly,"Do pass and be re-referred to the Committee on Revenue and Taxation",6,0,0,1,7
737446,440171,2015-04-27,Assembly,"Do pass as amended and be re-referred to the Committee on 	Appropriations",9,0,0,0,9
737446,448952,2015-05-20,Assembly,"Do pass, to Consent Calendar",15,0,0,2,17
737446,455358,2015-06-01,Assembly,"AB 668 GOMEZ  Assembly Third Reading",79,0,0,1,80
737446,462141,2015-06-23,Senate,"Do pass as amended, and re-refer to the Committee on Governance and 	Finance",10,0,1,0,11
737446,465655,2015-07-08,Senate,"Do pass, but re-refer to the Committee on Appropriations",7,0,0,0,7
737446,473668,2015-08-17,Senate,"Placed on Appropriations Suspense file",7,0,0,0,7
737446,474534,2015-08-27,Senate,"Do pass",7,0,0,0,7
737446,475940,2015-09-08,Senate,"Assembly 3rd Reading AB668 Gomez By Leno",40,0,0,0,40
737446,476123,2015-09-09,Assembly,"AB 668 GOMEZ  Concurrence in Senate Amendments",79,0,0,1,80
737447,440150,2015-04-28,Assembly,"Do pass as amended and be re-referred to the Committee on 	Appropriations",8,6,0,0,14
737447,453951,2015-05-28,Assembly,"Do pass",9,5,0,3,17
737447,488974,2016-01-28,Assembly,"AB 708 JONES-SAWYER  Assembly Third Reading",33,28,0,18,79
737448,437179,2015-04-22,Senate,"Do pass as amended, and re-refer to the Committee on Appropriations",4,1,0,0,5
737448,445128,2015-05-11,Senate,"Placed on Appropriations Suspense file",7,0,0,0,7
737448,453906,2015-05-28,Senate,"Do pass",5,2,0,0,7
737448,457329,2015-06-04,Senate,"Senate 3rd Reading SB406 Jackson",23,16,1,0,40
737448,462953,2015-06-24,Assembly,"Do pass and be re-referred to the Committee on Appropriations",5,2,0,0,7
737448,474336,2015-08-27,Assembly,"Do pass as amended",12,5,0,0,17
737448,476637,2015-09-11,Assembly,"SB 406 Jackson  Senate Third Reading  By GOMEZ",41,30,0,9,80
737448,476638,2015-09-11,Senate,"Unfinished Business (S upplemental File 5)SB4 06 Jac kson Con",23,16,1,0,40
737450,435999,2015-04-21,Senate,"Do pass as amended, and re-refer to the Committee on Environmental 	Quality",7,0,4,0,11
737450,441079,2015-04-29,Senate,"Do pass, but re-refer to the Committee on Appropriations",7,0,0,0,7
737450,453722,2015-05-28,Senate,"Do pass as amended",6,1,0,0,7
737450,456037,2015-06-02,Senate,"Senate 3rd Reading SB400 Lara",27,9,4,0,40
737450,463658,2015-05-18,Senate,"Placed on Appropriations Suspense file",7,0,0,0,7
737450,463914,2015-06-29,Assembly,"Do pass and be re-referred to the Committee on Natural Resources",15,0,0,1,16
737450,466044,2015-07-13,Assembly,"Do pass and be re-referred to the Committee on Appropriations",6,2,0,1,9
737451,432681,2015-04-15,Assembly,"Do pass and be re-referred to the Committee on Appropriations",10,0,0,0,10
737451,441901,2015-04-29,Assembly,"Do pass, to Consent Calendar",17,0,0,0,17
737451,444515,2015-05-07,Assembly,"AB 732 COOPER  Consent Calendar Second Day  Regular Session",77,0,0,3,80
737451,464297,2015-06-30,Senate,"Do pass as amended, and re-refer to the Committee on Appropriations",3,0,2,0,5
737451,475455,2015-09-01,Senate,"Assembly 3rd Reading AB732 Cooper By Galgiani",39,1,0,0,40
737451,475804,2015-09-03,Assembly,"AB 732 COOPER  Concurrence in Senate Amendments",78,0,0,2,80
737454,485068,2016-01-05,Assembly,"Be referred to Committee on Insurance",11,0,0,0,11
737455,436578,2015-04-21,Senate,"Do pass, but re-refer to the Committee on Governance and Finance",9,0,2,0,11
737455,446245,2015-05-13,Senate,"Do pass as amended",6,0,1,0,7
737455,456735,2015-06-03,Senate,"Senate 3rd Reading SB434 Allen",38,0,2,0,40
737456,437337,2015-04-21,Assembly,"Do pass as amended and be re-referred to the Committee on 	Appropriations",19,0,0,0,19
737456,453508,2015-05-27,Assembly,"Do pass, to Consent Calendar",17,0,0,0,17
737456,456626,2015-06-03,Assembly,"AB 766 RIDLEY-THOMAS  Assembly Third Reading",79,0,0,1,80
737456,464807,2015-07-01,Senate,"Do pass, but re-refer to the Committee on Appropriations",8,0,1,0,9
737456,473816,2015-08-17,Senate,"Placed on Appropriations Suspense file",7,0,0,0,7
737458,441055,2015-04-29,Senate,"Do pass, but re-refer to the Committee on Appropriations",5,0,2,0,7
737458,453767,2015-05-28,Senate,"Do pass",5,2,0,0,7
737458,455410,2015-06-01,Senate,"Senate 3rd Reading SB441 Leno",26,13,1,0,40
737458,463674,2015-05-18,Senate,"Placed on Appropriations Suspense file",7,0,0,0,7
737458,464939,2015-07-01,Assembly,"Do pass and be re-referred to the Committee on Local Government",5,2,0,0,7
737458,466469,2015-07-15,Assembly,"Do pass and be re-referred to the Committee on Appropriations",7,1,0,1,9
737458,474347,2015-08-27,Assembly,"Do pass",12,5,0,0,17
737458,476004,2015-09-08,Assembly,"SB 441 Leno  Senate Third Reading  By TING",50,28,0,2,80
737458,553745,2016-06-16,Assembly,"Be referred to Committee on Judiciary",10,0,0,1,11
737458,556101,2016-06-28,Assembly,"Do pass and be re-referred to the Committee on Appropriations to 	Consent Calendar",10,0,0,0,10
737458,559058,2016-08-03,Assembly,"Do pass, to Consent Calendar",20,0,0,0,20
737458,559506,2016-08-11,Assembly,"SB 441 Wolk  Consent Calendar Second Day  Regular Session",78,0,0,2,80
737458,560074,2016-08-17,Senate,"From committee:  That the Assembly Amendments be concurred in",7,0,0,0,7
737458,560152,2016-08-18,Senate,"Unfinished Business SB441 Wolk Concurrence",36,0,3,0,39
737459,428651,2015-04-07,Senate,"Do pass as amended",7,0,0,0,7
737459,433943,2015-04-16,Senate,"Senate 3rd Reading SB414 Jackson",35,2,2,0,39
737459,459884,2015-06-15,Assembly,"Be referred to Committee on Natural Resources",10,0,0,1,11
737459,463832,2015-06-29,Assembly,"Do pass as amended and be re-referred to the Committee on 	Governmental Organization",8,1,0,0,9
737459,466258,2015-07-15,Assembly,"Do pass as amended and be re-referred to the Committee on 	Appropriations",12,0,0,9,21
737459,474263,2015-08-27,Assembly,"Do pass",17,0,0,0,17
737459,475999,2015-09-08,Assembly,"SB 414 Jackson  Senate Third Reading  By WILLIAMS",79,0,0,1,80
737459,476260,2015-09-10,Senate,"From committee:  That the Assembly Amendments be concurred in",6,2,1,0,9
737459,476532,2015-09-11,Senate,"Unfinished Business SB414 Jackson Concurrence",26,13,1,0,40
737460,432881,2015-04-15,Senate,"Do pass as amended, and re-refer to the Committee on Appropriations",7,1,0,0,8
737460,445496,2015-05-11,Senate,"Placed on Appropriations Suspense file",7,0,0,0,7
737460,453790,2015-05-28,Senate,"Do pass as amended",5,2,0,0,7
737460,456675,2015-06-03,Senate,"Senate 3rd Reading SB463 Hancock",29,11,0,0,40
737462,429229,2015-04-08,Assembly,"Do pass and be re-referred to the Committee on Appropriations",5,1,0,1,7
737462,453732,2015-05-28,Assembly,"Do pass",12,5,0,0,17
737462,455984,2015-06-02,Assembly,"AB 676 CALDERON  Assembly Third Reading",51,27,0,2,80
737462,462847,2015-06-24,Senate,"Do pass, but re-refer to the Committee on Judiciary",4,1,0,0,5
737462,464724,2015-06-30,Senate,"Do pass, but re-refer to the Committee on Appropriations",5,2,0,0,7
737462,473759,2015-08-17,Senate,"Placed on Appropriations Suspense file",7,0,0,0,7
737462,474575,2015-08-27,Senate,"Do pass as amended",5,2,0,0,7
737462,475502,2015-09-01,Senate,"Assembly 3rd Reading AB676 Calderon By Mendoza",28,9,3,0,40
737462,475759,2015-09-03,Assembly,"AB 676 CALDERON  Concurrence in Senate Amendments",52,27,0,1,80
737463,427978,2015-04-07,Senate,"Do pass as amended, and re-refer to the Committee on Appropriations",4,0,1,0,5
737463,442865,2015-05-04,Senate,"Placed on Appropriations Suspense file",7,0,0,0,7
737463,454052,2015-05-28,Senate,"Do pass",7,0,0,0,7
737463,455463,2015-06-01,Senate,"Senate 3rd Reading SB417 Stone",40,0,0,0,40
737464,429282,2015-04-08,Assembly,"Do pass as amended and be re-referred to the Committee on 	Appropriations",4,3,0,0,7
737464,453854,2015-05-28,Assembly,"Do pass as amended",11,0,0,6,17
737464,457229,2015-06-04,Assembly,"AB 787 HERNANDEZ  Assembly Third Reading",46,28,0,6,80
737464,466279,2015-07-15,Senate,"Do pass as amended",6,3,0,0,9
737464,475932,2015-09-08,Senate,"Assembly 3rd Reading AB787 Roger Hern",22,15,3,0,40
737464,476121,2015-09-09,Assembly,"AB 787 HERNANDEZ  Concurrence in Senate Amendments",45,29,0,6,80
737466,436026,2015-04-21,Senate,"Do pass, but re-refer to the Committee on Appropriations",5,0,0,0,5
737466,446874,2015-05-14,Senate,"Senate 3rd Reading SB450 Allen",36,0,3,0,39
737466,556326,2016-06-29,Assembly,"Do pass and be re-referred to the Committee on Appropriations",5,2,0,0,7
737466,559331,2016-08-11,Assembly,"Do pass as amended",14,6,0,0,20
737466,560191,2016-08-18,Assembly,"SB 450 Allen  Senate Third Reading  By GONZALEZ  Amendment  Set #1",51,26,0,3,80
737466,560678,2016-08-23,Assembly,"SB 450 Allen  Senate Third Reading  By GONZALEZ",47,31,0,2,80
737466,561149,2016-08-25,Senate,"From committee:  That the Assembly Amendments be concurred in",4,1,0,0,5
737466,561356,2016-08-29,Senate,"Unfinished Business SB450 Allen Concurrence",27,11,1,0,39
737467,432568,2015-04-14,Assembly,"Do pass as amended",10,0,0,0,10
737467,442841,2015-05-04,Assembly,"AB 675 ALEJO  Assembly Third Reading",77,1,0,2,80
737467,466205,2015-07-14,Senate,"Do pass as amended",7,0,0,0,7
737467,474068,2015-08-24,Senate,"Assembly 3rd Reading AB675 Alejo By Jackson",39,0,1,0,40
737467,474069,2015-08-24,Senate,"Assembly 3rd Reading AB675 Alejo By Jackson",27,0,13,0,40
737467,474328,2015-08-27,Senate,"Assembly 3rd Reading AB675 Alejo By Jackson",40,0,0,0,40
737467,475465,2015-09-01,Assembly,"AB 675 ALEJO  Concurrence in Senate Amendments",80,0,0,0,80
737468,443446,2015-05-05,Assembly,"Do pass, to Consent Calendar",14,0,0,0,14
737468,445195,2015-05-11,Assembly,"AB 693 EGGMAN  Consent Calendar Second Day  Regular Session",79,0,0,1,80
737468,465966,2015-07-13,Senate,"Do pass as amended, and re-refer to the Committee on Appropriations",8,3,0,0,11
737468,474156,2015-08-24,Senate,"Placed on Appropriations Suspense file",7,0,0,0,7
737468,474655,2015-08-27,Senate,"Do pass as amended",5,2,0,0,7
737468,476329,2015-09-10,Senate,"Assembly 3rd Reading AB693 Eggman By Leyva",26,14,0,0,40
737468,476480,2015-09-11,Assembly,"AB 693 EGGMAN  Concurrence in Senate Amendments",51,28,0,1,80
737470,436016,2015-04-21,Senate,"Do pass, but re-refer to the Committee on Appropriations Recommend 	Consent",10,0,1,0,11
737470,442918,2015-05-04,Senate,"Placed on Appropriations Suspense file",7,0,0,0,7
737470,453831,2015-05-28,Senate,"Do pass",7,0,0,0,7
737470,456034,2015-06-02,Senate,"Senate 3rd Reading SB461 Hernandez",38,0,2,0,40
737470,474121,2015-07-13,Assembly,"Do pass and be re-referred to the Committee on Appropriations to 	Consent Calendar",16,0,0,0,16
737470,474436,2015-08-27,Assembly,"Do pass",17,0,0,0,17
737470,475349,2015-08-31,Assembly,"SB 461 Hernandez  Senate Third Reading  By CALDERON",80,0,0,0,80
737470,475530,2015-09-01,Senate,"Unfinished Business SB461 Hernandez Concurrence",40,0,0,0,40
737471,441734,2015-04-29,Senate,"Do pass, but re-refer to the Committee on Appropriations",6,1,0,0,7
737471,445127,2015-05-11,Senate,"Placed on Appropriations Suspense file",7,0,0,0,7
737471,454039,2015-05-28,Senate,"Do pass as amended",5,2,0,0,7
737471,456823,2015-06-03,Senate,"Senate 3rd Reading SB398 Leyva",31,9,0,0,40
737471,466018,2015-07-13,Assembly,"Do pass and be re-referred to the Committee on Appropriations to 	Consent Calendar",9,0,0,0,9
737475,427878,2015-04-07,Senate,"Do pass, but re-refer to the Committee on Judiciary",11,0,0,0,11
737475,437298,2015-04-21,Senate,"Do pass, but re-refer to the Committee on Appropriations Recommend 	Consent",7,0,0,0,7
737475,444448,2015-05-07,Senate,"Senate 3rd Reading SB438 Hill",37,0,2,0,39
737475,556825,2016-06-30,Assembly,"Do pass and be re-referred to the Committee on Appropriations",20,0,0,1,21
737475,558997,2016-08-03,Assembly,"Do pass",20,0,0,0,20
737475,560504,2016-08-22,Assembly,"SB 438 Hill  Senate Third Reading  By GRAY",77,0,0,3,80
737475,561230,2016-08-25,Senate,"From committee:  That the Assembly Amendments be concurred in",7,0,0,0,7
737475,561438,2016-08-29,Senate,"Unfinished Business SB438 Hill Concurrence",39,0,0,0,39
737476,437998,2015-04-22,Assembly,"Do pass and be re-referred to the Committee on Appropriations",6,1,0,0,7
737476,454152,2015-05-28,Assembly,"Do pass",12,5,0,0,17
737476,456067,2015-06-02,Assembly,"AB 769 JONES-SAWYER  Assembly Third Reading",58,21,0,1,80
737476,538187,2016-04-25,Senate,"Do pass, but re-refer to the Committee on Appropriations",3,2,0,0,5
737476,554542,2016-06-20,Senate,"Placed on Appropriations Suspense file",7,0,0,0,7
737476,559748,2016-08-11,Senate,"Do pass",5,2,0,0,7
737476,560264,2016-08-18,Senate,"Assembly 3rd Reading AB769 Jones-Sawyer By Pan",25,11,3,0,39
737476,560871,2016-08-23,Assembly,"AB 769 JONES-SAWYER  Concurrence in Senate Amendments",55,22,0,3,80
737477,428555,2015-04-08,Senate,"Do pass as amended, but re-refer to the Committee on Appropriations 	Recommend Consent",8,0,0,0,8
737477,445237,2015-05-11,Senate,"Consent Calendar 2nd SB416 Huff",36,0,3,0,39
737477,464883,2015-07-01,Assembly,"Do pass as amended and be re-referred to the Committee on 	Appropriations",6,0,0,1,7
737477,473915,2015-08-19,Assembly,"Do pass, to Consent Calendar",17,0,0,0,17
737477,474427,2015-08-27,Assembly,"SB 416 Huff  Consent Calendar Second Day  Regular Session",78,0,0,2,80
737477,475422,2015-09-01,Senate,"Special Consent #9 SB416 Huff",40,0,0,0,40
737479,484895,2016-01-12,Assembly,"Do pass and be re-referred to the Committee on Appropriations",4,7,0,3,14
737480,437766,2015-04-14,Assembly,"Do pass as amended and be re-referred to the Committee on Judiciary",12,5,0,2,19
737480,440091,2015-04-28,Assembly,"Do pass and be re-referred to the Committee on Appropriations",7,3,0,0,10
737480,451435,2015-05-26,Assembly,"AB 775 CHIU  Assembly Third Reading",49,26,0,5,80
737480,462926,2015-06-24,Senate,"Do pass",6,2,1,0,9
737480,475754,2015-09-03,Senate,"Assembly 3rd Reading AB775 Chiu By Jackson",24,14,2,0,40
737480,476854,2015-09-03,Senate,"Assembly 3rd Reading AB775 Chiu Amend by Stone",25,12,3,0,40
737480,476855,2015-09-03,Senate,"Assembly 3rd Reading AB775 Chiu Amend by Stone",25,13,2,0,40
737480,476856,2015-09-03,Senate,"Assembly 3rd Reading AB775 Chiu Amend by Anderson",25,13,2,0,40
737483,427769,2015-04-07,Assembly,"Do pass and be re-referred to the Committee on Appropriations",18,0,0,1,19
737484,437718,2015-04-22,Assembly,"Do pass and be re-referred to the Committee on Transportation",9,0,0,0,9
737484,439986,2015-04-27,Assembly,"Do pass as amended",16,0,0,0,16
737484,444474,2015-05-07,Assembly,"AB 726 NAZARIAN  Assembly Third Reading",77,0,0,3,80
737484,464405,2015-06-30,Senate,"Do pass as amended. To Consent Calendar",11,0,0,0,11
737484,466538,2015-07-16,Senate,"Consent Calendar 2nd AB726 Nazarian",38,0,2,0,40
737484,476096,2015-09-09,Senate,"Assembly 3rd Reading AB726 Nazarian By Hertzberg",40,0,0,0,40
737484,476237,2015-09-10,Assembly,"AB 726 NAZARIAN  Concurrence in Senate Amendments",80,0,0,0,80
737485,432190,2015-04-13,Assembly,"Do pass as amended and be re-referred to the Committee on 	Appropriations",14,0,0,1,15
737485,441106,2015-04-29,Assembly,"Do pass, to Consent Calendar",17,0,0,0,17
737485,444422,2015-05-07,Assembly,"AB 793 QUIRK  Consent Calendar Second Day  Regular Session",77,0,0,3,80
737485,464454,2015-06-30,Senate,"Do pass as amended, and re-refer to the Committee on Appropriations",6,1,4,0,11
737485,475690,2015-09-02,Senate,"Assembly 3rd Reading AB793 Quirk By Hill",38,0,2,0,40
737485,475805,2015-09-03,Assembly,"AB 793 QUIRK  Concurrence in Senate Amendments",79,0,0,1,80
737487,440287,2015-04-27,Senate,"Do pass, but re-refer to the Committee on Appropriations",9,0,0,0,9
737487,445219,2015-05-11,Senate,"Placed on Appropriations Suspense file",7,0,0,0,7
737487,453946,2015-05-28,Senate,"Do pass",7,0,0,0,7
737487,455280,2015-06-01,Senate,"Senate 3rd Reading SB465 Hill",40,0,0,0,40
737487,465992,2015-07-14,Assembly,"Do pass and be re-referred to the Committee on Appropriations",7,3,0,4,14
737487,465993,2015-07-14,Assembly,"Reconsideration granted",14,0,0,0,14
737487,554849,2016-06-21,Assembly,"Do pass as amended and be re-referred to the Committee on 	Appropriations",12,0,0,4,16
737487,559373,2016-08-11,Assembly,"Do pass as amended",18,0,0,2,20
737487,560414,2016-08-19,Assembly,"SB 465 Hill  Senate Third Reading  Amendment  Set #1",73,0,0,7,80
737487,561067,2016-08-24,Assembly,"Do pass as amended",16,0,0,0,16
737487,561761,2016-08-31,Senate,"From committee:  That the Assembly Amendments be concurred in",9,0,0,0,9
737487,561762,2016-08-31,Senate,"W/O REF. TO FILE SB465 Hill",38,0,1,0,39
737487,561763,2016-08-31,Assembly,"SB 465 Hill  Senate Third Reading  By WAGNER",79,0,0,1,80
737488,428084,2015-04-07,Assembly,"Do pass and be re-referred to the Committee on Appropriations",7,0,0,0,7
737488,454079,2015-05-28,Assembly,"Do pass as amended",12,0,0,5,17
737488,456556,2015-06-03,Assembly,"AB 672 JONES-SAWYER  Assembly Third Reading",79,0,0,1,80
737488,465420,2015-07-07,Senate,"Do pass, but re-refer to the Committee on Public Safety Recommend 	Consent",11,0,0,0,11
737488,466227,2015-07-14,Senate,"Do pass, but re-refer to the Committee on Appropriations",7,0,0,0,7
737488,473572,2015-08-17,Senate,"Placed on Appropriations Suspense file",7,0,0,0,7
737488,474669,2015-08-27,Senate,"Do pass as amended",7,0,0,0,7
737488,476239,2015-09-10,Senate,"Assembly 3rd Reading AB672 Jones-Sawyer By Mitchell",40,0,0,0,40
737488,476520,2015-09-11,Assembly,"AB 672 JONES-SAWYER  Concurrence in Senate Amendments",79,0,0,1,80
737489,440876,2015-04-29,Assembly,"Do pass as amended and be re-referred to the Committee on 	Appropriations",6,0,0,1,7
737489,453475,2015-05-27,Assembly,"Do pass, to Consent Calendar",17,0,0,0,17
737489,456124,2015-06-02,Assembly,"AB 723 RENDON  Consent Calendar Second Day  Regular Session",78,0,0,2,80
737489,466418,2015-07-14,Senate,"Do pass as amended, and re-refer to the Committee on Appropriations",4,2,1,0,7
737489,559205,2016-08-09,Senate,"Do pass, but re-refer to the Committee on Appropriations",11,0,0,0,11
737489,559651,2016-08-11,Senate,"Placed on Appropriations Suspense file",7,0,0,0,7
737489,559652,2016-08-11,Senate,"Do pass",7,0,0,0,7
737489,560841,2016-08-23,Senate,"Assembly 3rd Reading AB723 Chiu By Beall Urgency Claus",39,0,0,0,39
737489,561282,2016-08-25,Assembly,"Senate amendments be concurred in",7,0,0,0,7
737489,561610,2016-08-30,Assembly,"AB 723 CHIU  Concurrence- Urgency Added",80,0,0,0,80
737492,433356,2015-04-15,Assembly,"Do pass and be re-referred to the Committee on Transportation",5,1,0,1,7
737492,440170,2015-04-27,Assembly,"Do pass and be re-referred to the Committee on Appropriations",12,3,0,1,16
737492,454009,2015-05-28,Assembly,"Do pass",12,4,0,1,17
737492,456081,2015-06-02,Assembly,"AB 786 LEVINE  Assembly Third Reading",60,17,0,3,80
737492,474179,2015-08-25,Senate,"Do pass as amended",9,0,2,0,11
737492,475938,2015-09-08,Senate,"Assembly 3rd Reading AB786 Levine By Beall",39,0,1,0,40
737492,476282,2015-09-10,Assembly,"Senate amendments be concurred in",7,0,0,0,7
737492,476557,2015-09-11,Assembly,"AB 786 LEVINE  Concurrence- Urgency Added",78,0,0,2,80
737493,441500,2015-04-29,Senate,"Do pass, but re-refer to the Committee on Appropriations",7,0,2,0,9
737493,463637,2015-05-18,Senate,"Placed on Appropriations Suspense file",7,0,0,0,7
737494,437462,2015-04-22,Assembly,"Do pass, to Consent Calendar",17,0,0,0,17
737494,442158,2015-04-30,Assembly,"AB 794 LINDER  Consent Calendar Second Day  Regular Session",77,0,0,3,80
737494,460257,2015-06-16,Senate,"Do pass, but re-refer to the Committee on Appropriations",7,0,0,0,7
737494,463901,2015-06-29,Senate,"Do pass",6,0,1,0,7
737494,465180,2015-07-06,Senate,"Special Consent #4 AB794 Linder",39,0,1,0,40
737494,466142,2015-04-14,Assembly,"Do pass and be re-referred to the Committee on Appropriations to 	Consent Calendar",7,0,0,0,7
737495,432656,2015-04-15,Senate,"Do pass as amended, and re-refer to the Committee on Health",7,0,1,0,8
737495,442373,2015-04-29,Senate,"Do pass as amended, and re-refer to the Committee on Appropriations",8,0,1,0,9
737495,463680,2015-05-18,Senate,"Placed on Appropriations Suspense file",7,0,0,0,7
737496,443715,2015-05-05,Assembly,"From committee:  Be adopted.  To third reading",7,0,0,0,7
737496,444441,2015-05-07,Assembly,"AJR8 BROWN  Assembly Third Reading",75,0,0,5,80
737496,454407,2015-05-28,Senate,"Assembly 3rd Reading AJR8 Brown By Liu",38,0,2,0,40
737500,432651,2015-04-14,Assembly,"Do pass and be re-referred to the Committee on Appropriations to 	Consent Calendar",14,0,0,0,14
737500,437383,2015-04-22,Assembly,"Do pass, to Consent Calendar",17,0,0,0,17
737500,442330,2015-04-30,Assembly,"AB 773 BAKER  Consent Calendar Second Day  Regular Session",77,0,0,3,80
737500,457987,2015-06-08,Senate,"Do pass, but re-refer to the Committee on Appropriations Recommend 	Consent",9,0,0,0,9
737500,461875,2015-06-22,Senate,"Placed on Appropriations Suspense file",6,0,1,0,7
737500,474720,2015-08-27,Senate,"Do pass as amended",7,0,0,0,7
737500,475806,2015-09-03,Senate,"Assembly 3rd Reading AB773 Baker By Bates",40,0,0,0,40
737500,475873,2015-09-04,Assembly,"AB 773 BAKER  Concurrence in Senate Amendments",80,0,0,0,80
737502,427853,2015-04-07,Assembly,"Do pass and be re-referred to the Committee on Governmental 	Organization",4,2,0,1,7
737502,439444,2015-04-27,Assembly,"Do pass as amended and be re-referred to the Committee on 	Appropriations",15,5,0,1,21
737502,453066,2015-05-27,Assembly,"Do pass as amended",12,4,0,1,17
737502,457288,2015-06-04,Assembly,"AB 768 THURMOND  Assembly Third Reading",53,25,0,2,80
737502,463817,2015-06-29,Senate,"Do pass, but re-refer to the Committee on Labor and Industrial 	Relations",7,3,3,0,13
737502,465632,2015-07-08,Senate,"Do pass",4,1,0,0,5
737502,474139,2015-08-24,Senate,"Assembly 3rd Reading AB768 Thurmond By Leno",24,14,2,0,40
737502,474443,2015-08-27,Assembly,"AB 768 THURMOND  Concurrence in Senate Amendments",54,23,0,3,80
737503,442895,2015-05-04,Senate,"Do pass",8,0,1,0,9
737503,445156,2015-05-11,Senate,"Senate 3rd Reading SB464 Hernandez",27,2,10,0,39
737503,464495,2015-06-30,Assembly,"Do pass and be re-referred to the Committee on Appropriations",14,0,0,0,14
737503,466365,2015-07-15,Assembly,"Do pass",15,1,0,1,17
737503,473962,2015-08-20,Assembly,"SB 464 Hernandez  Senate Third Reading  By WOOD",73,1,0,6,80
737503,475320,2015-08-31,Senate,"Unfinished Business SB464 Hernandez Concurrence",29,5,6,0,40
737504,437266,2015-04-21,Assembly,"Do pass as amended and be re-referred to the Committee on 	Appropriations",13,0,0,0,13
737504,443867,2015-05-06,Assembly,"Do pass, to Consent Calendar",17,0,0,0,17
737504,446662,2015-05-14,Assembly,"AB 752 SALAS  Consent Calendar Second Day  Regular Session",78,0,0,2,80
737504,461970,2015-06-22,Senate,"Do pass, but re-refer to the Committee on Education",9,0,0,0,9
737504,464750,2015-07-01,Senate,"Do pass, but re-refer to the Committee on Appropriations Recommend 	Consent",7,0,2,0,9
737504,474438,2015-08-27,Senate,"Assembly 3rd Reading AB752 Salas By Wieckowski",39,0,1,0,40
737506,440176,2015-04-28,Senate,"Do pass, but re-refer to the Committee on Environmental Quality",7,1,1,0,9
737506,441550,2015-04-29,Senate,"Do pass, but re-refer to the Committee on Appropriations",5,2,0,0,7
737506,445212,2015-05-11,Senate,"Placed on Appropriations Suspense file",7,0,0,0,7
737506,453622,2015-05-28,Senate,"Do pass as amended",5,2,0,0,7
737506,457230,2015-06-04,Senate,"Senate 3rd Reading SB454 Allen Reconsider",39,0,1,0,40
737506,457934,2015-06-04,Senate,"Senate 3rd Reading SB454 Allen",17,17,6,0,40
737507,441943,2015-04-29,Senate,"Do pass, but re-refer to the Committee on Judiciary",2,5,0,0,7
737507,463663,2015-04-29,Senate,"Set, first hearing.  Failed passage in Committee.  Reconsideration 	granted",7,0,0,0,7
737510,431366,2015-04-09,Assembly,"Be referred to Committee on Elections and Redistricting",11,0,0,0,11
737510,441801,2015-04-29,Assembly,"Do pass and be re-referred to the Committee on Appropriations",7,0,0,0,7
737510,448877,2015-05-20,Assembly,"Do pass, to Consent Calendar",15,0,0,2,17
737510,451824,2015-05-26,Assembly,"AB 683 LOW  Consent Calendar Second Day  Regular Session",76,0,0,4,80
737510,464470,2015-06-30,Senate,"Do pass, but re-refer to the Committee on Appropriations",4,0,1,0,5
737510,475379,2015-08-31,Senate,"Assembly 3rd Reading AB683 Low By Allen",40,0,0,0,40
737510,475531,2015-09-01,Assembly,"AB 683 LOW  Concurrence in Senate Amendments",79,0,0,1,80
737511,440240,2015-04-28,Assembly,"Do pass and be re-referred to the Committee on Privacy and Consumer 	Protection",10,0,0,0,10
737511,443393,2015-05-05,Assembly,"Do pass",11,0,0,0,11
737511,445315,2015-05-11,Assembly,"AB 691 CALDERON  Assembly Third Reading",79,0,0,1,80
737511,466392,2015-07-14,Senate,"Do pass",6,0,1,0,7
737511,476410,2015-09-10,Senate,"From Committee:  That the measure be returned to the Senate floor 	for consideration",7,0,0,0,7
737511,542383,2016-05-03,Senate,"From Committee:  That the measure be returned to the Senate floor 	for consideration",6,0,1,0,7
737511,558692,2016-08-01,Senate,"Assembly 3rd Reading AB691 Calderon By Hertzberg",36,1,2,0,39
737511,560820,2016-08-23,Assembly,"Senate amendments be concurred in",10,0,0,0,10
737511,561295,2016-08-25,Assembly,"AB 691 CALDERON  Concurrence in Senate Amendments",79,0,0,1,80
737512,429531,2015-04-08,Assembly,"Do pass as amended and be re-referred to the Committee on 	Appropriations",7,0,0,0,7
737514,434424,2015-04-15,Senate,"Do pass as amended, and re-refer to the Committee on Appropriations",9,0,0,0,9
737514,445301,2015-05-11,Senate,"Do pass",7,0,0,0,7
737514,447654,2015-05-18,Senate,"Special Consent #1 SB407 Morrell",36,0,3,0,39
737514,462120,2015-06-23,Assembly,"Do pass and be re-referred to the Committee on Business and 	Professions",17,0,0,2,19
737514,464372,2015-06-30,Assembly,"Do pass as amended and be re-referred to the Committee on 	Appropriations",14,0,0,0,14
737514,473938,2015-08-19,Assembly,"Do pass, to Consent Calendar",17,0,0,0,17
737514,474314,2015-08-27,Assembly,"SB 407 Morrell  Consent Calendar Second Day  Regular Session",78,0,0,2,80
737514,475425,2015-09-01,Senate,"Special Consent #9 SB407 Morrell",40,0,0,0,40
737516,428142,2015-04-07,Assembly,"Do pass as amended and be re-referred to the Committee on 	Appropriations",14,0,0,0,14
737516,437886,2015-04-22,Assembly,"Do pass, to Consent Calendar",17,0,0,0,17
737516,442268,2015-04-30,Assembly,"AB 705 EGGMAN  Consent Calendar Second Day  Regular Session",77,0,0,3,80
737516,457985,2015-06-08,Senate,"Do pass as amended, but re-refer to the Committee on Appropriations 	Recommend Consent",9,0,0,0,9
737516,464893,2015-07-02,Senate,"Consent Calendar 2nd AB705 Eggman",38,0,2,0,40
737516,465138,2015-07-06,Assembly,"AB 705 EGGMAN  Concurrence in Senate Amendments",80,0,0,0,80
737517,440063,2015-04-27,Senate,"Do pass, but re-refer to the Committee on Judiciary",8,0,1,0,9
737517,445232,2015-05-11,Senate,"Placed on Appropriations Suspense file",7,0,0,0,7
737517,453956,2015-05-28,Senate,"Do pass as amended",7,0,0,0,7
737517,456019,2015-06-02,Senate,"Senate 3rd Reading SB468 Hill",28,7,5,0,40
737517,465459,2015-07-07,Assembly,"Do pass as amended and be re-referred to the Committee on 	Appropriations",11,3,0,0,14
737517,474407,2015-08-27,Assembly,"Do pass as amended",12,5,0,0,17
737517,475719,2015-09-03,Assembly,"SB 468 Hill  Senate Third Reading  By BONILLA  Amend By BONILLA 	Set #1",52,27,0,1,80
737518,436141,2015-04-21,Assembly,"Do pass and be re-referred to the Committee on Judiciary",11,0,0,0,11
737520,428920,2015-04-08,Senate,"Do pass as amended, but re-refer to the Committee on Appropriations 	Recommend Consent",8,0,0,0,8
737520,442837,2015-05-04,Senate,"Do pass",7,0,0,0,7
737520,447649,2015-05-18,Senate,"Special Consent #1 SB445 Liu",36,0,3,0,39
737520,464876,2015-07-01,Assembly,"Amend, and do pass as amended and be re-referred to the Committee 	on Appropriations with the recommendation:  To Consent Calendar",6,0,0,1,7
737520,466339,2015-07-15,Assembly,"Do pass, to Consent Calendar",16,0,0,1,17
737520,473951,2015-08-20,Assembly,"SB 445 Liu  Consent Calendar Second Day  Regular Session",79,0,0,1,80
737520,474343,2015-08-27,Senate,"Special Consent #7 SB445 Liu",40,0,0,0,40
737521,427806,2015-04-07,Assembly,"Do pass and be re-referred to the Committee on Appropriations",10,0,0,0,10
737521,437124,2015-04-22,Assembly,"Do pass",17,0,0,0,17
737521,439541,2015-04-27,Assembly,"AB 703 BLOOM  Assembly Third Reading",78,0,0,2,80
737521,458366,2015-06-09,Senate,"Do pass, but re-refer to the Committee on Appropriations",5,1,1,0,7
737521,462041,2015-06-22,Senate,"Placed on Appropriations Suspense file",6,0,1,0,7
737521,474674,2015-08-27,Senate,"Do pass",6,1,0,0,7
737521,475563,2015-09-02,Senate,"Assembly 3rd Reading AB703 Bloom By Lara",29,11,0,0,40
737522,435196,2015-04-20,Assembly,"Do pass as amended and be re-referred to the Committee on 	Appropriations",7,0,0,2,9
737522,453818,2015-05-28,Assembly,"Do pass",17,0,0,0,17
737522,455927,2015-06-02,Assembly,"AB 681 TING  Assembly Third Reading",79,0,0,1,80
737522,465565,2015-07-08,Senate,"Do pass as amended, and re-refer to the Committee on Appropriations",7,0,0,0,7
737522,473777,2015-08-17,Senate,"Placed on Appropriations Suspense file",7,0,0,0,7
737522,474560,2015-08-27,Senate,"Do pass",7,0,0,0,7
737522,475457,2015-09-01,Senate,"Assembly 3rd Reading AB681 Ting By Nguyen",40,0,0,0,40
737522,475627,2015-09-02,Assembly,"AB 681 TING  Concurrence in Senate Amendments",80,0,0,0,80
737524,427895,2015-04-06,Assembly,"Do pass and be re-referred to the Committee on Appropriations to 	Consent Calendar",15,0,0,1,16
737524,437238,2015-04-22,Assembly,"Do pass, to Consent Calendar",17,0,0,0,17
737524,442278,2015-04-30,Assembly,"AB 759 LINDER  Consent Calendar Second Day  Regular Session",77,0,0,3,80
737524,466107,2015-07-14,Senate,"Do pass, but re-refer to the Committee on Appropriations Recommend 	Consent",11,0,0,0,11
737524,476076,2015-09-09,Senate,"Assembly 3rd Reading AB759 Linder By Bates",39,0,1,0,40
737524,476431,2015-09-10,Assembly,"AB 759 LINDER  Concurrence in Senate Amendments",80,0,0,0,80
737526,435205,2015-04-20,Assembly,"Do pass as amended and be re-referred to the Committee on Judiciary",9,2,0,1,12
737526,440467,2015-04-28,Assembly,"Do pass as amended and be re-referred to the Committee on 	Appropriations",10,0,0,0,10
737528,439977,2015-04-27,Assembly,"Do pass and be re-referred to the Committee on Appropriations",9,0,0,0,9
737529,447795,2015-05-13,Assembly,"Do pass",5,2,0,0,7
737529,456641,2015-06-03,Assembly,"AB 709 GIPSON  Assembly Third Reading",47,27,0,6,80
737529,464734,2015-07-01,Senate,"Do pass, but re-refer to the Committee on Judiciary",5,2,2,0,9
737529,465564,2015-07-07,Senate,"Do pass, but re-refer to the Committee on Appropriations",5,1,1,0,7
737529,473609,2015-08-17,Senate,"Placed on Appropriations Suspense file",7,0,0,0,7
737529,474627,2015-08-27,Senate,"Do pass as amended",5,2,0,0,7
737529,560375,2016-08-19,Senate,"Assembly 3rd Reading AB709 Gipson By Leno",21,13,5,0,39
737529,560973,2016-08-24,Assembly,"AB 709 GIPSON  Concurrence in Senate Amendments",46,31,0,3,80
737530,427883,2015-04-07,Assembly,"Do pass and be re-referred to the Committee on Appropriations",17,0,0,2,19
737532,447611,2015-05-18,Senate,"Senate 3rd Reading SB456 Block",36,0,3,0,39
737532,458670,2015-04-14,Senate,"Do pass as amended, and re-refer to the Committee on Appropriations",6,0,0,1,7
737532,460207,2015-06-16,Assembly,"Do pass as amended and be re-referred to the Committee on 	Appropriations",7,0,0,0,7
737532,465572,2015-07-08,Assembly,"Do pass, to Consent Calendar",14,0,0,3,17
737532,473990,2015-08-20,Assembly,"SB 456 Block  Senate Third Reading  By GONZALEZ",79,0,0,1,80
737532,474389,2015-08-27,Senate,"Special Consent #7 SB456 Block",40,0,0,0,40
737533,427831,2015-04-07,Assembly,"Do pass",5,2,0,0,7
737533,435476,2015-04-20,Assembly,"AB 730 QUIRK  Assembly Third Reading",49,29,0,2,80
737533,458370,2015-06-09,Senate,"Do pass",5,2,0,0,7
737533,463041,2015-06-25,Senate,"Assembly 3rd Reading AB730 Quirk By Hancock",23,13,4,0,40
737534,429599,2015-04-08,Assembly,"Do pass as amended and be re-referred to the Committee on Education",7,0,0,0,7
737534,441129,2015-04-28,Assembly,"Do pass as amended and be re-referred to the Committee on 	Appropriations",11,2,0,0,13
737536,433145,2015-04-15,Assembly,"Do pass and be re-referred to the Committee on Appropriations",10,0,0,0,10
737536,454001,2015-05-28,Assembly,"Do pass",17,0,0,0,17
737536,455269,2015-06-01,Assembly,"AB 751 COOPER  Assembly Third Reading",80,0,0,0,80
737536,464582,2015-06-30,Senate,"Do pass, but re-refer to the Committee on Appropriations Recommend 	Consent",3,0,2,0,5
737536,465837,2015-07-13,Senate,"Do pass",7,0,0,0,7
737536,474109,2015-08-24,Senate,"Assembly 3rd Reading AB751 Cooper By Galgiani",40,0,0,0,40
737537,437102,2015-04-22,Senate,"Do pass, but re-refer to the Committee on Business, Professions and 	Economic Development Recommend Consent",9,0,0,0,9
737537,440109,2015-04-27,Senate,"Do pass, but re-refer to the Committee on Appropriations Recommend 	Consent",9,0,0,0,9
737537,447665,2015-05-18,Senate,"Consent Calendar 2nd SB410 Beall",36,0,3,0,39
737537,462088,2015-06-23,Assembly,"Do pass and be re-referred to the Committee on Appropriations",12,0,0,1,13
737537,465676,2015-07-08,Assembly,"Do pass, to Consent Calendar",14,0,0,3,17
737537,466575,2015-07-16,Assembly,"SB 410 Beall  Consent Calendar Second Day  Regular Session",79,0,0,1,80
737537,473966,2015-08-20,Senate,"Special Consent #6 SB410 Beall",38,0,2,0,40
737538,432677,2015-04-14,Assembly,"Do pass and be re-referred to the Committee on Appropriations",7,0,0,0,7
737538,453893,2015-05-28,Assembly,"Do pass as amended",14,0,0,3,17
737538,457268,2015-06-04,Assembly,"AB 762 MULLIN  Assembly Third Reading",78,0,0,2,80
737538,466008,2015-07-14,Senate,"Do pass as amended, but re-refer to the Committee on Appropriations 	Recommend Consent",5,0,0,0,5
737538,474418,2015-08-27,Senate,"Assembly 3rd Reading AB762 Mullin By McGuire",39,0,1,0,40
737538,475348,2015-08-31,Assembly,"AB 762 MULLIN  Concurrence in Senate Amendments",78,0,0,2,80
737540,433050,2015-04-15,Assembly,"Do pass and be re-referred to the Committee on Local Government",10,0,0,0,10
737540,440872,2015-04-29,Assembly,"Do pass and be re-referred to the Committee on Appropriations to 	Consent Calendar",9,0,0,0,9
737540,446335,2015-05-13,Assembly,"Do pass, to Consent Calendar",17,0,0,0,17
737540,450105,2015-05-22,Assembly,"AB 707 WOOD  Consent Calendar Second Day  Regular Session",74,0,0,6,80
737540,460753,2015-06-17,Senate,"Do pass, but re-refer to the Committee on Appropriations",7,0,0,0,7
737540,475260,2015-08-31,Senate,"Assembly 3rd Reading AB707 Wood By Hertzberg",40,0,0,0,40
737540,475528,2015-09-01,Assembly,"AB 707 WOOD  Concurrence in Senate Amendments",80,0,0,0,80
737541,428450,2015-04-08,Assembly,"Do pass as amended and be re-referred to the Committee on 	Appropriations",9,0,0,0,9
737541,437275,2015-04-22,Assembly,"Do pass, to Consent Calendar",17,0,0,0,17
737541,442345,2015-04-30,Assembly,"AB 778 MAIENSCHEIN  Consent Calendar Second Day  Regular Session",77,0,0,3,80
737541,458661,2015-06-09,Senate,"Do pass, but re-refer to the Committee on Appropriations Recommend 	Consent",5,0,0,0,5
737541,463026,2015-06-25,Senate,"Consent Calendar 2nd AB778 Maienschein",37,0,3,0,40
737544,450227,2015-05-22,Assembly,"From committee:  Be adopted.  To third reading",10,0,0,1,11
737544,461130,2015-06-18,Senate,"Special Consent #3 ACR33 Atkins By Fuller",38,0,2,0,40
737545,432668,2015-04-15,Assembly,"Do pass",9,0,0,0,9
737545,442407,2015-04-30,Assembly,"AB 747 EGGMAN  Assembly Third Reading",78,0,0,2,80
737545,462249,2015-06-23,Senate,"Do pass, but re-refer to the Committee on Governance and Finance 	Recommend Consent",9,0,0,0,9
737545,465709,2015-07-08,Senate,"Do pass and be placed on the Consent Calendar",7,0,0,0,7
737545,466576,2015-07-16,Senate,"Consent Calendar 2nd AB747 Eggman",38,0,2,0,40
737548,435997,2015-04-21,Senate,"Do pass, but re-refer to the Committee on Appropriations",4,1,0,0,5
737548,445199,2015-05-11,Senate,"Do pass",5,2,0,0,7
737548,447686,2015-05-18,Senate,"Senate 3rd Reading SB439 Allen",23,12,4,0,39
737548,466256,2015-07-15,Assembly,"Do pass and be re-referred to the Committee on Appropriations",5,2,0,0,7
737548,473878,2015-08-19,Assembly,"Do pass",12,4,0,1,17
737548,475801,2015-09-03,Assembly,"SB 439 Allen  Senate Third Reading  By MULLIN",54,23,0,3,80
737548,475875,2015-09-04,Senate,"Unfinished Business SB439 Allen Concurrence",26,13,1,0,40
737549,439942,2015-04-27,Senate,"Do pass, but re-refer to the Committee on Appropriations",8,0,1,0,9
737549,445201,2015-05-11,Senate,"Placed on Appropriations Suspense file",7,0,0,0,7
737549,453963,2015-05-28,Senate,"Do pass as amended",7,0,0,0,7
737549,455876,2015-06-02,Senate,"Senate 3rd Reading SB469 Hill",40,0,0,0,40
737549,464367,2015-06-30,Assembly,"Do pass and be re-referred to the Committee on Business and 	Professions",6,0,0,1,7
737549,465402,2015-07-07,Assembly,"Do pass as amended and be re-referred to the Committee on 	Appropriations",14,0,0,0,14
737549,474330,2015-08-27,Assembly,"Do pass",17,0,0,0,17
737549,475306,2015-08-31,Assembly,"SB 469 Hill  Senate Third Reading  By CALDERON",80,0,0,0,80
737549,475485,2015-09-01,Senate,"Unfinished Business SB469 Hill Concurrence",40,0,0,0,40
737552,436166,2015-04-21,Assembly,"Do pass and be re-referred to the Committee on Appropriations to 	Consent Calendar",9,0,0,0,9
737553,428965,2015-04-08,Assembly,"Do pass and be re-referred to the Committee on Appropriations",21,0,0,0,21
737553,433933,2015-04-15,Assembly,"Do pass",16,0,0,1,17
737553,444439,2015-05-07,Assembly,"AB 701 GARCIA, C.  Assembly Third Reading",76,1,0,3,80
737553,556448,2016-06-28,Senate,"Do pass as amended",7,0,0,0,7
737553,559235,2016-08-11,Senate,"Special Consent AB701 Cristina Garcia By Lara",37,0,2,0,39
737553,560743,2016-08-23,Assembly,"Senate amendments be concurred in",6,0,0,0,6
737553,560934,2016-08-24,Assembly,"AB 701 GARCIA, C.  Concurrence in Senate Amendments",80,0,0,0,80
737555,441060,2015-04-29,Senate,"Do pass and be placed on the Consent Calendar",7,0,2,0,9
737555,445139,2015-05-11,Senate,"Consent Calendar 2nd SB440 Committee On ED. (Liu)",36,0,3,0,39
737555,462164,2015-06-23,Assembly,"Do pass",12,0,0,1,13
737555,463866,2015-06-29,Assembly,"SB 440 ED.  Senate Third Reading  By MEDINA",74,0,0,6,80
737556,429736,2015-04-08,Assembly,"Do pass and be re-referred to the Committee on Appropriations",5,1,0,1,7
737557,440505,2015-04-28,Senate,"Do pass, but re-refer to the Committee on Appropriations Recommend 	Consent",7,0,4,0,11
737557,447629,2015-05-18,Senate,"Consent Calendar 2nd SB399 Hall",36,0,3,0,39
737557,464891,2015-07-02,Assembly,"Be referred to Committee on Natural Resources",10,0,0,1,11
737557,466120,2015-07-13,Assembly,"Do pass and be re-referred to the Committee on Local Government",9,0,0,0,9
737557,466519,2015-07-15,Assembly,"Do pass as amended",9,0,0,0,9
737557,475772,2015-09-03,Assembly,"SB 399 Hall  Senate Third Reading  By O'DONNELL",80,0,0,0,80
737557,476168,2015-09-09,Senate,"From committee:  That the Assembly Amendments be concurred in",9,0,0,0,9
737557,476385,2015-09-10,Senate,"Unfinished Business SB399 Hall Concurrence",40,0,0,0,40
737559,440157,2015-04-27,Senate,"Do pass as amended, and re-refer to the Committee on Appropriations",9,0,0,0,9
737559,453658,2015-05-28,Senate,"Do pass",7,0,0,0,7
737559,455431,2015-06-01,Senate,"Senate 3rd Reading SB466 Hill",40,0,0,0,40
737559,463601,2015-05-18,Senate,"Placed on Appropriations Suspense file",7,0,0,0,7
737559,465994,2015-07-14,Assembly,"Do pass as amended and be re-referred to the Committee on 	Appropriations",14,0,0,0,14
737559,474355,2015-08-27,Assembly,"Do pass",17,0,0,0,17
737559,475713,2015-09-03,Assembly,"SB 466 Hill  Senate Third Reading  By BONILLA",80,0,0,0,80
737559,475829,2015-09-04,Senate,"Unfinished Business SB466 Hill Concurrence",40,0,0,0,40
737562,466366,2015-07-15,Senate,"Do pass, but re-refer to the Committee on Appropriations",7,0,0,0,7
737562,473584,2015-08-17,Senate,"Placed on Appropriations Suspense file",7,0,0,0,7
737562,474660,2015-08-27,Senate,"Do pass as amended",7,0,0,0,7
737562,475437,2015-09-01,Senate,"Senate 3rd Reading SB423 Bates Urgency Clause",40,0,0,0,40
737562,555998,2016-06-28,Assembly,"Do pass as amended and be re-referred to the Committee on 	Appropriations",7,0,0,0,7
737562,559307,2016-08-11,Assembly,"Do pass as amended",15,0,0,5,20
737562,560196,2016-08-18,Assembly,"SB 423 Bates  Senate Third Reading  By ALEJO",77,1,0,2,80
737562,561161,2016-08-25,Senate,"Special Consent SB423 Bates",39,0,0,0,39
737563,433841,2015-04-15,Assembly,"Do pass and be re-referred to the Committee on Appropriations",10,0,0,0,10
737563,437209,2015-04-22,Assembly,"Do pass, to Consent Calendar",17,0,0,0,17
737563,442176,2015-04-30,Assembly,"AB 689 DODD  Consent Calendar Second Day  Regular Session",77,0,0,3,80
737563,464418,2015-06-30,Senate,"Do pass, but re-refer to the Committee on Appropriations",3,0,2,0,5
737563,474316,2015-08-27,Senate,"Assembly 3rd Reading AB689 Dodd By Cannella",39,0,1,0,40
737563,475261,2015-08-31,Assembly,"AB 689 DODD  Concurrence in Senate Amendments",80,0,0,0,80
737564,437198,2015-04-22,Senate,"Do pass as amended",8,1,0,0,9
737564,442273,2015-04-30,Senate,"Senate 3rd Reading SB451 Lara",32,0,7,0,39
737564,460620,2015-06-17,Assembly,"Do pass",6,0,0,1,7
737564,475351,2015-08-31,Assembly,"SB 451 Lara  Senate Third Reading  By O'DONNELL",68,5,0,7,80
737566,437254,2015-04-22,Senate,"Do pass, but re-refer to the Committee on Appropriations",7,1,1,0,9
737566,442807,2015-05-04,Senate,"Placed on Appropriations Suspense file",7,0,0,0,7
737566,454018,2015-05-28,Senate,"Do pass as amended",5,2,0,0,7
737566,456754,2015-06-03,Senate,"Senate 3rd Reading SB435 Pan",27,11,2,0,40
737566,466034,2015-07-14,Assembly,"Do pass and be re-referred to the Committee on Appropriations",14,4,0,1,19
737566,474392,2015-08-27,Assembly,"Do pass",12,5,0,0,17
737570,440358,2015-04-28,Assembly,"Do pass and be re-referred to the Committee on Appropriations",2,4,0,1,7
737570,463761,2015-04-28,Assembly,"Reconsideration granted",6,0,0,1,7
737570,484786,2016-01-12,Assembly,"Do pass and be re-referred to the Committee on Appropriations",2,2,0,3,7
737572,427836,2015-04-07,Assembly,"Do pass, to Consent Calendar",10,0,0,0,10
737572,430669,2015-04-13,Assembly,"AB 731 GALLAGHER  Consent Calendar Second Day  Regular Session",79,0,0,1,80
737572,466421,2015-07-14,Senate,"Do pass and be placed on the Consent Calendar",7,0,0,0,7
737572,473960,2015-08-20,Senate,"Consent Calendar 2nd AB731 Gallagher",38,0,2,0,40
737572,474083,2015-08-24,Assembly,"AB 731 GALLAGHER  Concurrence in Senate Amendments",78,0,0,2,80
737574,439375,2015-04-27,Senate,"Senate 3rd Reading SB431 Beall Urgency Clause",35,0,4,0,39
737575,431549,2015-04-13,Assembly,"Do pass as amended and be re-referred to the Committee on 	Appropriations",10,4,0,1,15
737575,440058,2015-04-27,Assembly,"Do pass as amended and be re-referred to the Committee on 	Appropriations",8,1,0,0,9
737578,443403,2015-05-05,Assembly,"Be adopted, as amended, to Consent Calendar",10,0,0,0,10
737578,447818,2015-05-18,Assembly,"AJR9 CHANG  Assembly Third Reading",76,0,0,4,80
737578,460764,2015-06-16,Senate,"Be adopted",6,0,1,0,7
737578,465208,2015-07-06,Senate,"Special Consent #4 AJR9 Chang",39,0,1,0,40
737580,432740,2015-04-14,Senate,"Do pass, but re-refer to the Committee on Appropriations",9,0,2,0,11
737580,447681,2015-05-18,Senate,"Senate 3rd Reading SB462 Wolk Urgency Clause",36,0,3,0,39
737580,465697,2015-07-08,Assembly,"Do pass and be re-referred to the Committee on Appropriations",19,0,0,2,21
737580,473870,2015-08-19,Assembly,"Do pass, to Consent Calendar",17,0,0,0,17
737580,475372,2015-08-31,Assembly,"SB 462 Wolk  Third Reading Urgency  By DODD",79,0,0,1,80
737580,475419,2015-09-01,Senate,"Unfinished Business SB462 Wolk Urgency Clause",40,0,0,0,40
737581,437045,2015-04-21,Assembly,"Do pass and be re-referred to the Committee on Appropriations",19,0,0,0,19
737581,453683,2015-05-28,Assembly,"Do pass",17,0,0,0,17
737581,456080,2015-06-02,Assembly,"AB 741 WILLIAMS  Assembly Third Reading",77,0,0,3,80
737581,552913,2016-06-14,Senate,"Do pass as amended, and re-refer to the Committee on Rules",4,0,1,0,5
737581,556893,2016-06-29,Senate,"Do pass, but re-refer to the Committee on Appropriations Recommend 	Consent",8,0,1,0,9
737581,558830,2016-08-01,Senate,"Placed on Appropriations Suspense file",7,0,0,0,7
737581,559607,2016-08-11,Senate,"Do pass as amended",7,0,0,0,7
737581,561090,2016-08-24,Senate,"Assembly 3rd Reading AB741 Williams By McGuire",38,0,1,0,39
737581,561665,2016-08-30,Assembly,"AB 741 WILLIAMS  Concurrence in Senate Amendments",79,1,0,0,80
737582,442439,2015-04-29,Assembly,"Do pass and be re-referred to the Committee on Appropriations",2,4,0,1,7
737582,463681,2015-04-29,Assembly,"Reconsideration granted",7,0,0,0,7
737584,428475,2015-04-08,Senate,"Do pass as amended, but re-refer to the Committee on Appropriations 	Recommend Consent",8,0,0,0,8
737584,445129,2015-05-11,Senate,"Consent Calendar 2nd SB418 Morrell",36,0,3,0,39
737584,462117,2015-06-23,Assembly,"Do pass and be re-referred to the Committee on Appropriations",12,0,0,1,13
737584,465625,2015-07-08,Assembly,"Do pass, to Consent Calendar",14,0,0,3,17
737584,466498,2015-07-16,Assembly,"SB 418 Morrell  Consent Calendar Second Day  Regular Session",79,0,0,1,80
737586,441975,2015-04-28,Assembly,"Do pass and be re-referred to the Committee on Appropriations",7,0,0,0,7
737588,430572,2015-04-13,Assembly,"From committee:  Be adopted.  To third reading",11,0,0,0,11
737588,442182,2015-04-30,Senate,"Assembly 3rd Reading ACR34 Cooper By Galgiani",33,0,6,0,39
737590,432942,2015-04-14,Assembly,"Do pass and be re-referred to the Committee on Appropriations to 	Consent Calendar",14,0,0,0,14
737590,441236,2015-04-29,Assembly,"Amend, and re-refer to the Committee on Appropriations",17,0,0,0,17
737590,444494,2015-05-07,Assembly,"Do pass as amended and be re-referred to the Committee on 	Appropriations",14,0,0,0,14
737590,448937,2015-05-20,Assembly,"Do pass, to Consent Calendar",15,0,0,2,17
737590,452009,2015-05-26,Assembly,"AB 684 ALEJO  Consent Calendar Second Day  Regular Session",76,0,0,4,80
737590,465467,2015-07-06,Senate,"Do pass, but re-refer to the Committee on Appropriations",7,0,2,0,9
737590,474080,2015-08-24,Senate,"Placed on Appropriations Suspense file",7,0,0,0,7
737590,474546,2015-08-27,Senate,"Do pass as amended, and re-refer to the Committee on Rules",5,0,2,0,7
737590,476331,2015-09-10,Senate,"Do pass",8,0,1,0,9
737590,476633,2015-09-11,Senate,"Assembly 3rd Reading AB684 Alejo By Hernandez",39,0,1,0,40
737590,476634,2015-09-11,Assembly,"AB 684 ALEJO  Concurrence in Senate Amendments",78,0,0,2,80
737592,428406,2015-04-07,Assembly,"Do pass as amended and be re-referred to the Committee on 	Appropriations",12,0,0,1,13
737592,454012,2015-05-28,Assembly,"Do pass as amended",17,0,0,0,17
737592,456070,2015-06-02,Assembly,"AB 721 MEDINA  Assembly Third Reading",78,0,0,2,80
737592,464757,2015-07-01,Senate,"Do pass, but re-refer to the Committee on Appropriations",7,0,2,0,9
737592,474126,2015-08-24,Senate,"Assembly 3rd Reading AB721 Medina By Block",40,0,0,0,40
737592,474424,2015-08-27,Assembly,"AB 721 MEDINA  Concurrence in Senate Amendments",77,0,0,3,80
737593,484752,2016-01-12,Assembly,"Do pass and be re-referred to the Committee on Appropriations",12,0,0,1,13
737593,485147,2016-01-05,Assembly,"Do pass and be re-referred to the Committee on Education",6,0,0,1,7
737593,486434,2016-01-21,Assembly,"Do pass, to Consent Calendar",17,0,0,0,17
737593,488486,2016-01-27,Assembly,"AB 735 RIDLEY-THOMAS  Consent Calendar Second Day  Regular Session",78,0,0,1,79
737593,556638,2016-06-29,Senate,"Do pass, but re-refer to the Committee on Appropriations Recommend 	Consent",9,0,0,0,9
737593,559388,2016-08-11,Senate,"Consent Calendar 2nd AB735 Ridley-Thomas",37,0,2,0,39
737594,440628,2015-04-28,Assembly,"Do pass as amended and be re-referred to the Committee on 	Appropriations",14,0,0,0,14
737594,446205,2015-05-13,Assembly,"Do pass, to Consent Calendar",17,0,0,0,17
737594,450273,2015-05-22,Assembly,"AB 757 GOMEZ  Consent Calendar Second Day  Regular Session",74,0,0,6,80
737594,464313,2015-06-29,Senate,"Do pass, but re-refer to the Committee on Appropriations",8,0,1,0,9
737594,474062,2015-08-24,Senate,"Assembly 3rd Reading AB757 Gomez By Hernandez",39,0,1,0,40
737594,475319,2015-08-31,Assembly,"AB 757 GOMEZ  Concurrence in Senate Amendments",80,0,0,0,80
737597,430627,2015-04-09,Assembly,"Be referred to Committee on Insurance",11,0,0,0,11
737602,441183,2015-04-29,Senate,"Do pass, but re-refer to the Committee on Appropriations Recommend 	Consent",7,0,2,0,9
737602,453795,2015-05-28,Senate,"Do pass",7,0,0,0,7
737602,455920,2015-06-02,Senate,"Senate 3rd Reading SB425 Hernandez Urgency Clause",39,0,1,0,40
737602,463600,2015-05-18,Senate,"Placed on Appropriations Suspense file",7,0,0,0,7
737602,550355,2016-06-01,Assembly,"Be referred to Committee on Transportation",11,0,0,0,11
737602,555535,2016-06-27,Assembly,"Do pass and be re-referred to the Committee on Appropriations to 	Consent Calendar",15,0,0,1,16
737602,559339,2016-08-11,Assembly,"Do pass",20,0,0,0,20
737602,560200,2016-08-18,Assembly,"SB 425 Hernandez  Senate Third Reading  By CHAU",79,0,0,1,80
737602,560913,2016-08-24,Senate,"From committee:  That the Assembly Amendments be concurred in",11,0,0,0,11
737602,561373,2016-08-29,Senate,"Unfinished Business SB425 Hernandez Concurrence",38,0,1,0,39
737603,443844,2015-05-06,Assembly,"Do pass as amended",9,0,0,0,9
737603,450191,2015-05-22,Assembly,"AB 738 GAINES  Assembly Third Reading",75,0,0,5,80
737603,466098,2015-07-14,Senate,"Do pass as amended",11,0,0,0,11
737603,474166,2015-08-24,Senate,"Assembly 3rd Reading AB738 Beth Gaines By Gaines",40,0,0,0,40
737603,474464,2015-08-27,Assembly,"AB 738 GAINES  Concurrence in Senate Amendments",78,0,0,2,80
737604,437342,2015-04-21,Assembly,"Do pass and be re-referred to the Committee on Appropriations to 	Consent Calendar",18,0,0,1,19
737604,441301,2015-04-29,Assembly,"Do pass",17,0,0,0,17
737604,442949,2015-05-04,Assembly,"AB 745 CHAU  Assembly Third Reading",78,0,0,2,80
737604,458781,2015-06-10,Senate,"Do pass, but re-refer to the Committee on Appropriations Recommend 	Consent",9,0,0,0,9
737604,463027,2015-06-25,Senate,"Consent Calendar 2nd AB745 Chau",37,0,3,0,40
737604,475516,2015-09-01,Senate,"Assembly 3rd Reading AB745 Chau By Hernandez",40,0,0,0,40
737604,475699,2015-09-02,Assembly,"AB 745 CHAU  Concurrence in Senate Amendments",79,0,0,1,80
737605,442438,2015-04-29,Assembly,"Do pass as amended and be re-referred to the Committee on 	Appropriations",5,2,0,0,7
737605,454156,2015-05-28,Assembly,"Do pass as amended",12,0,0,5,17
737607,427825,2015-04-07,Assembly,"Do pass and be re-referred to the Committee on Appropriations",11,0,0,0,11
737607,453682,2015-05-28,Assembly,"Do pass",17,0,0,0,17
737607,455959,2015-06-02,Assembly,"AB 670 IRWIN  Assembly Third Reading",79,0,0,1,80
737607,463956,2015-06-29,Senate,"Do pass, but re-refer to the Committee on Judiciary",12,0,1,0,13
737607,473712,2015-08-17,Senate,"Placed on Appropriations Suspense file",7,0,0,0,7
737607,474515,2015-08-27,Senate,"Do pass",6,0,1,0,7
737607,475970,2015-09-08,Senate,"Assembly 3rd Reading AB670 Irwin By Hill",39,0,1,0,40
737607,476129,2015-09-09,Assembly,"AB 670 IRWIN  Concurrence in Senate Amendments",79,0,0,1,80
737608,429001,2015-04-08,Senate,"Do pass",5,0,0,0,5
737608,442168,2015-04-30,Senate,"Senate 3rd Reading SB432 Mendoza",35,0,4,0,39
737608,463240,2015-06-24,Assembly,"Do pass",6,1,0,0,7
737608,465812,2015-07-09,Assembly,"SB 432 Mendoza  Senate Third Reading  By ALEJO",70,1,0,9,80
737609,427271,2015-04-06,Assembly,"From committee:  Be adopted.  To third reading",11,0,0,1,12
737609,438393,2015-04-23,Senate,"Assembly 3rd Reading ACR32 Bloom By McGuire",37,0,2,0,39
737609,439362,2015-04-27,Assembly,"ACR 32 BLOOM  Concurrence in Senate Amendments",79,0,0,1,80
737611,437397,2015-04-21,Senate,"Do pass as amended",7,0,0,0,7
737611,442860,2015-05-04,Senate,"Senate 3rd Reading SB420 Huff",36,0,3,0,39
737611,460301,2015-06-16,Assembly,"Subject matter be referred",7,0,0,0,7
737611,552927,2016-06-14,Assembly,"Do pass",5,0,0,2,7
737611,555782,2016-06-27,Assembly,"SB 420 Huff  Senate Third Reading  By GARCIA, C",74,0,0,6,80
737611,561501,2016-08-29,Assembly,"SB 420 Huff  Senate Third Reading  By GARCIA, C",79,0,0,1,80
737611,561707,2016-08-31,Senate,"Unfinished Business SB420 Huff Concurrence",39,0,0,0,39
737613,427880,2015-04-07,Assembly,"Do pass",6,0,0,1,7
737613,433878,2015-04-16,Assembly,"AB 696 JONES-SAWYER  Assembly Third Reading",60,16,0,4,80
737613,460264,2015-06-16,Senate,"Do pass, but re-refer to the Committee on Rules",4,3,0,0,7
737613,465167,2015-07-06,Senate,"Placed on Appropriations Suspense file",7,0,0,0,7
737613,474719,2015-08-27,Senate,"Do pass as amended",5,2,0,0,7
737613,475737,2015-09-03,Senate,"Assembly 3rd Reading AB696 Jones-Sawyer By Hertzberg",23,13,4,0,40
737613,476045,2015-09-08,Assembly,"AB 696 JONES-SAWYER  Concurrence in Senate Amendments",61,17,0,2,80
739268,440179,2015-04-28,Senate,"Do pass as amended, and re-refer to the Committee on Appropriations",7,0,0,0,7
739268,454086,2015-05-28,Senate,"Do pass as amended",7,0,0,0,7
739268,457254,2015-06-04,Senate,"Senate 3rd Reading SB507 Pavley",40,0,0,0,40
739268,463686,2015-05-18,Senate,"Placed on Appropriations Suspense file",7,0,0,0,7
739268,466171,2015-07-14,Assembly,"Do pass and be re-referred to the Committee on Appropriations",7,0,0,0,7
739268,474422,2015-08-27,Assembly,"Do pass",17,0,0,0,17
739268,476442,2015-09-10,Assembly,"SB 507 Pavley  Senate Third Reading  By COOLEY",79,1,0,0,80
739268,476607,2015-09-11,Senate,"Unfinished Business SB507 Pavley Concurrence",40,0,0,0,40
739270,441123,2015-04-29,Assembly,"Do pass as amended and be re-referred to the Committee on 	Appropriations",6,0,0,1,7
739270,453057,2015-05-27,Assembly,"Do pass, to Consent Calendar",17,0,0,0,17
739270,456003,2015-06-02,Assembly,"AB 1056 ATKINS  Consent Calendar Second Day  Regular Session",78,0,0,2,80
739270,464261,2015-06-30,Senate,"Do pass, but re-refer to the Committee on Appropriations",6,0,1,0,7
739270,465896,2015-07-13,Senate,"Placed on Appropriations Suspense file",7,0,0,0,7
739270,474531,2015-08-27,Senate,"Do pass as amended",7,0,0,0,7
739270,475393,2015-09-01,Senate,"Assembly 3rd Reading AB1056 Atkins By Hancock",40,0,0,0,40
739270,475616,2015-09-02,Assembly,"AB 1056 ATKINS  Concurrence in Senate Amendments",80,0,0,0,80
739271,437224,2015-04-21,Assembly,"Do pass as amended and be re-referred to the Committee on 	Appropriations",13,0,0,0,13
739271,453950,2015-05-28,Assembly,"Do pass as amended",14,0,0,3,17
739271,456693,2015-06-03,Assembly,"AB 967 WILLIAMS  Assembly Third Reading",71,4,0,5,80
739271,465656,2015-07-08,Senate,"Do pass as amended, and re-refer to the Committee on Appropriations",8,0,1,0,9
739271,473709,2015-08-17,Senate,"Placed on Appropriations Suspense file",7,0,0,0,7
739271,474641,2015-08-27,Senate,"Do pass",6,1,0,0,7
739271,475947,2015-09-08,Senate,"Assembly 3rd Reading AB967 Williams By Leyva",37,1,2,0,40
739271,476135,2015-09-09,Assembly,"AB 967 WILLIAMS  Concurrence in Senate Amendments",68,4,0,8,80
739273,441076,2015-04-28,Assembly,"Do pass and be re-referred to the Committee on Appropriations",8,1,0,0,9
739273,449059,2015-05-20,Assembly,"Do pass",15,0,0,2,17
739273,452037,2015-05-26,Assembly,"AB 1029 FRAZIER  Assembly Third Reading",76,0,0,4,80
739273,462283,2015-06-23,Senate,"Do pass, but re-refer to the Committee on Appropriations",5,0,0,0,5
739273,558750,2016-08-01,Senate,"Placed on Appropriations Suspense file",7,0,0,0,7
739275,436410,2015-04-21,Assembly,"Do pass",5,2,0,0,7
739275,447711,2015-05-18,Assembly,"AB 813 GONZALEZ  Assembly Third Reading",65,11,0,4,80
739275,544370,2016-05-10,Senate,"Do pass, but re-refer to the Committee on Rules",5,2,0,0,7
739275,554422,2016-06-20,Senate,"Placed on Appropriations Suspense file",7,0,0,0,7
739275,559597,2016-08-11,Senate,"Do pass",5,2,0,0,7
739275,559928,2016-08-16,Senate,"Assembly 3rd Reading AB813 Gonzalez By Leno",26,11,2,0,39
739275,561395,2016-08-29,Assembly,"AB 813 GONZALEZ  Concurrence in Senate Amendments",59,14,0,7,80
739275,561704,2016-08-31,Assembly,"AB 813 GONZALEZ  Concurrence in Senate Amendments",61,15,0,4,80
739279,437177,2015-04-21,Assembly,"Do pass as amended and be re-referred to the Committee on 	Appropriations",12,0,0,1,13
739279,443859,2015-05-06,Assembly,"Do pass",15,2,0,0,17
739279,447644,2015-05-18,Assembly,"AB 969 WILLIAMS  Assembly Third Reading",59,11,0,10,80
739279,460678,2015-06-17,Senate,"Do pass as amended, and re-refer to the Committee on Appropriations",8,0,1,0,9
739279,465166,2015-07-06,Senate,"Do pass",7,0,0,0,7
739279,473970,2015-08-20,Senate,"Assembly 3rd Reading AB969 Williams By Jackson",35,0,5,0,40
739279,474073,2015-08-24,Assembly,"AB 969 WILLIAMS  Concurrence in Senate Amendments",65,5,0,10,80
739279,559832,2016-08-15,Senate,"Assembly 3rd Reading AB969 Williams By Leyva",37,0,2,0,39
739279,560474,2016-08-22,Assembly,"AB 969 WILLIAMS  Concurrence in Senate Amendments",79,0,0,1,80
739280,440389,2015-04-28,Senate,"Do pass as amended, and re-refer to the Committee on Appropriations",11,0,0,0,11
739280,454414,2015-05-28,Senate,"Senate 3rd Reading SB516 Fuller",35,1,4,0,40
739280,463874,2015-06-29,Assembly,"Do pass as amended and be re-referred to the Committee on 	Appropriations",16,0,0,0,16
739280,465562,2015-07-08,Assembly,"Do pass, to Consent Calendar",14,0,0,3,17
739280,466470,2015-07-16,Assembly,"SB 516 Fuller  Consent Calendar Second Day  Regular Session",79,0,0,1,80
739280,474428,2015-08-27,Assembly,"SB 516 Fuller  Senate Third Reading  By GROVE",79,0,0,1,80
739280,475344,2015-08-31,Senate,"Unfinished Business SB516 Fuller Concurrence",37,1,2,0,40
739282,485059,2016-01-13,Senate,"Do pass, but re-refer to the Committee on Appropriations",8,0,1,0,9
739282,486993,2016-01-25,Senate,"Senate 3rd Reading SB488 Block",38,0,2,0,40
739282,554935,2016-06-22,Assembly,"Do pass and be re-referred to the Committee on Appropriations to 	Consent Calendar",13,0,0,0,13
739282,556277,2016-06-29,Assembly,"Do pass, to Consent Calendar",18,0,0,2,20
739282,560363,2016-08-19,Assembly,"SB 488 Block  Senate Third Reading  By HEALTH  Amendment  Set #1",73,0,0,7,80
739282,560500,2016-08-22,Assembly,"SB 488 Block  Senate Third Reading  By COOLEY",79,0,0,1,80
739282,561422,2016-08-29,Senate,"Special Consent SB488 Block",39,0,0,0,39
739284,437384,2015-04-22,Senate,"Do pass as amended, and re-refer to the Committee on Appropriations",7,0,0,0,7
739284,453901,2015-05-28,Senate,"Do pass",7,0,0,0,7
739284,455392,2015-06-01,Senate,"Senate 3rd Reading SB477 Leyva",40,0,0,0,40
739284,463664,2015-05-18,Senate,"Placed on Appropriations Suspense file",7,0,0,0,7
739284,464827,2015-07-01,Assembly,"Do pass and be re-referred to the Committee on Revenue and Taxation",7,0,0,2,9
739284,466032,2015-07-13,Assembly,"Do pass as amended and be re-referred to the Committee on 	Appropriations",9,0,0,0,9
739285,433346,2015-04-14,Assembly,"Do pass and be re-referred to the Committee on Appropriations",7,0,0,0,7
739285,441165,2015-04-29,Assembly,"Do pass",17,0,0,0,17
739285,442838,2015-05-04,Assembly,"AB 1059 GARCIA, E.  Assembly Third Reading",76,0,0,4,80
739285,460715,2015-06-17,Senate,"Do pass as amended, and re-refer to the Committee on Appropriations",7,0,0,0,7
739285,473987,2015-08-20,Senate,"Assembly 3rd Reading AB1059 Eduardo Garcia By Leno",38,0,2,0,40
739285,475252,2015-08-31,Senate,"Assembly 3rd Reading AB1059 Eduardo Garcia By Leno",40,0,0,0,40
739285,475431,2015-09-01,Assembly,"AB 1059 GARCIA, E.  Concurrence in Senate Amendments",78,0,0,2,80
739286,436349,2015-04-21,Assembly,"Do pass and be re-referred to the Committee on Appropriations",14,0,0,0,14
739286,441117,2015-04-29,Assembly,"Do pass, to Consent Calendar",17,0,0,0,17
739286,444483,2015-05-07,Assembly,"AB 873 JONES  Consent Calendar Second Day  Regular Session",77,0,0,3,80
739286,555528,2016-06-27,Senate,"Do pass, but re-refer to the Committee on Appropriations",9,0,0,0,9
739286,558714,2016-08-01,Senate,"Placed on Appropriations Suspense file",7,0,0,0,7
739286,559584,2016-08-11,Senate,"Do pass",7,0,0,0,7
739286,560921,2016-08-24,Senate,"Assembly 3rd Reading AB873 Jones By Hill",39,0,0,0,39
739286,561578,2016-08-30,Assembly,"AB 873 JONES  Concurrence in Senate Amendments",79,0,0,1,80
739289,440095,2015-04-28,Senate,"Do pass as amended, and re-refer to the Committee on Appropriations",7,0,0,0,7
739289,450095,2015-05-22,Senate,"Senate 3rd Reading SB510 Hall",39,0,0,0,39
739289,465902,2015-07-13,Assembly,"Do pass as amended and be re-referred to the Committee on 	Appropriations",16,0,0,0,16
739289,473871,2015-08-19,Assembly,"Do pass, to Consent Calendar",17,0,0,0,17
739289,474452,2015-08-27,Assembly,"SB 510 Hall  Consent Calendar Second Day  Regular Session",78,0,0,2,80
739289,475522,2015-09-01,Senate,"Special Consent #9 SB510 Hall",40,0,0,0,40
739290,453860,2015-05-28,Senate,"Do pass as amended",7,0,0,0,7
739290,455899,2015-06-02,Senate,"Senate 3rd Reading SB478 Huff",40,0,0,0,40
739290,458724,2015-04-14,Senate,"Do pass, but re-refer to the Committee on Appropriations",6,0,0,1,7
739290,463702,2015-04-27,Senate,"Placed on Appropriations Suspense file",7,0,0,0,7
739290,466358,2015-07-14,Assembly,"Amend, and do pass as amended and be re-referred to the Committee 	on Appropriations with the recommendation:  To Consent Calendar",7,0,0,0,7
739290,474230,2015-08-26,Assembly,"Do pass as amended, to Consent Calendar",17,0,0,0,17
739290,475693,2015-09-02,Assembly,"SB 478 Huff  Consent Calendar Second Day  Regular Session",79,0,0,1,80
739290,475809,2015-09-03,Senate,"Unfinished Business SB478 Huff Concurrence",39,0,1,0,40
739291,440964,2015-04-28,Senate,"Do pass as amended",4,0,1,0,5
739291,446627,2015-05-14,Senate,"Senate 3rd Reading SB475 Monning",31,4,4,0,39
739291,464326,2015-06-30,Assembly,"Do pass as amended and be re-referred to the Committee on Aging and 	Long",5,2,0,0,7
739291,466289,2015-07-14,Assembly,"Do pass as amended",5,2,0,0,7
739291,474214,2015-08-26,Assembly,"Do pass",12,5,0,0,17
739291,475987,2015-09-08,Assembly,"SB 475 Monning  Senate Third Reading  By BROWN",53,26,0,1,80
739291,476362,2015-09-10,Senate,"Unfinished Business SB475 Monning Concurrence",38,0,2,0,40
739294,443916,2015-05-06,Senate,"Do pass, but re-refer to the Committee on Appropriations",6,1,0,0,7
739294,463622,2015-05-18,Senate,"Placed on Appropriations Suspense file",7,0,0,0,7
739296,432226,2015-04-13,Assembly,"Do pass and be re-referred to the Committee on Judiciary",14,0,0,1,15
739296,440221,2015-04-28,Assembly,"Do pass and be re-referred to the Committee on Appropriations",10,0,0,0,10
739296,453871,2015-05-28,Assembly,"Do pass as amended",17,0,0,0,17
739296,456698,2015-06-03,Assembly,"AB 825 RENDON  Assembly Third Reading",79,0,0,1,80
739296,465528,2015-07-07,Senate,"Do pass, but re-refer to the Committee on Judiciary",11,0,0,0,11
739296,473626,2015-08-17,Senate,"Placed on Appropriations Suspense file",7,0,0,0,7
739296,474503,2015-08-27,Senate,"Do pass as amended",5,0,2,0,7
739296,476276,2015-09-10,Senate,"Assembly 3rd Reading AB825 Rendon By Hill",40,0,0,0,40
739296,476551,2015-09-11,Assembly,"AB 825 RENDON  Concurrence in Senate Amendments",79,0,0,1,80
739298,432730,2015-04-14,Assembly,"Do pass and be re-referred to the Committee on Appropriations to 	Consent Calendar",14,0,0,0,14
739298,440927,2015-04-29,Assembly,"Do pass, to Consent Calendar",17,0,0,0,17
739298,444456,2015-05-07,Assembly,"AB 1060 BONILLA  Consent Calendar Second Day  Regular Session",77,0,0,3,80
739298,468154,2015-07-15,Senate,"Do pass as amended, and re-refer to the Committee on Appropriations",9,0,0,0,9
739298,473787,2015-08-17,Senate,"Placed on Appropriations Suspense file",7,0,0,0,7
739298,474707,2015-08-27,Senate,"Do pass as amended",7,0,0,0,7
739298,475767,2015-09-03,Senate,"Assembly 3rd Reading AB1060 Bonilla By Pan",39,0,1,0,40
739298,476104,2015-09-09,Assembly,"Senate amendments be concurred in",17,1,0,1,19
739298,476250,2015-09-10,Assembly,"AB 1060 BONILLA  Concurrence in Senate Amendments",72,6,0,2,80
739300,432619,2015-04-14,Assembly,"Do pass and be re-referred to the Committee on Appropriations to 	Consent Calendar",14,0,0,0,14
739300,437317,2015-04-22,Assembly,"Do pass, to Consent Calendar",17,0,0,0,17
739300,442125,2015-04-30,Assembly,"AB 905 GAINES  Consent Calendar Second Day  Regular Session",77,0,0,3,80
739300,458855,2015-06-09,Senate,"Do pass, but re-refer to the Committee on Appropriations Recommend 	Consent",7,0,0,0,7
739300,462994,2015-06-25,Senate,"Consent Calendar 2nd AB905 Beth Gaines",37,0,3,0,40
739301,437123,2015-04-22,Senate,"Do pass as amended, and re-refer to the Committee on Appropriations",8,0,1,0,9
739301,445223,2015-05-11,Senate,"Placed on Appropriations Suspense file",7,0,0,0,7
739301,453644,2015-05-28,Senate,"Do pass",7,0,0,0,7
739301,455329,2015-06-01,Senate,"Senate 3rd Reading SB586 Hernandez",40,0,0,0,40
739301,556321,2016-06-28,Assembly,"Do pass as amended and be re-referred to the Committee on 	Appropriations",18,0,0,0,18
739301,559227,2016-08-11,Assembly,"Do pass",20,0,0,0,20
739301,560398,2016-08-19,Assembly,"SB 586 Hernandez  Senate Third Reading  ByA& A.R.  Amendment  Set #1",73,0,0,7,80
739301,560706,2016-08-23,Assembly,"SB 586 Hernandez  Senate Third Reading  By WOOD",80,0,0,0,80
739301,561179,2016-08-25,Senate,"From committee:  That the Assembly Amendments be concurred in",9,0,0,0,9
739301,561369,2016-08-29,Senate,"Unfinished Business SB586 Hernandez Concurrence",39,0,0,0,39
739302,427935,2015-04-07,Assembly,"Do pass as amended",9,0,0,1,10
739302,434011,2015-04-16,Assembly,"AB 899 LEVINE  Assembly Third Reading",76,1,0,3,80
739302,462394,2015-06-23,Senate,"Do pass",5,2,0,0,7
739302,473808,2015-08-17,Senate,"Assembly 3rd Reading AB899 Levine By Glazer",32,6,2,0,40
739303,432565,2015-04-14,Senate,"Do pass as amended, and re-refer to the Committee on Appropriations",8,0,1,0,9
739303,454130,2015-05-28,Senate,"Do pass",7,0,0,0,7
739303,455367,2015-06-01,Senate,"Senate 3rd Reading SB555 Wolk",36,2,2,0,40
739303,463687,2015-04-27,Senate,"Placed on Appropriations Suspense file",7,0,0,0,7
739303,466357,2015-07-14,Assembly,"Do pass as amended and be re-referred to the Committee on 	Appropriations",10,3,0,2,15
739303,474456,2015-08-27,Assembly,"Do pass",12,4,0,1,17
739303,475741,2015-09-03,Assembly,"SB 555 Wolk  Senate Third Reading  By CHU",71,5,0,4,80
739303,475876,2015-09-04,Senate,"Unfinished Business SB555 Wolk Concurrence",40,0,0,0,40
739306,442133,2015-04-30,Assembly,"Do pass as amended and be re-referred to the Committee on 	Appropriations",7,1,0,3,11
739306,448938,2015-05-20,Assembly,"Do pass",11,4,0,2,17
739306,456616,2015-06-03,Assembly,"AB 964 CHAU  Assembly Third Reading",69,7,0,4,80
739306,465651,2015-07-07,Senate,"Do pass",5,1,1,0,7
739306,475391,2015-09-01,Senate,"Assembly 3rd Reading AB964 Chau By Jackson",26,11,3,0,40
739306,475392,2015-09-01,Senate,"Assembly 3rd Reading AB964 Chau By Jackson",37,0,3,0,40
739306,475792,2015-09-03,Senate,"Assembly 3rd Reading AB964 Chau By Jackson",27,11,2,0,40
739306,475961,2015-09-08,Assembly,"AB 964 CHAU  Concurrence in Senate Amendments",63,11,0,6,80
739308,439450,2015-04-27,Senate,"Do pass as amended, and re-refer to the Committee on Appropriations",10,0,1,0,11
739308,451686,2015-05-26,Senate,"Placed on Appropriations Suspense file",7,0,0,0,7
739308,454019,2015-05-28,Senate,"Do pass as amended",7,0,0,0,7
739308,456824,2015-06-03,Senate,"Senate 3rd Reading SB541 Hill",40,0,0,0,40
739308,463895,2015-06-29,Assembly,"Do pass and be re-referred to the Committee on Public Safety",14,0,0,1,15
739308,465972,2015-07-14,Assembly,"Amend, and do pass as amended and be re-referred to the Committee 	on Appropriations with the recommendation:  To Consent Calendar",7,0,0,0,7
739308,474281,2015-08-27,Assembly,"Do pass as amended",17,0,0,0,17
739308,475923,2015-09-08,Assembly,"SB 541 Hill  Senate Third Reading  By RENDON",79,0,0,1,80
739308,476342,2015-09-10,Senate,"Unfinished Business SB541 Hill Concurrence",39,0,1,0,40
739309,437143,2015-04-22,Senate,"Do pass, but re-refer to the Committee on Appropriations",6,1,0,0,7
739309,447770,2015-05-18,Senate,"Senate 3rd Reading SB533 Pan",25,11,3,0,39
739309,466110,2015-07-13,Assembly,"Do pass and be re-referred to the Committee on Appropriations",5,3,0,1,9
739309,473891,2015-07-01,Assembly,"Do pass as amended and be re-referred to the Committee on Revenue 	and Taxation",9,0,0,0,9
739309,473892,2015-08-19,Assembly,"Do pass",12,4,0,1,17
739309,475383,2015-08-31,Assembly,"SB 533 Pan  Senate Third Reading  By MCCARTY",55,22,0,3,80
739309,476280,2015-09-10,Senate,"Unfinished Business SB533 Pan Concurrence",28,12,0,0,40
739311,429375,2015-04-08,Assembly,"Do pass",7,0,0,0,7
739311,433949,2015-04-16,Assembly,"AB 881 GARCIA, C.  Assembly Third Reading",78,0,0,2,80
739311,458907,2015-06-10,Senate,"Do pass",8,0,1,0,9
739311,463031,2015-06-25,Senate,"Assembly 3rd Reading AB881 Cristina Garcia By Liu",38,0,2,0,40
739312,431707,2015-04-13,Senate,"Do pass, but re-refer to the Committee on Appropriations Recommend 	Consent",9,0,0,0,9
739312,442388,2015-04-30,Senate,"Consent Calendar 2nd SB525 Nielsen",34,0,5,0,39
739312,462137,2015-06-23,Assembly,"Do pass and be re-referred to the Committee on Appropriations",14,0,0,0,14
739312,465666,2015-07-08,Assembly,"Do pass, to Consent Calendar",14,0,0,3,17
739312,466511,2015-07-16,Assembly,"SB 525 Nielsen  Consent Calendar Second Day  Regular Session",79,0,0,1,80
739312,473978,2015-08-20,Senate,"Special Consent #6 SB525 Nielsen",38,0,2,0,40
739314,446527,2015-05-13,Assembly,"Do pass, to Consent Calendar",7,0,0,0,7
739314,450188,2015-05-22,Assembly,"AB 1020 RIDLEY-THOMAS  Consent Calendar Second Day  Regular Session",74,0,0,6,80
739314,465358,2015-07-07,Senate,"Do pass, but re-refer to the Committee on Appropriations",4,0,1,0,5
739314,475771,2015-09-03,Senate,"Assembly 3rd Reading AB1020 Ridley-Thomas By Allen",38,1,1,0,40
739314,476124,2015-09-09,Assembly,"Senate amendments be concurred in",5,1,0,1,7
739314,476423,2015-09-10,Assembly,"AB 1020 RIDLEY-THOMAS  Concurrence in Senate Amendments",70,7,0,3,80
739316,437236,2015-04-22,Assembly,"Do pass and be re-referred to the Committee on Appropriations",6,1,0,0,7
739316,454293,2015-05-28,Assembly,"Do pass",12,5,0,0,17
739316,456025,2015-06-02,Assembly,"AB 874 RENDON  Assembly Third Reading",52,25,0,3,80
739316,538057,2016-04-25,Senate,"Do pass, but re-refer to the Committee on Judiciary",3,2,0,0,5
739316,555010,2016-06-21,Senate,"Do pass, but re-refer to the Committee on Appropriations",5,2,0,0,7
739316,558968,2016-08-01,Senate,"Placed on Appropriations Suspense file",7,0,0,0,7
739316,559758,2016-08-11,Senate,"Do pass as amended",5,2,0,0,7
739316,560256,2016-08-18,Senate,"Assembly 3rd Reading AB874 Santiago By Jackson",25,12,2,0,39
739316,561052,2016-08-24,Assembly,"AB 874 SANTIAGO  Concurrence in Senate Amendments",52,26,0,2,80
739318,440219,2015-04-28,Senate,"Do pass, but re-refer to the Committee on Appropriations",8,0,3,0,11
739318,445209,2015-05-11,Senate,"Placed on Appropriations Suspense file",7,0,0,0,7
739319,427874,2015-04-07,Assembly,"Do pass and be re-referred to the Committee on Appropriations",5,2,0,0,7
739321,436592,2015-04-20,Assembly,"Do pass and be re-referred to the Committee on Appropriations",14,0,0,1,15
739321,454248,2015-05-28,Assembly,"Do pass",17,0,0,0,17
739321,455359,2015-06-01,Assembly,"AB 1013 QUIRK  Assembly Third Reading",79,0,0,1,80
739321,460172,2015-06-16,Senate,"Do pass as amended, and re-refer to the Committee on Appropriations",10,0,1,0,11
739321,465206,2015-07-06,Senate,"Placed on Appropriations Suspense file",7,0,0,0,7
739322,442189,2015-04-29,Assembly,"Subject matter be referred",4,3,0,0,7
739323,429418,2015-04-08,Assembly,"Do pass and be re-referred to the Committee on Appropriations",6,0,0,1,7
739323,437156,2015-04-22,Assembly,"Do pass",17,0,0,0,17
739323,439386,2015-04-27,Assembly,"AB 987 LEVINE  Assembly Third Reading",76,0,0,4,80
739323,458643,2015-06-09,Senate,"Do pass, but re-refer to the Committee on Appropriations",7,0,0,0,7
739323,463876,2015-06-29,Senate,"Assembly 3rd Reading AB987 Levine By Moorlach",39,0,1,0,40
739323,464885,2015-07-02,Assembly,"AB 987 LEVINE  Concurrence in Senate Amendments",74,0,0,6,80
739324,484756,2016-01-12,Assembly,"Do pass and be re-referred to the Committee on Appropriations",6,10,0,3,19
739328,440674,2015-04-27,Assembly,"Do pass and be re-referred to the Committee on Appropriations to 	Consent Calendar",9,0,0,0,9
739328,443956,2015-05-06,Assembly,"Do pass, to Consent Calendar",17,0,0,0,17
739328,446683,2015-05-14,Assembly,"AB 824 GATTO  Consent Calendar Second Day  Regular Session",78,0,0,2,80
739328,465984,2015-07-14,Senate,"Do pass as amended, but re-refer to the Committee on Appropriations 	Recommend Consent",9,0,0,0,9
739328,473585,2015-08-17,Senate,"Placed on Appropriations Suspense file",7,0,0,0,7
739329,432499,2015-04-13,Assembly,"Do pass and be re-referred to the Committee on Insurance to Consent 	Calendar",16,0,0,0,16
739329,443614,2015-05-06,Assembly,"Do pass, to Consent Calendar",13,0,0,0,13
739329,446641,2015-05-14,Assembly,"AB 933 FRAZIER  Consent Calendar Second Day  Regular Session",78,0,0,2,80
739329,462595,2015-06-24,Senate,"Do pass as amended",8,0,1,0,9
739330,414945,2015-03-23,Assembly,"From committee:  Be adopted.  To third reading",10,0,0,1,11
739334,466094,2015-04-14,Assembly,"Amend, and do pass as amended and be re-referred to the Committee 	on Appropriations with the recommendation:  To Consent Calendar",7,0,0,0,7
739335,432644,2015-04-14,Assembly,"Do pass as amended and be re-referred to the Committee on Arts, 	Entertain, Sports, Tourism, & Internet Media",12,1,0,1,14
739335,440085,2015-04-28,Assembly,"Do pass and be re-referred to the Committee on Appropriations",5,2,0,0,7
739338,436020,2015-04-21,Assembly,"Do pass and be re-referred to the Committee on Appropriations",14,0,0,0,14
739338,453797,2015-05-28,Assembly,"Do pass",17,0,0,0,17
739338,455275,2015-06-01,Assembly,"AB 940 RIDLEY-THOMAS  Assembly Third Reading",79,0,0,1,80
739338,464325,2015-06-29,Senate,"Do pass as amended, and re-refer to the Committee on Appropriations",8,0,1,0,9
739338,475291,2015-08-31,Senate,"Assembly 3rd Reading AB940 Ridley-Thomas By Bates",40,0,0,0,40
739338,475559,2015-09-02,Assembly,"AB 940 RIDLEY-THOMAS  Concurrence in Senate Amendments",80,0,0,0,80
739339,438407,2015-04-22,Assembly,"Do pass as amended and be re-referred to the Committee on 	Appropriations",6,0,0,1,7
739339,454180,2015-05-28,Assembly,"Do pass as amended",12,4,0,1,17
739339,456785,2015-06-03,Assembly,"AB 1014 THURMOND  Assembly Third Reading",56,24,0,0,80
739339,465575,2015-07-08,Senate,"Do pass, but re-refer to the Committee on Appropriations",7,1,1,0,9
739339,473682,2015-08-17,Senate,"Placed on Appropriations Suspense file",7,0,0,0,7
739339,474544,2015-08-27,Senate,"Do pass as amended",5,2,0,0,7
739339,556309,2016-06-29,Senate,"Do pass, but re-refer to the Committee on Appropriations",9,0,0,0,9
739339,558820,2016-08-01,Senate,"Placed on Appropriations Suspense file",7,0,0,0,7
739339,559759,2016-08-11,Senate,"Do pass as amended",6,0,1,0,7
739339,560393,2016-08-19,Senate,"Assembly 3rd Reading AB1014 Thurmond By Lara",36,0,3,0,39
739339,561024,2016-08-24,Assembly,"AB 1014 THURMOND  Concurrence in Senate Amendments",62,16,0,2,80
739341,440500,2015-04-28,Assembly,"Do pass as amended and be re-referred to the Committee on 	Appropriations",7,0,0,0,7
739341,446200,2015-05-13,Assembly,"Do pass, to Consent Calendar",17,0,0,0,17
739341,450243,2015-05-22,Assembly,"AB 849 BONILLA  Consent Calendar Second Day  Regular Session",74,0,0,6,80
739341,466404,2015-07-14,Senate,"Do pass as amended, and re-refer to the Committee on Appropriations",7,0,0,0,7
739341,473674,2015-08-17,Senate,"Placed on Appropriations Suspense file",7,0,0,0,7
739341,474553,2015-08-27,Senate,"Do pass as amended",7,0,0,0,7
739341,475398,2015-09-01,Senate,"Assembly 3rd Reading AB849 Bonilla By Bates",40,0,0,0,40
739341,475691,2015-09-02,Assembly,"AB 849 BONILLA  Concurrence in Senate Amendments",80,0,0,0,80
739343,428585,2015-04-08,Assembly,"Do pass and be re-referred to the Committee on Education",6,0,0,1,7
739343,440882,2015-04-28,Assembly,"Do pass and be re-referred to the Committee on Appropriations",10,3,0,0,13
739343,453824,2015-05-28,Assembly,"Do pass",12,5,0,0,17
739343,455938,2015-06-02,Assembly,"AB 1066 GONZALEZ  Assembly Third Reading",54,25,0,1,80
739343,556394,2016-06-29,Senate,"Do pass, but re-refer to the Committee on Appropriations",4,1,0,0,5
739343,558761,2016-08-01,Senate,"Placed on Appropriations Suspense file",7,0,0,0,7
739343,559580,2016-08-11,Senate,"Do pass",5,2,0,0,7
739343,560473,2016-08-22,Senate,"Assembly 3rd Reading AB1066 Gonzalez By De Le",21,14,4,0,39
739343,561383,2016-08-29,Assembly,"AB 1066 GONZALEZ  Concurrence in Senate Amendments Motion to 	Appeal the Decision  of the Chair  By WAGNER",26,49,0,5,80
739343,561384,2016-08-29,Assembly,"AB 1066 GONZALEZ  Concurrence in Senate Amendments Motion to 	Re-refer to Committee  By OBERNOLTE",30,47,0,3,80
739343,561385,2016-08-29,Assembly,"AB 1066 GONZALEZ  Concurrence in Senate Amendments",44,32,0,4,80
739344,432987,2015-04-14,Assembly,"Do pass as amended and be re-referred to the Committee on 	Appropriations",14,0,0,1,15
739345,436241,2015-04-21,Senate,"Do pass, but re-refer to the Committee on Rules",10,0,1,0,11
739348,440366,2015-04-28,Assembly,"Do pass and be re-referred to the Committee on Appropriations to 	Consent Calendar",7,0,0,0,7
739349,438683,2015-04-22,Assembly,"Do pass and be re-referred to the Committee on Appropriations",2,5,0,0,7
739349,463672,2015-04-22,Assembly,"Reconsideration granted",7,0,0,0,7
739351,433071,2015-04-15,Senate,"Do pass, but re-refer to the Committee on Appropriations",8,0,0,0,8
739351,450193,2015-05-22,Senate,"Senate 3rd Reading SB532 Leyva",38,0,1,0,39
739351,466267,2015-07-15,Assembly,"Do pass and be re-referred to the Committee on Appropriations to 	Consent Calendar",7,0,0,0,7
739351,473903,2015-08-19,Assembly,"Do pass, to Consent Calendar",17,0,0,0,17
739351,474362,2015-08-27,Assembly,"SB 532 Leyva  Consent Calendar Second Day  Regular Session",78,0,0,2,80
739351,475461,2015-09-01,Senate,"Special Consent #9 SB532 Leyva",40,0,0,0,40
739352,437054,2015-04-22,Senate,"Do pass, but re-refer to the Committee on Appropriations Recommend 	Consent",7,0,0,0,7
739352,443203,2015-05-04,Senate,"Do pass",7,0,0,0,7
739352,445095,2015-05-11,Senate,"Senate 3rd Reading SB540 Hertzberg",36,0,3,0,39
739352,466106,2015-07-13,Assembly,"Do pass as amended and be re-referred to the Committee on 	Appropriations",9,0,0,0,9
739352,473904,2015-08-19,Assembly,"Do pass, to Consent Calendar",17,0,0,0,17
739352,476027,2015-09-08,Assembly,"SB 540 Hertzberg  Senate Third Reading  By BROUGH",79,0,0,1,80
739352,476434,2015-09-10,Senate,"Unfinished Business SB540 Hertzberg Concurrence",39,0,1,0,40
739354,437176,2015-04-21,Senate,"Do pass as amended, and re-refer to the Committee on Appropriations",4,0,1,0,5
739354,445174,2015-05-11,Senate,"Placed on Appropriations Suspense file",7,0,0,0,7
739355,432952,2015-04-13,Assembly,"Do pass as amended and be re-referred to the Committee on 	Appropriations",7,1,0,1,9
739355,441139,2015-04-29,Assembly,"Do pass as amended",12,5,0,0,17
739355,447699,2015-05-18,Assembly,"AB 864 WILLIAMS  Assembly Third Reading",62,14,0,4,80
739355,466021,2015-07-14,Senate,"Do pass, but re-refer to the Committee on Appropriations",8,1,0,0,9
739355,473579,2015-08-17,Senate,"Placed on Appropriations Suspense file",7,0,0,0,7
739355,474594,2015-08-27,Senate,"Do pass as amended",5,2,0,0,7
739355,476359,2015-09-10,Senate,"Assembly 3rd Reading AB864 Williams By Jackson",32,5,3,0,40
739355,476491,2015-09-11,Assembly,"AB 864 WILLIAMS  Concurrence in Senate Amendments By BURKE",65,11,0,4,80
739357,443868,2015-05-06,Assembly,"Do pass",18,0,0,3,21
739357,446657,2015-05-14,Assembly,"AB 903 GARCIA, C.  Assembly Third Reading",78,0,0,2,80
739357,466163,2015-07-14,Senate,"Do pass",11,2,0,0,13
739359,440105,2015-04-27,Assembly,"Do pass as amended and be re-referred to the Committee on 	Appropriations",14,2,0,0,16
739359,453887,2015-05-28,Assembly,"Do pass",12,5,0,0,17
739359,456018,2015-06-02,Assembly,"AB 904 PEREA  Assembly Third Reading",58,20,0,2,80
739359,466045,2015-07-14,Senate,"Do pass, but re-refer to the Committee on Environmental Quality",9,0,2,0,11
739359,466278,2015-07-15,Senate,"Do pass, but re-refer to the Committee on Appropriations",5,1,1,0,7
739359,473606,2015-08-17,Senate,"Placed on Appropriations Suspense file",7,0,0,0,7
739360,441221,2015-04-29,Senate,"Do pass, but re-refer to the Committee on Appropriations",6,0,1,0,7
739360,445225,2015-05-11,Senate,"Placed on Appropriations Suspense file",7,0,0,0,7
739360,453960,2015-05-28,Senate,"Do pass",7,0,0,0,7
739360,456046,2015-06-02,Senate,"Senate 3rd Reading SB526 Fuller",39,0,1,0,40
739360,485131,2016-01-11,Assembly,"Do pass as amended and be re-referred to the Committee on 	Appropriations",8,0,0,1,9
739360,559093,2016-08-03,Assembly,"Do pass, to Consent Calendar",20,0,0,0,20
739360,559511,2016-08-11,Assembly,"SB 526 Fuller  Consent Calendar Second Day  Regular Session",78,0,0,2,80
739360,560237,2016-08-18,Senate,"Special Consent SB526 Fuller",36,0,3,0,39
739361,442914,2015-05-04,Senate,"Senate 3rd Reading SB564 Cannella",30,2,7,0,39
739361,463736,2015-04-27,Senate,"Do pass",7,0,0,0,7
739361,555388,2016-06-23,Assembly,"Be referred to Committee on Water, Parks and Wildlife",11,0,0,0,11
739361,556040,2016-06-28,Assembly,"Do pass and be re-referred to the Committee on Local Government",14,1,0,0,15
739361,557046,2016-06-29,Assembly,"Do pass and be re-referred to the Committee on Appropriations",9,0,0,0,9
739361,559654,2016-08-10,Assembly,"Do pass",19,0,0,1,20
739361,561007,2016-08-24,Assembly,"SB 564 Cannella  Senate Third Reading  By SALAS",78,1,0,1,80
739361,561190,2016-08-25,Senate,"From committee:  That the Assembly Amendments be concurred in",8,0,1,0,9
739361,561505,2016-08-29,Senate,"Unfinished Business SB564 Cannella Concurrence",38,0,1,0,39
739363,428079,2015-04-07,Assembly,"Amend, and do pass as amended and be re-referred to the Committee 	on Privacy and Consumer Protection with the recommendation:  To 	Consent Calendar",7,0,0,0,7
739363,436124,2015-04-21,Assembly,"Do pass and be re-referred to the Committee on Appropriations",11,0,0,0,11
739363,441281,2015-04-29,Assembly,"Do pass, to Consent Calendar",17,0,0,0,17
739363,444505,2015-05-07,Assembly,"AB 929 CHAU  Consent Calendar Second Day  Regular Session",77,0,0,3,80
739363,460159,2015-06-16,Senate,"Do pass as amended, and re-refer to the Committee on Appropriations",7,0,0,0,7
739363,465154,2015-07-06,Senate,"Assembly 3rd Reading AB929 Chau By Hall",39,0,1,0,40
739363,465741,2015-07-09,Assembly,"AB 929 CHAU  Concurrence in Senate Amendments",79,0,0,1,80
739365,445707,2015-05-12,Assembly,"Do pass as amended",10,0,0,0,10
739365,453376,2015-05-27,Assembly,"Do pass, to Consent Calendar",17,0,0,0,17
739365,455997,2015-06-02,Assembly,"AB 1028 BONTA  Consent Calendar Second Day  Regular Session",78,0,0,2,80
739365,465716,2015-07-07,Senate,"Do pass, but re-refer to the Committee on Appropriations",6,0,1,0,7
739365,475323,2015-08-31,Senate,"Assembly 3rd Reading AB1028 Bonta By Hancock",39,1,0,0,40
739367,428427,2015-04-07,Assembly,"Do pass and be re-referred to the Committee on Appropriations",12,0,0,1,13
739367,453773,2015-05-28,Assembly,"Do pass",17,0,0,0,17
739367,456630,2015-06-03,Assembly,"AB 968 WILLIAMS  Assembly Third Reading",80,0,0,0,80
739367,465605,2015-07-08,Senate,"Do pass, but re-refer to the Committee on Appropriations",9,0,0,0,9
739367,473813,2015-08-17,Senate,"Placed on Appropriations Suspense file",7,0,0,0,7
739367,474557,2015-08-27,Senate,"Do pass",7,0,0,0,7
739367,476152,2015-09-09,Senate,"Assembly 3rd Reading AB968 Williams By Leyva",39,0,1,0,40
739367,476301,2015-09-10,Assembly,"AB 968 WILLIAMS  Concurrence in Senate Amendments",78,0,0,2,80
739368,442947,2015-05-04,Assembly,"Do pass, to Consent Calendar",9,0,0,0,9
739368,445181,2015-05-11,Assembly,"AB 1040 TING  Consent Calendar Second Day",79,0,0,1,80
739370,436226,2015-04-21,Assembly,"Do pass and be re-referred to the Committee on Appropriations",5,2,0,0,7
739370,453912,2015-05-28,Assembly,"Do pass as amended",12,5,0,0,17
739370,456566,2015-06-03,Assembly,"AB 953 WEBER  Assembly Third Reading",45,27,0,8,80
739370,465490,2015-07-07,Senate,"Do pass, but re-refer to the Committee on Appropriations",5,1,1,0,7
739370,473590,2015-08-17,Senate,"Placed on Appropriations Suspense file",7,0,0,0,7
739370,474527,2015-08-27,Senate,"Do pass as amended",5,2,0,0,7
739370,476085,2015-09-09,Senate,"Assembly 3rd Reading AB953 Weber By Mitchell",26,13,1,0,40
739370,476399,2015-09-10,Assembly,"AB 953 WEBER  Concurrence in Senate Amendments",43,30,0,7,80
739371,430694,2015-04-13,Assembly,"Be referred to Committee on Utilities and Commerce",11,0,0,0,11
739371,440125,2015-04-27,Assembly,"Do pass and be re-referred to the Committee on Appropriations",15,0,0,0,15
739371,454305,2015-05-28,Assembly,"Do pass as amended",17,0,0,0,17
739371,456011,2015-06-02,Assembly,"AB 802 WILLIAMS  Assembly Third Reading",74,0,0,6,80
739371,466104,2015-07-13,Senate,"Do pass, but re-refer to the Committee on Appropriations",9,0,2,0,11
739371,473685,2015-08-17,Senate,"Placed on Appropriations Suspense file",7,0,0,0,7
739371,474542,2015-08-27,Senate,"Do pass",6,0,1,0,7
739371,476308,2015-09-10,Senate,"Do pass as amended",5,2,0,0,7
739371,476468,2015-09-11,Senate,"Assembly 3rd Reading AB802 Williams By Wolk",27,9,4,0,40
739371,476469,2015-09-11,Assembly,"AB 802 WILLIAMS  Concurrence in Senate Amendments By RENDON",75,0,0,5,80
739372,441163,2015-04-28,Assembly,"Do pass and be re-referred to the Committee on Appropriations to 	Consent Calendar",19,0,0,0,19
739372,443940,2015-05-06,Assembly,"Do pass, to Consent Calendar",17,0,0,0,17
739372,446799,2015-05-14,Assembly,"AB 990 BONILLA  Consent Calendar Second Day  Regular Session",78,0,0,2,80
739372,473842,2015-08-18,Senate,"Do pass as amended, and re-refer to the Committee on Appropriations",4,1,0,0,5
739372,475705,2015-09-02,Senate,"Assembly 3rd Reading AB990 Bonilla By Allen",32,8,0,0,40
739372,476130,2015-09-09,Assembly,"Senate amendments be concurred in",4,1,0,2,7
739372,476273,2015-09-10,Assembly,"AB 990 BONILLA  Concurrence- Urgency Added",66,10,0,4,80
739373,484677,2016-01-11,Assembly,"Do pass and be re-referred to the Committee on Appropriations",9,0,0,0,9
739373,485069,2016-01-05,Assembly,"Be referred to Committee on Natural Resources",11,0,0,0,11
739373,486328,2016-01-21,Assembly,"Do pass",17,0,0,0,17
739373,487004,2016-01-25,Assembly,"AB 1005 GORDON  Assembly Third Reading",75,1,0,3,79
739373,552012,2016-06-08,Senate,"Do pass as amended, and re-refer to the Committee on Appropriations",6,0,1,0,7
739373,555545,2016-06-27,Senate,"Placed on Appropriations Suspense file",6,0,1,0,7
739373,559594,2016-08-11,Senate,"Do pass as amended",5,0,2,0,7
739373,560469,2016-08-22,Senate,"Assembly 3rd Reading AB1005 Gordon By Wieckowski",39,0,0,0,39
739373,561168,2016-08-25,Assembly,"AB 1005 GORDON  Concurrence in Senate Amendments",79,0,0,1,80
739378,406108,2015-03-05,Assembly,"From committee:  Be adopted.  To third reading",11,0,0,0,11
739379,443930,2015-05-06,Senate,"Do pass",7,0,0,0,7
739379,447671,2015-05-18,Senate,"Senate 3rd Reading SB485 Hernandez",36,0,3,0,39
739379,466447,2015-07-15,Assembly,"Do pass",9,0,0,0,9
739379,475267,2015-08-31,Assembly,"SB 485 Hernandez  Senate Third Reading  By RENDON",80,0,0,0,80
739379,475446,2015-09-01,Senate,"Unfinished Business SB485 Hernandez Concurrence",40,0,0,0,40
739384,437378,2015-04-22,Assembly,"Do pass and be re-referred to the Committee on Accountability and 	Administrative Review",8,0,0,1,9
739384,442183,2015-04-29,Assembly,"Do pass as amended and be re-referred to the Committee on 	Appropriations",7,0,0,0,7
739384,449075,2015-05-20,Assembly,"Do pass, to Consent Calendar",15,0,0,2,17
739384,451991,2015-05-26,Assembly,"AB 975 FRAZIER  Consent Calendar Second Day  Regular Session",76,0,0,4,80
739384,463986,2015-06-29,Senate,"Do pass, but re-refer to the Committee on Education Recommend 	Consent",12,0,1,0,13
739385,440177,2015-04-27,Senate,"Do pass, but re-refer to the Committee on Veterans Affairs",9,0,0,0,9
739385,445405,2015-05-11,Senate,"Placed on Appropriations Suspense file",7,0,0,0,7
739387,442248,2015-04-29,Assembly,"Do pass as amended and be re-referred to the Committee on 	Appropriations",6,0,0,1,7
739389,438025,2015-04-22,Assembly,"Do pass and be re-referred to the Committee on Appropriations to 	Consent Calendar",7,0,0,0,7
739389,441081,2015-04-29,Assembly,"Do pass, to Consent Calendar",17,0,0,0,17
739389,444401,2015-05-07,Assembly,"AB 1052 COOLEY  Consent Calendar Second Day  Regular Session",77,0,0,3,80
739389,465906,2015-07-13,Senate,"Do pass, but re-refer to the Committee on Appropriations",5,0,0,0,5
739389,474435,2015-08-27,Senate,"Assembly 3rd Reading AB1052 Cooley By Pan",39,0,1,0,40
739389,561274,2016-08-25,Senate,"Assembly 3rd Reading AB1052 Cooley By Pan",39,0,0,0,39
739390,435319,2015-04-20,Assembly,"Be referred to Committee on Transportation",10,0,0,1,11
739393,428491,2015-04-08,Assembly,"Do pass and be re-referred to the Committee on Appropriations",6,0,0,1,7
739394,440092,2015-04-27,Assembly,"Do pass and be re-referred to the Committee on Appropriations",7,1,0,1,9
739394,443839,2015-05-06,Assembly,"Do pass",12,4,0,1,17
739394,445172,2015-05-11,Assembly,"AB 1063 WILLIAMS  Assembly Third Reading",57,20,0,3,80
739395,427788,2015-04-07,Assembly,"Do pass and be re-referred to the Committee on Appropriations to 	Consent Calendar",18,0,0,1,19
739395,453928,2015-05-28,Assembly,"Do pass as amended",17,0,0,0,17
739395,456006,2015-06-02,Assembly,"AB 918 STONE  Assembly Third Reading",77,0,0,3,80
739395,465794,2015-07-08,Senate,"Do pass, but re-refer to the Committee on Human Services",8,0,1,0,9
739395,466100,2015-07-14,Senate,"Do pass as amended, and re-refer to the Committee on Appropriations",5,0,0,0,5
739395,475271,2015-08-31,Senate,"Assembly 3rd Reading AB918 Mark Stone By McGuire",40,0,0,0,40
739395,475448,2015-09-01,Assembly,"AB 918 STONE  Concurrence in Senate Amendments",79,0,0,1,80
739396,433508,2015-04-14,Assembly,"Amend, and do pass as amended and be re-referred to the Committee 	on Appropriations with the recommendation:  To Consent Calendar",7,0,0,0,7
739396,443835,2015-05-06,Assembly,"Do pass, to Consent Calendar",17,0,0,0,17
739396,446679,2015-05-14,Assembly,"AB 982 EGGMAN  Consent Calendar Second Day  Regular Session",78,0,0,2,80
739396,464685,2015-07-01,Senate,"Do pass, but re-refer to the Committee on Human Services",6,0,3,0,9
739396,466085,2015-07-14,Senate,"Do pass, but re-refer to the Committee on Appropriations Recommend 	Consent",5,0,0,0,5
739396,474290,2015-08-27,Senate,"Assembly 3rd Reading AB982 Eggman By Beall",38,0,2,0,40
739396,475296,2015-08-31,Assembly,"AB 982 EGGMAN  Concurrence in Senate Amendments",79,0,0,1,80
739399,484921,2016-01-13,Assembly,"Do pass and be re-referred to the Committee on Appropriations",3,3,0,1,7
739400,437467,2015-04-21,Assembly,"Do pass and be re-referred to the Committee on Appropriations",13,0,0,0,13
739400,443938,2015-05-06,Assembly,"Do pass, to Consent Calendar",17,0,0,0,17
739400,446767,2015-05-14,Assembly,"AB 819 IRWIN  Consent Calendar Second Day  Regular Session",78,0,0,2,80
739400,460677,2015-06-17,Senate,"Do pass, but re-refer to the Committee on Appropriations Recommend 	Consent",8,0,1,0,9
739400,464950,2015-07-02,Senate,"Consent Calendar 2nd AB819 Irwin",38,0,2,0,40
739401,427934,2015-04-07,Assembly,"Do pass and be re-referred to the Committee on Appropriations",5,2,0,0,7
739403,431947,2015-04-13,Assembly,"Do pass, to Consent Calendar",14,0,0,1,15
739403,435222,2015-04-20,Assembly,"AB 1008 QUIRK  Consent Calendar Second Day",80,0,0,0,80
739403,460214,2015-06-16,Senate,"Do pass",10,0,1,0,11
739403,463922,2015-06-29,Senate,"Assembly 3rd Reading AB1008 Quirk By Cannella",37,0,3,0,40
739404,439940,2015-04-28,Senate,"Do pass as amended, and re-refer to the Committee on Appropriations",7,1,3,0,11
739404,453915,2015-05-28,Senate,"Do pass as amended",5,2,0,0,7
739404,457237,2015-06-04,Senate,"Senate 3rd Reading SB573 Pan",28,11,1,0,40
739404,463657,2015-05-18,Senate,"Placed on Appropriations Suspense file",7,0,0,0,7
739404,464744,2015-07-01,Assembly,"Do pass and be re-referred to the Committee on Privacy and Consumer 	Protection",9,0,0,0,9
739404,474181,2015-07-07,Assembly,"Do pass as amended and be re-referred to the Committee on 	Appropriations",11,0,0,0,11
739406,428685,2015-04-08,Assembly,"Do pass",9,0,0,0,9
739406,434142,2015-04-16,Assembly,"AB 823 BIGELOW  Assembly Third Reading",79,0,0,1,80
739406,458866,2015-06-10,Senate,"Do pass and be placed on the Consent Calendar",7,0,0,0,7
739406,461231,2015-06-18,Senate,"Consent Calendar 2nd AB823 Bigelow",37,0,3,0,40
739409,448421,2015-05-18,Assembly,"Do pass and be re-referred to the Committee on Appropriations",7,2,0,0,9
739409,452924,2015-05-27,Assembly,"Do pass",15,1,0,1,17
739409,456036,2015-06-02,Assembly,"AB 976 STEINORTH  Assembly Third Reading",66,8,0,6,80
739409,462652,2015-06-24,Senate,"Do pass, but re-refer to the Committee on Appropriations",7,0,0,0,7
739409,465134,2015-07-06,Senate,"Placed on Appropriations Suspense file",7,0,0,0,7
739410,427809,2015-04-06,Assembly,"Do pass as amended and be re-referred to the Committee on Arts, 	Entertain, Sports, Tourism, & Internet Media",14,0,0,2,16
739410,436821,2015-04-21,Assembly,"Do pass and be re-referred to the Committee on Appropriations",7,0,0,0,7
739410,453621,2015-05-28,Assembly,"Do pass as amended",17,0,0,0,17
739410,456135,2015-06-02,Assembly,"AB 932 DALY  Assembly Third Reading",77,0,0,3,80
739410,465485,2015-07-07,Senate,"Do pass as amended, and re-refer to the Committee on Appropriations",11,0,0,0,11
739410,473732,2015-08-17,Senate,"Placed on Appropriations Suspense file",7,0,0,0,7
739411,437195,2015-04-22,Assembly,"Do pass and be re-referred to the Committee on Appropriations",9,0,0,0,9
739411,446212,2015-05-13,Assembly,"Do pass, to Consent Calendar",17,0,0,0,17
739411,450194,2015-05-22,Assembly,,75,0,0,5,80
739411,462649,2015-06-24,Senate,"Do pass as amended, and re-refer to the Committee on Appropriations",7,0,0,0,7
739411,474313,2015-08-27,Senate,"Assembly 3rd Reading AB851 Mayes By Beall",40,0,0,0,40
739411,475361,2015-08-31,Assembly,,80,0,0,0,80
739412,440226,2015-04-28,Assembly,"Do pass as amended and be re-referred to the Committee on 	Appropriations",15,0,0,0,15
739412,453711,2015-05-28,Assembly,"Do pass as amended",17,0,0,0,17
739412,457328,2015-06-04,Assembly,"AB 954 MATHIS  Third Reading Urgency",78,0,0,2,80
739412,466370,2015-07-15,Senate,"Do pass, but re-refer to the Committee on Appropriations",7,0,0,0,7
739412,473652,2015-08-17,Senate,"Placed on Appropriations Suspense file",7,0,0,0,7
739415,442437,2015-04-29,Assembly,"Do pass as amended and be re-referred to the Committee on 	Appropriations",7,0,0,0,7
739415,454070,2015-05-28,Assembly,"Do pass as amended",17,0,0,0,17
739415,456633,2015-06-03,Assembly,"AB 1012 JONES-SAWYER  Assembly Third Reading",79,0,0,1,80
739415,473707,2015-08-17,Senate,"Placed on Appropriations Suspense file",7,0,0,0,7
739415,474636,2015-08-27,Senate,"Do pass",7,0,0,0,7
739415,475962,2015-09-08,Senate,"Assembly 3rd Reading AB1012 Jones-Sawyer By Lara",39,0,1,0,40
739415,476120,2015-09-09,Assembly,"AB 1012 JONES-SAWYER  Concurrence in Senate Amendments",80,0,0,0,80
739416,447678,2015-05-13,Assembly,"Do pass",2,5,0,0,7
739416,463548,2015-05-13,Assembly,"Reconsideration granted",7,0,0,0,7
739419,428401,2015-04-08,Assembly,"Do pass",7,1,0,1,9
739419,454216,2015-05-28,Assembly,"AB 896 WAGNER  Assembly Third Reading",73,1,0,6,80
739419,466433,2015-07-15,Senate,"Do pass",6,0,1,0,7
739419,475367,2015-08-31,Senate,"Special Consent #8 AB896 Wagner By Berryhill",40,0,0,0,40
739419,475407,2015-09-01,Assembly,"AB 896 WAGNER  Concurrence in Senate Amendments",79,1,0,0,80
739421,435184,2015-04-20,Assembly,"Do pass and be re-referred to the Committee on Appropriations",11,0,0,1,12
739423,432694,2015-04-14,Senate,"Do pass as amended, and re-refer to the Committee on Environmental 	Quality",6,2,1,0,9
739423,445203,2015-05-11,Senate,"Placed on Appropriations Suspense file",7,0,0,0,7
739425,439971,2015-04-27,Assembly,"Do pass",14,0,0,2,16
739425,442855,2015-05-04,Assembly,"AB 828 LOW  Assembly Third Reading",71,1,0,8,80
739425,465436,2015-07-07,Senate,"Do pass as amended, and re-refer to the Committee on Rules",6,5,0,0,11
739425,554700,2016-06-21,Senate,"Do pass as amended, and re-refer to the Committee on Appropriations",6,4,1,0,11
739425,558713,2016-08-01,Senate,"Placed on Appropriations Suspense file",7,0,0,0,7
739426,427881,2015-04-07,Assembly,"Do pass as amended and be re-referred to the Committee on 	Appropriations",5,2,0,0,7
739426,441137,2015-04-29,Assembly,"Do pass",10,5,0,2,17
739426,446764,2015-05-14,Assembly,"AB 832 GARCIA, C.  Assembly Third Reading",27,32,0,21,80
739428,430689,2015-04-09,Assembly,"Be referred to Committee on Elections and Redistricting",11,0,0,0,11
739428,441198,2015-04-29,Assembly,"Do pass and be re-referred to the Committee on Appropriations",4,3,0,0,7
739430,438072,2015-04-22,Assembly,"Do pass as amended and be re-referred to the Committee on 	Appropriations",6,1,0,0,7
739430,453804,2015-05-28,Assembly,"Do pass as amended",12,0,0,5,17
739430,457293,2015-06-04,Assembly,"AB 827 O'DONNELL  Assembly Third Reading",59,15,0,6,80
739430,465665,2015-07-08,Senate,"Do pass, but re-refer to the Committee on Appropriations",7,2,0,0,9
739430,475428,2015-09-01,Senate,"Assembly 3rd Reading AB827 O'Donnell By Block",27,13,0,0,40
739430,475749,2015-09-03,Assembly,"AB 827 O'DONNELL  Concurrence in Senate Amendments",58,18,0,4,80
739431,433502,2015-04-13,Assembly,"Do pass as amended and be re-referred to the Committee on 	Appropriations",8,1,0,0,9
739431,454031,2015-05-28,Assembly,"Do pass",17,0,0,0,17
739431,455525,2015-06-01,Assembly,"AB 901 GORDON  Assembly Third Reading",78,2,0,0,80
739431,466381,2015-07-15,Senate,"Do pass as amended, and re-refer to the Committee on Appropriations",6,1,0,0,7
739431,473591,2015-08-17,Senate,"Placed on Appropriations Suspense file",7,0,0,0,7
739431,474711,2015-08-27,Senate,"Do pass as amended",6,1,0,0,7
739431,476328,2015-09-10,Senate,"Assembly 3rd Reading AB901 Gordon By Wieckowski",26,10,4,0,40
739431,476650,2015-09-11,Assembly,"AB 901 GORDON  Concurrence in Senate Amendments",78,0,0,2,80
739432,437159,2015-04-21,Senate,"Do pass, but re-refer to the Committee on Appropriations",5,2,0,0,7
739432,442809,2015-05-04,Senate,"Placed on Appropriations Suspense file",7,0,0,0,7
739432,454087,2015-05-28,Senate,"Do pass as amended",5,2,0,0,7
739432,456050,2015-06-02,Senate,"Senate 3rd Reading SB504 Lara",25,13,2,0,40
739432,464401,2015-06-30,Assembly,"Do pass and be re-referred to the Committee on Appropriations",4,2,0,1,7
739432,473937,2015-08-19,Assembly,"Do pass",11,4,0,2,17
739432,475347,2015-08-31,Assembly,"SB 504 Lara  Senate Third Reading  By BLOOM",58,19,0,3,80
739432,475513,2015-09-01,Senate,"Unfinished Business SB504 Lara Concurrence",26,14,0,0,40
739434,440658,2015-04-27,Senate,"Do pass, but re-refer to the Committee on Appropriations",8,0,1,0,9
739434,445171,2015-05-11,Senate,"Placed on Appropriations Suspense file",7,0,0,0,7
739434,453978,2015-05-28,Senate,"Do pass as amended",7,0,0,0,7
739434,456715,2015-06-03,Senate,"Senate 3rd Reading SB479 Bates",40,0,0,0,40
739434,465350,2015-07-07,Assembly,"Do pass as amended and be re-referred to the Committee on 	Appropriations",13,0,0,1,14
739436,435992,2015-04-21,Senate,"Do pass, but re-refer to the Committee on Rules",4,1,0,0,5
739436,440455,2015-04-28,Senate,"Do pass, but re-refer to the Committee on Appropriations",5,1,1,0,7
739436,450314,2015-05-22,Senate,"Senate 3rd Reading SB589 Block",27,10,2,0,39
739436,464683,2015-07-01,Assembly,"Do pass and be re-referred to the Committee on Judiciary",6,0,0,1,7
739436,465401,2015-07-07,Assembly,"Do pass and be re-referred to the Committee on Appropriations",8,1,0,1,10
739436,466383,2015-07-15,Assembly,"Do pass",11,4,0,2,17
739436,474286,2015-08-27,Assembly,"SB 589 Block  Senate Third Reading  By MULLIN",62,11,0,7,80
739436,475254,2015-08-31,Senate,"Unfinished Business SB589 Block Concurrence",27,11,2,0,40
739439,439370,2015-04-27,Senate,"Do pass as amended, and re-refer to the Committee on Appropriations",6,3,2,0,11
739439,463602,2015-05-18,Senate,"Placed on Appropriations Suspense file",7,0,0,0,7
739442,484676,2016-01-11,Assembly,"Do pass as amended and be re-referred to the Committee on 	Appropriations",5,3,0,1,9
739442,485047,2016-01-05,Assembly,"Be referred to Committee on Revenue and Taxation",11,0,0,0,11
739442,486305,2016-01-21,Assembly,"Do pass",12,5,0,0,17
739442,488977,2016-01-28,Assembly,"AB 821 GIPSON  Assembly Third Reading",58,17,0,4,79
739442,544845,2016-05-11,Senate,"Do pass, but re-refer to the Committee on Appropriations",6,1,0,0,7
739442,559926,2016-08-16,Senate,"Assembly 3rd Reading AB821 Gipson By Pavley",28,9,2,0,39
739443,440078,2015-04-28,Senate,"Do pass, but re-refer to the Committee on Appropriations",7,0,0,0,7
739443,445101,2015-05-11,Senate,"Placed on Appropriations Suspense file",7,0,0,0,7
739443,458540,2015-04-14,Senate,"Do pass, but re-refer to the Committee on Appropriations",1,4,0,2,7
739444,441099,2015-04-28,Assembly,"Do pass and be re-referred to the Committee on Appropriations",7,0,0,0,7
739444,454392,2015-05-28,Assembly,"Do pass",17,0,0,0,17
739444,455396,2015-06-01,Assembly,"AB 833 BONTA  Assembly Third Reading",80,0,0,0,80
739444,462633,2015-06-24,Senate,"Do pass, but re-refer to the Committee on Appropriations",9,0,0,0,9
739444,465175,2015-07-06,Senate,"Placed on Appropriations Suspense file",7,0,0,0,7
739444,474582,2015-08-27,Senate,"Do pass",7,0,0,0,7
739444,476183,2015-09-09,Senate,"Assembly 3rd Reading AB833 Bonta By Hancock",40,0,0,0,40
739444,476363,2015-09-10,Assembly,"AB 833 BONTA  Concurrence in Senate Amendments",80,0,0,0,80
739445,428617,2015-04-08,Assembly,"Do pass and be re-referred to the Committee on Appropriations",8,0,0,1,9
739449,427991,2015-04-07,Assembly,"Do pass, to Consent Calendar",7,0,0,0,7
739449,433889,2015-04-16,Assembly,"AB 892 ACHADJIAN  Consent Calendar Second Day  Regular Session",79,0,0,1,80
739449,458492,2015-06-09,Senate,"Do pass",7,0,0,0,7
739449,465162,2015-07-06,Senate,"Assembly 3rd Reading AB892 Achadjian By Anderson",37,0,3,0,40
739451,441008,2015-04-28,Senate,"Do pass as amended, and re-refer to the Committee on Appropriations",4,0,1,0,5
739451,454154,2015-05-28,Senate,"Do pass",5,0,2,0,7
739451,455408,2015-06-01,Senate,"Senate 3rd Reading SB524 Lara",35,1,4,0,40
739451,463708,2015-05-18,Senate,"Placed on Appropriations Suspense file",7,0,0,0,7
739451,466331,2015-07-14,Assembly,"Do pass and be re-referred to the Committee on Appropriations",7,0,0,0,7
739451,474354,2015-08-27,Assembly,"Do pass",16,0,0,1,17
739451,560424,2016-08-19,Assembly,"SB 524 Lara  Senate Third Reading  Amend By LOW  Set #1",49,20,0,11,80
739451,561003,2016-08-24,Assembly,"SB 524 Lara  Senate Third Reading  By LOW",54,23,0,3,80
739451,561323,2016-08-26,Senate,"From committee:  That the Assembly Amendments be concurred in",3,2,0,0,5
739451,561405,2016-08-29,Senate,"Unfinished Business SB524 Lara Concurrence",26,11,2,0,39
739452,442364,2015-04-29,Senate,"Do pass as amended, and re-refer to the Committee on Appropriations",7,0,2,0,9
739452,450145,2015-05-22,Senate,"Senate 3rd Reading SB492 Liu",29,7,3,0,39
739452,462212,2015-06-23,Assembly,"Do pass as amended and be re-referred to the Committee on 	Appropriations",17,2,0,0,19
739452,466409,2015-07-15,Assembly,"Do pass",15,1,0,1,17
739452,473632,2015-08-17,Assembly,"SB 492 Liu  Senate Third Reading  By BROWN",72,5,0,3,80
739452,474112,2015-08-24,Senate,"Unfinished Business SB492 Liu Concurrence",30,8,2,0,40
739453,440172,2015-04-28,Senate,"Do pass, but re-refer to the Committee on Appropriations",5,1,1,0,7
739453,445096,2015-05-11,Senate,"Do pass",5,2,0,0,7
739453,454415,2015-05-28,Senate,"Senate 3rd Reading SB570 Jackson",27,11,2,0,40
739453,465362,2015-07-07,Assembly,"Do pass and be re-referred to the Committee on Appropriations",11,0,0,0,11
739453,466264,2015-07-15,Assembly,"Do pass",16,0,0,1,17
739453,475757,2015-09-03,Assembly,"SB 570 Jackson  Senate Third Reading  By CHAU",80,0,0,0,80
739453,475899,2015-09-04,Senate,"Unfinished Business SB570 Jackson Concurrence",38,2,0,0,40
739454,438649,2015-04-22,Assembly,"Amend, and do pass as amended and be re-referred to the Committee 	on Appropriations with the recommendation:  To Consent Calendar",7,0,0,0,7
739454,446324,2015-05-13,Assembly,"Do pass, to Consent Calendar",17,0,0,0,17
739454,450127,2015-05-22,Assembly,"AB 943 ALLEN  Consent Calendar Second Day  Regular Session",74,0,0,6,80
739454,464752,2015-07-01,Senate,"Do pass as amended, but re-refer to the Committee on Appropriations 	Recommend Consent",7,0,2,0,9
739454,473973,2015-08-20,Senate,"Consent Calendar 2nd AB943 Travis Allen",38,0,2,0,40
739454,474090,2015-08-24,Assembly,"AB 943 ALLEN  Concurrence in Senate Amendments",78,0,0,2,80
739458,432322,2015-04-13,Assembly,"Do pass as amended and be re-referred to the Committee on Jobs, 	Economic Development and The Economy",10,3,0,2,15
739458,440919,2015-04-29,Assembly,"Do pass as amended and be re-referred to the Committee on 	Appropriations",6,1,0,2,9
739458,453996,2015-05-28,Assembly,"Do pass",12,4,0,1,17
739458,455954,2015-06-02,Assembly,"AB 865 ALEJO  Assembly Third Reading",59,16,0,5,80
739458,466119,2015-07-13,Senate,"Do pass, but re-refer to the Committee on Appropriations",9,2,0,0,11
739458,473589,2015-08-17,Senate,"Placed on Appropriations Suspense file",7,0,0,0,7
739458,474521,2015-08-27,Senate,"Do pass as amended",5,2,0,0,7
739458,475721,2015-09-03,Senate,"Assembly 3rd Reading AB865 Alejo By Hueso",28,11,1,0,40
739458,476025,2015-09-08,Assembly,"AB 865 ALEJO  Concurrence in Senate Amendments",59,16,0,5,80
739459,440445,2015-04-27,Assembly,"Do pass and be re-referred to the Committee on Appropriations",15,0,0,0,15
739459,446171,2015-05-13,Assembly,"Do pass, to Consent Calendar",17,0,0,0,17
739459,450190,2015-05-22,Assembly,"AB 1023 RENDON  Consent Calendar Second Day  Regular Session",74,0,0,6,80
739459,466125,2015-07-13,Senate,"Do pass as amended, and re-refer to the Committee on Appropriations",11,0,0,0,11
739459,476322,2015-09-10,Senate,"Assembly 3rd Reading AB1023 Rendon By Hill",40,0,0,0,40
739459,476648,2015-09-11,Assembly,"AB 1023 RENDON  Concurrence in Senate Amendments",79,0,0,1,80
739461,442354,2015-04-29,Senate,"Do pass as amended, and re-refer to the Committee on Appropriations",9,0,0,0,9
739461,463655,2015-05-18,Senate,"Placed on Appropriations Suspense file",7,0,0,0,7
739463,448462,2015-05-18,Assembly,"Do pass as amended and be re-referred to the Committee on 	Appropriations",9,0,0,0,9
739463,453065,2015-05-27,Assembly,"Do pass",17,0,0,0,17
739463,455506,2015-06-01,Assembly,"AB 931 IRWIN  Assembly Third Reading",79,0,0,1,80
739463,465618,2015-07-08,Senate,"Do pass, but re-refer to the Committee on Appropriations",7,0,0,0,7
739463,473634,2015-08-17,Senate,"Placed on Appropriations Suspense file",7,0,0,0,7
739463,474695,2015-08-27,Senate,"Do pass",7,0,0,0,7
739463,475726,2015-09-03,Senate,"Assembly 3rd Reading AB931 Irwin By Hertzberg",39,0,1,0,40
739463,475874,2015-09-04,Assembly,"AB 931 IRWIN  Concurrence in Senate Amendments",80,0,0,0,80
739464,437104,2015-04-22,Assembly,"Do pass and be re-referred to the Committee on Appropriations",5,1,0,1,7
739465,428479,2015-04-08,Assembly,"Do pass and be re-referred to the Committee on Appropriations to 	Consent Calendar",21,0,0,0,21
739465,433905,2015-04-15,Assembly,"Do pass, to Consent Calendar",16,0,0,1,17
739465,437895,2015-04-23,Assembly,"AB 893 STONE  Consent Calendar Second Day  Regular Session",78,0,0,2,80
739465,473971,2015-08-20,Senate,"Consent Calendar 2nd AB893 Mark Stone",38,0,2,0,40
739465,474087,2015-08-24,Assembly,"AB 893 STONE  Concurrence in Senate Amendments",79,0,0,1,80
739468,438419,2015-04-22,Assembly,"Do pass as amended and be re-referred to the Committee on 	Appropriations",7,0,0,0,7
739468,454185,2015-05-28,Assembly,"Do pass as amended",17,0,0,0,17
739468,456052,2015-06-02,Assembly,"AB 854 WEBER  Assembly Third Reading",79,0,0,1,80
739468,466348,2015-07-15,Senate,"Do pass as amended, and re-refer to the Committee on Appropriations",8,0,1,0,9
739468,474130,2015-08-24,Senate,"Placed on Appropriations Suspense file",7,0,0,0,7
739468,474622,2015-08-27,Senate,"Do pass as amended",7,0,0,0,7
739468,476181,2015-09-09,Senate,"Assembly 3rd Reading AB854 Weber By Mitchell",38,0,2,0,40
739468,476355,2015-09-10,Assembly,"AB 854 WEBER  Concurrence- Urgency Added",80,0,0,0,80
739469,439458,2015-04-27,Assembly,"Do pass and be re-referred to the Committee on Appropriations",20,0,0,1,21
739470,432532,2015-04-15,Assembly,"Do pass as amended and be re-referred to the Committee on Elections 	and Redistricting",8,0,0,1,9
739470,446199,2015-05-13,Assembly,"Do pass, to Consent Calendar",7,0,0,0,7
739470,450251,2015-05-22,Assembly,"AB 952 GARCIA, C.  Consent Calendar Second Day  Regular Session",74,0,0,6,80
739470,465908,2015-07-13,Senate,"Assembly 3rd Reading AB952 Cristina Garcia By Lara",39,0,1,0,40
739471,432673,2015-04-14,Assembly,"Do pass and be re-referred to the Committee on Health",12,2,0,0,14
739471,441063,2015-04-28,Assembly,"Do pass and be re-referred to the Committee on Appropriations",19,0,0,0,19
739471,454149,2015-05-28,Assembly,"Do pass as amended",12,0,0,5,17
739471,456736,2015-06-03,Assembly,"AB 848 STONE  Assembly Third Reading",74,3,0,3,80
739471,466579,2015-07-15,Senate,"Do pass as amended, and re-refer to the Committee on Appropriations",8,1,0,0,9
739471,473673,2015-08-17,Senate,"Placed on Appropriations Suspense file",7,0,0,0,7
739471,474710,2015-08-27,Senate,"Do pass as amended",6,1,0,0,7
739471,475504,2015-09-01,Senate,"Assembly 3rd Reading AB848 Mark Stone By Hernandez",29,9,2,0,40
739471,475782,2015-09-03,Assembly,"AB 848 STONE  Concurrence in Senate Amendments",72,4,0,4,80
739473,443841,2015-05-06,Senate,"Do pass",7,0,0,0,7
739473,447666,2015-05-18,Senate,"Special Consent #1 SB562 Lara",36,0,3,0,39
739473,464697,2015-07-01,Assembly,"Do pass",9,0,0,0,9
739473,465873,2015-07-13,Assembly,"SB 562 Lara  Senate Third Reading  By RENDON",79,0,0,1,80
739473,466446,2015-07-16,Senate,"Unfinished Business SB562 Lara Concurrence",37,0,3,0,40
739474,436185,2015-04-21,Assembly,"Do pass as amended and be re-referred to the Committee on 	Appropriations",14,0,0,0,14
739474,443879,2015-05-06,Assembly,"Do pass, to Consent Calendar",17,0,0,0,17
739474,446686,2015-05-14,Assembly,"AB 880 RIDLEY-THOMAS  Consent Calendar Second Day  Regular Session",78,0,0,2,80
739474,464303,2015-06-29,Senate,"Do pass as amended, and re-refer to the Committee on Appropriations",8,0,1,0,9
739474,474379,2015-08-27,Senate,"Assembly 3rd Reading AB880 Ridley-Thomas By Hall",40,0,0,0,40
739474,475365,2015-08-31,Assembly,"AB 880 RIDLEY-THOMAS  Concurrence in Senate Amendments",80,0,0,0,80
739475,444499,2015-05-06,Assembly,"Do pass",2,5,0,0,7
739477,437296,2015-04-21,Senate,"Do pass, but re-refer to the Committee on Appropriations",7,0,0,0,7
739477,442820,2015-05-04,Senate,"Placed on Appropriations Suspense file",7,0,0,0,7
739479,431628,2015-04-13,Senate,"Do pass, but re-refer to the Committee on Appropriations",9,0,0,0,9
739479,442135,2015-04-30,Senate,"Senate 3rd Reading SB560 Monning",35,0,4,0,39
739479,462178,2015-06-23,Assembly,"Do pass and be re-referred to the Committee on Insurance to Consent 	Calendar",14,0,0,0,14
739479,465668,2015-07-08,Assembly,"Do pass and be re-referred to the Committee on Appropriations to 	Consent Calendar",13,0,0,0,13
739479,473921,2015-08-19,Assembly,"Do pass, to Consent Calendar",17,0,0,0,17
739479,474394,2015-08-27,Assembly,"SB 560 Monning  Consent Calendar Second Day  Regular Session",78,0,0,2,80
739479,475497,2015-09-01,Senate,"Special Consent #9 SB560 Monning",40,0,0,0,40
739480,438040,2015-04-23,Assembly,"Be referred to Committee on Labor and Employment",10,0,0,1,11
739480,442130,2015-04-30,Assembly,"Do pass and be re-referred to the Committee on Appropriations",5,2,0,0,7
739480,446204,2015-05-13,Assembly,"Do pass",11,5,0,1,17
739480,451664,2015-05-26,Assembly,"AB 1017 CAMPOS  Assembly Third Reading",42,29,0,9,80
739480,462606,2015-06-24,Senate,"Do pass, but re-refer to the Committee on Appropriations",4,1,0,0,5
739480,475460,2015-09-01,Senate,"Assembly 3rd Reading AB1017 Campos By Mitchell",23,14,3,0,40
739480,475783,2015-09-03,Assembly,"AB 1017 CAMPOS  Concurrence in Senate Amendments",42,33,0,5,80
739481,432615,2015-04-13,Assembly,"Do pass as amended and be re-referred to the Committee on 	Appropriations",9,0,0,0,9
739481,441254,2015-04-29,Assembly,"Do pass, to Consent Calendar",17,0,0,0,17
739481,447742,2015-05-18,Assembly,"AB 1004 DAHLE  Assembly Third Reading",77,0,0,3,80
739481,462227,2015-06-23,Senate,"Do pass, but re-refer to the Committee on Appropriations Recommend 	Consent",9,0,0,0,9
739481,465758,2015-07-09,Senate,"Consent Calendar 2nd AB1004 Dahle",39,0,1,0,40
739482,437188,2015-04-22,Senate,"Do pass, but re-refer to the Committee on Health",5,2,0,0,7
739482,442246,2015-04-29,Senate,"Do pass, but re-refer to the Committee on Appropriations",6,2,1,0,9
739482,445140,2015-05-11,Senate,"Placed on Appropriations Suspense file",7,0,0,0,7
739482,453981,2015-05-28,Senate,"Do pass as amended",5,2,0,0,7
739483,454313,2015-05-28,Assembly,"Do pass",13,0,0,4,17
739483,455933,2015-06-02,Assembly,"AB 909 QUIRK  Assembly Third Reading",77,0,0,3,80
739483,462165,2015-06-23,Senate,"Do pass, but re-refer to the Committee on Appropriations",7,0,0,0,7
739483,465181,2015-07-06,Senate,"Placed on Appropriations Suspense file",7,0,0,0,7
739483,466040,2015-04-14,Assembly,"Do pass and be re-referred to the Committee on Appropriations",5,0,0,2,7
739486,432837,2015-04-13,Assembly,"Do pass as amended and be re-referred to the Committee on Natural 	Resources",16,0,0,0,16
739486,440016,2015-04-27,Assembly,"Do pass as amended and be re-referred to the Committee on 	Appropriations",9,0,0,0,9
739486,454096,2015-05-28,Assembly,"Do pass",17,0,0,0,17
739486,455517,2015-06-01,Assembly,"AB 857 PEREA  Assembly Third Reading",80,0,0,0,80
739486,464388,2015-06-30,Senate,"Do pass, but re-refer to the Committee on Environmental Quality",8,1,2,0,11
739486,466307,2015-07-15,Senate,"Do pass as amended, and re-refer to the Committee on Appropriations",5,2,0,0,7
739486,474118,2015-08-24,Senate,"Placed on Appropriations Suspense file",7,0,0,0,7
739486,544360,2016-05-10,Senate,"Do pass, but re-refer to the Committee on Appropriations",5,2,0,0,7
739486,545820,2016-05-16,Senate,"Placed on Appropriations Suspense file",2,5,0,0,7
739486,545821,2016-05-16,Senate,"Do pass",5,2,0,0,7
739486,547027,2016-05-19,Senate,"Assembly 3rd Reading AB857 Cooper By Jackson",24,14,2,0,40
739486,556790,2016-06-30,Assembly,"AB 857 COOPER  Concurrence in Senate Amendments",50,26,0,4,80
739487,428572,2015-04-08,Assembly,"Do pass and be re-referred to the Committee on Appropriations to 	Consent Calendar",21,0,0,0,21
739487,437201,2015-04-22,Assembly,"Do pass, to Consent Calendar",17,0,0,0,17
739487,442384,2015-04-30,Assembly,"AB 973 GRAY  Consent Calendar Second Day  Regular Session",77,0,0,3,80
739487,463837,2015-06-29,Senate,"Do pass, but re-refer to the Committee on Appropriations Recommend 	Consent",12,0,1,0,13
739487,473977,2015-08-20,Senate,"Consent Calendar 2nd AB973 Gray",38,0,2,0,40
739489,443675,2015-05-06,Assembly,"Do pass",13,0,0,0,13
739489,446615,2015-05-14,Assembly,"AB 915 HOLDEN  Assembly Third Reading",80,0,0,0,80
739489,460671,2015-06-17,Senate,"Do pass",8,0,1,0,9
739489,461833,2015-06-22,Senate,"Assembly 3rd Reading AB915 Holden By Monning",36,0,4,0,40
739490,437208,2015-04-22,Senate,"Do pass as amended, and re-refer to the Committee on Appropriations",4,2,1,0,7
739490,445213,2015-05-11,Senate,"Placed on Appropriations Suspense file",7,0,0,0,7
739492,447860,2015-05-13,Assembly,"Do pass as amended",7,0,0,0,7
739492,451597,2015-05-26,Assembly,"AB 882 WILK  Assembly Third Reading",75,0,0,5,80
739492,460663,2015-06-17,Senate,"Do pass as amended, and re-refer to the Committee on Governance and 	Finance",8,0,1,0,9
739497,437760,2015-04-22,Assembly,"Do pass and be re-referred to the Committee on Appropriations",6,1,0,0,7
739497,453832,2015-05-28,Assembly,"Do pass",12,5,0,0,17
739497,455951,2015-06-02,Assembly,"AB 840 RIDLEY-THOMAS  Assembly Third Reading",57,21,0,2,80
739497,555544,2016-06-27,Senate,"Do pass, but re-refer to the Committee on Appropriations",3,0,2,0,5
739497,558780,2016-08-01,Senate,"Placed on Appropriations Suspense file",7,0,0,0,7
739497,559625,2016-08-11,Senate,"Do pass",5,2,0,0,7
739497,560477,2016-08-22,Senate,"Assembly 3rd Reading AB840 Ridley-Thomas By Pan",26,13,0,0,39
739497,561182,2016-08-25,Assembly,"AB 840 RIDLEY-THOMAS  Concurrence in Senate Amendments",57,21,0,2,80
739499,440383,2015-04-28,Senate,"Do pass, but re-refer to the Committee on Appropriations",10,1,0,0,11
739499,447708,2015-05-18,Senate,"Senate 3rd Reading SB530 Pan",35,0,4,0,39
739499,461895,2015-06-22,Assembly,"Do pass and be re-referred to the Committee on Governmental 	Organization",8,0,0,8,16
739499,463878,2015-06-29,Assembly,"Do pass and be re-referred to the Committee on Governmental 	Organization",14,0,0,2,16
739499,466316,2015-07-15,Assembly,"Do pass and be re-referred to the Committee on Appropriations",16,1,0,4,21
739499,473928,2015-08-19,Assembly,"Do pass",17,0,0,0,17
739499,475997,2015-09-08,Assembly,"SB 530 Pan  Senate Third Reading  By MCCARTY",74,0,0,6,80
739499,476335,2015-09-10,Senate,"Unfinished Business SB530 Pan Concurrence",37,0,3,0,40
739500,440733,2015-04-27,Assembly,"Do pass and be re-referred to the Committee on Appropriations",15,0,0,0,15
739500,453991,2015-05-28,Assembly,"Do pass",17,0,0,0,17
739500,455476,2015-06-01,Assembly,"AB 895 RENDON  Assembly Third Reading",79,0,0,1,80
739500,464488,2015-06-30,Senate,"Do pass, but re-refer to the Committee on Appropriations",10,0,1,0,11
739500,465923,2015-07-13,Senate,"Placed on Appropriations Suspense file",7,0,0,0,7
739500,474694,2015-08-27,Senate,"Do pass as amended",5,0,2,0,7
739500,476371,2015-09-10,Senate,"Assembly 3rd Reading AB895 Rendon By Hueso",39,0,1,0,40
739500,476556,2015-09-11,Assembly,"AB 895 RENDON  Concurrence in Senate Amendments",79,0,0,1,80
739502,428926,2015-04-08,Assembly,"Do pass and be re-referred to the Committee on Appropriations",10,2,0,1,13
739502,453962,2015-05-28,Assembly,"Do pass",12,5,0,0,17
739502,455934,2015-06-02,Assembly,"AB 908 GOMEZ  Assembly Third Reading",60,17,0,3,80
739502,462594,2015-06-24,Senate,"Do pass, but re-refer to the Committee on Appropriations",4,1,0,0,5
739502,465137,2015-07-06,Senate,"Placed on Appropriations Suspense file",7,0,0,0,7
739502,474721,2015-08-27,Senate,"Do pass as amended",5,2,0,0,7
739502,476189,2015-09-09,Senate,"That the Assembly amendments be concurred in, but first be 	re-referred to the Committee on Appropriations",4,1,0,0,5
739502,476375,2015-09-10,Senate,"From Committee:  That the measure be returned to the Senate floor 	for consideration",5,2,0,0,7
739502,476564,2015-09-11,Senate,"Assembly 3rd Reading AB908 Gomez By Jackson",27,13,0,0,40
739502,509360,2016-02-29,Senate,"Assembly 3rd Reading AB908 Gomez By Jackson",28,11,1,0,40
739502,513036,2016-03-03,Assembly,"AB 908 GOMEZ  Concurrence in Senate Amendments",62,11,0,6,79
739505,429656,2015-04-08,Assembly,"Do pass as amended and be re-referred to the Committee on Human 	Services",7,0,0,0,7
739505,441531,2015-04-28,Assembly,"Do pass and be re-referred to the Committee on Appropriations",5,2,0,0,7
739507,441210,2015-04-28,Assembly,"Amend, and do pass as amended and be re-referred to the Committee 	on Appropriations with the recommendation:  To Consent Calendar",19,0,0,0,19
739507,446227,2015-05-13,Assembly,"Do pass, to Consent Calendar",17,0,0,0,17
739507,450261,2015-05-22,Assembly,"AB 861 MAIENSCHEIN  Consent Calendar Second Day  Regular Session",74,0,0,6,80
739507,460670,2015-06-17,Senate,"Do pass, but re-refer to the Committee on Appropriations",9,0,0,0,9
739507,465203,2015-07-06,Senate,"Placed on Appropriations Suspense file",7,0,0,0,7
739507,474607,2015-08-27,Senate,"Do pass",7,0,0,0,7
739507,476030,2015-09-08,Senate,"Assembly 3rd Reading AB861 Maienschein By Beall",40,0,0,0,40
739507,476126,2015-09-09,Assembly,"AB 861 MAIENSCHEIN  Concurrence in Senate Amendments",79,0,0,1,80
739510,440154,2015-04-28,Senate,"Do pass, but re-refer to the Committee on Appropriations",7,0,0,0,7
739510,445254,2015-05-11,Senate,"Placed on Appropriations Suspense file",7,0,0,0,7
739510,453868,2015-05-28,Senate,"Do pass as amended",6,1,0,0,7
739510,456757,2015-06-03,Senate,"Senate 3rd Reading SB519 Hancock",40,0,0,0,40
739510,466123,2015-07-14,Assembly,"Do pass as amended and be re-referred to the Committee on 	Appropriations",7,0,0,0,7
739510,474414,2015-08-27,Assembly,"Do pass",17,0,0,0,17
739510,475909,2015-09-08,Assembly,"SB 519 Hancock  Senate Third Reading  By JONES-SAWYER",64,14,0,2,80
739510,476370,2015-09-10,Senate,"Unfinished Business SB519 Hancock Concurrence",27,13,0,0,40
739512,484784,2016-01-12,Assembly,"Do pass as amended and be re-referred to the Committee on 	Appropriations",7,0,0,0,7
739512,485075,2016-01-05,Assembly,"Be referred to Committee on Human Services",11,0,0,0,11
739512,486398,2016-01-21,Assembly,"Do pass, to Consent Calendar",17,0,0,0,17
739512,488477,2016-01-27,Assembly,"AB 1001 MAIENSCHEIN  Consent Calendar Second Day  Regular Session",78,0,0,1,79
739512,544645,2016-05-10,Senate,"Do pass as amended, but re-refer to the Committee on Public Safety 	Recommend Consent",5,0,0,0,5
739512,552893,2016-06-14,Senate,"Do pass, but re-refer to the Committee on Appropriations Recommend 	Consent",7,0,0,0,7
739512,560593,2016-08-22,Senate,"Assembly 3rd Reading AB1001 Maienschein By Hancock",39,0,0,0,39
739512,561237,2016-08-25,Assembly,"AB 1001 MAIENSCHEIN  Concurrence in Senate Amendments",79,0,0,1,80
739513,442383,2015-04-29,Assembly,"Do pass and be re-referred to the Committee on Appropriations",2,5,0,0,7
739513,463699,2015-04-29,Assembly,"Reconsideration granted",7,0,0,0,7
739514,440124,2015-04-27,Assembly,"Do pass and be re-referred to the Committee on Appropriations",9,0,0,0,9
739514,453852,2015-05-28,Assembly,"Do pass",17,0,0,0,17
739514,455398,2015-06-01,Assembly,"AB 1032 SALAS  Assembly Third Reading",80,0,0,0,80
739514,462108,2015-06-23,Senate,"Do pass, but re-refer to the Committee on Governance and Finance 	Recommend Consent",11,0,0,0,11
739514,465711,2015-07-08,Senate,"Do pass, but re-refer to the Committee on Appropriations Recommend 	Consent",7,0,0,0,7
739514,473745,2015-08-17,Senate,"Placed on Appropriations Suspense file",7,0,0,0,7
739514,474550,2015-08-27,Senate,"Do pass",7,0,0,0,7
739514,475704,2015-09-02,Senate,"Assembly 3rd Reading AB1032 Salas By Leyva",40,0,0,0,40
739517,432852,2015-04-15,Senate,"Do pass, but re-refer to the Committee on Appropriations Recommend 	Consent",8,0,0,0,8
739517,453847,2015-05-28,Senate,"Do pass",7,0,0,0,7
739517,455943,2015-06-02,Senate,"Senate 3rd Reading SB497 Vidak",39,0,1,0,40
739517,463560,2015-05-18,Senate,"Placed on Appropriations Suspense file",7,0,0,0,7
739517,464904,2015-07-01,Assembly,"Do pass and be re-referred to the Committee on Appropriations to 	Consent Calendar",6,0,0,1,7
739517,465568,2015-07-08,Assembly,"Do pass, to Consent Calendar",14,0,0,3,17
739517,466483,2015-07-16,Assembly,"SB 497 Vidak  Consent Calendar Second Day  Regular Session",79,0,0,1,80
739518,437442,2015-04-22,Assembly,"Do pass and be re-referred to the Committee on Appropriations to 	Consent Calendar",7,0,0,0,7
739518,440996,2015-04-29,Assembly,"Do pass, to Consent Calendar",17,0,0,0,17
739518,444497,2015-05-07,Assembly,"AB 963 BONILLA  Consent Calendar Second Day  Regular Session",77,0,0,3,80
739518,465845,2015-07-13,Senate,"Do pass, but re-refer to the Committee on Appropriations",5,0,0,0,5
739518,473770,2015-08-17,Senate,"Do pass",7,0,0,0,7
739518,475562,2015-09-02,Senate,"Assembly 3rd Reading AB963 Bonilla By Pan",40,0,0,0,40
739518,475826,2015-09-03,Assembly,"AB 963 BONILLA  Concurrence in Senate Amendments",78,0,0,2,80
739520,484914,2016-01-13,Senate,"Do pass as amended, and re-refer to the Committee on Appropriations",6,0,3,0,9
739520,485583,2016-01-19,Senate,"Placed on Appropriations Suspense file",7,0,0,0,7
739520,486485,2016-01-21,Senate,"Do pass as amended",7,0,0,0,7
739520,488554,2016-01-27,Senate,"Senate 3rd Reading SB514 Anderson Urgency Clause",39,0,1,0,40
739520,553269,2016-06-14,Assembly,"Do pass and be re-referred to the Committee on Privacy and Consumer 	Protection to Consent Calendar",15,0,0,3,18
739520,554752,2016-06-21,Assembly,"Do pass and be re-referred to the Committee on Appropriations to 	Consent Calendar",11,0,0,0,11
739520,556496,2016-06-29,Assembly,"Do pass, to Consent Calendar",18,0,0,2,20
739520,559098,2016-08-04,Assembly,"SB 514 Anderson  Consent Calendar Second Day  Regular Session",77,0,0,3,80
739521,444061,2015-05-06,Assembly,"Do pass",6,3,0,0,9
739521,456069,2015-06-02,Assembly,"AB 906 COOPER  Assembly Third Reading",57,17,0,6,80
739521,466109,2015-07-14,Senate,"Do pass as amended",10,1,0,0,11
739521,474099,2015-08-24,Senate,"Assembly 3rd Reading AB906 Cooper By Pan",38,0,2,0,40
739521,474385,2015-08-27,Assembly,"AB 906 COOPER  Concurrence in Senate Amendments",78,0,0,2,80
739522,466158,2015-04-14,Assembly,"Do pass and be re-referred to the Committee on Appropriations",7,0,0,0,7
739526,440468,2015-04-27,Assembly,"Do pass as amended and be re-referred to the Committee on 	Appropriations",15,0,0,1,16
739526,446456,2015-05-13,Assembly,"Do pass, to Consent Calendar",17,0,0,0,17
739526,450065,2015-05-22,Assembly,"AB 995 BIGELOW  Consent Calendar Second Day  Regular Session",74,0,0,6,80
739526,560273,2016-08-18,Senate,"Assembly 3rd Reading AB995 Bigelow By Vidak",37,0,2,0,39
739526,560655,2016-08-23,Assembly,"AB 995 BIGELOW  Concurrence in Senate Amendments",78,0,0,2,80
739528,440981,2015-04-29,Assembly,"Do pass and be re-referred to the Committee on Appropriations to 	Consent Calendar",9,0,0,1,10
739528,446311,2015-05-13,Assembly,"Do pass, to Consent Calendar",17,0,0,0,17
739528,450217,2015-05-22,Assembly,"AB 1039 AGRI.  Consent Calendar Second Day  Regular Session",74,0,0,6,80
739528,465462,2015-07-07,Senate,"Do pass, but re-refer to the Committee on Appropriations Recommend 	Consent",5,0,0,0,5
739528,473974,2015-08-20,Senate,"Consent Calendar 2nd AB1039 Committee On AGRI. (Galgiani)",38,0,2,0,40
739529,442141,2015-04-30,Assembly,"From committee:  Be adopted.  To third reading",10,0,0,1,11
739529,461903,2015-06-22,Senate,"Special Consent #3 ACR35 Gonzalez",37,0,3,0,40
739531,440100,2015-04-27,Senate,"Do pass, but re-refer to the Committee on Appropriations",5,2,2,0,9
739531,451705,2015-05-26,Senate,"Do pass",5,2,0,0,7
739531,455380,2015-06-01,Senate,"Senate 3rd Reading SB538 Block",21,9,10,0,40
739531,464281,2015-06-30,Assembly,"Do pass as amended and be re-referred to the Committee on 	Appropriations",8,4,0,2,14
739531,474225,2015-08-26,Assembly,"Do pass",7,6,0,4,17
739531,474226,2015-08-26,Assembly,"Reconsideration granted",17,0,0,0,17
739531,559548,2016-08-10,Assembly,"Do pass as amended",11,1,0,8,20
739531,561754,2016-08-31,Assembly,"SB 538 Hueso  Senate Third Reading  By JONES",20,28,0,32,80
739532,436730,2015-04-21,Assembly,"Do pass and be re-referred to the Committee on Appropriations",9,0,0,0,9
739532,443986,2015-05-06,Assembly,"Do pass, to Consent Calendar",17,0,0,0,17
739532,446859,2015-05-14,Assembly,"AB 826 CHAU  Consent Calendar Second Day  Regular Session",78,0,0,2,80
739533,443696,2015-05-05,Assembly,"Do pass, to Consent Calendar",10,0,0,0,10
739533,445132,2015-05-11,Assembly,"AB 807 STONE  Consent Calendar Second Day  Regular Session",79,0,0,1,80
739533,458673,2015-06-09,Senate,"Do pass as amended",7,0,0,0,7
739533,475952,2015-09-08,Senate,"Assembly 3rd Reading AB807 Mark Stone By Wieckowski",40,0,0,0,40
739533,476147,2015-09-09,Assembly,"AB 807 STONE  Concurrence in Senate Amendments",78,0,0,2,80
739537,427826,2015-04-07,Assembly,"Do pass as amended",10,0,0,0,10
739537,454242,2015-05-28,Assembly,"AB 998 WAGNER  Assembly Third Reading",76,0,0,4,80
739537,466219,2015-07-14,Senate,"Do pass",6,0,1,0,7
739537,475274,2015-08-31,Senate,"Special Consent #8 AB998 Wagner",40,0,0,0,40
739537,475418,2015-09-01,Assembly,"AB 998 WAGNER  Concurrence in Senate Amendments",79,0,0,1,80
739538,432663,2015-04-15,Assembly,"Do pass and be re-referred to the Committee on Housing and 	Community Development",9,0,0,0,9
739538,441856,2015-04-29,Assembly,"Do pass and be re-referred to the Committee on Appropriations",6,0,0,1,7
739538,454425,2015-05-28,Assembly,"Do pass as amended",17,0,0,0,17
739538,456565,2015-06-03,Assembly,"AB 806 DODD  Assembly Third Reading",79,0,0,1,80
739538,553144,2016-06-15,Senate,"Do pass as amended",7,0,0,0,7
739538,559803,2016-08-15,Senate,"Assembly 3rd Reading AB806 Dodd By Hertzberg",38,0,1,0,39
739538,561154,2016-08-25,Assembly,"Senate amendments be concurred in",9,0,0,0,9
739538,561537,2016-08-30,Assembly,"AB 806 DODD  Concurrence in Senate Amendments",80,0,0,0,80
739539,427899,2015-04-07,Assembly,"Amend, and do pass as amended and be re-referred to the Committee 	on Privacy and Consumer Protection with the recommendation:  To 	Consent Calendar",10,0,0,0,10
739539,443423,2015-05-05,Assembly,"Do pass, to Consent Calendar",11,0,0,0,11
739539,446650,2015-05-14,Assembly,"AB 856 CALDERON  Consent Calendar Second Day",78,0,0,2,80
739539,466197,2015-07-14,Senate,"Do pass",7,0,0,0,7
739539,474060,2015-08-24,Senate,"Assembly 3rd Reading AB856 Calderon By Wieckowski",40,0,0,0,40
739539,474285,2015-08-27,Assembly,"AB 856 CALDERON  Concurrence in Senate Amendments",78,0,0,2,80
739541,443653,2015-05-05,Assembly,"Do pass as amended",17,0,0,2,19
739541,455482,2015-06-01,Assembly,"AB 1069 GORDON  Assembly Third Reading",80,0,0,0,80
739541,465352,2015-07-06,Senate,"Do pass, but re-refer to the Committee on Appropriations",7,0,2,0,9
739541,560289,2016-08-18,Senate,"Assembly 3rd Reading AB1069 Gordon By Beall",38,0,1,0,39
739541,560893,2016-08-23,Assembly,"AB 1069 GORDON  Concurrence in Senate Amendments",80,0,0,0,80
739542,437488,2015-04-22,Assembly,"Do pass and be re-referred to the Committee on Appropriations to 	Consent Calendar",7,0,0,0,7
739542,441019,2015-04-29,Assembly,"Do pass, to Consent Calendar",17,0,0,0,17
739542,444451,2015-05-07,Assembly,"AB 868 OBERNOLTE  Consent Calendar Second Day  Regular Session",77,0,0,3,80
739542,457904,2015-06-08,Senate,"Do pass, but re-refer to the Committee on Appropriations Recommend 	Consent",4,0,1,0,5
739542,462928,2015-06-25,Senate,"Consent Calendar 2nd AB868 Obernolte",37,0,3,0,40
739543,433013,2015-04-13,Assembly,"Do pass and be re-referred to the Committee on Appropriations",7,2,0,0,9
739543,453999,2015-05-28,Assembly,"Do pass as amended",12,5,0,0,17
739543,456812,2015-06-03,Assembly,"AB 876 MCCARTY  Assembly Third Reading",53,26,0,1,80
739543,464743,2015-07-01,Senate,"Do pass, but re-refer to the Committee on Appropriations",5,1,1,0,7
739543,474065,2015-08-24,Senate,"Assembly 3rd Reading AB876 McCarty By Wolk",26,14,0,0,40
739545,428998,2015-04-08,Senate,"Do pass, but re-refer to the Committee on Judiciary",6,0,2,0,8
739545,440215,2015-04-28,Senate,"Do pass as amended, and re-refer to the Committee on Appropriations",5,1,1,0,7
739545,454416,2015-05-28,Senate,"Senate 3rd Reading SB585 Leyva",29,4,7,0,40
739547,438073,2015-04-23,Assembly,"AB 989 COOPER  Assembly Third Reading",78,0,0,2,80
739547,462231,2015-06-23,Senate,"Do pass",7,0,0,0,7
739547,466155,2015-04-14,Assembly,"Do pass as amended",7,0,0,0,7
739547,475925,2015-09-08,Senate,"Assembly 3rd Reading AB989 Cooper By Hall",39,0,1,0,40
739547,476087,2015-09-09,Assembly,"AB 989 COOPER  Concurrence in Senate Amendments",78,0,0,2,80
739548,484743,2016-01-12,Assembly,"Do pass and be re-referred to the Committee on Appropriations to 	Consent Calendar",6,0,0,1,7
739548,486272,2016-01-21,Assembly,"Do pass, to Consent Calendar",17,0,0,0,17
739548,488335,2016-01-27,Assembly,"AB 898 GONZALEZ  Consent Calendar Second Day  Regular Session",78,0,0,1,79
739548,544275,2016-05-10,Senate,"Do pass, but re-refer to the Committee on Appropriations",7,0,0,0,7
739548,558629,2016-08-01,Senate,"Assembly 3rd Reading AB898 Gonzalez By Hertzberg",39,0,0,0,39
739548,559105,2016-08-04,Assembly,"AB 898 GONZALEZ  Concurrence in Senate Amendments",77,0,0,3,80
739550,429300,2015-04-08,Senate,"Do pass as amended, and re-refer to the Committee on Appropriations",9,0,0,0,9
739550,450263,2015-05-22,Senate,"Senate 3rd Reading SB476 Mendoza",39,0,0,0,39
739550,466078,2015-07-14,Assembly,"Do pass as amended and be re-referred to the Committee on 	Appropriations",15,2,0,2,19
739551,442263,2015-04-29,Senate,"Do pass as amended, and re-refer to the Committee on Appropriations",6,2,1,0,9
739551,463659,2015-05-18,Senate,"Placed on Appropriations Suspense file",7,0,0,0,7
739553,443660,2015-05-06,Assembly,"Do pass",7,0,0,0,7
739553,445222,2015-05-11,Assembly,"AB 1031 THURMOND  Assembly Third Reading",79,0,0,1,80
739553,457962,2015-06-08,Senate,"Do pass, but re-refer to the Committee on Appropriations",3,1,1,0,5
739553,475823,2015-09-03,Senate,"Assembly 3rd Reading AB1031 Thurmond By McGuire",33,6,1,0,40
739553,475887,2015-09-04,Assembly,"AB 1031 THURMOND  Concurrence in Senate Amendments",79,0,0,1,80
739554,439969,2015-04-27,Assembly,"Do pass and be re-referred to the Committee on Appropriations",15,0,0,1,16
739556,436293,2015-04-21,Senate,"Do pass, but re-refer to the Committee on Appropriations",4,1,0,0,5
739556,446710,2015-05-14,Senate,"Senate 3rd Reading SB505 Mendoza",26,11,2,0,39
739556,464845,2015-07-01,Assembly,"Do pass and be re-referred to the Committee on Appropriations",5,1,0,1,7
739556,465582,2015-07-08,Assembly,"Do pass",10,4,0,3,17
739556,473704,2015-08-17,Assembly,"SB 505 Mendoza  Senate Third Reading  By THURMOND",52,25,0,3,80
739557,436049,2015-04-21,Senate,"Do pass, but re-refer to the Committee on Environmental Quality",10,0,1,0,11
739557,441151,2015-04-29,Senate,"Do pass, but re-refer to the Committee on Appropriations",7,0,0,0,7
739557,453800,2015-05-28,Senate,"Do pass as amended",7,0,0,0,7
739557,456789,2015-06-03,Senate,"Senate 3rd Reading SB513 Beall",40,0,0,0,40
739557,463675,2015-05-18,Senate,"Placed on Appropriations Suspense file",7,0,0,0,7
739557,465907,2015-07-13,Assembly,"Do pass and be re-referred to the Committee on Appropriations",12,3,0,1,16
739557,474353,2015-08-27,Assembly,"Do pass as amended",12,5,0,0,17
739557,475684,2015-09-02,Assembly,"SB 513 Beall  Senate Third Reading  By FRAZIER",54,26,0,0,80
739557,475802,2015-09-03,Senate,"Unfinished Business SB513 Beall Concurrence",39,0,1,0,40
739558,428579,2015-04-07,Assembly,"Do pass as amended and be re-referred to the Committee on Education",12,0,0,1,13
739558,442274,2015-04-29,Assembly,"Do pass and be re-referred to the Committee on Appropriations",7,0,0,0,7
739559,428442,2015-04-07,Assembly,"Do pass and be re-referred to the Committee on Appropriations",12,0,0,1,13
739560,440201,2015-04-27,Senate,"Do pass, but re-refer to the Committee on Appropriations",9,0,0,0,9
739560,450289,2015-05-22,Senate,"Special Consent #2 SB561 Monning",38,0,1,0,39
739560,462158,2015-06-23,Assembly,"Do pass and be re-referred to the Committee on Appropriations to 	Consent Calendar",14,0,0,0,14
739560,463647,2015-05-18,Senate,"Do pass",7,0,0,0,7
739560,465707,2015-07-08,Assembly,"Do pass, to Consent Calendar",14,0,0,3,17
739560,466534,2015-07-16,Assembly,"SB 561 Monning  Consent Calendar Second Day  Regular Session",79,0,0,1,80
739560,473944,2015-08-20,Senate,"Special Consent #6 SB561 Monning",38,0,2,0,40
739561,437084,2015-04-21,Assembly,"Do pass and be re-referred to the Committee on Human Services",11,2,0,0,13
739561,440905,2015-04-28,Assembly,"Do pass and be re-referred to the Committee on Appropriations",5,0,0,2,7
739561,453934,2015-05-28,Assembly,"Do pass as amended",12,3,0,2,17
739561,456663,2015-06-03,Assembly,"AB 801 BLOOM  Assembly Third Reading",61,13,0,6,80
739561,465638,2015-07-08,Senate,"Do pass, but re-refer to the Committee on Appropriations",7,0,2,0,9
739561,473611,2015-08-17,Senate,"Placed on Appropriations Suspense file",7,0,0,0,7
739561,474497,2015-08-27,Senate,"Do pass as amended",6,0,1,0,7
739561,560685,2016-08-23,Senate,"Assembly 3rd Reading AB801 Bloom By Leno",36,1,2,0,39
739561,561439,2016-08-29,Assembly,"AB 801 BLOOM  Concurrence in Senate Amendments",66,13,0,1,80
739563,441296,2015-04-29,Assembly,"Do pass as amended and be re-referred to the Committee on 	Appropriations",5,1,0,1,7
739563,453813,2015-05-28,Assembly,"Do pass as amended",12,5,0,0,17
739563,457241,2015-06-04,Assembly,"AB 870 COOLEY  Assembly Third Reading",66,12,0,2,80
739563,464298,2015-06-30,Senate,"Do pass, but re-refer to the Committee on Appropriations",9,0,2,0,11
739563,465886,2015-07-13,Senate,"Placed on Appropriations Suspense file",7,0,0,0,7
739563,474592,2015-08-27,Senate,"Do pass as amended",5,0,2,0,7
739565,438116,2015-04-14,Assembly,"Do pass as amended and be re-referred to the Committee on 	Appropriations",16,0,0,3,19
739565,453753,2015-05-28,Assembly,"Do pass as amended",17,0,0,0,17
739565,455901,2015-06-02,Assembly,"AB 858 WOOD  Assembly Third Reading",76,0,0,4,80
739565,460651,2015-06-17,Senate,"Do pass, but re-refer to the Committee on Appropriations",9,0,0,0,9
739565,465193,2015-07-06,Senate,"Placed on Appropriations Suspense file",7,0,0,0,7
739565,474572,2015-08-27,Senate,"Do pass as amended",7,0,0,0,7
739565,476062,2015-09-09,Senate,"Assembly 3rd Reading AB858 Wood By Pan",40,0,0,0,40
739565,476361,2015-09-10,Assembly,"AB 858 WOOD  Concurrence in Senate Amendments",80,0,0,0,80
739566,440413,2015-04-28,Assembly,"Do pass as amended and be re-referred to the Committee on 	Appropriations",6,1,0,0,7
739566,453942,2015-05-28,Assembly,"Do pass",16,0,0,1,17
739566,455983,2015-06-02,Assembly,"AB 1051 MAIENSCHEIN  Assembly Third Reading",74,0,0,6,80
739566,465454,2015-07-07,Senate,"Do pass as amended, and re-refer to the Committee on Appropriations",6,0,1,0,7
739566,473684,2015-08-17,Senate,"Placed on Appropriations Suspense file",7,0,0,0,7
739566,556869,2016-06-29,Senate,"Do pass as amended, and re-refer to the Committee on Appropriations",8,0,1,0,9
739568,440431,2015-04-28,Assembly,"Do pass as amended and be re-referred to the Committee on 	Appropriations",13,0,0,1,14
739568,449037,2015-05-20,Assembly,"Do pass, to Consent Calendar",15,0,0,2,17
739568,454029,2015-05-28,Assembly,"AB 808 RIDLEY-THOMAS  Assembly Third Reading",71,5,0,4,80
739568,461821,2015-06-22,Senate,"Do pass, but re-refer to the Committee on Transportation and 	Housing",8,0,1,0,9
739568,466033,2015-07-14,Senate,"Do pass as amended, and re-refer to the Committee on Appropriations",11,0,0,0,11
739568,474085,2015-08-24,Senate,"Placed on Appropriations Suspense file",7,0,0,0,7
739568,474587,2015-08-27,Senate,"Do pass",7,0,0,0,7
739568,475734,2015-09-03,Senate,"Assembly 3rd Reading AB808 Ridley-Thomas By Beall",40,0,0,0,40
739568,475851,2015-09-04,Assembly,"AB 808 RIDLEY-THOMAS  Concurrence in Senate Amendments",77,3,0,0,80
739570,440082,2015-04-27,Assembly,"Do pass and be re-referred to the Committee on Appropriations",3,6,0,0,9
739571,437154,2015-04-22,Senate,"Do pass, but re-refer to the Committee on Labor and Industrial 	Relations",7,2,0,0,9
739571,441120,2015-04-29,Senate,"Do pass, but re-refer to the Committee on Appropriations",4,1,0,0,5
739571,454055,2015-05-28,Senate,"Do pass as amended",5,2,0,0,7
739571,456640,2015-06-03,Senate,"Senate 3rd Reading SB548 De Le",25,12,3,0,40
739571,463654,2015-05-18,Senate,"Placed on Appropriations Suspense file",7,0,0,0,7
739571,473552,2015-07-08,Assembly,"Do pass and be re-referred to the Committee on Appropriations",5,2,0,0,7
739571,474401,2015-08-27,Assembly,"Do pass",12,5,0,0,17
739571,476379,2015-09-10,Assembly,"Do pass as amended",4,1,0,2,7
739571,476610,2015-09-11,Assembly,"Do pass as amended",5,1,0,1,7
739571,476611,2015-09-11,Senate,"From committee:  That the Assembly Amendments be concurred in",7,1,1,0,9
739571,476612,2015-09-11,Assembly,"SB 548 De Leon  Senate Third Reading  By ALEJO",50,26,0,4,80
739571,476613,2015-09-11,Senate,"Unfinished Business (S upplemental File 6)SB5 48 De Le",26,14,0,0,40
739572,484745,2016-01-12,Assembly,"Do pass as amended and be re-referred to the Committee on 	Appropriations",7,0,0,0,7
739572,486334,2016-01-21,Assembly,"Do pass, to Consent Calendar",17,0,0,0,17
739572,488328,2016-01-27,Assembly,"AB 1067 GIPSON  Consent Calendar Second Day  Regular Session",78,0,0,1,79
739572,544306,2016-05-10,Senate,"Do pass as amended, and re-refer to the Committee on Appropriations",5,0,0,0,5
739572,560515,2016-08-22,Senate,"Assembly 3rd Reading AB1067 Gipson By McGuire",38,0,1,0,39
739572,561145,2016-08-25,Assembly,"AB 1067 GIPSON  Concurrence in Senate Amendments",79,0,0,1,80
739575,440115,2015-04-28,Assembly,"Do pass and be re-referred to the Committee on Appropriations",5,2,0,0,7
739577,432500,2015-04-15,Assembly,"Do pass and be re-referred to the Committee on Appropriations",9,0,0,0,9
739577,437227,2015-04-22,Assembly,"Do pass, to Consent Calendar",17,0,0,0,17
739577,442167,2015-04-30,Assembly,"AB 797 STEINORTH  Consent Calendar Second Day  Regular Session",77,0,0,3,80
739577,553095,2016-06-14,Senate,"Do pass, but re-refer to the Committee on Rules",7,0,0,0,7
739577,556249,2016-06-28,Senate,"Do pass",7,0,0,0,7
739577,559818,2016-08-15,Senate,"Assembly 3rd Reading AB797 Steinorth By Glazer",37,0,2,0,39
739577,560709,2016-08-23,Assembly,"Senate amendments be concurred in",8,0,0,2,10
739577,561189,2016-08-25,Assembly,"AB 797 STEINORTH  Concurrence in Senate Amendments",77,0,0,3,80
739579,439492,2015-04-27,Senate,"Senate 3rd Reading SB531 Bates",34,0,5,0,39
739579,446936,2015-04-06,Senate,"Do pass, but re-refer to the Committee on Appropriations",9,0,0,0,9
739579,462172,2015-06-23,Assembly,"Do pass as amended and be re-referred to the Committee on 	Appropriations",14,0,0,0,14
739579,465620,2015-07-08,Assembly,"Do pass, to Consent Calendar",14,0,0,3,17
739579,466559,2015-07-16,Assembly,"SB 531 Bates  Consent Calendar Second Day  Regular Session",79,0,0,1,80
739579,474001,2015-08-20,Senate,"Special Consent #6 SB531 Bates",38,0,2,0,40
739581,432967,2015-04-15,Assembly,"Do pass as amended and be re-referred to the Committee on 	Appropriations",9,0,0,0,9
739581,441134,2015-04-29,Assembly,"Do pass, to Consent Calendar",17,0,0,0,17
739581,444433,2015-05-07,Assembly,"AB 951 WILK  Consent Calendar Second Day  Regular Session",77,0,0,3,80
739581,465731,2015-07-08,Senate,"Do pass, but re-refer to the Committee on Appropriations",7,0,0,0,7
739581,475376,2015-08-31,Senate,"Assembly 3rd Reading AB951 Wilk By Runner",40,0,0,0,40
739581,475426,2015-09-01,Assembly,"AB 951 WILK  Concurrence in Senate Amendments",79,0,0,1,80
739582,440273,2015-04-28,Senate,"Do pass, but re-refer to the Committee on Appropriations Recommend 	Consent",7,0,4,0,11
739582,445427,2015-05-11,Senate,"Do pass",7,0,0,0,7
739582,450247,2015-05-22,Senate,"Senate 3rd Reading SB557 Hall",39,0,0,0,39
739582,465641,2015-07-08,Assembly,"Do pass and be re-referred to the Committee on Appropriations",19,0,0,2,21
739582,473879,2015-08-19,Assembly,"Do pass, to Consent Calendar",17,0,0,0,17
739582,475786,2015-09-03,Assembly,"SB 557 Hall  Senate Third Reading  By GRAY",80,0,0,0,80
739582,475928,2015-09-08,Senate,"Unfinished Business SB557 Hall Concurrence",40,0,0,0,40
739585,441036,2015-04-29,Senate,"Do pass, but re-refer to the Committee on Appropriations",6,0,1,0,7
739585,445152,2015-05-11,Senate,"Placed on Appropriations Suspense file",7,0,0,0,7
739585,453675,2015-05-28,Senate,"Do pass",5,0,2,0,7
739585,455539,2015-06-01,Senate,"Senate 3rd Reading SB552 Wolk",31,5,4,0,40
739585,548975,2016-05-27,Assembly,"Be referred to Committee on Environmental Safety and Toxic 	Materials",10,0,0,1,11
739585,552684,2016-06-14,Assembly,"Do pass as amended and be re-referred to the Committee on Water, 	Parks and Wildlife",4,2,0,1,7
739585,555988,2016-06-28,Assembly,"Do pass and be re-referred to the Committee on Appropriations",10,5,0,0,15
739585,559246,2016-08-11,Assembly,"Do pass as amended",11,4,0,5,20
739585,560367,2016-08-19,Assembly,"SB 552 Wolk  Senate Third Reading  Amend By ARAMBULA  Set #1",50,21,0,9,80
739585,560774,2016-08-23,Assembly,"SB 552 Wolk  Senate Third Reading  By ARAMBULA",50,28,0,2,80
739585,561324,2016-08-26,Senate,"From committee:  That the Assembly Amendments be concurred in",5,2,0,0,7
739585,561430,2016-08-29,Senate,"Unfinished Business SB552 Wolk Concurrence",25,13,1,0,39
739586,441220,2015-04-29,Senate,"Do pass as amended, and re-refer to the Committee on Appropriations",7,0,0,0,7
739586,453919,2015-05-28,Senate,"Do pass as amended",6,1,0,0,7
739586,456656,2015-06-03,Senate,"Senate 3rd Reading SB471 Pavley",37,2,1,0,40
739586,463616,2015-05-18,Senate,"Placed on Appropriations Suspense file",7,0,0,0,7
739586,466099,2015-07-13,Assembly,"Do pass as amended and be re-referred to the Committee on 	Appropriations",9,0,0,0,9
739588,437243,2015-04-22,Senate,"Do pass as amended",7,0,1,0,8
739588,442851,2015-05-04,Senate,"Senate 3rd Reading SB575 Liu",36,0,3,0,39
739588,462610,2015-06-24,Assembly,"Do pass as amended and be re-referred to the Committee on Aging and 	Long",13,0,0,0,13
739588,474381,2015-08-27,Assembly,"SB 575 Liu  Senate Third Reading  By BROWN",79,0,0,1,80
739588,475501,2015-09-01,Senate,"Special Consent #9 SB575 Liu",40,0,0,0,40
739591,440894,2015-04-28,Senate,"Do pass, but re-refer to the Committee on Appropriations",3,1,1,0,5
739591,445309,2015-05-11,Senate,"Placed on Appropriations Suspense file",7,0,0,0,7
739594,440152,2015-04-27,Assembly,"Do pass as amended and be re-referred to the Committee on 	Appropriations",15,0,0,1,16
739594,446143,2015-05-13,Assembly,"Do pass, to Consent Calendar",17,0,0,0,17
739594,453884,2015-05-28,Assembly,"AB 914 BROWN  Assembly Third Reading",69,7,0,4,80
739594,462374,2015-06-23,Senate,"Do pass as amended, and re-refer to the Committee on Appropriations",10,0,1,0,11
739594,465929,2015-07-13,Senate,"Do pass",5,2,0,0,7
739594,476608,2015-09-11,Senate,"Assembly 3rd Reading AB914 Brown By Leyva",33,4,3,0,40
739594,476609,2015-09-11,Assembly,"AB 914 BROWN  Concurrence in Senate Amendments",73,5,0,2,80
739595,437155,2015-04-21,Assembly,"Do pass and be re-referred to the Committee on Appropriations",18,0,0,1,19
739595,453651,2015-05-28,Assembly,"Do pass as amended",17,0,0,0,17
739595,455981,2015-06-02,Assembly,"AB 1018 COOPER  Assembly Third Reading",71,0,0,9,80
739595,462570,2015-06-24,Senate,"Do pass, but re-refer to the Committee on Health",9,0,0,0,9
739595,464702,2015-07-01,Senate,"Do pass, but re-refer to the Committee on Appropriations",7,0,2,0,9
739595,473600,2015-08-17,Senate,"Placed on Appropriations Suspense file",7,0,0,0,7
739596,441174,2015-04-29,Assembly,"Do pass and be re-referred to the Committee on Appropriations to 	Consent Calendar",9,0,0,1,10
739596,446254,2015-05-13,Assembly,"Do pass, to Consent Calendar",17,0,0,0,17
739596,450133,2015-05-22,Assembly,"AB 862 AGRI.  Consent Calendar Second Day  Regular Session",74,0,0,6,80
739596,474022,2015-08-20,Senate,"Consent Calendar 2nd AB862 Committee On AGRI. (Galgiani)",38,0,2,0,40
739596,474145,2015-08-24,Assembly,"AB 862 AGRI.  Concurrence in Senate Amendments By PEREA",79,0,0,1,80
739597,432658,2015-04-15,Assembly,"Do pass and be re-referred to the Committee on Appropriations",5,1,0,1,7
739600,445761,2015-05-12,Assembly,"Do pass and be re-referred to the Committee on Appropriations to 	Consent Calendar",10,0,0,0,10
739600,449033,2015-05-20,Assembly,"Do pass, to Consent Calendar",15,0,0,2,17
739600,451567,2015-05-26,Assembly,"AB 897 GONZALEZ  Consent Calendar Second Day  Regular Session",76,0,0,4,80
739600,475362,2015-08-31,Senate,"Assembly 3rd Reading AB897 Gonzalez By Leyva",24,10,6,0,40
739600,475635,2015-09-02,Assembly,"AB 897 GONZALEZ  Concurrence in Senate Amendments",63,15,0,2,80
739601,437470,2015-04-22,Assembly,"Do pass and be re-referred to the Committee on Appropriations",7,0,0,0,7
739601,454106,2015-05-28,Assembly,"Do pass",17,0,0,0,17
739603,440749,2015-04-27,Assembly,"Do pass as amended and be re-referred to the Committee on 	Appropriations",9,3,0,0,12
739603,446256,2015-05-13,Assembly,"Do pass as amended",12,5,0,0,17
739603,450290,2015-05-22,Assembly,"AB 816 BONTA  Assembly Third Reading",55,17,0,8,80
739603,465846,2015-07-13,Senate,"Assembly 3rd Reading AB816 Bonta By Hancock",39,0,1,0,40
739603,466508,2015-07-16,Assembly,"AB 816 BONTA  Concurrence in Senate Amendments",59,18,0,3,80
739608,432674,2015-04-14,Assembly,"Do pass and be re-referred to the Committee on Appropriations",6,0,0,1,7
739608,440417,2015-04-28,Assembly,"Amend, and do pass as amended and be re-referred to the Committee 	on Appropriations with the recommendation:  To Consent Calendar",15,0,0,0,15
739608,453747,2015-05-28,Assembly,"Do pass",17,0,0,0,17
739608,455447,2015-06-01,Assembly,"AB 965 GARCIA, E.  Assembly Third Reading",80,0,0,0,80
739608,462193,2015-06-23,Senate,"Do pass, but re-refer to the Committee on Environmental Quality",8,0,1,0,9
739608,466324,2015-07-15,Senate,"Do pass as amended, and re-refer to the Committee on Appropriations",7,0,0,0,7
739608,474066,2015-08-24,Senate,"Placed on Appropriations Suspense file",7,0,0,0,7
739608,474642,2015-08-27,Senate,"Do pass",7,0,0,0,7
739608,475453,2015-09-01,Senate,"Assembly 3rd Reading AB965 Eduardo Garcia By Hueso",40,0,0,0,40
739608,475602,2015-09-02,Assembly,"AB 965 GARCIA, E.  Concurrence in Senate Amendments",80,0,0,0,80
739609,441619,2015-04-28,Assembly,"Amend, and do pass as amended and be re-referred to the Committee 	on Appropriations with the recommendation:  To Consent Calendar",19,0,0,0,19
739609,446113,2015-05-13,Assembly,"Do pass, to Consent Calendar",17,0,0,0,17
739609,450223,2015-05-22,Assembly,"AB 847 MULLIN  Consent Calendar Second Day  Regular Session",74,0,0,6,80
739609,460618,2015-06-17,Senate,"Do pass, but re-refer to the Committee on Appropriations",9,0,0,0,9
739609,514825,2016-03-07,Senate,"Do pass",7,0,0,0,7
739609,517850,2016-03-10,Senate,"Assembly 3rd Reading AB847 Mullin By Beall Urgency Claus",39,0,1,0,40
739609,521087,2016-03-17,Assembly,"AB 847 MULLIN  Concurrence in Senate Amendments",68,0,0,11,79
739611,440823,2015-04-27,Assembly,"Do pass and be re-referred to the Committee on Appropriations",9,0,0,0,9
739611,454159,2015-05-28,Assembly,"Do pass",17,0,0,0,17
739611,455400,2015-06-01,Assembly,"AB 1071 ATKINS  Assembly Third Reading",79,0,0,1,80
739611,466390,2015-07-15,Senate,"Do pass as amended, and re-refer to the Committee on Appropriations",7,0,0,0,7
739611,474149,2015-08-24,Senate,"Placed on Appropriations Suspense file",7,0,0,0,7
739611,474661,2015-08-27,Senate,"Do pass as amended",6,1,0,0,7
739611,475755,2015-09-03,Senate,"Assembly 3rd Reading AB1071 Atkins By Mitchell",39,1,0,0,40
739611,475870,2015-09-04,Assembly,"AB 1071 ATKINS  Concurrence in Senate Amendments",78,0,0,2,80
739612,440307,2015-04-27,Assembly,"Do pass as amended and be re-referred to the Committee on 	Appropriations",9,0,0,0,9
739612,448972,2015-05-20,Assembly,"Do pass",15,0,0,2,17
739612,450165,2015-05-22,Assembly,"AB 1030 RIDLEY-THOMAS  Assembly Third Reading",71,1,0,8,80
739612,464789,2015-07-01,Senate,"Do pass as amended, and re-refer to the Committee on Appropriations",6,0,1,0,7
739612,473586,2015-08-17,Senate,"Placed on Appropriations Suspense file",7,0,0,0,7
739613,407768,2015-03-09,Senate,"Senate 3rd Reading SR14 Hall",36,0,1,0,37
739615,430661,2015-04-13,Assembly,"Be referred to Committee on Elections and Redistricting",11,0,0,0,11
739615,440977,2015-04-29,Assembly,"Do pass as amended and be re-referred to the Committee on 	Appropriations",5,1,0,1,7
739615,449035,2015-05-20,Assembly,"Do pass",11,4,0,2,17
739615,451390,2015-05-26,Assembly,"AB 884 RENDON  Assembly Third Reading",50,26,0,4,80
739615,552088,2016-06-08,Senate,"Do pass, but re-refer to the Committee on Appropriations",4,1,0,0,5
739615,552483,2016-06-13,Senate,"Do pass",4,2,1,0,7
739615,561312,2016-08-25,Senate,"Assembly 3rd Reading AB884 Gordon By Wolk Urgency Clause",38,0,1,0,39
739615,561541,2016-08-30,Assembly,"AB 884 GORDON  Concurrence- Urgency Added",80,0,0,0,80
739617,441577,2015-04-29,Assembly,"Do pass and be re-referred to the Committee on Appropriations",9,0,0,1,10
739617,446305,2015-05-13,Assembly,"Do pass as amended, to Consent Calendar",17,0,0,0,17
739617,450163,2015-05-22,Assembly,"AB 958 AGRI.  Consent Calendar Second Day  Regular Session",74,0,0,6,80
739617,465407,2015-07-07,Senate,"Do pass, but re-refer to the Committee on Appropriations Recommend 	Consent",5,0,0,0,5
739617,474023,2015-08-20,Senate,"Consent Calendar 2nd AB958 Committee On AGRI. (Galgiani) By Pan",38,0,2,0,40
739617,474157,2015-08-24,Assembly,"AB 958 AGRI.  Concurrence in Senate Amendments By PEREA",78,0,0,2,80
739618,432712,2015-04-15,Senate,"Do pass as amended, and re-refer to the Committee on Appropriations",7,0,0,0,7
739618,442843,2015-05-04,Senate,"Placed on Appropriations Suspense file",7,0,0,0,7
739619,462797,2015-06-24,Assembly,"Be adopted and be re-referred to the Committee on Appropriations",2,3,0,2,7
739619,462798,2015-06-24,Assembly,"Reconsideration granted",7,0,0,0,7
739620,437114,2015-04-22,Senate,"Do pass as amended, and re-refer to the Committee on Appropriations",5,2,2,0,9
739620,454165,2015-05-28,Senate,"Do pass as amended",5,2,0,0,7
739620,456739,2015-06-03,Senate,"Senate 3rd Reading SB546 Leno",23,16,1,0,40
739620,463690,2015-05-18,Senate,"Placed on Appropriations Suspense file",7,0,0,0,7
739620,465351,2015-07-07,Assembly,"Do pass and be re-referred to the Committee on Appropriations",11,8,0,0,19
739620,474468,2015-08-27,Assembly,"Do pass as amended",12,5,0,0,17
739620,476337,2015-09-10,Assembly,"SB 546 Leno  Senate Third Reading  By BONILLA",51,27,0,2,80
739620,476529,2015-09-11,Senate,"Unfinished Business SB546 Leno Concurrence",26,14,0,0,40
739622,432648,2015-04-15,Senate,"Do pass, but re-refer to the Committee on Appropriations",7,0,0,0,7
739622,453976,2015-05-28,Senate,"Do pass",7,0,0,0,7
739622,455317,2015-06-01,Senate,"Senate 3rd Reading SB500 Hertzberg",40,0,0,0,40
739622,463677,2015-04-27,Senate,"Placed on Appropriations Suspense file",7,0,0,0,7
739622,466173,2015-07-13,Assembly,"Do pass as amended and be re-referred to the Committee on 	Appropriations",9,0,0,0,9
739623,432809,2015-04-14,Assembly,"Do pass as amended and be re-referred to the Committee on Housing 	and Community Development",10,0,0,0,10
739623,441527,2015-04-29,Assembly,"Do pass and be re-referred to the Committee on Appropriations",6,0,0,1,7
739623,446180,2015-05-13,Assembly,"Do pass, to Consent Calendar",17,0,0,0,17
739623,450275,2015-05-22,Assembly,"AB 999 DALY  Consent Calendar Second Day  Regular Session",74,0,0,6,80
739623,462214,2015-06-23,Senate,"Do pass, but re-refer to the Committee on Judiciary",8,0,3,0,11
739623,465678,2015-07-07,Senate,"Do pass as amended, and re-refer to the Committee on Appropriations",6,0,1,0,7
739623,473588,2015-08-17,Senate,"Do pass",7,0,0,0,7
739623,475397,2015-09-01,Senate,"Assembly 3rd Reading AB999 Daly By Hill",39,0,1,0,40
739623,475709,2015-09-03,Assembly,"AB 999 DALY  Concurrence in Senate Amendments",77,0,0,3,80
739625,427981,2015-04-06,Assembly,"Do pass and be re-referred to the Committee on Appropriations",15,0,0,1,16
739625,441098,2015-04-29,Assembly,"Do pass, to Consent Calendar",17,0,0,0,17
739625,444414,2015-05-07,Assembly,"AB 869 COOPER  Consent Calendar Second Day  Regular Session",77,0,0,3,80
739625,460183,2015-06-16,Senate,"Do pass as amended, and re-refer to the Committee on Appropriations",11,0,0,0,11
739626,443377,2015-05-05,Assembly,"Do pass and be re-referred to the Committee on Health",7,4,0,3,14
739626,444427,2015-05-07,Assembly,"Reconsideration granted",14,0,0,0,14
739626,484757,2016-01-12,Assembly,"Do pass and be re-referred to the Committee on Appropriations",18,0,0,1,19
739626,486301,2016-01-21,Assembly,"Do pass",17,0,0,0,17
739626,487025,2016-01-25,Assembly,"AB 796 NAZARIAN  Assembly Third Reading",75,0,0,4,79
739626,553111,2016-06-15,Senate,"Do pass as amended, and re-refer to the Committee on Human Services",6,2,1,0,9
739626,556272,2016-06-28,Senate,"Do pass as amended, and re-refer to the Committee on Appropriations",5,0,0,0,5
739626,558704,2016-08-01,Senate,"Placed on Appropriations Suspense file",7,0,0,0,7
739626,559621,2016-08-11,Senate,"Do pass as amended",5,0,2,0,7
739626,560936,2016-08-24,Senate,"Assembly 3rd Reading AB796 Nazarian By Pan",39,0,0,0,39
739626,561533,2016-08-30,Assembly,"AB 796 NAZARIAN  Concurrence in Senate Amendments",80,0,0,0,80
739628,437127,2015-04-22,Assembly,"Do pass, to Consent Calendar",17,0,0,0,17
739628,442216,2015-04-30,Assembly,"AB 950 MELENDEZ  Consent Calendar Second Day  Regular Session",77,0,0,3,80
739628,458325,2015-06-09,Senate,"Do pass, but re-refer to the Committee on Appropriations",7,0,0,0,7
739628,463855,2015-06-29,Senate,"Do pass as amended",6,0,1,0,7
739628,465168,2015-07-06,Senate,"Special Consent #4 AB950 Melendez By Pan",39,0,1,0,40
739628,465757,2015-07-09,Assembly,"AB 950 MELENDEZ  Concurrence in Senate Amendments",78,0,0,2,80
739628,466067,2015-04-14,Assembly,"Do pass and be re-referred to the Committee on Appropriations to 	Consent Calendar",7,0,0,0,7
739629,440387,2015-04-27,Assembly,"Do pass, to Consent Calendar",16,0,0,0,16
739629,442862,2015-05-04,Assembly,"AB 1015 BLOOM  Consent Calendar Second Day  Regular Session",78,0,0,2,80
739629,458823,2015-06-09,Senate,"Do pass and be placed on the Consent Calendar",11,0,0,0,11
739629,461122,2015-06-18,Senate,"Consent Calendar 2nd AB1015 Bloom",37,0,3,0,40
739630,432636,2015-04-15,Senate,"Do pass as amended, and re-refer to the Committee on Appropriations",6,2,0,0,8
739630,445177,2015-05-11,Senate,"Placed on Appropriations Suspense file",7,0,0,0,7
739630,453720,2015-05-28,Senate,"Do pass",5,2,0,0,7
739630,456152,2015-06-02,Senate,"Senate 3rd Reading SB572 Pan Reconsider",40,0,0,0,40
739630,457939,2015-06-02,Senate,"Senate 3rd Reading SB572 Pan",17,19,4,0,40
739631,429661,2015-04-08,Assembly,"Do pass as amended and be re-referred to the Committee on 	Appropriations",6,0,0,1,7
739633,432605,2015-04-15,Assembly,"Do pass and be re-referred to the Committee on Appropriations",2,2,0,3,7
739633,441891,2015-04-29,Assembly,"Do pass and be re-referred to the Committee on Appropriations",4,3,0,0,7
739633,446207,2015-05-13,Assembly,"Do pass",17,0,0,0,17
739633,450130,2015-05-22,Assembly,"AB 809 OBERNOLTE  Assembly Third Reading",57,8,0,15,80
739633,463632,2015-04-15,Assembly,"Reconsideration granted",6,0,0,1,7
739633,465500,2015-07-07,Senate,"Do pass, but re-refer to the Committee on Appropriations",4,0,1,0,5
739633,474279,2015-08-27,Senate,"Assembly 3rd Reading AB809 Obernolte By Cannella",40,0,0,0,40
739636,436135,2015-04-21,Assembly,"Do pass and be re-referred to the Committee on Appropriations",9,0,0,0,9
739636,453891,2015-05-28,Assembly,"Do pass as amended",17,0,0,0,17
739636,455895,2015-06-02,Assembly,"AB 866 GARCIA, E.  Assembly Third Reading",78,0,0,2,80
739636,544634,2016-05-10,Senate,"Do pass as amended, and re-refer to the Committee on Appropriations",10,0,3,0,13
739638,437106,2015-04-21,Assembly,"Do pass as amended and be re-referred to the Committee on 	Appropriations",13,0,0,0,13
739638,454339,2015-05-28,Assembly,"Do pass as amended",17,0,0,0,17
739638,455961,2015-06-02,Assembly,"AB 1000 WEBER  Assembly Third Reading",79,0,0,1,80
739638,475335,2015-08-31,Senate,"Assembly 3rd Reading AB1000 Weber By Leyva",40,0,0,0,40
739638,475510,2015-09-01,Assembly,"AB 1000 WEBER  Concurrence in Senate Amendments",80,0,0,0,80
739639,428504,2015-04-08,Senate,"Do pass",5,0,0,0,5
739639,430629,2015-04-13,Senate,"Senate 3rd Reading SB559 Block",28,3,8,0,39
739640,442211,2015-04-29,Assembly,"Do pass as amended and be re-referred to the Committee on 	Appropriations",6,0,0,1,7
739640,454067,2015-05-28,Assembly,"Do pass as amended",11,4,0,2,17
739640,457351,2015-06-04,Assembly,"AB 1025 THURMOND  Assembly Third Reading",69,9,0,2,80
739640,466502,2015-07-15,Senate,"Do pass as amended, and re-refer to the Committee on Appropriations",9,0,0,0,9
739640,474153,2015-08-24,Senate,"Placed on Appropriations Suspense file",7,0,0,0,7
739641,432621,2015-04-13,Assembly,"Do pass and be re-referred to the Committee on Appropriations",13,2,0,1,16
739641,441921,2015-04-29,Assembly,"Do pass",12,5,0,0,17
739641,444375,2015-05-07,Assembly,"AB 1043 SALAS  Assembly Third Reading",60,14,0,6,80
739641,460461,2015-06-16,Senate,"Do pass, but re-refer to the Committee on Appropriations",9,0,2,0,11
739641,463887,2015-06-29,Senate,"Placed on Appropriations Suspense file",6,0,1,0,7
739641,474547,2015-08-27,Senate,"Do pass",5,2,0,0,7
739641,476031,2015-09-08,Senate,"Assembly 3rd Reading AB1043 Salas By Vidak",31,8,1,0,40
739646,440295,2015-04-28,Assembly,"Do pass as amended and be re-referred to the Committee on 	Appropriations",9,2,0,3,14
739649,484950,2016-01-13,Assembly,"Do pass, to Consent Calendar",9,0,0,0,9
739649,485042,2016-01-05,Assembly,"Be referred to Committee on Jobs, Economic Development and The 	Economy",11,0,0,0,11
739649,485688,2016-01-19,Assembly,"AB 1033 GARCIA, E.  Consent Calendar Second Day",77,0,0,2,79
739649,552888,2016-06-14,Senate,"Do pass and be placed on the Consent Calendar",12,0,1,0,13
739649,556876,2016-06-30,Senate,"Consent Calendar 2nd AB1033 Eduardo Garcia",37,0,3,0,40
739649,560546,2016-08-22,Assembly,"AB 1033 GARCIA, E.  Concurrence in Senate Amendments",79,0,0,1,80
739650,453612,2015-05-28,Assembly,"Do pass as amended",17,0,0,0,17
739650,455909,2015-06-02,Assembly,"AB 920 GIPSON  Assembly Third Reading",78,0,0,2,80
739650,466148,2015-04-14,Assembly,"Do pass as amended and be re-referred to the Committee on 	Appropriations",7,0,0,0,7
739650,552938,2016-06-14,Senate,"Do pass",7,0,0,0,7
739650,558646,2016-08-01,Senate,"Assembly 3rd Reading AB920 Gipson By Stone Urgency Claus",39,0,0,0,39
739650,559885,2016-08-15,Assembly,"AB 920 GIPSON  Concurrence- Urgency Added",78,0,0,2,80
739651,443408,2015-05-05,Senate,"Do pass as amended",8,0,3,0,11
739651,447609,2015-05-18,Senate,"Senate 3rd Reading SB508 Beall",28,8,3,0,39
739651,465898,2015-07-13,Assembly,"Do pass as amended",16,0,0,0,16
739651,475360,2015-08-31,Assembly,"SB 508 Beall  Senate Third Reading  By FRAZIER",66,14,0,0,80
739651,475403,2015-09-01,Senate,"Unfinished Business SB508 Beall Concurrence",31,9,0,0,40
739652,432518,2015-04-14,Senate,"Do pass, but re-refer to the Committee on Public Safety",10,0,1,0,11
739652,445363,2015-05-11,Senate,"Placed on Appropriations Suspense file",7,0,0,0,7
739652,453613,2015-05-28,Senate,"Do pass as amended",7,0,0,0,7
739652,456740,2015-06-03,Senate,"Senate 3rd Reading SB549 Hall",38,0,2,0,40
739652,465649,2015-07-08,Assembly,"Do pass and be re-referred to the Committee on Appropriations",18,0,0,3,21
739652,474395,2015-08-27,Assembly,"Do pass as amended",17,0,0,0,17
739652,475672,2015-09-02,Assembly,"SB 549 Hall  Senate Third Reading  By JONES-SAWYER",64,7,0,9,80
739652,475795,2015-09-03,Senate,"Unfinished Business SB549 Hall Concurrence",37,2,1,0,40
739654,437301,2015-04-21,Senate,"Do pass, but re-refer to the Committee on Education",3,1,1,0,5
739654,441270,2015-04-29,Senate,"Do pass, but re-refer to the Committee on Appropriations",7,0,2,0,9
739654,463618,2015-05-18,Senate,"Placed on Appropriations Suspense file",7,0,0,0,7
739656,441109,2015-04-28,Assembly,"Do pass and be re-referred to the Committee on Appropriations",12,0,0,1,13
739656,454063,2015-05-28,Assembly,"Do pass as amended",17,0,0,0,17
739656,455988,2015-06-02,Assembly,"AB 1016 SANTIAGO  Assembly Third Reading",77,0,0,3,80
739656,462578,2015-06-24,Senate,"Do pass as amended, but re-refer to the Committee on Appropriations 	Recommend Consent",9,0,0,0,9
739656,465840,2015-07-13,Senate,"Do pass",7,0,0,0,7
739656,474097,2015-08-24,Senate,"Assembly 3rd Reading AB1016 Santiago By Block",40,0,0,0,40
739656,474291,2015-08-27,Assembly,"AB 1016 SANTIAGO  Concurrence in Senate Amendments",79,0,0,1,80
739657,432513,2015-04-13,Assembly,"Do pass as amended and be re-referred to the Committee on 	Appropriations",6,0,0,3,9
739657,441211,2015-04-29,Assembly,"Do pass",12,0,0,5,17
739657,453822,2015-05-28,Assembly,"AB 1045 IRWIN  Assembly Third Reading",62,2,0,16,80
739657,473633,2015-08-17,Senate,"Placed on Appropriations Suspense file",7,0,0,0,7
739657,474620,2015-08-27,Senate,"Do pass",5,1,1,0,7
739657,476058,2015-09-09,Senate,"Assembly 3rd Reading AB1045 Irwin By Wolk",28,12,0,0,40
739657,476360,2015-09-10,Assembly,"AB 1045 IRWIN  Concurrence in Senate Amendments",64,9,0,7,80
739659,454023,2015-05-28,Senate,"Do pass",6,0,1,0,7
739659,455299,2015-06-01,Senate,"Senate 3rd Reading SB543 Wolk",34,4,2,0,40
739659,463667,2015-04-28,Senate,"Do pass as amended, and re-refer to the Committee on Appropriations",5,0,0,0,5
739659,463668,2015-05-18,Senate,"Placed on Appropriations Suspense file",7,0,0,0,7
739659,553126,2016-06-14,Assembly,"Do pass and be re-referred to the Committee on Appropriations",8,0,0,1,9
739659,559034,2016-08-03,Assembly,"Do pass",14,4,0,2,20
739659,560127,2016-08-18,Assembly,"SB 543 Wolk  Senate Third Reading  By IRWIN",54,23,0,3,80
739659,560949,2016-08-24,Senate,"Unfinished Business SB543 Wolk Concurrence",35,4,0,0,39
739661,437147,2015-04-21,Assembly,"Do pass as amended and be re-referred to the Committee on 	Appropriations",11,2,0,0,13
739661,453735,2015-05-28,Assembly,"Do pass",13,4,0,0,17
739661,456013,2015-06-02,Assembly,"AB 986 GIPSON  Assembly Third Reading",67,11,0,2,80
739664,427938,2015-04-07,Assembly,"Do pass as amended and be re-referred to the Committee on 	Accountability and Administrative Review",11,0,0,0,11
739664,441050,2015-04-29,Assembly,"Do pass and be re-referred to the Committee on Appropriations",9,0,0,0,9
739665,437069,2015-04-22,Senate,"Do pass",5,0,0,0,5
739665,442214,2015-04-30,Senate,"Senate 3rd Reading SB522 Mendoza",36,1,2,0,39
739665,490272,2016-02-01,Assembly,"Be referred to Committee on Governmental Organization",10,0,0,1,11
739666,429421,2015-04-08,Assembly,"Do pass and be re-referred to the Committee on Appropriations",5,2,0,0,7
739666,437146,2015-04-22,Assembly,"Do pass",12,5,0,0,17
739666,439430,2015-04-27,Assembly,"AB 852 BURKE  Assembly Third Reading",55,24,0,1,80
739666,462630,2015-06-24,Senate,"Do pass, but re-refer to the Committee on Appropriations",4,1,0,0,5
739666,465275,2015-07-06,Senate,"Placed on Appropriations Suspense file",7,0,0,0,7
739666,474598,2015-08-27,Senate,"Do pass",5,2,0,0,7
739666,475670,2015-09-02,Senate,"Assembly 3rd Reading AB852 Burke By Galgiani",27,13,0,0,40
739666,475864,2015-09-04,Assembly,"AB 852 BURKE  Concurrence in Senate Amendments",58,21,0,1,80
739668,440340,2015-04-28,Senate,"Do pass, but re-refer to the Committee on Appropriations",4,2,1,0,7
739668,445169,2015-05-11,Senate,"Placed on Appropriations Suspense file",7,0,0,0,7
739668,485066,2016-01-13,Senate,"Do pass, but re-refer to the Committee on Appropriations",10,0,1,0,11
739668,485588,2016-01-19,Senate,"Placed on Appropriations Suspense file",7,0,0,0,7
739668,486514,2016-01-21,Senate,"Do pass",7,0,0,0,7
739668,487939,2016-01-26,Senate,"Senate 3rd Reading SB512 Hill",37,0,3,0,40
739668,556773,2016-06-29,Assembly,"Do pass as amended and be re-referred to the Committee on 	Appropriations",10,2,0,3,15
739668,559244,2016-08-11,Assembly,"Do pass as amended",12,2,0,6,20
739668,560349,2016-08-19,Assembly,"SB 512 Hill  Senate Third Reading  Amendment  Set #1",73,0,0,7,80
739668,561382,2016-08-29,Assembly,"SB 512 Hill  Senate Third Reading  By GATTO",61,12,0,7,80
739668,561685,2016-08-31,Senate,"Unfinished Business SB512 Hill Concurrence",32,6,1,0,39
739670,440076,2015-04-28,Assembly,"Do pass and be re-referred to the Committee on Appropriations",7,0,0,0,7
739670,443931,2015-05-06,Assembly,"Do pass, to Consent Calendar",17,0,0,0,17
739670,450195,2015-05-22,Assembly,"AB 835 GIPSON  Assembly Third Reading",75,0,0,5,80
739670,462100,2015-06-23,Senate,"Do pass, but re-refer to the Committee on Appropriations",7,0,0,0,7
739670,465131,2015-07-06,Senate,"Placed on Appropriations Suspense file",7,0,0,0,7
739670,474651,2015-08-27,Senate,"Do pass as amended",7,0,0,0,7
739670,475646,2015-09-02,Senate,"Assembly 3rd Reading AB835 Gipson By Anderson",40,0,0,0,40
739670,475819,2015-09-03,Assembly,"AB 835 GIPSON  Concurrence in Senate Amendments",80,0,0,0,80
739673,443489,2015-05-05,Assembly,"Do pass as amended",14,0,0,0,14
739673,453913,2015-05-28,Assembly,"AB 1042 COOPER  Assembly Third Reading",78,0,0,2,80
739673,461911,2015-06-22,Senate,"Do pass as amended, and re-refer to the Committee on Rules",8,1,0,0,9
739673,474125,2015-08-24,Senate,"Do pass",7,0,0,0,7
739673,476171,2015-09-09,Senate,"Assembly 3rd Reading AB1042 Cooper By Hill",38,0,2,0,40
739673,476397,2015-09-10,Assembly,"AB 1042 COOPER  Concurrence in Senate Amendments",80,0,0,0,80
739675,440726,2015-04-27,Assembly,"Do pass as amended and be re-referred to the Committee on 	Appropriations",10,4,0,1,15
739675,453873,2015-05-28,Assembly,"Do pass",12,5,0,0,17
739675,455931,2015-06-02,Assembly,"AB 853 HERNANDEZ  Assembly Third Reading",50,25,0,5,80
739675,466074,2015-07-13,Senate,"Do pass as amended, and re-refer to the Committee on Appropriations",7,3,1,0,11
739675,474133,2015-08-24,Senate,"Placed on Appropriations Suspense file",7,0,0,0,7
739675,474486,2015-08-27,Senate,"Do pass as amended",4,3,0,0,7
739676,432563,2015-04-14,Assembly,"Do pass as amended, to Consent Calendar",10,0,0,0,10
739676,439378,2015-04-27,Assembly,"AB 879 BURKE  Consent Calendar Second Day",79,0,0,1,80
739676,458824,2015-06-09,Senate,"Do pass",7,0,0,0,7
739676,465892,2015-07-13,Senate,"Assembly 3rd Reading AB879 Burke By Hertzberg",40,0,0,0,40
739676,466563,2015-07-16,Assembly,"AB 879 BURKE  Concurrence in Senate Amendments",79,0,0,1,80
739677,433104,2015-04-14,Assembly,"Do pass and be re-referred to the Committee on Judiciary",7,0,0,0,7
739677,436030,2015-04-21,Assembly,"Do pass and be re-referred to the Committee on Appropriations to 	Consent Calendar",10,0,0,0,10
739677,486521,2016-01-21,Assembly,"Do pass as amended",17,0,0,0,17
739677,488517,2016-01-27,Assembly,"AB 885 LOPEZ  Assembly Third Reading",79,0,0,0,79
739677,544339,2016-05-10,Senate,"Do pass as amended, and re-refer to the Committee on Judiciary",5,0,0,0,5
739677,553141,2016-06-14,Senate,"Do pass, but re-refer to the Committee on Appropriations Recommend 	Consent",7,0,0,0,7
739677,558817,2016-08-01,Senate,"Placed on Appropriations Suspense file",7,0,0,0,7
739677,559581,2016-08-11,Senate,"Do pass",7,0,0,0,7
739677,560485,2016-08-22,Senate,"Assembly 3rd Reading AB885 Lopez By Liu",39,0,0,0,39
739677,561197,2016-08-25,Assembly,"AB 885 LOPEZ  Concurrence in Senate Amendments",79,0,0,1,80
739678,441007,2015-04-29,Senate,"Do pass as amended, and re-refer to the Committee on Rules",4,1,0,0,5
739678,463550,2015-05-18,Senate,"Placed on Appropriations Suspense file",7,0,0,0,7
739678,484879,2016-01-13,Senate,"Do pass, but re-refer to the Committee on Appropriations Recommend 	Consent",5,0,0,0,5
739678,485571,2016-01-19,Senate,"Placed on Appropriations Suspense file",7,0,0,0,7
739678,486306,2016-01-21,Senate,"Do pass",7,0,0,0,7
739678,487751,2016-01-26,Senate,"Senate 3rd Reading SB563 Pan",38,0,2,0,40
739678,554988,2016-06-22,Assembly,"Amend, and do pass as amended and be re-referred to the Committee 	on Appropriations with the recommendation:  To Consent Calendar",13,0,0,0,13
739678,559351,2016-08-11,Assembly,"Do pass",20,0,0,0,20
739679,441053,2015-04-29,Senate,"Do pass, but re-refer to the Committee on Appropriations",7,0,2,0,9
739679,454137,2015-05-28,Senate,"Do pass",7,0,0,0,7
739679,455497,2015-06-01,Senate,"Senate 3rd Reading SB574 Pan",37,0,3,0,40
739679,463698,2015-05-18,Senate,"Placed on Appropriations Suspense file",7,0,0,0,7
739679,465417,2015-07-07,Assembly,"Do pass and be re-referred to the Committee on Appropriations",8,4,0,1,13
739681,446172,2015-05-12,Senate,"Do pass as amended",7,0,0,0,7
739681,450238,2015-05-22,Senate,"Special Consent #2 SB582 Hall",38,0,1,0,39
739681,466138,2015-07-14,Assembly,"Do pass as amended",10,0,0,0,10
739681,473985,2015-08-20,Assembly,"SB 582 Hall  Senate Third Reading  By GARCIA, C",79,0,0,1,80
739681,474388,2015-08-27,Senate,"Special Consent #7 SB582 Hall",40,0,0,0,40
739683,443919,2015-05-06,Assembly,"Do pass, to Consent Calendar",17,0,0,0,17
739683,446747,2015-05-14,Assembly,"AB 947 CHAVEZ  Consent Calendar Second Day  Regular Session",78,0,0,2,80
739683,466143,2015-04-14,Assembly,"Do pass and be re-referred to the Committee on Appropriations",6,0,0,1,7
739683,466399,2015-07-14,Senate,"Do pass, but re-refer to the Committee on Appropriations",7,0,0,0,7
739683,473738,2015-08-17,Senate,"Placed on Appropriations Suspense file",7,0,0,0,7
739684,428382,2015-04-07,Assembly,"Do pass as amended and be re-referred to the Committee on Public 	Safety",12,0,0,1,13
739684,439958,2015-04-28,Assembly,"Do pass and be re-referred to the Committee on Appropriations to 	Consent Calendar",7,0,0,0,7
739684,446148,2015-05-13,Assembly,"Do pass",17,0,0,0,17
739684,450084,2015-05-22,Assembly,"AB 913 SANTIAGO  Assembly Third Reading",75,0,0,5,80
739684,460641,2015-06-17,Senate,"Do pass, but re-refer to the Committee on Appropriations Recommend 	Consent",8,0,1,0,9
739684,463892,2015-06-29,Senate,"Placed on Appropriations Suspense file",6,0,1,0,7
739684,474654,2015-08-27,Senate,"Do pass as amended",7,0,0,0,7
739684,475581,2015-09-02,Senate,"Assembly 3rd Reading AB913 Santiago By Jackson",39,0,1,0,40
739684,475720,2015-09-03,Assembly,"AB 913 SANTIAGO  Concurrence in Senate Amendments",79,0,0,1,80
739686,427954,2015-04-07,Assembly,"Do pass and be re-referred to the Committee on Appropriations",7,0,0,0,7
739686,434009,2015-04-15,Assembly,"Do pass, to Consent Calendar",16,0,0,1,17
739686,438338,2015-04-23,Assembly,"AB 860 DALY  Consent Calendar Second Day  Regular Session",78,0,0,2,80
739686,460550,2015-06-16,Senate,"Do pass, but re-refer to the Committee on Appropriations",7,0,0,0,7
739686,464005,2015-06-29,Senate,"Placed on Appropriations Suspense file",6,0,1,0,7
739687,441235,2015-04-28,Assembly,"Do pass and be re-referred to the Committee on Appropriations",19,0,0,0,19
739687,443941,2015-05-06,Assembly,"Do pass",16,0,0,1,17
739687,445236,2015-05-11,Assembly,"AB 941 WOOD  Assembly Third Reading",77,0,0,3,80
739687,463021,2015-06-24,Senate,"Do pass, but re-refer to the Committee on Appropriations",8,0,1,0,9
739687,475356,2015-08-31,Senate,"Assembly 3rd Reading AB941 Wood By Hernandez",39,0,1,0,40
739687,475560,2015-09-02,Assembly,"AB 941 WOOD  Concurrence in Senate Amendments",79,0,0,1,80
739689,428373,2015-04-08,Assembly,"Do pass and be re-referred to the Committee on Appropriations to 	Consent Calendar",6,0,0,1,7
739689,434080,2015-04-15,Assembly,"Do pass, to Consent Calendar",16,0,0,1,17
739689,438209,2015-04-23,Assembly,"AB 991 P.E., R.& S.S.  Consent Calendar Second Day  Regular Session",78,0,0,2,80
739689,457981,2015-06-08,Senate,"Do pass, but re-refer to the Committee on Appropriations",4,0,1,0,5
739689,461857,2015-06-22,Senate,"Do pass",5,0,2,0,7
739689,463847,2015-06-29,Senate,"Assembly 3rd Reading AB991 Committee on Public Em ployees, 	Retirement,",39,0,1,0,40
739689,464903,2015-07-02,Assembly,"AB 991 P.E., R.& S.S.  Concurrence in Senate Amendments By BONTA",77,0,0,3,80
739691,442261,2015-04-30,Senate,"Senate 3rd Reading SB590 Stone",37,0,2,0,39
739691,446709,2015-04-06,Senate,"Do pass, but re-refer to the Committee on Appropriations Recommend 	Consent",9,0,0,0,9
739691,462167,2015-06-23,Assembly,"Do pass and be re-referred to the Committee on Appropriations to 	Consent Calendar",14,0,0,0,14
739691,465630,2015-07-08,Assembly,"Do pass, to Consent Calendar",14,0,0,3,17
739691,466516,2015-07-16,Assembly,"SB 590 Stone  Consent Calendar Second Day  Regular Session",79,0,0,1,80
739694,440256,2015-04-28,Senate,"Do pass, but re-refer to the Committee on Labor and Industrial 	Relations",4,1,2,0,7
739694,441021,2015-04-29,Senate,"Do pass as amended, and re-refer to the Committee on Appropriations",4,1,0,0,5
739694,445146,2015-05-11,Senate,"Placed on Appropriations Suspense file",7,0,0,0,7
739694,453954,2015-05-28,Senate,"Do pass",5,2,0,0,7
739694,455257,2015-06-01,Senate,"Senate 3rd Reading SB588 De Le",26,13,1,0,40
739694,465774,2015-07-08,Assembly,"Do pass and be re-referred to the Committee on Judiciary",5,2,0,0,7
739694,466015,2015-07-14,Assembly,"Do pass and be re-referred to the Committee on Appropriations",7,3,0,0,10
739694,474458,2015-08-27,Assembly,"Do pass as amended",12,5,0,0,17
739694,475998,2015-09-08,Assembly,"SB 588 De Leon  Senate Third Reading",58,18,0,4,80
739694,476303,2015-09-10,Senate,"Unfinished Business SB588 De Le",28,11,1,0,40
739695,443766,2015-05-06,Assembly,"Do pass, to Consent Calendar",7,0,0,0,7
739695,446698,2015-05-14,Assembly,"AB 992 P.E., R.& S.S.  Consent Calendar Second Day  Regular Session",78,0,0,2,80
739695,457954,2015-06-08,Senate,"Do pass and be placed on the Consent Calendar",4,0,1,0,5
739695,461244,2015-06-18,Senate,"Consent Calendar 2nd AB992 Committee on Public Em ployees, 	Retirement,",37,0,3,0,40
739698,433065,2015-04-15,Senate,"Do pass, but re-refer to the Committee on Appropriations",7,0,0,0,7
739698,442866,2015-05-04,Senate,"Senate 3rd Reading SB489 Monning",35,0,4,0,39
739698,463556,2015-04-27,Senate,"Do pass",7,0,0,0,7
739698,464477,2015-06-30,Assembly,"Do pass and be re-referred to the Committee on Appropriations to 	Consent Calendar",7,0,0,0,7
739698,466415,2015-07-15,Assembly,"Do pass as amended, to Consent Calendar",16,0,0,1,17
739698,474441,2015-08-27,Assembly,"SB 489 Monning  Senate Third Reading  By ALEJO",76,1,0,3,80
739698,475410,2015-09-01,Senate,"Special Consent #9 SB489 Monning",40,0,0,0,40
739699,429586,2015-04-08,Assembly,"Do pass as amended and be re-referred to the Committee on 	Appropriations",7,0,0,0,7
739699,440928,2015-04-29,Assembly,"Do pass",17,0,0,0,17
739699,444431,2015-05-07,Assembly,"AB 1058 BAKER  Assembly Third Reading  Motion to  Suspend the Rules 	By ALEJO",35,29,0,16,80
739699,444432,2015-05-07,Assembly,"AB 1058 BAKER  Assembly Third Reading",77,0,0,3,80
739699,458826,2015-06-10,Senate,"Do pass, but re-refer to the Committee on Appropriations Recommend 	Consent",8,0,1,0,9
739699,461900,2015-06-22,Senate,"Placed on Appropriations Suspense file",6,0,1,0,7
739699,474593,2015-08-27,Senate,"Do pass",7,0,0,0,7
739699,476092,2015-09-09,Senate,"Assembly 3rd Reading AB1058 Baker By Glazer",39,0,1,0,40
739699,476507,2015-09-11,Assembly,"AB 1058 BAKER  Concurrence in Senate Amendments",79,0,0,1,80
739700,484716,2016-01-11,Senate,"Do pass, but re-refer to the Committee on Appropriations Recommend 	Consent",8,0,1,0,9
739700,487413,2016-01-25,Senate,"Consent Calendar 2nd SB587 Stone",38,0,2,0,40
739700,555308,2016-06-23,Assembly,"Be referred to Committee on Revenue and Taxation",11,0,0,0,11
739700,559069,2016-08-01,Assembly,"Do pass as amended and be re-referred to the Committee on 	Appropriations",8,0,0,1,9
739703,433041,2015-04-13,Assembly,"Do pass and be re-referred to the Committee on Environmental Safety 	and Toxic Materials",7,0,0,2,9
739703,440411,2015-04-28,Assembly,"Do pass and be re-referred to the Committee on Appropriations",6,0,0,1,7
739703,446174,2015-05-13,Assembly,"Do pass",12,4,0,1,17
739703,450185,2015-05-22,Assembly,"AB 888 BLOOM  Assembly Third Reading",59,12,0,9,80
739703,460629,2015-06-17,Senate,"Do pass, but re-refer to the Committee on Judiciary",5,1,1,0,7
739703,464692,2015-06-30,Senate,"Do pass, but re-refer to the Committee on Appropriations",4,1,2,0,7
739703,475789,2015-09-03,Senate,"Assembly 3rd Reading AB888 Bloom By Hueso",19,16,5,0,40
739703,475790,2015-09-03,Senate,"Assembly 3rd Reading AB888 Bloom By Hueso",39,0,1,0,40
739703,475895,2015-09-04,Senate,"Assembly 2nd Reading AB888 Bloom By Hueso",24,14,2,0,40
739703,475917,2015-09-08,Assembly,"AB 888 BLOOM  Concurrence in Senate Amendments",64,12,0,4,80
739704,411733,2015-03-16,Assembly,"From committee:  Be adopted.  To third reading",11,0,0,0,11
739706,436065,2015-04-21,Senate,"Do pass, but re-refer to the Committee on Appropriations",10,0,1,0,11
739706,442924,2015-05-04,Senate,"Do pass",7,0,0,0,7
739706,447740,2015-05-18,Senate,"Special Consent #1 SB580 Liu",36,0,3,0,39
739706,464835,2015-07-01,Assembly,"Do pass and be re-referred to the Committee on Appropriations",7,0,0,0,7
739706,465603,2015-07-08,Assembly,"Do pass, to Consent Calendar",14,0,0,3,17
739706,476007,2015-09-08,Assembly,"SB 580 Liu  Senate Third Reading  By HOLDEN",77,1,0,2,80
739706,560199,2016-08-18,Assembly,"SB 580 Liu  Third Reading Urgency  By HOLDEN",79,0,0,1,80
739706,561153,2016-08-25,Senate,"Special Consent SB580 Liu Urgency Clause",39,0,0,0,39
739708,432684,2015-04-14,Senate,"Do pass as amended, and re-refer to the Committee on Governmental 	Organization",5,0,0,0,5
739708,440245,2015-04-28,Senate,"Do pass as amended, and re-refer to the Committee on Appropriations",8,0,3,0,11
739708,454128,2015-05-28,Senate,"Do pass",7,0,0,0,7
739708,455451,2015-06-01,Senate,"Senate 3rd Reading SB536 Roth",40,0,0,0,40
739708,463719,2015-05-18,Senate,"Placed on Appropriations Suspense file",7,0,0,0,7
739708,466389,2015-07-14,Assembly,"Do pass and be re-referred to the Committee on Appropriations",9,0,0,0,9
739708,468567,2015-07-01,Assembly,"Do pass and be re-referred to the Committee on Veterans Affairs",9,0,0,0,9
739708,474446,2015-08-27,Assembly,"Do pass",17,0,0,0,17
739708,475314,2015-08-31,Assembly,"SB 536 Roth  Senate Third Reading  By IRWIN",78,0,0,2,80
739708,475492,2015-09-01,Senate,"Unfinished Business SB536 Roth Concurrence",39,0,1,0,40
739709,432519,2015-04-13,Assembly,"Do pass and be re-referred to the Committee on Appropriations to 	Consent Calendar",9,0,0,0,9
739709,437242,2015-04-22,Assembly,"Do pass, to Consent Calendar",17,0,0,0,17
739709,442179,2015-04-30,Assembly,"AB 815 RIDLEY-THOMAS  Consent Calendar Second Day  Regular Session",77,0,0,3,80
739709,458607,2015-06-09,Senate,"Do pass, but re-refer to the Committee on Appropriations Recommend 	Consent",9,0,0,0,9
739709,464946,2015-07-02,Senate,"Consent Calendar 2nd AB815 Ridley-Thomas",38,0,2,0,40
739710,443506,2015-05-05,Assembly,"Do pass as amended, to Consent Calendar",10,0,0,0,10
739710,446623,2015-05-14,Assembly,"AB 1002 WILK  Consent Calendar Second Day  Regular Session",78,0,0,2,80
739710,461056,2015-06-16,Senate,"Do pass and be placed on the Consent Calendar",7,0,0,0,7
739710,463055,2015-06-25,Senate,"Consent Calendar 2nd AB1002 Wilk",37,0,3,0,40
739713,438045,2015-04-22,Assembly,"Do pass and be re-referred to the Committee on Appropriations",2,5,0,0,7
739713,463575,2015-04-22,Assembly,"Reconsideration granted",7,0,0,0,7
739714,439976,2015-04-28,Senate,"Do pass, but re-refer to the Committee on Appropriations Recommend 	Consent",10,0,1,0,11
739714,447673,2015-05-18,Senate,"Consent Calendar 2nd SB491 Committee On T.&H. (Beall)",36,0,3,0,39
739714,465853,2015-07-13,Assembly,"Do pass and be re-referred to the Committee on Appropriations to 	Consent Calendar",16,0,0,0,16
739714,473876,2015-08-19,Assembly,"Do pass, to Consent Calendar",17,0,0,0,17
739714,474255,2015-08-27,Assembly,"SB 491 T.& H.  Consent Calendar Second Day  Regular Session",78,0,0,2,80
739714,475463,2015-09-01,Senate,"Special Consent #9 SB491 Committee On T.&H. (Beall)",40,0,0,0,40
739715,441807,2015-04-29,Assembly,"Do pass and be re-referred to the Committee on Appropriations",8,0,0,1,9
739715,453138,2015-05-27,Assembly,"Do pass",13,0,0,4,17
739715,455510,2015-06-01,Assembly,"AB 959 CHIU  Assembly Third Reading",69,0,0,11,80
739715,466096,2015-07-14,Senate,"Do pass, but re-refer to the Committee on Appropriations",12,1,0,0,13
739715,473754,2015-08-17,Senate,"Placed on Appropriations Suspense file",7,0,0,0,7
739715,474637,2015-08-27,Senate,"Do pass as amended",5,0,2,0,7
739715,476348,2015-09-10,Senate,"Assembly 3rd Reading AB959 Chiu By Hall",32,5,3,0,40
739715,476538,2015-09-11,Assembly,"AB 959 CHIU  Concurrence in Senate Amendments",68,0,0,12,80
739716,429359,2015-04-08,Assembly,"Do pass and be re-referred to the Committee on Appropriations",5,2,0,0,7
739716,437145,2015-04-22,Assembly,"Do pass",11,5,0,1,17
739716,447596,2015-05-18,Assembly,"AB 970 NAZARIAN  Assembly Third Reading",48,26,0,6,80
739716,458727,2015-06-10,Senate,"Do pass, but re-refer to the Committee on Appropriations",3,1,0,1,5
739716,461831,2015-06-22,Senate,"Do pass",5,1,1,0,7
739716,475307,2015-08-31,Senate,"Assembly 3rd Reading AB970 Nazarian By Leyva",25,14,1,0,40
739716,475647,2015-09-02,Assembly,"AB 970 NAZARIAN  Concurrence in Senate Amendments",49,29,0,2,80
739719,440921,2015-04-29,Assembly,"Do pass and be re-referred to the Committee on Appropriations",8,1,0,0,9
739719,446308,2015-05-13,Assembly,"Do pass",13,4,0,0,17
739719,452226,2015-05-26,Assembly,"AB 1050 LOW  Assembly Third Reading",62,7,0,11,80
739719,462796,2015-06-23,Senate,"Do pass, but re-refer to the Committee on Appropriations",5,1,1,0,7
739719,552148,2016-06-08,Senate,"Do pass, but re-refer to the Committee on Appropriations",3,1,1,0,5
739719,558832,2016-08-01,Senate,"Placed on Appropriations Suspense file",7,0,0,0,7
739719,559747,2016-08-11,Senate,"Do pass",5,2,0,0,7
739719,560740,2016-08-23,Senate,"Assembly 3rd Reading AB1050 Low By Leno",26,13,0,0,39
739719,561468,2016-08-29,Assembly,"Senate amendments be concurred in",5,2,0,0,7
739719,561666,2016-08-30,Assembly,"AB 1050 LOW  Concurrence in Senate Amendments",52,28,0,0,80
739720,432585,2015-04-15,Senate,"Do pass, but re-refer to the Committee on Judiciary",7,0,0,0,7
739721,437107,2015-04-21,Assembly,"Do pass as amended and be re-referred to the Committee on 	Appropriations",9,4,0,0,13
739721,454095,2015-05-28,Assembly,"Do pass",12,5,0,0,17
739721,455969,2015-06-02,Assembly,"AB 1010 MEDINA  Assembly Third Reading",51,27,0,2,80
739721,462659,2015-06-24,Senate,"Do pass, but re-refer to the Committee on Appropriations",6,2,1,0,9
739721,465262,2015-07-06,Senate,"Placed on Appropriations Suspense file",7,0,0,0,7
739722,437493,2015-04-21,Senate,"Do pass, but re-refer to the Committee on Health",5,0,0,0,5
739722,442337,2015-04-29,Senate,"Do pass, but re-refer to the Committee on Appropriations",9,0,0,0,9
739722,453967,2015-05-28,Senate,"Do pass as amended",7,0,0,0,7
739722,456791,2015-06-03,Senate,"Senate 3rd Reading SB484 Beall",40,0,0,0,40
739722,463650,2015-05-18,Senate,"Placed on Appropriations Suspense file",7,0,0,0,7
739722,466275,2015-07-14,Assembly,"Do pass and be re-referred to the Committee on Appropriations",7,0,0,0,7
739722,474333,2015-08-27,Assembly,"Do pass as amended",17,0,0,0,17
739722,475942,2015-09-08,Assembly,"SB 484 Beall  Senate Third Reading  By CHIU",79,0,0,1,80
739722,476426,2015-09-10,Senate,"Unfinished Business SB484 Beall Concurrence",40,0,0,0,40
739725,448389,2015-05-18,Assembly,"Do pass as amended and be re-referred to the Committee on 	Appropriations",9,0,0,0,9
739726,440200,2015-04-28,Assembly,"Do pass and be re-referred to the Committee on Appropriations",15,0,0,0,15
739726,454103,2015-05-28,Assembly,"Do pass as amended",12,0,0,5,17
739726,456811,2015-06-03,Assembly,"AB 937 SALAS  Assembly Third Reading",79,0,0,1,80
739726,466041,2015-07-14,Senate,"Do pass as amended, and re-refer to the Committee on Appropriations",9,0,0,0,9
739726,473623,2015-08-17,Senate,"Placed on Appropriations Suspense file",7,0,0,0,7
739727,428138,2015-04-07,Assembly,"Do pass and be re-referred to the Committee on Appropriations",14,0,0,0,14
739727,433879,2015-04-15,Assembly,"Do pass",16,0,0,1,17
739727,438424,2015-04-23,Assembly,"AB 804 HERNANDEZ  Assembly Third Reading",76,0,0,4,80
739727,458049,2015-06-08,Senate,"Do pass, but re-refer to the Committee on Appropriations",7,2,0,0,9
739727,462016,2015-06-22,Senate,"Do pass",5,1,1,0,7
739727,475657,2015-09-02,Senate,"Assembly 3rd Reading AB804 Roger Hern",28,12,0,0,40
739727,475855,2015-09-04,Assembly,"AB 804 HERNANDEZ  Concurrence in Senate Amendments",78,1,0,1,80
739728,436268,2015-04-20,Assembly,"Do pass",15,0,0,1,16
739728,438211,2015-04-23,Assembly,"AB 902 BLOOM  Assembly Third Reading",77,0,0,3,80
739728,466134,2015-07-14,Senate,"Do pass and be placed on the Consent Calendar",11,0,0,0,11
739728,474041,2015-08-20,Senate,"Consent Calendar 2nd AB902 Bloom",38,0,2,0,40
739728,474140,2015-08-24,Assembly,"AB 902 BLOOM  Concurrence in Senate Amendments",79,0,0,1,80
739730,432983,2015-04-13,Assembly,"Do pass as amended and be re-referred to the Committee on 	Appropriations",9,0,0,0,9
739730,441179,2015-04-29,Assembly,"Do pass, to Consent Calendar",17,0,0,0,17
739730,444400,2015-05-07,Assembly,"AB 985 DAHLE  Consent Calendar Second Day  Regular Session",77,0,0,3,80
739730,458347,2015-06-09,Senate,"Do pass, but re-refer to the Committee on Appropriations Recommend 	Consent",9,0,0,0,9
739730,463023,2015-06-25,Senate,"Consent Calendar 2nd AB985 Dahle",37,0,3,0,40
739731,440033,2015-04-27,Assembly,"Do pass and be re-referred to the Committee on Appropriations to 	Consent Calendar",16,0,0,0,16
739731,454120,2015-05-28,Assembly,"Do pass as amended",17,0,0,0,17
739731,456082,2015-06-02,Assembly,"AB 810 RIDLEY-THOMAS  Assembly Third Reading",78,0,0,2,80
739731,464428,2015-06-30,Senate,"Do pass, but re-refer to the Committee on Appropriations Recommend 	Consent",11,0,0,0,11
739731,465859,2015-07-13,Senate,"Placed on Appropriations Suspense file",7,0,0,0,7
739731,474715,2015-08-27,Senate,"Do pass",7,0,0,0,7
739731,476029,2015-09-08,Senate,"Assembly 3rd Reading AB810 Ridley-Thomas By Allen",40,0,0,0,40
739732,440153,2015-04-28,Assembly,"Do pass and be re-referred to the Committee on Appropriations",3,4,0,3,10
739732,466097,2015-04-14,Assembly,"Do pass and be re-referred to the Committee on Judiciary",5,2,0,0,7
739735,440910,2015-04-28,Assembly,"Do pass as amended and be re-referred to the Committee on 	Appropriations",19,0,0,0,19
739736,438270,2015-04-22,Assembly,"Do pass and be re-referred to the Committee on Appropriations",5,1,0,1,7
739737,433153,2015-04-14,Assembly,"Do pass as amended and be re-referred to the Committee on 	Appropriations",14,0,0,0,14
739737,443939,2015-05-06,Assembly,"Do pass, to Consent Calendar",17,0,0,0,17
739737,446839,2015-05-14,Assembly,"AB 921 JONES  Consent Calendar Second Day  Regular Session",78,0,0,2,80
739737,462010,2015-06-22,Senate,"Do pass as amended, and re-refer to the Committee on Appropriations",9,0,0,0,9
739737,465943,2015-07-13,Senate,"Do pass as amended",7,0,0,0,7
739737,476185,2015-09-09,Senate,"Assembly 3rd Reading AB921 Jones By Nielsen",40,0,0,0,40
739737,476368,2015-09-10,Assembly,"AB 921 JONES  Concurrence in Senate Amendments",80,0,0,0,80
739738,443478,2015-05-05,Assembly,"Do pass",10,0,0,0,10
739738,447687,2015-05-18,Assembly,"AB 960 CHIU  Assembly Third Reading",71,0,0,9,80
739738,465636,2015-07-07,Senate,"Do pass",5,0,2,0,7
739738,473645,2015-08-17,Senate,"Assembly 3rd Reading AB960 Chiu By Wolk",29,2,9,0,40
739738,474117,2015-08-24,Assembly,"AB 960 CHIU  Concurrence in Senate Amendments",68,0,0,12,80
739739,438418,2015-04-22,Assembly,"Do pass and be re-referred to the Committee on Appropriations to 	Consent Calendar",7,0,0,0,7
739739,443888,2015-05-06,Assembly,"Do pass, to Consent Calendar",17,0,0,0,17
739739,446871,2015-05-14,Assembly,"AB 1064 HERNANDEZ  Consent Calendar Second Day  Regular Session",78,0,0,2,80
739739,464799,2015-07-01,Senate,"Do pass, but re-refer to the Committee on Appropriations",7,0,2,0,9
739739,465878,2015-07-13,Senate,"Do pass as amended",7,0,0,0,7
739739,475342,2015-08-31,Senate,"Special Consent #8 AB1064 Roger Hern",40,0,0,0,40
739739,475524,2015-09-01,Assembly,"AB 1064 HERNANDEZ  Concurrence in Senate Amendments",77,0,0,3,80
739741,443418,2015-05-05,Assembly,"Do pass as amended",5,2,0,0,7
739742,436150,2015-04-20,Assembly,"Do pass and be re-referred to the Committee on Appropriations",14,1,0,1,16
739742,443891,2015-05-06,Assembly,"Do pass",17,0,0,0,17
739742,446648,2015-05-14,Assembly,"AB 1024 GAINES  Assembly Third Reading",79,0,0,1,80
739742,460192,2015-06-16,Senate,"Do pass as amended, and re-refer to the Committee on Appropriations",11,0,0,0,11
739742,463828,2015-06-29,Senate,"Placed on Appropriations Suspense file",6,0,1,0,7
739742,474616,2015-08-27,Senate,"Do pass",7,0,0,0,7
739742,475654,2015-09-02,Senate,"Assembly 3rd Reading AB1024 Beth Gaines By Roth",40,0,0,0,40
739742,475722,2015-09-03,Assembly,"AB 1024 GAINES  Concurrence in Senate Amendments",79,0,0,1,80
739744,439999,2015-04-28,Senate,"Do pass, but re-refer to the Committee on Appropriations",7,0,0,0,7
739744,445390,2015-05-11,Senate,"Placed on Appropriations Suspense file",7,0,0,0,7
739746,439979,2015-04-28,Assembly,"Do pass, to Consent Calendar",10,0,0,0,10
739746,442964,2015-05-04,Assembly,"AB 1049 PATTERSON  Consent Calendar Second Day  Regular Session",78,0,0,2,80
739746,460977,2015-06-16,Senate,"Do pass and be placed on the Consent Calendar",7,0,0,0,7
739746,462969,2015-06-25,Senate,"Consent Calendar 2nd AB1049 Patterson",37,0,3,0,40
739748,436891,2015-04-21,Assembly,"Do pass and be re-referred to the Committee on Education",6,0,0,1,7
739748,442134,2015-04-29,Assembly,"Do pass as amended and be re-referred to the Committee on 	Appropriations",7,0,0,0,7
739748,453227,2015-05-27,Assembly,"Do pass",17,0,0,0,17
739748,455441,2015-06-01,Assembly,"AB 949 GONZALEZ  Assembly Third Reading",77,1,0,2,80
739748,464729,2015-07-01,Senate,"Do pass, but re-refer to the Committee on Appropriations",7,0,2,0,9
739748,474167,2015-08-24,Senate,"Assembly 3rd Reading AB949 Gonzalez By Lara",40,0,0,0,40
739749,432552,2015-04-14,Assembly,"Do pass, to Consent Calendar",15,0,0,0,15
739749,435213,2015-04-20,Assembly,"AB 939 SALAS  Consent Calendar Second Day  Regular Session",80,0,0,0,80
739749,466108,2015-07-14,Senate,"Do pass",9,0,0,0,9
739749,475284,2015-08-31,Senate,"Special Consent #8 AB939 Salas",40,0,0,0,40
739749,475462,2015-09-01,Assembly,"AB 939 SALAS  Concurrence in Senate Amendments",79,0,0,1,80
739750,440188,2015-04-28,Senate,"Do pass, but re-refer to the Committee on Appropriations",7,0,0,0,7
739750,445531,2015-05-11,Senate,"Placed on Appropriations Suspense file",7,0,0,0,7
739750,453885,2015-05-28,Senate,"Do pass",6,1,0,0,7
739750,455403,2015-06-01,Senate,"Senate 3rd Reading SB518 Leno",40,0,0,0,40
739750,464407,2015-06-30,Assembly,"Do pass as amended and be re-referred to the Committee on 	Appropriations",7,0,0,0,7
739752,443387,2015-05-05,Assembly,"Do pass, to Consent Calendar",10,0,0,0,10
739752,445155,2015-05-11,Assembly,"AB 1036 QUIRK  Consent Calendar Second Day  Regular Session",79,0,0,1,80
739752,458787,2015-06-09,Senate,"Do pass and be placed on the Consent Calendar",7,0,0,0,7
739752,461286,2015-06-18,Senate,"Consent Calendar 2nd AB1036 Quirk",37,0,3,0,40
739754,428432,2015-04-07,Assembly,"Do pass and be re-referred to the Committee on Appropriations",10,3,0,0,13
739755,438272,2015-04-14,Assembly,"Do pass as amended and be re-referred to the Committee on 	Appropriations",17,0,0,2,19
739760,427912,2015-04-07,Senate,"Do pass as amended, and re-refer to the Committee on Appropriations",11,0,0,0,11
739760,442271,2015-04-30,Senate,"Senate 3rd Reading SB502 Leno",37,0,2,0,39
739760,462300,2015-06-22,Assembly,"Do pass and be re-referred to the Committee on Appropriations",14,0,0,0,14
739760,465601,2015-07-08,Assembly,"Do pass, to Consent Calendar",14,0,0,3,17
739760,466572,2015-07-16,Assembly,"SB 502 Leno  Consent Calendar Second Day  Regular Session",79,0,0,1,80
739762,437088,2015-04-22,Senate,"Do pass, but re-refer to the Committee on Appropriations",4,1,0,0,5
739762,457272,2015-06-04,Senate,"Senate 3rd Reading SB579 Jackson",38,1,1,0,40
739762,462955,2015-06-24,Assembly,"Do pass and be re-referred to the Committee on Appropriations",6,1,0,0,7
739762,473918,2015-08-19,Assembly,"Do pass",17,0,0,0,17
739762,475549,2015-09-01,Assembly,"SB 579 Jackson  Senate Third Reading  By GARCIA, C",77,0,0,3,80
739762,475617,2015-09-02,Senate,"Unfinished Business SB579 Jackson Concurrence",40,0,0,0,40
739764,436189,2015-04-21,Senate,"Do pass as amended, and re-refer to the Committee on Appropriations",9,0,2,0,11
739764,444424,2015-05-07,Senate,"Senate 3rd Reading SB539 Hueso",37,0,2,0,39
739764,465136,2015-07-06,Assembly,"Be referred to Committee on Judiciary",11,0,0,0,11
739764,465999,2015-07-14,Assembly,"Do pass as amended and be re-referred to the Committee on 	Appropriations",9,1,0,0,10
739764,473861,2015-08-19,Assembly,"Do pass",14,3,0,0,17
739764,475292,2015-08-31,Assembly,"SB 539 Glazer  Senate Third Reading  By WEBER",64,11,0,5,80
739764,475954,2015-09-08,Senate,"Unfinished Business SB539 Glazer Concurrence",31,2,7,0,40
739764,485071,2015-09-03,Senate,"From committee:  That the Assembly Amendments be concurred in",12,0,1,0,13
739766,442225,2015-04-29,Senate,"Do pass as amended, but re-refer to the Committee on Appropriations 	Recommend Consent",9,0,0,0,9
739766,454008,2015-05-28,Senate,"Do pass",7,0,0,0,7
739766,455349,2015-06-01,Senate,"Senate 3rd Reading SB503 Hernandez",40,0,0,0,40
739766,463689,2015-05-18,Senate,"Placed on Appropriations Suspense file",7,0,0,0,7
739766,465969,2015-07-14,Assembly,"Amend, and do pass as amended and be re-referred to the Committee 	on Appropriations with the recommendation:  To Consent Calendar",19,0,0,0,19
739766,474408,2015-08-27,Assembly,"Do pass",17,0,0,0,17
739766,557030,2016-06-30,Assembly,"SB 503 Hernandez  Senate Third Reading  By BROWN  Amend By BROWN 	Set #1",51,26,0,3,80
739768,443409,2015-05-04,Assembly,"Do pass",12,0,0,0,12
739768,444381,2015-05-07,Assembly,"AB 844 BLOOM  Assembly Third Reading",77,0,0,3,80
739768,458344,2015-06-09,Senate,"Do pass",7,0,0,0,7
739768,461818,2015-06-22,Senate,"Special Consent #3 AB844 Bloom By Hertzberg",37,0,3,0,40
739768,466092,2015-04-14,Assembly,"Do pass and be re-referred to the Committee on Banking and Finance 	to Consent Calendar",7,0,0,0,7
739769,437239,2015-04-22,Senate,"Do pass as amended, and re-refer to the Committee on Appropriations",7,2,0,0,9
739769,453810,2015-05-28,Senate,"Do pass as amended",5,2,0,0,7
739769,456680,2015-06-03,Senate,"Senate 3rd Reading SB499 Liu",23,16,1,0,40
739769,463546,2015-05-18,Senate,"Placed on Appropriations Suspense file",7,0,0,0,7
739774,442359,2015-04-29,Assembly,"Do pass and be re-referred to the Committee on Appropriations to 	Consent Calendar",6,0,0,1,7
739774,446262,2015-05-13,Assembly,"Do pass, to Consent Calendar",17,0,0,0,17
739774,450201,2015-05-22,Assembly,"AB 934 BONILLA  Consent Calendar Second Day  Regular Session",74,0,0,6,80
739774,556289,2016-06-29,Senate,"Do pass as amended, and re-refer to the Committee on Appropriations",2,5,2,0,9
739774,556290,2016-06-29,Senate,"Set, first hearing.  Failed passage in Committee.  Reconsideration 	granted",9,0,0,0,9
739775,443444,2015-05-05,Senate,"Be adopted, but re-refer to the Committee on Appropriations 	Recommend Consent",9,0,2,0,11
739775,450208,2015-05-22,Senate,"Consent Calendar 2nd SCR22 Morrell",38,0,1,0,39
739775,461959,2015-06-22,Assembly,"Be adopted and re-referred to the Committee on Appropriations with 	recommendation:  To Consent Calendar",16,0,0,0,16
739775,465704,2015-07-08,Assembly,"Be adopted, to Consent Calendar",14,0,0,3,17
739775,465875,2015-07-13,Assembly,"SCR 22 Morrell  Consent Calendar Second Day  Regular Session",79,0,0,1,80
739776,440214,2015-04-28,Assembly,"Amend, and do pass as amended and be re-referred to the Committee 	on Appropriations with the recommendation:  To Consent Calendar",15,0,0,0,15
739776,454062,2015-05-28,Assembly,"Do pass as amended",17,0,0,0,17
739776,456810,2015-06-03,Assembly,"AB 1061 GALLAGHER  Assembly Third Reading",74,2,0,4,80
739776,466080,2015-07-14,Senate,"Do pass, but re-refer to the Committee on Appropriations Recommend 	Consent",9,0,0,0,9
739780,484742,2016-01-12,Senate,"Do pass, but re-refer to the Committee on Appropriations",9,0,0,0,9
739780,485587,2016-01-19,Senate,"Placed on Appropriations Suspense file",7,0,0,0,7
739780,486510,2016-01-21,Senate,"Do pass",7,0,0,0,7
739780,488656,2016-01-27,Senate,"Senate 3rd Reading SB554 Wolk",39,0,1,0,40
739780,553018,2016-06-14,Assembly,"Do pass and be re-referred to the Committee on Appropriations",10,3,0,2,15
739780,559513,2016-08-11,Assembly,"Do pass as amended",11,4,0,5,20
739780,561045,2016-08-24,Assembly,"SB 554 Wolk  Senate Third Reading  By OLSEN",72,4,0,4,80
739780,561347,2016-08-26,Senate,"Unfinished Business SB554 Wolk Concurrence",39,0,0,0,39
739780,561348,2016-08-26,Senate,"Unfinished Business SB554 Wolk Concurrence",39,0,0,0,39
739780,561349,2016-08-26,Senate,"Unfinished Business SB554 Wolk Concurrence",36,3,0,0,39
739781,437060,2015-04-21,Senate,"Do pass as amended, but re-refer to the Committee on Appropriations 	Recommend Consent",5,0,0,0,5
739781,442931,2015-05-04,Senate,"Do pass",7,0,0,0,7
739781,445283,2015-05-11,Senate,"Senate 3rd Reading SB490 Beall",36,0,3,0,39
739781,464339,2015-06-30,Assembly,"Do pass and be re-referred to the Committee on Appropriations",7,0,0,0,7
739784,446269,2015-05-12,Senate,"Do pass",5,2,0,0,7
739784,450231,2015-05-22,Senate,"Senate 3rd Reading SB501 Wieckowski",26,11,2,0,39
739784,465487,2015-07-07,Assembly,"Do pass as amended",6,2,0,2,10
739784,476109,2015-09-09,Assembly,"SB 501 Wieckowski  Senate Third Reading  By GARCIA, C",62,16,0,2,80
739784,476387,2015-09-10,Senate,"Unfinished Business SB501 Wieckowski Concurrence",27,11,2,0,40
739785,440104,2015-04-27,Assembly,"Do pass as amended and be re-referred to the Committee on 	Appropriations",9,0,0,0,9
739785,448929,2015-05-20,Assembly,"Do pass, to Consent Calendar",15,0,0,2,17
739785,451538,2015-05-26,Assembly,"AB 1034 OBERNOLTE  Consent Calendar Second Day  Regular Session",76,0,0,4,80
739785,466077,2015-07-14,Senate,"Do pass as amended, but re-refer to the Committee on Appropriations 	Recommend Consent",9,0,0,0,9
739785,473979,2015-08-20,Senate,"Consent Calendar 2nd AB1034 Obernolte",38,0,2,0,40
739785,475256,2015-08-31,Assembly,"AB 1034 OBERNOLTE  Concurrence in Senate Amendments",80,0,0,0,80
739786,440566,2015-04-28,Senate,"Do pass, but re-refer to the Committee on Appropriations",8,0,1,0,9
739786,445361,2015-05-11,Senate,"Placed on Appropriations Suspense file",7,0,0,0,7
739786,453897,2015-05-28,Senate,"Do pass",5,2,0,0,7
739786,455428,2015-06-01,Senate,"Senate 3rd Reading SB551 Wolk",27,9,4,0,40
739786,466391,2015-07-14,Assembly,"Do pass and be re-referred to the Committee on Appropriations",9,4,0,2,15
739787,437847,2015-04-22,Assembly,"Do pass and be re-referred to the Committee on Arts, Entertain, 	Sports, Tourism, & Internet Media",5,2,0,0,7
739787,440046,2015-04-28,Assembly,"Do pass and be re-referred to the Committee on Appropriations",5,1,0,1,7
739791,443804,2015-05-05,Senate,"Do pass, but re-refer to the Committee on Appropriations Recommend 	Consent",7,0,0,0,7
739791,450109,2015-05-22,Senate,"Consent Calendar 2nd SB474 Wieckowski Urgency Clause",38,0,1,0,39
739791,465479,2015-07-07,Assembly,"Amend, and do pass as amended and be re-referred to the Committee 	on Appropriations with the recommendation:  To Consent Calendar",10,0,0,0,10
739791,473935,2015-08-19,Assembly,"Do pass, to Consent Calendar",17,0,0,0,17
739791,474260,2015-08-27,Assembly,"SB 474 Wieckowski  Consent Calendar Second Day  Regular Session",78,0,0,2,80
739791,475430,2015-09-01,Senate,"Special Consent #9 SB474 Wieckowski Urgency Clause",40,0,0,0,40
739793,429280,2015-04-08,Assembly,"Do pass and be re-referred to the Committee on Education to Consent 	Calendar",7,0,0,0,7
739793,440920,2015-04-28,Assembly,"Do pass as amended and be re-referred to the Committee on 	Appropriations",12,0,0,1,13
739793,454365,2015-05-28,Assembly,"Do pass",17,0,0,0,17
739793,455459,2015-06-01,Assembly,"AB 907 BURKE  Third Reading Urgency",80,0,0,0,80
739795,440334,2015-04-28,Senate,"Do pass, but re-refer to the Committee on Appropriations Recommend 	Consent",7,0,4,0,11
739795,450092,2015-05-22,Senate,"Consent Calendar 2nd SB494 Hill",38,0,1,0,39
739795,466231,2015-07-15,Assembly,"Do pass and be re-referred to the Committee on Appropriations",18,0,0,3,21
739795,473897,2015-08-19,Assembly,"Do pass, to Consent Calendar",17,0,0,0,17
739795,476042,2015-09-08,Assembly,"SB 494 Hill  Senate Third Reading  By COOLEY",79,0,0,1,80
739795,476384,2015-09-10,Senate,"Unfinished Business SB494 Hill Concurrence",40,0,0,0,40
739796,432783,2015-04-15,Assembly,"Do pass and be re-referred to the Committee on Housing and 	Community Development",5,3,0,1,9
739796,441557,2015-04-29,Assembly,"Do pass and be re-referred to the Committee on Appropriations",4,2,0,1,7
739796,454183,2015-05-28,Assembly,"Do pass",12,5,0,0,17
739796,456092,2015-06-02,Assembly,"AB 974 BLOOM  Assembly Third Reading",46,29,0,5,80
739796,465527,2015-07-07,Senate,"Do pass, but re-refer to the Committee on Governance and Finance",8,2,1,0,11
739796,466225,2015-07-15,Senate,"Do pass, but re-refer to the Committee on Appropriations",4,1,2,0,7
739796,473800,2015-08-17,Senate,"Placed on Appropriations Suspense file",7,0,0,0,7
739796,474681,2015-08-27,Senate,"Do pass",5,2,0,0,7
739797,440183,2015-04-28,Senate,"Do pass, but re-refer to the Committee on Appropriations",7,0,0,0,7
739797,452025,2015-05-26,Senate,"Senate 3rd Reading SB556 De Le",38,0,1,0,39
739797,464392,2015-06-30,Assembly,"Do pass and be re-referred to the Committee on Appropriations to 	Consent Calendar",7,0,0,0,7
739797,465681,2015-07-08,Assembly,"Do pass, to Consent Calendar",14,0,0,3,17
739798,428571,2015-04-08,Assembly,"Do pass, to Consent Calendar",12,0,0,1,13
739798,434098,2015-04-16,Assembly,"AB 822 COOLEY  Consent Calendar Second Day",79,0,0,1,80
739798,459508,2015-06-10,Senate,"Do pass",9,0,0,0,9
739798,461850,2015-06-22,Senate,"Special Consent #3 AB822 Cooley",37,0,3,0,40
739798,462943,2015-06-25,Assembly,"AB 822 COOLEY  Concurrence in Senate Amendments",80,0,0,0,80
739800,435308,2015-04-20,Assembly,"Do pass as amended and be re-referred to the Committee on 	Appropriations",7,0,0,2,9
739800,446193,2015-05-13,Assembly,"Do pass, to Consent Calendar",17,0,0,0,17
739800,450240,2015-05-22,Assembly,"AB 924 COOLEY  Consent Calendar Second Day  Regular Session",74,0,0,6,80
739800,460876,2015-06-17,Senate,"Do pass, but re-refer to the Committee on Appropriations",7,0,0,0,7
739800,464126,2015-06-29,Senate,"Do pass",6,0,1,0,7
739800,473773,2015-08-17,Senate,"Assembly 3rd Reading AB924 Cooley By Beall",37,1,2,0,40
739801,440228,2015-04-28,Assembly,"Do pass and be re-referred to the Committee on Appropriations",7,3,0,0,10
739801,453925,2015-05-28,Assembly,"Do pass",12,4,0,1,17
739801,455922,2015-06-02,Assembly,"AB 900 LEVINE  Assembly Third Reading",56,23,0,1,80
739801,466410,2015-07-14,Senate,"Do pass, but re-refer to the Committee on Appropriations",5,1,1,0,7
739801,473687,2015-08-17,Senate,"Placed on Appropriations Suspense file",7,0,0,0,7
739801,474559,2015-08-27,Senate,"Do pass",5,2,0,0,7
739801,475572,2015-09-02,Senate,"Assembly 3rd Reading AB900 Levine By Lara",29,11,0,0,40
739801,475877,2015-09-04,Assembly,"AB 900 LEVINE  Concurrence in Senate Amendments",55,24,0,1,80
739803,443590,2015-05-05,Assembly,"Do pass as amended",9,0,0,1,10
739803,446895,2015-05-14,Assembly,"AB 830 EGGMAN  Assembly Third Reading",74,0,0,6,80
739803,461083,2015-06-16,Senate,"Do pass as amended",6,1,0,0,7
739803,465754,2015-07-09,Senate,"Assembly 3rd Reading AB830 Eggman By Leno",37,0,3,0,40
739803,465919,2015-07-13,Assembly,"AB 830 EGGMAN  Concurrence in Senate Amendments",72,0,0,8,80
739805,437120,2015-04-21,Assembly,"Do pass and be re-referred to the Committee on Appropriations",12,1,0,0,13
739805,454048,2015-05-28,Assembly,"Do pass as amended",17,0,0,0,17
739805,457278,2015-06-04,Assembly,"AB 798 BONILLA  Assembly Third Reading",78,0,0,2,80
739805,465635,2015-07-08,Senate,"Do pass, but re-refer to the Committee on Appropriations",7,0,2,0,9
739805,473655,2015-08-17,Senate,"Placed on Appropriations Suspense file",7,0,0,0,7
739805,474645,2015-08-27,Senate,"Do pass as amended",7,0,0,0,7
739805,476514,2015-09-11,Senate,"Assembly 3rd Reading AB798 Bonilla By Block",39,0,1,0,40
739805,476515,2015-09-11,Assembly,"AB 798 BONILLA  Concurrence in Senate Amendments",79,0,0,1,80
739806,435285,2015-04-20,Senate,"Senate 3rd Reading SB517 Monning",34,1,4,0,39
739806,458852,2015-04-14,Senate,"Do pass",6,0,1,0,7
739806,460189,2015-06-16,Assembly,"Do pass",7,0,0,0,7
739806,462997,2015-06-25,Assembly,"SB 517 Monning  Senate Third Reading  By QUIRK",76,0,0,4,80
739807,432617,2015-04-14,Assembly,"Do pass, to Consent Calendar",15,0,0,0,15
739807,435245,2015-04-20,Assembly,"AB 938 SALAS  Consent Calendar Second Day  Regular Session",80,0,0,0,80
739810,432689,2015-04-14,Senate,"Do pass, but re-refer to the Committee on Health",8,3,0,0,11
739810,484918,2016-01-13,Senate,"Do pass, but re-refer to the Committee on Appropriations",6,0,3,0,9
739810,485582,2016-01-19,Senate,"Placed on Appropriations Suspense file",7,0,0,0,7
739810,486372,2016-01-21,Senate,"Do pass as amended",5,1,1,0,7
739810,488680,2016-01-27,Senate,"Senate 3rd Reading SB547 Liu",35,4,1,0,40
739810,554995,2016-06-21,Assembly,"Do pass and be re-referred to the Committee on Appropriations",6,0,0,1,7
739810,559316,2016-08-11,Assembly,"Do pass",19,1,0,0,20
739810,560528,2016-08-22,Assembly,"SB 547 Liu  Senate Third Reading  By BROWN",76,0,0,4,80
739810,560975,2016-08-24,Senate,"Unfinished Business SB547 Liu Concurrence",38,1,0,0,39
739813,432549,2015-04-15,Senate,"Do pass, but re-refer to the Committee on Appropriations",5,0,2,0,7
739813,442256,2015-04-30,Senate,"Senate 3rd Reading SB481 Hueso",29,0,10,0,39
739813,461003,2015-06-17,Assembly,"Do pass as amended and be re-referred to the Committee on 	Appropriations",9,0,0,0,9
739813,465710,2015-07-08,Assembly,"Do pass",14,0,0,3,17
739813,466506,2015-07-16,Assembly,"SB 481 Hueso  Senate Third Reading  By WEBER",75,0,0,5,80
739813,474042,2015-08-20,Senate,"Unfinished Business SB481 Hueso Concurrence",38,0,2,0,40
739815,440618,2015-04-28,Assembly,"Do pass as amended and be re-referred to the Committee on 	Appropriations",12,2,0,1,15
739815,454358,2015-05-28,Assembly,"Do pass as amended",12,1,0,4,17
739815,456619,2015-06-03,Assembly,"AB 988 STONE  Assembly Third Reading",73,3,0,4,80
739815,465977,2015-07-14,Senate,"Do pass, but re-refer to the Committee on Appropriations",8,1,0,0,9
739815,473617,2015-08-17,Senate,"Placed on Appropriations Suspense file",7,0,0,0,7
739816,432589,2015-04-13,Assembly,"Do pass and be re-referred to the Committee on Appropriations",9,0,0,0,9
739816,454057,2015-05-28,Assembly,"Do pass",17,0,0,0,17
739816,455335,2015-06-01,Assembly,"AB 1062 BONTA  Assembly Third Reading",74,3,0,3,80
739817,436786,2015-04-20,Assembly,"Do pass and be re-referred to the Committee on Privacy and Consumer 	Protection",4,6,0,5,15
739817,436787,2015-04-20,Assembly,"Do pass and be re-referred to the Committee on Privacy and Consumer 	Protection",4,6,0,5,15
739817,463598,2015-04-20,Assembly,"Reconsideration granted",15,0,0,0,15
739818,440139,2015-04-27,Senate,"Do pass as amended, and re-refer to the Committee on Appropriations",7,1,1,0,9
739818,454413,2015-05-28,Senate,"Senate 3rd Reading SB482 Lara",28,11,1,0,40
739818,463543,2015-05-18,Senate,"Do pass",5,2,0,0,7
739818,547034,2016-05-19,Assembly,"Be referred to Committee on Business and Professions",11,0,0,0,11
739818,552690,2016-06-14,Assembly,"Do pass as amended and be re-referred to the Committee on 	Appropriations",16,0,0,0,16
739818,559006,2016-08-03,Assembly,"Do pass",20,0,0,0,20
739818,560388,2016-08-19,Assembly,"SB 482 Lara  Senate Third Reading  ByA& A.R.  Amendment  Set #1",73,0,0,7,80
739818,560906,2016-08-24,Assembly,"SB 482 Lara  Senate Third Reading  By WOOD",80,0,0,0,80
739818,561561,2016-08-30,Senate,"Unfinished Business (S upplemental File 1)SB4 82 Lar a Con",38,1,0,0,39
739819,437219,2015-04-22,Senate,"Do pass, but re-refer to the Committee on Appropriations",5,0,0,0,5
739819,444394,2015-05-07,Senate,"Senate 3rd Reading SB542 Mendoza",37,0,2,0,39
739819,465653,2015-07-08,Assembly,"Do pass and be re-referred to the Committee on Appropriations to 	Consent Calendar",13,0,0,0,13
739819,473872,2015-08-19,Assembly,"Do pass, to Consent Calendar",17,0,0,0,17
739819,475294,2015-08-31,Assembly,"SB 542 Mendoza  Senate Third Reading  By DALY",79,0,0,1,80
739819,476345,2015-09-10,Senate,"Unfinished Business SB542 Mendoza Concurrence",39,0,1,0,40
739822,427879,2015-04-06,Assembly,"Do pass",14,0,0,2,16
739822,433837,2015-04-16,Assembly,"AB 863 DODD  Assembly Third Reading",77,0,0,3,80
739822,458906,2015-06-09,Senate,"Do pass",10,0,1,0,11
739822,474403,2015-08-27,Senate,"Assembly 3rd Reading AB863 Dodd By Hill",39,0,1,0,40
739822,475339,2015-08-31,Assembly,"AB 863 DODD  Concurrence in Senate Amendments",79,0,0,1,80
739823,440584,2015-04-28,Assembly,"Do pass and be re-referred to the Committee on Appropriations to 	Consent Calendar",15,0,0,0,15
739823,454173,2015-05-28,Assembly,"Do pass",17,0,0,0,17
739823,456787,2015-06-03,Assembly,"AB 935 SALAS  Assembly Third Reading",80,0,0,0,80
739823,466009,2015-07-14,Senate,"Do pass as amended, and re-refer to the Committee on Appropriations",9,0,0,0,9
739823,473744,2015-08-17,Senate,"Placed on Appropriations Suspense file",7,0,0,0,7
739823,474713,2015-08-27,Senate,"Do pass",7,0,0,0,7
739823,560556,2016-08-22,Senate,"Assembly 3rd Reading AB935 Salas By Galgiani",30,3,6,0,39
739823,561281,2016-08-25,Assembly,"Senate amendments be concurred in",12,0,0,3,15
739823,561629,2016-08-30,Assembly,"AB 935 SALAS  Concurrence in Senate Amendments",75,4,0,1,80
739824,441227,2015-04-29,Senate,"Do pass, but re-refer to the Committee on Appropriations",7,0,2,0,9
739824,463545,2015-05-18,Senate,"Placed on Appropriations Suspense file",7,0,0,0,7
739824,486308,2016-01-21,Senate,"Do pass",5,1,1,0,7
739824,487685,2016-01-26,Senate,"Senate 3rd Reading SB527 Liu",24,10,6,0,40
739824,553668,2016-06-15,Assembly,"Do pass and be re-referred to the Committee on Appropriations",7,0,0,0,7
739824,559242,2016-08-11,Assembly,"Do pass as amended",16,1,0,3,20
739824,560209,2016-08-18,Assembly,"SB 527 Liu  Senate Third Reading  By THURMOND",63,15,0,2,80
739824,561335,2016-08-26,Senate,"From committee:  That the Assembly Amendments be concurred in",9,0,0,0,9
739824,561739,2016-08-31,Senate,"Unfinished Business SB527 Liu Concurrence",39,0,0,0,39
739826,433218,2015-04-14,Assembly,"Do pass and be re-referred to the Committee on Appropriations",9,0,0,0,9
739826,441095,2015-04-29,Assembly,"Do pass, to Consent Calendar",17,0,0,0,17
739826,444490,2015-05-07,Assembly,"AB 930 IRWIN  Consent Calendar Second Day  Regular Session",77,0,0,3,80
739826,462136,2015-06-23,Senate,"Do pass, but re-refer to the Committee on Appropriations Recommend 	Consent",5,0,0,0,5
739826,473616,2015-08-17,Senate,"Placed on Appropriations Suspense file",7,0,0,0,7
739826,474621,2015-08-27,Senate,"Do pass",7,0,0,0,7
739827,484781,2016-01-12,Assembly,"Do pass and be re-referred to the Committee on Appropriations to 	Consent Calendar",14,0,0,0,14
739827,486477,2016-01-21,Assembly,"Do pass, to Consent Calendar",17,0,0,0,17
739827,488766,2016-01-27,Assembly,"AB 923 STEINORTH  Consent Calendar Second Day  Regular Session",78,0,0,1,79
739827,551427,2016-06-06,Senate,"Do pass, but re-refer to the Committee on Appropriations Recommend 	Consent",8,0,1,0,9
739827,559875,2016-08-15,Senate,"Assembly 3rd Reading AB923 Steinorth By Bates",38,0,1,0,39
739827,560271,2016-08-18,Assembly,"AB 923 STEINORTH  Concurrence in Senate Amendments",76,0,0,4,80
739828,429464,2015-04-08,Assembly,"Do pass and be re-referred to the Committee on Appropriations",5,1,0,1,7
739828,453875,2015-05-28,Assembly,"Do pass as amended",12,5,0,0,17
739828,456702,2015-06-03,Assembly,"AB 883 LOW  Assembly Third Reading",52,27,0,1,80
739828,462613,2015-06-24,Senate,"Do pass, but re-refer to the Committee on Judiciary",4,1,0,0,5
739828,466387,2015-07-14,Senate,"Do pass as amended, and re-refer to the Committee on Appropriations",5,2,0,0,7
739828,473662,2015-08-17,Senate,"Placed on Appropriations Suspense file",7,0,0,0,7
739828,474536,2015-08-27,Senate,"Do pass as amended",5,2,0,0,7
739828,476191,2015-09-09,Senate,"Assembly 3rd Reading AB883 Low By Pan",29,9,2,0,40
739828,476383,2015-09-10,Assembly,"AB 883 LOW  Concurrence in Senate Amendments",65,13,0,2,80
739829,443886,2015-05-06,Senate,"Do pass",7,0,0,0,7
739829,447733,2015-05-18,Senate,"Senate 3rd Reading SB493 Cannella",29,3,7,0,39
739829,464708,2015-07-01,Assembly,"Do pass as amended and be re-referred to the Committee on Local 	Government",5,0,0,2,7
739829,466574,2015-07-15,Assembly,"Do pass",8,0,0,1,9
739829,475850,2015-09-04,Assembly,"SB 493 Cannella  Senate Third Reading  By ALEJO",62,14,0,4,80
739829,476015,2015-09-08,Senate,"Unfinished Business SB493 Cannella Concurrence",35,4,1,0,40
740931,428936,2015-04-08,Assembly,"Do pass as amended and be re-referred to the Committee on 	Appropriations",21,0,0,0,21
740931,437370,2015-04-22,Assembly,"Do pass, to Consent Calendar",17,0,0,0,17
740931,444361,2015-05-07,Assembly,"AB 1322 DALY  Assembly Third Reading",74,0,0,6,80
740931,559816,2016-08-15,Senate,"Assembly 3rd Reading AB1322 Daly By Galgiani",28,7,4,0,39
740931,560470,2016-08-22,Assembly,"AB 1322 DALY  Concurrence in Senate Amendments",79,0,0,1,80
740933,440926,2015-04-29,Senate,"Do pass, but re-refer to the Committee on Appropriations",7,0,0,0,7
740933,445215,2015-05-11,Senate,"Placed on Appropriations Suspense file",7,0,0,0,7
740934,433549,2015-04-14,Assembly,"Do pass and be re-referred to the Committee on Judiciary",2,5,0,0,7
740935,429695,2015-04-08,Assembly,"Do pass and be re-referred to the Committee on Appropriations to 	Consent Calendar",7,0,0,0,7
740935,437173,2015-04-22,Assembly,"Do pass, to Consent Calendar",17,0,0,0,17
740935,442200,2015-04-30,Assembly,"AB 1166 BLOOM  Consent Calendar Second Day  Regular Session",77,0,0,3,80
740935,458580,2015-06-10,Senate,"Do pass, but re-refer to the Committee on Appropriations Recommend 	Consent",8,0,0,1,9
740935,461810,2015-06-22,Senate,"Do pass as amended",6,0,1,0,7
740935,465164,2015-07-06,Senate,"Special Consent #4 AB1166 Bloom",39,0,1,0,40
740935,465744,2015-07-09,Assembly,"AB 1166 BLOOM  Concurrence in Senate Amendments",79,0,0,1,80
740936,437989,2015-04-21,Senate,"Do pass as amended, and re-refer to the Committee on Appropriations",6,0,1,0,7
740936,463661,2015-05-18,Senate,"Placed on Appropriations Suspense file",7,0,0,0,7
740937,437385,2015-04-22,Assembly,"Do pass and be re-referred to the Committee on Appropriations",17,0,0,4,21
740937,453955,2015-05-28,Assembly,"Do pass as amended",13,0,0,4,17
740937,456615,2015-06-03,Assembly,"AB 1411 GARCIA, E.  Assembly Third Reading",74,3,0,3,80
740937,466130,2015-07-14,Senate,"Do pass, but re-refer to the Committee on Appropriations",10,3,0,0,13
740937,475490,2015-09-01,Senate,"Assembly 3rd Reading AB1411 Eduardo Garcia By McGuire",30,10,0,0,40
740937,475777,2015-09-03,Assembly,"AB 1411 GARCIA, E.  Concurrence in Senate Amendments",75,3,0,2,80
740938,433927,2015-04-16,Assembly,"Be referred to Committee on Housing and Community Development",11,0,0,0,11
740939,441946,2015-04-28,Assembly,"Do pass and be re-referred to the Committee on Appropriations",9,0,0,0,9
740939,446127,2015-05-13,Assembly,"Do pass, to Consent Calendar",17,0,0,0,17
740939,450167,2015-05-22,Assembly,"AB 1401 BAKER  Consent Calendar Second Day  Regular Session",74,0,0,6,80
740939,462113,2015-06-23,Senate,"Do pass, but re-refer to the Committee on Appropriations Recommend 	Consent",5,0,0,0,5
740939,473998,2015-08-20,Senate,"Consent Calendar 2nd AB1401 Baker",38,0,2,0,40
740941,441061,2015-04-28,Assembly,"Do pass and be re-referred to the Committee on Appropriations",18,0,0,1,19
740941,454074,2015-05-28,Assembly,"Do pass",17,0,0,0,17
740941,455382,2015-06-01,Assembly,"AB 1319 DABABNEH  Assembly Third Reading",80,0,0,0,80
740941,473815,2015-08-17,Senate,"Placed on Appropriations Suspense file",7,0,0,0,7
740943,439992,2015-04-28,Assembly,"Do pass",14,0,0,0,14
740943,444500,2015-05-07,Assembly,"AB 1279 HOLDEN  Assembly Third Reading",75,0,0,5,80
740943,465491,2015-07-06,Senate,"Do pass",7,0,2,0,9
740943,474380,2015-08-27,Senate,"Assembly 3rd Reading AB1279 Holden By Block",39,0,1,0,40
740943,475363,2015-08-31,Assembly,"AB 1279 HOLDEN  Concurrence in Senate Amendments",79,0,0,1,80
740944,443915,2015-05-05,Senate,"Do pass as amended",7,0,0,0,7
740944,447823,2015-05-18,Senate,"Senate 3rd Reading SB738 Huff",36,0,3,0,39
740944,462335,2015-06-23,Assembly,"Do pass and be re-referred to the Committee on Judiciary to Consent 	Calendar",14,0,0,0,14
740944,464374,2015-06-30,Assembly,"Do pass, to Consent Calendar",10,0,0,0,10
740944,465192,2015-07-06,Assembly,"SB 738 Huff  Consent Calendar Second Day",78,0,0,2,80
740946,440087,2015-04-28,Senate,"Do pass as amended, and re-refer to the Committee on Appropriations",8,1,2,0,11
740946,463626,2015-05-18,Senate,"Placed on Appropriations Suspense file",7,0,0,0,7
740950,441024,2015-04-29,Assembly,"Do pass and be re-referred to the Committee on Appropriations",9,0,0,0,9
740952,437297,2015-04-21,Senate,"Do pass",2,5,0,0,7
740954,440149,2015-04-27,Assembly,"Do pass and be re-referred to the Committee on Appropriations",8,0,0,1,9
740954,453727,2015-05-28,Assembly,"Do pass",17,0,0,0,17
740954,455319,2015-06-01,Assembly,"AB 1161 OLSEN  Assembly Third Reading",75,0,0,5,80
740954,473627,2015-08-17,Senate,"Placed on Appropriations Suspense file",7,0,0,0,7
740956,484699,2016-01-11,Assembly,"Do pass as amended and be re-referred to the Committee on 	Appropriations",14,0,0,1,15
740956,486336,2016-01-21,Assembly,"Do pass",17,0,0,0,17
740956,487148,2016-01-25,Assembly,"AB 1180 GARCIA, C.  Assembly Third Reading",71,3,0,5,79
740956,552477,2016-06-13,Senate,"Do pass, but re-refer to the Committee on Natural Resources and 	Water",11,0,0,0,11
740956,555728,2016-06-27,Senate,"Do pass",5,0,2,0,7
740956,559824,2016-08-15,Senate,"Assembly 3rd Reading AB1180 Cristina Garcia By Cannella",38,0,1,0,39
740956,560499,2016-08-22,Assembly,"AB 1180 GARCIA, C.  Concurrence in Senate Amendments",75,0,0,5,80
740957,437237,2015-04-21,Assembly,"Do pass and be re-referred to the Committee on Appropriations",18,0,0,1,19
740957,453680,2015-05-28,Assembly,"Do pass as amended",13,1,0,3,17
740957,456670,2015-06-03,Assembly,"AB 1117 GARCIA, C.  Assembly Third Reading",65,12,0,3,80
740957,464749,2015-07-01,Senate,"Do pass, but re-refer to the Committee on Appropriations",6,1,2,0,9
740957,473574,2015-08-17,Senate,"Placed on Appropriations Suspense file",7,0,0,0,7
740958,436336,2015-04-21,Assembly,"Do pass and be re-referred to the Committee on Public Safety",7,2,0,1,10
740959,439410,2015-04-27,Assembly,"Do pass and be re-referred to the Committee on Appropriations",19,1,0,1,21
740959,446253,2015-05-13,Assembly,"Do pass as amended",16,1,0,0,17
740959,454140,2015-05-28,Assembly,"AB 1373 SANTIAGO  Assembly Third Reading",71,6,0,3,80
740959,560714,2016-08-23,Senate,"Assembly 3rd Reading AB1373 Santiago By Lara",31,4,4,0,39
740959,560715,2016-08-23,Senate,"Assembly 3rd Reading AB1373 Santiago By Lara",39,0,0,0,39
740959,560716,2016-08-23,Senate,"Assembly 3rd Reading AB1373 Santiago By Lara",22,10,7,0,39
740959,561396,2016-08-29,Assembly,"AB 1373 SANTIAGO  Concurrence in Senate Amendments",73,5,0,2,80
740960,446202,2015-05-12,Senate,"Do pass",7,0,0,0,7
740960,450140,2015-05-22,Senate,"Special Consent #2 SB775 Allen",38,0,1,0,39
740960,466238,2015-07-15,Assembly,"Do pass and be re-referred to the Committee on Appropriations",7,0,0,0,7
740960,473860,2015-08-19,Assembly,"Do pass, to Consent Calendar",17,0,0,0,17
740960,555508,2016-06-27,Assembly,"SB 775 Allen  Senate Third Reading  By BLOOM",75,0,0,5,80
740960,556807,2016-06-30,Senate,"Unfinished Business SB775 Allen Concurrence",38,0,2,0,40
740961,441184,2015-04-28,Assembly,"Do pass and be re-referred to the Committee on Appropriations",10,2,0,1,13
740961,453686,2015-05-28,Assembly,"Do pass as amended",12,5,0,0,17
740961,456817,2015-06-03,Assembly,"AB 1366 LOPEZ  Assembly Third Reading",52,23,0,5,80
740961,466224,2015-07-15,Senate,"Do pass as amended, and re-refer to the Committee on Appropriations",8,1,0,0,9
740961,474108,2015-08-24,Senate,"Placed on Appropriations Suspense file",7,0,0,0,7
740961,474552,2015-08-27,Senate,"Do pass as amended",5,2,0,0,7
740962,437280,2015-04-22,Assembly,"Do pass and be re-referred to the Committee on Appropriations to 	Consent Calendar",20,0,0,1,21
740962,486428,2016-01-21,Assembly,"Do pass as amended",17,0,0,0,17
740962,489065,2016-01-28,Assembly,"AB 1346 GRAY  Assembly Third Reading",77,0,0,2,79
740962,552946,2016-06-14,Senate,"Do pass, but re-refer to the Committee on Appropriations",12,0,1,0,13
740962,558869,2016-08-01,Senate,"Placed on Appropriations Suspense file",7,0,0,0,7
740962,559760,2016-08-11,Senate,"Do pass as amended",7,0,0,0,7
740963,437276,2015-04-21,Assembly,"Do pass and be re-referred to the Committee on Judiciary",18,0,0,1,19
740963,440086,2015-04-28,Assembly,"Do pass as amended and be re-referred to the Committee on 	Appropriations",10,0,0,0,10
740963,486271,2016-01-21,Assembly,"Do pass as amended",17,0,0,0,17
740963,488334,2016-01-27,Assembly,"AB 1300 RIDLEY-THOMAS  Assembly Third Reading",77,0,0,2,79
740963,556814,2016-06-29,Senate,"Do pass, but re-refer to the Committee on Rules",7,0,2,0,9
740964,427999,2015-04-06,Assembly,"Do pass as amended and be re-referred to the Committee on Local 	Government",15,0,0,1,16
740964,441969,2015-04-29,Assembly,"Do pass and be re-referred to the Committee on Appropriations",9,0,0,0,9
740964,446203,2015-05-13,Assembly,"Do pass, to Consent Calendar",17,0,0,0,17
740964,450108,2015-05-22,Assembly,"AB 1284 BAKER  Consent Calendar Second Day  Regular Session",74,0,0,6,80
740964,462326,2015-06-23,Senate,"Do pass, but re-refer to the Committee on Appropriations Recommend 	Consent",11,0,0,0,11
740964,465778,2015-07-09,Senate,"Consent Calendar 2nd AB1284 Baker",39,0,1,0,40
740965,442247,2015-04-29,Assembly,"Do pass as amended and be re-referred to the Committee on 	Appropriations",7,0,0,0,7
740965,453932,2015-05-28,Assembly,"Do pass as amended",17,0,0,0,17
740965,455990,2015-06-02,Assembly,"AB 1426 LEVINE  Assembly Third Reading",75,0,0,5,80
740965,556477,2016-06-29,Senate,"Do pass, but re-refer to the Committee on Appropriations",8,0,1,0,9
740966,432693,2015-04-15,Senate,"Do pass, but re-refer to the Committee on Judiciary",7,0,0,0,7
740966,446144,2015-05-12,Senate,"Do pass as amended",7,0,0,0,7
740966,450186,2015-05-22,Senate,"Senate 3rd Reading SB741 Hill",39,0,0,0,39
740966,462086,2015-06-23,Assembly,"Do pass as amended and be re-referred to the Committee on Local 	Government",11,0,0,0,11
740966,466493,2015-07-15,Assembly,"Do pass as amended",9,0,0,0,9
740966,475597,2015-09-02,Assembly,"SB 741 Hill  Senate Third Reading  By GATTO",79,0,0,1,80
740966,475728,2015-09-03,Senate,"Unfinished Business SB741 Hill Concurrence",40,0,0,0,40
740968,430619,2015-04-13,Senate,"Do pass, but re-refer to the Committee on Appropriations",3,1,1,0,5
740968,453878,2015-05-28,Senate,"Do pass",5,2,0,0,7
740968,455258,2015-06-01,Senate,"Senate 3rd Reading SB780 Mendoza",22,11,7,0,40
740968,463591,2015-04-27,Senate,"Placed on Appropriations Suspense file",7,0,0,0,7
740968,555028,2016-06-22,Assembly,"Do pass and be re-referred to the Committee on Appropriations",5,1,0,1,7
740968,559254,2016-08-11,Assembly,"Do pass",14,5,0,1,20
740968,560131,2016-08-18,Assembly,"SB 780 Mendoza  Senate Third Reading  By RIDLEY-THOMAS",54,19,0,7,80
740969,439441,2015-04-27,Assembly,"Subject matter be referred",16,1,0,4,21
740969,485043,2016-01-05,Assembly,"Be referred to Committee on Labor and Employment",11,0,0,0,11
740969,485044,2016-01-06,Assembly,"Do pass and be re-referred to the Committee on Appropriations",5,2,0,0,7
740969,486299,2016-01-21,Assembly,"Do pass",12,4,0,1,17
740969,488370,2016-01-27,Assembly,"AB 1233 LEVINE  Assembly Third Reading",53,25,0,1,79
740970,440329,2015-04-27,Assembly,"Do pass and be re-referred to the Committee on Appropriations",16,0,0,0,16
740970,444033,2015-05-06,Assembly,"Do pass, to Consent Calendar",17,0,0,0,17
740970,446612,2015-05-14,Assembly,"AB 1171 LINDER  Consent Calendar Second Day  Regular Session",78,0,0,2,80
740970,460291,2015-06-16,Senate,"Do pass as amended, and re-refer to the Committee on Appropriations",11,0,0,0,11
740970,465196,2015-07-06,Senate,"Do pass",7,0,0,0,7
740970,466539,2015-07-16,Senate,"Special Consent #5 AB1171 Linder",38,0,2,0,40
740970,473803,2015-08-17,Assembly,"AB 1171 LINDER  Concurrence in Senate Amendments",79,0,0,1,80
740971,437349,2015-04-22,Senate,"Do pass, but re-refer to the Committee on Appropriations",5,0,0,0,5
740971,442950,2015-05-04,Senate,"Do pass",7,0,0,0,7
740971,454419,2015-05-28,Senate,"Senate 3rd Reading SB667 Jackson",38,0,2,0,40
740971,465645,2015-07-08,Assembly,"Do pass and be re-referred to the Committee on Appropriations to 	Consent Calendar",13,0,0,0,13
740971,474321,2015-08-27,Assembly,"Do pass",17,0,0,0,17
740971,475451,2015-09-01,Assembly,"SB 667 Jackson  Senate Third Reading  By DALY",80,0,0,0,80
740973,432884,2015-04-14,Assembly,"Do pass as amended",10,0,0,0,10
740973,438416,2015-04-23,Assembly,"AB 1197 BONILLA  Assembly Third Reading",78,0,0,2,80
740973,465680,2015-07-07,Senate,"Do pass as amended",5,0,2,0,7
740973,474056,2015-08-24,Senate,"Assembly 3rd Reading AB1197 Bonilla By Jackson",39,0,1,0,40
740973,474238,2015-08-27,Assembly,"AB 1197 BONILLA  Concurrence in Senate Amendments",78,0,0,2,80
740976,441067,2015-04-29,Assembly,"Do pass and be re-referred to the Committee on Appropriations",9,0,0,0,9
740976,453703,2015-05-28,Assembly,"Do pass as amended",15,2,0,0,17
740976,456747,2015-06-03,Assembly,"AB 1347 CHIU  Assembly Third Reading",76,0,0,4,80
740976,464671,2015-06-30,Senate,"Do pass as amended, and re-refer to the Committee on Appropriations",7,0,0,0,7
740976,474152,2015-08-24,Senate,"Placed on Appropriations Suspense file",7,0,0,0,7
740976,474579,2015-08-27,Senate,"Do pass as amended",7,0,0,0,7
740976,476438,2015-09-10,Senate,"Assembly 3rd Reading AB1347 Chiu By Galgiani",40,0,0,0,40
740976,476652,2015-09-11,Assembly,"AB 1347 CHIU  Concurrence in Senate Amendments",77,0,0,3,80
740977,443386,2015-05-05,Assembly,"Do pass",17,0,0,2,19
740977,444501,2015-05-07,Assembly,"AB 1337 LINDER  Assembly Third Reading",77,0,0,3,80
740977,465747,2015-07-08,Senate,"Do pass, but re-refer to the Committee on Judiciary",8,0,1,0,9
740977,466223,2015-07-14,Senate,"Do pass as amended. To Consent Calendar",7,0,0,0,7
740977,474038,2015-08-20,Senate,"Consent Calendar 2nd AB1337 Linder",38,0,2,0,40
740977,474138,2015-08-24,Assembly,"AB 1337 LINDER  Concurrence in Senate Amendments",80,0,0,0,80
740978,440408,2015-04-27,Assembly,"Do pass and be re-referred to the Committee on Appropriations",9,0,0,0,9
740978,454218,2015-05-28,Assembly,"Do pass",17,0,0,0,17
740978,455454,2015-06-01,Assembly,"AB 1269 DABABNEH  Assembly Third Reading",80,0,0,0,80
740978,466270,2015-07-15,Senate,"Do pass, but re-refer to the Committee on Appropriations",5,0,2,0,7
740978,473644,2015-08-17,Senate,"Placed on Appropriations Suspense file",7,0,0,0,7
740978,474539,2015-08-27,Senate,"Do pass",6,0,1,0,7
740978,476277,2015-09-10,Senate,"Assembly 3rd Reading AB1269 Dababneh By Beall",40,0,0,0,40
740978,476522,2015-09-11,Assembly,"AB 1269 DABABNEH  Concurrence in Senate Amendments",78,0,0,2,80
740979,437770,2015-04-22,Senate,"Do pass as amended, but re-refer to the Committee on Appropriations 	Recommend Consent",9,0,0,0,9
740979,454113,2015-05-28,Senate,"Do pass as amended",7,0,0,0,7
740979,456692,2015-06-03,Senate,"Senate 3rd Reading SB725 Hancock",40,0,0,0,40
740979,463554,2015-05-18,Senate,"Placed on Appropriations Suspense file",7,0,0,0,7
740979,466196,2015-07-15,Assembly,"Do pass and be re-referred to the Committee on Appropriations",7,0,0,0,7
740979,473864,2015-08-19,Assembly,"Do pass",17,0,0,0,17
740979,473994,2015-08-20,Assembly,"SB 725 Hancock  Third Reading Urgency  By O'DONNELL",77,1,0,2,80
740979,474079,2015-08-24,Senate,"Unfinished Business SB725 Hancock Urgency Clause",38,0,2,0,40
740980,432650,2015-04-15,Senate,"Do pass, but re-refer to the Committee on Appropriations",7,0,0,0,7
740980,453707,2015-05-28,Senate,"Do pass",7,0,0,0,7
740980,455330,2015-06-01,Senate,"Senate 3rd Reading SB612 Jackson",37,0,3,0,40
740980,463569,2015-04-27,Senate,"Placed on Appropriations Suspense file",7,0,0,0,7
740980,464396,2015-06-30,Assembly,"Do pass and be re-referred to the Committee on Appropriations",6,0,0,1,7
740980,474295,2015-08-27,Assembly,"Do pass as amended",16,1,0,0,17
740980,476023,2015-09-08,Assembly,"SB 612 Jackson  Senate Third Reading  By ALEJO",72,2,0,6,80
740980,476351,2015-09-10,Senate,"Unfinished Business SB612 Jackson Concurrence",39,0,1,0,40
740981,427807,2015-04-07,Senate,"Do pass as amended, and re-refer to the Committee on Environmental 	Quality",7,3,1,0,11
740981,440874,2015-04-29,Senate,"Do pass as amended, and re-refer to the Committee on Appropriations",5,2,0,0,7
740981,463610,2015-05-18,Senate,"Placed on Appropriations Suspense file",7,0,0,0,7
740984,428894,2015-04-08,Senate,"Do pass, but re-refer to the Committee on Appropriations",7,1,0,0,8
740984,445180,2015-05-11,Senate,"Placed on Appropriations Suspense file",7,0,0,0,7
740985,428437,2015-04-08,Senate,"Do pass as amended, and re-refer to the Committee on Appropriations",8,0,0,0,8
740985,447652,2015-05-18,Senate,"Senate 3rd Reading SB750 Mendoza",36,0,3,0,39
740985,460927,2015-06-17,Assembly,"Do pass and be re-referred to the Committee on Appropriations to 	Consent Calendar",7,0,0,0,7
740985,465650,2015-07-08,Assembly,"Do pass, to Consent Calendar",14,0,0,3,17
740985,475712,2015-09-03,Assembly,"SB 750 Mendoza  Senate Third Reading  By BLOOM",79,0,0,1,80
740985,475881,2015-09-04,Senate,"Unfinished Business SB750 Mendoza Concurrence",40,0,0,0,40
740990,437804,2015-04-22,Senate,"Do pass, but re-refer to the Committee on Appropriations",4,1,0,0,5
740990,444386,2015-05-07,Senate,"Senate 3rd Reading SB730 Wolk",23,11,5,0,39
740990,466364,2015-07-15,Assembly,"Do pass",11,5,0,1,17
740990,473551,2015-07-08,Assembly,"Do pass and be re-referred to the Committee on Appropriations",5,2,0,0,7
740990,474005,2015-08-20,Assembly,"SB 730 Wolk  Senate Third Reading  By THURMOND",51,28,0,1,80
740991,484941,2016-01-13,Assembly,"Do pass and be re-referred to the Committee on Appropriations",9,0,0,0,9
740991,486482,2016-01-21,Assembly,"Do pass",17,0,0,0,17
740991,487047,2016-01-25,Assembly,"AB 1348 IRWIN  Assembly Third Reading",76,0,0,3,79
740991,544818,2016-05-10,Senate,"Do pass, but re-refer to the Committee on Appropriations",11,0,2,0,13
740991,554541,2016-06-20,Senate,"Placed on Appropriations Suspense file",7,0,0,0,7
740991,559731,2016-08-11,Senate,"Do pass",7,0,0,0,7
740991,560776,2016-08-23,Senate,"Assembly 3rd Reading AB1348 Irwin By Lara",39,0,0,0,39
740992,437200,2015-04-21,Senate,"Do pass as amended, but re-refer to the Committee on Appropriations 	Recommend Consent",5,0,0,0,5
740992,442879,2015-05-04,Senate,"Placed on Appropriations Suspense file",7,0,0,0,7
740994,440132,2015-04-27,Assembly,"Do pass, to Consent Calendar",16,0,0,0,16
740994,442900,2015-05-04,Assembly,"AB 1151 SANTIAGO  Consent Calendar Second Day  Regular Session",78,0,0,2,80
740994,462521,2015-06-23,Senate,"Do pass and be placed on the Consent Calendar",11,0,0,0,11
740994,464886,2015-07-02,Senate,"Consent Calendar 2nd AB1151 Santiago",38,0,2,0,40
740996,440079,2015-04-27,Assembly,"Do pass and be re-referred to the Committee on Appropriations",6,3,0,0,9
740999,484767,2016-01-12,Assembly,"Do pass and be re-referred to the Committee on Appropriations to 	Consent Calendar",14,0,0,0,14
740999,485048,2016-01-05,Assembly,"Be referred to Committee on Business and Professions",11,0,0,0,11
740999,486493,2016-01-21,Assembly,"Do pass, to Consent Calendar",17,0,0,0,17
740999,488762,2016-01-27,Assembly,"AB 1174 BONILLA  Consent Calendar Second Day  Regular Session",78,0,0,1,79
740999,555518,2016-06-27,Senate,"Do pass, but re-refer to the Committee on Appropriations",9,0,0,0,9
740999,560178,2016-08-18,Senate,"Assembly 3rd Reading AB1174 Bonilla By Hill",36,0,3,0,39
740999,560958,2016-08-24,Assembly,"Senate amendments be concurred in",16,0,0,0,16
740999,561535,2016-08-30,Assembly,"AB 1174 BONILLA  Concurrence in Senate Amendments",79,0,0,1,80
741000,441780,2015-04-28,Assembly,"Do pass and be re-referred to the Committee on Appropriations",19,0,0,0,19
741001,436890,2015-04-21,Senate,"Do pass, but re-refer to the Committee on Governance and Finance",9,0,2,0,11
741001,443842,2015-05-06,Senate,"Do pass as amended, and re-refer to the Committee on Appropriations",5,2,0,0,7
741001,451900,2015-05-26,Senate,"Placed on Appropriations Suspense file",7,0,0,0,7
741001,486511,2016-01-21,Senate,"Do pass as amended",6,1,0,0,7
741001,488694,2016-01-27,Senate,"Senate 3rd Reading SB680 Wieckowski",33,2,5,0,40
741001,552438,2016-06-13,Assembly,"Be referred to Committee on Accountability and Administrative 	Review",11,0,0,0,11
741001,556344,2016-06-29,Assembly,"Do pass as amended and be re-referred to the Committee on 	Appropriations",7,0,0,2,9
741001,559016,2016-08-03,Assembly,"Do pass, to Consent Calendar",20,0,0,0,20
741001,560396,2016-08-19,Assembly,"SB 680 Wieckowski  Third Reading Urgency  By APPR.  Amendment  Set 	#1",73,0,0,7,80
741001,560909,2016-08-24,Assembly,"SB 680 Wieckowski  Third Reading Urgency  By CHU",78,0,0,2,80
741001,561334,2016-08-26,Senate,"From committee:  That the Assembly Amendments be concurred in",12,0,1,0,13
741001,561370,2016-08-29,Senate,"Unfinished Business SB680 Wieckowski Urgency Clause Concurr",38,1,0,0,39
741002,438024,2015-04-22,Assembly,"Do pass and be re-referred to the Committee on Appropriations",5,2,0,0,7
741002,454223,2015-05-28,Assembly,"Do pass as amended",12,4,0,1,17
741002,456681,2015-06-03,Assembly,"AB 1354 DODD  Assembly Third Reading",55,23,0,2,80
741002,473620,2015-08-17,Senate,"Placed on Appropriations Suspense file",7,0,0,0,7
741002,474663,2015-08-27,Senate,"Do pass as amended",5,2,0,0,7
741002,475844,2015-09-04,Senate,"Assembly 3rd Reading AB1354 Dodd By Mitchell",26,13,1,0,40
741002,475985,2015-09-08,Assembly,"AB 1354 DODD  Concurrence in Senate Amendments",54,25,0,1,80
741003,437178,2015-04-22,Assembly,"Do pass as amended and be re-referred to the Committee on 	Appropriations",12,0,0,1,13
741003,443947,2015-05-06,Assembly,"Do pass",17,0,0,0,17
741003,445194,2015-05-11,Assembly,"AB 1072 DALY  Assembly Third Reading",79,0,0,1,80
741003,462634,2015-06-24,Senate,"Do pass as amended, and re-refer to the Committee on Appropriations",8,0,1,0,9
741003,466388,2015-07-14,Senate,"Do pass, but re-refer to the Committee on Appropriations",7,0,0,0,7
741003,475454,2015-09-01,Senate,"Assembly 3rd Reading AB1072 Daly By Roth",37,0,3,0,40
741003,475639,2015-09-02,Assembly,"AB 1072 DALY  Concurrence in Senate Amendments",79,0,0,1,80
741004,440356,2015-04-27,Assembly,"Do pass and be re-referred to the Committee on Appropriations",16,0,0,0,16
741004,454371,2015-05-28,Assembly,"Do pass",17,0,0,0,17
741004,455354,2015-06-01,Assembly,"AB 1164 GATTO  Assembly Third Reading",80,0,0,0,80
741004,465574,2015-07-08,Senate,"Do pass, but re-refer to the Committee on Natural Resources and 	Water",6,0,1,0,7
741004,466025,2015-07-14,Senate,"Do pass as amended, and re-refer to the Committee on Appropriations",9,0,0,0,9
741004,473804,2015-08-17,Senate,"Placed on Appropriations Suspense file",7,0,0,0,7
741004,474700,2015-08-27,Senate,"Do pass as amended",6,0,1,0,7
741004,476133,2015-09-09,Senate,"Assembly 3rd Reading AB1164 Gatto By Galgiani",39,1,0,0,40
741004,476580,2015-09-11,Assembly,"Senate amendments be concurred in",8,0,0,1,9
741004,476581,2015-09-11,Assembly,"AB 1164 GATTO  Concurrence- Urgency Added",78,1,0,1,80
741008,428014,2015-04-07,Senate,"Do pass, but re-refer to the Committee on Appropriations",10,0,1,0,11
741008,439399,2015-04-27,Senate,"Senate 3rd Reading SB631 Hueso",29,4,6,0,39
741008,462091,2015-06-22,Assembly,"Do pass and be re-referred to the Committee on Appropriations",14,0,0,0,14
741008,465700,2015-07-08,Assembly,"Do pass",10,3,0,4,17
741008,466514,2015-07-16,Assembly,"SB 631 Hueso  Senate Third Reading  By RENDON",58,16,0,6,80
741008,473991,2015-08-20,Senate,"Unfinished Business SB631 Hueso Concurrence",24,11,5,0,40
741010,442462,2015-04-29,Assembly,"Do pass as amended and be re-referred to the Committee on 	Appropriations",7,0,0,0,7
741010,449052,2015-05-20,Assembly,"Do pass, to Consent Calendar",15,0,0,2,17
741010,454178,2015-05-28,Assembly,"AB 1099 OLSEN  Assembly Third Reading",70,2,0,8,80
741010,464679,2015-07-01,Senate,"Do pass as amended, and re-refer to the Committee on Appropriations",5,1,3,0,9
741010,473786,2015-08-17,Senate,"Placed on Appropriations Suspense file",7,0,0,0,7
741011,437192,2015-04-21,Senate,"Do pass, but re-refer to the Committee on Appropriations",5,2,0,0,7
741011,450262,2015-05-22,Senate,"Senate 3rd Reading SB641 Wieckowski",29,10,0,0,39
741011,465353,2015-07-06,Assembly,"Do pass as amended and be re-referred to the Committee on Judiciary",7,2,0,3,12
741011,466055,2015-07-14,Assembly,"Do pass as amended and be re-referred to the Committee on 	Appropriations",7,3,0,0,10
741011,473905,2015-08-19,Assembly,"Do pass",11,5,0,1,17
741011,476080,2015-09-09,Assembly,"SB 641 Wieckowski  Senate Third Reading  By STONE",45,26,0,9,80
741011,476357,2015-09-10,Senate,"Unfinished Business SB641 Wieckowski Concurrence",28,11,1,0,40
741012,442276,2015-04-29,Assembly,"Subject matter be referred",4,3,0,0,7
741014,440225,2015-04-27,Assembly,"Do pass as amended and be re-referred to the Committee on 	Appropriations",15,0,0,0,15
741016,440320,2015-04-28,Assembly,"Do pass",5,0,0,2,7
741016,442146,2015-04-30,Assembly,"AB 1104 RODRIGUEZ  Assembly Third Reading",76,0,0,4,80
741016,460290,2015-06-16,Senate,"Do pass",7,0,0,0,7
741016,462976,2015-06-25,Senate,"Assembly 3rd Reading AB1104 Rodriguez By Stone",38,0,2,0,40
741016,463936,2015-06-29,Assembly,"AB 1104 RODRIGUEZ  Concurrence in Senate Amendments",75,0,0,5,80
741017,437358,2015-04-22,Senate,"Do pass, but re-refer to the Committee on Appropriations",5,2,0,0,7
741017,457312,2015-06-04,Senate,"Senate 3rd Reading SB767 De Le",24,13,3,0,40
741017,465880,2015-07-13,Assembly,"Do pass as amended and be re-referred to the Committee on 	Appropriations",12,2,0,2,16
741017,473907,2015-07-01,Assembly,"Do pass and be re-referred to the Committee on Transportation",6,3,0,0,9
741017,473908,2015-08-19,Assembly,"Do pass",12,4,0,1,17
741017,476417,2015-09-10,Assembly,"SB 767 De Leon  Senate Third Reading  By SANTIAGO",51,27,0,2,80
741017,476626,2015-09-11,Senate,"Unfinished Business SB767 De Le",26,13,1,0,40
741018,434111,2015-04-16,Assembly,"Be referred to Committee on Natural Resources",11,0,0,0,11
741018,440051,2015-04-27,Assembly,"Do pass as amended and be re-referred to the Committee on 	Appropriations",8,1,0,0,9
741018,454167,2015-05-28,Assembly,"Do pass",17,0,0,0,17
741018,456584,2015-06-03,Assembly,"AB 1205 GOMEZ  Assembly Third Reading",75,4,0,1,80
741018,465995,2015-07-14,Senate,"Do pass as amended, and re-refer to the Committee on Appropriations",8,1,0,0,9
741018,473642,2015-08-17,Senate,"Placed on Appropriations Suspense file",7,0,0,0,7
741019,438391,2015-04-22,Assembly,"Amend, and do pass as amended and be re-referred to the Committee 	on Appropriations with the recommendation:  To Consent Calendar",7,0,0,0,7
741019,446225,2015-05-13,Assembly,"Do pass, to Consent Calendar",17,0,0,0,17
741019,450176,2015-05-22,Assembly,"AB 1204 CHAU  Consent Calendar Second Day  Regular Session",74,0,0,6,80
741019,460938,2015-06-17,Senate,"Do pass, but re-refer to the Committee on Appropriations Recommend 	Consent",8,0,1,0,9
741019,464918,2015-07-02,Senate,"Consent Calendar 2nd AB1204 Chau",38,0,2,0,40
741019,475926,2015-09-08,Senate,"Assembly 3rd Reading AB1204 Chau By Block",40,0,0,0,40
741019,476086,2015-09-09,Assembly,"AB 1204 CHAU  Concurrence in Senate Amendments",79,0,0,1,80
741022,429283,2015-04-08,Assembly,"Do pass and be re-referred to the Committee on Judiciary",7,0,0,0,7
741022,440073,2015-04-28,Assembly,"Do pass as amended and be re-referred to the Committee on 	Appropriations",10,0,0,0,10
741022,453949,2015-05-28,Assembly,"Do pass",17,0,0,0,17
741022,455420,2015-06-01,Assembly,"AB 1391 GOMEZ  Third Reading Urgency",80,0,0,0,80
741022,462558,2015-06-24,Senate,"Do pass as amended, but re-refer to the Committee on Appropriations 	Recommend Consent",9,0,0,0,9
741022,473672,2015-08-17,Senate,"Placed on Appropriations Suspense file",7,0,0,0,7
741022,474653,2015-08-27,Senate,"Do pass",7,0,0,0,7
741022,475930,2015-09-08,Senate,"Assembly 3rd Reading AB1391 Gomez By Block",40,0,0,0,40
741022,476113,2015-09-09,Assembly,"AB 1391 GOMEZ  Concurrence in Senate Amendments",79,0,0,1,80
741024,443372,2015-05-04,Assembly,"Do pass",12,0,0,0,12
741024,444419,2015-05-07,Assembly,"AB 1195 RIDLEY-THOMAS  Assembly Third Reading",77,0,0,3,80
741024,460784,2015-06-17,Senate,"Do pass, but re-refer to the Committee on Rules",7,0,0,0,7
741024,466411,2015-07-15,Senate,"Do pass and be placed on the Consent Calendar",9,0,0,0,9
741024,474003,2015-08-20,Senate,"Consent Calendar 2nd AB1195 Ridley-Thomas",38,0,2,0,40
741025,438434,2015-04-14,Assembly,"Do pass and be re-referred to the Committee on Public Safety",15,0,0,4,19
741026,445770,2015-05-12,Senate,"Do pass",7,0,0,0,7
741026,447608,2015-05-18,Senate,"Senate 3rd Reading SB626 McGuire",36,0,3,0,39
741026,461859,2015-06-22,Assembly,"Do pass and be re-referred to the Committee on Local Government",16,0,0,0,16
741026,466507,2015-07-15,Assembly,"Do pass",8,0,0,1,9
741026,474405,2015-08-27,Assembly,"SB 626 McGuire  Senate Third Reading  By DODD",78,0,0,2,80
741026,475288,2015-08-31,Senate,"Unfinished Business SB626 McGuire Concurrence",39,0,1,0,40
741027,436345,2015-04-21,Assembly,"Do pass and be re-referred to the Committee on Accountability and 	Administrative Review",8,0,0,1,9
741027,440932,2015-04-29,Assembly,"Do pass and be re-referred to the Committee on Appropriations",9,0,0,0,9
741027,454116,2015-05-28,Assembly,"Do pass",17,0,0,0,17
741027,456146,2015-06-02,Assembly,"AB 1218 WEBER  Assembly Third Reading",78,0,0,2,80
741027,462185,2015-06-23,Senate,"Do pass, but re-refer to the Committee on Governmental Organization",5,0,0,0,5
741027,466133,2015-07-14,Senate,"Do pass, but re-refer to the Committee on Appropriations",13,0,0,0,13
741027,473681,2015-08-17,Senate,"Placed on Appropriations Suspense file",7,0,0,0,7
741028,437240,2015-04-22,Assembly,"Do pass and be re-referred to the Committee on Appropriations",12,0,0,1,13
741028,453840,2015-05-28,Assembly,"Do pass",17,0,0,0,17
741028,455248,2015-06-01,Assembly,"AB 1440 NAZARIAN  Assembly Third Reading",79,0,0,1,80
741029,440206,2015-04-27,Assembly,"Do pass as amended and be re-referred to the Committee on 	Appropriations",6,3,0,0,9
741029,453694,2015-05-28,Assembly,"Do pass",12,5,0,0,17
741029,456077,2015-06-02,Assembly,"AB 1239 GORDON  Assembly Third Reading",50,29,0,1,80
741029,556516,2016-06-29,Senate,"Do pass as amended, and re-refer to the Committee on Appropriations",5,1,1,0,7
741029,559596,2016-08-11,Senate,"Do pass as amended",5,2,0,0,7
741029,560565,2016-08-22,Senate,"Assembly 3rd Reading AB1239 Gordon By Hueso",25,13,1,0,39
741029,561679,2016-08-30,Assembly,"Senate amendments be concurred in",6,2,0,1,9
741029,561680,2016-08-31,Assembly,"AB 1239 GORDON  Concurrence in Senate Amendments",34,34,0,12,80
741030,447812,2015-05-13,Assembly,"Do pass, to Consent Calendar",7,0,0,0,7
741030,450090,2015-05-22,Assembly,"AB 1339 SANTIAGO  Consent Calendar Second Day  Regular Session",74,0,0,6,80
741030,466428,2015-07-15,Senate,"Do pass and be placed on the Consent Calendar",9,0,0,0,9
741030,474037,2015-08-20,Senate,"Consent Calendar 2nd AB1339 Santiago",38,0,2,0,40
741033,440716,2015-04-28,Assembly,"Do pass, to Consent Calendar",7,0,0,0,7
741033,442903,2015-05-04,Assembly,"AB 1241 CALDERON  Consent Calendar Second Day  Regular Session",78,0,0,2,80
741033,554876,2016-06-21,Senate,"Do pass",7,0,0,0,7
741033,558680,2016-08-01,Senate,"Assembly 3rd Reading AB1241 Calderon By Allen",39,0,0,0,39
741034,440278,2015-04-27,Assembly,"Do pass as amended and be re-referred to the Committee on 	Appropriations",10,5,0,0,15
741034,454107,2015-05-28,Assembly,"Do pass",12,5,0,0,17
741034,456721,2015-06-03,Assembly,"AB 1266 GONZALEZ  Assembly Third Reading",48,28,0,4,80
741034,466016,2015-07-13,Senate,"Do pass, but re-refer to the Committee on Appropriations",7,3,1,0,11
741034,473583,2015-08-17,Senate,"Placed on Appropriations Suspense file",7,0,0,0,7
741034,474545,2015-08-27,Senate,"Do pass as amended",5,2,0,0,7
741034,476416,2015-09-10,Senate,"Assembly 3rd Reading AB1266 Gonzalez By Hueso",24,14,2,0,40
741034,476589,2015-09-11,Assembly,"AB 1266 GONZALEZ  Concurrence in Senate Amendments",48,30,0,2,80
741036,433069,2015-04-15,Assembly,"Do pass as amended and be re-referred to the Committee on Natural 	Resources",7,0,0,0,7
741036,484675,2016-01-11,Assembly,"Do pass as amended and be re-referred to the Committee on 	Appropriations",9,0,0,0,9
741036,488376,2016-01-27,Assembly,"AB 1500 MAIENSCHEIN  Assembly Third Reading",77,1,0,1,79
741036,558755,2016-08-01,Senate,"Placed on Appropriations Suspense file",7,0,0,0,7
741036,559533,2016-08-11,Senate,"Do pass",7,0,0,0,7
741036,559936,2016-08-16,Senate,"Assembly 3rd Reading AB1500 Atkins By Hueso",38,0,1,0,39
741036,560509,2016-08-22,Assembly,"AB 1500 ATKINS  Concurrence in Senate Amendments",78,0,0,2,80
741037,455646,2015-06-01,Assembly,"AB 1328 WEBER  Assembly Third Reading",41,36,0,3,80
741037,466023,2015-04-14,Assembly,"Do pass",4,2,0,1,7
741037,466295,2015-07-14,Senate,"Do pass",5,2,0,0,7
741037,476304,2015-09-10,Senate,"Assembly 3rd Reading AB1328 Weber By Leno",26,13,1,0,40
741037,476636,2015-09-11,Assembly,"AB 1328 WEBER  Concurrence in Senate Amendments",47,26,0,7,80
741039,436246,2015-04-20,Assembly,"Do pass and be re-referred to the Committee on Natural Resources",12,0,0,3,15
741039,440074,2015-04-27,Assembly,"Do pass and be re-referred to the Committee on Appropriations",9,0,0,0,9
741039,446327,2015-05-13,Assembly,"Do pass",17,0,0,0,17
741039,450063,2015-05-22,Assembly,"AB 1144 RENDON  Assembly Third Reading",73,0,0,7,80
741039,465474,2015-07-07,Senate,"Do pass, but re-refer to the Committee on Appropriations",9,2,0,0,11
741040,436426,2015-04-21,Assembly,"Do pass and be re-referred to the Committee on Judiciary",11,0,0,0,11
741040,440055,2015-04-28,Assembly,"Do pass as amended and be re-referred to the Committee on 	Appropriations",10,0,0,0,10
741040,446147,2015-05-13,Assembly,"Do pass, to Consent Calendar",17,0,0,0,17
741040,450258,2015-05-22,Assembly,"AB 1116 P.& C.P.  Consent Calendar Second Day  Regular Session",74,0,0,6,80
741040,466335,2015-07-14,Senate,"Do pass as amended, but re-refer to the Committee on Appropriations 	Recommend Consent",7,0,0,0,7
741040,475939,2015-09-08,Senate,"Assembly 3rd Reading AB1116 Committee On P. & C.P. (Gatto) By Leno",40,0,0,0,40
741040,476122,2015-09-09,Assembly,"AB 1116 P.& C.P.  Concurrence in Senate Amendments By GATTO",76,0,0,4,80
741044,436239,2015-04-21,Senate,"Do pass as amended, and re-refer to the Committee on Appropriations",8,3,0,0,11
741044,445214,2015-05-11,Senate,"Do pass",5,2,0,0,7
741044,447730,2015-05-18,Senate,"Senate 3rd Reading SB793 Wolk",23,13,3,0,39
741044,462096,2015-06-22,Assembly,"Do pass as amended and be re-referred to the Committee on 	Appropriations",14,0,0,0,14
741044,466314,2015-07-15,Assembly,"Do pass, to Consent Calendar",16,0,0,1,17
741044,474296,2015-08-27,Assembly,"SB 793 Wolk  Senate Third Reading  By WILLIAMS",79,0,0,1,80
741044,475345,2015-08-31,Senate,"Unfinished Business SB793 Wolk Concurrence",38,0,2,0,40
741045,431531,2015-04-13,Senate,"Do pass, but re-refer to the Committee on Health",7,0,2,0,9
741045,442202,2015-04-29,Senate,"Do pass as amended, and re-refer to the Committee on Appropriations",9,0,0,0,9
741045,450103,2015-05-22,Senate,"Senate 3rd Reading SB671 Hill",31,5,3,0,39
741045,465481,2015-07-07,Assembly,"Do pass and be re-referred to the Committee on Health",14,0,0,0,14
741045,466049,2015-07-14,Assembly,"Do pass as amended and be re-referred to the Committee on 	Appropriations",18,0,0,1,19
741045,473859,2015-08-19,Assembly,"Do pass, to Consent Calendar",17,0,0,0,17
741045,474349,2015-08-27,Assembly,"SB 671 Hill  Consent Calendar Second Day  Regular Session",78,0,0,2,80
741045,475268,2015-08-31,Senate,"Unfinished Business SB671 Hill Concurrence",38,0,2,0,40
741047,432511,2015-04-13,Assembly,"Do pass as amended and be re-referred to the Committee on 	Appropriations",16,0,0,0,16
741049,442461,2015-04-29,Senate,"Do pass as amended, and re-refer to the Committee on Appropriations",7,2,0,0,9
741049,463666,2015-05-18,Senate,"Placed on Appropriations Suspense file",7,0,0,0,7
741051,432707,2015-04-15,Assembly,"Do pass as amended and be re-referred to the Committee on 	Transportation",8,0,0,1,9
741051,440094,2015-04-27,Assembly,"Do pass and be re-referred to the Committee on Appropriations",16,0,0,0,16
741051,448967,2015-05-20,Assembly,"Do pass, to Consent Calendar",15,0,0,2,17
741051,451396,2015-05-26,Assembly,"AB 1236 CHIU  Consent Calendar Second Day  Regular Session",76,0,0,4,80
741051,460800,2015-06-17,Senate,"Do pass as amended, and re-refer to the Committee on Transportation 	and Housing",6,1,0,0,7
741051,465349,2015-07-07,Senate,"Do pass as amended, and re-refer to the Committee on Appropriations",8,0,3,0,11
741051,475957,2015-09-08,Senate,"Assembly 3rd Reading AB1236 Chiu By Beall",27,12,1,0,40
741051,476097,2015-09-09,Assembly,"AB 1236 CHIU  Concurrence in Senate Amendments",77,2,0,1,80
741052,440068,2015-04-28,Senate,"Do pass as amended, and re-refer to the Committee on Appropriations",7,1,1,0,9
741052,454037,2015-05-28,Senate,"Do pass as amended",5,2,0,0,7
741052,456694,2015-06-03,Senate,"Senate 3rd Reading SB788 McGuire",23,14,3,0,40
741052,463619,2015-05-18,Senate,"Placed on Appropriations Suspense file",7,0,0,0,7
741052,463864,2015-06-29,Assembly,"Do pass and be re-referred to the Committee on Appropriations",7,2,0,0,9
741054,428106,2015-04-06,Assembly,"Do pass and be re-referred to the Committee on Appropriations",15,0,0,1,16
741054,454362,2015-05-28,Assembly,"Do pass",17,0,0,0,17
741054,455453,2015-06-01,Assembly,"AB 1353 PATTERSON  Assembly Third Reading",78,0,0,2,80
741054,462133,2015-06-23,Senate,"Do pass, but re-refer to the Committee on Appropriations Recommend 	Consent",11,0,0,0,11
741054,465274,2015-07-06,Senate,"Do pass",7,0,0,0,7
741054,466527,2015-07-16,Senate,"Special Consent #5 AB1353 Patterson",38,0,2,0,40
741055,443837,2015-05-05,Assembly,"From committee:  Be adopted.  To third reading",7,0,0,0,7
741055,458299,2015-06-09,Senate,"Be adopted as amended, and re-refer to the Committee on 	Appropriations",5,0,0,0,5
741055,463933,2015-06-29,Senate,"Placed on Appropriations Suspense file",6,0,1,0,7
741055,474535,2015-08-27,Senate,"Be adopted as amended",7,0,0,0,7
741055,475944,2015-09-08,Senate,"Assembly 3rd Reading ACR38 Brown By Liu",40,0,0,0,40
741055,476178,2015-09-09,Assembly,"ACR 38 BROWN  Concurrence in Senate Amendments",79,0,0,1,80
741056,430936,2015-04-09,Assembly,"Be referred to Committee on Banking and Finance",11,0,0,0,11
741056,440735,2015-04-27,Assembly,"Do pass and be re-referred to the Committee on Appropriations",11,1,0,0,12
741056,453710,2015-05-28,Assembly,"Do pass as amended",17,0,0,0,17
741056,456062,2015-06-02,Assembly,"AB 1230 GOMEZ  Assembly Third Reading",77,1,0,2,80
741056,465457,2015-07-06,Senate,"Do pass, but re-refer to the Committee on Appropriations",9,0,0,0,9
741056,473730,2015-08-17,Senate,"Placed on Appropriations Suspense file",7,0,0,0,7
741056,474597,2015-08-27,Senate,"Do pass",7,0,0,0,7
741056,475920,2015-09-08,Senate,"Assembly 3rd Reading AB1230 Gomez By Galgiani",39,0,1,0,40
741056,476082,2015-09-09,Assembly,"AB 1230 GOMEZ  Concurrence in Senate Amendments",79,0,0,1,80
741057,434177,2015-04-15,Senate,"Do pass as amended, and re-refer to the Committee on Judiciary",7,2,0,0,9
741057,440318,2015-04-28,Senate,"Do pass as amended, and re-refer to the Committee on Appropriations",5,1,1,0,7
741057,463651,2015-05-18,Senate,"Placed on Appropriations Suspense file",7,0,0,0,7
741057,486515,2016-01-21,Senate,"Do pass as amended",5,2,0,0,7
741057,488329,2016-01-27,Senate,"Senate 3rd Reading SB648 Mendoza",27,12,1,0,40
741057,555046,2016-06-21,Assembly,"Do pass and be re-referred to the Committee on Judiciary",4,1,0,2,7
741057,556139,2016-06-28,Assembly,"Do pass as amended and be re-referred to the Committee on 	Appropriations",10,0,0,0,10
741057,559311,2016-08-11,Assembly,"Do pass as amended",16,4,0,0,20
741057,560438,2016-08-19,Assembly,"SB 648 Mendoza  Senate Third Reading  By H.& C.D.  Amendment  Set #1",73,0,0,7,80
741057,561086,2016-08-24,Assembly,"SB 648 Mendoza  Senate Third Reading  By LEVINE",59,19,0,2,80
741057,561444,2016-08-29,Senate,"Unfinished Business SB648 Mendoza Concurrence",27,12,0,0,39
741058,437985,2015-04-14,Assembly,"Do pass and be re-referred to the Committee on Judiciary",16,0,0,3,19
741058,439951,2015-04-28,Assembly,"Do pass as amended and be re-referred to the Committee on 	Appropriations",10,0,0,0,10
741060,441259,2015-04-28,Assembly,"Do pass and be re-referred to the Committee on Appropriations",19,0,0,0,19
741060,454303,2015-05-28,Assembly,"Do pass",17,0,0,0,17
741060,456578,2015-06-03,Assembly,"AB 1235 GIPSON  Assembly Third Reading",79,1,0,0,80
741060,464741,2015-07-01,Senate,"Do pass as amended, and re-refer to the Committee on Appropriations",8,0,1,0,9
741060,473741,2015-08-17,Senate,"Placed on Appropriations Suspense file",7,0,0,0,7
741061,441162,2015-04-28,Assembly,"Do pass and be re-referred to the Committee on Appropriations to 	Consent Calendar",7,0,0,0,7
741061,446378,2015-05-13,Assembly,"Do pass, to Consent Calendar",17,0,0,0,17
741061,450200,2015-05-22,Assembly,"AB 1387 CHU  Consent Calendar Second Day  Regular Session",74,0,0,6,80
741061,466088,2015-07-14,Senate,"Do pass as amended, and re-refer to the Committee on Appropriations",3,0,2,0,5
741061,473762,2015-08-17,Senate,"Placed on Appropriations Suspense file",7,0,0,0,7
741061,474537,2015-08-27,Senate,"Do pass as amended",6,1,0,0,7
741061,476402,2015-09-10,Senate,"Assembly 3rd Reading AB1387 Chu By Monning",39,0,1,0,40
741061,476582,2015-09-11,Assembly,"AB 1387 CHU  Concurrence in Senate Amendments",79,0,0,1,80
741063,432840,2015-04-14,Senate,"Do pass, but re-refer to the Committee on Appropriations",11,0,0,0,11
741063,445322,2015-05-11,Senate,"Senate 3rd Reading SB692 Vidak",36,0,3,0,39
741063,465643,2015-07-08,Assembly,"Do pass and be re-referred to the Committee on Appropriations",19,0,0,2,21
741063,559039,2016-08-03,Assembly,"Do pass, to Consent Calendar",20,0,0,0,20
741063,559493,2016-08-11,Assembly,"SB 692 Vidak  Consent Calendar Second Day  Regular Session",78,0,0,2,80
741063,561031,2016-08-24,Senate,"Unfinished Business SB692 Vidak Concurrence",38,0,1,0,39
741064,436007,2015-04-20,Assembly,"Do pass and be re-referred to the Committee on Local Government",2,9,0,5,16
741064,463691,2015-04-20,Assembly,"Reconsideration granted",15,0,0,1,16
741065,446640,2015-05-14,Senate,"Senate 3rd Reading SB719 Hernandez",35,0,4,0,39
741065,461808,2015-06-22,Assembly,"Do pass and be re-referred to the Committee on Appropriations to 	Consent Calendar",16,0,0,0,16
741065,465648,2015-07-08,Assembly,"Do pass, to Consent Calendar",14,0,0,3,17
741065,466443,2015-07-16,Assembly,"SB 719 Hernandez  Consent Calendar Second Day  Regular Session",79,0,0,1,80
741066,440510,2015-04-27,Assembly,"Do pass and be re-referred to the Committee on Appropriations",6,0,0,3,9
741066,453724,2015-05-28,Assembly,"Do pass",12,4,0,1,17
741066,456154,2015-06-02,Assembly,"AB 1496 THURMOND  Assembly Third Reading",57,18,0,5,80
741066,464804,2015-07-01,Senate,"Do pass as amended, and re-refer to the Committee on Appropriations",5,1,1,0,7
741066,473607,2015-08-17,Senate,"Placed on Appropriations Suspense file",7,0,0,0,7
741066,474610,2015-08-27,Senate,"Do pass as amended",5,2,0,0,7
741066,476166,2015-09-09,Senate,"Assembly 3rd Reading AB1496 Thurmond By Wieckowski",25,14,1,0,40
741066,476353,2015-09-10,Assembly,"AB 1496 THURMOND  Concurrence in Senate Amendments",57,22,0,1,80
741069,436299,2015-04-21,Assembly,"Do pass as amended and be re-referred to the Committee on 	Appropriations",8,0,0,1,9
741070,433934,2015-04-15,Senate,"Do pass, but re-refer to the Committee on Human Services",8,0,1,0,9
741070,440931,2015-04-28,Senate,"Do pass as amended, and re-refer to the Committee on Appropriations",3,0,2,0,5
741070,450144,2015-05-22,Senate,"Senate 3rd Reading SB792 Mendoza",34,3,2,0,39
741070,464700,2015-06-30,Assembly,"Do pass as amended and be re-referred to the Committee on Human 	Services",17,1,0,1,19
741070,466320,2015-07-14,Assembly,"Do pass as amended and be re-referred to the Committee on 	Appropriations",6,1,0,0,7
741070,474218,2015-08-26,Assembly,"Do pass",16,1,0,0,17
741070,475839,2015-09-04,Assembly,"SB 792 Mendoza  Senate Third Reading  By THURMOND  Amend By MATHIS 	Set #1  Motion to  Lay on the Table  By HOLDEN",50,26,0,4,80
741070,475989,2015-09-08,Assembly,"SB 792 Mendoza  Senate Third Reading  By CALDERON",60,16,0,4,80
741070,476292,2015-09-10,Senate,"Unfinished Business SB792 Mendoza Concurrence",32,5,3,0,40
741071,428595,2015-04-08,Assembly,"Do pass and be re-referred to the Committee on Appropriations to 	Consent Calendar",21,0,0,0,21
741071,437128,2015-04-22,Assembly,"Do pass, to Consent Calendar",17,0,0,0,17
741071,442302,2015-04-30,Assembly,"AB 1188 GIPSON  Consent Calendar Second Day  Regular Session",77,0,0,3,80
741072,434120,2015-04-16,Assembly,"Be referred to Committee on Governmental Organization",11,0,0,0,11
741072,442361,2015-04-30,Assembly,"Amend, and re-refer to the Committee on Governmental Organization",10,6,0,5,21
741073,436950,2015-04-21,Assembly,"Do pass and be re-referred to the Committee on Appropriations to 	Consent Calendar",7,0,0,0,7
741073,441102,2015-04-29,Assembly,"Do pass, to Consent Calendar",17,0,0,0,17
741073,444440,2015-05-07,Assembly,"AB 1207 LOPEZ  Consent Calendar Second Day  Regular Session",77,0,0,3,80
741073,462464,2015-06-23,Senate,"Do pass, but re-refer to the Committee on Appropriations",7,0,0,0,7
741073,465150,2015-07-06,Senate,"Placed on Appropriations Suspense file",7,0,0,0,7
741073,474698,2015-08-27,Senate,"Do pass as amended",7,0,0,0,7
741073,476403,2015-09-10,Senate,"Assembly 3rd Reading AB1207 Lopez By Hancock",40,0,0,0,40
741073,476583,2015-09-11,Assembly,"AB 1207 LOPEZ  Concurrence in Senate Amendments",79,0,0,1,80
741075,438027,2015-04-22,Assembly,"Do pass as amended and be re-referred to the Committee on 	Appropriations",6,0,0,1,7
741076,438052,2015-04-21,Assembly,"Amend, and do pass as amended and be re-referred to the Committee 	on Appropriations with the recommendation:  To Consent Calendar",18,0,0,1,19
741076,443822,2015-05-06,Assembly,"Do pass, to Consent Calendar",17,0,0,0,17
741076,446900,2015-05-14,Assembly,"AB 1149 WOOD  Consent Calendar Second Day  Regular Session",78,0,0,2,80
741076,458542,2015-06-10,Senate,"Do pass, but re-refer to the Committee on Appropriations Recommend 	Consent",9,0,0,0,9
741076,461885,2015-06-22,Senate,"Do pass",6,0,1,0,7
741076,462934,2015-06-25,Senate,"Assembly 3rd Reading AB1149 Wood By Hernandez",38,0,2,0,40
741077,446577,2015-05-13,Assembly,"Do pass as amended",9,0,0,0,9
741077,450087,2015-05-22,Assembly,"AB 1191 NAZARIAN  Assembly Third Reading",74,0,0,6,80
741077,466513,2015-07-16,Senate,"Special Consent #5 AB1191 Nazarian",38,0,2,0,40
741077,473728,2015-08-17,Assembly,"AB 1191 NAZARIAN  Concurrence in Senate Amendments",79,0,0,1,80
741078,438363,2015-04-22,Assembly,"Do pass and be re-referred to the Committee on Appropriations",5,2,0,0,7
741078,443620,2015-05-06,Assembly,"Do pass",12,5,0,0,17
741078,446809,2015-05-14,Assembly,"AB 1358 DABABNEH  Assembly Third Reading",63,16,0,1,80
741078,464780,2015-07-01,Senate,"Do pass as amended, and re-refer to the Committee on Appropriations",5,2,2,0,9
741078,473756,2015-08-17,Senate,"Do pass",5,2,0,0,7
741078,475315,2015-08-31,Senate,"Assembly 3rd Reading AB1358 Dababneh By Wolk",27,13,0,0,40
741078,475665,2015-09-02,Assembly,"AB 1358 DABABNEH  Concurrence in Senate Amendments",59,21,0,0,80
741082,441138,2015-04-28,Assembly,"Do pass and be re-referred to the Committee on Appropriations to 	Consent Calendar",19,0,0,0,19
741082,446142,2015-05-13,Assembly,"Do pass, to Consent Calendar",17,0,0,0,17
741082,450074,2015-05-22,Assembly,"AB 1423 STONE  Consent Calendar Second Day  Regular Session",74,0,0,6,80
741082,465427,2015-07-07,Senate,"Do pass, but re-refer to the Committee on Appropriations",6,0,1,0,7
741082,466132,2015-04-14,Assembly,"Do pass and be re-referred to the Committee on Health",6,0,0,1,7
741082,473749,2015-08-17,Senate,"Placed on Appropriations Suspense file",7,0,0,0,7
741082,474591,2015-08-27,Senate,"Do pass",7,0,0,0,7
741082,475664,2015-09-02,Senate,"Assembly 3rd Reading AB1423 Mark Stone By Glazer",39,0,1,0,40
741083,441547,2015-04-28,Assembly,"Do pass as amended and be re-referred to the Committee on 	Appropriations",16,1,0,2,19
741083,454203,2015-05-28,Assembly,"Do pass as amended",13,1,0,3,17
741083,457246,2015-06-04,Assembly,"AB 1102 SANTIAGO  Assembly Third Reading",66,10,0,4,80
741083,466537,2015-07-15,Senate,"Do pass, but re-refer to the Committee on Appropriations",8,0,1,0,9
741083,473691,2015-08-17,Senate,"Placed on Appropriations Suspense file",7,0,0,0,7
741083,474566,2015-08-27,Senate,"Do pass",5,2,0,0,7
741084,432958,2015-04-14,Senate,"Do pass, but re-refer to the Committee on Appropriations",11,0,0,0,11
741084,453848,2015-05-28,Senate,"Do pass as amended",7,0,0,0,7
741084,455950,2015-06-02,Senate,"Senate 3rd Reading SB685 McGuire",40,0,0,0,40
741084,463652,2015-04-27,Senate,"Placed on Appropriations Suspense file",7,0,0,0,7
741084,465698,2015-07-08,Assembly,"Do pass and be re-referred to the Committee on Appropriations",18,0,0,3,21
741084,473869,2015-08-19,Assembly,"Do pass, to Consent Calendar",17,0,0,0,17
741084,474240,2015-08-27,Assembly,"SB 685 McGuire  Consent Calendar Second Day  Regular Session",78,0,0,2,80
741084,475276,2015-08-31,Senate,"Unfinished Business SB685 McGuire Concurrence",39,0,1,0,40
741085,437058,2015-04-22,Assembly,"Do pass and be re-referred to the Committee on Appropriations",12,0,0,1,13
741085,453704,2015-05-28,Assembly,"Do pass",17,0,0,0,17
741085,455323,2015-06-01,Assembly,"AB 1429 CHIU  Assembly Third Reading",79,0,0,1,80
741089,439980,2015-04-28,Senate,"Do pass, but re-refer to the Committee on Appropriations Recommend 	Consent",8,0,1,0,9
741089,445159,2015-05-11,Senate,"Placed on Appropriations Suspense file",7,0,0,0,7
741089,453904,2015-05-28,Senate,"Do pass as amended",7,0,0,0,7
741089,457287,2015-06-04,Senate,"Senate 3rd Reading SB734 De Le",37,0,3,0,40
741089,466051,2015-07-13,Assembly,"Do pass and be re-referred to the Committee on Appropriations to 	Consent Calendar",9,0,0,0,9
741089,474215,2015-08-26,Assembly,"Do pass, to Consent Calendar",17,0,0,0,17
741089,552441,2016-06-13,Assembly,"Do pass as amended and be re-referred to the Committee on 	Appropriations",5,3,0,1,9
741089,555004,2016-06-22,Assembly,"Do pass",14,5,0,1,20
741089,559099,2016-08-04,Assembly,"SB 734 Galgiani  Third Reading Urgency  By GRAY",61,10,0,9,80
741089,559213,2016-08-10,Senate,"From committee:  That the Assembly Amendments be concurred in",4,1,2,0,7
741089,559270,2016-08-11,Senate,"Unfinished Business SB734 Galgiani Urgency Clause Concurr",28,0,11,0,39
741091,427749,2015-04-07,Assembly,"Do pass and be re-referred to the Committee on Appropriations to 	Consent Calendar",18,0,0,1,19
741091,434152,2015-04-15,Assembly,"Do pass, to Consent Calendar",16,0,0,1,17
741091,438394,2015-04-23,Assembly,"AB 1432 BONTA  Consent Calendar Second Day  Regular Session",78,0,0,2,80
741091,474072,2015-08-24,Senate,"Do pass",6,1,0,0,7
741091,548650,2016-05-26,Senate,"Assembly 3rd Reading AB1432 Bonta By Wieckowski",29,7,4,0,40
741091,555511,2016-06-27,Assembly,"Senate amendments be concurred in",15,0,0,1,16
741091,558636,2016-08-01,Assembly,"AB 1432 BONTA  Concurrence in Senate Amendments",70,0,0,10,80
741092,436181,2015-04-20,Assembly,"Do pass and be re-referred to the Committee on Appropriations to 	Consent Calendar",14,0,0,1,15
741092,440885,2015-04-29,Assembly,"Do pass, to Consent Calendar",17,0,0,0,17
741092,444410,2015-05-07,Assembly,"AB 1262 WOOD  Consent Calendar Second Day  Regular Session",77,0,0,3,80
741092,460177,2015-06-16,Senate,"Do pass, but re-refer to the Committee on Appropriations",10,0,1,0,11
741092,463858,2015-06-29,Senate,"Do pass",6,0,1,0,7
741092,473827,2015-08-17,Senate,"Assembly 3rd Reading AB1262 Wood By Hueso",38,0,2,0,40
741093,430577,2015-04-13,Senate,"Do pass, but re-refer to the Committee on Appropriations",4,1,0,0,5
741093,453867,2015-05-28,Senate,"Do pass",5,2,0,0,7
741093,455397,2015-06-01,Senate,"Senate 3rd Reading SB686 Pan",23,13,4,0,40
741093,463692,2015-04-27,Senate,"Placed on Appropriations Suspense file",7,0,0,0,7
741093,465453,2015-07-07,Assembly,"Do pass and be re-referred to the Committee on Appropriations",11,2,0,0,13
741093,474477,2015-08-27,Assembly,"Do pass",12,5,0,0,17
741093,475624,2015-09-02,Assembly,"SB 686 Pan  Senate Third Reading  By COOPER",54,24,0,2,80
741094,437829,2015-04-14,Assembly,"Do pass and be re-referred to the Committee on Appropriations",16,0,0,3,19
741094,446126,2015-05-13,Assembly,"Do pass, to Consent Calendar",17,0,0,0,17
741094,455405,2015-06-01,Assembly,"AB 1194 EGGMAN  Assembly Third Reading",79,0,0,1,80
741094,464711,2015-07-01,Senate,"Do pass as amended, and re-refer to the Committee on Appropriations",7,0,2,0,9
741094,475968,2015-09-08,Senate,"Assembly 3rd Reading AB1194 Eggman By Hernandez",40,0,0,0,40
741094,476157,2015-09-09,Assembly,"AB 1194 EGGMAN  Concurrence in Senate Amendments",80,0,0,0,80
741095,431684,2015-04-13,Senate,"Do pass, but re-refer to the Committee on Environmental Quality",5,2,2,0,9
741095,441690,2015-04-29,Senate,"Do pass, but re-refer to the Committee on Appropriations",6,0,1,0,7
741095,454124,2015-05-28,Senate,"Do pass as amended",5,2,0,0,7
741095,456603,2015-06-03,Senate,"Senate 3rd Reading SB763 Leno",30,10,0,0,40
741095,463594,2015-05-18,Senate,"Placed on Appropriations Suspense file",7,0,0,0,7
741095,465405,2015-07-07,Assembly,"Amend, and do pass as amended and be re-referred to the Committee 	on Environmental Safety and Toxic Materials with the 	recommendation:  To Consent Calendar",12,0,0,2,14
741095,466043,2015-07-14,Assembly,"Do pass and be re-referred to the Committee on Appropriations",7,0,0,0,7
741095,474246,2015-08-27,Assembly,"Do pass as amended",16,0,0,1,17
741098,443756,2015-05-05,Senate,"Do pass and be placed on the Consent Calendar",7,0,0,0,7
741098,447716,2015-05-18,Senate,"Consent Calendar 2nd SB785 Morrell",36,0,3,0,39
741098,460188,2015-06-16,Assembly,"Do pass, to Consent Calendar",10,0,0,0,10
741098,461868,2015-06-22,Assembly,"SB 785 Morrell  Consent Calendar Second Day  Regular Session",77,0,0,3,80
741100,446150,2015-05-13,Assembly,"Do pass",3,4,0,0,7
741101,436089,2015-04-21,Assembly,"Do pass, to Consent Calendar",9,0,0,0,9
741101,439461,2015-04-27,Assembly,"AB 1444 GARCIA, E.  Consent Calendar Second Day  Regular Session",79,0,0,1,80
741103,484876,2016-01-13,Senate,"Do pass, but re-refer to the Committee on Appropriations",9,0,2,0,11
741103,485578,2016-01-19,Senate,"Do pass",7,0,0,0,7
741103,487019,2016-01-25,Senate,"Senate 3rd Reading SB745 Hueso",36,1,3,0,40
741103,556763,2016-06-29,Assembly,"Do pass as amended and be re-referred to the Committee on 	Appropriations",10,4,0,1,15
741103,559250,2016-08-11,Assembly,"Do pass",11,4,0,5,20
741103,560347,2016-08-19,Assembly,"SB 745 Hueso  Senate Third Reading  Amendment  Set #1",73,0,0,7,80
741103,560750,2016-08-23,Assembly,"SB 745 Hueso  Senate Third Reading  By GIPSON",54,26,0,0,80
741103,560931,2016-08-24,Senate,"Unfinished Business SB745 Hueso Concurrence",28,10,1,0,39
741104,482971,2015-12-09,Assembly,"Be referred to Committee on Health",8,0,0,3,11
741104,484750,2016-01-12,Assembly,"Do pass and be re-referred to the Committee on Appropriations",19,0,0,0,19
741105,441093,2015-04-29,Senate,"Do pass, but re-refer to the Committee on Appropriations",4,1,2,0,7
741105,445150,2015-05-11,Senate,"Placed on Appropriations Suspense file",7,0,0,0,7
741105,484696,2016-01-11,Senate,"Do pass, but re-refer to the Committee on Appropriations",5,1,3,0,9
741105,487020,2016-01-25,Senate,"Senate 3rd Reading SB778 Allen",22,12,6,0,40
741105,552775,2016-06-14,Assembly,"Do pass and be re-referred to the Committee on Business and 	Professions",8,0,0,3,11
741105,556098,2016-06-28,Assembly,"Do pass and be re-referred to the Committee on Appropriations",14,1,0,1,16
741105,559394,2016-08-11,Assembly,"Do pass",17,3,0,0,20
741105,560526,2016-08-22,Assembly,"SB 778 Allen  Senate Third Reading  By SALAS",66,10,0,4,80
741105,561287,2016-08-25,Senate,"From committee:  That the Assembly Amendments be concurred in",7,2,0,0,9
741105,561463,2016-08-29,Senate,"Unfinished Business SB778 Allen Concurrence",29,10,0,0,39
741106,485127,2016-01-13,Assembly,"Do pass and be re-referred to the Committee on Appropriations",9,0,0,0,9
741107,439374,2015-04-27,Senate,"Do pass as amended, and re-refer to the Committee on Appropriations",7,2,2,0,11
741107,453760,2015-05-28,Senate,"Do pass",5,2,0,0,7
741107,455955,2015-06-02,Senate,"Senate 3rd Reading SB660 Leno",29,7,4,0,40
741107,463656,2015-05-18,Senate,"Placed on Appropriations Suspense file",7,0,0,0,7
741107,474386,2015-08-27,Assembly,"Do pass",17,0,0,0,17
741107,476252,2015-09-10,Assembly,"SB 660 Leno  Senate Third Reading  By RENDON",80,0,0,0,80
741107,476534,2015-09-11,Senate,"Unfinished Business SB660 Leno Concurrence",40,0,0,0,40
741108,440434,2015-04-27,Assembly,"Do pass as amended and be re-referred to the Committee on 	Appropriations",9,0,0,0,9
741108,446288,2015-05-13,Assembly,"Do pass, to Consent Calendar",17,0,0,0,17
741108,450141,2015-05-22,Assembly,"AB 1323 FRAZIER  Consent Calendar Second Day  Regular Session",74,0,0,6,80
741108,462135,2015-06-23,Senate,"Do pass, but re-refer to the Committee on Judiciary",9,0,0,0,9
741108,466400,2015-07-14,Senate,"Do pass, but re-refer to the Committee on Appropriations Recommend 	Consent",7,0,0,0,7
741108,475986,2015-09-08,Senate,"Assembly 3rd Reading AB1323 Frazier By Hueso",40,0,0,0,40
741108,476140,2015-09-09,Assembly,"AB 1323 FRAZIER  Concurrence in Senate Amendments",79,0,0,1,80
741110,436449,2015-04-21,Senate,"Do pass, but re-refer to the Committee on Appropriations",7,0,4,0,11
741110,455647,2015-06-01,Senate,"Senate 3rd Reading SB655 Mitchell",22,13,5,0,40
741110,473906,2015-08-19,Assembly,"Do pass",11,5,0,1,17
741110,474043,2015-07-15,Assembly,"Do pass and be re-referred to the Committee on Appropriations",5,2,0,0,7
741110,475662,2015-09-02,Assembly,"SB 655 Mitchell  Senate Third Reading  By CHIU",44,28,0,8,80
741110,475845,2015-09-04,Senate,"Unfinished Business SB655 Mitchell Concurrence",25,14,1,0,40
741111,440955,2015-04-29,Assembly,"Do pass and be re-referred to the Committee on Appropriations to 	Consent Calendar",9,0,0,1,10
741111,446513,2015-05-13,Assembly,"Do pass as amended",17,0,0,0,17
741111,450081,2015-05-22,Assembly,"AB 1363 SALAS  Assembly Third Reading",75,0,0,5,80
741111,465406,2015-07-07,Senate,"Do pass as amended, and re-refer to the Committee on Appropriations",5,0,0,0,5
741111,476464,2015-09-10,Senate,"Assembly 3rd Reading AB1363 Salas By Vidak",40,0,0,0,40
741111,476654,2015-09-11,Assembly,"AB 1363 SALAS  Concurrence in Senate Amendments",79,0,0,1,80
741113,443630,2015-05-05,Assembly,"Do pass as amended, to Consent Calendar",14,0,0,0,14
741113,446626,2015-05-14,Assembly,"AB 1097 HOLDEN  Consent Calendar Second Day  Regular Session",78,0,0,2,80
741113,459819,2015-06-15,Senate,"Do pass, but re-refer to the Committee on Judiciary Recommend 	Consent",9,0,0,0,9
741113,465578,2015-07-07,Senate,"Do pass and be placed on the Consent Calendar",6,0,1,0,7
741113,476061,2015-09-09,Senate,"Assembly 3rd Reading AB1097 Holden By Hill",40,0,0,0,40
741113,476347,2015-09-10,Assembly,"AB 1097 HOLDEN  Concurrence in Senate Amendments",80,0,0,0,80
741114,428541,2015-04-08,Senate,"Do pass, but re-refer to the Committee on Appropriations",7,1,0,0,8
741114,435230,2015-04-20,Senate,"Placed on Appropriations Suspense file",7,0,0,0,7
741114,454041,2015-05-28,Senate,"Do pass as amended",5,2,0,0,7
741114,456691,2015-06-03,Senate,"Senate 3rd Reading SB645 Hancock",30,10,0,0,40
741114,466240,2015-07-15,Assembly,"Do pass and be re-referred to the Committee on Appropriations to 	Consent Calendar",7,0,0,0,7
741115,441052,2015-04-28,Assembly,"Do pass and be re-referred to the Committee on Appropriations",5,14,0,0,19
741116,442121,2015-04-29,Assembly,"Do pass as amended and be re-referred to the Committee on 	Appropriations",5,0,0,2,7
741117,433640,2015-04-14,Assembly,"Amend, and do pass as amended and be re-referred to the Committee 	on Health with the recommendation:  To Consent Calendar",7,0,0,0,7
741117,441511,2015-04-28,Assembly,"Do pass and be re-referred to the Committee on Appropriations to 	Consent Calendar",19,0,0,0,19
741117,453907,2015-05-28,Assembly,"Do pass",17,0,0,0,17
741117,455439,2015-06-01,Assembly,"AB 1299 RIDLEY-THOMAS  Assembly Third Reading",80,0,0,0,80
741117,460782,2015-06-17,Senate,"Do pass, but re-refer to the Committee on Human Services",9,0,0,0,9
741117,466172,2015-07-14,Senate,"Do pass as amended, and re-refer to the Committee on Appropriations",5,0,0,0,5
741117,473818,2015-08-17,Senate,"Placed on Appropriations Suspense file",7,0,0,0,7
741117,560667,2016-08-23,Senate,"Assembly 3rd Reading AB1299 Ridley-Thomas By Hertzberg",39,0,0,0,39
741117,561359,2016-08-29,Assembly,"AB 1299 RIDLEY-THOMAS  Concurrence in Senate Amendments",79,1,0,0,80
741119,428076,2015-04-07,Senate,"Do pass, but re-refer to the Committee on Appropriations",11,0,0,0,11
741119,439395,2015-04-27,Senate,"Senate 3rd Reading SB726 Hueso",35,0,4,0,39
741119,545502,2016-05-12,Assembly,"Be referred to Committee on Banking and Finance",10,0,0,1,11
741119,556022,2016-06-27,Assembly,"Do pass as amended and be re-referred to the Committee on 	Appropriations",9,1,0,2,12
741120,437459,2015-04-22,Senate,"Do pass",1,3,1,0,5
741122,442050,2015-04-28,Assembly,"Do pass and be re-referred to the Committee on Appropriations",10,3,0,0,13
741124,484790,2016-01-12,Assembly,"Do pass and be re-referred to the Committee on Appropriations",4,1,0,2,7
741124,486287,2016-01-21,Assembly,"Do pass",16,0,0,1,17
741124,487015,2016-01-25,Assembly,"AB 1395 SALAS  Assembly Third Reading",69,2,0,8,79
741124,552702,2016-06-14,Senate,"Do pass as amended, and re-refer to the Committee on Appropriations",7,0,0,0,7
741124,558710,2016-08-01,Senate,"Placed on Appropriations Suspense file",7,0,0,0,7
741125,436001,2015-04-21,Assembly,"Do pass, to Consent Calendar",7,0,0,0,7
741125,442352,2015-04-30,Assembly,"AB 1168 SALAS  Consent Calendar Second Day  Regular Session",77,0,0,3,80
741125,462199,2015-06-23,Senate,"Do pass",7,0,0,0,7
741125,465210,2015-07-06,Senate,"Special Consent #4 AB1168 Salas",39,0,1,0,40
741125,465776,2015-07-09,Assembly,"AB 1168 SALAS  Concurrence in Senate Amendments",79,0,0,1,80
741126,430573,2015-04-13,Assembly,"Be referred to Committee on Governmental Organization",11,0,0,0,11
741129,437086,2015-04-22,Assembly,"Do pass, to Consent Calendar",17,0,0,0,17
741129,438068,2015-04-14,Assembly,"Do pass and be re-referred to the Committee on Appropriations to 	Consent Calendar",16,0,0,3,19
741129,442208,2015-04-30,Assembly,"AB 1130 GRAY  Consent Calendar Second Day  Regular Session",77,0,0,3,80
741129,462964,2015-06-24,Senate,"Do pass as amended, and re-refer to the Committee on Appropriations",8,0,1,0,9
741129,475334,2015-08-31,Senate,"Assembly 3rd Reading AB1130 Gray By Pan",40,0,0,0,40
741129,475427,2015-09-01,Assembly,"AB 1130 GRAY  Concurrence in Senate Amendments",80,0,0,0,80
741132,435968,2015-04-20,Assembly,"Do pass and be re-referred to the Committee on Natural Resources",11,3,0,1,15
741132,439960,2015-04-27,Assembly,"Do pass as amended and be re-referred to the Committee on 	Appropriations",7,2,0,0,9
741133,434335,2015-04-16,Assembly,"Be referred to Committee on Health",11,0,0,0,11
741133,440918,2015-04-28,Assembly,"Do pass and be re-referred to the Committee on Appropriations to 	Consent Calendar",19,0,0,0,19
741133,443892,2015-05-06,Assembly,"Do pass, to Consent Calendar",17,0,0,0,17
741133,446604,2015-05-14,Assembly,"AB 1211 MAIENSCHEIN  Consent Calendar Second Day  Regular Session",78,0,0,2,80
741133,464715,2015-07-01,Senate,"Do pass, but re-refer to the Committee on Appropriations",8,0,1,0,9
741133,475302,2015-08-31,Senate,"Assembly 3rd Reading AB1211 Maienschein By Hancock",40,0,0,0,40
741133,475478,2015-09-01,Assembly,"AB 1211 MAIENSCHEIN  Concurrence- Urgency Added",80,0,0,0,80
741135,432897,2015-04-14,Senate,"Do pass, but re-refer to the Committee on Judiciary",7,3,1,0,11
741135,437229,2015-04-21,Senate,"Do pass, but re-refer to the Committee on Appropriations",5,1,1,0,7
741135,442926,2015-05-04,Senate,"Placed on Appropriations Suspense file",7,0,0,0,7
741135,453705,2015-05-28,Senate,"Do pass as amended",5,2,0,0,7
741135,456623,2015-06-03,Senate,"Senate 3rd Reading SB703 Leno",25,13,2,0,40
741135,468568,2015-07-01,Assembly,"Do pass and be re-referred to the Committee on Appropriations",6,3,0,0,9
741135,474269,2015-08-27,Assembly,"Do pass as amended",12,5,0,0,17
741135,475579,2015-09-02,Assembly,"SB 703 Leno  Senate Third Reading  By GORDON",53,24,0,3,80
741135,475859,2015-09-04,Senate,"Unfinished Business SB703 Leno Concurrence",26,12,2,0,40
741136,443913,2015-05-06,Assembly,"Do pass, to Consent Calendar",18,0,0,3,21
741136,446617,2015-05-14,Assembly,"AB 1278 GRAY  Consent Calendar Second Day  Regular Session",78,0,0,2,80
741136,458706,2015-06-10,Senate,"Do pass",8,0,0,1,9
741138,485053,2016-01-12,Senate,"Do pass, but re-refer to the Committee on Rules",5,1,1,0,7
741138,485575,2016-01-19,Senate,"Placed on Appropriations Suspense file",7,0,0,0,7
741139,440374,2015-04-27,Assembly,"Do pass and be re-referred to the Committee on Appropriations to 	Consent Calendar",12,0,0,0,12
741139,443570,2015-05-06,Assembly,"Do pass, to Consent Calendar",17,0,0,0,17
741139,446842,2015-05-14,Assembly,"AB 1446 DABABNEH  Consent Calendar Second Day  Regular Session",78,0,0,2,80
741139,460683,2015-06-17,Senate,"Do pass as amended, and re-refer to the Committee on Appropriations",7,0,0,0,7
741139,474058,2015-08-24,Senate,"Assembly 3rd Reading AB1446 Dababneh By Block",40,0,0,0,40
741139,474393,2015-08-27,Assembly,"AB 1446 DABABNEH  Concurrence in Senate Amendments",79,0,0,1,80
741140,484680,2016-01-11,Assembly,"Do pass and be re-referred to the Committee on Appropriations",16,0,0,0,16
741140,486414,2016-01-21,Assembly,"Do pass, to Consent Calendar",17,0,0,0,17
741140,488429,2016-01-27,Assembly,"AB 1364 LINDER  Consent Calendar Second Day  Regular Session",78,0,0,1,79
741143,484801,2016-01-12,Assembly,"Do pass and be re-referred to the Committee on Appropriations",13,0,0,0,13
741143,486342,2016-01-21,Assembly,"Do pass",17,0,0,0,17
741143,487051,2016-01-25,Assembly,"AB 1449 LOPEZ  Assembly Third Reading",74,1,0,4,79
741143,556465,2016-06-29,Senate,"Do pass, but re-refer to the Committee on Appropriations",9,0,0,0,9
741143,558912,2016-08-01,Senate,"Placed on Appropriations Suspense file",7,0,0,0,7
741143,559752,2016-08-11,Senate,"Do pass as amended",7,0,0,0,7
741143,561094,2016-08-24,Senate,"Assembly 3rd Reading AB1449 Lopez By Block",39,0,0,0,39
741143,561571,2016-08-30,Assembly,"AB 1449 LOPEZ  Concurrence in Senate Amendments",75,1,0,4,80
741145,437419,2015-04-21,Assembly,"Do pass and be re-referred to the Committee on Appropriations",12,1,0,0,13
741145,444234,2015-05-06,Assembly,"Do pass",16,1,0,0,17
741145,446745,2015-05-14,Assembly,"AB 1228 GIPSON  Assembly Third Reading",76,2,0,2,80
741145,462635,2015-06-24,Senate,"Do pass, but re-refer to the Committee on Appropriations",9,0,0,0,9
741145,475945,2015-09-08,Senate,"Assembly 3rd Reading AB1228 Gipson By Leyva",40,0,0,0,40
741145,476125,2015-09-09,Assembly,"AB 1228 GIPSON  Concurrence in Senate Amendments",75,2,0,3,80
741147,441561,2015-04-29,Assembly,"Do pass and be re-referred to the Committee on Appropriations",9,0,0,0,9
741147,446146,2015-05-13,Assembly,"Do pass",17,0,0,0,17
741147,447679,2015-05-18,Assembly,"AB 1083 EGGMAN  Assembly Third Reading",74,1,0,5,80
741147,460537,2015-06-16,Senate,"Do pass, but re-refer to the Committee on Appropriations",5,0,0,0,5
741147,464043,2015-06-29,Senate,"Do pass",6,0,1,0,7
741147,465133,2015-07-06,Senate,"Special Consent #4 AB1083 Eggman",39,0,1,0,40
741148,441533,2015-04-28,Assembly,"Do pass and be re-referred to the Committee on Appropriations to 	Consent Calendar",7,0,0,0,7
741149,427784,2015-04-07,Senate,"Do pass",9,0,2,0,11
741149,430662,2015-04-13,Senate,"Senate 3rd Reading SB693 Hueso",31,1,7,0,39
741149,543802,2016-05-09,Assembly,"Be referred to Committee on Labor and Employment",10,0,0,1,11
741149,555272,2016-06-22,Assembly,"Do pass as amended and be re-referred to the Committee on 	Appropriations",6,1,0,0,7
741149,559008,2016-08-03,Assembly,"Do pass",16,4,0,0,20
741149,560220,2016-08-18,Assembly,"SB 693 Hueso  Senate Third Reading  By RIDLEY-THOMAS",64,14,0,2,80
741149,560737,2016-08-23,Senate,"From committee:  That the Assembly Amendments be concurred in",4,1,0,0,5
741149,560925,2016-08-24,Senate,"Unfinished Business SB693 Hueso Concurrence",27,12,0,0,39
741150,431821,2015-04-13,Assembly,"Do pass",14,0,0,1,15
741150,443975,2015-05-06,Assembly,"Do pass as amended",9,0,0,0,9
741150,447636,2015-05-18,Assembly,"AB 1119 RENDON  Assembly Third Reading",77,0,0,3,80
741150,460236,2015-06-16,Senate,"Do pass, but re-refer to the Committee on Governance and Finance",10,0,1,0,11
741150,465730,2015-07-08,Senate,"Do pass",7,0,0,0,7
741150,474439,2015-08-27,Senate,"Assembly 3rd Reading AB1119 Rendon By Hertzberg",34,1,5,0,40
741151,431518,2015-04-13,Senate,"Do pass as amended, and re-refer to the Committee on Appropriations",9,0,0,0,9
741151,447614,2015-05-18,Senate,"Senate 3rd Reading SB620 Block",36,0,3,0,39
741151,462186,2015-06-23,Assembly,"Do pass and be re-referred to the Committee on Appropriations to 	Consent Calendar",14,0,0,0,14
741151,465654,2015-07-08,Assembly,"Do pass, to Consent Calendar",14,0,0,3,17
741151,466496,2015-07-16,Assembly,"SB 620 Block  Consent Calendar Second Day  Regular Session",79,0,0,1,80
741151,473981,2015-08-20,Senate,"Special Consent #6 SB620 Block",38,0,2,0,40
741152,448550,2015-05-18,Assembly,"Do pass as amended and be re-referred to the Committee on 	Appropriations",9,0,0,0,9
741154,440391,2015-04-28,Assembly,"Amend, and do pass as amended and be re-referred to the Committee 	on Appropriations with the recommendation:  To Consent Calendar",7,0,0,0,7
741154,443771,2015-05-06,Assembly,"Do pass as amended, to Consent Calendar",17,0,0,0,17
741154,446721,2015-05-14,Assembly,"AB 1234 MCCARTY  Consent Calendar Second Day  Regular Session",78,0,0,2,80
741154,458359,2015-06-09,Senate,"Do pass, but re-refer to the Committee on Appropriations Recommend 	Consent",13,0,0,0,13
741154,461323,2015-06-18,Senate,"Consent Calendar 2nd AB1234 McCarty Urgency Clause",37,0,3,0,40
741156,440187,2015-04-28,Senate,"Do pass as amended, and re-refer to the Committee on Appropriations",8,0,1,0,9
741156,445103,2015-05-11,Senate,"Placed on Appropriations Suspense file",7,0,0,0,7
741156,453817,2015-05-28,Senate,"Do pass as amended",7,0,0,0,7
741156,456707,2015-06-03,Senate,"Senate 3rd Reading SB758 Block",38,0,2,0,40
741156,466309,2015-07-14,Assembly,"Do pass and be re-referred to the Committee on Appropriations to 	Consent Calendar",12,0,0,3,15
741156,474419,2015-08-27,Assembly,"Do pass",17,0,0,0,17
741156,475852,2015-09-04,Assembly,"SB 758 Block  Senate Third Reading  By WILLIAMS",73,0,0,7,80
741156,475953,2015-09-08,Senate,"Unfinished Business SB758 Block Concurrence",35,5,0,0,40
741158,427877,2015-04-07,Senate,"Do pass as amended, and re-refer to the Committee on Appropriations",6,0,1,0,7
741158,463604,2015-04-27,Senate,"Placed on Appropriations Suspense file",7,0,0,0,7
741159,437355,2015-04-21,Assembly,"Do pass and be re-referred to the Committee on Appropriations",11,2,0,0,13
741160,441731,2015-04-29,Assembly,"Do pass as amended and be re-referred to the Committee on 	Appropriations",7,0,0,0,7
741161,432764,2015-04-13,Assembly,"Do pass as amended and be re-referred to the Committee on 	Appropriations",9,0,0,0,9
741161,454454,2015-05-28,Assembly,"Do pass",17,0,0,0,17
741161,455537,2015-06-01,Assembly,"AB 1274 STONE  Assembly Third Reading",74,2,0,4,80
741161,462194,2015-06-23,Senate,"Do pass, but re-refer to the Committee on Appropriations",8,1,0,0,9
741161,474063,2015-08-24,Senate,"Assembly 3rd Reading AB1274 Mark Stone By Allen",29,8,3,0,40
741161,474300,2015-08-27,Assembly,"AB 1274 STONE  Concurrence in Senate Amendments",74,1,0,5,80
741163,440693,2015-04-27,Assembly,"Do pass and be re-referred to the Committee on Appropriations",5,9,0,1,15
741163,463766,2015-04-27,Assembly,"Reconsideration granted",15,0,0,0,15
741166,432618,2015-04-14,Assembly,"Do pass and be re-referred to the Committee on Appropriations",14,0,0,0,14
741166,437311,2015-04-22,Assembly,"Do pass, to Consent Calendar",17,0,0,0,17
741166,442336,2015-04-30,Assembly,"AB 1374 LEVINE  Consent Calendar Second Day  Regular Session",77,0,0,3,80
741166,457925,2015-06-08,Senate,"Do pass as amended, but re-refer to the Committee on Appropriations 	Recommend Consent",9,0,0,0,9
741166,474115,2015-08-24,Senate,"Assembly 3rd Reading AB1374 Levine By Bates",40,0,0,0,40
741166,474416,2015-08-27,Assembly,"AB 1374 LEVINE  Concurrence in Senate Amendments",78,0,0,2,80
741167,439939,2015-04-27,Assembly,"Do pass as amended and be re-referred to the Committee on 	Appropriations",6,3,0,0,9
741168,439966,2015-04-28,Senate,"Do pass as amended, and re-refer to the Committee on Appropriations",5,2,0,0,7
741168,450067,2015-05-22,Senate,"Senate 3rd Reading SB716 Lara",29,7,3,0,39
741168,464311,2015-06-30,Assembly,"Do pass and be re-referred to the Committee on Arts, Entertain, 	Sports, Tourism, & Internet Media",4,2,0,1,7
741168,465975,2015-07-14,Assembly,"Do pass as amended and be re-referred to the Committee on 	Appropriations",4,2,0,1,7
741168,473886,2015-08-19,Assembly,"Do pass",17,0,0,0,17
741168,474287,2015-08-27,Assembly,"SB 716 Lara  Senate Third Reading  By BONTA",69,8,0,3,80
741168,475310,2015-08-31,Senate,"Unfinished Business SB716 Lara Concurrence",28,8,4,0,40
741169,435983,2015-04-21,Assembly,"Do pass, to Consent Calendar",7,0,0,0,7
741169,442206,2015-04-30,Assembly,"AB 1475 COOPER  Consent Calendar Second Day  Regular Session",77,0,0,3,80
741169,460294,2015-06-16,Senate,"Do pass",7,0,0,0,7
741169,465843,2015-07-13,Senate,"Assembly 3rd Reading AB1475 Cooper By Mitchell",40,0,0,0,40
741169,466490,2015-07-16,Assembly,"AB 1475 COOPER  Concurrence in Senate Amendments",79,0,0,1,80
741170,435359,2015-04-20,Senate,"Do pass, but re-refer to the Committee on Rules",7,0,2,0,9
741170,440869,2015-04-29,Senate,"Do pass as amended, and re-refer to the Committee on Appropriations",5,1,1,0,7
741170,454026,2015-05-28,Senate,"Do pass as amended",5,1,1,0,7
741170,457263,2015-06-04,Senate,"Senate 3rd Reading SB643 McGuire",26,13,1,0,40
741170,463592,2015-05-18,Senate,"Placed on Appropriations Suspense file",7,0,0,0,7
741170,465473,2015-07-07,Assembly,"Do pass and be re-referred to the Committee on Health",8,2,0,4,14
741170,466046,2015-07-14,Assembly,"Do pass as amended and be re-referred to the Committee on 	Appropriations",11,2,0,6,19
741170,474292,2015-08-27,Assembly,"Do pass as amended",11,0,0,6,17
741170,476535,2015-09-11,Assembly,"Do pass as amended",8,1,0,5,14
741170,476536,2015-09-11,Assembly,"SB 643 McGuire  Senate Third Reading  By BONTA",58,13,0,9,80
741170,476537,2015-09-11,Senate,"Unfinished Business (S upplemental File 6)SB6 43 McG uire Con",30,9,1,0,40
741174,440173,2015-04-27,Assembly,"Do pass and be re-referred to the Committee on Appropriations",8,2,0,2,12
741174,453781,2015-05-28,Assembly,"Do pass as amended",12,5,0,0,17
741174,456624,2015-06-03,Assembly,"AB 1326 DABABNEH  Assembly Third Reading",55,22,0,3,80
741174,474091,2015-08-24,Senate,"Placed on Appropriations Suspense file",7,0,0,0,7
741174,474625,2015-08-27,Senate,"Do pass",6,1,0,0,7
741175,440269,2015-04-27,Assembly,"Do pass as amended and be re-referred to the Committee on 	Appropriations",9,0,0,0,9
741175,446121,2015-05-13,Assembly,"Do pass, to Consent Calendar",17,0,0,0,17
741175,450178,2015-05-22,Assembly,"AB 1419 EGGMAN  Consent Calendar Second Day  Regular Session",74,0,0,6,80
741175,556469,2016-06-29,Senate,"Do pass, but re-refer to the Committee on Appropriations",7,0,0,0,7
741175,558981,2016-08-01,Senate,"Do pass",7,0,0,0,7
741175,560837,2016-08-23,Senate,"Assembly 3rd Reading AB1419 Eggman By Leyva",39,0,0,0,39
741175,561242,2016-08-25,Assembly,"Senate amendments be concurred in",5,0,0,2,7
741175,561524,2016-08-30,Assembly,"AB 1419 EGGMAN  Concurrence in Senate Amendments",80,0,0,0,80
741177,430576,2015-04-09,Assembly,"Be referred to Committee on Elections and Redistricting",11,0,0,0,11
741177,441112,2015-04-29,Assembly,"Do pass and be re-referred to the Committee on Appropriations to 	Consent Calendar",7,0,0,0,7
741177,446473,2015-05-13,Assembly,"Do pass, to Consent Calendar",17,0,0,0,17
741177,450175,2015-05-22,Assembly,"AB 1443 CHAU  Consent Calendar Second Day  Regular Session",74,0,0,6,80
741177,464299,2015-06-30,Senate,"Do pass, but re-refer to the Committee on Appropriations",4,0,1,0,5
741177,474273,2015-08-27,Senate,"Assembly 3rd Reading AB1443 Chau By Mendoza",40,0,0,0,40
741177,475275,2015-08-31,Assembly,"AB 1443 CHAU  Concurrence in Senate Amendments",80,0,0,0,80
741178,437096,2015-04-21,Senate,"Do pass, but re-refer to the Committee on Appropriations",7,0,0,0,7
741178,442825,2015-05-04,Senate,"Placed on Appropriations Suspense file",7,0,0,0,7
741179,446206,2015-05-13,Assembly,"Do pass as amended",9,0,0,0,9
741179,450158,2015-05-22,Assembly,"AB 1290 DAHLE  Third Reading Urgency",75,0,0,5,80
741179,458723,2015-06-10,Senate,"Do pass as amended",7,0,0,0,7
741179,461884,2015-06-22,Senate,"Assembly 3rd Reading AB1290 Dahle By Gaines",37,0,3,0,40
741180,432502,2015-04-14,Senate,"Do pass as amended, and re-refer to the Committee on Transportation 	and Housing",5,0,0,0,5
741181,484855,2016-01-12,Assembly,"Do pass and be re-referred to the Committee on Appropriations",8,3,0,3,14
741181,486486,2016-01-21,Assembly,"Do pass",12,3,0,2,17
741181,488366,2016-01-27,Assembly,"AB 1381 WEBER  Assembly Third Reading",65,10,0,4,79
741181,552616,2016-06-13,Senate,"Do pass, but re-refer to the Committee on Appropriations",7,1,1,0,9
741181,561286,2016-08-25,Senate,"From Committee:  That the measure be returned to the Senate floor 	for consideration",9,0,0,0,9
741181,561649,2016-08-30,Senate,"Assembly 3rd Reading AB1381 Weber By Hill",36,0,3,0,39
741181,561780,2016-08-31,Assembly,"AB 1381 WEBER  Concurrence in Senate Amendments",79,0,0,1,80
741182,442194,2015-04-29,Assembly,"Do pass as amended and be re-referred to the Committee on 	Appropriations",6,0,0,1,7
741182,453679,2015-05-28,Assembly,"Do pass",13,1,0,3,17
741182,456741,2015-06-03,Assembly,"AB 1258 CHAU  Assembly Third Reading",65,13,0,2,80
741182,466222,2015-07-15,Senate,"Do pass, but re-refer to the Committee on Appropriations",9,0,0,0,9
741182,473768,2015-08-17,Senate,"Placed on Appropriations Suspense file",7,0,0,0,7
741183,440317,2015-04-28,Assembly,"Do pass as amended and be re-referred to the Committee on 	Appropriations",13,0,0,1,14
741184,428702,2015-04-08,Senate,"Do pass as amended, and re-refer to the Committee on Appropriations",8,0,0,0,8
741184,445327,2015-05-11,Senate,"Placed on Appropriations Suspense file",7,0,0,0,7
741185,440478,2015-04-28,Assembly,"Do pass and be re-referred to the Committee on Appropriations",5,0,0,2,7
741185,446223,2015-05-13,Assembly,"Do pass",13,3,0,1,17
741185,454025,2015-05-28,Assembly,"AB 1173 WILLIAMS  Assembly Third Reading",55,22,0,3,80
741186,440184,2015-04-28,Assembly,"Do pass as amended and be re-referred to the Committee on 	Appropriations",11,2,0,2,15
741186,454147,2015-05-28,Assembly,"Do pass as amended",12,0,0,5,17
741186,456745,2015-06-03,Assembly,"AB 1095 GARCIA, E.  Assembly Third Reading",78,0,0,2,80
741186,466117,2015-07-14,Senate,"Do pass, but re-refer to the Committee on Appropriations",9,0,0,0,9
741186,475350,2015-08-31,Senate,"Assembly 3rd Reading AB1095 Eduardo Garcia By Hueso",39,0,1,0,40
741186,475389,2015-09-01,Assembly,"AB 1095 GARCIA, E.  Concurrence in Senate Amendments",80,0,0,0,80
741190,432572,2015-04-15,Senate,"Do pass, but re-refer to the Committee on Judiciary",7,0,0,0,7
741190,440028,2015-04-28,Senate,"Do pass, but re-refer to the Committee on Appropriations",6,0,1,0,7
741190,447756,2015-05-18,Senate,"Senate 3rd Reading SB647 Morrell",36,0,3,0,39
741190,462220,2015-06-22,Assembly,"Do pass as amended and be re-referred to the Committee on 	Appropriations",12,0,0,0,12
741190,466435,2015-07-15,Assembly,"Do pass, to Consent Calendar",16,0,0,1,17
741190,474028,2015-08-20,Assembly,"SB 647 Morrell  Consent Calendar Second Day  Regular Session",79,0,0,1,80
741190,474244,2015-08-27,Senate,"Special Consent #7 SB647 Morrell",40,0,0,0,40
741191,437523,2015-04-21,Senate,"Do pass, but re-refer to the Committee on Appropriations",5,2,0,0,7
741191,442877,2015-05-04,Senate,"Placed on Appropriations Suspense file",7,0,0,0,7
741191,454080,2015-05-28,Senate,"Do pass",5,2,0,0,7
741191,455321,2015-06-01,Senate,"Senate 3rd Reading SB694 Leno",23,16,1,0,40
741191,465989,2015-07-14,Assembly,"Do pass and be re-referred to the Committee on Appropriations",5,2,0,0,7
741192,440332,2015-04-28,Assembly,"Do pass and be re-referred to the Committee on Revenue and Taxation",7,0,0,0,7
741192,448444,2015-05-18,Assembly,"Do pass and be re-referred to the Committee on Appropriations",9,0,0,0,9
741192,452920,2015-05-27,Assembly,"Do pass, to Consent Calendar",17,0,0,0,17
741192,456058,2015-06-02,Assembly,"AB 1199 NAZARIAN  Consent Calendar Second Day  Regular Session",78,0,0,2,80
741194,437080,2015-04-22,Assembly,"Do pass as amended and be re-referred to the Committee on 	Appropriations",8,2,0,3,13
741195,433180,2015-04-15,Senate,"Do pass as amended, and re-refer to the Committee on Appropriations",7,0,0,0,7
741195,443168,2015-05-04,Senate,"Placed on Appropriations Suspense file",7,0,0,0,7
741195,454010,2015-05-28,Senate,"Do pass as amended",7,0,0,0,7
741195,456708,2015-06-03,Senate,"Senate 3rd Reading SB640 Beall",40,0,0,0,40
741195,466035,2015-07-13,Assembly,"Do pass as amended and be re-referred to the Committee on 	Appropriations",9,0,0,0,9
741196,445903,2015-05-12,Assembly,"Do pass",3,7,0,0,10
741196,463641,2015-05-12,Assembly,"Reconsideration granted",10,0,0,0,10
741197,485356,2016-01-05,Assembly,"Be referred to Committee on Water, Parks and Wildlife",11,0,0,0,11
741201,437299,2015-04-21,Assembly,"Do pass as amended and be re-referred to the Committee on 	Appropriations",13,0,0,0,13
741201,453633,2015-05-28,Assembly,"Do pass as amended",14,1,0,2,17
741201,457294,2015-06-04,Assembly,"AB 1317 SALAS  Assembly Third Reading",77,0,0,3,80
741202,437483,2015-04-22,Assembly,"Do pass and be re-referred to the Committee on Appropriations",6,0,0,1,7
741203,432716,2015-04-13,Assembly,"Do pass and be re-referred to the Committee on Appropriations to 	Consent Calendar",9,0,0,0,9
741204,437049,2015-04-21,Assembly,"Do pass and be re-referred to the Committee on Appropriations to 	Consent Calendar",18,0,0,1,19
741204,448973,2015-05-20,Assembly,"Do pass, to Consent Calendar",15,0,0,2,17
741204,451568,2015-05-26,Assembly,"AB 1216 BONTA  Consent Calendar Second Day  Regular Session",76,0,0,4,80
741204,553091,2016-06-15,Senate,"Do pass, but re-refer to the Committee on Appropriations",9,0,0,0,9
741205,432769,2015-04-13,Assembly,"Do pass and be re-referred to the Committee on Appropriations",9,0,0,0,9
741205,441468,2015-04-29,Assembly,"Do pass",17,0,0,0,17
741205,442812,2015-05-04,Assembly,"AB 1089 GARCIA, E.  Assembly Third Reading",78,0,0,2,80
741205,458390,2015-06-09,Senate,"Do pass, but re-refer to the Committee on Appropriations",9,0,0,0,9
741205,474018,2015-08-20,Senate,"Assembly 3rd Reading AB1089 Eduardo Garcia By Stone",38,0,2,0,40
741207,436039,2015-04-21,Assembly,"Do pass as amended and be re-referred to the Committee on 	Appropriations",14,0,0,0,14
741207,443857,2015-05-06,Assembly,"Do pass",16,0,0,1,17
741207,446681,2015-05-14,Assembly,"AB 1073 TING  Assembly Third Reading",76,0,0,4,80
741207,465431,2015-07-06,Senate,"Do pass as amended, and re-refer to the Committee on Judiciary",7,0,2,0,9
741207,476160,2015-09-09,Senate,"Assembly 3rd Reading AB1073 Ting By Hernandez",40,0,0,0,40
741207,476339,2015-09-10,Assembly,"AB 1073 TING  Concurrence in Senate Amendments",80,0,0,0,80
741212,443388,2015-05-05,Senate,"Be adopted, but re-refer to the Committee on Appropriations 	Recommend Consent",9,0,2,0,11
741212,450224,2015-05-22,Senate,"Consent Calendar 2nd SCR24 Wolk",38,0,1,0,39
741212,461998,2015-06-22,Assembly,"Be adopted and re-referred to the Committee on Appropriations with 	recommendation:  To Consent Calendar",16,0,0,0,16
741212,465642,2015-07-08,Assembly,"Be adopted, to Consent Calendar",14,0,0,3,17
741212,465912,2015-07-13,Assembly,"SCR 24 Wolk  Consent Calendar Second Day  Regular Session",79,0,0,1,80
741213,436077,2015-04-20,Assembly,"Do pass and be re-referred to the Committee on Appropriations",5,10,0,1,16
741213,463568,2015-04-20,Assembly,"Reconsideration granted",15,0,0,1,16
741214,440006,2015-04-28,Senate,"Do pass, but re-refer to the Committee on Appropriations",5,2,0,0,7
741214,445204,2015-05-11,Senate,"Placed on Appropriations Suspense file",7,0,0,0,7
741214,485049,2016-01-13,Senate,"Do pass, but re-refer to the Committee on Appropriations",7,0,0,0,7
741214,485568,2016-01-19,Senate,"Placed on Appropriations Suspense file",7,0,0,0,7
741216,437380,2015-04-21,Assembly,"Do pass and be re-referred to the Committee on Appropriations to 	Consent Calendar",18,0,0,1,19
741216,454083,2015-05-28,Assembly,"Do pass",17,0,0,0,17
741216,455508,2015-06-01,Assembly,"AB 1114 BONILLA  Assembly Third Reading",79,0,0,1,80
741216,463014,2015-06-24,Senate,"Do pass and be placed on the Consent Calendar",8,0,1,0,9
741216,465941,2015-07-13,Senate,"Placed on Appropriations Suspense file",7,0,0,0,7
741216,474529,2015-08-27,Senate,"Do pass as amended",7,0,0,0,7
741216,560550,2016-08-22,Senate,"Do pass, but re-refer to the Committee on Appropriations",5,0,4,0,9
741216,560551,2016-08-22,Senate,"Set, first hearing.  Held in Committee.  Reconsideration of 	favorable vote granted",6,0,3,0,9
741216,560552,2016-08-22,Senate,"Do pass, but re-refer to the Committee on Appropriations",7,0,2,0,9
741216,560815,2016-08-23,Senate,"Do pass as amended",6,0,1,0,7
741216,561304,2016-08-25,Senate,"Assembly 3rd Reading AB1114 Eggman By Hernandez Urgency C",38,1,0,0,39
741216,561639,2016-08-30,Assembly,"Senate amendments be concurred in",16,0,0,2,18
741216,561809,2016-08-31,Assembly,"AB 1114 EGGMAN  Concurrence- Urgency Added",79,0,0,1,80
741217,441068,2015-04-28,Assembly,"Do pass and be re-referred to the Committee on Appropriations",8,3,0,2,13
741218,484681,2016-01-11,Assembly,"Do pass as amended and be re-referred to the Committee on 	Appropriations",8,0,0,1,9
741218,486294,2016-01-21,Assembly,"Do pass, to Consent Calendar",17,0,0,0,17
741218,488463,2016-01-27,Assembly,"AB 1399 BAKER  Consent Calendar Second Day  Regular Session",78,0,0,1,79
741218,552127,2016-06-08,Senate,"Do pass, but re-refer to the Committee on Appropriations",7,0,0,0,7
741218,555696,2016-06-27,Senate,"Do pass",6,0,1,0,7
741218,559911,2016-08-15,Senate,"Assembly 3rd Reading AB1399 Baker By Bates",37,0,2,0,39
741218,560594,2016-08-22,Assembly,"AB 1399 BAKER  Concurrence in Senate Amendments",79,0,0,1,80
741219,443687,2015-05-05,Assembly,"Do pass as amended, to Consent Calendar",10,0,0,0,10
741219,446905,2015-05-14,Assembly,"AB 1081 QUIRK  Consent Calendar Second Day  Regular Session",78,0,0,2,80
741219,462804,2015-06-23,Senate,"Do pass as amended. To Consent Calendar",7,0,0,0,7
741219,475432,2015-09-01,Senate,"Assembly 3rd Reading AB1081 Quirk By Hancock",40,0,0,0,40
741219,475598,2015-09-02,Assembly,"AB 1081 QUIRK  Concurrence in Senate Amendments",79,0,0,1,80
741220,436192,2015-04-20,Assembly,"Do pass as amended and be re-referred to the Committee on Privacy 	and Consumer Protection",14,0,0,1,15
741220,443437,2015-05-05,Assembly,"Do pass as amended",11,0,0,0,11
741220,450124,2015-05-22,Assembly,"AB 1360 TING  Assembly Third Reading",73,0,0,7,80
741220,464544,2015-06-30,Senate,"Do pass as amended, and re-refer to the Committee on Energy, 	Utilities and Communications",11,0,0,0,11
741222,437180,2015-04-21,Assembly,"Do pass and be re-referred to the Committee on Appropriations",13,5,0,1,19
741222,454038,2015-05-28,Assembly,"Do pass as amended",12,5,0,0,17
741222,456650,2015-06-03,Assembly,"AB 1396 BONTA  Assembly Third Reading  Amend By BONTA  Set #1",48,28,0,4,80
741223,440339,2015-04-27,Senate,"Do pass as amended, and re-refer to the Committee on Appropriations",9,0,0,0,9
741223,450268,2015-05-22,Senate,"Senate 3rd Reading SB622 Hernandez",33,4,2,0,39
741223,463646,2015-05-18,Senate,"Do pass",7,0,0,0,7
741224,466153,2015-04-14,Assembly,"Amend, and do pass as amended and be re-referred to the Committee 	on Judiciary with the recommendation:  To Consent Calendar",7,0,0,0,7
741224,484759,2016-01-12,Assembly,"Amend, and do pass as amended and be re-referred to the Committee 	on Appropriations with the recommendation:  To Consent Calendar",6,0,0,1,7
741224,485067,2016-01-05,Assembly,"Be referred to Committee on Public Safety",11,0,0,0,11
741224,488937,2016-01-28,Assembly,"AB 1272 GROVE  Assembly Third Reading",78,0,0,1,79
741224,552713,2016-06-14,Senate,"Do pass and be placed on the Consent Calendar",7,0,0,0,7
741224,556817,2016-06-30,Senate,"Consent Calendar 2nd AB1272 Grove",37,0,3,0,40
741225,436178,2015-04-21,Assembly,"Do pass as amended",5,2,0,0,7
741225,442890,2015-05-04,Assembly,"AB 1352 EGGMAN  Assembly Third Reading",42,33,0,5,80
741225,466232,2015-07-14,Senate,"Do pass, but re-refer to the Committee on Appropriations",5,2,0,0,7
741225,473587,2015-08-17,Senate,"Placed on Appropriations Suspense file",7,0,0,0,7
741225,474648,2015-08-27,Senate,"Do pass",5,2,0,0,7
741225,476496,2015-09-11,Senate,"Assembly 3rd Reading AB1352 Eggman By Lara",22,15,3,0,40
741225,476497,2015-09-11,Assembly,"AB 1352 EGGMAN  Concurrence in Senate Amendments",43,32,0,5,80
741226,441023,2015-04-29,Senate,"Do pass, but re-refer to the Committee on Appropriations",5,2,0,0,7
741226,445142,2015-05-11,Senate,"Placed on Appropriations Suspense file",7,0,0,0,7
741226,454036,2015-05-28,Senate,"Do pass as amended",5,2,0,0,7
741226,457344,2015-06-04,Senate,"Senate 3rd Reading SB654 De Le",21,16,3,0,40
741226,466114,2015-07-14,Assembly,"Do pass and be re-referred to the Committee on Appropriations",5,2,0,0,7
741226,474323,2015-08-27,Assembly,"Do pass as amended",12,5,0,0,17
741226,559435,2016-08-11,Assembly,"SB 654 De Leon  Senate Third Reading  By GARCIA, C.  Amendment  Set 	#1",49,26,0,5,80
741226,560761,2016-08-22,Assembly,"Do pass and be re-referred to the Committee on Appropriations",4,2,0,1,7
741226,561467,2016-08-29,Assembly,"Do pass",12,5,0,3,20
741226,561532,2016-08-30,Assembly,"SB 654 Jackson  Senate Third Reading  By GARCIA, C",54,17,0,9,80
741226,561787,2016-08-31,Senate,"Unfinished Business SB654 Jackson Concurrence",24,12,3,0,39
741227,440435,2015-04-27,Assembly,"Do pass and be re-referred to the Committee on Appropriations",16,0,0,0,16
741227,443964,2015-05-06,Assembly,"Do pass, to Consent Calendar",17,0,0,0,17
741227,457323,2015-06-04,Assembly,"AB 1178 ACHADJIAN  Assembly Third Reading",80,0,0,0,80
741227,466384,2015-07-14,Senate,"Do pass as amended, and re-refer to the Committee on Appropriations",7,0,0,0,7
741227,476131,2015-09-09,Senate,"Assembly 3rd Reading AB1178 Achadjian By Wieckowski",40,0,0,0,40
741227,476338,2015-09-10,Assembly,"AB 1178 ACHADJIAN  Concurrence in Senate Amendments",80,0,0,0,80
741228,440148,2015-04-27,Assembly,"Do pass as amended and be re-referred to the Committee on 	Appropriations",6,3,0,0,9
741229,484695,2016-01-11,Assembly,"Do pass as amended and be re-referred to the Committee on 	Appropriations",8,1,0,0,9
741230,443872,2015-05-06,Senate,"Do pass as amended, and re-refer to the Committee on Appropriations",6,0,1,0,7
741230,451922,2015-05-26,Senate,"Placed on Appropriations Suspense file",7,0,0,0,7
741230,454145,2015-05-28,Senate,"Do pass as amended",7,0,0,0,7
741230,455937,2015-06-02,Senate,"Senate 3rd Reading SB670 Jackson",40,0,0,0,40
741230,465980,2015-07-13,Assembly,"Do pass as amended and be re-referred to the Committee on 	Appropriations",9,0,0,0,9
741231,437347,2015-04-22,Senate,"Do pass as amended, and re-refer to the Committee on Appropriations",9,0,0,0,9
741231,454129,2015-05-28,Senate,"Do pass as amended",7,0,0,0,7
741231,457364,2015-06-04,Senate,"Senate 3rd Reading SB605 Gaines",39,0,1,0,40
741231,463683,2015-05-18,Senate,"Placed on Appropriations Suspense file",7,0,0,0,7
741231,465499,2015-07-07,Assembly,"Do pass and be re-referred to the Committee on Appropriations",12,0,0,1,13
741231,466277,2015-07-15,Assembly,"Do pass as amended",15,1,0,1,17
741231,476143,2015-09-09,Assembly,"SB 605 Gaines  Senate Third Reading  By BONILLA",76,4,0,0,80
741231,476300,2015-09-10,Senate,"Unfinished Business SB605 Gaines Concurrence",40,0,0,0,40
741234,442212,2015-04-29,Assembly,"Do pass as amended and be re-referred to the Committee on 	Appropriations",7,0,0,0,7
741234,448945,2015-05-20,Assembly,"Do pass, to Consent Calendar",15,0,0,2,17
741234,451848,2015-05-26,Assembly,"AB 1198 DABABNEH  Consent Calendar Second Day  Regular Session",76,0,0,4,80
741234,466336,2015-07-15,Senate,"Do pass as amended, but re-refer to the Committee on Appropriations 	Recommend Consent",9,0,0,0,9
741234,474113,2015-08-24,Senate,"Placed on Appropriations Suspense file",7,0,0,0,7
741234,560695,2016-08-23,Senate,"Assembly 3rd Reading AB1198 Dababneh By Pan",39,0,0,0,39
741234,561469,2016-08-29,Assembly,"AB 1198 DABABNEH  Concurrence in Senate Amendments",80,0,0,0,80
741235,436224,2015-04-21,Assembly,"Do pass and be re-referred to the Committee on Appropriations",5,2,0,0,7
741235,453833,2015-05-28,Assembly,"Do pass as amended",12,5,0,0,17
741235,456549,2015-06-03,Assembly,"AB 1351 EGGMAN  Assembly Third Reading",47,30,0,3,80
741235,466341,2015-07-14,Senate,"Do pass, but re-refer to the Committee on Appropriations",4,2,1,0,7
741235,473696,2015-08-17,Senate,"Placed on Appropriations Suspense file",7,0,0,0,7
741235,474530,2015-08-27,Senate,"Do pass",5,2,0,0,7
741235,476115,2015-09-09,Senate,"Assembly 3rd Reading AB1351 Eggman By Lara",22,15,3,0,40
741235,476271,2015-09-10,Assembly,"AB 1351 EGGMAN  Concurrence in Senate Amendments",48,30,0,2,80
741238,484831,2016-01-12,Assembly,"Do pass and be re-referred to the Committee on Appropriations to 	Consent Calendar",14,0,0,0,14
741238,485126,2016-01-05,Assembly,"Be referred to Committee on Business and Professions",11,0,0,0,11
741238,486351,2016-01-21,Assembly,"Do pass, to Consent Calendar",17,0,0,0,17
741238,488418,2016-01-27,Assembly,"AB 1084 BONILLA  Consent Calendar Second Day  Regular Session",78,0,0,1,79
741238,556656,2016-06-29,Senate,"Do pass",6,2,1,0,9
741239,437361,2015-04-22,Assembly,"Do pass and be re-referred to the Committee on Appropriations to 	Consent Calendar",12,0,0,1,13
741239,441033,2015-04-29,Assembly,"Do pass as amended, to Consent Calendar",17,0,0,0,17
741239,444452,2015-05-07,Assembly,"AB 1232 GARCIA, C.  Consent Calendar Second Day  Regular Session",77,0,0,3,80
741239,465566,2015-07-08,Senate,"Do pass, but re-refer to the Committee on Appropriations",8,0,1,0,9
741239,475386,2015-08-31,Senate,"Assembly 3rd Reading AB1232 Cristina Garcia By Hill",40,0,0,0,40
741239,475479,2015-09-01,Assembly,"AB 1232 GARCIA, C.  Concurrence in Senate Amendments",80,0,0,0,80
741240,440432,2015-04-28,Senate,"Do pass, but re-refer to the Committee on Appropriations",7,0,4,0,11
741240,447719,2015-05-18,Senate,"Senate 3rd Reading SB786 Allen",24,11,4,0,39
741240,463911,2015-06-29,Assembly,"Be referred to Committee on Education",10,0,0,1,11
741240,466372,2015-07-15,Assembly,"Amend, and do pass as amended and be re-referred to the Committee 	on Appropriations with the recommendation:  To Consent Calendar",7,0,0,0,7
741242,447641,2015-05-13,Assembly,"Do pass as amended",5,2,0,0,7
741242,450122,2015-05-22,Assembly,"AB 1185 RIDLEY-THOMAS  Assembly Third Reading",48,23,0,9,80
741242,460627,2015-06-17,Senate,"Do pass, but re-refer to the Committee on Appropriations",6,2,1,0,9
741242,465159,2015-07-06,Senate,"Placed on Appropriations Suspense file",7,0,0,0,7
741242,474519,2015-08-27,Senate,"Do pass as amended",5,2,0,0,7
741242,475472,2015-09-01,Senate,"Assembly 3rd Reading AB1185 Ridley-Thomas By Mendoza",26,14,0,0,40
741242,475747,2015-09-03,Assembly,"AB 1185 RIDLEY-THOMAS  Concurrence in Senate Amendments",53,25,0,2,80
741243,432643,2015-04-14,Senate,"Do pass, but re-refer to the Committee on Health Recommend Consent",7,0,2,0,9
741243,437256,2015-04-22,Senate,"Do pass and be placed on the Consent Calendar",8,0,1,0,9
741243,442252,2015-04-30,Senate,"Consent Calendar 2nd SB746 Wolk",34,0,5,0,39
741243,541009,2016-05-02,Assembly,"Be referred to Committee on Agriculture",11,0,0,0,11
741243,556519,2016-06-29,Assembly,"Do pass and be re-referred to the Committee on Appropriations to 	Consent Calendar",9,0,0,1,10
741243,559047,2016-08-03,Assembly,"Do pass, to Consent Calendar",20,0,0,0,20
741243,559370,2016-08-11,Assembly,"SB 746 Wolk  Consent Calendar Second Day  Regular Session",78,0,0,2,80
741243,560076,2016-08-17,Senate,"From committee:  That the Assembly Amendments be concurred in",5,0,0,0,5
741243,560224,2016-08-18,Senate,"Unfinished Business SB746 Wolk Concurrence",36,0,3,0,39
741245,442342,2015-04-29,Senate,"Do pass, but re-refer to the Committee on Appropriations",9,0,0,0,9
741245,445117,2015-05-11,Senate,"Placed on Appropriations Suspense file",7,0,0,0,7
741245,454058,2015-05-28,Senate,"Do pass",7,0,0,0,7
741245,455520,2015-06-01,Senate,"Senate 3rd Reading SB613 Allen",40,0,0,0,40
741245,464960,2015-06-30,Assembly,"Do pass as amended and be re-referred to the Committee on 	Appropriations",18,0,0,1,19
741245,466297,2015-07-14,Assembly,"Do pass and be re-referred to the Committee on Appropriations to 	Consent Calendar",7,0,0,0,7
741245,474460,2015-08-27,Assembly,"Do pass",17,0,0,0,17
741245,475775,2015-09-03,Assembly,"SB 613 Allen  Senate Third Reading  By THURMOND",80,0,0,0,80
741245,475865,2015-09-04,Senate,"Unfinished Business SB613 Allen Concurrence",39,0,1,0,40
741246,441064,2015-04-29,Assembly,"Do pass and be re-referred to the Committee on Appropriations",4,1,0,2,7
741246,454163,2015-05-28,Assembly,"Do pass",15,0,0,2,17
741246,456744,2015-06-03,Assembly,"AB 1200 GORDON  Assembly Third Reading",79,0,0,1,80
741246,465409,2015-07-07,Senate,"Do pass, but re-refer to the Committee on Appropriations",4,0,1,0,5
741246,473781,2015-08-17,Senate,"Placed on Appropriations Suspense file",7,0,0,0,7
741246,474656,2015-08-27,Senate,"Do pass",5,0,2,0,7
741246,476043,2015-09-08,Senate,"Assembly 3rd Reading AB1200 Gordon By Allen",26,5,9,0,40
741246,476044,2015-09-08,Senate,"Assembly 3rd Reading AB1200 Gordon By Allen Reconsider",39,0,1,0,40
741246,513072,2016-03-03,Senate,"Assembly 3rd Reading AB1200 Gordon By Allen Urgency Claus",38,1,1,0,40
741246,540795,2016-05-02,Assembly,"AB 1200 GORDON  Concurrence- Urgency Added",72,0,0,8,80
741247,415111,2015-03-23,Assembly,"From committee:  Be adopted.  To third reading",11,0,0,0,11
741247,438241,2015-04-23,Senate,"Assembly 3rd Reading ACR39 Dababneh By Block",37,0,2,0,39
741249,433219,2015-04-15,Senate,"Do pass, but re-refer to the Committee on Appropriations Recommend 	Consent",8,0,0,0,8
741249,442151,2015-04-30,Senate,"Consent Calendar 2nd SB683 Wolk",34,0,5,0,39
741249,462975,2015-06-25,Assembly,"Be referred to Committee on Arts, Entertain, Sports, Tourism, & 	Internet Media",11,0,0,0,11
741249,540820,2016-05-02,Assembly,"Be referred to Committee on Governmental Organization",11,0,0,0,11
741249,556744,2016-06-30,Assembly,"Do pass and be re-referred to the Committee on Appropriations",19,0,0,2,21
741249,559025,2016-08-03,Assembly,"Do pass, to Consent Calendar",20,0,0,0,20
741249,560125,2016-08-18,Assembly,"SB 683 Wolk  Senate Third Reading  By DODD",78,0,0,2,80
741249,560741,2016-08-23,Senate,"From committee:  That the Assembly Amendments be concurred in",11,0,2,0,13
741249,560920,2016-08-24,Senate,"Unfinished Business SB683 Wolk Concurrence",39,0,0,0,39
741252,440393,2015-04-28,Assembly,"Do pass as amended and be re-referred to the Committee on 	Appropriations",7,0,0,0,7
741252,453670,2015-05-28,Assembly,"Do pass as amended",17,0,0,0,17
741252,456562,2015-06-03,Assembly,"AB 1140 BONTA  Assembly Third Reading",79,0,0,1,80
741252,466305,2015-07-14,Senate,"Do pass as amended, and re-refer to the Committee on Appropriations",7,0,0,0,7
741252,474095,2015-08-24,Senate,"Placed on Appropriations Suspense file",7,0,0,0,7
741252,474518,2015-08-27,Senate,"Do pass as amended",7,0,0,0,7
741252,476349,2015-09-10,Senate,"Assembly 3rd Reading AB1140 Bonta By Hancock",40,0,0,0,40
741252,476539,2015-09-11,Assembly,"AB 1140 BONTA  Concurrence in Senate Amendments",79,0,0,1,80
741253,437167,2015-04-21,Assembly,"Do pass as amended and be re-referred to the Committee on 	Appropriations",19,0,0,0,19
741253,443836,2015-05-06,Assembly,"Do pass, to Consent Calendar",17,0,0,0,17
741253,446685,2015-05-14,Assembly,"AB 1147 MAIENSCHEIN  Consent Calendar Second Day  Regular Session",78,0,0,2,80
741253,464688,2015-07-01,Senate,"Do pass as amended, and re-refer to the Committee on Appropriations",8,0,1,0,9
741253,465848,2015-07-13,Senate,"Assembly 3rd Reading AB1147 Maienschein By Monning",39,0,1,0,40
741253,466448,2015-07-16,Assembly,"AB 1147 MAIENSCHEIN  Concurrence in Senate Amendments",79,0,0,1,80
741254,445728,2015-05-12,Assembly,"Do pass, to Consent Calendar",10,0,0,0,10
741254,447741,2015-05-18,Assembly,"AB 1085 GATTO  Consent Calendar Second Day  Regular Session",77,0,0,3,80
741254,460662,2015-06-16,Senate,"Do pass and be placed on the Consent Calendar",7,0,0,0,7
741254,463016,2015-06-25,Senate,"Consent Calendar 2nd AB1085 Gatto",37,0,3,0,40
741257,436168,2015-04-20,Assembly,"Do pass and be re-referred to the Committee on Appropriations",4,9,0,3,16
741257,463623,2015-04-20,Assembly,"Reconsideration granted",15,0,0,1,16
741259,437391,2015-04-21,Assembly,"Do pass and be re-referred to the Committee on Appropriations",14,5,0,0,19
741259,443862,2015-05-06,Assembly,"Do pass",12,5,0,0,17
741259,445126,2015-05-11,Assembly,"AB 1177 GOMEZ  Assembly Third Reading",51,28,0,1,80
741259,468142,2015-07-15,Senate,"Do pass as amended, and re-refer to the Committee on Appropriations",7,2,0,0,9
741259,476182,2015-09-09,Senate,"Assembly 3rd Reading AB1177 Gomez By Mitchell",26,13,1,0,40
741259,476356,2015-09-10,Assembly,"AB 1177 GOMEZ  Concurrence in Senate Amendments",52,28,0,0,80
741260,432736,2015-04-14,Senate,"Do pass as amended, and re-refer to the Committee on Environmental 	Quality",6,1,2,0,9
741260,440961,2015-04-29,Senate,"Do pass as amended, and re-refer to the Committee on Appropriations",5,2,0,0,7
741260,453917,2015-05-28,Senate,"Do pass as amended",5,2,0,0,7
741260,456592,2015-06-03,Senate,"Senate 3rd Reading SB637 Allen",22,15,3,0,40
741260,463593,2015-05-18,Senate,"Placed on Appropriations Suspense file",7,0,0,0,7
741260,466255,2015-07-14,Assembly,"Do pass and be re-referred to the Committee on Appropriations",10,4,0,1,15
741260,474253,2015-08-27,Assembly,"Do pass",12,5,0,0,17
741260,475863,2015-09-04,Assembly,"SB 637 Allen  Senate Third Reading  By DODD  Amend By DODD  Set #1",51,27,0,2,80
741260,476067,2015-09-09,Assembly,"Do pass as amended",5,2,0,2,9
741260,476499,2015-09-11,Assembly,"SB 637 Allen  Senate Third Reading  By DODD",52,26,0,2,80
741260,476500,2015-09-11,Senate,"Unfinished Business (S upplemental File 5)SB6 37 All en Con",24,14,2,0,40
741262,443937,2015-05-06,Assembly,"Do pass and be re-referred to the Committee on Judiciary",5,3,0,1,9
741262,445803,2015-05-12,Assembly,"Do pass",7,3,0,0,10
741262,447613,2015-05-18,Assembly,"AB 1127 COOLEY  Assembly Third Reading",49,26,0,5,80
741263,443882,2015-05-06,Assembly,"Do pass",9,0,0,0,9
741263,446877,2015-05-14,Assembly,"AB 1350 SALAS  Assembly Third Reading",80,0,0,0,80
741263,462982,2015-06-24,Senate,"Do pass, but re-refer to the Committee on Governance and Finance 	Recommend Consent",8,0,1,0,9
741263,466431,2015-07-15,Senate,"Do pass and be placed on the Consent Calendar",6,0,1,0,7
741263,474031,2015-08-20,Senate,"Consent Calendar 2nd AB1350 Salas",38,0,2,0,40
741263,474089,2015-08-24,Assembly,"AB 1350 SALAS  Concurrence in Senate Amendments",80,0,0,0,80
741264,436143,2015-04-21,Assembly,"Do pass and be re-referred to the Committee on Appropriations to 	Consent Calendar",7,0,0,0,7
741265,436157,2015-04-21,Assembly,"Do pass and be re-referred to the Committee on Appropriations to 	Consent Calendar",7,0,0,0,7
741265,454017,2015-05-28,Assembly,"Do pass",17,0,0,0,17
741265,455310,2015-06-01,Assembly,"AB 1289 COOPER  Assembly Third Reading",80,0,0,0,80
741265,552535,2016-06-13,Senate,"Do pass, but re-refer to the Committee on Public Safety",11,0,0,0,11
741265,556493,2016-06-28,Senate,"Do pass, but re-refer to the Committee on Appropriations",5,2,0,0,7
741265,560881,2016-08-23,Senate,"Assembly 3rd Reading AB1289 Cooper By Monning",39,0,0,0,39
741265,561620,2016-08-30,Assembly,"Senate amendments be concurred in",11,1,0,3,15
741265,561806,2016-08-31,Assembly,"AB 1289 COOPER  Concurrence in Senate Amendments",70,4,0,6,80
741267,443573,2015-05-05,Assembly,"Do pass",14,0,0,0,14
741267,444438,2015-05-07,Assembly,"AB 1430 COOPER  Assembly Third Reading",76,0,0,4,80
741267,551559,2016-06-06,Senate,"Do pass",8,0,1,0,9
741271,446263,2015-05-13,Assembly,"Do pass",12,4,0,1,17
741271,455928,2015-06-02,Assembly,"AB 1156 BROWN  Assembly Third Reading",54,24,0,2,80
741271,465475,2015-07-07,Senate,"Do pass, but re-refer to the Committee on Appropriations",5,1,1,0,7
741271,466129,2015-04-14,Assembly,"Do pass and be re-referred to the Committee on Appropriations",6,0,0,1,7
741271,473612,2015-08-17,Senate,"Placed on Appropriations Suspense file",7,0,0,0,7
741271,474595,2015-08-27,Senate,"Do pass as amended",5,2,0,0,7
741271,475622,2015-09-02,Senate,"Assembly 3rd Reading AB1156 Brown By Hancock",25,14,1,0,40
741271,475893,2015-09-04,Assembly,"AB 1156 BROWN  Concurrence in Senate Amendments",54,26,0,0,80
741272,440650,2015-04-28,Senate,"Do pass and be placed on the Consent Calendar",7,0,4,0,11
741272,442968,2015-05-04,Senate,"Consent Calendar 2nd SB650 Hall",35,0,4,0,39
741272,550416,2016-06-01,Assembly,"Be referred to Committee on Public Safety",11,0,0,0,11
741273,432735,2015-04-15,Assembly,"Do pass as amended and be re-referred to the Committee on Housing 	and Community Development",9,0,0,0,9
741273,441737,2015-04-29,Assembly,"Do pass as amended and be re-referred to the Committee on 	Appropriations",6,0,0,1,7
741273,448987,2015-05-20,Assembly,"Do pass, to Consent Calendar",15,0,0,2,17
741273,451998,2015-05-26,Assembly,"AB 1412 PEREA  Consent Calendar Second Day  Regular Session",76,0,0,4,80
741273,461009,2015-06-17,Senate,"Do pass, but re-refer to the Committee on Appropriations",7,0,0,0,7
741273,463851,2015-06-29,Senate,"Placed on Appropriations Suspense file",6,0,1,0,7
741273,474548,2015-08-27,Senate,"Do pass",7,0,0,0,7
741273,476079,2015-09-09,Senate,"Assembly 3rd Reading AB1412 Perea By Cannella",39,0,1,0,40
741274,429611,2015-04-08,Assembly,"Do pass as amended and be re-referred to the Committee on 	Appropriations",7,0,0,0,7
741274,440986,2015-04-29,Assembly,"Do pass, to Consent Calendar",17,0,0,0,17
741274,444476,2015-05-07,Assembly,"AB 1126 RENDON  Consent Calendar Second Day  Regular Session",77,0,0,3,80
741274,462790,2015-06-24,Senate,"Do pass, but re-refer to the Committee on Appropriations",9,0,0,0,9
741274,465143,2015-07-06,Senate,"Placed on Appropriations Suspense file",7,0,0,0,7
741276,443450,2015-05-05,Assembly,"Do pass",10,0,0,0,10
741276,444443,2015-05-07,Assembly,"AB 1267 BLOOM  Assembly Third Reading",76,0,0,4,80
741276,460746,2015-06-16,Senate,"Do pass",7,0,0,0,7
741276,465172,2015-07-06,Senate,"Special Consent #4 AB1267 Bloom By Jackson",39,0,1,0,40
741279,443519,2015-05-05,Senate,"Be adopted as amended, but re-refer to the Committee on 	Appropriations Recommend Consent",9,0,2,0,11
741279,450213,2015-05-22,Senate,"Consent Calendar 2nd SCR23 Gaines",38,0,1,0,39
741279,461917,2015-06-22,Assembly,"Be adopted and re-referred to the Committee on Appropriations with 	recommendation:  To Consent Calendar",16,0,0,0,16
741279,465663,2015-07-08,Assembly,"Be adopted, to Consent Calendar",14,0,0,3,17
741279,465903,2015-07-13,Assembly,"SCR 23 Gaines  Consent Calendar Second Day  Regular Session",79,0,0,1,80
741279,474008,2015-08-20,Senate,"Special Consent #6 SCR23 Gaines",38,0,2,0,40
741280,437193,2015-04-22,Senate,"Do pass, but re-refer to the Committee on Governmental Organization",4,2,1,0,7
741280,439996,2015-04-28,Senate,"Do pass as amended, and re-refer to the Committee on Appropriations",2,3,6,0,11
741281,444108,2015-05-06,Assembly,"Do pass as amended",9,0,0,0,9
741281,450159,2015-05-22,Assembly,"AB 1455 RODRIGUEZ  Assembly Third Reading",75,0,0,5,80
741282,441233,2015-04-28,Assembly,"Do pass as amended and be re-referred to the Committee on 	Appropriations",10,3,0,0,13
741282,449078,2015-05-20,Assembly,"Do pass",12,0,0,5,17
741282,457298,2015-06-04,Assembly,"AB 1397 TING  Assembly Third Reading",61,18,0,1,80
741282,466215,2015-07-15,Senate,"Do pass, but re-refer to the Committee on Appropriations",6,3,0,0,9
741282,473766,2015-08-17,Senate,"Do pass",6,0,1,0,7
741283,446236,2015-05-12,Senate,"Do pass and be placed on the Consent Calendar",7,0,0,0,7
741283,450204,2015-05-22,Senate,"Consent Calendar 2nd SB711 Wolk",38,0,1,0,39
741283,460835,2015-06-17,Assembly,"Do pass, to Consent Calendar",9,0,0,0,9
741283,461880,2015-06-22,Assembly,"SB 711 Wolk  Consent Calendar Second Day  Regular Session",77,0,0,3,80
741283,473910,2015-08-19,Assembly,"Do pass, to Consent Calendar",17,0,0,0,17
741283,474248,2015-08-27,Assembly,"SB 711 Wolk  Consent Calendar Second Day  Regular Session",78,0,0,2,80
741283,475523,2015-09-01,Senate,"Special Consent #9 SB711 Wolk",40,0,0,0,40
741284,432553,2015-04-14,Assembly,"Do pass and be re-referred to the Committee on Natural Resources",8,4,0,3,15
741284,440193,2015-04-27,Assembly,"Do pass as amended and be re-referred to the Committee on 	Appropriations",8,1,0,0,9
741284,453830,2015-05-28,Assembly,"Do pass",16,0,0,1,17
741284,455982,2015-06-02,Assembly,"AB 1242 GRAY  Assembly Third Reading",69,6,0,5,80
741284,462382,2015-06-23,Senate,"Do pass, but re-refer to the Committee on Environmental Quality",5,0,4,0,9
741284,466265,2015-07-15,Senate,"Do pass as amended, and re-refer to the Committee on Appropriations",7,0,0,0,7
741285,442833,2015-05-04,Assembly,"Do pass, to Consent Calendar",9,0,0,0,9
741285,445153,2015-05-11,Assembly,"AB 1110 TING  Consent Calendar Second Day  Regular Session",79,0,0,1,80
741285,474094,2015-08-24,Senate,"Placed on Appropriations Suspense file",7,0,0,0,7
741285,474522,2015-08-27,Senate,"Do pass",5,2,0,0,7
741285,560765,2016-08-23,Senate,"Assembly 3rd Reading AB1110 Ting By Wolk",26,12,1,0,39
741285,561601,2016-08-30,Assembly,"Senate amendments be concurred in",11,3,0,1,15
741285,561701,2016-08-31,Assembly,"AB 1110 TING  Concurrence in Senate Amendments",54,25,0,1,80
741289,432637,2015-04-13,Assembly,"Do pass and be re-referred to the Committee on Appropriations to 	Consent Calendar",16,0,0,0,16
741289,440891,2015-04-29,Assembly,"Do pass, to Consent Calendar",17,0,0,0,17
741289,446862,2015-05-14,Assembly,"AB 1338 GOMEZ  Assembly Third Reading",80,0,0,0,80
741289,465520,2015-07-07,Senate,"Do pass, but re-refer to the Committee on Appropriations Recommend 	Consent",11,0,0,0,11
741289,473997,2015-08-20,Senate,"Consent Calendar 2nd AB1338 Gomez By Leyva",38,0,2,0,40
741293,432858,2015-04-15,Assembly,"Do pass and be re-referred to the Committee on Privacy and Consumer 	Protection",9,0,0,0,9
741293,436412,2015-04-21,Assembly,"Do pass and be re-referred to the Committee on Appropriations",11,0,0,0,11
741296,432587,2015-04-13,Assembly,"Do pass as amended and be re-referred to the Committee on 	Appropriations",9,0,0,0,9
741296,440204,2015-04-28,Assembly,"Do pass and be re-referred to the Committee on Appropriations",6,0,0,1,7
741298,441509,2015-04-28,Assembly,"Do pass as amended and be re-referred to the Committee on 	Appropriations",5,0,0,2,7
741298,456591,2015-06-03,Assembly,"AB 1400 SANTIAGO  Assembly Third Reading",62,5,0,13,80
741299,427759,2015-04-07,Senate,"Do pass",5,0,0,0,5
741299,442901,2015-05-04,Senate,"Senate 3rd Reading SB770 Mendoza",36,0,3,0,39
741299,464782,2015-07-01,Assembly,"Do pass, to Consent Calendar",9,0,0,1,10
741299,465770,2015-07-09,Assembly,"SB 770 Mendoza  Consent Calendar Second Day  Regular Session",79,0,0,1,80
741300,436068,2015-04-20,Assembly,"Do pass and be re-referred to the Committee on Transportation",14,0,0,1,15
741300,440355,2015-04-27,Assembly,"Do pass and be re-referred to the Committee on Appropriations",16,0,0,0,16
741300,453425,2015-05-27,Assembly,"Do pass, to Consent Calendar",17,0,0,0,17
741300,456091,2015-06-02,Assembly,"AB 1422 COOPER  Consent Calendar Second Day  Regular Session",78,0,0,2,80
741300,464623,2015-06-30,Senate,"Do pass, but re-refer to the Committee on Transportation and 	Housing",9,0,2,0,11
741300,465967,2015-07-14,Senate,"Do pass as amended, and re-refer to the Committee on Appropriations",11,0,0,0,11
741300,474400,2015-08-27,Senate,"Assembly 3rd Reading AB1422 Cooper By Allen",39,0,1,0,40
741300,475336,2015-08-31,Assembly,"AB 1422 COOPER  Concurrence in Senate Amendments",80,0,0,0,80
741302,431177,2015-04-13,Assembly,"Do pass and be re-referred to the Committee on Appropriations",11,0,0,1,12
741302,437110,2015-04-22,Assembly,"Do pass, to Consent Calendar",17,0,0,0,17
741302,442374,2015-04-30,Assembly,"AB 1292 DABABNEH  Consent Calendar Second Day  Regular Session",77,0,0,3,80
741302,460633,2015-06-17,Senate,"Do pass, but re-refer to the Committee on Appropriations Recommend 	Consent",7,0,0,0,7
741302,473614,2015-08-17,Senate,"Placed on Appropriations Suspense file",7,0,0,0,7
741302,474630,2015-08-27,Senate,"Do pass",7,0,0,0,7
741302,476136,2015-09-09,Senate,"Assembly 3rd Reading AB1292 Dababneh By Block",40,0,0,0,40
741303,440939,2015-04-29,Senate,"Do pass, but re-refer to the Committee on Appropriations Recommend 	Consent",7,0,2,0,9
741303,450161,2015-05-22,Senate,"Consent Calendar 2nd SB652 Allen",38,0,1,0,39
741303,460705,2015-06-17,Assembly,"Do pass and be re-referred to the Committee on Appropriations to 	Consent Calendar",7,0,0,0,7
741303,465629,2015-07-08,Assembly,"Do pass, to Consent Calendar",14,0,0,3,17
741303,466547,2015-07-16,Assembly,"SB 652 Allen  Consent Calendar Second Day  Regular Session",79,0,0,1,80
741304,438286,2015-04-22,Assembly,"Do pass as amended and be re-referred to the Committee on 	Appropriations",7,0,0,0,7
741304,454190,2015-05-28,Assembly,"Do pass",17,0,0,0,17
741304,455305,2015-06-01,Assembly,"AB 1369 FRAZIER  Assembly Third Reading",80,0,0,0,80
741304,473771,2015-08-17,Senate,"Placed on Appropriations Suspense file",7,0,0,0,7
741304,474577,2015-08-27,Senate,"Do pass",7,0,0,0,7
741304,475818,2015-09-03,Senate,"Assembly 3rd Reading AB1369 Frazier By Monning",39,0,1,0,40
741305,428830,2015-04-08,Assembly,"Do pass and be re-referred to the Committee on Appropriations to 	Consent Calendar",9,0,0,0,9
741305,433796,2015-04-15,Assembly,"Do pass, to Consent Calendar",16,0,0,1,17
741305,438420,2015-04-23,Assembly,"AB 1105 DALY  Consent Calendar Second Day  Regular Session",78,0,0,2,80
741306,484890,2016-01-13,Senate,"Do pass, but re-refer to the Committee on Appropriations Recommend 	Consent",5,0,0,0,5
741306,486378,2016-01-21,Senate,"Do pass",7,0,0,0,7
741306,488146,2016-01-26,Senate,"Senate 3rd Reading SB702 McGuire",38,0,2,0,40
741306,555428,2016-06-22,Assembly,"Do pass as amended and be re-referred to the Committee on 	Appropriations",7,0,0,0,7
741306,559645,2016-08-10,Assembly,"Do pass",18,1,0,1,20
741306,560284,2016-08-18,Assembly,"SB 702 McGuire  Senate Third Reading  By DODD",77,1,0,2,80
741306,561292,2016-08-25,Senate,"Special Consent SB702 McGuire",39,0,0,0,39
741307,433020,2015-04-14,Assembly,"Do pass and be re-referred to the Committee on Business and 	Professions to Consent Calendar",15,0,0,0,15
741307,440277,2015-04-28,Assembly,"Do pass and be re-referred to the Committee on Appropriations to 	Consent Calendar",14,0,0,0,14
741307,453792,2015-05-28,Assembly,"Do pass",17,0,0,0,17
741307,455378,2015-06-01,Assembly,"AB 1463 GATTO  Assembly Third Reading",79,0,0,1,80
741309,433392,2015-04-15,Assembly,"Do pass and be re-referred to the Committee on Appropriations to 	Consent Calendar",6,0,0,1,7
741309,441539,2015-04-29,Assembly,"Do pass, to Consent Calendar",17,0,0,0,17
741309,444425,2015-05-07,Assembly,"AB 1148 GAINES  Consent Calendar Second Day  Regular Session",77,0,0,3,80
741309,460547,2015-06-16,Senate,"Do pass, but re-refer to the Committee on Appropriations Recommend 	Consent",5,0,0,0,5
741309,464949,2015-07-02,Senate,"Consent Calendar 2nd AB1148 Beth Gaines",38,0,2,0,40
741310,428635,2015-04-08,Assembly,"Do pass and be re-referred to the Committee on Appropriations",11,1,0,1,13
741310,434077,2015-04-15,Assembly,"Do pass",15,1,0,1,17
741310,447705,2015-05-18,Assembly,"AB 1245 COOLEY  Assembly Third Reading",76,1,0,3,80
741310,458822,2015-06-10,Senate,"Do pass, but re-refer to the Committee on Appropriations",5,0,0,0,5
741310,465925,2015-07-13,Senate,"Assembly 3rd Reading AB1245 Cooley By Lara",36,3,1,0,40
741310,466455,2015-07-16,Assembly,"AB 1245 COOLEY  Concurrence in Senate Amendments",76,2,0,2,80
741316,443694,2015-05-05,Senate,"Do pass as amended",7,0,0,0,7
741316,447621,2015-05-18,Senate,"Senate 3rd Reading SB594 Wieckowski",36,0,3,0,39
741316,462204,2015-06-23,Assembly,"Do pass, to Consent Calendar",10,0,0,0,10
741316,463942,2015-06-29,Assembly,"SB 594 Wieckowski  Consent Calendar Second Day  Regular Session",76,0,0,4,80
741316,465200,2015-07-06,Senate,"Special Consent #4 SB594 Wieckowski",39,0,1,0,40
741318,437935,2015-04-22,Assembly,"Do pass and be re-referred to the Committee on Appropriations",5,2,0,0,7
741318,441237,2015-04-29,Assembly,"Do pass",12,4,0,1,17
741318,442857,2015-05-04,Assembly,"AB 1308 PEREA  Assembly Third Reading",53,23,0,4,80
741318,458830,2015-06-10,Senate,"Do pass, but re-refer to the Committee on Appropriations",4,1,0,0,5
741318,463032,2015-06-25,Senate,"Assembly 3rd Reading AB1308 Perea By Mendoza",26,12,2,0,40
741318,464878,2015-07-02,Assembly,"AB 1308 PEREA  Concurrence in Senate Amendments",53,22,0,5,80
741320,466152,2015-04-14,Assembly,"Do pass and be re-referred to the Committee on Appropriations",7,0,0,0,7
741321,441058,2015-04-29,Senate,"Do pass as amended, and re-refer to the Committee on Appropriations",6,0,1,0,7
741321,450248,2015-05-22,Senate,"Senate 3rd Reading SB704 Gaines",38,0,1,0,39
741321,466207,2015-07-15,Assembly,"Do pass and be re-referred to the Committee on Appropriations",7,0,0,0,7
741321,473916,2015-08-19,Assembly,"Do pass, to Consent Calendar",17,0,0,0,17
741321,474265,2015-08-27,Assembly,"SB 704 Gaines  Consent Calendar Second Day  Regular Session",78,0,0,2,80
741321,475506,2015-09-01,Senate,"Special Consent #9 SB704 Gaines",40,0,0,0,40
741323,440476,2015-04-28,Assembly,"Do pass and be re-referred to the Committee on Appropriations",15,0,0,0,15
741323,453945,2015-05-28,Assembly,"Do pass as amended",16,1,0,0,17
741323,457276,2015-06-04,Assembly,"AB 1201 SALAS  Assembly Third Reading",74,1,0,5,80
741323,465970,2015-07-14,Senate,"Do pass as amended, and re-refer to the Committee on Appropriations",9,0,0,0,9
741323,473717,2015-08-17,Senate,"Placed on Appropriations Suspense file",7,0,0,0,7
741326,460184,2015-06-16,Senate,"Do pass as amended, and re-refer to the Committee on Appropriations",10,0,1,0,11
741326,465128,2015-07-06,Senate,"Placed on Appropriations Suspense file",7,0,0,0,7
741326,474490,2015-08-27,Senate,"Do pass",7,0,0,0,7
741326,475295,2015-08-31,Senate,"Senate 2nd Reading SB657 Monning Urgency Clause",38,0,2,0,40
741326,555980,2016-06-27,Assembly,"Do pass and be re-referred to the Committee on Appropriations",12,0,0,0,12
741326,559013,2016-08-03,Assembly,"Do pass, to Consent Calendar",20,0,0,0,20
741326,559336,2016-08-11,Assembly,"SB 657 Berryhill, T.  Consent Calendar Second Day  Regular Session",78,0,0,2,80
741326,560034,2016-08-17,Senate,"From committee:  That the Assembly Amendments be concurred in",7,0,0,0,7
741326,561186,2016-08-25,Senate,"Special Consent SB657 Berryhill",39,0,0,0,39
741327,430766,2015-04-13,Senate,"Do pass, but re-refer to the Committee on Appropriations",5,0,0,0,5
741327,454068,2015-05-28,Senate,"Do pass as amended",7,0,0,0,7
741327,456054,2015-06-02,Senate,"Senate 3rd Reading SB644 Hancock",40,0,0,0,40
741327,462617,2015-06-24,Assembly,"Do pass and be re-referred to the Committee on Appropriations",6,0,0,1,7
741327,463645,2015-04-27,Senate,"Placed on Appropriations Suspense file",7,0,0,0,7
741327,474481,2015-08-27,Assembly,"Do pass as amended",17,0,0,0,17
741327,475663,2015-09-02,Assembly,"SB 644 Hancock  Senate Third Reading  By RENDON",80,0,0,0,80
741327,475788,2015-09-03,Senate,"Unfinished Business SB644 Hancock Concurrence",40,0,0,0,40
741328,429381,2015-04-08,Assembly,"Do pass and be re-referred to the Committee on Health",7,0,0,0,7
741328,437359,2015-04-21,Assembly,"Do pass and be re-referred to the Committee on Appropriations",18,0,0,1,19
741330,437934,2015-04-21,Senate,"Do pass, but re-refer to the Committee on Appropriations",7,0,0,0,7
741330,442864,2015-05-04,Senate,"Placed on Appropriations Suspense file",7,0,0,0,7
741330,453936,2015-05-28,Senate,"Do pass",6,1,0,0,7
741330,455485,2015-06-01,Senate,"Senate 3rd Reading SB674 De Le",38,0,2,0,40
741330,465974,2015-07-14,Assembly,"Do pass and be re-referred to the Committee on Appropriations to 	Consent Calendar",7,0,0,0,7
741330,474374,2015-08-27,Assembly,"Do pass",17,0,0,0,17
741330,475756,2015-09-03,Assembly,"SB 674 De Leon  Senate Third Reading  By ATKINS",78,0,0,2,80
741331,433679,2015-04-15,Senate,"Do pass, but re-refer to the Committee on Appropriations Recommend 	Consent",7,0,0,0,7
741331,444462,2015-05-07,Senate,"Senate 3rd Reading SB662 Committee On E.Q. (Wieckowski)",37,0,2,0,39
741331,462037,2015-06-22,Assembly,"Do pass and be re-referred to the Committee on Appropriations to 	Consent Calendar",7,0,0,2,9
741331,463671,2015-04-27,Senate,"Do pass",7,0,0,0,7
741331,474472,2015-08-27,Assembly,"Do pass",17,0,0,0,17
741331,475745,2015-09-03,Assembly,"SB 662 E.Q.  Senate Third Reading  By GORDON",80,0,0,0,80
741332,440361,2015-04-27,Assembly,"Do pass as amended and be re-referred to the Committee on 	Appropriations",9,0,0,0,9
741332,453929,2015-05-28,Assembly,"Do pass",17,0,0,0,17
741332,457310,2015-06-04,Assembly,"AB 1142 GRAY  Assembly Third Reading",73,1,0,6,80
741332,466162,2015-07-14,Senate,"Do pass as amended, and re-refer to the Committee on Appropriations",8,0,1,0,9
741332,474155,2015-08-24,Senate,"Placed on Appropriations Suspense file",7,0,0,0,7
741332,474507,2015-08-27,Senate,"Do pass as amended",5,0,2,0,7
741332,526777,2016-03-31,Senate,"Assembly 3rd Reading AB1142 Gray By Pavley",35,0,5,0,40
741332,530429,2016-04-11,Assembly,"Senate amendments be concurred in",9,0,0,0,9
741332,533177,2016-04-14,Assembly,"AB 1142 GRAY  Concurrence in Senate Amendments",75,0,0,5,80
741333,430685,2015-04-13,Assembly,"Be referred to Committee on Privacy and Consumer Protection",11,0,0,0,11
741336,437901,2015-04-21,Assembly,"Do pass and be re-referred to the Committee on Judiciary",2,9,0,2,13
741336,463717,2015-04-21,Assembly,"Reconsideration granted",13,0,0,0,13
741337,484875,2016-01-12,Assembly,"Do pass",6,0,0,1,7
741337,485592,2016-01-19,Assembly,"AB 1276 SANTIAGO  Assembly Third Reading",77,0,0,2,79
741337,556405,2016-06-28,Senate,"Do pass as amended",7,0,0,0,7
741337,559225,2016-08-11,Senate,"Special Consent AB1276 Santiago By Block",37,0,2,0,39
741337,560212,2016-08-18,Assembly,"AB 1276 SANTIAGO  Concurrence in Senate Amendments",79,0,0,1,80
741338,443402,2015-05-05,Assembly,"Do pass",8,2,0,0,10
741338,444416,2015-05-07,Assembly,"AB 1283 TING  Assembly Third Reading",55,18,0,7,80
741340,430886,2015-04-13,Assembly,"Do pass and be re-referred to the Committee on Jobs, Economic 	Development and The Economy",11,0,0,1,12
741340,441201,2015-04-29,Assembly,"Do pass and be re-referred to the Committee on Appropriations",8,0,0,1,9
741340,448942,2015-05-20,Assembly,"Do pass, to Consent Calendar",15,0,0,2,17
741340,451712,2015-05-26,Assembly,"AB 1393 BURKE  Consent Calendar Second Day  Regular Session",76,0,0,4,80
741340,465622,2015-07-08,Senate,"Do pass, but re-refer to the Committee on Appropriations",7,0,0,0,7
741340,474088,2015-08-24,Senate,"Placed on Appropriations Suspense file",7,0,0,0,7
741341,440185,2015-04-27,Assembly,"Do pass and be re-referred to the Committee on Appropriations",6,3,0,0,9
741341,453086,2015-05-27,Assembly,"Do pass",12,5,0,0,17
741341,456686,2015-06-03,Assembly,"AB 1288 ATKINS  Assembly Third Reading",51,28,0,1,80
741341,466405,2015-07-15,Senate,"Do pass, but re-refer to the Committee on Appropriations",5,2,0,0,7
741341,473629,2015-08-17,Senate,"Placed on Appropriations Suspense file",7,0,0,0,7
741341,474629,2015-08-27,Senate,"Do pass",5,2,0,0,7
741341,476540,2015-09-11,Senate,"Do pass",5,0,2,0,7
741341,476541,2015-09-11,Senate,"Assembly 3rd Reading ( Supplemental File 3)AB 1288 At kins By",28,10,2,0,40
741341,476542,2015-09-12,Assembly,"AB 1288 ATKINS  Concurrence in Senate Amendments",52,26,0,2,80
741342,440270,2015-04-27,Assembly,"Do pass and be re-referred to the Committee on Appropriations to 	Consent Calendar",9,0,0,0,9
741342,443945,2015-05-06,Assembly,"Do pass, to Consent Calendar",17,0,0,0,17
741342,446812,2015-05-14,Assembly,"AB 1169 GOMEZ  Consent Calendar Second Day  Regular Session",78,0,0,2,80
741342,462347,2015-06-23,Senate,"Do pass, but re-refer to the Committee on Appropriations",6,2,1,0,9
741343,436272,2015-04-21,Senate,"Do pass as amended, and re-refer to the Committee on Appropriations",11,0,0,0,11
741343,442861,2015-05-04,Senate,"Placed on Appropriations Suspense file",7,0,0,0,7
741345,432613,2015-04-14,Assembly,"Do pass and be re-referred to the Committee on Local Government",10,4,0,1,15
741345,437212,2015-04-22,Assembly,"Do pass and be re-referred to the Committee on Appropriations",9,0,0,0,9
741345,453992,2015-05-28,Assembly,"Do pass",12,4,0,1,17
741345,456601,2015-06-03,Assembly,"AB 1251 GOMEZ  Assembly Third Reading",61,15,0,4,80
741345,465844,2015-07-13,Senate,"Placed on Appropriations Suspense file",7,0,0,0,7
741345,474502,2015-08-27,Senate,"Do pass",5,2,0,0,7
741345,476243,2015-09-10,Senate,"Assembly 3rd Reading AB1251 Gomez By De Le",27,13,0,0,40
741345,476614,2015-09-11,Assembly,"AB 1251 GOMEZ  Concurrence in Senate Amendments",61,16,0,3,80
741348,439953,2015-04-28,Assembly,"Do pass and be re-referred to the Committee on Appropriations",5,0,0,2,7
741350,440475,2015-04-27,Senate,"Do pass, but re-refer to the Committee on Appropriations",8,0,1,0,9
741350,445311,2015-05-11,Senate,"Placed on Appropriations Suspense file",7,0,0,0,7
741351,485026,2016-01-12,Assembly,"Do pass and be re-referred to the Committee on Appropriations to 	Consent Calendar",14,0,0,1,15
741351,486408,2016-01-21,Assembly,"Do pass as amended",17,0,0,0,17
741351,489197,2016-01-28,Assembly,"AB 1244 GRAY  Assembly Third Reading",78,0,0,1,79
741351,556478,2016-06-29,Senate,"Do pass, but re-refer to the Committee on Appropriations",5,0,0,0,5
741351,559579,2016-08-11,Senate,"Do pass as amended",5,0,2,0,7
741351,560742,2016-08-23,Senate,"Assembly 3rd Reading AB1244 Gray By Mendoza",39,0,0,0,39
741351,561318,2016-08-25,Assembly,"Senate amendments be concurred in",12,0,0,1,13
741351,561587,2016-08-30,Assembly,"AB 1244 GRAY  Concurrence in Senate Amendments",79,0,0,1,80
741352,441272,2015-04-29,Assembly,"Do pass and be re-referred to the Committee on Appropriations to 	Consent Calendar",9,0,0,1,10
741352,446320,2015-05-13,Assembly,"Do pass, to Consent Calendar",17,0,0,0,17
741352,450099,2015-05-22,Assembly,"AB 1135 AGRI.  Consent Calendar Second Day  Regular Session",74,0,0,6,80
741352,544305,2016-05-10,Senate,"Do pass, but re-refer to the Committee on Appropriations",5,2,0,0,7
741352,545816,2016-05-16,Senate,"Placed on Appropriations Suspense file",2,4,1,0,7
741352,545817,2016-05-16,Senate,"Do pass",5,2,0,0,7
741352,547025,2016-05-19,Senate,"Assembly 3rd Reading AB1135 Levine By Glazer",24,14,2,0,40
741352,556724,2016-06-30,Assembly,"AB 1135 LEVINE  Concurrence in Senate Amendments",46,30,0,4,80
741353,484888,2016-01-13,Assembly,"Do pass and be re-referred to the Committee on Appropriations",4,3,0,0,7
741353,486310,2016-01-21,Assembly,"Do pass",14,3,0,0,17
741353,488350,2016-01-27,Assembly,"AB 1494 LEVINE  Assembly Third Reading",51,18,0,10,79
741353,552057,2016-06-08,Senate,"Do pass as amended",5,0,0,0,5
741353,558638,2016-08-01,Senate,"Assembly 3rd Reading AB1494 Levine By Anderson",31,8,0,0,39
741353,559791,2016-08-15,Senate,"Assembly 3rd Reading AB1494 Levine By Anderson",31,6,2,0,39
741353,560512,2016-08-22,Assembly,"AB 1494 LEVINE  Concurrence in Senate Amendments",63,15,0,2,80
741354,441194,2015-04-28,Assembly,"Do pass as amended and be re-referred to the Committee on 	Appropriations",11,1,0,7,19
741357,429310,2015-04-08,Senate,"Do pass, but re-refer to the Committee on Judiciary",9,0,0,0,9
741357,446189,2015-05-12,Senate,"Do pass as amended",7,0,0,0,7
741357,450147,2015-05-22,Senate,"Senate 3rd Reading SB658 Hill",39,0,0,0,39
741357,462119,2015-06-23,Assembly,"Do pass",10,0,0,0,10
741357,473989,2015-08-20,Assembly,"SB 658 Hill  Senate Third Reading  By GORDON",79,0,0,1,80
741357,474303,2015-08-27,Senate,"Unfinished Business SB658 Hill Concurrence",37,0,3,0,40
741359,436008,2015-04-21,Assembly,"Do pass as amended and be re-referred to the Committee on 	Appropriations",9,0,0,0,9
741360,442356,2015-04-29,Assembly,"Do pass and be re-referred to the Committee on Appropriations to 	Consent Calendar",6,0,0,1,7
741360,446409,2015-05-13,Assembly,"Do pass",17,0,0,0,17
741360,447777,2015-05-18,Assembly,"AB 1153 CALDERON  Assembly Third Reading",77,0,0,3,80
741360,460946,2015-06-17,Senate,"Do pass, but re-refer to the Committee on Appropriations",8,0,1,0,9
741360,463840,2015-06-29,Senate,"Placed on Appropriations Suspense file",6,0,1,0,7
741361,443764,2015-05-06,Assembly,"Do pass and be re-referred to the Committee on Appropriations to 	Consent Calendar",13,0,0,0,13
741361,448896,2015-05-20,Assembly,"Do pass, to Consent Calendar",15,0,0,2,17
741361,451453,2015-05-26,Assembly,"AB 1131 DABABNEH  Consent Calendar Second Day  Regular Session",76,0,0,4,80
741361,465657,2015-07-08,Senate,"Do pass, but re-refer to the Committee on Judiciary Recommend 	Consent",8,0,1,0,9
741361,466356,2015-07-14,Senate,"Do pass, but re-refer to the Committee on Appropriations",7,0,0,0,7
741361,475984,2015-09-08,Senate,"Assembly 3rd Reading AB1131 Dababneh By Hall",40,0,0,0,40
741361,476060,2015-09-09,Assembly,"AB 1131 DABABNEH  Concurrence in Senate Amendments",80,0,0,0,80
741362,442294,2015-04-29,Assembly,"Subject matter be referred",4,3,0,0,7
741363,441717,2015-04-29,Assembly,"Do pass as amended and be re-referred to the Committee on 	Appropriations",4,2,0,1,7
741363,453636,2015-05-28,Assembly,"Do pass",12,5,0,0,17
741363,455945,2015-06-02,Assembly,"AB 1301 JONES-SAWYER  Assembly Third Reading",51,26,0,3,80
741363,465426,2015-07-07,Senate,"Do pass, but re-refer to the Committee on Appropriations",4,0,1,0,5
741363,473686,2015-08-17,Senate,"Placed on Appropriations Suspense file",7,0,0,0,7
741363,474657,2015-08-27,Senate,"Do pass",5,2,0,0,7
741363,475738,2015-09-03,Senate,"Assembly 3rd Reading AB1301 Jones-Sawyer By Hall",26,14,0,0,40
741364,445788,2015-05-12,Senate,"Do pass and be placed on the Consent Calendar",9,0,2,0,11
741364,447633,2015-05-18,Senate,"Consent Calendar 2nd SB777 Lara",36,0,3,0,39
741364,465732,2015-07-08,Assembly,"Do pass",18,0,0,3,21
741364,559216,2016-08-09,Assembly,"Do pass as amended and be re-referred to the Committee on 	Appropriations",11,0,0,1,12
741364,560118,2016-08-18,Assembly,"SB 777 Lara  Senate Third Reading  By SANTIAGO",78,0,0,2,80
741364,561272,2016-08-25,Senate,"From committee:  That the Assembly Amendments be concurred in",7,0,0,0,7
741364,561448,2016-08-29,Senate,"Unfinished Business SB777 Lara Concurrence",39,0,0,0,39
741365,432937,2015-04-13,Assembly,"Do pass, to Consent Calendar",16,0,0,0,16
741365,435376,2015-04-20,Assembly,"AB 1250 BLOOM  Consent Calendar Second Day  Regular Session",80,0,0,0,80
741365,466135,2015-07-14,Senate,"Do pass, but re-refer to the Committee on Appropriations",11,0,0,0,11
741365,473785,2015-08-17,Senate,"Do pass",7,0,0,0,7
741365,476268,2015-09-10,Senate,"From Committee:  That the measure be returned to the Senate floor 	for consideration",9,0,2,0,11
741365,476622,2015-09-11,Assembly,"Senate amendments be concurred in",16,0,0,0,16
741365,476623,2015-09-11,Senate,"Assembly 3rd Reading AB1250 Bloom By Beall",40,0,0,0,40
741365,476624,2015-09-11,Assembly,"AB 1250 BLOOM  Concurrence in Senate Amendments",79,0,0,1,80
741366,443965,2015-05-06,Assembly,"Do pass",18,0,0,3,21
741366,446907,2015-05-14,Assembly,"AB 1295 GRAY  Assembly Third Reading",79,0,0,1,80
741366,473570,2015-08-17,Senate,"Do pass",7,0,0,0,7
741366,476106,2015-09-09,Senate,"Assembly 3rd Reading AB1295 Levine By Hall",40,0,0,0,40
741366,476471,2015-09-11,Assembly,"Senate amendments be concurred in",19,0,0,2,21
741366,476472,2015-09-11,Assembly,"AB 1295 LEVINE  Concurrence in Senate Amendments",78,0,0,2,80
741367,444518,2015-05-06,Assembly,"Do pass and be re-referred to the Committee on Appropriations",2,5,0,0,7
741367,463612,2015-05-06,Assembly,"Reconsideration granted",7,0,0,0,7
741368,437187,2015-04-22,Assembly,"Do pass, to Consent Calendar",17,0,0,0,17
741368,442297,2015-04-30,Assembly,"AB 1375 THURMOND  Consent Calendar Second Day  Regular Session",77,0,0,3,80
741368,460174,2015-06-16,Senate,"Do pass, but re-refer to the Committee on Appropriations",7,0,0,0,7
741368,465142,2015-07-06,Senate,"Assembly 3rd Reading AB1375 Thurmond By Hall",39,0,1,0,40
741368,466141,2015-04-14,Assembly,"Do pass and be re-referred to the Committee on Appropriations to 	Consent Calendar",7,0,0,0,7
741372,436080,2015-04-21,Assembly,"Do pass and be re-referred to the Committee on Appropriations",7,0,0,0,7
741372,441242,2015-04-29,Assembly,"Do pass",17,0,0,0,17
741372,447667,2015-05-18,Assembly,"AB 1343 THURMOND  Assembly Third Reading",77,0,0,3,80
741372,465486,2015-07-07,Senate,"Do pass, but re-refer to the Committee on Appropriations",5,1,1,0,7
741372,475576,2015-09-02,Senate,"Assembly 3rd Reading AB1343 Thurmond By Lara",35,5,0,0,40
741372,475888,2015-09-04,Assembly,"AB 1343 THURMOND  Concurrence in Senate Amendments",78,0,0,2,80
741373,439983,2015-04-28,Senate,"Do pass, but re-refer to the Committee on Appropriations",7,0,0,0,7
741373,450241,2015-05-22,Senate,"Senate 3rd Reading SB601 Hancock",39,0,0,0,39
741373,464276,2015-06-30,Assembly,"Do pass and be re-referred to the Committee on Appropriations to 	Consent Calendar",7,0,0,0,7
741373,465567,2015-07-08,Assembly,"Do pass, to Consent Calendar",14,0,0,3,17
741373,466565,2015-07-16,Assembly,"SB 601 Hancock  Consent Calendar Second Day  Regular Session",79,0,0,1,80
741376,437572,2015-04-21,Assembly,"Do pass and be re-referred to the Committee on Education",13,0,0,0,13
741376,442209,2015-04-29,Assembly,"Amend, and do pass as amended and be re-referred to the Committee 	on Appropriations with the recommendation:  To Consent Calendar",6,0,0,1,7
741376,453650,2015-05-28,Assembly,"Do pass",17,0,0,0,17
741376,455430,2015-06-01,Assembly,"AB 1145 MEDINA  Assembly Third Reading",79,0,0,1,80
741376,462603,2015-06-24,Senate,"Do pass as amended, but re-refer to the Committee on Appropriations 	Recommend Consent",9,0,0,0,9
741377,441083,2015-04-28,Assembly,"Do pass as amended",9,3,0,1,13
741377,457337,2015-06-04,Assembly,"AB 1385 TING  Assembly Third Reading",62,18,0,0,80
741377,466204,2015-07-15,Senate,"Do pass",6,3,0,0,9
741378,441096,2015-04-29,Senate,"Do pass as amended, and re-refer to the Committee on Appropriations",5,2,0,0,7
741378,453766,2015-05-28,Senate,"Do pass",5,2,0,0,7
741378,455361,2015-06-01,Senate,"Senate 3rd Reading SB673 Lara Motions",21,14,5,0,40
741378,463693,2015-05-18,Senate,"Placed on Appropriations Suspense file",7,0,0,0,7
741378,466065,2015-07-14,Assembly,"Do pass and be re-referred to the Committee on Appropriations",5,1,0,1,7
741378,474302,2015-08-27,Assembly,"Do pass",12,5,0,0,17
741378,476372,2015-09-10,Assembly,"SB 673 Lara  Senate Third Reading  By SANTIAGO",50,25,0,5,80
741378,476498,2015-09-11,Senate,"Unfinished Business SB673 Lara Concurrence",31,7,2,0,40
741381,440110,2015-04-28,Assembly,"Do pass as amended and be re-referred to the Committee on 	Appropriations",7,3,0,0,10
741382,436196,2015-04-21,Assembly,"Do pass as amended and be re-referred to the Committee on 	Appropriations",10,0,0,0,10
741382,453730,2015-05-28,Assembly,"Do pass as amended",17,0,0,0,17
741382,456818,2015-06-03,Assembly,"AB 1342 STEINORTH  Assembly Third Reading",78,0,0,2,80
741382,463845,2015-06-29,Senate,"Do pass, but re-refer to the Committee on Judiciary",12,0,1,0,13
741382,466318,2015-07-14,Senate,"Do pass as amended, but re-refer to the Committee on Appropriations 	Recommend Consent",7,0,0,0,7
741382,473798,2015-08-17,Senate,"Placed on Appropriations Suspense file",7,0,0,0,7
741382,474599,2015-08-27,Senate,"Do pass as amended",7,0,0,0,7
741382,475796,2015-09-03,Senate,"Assembly 3rd Reading AB1342 Steinorth By Galgiani",40,0,0,0,40
741382,475896,2015-09-04,Assembly,"AB 1342 STEINORTH  Concurrence in Senate Amendments",77,0,0,3,80
741384,446191,2015-05-12,Senate,"Do pass",5,2,0,0,7
741384,454417,2015-05-28,Senate,"Senate 3rd Reading SB600 Pan",30,9,1,0,40
741384,464340,2015-06-30,Assembly,"Do pass",8,1,0,1,10
741384,474131,2015-08-24,Assembly,"SB 600 Pan  Senate Third Reading  By CHIU",63,13,0,4,80
741387,446280,2015-05-12,Assembly,"Do pass and be re-referred to the Committee on Appropriations",19,0,0,0,19
741387,449005,2015-05-20,Assembly,"Do pass, to Consent Calendar",15,0,0,2,17
741387,451700,2015-05-26,Assembly,"AB 1223 O'DONNELL  Consent Calendar Second Day  Regular Session",76,0,0,4,80
741387,465809,2015-07-08,Senate,"Do pass, but re-refer to the Committee on Appropriations",6,0,3,0,9
741387,475270,2015-08-31,Senate,"Assembly 3rd Reading AB1223 O'Donnell By Pan",38,0,2,0,40
741387,475612,2015-09-02,Assembly,"AB 1223 O'DONNELL  Concurrence in Senate Amendments",80,0,0,0,80
741388,441621,2015-04-29,Assembly,"Do pass and be re-referred to the Committee on Appropriations",2,4,0,1,7
741389,422098,2015-03-26,Senate,"Senate 3rd Reading SR15 Mendoza",32,0,7,0,39
741390,442386,2015-04-29,Senate,"Do pass, but re-refer to the Committee on Appropriations",8,0,1,0,9
741390,450250,2015-05-22,Senate,"Senate 3rd Reading SB675 Liu",37,0,2,0,39
741390,466000,2015-07-14,Assembly,"Amend, and do pass as amended and be re-referred to the Committee 	on Appropriations with the recommendation:  To Consent Calendar",19,0,0,0,19
741390,473883,2015-08-19,Assembly,"Do pass, to Consent Calendar",17,0,0,0,17
741390,474344,2015-08-27,Assembly,"SB 675 Liu  Consent Calendar Second Day  Regular Session",78,0,0,2,80
741390,475417,2015-09-01,Senate,"Special Consent #9 SB675 Liu",40,0,0,0,40
741391,446281,2015-05-12,Senate,"Do pass as amended",4,1,2,0,7
741391,453998,2015-05-28,Senate,"Senate 3rd Reading SB761 Hall",35,3,1,0,39
741391,464411,2015-06-30,Assembly,"Do pass",10,0,0,0,10
741391,466546,2015-07-16,Assembly,"SB 761 Hall  Senate Third Reading  By COOPER",77,0,0,3,80
741391,473830,2015-08-17,Senate,"Unfinished Business SB761 Hall Concurrence",38,0,2,0,40
741393,441538,2015-04-29,Assembly,"Do pass and be re-referred to the Committee on Local Government",6,0,0,1,7
741393,446268,2015-05-13,Assembly,"Do pass, to Consent Calendar",9,0,0,0,9
741393,450173,2015-05-22,Assembly,"AB 1403 MAIENSCHEIN  Consent Calendar Second Day  Regular Session",74,0,0,6,80
741393,460171,2015-06-16,Senate,"Do pass, but re-refer to the Committee on Governance and Finance 	Recommend Consent",11,0,0,0,11
741393,465802,2015-07-09,Senate,"Consent Calendar 2nd AB1403 Maienschein",39,0,1,0,40
741393,465869,2015-07-13,Assembly,"AB 1403 MAIENSCHEIN  Concurrence in Senate Amendments",79,0,0,1,80
741395,441071,2015-04-29,Senate,"Do pass as amended, and re-refer to the Committee on Appropriations",5,0,2,0,7
741395,463628,2015-05-18,Senate,"Placed on Appropriations Suspense file",7,0,0,0,7
741396,428764,2015-04-08,Senate,"Do pass, but re-refer to the Committee on Appropriations",4,1,0,0,5
741396,435450,2015-04-20,Senate,"Placed on Appropriations Suspense file",7,0,0,0,7
741396,453629,2015-05-28,Senate,"Do pass",5,2,0,0,7
741396,455561,2015-06-01,Senate,"Senate 3rd Reading SB599 Mendoza",23,14,3,0,40
741396,463034,2015-06-24,Assembly,"Do pass and be re-referred to the Committee on Appropriations",5,2,0,0,7
741396,474337,2015-08-27,Assembly,"Do pass",12,5,0,0,17
741396,475500,2015-09-01,Assembly,"SB 599 Mendoza  Senate Third Reading  By THURMOND",52,28,0,0,80
741397,441851,2015-04-28,Assembly,"Do pass as amended and be re-referred to the Committee on 	Appropriations",18,0,0,1,19
741397,453889,2015-05-28,Assembly,"Do pass",17,0,0,0,17
741397,455340,2015-06-01,Assembly,"AB 1305 BONTA  Assembly Third Reading",78,0,0,2,80
741397,464712,2015-07-01,Senate,"Do pass, but re-refer to the Committee on Appropriations",8,0,1,0,9
741397,473675,2015-08-17,Senate,"Placed on Appropriations Suspense file",7,0,0,0,7
741397,474677,2015-08-27,Senate,"Do pass",7,0,0,0,7
741397,476167,2015-09-09,Senate,"Assembly 3rd Reading AB1305 Bonta By Hernandez",40,0,0,0,40
741397,476436,2015-09-10,Assembly,"AB 1305 BONTA  Concurrence in Senate Amendments",78,1,0,1,80
741398,440223,2015-04-27,Assembly,"Be adopted and be re-referred to the Committee on Revenue and 	Taxation",10,5,0,1,16
741398,466024,2015-07-13,Assembly,"Be adopted and be re-referred to the Committee on Appropriations",5,3,0,1,9
741399,429006,2015-04-08,Senate,"Do pass as amended, and re-refer to the Committee on Appropriations",7,0,0,0,7
741399,442175,2015-04-30,Senate,"Senate 3rd Reading SB598 Hill",35,0,4,0,39
741399,461869,2015-06-22,Assembly,"Do pass as amended and be re-referred to the Committee on 	Appropriations",9,0,0,0,9
741399,465658,2015-07-08,Assembly,"Do pass, to Consent Calendar",14,0,0,3,17
741399,466497,2015-07-16,Assembly,"SB 598 Hill  Consent Calendar Second Day  Regular Session",79,0,0,1,80
741399,473988,2015-08-20,Senate,"Special Consent #6 SB598 Hill",38,0,2,0,40
741400,440342,2015-04-28,Assembly,"Do pass and be re-referred to the Committee on Appropriations to 	Consent Calendar",14,0,0,0,14
741400,443819,2015-05-06,Assembly,"Do pass, to Consent Calendar",17,0,0,0,17
741400,446746,2015-05-14,Assembly,"AB 1359 NAZARIAN  Consent Calendar Second Day  Regular Session",78,0,0,2,80
741400,460104,2015-06-15,Senate,"Do pass as amended, and re-refer to the Committee on Appropriations",9,0,0,0,9
741400,474014,2015-08-20,Senate,"Assembly 3rd Reading AB1359 Nazarian By Berryhill",38,0,2,0,40
741400,474146,2015-08-24,Assembly,"AB 1359 NAZARIAN  Concurrence in Senate Amendments",80,0,0,0,80
741403,437903,2015-04-23,Assembly,"Do pass",3,7,0,1,11
741404,437568,2015-04-22,Assembly,"Do pass and be re-referred to the Committee on Education",6,2,0,1,9
741404,441030,2015-04-28,Assembly,"Do pass and be re-referred to the Committee on Appropriations",8,3,0,2,13
741404,453018,2015-05-27,Assembly,"Do pass",12,5,0,0,17
741404,455461,2015-06-01,Assembly,"AB 1260 THURMOND  Assembly Third Reading",51,26,0,3,80
741405,441078,2015-04-28,Senate,"Do pass, but re-refer to the Committee on Appropriations",4,0,1,0,5
741405,445261,2015-05-11,Senate,"Placed on Appropriations Suspense file",7,0,0,0,7
741406,440360,2015-04-27,Assembly,"Do pass and be re-referred to the Committee on Appropriations",3,6,0,0,9
741409,429378,2015-04-08,Assembly,"Do pass and be re-referred to the Committee on Education",5,2,0,0,7
741409,441069,2015-04-28,Assembly,"Do pass and be re-referred to the Committee on Appropriations",4,7,0,2,13
741410,440547,2015-04-28,Senate,"Do pass as amended, and re-refer to the Committee on Appropriations",7,0,0,0,7
741410,453863,2015-05-28,Senate,"Do pass",7,0,0,0,7
741410,456017,2015-06-02,Senate,"Senate 3rd Reading SB722 Bates",40,0,0,0,40
741410,463715,2015-05-18,Senate,"Placed on Appropriations Suspense file",7,0,0,0,7
741410,465986,2015-07-14,Assembly,"Do pass and be re-referred to the Committee on Appropriations",5,1,0,1,7
741410,474317,2015-08-27,Assembly,"Do pass as amended",16,0,0,1,17
741410,475623,2015-09-02,Assembly,"SB 722 Bates  Senate Third Reading  By WAGNER",77,1,0,2,80
741410,475758,2015-09-03,Senate,"Unfinished Business SB722 Bates Concurrence",40,0,0,0,40
741411,446010,2015-05-12,Senate,"Do pass as amended",7,0,0,0,7
741411,450171,2015-05-22,Senate,"Special Consent #2 SB776 Block",38,0,1,0,39
741411,464490,2015-06-30,Assembly,"Subject matter be referred",4,2,0,1,7
741412,428601,2015-04-08,Senate,"Do pass as amended, but re-refer to the Committee on Appropriations 	Recommend Consent",8,0,0,0,8
741412,445144,2015-05-11,Senate,"Consent Calendar 2nd SB597 Huff",36,0,3,0,39
741412,464947,2015-07-01,Assembly,"Do pass and be re-referred to the Committee on Appropriations to 	Consent Calendar",6,0,0,1,7
741412,473899,2015-08-19,Assembly,"Do pass",17,0,0,0,17
741412,474352,2015-08-27,Assembly,"SB 597 Huff  Senate Third Reading  By MEDINA",78,0,0,2,80
741412,475470,2015-09-01,Senate,"Special Consent #9 SB597 Huff",40,0,0,0,40
741415,447685,2015-05-13,Assembly,"Do pass, to Consent Calendar",7,0,0,0,7
741415,450104,2015-05-22,Assembly,"AB 1452 HADLEY  Consent Calendar Second Day  Regular Session",74,0,0,6,80
741415,460717,2015-06-17,Senate,"Do pass and be placed on the Consent Calendar",8,0,1,0,9
741415,461836,2015-06-22,Senate,"Consent Calendar 2nd AB1452 Hadley",37,0,3,0,40
741416,443908,2015-05-06,Senate,"Do pass as amended, and re-refer to the Committee on Appropriations",5,0,2,0,7
741416,455986,2015-06-02,Senate,"Senate 3rd Reading SB710 Galgiani Urgency Clause",39,0,1,0,40
741416,550448,2016-06-01,Assembly,"Be referred to Committee on Business and Professions",11,0,0,0,11
741416,554639,2016-06-21,Assembly,"Do pass, to Consent Calendar",15,0,0,1,16
741416,556811,2016-06-30,Assembly,"SB 710 Galgiani  Consent Calendar Second Day",79,0,0,1,80
741416,559232,2016-08-11,Senate,"Special Consent SB710 Galgiani Urgency Clause Concurr",37,0,2,0,39
741417,436213,2015-04-21,Assembly,"Do pass and be re-referred to the Committee on Appropriations",11,2,0,1,14
741417,443929,2015-05-06,Assembly,"Do pass",12,5,0,0,17
741417,445136,2015-05-11,Assembly,"AB 1175 RIDLEY-THOMAS  Assembly Third Reading",51,26,0,3,80
741417,457902,2015-06-08,Senate,"Do pass, but re-refer to the Committee on Appropriations",6,0,3,0,9
741417,461876,2015-06-22,Senate,"Do pass",5,0,2,0,7
741417,465788,2015-07-09,Senate,"Assembly 3rd Reading AB1175 Ridley-Thomas By Hill",25,12,3,0,40
741418,440283,2015-04-28,Assembly,"Do pass and be re-referred to the Committee on Privacy and Consumer 	Protection",7,0,0,0,7
741418,443476,2015-05-05,Assembly,"Do pass",11,0,0,0,11
741418,446661,2015-05-14,Assembly,"AB 1310 GATTO  Assembly Third Reading",79,0,0,1,80
741418,464406,2015-06-30,Senate,"Do pass as amended, and re-refer to the Committee on Appropriations",7,0,0,0,7
741418,473775,2015-08-17,Senate,"Placed on Appropriations Suspense file",7,0,0,0,7
741418,474500,2015-08-27,Senate,"Do pass",7,0,0,0,7
741418,475649,2015-09-02,Senate,"Assembly 3rd Reading AB1310 Gatto By Cannella",40,0,0,0,40
741418,475778,2015-09-03,Assembly,"AB 1310 GATTO  Concurrence in Senate Amendments",79,0,0,1,80
741419,436061,2015-04-21,Senate,"Do pass, but re-refer to the Committee on Appropriations",8,2,1,0,11
741419,442971,2015-05-04,Senate,"Placed on Appropriations Suspense file",7,0,0,0,7
741419,454144,2015-05-28,Senate,"Do pass as amended",5,2,0,0,7
741419,456571,2015-06-03,Senate,"Senate 3rd Reading SB765 Wolk",23,17,0,0,40
741420,436012,2015-04-21,Assembly,"Do pass",11,0,0,0,11
741420,438093,2015-04-14,Assembly,"Do pass and be re-referred to the Committee on Privacy and Consumer 	Protection",16,0,0,3,19
741420,444453,2015-05-07,Assembly,"AB 1129 BURKE  Assembly Third Reading",77,0,0,3,80
741420,464754,2015-07-01,Senate,"Do pass, but re-refer to the Committee on Judiciary",8,0,1,0,9
741420,475264,2015-08-31,Senate,"Assembly 3rd Reading AB1129 Burke By Nguyen",40,0,0,0,40
741420,475445,2015-09-01,Assembly,"AB 1129 BURKE  Concurrence in Senate Amendments",79,0,0,1,80
741421,430780,2015-04-13,Assembly,"Be referred to Committee on Transportation",11,0,0,0,11
741421,440321,2015-04-27,Assembly,"Do pass and be re-referred to the Committee on Elections and 	Redistricting",10,5,0,1,16
741421,441135,2015-04-29,Assembly,"Do pass as amended and be re-referred to the Committee on 	Appropriations",5,2,0,0,7
741421,453980,2015-05-28,Assembly,"Do pass",12,5,0,0,17
741421,456057,2015-06-02,Assembly,"AB 1461 GONZALEZ  Assembly Third Reading",52,26,0,2,80
741421,464329,2015-06-30,Senate,"Do pass, but re-refer to the Committee on Transportation and 	Housing",3,1,1,0,5
741421,466079,2015-07-14,Senate,"Do pass, but re-refer to the Committee on Appropriations",8,3,0,0,11
741421,474067,2015-08-24,Senate,"Placed on Appropriations Suspense file",7,0,0,0,7
741421,474672,2015-08-27,Senate,"Do pass as amended",5,2,0,0,7
741421,476264,2015-09-10,Senate,"Assembly 3rd Reading AB1461 Gonzalez By Lara",25,15,0,0,40
741421,476516,2015-09-11,Assembly,"AB 1461 GONZALEZ  Concurrence in Senate Amendments",52,26,0,2,80
741427,436018,2015-04-21,Assembly,"Do pass",8,1,0,1,10
741427,438309,2015-04-23,Assembly,"AB 1141 CHAU  Assembly Third Reading",48,29,0,3,80
741427,461025,2015-06-16,Senate,"Do pass",7,0,0,0,7
741427,474147,2015-08-24,Senate,"Assembly 3rd Reading AB1141 Chau By Wieckowski",40,0,0,0,40
741427,474465,2015-08-27,Assembly,"AB 1141 CHAU  Concurrence in Senate Amendments",79,0,0,1,80
741429,485129,2016-01-05,Assembly,"Be referred to Committee on Transportation",11,0,0,0,11
741430,442351,2015-04-29,Assembly,"Do pass and be re-referred to the Committee on Appropriations",3,2,0,2,7
741430,463670,2015-04-29,Assembly,"Reconsideration granted",7,0,0,0,7
741431,432604,2015-04-13,Assembly,"Do pass and be re-referred to the Committee on Appropriations to 	Consent Calendar",16,0,0,0,16
741431,453988,2015-05-28,Assembly,"Do pass",17,0,0,0,17
741431,455368,2015-06-01,Assembly,"AB 1465 GORDON  Assembly Third Reading",78,0,0,2,80
741431,462148,2015-06-23,Senate,"Do pass, but re-refer to the Committee on Appropriations Recommend 	Consent",11,0,0,0,11
741431,465211,2015-07-06,Senate,"Placed on Appropriations Suspense file",7,0,0,0,7
741431,474498,2015-08-27,Senate,"Do pass",7,0,0,0,7
741431,476050,2015-09-08,Senate,"Assembly 3rd Reading AB1465 Gordon By Beall",39,0,1,0,40
741432,437348,2015-04-22,Senate,"Do pass, but re-refer to the Committee on Judiciary",7,0,1,0,8
741432,440462,2015-04-28,Senate,"Do pass as amended, but re-refer to the Committee on Appropriations 	Recommend Consent",6,0,1,0,7
741432,453842,2015-05-28,Senate,"Do pass",6,0,1,0,7
741432,455407,2015-06-01,Senate,"Senate 3rd Reading SB696 Roth",38,1,1,0,40
741432,463712,2015-05-18,Senate,"Placed on Appropriations Suspense file",7,0,0,0,7
741432,465607,2015-07-08,Assembly,"Do pass and be re-referred to the Committee on Appropriations",13,0,0,0,13
741432,466050,2015-07-14,Assembly,"Do pass as amended and be re-referred to the Committee on 	Appropriations",10,0,0,0,10
741432,474239,2015-08-27,Assembly,"Do pass as amended",17,0,0,0,17
741432,476036,2015-09-08,Assembly,"SB 696 Roth  Senate Third Reading  By COOLEY",78,0,0,2,80
741432,476326,2015-09-10,Senate,"Unfinished Business SB696 Roth Concurrence",39,0,1,0,40
741433,446192,2015-05-13,Assembly,"Do pass",5,2,0,2,9
741433,451465,2015-05-26,Assembly,"AB 1217 DALY  Assembly Third Reading",47,25,0,8,80
741433,556328,2016-06-29,Senate,"Do pass as amended",7,0,0,0,7
741433,559806,2016-08-15,Senate,"Assembly 3rd Reading AB1217 Daly By Hertzberg",24,12,3,0,39
741433,560460,2016-08-22,Assembly,"AB 1217 DALY  Concurrence in Senate Amendments",51,27,0,2,80
741434,437448,2015-04-22,Senate,"Do pass, but re-refer to the Committee on Appropriations",7,0,0,0,7
741434,445226,2015-05-11,Senate,"Placed on Appropriations Suspense file",7,0,0,0,7
741434,485061,2016-01-11,Senate,"Do pass, but re-refer to the Committee on Judiciary",8,0,1,0,9
741434,485062,2016-01-12,Senate,"Do pass, but re-refer to the Committee on Appropriations",5,1,1,0,7
741434,485581,2016-01-19,Senate,"Placed on Appropriations Suspense file",7,0,0,0,7
741434,486508,2016-01-21,Senate,"Do pass",6,1,0,0,7
741434,487962,2016-01-26,Senate,"Senate 3rd Reading SB661 Hill",35,3,2,0,40
741434,555162,2016-06-22,Assembly,"Do pass as amended and be re-referred to the Committee on 	Appropriations",10,2,0,3,15
741434,559386,2016-08-11,Assembly,"Do pass as amended",12,1,0,7,20
741434,560426,2016-08-19,Assembly,"SB 661 Hill  Senate Third Reading  Amendment  Set #1",73,0,0,7,80
741434,561621,2016-08-30,Assembly,"Do pass",12,1,0,2,15
741434,561843,2016-08-31,Assembly,"SB 661 Hill  Senate Third Reading  By SALAS",64,10,0,6,80
741434,561844,2016-08-31,Senate,"W/O REF. TO FILE SB661 Hill",35,3,1,0,39
741435,438364,2015-04-23,Assembly,"Be referred to Committee on Business and Professions",10,0,0,1,11
741435,484741,2016-01-12,Assembly,"Do pass as amended and be re-referred to the Committee on Judiciary",14,0,0,0,14
741435,485076,2016-01-15,Assembly,"Do pass and be re-referred to the Committee on Appropriations",9,0,0,1,10
741435,486497,2016-01-21,Assembly,"Do pass, to Consent Calendar",17,0,0,0,17
741435,488733,2016-01-27,Assembly,"AB 1386 LOW  Consent Calendar Second Day  Regular Session",78,0,0,1,79
741435,552069,2016-06-08,Senate,"Do pass, but re-refer to the Committee on Judiciary",7,0,2,0,9
741435,555013,2016-06-21,Senate,"Do pass as amended, and re-refer to the Committee on Appropriations",7,0,0,0,7
741435,558867,2016-08-01,Senate,"Placed on Appropriations Suspense file",7,0,0,0,7
741435,559777,2016-08-11,Senate,"Do pass",7,0,0,0,7
741435,559974,2016-08-16,Senate,"Assembly 3rd Reading AB1386 Low By Huff",38,0,1,0,39
741435,560491,2016-08-22,Assembly,"AB 1386 LOW  Concurrence in Senate Amendments",78,0,0,2,80
741437,441005,2015-04-28,Assembly,"Amend, and re-refer to the Committee on Health",12,1,0,6,19
741437,446138,2015-05-12,Assembly,"Do pass and be re-referred to the Committee on Revenue and Taxation",6,10,0,3,19
741439,441735,2015-04-28,Assembly,"Do pass and be re-referred to the Committee on Appropriations",12,0,0,1,13
741439,453078,2015-05-27,Assembly,"Do pass",17,0,0,0,17
741439,455475,2015-06-01,Assembly,"AB 1361 BURKE  Assembly Third Reading",80,0,0,0,80
741439,462574,2015-06-24,Senate,"Do pass, but re-refer to the Committee on Appropriations",8,0,1,0,9
741439,465155,2015-07-06,Senate,"Placed on Appropriations Suspense file",7,0,0,0,7
741439,474722,2015-08-27,Senate,"Do pass",7,0,0,0,7
741439,476196,2015-09-09,Senate,"Assembly 3rd Reading AB1361 Burke By Leyva",40,0,0,0,40
741440,432891,2015-04-15,Senate,"Do pass, but re-refer to the Committee on Appropriations",7,1,0,0,8
741440,442937,2015-05-04,Senate,"Do pass as amended",5,2,0,0,7
741440,445163,2015-05-11,Senate,"Senate 3rd Reading SB739 Pavley",23,11,5,0,39
741440,460727,2015-06-17,Assembly,"Do pass and be re-referred to the Committee on Appropriations",6,0,0,1,7
741440,559641,2016-08-10,Assembly,"Do pass",14,5,0,1,20
741440,561517,2016-08-29,Assembly,"SB 739 Pavley  Senate Third Reading  By O'DONNELL",51,26,0,3,80
741440,561740,2016-08-31,Senate,"Unfinished Business SB739 Pavley Concurrence",25,13,1,0,39
741441,448636,2015-05-18,Assembly,"Do pass and be re-referred to the Committee on Appropriations",9,0,0,0,9
741441,453742,2015-05-28,Assembly,"Do pass",17,0,0,0,17
741441,455376,2015-06-01,Assembly,"AB 1378 HOLDEN  Assembly Third Reading",80,0,0,0,80
741441,465708,2015-07-08,Senate,"Do pass, but re-refer to the Committee on Appropriations",7,0,0,0,7
741441,473772,2015-08-17,Senate,"Placed on Appropriations Suspense file",7,0,0,0,7
741441,474638,2015-08-27,Senate,"Do pass",7,0,0,0,7
741441,475532,2015-09-01,Senate,"Assembly 3rd Reading AB1378 Holden By Galgiani",40,0,0,0,40
741443,453798,2015-05-28,Senate,"Do pass",7,0,0,0,7
741443,455301,2015-06-01,Senate,"Senate 3rd Reading SB707 Wolk",23,12,5,0,40
741443,458598,2015-04-14,Senate,"Do pass, but re-refer to the Committee on Appropriations",4,2,0,1,7
741443,463547,2015-04-27,Senate,"Placed on Appropriations Suspense file",7,0,0,0,7
741443,465973,2015-07-14,Assembly,"Do pass and be re-referred to the Committee on Appropriations",5,2,0,0,7
741443,474264,2015-08-27,Assembly,"Do pass",12,5,0,0,17
741443,475399,2015-09-01,Assembly,"SB 707 Wolk  Senate Third Reading  By DODD",54,24,0,2,80
741443,475595,2015-09-02,Senate,"Unfinished Business SB707 Wolk Concurrence",24,15,1,0,40
741445,432562,2015-04-15,Senate,"Do pass as amended, and re-refer to the Committee on Appropriations",8,0,0,0,8
741445,442818,2015-05-04,Senate,"Placed on Appropriations Suspense file",7,0,0,0,7
741445,453757,2015-05-28,Senate,"Do pass",7,0,0,0,7
741445,455365,2015-06-01,Senate,"Senate 3rd Reading SB695 De Le",39,0,1,0,40
741445,464909,2015-07-01,Assembly,"Do pass and be re-referred to the Committee on Appropriations",6,0,0,1,7
741445,474453,2015-08-27,Assembly,"Do pass as amended",17,0,0,0,17
741445,475586,2015-09-02,Assembly,"SB 695 De Leon  Senate Third Reading  By CHAVEZ",78,1,0,1,80
741445,475866,2015-09-04,Senate,"Unfinished Business SB695 De Le",40,0,0,0,40
741446,474221,2015-08-25,Assembly,"From committee:  Be adopted.  To third reading",6,0,0,3,9
741446,476142,2015-09-09,Senate,"Assembly 3rd Reading ACR36 Gray By Nguyen",39,0,1,0,40
741447,440276,2015-04-27,Assembly,"Do pass as amended and be re-referred to the Committee on 	Appropriations",9,0,0,0,9
741447,446213,2015-05-13,Assembly,"Do pass, to Consent Calendar",17,0,0,0,17
741447,451566,2015-05-26,Assembly,"AB 1108 LOW  Assembly Third Reading",75,0,0,5,80
741447,552030,2016-06-08,Senate,"Do pass, but re-refer to the Committee on Appropriations",4,0,3,0,7
741448,440572,2015-04-28,Assembly,"Do pass and be re-referred to the Committee on Appropriations",7,0,0,0,7
741448,446120,2015-05-13,Assembly,"Do pass, to Consent Calendar",17,0,0,0,17
741448,451417,2015-05-26,Assembly,"AB 1435 ALEJO  Assembly Third Reading",73,2,0,5,80
741448,466347,2015-07-15,Senate,"Do pass as amended, and re-refer to the Committee on Appropriations",7,0,0,0,7
741449,429241,2015-04-08,Assembly,"Do pass as amended and be re-referred to the Committee on 	Appropriations",7,0,0,0,7
741451,437322,2015-04-22,Senate,"Do pass, but re-refer to the Committee on Appropriations Recommend 	Consent",9,0,0,0,9
741451,445205,2015-05-11,Senate,"Placed on Appropriations Suspense file",7,0,0,0,7
741451,453749,2015-05-28,Senate,"Do pass",7,0,0,0,7
741451,455343,2015-06-01,Senate,"Senate 3rd Reading SB708 Mendoza",38,0,2,0,40
741451,464935,2015-07-01,Assembly,"Amend, and do pass as amended and be re-referred to the Committee 	on Appropriations with the recommendation:  To Consent Calendar",6,0,0,1,7
741451,466352,2015-07-15,Assembly,"Do pass as amended, to Consent Calendar",16,0,0,1,17
741451,475396,2015-09-01,Assembly,"SB 708 Mendoza  Senate Third Reading  By O'DONNELL",79,0,0,1,80
741451,475609,2015-09-02,Senate,"Unfinished Business SB708 Mendoza Concurrence",40,0,0,0,40
741454,435681,2015-04-20,Assembly,"Do pass as amended and be re-referred to the Committee on 	Appropriations",7,0,0,2,9
741454,446294,2015-05-13,Assembly,"Do pass, to Consent Calendar",17,0,0,0,17
741454,450272,2015-05-22,Assembly,"AB 1277 BROUGH  Consent Calendar Second Day  Regular Session",74,0,0,6,80
741454,462632,2015-06-24,Senate,"Do pass, but re-refer to the Committee on Appropriations",7,0,0,0,7
741454,474169,2015-08-24,Senate,"Assembly 3rd Reading AB1277 Brough By Hertzberg",40,0,0,0,40
741461,442260,2015-04-30,Assembly,"Do pass and be re-referred to the Committee on Appropriations",11,0,0,0,11
741461,453799,2015-05-28,Assembly,"Do pass",17,0,0,0,17
741461,456084,2015-06-02,Assembly,"AB 1172 CHAU  Assembly Third Reading",78,0,0,2,80
741461,466089,2015-07-14,Senate,"Do pass, but re-refer to the Committee on Appropriations",13,0,0,0,13
741461,473753,2015-08-17,Senate,"Placed on Appropriations Suspense file",7,0,0,0,7
741461,474562,2015-08-27,Senate,"Do pass as amended",6,1,0,0,7
741462,436069,2015-04-21,Assembly,"Do pass and be re-referred to the Committee on Appropriations to 	Consent Calendar",10,0,0,0,10
741462,443883,2015-05-06,Assembly,"Do pass",16,0,0,1,17
741463,436701,2015-04-21,Assembly,"Do pass as amended and be re-referred to the Committee on 	Appropriations",7,0,0,0,7
741464,440035,2015-04-28,Senate,"Do pass as amended, and re-refer to the Committee on Appropriations",5,1,1,0,7
741464,453923,2015-05-28,Senate,"Do pass",5,2,0,0,7
741464,456045,2015-06-02,Senate,"Senate 3rd Reading SB682 Leno",24,14,2,0,40
741464,462122,2015-06-23,Assembly,"Do pass as amended and be re-referred to the Committee on 	Appropriations",7,3,0,0,10
741464,463634,2015-05-18,Senate,"Placed on Appropriations Suspense file",7,0,0,0,7
741464,474364,2015-08-27,Assembly,"Do pass as amended",12,5,0,0,17
741464,475600,2015-09-02,Assembly,"SB 682 Leno  Senate Third Reading",51,28,0,1,80
741464,475735,2015-09-03,Senate,"Unfinished Business SB682 Leno Concurrence",25,15,0,0,40
741466,437163,2015-04-21,Assembly,"Do pass as amended and be re-referred to the Committee on 	Appropriations",18,0,0,1,19
741466,453656,2015-05-28,Assembly,"Do pass as amended",12,5,0,0,17
741466,456676,2015-06-03,Assembly,"AB 1162 HOLDEN  Assembly Third Reading",67,12,0,1,80
741466,465804,2015-07-08,Senate,"Do pass as amended, and re-refer to the Committee on Appropriations",8,0,1,0,9
741466,473671,2015-08-17,Senate,"Placed on Appropriations Suspense file",7,0,0,0,7
741466,474533,2015-08-27,Senate,"Do pass as amended",6,1,0,0,7
741466,476165,2015-09-09,Senate,"Assembly 3rd Reading AB1162 Holden By Pan",30,10,0,0,40
741466,476320,2015-09-10,Assembly,"AB 1162 HOLDEN  Concurrence in Senate Amendments",67,12,0,1,80
741467,437492,2015-04-21,Senate,"Do pass, but re-refer to the Committee on Appropriations",7,0,0,0,7
741467,447676,2015-05-18,Senate,"Special Consent #1 SB651 Leyva",36,0,3,0,39
741467,460265,2015-06-16,Assembly,"Do pass as amended",7,0,0,0,7
741467,463829,2015-06-29,Assembly,"SB 651 Leyva  Senate Third Reading  By COOLEY",74,0,0,6,80
741467,465191,2015-07-06,Senate,"Special Consent #4 SB651 Leyva",39,0,1,0,40
741468,440429,2015-04-27,Assembly,"Do pass as amended and be re-referred to the Committee on 	Appropriations",9,0,0,0,9
741469,430565,2015-04-09,Assembly,"Be referred to Committee on Elections and Redistricting",11,0,0,0,11
741469,441652,2015-04-29,Assembly,"Do pass and be re-referred to the Committee on Appropriations",5,2,0,0,7
741469,446228,2015-05-13,Assembly,"Do pass",12,5,0,0,17
741469,451473,2015-05-26,Assembly,"AB 1100 LOW  Assembly Third Reading",46,28,0,6,80
741469,460549,2015-06-16,Senate,"Do pass as amended, and re-refer to the Committee on Appropriations",3,2,0,0,5
741469,463915,2015-06-29,Senate,"Do pass",5,1,1,0,7
741469,473665,2015-08-17,Senate,"Assembly 3rd Reading AB1100 Low By Lara",23,14,3,0,40
741469,474026,2015-08-20,Assembly,"AB 1100 LOW  Concurrence in Senate Amendments",48,31,0,1,80
741472,432717,2015-04-14,Assembly,"Do pass and be re-referred to the Committee on Judiciary",14,0,0,1,15
741472,440741,2015-04-28,Assembly,"Do pass as amended and be re-referred to the Committee on 	Appropriations",10,0,0,0,10
741472,446168,2015-05-13,Assembly,"Do pass",17,0,0,0,17
741472,451409,2015-05-26,Assembly,"AB 1390 ALEJO  Assembly Third Reading",76,0,0,4,80
741472,462468,2015-06-23,Senate,"Do pass, but re-refer to the Committee on Judiciary",8,0,1,0,9
741472,466263,2015-07-14,Senate,"Do pass as amended, and re-refer to the Committee on Appropriations",7,0,0,0,7
741472,474105,2015-08-24,Senate,"Placed on Appropriations Suspense file",7,0,0,0,7
741472,474492,2015-08-27,Senate,"Do pass as amended",5,1,1,0,7
741472,474493,2015-08-27,Senate,"Set, first hearing.  Held in Committee.  Reconsideration of 	favorable vote granted",7,0,0,0,7
741472,474494,2015-08-27,Senate,"Do pass as amended",6,0,1,0,7
741472,476164,2015-09-09,Senate,"Assembly 3rd Reading AB1390 Alejo By Pavley",40,0,0,0,40
741472,476401,2015-09-10,Assembly,"AB 1390 ALEJO  Concurrence in Senate Amendments",74,0,0,6,80
741473,440012,2015-04-28,Senate,"Do pass as amended, and re-refer to the Committee on Appropriations",6,1,0,0,7
741473,454061,2015-05-28,Senate,"Do pass as amended",5,1,1,0,7
741473,456661,2015-06-03,Senate,"Senate 3rd Reading SB759 Anderson",29,7,4,0,40
741473,463559,2015-05-18,Senate,"Placed on Appropriations Suspense file",7,0,0,0,7
741473,554716,2016-06-21,Assembly,"Do pass and be re-referred to the Committee on Appropriations",5,2,0,0,7
741473,556325,2016-06-29,Assembly,"Do pass",12,6,0,2,20
741473,559116,2016-08-04,Assembly,"SB 759 Anderson  Senate Third Reading  By QUIRK",41,31,0,8,80
741473,559278,2016-08-11,Senate,"Unfinished Business SB759 Anderson Concurrence",32,2,5,0,39
741476,440189,2015-04-27,Assembly,"Do pass and be re-referred to the Committee on Environmental Safety 	and Toxic Materials to Consent Calendar",9,0,0,0,9
741476,440190,2015-04-28,Assembly,"Do pass and be re-referred to the Committee on Appropriations to 	Consent Calendar",5,0,0,2,7
741476,446300,2015-05-13,Assembly,"Do pass, to Consent Calendar",17,0,0,0,17
741476,450076,2015-05-22,Assembly,"AB 1420 SALAS  Consent Calendar Second Day  Regular Session",74,0,0,6,80
741476,462284,2015-06-23,Senate,"Do pass as amended, and re-refer to the Committee on Environmental 	Quality",9,0,0,0,9
741476,466353,2015-07-15,Senate,"Do pass as amended, and re-refer to the Committee on Appropriations",7,0,0,0,7
741476,474111,2015-08-24,Senate,"Placed on Appropriations Suspense file",7,0,0,0,7
741476,474555,2015-08-27,Senate,"Do pass as amended",7,0,0,0,7
741476,476068,2015-09-09,Senate,"Assembly 3rd Reading AB1420 Salas By Jackson",40,0,0,0,40
741476,476400,2015-09-10,Assembly,"AB 1420 SALAS  Concurrence in Senate Amendments",80,0,0,0,80
741477,432512,2015-04-14,Assembly,"Do pass as amended",10,0,0,0,10
741477,442277,2015-04-30,Assembly,"AB 1146 JONES  Assembly Third Reading",77,0,0,3,80
741477,464816,2015-06-30,Senate,"Do pass as amended",7,0,0,0,7
741477,465863,2015-07-13,Senate,"Assembly 3rd Reading AB1146 Jones By Anderson",38,0,2,0,40
741477,466482,2015-07-16,Assembly,"AB 1146 JONES  Concurrence in Senate Amendments",78,0,0,2,80
741478,438054,2015-04-23,Assembly,"Be referred to Committee on Elections and Redistricting",10,0,0,1,11
741478,441574,2015-04-29,Assembly,"Amend, and do pass as amended and be re-referred to the Committee 	on Appropriations with the recommendation:  To Consent Calendar",7,0,0,0,7
741478,446218,2015-05-13,Assembly,"Do pass, to Consent Calendar",17,0,0,0,17
741478,450269,2015-05-22,Assembly,"AB 1492 LOW  Consent Calendar Second Day  Regular Session",74,0,0,6,80
741478,460205,2015-06-16,Senate,"Do pass, but re-refer to the Committee on Appropriations Recommend 	Consent",5,0,0,0,5
741478,466412,2015-07-14,Senate,"Do pass as amended, and re-refer to the Committee on Appropriations",7,0,0,0,7
741478,473714,2015-08-17,Senate,"Placed on Appropriations Suspense file",7,0,0,0,7
741478,474680,2015-08-27,Senate,"Do pass as amended",6,0,1,0,7
741478,476346,2015-09-10,Senate,"Assembly 3rd Reading AB1492 Gatto By Hancock Reconsider",40,0,0,0,40
741478,476533,2015-09-11,Assembly,"AB 1492 GATTO  Concurrence in Senate Amendments",76,1,0,3,80
741478,476862,2015-09-10,Senate,"Assembly 3rd Reading AB1492 Gatto By Hancock",38,0,2,0,40
741478,476863,2015-09-10,Senate,"Assembly 3rd Reading AB1492 Gatto By Hancock Reconsider",40,0,0,0,40
741479,441229,2015-04-29,Assembly,"Do pass and be re-referred to the Committee on Appropriations",9,0,0,0,9
741480,441217,2015-04-29,Senate,"Do pass as amended, and re-refer to the Committee on Appropriations",6,0,1,0,7
741480,453965,2015-05-28,Senate,"Do pass",7,0,0,0,7
741480,456033,2015-06-02,Senate,"Senate 3rd Reading SB736 Vidak",40,0,0,0,40
741480,463701,2015-05-18,Senate,"Placed on Appropriations Suspense file",7,0,0,0,7
741483,440052,2015-04-28,Assembly,"Do pass as amended and be re-referred to the Committee on 	Appropriations",10,0,0,0,10
741483,452914,2015-05-27,Assembly,"Do pass, to Consent Calendar",17,0,0,0,17
741483,456009,2015-06-02,Assembly,"AB 1407 ATKINS  Consent Calendar Second Day  Regular Session",78,0,0,2,80
741483,464859,2015-06-30,Senate,"Do pass as amended, but re-refer to the Committee on Appropriations 	Recommend Consent",7,0,0,0,7
741483,474025,2015-08-20,Senate,"Consent Calendar 2nd AB1407 Atkins",38,0,2,0,40
741483,474098,2015-08-24,Assembly,"AB 1407 ATKINS  Concurrence in Senate Amendments",79,0,0,1,80
741486,428730,2015-04-08,Senate,"Do pass as amended, and re-refer to the Committee on Appropriations",6,2,0,0,8
741486,447657,2015-05-18,Senate,"Senate 3rd Reading SB705 Hill",21,13,5,0,39
741486,460682,2015-06-17,Assembly,"Do pass and be re-referred to the Committee on Appropriations",5,2,0,0,7
741486,473858,2015-08-19,Assembly,"Do pass",12,5,0,0,17
741486,475825,2015-09-03,Assembly,"SB 705 Hill  Senate Third Reading  Amend By MULLIN  Set #1",50,28,0,2,80
741486,475982,2015-09-08,Assembly,"Do pass",5,3,0,1,9
741486,476398,2015-09-10,Assembly,"SB 705 Hill  Senate Third Reading  By MULLIN",51,29,0,0,80
741486,476575,2015-09-11,Senate,"From committee:  That the Assembly Amendments be concurred in",7,2,2,0,11
741486,476576,2015-09-11,Senate,"Unfinished Business (S upplemental File 1)SB7 05 Hil l Con",25,14,1,0,40
741487,441206,2015-04-29,Senate,"Do pass, but re-refer to the Committee on Appropriations",7,0,0,0,7
741487,463639,2015-05-18,Senate,"Placed on Appropriations Suspense file",7,0,0,0,7
741489,441990,2015-04-28,Assembly,"Amend, and do pass as amended and be re-referred to the Committee 	on Appropriations with the recommendation:  To Consent Calendar",7,0,0,0,7
741489,448986,2015-05-20,Assembly,"Do pass, to Consent Calendar",15,0,0,2,17
741489,451662,2015-05-26,Assembly,"AB 1436 BURKE  Consent Calendar Second Day  Regular Session",76,0,0,4,80
741489,462221,2015-06-23,Senate,"Do pass, but re-refer to the Committee on Appropriations Recommend 	Consent",5,0,0,0,5
741489,465214,2015-07-06,Senate,"Placed on Appropriations Suspense file",7,0,0,0,7
741489,474634,2015-08-27,Senate,"Do pass as amended",7,0,0,0,7
741489,476257,2015-09-10,Senate,"Assembly 3rd Reading AB1436 Burke By McGuire",40,0,0,0,40
741489,476618,2015-09-11,Assembly,"AB 1436 BURKE  Concurrence in Senate Amendments",78,0,0,2,80
741490,437269,2015-04-21,Senate,"Do pass, but re-refer to the Committee on Judiciary",3,0,2,0,5
741490,440337,2015-04-28,Senate,"Do pass, but re-refer to the Committee on Appropriations",5,1,1,0,7
741490,445354,2015-05-11,Senate,"Placed on Appropriations Suspense file",7,0,0,0,7
741490,453713,2015-05-28,Senate,"Do pass",5,1,1,0,7
741490,455350,2015-06-01,Senate,"Senate 3rd Reading SB731 Leno",28,5,7,0,40
741490,466325,2015-07-14,Assembly,"Do pass and be re-referred to the Committee on Appropriations",7,0,0,0,7
741490,474224,2015-08-26,Assembly,"Do pass",12,1,0,4,17
741490,475695,2015-09-02,Assembly,"SB 731 Leno  Senate Third Reading  By CHU",60,1,0,19,80
741490,475810,2015-09-03,Senate,"Unfinished Business SB731 Leno Concurrence",27,10,3,0,40
741491,443401,2015-05-05,Assembly,"Do pass as amended and be re-referred to the Committee on Housing 	and Community Development",6,3,0,1,10
741491,446232,2015-05-13,Assembly,"Do pass as amended",5,2,0,0,7
741491,450151,2015-05-22,Assembly,"AB 1448 LOPEZ  Assembly Third Reading",52,18,0,10,80
741491,462208,2015-06-23,Senate,"Do pass, but re-refer to the Committee on Judiciary",8,1,2,0,11
741491,465672,2015-07-07,Senate,"Do pass as amended",6,0,1,0,7
741491,476128,2015-09-09,Senate,"Assembly 3rd Reading AB1448 Lopez By Leno",35,4,1,0,40
741491,476290,2015-09-10,Assembly,"AB 1448 LOPEZ  Concurrence in Senate Amendments",53,22,0,5,80
741494,483873,2016-01-06,Assembly,"Do pass as amended and be re-referred to the Committee on 	Appropriations",18,1,0,2,21
741494,486283,2016-01-21,Assembly,"Do pass",15,0,0,2,17
741494,488381,2016-01-27,Assembly,"AB 1437 GRAY  Assembly Third Reading",68,1,0,10,79
741495,441543,2015-04-28,Assembly,"Do pass and be re-referred to the Committee on Appropriations",11,0,0,2,13
741495,454209,2015-05-28,Assembly,"Do pass as amended",12,0,0,5,17
741495,456607,2015-06-03,Assembly,"AB 1370 MEDINA  Assembly Third Reading",78,0,0,2,80
741500,446186,2015-05-13,Assembly,"Do pass as amended",9,0,0,0,9
741500,450100,2015-05-22,Assembly,"AB 1077 HOLDEN  Assembly Third Reading",75,0,0,5,80
741500,460623,2015-06-17,Senate,"Do pass as amended, and re-refer to the Committee on Appropriations",6,0,1,0,7
741500,475641,2015-09-02,Senate,"Assembly 3rd Reading AB1077 Holden By Hertzberg",40,0,0,0,40
741500,475739,2015-09-03,Assembly,"AB 1077 HOLDEN  Concurrence in Senate Amendments",80,0,0,0,80
741501,436091,2015-04-20,Assembly,"Do pass and be re-referred to the Committee on Judiciary",5,10,0,1,16
741501,463721,2015-04-20,Assembly,"Reconsideration granted",15,0,0,1,16
741502,439963,2015-04-28,Senate,"Do pass, but re-refer to the Committee on Appropriations",6,1,0,0,7
741506,441762,2015-04-28,Assembly,"Do pass as amended and be re-referred to the Committee on 	Appropriations",12,1,0,0,13
741506,454276,2015-05-28,Assembly,"Do pass as amended",12,1,0,4,17
741506,456560,2015-06-03,Assembly,"AB 1091 GARCIA, E.  Assembly Third Reading",77,2,0,1,80
741506,466303,2015-07-15,Senate,"Do pass, but re-refer to the Committee on Appropriations",9,0,0,0,9
741506,473688,2015-08-17,Senate,"Placed on Appropriations Suspense file",7,0,0,0,7
741506,474565,2015-08-27,Senate,"Do pass",7,0,0,0,7
741506,475763,2015-09-03,Senate,"Assembly 3rd Reading AB1091 Eduardo Garcia By Block",40,0,0,0,40
741509,438144,2015-04-22,Assembly,"Do pass and be re-referred to the Committee on Appropriations",7,0,0,0,7
741509,453725,2015-05-28,Assembly,"Do pass as amended",17,0,0,0,17
741509,456014,2015-06-02,Assembly,"AB 1383 JONES  Assembly Third Reading",77,0,0,3,80
741509,555025,2016-06-21,Senate,"Do pass, but re-refer to the Committee on Appropriations",3,3,1,0,7
741509,555026,2016-06-21,Senate,"Set, first hearing.  Failed passage in Committee.  Reconsideration 	granted",7,0,0,0,7
741510,437228,2015-04-22,Senate,"Do pass as amended, and re-refer to the Committee on Appropriations",8,0,1,0,9
741510,445109,2015-05-11,Senate,"Placed on Appropriations Suspense file",7,0,0,0,7
741510,453619,2015-05-28,Senate,"Do pass",7,0,0,0,7
741510,455314,2015-06-01,Senate,"Senate 3rd Reading SB610 Pan",39,0,1,0,40
741510,464673,2015-06-30,Assembly,"Do pass as amended and be re-referred to the Committee on 	Appropriations",18,0,0,1,19
741510,474404,2015-08-27,Assembly,"Do pass",17,0,0,0,17
741510,476240,2015-09-10,Assembly,"SB 610 Pan  Senate Third Reading  By BONTA",80,0,0,0,80
741510,476526,2015-09-11,Senate,"Unfinished Business SB610 Pan Concurrence",40,0,0,0,40
741512,432928,2015-04-14,Senate,"Do pass, but re-refer to the Committee on Rules",6,2,1,0,9
741512,441282,2015-04-29,Senate,"Do pass as amended, and re-refer to the Committee on Appropriations",6,1,0,0,7
741512,463743,2015-05-18,Senate,"Placed on Appropriations Suspense file",7,0,0,0,7
741514,484684,2016-01-11,Assembly,"Do pass as amended and be re-referred to the Committee on 	Appropriations",16,0,0,0,16
741514,486412,2016-01-21,Assembly,"Do pass, to Consent Calendar",17,0,0,0,17
741514,488663,2016-01-27,Assembly,"AB 1115 SALAS  Consent Calendar Second Day  Regular Session",78,0,0,1,79
741514,552952,2016-06-14,Senate,"Do pass, but re-refer to the Committee on Appropriations Recommend 	Consent",11,0,0,0,11
741514,559500,2016-08-11,Senate,"Consent Calendar 2nd AB1115 Salas",37,0,2,0,39
741516,432825,2015-04-15,Senate,"Do pass, but re-refer to the Committee on Appropriations",1,0,6,0,7
741518,433122,2015-04-14,Assembly,"Do pass and be re-referred to the Committee on Appropriations",5,2,0,0,7
741518,449068,2015-05-20,Assembly,"Do pass",11,4,0,2,17
741518,454171,2015-05-28,Assembly,"AB 1075 ALEJO  Assembly Third Reading",45,28,0,7,80
741518,466201,2015-07-15,Senate,"Do pass, but re-refer to the Committee on Appropriations",5,0,2,0,7
741518,473793,2015-08-17,Senate,"Placed on Appropriations Suspense file",7,0,0,0,7
741518,474673,2015-08-27,Senate,"Do pass as amended",5,2,0,0,7
741518,475967,2015-09-08,Senate,"Assembly 3rd Reading AB1075 Alejo By Lara",24,15,1,0,40
741518,476119,2015-09-09,Assembly,"AB 1075 ALEJO  Concurrence in Senate Amendments",54,25,0,1,80
741519,428354,2015-04-08,Senate,"Do pass, but re-refer to the Committee on Governance and Finance 	Recommend Consent",7,0,1,0,8
741519,441553,2015-04-29,Senate,"Do pass, but re-refer to the Committee on Appropriations Recommend 	Consent",6,0,1,0,7
741519,452015,2015-05-26,Senate,"Do pass",7,0,0,0,7
741519,454418,2015-05-28,Senate,"Senate 3rd Reading SB602 Monning",38,0,2,0,40
741519,462614,2015-06-24,Assembly,"Do pass and be re-referred to the Committee on Local Government",13,0,0,0,13
741519,466485,2015-07-15,Assembly,"Do pass as amended and be re-referred to the Committee on 	Appropriations",5,2,0,2,9
741522,437199,2015-04-22,Assembly,"Do pass and be re-referred to the Committee on Appropriations",6,1,0,0,7
741522,454088,2015-05-28,Assembly,"Do pass",12,5,0,0,17
741522,456143,2015-06-02,Assembly,"AB 1293 HOLDEN  Assembly Third Reading",53,24,0,3,80
741522,465924,2015-07-13,Senate,"Do pass, but re-refer to the Committee on Appropriations",3,2,0,0,5
741522,473811,2015-08-17,Senate,"Placed on Appropriations Suspense file",7,0,0,0,7
741522,474574,2015-08-27,Senate,"Do pass",5,2,0,0,7
741522,475645,2015-09-02,Senate,"Assembly 3rd Reading AB1293 Holden By Pan",25,15,0,0,40
741524,443697,2015-05-05,Assembly,"Do pass and be re-referred to the Committee on Natural Resources",6,1,0,0,7
741526,440779,2015-04-27,Assembly,"Do pass as amended and be re-referred to the Committee on 	Appropriations",6,3,0,0,9
741526,446285,2015-05-13,Assembly,"Do pass",12,5,0,0,17
741526,450137,2015-05-22,Assembly,"AB 1157 NAZARIAN  Assembly Third Reading",49,25,0,6,80
741526,466413,2015-07-15,Senate,"Do pass, but re-refer to the Committee on Appropriations",6,0,1,0,7
741526,473610,2015-08-17,Senate,"Placed on Appropriations Suspense file",7,0,0,0,7
741526,474683,2015-08-27,Senate,"Do pass",7,0,0,0,7
741526,476440,2015-09-10,Senate,"Assembly 3rd Reading AB1157 Nazarian By Hill",39,0,1,0,40
741528,439974,2015-04-27,Assembly,"Do pass and be re-referred to the Committee on Appropriations",15,1,0,0,16
741528,453808,2015-05-28,Assembly,"Do pass as amended",13,0,0,4,17
741528,456609,2015-06-03,Assembly,"AB 1176 PEREA  Third Reading Urgency",78,0,0,2,80
741528,464408,2015-06-30,Senate,"Do pass as amended, and re-refer to the Committee on Environmental 	Quality",10,0,1,0,11
741528,466304,2015-07-15,Senate,"Do pass as amended, and re-refer to the Committee on Appropriations",7,0,0,0,7
741528,474134,2015-08-24,Senate,"Placed on Appropriations Suspense file",7,0,0,0,7
741528,544300,2016-05-10,Senate,"Do pass, but re-refer to the Committee on Appropriations",6,1,0,0,7
741528,545765,2016-05-16,Senate,"Placed on Appropriations Suspense file",2,4,1,0,7
741528,545766,2016-05-16,Senate,"Do pass",7,0,0,0,7
741528,547033,2016-05-19,Senate,"Assembly 3rd Reading AB1176 Cooper By Hall",37,2,1,0,40
741528,556717,2016-06-30,Senate,"W/O REF. TO FILE AB1176 Cooper By McGuire",34,1,5,0,40
741528,556718,2016-06-30,Assembly,"AB 1176 COOPER  Concurrence in Senate Amendments",77,0,0,3,80
741529,437197,2015-04-21,Assembly,"Do pass and be re-referred to the Committee on Appropriations",7,11,0,1,19
741530,432670,2015-04-15,Senate,"Do pass, but re-refer to the Committee on Appropriations",7,0,1,0,8
741530,442850,2015-05-04,Senate,"Placed on Appropriations Suspense file",7,0,0,0,7
741531,440348,2015-04-27,Assembly,"Do pass as amended and be re-referred to the Committee on 	Appropriations",10,4,0,2,16
741531,454011,2015-05-28,Assembly,"Do pass",12,5,0,0,17
741531,456147,2015-06-02,Assembly,"AB 1287 CHIU  Assembly Third Reading",29,36,0,15,80
741531,457233,2015-06-04,Assembly,"AB 1287 CHIU  Assembly Third Reading",49,29,0,2,80
741531,464413,2015-06-30,Senate,"Do pass, but re-refer to the Committee on Judiciary",10,0,1,0,11
741531,466330,2015-07-14,Senate,"Do pass",7,0,0,0,7
741531,476034,2015-09-08,Senate,"Assembly 3rd Reading AB1287 Chiu By Leno",40,0,0,0,40
741531,476088,2015-09-09,Assembly,"AB 1287 CHIU  Concurrence in Senate Amendments",69,9,0,2,80
741532,441044,2015-04-28,Assembly,"Do pass as amended and be re-referred to the Committee on 	Appropriations",9,6,0,4,19
741534,442165,2015-04-30,Assembly,"Do pass and be re-referred to the Committee on Appropriations",20,0,0,1,21
741534,448951,2015-05-20,Assembly,"Do pass, to Consent Calendar",15,0,0,2,17
741534,451860,2015-05-26,Assembly,"AB 1320 MAIENSCHEIN  Consent Calendar Second Day  Regular Session",76,0,0,4,80
741534,463929,2015-06-29,Senate,"Do pass, but re-refer to the Committee on Appropriations",12,0,1,0,13
741534,474075,2015-08-24,Senate,"Assembly 3rd Reading AB1320 Maienschein By Wolk",39,0,1,0,40
741534,476134,2015-09-09,Senate,"Assembly 3rd Reading AB1320 Maienschein By Wolk",40,0,0,0,40
741534,476297,2015-09-10,Assembly,"AB 1320 MAIENSCHEIN  Concurrence- Urgency Added",79,0,0,1,80
741536,445765,2015-05-12,Senate,"Do pass, but re-refer to the Committee on Appropriations",9,0,2,0,11
741536,451561,2015-05-26,Senate,"Placed on Appropriations Suspense file",7,0,0,0,7
741538,443624,2015-05-06,Assembly,"Do pass",8,2,0,3,13
741538,457232,2015-06-04,Assembly,"AB 1451 CHAVEZ  Assembly Third Reading",65,7,0,8,80
741538,462615,2015-06-24,Senate,"Do pass",5,0,0,0,5
741538,465891,2015-07-13,Senate,"Assembly 3rd Reading AB1451 Ch",33,6,1,0,40
741539,436167,2015-04-21,Senate,"Do pass, but re-refer to the Committee on Appropriations",11,0,0,0,11
741539,442853,2015-05-04,Senate,"Do pass",7,0,0,0,7
741539,445284,2015-05-11,Senate,"Senate 3rd Reading SB697 Hertzberg",36,0,3,0,39
741539,466350,2015-07-06,Assembly,"Do pass as amended and be re-referred to the Committee on Judiciary",13,0,0,2,15
741539,473895,2015-08-19,Assembly,"Do pass, to Consent Calendar",17,0,0,0,17
741539,476064,2015-09-09,Assembly,"SB 697 Hertzberg  Senate Third Reading  By TING",78,0,0,2,80
741539,476291,2015-09-10,Senate,"Unfinished Business SB697 Hertzberg Concurrence",40,0,0,0,40
741540,484008,2016-01-06,Assembly,"Do pass as amended and be re-referred to the Committee on 	Appropriations",7,0,0,0,7
741540,486544,2016-01-21,Assembly,"Do pass, to Consent Calendar",17,0,0,0,17
741540,488546,2016-01-27,Assembly,"AB 1311 COOPER  Consent Calendar Second Day  Regular Session",78,0,0,1,79
741540,552145,2016-06-08,Senate,"Do pass, but re-refer to the Committee on Appropriations Recommend 	Consent",4,0,1,0,5
741540,556873,2016-06-30,Senate,"Consent Calendar 2nd AB1311 Cooper Urgency Clause",37,0,3,0,40
741541,437346,2015-04-22,Senate,"Do pass as amended, and re-refer to the Committee on Appropriations",5,0,2,0,7
741541,447822,2015-05-18,Senate,"Senate 3rd Reading SB762 Wolk",24,12,3,0,39
741541,466555,2015-07-15,Assembly,"Do pass as amended and be re-referred to the Committee on 	Appropriations",6,3,0,0,9
741541,473898,2015-08-19,Assembly,"Do pass",13,4,0,0,17
741541,476013,2015-09-08,Assembly,"SB 762 Wolk  Senate Third Reading  By RIDLEY-THOMAS",53,25,0,2,80
741541,476289,2015-09-10,Senate,"Unfinished Business SB762 Wolk Concurrence",28,12,0,0,40
741543,445220,2015-05-11,Assembly,"Do pass as amended",6,1,0,2,9
741543,452041,2015-05-26,Assembly,"AB 1103 DODD  Assembly Third Reading",54,14,0,12,80
741543,553234,2016-06-15,Senate,"Do pass, but re-refer to the Committee on Appropriations",7,0,0,0,7
741543,559903,2016-08-15,Senate,"Assembly 3rd Reading AB1103 Dodd By Wieckowski",33,5,1,0,39
741543,561061,2016-08-24,Assembly,"Senate amendments be concurred in",8,0,0,1,9
741543,561252,2016-08-25,Assembly,"AB 1103 DODD  Concurrence in Senate Amendments",72,1,0,7,80
741544,440364,2015-04-27,Assembly,"Do pass and be re-referred to the Committee on Appropriations",14,0,0,1,15
741544,454382,2015-05-28,Assembly,"Do pass",17,0,0,0,17
741544,455464,2015-06-01,Assembly,"AB 1453 RENDON  Assembly Third Reading",80,0,0,0,80
741544,559328,2016-08-11,Senate,"Do pass, but re-refer to the Committee on Appropriations",8,0,1,0,9
741547,444081,2015-05-06,Assembly,"Do pass, to Consent Calendar",18,0,0,3,21
741547,446619,2015-05-14,Assembly,"AB 1282 GRAY  Consent Calendar Second Day  Regular Session",78,0,0,2,80
741547,464001,2015-06-29,Senate,"Do pass and be placed on the Consent Calendar",12,0,1,0,13
741547,560044,2016-08-17,Senate,"Assembly 3rd Reading AB1282 Gray By Hall Urgency Clause",39,0,0,0,39
741547,560836,2016-08-23,Assembly,"AB 1282 GRAY  Concurrence- Urgency Added",77,1,0,2,80
741549,440322,2015-04-27,Assembly,"Do pass and be re-referred to the Committee on Appropriations to 	Consent Calendar",12,0,0,0,12
741549,443840,2015-05-06,Assembly,"Do pass, to Consent Calendar",17,0,0,0,17
741549,446720,2015-05-14,Assembly,"AB 1113 CHAU  Consent Calendar Second Day  Regular Session",78,0,0,2,80
741549,460928,2015-06-17,Senate,"Do pass, but re-refer to the Committee on Appropriations Recommend 	Consent",7,0,0,0,7
741549,464930,2015-07-02,Senate,"Consent Calendar 2nd AB1113 Chau",38,0,2,0,40
741552,435981,2015-04-21,Assembly,"Do pass and be re-referred to the Committee on Appropriations to 	Consent Calendar",14,0,0,0,14
741552,443881,2015-05-06,Assembly,"Do pass, to Consent Calendar",17,0,0,0,17
741552,446768,2015-05-14,Assembly,"AB 1107 IRWIN  Consent Calendar Second Day  Regular Session",78,0,0,2,80
741552,459775,2015-06-15,Senate,"Do pass, but re-refer to the Committee on Judiciary Recommend 	Consent",9,0,0,0,9
741552,465714,2015-07-07,Senate,"Do pass, but re-refer to the Committee on Appropriations Recommend 	Consent",6,0,1,0,7
741552,473969,2015-08-20,Senate,"Consent Calendar 2nd AB1107 Irwin",38,0,2,0,40
741554,428609,2015-04-08,Assembly,"Do pass and be re-referred to the Committee on Appropriations to 	Consent Calendar",21,0,0,0,21
741554,433974,2015-04-15,Assembly,"Do pass, to Consent Calendar",16,0,0,1,17
741554,438342,2015-04-23,Assembly,"AB 1303 GRAY  Consent Calendar Second Day  Regular Session",78,0,0,2,80
741554,466281,2015-07-15,Senate,"Do pass as amended, and re-refer to the Committee on Appropriations",5,0,2,0,7
741554,475269,2015-08-31,Senate,"Assembly 3rd Reading AB1303 Gray By Cannella",40,0,0,0,40
741554,475916,2015-09-08,Assembly,"Senate amendments be concurred in",7,0,0,2,9
741554,476101,2015-09-09,Assembly,"AB 1303 GRAY  Concurrence- Urgency Added",79,0,0,1,80
741555,434363,2015-04-15,Senate,"Do pass, but re-refer to the Committee on Appropriations",9,0,0,0,9
741555,453700,2015-05-28,Senate,"Do pass",7,0,0,0,7
741555,455338,2015-06-01,Senate,"Senate 3rd Reading SB614 Leno",40,0,0,0,40
741555,463579,2015-04-27,Senate,"Placed on Appropriations Suspense file",7,0,0,0,7
741555,466053,2015-07-14,Assembly,"Do pass as amended and be re-referred to the Committee on 	Appropriations",18,0,0,1,19
741555,474415,2015-08-27,Assembly,"Do pass as amended",12,0,0,5,17
741555,560732,2016-08-23,Assembly,"Do pass",6,0,0,0,6
741555,561185,2016-08-25,Assembly,,79,0,0,1,80
741555,561376,2016-08-29,Senate,"From committee:  That the Assembly Amendments be concurred in",7,0,0,0,7
741555,561576,2016-08-30,Senate,"Unfinished Business SB614 Hertzberg Concurrence",39,0,0,0,39
741558,432785,2015-04-13,Assembly,"Do pass and be re-referred to the Committee on Appropriations",15,0,0,1,16
741560,440375,2015-04-28,Senate,"Do pass, but re-refer to the Committee on Appropriations Recommend 	Consent",10,0,1,0,11
741560,445099,2015-05-11,Senate,"Placed on Appropriations Suspense file",7,0,0,0,7
741560,454035,2015-05-28,Senate,"Do pass as amended",7,0,0,0,7
741560,456068,2015-06-02,Senate,"Senate 3rd Reading SB773 Allen",40,0,0,0,40
741560,552436,2016-06-13,Assembly,"Amend, and do pass as amended and be re-referred to the Committee 	on Appropriations with the recommendation:  To Consent Calendar",15,0,0,1,16
741560,559222,2016-08-11,Assembly,"Do pass",20,0,0,0,20
741560,560988,2016-08-24,Assembly,"SB 773 Allen  Senate Third Reading  By DODD",79,0,0,1,80
741560,561331,2016-08-26,Senate,"Unfinished Business SB773 Allen Concurrence",39,0,0,0,39
741564,438307,2015-04-22,Assembly,"Do pass as amended and be re-referred to the Committee on 	Appropriations",5,2,0,0,7
741564,449346,2015-05-20,Assembly,"Do pass",11,4,0,2,17
741564,450215,2015-05-22,Assembly,"AB 1431 GOMEZ  Assembly Third Reading",50,25,0,5,80
741564,460660,2015-06-17,Senate,"Do pass as amended, and re-refer to the Committee on Appropriations",6,2,1,0,9
741564,465953,2015-07-13,Senate,"Do pass as amended",5,2,0,0,7
741564,475575,2015-09-02,Senate,"Assembly 3rd Reading AB1431 Gomez By Lara",26,13,1,0,40
741564,475833,2015-09-04,Assembly,"AB 1431 GOMEZ  Concurrence in Senate Amendments",53,27,0,0,80
741564,476864,2015-09-02,Senate,"Assembly 3rd Reading AB1431 Gomez By Lara Reconsider",36,0,4,0,40
741564,476865,2015-09-02,Senate,"Assembly 3rd Reading AB1431 Gomez By Lara",23,14,3,0,40
741565,433010,2015-04-14,Assembly,"Do pass and be re-referred to the Committee on Transportation",7,0,0,0,7
741565,436179,2015-04-20,Assembly,"Do pass and be re-referred to the Committee on Appropriations to 	Consent Calendar",15,0,0,1,16
741565,441566,2015-04-29,Assembly,"Do pass, to Consent Calendar",17,0,0,0,17
741565,444473,2015-05-07,Assembly,"AB 1312 O'DONNELL  Consent Calendar Second Day  Regular Session",77,0,0,3,80
741565,458480,2015-06-09,Senate,"Do pass, but re-refer to the Committee on Environmental Quality",9,0,0,0,9
741565,464730,2015-07-01,Senate,"Do pass, but re-refer to the Committee on Appropriations",6,0,1,0,7
741565,474142,2015-08-24,Senate,"Assembly 3rd Reading AB1312 O'Donnell By Hill",40,0,0,0,40
741566,440443,2015-04-28,Senate,"Do pass, but re-refer to the Committee on Appropriations",7,0,0,0,7
741566,455564,2015-06-01,Senate,"Senate 3rd Reading SB690 Stone",40,0,0,0,40
741566,555262,2016-06-23,Assembly,"Be referred to Committee on Revenue and Taxation",11,0,0,0,11
741566,559011,2016-08-01,Assembly,"Do pass as amended and be re-referred to the Committee on 	Appropriations",8,0,0,1,9
741567,437950,2015-04-14,Assembly,"Do pass as amended and be re-referred to the Committee on Insurance",17,0,0,2,19
741567,443533,2015-05-06,Assembly,"Do pass as amended",12,0,0,1,13
741567,450271,2015-05-22,Assembly,"AB 1163 RODRIGUEZ  Assembly Third Reading",75,0,0,5,80
741567,475625,2015-09-02,Senate,"Assembly 3rd Reading AB1163 Rodriguez By Pan",40,0,0,0,40
741567,475764,2015-09-03,Assembly,"AB 1163 RODRIGUEZ  Concurrence in Senate Amendments",78,0,0,2,80
741568,439970,2015-04-27,Assembly,"Do pass, to Consent Calendar",12,0,0,0,12
741568,442819,2015-05-04,Assembly,"AB 1471 PEREA  Consent Calendar Second Day",78,0,0,2,80
741568,461118,2015-06-17,Senate,"Do pass, but re-refer to the Committee on Judiciary Recommend 	Consent",7,0,0,0,7
741568,462566,2015-06-23,Senate,"Do pass as amended. To Consent Calendar",7,0,0,0,7
741568,464905,2015-07-02,Senate,"Consent Calendar 2nd AB1471 Perea",38,0,2,0,40
741568,466582,2015-07-16,Assembly,"AB 1471 PEREA  Concurrence in Senate Amendments",78,0,0,2,80
741573,438031,2015-04-21,Assembly,"Do pass and be re-referred to the Committee on Appropriations",18,0,0,1,19
741573,453688,2015-05-28,Assembly,"Do pass as amended",17,0,0,0,17
741573,455996,2015-06-02,Assembly,"AB 1231 WOOD  Assembly Third Reading",76,0,0,4,80
741573,460686,2015-06-17,Senate,"Do pass as amended, and re-refer to the Committee on Appropriations",9,0,0,0,9
741573,473639,2015-08-17,Senate,"Placed on Appropriations Suspense file",7,0,0,0,7
741573,474692,2015-08-27,Senate,"Do pass as amended",7,0,0,0,7
741573,476145,2015-09-09,Senate,"Assembly 3rd Reading AB1231 Wood By Nguyen",40,0,0,0,40
741573,476298,2015-09-10,Assembly,"AB 1231 WOOD  Concurrence in Senate Amendments",80,0,0,0,80
741574,443935,2015-05-06,Assembly,"Do pass",7,0,0,0,7
741574,445234,2015-05-11,Assembly,"AB 1291 WILLIAMS  Assembly Third Reading",77,0,0,3,80
741574,457909,2015-06-08,Senate,"Do pass",4,0,1,0,5
741574,465264,2015-07-06,Senate,"Assembly 3rd Reading AB1291 Williams By Pavley",38,0,2,0,40
741574,465792,2015-07-09,Assembly,"AB 1291 WILLIAMS  Concurrence in Senate Amendments",79,0,0,1,80
741576,428649,2015-04-07,Senate,"Do pass, but re-refer to the Committee on Appropriations Recommend 	Consent",7,0,0,0,7
741576,435415,2015-04-20,Senate,"Placed on Appropriations Suspense file",7,0,0,0,7
741576,454114,2015-05-28,Senate,"Do pass",7,0,0,0,7
741576,455460,2015-06-01,Senate,"Senate 3rd Reading SB646 Jackson",40,0,0,0,40
741576,464403,2015-06-30,Assembly,"Do pass and be re-referred to the Committee on Appropriations to 	Consent Calendar",10,0,0,0,10
741576,474476,2015-08-27,Assembly,"Do pass as amended",17,0,0,0,17
741576,475643,2015-09-02,Assembly,"SB 646 Jackson  Senate Third Reading  By STONE",80,0,0,0,80
741576,475774,2015-09-03,Senate,"Unfinished Business SB646 Jackson Concurrence",39,0,1,0,40
741577,440870,2015-04-29,Assembly,"Do pass as amended and be re-referred to the Committee on 	Appropriations",5,1,0,1,7
741577,453984,2015-05-28,Assembly,"Do pass",12,4,0,1,17
741577,456631,2015-06-03,Assembly,"AB 1335 ATKINS  Third Reading Urgency  Amend By ATKINS  Set #1",48,26,0,6,80
741578,427795,2015-04-07,Assembly,"Do pass as amended and be re-referred to the Committee on 	Appropriations",14,0,0,0,14
741578,437855,2015-04-22,Assembly,"Do pass, to Consent Calendar",17,0,0,0,17
741578,442341,2015-04-30,Assembly,"AB 1253 STEINORTH  Consent Calendar Second Day  Regular Session",77,0,0,3,80
741578,457899,2015-06-08,Senate,"Do pass, but re-refer to the Committee on Appropriations",9,0,0,0,9
741578,463925,2015-06-29,Senate,"Assembly 3rd Reading AB1253 Steinorth By Hernandez",39,0,1,0,40
741578,464944,2015-07-02,Assembly,"AB 1253 STEINORTH  Concurrence in Senate Amendments",78,0,0,2,80
741579,484883,2016-01-13,Senate,"Do pass, but re-refer to the Committee on Appropriations",2,0,7,0,9
741579,484884,2016-01-13,Senate,"Set, first hearing.  Failed passage in Committee.  Reconsideration 	granted",6,0,3,0,9
741584,436115,2015-04-21,Senate,"Do pass, but re-refer to the Committee on Appropriations Recommend 	Consent",10,0,1,0,11
741584,442922,2015-05-04,Senate,"Do pass as amended",7,0,0,0,7
741584,447721,2015-05-18,Senate,"Special Consent #1 SB789 Wieckowski",36,0,3,0,39
741584,459800,2015-06-15,Assembly,"Be referred to Committee on Local Government",10,0,0,1,11
741585,440138,2015-04-28,Assembly,"Do pass and be re-referred to the Committee on Appropriations",7,0,0,0,7
741588,443397,2015-05-05,Assembly,"Do pass",2,1,0,4,7
741589,440158,2015-04-27,Assembly,"Do pass as amended and be re-referred to the Committee on 	Appropriations",16,0,0,0,16
741589,446122,2015-05-13,Assembly,"Do pass, to Consent Calendar",17,0,0,0,17
741589,450066,2015-05-22,Assembly,"AB 1222 BLOOM  Consent Calendar Second Day  Regular Session",74,0,0,6,80
741589,465464,2015-07-07,Senate,"Do pass, but re-refer to the Committee on Appropriations Recommend 	Consent",11,0,0,0,11
741589,473947,2015-08-20,Senate,"Consent Calendar 2nd AB1222 Bloom",38,0,2,0,40
741589,474141,2015-08-24,Assembly,"AB 1222 BLOOM  Concurrence in Senate Amendments",79,0,0,1,80
741592,485087,2016-01-05,Assembly,"Be referred to Committee on Housing and Community Development",11,0,0,0,11
741593,440180,2015-04-27,Assembly,"Do pass as amended and be re-referred to the Committee on 	Appropriations",8,1,0,0,9
741593,454053,2015-05-28,Assembly,"Do pass",12,4,0,1,17
741593,456090,2015-06-02,Assembly,"AB 1482 GORDON  Assembly Third Reading",63,12,0,5,80
741593,462189,2015-06-23,Senate,"Do pass, but re-refer to the Committee on Environmental Quality",7,2,0,0,9
741593,473776,2015-08-17,Senate,"Placed on Appropriations Suspense file",7,0,0,0,7
741593,474705,2015-08-27,Senate,"Do pass as amended",5,2,0,0,7
741593,476035,2015-09-08,Senate,"Assembly 3rd Reading AB1482 Gordon By Wieckowski",27,13,0,0,40
741593,476188,2015-09-09,Assembly,"AB 1482 GORDON  Concurrence in Senate Amendments",65,14,0,1,80
741594,443909,2015-05-05,Senate,"Do pass as amended",7,0,0,0,7
741594,447728,2015-05-18,Senate,"Senate 3rd Reading SB672 Hernandez",36,0,3,0,39
741594,460523,2015-06-16,Assembly,"Do pass, to Consent Calendar",10,0,0,0,10
741594,474367,2015-08-27,Assembly,"SB 672 Hernandez  Senate Third Reading  By STONE",78,0,0,2,80
741596,440031,2015-04-28,Senate,"Do pass as amended, and re-refer to the Committee on Appropriations",8,0,1,0,9
741596,445120,2015-05-11,Senate,"Placed on Appropriations Suspense file",7,0,0,0,7
741596,454179,2015-05-28,Senate,"Do pass as amended",7,0,0,0,7
741596,456595,2015-06-03,Senate,"Senate 3rd Reading SB664 Hertzberg",40,0,0,0,40
741596,464483,2015-06-30,Assembly,"Do pass and be re-referred to the Committee on Appropriations",13,2,0,0,15
741596,474469,2015-08-27,Assembly,"Do pass",16,1,0,0,17
741596,475487,2015-09-01,Assembly,"SB 664 Hertzberg  Senate Third Reading  By LEVINE",71,9,0,0,80
741596,475659,2015-09-02,Senate,"Unfinished Business SB664 Hertzberg Concurrence",40,0,0,0,40
741597,483876,2016-01-06,Assembly,"Do pass, to Consent Calendar",20,0,0,1,21
741597,485028,2016-01-15,Assembly,"AB 1355 GRAY  Consent Calendar Second Day",72,0,0,7,79
741597,558632,2016-08-01,Senate,"Consent Calendar 2nd AB1355 Gray",39,0,0,0,39
741598,414002,2015-03-19,Assembly,"From committee:  Be adopted.  To third reading",11,0,0,0,11
741598,447743,2015-05-18,Senate,"Special Consent #1 ACR37 Gray",36,0,3,0,39
741599,485039,2016-01-13,Assembly,"Do pass",9,0,0,0,9
741599,488378,2016-01-27,Assembly,"AB 1362 GORDON  Assembly Third Reading",56,15,0,8,79
741599,556329,2016-06-29,Senate,"Do pass, but re-refer to the Committee on Appropriations",6,1,0,0,7
741599,560203,2016-08-18,Senate,"Assembly 3rd Reading AB1362 Gordon By Leno",30,5,4,0,39
741599,560986,2016-08-24,Assembly,"AB 1362 GORDON  Concurrence in Senate Amendments",65,10,0,5,80
741600,436205,2015-04-21,Senate,"Do pass, but re-refer to the Committee on Rules",8,0,3,0,11
741600,443863,2015-05-06,Senate,"Do pass as amended, and re-refer to the Committee on Appropriations",6,0,1,0,7
741600,446198,2015-05-13,Senate,"Do pass",4,2,1,0,7
741601,440155,2015-04-27,Assembly,"Do pass as amended and be re-referred to the Committee on 	Appropriations",15,0,0,1,16
741601,446508,2015-05-13,Assembly,"Do pass, to Consent Calendar",17,0,0,0,17
741601,450183,2015-05-22,Assembly,"AB 1096 CHIU  Consent Calendar Second Day  Regular Session",74,0,0,6,80
741601,462090,2015-06-23,Senate,"Do pass, but re-refer to the Committee on Appropriations",9,0,2,0,11
741601,476072,2015-09-09,Senate,"Assembly 3rd Reading AB1096 Chiu By Allen",40,0,0,0,40
741601,476286,2015-09-10,Assembly,"AB 1096 CHIU  Concurrence in Senate Amendments",80,0,0,0,80
741603,440102,2015-04-28,Assembly,"Do pass as amended and be re-referred to the Committee on 	Appropriations",14,0,0,0,14
741603,453015,2015-05-27,Assembly,"Do pass",17,0,0,0,17
741603,455309,2015-06-01,Assembly,"AB 1182 SANTIAGO  Assembly Third Reading",79,0,0,1,80
741603,466317,2015-07-14,Senate,"Do pass as amended, and re-refer to the Committee on Appropriations",6,1,0,0,7
741603,476049,2015-09-08,Senate,"Assembly 3rd Reading AB1182 Santiago By Wieckowski",40,0,0,0,40
741603,476202,2015-09-09,Assembly,"AB 1182 SANTIAGO  Concurrence in Senate Amendments",78,0,0,2,80
741604,447696,2015-05-13,Assembly,"Do pass as amended",7,0,0,0,7
741604,450075,2015-05-22,Assembly,"AB 1101 BONILLA  Assembly Third Reading",74,0,0,6,80
741604,462620,2015-06-24,Senate,"Do pass as amended",9,0,0,0,9
741604,465894,2015-07-13,Senate,"Assembly 3rd Reading AB1101 Bonilla By Lara",35,0,5,0,40
741604,466488,2015-07-16,Assembly,"AB 1101 BONILLA  Concurrence in Senate Amendments",79,0,0,1,80
741605,440089,2015-04-28,Assembly,"Amend, and do pass as amended and be re-referred to the Committee 	on Appropriations with the recommendation:  To Consent Calendar",15,0,0,0,15
741605,443818,2015-05-06,Assembly,"Do pass, to Consent Calendar",17,0,0,0,17
741605,446697,2015-05-14,Assembly,"AB 1259 LEVINE  Consent Calendar Second Day  Regular Session",78,0,0,2,80
741605,464437,2015-06-30,Senate,"Do pass, but re-refer to the Committee on Appropriations",3,0,2,0,5
741605,465858,2015-07-13,Senate,"Placed on Appropriations Suspense file",7,0,0,0,7
741605,474688,2015-08-27,Senate,"Do pass as amended",7,0,0,0,7
741605,475752,2015-09-03,Senate,"Assembly 3rd Reading AB1259 Levine By Vidak",40,0,0,0,40
741605,475841,2015-09-04,Assembly,"AB 1259 LEVINE  Concurrence in Senate Amendments",79,0,0,1,80
741606,436208,2015-04-20,Assembly,"Do pass as amended and be re-referred to the Committee on 	Appropriations",9,5,0,1,15
741606,454098,2015-05-28,Assembly,"Do pass as amended",12,5,0,0,17
741606,457266,2015-06-04,Assembly,"AB 1330 BLOOM  Assembly Third Reading",46,29,0,5,80
741606,474081,2015-08-24,Senate,"Placed on Appropriations Suspense file",7,0,0,0,7
741606,474665,2015-08-27,Senate,"Do pass as amended",5,2,0,0,7
741606,555546,2016-06-27,Senate,"That the Assembly amendments be concurred in, but first be 	re-referred to the Committee on Appropriations",6,2,3,0,11
741606,559901,2016-08-16,Senate,"From Committee:  That the measure be returned to the Senate floor 	for consideration",5,2,0,0,7
741606,560987,2016-08-24,Senate,"Assembly 3rd Reading AB1330 Bloom By Hertzberg",26,12,1,0,39
741606,561751,2016-08-31,Assembly,"AB 1330 BLOOM  Concurrence in Senate Amendments",51,28,0,1,80
741608,436232,2015-04-21,Assembly,"Do pass and be re-referred to the Committee on Appropriations to 	Consent Calendar",9,0,0,0,9
741608,441029,2015-04-29,Assembly,"Do pass, to Consent Calendar",17,0,0,0,17
741608,444397,2015-05-07,Assembly,"AB 1093 GARCIA, E.  Consent Calendar Second Day  Regular Session",77,0,0,3,80
741608,460176,2015-06-16,Senate,"Do pass, but re-refer to the Committee on Appropriations",7,0,0,0,7
741608,465176,2015-07-06,Senate,"Assembly 3rd Reading AB1093 Eduardo Garcia By Monning",39,0,1,0,40
741608,466069,2015-04-14,Assembly,"Do pass and be re-referred to the Committee on Jobs, Economic 	Development and The Economy to Consent Calendar",7,0,0,0,7
741611,436015,2015-04-21,Senate,"Do pass as amended, and re-refer to the Committee on Appropriations",10,1,0,0,11
741611,442917,2015-05-04,Senate,"Placed on Appropriations Suspense file",7,0,0,0,7
741613,446117,2015-05-12,Senate,"Do pass as amended",7,0,0,0,7
741613,450079,2015-05-22,Senate,"Senate 3rd Reading SB633 Hill",39,0,0,0,39
741613,465458,2015-07-07,Assembly,"Do pass as amended",11,0,0,0,11
741613,466471,2015-07-16,Assembly,"SB 633 Hill  Senate Third Reading  By JONES",77,0,0,3,80
741613,473820,2015-08-17,Senate,"Unfinished Business SB633 Hill Concurrence",37,0,3,0,40
741615,440267,2015-04-28,Senate,"Do pass as amended, and re-refer to the Committee on Appropriations",5,1,1,0,7
741615,454051,2015-05-28,Senate,"Do pass",7,0,0,0,7
741615,463748,2015-05-18,Senate,"Placed on Appropriations Suspense file",7,0,0,0,7
741615,466380,2015-07-15,Senate,"Do pass as amended, and re-refer to the Committee on Appropriations",4,2,1,0,7
741615,475807,2015-09-03,Senate,"Senate 3rd Reading SB681 Hill Urgency Clause",25,14,1,0,40
741615,475808,2015-09-03,Senate,"Senate 3rd Reading SB681 Hill Urgency Clause",40,0,0,0,40
741615,484740,2016-01-12,Senate,"Do pass, but re-refer to the Committee on Appropriations",10,0,1,0,11
741615,485580,2016-01-19,Senate,"Placed on Appropriations Suspense file",7,0,0,0,7
741617,445840,2015-05-12,Senate,"Do pass",7,0,0,0,7
741617,447688,2015-05-18,Senate,"Senate 3rd Reading SB629 Mitchell",36,0,3,0,39
741617,460234,2015-06-16,Assembly,"Do pass, to Consent Calendar",7,0,0,0,7
741617,461918,2015-06-22,Assembly,"SB 629 Mitchell  Consent Calendar Second Day  Regular Session",77,0,0,3,80
741618,435971,2015-04-21,Senate,"Do pass as amended, and re-refer to the Committee on Rules",9,0,2,0,11
741618,441066,2015-04-29,Senate,"Do pass as amended, and re-refer to the Committee on Appropriations",6,0,1,0,7
741618,463751,2015-05-18,Senate,"Placed on Appropriations Suspense file",7,0,0,0,7
741619,440496,2015-04-28,Assembly,"Do pass and be re-referred to the Committee on Appropriations",6,5,0,4,15
741619,463759,2015-04-28,Assembly,"Reconsideration granted",15,0,0,0,15
741619,485033,2016-01-12,Assembly,"Do pass and be re-referred to the Committee on Appropriations",6,6,0,3,15
741620,428790,2015-04-08,Senate,"Do pass as amended, and re-refer to the Committee on Appropriations",5,0,0,0,5
741620,442258,2015-04-30,Senate,"Senate 3rd Reading SB623 Lara",34,1,4,0,39
741620,462591,2015-06-24,Assembly,"Do pass and be re-referred to the Committee on Appropriations",10,0,0,3,13
741620,465563,2015-07-08,Assembly,"Do pass",11,3,0,3,17
741620,474478,2015-08-27,Assembly,"SB 623 Lara  Senate Third Reading  By GONZALEZ",64,12,0,4,80
741622,442375,2015-04-30,Assembly,"Amend, and re-refer to the Committee on Human Services",5,0,0,2,7
741622,458339,2015-06-09,Assembly,"Do pass as amended and be re-referred to the Committee on 	Accountability and Administrative Review",4,0,0,3,7
741623,427753,2015-04-07,Assembly,"Do pass",5,2,0,0,7
741623,433998,2015-04-16,Assembly,"AB 1134 STONE  Assembly Third Reading",51,26,0,3,80
741623,466273,2015-07-14,Senate,"Do pass as amended",5,2,0,0,7
741623,475561,2015-09-02,Senate,"Assembly 3rd Reading AB1134 Mark Stone By Lara",23,16,1,0,40
741623,475898,2015-09-04,Assembly,"AB 1134 STONE  Concurrence in Senate Amendments",49,30,0,1,80
741624,443619,2015-05-05,Assembly,"Do pass as amended, to Consent Calendar",17,0,0,2,19
741624,446725,2015-05-14,Assembly,"AB 1424 MULLIN  Consent Calendar Second Day  Regular Session",78,0,0,2,80
741624,460742,2015-06-17,Senate,"Do pass and be placed on the Consent Calendar",9,0,0,0,9
741624,463909,2015-06-29,Senate,"Assembly 3rd Reading AB1424 Mullin By Hill",35,0,5,0,40
741626,429384,2015-04-08,Assembly,"Do pass and be re-referred to the Committee on Jobs, Economic 	Development and The Economy",6,0,0,1,7
741626,436136,2015-04-21,Assembly,"Do pass and be re-referred to the Committee on Appropriations",8,1,0,0,9
741626,443524,2015-05-06,Assembly,"Do pass",17,0,0,0,17
741626,445133,2015-05-11,Assembly,"AB 1270 GARCIA, E.  Assembly Third Reading",74,0,0,6,80
741626,458649,2015-06-10,Senate,"Do pass, but re-refer to the Committee on Appropriations",5,0,0,0,5
741626,462925,2015-06-25,Senate,"Assembly 3rd Reading AB1270 Eduardo Garcia By Mendoza",37,0,3,0,40
741627,437051,2015-04-21,Senate,"Do pass as amended",2,5,0,0,7
741628,440019,2015-04-28,Senate,"Do pass as amended, and re-refer to the Committee on Appropriations",7,0,0,0,7
741628,450265,2015-05-22,Senate,"Senate 3rd Reading SB676 Cannella",38,0,1,0,39
741628,464573,2015-06-30,Assembly,"Amend, and do pass as amended and be re-referred to the Committee 	on Appropriations with the recommendation:  To Consent Calendar",7,0,0,0,7
741628,466424,2015-07-15,Assembly,"Do pass, to Consent Calendar",16,0,0,1,17
741628,474035,2015-08-20,Assembly,"SB 676 Cannella  Consent Calendar Second Day  Regular Session",79,0,0,1,80
741628,474371,2015-08-27,Senate,"Special Consent #7 SB676 Cannella",40,0,0,0,40
741629,441361,2015-04-29,Assembly,"Do pass and be re-referred to the Committee on Appropriations",7,1,0,2,10
741629,454151,2015-05-28,Assembly,"Do pass as amended",12,1,0,4,17
741629,456700,2015-06-03,Assembly,"AB 1321 TING  Assembly Third Reading",61,16,0,3,80
741629,473782,2015-08-17,Senate,"Placed on Appropriations Suspense file",7,0,0,0,7
741629,474706,2015-08-27,Senate,"Do pass as amended",5,2,0,0,7
741629,475669,2015-09-02,Senate,"Assembly 3rd Reading AB1321 Ting By Wolk",30,8,2,0,40
741629,475868,2015-09-04,Assembly,"AB 1321 TING  Concurrence in Senate Amendments",60,18,0,2,80
741630,441872,2015-04-29,Senate,"Do pass as amended, and re-refer to the Committee on Appropriations",7,0,2,0,9
741630,463636,2015-05-18,Senate,"Placed on Appropriations Suspense file",7,0,0,0,7
741631,440305,2015-04-28,Assembly,"Do pass and be re-referred to the Committee on Appropriations",14,0,0,0,14
741631,446115,2015-05-13,Assembly,"Do pass",15,2,0,0,17
741631,456577,2015-06-03,Assembly,"AB 1306 BURKE  Assembly Third Reading",78,1,0,1,80
741631,555524,2016-06-27,Senate,"Do pass as amended, and re-refer to the Committee on Appropriations",7,0,2,0,9
741631,561567,2016-08-30,Senate,"Assembly 3rd Reading AB1306 Burke By Hill",22,9,8,0,39
741631,561690,2016-08-31,Assembly,"AB 1306 BURKE  Concurrence in Senate Amendments",31,21,0,28,80
741632,427933,2015-04-07,Senate,"Do pass, but re-refer to the Committee on Appropriations",7,0,0,0,7
741632,435303,2015-04-20,Senate,"Placed on Appropriations Suspense file",7,0,0,0,7
741632,454077,2015-05-28,Senate,"Do pass",7,0,0,0,7
741632,455554,2015-06-01,Senate,"Senate 3rd Reading SB621 Hertzberg",40,0,0,0,40
741632,464316,2015-06-30,Assembly,"Do pass and be re-referred to the Committee on Appropriations to 	Consent Calendar",7,0,0,0,7
741632,474457,2015-08-27,Assembly,"Do pass",17,0,0,0,17
741632,475674,2015-09-02,Assembly,"SB 621 Hertzberg  Senate Third Reading  By BURKE",80,0,0,0,80
741633,446284,2015-05-13,Assembly,"Do pass as amended",4,3,0,0,7
741633,456555,2015-06-03,Assembly,"AB 1504 ALEJO  Assembly Third Reading",53,27,0,0,80
741633,464321,2015-06-30,Senate,"Do pass",4,0,1,0,5
741633,475924,2015-09-08,Senate,"Assembly 3rd Reading AB1504 Alejo By Cannella",32,6,2,0,40
741633,476176,2015-09-09,Assembly,"AB 1504 ALEJO  Concurrence in Senate Amendments",52,24,0,4,80
741634,436242,2015-04-21,Assembly,"Do pass and be re-referred to the Committee on Appropriations to 	Consent Calendar",7,0,0,0,7
741634,438225,2015-04-14,Assembly,"Do pass and be re-referred to the Committee on Aging and Long",16,0,0,3,19
741634,454204,2015-05-28,Assembly,"Do pass",17,0,0,0,17
741634,455980,2015-06-02,Assembly,"AB 1261 BURKE  Assembly Third Reading",79,0,0,1,80
741634,460799,2015-06-17,Senate,"Do pass, but re-refer to the Committee on Appropriations",9,0,0,0,9
741634,465194,2015-07-06,Senate,"Placed on Appropriations Suspense file",7,0,0,0,7
741634,474687,2015-08-27,Senate,"Do pass as amended",7,0,0,0,7
741634,476432,2015-09-10,Senate,"Assembly 3rd Reading AB1261 Burke By Allen",40,0,0,0,40
741634,476603,2015-09-11,Assembly,"AB 1261 BURKE  Concurrence in Senate Amendments",79,0,0,1,80
741635,440533,2015-04-27,Assembly,"Do pass as amended and be re-referred to the Committee on 	Appropriations",14,1,0,0,15
741637,484951,2016-01-13,Senate,"Do pass and be placed on the Consent Calendar",6,0,3,0,9
741637,485711,2016-01-19,Senate,"Consent Calendar 2nd SB616 Huff",40,0,0,0,40
741637,555337,2016-06-22,Assembly,"Do pass",2,0,0,5,7
741637,555338,2016-06-22,Assembly,"Reconsideration granted",7,0,0,0,7
741638,437973,2015-04-21,Senate,"Do pass as amended, and re-refer to the Committee on Appropriations",7,0,0,0,7
741638,454115,2015-05-28,Senate,"Do pass",7,0,0,0,7
741638,456083,2015-06-02,Senate,"Senate 3rd Reading SB635 Nielsen",40,0,0,0,40
741638,463696,2015-05-18,Senate,"Placed on Appropriations Suspense file",7,0,0,0,7
741638,466061,2015-07-14,Assembly,"Do pass and be re-referred to the Committee on Appropriations to 	Consent Calendar",7,0,0,0,7
741638,474455,2015-08-27,Assembly,"Do pass",17,0,0,0,17
741638,475918,2015-09-08,Assembly,"SB 635 Nielsen  Senate Third Reading  By BONTA",79,0,0,1,80
741638,476236,2015-09-10,Senate,"Unfinished Business SB635 Nielsen Concurrence",39,0,1,0,40
741639,436046,2015-04-20,Assembly,"Do pass and be re-referred to the Committee on Education",14,0,0,1,15
741639,441269,2015-04-28,Assembly,"Do pass and be re-referred to the Committee on Appropriations",12,0,0,1,13
741639,448935,2015-05-20,Assembly,"Do pass, to Consent Calendar",15,0,0,2,17
741639,451828,2015-05-26,Assembly,"AB 1150 LEVINE  Consent Calendar Second Day  Regular Session",76,0,0,4,80
741639,460667,2015-06-17,Senate,"Do pass, but re-refer to the Committee on Energy, Utilities and 	Communications Recommend Consent",8,0,1,0,9
741639,464586,2015-06-30,Senate,"Do pass as amended, and re-refer to the Committee on Appropriations",10,0,1,0,11
741639,473654,2015-08-17,Senate,"Placed on Appropriations Suspense file",7,0,0,0,7
741639,474511,2015-08-27,Senate,"Do pass as amended",7,0,0,0,7
741639,475979,2015-09-08,Senate,"Assembly 3rd Reading AB1150 Levine By Fuller",40,0,0,0,40
741639,476154,2015-09-09,Assembly,"AB 1150 LEVINE  Concurrence in Senate Amendments",79,0,0,1,80
741641,437379,2015-04-21,Assembly,"Do pass as amended and be re-referred to the Committee on 	Appropriations",10,3,0,0,13
741641,453652,2015-05-28,Assembly,"Do pass as amended",12,5,0,0,17
741641,456628,2015-06-03,Assembly,"AB 1307 MCCARTY  Assembly Third Reading",52,25,0,3,80
741641,466355,2015-07-15,Senate,"Do pass as amended, and re-refer to the Committee on Appropriations",8,0,1,0,9
741641,476006,2015-09-08,Senate,"Assembly 3rd Reading AB1307 McCarty By Block",40,0,0,0,40
741641,476162,2015-09-09,Assembly,"AB 1307 MCCARTY  Concurrence in Senate Amendments",69,9,0,2,80
741643,437277,2015-04-22,Assembly,"Do pass and be re-referred to the Committee on Education to Consent 	Calendar",20,0,0,1,21
741643,442215,2015-04-29,Assembly,"Do pass and be re-referred to the Committee on Appropriations to 	Consent Calendar",6,0,0,1,7
741644,430696,2015-04-09,Assembly,"Be referred to Committee on Revenue and Taxation",11,0,0,0,11
741645,437252,2015-04-22,Assembly,"Do pass and be re-referred to the Committee on Appropriations",12,0,0,1,13
741645,453634,2015-05-28,Assembly,"Do pass as amended",12,0,0,5,17
741645,456625,2015-06-03,Assembly,"AB 1124 PEREA  Assembly Third Reading",79,0,0,1,80
741645,465874,2015-07-13,Senate,"Do pass as amended, and re-refer to the Committee on Appropriations",4,1,0,0,5
741645,473582,2015-08-17,Senate,"Placed on Appropriations Suspense file",7,0,0,0,7
741645,474487,2015-08-27,Senate,"Do pass as amended",5,1,1,0,7
741645,476511,2015-09-11,Senate,"Assembly 3rd Reading AB1124 Perea By Mendoza",28,4,8,0,40
741645,476512,2015-09-12,Assembly,"AB 1124 PEREA  Concurrence in Senate Amendments",79,0,0,1,80
743958,410413,2015-03-12,Assembly,"From committee:  Be adopted.  To third reading",9,0,0,2,11
743958,418892,2015-03-26,Senate,"Assembly 3rd Reading ACR41 Ting By Pan",31,0,8,0,39
743979,441978,2015-04-28,Senate,"Do pass as amended, but re-refer to the Committee on Appropriations 	Recommend Consent",5,0,0,0,5
743979,453603,2015-05-28,Senate,"Do pass as amended",7,0,0,0,7
743979,457367,2015-06-04,Senate,"Senate 3rd Reading SB794 Committee On HUMAN S. (McGuire)",40,0,0,0,40
743979,463679,2015-05-18,Senate,"Placed on Appropriations Suspense file",7,0,0,0,7
743979,466280,2015-07-14,Assembly,"Do pass and be re-referred to the Committee on Appropriations to 	Consent Calendar",7,0,0,0,7
743979,474277,2015-08-27,Assembly,"Do pass as amended",17,0,0,0,17
743979,476294,2015-09-10,Assembly,"SB 794 HUM. S.  Senate Third Reading  By CHU",80,0,0,0,80
743979,476632,2015-09-11,Senate,"Unfinished Business SB794 Committee On HUMAN S. (McGuire) 	Concurrence",40,0,0,0,40
744000,439754,2015-04-27,Assembly,"From committee:  Be adopted.  To third reading",10,0,0,1,11
744000,450226,2015-05-22,Senate,"Special Consent #2 ACR40 Calderon",38,0,1,0,39
745144,438189,2015-04-22,Assembly,"Do pass and be re-referred to the Committee on Appropriations",5,2,0,0,7
745144,441104,2015-04-29,Assembly,"Do pass",12,5,0,0,17
745144,442849,2015-05-04,Assembly,"AB 1506 L.& E.  Assembly Third Reading  By HERNANDEZ",51,26,0,3,80
745144,462646,2015-06-24,Senate,"Do pass, but re-refer to the Committee on Rules",5,0,0,0,5
745144,465576,2015-07-07,Senate,"Do pass, but re-refer to the Committee on Appropriations",6,0,1,0,7
745144,475569,2015-09-02,Senate,"Assembly 3rd Reading AB1506 Roger Hern",40,0,0,0,40
745144,476001,2015-09-08,Assembly,"Do pass and be re-referred to the Committee on Appropriations",6,0,0,1,7
745144,476146,2015-09-09,Assembly,"AB 1506 HERNANDEZ  Concurrence- Urgency Added",80,0,0,0,80
745168,438359,2015-04-22,Assembly,"Do pass as amended and be re-referred to the Committee on 	Appropriations",5,2,0,0,7
745168,443817,2015-05-06,Assembly,"Do pass",12,5,0,0,17
745168,446605,2015-05-14,Assembly,"AB 1509 HERNANDEZ  Assembly Third Reading",54,26,0,0,80
745168,458764,2015-06-10,Senate,"Do pass, but re-refer to the Committee on Judiciary",3,1,0,1,5
745168,462564,2015-06-23,Senate,"Do pass, but re-refer to the Committee on Appropriations",5,2,0,0,7
745168,465904,2015-07-13,Senate,"Do pass",5,2,0,0,7
745168,475668,2015-09-02,Senate,"Assembly 3rd Reading AB1509 Roger Hern",27,13,0,0,40
745168,475867,2015-09-04,Assembly,"AB 1509 HERNANDEZ  Concurrence in Senate Amendments",53,25,0,2,80
745219,437893,2015-04-22,Assembly,"Do pass and be re-referred to the Committee on Appropriations",7,0,0,0,7
745219,443678,2015-05-06,Assembly,"Do pass, to Consent Calendar",17,0,0,0,17
745219,446689,2015-05-14,Assembly,"AB 1507 L.& E.  Consent Calendar Second Day  Regular Session",78,0,0,2,80
745219,458602,2015-06-10,Senate,"Do pass, but re-refer to the Committee on Appropriations",5,0,0,0,5
745243,444484,2015-05-06,Assembly,"Do pass",7,0,0,0,7
745243,446911,2015-05-14,Assembly,"AB 1505 L.& E.  Assembly Third Reading  By HERNANDEZ",76,0,0,4,80
745243,458521,2015-06-10,Senate,"Do pass",5,0,0,0,5
745243,552917,2016-06-14,Senate,"Do pass",5,2,0,0,7
745243,560296,2016-08-18,Senate,"Assembly 3rd Reading AB1505 Roger Hern",29,6,4,0,39
745243,561039,2016-08-24,Assembly,"Senate amendments be concurred in",6,0,0,0,6
745243,561221,2016-08-25,Assembly,"AB 1505 HERNANDEZ  Concurrence in Senate Amendments",77,1,0,2,80
745268,438567,2015-04-22,Assembly,"Do pass and be re-referred to the Committee on Appropriations to 	Consent Calendar",7,0,0,0,7
745268,454021,2015-05-28,Assembly,"Do pass",17,0,0,0,17
745268,455489,2015-06-01,Assembly,"AB 1508 HERNANDEZ  Assembly Third Reading",77,2,0,1,80
745268,461946,2015-06-22,Senate,"Do pass, but re-refer to the Committee on Appropriations",9,0,0,0,9
745268,465926,2015-07-13,Senate,"Placed on Appropriations Suspense file",7,0,0,0,7
745268,474716,2015-08-27,Senate,"Do pass",5,2,0,0,7
745291,432846,2015-04-14,Assembly,"From committee:  Be adopted.  To third reading",9,0,0,0,9
745291,438285,2015-04-23,Assembly,"AJR 11 BURKE  Assembly Third Reading",76,0,0,4,80
745291,458718,2015-06-09,Senate,"Be adopted and be placed on the Consent Calendar",5,0,0,0,5
745291,461223,2015-06-18,Senate,"Assembly 3rd Reading AJR11 Burke By Allen",37,0,3,0,40
746423,429440,2015-04-09,Senate,"Senate 3rd Reading SR17 Jackson",27,7,5,0,39
746424,428457,2015-04-08,Assembly,"Do pass, to Consent Calendar",12,0,0,1,13
746424,433882,2015-04-16,Assembly,"AB 1512 INS.  Consent Calendar Second Day  Regular Session",79,0,0,1,80
746424,459404,2015-06-10,Senate,"Do pass",9,0,0,0,9
746424,461861,2015-06-22,Senate,"Special Consent #3 AB1512 Committee On INS. (Roth)",37,0,3,0,40
746424,463013,2015-06-25,Assembly,"AB 1512 INS.  Concurrence in Senate Amendments By DALY",80,0,0,0,80
746427,428524,2015-04-08,Assembly,"Do pass, to Consent Calendar",12,0,0,1,13
746427,433959,2015-04-16,Assembly,"AB 1511 INS.  Consent Calendar Second Day  Regular Session",79,0,0,1,80
746427,544347,2016-05-10,Senate,"Do pass, but re-refer to the Committee on Appropriations",5,2,0,0,7
746427,545794,2016-05-16,Senate,"Placed on Appropriations Suspense file",2,4,1,0,7
746427,545795,2016-05-16,Senate,"Do pass as amended",5,2,0,0,7
746427,547009,2016-05-19,Senate,"Assembly 3rd Reading AB1511 Santiago By Pan",22,15,3,0,40
746427,554634,2016-06-21,Assembly,"Senate amendments be concurred in",5,2,0,0,7
746427,556769,2016-06-30,Assembly,"AB 1511 SANTIAGO  Concurrence in Senate Amendments",43,31,0,6,80
746430,428536,2015-04-08,Assembly,"Do pass, to Consent Calendar",12,0,0,1,13
746430,434014,2015-04-16,Assembly,"AB 1513 INS.  Consent Calendar Second Day  Regular Session",79,0,0,1,80
746430,462576,2015-06-24,Senate,"Do pass",5,0,0,0,5
746430,476238,2015-09-10,Senate,"From Committee:  That the measure be returned to the Senate floor 	for consideration",4,1,0,0,5
746430,476492,2015-09-11,Senate,"Assembly 3rd Reading AB1513 Williams By Mendoza",30,8,2,0,40
746430,476493,2015-09-11,Assembly,"AB 1513 WILLIAMS  Concurrence in Senate Amendments By STONE",58,13,0,9,80
746430,485040,2015-09-03,Senate,"From Committee:  Amendments held in committee pursuant to Senate 	Rule 29.10",5,0,0,0,5
746433,410392,2015-03-12,Assembly,"From committee:  Be adopted.  To third reading",9,0,0,2,11
746433,418913,2015-03-26,Senate,"Assembly 3rd Reading ACR42 Quirk By Fuller",31,0,8,0,39
746433,427307,2015-04-06,Assembly,"ACR 42 QUIRK  Concurrence in Senate Amendments",78,0,0,2,80
746436,413941,2015-03-19,Senate,"Senate 3rd Reading SR16 Bates",35,0,3,0,38
746439,428493,2015-04-08,Assembly,"Do pass and be re-referred to the Committee on Appropriations to 	Consent Calendar",12,0,0,1,13
746439,433916,2015-04-15,Assembly,"Do pass as amended, to Consent Calendar",16,0,0,1,17
746439,438425,2015-04-23,Assembly,"AB 1515 INS.  Consent Calendar Second Day  Regular Session",78,0,0,2,80
746439,465695,2015-07-08,Senate,"Do pass, but re-refer to the Committee on Appropriations Recommend 	Consent",8,0,1,0,9
746439,474009,2015-08-20,Senate,"Consent Calendar 2nd AB1515 Committee On INS. (Roth)",38,0,2,0,40
746439,474076,2015-08-24,Assembly,"AB 1515 INS.  Concurrence in Senate Amendments By DALY",80,0,0,0,80
746442,415397,2015-03-23,Senate,"Senate 3rd Reading SCR26 Beall",32,0,7,0,39
746442,434210,2015-04-16,Assembly,"From committee:  Be adopted.  To third reading",11,0,0,0,11
746442,442153,2015-04-30,Senate,"Unfinished Business SCR26 Beall Concurrence",37,0,2,0,39
746445,430715,2015-04-13,Senate,"Senate 3rd Reading SCR25 Block",34,0,5,0,39
746445,446932,2015-04-06,Senate,"Be adopted and be placed on the Consent Calendar",9,0,0,0,9
746445,466553,2015-07-16,Senate,"Unfinished Business SCR25 Block Concurrence",37,0,3,0,40
746448,428403,2015-04-08,Assembly,"Do pass and be re-referred to the Committee on Appropriations to 	Consent Calendar",12,0,0,1,13
746448,433947,2015-04-15,Assembly,"Do pass, to Consent Calendar",16,0,0,1,17
746448,438401,2015-04-23,Assembly,"AB 1514 INS.  Consent Calendar Second Day  Regular Session",78,0,0,2,80
746448,458637,2015-06-10,Senate,"Do pass, but re-refer to the Committee on Appropriations",5,0,0,0,5
746448,465199,2015-07-06,Senate,"Assembly 3rd Reading AB1514 INS. By Mendoza",39,0,1,0,40
748598,443363,2015-05-05,Senate,"Be adopted, but re-refer to the Committee on Appropriations 	Recommend Consent",9,0,2,0,11
748598,450209,2015-05-22,Senate,"Consent Calendar 2nd SCR28 Huff",38,0,1,0,39
748598,461838,2015-06-22,Assembly,"Be adopted and re-referred to the Committee on Appropriations with 	recommendation:  To Consent Calendar",16,0,0,0,16
748598,465579,2015-07-08,Assembly,"Be adopted, to Consent Calendar",14,0,0,3,17
748598,465932,2015-07-13,Assembly,"SCR 28 Huff  Consent Calendar Second Day  Regular Session",79,0,0,1,80
748598,466568,2015-07-16,Senate,"Unfinished Business SCR28 Huff Concurrence",37,0,3,0,40
748604,443496,2015-05-05,Senate,"Be adopted, but re-refer to the Committee on Appropriations 	Recommend Consent",9,0,2,0,11
748604,450182,2015-05-22,Senate,"Consent Calendar 2nd SCR27 Huff",38,0,1,0,39
748604,461926,2015-06-22,Assembly,"Be adopted and re-referred to the Committee on Appropriations with 	recommendation:  To Consent Calendar",16,0,0,0,16
748604,465717,2015-07-08,Assembly,"Be adopted, to Consent Calendar",14,0,0,3,17
748604,465838,2015-07-13,Assembly,"SCR 27 Huff  Consent Calendar Second Day  Regular Session",79,0,0,1,80
748609,413871,2015-03-19,Assembly,"From committee:  Be adopted.  To third reading",11,0,0,0,11
748609,434236,2015-04-16,Senate,"Assembly 3rd Reading ACR43 O'Donnell By Fuller",37,0,2,0,39
748620,441805,2015-04-29,Assembly,"Do pass",6,0,0,1,7
748620,444523,2015-05-07,Assembly,"AB 1516 H.& C.D.  Consent Calendar Second Day  Regular Session",77,0,0,3,80
748620,466047,2015-07-14,Senate,"Do pass, but re-refer to the Committee on Appropriations Recommend 	Consent",11,0,0,0,11
748620,473783,2015-08-17,Senate,"Do pass",7,0,0,0,7
748620,475326,2015-08-31,Senate,"Special Consent #8 AB1516 Committee On H. & C.D. (Chau)",40,0,0,0,40
748620,475474,2015-09-01,Assembly,"AB 1516 H.& C.D.  Concurrence in Senate Amendments By CHAU",79,0,0,1,80
751519,432772,2015-04-14,Assembly,"Do pass",8,1,0,1,10
751519,434023,2015-04-16,Assembly,"AB 1523 JUD.  Assembly Third Reading  By STONE",52,21,0,7,80
751520,437452,2015-04-21,Assembly,"Do pass and be re-referred to the Committee on Aging and Long",19,0,0,0,19
751520,442117,2015-04-30,Assembly,"Do pass and be re-referred to the Committee on Appropriations",6,0,0,1,7
751520,453814,2015-05-28,Assembly,"Do pass",17,0,0,0,17
751520,455388,2015-06-01,Assembly,"AB 1518 AGING& L.T.C.  Assembly Third Reading  By BROWN",80,0,0,0,80
751520,464678,2015-07-01,Senate,"Do pass, but re-refer to the Committee on Appropriations",8,0,1,0,9
751520,473765,2015-08-17,Senate,"Placed on Appropriations Suspense file",7,0,0,0,7
751520,474520,2015-08-27,Senate,"Do pass as amended",7,0,0,0,7
751521,445716,2015-05-12,Assembly,"Do pass and be re-referred to the Committee on Appropriations",10,0,0,0,10
751521,448976,2015-05-20,Assembly,"Do pass as amended, to Consent Calendar",15,0,0,2,17
751521,454066,2015-05-28,Assembly,"AB 1521 JUD.  Consent Calendar Second Day  By STONE",76,0,0,4,80
751521,474176,2015-08-25,Senate,"Do pass, but re-refer to the Committee on Appropriations",5,1,1,0,7
751521,474667,2015-08-27,Senate,"Placed on Appropriations Suspense file",7,0,0,0,7
751521,474668,2015-08-27,Senate,"Do pass",5,2,0,0,7
751521,476251,2015-09-10,Senate,"Assembly 3rd Reading AB1521 Committee On JUD. (Stone) By Roth",38,0,2,0,40
751521,476483,2015-09-11,Assembly,"AB 1521 JUD.  Concurrence- Urgency Added  By STONE",78,0,0,2,80
751522,432932,2015-04-14,Senate,"Be adopted as amended",6,0,1,0,7
751522,442157,2015-04-30,Senate,"Senate 2nd Reading SJR5 Nguyen",34,0,5,0,39
751522,462153,2015-06-23,Assembly,"From committee:  Be adopted.  To third reading",9,0,0,1,10
751522,462959,2015-06-25,Assembly,"SJR5 Nguyen  Senate Third Reading  By CHU",78,0,0,2,80
751522,464942,2015-07-02,Senate,"Unfinished Business SJR5 Nguyen Concurrence",37,0,3,0,40
751523,432547,2015-04-14,Assembly,"Do pass and be re-referred to the Committee on Appropriations",10,0,0,0,10
751523,453888,2015-05-28,Assembly,"Do pass",17,0,0,0,17
751523,455294,2015-06-01,Assembly,"AB 1519 JUD.  Assembly Third Reading  By STONE",80,0,0,0,80
751523,466436,2015-07-14,Senate,"Do pass, but re-refer to the Committee on Appropriations Recommend 	Consent",7,0,0,0,7
751523,473715,2015-08-17,Senate,"Placed on Appropriations Suspense file",7,0,0,0,7
751523,474693,2015-08-27,Senate,"Do pass",7,0,0,0,7
751523,475717,2015-09-03,Senate,"Assembly 3rd Reading AB1519 JUD. By Wieckowski",40,0,0,0,40
751523,475884,2015-09-04,Assembly,"AB 1519 JUD.  Concurrence in Senate Amendments By STONE",78,0,0,2,80
751524,440140,2015-04-28,Senate,"Do pass, but re-refer to the Committee on Appropriations",7,0,0,0,7
751524,445143,2015-05-11,Senate,"Placed on Appropriations Suspense file",7,0,0,0,7
751524,454076,2015-05-28,Senate,"Do pass as amended",7,0,0,0,7
751524,455900,2015-06-02,Senate,"Senate 3rd Reading SB795 Committee On PUB. S. (Hancock)",40,0,0,0,40
751524,466068,2015-07-14,Assembly,"Amend, and do pass as amended and be re-referred to the Committee 	on Appropriations with the recommendation:  To Consent Calendar",7,0,0,0,7
751524,473936,2015-08-19,Assembly,"Do pass, to Consent Calendar",17,0,0,0,17
751524,474340,2015-08-27,Assembly,"SB 795 PUB. S.  Consent Calendar Second Day  Regular Session",78,0,0,2,80
751524,475411,2015-09-01,Senate,"Special Consent #9 SB795 Committee On PUB. S. (Hancock)",40,0,0,0,40
751525,466396,2015-07-15,Senate,"Be adopted, but re-refer to the Committee on Elections and 	Constitutional Amendments",2,6,1,0,9
751525,466397,2015-07-15,Senate,"Set, first hearing.  Failed passage in Committee.  Reconsideration 	granted",9,0,0,0,9
751527,440218,2015-04-27,Assembly,"Do pass and be re-referred to the Committee on Appropriations to 	Consent Calendar",12,0,0,0,12
751527,443656,2015-05-06,Assembly,"Do pass, to Consent Calendar",17,0,0,0,17
751527,446602,2015-05-14,Assembly,"AB 1517 B.& F.  Consent Calendar Second Day  Regular Session",78,0,0,2,80
751527,460594,2015-06-17,Senate,"Do pass, but re-refer to the Committee on Appropriations",7,0,0,0,7
751527,465856,2015-07-13,Senate,"Assembly 3rd Reading AB1517 Committee On B. & F. (Dababneh) By Block",40,0,0,0,40
751527,466480,2015-07-16,Assembly,"AB 1517 B.& F.  Concurrence in Senate Amendments By DABABNEH",79,0,0,1,80
751528,415077,2015-03-23,Assembly,"From committee:  Be adopted.  To third reading",11,0,0,0,11
751528,434018,2015-04-16,Senate,"Assembly 3rd Reading ACR44 Dodd By Wolk",37,0,2,0,39
751529,432564,2015-04-14,Assembly,"Do pass",7,2,0,1,10
751529,434032,2015-04-16,Assembly,"AB 1522 JUD.  Assembly Third Reading  By STONE",52,19,0,9,80
751530,432842,2015-04-14,Assembly,"Do pass",7,2,0,1,10
751530,434025,2015-04-16,Assembly,"AB 1520 JUD.  Assembly Third Reading  By STONE",53,21,0,6,80
751530,553397,2016-06-14,Senate,"Do pass, but re-refer to the Committee on Appropriations",5,2,0,0,7
751530,560452,2016-08-19,Senate,"Assembly 3rd Reading AB1520 Mark Stone By Wieckowski",15,20,4,0,39
751530,560453,2016-08-19,Senate,"Assembly 3rd Reading AB1520 Mark Stone By Wieckowski",36,0,3,0,39
751531,421935,2015-03-26,Senate,"Senate 3rd Reading SCR29 Nguyen",27,1,11,0,39
751531,429266,2015-04-09,Assembly,"Be adopted, to Consent Calendar",11,0,0,0,11
751531,434040,2015-04-16,Assembly,"SCR 29 Nguyen  Consent Calendar Second Day  Regular Session",79,0,0,1,80
754320,442123,2015-04-30,Senate,"Consent Calendar 2nd SCR30 Hill",34,0,5,0,39
754320,461967,2015-06-22,Assembly,"Be adopted and re-referred to the Committee on Appropriations with 	recommendation:  To Consent Calendar",16,0,0,0,16
754320,465702,2015-07-08,Assembly,"Be adopted, to Consent Calendar",14,0,0,3,17
754320,465870,2015-07-13,Assembly,"SCR 30 Hill  Consent Calendar Second Day  Regular Session",79,0,0,1,80
754326,539650,2016-04-28,Assembly,"Be referred to Committee on Rules",11,0,0,0,11
754326,558671,2016-08-01,Assembly,"From committee:  Be adopted.  To third reading",10,0,0,1,11
754326,561451,2016-08-29,Senate,"Assembly 3rd Reading ACR45 Grove By Nielsen",39,0,0,0,39
755865,440560,2015-04-28,Senate,"Do pass, but re-refer to the Committee on Appropriations Recommend 	Consent",7,0,4,0,11
755865,447714,2015-05-18,Senate,"Consent Calendar 2nd SB797 Committee On G.O. (Hall)",36,0,3,0,39
755865,465524,2015-07-06,Assembly,"Do pass and be re-referred to the Committee on Appropriations to 	Consent Calendar",11,0,0,1,12
755865,466321,2015-07-15,Assembly,"Do pass, to Consent Calendar",16,0,0,1,17
755865,473955,2015-08-20,Assembly,"SB 797 G.O.  Consent Calendar Second Day  Regular Session",79,0,0,1,80
755868,432581,2015-04-14,Senate,"Do pass, but re-refer to the Committee on Appropriations Recommend 	Consent",10,0,1,0,11
755868,442314,2015-04-30,Senate,"Consent Calendar 2nd SB796 Committee On G.O. (Hall)",34,0,5,0,39
755868,466246,2015-07-15,Assembly,"Do pass and be re-referred to the Committee on Appropriations to 	Consent Calendar",18,0,0,3,21
755868,473877,2015-08-19,Assembly,"Do pass, to Consent Calendar",17,0,0,0,17
755868,474262,2015-08-27,Assembly,"SB 796 G.O.  Consent Calendar Second Day  Regular Session",78,0,0,2,80
755868,475477,2015-09-01,Senate,"Special Consent #9 SB796 Committee On G.O. (Hall)",40,0,0,0,40
755871,413940,2015-03-19,Senate,"Senate 3rd Reading SCR31 Wolk",35,0,3,0,38
755871,429331,2015-04-09,Assembly,"Be adopted, to Consent Calendar",11,0,0,0,11
755871,433997,2015-04-16,Assembly,"SCR 31 Wolk  Consent Calendar Second Day  Regular Session",79,0,0,1,80
755874,415196,2015-03-23,Senate,"Senate 3rd Reading SR19 Fuller",36,0,3,0,39
758330,445110,2015-05-11,Assembly,"Do pass, to Consent Calendar",15,0,0,0,15
758330,447735,2015-05-18,Assembly,"AB 1525 U.& C.  Consent Calendar Second Day  Regular Session",77,0,0,3,80
758330,460193,2015-06-16,Senate,"Do pass",10,0,1,0,11
758330,465171,2015-07-06,Senate,"Special Consent #4 AB1525 Committee On U. & C. (Rendon)",39,0,1,0,40
758338,436843,2015-04-20,Assembly,"Do pass and be re-referred to the Committee on Judiciary to Consent 	Calendar",14,0,0,1,15
758338,439944,2015-04-28,Assembly,"Do pass and be re-referred to the Committee on Appropriations to 	Consent Calendar",10,0,0,0,10
758338,446290,2015-05-13,Assembly,"Do pass, to Consent Calendar",17,0,0,0,17
758338,450136,2015-05-22,Assembly,"AB 1524 U.& C.  Consent Calendar Second Day  Regular Session",74,0,0,6,80
758338,460220,2015-06-16,Senate,"Do pass, but re-refer to the Committee on Appropriations",10,0,1,0,11
758338,476340,2015-09-10,Senate,"Assembly 3rd Reading AB1524 Committee On U. & C. (Rendon) By Hueso",38,0,2,0,40
758348,418607,2015-03-26,Senate,"Senate 3rd Reading SCR32 Beall",32,0,7,0,39
758348,430594,2015-04-13,Assembly,"From committee:  Be adopted.  To third reading",11,0,0,0,11
758348,438367,2015-04-23,Senate,"Unfinished Business SCR32 Beall Concurrence",38,0,1,0,39
758361,436148,2015-04-21,Assembly,"Do pass and be re-referred to the Committee on Health",6,0,0,1,7
758361,441274,2015-04-28,Assembly,"Do pass and be re-referred to the Committee on Appropriations",13,0,0,6,19
758361,453815,2015-05-28,Assembly,"Do pass",17,0,0,0,17
758361,455277,2015-06-01,Assembly,"AB 1526 AGING& L.T.C.  Assembly Third Reading  By BROWN",79,0,0,1,80
758361,464810,2015-07-01,Senate,"Do pass, but re-refer to the Committee on Appropriations Recommend 	Consent",8,0,1,0,9
758361,473755,2015-08-17,Senate,"Placed on Appropriations Suspense file",7,0,0,0,7
758361,474532,2015-08-27,Senate,"Do pass",7,0,0,0,7
758361,476078,2015-09-09,Senate,"Assembly 3rd Reading AB1526 Committee On AGING & LTC. (Brown) By 	Allen",40,0,0,0,40
758361,476433,2015-09-10,Assembly,"AB 1526 AGING& L.T.C.  Concurrence in Senate Amendments By BROWN",80,0,0,0,80
759165,461197,2015-06-18,Senate,"Senate 3rd Reading SJR6 Stone",28,0,12,0,40
759195,427849,2015-04-07,Assembly,"From committee:  Be adopted.  To third reading",6,0,0,1,7
759195,474106,2015-08-24,Senate,"Assembly 3rd Reading ACR46 Calderon By Nielsen",40,0,0,0,40
759815,440265,2015-04-28,Assembly,"Do pass",14,0,0,1,15
759815,442299,2015-04-30,Assembly,"AB 1528 W., P.& W.  Assembly Third Reading  By LEVINE",75,0,0,5,80
759815,462191,2015-06-23,Senate,"Do pass",7,2,0,0,9
759815,463849,2015-06-29,Senate,"Assembly 3rd Reading AB1528 Committee on Water, Pa rks, and 	WildlifeBy Pa",37,2,1,0,40
759835,440037,2015-04-28,Senate,"Do pass as amended, but re-refer to the Committee on Appropriations 	Recommend Consent",8,0,1,0,9
759835,450210,2015-05-22,Senate,"Consent Calendar 2nd SB798 Committee On N.R. & W. (Pavley)",38,0,1,0,39
759835,464451,2015-06-30,Assembly,"Amend, and do pass as amended and be re-referred to the Committee 	on Appropriations with the recommendation:  To Consent Calendar",15,0,0,0,15
759835,473941,2015-08-19,Assembly,"Do pass, to Consent Calendar",17,0,0,0,17
759835,474449,2015-08-27,Assembly,"SB 798 N.R.& W.  Consent Calendar Second Day  Regular Session",78,0,0,2,80
759835,475466,2015-09-01,Senate,"Special Consent #9 SB798 Committee On N.R. & W. (Pavley)",40,0,0,0,40
759845,414961,2015-03-23,Assembly,"Be adopted as amended",11,0,0,0,11
759845,447606,2015-05-18,Senate,"Special Consent #1 ACR48 Cooley",36,0,3,0,39
759856,440147,2015-04-28,Assembly,"Do pass and be re-referred to the Committee on Appropriations to 	Consent Calendar",15,0,0,0,15
759856,443721,2015-05-06,Assembly,"Do pass, to Consent Calendar",17,0,0,0,17
759856,446600,2015-05-14,Assembly,"AB 1527 W., P.& W.  Consent Calendar Second Day  Regular Session",78,0,0,2,80
759856,462154,2015-06-23,Senate,"Do pass, but re-refer to the Committee on Appropriations Recommend 	Consent",9,0,0,0,9
759856,465810,2015-07-09,Senate,"Consent Calendar 2nd AB1527 Committee on Water, Pa rks, and Wildlife",39,0,1,0,40
759866,440059,2015-04-27,Senate,"Do pass, but re-refer to the Committee on Appropriations Recommend 	Consent",9,0,0,0,9
759866,447658,2015-05-18,Senate,"Consent Calendar 2nd SB799 Committee On B.P.&E.D. (Hill)",36,0,3,0,39
759866,465411,2015-07-07,Assembly,"Do pass and be re-referred to the Committee on Appropriations to 	Consent Calendar",14,0,0,0,14
759866,474731,2015-07-15,Assembly,"Do pass, to Consent Calendar",16,0,0,1,17
759866,553699,2016-06-16,Assembly,"Be referred to Committee on Education",10,0,0,1,11
759876,440418,2015-04-27,Senate,"Do pass, but re-refer to the Committee on Appropriations Recommend 	Consent",9,0,0,0,9
759876,447631,2015-05-18,Senate,"Consent Calendar 2nd SB800 Committee On B.P.&E.D. (Hill)",36,0,3,0,39
759876,465483,2015-07-07,Assembly,"Amend, and do pass as amended and be re-referred to the Committee 	on Appropriations with the recommendation:  To Consent Calendar",14,0,0,0,14
759876,474217,2015-08-26,Assembly,"Do pass, to Consent Calendar",17,0,0,0,17
759876,476010,2015-09-08,Assembly,"SB 800 B. P.& E.D.  Senate Third Reading  By GORDON",79,0,0,1,80
759876,476309,2015-09-10,Senate,"Unfinished Business SB800 Committee On B.P.&E.D. (Hill) Concurrence",39,0,1,0,40
759887,439575,2015-04-27,Assembly,"From committee:  Be adopted.  To third reading",10,0,0,1,11
759887,454405,2015-05-28,Senate,"Assembly 3rd Reading ACR47 Chau By Lara",38,0,2,0,40
759897,441086,2015-04-28,Assembly,"Do pass and be re-referred to the Committee on Appropriations",9,0,0,0,9
759897,443531,2015-05-06,Assembly,"Do pass, to Consent Calendar",17,0,0,0,17
759897,446655,2015-05-14,Assembly,"AB 1530 V. A.  Consent Calendar Second Day  Regular Session",78,0,0,2,80
759897,462134,2015-06-23,Senate,"Do pass, but re-refer to the Committee on Appropriations Recommend 	Consent",5,0,0,0,5
759897,534858,2016-04-19,Senate,"Do pass as amended, and re-refer to the Committee on Environmental 	Quality",6,4,1,0,11
760464,436060,2015-04-21,Assembly,"Be adopted, to Consent Calendar",7,0,0,0,7
760464,459545,2015-06-11,Senate,"Assembly 3rd Reading ACR49 Weber By Wolk",37,0,3,0,40
760491,439696,2015-04-27,Senate,"Senate 3rd Reading SJR7 Pan",36,0,3,0,39
760491,462200,2015-06-23,Assembly,"Be adopted, to Consent Calendar",19,0,0,0,19
760491,463904,2015-06-29,Assembly,"SJR7 Pan  Consent Calendar Second Day  Regular Session",76,0,0,4,80
760520,430598,2015-04-13,Senate,"Senate 3rd Reading SCR33 Fuller",34,0,5,0,39
760520,444428,2015-05-07,Assembly,"Be adopted, to Consent Calendar",8,0,0,3,11
760520,446653,2015-05-14,Assembly,"SCR 33 Fuller  Consent Calendar Second Day  Regular Session",78,0,0,2,80
760547,429248,2015-04-09,Assembly,"From committee:  Be adopted.  To third reading",7,0,0,4,11
760547,466564,2015-07-16,Senate,"Assembly 3rd Reading ACR50 Gonzalez By Jackson",36,0,4,0,40
761532,440066,2015-04-28,Assembly,"Do pass and be re-referred to the Committee on Appropriations",7,0,0,0,7
761532,443571,2015-05-06,Assembly,"Do pass, to Consent Calendar",17,0,0,0,17
761532,446774,2015-05-14,Assembly,"AB 1531 E.S.& T.M.  Consent Calendar Second Day  Regular Session",78,0,0,2,80
761532,473972,2015-08-20,Senate,"Consent Calendar 2nd AB1531 Committee On E.S. & T.M. (Alejo)",38,0,2,0,40
761532,474107,2015-08-24,Assembly,"AB 1531 E.S.& T.M.  Concurrence in Senate Amendments By ALEJO",80,0,0,0,80
761576,430680,2015-04-13,Assembly,"Be adopted, to Consent Calendar",11,0,0,0,11
761576,433948,2015-04-16,Assembly,"ACR 51 WOOD  Consent Calendar Second Day  Regular Session",79,0,0,1,80
761576,447807,2015-05-18,Senate,"Special Consent #1 ACR51 Wood",36,0,3,0,39
761620,444029,2015-05-06,Assembly,"Do pass, to Consent Calendar",9,0,0,0,9
761620,453952,2015-05-28,Assembly,"AB 1532 L. GOV.  Assembly Third Reading  By MAIENSCHEIN",78,0,0,2,80
761620,462759,2015-06-24,Senate,"Do pass and be placed on the Consent Calendar",7,0,0,0,7
761620,464938,2015-07-02,Senate,"Consent Calendar 2nd AB1532 Committee On L. GOV. (Maienschein)",38,0,2,0,40
762236,463003,2015-06-24,Assembly,"From committee:  Be adopted.  To third reading",5,2,0,0,7
762236,463916,2015-06-29,Assembly,"AJR 12 GARCIA, E.  Assembly Third Reading",49,20,0,11,80
762250,440877,2015-04-29,Senate,"Do pass, but re-refer to the Committee on Appropriations Recommend 	Consent",6,0,1,0,7
762250,447720,2015-05-18,Senate,"Consent Calendar 2nd SB802 Committee On GOV. & F. (Hertzberg) 	Urgency Clause",36,0,3,0,39
762264,440903,2015-04-29,Senate,"Do pass, but re-refer to the Committee on Appropriations Recommend 	Consent",6,0,1,0,7
762264,447731,2015-05-18,Senate,"Consent Calendar 2nd SB803 Committee On GOV. & F. (Hertzberg)",36,0,3,0,39
762264,466170,2015-07-13,Assembly,"Do pass as amended",8,0,0,1,9
762264,474228,2015-08-26,Assembly,"Do pass, to Consent Calendar",17,0,0,0,17
762264,475491,2015-09-01,Assembly,"SB 803 GOV.& F.  Consent Calendar Second Day  By TING",80,0,0,0,80
762264,475660,2015-09-02,Senate,"Unfinished Business SB803 Committee On GOV. & F. (Hertzberg) 	Concurrence",40,0,0,0,40
762279,440925,2015-04-29,Senate,"Do pass, but re-refer to the Committee on Appropriations Recommend 	Consent",6,0,1,0,7
762279,447599,2015-05-18,Senate,"Special Consent #1 SB801 Committee On GOV. & F. (Hertzberg)",36,0,3,0,39
762279,466164,2015-07-13,Assembly,"Do pass as amended",8,0,0,1,9
762279,475424,2015-09-01,Assembly,"SB 801 GOV.& F.  Senate Third Reading  By TING",80,0,0,0,80
762279,475685,2015-09-02,Senate,"Unfinished Business SB801 Committee On GOV. & F. (Hertzberg) 	Concurrence",40,0,0,0,40
762294,441674,2015-04-29,Assembly,"Do pass and be re-referred to the Committee on Appropriations",8,0,0,1,9
762294,453032,2015-05-27,Assembly,"Do pass",17,0,0,0,17
762294,455353,2015-06-01,Assembly,"AB 1533 J., E.D.& E.  Assembly Third Reading  By GARCIA, E",80,0,0,0,80
762294,465519,2015-07-06,Senate,"Do pass, but re-refer to the Committee on Appropriations Recommend 	Consent",9,0,0,0,9
762294,473615,2015-08-17,Senate,"Placed on Appropriations Suspense file",7,0,0,0,7
762294,474696,2015-08-27,Senate,"Do pass as amended",7,0,0,0,7
762294,475682,2015-09-02,Senate,"Assembly 3rd Reading AB1533 Committee on Jobs, Eco nomic 	Development, an",40,0,0,0,40
762294,475799,2015-09-03,Assembly,"AB 1533 J., E.D.& E.  Concurrence in Senate Amendments By GARCIA, E",78,0,0,2,80
762962,441512,2015-04-29,Assembly,"Do pass and be re-referred to the Committee on Appropriations to 	Consent Calendar",8,0,0,1,9
762962,446463,2015-05-13,Assembly,"Do pass",17,0,0,0,17
762962,447715,2015-05-18,Assembly,"AB 1537 J., E.D.& E.  Assembly Third Reading  By GARCIA, E",77,0,0,3,80
762962,460079,2015-06-15,Senate,"Do pass, but re-refer to the Committee on Appropriations Recommend 	Consent",9,0,0,0,9
762962,465805,2015-07-09,Senate,"Consent Calendar 2nd AB1537 Committee on Jobs, Eco nomic 	Development, an",39,0,1,0,40
762962,466526,2015-07-16,Assembly,"AB 1537 J., E.D.& E.  Concurrence in Senate Amendments By GARCIA, E",79,0,0,1,80
762973,447703,2015-05-18,Senate,"Special Consent #1 SR20 Berryhill",36,0,3,0,39
762986,434002,2015-04-16,Senate,"Senate 3rd Reading SCR34 Monning",29,4,6,0,39
762986,463022,2015-06-25,Assembly,"From committee:  Be adopted.  To third reading",8,2,0,1,11
762998,446379,2015-05-13,Assembly,"Do pass, to Consent Calendar",7,0,0,0,7
762998,450274,2015-05-22,Assembly,"AB 1536 E.& R.  Consent Calendar Second Day  Regular Session",74,0,0,6,80
762998,460346,2015-06-16,Senate,"Do pass and be placed on the Consent Calendar",5,0,0,0,5
762998,476039,2015-09-08,Senate,"Assembly 3rd Reading AB1536 Committee On E.&R.(Ridley-Thomas) By 	Anderson",40,0,0,0,40
763011,440362,2015-04-27,Assembly,"Amend, and do pass as amended and be re-referred to the Committee 	on Appropriations with the recommendation:  To Consent Calendar",9,0,0,0,9
763011,454110,2015-05-28,Assembly,"Do pass",17,0,0,0,17
763011,455966,2015-06-02,Assembly,"AB 1534 REV.& TAX.  Assembly Third Reading  By TING",79,0,0,1,80
763011,462626,2015-06-24,Senate,"Do pass, but re-refer to the Committee on Appropriations Recommend 	Consent",7,0,0,0,7
763011,465265,2015-07-06,Senate,"Placed on Appropriations Suspense file",7,0,0,0,7
763011,474703,2015-08-27,Senate,"Do pass",7,0,0,0,7
763011,475628,2015-09-02,Senate,"Assembly 3rd Reading AB1534 Committee On REV. & TAX. (Ting) By 	Nguyen",38,0,2,0,40
763024,446445,2015-05-13,Assembly,"Do pass, to Consent Calendar",7,0,0,0,7
763024,450146,2015-05-22,Assembly,"AB 1535 E.& R.  Consent Calendar Second Day  Regular Session",74,0,0,6,80
763024,465477,2015-07-07,Senate,"Do pass as amended",4,0,1,0,5
763024,476158,2015-09-09,Senate,"Assembly 3rd Reading AB1535 Committee On E.&R.(Ridley-Thomas) By 	Allen",40,0,0,0,40
763024,476314,2015-09-10,Assembly,"AB 1535 E.& R.  Concurrence in Senate Amendments By RIDLEY-THOMAS",80,0,0,0,80
763818,440483,2015-04-28,Assembly,"Do pass, to Consent Calendar",7,0,0,0,7
763818,442936,2015-05-04,Assembly,"AB 1538 A.,E.,S.,T.,& I.M.  Consent Calendar Second Day  Regular 	Session",78,0,0,2,80
763818,458574,2015-06-10,Senate,"Do pass and be placed on the Consent Calendar",8,0,0,1,9
763818,461277,2015-06-18,Senate,"Consent Calendar 2nd AB1538 Committee on Arts, Ent ertainment, 	Sports, To",37,0,3,0,40
763820,443360,2015-05-05,Assembly,"Do pass, to Consent Calendar",11,0,0,0,11
763820,446771,2015-05-14,Assembly,"AB 1541 P.& C.P.  Consent Calendar Second Day  Regular Session",78,0,0,2,80
763820,460672,2015-06-16,Senate,"Do pass and be placed on the Consent Calendar",7,0,0,0,7
763820,463012,2015-06-25,Senate,"Consent Calendar 2nd AB1541 Committee On P. & C.P. (Gatto)",37,0,3,0,40
763822,441803,2015-04-29,Senate,"Be adopted as amended, and re-refer to the Committee on 	Appropriations",6,0,3,0,9
763822,446696,2015-05-14,Senate,"Senate 3rd Reading SCR35 Stone",35,0,4,0,39
763822,462115,2015-06-23,Assembly,"Be adopted as amended",12,0,0,1,13
763822,466479,2015-07-16,Senate,"Unfinished Business SCR35 Stone Concurrence",37,0,3,0,40
763823,438165,2015-04-23,Assembly,"From committee:  Be adopted.  To third reading",10,0,0,1,11
763823,447691,2015-05-18,Senate,"Special Consent #1 ACR52 Frazier",36,0,3,0,39
763824,443821,2015-05-06,Assembly,"Do pass, to Consent Calendar",18,0,0,3,21
763824,446731,2015-05-14,Assembly,"AB 1540 G.O.  Consent Calendar Second Day  Regular Session",78,0,0,2,80
763824,464098,2015-06-29,Senate,"Do pass and be placed on the Consent Calendar",12,0,1,0,13
763824,475658,2015-09-02,Senate,"Assembly 3rd Reading AB1540 Gray By Jackson",39,0,1,0,40
763824,475711,2015-09-03,Assembly,"AB 1540 GRAY  Concurrence- Urgency Added",79,0,0,1,80
763825,442315,2015-04-29,Senate,"Do pass, but re-refer to the Committee on Appropriations Recommend 	Consent",9,0,0,0,9
763825,445137,2015-05-11,Senate,"Placed on Appropriations Suspense file",7,0,0,0,7
763825,454187,2015-05-28,Senate,"Do pass",7,0,0,0,7
763825,455540,2015-06-01,Senate,"Senate 3rd Reading SB804 Committee On HEALTH (Hernandez)",39,0,1,0,40
763825,465430,2015-07-07,Assembly,"Do pass and be re-referred to the Committee on Appropriations to 	Consent Calendar",19,0,0,0,19
763825,474257,2015-08-27,Assembly,"Do pass as amended",17,0,0,0,17
763825,476293,2015-09-10,Assembly,"SB 804 HEALTH  Senate Third Reading  By BONTA",76,1,0,3,80
763825,476596,2015-09-11,Senate,"Unfinished Business SB804 Committee On HEALTH (Hernandez) 	Concurrence",40,0,0,0,40
763826,439468,2015-04-27,Assembly,"Do pass and be re-referred to the Committee on Appropriations to 	Consent Calendar",20,0,0,1,21
767192,434064,2015-04-16,Senate,"Senate 3rd Reading SR21 Lara",38,0,1,0,39
767196,430655,2015-04-13,Assembly,"From committee:  Be adopted.  To third reading",11,0,0,0,11
767198,436450,2015-04-20,Assembly,"Be adopted and re-referred to the Committee on Appropriations with 	recommendation:  To Consent Calendar",15,0,0,1,16
767198,441491,2015-04-29,Assembly,"Be adopted, to Consent Calendar",17,0,0,0,17
767198,445326,2015-05-11,Assembly,"ACR 53 DAHLE  Assembly Third Reading",78,0,0,2,80
767198,462146,2015-06-23,Senate,"Be adopted, but re-refer to the Committee on Appropriations 	Recommend Consent",11,0,0,0,11
767198,465862,2015-07-13,Senate,"Assembly 3rd Reading ACR53 Dahle By Nielsen",39,0,1,0,40
767198,466450,2015-07-16,Assembly,"ACR 53 DAHLE  Concurrence in Senate Amendments",79,0,0,1,80
767482,464831,2015-07-01,Assembly,"From committee:  Be adopted.  To third reading",6,0,0,1,7
767482,473764,2015-08-17,Assembly,"AJR 13 RIDLEY-THOMAS  Assembly Third Reading",78,0,0,2,80
767482,476040,2015-09-08,Senate,"Assembly 3rd Reading AJR13 Ridley-Thomas By Hall",40,0,0,0,40
768083,444404,2015-05-07,Senate,"Senate 3rd Reading SCR40 Leyva",34,0,5,0,39
768083,453639,2015-05-28,Assembly,"Be adopted, to Consent Calendar",11,0,0,0,11
768083,456008,2015-06-02,Assembly,"SCR 40 Leyva  Consent Calendar Second Day  Regular Session",78,0,0,2,80
768084,435986,2015-04-20,Assembly,"Be adopted and re-referred to the Committee on Appropriations with 	recommendation:  To Consent Calendar",15,0,0,1,16
768084,440968,2015-04-29,Assembly,"Be adopted, to Consent Calendar",17,0,0,0,17
768084,442978,2015-05-04,Assembly,"ACR 54 WOOD  Consent Calendar Second Day  Regular Session",78,0,0,2,80
768084,460493,2015-06-16,Senate,"Be adopted, but re-refer to the Committee on Appropriations 	Recommend Consent",11,0,0,0,11
768084,464925,2015-07-02,Senate,"Consent Calendar 2nd ACR54 Wood",38,0,2,0,40
768085,433972,2015-04-16,Assembly,"From committee:  Be adopted.  To third reading",11,0,0,0,11
768085,447745,2015-05-18,Senate,"Special Consent #1 ACR55 Irwin",36,0,3,0,39
768087,439719,2015-04-27,Senate,"Senate 3rd Reading SCR37 De Le",35,0,4,0,39
768087,450301,2015-05-22,Assembly,"From committee:  Be adopted.  To third reading",7,3,0,1,11
768087,454184,2015-05-28,Assembly,"SCR 37 De Leon  Senate Third Reading  By GORDON",51,25,0,4,80
768088,443486,2015-05-05,Senate,"Be adopted as amended, but re-refer to the Committee on 	Appropriations Recommend Consent",9,0,2,0,11
768088,450246,2015-05-22,Senate,"Consent Calendar 2nd SCR38 Roth",38,0,1,0,39
768088,461896,2015-06-22,Assembly,"Be adopted and re-referred to the Committee on Appropriations with 	recommendation:  To Consent Calendar",16,0,0,0,16
768088,465713,2015-07-08,Assembly,"Be adopted, to Consent Calendar",14,0,0,3,17
768088,465883,2015-07-13,Assembly,"SCR 38 Roth  Consent Calendar Second Day  Regular Session",79,0,0,1,80
768091,443140,2015-05-04,Senate,"Senate 3rd Reading SCR39 Block",36,0,3,0,39
768091,459779,2015-06-15,Assembly,"From committee:  Be adopted.  To third reading",10,0,0,1,11
768091,462954,2015-06-25,Senate,"Unfinished Business SCR39 Block Concurrence",37,0,3,0,40
768770,442177,2015-04-30,Senate,"Senate 3rd Reading SCR41 Hancock",37,0,2,0,39
768770,459948,2015-06-15,Assembly,"Be adopted, to Consent Calendar",10,0,0,1,11
768770,461147,2015-06-18,Assembly,"SCR 41 Hancock  Consent Calendar Second Day  Regular Session",75,0,0,5,80
768771,435216,2015-04-20,Senate,"Senate 3rd Reading SR22 Allen",28,5,6,0,39
769348,442339,2015-04-30,Senate,"Senate 3rd Reading SCR42 Huff",37,0,2,0,39
769348,450101,2015-05-22,Assembly,"Be adopted, to Consent Calendar",10,0,0,1,11
769348,453812,2015-05-28,Assembly,"SCR 42 Huff  Consent Calendar Second Day  Regular Session",76,0,0,4,80
769348,455889,2015-06-02,Senate,"Unfinished Business SCR42 Huff Concurrence",33,0,7,0,40
771950,442197,2015-04-30,Assembly,"From committee:  Be adopted.  To third reading",10,0,0,1,11
772960,442116,2015-04-30,Assembly,"From committee:  Be adopted.  To third reading",10,0,0,1,11
772961,438400,2015-04-23,Senate,"Senate 3rd Reading SCR44 Nielsen",37,0,2,0,39
772961,454022,2015-05-28,Assembly,"Be adopted, to Consent Calendar",11,0,0,0,11
772961,455942,2015-06-02,Assembly,"SCR 44 Nielsen  Consent Calendar Second Day  Regular Session",78,0,0,2,80
772962,528528,2016-04-04,Assembly,"Amend, and be adopted as amended and be re-referred to the 	Committee on Appropriations with the recommendation:  To Consent 	Calendar",9,0,0,0,9
772964,465624,2015-07-08,Assembly,"Be adopted, to Consent Calendar",20,0,0,1,21
772964,466451,2015-07-16,Assembly,"ACR 56 LINDER  Consent Calendar Second Day  Regular Session",79,0,0,1,80
772964,475566,2015-09-02,Senate,"Assembly 3rd Reading ACR56 Linder By Allen",40,0,0,0,40
772964,475714,2015-09-03,Assembly,"ACR 56 LINDER  Concurrence in Senate Amendments",78,0,0,2,80
772965,442160,2015-04-30,Assembly,"From committee:  Be adopted.  To third reading",10,0,0,1,11
772966,439455,2015-04-27,Senate,"Senate 3rd Reading SCR43 Galgiani",35,0,4,0,39
772966,454027,2015-05-28,Assembly,"Be adopted, to Consent Calendar",11,0,0,0,11
772966,456096,2015-06-02,Assembly,"SCR 43 Galgiani  Consent Calendar Second Day  Regular Session",78,0,0,2,80
772967,444445,2015-05-07,Assembly,"From committee:  Be adopted.  To third reading",8,0,0,3,11
772967,461925,2015-06-22,Senate,"Assembly 3rd Reading ACR57 Achadjian By Monning",36,0,4,0,40
773354,466066,2015-07-14,Senate,"Be adopted, but re-refer to the Committee on Appropriations 	Recommend Consent",11,0,0,0,11
773354,474020,2015-08-20,Senate,"Consent Calendar 2nd SCR45 Berryhill",38,0,2,0,40
773354,476620,2015-09-11,Assembly,"Be adopted and re-referred to the Committee on Appropriations with 	recommendation:  To Consent Calendar",16,0,0,0,16
773354,486278,2016-01-21,Assembly,"Be adopted, to Consent Calendar",17,0,0,0,17
773354,488372,2016-01-27,Assembly,"SCR 45 Berryhill, T.  Consent Calendar Second Day  Regular Session",78,0,0,1,79
773720,442333,2015-04-30,Senate,"Senate 3rd Reading SR23 Fuller",36,0,3,0,39
773721,461914,2015-06-22,Assembly,"Be adopted and re-referred to the Committee on Appropriations with 	recommendation:  To Consent Calendar",16,0,0,0,16
773721,465706,2015-07-08,Assembly,"From committee:  Be adopted.  To third reading",14,0,0,3,17
773721,465766,2015-07-09,Assembly,"ACR 58 WILLIAMS  Assembly Third Reading",77,0,0,3,80
773721,473821,2015-08-18,Senate,"Be adopted, but re-refer to the Committee on Appropriations 	Recommend Consent",10,0,1,0,11
773721,474338,2015-08-27,Senate,"Consent Calendar 2nd ACR58 Williams",40,0,0,0,40
774076,442988,2015-05-04,Senate,"Senate 3rd Reading SCR46 Bates",36,0,3,0,39
774076,450174,2015-05-22,Assembly,"From committee:  Be adopted.  To third reading",10,0,0,1,11
774076,453714,2015-05-28,Senate,"Unfinished Business SCR46 Bates Concurrence",39,0,0,0,39
774126,462123,2015-06-08,Assembly,"Do pass and be re-referred to the Committee on Appropriations",12,0,0,1,13
774126,465626,2015-07-08,Assembly,"Do pass, to Consent Calendar",14,0,0,3,17
774126,466504,2015-07-16,Assembly,"AB 1542 MATHIS  Consent Calendar Second Day",79,0,0,1,80
774126,475440,2015-09-01,Senate,"Assembly 3rd Reading AB1542 Mathis By Beall",40,0,0,0,40
774659,446810,2015-05-14,Senate,"Senate 3rd Reading SCR47 Fuller",35,0,4,0,39
774659,455273,2015-06-01,Assembly,"Be adopted, to Consent Calendar",11,0,0,0,11
774659,456705,2015-06-03,Assembly,"SCR 47 Fuller  Consent Calendar Second Day",77,0,0,3,80
774660,445094,2015-05-11,Senate,"Senate 3rd Reading SCR48 McGuire",36,0,3,0,39
774660,462132,2015-06-22,Assembly,"Be adopted, to Consent Calendar",13,0,0,1,14
774660,462977,2015-06-25,Assembly,"SCR 48 McGuire  Consent Calendar Second Day  Regular Session",79,0,0,1,80
774661,450291,2015-05-22,Assembly,"From committee:  Be adopted.  To third reading",10,0,0,1,11
774661,461842,2015-06-22,Senate,"Special Consent #3 ACR59 Maienschein",37,0,3,0,40
774662,442831,2015-05-04,Assembly,"From committee:  Be adopted.  To third reading",8,0,0,3,11
774662,444398,2015-05-07,Assembly,"HR 20 WILLIAMS  Assembly Third Reading",77,0,0,3,80
775038,447600,2015-05-13,Assembly,"Be adopted, as amended, to Consent Calendar",7,0,0,0,7
775038,450199,2015-05-22,Assembly,"ACR 60 SANTIAGO  Consent Calendar Second Day  Regular Session",74,0,0,6,80
775038,461051,2015-06-17,Senate,"Be adopted and be placed on the Consent Calendar",8,0,1,0,9
775038,465273,2015-07-06,Senate,"Assembly 3rd Reading ACR60 Santiago By Pan",39,0,1,0,40
775078,444368,2015-05-07,Assembly,"From committee:  Be adopted.  To third reading",8,0,0,3,11
775078,454406,2015-05-28,Senate,"Assembly 3rd Reading ACR61 Chu By Pan",38,0,2,0,40
775431,445262,2015-05-11,Senate,"Senate 3rd Reading SCR50 Nielsen",36,0,3,0,39
775431,464737,2015-06-30,Assembly,"From committee:  Be adopted.  To third reading",8,0,0,1,9
775431,475574,2015-09-02,Senate,"Unfinished Business SCR50 Nielsen Concurrence",40,0,0,0,40
775452,450254,2015-05-22,Assembly,"From committee:  Be adopted.  To third reading",10,0,0,1,11
775452,465160,2015-07-06,Senate,"Special Consent #4 ACR62 Baker",39,0,1,0,40
775474,445191,2015-05-11,Senate,"Senate 3rd Reading SCR49 Berryhill",36,0,3,0,39
775474,458190,2015-06-08,Assembly,"Be adopted, to Consent Calendar",11,0,0,0,11
775474,459552,2015-06-11,Assembly,"SCR 49 Berryhill, T.  Consent Calendar Second Day  Regular Session",79,0,0,1,80
775474,461932,2015-06-22,Senate,"Special Consent #3 SCR49 Berryhill",37,0,3,0,40
775863,460233,2015-06-16,Senate,"Be adopted, but re-refer to the Committee on Appropriations 	Recommend Consent",11,0,0,0,11
775863,464948,2015-07-02,Senate,"Consent Calendar 2nd SCR51 Stone",38,0,2,0,40
775863,476602,2015-09-11,Assembly,"Be adopted and re-referred to the Committee on Appropriations with 	recommendation:  To Consent Calendar",16,0,0,0,16
775863,486332,2016-01-21,Assembly,"Be adopted, to Consent Calendar",17,0,0,0,17
775863,488451,2016-01-27,Assembly,"SCR 51 Stone  Consent Calendar Second Day  Regular Session",78,0,0,1,79
775879,445145,2015-05-11,Assembly,"From committee:  Be adopted.  To third reading",10,0,0,1,11
775901,446609,2015-05-14,Senate,"Senate 3rd Reading SCR52 Huff",38,0,1,0,39
775901,454121,2015-05-28,Assembly,"Be adopted, to Consent Calendar",11,0,0,0,11
775901,456015,2015-06-02,Assembly,"SCR 52 Huff  Consent Calendar Second Day  Regular Session",78,0,0,2,80
775901,457292,2015-06-04,Senate,"Unfinished Business SCR52 Huff Concurrence",39,0,1,0,40
776463,450120,2015-05-22,Senate,"Special Consent #2 SCR53 Galgiani",38,0,1,0,39
776463,457260,2015-06-04,Assembly,"Be adopted, to Consent Calendar",10,0,0,1,11
776463,459551,2015-06-11,Assembly,"SCR 53 Galgiani  Consent Calendar Second Day  Regular Session",79,0,0,1,80
776833,447729,2015-05-18,Senate,"Senate 3rd Reading SCR55 Pan",36,0,3,0,39
776833,464478,2015-06-30,Assembly,"From committee:  Be adopted.  To third reading",6,0,0,1,7
776833,474015,2015-08-20,Senate,"Unfinished Business SCR55 Pan Concurrence",38,0,2,0,40
776834,462033,2015-06-22,Assembly,"Be adopted and re-referred to the Committee on Appropriations with 	recommendation:  To Consent Calendar",16,0,0,0,16
776834,465639,2015-07-08,Assembly,"From committee:  Be adopted.  To third reading",14,0,0,3,17
776834,465787,2015-07-09,Assembly,"ACR 63 MAIENSCHEIN  Assembly Third Reading",77,0,0,3,80
776834,473826,2015-08-18,Senate,"Be adopted, but re-refer to the Committee on Appropriations 	Recommend Consent",10,0,1,0,11
776834,474376,2015-08-27,Senate,"Consent Calendar 2nd ACR63 Maienschein",40,0,0,0,40
776834,475286,2015-08-31,Assembly,"ACR 63 MAIENSCHEIN  Concurrence in Senate Amendments",79,0,0,1,80
776835,446704,2015-05-14,Assembly,"From committee:  Be adopted.  To third reading",10,0,0,1,11
776835,461874,2015-06-22,Senate,"Special Consent #3 ACR64 Santiago",37,0,3,0,40
776837,455462,2015-06-01,Senate,"Senate 3rd Reading SCR58 Pan",38,0,2,0,40
776837,462932,2015-06-25,Assembly,"Be adopted, to Consent Calendar",11,0,0,0,11
776837,464951,2015-07-02,Assembly,"SCR 58 Pan  Consent Calendar Second Day  Regular Session",78,0,0,2,80
776837,465734,2015-07-09,Senate,"Unfinished Business SCR58 Pan Concurrence",36,0,4,0,40
776838,455654,2015-06-01,Senate,"Senate 3rd Reading SCR54 Nguyen",38,0,2,0,40
776838,461679,2015-06-19,Assembly,"Be adopted, to Consent Calendar",10,0,0,1,11
776838,462942,2015-06-25,Assembly,"SCR 54 Nguyen  Consent Calendar Second Day",79,0,0,1,80
776839,450073,2015-05-22,Senate,"Special Consent #2 SCR56 Pan",38,0,1,0,39
776839,461877,2015-06-22,Assembly,"From committee:  Be adopted.  To third reading",9,0,0,2,11
776839,466453,2015-07-16,Senate,"Unfinished Business SCR56 Pan Concurrence",36,0,4,0,40
776840,450228,2015-05-22,Senate,"Special Consent #2 SCR59 Galgiani",38,0,1,0,39
776840,462103,2015-06-23,Assembly,"Be adopted and re-referred to the Committee on Appropriations with 	recommendation:  To Consent Calendar",19,0,0,0,19
776840,465633,2015-07-08,Assembly,"Be adopted, to Consent Calendar",14,0,0,3,17
776840,465933,2015-07-13,Assembly,"SCR 59 Galgiani  Consent Calendar Second Day  Regular Session",79,0,0,1,80
776841,450219,2015-05-22,Senate,"Special Consent #2 SCR57 Pan",38,0,1,0,39
776841,461153,2015-06-18,Assembly,"Be adopted, to Consent Calendar",11,0,0,0,11
776841,461887,2015-06-22,Assembly,"SCR 57 Pan  Consent Calendar Second Day  Regular Session",77,0,0,3,80
776841,465127,2015-07-06,Senate,"Special Consent #4 SCR57 Pan",39,0,1,0,40
777204,450211,2015-05-22,Senate,"Special Consent #2 SCR60 McGuire",38,0,1,0,39
777204,459387,2015-06-11,Assembly,"Be adopted, to Consent Calendar",10,0,0,1,11
777204,461183,2015-06-18,Assembly,"SCR 60 McGuire  Consent Calendar Second Day",75,0,0,5,80
777228,461882,2015-06-22,Assembly,"Be adopted and re-referred to the Committee on Appropriations with 	recommendation:  To Consent Calendar",16,0,0,0,16
777228,465718,2015-07-08,Assembly,"From committee:  Be adopted.  To third reading",14,0,0,3,17
777228,465796,2015-07-09,Assembly,"ACR 65 BROUGH  Assembly Third Reading",78,0,0,2,80
777228,473832,2015-08-18,Senate,"Be adopted, but re-refer to the Committee on Appropriations 	Recommend Consent",10,0,1,0,11
777228,474387,2015-08-27,Senate,"Consent Calendar 2nd ACR65 Brough",40,0,0,0,40
777228,475373,2015-08-31,Assembly,"ACR 65 BROUGH  Concurrence in Senate Amendments",79,0,0,1,80
777583,455440,2015-06-01,Senate,"Senate 3rd Reading SJR8 Hernandez",40,0,0,0,40
777583,466192,2015-07-14,Assembly,"Be adopted, to Consent Calendar",19,0,0,0,19
777583,473711,2015-08-17,Assembly,"SJR8 Hernandez  Consent Calendar Second Day  Regular Session",79,0,0,1,80
777589,446726,2015-05-14,Senate,"Senate 3rd Reading SR24 De Le",35,0,4,0,39
777608,450149,2015-05-22,Assembly,"From committee:  Be adopted.  To third reading",8,0,0,1,9
777608,453698,2015-05-28,Assembly,"AJR 14 CHU  Assembly Third Reading",63,1,0,16,80
777608,461793,2015-06-22,Senate,"Assembly 3rd Reading AJR14 Chu By Lara",32,2,6,0,40
778067,465461,2015-07-07,Senate,"Be adopted as amended, and re-refer to the Committee on 	Appropriations",4,0,1,0,5
778067,473802,2015-08-17,Senate,"Placed on Appropriations Suspense file",7,0,0,0,7
778067,474573,2015-08-27,Senate,"Be adopted",5,2,0,0,7
778067,476323,2015-09-10,Senate,"Senate 3rd Reading SCA8 Mendoza",24,15,1,0,40
778067,476324,2015-09-10,Senate,"Senate 3rd Reading SCA8 Mendoza Reconsider",40,0,0,0,40
778073,465983,2015-07-13,Assembly,"From committee:  Be adopted.  To third reading",10,0,0,1,11
778073,475283,2015-08-31,Senate,"Special Consent #8 ACR68 Steinorth By Jackson",40,0,0,0,40
778079,460544,2015-06-16,Assembly,"From committee:  Be adopted.  To third reading",10,0,0,0,10
778079,461890,2015-06-22,Assembly,"ACR 67 MULLIN  Assembly Third Reading  By CHIU",77,0,0,3,80
778079,466361,2015-07-14,Senate,"Be adopted",7,0,0,0,7
778079,475279,2015-08-31,Senate,"Special Consent #8 ACR67 Mullin",40,0,0,0,40
778086,461866,2015-06-22,Assembly,"From committee:  Be adopted.  To third reading",9,0,0,2,11
778086,475456,2015-09-01,Senate,"Assembly 3rd Reading ACR66 Bonta By Pan",39,0,1,0,40
778676,450287,2015-05-22,Assembly,"From committee:  Be adopted.  To third reading",10,0,0,1,11
778676,461847,2015-06-22,Senate,"Special Consent #3 ACR69 Ch",37,0,3,0,40
778677,454420,2015-05-28,Senate,"Senate 3rd Reading SCR61 Pan",39,0,1,0,40
778677,459965,2015-06-15,Assembly,"Be adopted, to Consent Calendar",10,0,0,1,11
778677,461144,2015-06-18,Assembly,"SCR 61 Pan  Consent Calendar Second Day  Regular Session",75,0,0,5,80
779029,454421,2015-05-28,Senate,"Senate 3rd Reading SCR62 Mendoza",39,0,1,0,40
779029,459468,2015-06-11,Assembly,"Be adopted, to Consent Calendar",10,0,0,1,11
779029,461142,2015-06-18,Assembly,"SCR 62 Mendoza  Consent Calendar Second Day  Regular Session",75,0,0,5,80
779029,461825,2015-06-22,Senate,"Unfinished Business SCR62 Mendoza Concurrence",37,0,3,0,40
779050,460240,2015-06-16,Assembly,"From committee:  Be adopted.  To third reading",8,2,0,0,10
779050,462937,2015-06-25,Assembly,"AJR 16 GARCIA, E.  Assembly Third Reading",62,6,0,12,80
779050,466540,2015-07-15,Senate,"Be adopted",7,2,0,0,9
779050,475779,2015-09-03,Senate,"Assembly 3rd Reading AJR16 Eduardo Garcia By Leno",31,4,5,0,40
779050,476852,2015-09-03,Senate,"Assembly 3rd Reading AJR16 Eduardo Garcia By Leno Reconsider",39,0,1,0,40
779050,476853,2015-09-03,Senate,"Assembly 3rd Reading AJR16 Eduardo Garcia By Leno",30,6,4,0,40
779070,454119,2015-05-28,Assembly,"From committee:  Be adopted.  To third reading",11,0,0,0,11
779070,461837,2015-06-22,Senate,"Special Consent #3 ACR70 Salas",37,0,3,0,40
779684,454422,2015-05-28,Senate,"Senate 3rd Reading SR27 Runner",38,0,2,0,40
779700,457920,2015-06-08,Assembly,"Be adopted, to Consent Calendar",11,0,0,0,11
779700,459427,2015-06-11,Assembly,"ACR 72 GIPSON  Consent Calendar Second Day",79,0,0,1,80
779700,465153,2015-07-06,Senate,"Special Consent #4 ACR72 Gipson",39,0,1,0,40
779719,457428,2015-06-04,Assembly,"From committee:  Be adopted.  To third reading",10,0,0,1,11
779719,461816,2015-06-22,Senate,"Assembly 3rd Reading ACR71 Dodd By Wolk",36,0,4,0,40
779719,463910,2015-06-29,Assembly,"ACR 71 DODD  Concurrence in Senate Amendments",76,0,0,4,80
779734,537498,2016-04-21,Assembly,"From committee:  Be adopted.  To third reading",9,0,0,2,11
779734,550941,2016-06-02,Senate,"Special Consent # ACR73 Baker",39,0,1,0,40
779761,457353,2015-06-04,Senate,"Senate 3rd Reading SCR63 Bates",40,0,0,0,40
779761,464967,2015-07-02,Assembly,"Be adopted, to Consent Calendar",10,0,0,1,11
779761,465820,2015-07-09,Assembly,"SCR 63 Bates  Consent Calendar Second Day  Regular Session",79,0,0,1,80
780322,451514,2015-05-26,Assembly,"From committee:  Be adopted.  To third reading",11,0,0,0,11
780322,461910,2015-06-22,Senate,"Assembly 3rd Reading ACR74 Bigelow By Nielsen",37,0,3,0,40
780323,459369,2015-06-11,Senate,"Senate 3rd Reading SR31 Vidak",38,0,2,0,40
780325,454423,2015-05-28,Senate,"Senate 3rd Reading SR29 Runner",38,0,2,0,40
780329,453872,2015-05-28,Assembly,"From committee:  Be adopted.  To third reading",11,0,0,0,11
780331,455536,2015-06-01,Senate,"Senate 3rd Reading SR30 Runner",40,0,0,0,40
780766,465828,2015-07-09,Senate,"Senate 3rd Reading SCR64 Pan",39,0,1,0,40
780766,473605,2015-08-17,Assembly,"Be adopted, to Consent Calendar",11,0,0,0,11
780766,474021,2015-08-20,Assembly,"SCR 64 Pan  Consent Calendar Second Day  Regular Session",79,0,0,1,80
780766,474368,2015-08-27,Senate,"Special Consent #7 SCR64 Pan",40,0,0,0,40
780775,457296,2015-06-04,Assembly,"From committee:  Be adopted.  To third reading",10,0,0,1,11
780775,462957,2015-06-25,Senate,"Assembly 3rd Reading ACR76 Jones By Hall",38,0,2,0,40
781095,464452,2015-06-30,Assembly,"Be adopted, to Consent Calendar",7,0,0,0,7
781095,474092,2015-08-24,Senate,"Assembly 3rd Reading ACR77 Mark Stone By Beall",40,0,0,0,40
781112,461802,2015-06-22,Assembly,"Be adopted and re-referred to the Committee on Appropriations with 	recommendation:  To Consent Calendar",16,0,0,0,16
781112,465688,2015-07-08,Assembly,"From committee:  Be adopted.  To third reading",14,0,0,3,17
781112,465746,2015-07-09,Assembly,"ACR 78 SALAS  Assembly Third Reading",78,0,0,2,80
781112,473824,2015-08-18,Senate,"Be adopted, but re-refer to the Committee on Appropriations 	Recommend Consent",10,0,1,0,11
781112,474434,2015-08-27,Senate,"Consent Calendar 2nd ACR78 Salas",40,0,0,0,40
781479,461920,2015-06-22,Assembly,"From committee:  Be adopted.  To third reading",9,0,0,2,11
781479,465145,2015-07-06,Senate,"Special Consent #4 ACR79 Travis Allen",39,0,1,0,40
781765,461137,2015-06-18,Senate,"Senate 3rd Reading SCR65 Cannella",38,0,2,0,40
781765,473740,2015-08-17,Assembly,"Be adopted, to Consent Calendar",11,0,0,0,11
781765,473954,2015-08-20,Assembly,"SCR 65 Cannella  Consent Calendar Second Day  Regular Session",79,0,0,1,80
781766,463051,2015-06-24,Senate,"Be adopted as amended. To Consent Calendar",8,0,1,0,9
781766,466581,2015-07-16,Senate,"Senate 3rd Reading SJR9 Stone",37,0,3,0,40
781766,476443,2015-09-10,Assembly,"SJR9 Stone  Senate Third Reading  By MCCARTY",79,0,0,1,80
781766,476615,2015-09-11,Senate,"Unfinished Business (S upplemental File 1)SJR 9 Sto ne Con",39,0,1,0,40
781767,457923,2015-06-08,Senate,"Senate 3rd Reading SCR66 Stone",40,0,0,0,40
781767,464978,2015-07-02,Assembly,"Be adopted, to Consent Calendar",10,0,0,1,11
781767,465821,2015-07-09,Assembly,"SCR 66 Stone  Consent Calendar Second Day  Regular Session",79,0,0,1,80
781768,464414,2015-06-30,Assembly,"From committee:  Be adopted.  To third reading",6,0,0,1,7
781768,465783,2015-07-09,Assembly,"AJR 17 LOPEZ  Assembly Third Reading",74,0,0,6,80
781768,475273,2015-08-31,Senate,"Special Consent #8 AJR17 Lopez By Liu",40,0,0,0,40
781769,462588,2015-06-24,Senate,"Be adopted",7,0,0,0,7
781769,474029,2015-08-20,Senate,"Senate 3rd Reading SJR10 Stone",38,0,2,0,40
781769,476208,2015-09-09,Assembly,"From committee:  Be adopted.  To third reading",8,0,0,1,9
781769,476407,2015-09-10,Assembly,"SJR 10 Stone  Senate Third Reading  By PATTERSON",77,1,0,2,80
781769,476588,2015-09-11,Senate,"Unfinished Business (S upplemental File 1)SJR 10 Sto ne Con",40,0,0,0,40
781770,459534,2015-06-11,Senate,"Senate 3rd Reading SCR67 Stone",38,0,2,0,40
781770,464980,2015-07-02,Assembly,"Be adopted, to Consent Calendar",10,0,0,1,11
781770,465750,2015-07-09,Assembly,"SCR 67 Stone  Consent Calendar Second Day  Regular Session",79,0,0,1,80
782279,463885,2015-06-29,Senate,"Be adopted, but re-refer to the Committee on Appropriations",8,4,1,0,13
782279,466556,2015-07-16,Senate,"Senate 3rd Reading SJR11 Leyva",25,12,3,0,40
782279,474188,2015-08-25,Assembly,"Be adopted and be re-referred to the Committee on Appropriations",7,3,0,0,10
782279,476597,2015-09-11,Assembly,"From committee:  Be adopted.  To third reading",11,5,0,1,17
782279,476598,2015-09-11,Assembly,"SJR 11 Leyva  Senate Third Reading  By DODD",53,23,0,4,80
782280,458000,2015-06-08,Senate,"Senate 3rd Reading SCR68 Galgiani",40,0,0,0,40
782280,461907,2015-06-22,Assembly,"From committee:  Be adopted.  To third reading",9,0,0,2,11
782280,473953,2015-08-20,Senate,"Special Consent #6 SCR68 Galgiani",38,0,2,0,40
782542,461933,2015-06-22,Assembly,"Be adopted as amended",7,0,0,2,9
782542,464887,2015-07-02,Assembly,"AJR 18 PATTERSON  Assembly Third Reading",78,0,0,2,80
782542,466048,2015-07-14,Senate,"Be adopted and be placed on the Consent Calendar",9,0,0,0,9
782542,473961,2015-08-20,Senate,"Consent Calendar 2nd AJR18 Patterson",38,0,2,0,40
782544,462259,2015-06-23,Assembly,"From committee:  Be adopted.  To third reading",9,1,0,0,10
782544,463018,2015-06-25,Assembly,"AJR 19 ALEJO  Assembly Third Reading",70,2,0,8,80
782544,474032,2015-08-20,Senate,"Assembly 3rd Reading AJR19 Alejo By Hueso",37,0,3,0,40
782545,457948,2015-06-08,Assembly,"From committee:  Be adopted.  To third reading",11,0,0,0,11
782545,465147,2015-07-06,Senate,"Special Consent #4 ACR80 Gallagher",39,0,1,0,40
782546,457950,2015-06-08,Assembly,"From committee:  Be adopted.  To third reading",11,0,0,0,11
782546,461893,2015-06-22,Senate,"W/O REF. TO FILE ACR81 Chiu By Pan",38,0,2,0,40
782782,463043,2015-06-25,Senate,"Senate 3rd Reading SCR70 Bates",37,0,3,0,40
782782,465872,2015-07-13,Assembly,"Be adopted, to Consent Calendar",10,0,0,1,11
782782,466525,2015-07-16,Assembly,"SCR 70 Bates  Consent Calendar Second Day  Regular Session",79,0,0,1,80
782782,474002,2015-08-20,Senate,"Special Consent #6 SCR70 Bates",38,0,2,0,40
782783,526463,2016-03-29,Assembly,"From committee:  Be adopted.  To third reading",8,0,0,1,9
782783,530608,2016-04-11,Assembly,"AJR 20 KIM  Assembly Third Reading",75,0,0,4,79
782783,552703,2016-06-14,Senate,"Be adopted",5,0,0,0,5
782783,556826,2016-06-30,Senate,"Special Consent # AJR20 Kim",37,0,3,0,40
782784,459442,2015-06-11,Assembly,"From committee:  Be adopted.  To third reading",10,0,0,1,11
782784,465144,2015-07-06,Senate,"Special Consent #4 ACR82 Williams",39,0,1,0,40
783425,461915,2015-06-22,Senate,"Senate 3rd Reading SCR71 Gaines",36,0,4,0,40
783425,465996,2015-07-13,Assembly,"Be adopted as amended and be re-referred to the Committee on 	Appropriations",9,0,0,0,9
783425,473865,2015-08-19,Assembly,"Be adopted, to Consent Calendar",17,0,0,0,17
783425,474128,2015-08-24,Assembly,"SCR 71 Gaines  Consent Calendar Second Day",80,0,0,0,80
783425,475415,2015-09-01,Senate,"Special Consent #9 SCR71 Gaines",40,0,0,0,40
783440,463833,2015-06-29,Senate,"Senate 3rd Reading SCR72 Gaines",39,0,1,0,40
783440,465755,2015-07-09,Assembly,"SCR 72 Gaines  Consent Calendar Second Day  Regular Session",79,0,0,1,80
783724,461972,2015-06-22,Assembly,"From committee:  Be adopted.  To third reading",9,0,0,2,11
783724,473965,2015-08-20,Senate,"Assembly 3rd Reading ACR83 Campos By Jackson",38,0,2,0,40
783732,464965,2015-07-02,Senate,"Senate 3rd Reading SJR12 Pan Motions",38,0,2,0,40
783732,474211,2015-08-25,Assembly,"Be adopted, to Consent Calendar",10,0,0,0,10
783732,474322,2015-08-27,Assembly,"SJR 12 Pan  Consent Calendar Second Day  Regular Session",78,0,0,2,80
784001,461863,2015-06-22,Senate,"Senate 3rd Reading SR33 Lara",23,3,14,0,40
784203,459461,2015-06-11,Assembly,"From committee:  Be adopted.  To third reading",8,0,0,3,11
784203,461919,2015-06-22,Assembly,"HR 24 EGGMAN  Assembly Third Reading",65,0,0,15,80
784510,465356,2015-07-07,Senate,"Be adopted, but re-refer to the Committee on Appropriations 	Recommend Consent",11,0,0,0,11
784510,474017,2015-08-20,Senate,"Consent Calendar 2nd SCR73 McGuire",38,0,2,0,40
784510,476641,2015-09-11,Assembly,"SCR 73 McGuire  Senate Third Reading  By OLSEN",77,0,0,3,80
784513,459517,2015-06-11,Senate,"Senate 3rd Reading SR34 De Le",38,0,2,0,40
784515,461864,2015-06-22,Assembly,"Be adopted and re-referred to the Committee on Appropriations with 	recommendation:  To Consent Calendar",16,0,0,0,16
784518,460635,2015-06-16,Senate,"Be adopted",7,0,0,0,7
784518,461930,2015-06-22,Senate,"Senate 3rd Reading SJR13 De Le",36,0,4,0,40
784518,466220,2015-07-15,Assembly,"From committee:  Be adopted.  To third reading",5,1,0,1,7
784518,475263,2015-08-31,Assembly,"SJR 13 De Leon  Senate Third Reading  By GOMEZ",57,11,0,12,80
784712,466293,2015-07-14,Assembly,"From committee:  Be adopted.  To third reading",6,1,0,0,7
784712,474483,2015-08-27,Assembly,"AJR 22 MULLIN  Assembly Third Reading",58,18,0,4,80
784712,475937,2015-09-08,Senate,"Assembly 3rd Reading AJR22 Mullin By Vidak",29,10,1,0,40
784893,463888,2015-06-29,Senate,"Senate 3rd Reading SR35 Pan",39,0,1,0,40
784894,464875,2015-07-02,Assembly,"From committee:  Be adopted.  To third reading",10,0,0,1,11
784894,474168,2015-08-24,Senate,"Assembly 3rd Reading ACR85 Gordon By Mitchell",40,0,0,0,40
785277,459934,2015-06-15,Assembly,"From committee:  Be adopted.  To third reading",10,0,0,1,11
785277,465177,2015-07-06,Senate,"Special Consent #4 ACR87 Ridley-Thomas",39,0,1,0,40
785283,462939,2015-06-25,Assembly,"From committee:  Be adopted.  To third reading",11,0,0,0,11
785291,466394,2015-07-15,Assembly,"Be adopted, to Consent Calendar",16,0,0,1,17
785291,473726,2015-08-17,Assembly,"ACR 86 HERNANDEZ  Consent Calendar Second Day  Regular Session",79,0,0,1,80
785291,474191,2015-08-25,Senate,"Be adopted, but re-refer to the Committee on Appropriations 	Recommend Consent",10,0,1,0,11
785291,475730,2015-09-03,Senate,"Consent Calendar 2nd ACR86 Roger Hern",40,0,0,0,40
785444,464975,2015-07-02,Senate,"Senate 3rd Reading SR36 Morrell",38,0,2,0,40
785630,465881,2015-07-13,Assembly,"Be adopted and re-referred to the Committee on Appropriations with 	recommendation:  To Consent Calendar",16,0,0,0,16
785630,466269,2015-07-15,Assembly,"Be adopted, to Consent Calendar",16,0,0,1,17
785630,473791,2015-08-17,Assembly,"ACR 88 CAMPOS  Consent Calendar Second Day  Regular Session",79,0,0,1,80
785630,474189,2015-08-25,Senate,"Be adopted, but re-refer to the Committee on Appropriations 	Recommend Consent",10,0,1,0,11
785630,475762,2015-09-03,Senate,"Consent Calendar 2nd ACR88 Campos",40,0,0,0,40
785643,461678,2015-06-19,Assembly,"From committee:  Be adopted.  To third reading",10,0,0,1,11
785643,461881,2015-06-22,Assembly,"AJR 23 BONILLA  Assembly Third Reading",68,4,0,8,80
785643,465195,2015-07-06,Senate,"Assembly 3rd Reading AJR23 Bonilla By Jackson",37,0,3,0,40
786036,465772,2015-07-09,Assembly,"From committee:  Be adopted.  To third reading",11,0,0,0,11
786036,474120,2015-08-24,Senate,"Assembly 3rd Reading ACR90 Irwin By Leyva",40,0,0,0,40
786040,466200,2015-07-15,Assembly,"Be adopted, to Consent Calendar",16,0,0,1,17
786040,473705,2015-08-17,Assembly,"ACR 89 WILK  Consent Calendar Second Day  Regular Session",79,0,0,1,80
786040,474185,2015-08-25,Senate,"Be adopted, but re-refer to the Committee on Appropriations 	Recommend Consent",10,0,1,0,11
786040,475794,2015-09-03,Senate,"Consent Calendar 2nd ACR89 Wilk",40,0,0,0,40
786173,561507,2016-08-29,Assembly,"Be adopted, as amended, to Consent Calendar",15,0,0,1,16
786173,561767,2016-08-31,Assembly,"ACR 91 ALEJO  Consent Calendar First Day",79,0,0,1,80
786174,465263,2015-07-06,Senate,"Senate 3rd Reading SCR75 Nguyen",38,0,2,0,40
786174,466086,2015-07-13,Assembly,"Be adopted, to Consent Calendar",10,0,0,1,11
786174,466562,2015-07-16,Assembly,"SCR 75 Nguyen  Consent Calendar Second Day  Regular Session",79,0,0,1,80
786175,476019,2015-09-08,Senate,"Be adopted, but re-refer to the Committee on Appropriations",13,0,0,0,13
786208,475840,2015-08-19,Senate,"Do pass as amended, and re-refer to the Committee on Appropriations",9,2,2,0,13
786441,465998,2015-07-14,Assembly,"Be adopted, to Consent Calendar",19,0,0,0,19
786441,473625,2015-08-17,Assembly,"HR 26 LOW  Consent Calendar Second Day",79,0,0,1,80
786560,465188,2015-07-06,Senate,"Senate 3rd Reading SCR76 Gaines",39,0,1,0,40
786560,473680,2015-08-17,Assembly,"Be adopted, to Consent Calendar",11,0,0,0,11
786560,474012,2015-08-20,Assembly,"SCR 76 Gaines  Consent Calendar Second Day  Regular Session",79,0,0,1,80
786560,474463,2015-08-27,Senate,"Special Consent #7 SCR76 Gaines",40,0,0,0,40
786562,474061,2015-08-24,Assembly,"From committee:  Be adopted.  To third reading",9,1,0,2,12
786562,474329,2015-08-27,Assembly,"AJR 25 LACKEY  Assembly Third Reading",67,3,0,10,80
786562,476487,2015-09-11,Senate,"Assembly 3rd Reading AJR25 Lackey By McGuire",36,3,1,0,40
786564,465432,2015-07-07,Assembly,"From committee:  Be adopted.  To third reading",8,2,0,0,10
786564,465851,2015-07-13,Assembly,"ACR 92 GIPSON  Assembly Third Reading  Amend By GIPSON  Set #1",70,0,0,10,80
786564,475589,2015-09-02,Senate,"Assembly 3rd Reading ACR92 Gipson By Hall",40,0,0,0,40
786777,466217,2015-07-15,Senate,"Be adopted",6,0,1,0,7
786777,466461,2015-07-16,Senate,"Senate 3rd Reading SR37 De Le",24,3,13,0,40
786783,465198,2015-07-06,Senate,"Senate 3rd Reading SCR77 Liu",39,0,1,0,40
786783,473812,2015-08-17,Assembly,"Be adopted, to Consent Calendar",11,0,0,0,11
786783,474019,2015-08-20,Assembly,"SCR 77 Liu  Consent Calendar Second Day  Regular Session",79,0,0,1,80
786919,465949,2015-07-13,Senate,"Senate 3rd Reading SCR78 Nielsen",39,0,1,0,40
786919,474047,2015-08-20,Assembly,"Be adopted, to Consent Calendar",11,0,0,0,11
786919,475304,2015-08-31,Assembly,"SCR 78 Nielsen  Senate Third Reading  By IRWIN",80,0,0,0,80
786919,475570,2015-09-02,Senate,"Unfinished Business SCR78 Nielsen Concurrence",40,0,0,0,40
786920,473547,2015-07-14,Assembly,"Be adopted as amended",10,0,0,0,10
786920,473677,2015-08-17,Assembly,"AJR 26 WEBER  Assembly Third Reading",75,0,0,5,80
786920,475837,2015-09-04,Senate,"Assembly 3rd Reading AJR26 Weber By Mitchell",40,0,0,0,40
786920,476014,2015-09-08,Assembly,"AJR 26 WEBER  Concurrence in Senate Amendments",73,0,0,7,80
786921,466580,2015-07-15,Assembly,"From committee:  Be adopted.  To third reading",9,0,0,0,9
786921,475371,2015-08-31,Senate,"Assembly 3rd Reading ACR93 Holden By Hueso",37,3,0,0,40
786946,465861,2015-07-13,Assembly,"From committee:  Be adopted.  To third reading",10,0,0,1,11
786946,475325,2015-08-31,Senate,"Assembly 3rd Reading ACR94 Gallagher By Fuller",40,0,0,0,40
786963,475297,2015-08-31,Assembly,"AB2 BONTA  Assembly Third Reading  Second Extraordinary Session",50,28,0,2,80
786964,475301,2015-08-31,Assembly,"AB1 BONTA  Assembly Third Reading  Second Extraordinary Session",50,28,0,2,80
786964,476155,2015-09-09,Senate,"Assembly 3rd Reading AB1 Bonta By Hernandez",24,14,2,0,40
786964,476439,2015-09-10,Assembly,"AB1 BONTA  Concurrence in Senate Amendments  Second Extraordinary 	Session",3,50,0,27,80
786964,509504,2016-02-29,Senate,"Conference Report AB1 Thurmond, et al. By Beall",40,0,0,0,40
786964,509505,2016-02-29,Assembly,"AB1 THURMOND  Conference Report  Second Extraordinary Session",78,0,0,1,79
786966,487292,2016-01-25,Senate,"Senate 3rd Reading SJR15 Glazer",31,2,7,0,40
786966,552188,2016-06-08,Assembly,"From committee:  Be adopted.  To third reading",8,1,0,1,10
786966,555570,2016-06-27,Assembly,"SJR 15 Glazer  Senate Third Reading  By GONZALEZ",59,7,0,14,80
786966,556990,2016-06-30,Senate,"Unfinished Business SJR15 Glazer Concurrence",29,3,8,0,40
786967,516299,2016-03-08,Assembly,"Be adopted, to Consent Calendar",9,0,0,1,10
786967,517794,2016-03-10,Assembly,"ACR 95 MATHIS  Consent Calendar Second Day",75,0,0,4,79
786967,556682,2016-06-28,Senate,"Be adopted and be placed on the Consent Calendar",7,0,0,0,7
786967,559416,2016-08-11,Senate,"Consent Calendar 2nd ACR95 Mathis",37,0,2,0,39
786980,475557,2015-09-01,Senate,"Senate 3rd Reading SB3 Hernandez",25,13,2,0,40
786981,465742,2015-07-09,Senate,"Senate 3rd Reading SR38 Mitchell",39,0,1,0,40
786982,475679,2015-09-01,Senate,"Do pass, but re-refer to the Committee on Appropriations",3,9,1,0,13
786982,475680,2015-09-01,Senate,"Set, first hearing.  Failed passage in Committee.  Reconsideration 	granted",13,0,0,0,13
786983,466136,2015-07-14,Senate,"Be adopted as amended, and re-refer to the Committee on 	Appropriations",9,0,0,0,9
786983,474024,2015-08-20,Senate,"Senate 3rd Reading SCR79 McGuire",38,0,2,0,40
786983,474335,2015-08-27,Assembly,"Be adopted and be re-referred to the Committee on Appropriations",12,0,0,3,15
786983,476489,2015-09-11,Assembly,"Be adopted, to Consent Calendar",16,0,0,1,17
786983,476490,2015-09-11,Assembly,"SCR 79 McGuire  Senate Third Reading  By DODD",79,0,0,1,80
786984,475900,2015-08-19,Senate,"Do pass, but re-refer to the Committee on Appropriations",4,8,1,0,13
786986,466038,2015-07-14,Assembly,"From committee:  Be adopted.  To third reading",6,0,0,1,7
786987,475551,2015-09-01,Senate,"Senate 3rd Reading SB2 Hernandez",25,13,2,0,40
786987,476159,2015-09-09,Assembly,"SB2 Hernandez  Senate Third Reading  By BONTA  Second Extraordinary 	Session",53,1,0,26,80
786987,476437,2015-09-10,Senate,"Unfinished Business SB2 Hernandez Concurrence",1,39,0,0,40
786987,509543,2016-02-29,Senate,"Conference Report SB2 Hernandez",28,11,1,0,40
786987,509544,2016-02-29,Assembly,"SB2 Hernandez  Conference Report  By BONTA  Second Extraordinary 	Session",61,16,0,2,79
787013,561779,2016-08-31,Senate,"Senate 3rd Reading SCR80 Runner By Allen",39,0,0,0,39
787023,475509,2015-09-01,Senate,"Senate 3rd Reading SB5 Beall",25,13,2,0,40
787033,475554,2015-09-01,Senate,"Senate 3rd Reading SB4 Beall",25,12,3,0,40
787033,476144,2015-09-09,Assembly,"SB4 Beall  Senate Third Reading  By FRAZIER  First Extraordinary 	Session",54,1,0,25,80
787033,476233,2015-09-10,Senate,"Unfinished Business SB4 Beall Concurrence",1,39,0,0,40
787083,476584,2015-09-11,Senate,"Senate 3rd Reading SR39 Hall",25,1,14,0,40
787107,474044,2015-08-20,Assembly,"From committee:  Be adopted.  To third reading",11,0,0,0,11
787107,475355,2015-08-31,Senate,"Assembly 3rd Reading ACR96 Weber By Liu",40,0,0,0,40
787110,475281,2015-08-31,Assembly,"AB4 FRAZIER  Assembly Third Reading  First Extraordinary Session",50,29,0,1,80
787111,475255,2015-08-31,Assembly,"AB3 FRAZIER  Assembly Third Reading  First Extraordinary Session",50,29,0,1,80
787111,476018,2015-09-08,Senate,"Assembly 3rd Reading AB3 Frazier By Beall",24,14,2,0,40
787111,476334,2015-09-10,Assembly,"AB3 FRAZIER  Concurrence in Senate Amendments  First Extraordinary 	Session",3,50,0,27,80
787112,466524,2015-07-16,Senate,"Senate 3rd Reading SJR16 De Le",35,0,5,0,40
787112,474596,2015-08-27,Assembly,"From committee:  Be adopted.  To third reading",9,0,0,0,9
787112,475798,2015-09-03,Assembly,"SJR 16 De Leon  Senate Third Reading  By BURKE",79,0,0,1,80
787428,473603,2015-08-17,Senate,"Senate 3rd Reading SR40 Hill",38,0,2,0,40
787436,473784,2015-08-17,Senate,"Senate 3rd Reading SCR81 Hill",38,0,2,0,40
787436,474178,2015-08-24,Assembly,"Be adopted, to Consent Calendar",8,0,0,3,11
787436,474378,2015-08-27,Assembly,"SCR 81 Hill  Consent Calendar Second Day  Regular Session",78,0,0,2,80
787441,474034,2015-08-20,Senate,"Senate 3rd Reading SCR82 McGuire",38,0,2,0,40
787441,474420,2015-08-27,Assembly,"Be adopted, to Consent Calendar",11,0,0,0,11
787441,475494,2015-09-01,Assembly,"SCR 82 McGuire  Consent Calendar Second Day  Regular Session",80,0,0,0,80
787447,475696,2015-09-01,Senate,"Do pass, but re-refer to the Committee on Appropriations",2,9,2,0,13
787598,474151,2015-08-24,Assembly,"Do pass",6,0,0,1,7
787598,475571,2015-09-02,Assembly,"AB 1544 COOLEY  Third Reading Urgency",74,0,0,6,80
787598,476198,2015-09-09,Senate,"Do pass",5,0,0,0,5
787598,476571,2015-09-11,Senate,"Assembly 3rd Reading AB1544 Cooley By Anderson",37,1,2,0,40
787599,529607,2016-04-06,Assembly,"From committee:  Be adopted.  To third reading",7,0,0,0,7
787600,475330,2015-08-31,Senate,"Senate 3rd Reading SR41 Morrell",39,0,1,0,40
787673,474187,2015-08-25,Senate,"Be adopted as amended",7,0,0,0,7
787673,475613,2015-09-02,Senate,"Senate 3rd Reading SJR18 Wolk",39,0,1,0,40
787673,541386,2016-05-03,Assembly,"Be adopted, to Consent Calendar",11,0,0,0,11
787673,543790,2016-05-09,Assembly,"SJR 18 Wolk  Consent Calendar Second Day  Regular Session",78,0,0,2,80
787673,545234,2016-05-12,Senate,"Unfinished Business SJR18 Wolk Concurrence",37,0,3,0,40
787674,475583,2015-09-01,Senate,"Do pass as amended, and re-refer to the Committee on Appropriations",9,2,2,0,13
787675,475861,2015-08-19,Senate,"Do pass as amended, and re-refer to the Committee on Appropriations",12,0,1,0,13
787677,474082,2015-08-24,Senate,"Do pass",5,2,0,0,7
787677,474475,2015-08-27,Senate,"Senate 3rd Reading SB7 Hernandez",25,11,4,0,40
787677,476630,2015-08-19,Senate,"Do pass, but re-refer to the Committee on Appropriations",9,3,1,0,13
787677,513227,2016-03-03,Assembly,"SB7 Hernandez  Senate Third Reading  By WOOD  Motion to  Appeal the 	Decision  of the Chair  By BAKER  Second Extraordinary Session",49,26,0,4,79
787677,513228,2016-03-03,Assembly,"SB7 Hernandez  Senate Third Reading  By WOOD  Motion to Adjourn  By 	GALLAGHER  Second Extraordinary Session",26,49,0,4,79
787677,513229,2016-03-03,Assembly,"SB7 Hernandez  Senate Third Reading  By WOOD  Move Previous 	Question  By CALDERON  Second Extraordinary Session",49,26,0,4,79
787677,513230,2016-03-03,Assembly,"SB7 Hernandez  Senate Third Reading  By WOOD  Second Extraordinary 	Session",49,25,0,5,79
787677,517868,2016-03-10,Senate,"Unfinished Business SB7 Hernandez Concurrence",26,10,4,0,40
787680,474183,2015-08-25,Assembly,"Do pass and be re-referred to the Committee on Finance",9,4,0,0,13
787680,475906,2015-09-08,Assembly,"Do pass",6,3,0,0,9
787680,513106,2016-03-03,Assembly,"AB 11 NAZARIAN  Assembly Third Reading  Second Extraordinary Session",48,26,0,5,79
787680,514835,2016-03-07,Senate,"Do pass, but re-refer to the Committee on Appropriations",9,4,0,0,13
787680,515837,2016-03-08,Senate,"Do pass",5,2,0,0,7
787680,517774,2016-03-10,Senate,"Assembly 3rd Reading AB11 Nazarian By Beall",24,15,1,0,40
787682,474216,2015-08-25,Assembly,"From committee:  Be adopted.  To third reading",14,0,0,0,14
787682,475966,2015-09-08,Senate,"Assembly 3rd Reading ACR97 Bonilla By Leyva",39,0,1,0,40
787684,474071,2015-08-24,Senate,"Do pass as amended",5,0,2,0,7
787684,474474,2015-08-27,Senate,"Senate 3rd Reading SB8 Liu",27,10,3,0,40
787684,476606,2015-08-19,Senate,"Do pass, but re-refer to the Committee on Appropriations",9,3,1,0,13
787686,474480,2015-08-27,Senate,"Senate 3rd Reading SB9 McGuire",23,15,2,0,40
787686,476521,2015-08-19,Senate,"Do pass",9,2,2,0,13
787687,475686,2015-09-01,Senate,"Do pass, but re-refer to the Committee on Appropriations",8,0,5,0,13
787688,474186,2015-08-25,Assembly,"Do pass and be re-referred to the Committee on Finance",9,4,0,0,13
787688,475907,2015-09-08,Assembly,"Do pass",5,3,0,1,9
787689,474101,2015-08-24,Senate,"Do pass",5,2,0,0,7
787689,474479,2015-08-27,Senate,"Senate 3rd Reading SB10 Beall",24,15,1,0,40
787689,476513,2015-08-19,Senate,"Do pass, but re-refer to the Committee on Appropriations",9,3,1,0,13
787694,474172,2015-08-25,Assembly,"Do pass",9,4,0,0,13
787694,513076,2016-03-03,Assembly,"AB 10 BLOOM  Assembly Third Reading  Motion to  Appeal the Decision 	of the Chair  By GALLAGHER  Second Extraordinary Session",48,26,0,5,79
787694,513077,2016-03-03,Assembly,"AB 10 BLOOM  Assembly Third Reading  Second Extraordinary Session",46,27,0,6,79
787694,514831,2016-03-07,Senate,"Do pass, but re-refer to the Committee on Appropriations",9,3,1,0,13
787694,515820,2016-03-08,Senate,"Do pass",5,2,0,0,7
787694,517890,2016-03-10,Senate,"Assembly 3rd Reading AB10 Bloom By McGuire",23,14,3,0,40
787695,475933,2015-09-08,Assembly,"Do pass",6,3,0,0,9
787695,476503,2015-08-25,Assembly,"Do pass as amended and be re-referred to the Committee on Finance",10,2,0,1,13
787697,474000,2015-08-20,Assembly,"From committee:  Be adopted.  To third reading",11,0,0,0,11
787697,476016,2015-09-08,Senate,"Assembly 3rd Reading ACR99 Lopez By Hueso",40,0,0,0,40
787701,475856,2015-08-19,Senate,"Do pass, but re-refer to the Committee on Appropriations",12,0,1,0,13
787702,475838,2015-08-19,Senate,"Do pass, but re-refer to the Committee on Appropriations",3,9,1,0,13
787703,473992,2015-08-20,Senate,"Senate 3rd Reading SCR83 Wolk",38,0,2,0,40
787703,474429,2015-08-27,Assembly,"From committee:  Be adopted.  To third reading",11,0,0,0,11
787703,475701,2015-09-02,Senate,"Unfinished Business SCR83 Wolk Concurrence",40,0,0,0,40
787706,484017,2016-01-06,Assembly,"Be adopted, to Consent Calendar",6,0,0,1,7
787706,486549,2016-01-21,Assembly,"Be adopted, to Consent Calendar",17,0,0,0,17
787706,488561,2016-01-27,Assembly,"ACR 98 GAINES  Consent Calendar Second Day  Regular Session",78,0,0,1,79
787706,531075,2016-04-11,Senate,"Be adopted, but re-refer to the Committee on Appropriations 	Recommend Consent",5,0,0,0,5
787706,554544,2016-06-20,Senate,"Placed on Appropriations Suspense file",7,0,0,0,7
787706,559485,2016-08-11,Senate,"Be adopted",7,0,0,0,7
787706,561036,2016-08-24,Senate,"Assembly 3rd Reading ACR98 Beth Gaines By Gaines",39,0,0,0,39
787707,474122,2015-08-24,Senate,"Do pass as amended",5,2,0,0,7
787707,474482,2015-08-27,Senate,"Senate 3rd Reading SB5 Leno",25,13,2,0,40
787707,475832,2015-08-19,Senate,"Do pass, but re-refer to the Committee on Appropriations",9,3,1,0,13
787707,513130,2016-03-03,Assembly,"SB5 Leno  Senate Third Reading  By BONTA  Motion to  Appeal the 	Decision  of the Chair  By GALLAGHER  Second Extraordinary Session",49,26,0,4,79
787707,513131,2016-03-03,Assembly,"SB5 Leno  Senate Third Reading  By BONTA  Second Extraordinary 	Session",52,21,0,6,79
787707,517873,2016-03-10,Senate,"Unfinished Business SB5 Leno Concurrence",26,11,3,0,40
787708,474174,2015-08-25,Assembly,"Do pass and be re-referred to the Committee on Finance",10,3,0,0,13
787708,476032,2015-09-08,Assembly,"Do pass",6,3,0,0,9
787708,513135,2016-03-03,Assembly,"AB7 STONE  Assembly Third Reading  Amend By STONE  Set #1  Second 	Extraordinary Session",48,25,0,6,79
787708,513136,2016-03-03,Assembly,"AB7 STONE  Assembly Third Reading  Motion to  Appeal the Decision 	of the Chair  By WILK  Second Extraordinary Session",48,25,0,6,79
787708,513137,2016-03-03,Assembly,"AB7 STONE  Assembly Third Reading  Second Extraordinary Session",49,25,0,5,79
787708,514767,2016-03-07,Senate,"Do pass, but re-refer to the Committee on Appropriations",9,4,0,0,13
787708,517778,2016-03-10,Senate,"Assembly 3rd Reading AB7 Mark Stone By Monning",21,13,6,0,40
787709,474470,2015-08-27,Senate,"Senate 3rd Reading SB6 Monning",24,13,3,0,40
787709,475849,2015-08-19,Senate,"Do pass, but re-refer to the Committee on Appropriations",9,2,2,0,13
787710,474184,2015-08-25,Assembly,"Do pass as amended and be re-referred to the Committee on Finance",12,0,0,1,13
787710,475963,2015-09-08,Assembly,"Do pass",7,2,0,0,9
787710,513046,2016-03-03,Assembly,"AB9 THURMOND  Assembly Third Reading  Second Extraordinary Session",59,6,0,14,79
787710,514761,2016-03-07,Senate,"Do pass, but re-refer to the Committee on Appropriations",9,3,1,0,13
787710,515867,2016-03-08,Senate,"Do pass",5,1,1,0,7
787710,517793,2016-03-10,Senate,"Assembly 3rd Reading AB9 Thurmond By Liu",30,8,2,0,40
789453,474093,2015-08-24,Senate,"Senate 3rd Reading SCR84 Jackson",40,0,0,0,40
789453,475667,2015-09-02,Assembly,"SCR 84 Jackson  Senate Third Reading  By GARCIA, C",80,0,0,0,80
789455,475400,2015-09-01,Assembly,"Do pass as amended and be re-referred to the Committee on Finance",10,3,0,0,13
789455,476024,2015-09-04,Assembly,"Do pass",5,3,0,1,9
789455,476108,2015-09-09,Assembly,"AB 15 EGGMAN  Assembly Third Reading  Second Extraordinary Session",44,35,0,1,80
789455,476555,2015-09-11,Senate,"Assembly 3rd Reading AB15 Eggman By Wolk and Monning",23,15,2,0,40
789456,474175,2015-08-24,Assembly,"From committee:  Be adopted.  To third reading",8,0,0,3,11
789456,476047,2015-09-08,Senate,"Assembly 3rd Reading ACR101 Brough By Hill",40,0,0,0,40
789458,476625,2015-09-11,Assembly,"Be adopted and re-referred to the Committee on Appropriations with 	recommendation:  To Consent Calendar",16,0,0,0,16
789458,486488,2016-01-21,Assembly,"Be adopted, to Consent Calendar",17,0,0,0,17
789458,540847,2016-05-02,Assembly,"ACR 100 ALLEN  Assembly Third Reading",74,0,0,6,80
789458,559497,2016-08-11,Senate,"Consent Calendar 2nd ACR100 Travis Allen",37,0,2,0,39
789459,474301,2015-08-27,Senate,"Senate 3rd Reading SCR85 Hall",38,0,2,0,40
789459,475384,2015-09-01,Assembly,"From committee:  Be adopted.  To third reading",8,0,0,3,11
789459,476033,2015-09-08,Assembly,"SCR 85 Hall  Senate Third Reading  By MEDINA",69,0,0,11,80
789462,474132,2015-08-24,Assembly,"From committee:  Be adopted.  To third reading",8,0,0,3,11
789462,475994,2015-09-08,Senate,"Assembly 3rd Reading ACR102 Salas By Liu",40,0,0,0,40
789514,485051,2016-01-13,Senate,"Be adopted, but re-refer to the Committee on Elections and 	Constitutional Amendments",7,0,0,0,7
789584,474315,2015-08-27,Assembly,"From committee:  Be adopted.  To third reading",11,0,0,0,11
789586,475338,2015-08-31,Senate,"Senate 3rd Reading SR42 Nguyen",39,0,1,0,40
789588,475308,2015-08-31,Senate,"Senate 3rd Reading SR43 Nguyen",39,0,1,0,40
789613,475644,2015-09-02,Senate,"Senate 3rd Reading SR45 Bates",40,0,0,0,40
789616,475519,2015-09-01,Senate,"Senate 3rd Reading SCR86 Pan",40,0,0,0,40
789616,559505,2016-08-11,Assembly,"Be adopted, to Consent Calendar",9,0,0,2,11
789616,560239,2016-08-18,Assembly,"SCR 86 Pan  Consent Calendar Second Day  Regular Session",78,0,0,2,80
789624,475447,2015-09-01,Senate,"Senate 3rd Reading SR44 Pan",36,0,4,0,40
789683,475482,2015-09-01,Senate,"Senate 3rd Reading SCR87 Pan",36,0,4,0,40
789683,559479,2016-08-11,Assembly,"Be adopted, to Consent Calendar",9,0,0,2,11
789683,560259,2016-08-18,Assembly,"SCR 87 Pan  Consent Calendar Second Day  Regular Session",78,0,0,2,80
789683,561136,2016-08-25,Senate,"Special Consent SCR87 Pan",39,0,0,0,39
789684,475265,2015-08-31,Senate,"Senate 3rd Reading SCR88 Runner",39,0,1,0,40
789684,485564,2016-01-15,Assembly,"Be adopted, to Consent Calendar",11,0,0,0,11
789684,488951,2016-01-28,Senate,"Unfinished Business SCR88 Runner Concurrence",40,0,0,0,40
789705,475903,2015-09-04,Assembly,"From committee:  Be adopted.  To third reading",11,0,0,0,11
789705,476373,2015-09-10,Senate,"Assembly 3rd Reading ACR103 McCarty By McGuire",40,0,0,0,40
789713,487727,2016-01-26,Senate,"Be adopted",5,2,0,0,7
789713,489672,2016-02-01,Senate,"Senate 3rd Reading SJR19 Jackson",25,12,3,0,40
789713,541340,2016-05-03,Assembly,"From committee:  Be adopted.  To third reading",11,5,0,2,18
789713,547533,2016-05-23,Assembly,"SJR 19 Jackson  Senate Third Reading  By ATKINS",51,22,0,7,80
789713,548659,2016-05-26,Senate,"Unfinished Business SJR19 Jackson Concurrence",27,9,4,0,40
789713,548660,2016-05-26,Senate,"Unfinished Business SJR19 Jackson Concurrence",38,0,2,0,40
789713,548661,2016-05-26,Senate,"Unfinished Business SJR19 Jackson Concurrence",26,12,2,0,40
789727,475483,2015-09-01,Assembly,"From committee:  Be adopted.  To third reading",10,2,0,3,15
789727,475655,2015-09-02,Assembly,"AJR 27 LEVINE  Assembly Third Reading",62,13,0,5,80
789727,476048,2015-09-08,Senate,"Assembly 3rd Reading AJR27 Levine By Wolk",30,7,3,0,40
789729,475666,2015-09-02,Senate,"Senate 3rd Reading SCR89 Galgiani",39,0,1,0,40
789731,484682,2016-01-11,Assembly,"Be adopted and re-referred to the Committee on Appropriations with 	recommendation:  To Consent Calendar",16,0,0,0,16
789731,486285,2016-01-21,Assembly,"Be adopted, to Consent Calendar",17,0,0,0,17
789731,488325,2016-01-27,Assembly,"ACR 104 RODRIGUEZ  Consent Calendar Second Day  Regular Session",78,0,0,1,79
789731,491615,2016-02-04,Assembly,"ACR 104 RODRIGUEZ  Assembly Third Reading",65,0,0,14,79
789731,541913,2016-05-03,Senate,"Be adopted, but re-refer to the Committee on Appropriations 	Recommend Consent",11,0,0,0,11
789731,547019,2016-05-19,Senate,"Consent Calendar 2nd ACR104 Rodriguez",39,0,1,0,40
789731,549080,2016-05-27,Assembly,"ACR 104 RODRIGUEZ  Concurrence in Senate Amendments",71,0,0,9,80
789732,475894,2015-09-04,Senate,"Senate 3rd Reading SR47 Hall",39,0,1,0,40
789736,476249,2015-09-10,Senate,"Senate 3rd Reading SR46 Hueso",40,0,0,0,40
789737,475484,2015-09-01,Assembly,"From committee:  Be adopted.  To third reading",10,0,0,1,11
790067,476647,2015-09-11,Assembly,"Do pass",6,3,0,0,9
790078,475568,2015-09-02,Senate,"Senate 3rd Reading SR48 Mendoza",39,0,1,0,40
790107,559122,2016-08-04,Assembly,"From committee:  Be adopted.  To third reading",9,0,0,2,11
790107,560589,2016-08-22,Senate,"Assembly 3rd Reading ACR106 Gonzalez By Anderson",39,0,0,0,39
790108,476605,2015-09-11,Assembly,"Be adopted and re-referred to the Committee on Appropriations with 	recommendation:  To Consent Calendar",16,0,0,0,16
790108,486355,2016-01-21,Assembly,"Be adopted, to Consent Calendar",17,0,0,0,17
790108,488569,2016-01-27,Assembly,"ACR 107 GROVE  Consent Calendar Second Day  Regular Session",78,0,0,1,79
790108,541885,2016-05-03,Senate,"Be adopted, but re-refer to the Committee on Appropriations 	Recommend Consent",11,0,0,0,11
790108,547046,2016-05-19,Senate,"Consent Calendar 2nd ACR107 Grove",39,0,1,0,40
790163,476262,2015-09-10,Senate,"Senate 3rd Reading SR50 De Le",31,0,9,0,40
790164,476247,2015-09-10,Senate,"Senate 3rd Reading SR49 De Le",40,0,0,0,40
790455,484797,2016-01-12,Assembly,"Do pass and be re-referred to the Committee on Appropriations",19,0,0,0,19
790455,486381,2016-01-21,Assembly,"Do pass",17,0,0,0,17
790455,488518,2016-01-27,Assembly,"AB 1546 OLSEN  Third Reading Urgency",79,0,0,0,79
790455,553277,2016-06-15,Senate,"Do pass as amended, and re-refer to the Committee on Appropriations",9,0,0,0,9
790455,560015,2016-08-16,Senate,"Assembly 3rd Reading AB1546 Olsen By Allen Urgency Claus",39,0,0,0,39
790455,560606,2016-08-22,Assembly,"AB 1546 OLSEN  Concurrence in Senate Amendments",77,0,0,3,80
790456,476255,2015-09-10,Senate,"Do pass, but re-refer to the Committee on Appropriations",9,4,0,0,13
790459,476595,2015-09-11,Senate,"W/O REF. TO FILE SR51 De Le",40,0,0,0,40
790608,476621,2015-09-11,Senate,"Senate 3rd Reading SR52 Lara",40,0,0,0,40
790730,484672,2016-01-11,Assembly,"Do pass as amended and be re-referred to the Committee on 	Appropriations",16,0,0,0,16
790730,485056,2016-01-05,Assembly,"Be referred to Committee on Transportation",11,0,0,0,11
790730,486295,2016-01-21,Assembly,"Do pass, to Consent Calendar",17,0,0,0,17
790730,488365,2016-01-27,Assembly,"AB 1549 WOOD  Consent Calendar Second Day  Regular Session",78,0,0,1,79
790730,552650,2016-06-14,Senate,"Do pass as amended, and re-refer to the Committee on Appropriations",10,0,1,0,11
790730,558705,2016-08-01,Senate,"Placed on Appropriations Suspense file",7,0,0,0,7
790730,559617,2016-08-11,Senate,"Do pass",7,0,0,0,7
790730,560043,2016-08-17,Senate,"Assembly 3rd Reading AB1549 Wood By McGuire",39,0,0,0,39
790730,560727,2016-08-23,Senate,"Assembly 3rd Reading AB1549 Wood By McGuire",39,0,0,0,39
790730,561388,2016-08-29,Assembly,"AB 1549 WOOD  Concurrence in Senate Amendments",80,0,0,0,80
807543,485027,2016-01-15,Senate,"Senate 3rd Reading SCR91 Mendoza",35,0,5,0,40
807543,486359,2016-01-21,Assembly,"From committee:  Be adopted.  To third reading",9,0,0,2,11
807543,488426,2016-01-27,Senate,"Unfinished Business SCR91 Mendoza Concurrence",31,0,9,0,40
807544,526459,2016-03-30,Senate,"Do pass, but re-refer to the Committee on Elections and 	Constitutional Amendments",5,0,2,0,7
807544,535027,2016-04-19,Senate,"Do pass as amended, and re-refer to the Committee on Appropriations",3,1,1,0,5
807544,545168,2016-05-12,Senate,"Senate 3rd Reading SB816 Hill",32,3,5,0,40
807544,556456,2016-06-29,Assembly,"Do pass and be re-referred to the Committee on Appropriations",4,2,0,1,7
807546,531221,2016-04-12,Assembly,"Do pass as amended and be re-referred to the Committee on Banking 	and Finance",14,0,0,2,16
807546,534937,2016-04-18,Assembly,"Do pass as amended and be re-referred to the Committee on 	Appropriations",8,2,0,2,12
807546,548959,2016-05-27,Assembly,"Do pass",15,1,0,4,20
807546,550354,2016-06-01,Assembly,"AB 1575 BONTA  Assembly Third Reading",65,8,0,7,80
807546,554665,2016-06-20,Senate,"Do pass as amended, and re-refer to the Committee on Governance and 	Finance",6,1,2,0,9
807546,556255,2016-06-29,Senate,"Do pass, but re-refer to the Committee on Appropriations",6,1,0,0,7
807547,527979,2016-04-04,Assembly,"Do pass and be re-referred to the Committee on Transportation",3,5,0,1,9
807547,527980,2016-04-04,Assembly,"Reconsideration granted",9,0,0,0,9
807548,530710,2016-04-11,Assembly,"Amend, and do pass as amended and be re-referred to the Committee 	on Appropriations with the recommendation:  To Consent Calendar",9,0,0,0,9
807548,539058,2016-04-27,Assembly,"Do pass, to Consent Calendar",19,0,0,1,20
807548,543038,2016-05-05,Assembly,"AB 1559 DODD  Consent Calendar Second Day  Regular Session",79,0,0,1,80
807548,553468,2016-06-15,Senate,"Do pass as amended, and re-refer to the Committee on Appropriations",7,0,0,0,7
807548,559888,2016-08-15,Senate,"Assembly 3rd Reading AB1559 Dodd By Fuller Urgency Clau",38,0,1,0,39
807548,560852,2016-08-23,Assembly,"Senate amendments be concurred in",9,0,0,0,9
807548,561015,2016-08-24,Assembly,"AB 1559 DODD  Concurrence- Urgency Added",80,0,0,0,80
807549,525608,2016-03-29,Senate,"Do pass, but re-refer to the Committee on Appropriations",7,0,0,0,7
807549,542998,2016-05-05,Senate,"Senate 3rd Reading SB807 Gaines",37,0,3,0,40
807549,552719,2016-06-14,Assembly,"Do pass as amended and be re-referred to the Committee on Judiciary",11,0,0,0,11
807549,556001,2016-06-28,Assembly,"Do pass and be re-referred to the Committee on Appropriations to 	Consent Calendar",10,0,0,0,10
807549,559019,2016-08-03,Assembly,"Do pass, to Consent Calendar",20,0,0,0,20
807549,560483,2016-08-22,Assembly,"SB 807 Gaines  Senate Third Reading  By GATTO",79,0,0,1,80
807549,561408,2016-08-29,Senate,"Special Consent SB807 Gaines",39,0,0,0,39
807550,544309,2016-05-09,Assembly,"Do pass as amended and be re-referred to the Committee on 	Appropriations",9,0,0,0,9
807551,531280,2016-04-12,Assembly,"Do pass as amended and be re-referred to the Committee on 	Appropriations",18,0,0,1,19
807551,549017,2016-05-27,Assembly,"Do pass",20,0,0,0,20
807551,549974,2016-05-31,Assembly,"AB 1578 RODRIGUEZ  Third Reading Urgency",80,0,0,0,80
807552,526203,2016-03-30,Assembly,"Do pass and be re-referred to the Committee on Governmental 	Organization to Consent Calendar",15,0,0,0,15
807552,536168,2016-04-20,Assembly,"Do pass and be re-referred to the Committee on Appropriations to 	Consent Calendar",21,0,0,0,21
807552,542205,2016-05-04,Assembly,"Do pass, to Consent Calendar",20,0,0,0,20
807552,545187,2016-05-12,Assembly,"AB 1564 WILLIAMS  Consent Calendar Second Day  Regular Session",78,0,0,2,80
807552,554628,2016-06-21,Senate,"Do pass, but re-refer to the Committee on Appropriations",10,0,1,0,11
807552,559944,2016-08-16,Senate,"Assembly 3rd Reading AB1564 Williams By Hertzberg",38,0,1,0,39
807553,541373,2016-05-03,Assembly,"Do pass, to Consent Calendar",11,0,0,0,11
807553,545200,2016-05-12,Assembly,"AB 1570 CHANG  Consent Calendar Second Day  Regular Session",78,0,0,2,80
807553,552445,2016-06-13,Senate,"Do pass, but re-refer to the Committee on Judiciary",9,0,0,0,9
807553,556361,2016-06-28,Senate,"Do pass and be placed on the Consent Calendar",7,0,0,0,7
807553,559228,2016-08-11,Senate,"Consent Calendar 2nd AB1570 Chang",37,0,2,0,39
807553,560708,2016-08-23,Assembly,"AB 1570 CHANG  Concurrence in Senate Amendments",79,0,0,1,80
807558,531282,2016-04-12,Senate,"Do pass, but re-refer to the Committee on Appropriations",5,0,2,0,7
807558,544375,2016-04-25,Senate,"Placed on Appropriations Suspense file",7,0,0,0,7
807558,549010,2016-05-27,Senate,"Do pass",7,0,0,0,7
807558,550359,2016-06-01,Senate,"Senate 3rd Reading SB813 Leyva",33,0,7,0,40
807558,554681,2016-06-21,Assembly,"Do pass",6,0,0,1,7
807558,560170,2016-08-18,Assembly,"SB 813 Leyva  Senate Third Reading  By GIPSON",78,0,0,2,80
807558,561569,2016-08-30,Senate,"Unfinished Business (S upplemental File 2)SB8 13 Ley va Con",39,0,0,0,39
807559,542510,2016-05-04,Assembly,"Do pass as amended",7,0,0,0,7
807559,547655,2016-05-23,Assembly,"AB 1557 MATHIS  Assembly Third Reading",76,0,0,4,80
807559,553276,2016-06-15,Senate,"Do pass",9,0,0,0,9
807559,558651,2016-08-01,Senate,"Assembly 3rd Reading AB1557 Mathis By Anderson",39,0,0,0,39
807560,526416,2016-03-30,Assembly,"Do pass as amended and be re-referred to the Committee on 	Transportation",13,0,0,2,15
807560,534255,2016-04-18,Assembly,"Do pass and be re-referred to the Committee on Appropriations to 	Consent Calendar",15,0,0,1,16
807560,549432,2016-05-27,Assembly,"Do pass",20,0,0,0,20
807560,549984,2016-05-31,Assembly,"AB 1574 CHIU  Assembly Third Reading",79,0,0,1,80
807560,552476,2016-06-13,Senate,"Do pass, but re-refer to the Committee on Transportation and 	Housing",11,0,0,0,11
807560,558955,2016-08-01,Senate,"Placed on Appropriations Suspense file",7,0,0,0,7
807560,559683,2016-08-11,Senate,"Do pass",7,0,0,0,7
807562,525882,2016-03-29,Senate,"Do pass, but re-refer to the Committee on Judiciary",7,2,0,0,9
807562,544047,2016-05-09,Senate,"Senate 3rd Reading SB814 Hill",23,11,6,0,40
807562,552717,2016-06-14,Assembly,"Do pass as amended and be re-referred to the Committee on 	Appropriations",9,4,0,2,15
807562,556251,2016-06-29,Assembly,"Do pass",12,6,0,2,20
807562,559157,2016-08-04,Assembly,"SB 814 Hill  Senate Third Reading  By LEVINE",45,29,0,6,80
807562,559219,2016-08-10,Senate,"From committee:  That the Assembly Amendments be concurred in",6,1,2,0,9
807562,559378,2016-08-11,Senate,"Unfinished Business SB814 Hill Concurrence",23,13,3,0,39
807563,533174,2016-04-13,Assembly,"Do pass and be re-referred to the Committee on Appropriations to 	Consent Calendar",7,0,0,0,7
807563,549441,2016-05-27,Assembly,"Do pass as amended",20,0,0,0,20
807563,550582,2016-06-01,Assembly,"AB 1567 CAMPOS  Assembly Third Reading",80,0,0,0,80
807563,553210,2016-06-15,Senate,"Do pass as amended, but re-refer to the Committee on Appropriations 	Recommend Consent",9,0,0,0,9
807563,558971,2016-08-01,Senate,"Placed on Appropriations Suspense file",7,0,0,0,7
807563,559778,2016-08-11,Senate,"Do pass as amended",7,0,0,0,7
807563,560584,2016-08-22,Senate,"Assembly 3rd Reading AB1567 Campos By Liu",39,0,0,0,39
807563,561235,2016-08-25,Assembly,"AB 1567 CAMPOS  Concurrence in Senate Amendments",78,0,0,2,80
807564,483921,2016-01-07,Assembly,"From committee:  Be adopted.  To third reading",11,0,0,0,11
807564,550946,2016-06-02,Senate,"Special Consent # ACR109 Cooper",39,0,1,0,40
807565,537087,2016-04-20,Assembly,"Do pass as amended and be re-referred to the Committee on 	Appropriations",6,0,0,1,7
807566,483868,2016-01-07,Assembly,"From committee:  Be adopted.  To third reading",11,0,0,0,11
807566,507265,2016-02-25,Senate,"Assembly 3rd Reading ACR110 Wilk By Nguyen",37,0,3,0,40
807566,513636,2016-03-03,Assembly,"ACR 110 WILK  Concurrence in Senate Amendments By KIM",73,0,0,6,79
807567,544478,2016-05-09,Assembly,"Do pass and be re-referred to the Committee on Appropriations",9,0,0,0,9
807567,549265,2016-05-27,Assembly,"Do pass as amended",18,1,0,1,20
807567,550923,2016-06-02,Assembly,"AB 1561 GARCIA, C.  Assembly Third Reading",78,0,0,2,80
807567,555144,2016-06-22,Senate,"Do pass, but re-refer to the Committee on Appropriations",5,0,2,0,7
807567,558854,2016-08-01,Senate,"Placed on Appropriations Suspense file",7,0,0,0,7
807567,559763,2016-08-11,Senate,"Do pass as amended",7,0,0,0,7
807567,560269,2016-08-18,Senate,"Assembly 3rd Reading AB1561 Cristina Garcia By Jackson",38,0,1,0,39
807567,560639,2016-08-23,Assembly,"AB 1561 GARCIA, C.  Concurrence in Senate Amendments",77,0,0,3,80
807570,485029,2016-01-15,Senate,"Senate 3rd Reading SR53 Hall By Mitchell",35,0,5,0,40
807572,532939,2016-04-13,Assembly,"Do pass and be re-referred to the Committee on Appropriations",3,5,0,1,9
807573,511188,2016-03-01,Assembly,"Do pass and be re-referred to the Committee on Appropriations to 	Consent Calendar",7,0,0,0,7
807573,532256,2016-04-06,Assembly,"Do pass, to Consent Calendar",18,0,0,2,20
807573,533464,2016-04-14,Assembly,"AB 1563 RODRIGUEZ  Consent Calendar Second Day  Regular Session",76,0,0,4,80
807573,544621,2016-05-10,Senate,"Do pass, but re-refer to the Committee on Appropriations Recommend 	Consent",7,0,0,0,7
807573,556855,2016-06-30,Senate,"Consent Calendar 2nd AB1563 Rodriguez",37,0,3,0,40
807573,558668,2016-08-01,Assembly,"AB 1563 RODRIGUEZ  Concurrence in Senate Amendments",76,0,0,4,80
807574,536040,2016-04-18,Assembly,"Do pass as amended and be re-referred to the Committee on 	Appropriations",9,0,0,0,9
807574,549458,2016-05-27,Assembly,"Do pass as amended",20,0,0,0,20
807574,550487,2016-06-01,Assembly,"AB 1577 EGGMAN  Assembly Third Reading",80,0,0,0,80
807574,554951,2016-06-22,Senate,"Do pass, but re-refer to the Committee on Appropriations Recommend 	Consent",6,0,1,0,7
807574,560505,2016-08-22,Senate,"Assembly 3rd Reading AB1577 Eggman By Berryhill",39,0,0,0,39
807574,561222,2016-08-25,Assembly,"AB 1577 EGGMAN  Concurrence in Senate Amendments",79,0,0,1,80
807575,538548,2016-04-26,Assembly,"Do pass and be re-referred to the Committee on Appropriations",17,0,0,1,18
807575,549023,2016-05-27,Assembly,"Do pass",20,0,0,0,20
807575,550036,2016-05-31,Assembly,"AB 1568 BONTA  Third Reading Urgency",80,0,0,0,80
807575,552074,2016-06-08,Senate,"Do pass, but re-refer to the Committee on Appropriations",7,0,2,0,9
807575,554521,2016-06-20,Senate,"Do pass",7,0,0,0,7
807575,555395,2016-06-23,Senate,"Assembly 3rd Reading AB1568 Bonta By Hernandez Urgency C",36,0,4,0,40
807575,555812,2016-06-27,Assembly,"AB 1568 BONTA  Concurrence in Senate Amendments",75,0,0,5,80
807576,528274,2016-04-05,Senate,"Do pass as amended, and re-refer to the Committee on Energy, 	Utilities and Communications",10,0,1,0,11
807576,535260,2016-04-19,Senate,"Do pass as amended, and re-refer to the Committee on Appropriations",11,0,0,0,11
807576,546081,2016-05-16,Senate,"Placed on Appropriations Suspense file",7,0,0,0,7
807576,549345,2016-05-27,Senate,"Do pass as amended",7,0,0,0,7
807576,550490,2016-06-01,Senate,"Senate 3rd Reading SB812 Hill",39,0,1,0,40
807576,555594,2016-06-27,Assembly,"Do pass as amended and be re-referred to the Committee on 	Appropriations",15,0,0,1,16
807576,559408,2016-08-11,Assembly,"Do pass as amended",14,0,0,6,20
807576,561518,2016-08-29,Assembly,"Do pass",15,0,0,1,16
807576,561635,2016-08-30,Assembly,"SB 812 Hill  Senate Third Reading  By CHIU",80,0,0,0,80
807576,561692,2016-08-31,Senate,"Unfinished Business SB812 Hill Concurrence",38,0,1,0,39
807577,529002,2016-04-06,Assembly,"Do pass and be re-referred to the Committee on Appropriations",18,0,0,3,21
807577,536831,2016-04-20,Assembly,"Do pass as amended, to Consent Calendar",16,0,0,4,20
807577,539913,2016-04-28,Assembly,"AB 1554 IRWIN  Consent Calendar Second Day  Regular Session",76,0,0,4,80
807577,552764,2016-06-14,Senate,"Do pass, but re-refer to the Committee on Appropriations",12,0,1,0,13
807577,560016,2016-08-16,Senate,"Assembly 3rd Reading AB1554 Irwin By Huff",39,0,0,0,39
807577,560455,2016-08-22,Assembly,"AB 1554 IRWIN  Concurrence in Senate Amendments",76,0,0,4,80
807578,544553,2016-05-09,Assembly,"Do pass as amended and be re-referred to the Committee on 	Appropriations",9,0,0,0,9
807579,538963,2016-04-27,Senate,"Do pass, but re-refer to the Committee on Appropriations",8,0,1,0,9
807579,547594,2016-05-23,Senate,"Placed on Appropriations Suspense file",7,0,0,0,7
807579,548995,2016-05-27,Senate,"Do pass",7,0,0,0,7
807579,549923,2016-05-31,Senate,"Senate 3rd Reading SB815 Hernandez Urgency Clause",39,0,1,0,40
807579,552052,2016-06-08,Assembly,"Do pass and be re-referred to the Committee on Appropriations",16,0,0,2,18
807579,553119,2016-06-15,Assembly,"Do pass, to Consent Calendar",20,0,0,0,20
807579,555267,2016-06-23,Assembly,"SB 815 Hernandez  Consent Calendar Second Day  Regular Session",79,0,0,1,80
807579,555550,2016-06-27,Senate,"Unfinished Business SB815 Hernandez Urgency Clause Concurr",38,0,2,0,40
807580,528997,2016-04-06,Assembly,"Do pass and be re-referred to the Committee on Appropriations",18,0,0,3,21
807580,536823,2016-04-20,Assembly,"Do pass, to Consent Calendar",16,0,0,4,20
807580,539710,2016-04-28,Assembly,"AB 1558 MATHIS  Consent Calendar Second Day  Regular Session",76,0,0,4,80
807580,552979,2016-06-14,Senate,"Do pass, but re-refer to the Committee on Appropriations",3,6,4,0,13
807580,552980,2016-06-14,Senate,"Set, first hearing.  Failed passage in Committee.  Reconsideration 	granted",12,0,1,0,13
807580,560300,2016-08-18,Senate,"Assembly 3rd Reading AB1558 Mathis By Berryhill",38,0,1,0,39
807580,560783,2016-08-23,Assembly,"AB 1558 MATHIS  Concurrence in Senate Amendments",80,0,0,0,80
807581,526768,2016-03-31,Assembly,"Be referred to Committee on Revenue and Taxation",8,0,0,3,11
807581,534838,2016-04-18,Assembly,"Do pass and be re-referred to the Committee on Appropriations",9,0,0,0,9
807581,538928,2016-04-27,Assembly,"Do pass, to Consent Calendar",19,0,0,1,20
807581,542990,2016-05-05,Assembly,"AB 1553 IRWIN  Consent Calendar Second Day  Regular Session",79,0,0,1,80
807581,553110,2016-06-15,Senate,"Do pass as amended, and re-refer to the Committee on Appropriations",7,0,0,0,7
807581,559929,2016-08-16,Senate,"Assembly 3rd Reading AB1553 Irwin By Pavley Urgency Clau",38,0,1,0,39
807581,560501,2016-08-22,Assembly,"AB 1553 IRWIN  Concurrence- Urgency Added",78,0,0,2,80
807584,533222,2016-04-13,Assembly,"Do pass as amended and be re-referred to the Committee on 	Appropriations",5,0,0,2,7
807585,496567,2016-02-12,Senate,"Senate 3rd Reading SR54 Hall",32,0,8,0,40
807586,527965,2016-04-04,Assembly,"Do pass as amended and be re-referred to the Committee on 	Appropriations",7,0,0,2,9
807586,549041,2016-05-27,Assembly,"Do pass as amended",15,2,0,3,20
807586,550860,2016-06-02,Assembly,"AB 1550 GOMEZ  Assembly Third Reading",54,23,0,3,80
807586,556370,2016-06-29,Senate,"Do pass as amended, and re-refer to the Committee on Appropriations",5,1,1,0,7
807586,559552,2016-08-11,Senate,"Do pass as amended",5,2,0,0,7
807586,561737,2016-08-31,Senate,"Assembly 3rd Reading ( Supplemental File 1)AB 1550 Go mez By",26,12,1,0,39
807586,561738,2016-08-31,Assembly,"AB 1550 GOMEZ  Concurrence in Senate Amendments",53,22,0,5,80
807587,485031,2016-01-15,Assembly,"From committee:  Be adopted.  To third reading",11,0,0,0,11
807587,513042,2016-03-03,Senate,"Assembly 3rd Reading ACR108 Mathis By Vidak",39,0,1,0,40
807587,518175,2016-03-10,Assembly,"ACR 108 MATHIS  Concurrence in Senate Amendments",75,0,0,4,79
808104,525938,2016-03-29,Assembly,"Do pass and be re-referred to the Committee on Appropriations to 	Consent Calendar",13,0,0,2,15
808104,532951,2016-04-06,Assembly,"Do pass, to Consent Calendar",18,0,0,2,20
808104,533416,2016-04-14,Assembly,"AB 1579 ALLEN  Consent Calendar Second Day  Regular Session",76,0,0,4,80
808105,528004,2016-04-05,Senate,"Do pass as amended, and re-refer to the Committee on Appropriations",7,0,0,0,7
808107,532295,2016-04-12,Assembly,"Do pass as amended and be re-referred to the Committee on 	Appropriations",9,2,0,2,13
808107,548997,2016-05-27,Assembly,"Do pass as amended",14,6,0,0,20
808107,550841,2016-06-02,Assembly,"AB 1583 SANTIAGO  Assembly Third Reading",53,25,0,2,80
808107,556302,2016-06-29,Senate,"Do pass, but re-refer to the Committee on Appropriations",4,3,2,0,9
808107,556303,2016-06-29,Senate,"Set, first hearing.  Failed passage in Committee.  Reconsideration 	granted",9,0,0,0,9
808110,525878,2016-03-29,Senate,"Do pass, but re-refer to the Committee on Appropriations",4,0,1,0,5
808110,531043,2016-04-11,Senate,"Placed on Appropriations Suspense file",7,0,0,0,7
808110,549235,2016-05-27,Senate,"Do pass as amended",7,0,0,0,7
808110,550716,2016-06-01,Senate,"Senate 3rd Reading SB822 Roth",38,1,1,0,40
808110,556492,2016-06-29,Assembly,"Do pass and be re-referred to the Committee on Appropriations",9,0,0,1,10
808110,559091,2016-08-03,Assembly,"Do pass, to Consent Calendar",20,0,0,0,20
808110,560210,2016-08-18,Assembly,"SB 822 Roth  Senate Third Reading  By MATHIS",77,0,0,3,80
808111,526292,2016-03-30,Senate,"Do pass, but re-refer to the Committee on Appropriations",7,0,0,0,7
808111,530523,2016-04-11,Senate,"Placed on Appropriations Suspense file",7,0,0,0,7
808111,549241,2016-05-27,Senate,"Do pass",7,0,0,0,7
808111,550144,2016-05-31,Senate,"Senate 3rd Reading SB817 Roth",38,0,2,0,40
808111,553216,2016-06-15,Assembly,"Do pass and be re-referred to the Committee on Appropriations",8,0,0,1,9
808111,559512,2016-08-11,Assembly,"Do pass",20,0,0,0,20
808111,560572,2016-08-22,Assembly,"SB 817 Roth  Senate Third Reading  By COOLEY",77,0,0,3,80
808111,561642,2016-08-30,Senate,"Unfinished Business SB817 Roth Concurrence",39,0,0,0,39
808112,485128,2016-01-15,Assembly,"From committee:  Be adopted.  To third reading",7,2,0,1,10
808112,485671,2016-01-19,Assembly,"HR 32 ATKINS  Assembly Third Reading",53,22,0,4,79
808113,516016,2016-03-08,Senate,"Do pass as amended, and re-refer to the Committee on Appropriations",12,0,1,0,13
808113,534366,2016-04-18,Senate,"Senate 3rd Reading SB819 Huff",39,0,1,0,40
808113,552161,2016-06-08,Assembly,"Do pass as amended and be re-referred to the Committee on 	Appropriations",15,0,0,6,21
808113,559071,2016-08-03,Assembly,"Do pass, to Consent Calendar",20,0,0,0,20
808113,560971,2016-08-24,Assembly,"SB 819 Huff  Senate Third Reading  By IRWIN",79,0,0,1,80
808113,561327,2016-08-26,Senate,"Unfinished Business SB819 Huff Concurrence",39,0,0,0,39
808114,519061,2016-03-14,Assembly,"Do pass as amended and be re-referred to the Committee on Privacy 	and Consumer Protection",12,0,0,0,12
808114,541346,2016-05-03,Assembly,"Do pass as amended, to Consent Calendar",11,0,0,0,11
808114,545175,2016-05-12,Assembly,"AB 1580 GATTO  Consent Calendar Second Day  Regular Session",78,0,0,2,80
808114,553096,2016-06-14,Senate,"Do pass as amended",7,0,0,0,7
808114,560179,2016-08-18,Senate,"Assembly 3rd Reading AB1580 Gatto By Hertzberg",38,0,1,0,39
808114,560665,2016-08-23,Assembly,"AB 1580 GATTO  Concurrence in Senate Amendments",80,0,0,0,80
808115,528986,2016-04-06,Senate,"Do pass as amended, and re-refer to the Committee on Judiciary",6,0,1,0,7
808115,535228,2016-04-19,Senate,"Do pass, but re-refer to the Committee on Appropriations Recommend 	Consent",7,0,0,0,7
808115,545180,2016-05-12,Senate,"Senate 3rd Reading SB820 Hertzberg",38,0,2,0,40
808115,552668,2016-06-14,Assembly,"Do pass and be re-referred to the Committee on Judiciary to Consent 	Calendar",7,0,0,0,7
808115,554667,2016-06-21,Assembly,"Do pass and be re-referred to the Committee on Appropriations to 	Consent Calendar",10,0,0,0,10
808115,556374,2016-06-29,Assembly,"Do pass, to Consent Calendar",18,0,0,2,20
808115,559111,2016-08-04,Assembly,"SB 820 Hertzberg  Consent Calendar Second Day  Regular Session",77,0,0,3,80
809016,537633,2016-04-20,Assembly,"Do pass and be re-referred to the Committee on Appropriations",6,0,0,1,7
809022,527489,2016-04-04,Assembly,"Do pass",16,0,0,0,16
809022,529422,2016-04-07,Assembly,"AB 1592 BONILLA  Assembly Third Reading",75,0,0,4,79
809022,552661,2016-06-14,Senate,"Do pass as amended",10,0,1,0,11
809022,560631,2016-08-23,Senate,"Assembly 3rd Reading AB1592 Bonilla By Cannella",39,0,0,0,39
809022,561417,2016-08-29,Assembly,"AB 1592 BONILLA  Concurrence in Senate Amendments",75,3,0,2,80
809026,516484,2016-03-08,Assembly,"From committee:  Be adopted.  To third reading",10,0,0,1,11
809026,545329,2016-05-12,Senate,"Assembly 3rd Reading ACR111 Nazarian By Allen",38,0,2,0,40
809034,531402,2016-04-12,Assembly,"Do pass and be re-referred to the Committee on Appropriations",12,1,0,2,15
809034,549243,2016-05-27,Assembly,"Do pass as amended",16,1,0,3,20
809034,551109,2016-06-02,Assembly,"AB 1585 ALEJO  Third Reading Urgency",70,2,0,8,80
809037,529452,2016-04-06,Assembly,"Do pass and be re-referred to the Committee on Appropriations to 	Consent Calendar",7,0,0,0,7
809037,532398,2016-04-13,Assembly,"Do pass, to Consent Calendar",20,0,0,0,20
809037,537535,2016-04-21,Assembly,"AB 1593 OBERNOLTE  Consent Calendar Second Day  Regular Session",79,0,0,1,80
809037,552192,2016-06-08,Senate,"Do pass, but re-refer to the Committee on Appropriations Recommend 	Consent",9,0,0,0,9
809037,557089,2016-06-30,Senate,"Consent Calendar 2nd AB1593 Obernolte",37,0,3,0,40
809041,527941,2016-04-04,Assembly,"Do pass and be re-referred to the Committee on Appropriations",1,6,0,2,9
809041,527942,2016-04-04,Assembly,"Reconsideration granted",9,0,0,0,9
809045,525614,2016-03-29,Assembly,"Do pass and be re-referred to the Committee on Appropriations to 	Consent Calendar",13,0,0,2,15
809045,549158,2016-05-27,Assembly,"Do pass as amended",20,0,0,0,20
809045,550364,2016-06-01,Assembly,"AB 1588 MATHIS  Third Reading Urgency",51,0,0,29,80
809045,550822,2016-06-02,Assembly,"AB 1588 MATHIS  Third Reading Urgency",76,0,0,4,80
809045,556252,2016-06-29,Senate,"Do pass, but re-refer to the Committee on Appropriations",7,0,0,0,7
809045,558762,2016-08-01,Senate,"Placed on Appropriations Suspense file",7,0,0,0,7
809045,559622,2016-08-11,Senate,"Do pass as amended",7,0,0,0,7
809045,560045,2016-08-17,Senate,"Assembly 3rd Reading AB1588 Mathis By Vidak",39,0,0,0,39
809045,560756,2016-08-23,Assembly,"AB 1588 MATHIS  Concurrence in Senate Amendments",80,0,0,0,80
809047,531237,2016-04-12,Assembly,"Do pass as amended and be re-referred to the Committee on 	Appropriations",14,0,0,1,15
809050,531216,2016-04-12,Senate,"Do pass, but re-refer to the Committee on Appropriations",5,1,1,0,7
809050,544330,2016-04-25,Senate,"Placed on Appropriations Suspense file",7,0,0,0,7
809050,549068,2016-05-27,Senate,"Do pass as amended",5,2,0,0,7
809050,550864,2016-06-02,Senate,"Senate 3rd Reading SB823 Block",25,13,2,0,40
809050,554719,2016-06-21,Assembly,"Do pass as amended and be re-referred to the Committee on 	Appropriations",6,0,0,1,7
809050,559271,2016-08-11,Assembly,"Do pass",14,5,0,1,20
809050,560772,2016-08-23,Assembly,"SB 823 Block  Senate Third Reading  By GONZALEZ",57,21,0,2,80
809050,561217,2016-08-25,Senate,"Unfinished Business SB823 Block Concurrence",34,5,0,0,39
809056,527982,2016-04-04,Assembly,"Do pass as amended and be re-referred to the Committee on Judiciary",1,6,0,2,9
809056,527983,2016-04-04,Assembly,"Reconsideration granted",9,0,0,0,9
809060,520471,2016-03-15,Assembly,"Do pass and be re-referred to the Committee on Appropriations",10,3,0,0,13
809060,532493,2016-04-13,Assembly,"Do pass",14,6,0,0,20
809060,538137,2016-04-25,Assembly,"AB 1594 MCCARTY  Assembly Third Reading",48,24,0,8,80
809060,552185,2016-06-08,Senate,"Do pass as amended, and re-refer to the Committee on Appropriations",7,2,0,0,9
809060,558831,2016-08-01,Senate,"Placed on Appropriations Suspense file",7,0,0,0,7
809060,559646,2016-08-11,Senate,"Do pass",5,2,0,0,7
809060,560633,2016-08-23,Senate,"Assembly 3rd Reading AB1594 McCarty By Leno",26,12,1,0,39
809060,561623,2016-08-30,Assembly,"AB 1594 MCCARTY  Concurrence in Senate Amendments",52,27,0,1,80
809064,526274,2016-03-29,Assembly,"Do pass as amended and be re-referred to the Committee on 	Appropriations",6,0,0,1,7
809064,548988,2016-05-27,Assembly,"Do pass",16,0,0,4,20
809064,550830,2016-06-02,Assembly,"AB 1584 BROWN  Assembly Third Reading",76,0,0,4,80
809064,556263,2016-06-28,Senate,"Do pass as amended, and re-refer to the Committee on Appropriations",5,0,0,0,5
809064,558760,2016-08-01,Senate,"Placed on Appropriations Suspense file",7,0,0,0,7
809064,559608,2016-08-11,Senate,"Do pass as amended",7,0,0,0,7
809064,560230,2016-08-18,Senate,"Assembly 3rd Reading AB1584 Brown By Liu",38,0,1,0,39
809064,560747,2016-08-23,Assembly,"AB 1584 BROWN  Concurrence in Senate Amendments",79,0,0,1,80
809755,539844,2016-04-28,Assembly,"AB 1623 BUDGET  Assembly Third Reading  By TING",51,26,0,3,80
809755,559467,2016-08-11,Senate,"Do pass",15,0,2,0,17
809755,559956,2016-08-16,Senate,"Assembly 3rd Reading AB1623 Committee On BUDGET (Ting) By Leno",38,0,1,0,39
809755,561032,2016-08-24,Assembly,"AB 1623 BUDGET  Concurrence in Senate Amendments By TING",73,1,0,6,80
809758,533349,2016-04-14,Senate,"Senate 3rd Reading SB854 Committee On B. & F.R. (Leno)",25,11,4,0,40
809758,559221,2016-08-10,Assembly,"Do pass",24,1,0,2,27
809759,528764,2016-04-06,Assembly,"Do pass and be re-referred to the Committee on Appropriations",5,1,0,1,7
809759,536206,2016-04-20,Assembly,"Do pass",11,5,0,4,20
809759,539608,2016-04-28,Assembly,"AB 1640 STONE  Assembly Third Reading",53,26,0,1,80
809759,555514,2016-06-27,Senate,"Do pass, but re-refer to the Committee on Appropriations",3,0,2,0,5
809759,558793,2016-08-01,Senate,"Do pass",5,2,0,0,7
809760,533234,2016-04-14,Senate,"Senate 3rd Reading SB851 Committee On B. & F.R. (Leno)",25,11,4,0,40
809763,539584,2016-04-28,Assembly,"AB 1610 BUDGET  Assembly Third Reading  By TING",51,26,0,3,80
809763,553402,2016-06-15,Senate,"Do pass",10,5,2,0,17
809763,553716,2016-06-16,Senate,"Assembly 3rd Reading AB1610 Committee On BUDGET (Ting) By Leno",23,14,3,0,40
809764,485023,2016-01-15,Assembly,"From committee:  Be adopted.  To third reading",10,0,0,1,11
809766,533336,2016-04-14,Senate,"Senate 3rd Reading SB850 Committee On B. & F.R. (Leno)",25,11,4,0,40
809768,487536,2016-01-25,Senate,"Senate 3rd Reading SCR92 Pan",38,0,2,0,40
809768,509380,2016-02-29,Assembly,"Be adopted, to Consent Calendar",8,0,0,3,11
809768,513178,2016-03-03,Assembly,"SCR 92 Pan  Consent Calendar Second Day",75,0,0,4,79
809771,540251,2016-04-28,Assembly,"AB 1638 BUDGET  Assembly Third Reading  By TING",51,26,0,3,80
809772,533443,2016-04-14,Senate,"Senate 3rd Reading SB859 Committee On B. & F.R. (Leno)",25,11,4,0,40
809772,559214,2016-08-10,Assembly,"Do pass",25,0,0,2,27
809772,560421,2016-08-19,Assembly,"SB 859 B.& F. R.  Senate Third Reading  Amend By TING  Set #1",49,22,0,9,80
809772,561764,2016-08-31,Assembly,"Do pass as amended",19,5,0,3,27
809772,561765,2016-08-31,Assembly,"SB 859 B.& F. R.  Senate Third Reading  By TING",51,20,0,9,80
809772,561766,2016-08-31,Senate,"Unfinished Business (S upplemental File 3)SB8 59 Com mittee on 	Budget and F",25,11,3,0,39
809773,502579,2016-02-18,Senate,"Senate 3rd Reading SCR96 Pan",39,0,1,0,40
809773,537326,2016-04-21,Assembly,"Be adopted, to Consent Calendar",9,0,0,2,11
809773,539652,2016-04-28,Assembly,"SCR 96 Pan  Consent Calendar Second Day  Regular Session",76,0,0,4,80
809775,533403,2016-04-14,Senate,"Senate 3rd Reading SB831 Committee On B. & F.R. (Leno)",25,11,4,0,40
809775,560423,2016-08-19,Assembly,"SB 831 B.& F. R.  Senate Third Reading  Amend By TING  Set #1",49,21,0,10,80
809775,561631,2016-08-30,Assembly,"SB 831 B.& F. R.  Senate Third Reading  By ALEJO",65,12,0,3,80
809775,561822,2016-08-31,Senate,"From committee:  That the Assembly Amendments be concurred in",14,0,3,0,17
809775,561823,2016-08-31,Senate,"Unfinished Business (S upplemental File 2)SB8 31 Com mittee on 	Budget and F",36,2,1,0,39
809776,533120,2016-04-14,Senate,"Senate 3rd Reading SB842 Committee On B. & F.R. (Leno)",25,11,4,0,40
809776,555507,2016-06-27,Assembly,"SB 842 B.& F. R.  Senate Third Reading  By TING",75,0,0,5,80
809779,545218,2016-05-12,Senate,"Senate 3rd Reading SCR94 Pan",38,0,2,0,40
809779,552040,2016-06-08,Assembly,"Be adopted, as amended, to Consent Calendar",9,0,0,1,10
809779,553741,2016-06-16,Assembly,"SCR 94 Pan  Consent Calendar Second Day  Regular Session",78,0,0,2,80
809779,557056,2016-06-30,Senate,"Special Consent # SCR94 Pan",37,0,3,0,40
809783,540130,2016-04-28,Assembly,"AB 1605 BUDGET  Assembly Third Reading  By TING",51,26,0,3,80
809783,552472,2016-06-13,Senate,"Do pass",11,5,1,0,17
809784,539704,2016-04-28,Assembly,"AB 1628 BUDGET  Assembly Third Reading  By TING",51,26,0,3,80
809784,559402,2016-08-11,Senate,"Do pass as amended",15,1,1,0,17
809784,560049,2016-08-17,Senate,"Assembly 3rd Reading AB1628 Committee On BUDGET (Ting) By Leno",38,0,1,0,39
809784,561002,2016-08-24,Assembly,"AB 1628 BUDGET  Concurrence in Senate Amendments By TING",69,10,0,1,80
809785,533326,2016-04-14,Senate,"Senate 3rd Reading SB837 Committee On B. & F.R. (Leno)",25,11,4,0,40
809785,553607,2016-06-16,Assembly,"SB 837 B.& F. R.  Senate Third Reading  By TING",49,27,0,4,80
809785,553608,2016-06-16,Senate,"Unfinished Business Su p 1SB837 Committee O n B. & F.R.(Leno) 	Concurrence",27,12,1,0,40
809789,540094,2016-04-28,Assembly,"AB 1599 BUDGET  Assembly Third Reading  By TING",51,26,0,3,80
809789,552471,2016-06-13,Senate,"Do pass",15,0,2,0,17
809791,539587,2016-04-28,Assembly,"AB 1615 BUDGET  Assembly Third Reading  By TING",51,26,0,3,80
809791,552470,2016-06-13,Senate,"Do pass",12,5,0,0,17
809792,539758,2016-04-28,Assembly,"AB 1620 BUDGET  Assembly Third Reading  By TING",51,26,0,3,80
809792,552450,2016-06-13,Senate,"Do pass",14,1,2,0,17
809793,539600,2016-04-28,Assembly,"AB 1607 BUDGET  Assembly Third Reading  By TING",51,26,0,3,80
809793,552465,2016-06-13,Senate,"Do pass",14,2,1,0,17
809793,553724,2016-06-16,Senate,"Assembly 3rd Reading AB1607 Committee On BUDGET (Ting) By Leno 	Urgency Clause",34,4,2,0,40
809793,553725,2016-06-16,Assembly,"AB 1607 BUDGET  Concurrence- Urgency Added  By TING",75,0,0,5,80
809796,540059,2016-04-28,Assembly,"AB 1603 BUDGET  Assembly Third Reading  By TING",51,26,0,3,80
809796,553194,2016-06-15,Senate,"Do pass",13,3,1,0,17
809796,553689,2016-06-16,Senate,"Assembly 3rd Reading AB1603 Committee On BUDGET (Ting) By Leno",29,9,2,0,40
809796,553690,2016-06-16,Assembly,"AB 1603 BUDGET  Concurrence in Senate Amendments By TING",54,24,0,2,80
809797,539804,2016-04-28,Assembly,"AB 1619 BUDGET  Assembly Third Reading  By TING",51,26,0,3,80
809799,533160,2016-04-14,Senate,"Senate 3rd Reading SB855 Committee On B. & F.R. (Leno)",25,11,4,0,40
809799,559217,2016-08-10,Assembly,"Do pass",18,2,0,7,27
809800,539711,2016-04-28,Assembly,"AB 1612 BUDGET  Assembly Third Reading  By TING",51,26,0,3,80
809800,560071,2016-08-17,Senate,"Do pass",12,5,0,0,17
809802,539641,2016-04-28,Assembly,"AB 1601 BUDGET  Assembly Third Reading  By TING",51,26,0,3,80
809803,533380,2016-04-14,Senate,"Senate 3rd Reading SB845 Committee On B. & F.R. (Leno)",25,11,4,0,40
809804,539585,2016-04-28,Assembly,"AB 1630 BUDGET  Assembly Third Reading  By TING",51,26,0,3,80
809804,561784,2016-08-31,Senate,"Do pass",14,1,2,0,17
809804,561785,2016-08-31,Senate,"Assembly 3rd Reading ( Supplemental File 2)AB 1630 Co mmittee on 	Budget By",32,6,1,0,39
809804,561786,2016-08-31,Assembly,"AB 1630 BUDGET  Concurrence in Senate Amendments By TING",54,23,0,3,80
809806,539708,2016-04-28,Assembly,"AB 1624 BUDGET  Assembly Third Reading  By TING",51,26,0,3,80
809806,559472,2016-08-11,Senate,"Do pass",14,2,1,0,17
809806,559959,2016-08-16,Senate,"Assembly 3rd Reading AB1624 Committee On BUDGET (Ting) By Leno",30,2,7,0,39
809806,561075,2016-08-24,Assembly,"AB 1624 BUDGET  Concurrence in Senate Amendments By TING",77,3,0,0,80
809810,533400,2016-04-14,Senate,"Senate 3rd Reading SB832 Committee On B. & F.R. (Leno)",25,11,4,0,40
809811,539755,2016-04-28,Assembly,"AB 1614 BUDGET  Assembly Third Reading  By TING",51,26,0,3,80
809813,539712,2016-04-28,Assembly,"AB 1606 BUDGET  Assembly Third Reading  By TING",51,26,0,3,80
809813,553273,2016-06-15,Senate,"Do pass",14,1,2,0,17
809813,553769,2016-06-16,Senate,"Assembly 3rd Reading AB1606 Committee On BUDGET (Ting) By Leno",38,0,2,0,40
809813,553770,2016-06-16,Assembly,"AB 1606 BUDGET  Concurrence in Senate Amendments By TING",65,13,0,2,80
809814,489720,2016-02-01,Senate,"Senate 3rd Reading SCR95 Pan",38,0,2,0,40
809814,509276,2016-02-29,Assembly,"Be adopted, to Consent Calendar",8,0,0,3,11
809814,513479,2016-03-03,Assembly,"SCR 95 Pan  Consent Calendar Second Day  Regular Session",75,0,0,4,79
809814,515139,2016-03-07,Senate,"Unfinished Business SCR95 Pan Concurrence",40,0,0,0,40
809815,539976,2016-04-28,Assembly,"AB 1608 BUDGET  Assembly Third Reading  By TING",51,26,0,3,80
809815,553391,2016-06-15,Senate,"Do pass",11,5,1,0,17
809817,533463,2016-04-14,Senate,"Senate 3rd Reading SB828 Committee On B. & F.R. (Leno)",25,11,4,0,40
809817,553253,2016-06-15,Assembly,"SB 828 B.& F. R.  Senate Third Reading  By TING",78,0,0,2,80
809817,553254,2016-06-15,Senate,"Unfinished Business Su p 1SB828 Committee O n B. & F.R.(Leno) 	Concurrence",38,0,2,0,40
809818,539638,2016-04-28,Assembly,"AB 1631 BUDGET  Assembly Third Reading  By TING",51,26,0,3,80
809821,533465,2016-04-14,Senate,"Senate 3rd Reading SB853 Committee On B. & F.R. (Leno)",25,11,4,0,40
809821,559218,2016-08-10,Assembly,"Do pass as amended",21,0,0,6,27
809822,511682,2016-03-01,Assembly,"Do pass as amended",5,0,0,2,7
809822,525347,2016-03-28,Assembly,"AB 1597 STONE  Assembly Third Reading",54,17,0,8,79
809822,544649,2016-05-10,Senate,"Do pass",6,1,0,0,7
809822,552546,2016-06-13,Senate,"Assembly 3rd Reading AB1597 Mark Stone By Hancock",32,7,1,0,40
809822,553768,2016-06-16,Assembly,"AB 1597 STONE  Concurrence in Senate Amendments",54,22,0,4,80
809824,532359,2016-04-12,Assembly,"Do pass as amended and be re-referred to the Committee on 	Appropriations",7,0,0,2,9
809826,533115,2016-04-14,Senate,"Senate 3rd Reading SB834 Committee On B. & F.R. (Leno)",25,11,4,0,40
809826,560450,2016-08-19,Assembly,"SB 834 B.& F. R.  Senate Third Reading  Amend By TING  Set #1",50,20,0,10,80
809826,561753,2016-08-31,Assembly,"Do pass",17,8,0,2,27
809827,533163,2016-04-14,Senate,"Senate 3rd Reading SB852 Committee On B. & F.R. (Leno)",25,11,4,0,40
809829,540139,2016-04-28,Assembly,"AB 1625 BUDGET  Assembly Third Reading  By TING",51,26,0,3,80
809829,559372,2016-08-11,Senate,"Do pass as amended",15,0,2,0,17
809829,559957,2016-08-16,Senate,"Assembly 3rd Reading AB1625 Committee On BUDGET (Ting) By Leno",37,0,2,0,39
809829,561028,2016-08-24,Assembly,"AB 1625 BUDGET  Concurrence in Senate Amendments By TING",74,4,0,2,80
809830,533381,2016-04-14,Senate,"Senate 3rd Reading SB846 Committee On B. & F.R. (Leno)",25,11,4,0,40
809830,560402,2016-08-19,Assembly,"SB 846 B.& F. R.  Senate Third Reading  Amend By STONE  Set #1",73,0,0,7,80
809830,560918,2016-08-24,Assembly,"Do pass",8,0,0,2,10
809830,561381,2016-08-29,Assembly,"SB 846 Anderson  Senate Third Reading  By STONE",80,0,0,0,80
809831,539601,2016-04-28,Assembly,"AB 1600 BUDGET  Assembly Third Reading  By TING",51,26,0,3,80
809831,552448,2016-06-13,Senate,"Do pass",17,0,0,0,17
809835,542783,2016-05-03,Assembly,"Be adopted as amended",7,0,0,2,9
809835,556550,2016-06-29,Senate,"Be adopted",7,0,0,0,7
809835,559367,2016-08-11,Senate,"Special Consent ACR112 Hadley By Pavley",37,0,2,0,39
809837,539856,2016-04-28,Assembly,"AB 1617 BUDGET  Assembly Third Reading  By TING",51,26,0,3,80
809838,539709,2016-04-28,Assembly,"AB 1604 BUDGET  Assembly Third Reading  By TING",51,26,0,3,80
809839,533242,2016-04-14,Senate,"Senate 3rd Reading SB856 Committee On B. & F.R. (Leno)",25,11,4,0,40
809839,559215,2016-08-10,Assembly,"Do pass",25,0,0,2,27
809841,533205,2016-04-14,Senate,"Senate 3rd Reading SB843 Committee On B. & F.R. (Leno)",25,11,4,0,40
809841,553637,2016-06-16,Assembly,"SB 843 B.& F. R.  Senate Third Reading  By TING",51,27,0,2,80
809841,553638,2016-06-16,Senate,"Unfinished Business Su p 1SB843 Committee O n B. & F.R.(Leno) 	Concurrence",26,13,1,0,40
809843,539651,2016-04-28,Assembly,"AB 1626 BUDGET  Assembly Third Reading  By TING",51,26,0,3,80
809843,559391,2016-08-11,Senate,"Do pass",16,0,1,0,17
809843,559958,2016-08-16,Senate,"Assembly 3rd Reading AB1626 Committee On BUDGET (Ting) By Leno",38,0,1,0,39
809844,539640,2016-04-28,Assembly,"AB 1618 BUDGET  Assembly Third Reading  By TING",51,26,0,3,80
809844,553212,2016-06-15,Senate,"Do pass as amended",10,2,5,0,17
809844,555664,2016-06-27,Senate,"Do pass",13,3,1,0,17
809844,555665,2016-06-27,Senate,"Assembly 3rd Reading ( Supplemental File 1)AB 1618 Co mmittee on 	Budget By",36,1,3,0,40
809844,556874,2016-06-30,Assembly,"AB 1618 BUDGET  Concurrence in Senate Amendments By TING",70,7,0,3,80
809846,533466,2016-04-14,Senate,"Senate 3rd Reading SB857 Committee On B. & F.R. (Leno)",25,11,4,0,40
809846,559210,2016-08-10,Assembly,"Do pass",25,0,0,2,27
809849,540317,2016-04-28,Assembly,"AB 1635 BUDGET  Assembly Third Reading  By TING",51,26,0,3,80
809850,539701,2016-04-28,Assembly,"AB 1636 BUDGET  Assembly Third Reading  By TING",51,26,0,3,80
809851,539639,2016-04-28,Assembly,"AB 1602 BUDGET  Assembly Third Reading  By TING",51,26,0,3,80
809851,553274,2016-06-15,Senate,"Do pass",14,1,2,0,17
809851,553694,2016-06-16,Senate,"Assembly 3rd Reading AB1602 Committee On BUDGET (Ting) By Leno",29,5,6,0,40
809851,553695,2016-06-16,Assembly,"AB 1602 BUDGET  Concurrence in Senate Amendments By TING",61,12,0,7,80
809853,539700,2016-04-28,Assembly,"AB 1611 BUDGET  Assembly Third Reading  By TING",51,26,0,3,80
809853,555579,2016-06-27,Senate,"Do pass",10,5,2,0,17
809853,555580,2016-06-27,Senate,"Assembly 3rd Reading ( Supplemental File 1)AB 1611 Co mmittee on 	Budget By",23,13,4,0,40
809854,539589,2016-04-28,Assembly,"AB 1613 BUDGET  Assembly Third Reading  By TING",51,26,0,3,80
809854,561719,2016-08-31,Senate,"Assembly 3rd Reading ( Supplemental File 1)AB 1613 Co mmittee on 	Budget By",25,13,1,0,39
809854,561720,2016-08-31,Assembly,"AB 1613 BUDGET  Concurrence in Senate Amendments By TING",51,28,0,1,80
809855,539880,2016-04-28,Assembly,"AB 1637 BUDGET  Assembly Third Reading  By TING",51,26,0,3,80
809855,560524,2016-08-22,Senate,"Assembly 3rd Reading AB1637 Low By Beall",23,12,4,0,39
809855,561733,2016-08-30,Assembly,"Be referred to Committee on Appropriations",5,3,0,1,9
809855,561734,2016-08-31,Assembly,"Senate amendments be concurred in",16,0,0,4,20
809855,561735,2016-08-31,Assembly,"AB 1637 LOW  Concurrence in Senate Amendments",47,27,0,6,80
809862,533116,2016-04-14,Senate,"Senate 3rd Reading SB836 Committee On B. & F.R. (Leno)",25,11,4,0,40
809862,553798,2016-06-16,Assembly,"SB 836 B.& F. R.  Senate Third Reading  By TING",59,17,0,4,80
809862,553799,2016-06-16,Senate,"Unfinished Business Su p 1SB836 Committee O n B. & F.R.(Leno) 	Concurrence",26,13,1,0,40
809864,539656,2016-04-28,Assembly,"AB 1609 BUDGET  Assembly Third Reading  By TING",51,26,0,3,80
809864,553279,2016-06-15,Senate,"Do pass",13,3,1,0,17
809866,540177,2016-04-28,Assembly,"AB 1616 BUDGET  Assembly Third Reading  By TING",51,26,0,3,80
809866,552455,2016-06-13,Senate,"Do pass",14,3,0,0,17
809867,533324,2016-04-14,Senate,"Senate 3rd Reading SB839 Committee On B. & F.R. (Leno)",25,11,4,0,40
809867,553707,2016-06-16,Assembly,"SB 839 B.& F. R.  Senate Third Reading  By TING",48,28,0,4,80
809867,561341,2016-08-26,Senate,"Unfinished Business SB839 Committee On B. & F.R. (Leno) Concurrence",26,13,0,0,39
809869,535135,2016-04-19,Senate,"Do pass, but re-refer to the Committee on Appropriations",10,1,0,0,11
809869,549415,2016-05-27,Senate,"Do pass as amended",6,1,0,0,7
809869,550401,2016-06-01,Senate,"Senate 3rd Reading SB824 Beall Reconsider",36,0,4,0,40
809869,550402,2016-06-01,Senate,"Senate 3rd Reading SB824 Beall",26,11,3,0,40
809869,550403,2016-06-01,Senate,"Senate 3rd Reading SB824 Beall",25,9,6,0,40
809869,555586,2016-06-27,Assembly,"Do pass and be re-referred to the Committee on Appropriations",12,1,0,3,16
809869,559343,2016-08-11,Assembly,"Do pass as amended",14,2,0,4,20
809869,560870,2016-08-23,Assembly,"SB 824 Beall  Senate Third Reading  By FRAZIER",60,11,0,9,80
809869,561229,2016-08-25,Senate,"Unfinished Business SB824 Beall Concurrence",25,10,4,0,39
809870,533249,2016-04-14,Senate,"Senate 3rd Reading SB841 Committee On B. & F.R. (Leno)",25,11,4,0,40
809872,543828,2016-05-09,Senate,"Senate 3rd Reading SCR93 Pan",37,0,3,0,40
809872,547660,2016-05-23,Assembly,"Be adopted, to Consent Calendar",10,0,0,1,11
809872,549074,2016-05-27,Assembly,"SCR 93 Pan  Consent Calendar Second Day  Regular Session",67,0,0,13,80
809874,539697,2016-04-28,Assembly,"AB 1629 BUDGET  Assembly Third Reading  By TING",51,26,0,3,80
809877,540218,2016-04-28,Assembly,"AB 1621 BUDGET  Assembly Third Reading  By TING",51,26,0,3,80
809878,533482,2016-04-14,Senate,"Senate 3rd Reading SB833 Committee On B. & F.R. (Leno)",25,11,4,0,40
809878,553108,2016-06-15,Assembly,"SB 833 B.& F. R.  Senate Third Reading  By TING",71,8,0,1,80
809878,553109,2016-06-15,Senate,"Unfinished Business Su p 1SB833 Committee O n B. & F.R.(Leno) 	Concurrence",28,9,3,0,40
809880,539703,2016-04-28,Assembly,"AB 1627 BUDGET  Assembly Third Reading  By TING",51,26,0,3,80
809880,560075,2016-08-17,Senate,"Do pass",13,2,2,0,17
809880,560568,2016-08-22,Senate,"Assembly 3rd Reading AB1627 Committee On BUDGET (Ting) By Leno",32,4,3,0,39
809880,561268,2016-08-25,Assembly,"AB 1627 BUDGET  Concurrence in Senate Amendments By TING",79,0,0,1,80
809881,533252,2016-04-14,Senate,"Senate 3rd Reading SB830 Committee On B. & F.R. (Leno)",25,11,4,0,40
809881,560434,2016-08-19,Assembly,"SB 830 B.& F. R.  Senate Third Reading  Amend By TING  Set #1",48,21,0,11,80
809881,561698,2016-08-31,Assembly,"Do pass",16,10,0,1,27
809883,533332,2016-04-14,Senate,"Senate 3rd Reading SB858 Committee On B. & F.R. (Leno)",25,11,4,0,40
809883,559212,2016-08-10,Assembly,"Do pass",20,5,0,2,27
809884,533421,2016-04-14,Senate,"Senate 3rd Reading SB848 Committee On B. & F.R. (Leno)",25,11,4,0,40
809884,553101,2016-06-15,Assembly,"SB 848 B.& F. R.  Senate Third Reading  By TING",64,15,0,1,80
809884,553102,2016-06-15,Senate,"Unfinished Business Su p 1SB848 Committee O n B. & F.R.(Leno) 	Concurrence",31,4,5,0,40
809887,533202,2016-04-14,Senate,"Senate 3rd Reading SB827 Committee On B. & F.R. (Leno)",25,11,4,0,40
809887,553422,2016-06-15,Assembly,"SB 827 B.& F. R.  Senate Third Reading  By TING",80,0,0,0,80
809887,553423,2016-06-15,Senate,"Unfinished Business Su p 1SB827 Committee O n B. & F.R.(Leno) 	Concurrence",38,0,2,0,40
809888,533315,2016-04-14,Senate,"Senate 3rd Reading SB835 Committee On B. & F.R. (Leno)",25,11,4,0,40
809888,560451,2016-08-19,Assembly,"SB 835 B.& F. R.  Third Reading Urgency  Amend By TING  Set #1",50,20,0,10,80
809888,561259,2016-08-25,Senate,"From committee:  That the Assembly Amendments be concurred in",17,0,0,0,17
809888,561260,2016-08-25,Assembly,"SB 835 B.& F. R.  Senate Third Reading  By TING",79,0,0,1,80
809888,561329,2016-08-26,Senate,"Unfinished Business SB835 Committee On B. & F.R. (Leno) Concurrence",39,0,0,0,39
809889,533486,2016-04-14,Senate,"Senate 3rd Reading SB826 Committee On B. & F.R. (Leno)",25,11,4,0,40
809889,549115,2016-05-27,Assembly,"SB 826 B.& F. R.  Senate Third Reading  By TING",48,24,0,8,80
809889,549116,2016-05-27,Senate,"W/O REF. TO FILE SB826 Committee on B & F R By Leno",1,36,3,0,40
809889,553105,2016-06-15,Assembly,"SB 826 B.& F. R.  Conference Report  By TING",52,27,0,1,80
809889,553106,2016-06-15,Senate,"Conference Report SB826 Leno",27,11,2,0,40
809891,533413,2016-04-14,Senate,"Senate 3rd Reading SB860 Committee On B. & F.R. (Leno)",25,11,4,0,40
809894,533401,2016-04-14,Senate,"Senate 3rd Reading SB849 Committee On B. & F.R. (Leno)",25,11,4,0,40
809895,533415,2016-04-14,Senate,"Senate 3rd Reading SB838 Committee On B. & F.R. (Leno)",25,11,4,0,40
809895,553709,2016-06-16,Assembly,"SB 838 B.& F. R.  Senate Third Reading  By TING",49,28,0,3,80
809895,560622,2016-08-22,Senate,"Unfinished Business SB838 Committee On B. & F.R. (Leno) Concurrence",25,13,1,0,39
809897,533393,2016-04-14,Senate,"Senate 3rd Reading SB844 Committee On B. & F.R. (Leno)",25,11,4,0,40
809897,553154,2016-06-15,Assembly,"SB 844 B.& F. R.  Senate Third Reading  By TING",79,0,0,1,80
809897,553155,2016-06-15,Senate,"Unfinished Business Su p 1SB844 Committee O n B. & F.R.(Leno) 	Concurrence",32,6,2,0,40
809900,539578,2016-04-28,Assembly,"AB 1634 BUDGET  Assembly Third Reading  By TING",51,26,0,3,80
809901,539580,2016-04-28,Assembly,"AB 1632 BUDGET  Assembly Third Reading  By TING",51,26,0,3,80
809903,539732,2016-04-28,Assembly,"AB 1633 BUDGET  Assembly Third Reading  By TING",51,26,0,3,80
809904,520569,2016-03-16,Assembly,"Do pass as amended and be re-referred to the Committee on Judiciary",6,0,0,1,7
809904,528122,2016-04-05,Assembly,"Amend, and do pass as amended and be re-referred to the Committee 	on Appropriations with the recommendation:  To Consent Calendar",10,0,0,0,10
809904,536200,2016-04-20,Assembly,"Do pass, to Consent Calendar",16,0,0,4,20
809904,539635,2016-04-28,Assembly,"AB 1639 MAIENSCHEIN  Consent Calendar Second Day  Regular Session",76,0,0,4,80
809904,556565,2016-06-29,Senate,"Do pass, but re-refer to the Committee on Appropriations Recommend 	Consent",9,0,0,0,9
809904,558966,2016-08-01,Senate,"Placed on Appropriations Suspense file",7,0,0,0,7
809904,559707,2016-08-11,Senate,"Do pass as amended",7,0,0,0,7
809904,560233,2016-08-18,Senate,"Assembly 3rd Reading AB1639 Maienschein By Pan",38,0,1,0,39
809904,560886,2016-08-23,Assembly,"AB 1639 MAIENSCHEIN  Concurrence in Senate Amendments",79,0,0,1,80
809906,533451,2016-04-14,Senate,"Senate 3rd Reading SB840 Committee On B. & F.R. (Leno)",25,11,4,0,40
809906,553663,2016-06-16,Assembly,"SB 840 B.& F. R.  Senate Third Reading  By TING",53,23,0,4,80
809906,560626,2016-08-22,Senate,"Unfinished Business SB840 Committee On B. & F.R. (Leno) Concurrence",26,13,0,0,39
809907,533109,2016-04-14,Senate,"Senate 3rd Reading SB847 Committee On B. & F.R. (Leno)",25,11,4,0,40
809908,533418,2016-04-14,Senate,"Senate 3rd Reading SB829 Committee On B. & F.R. (Leno)",25,11,4,0,40
809910,539582,2016-04-28,Assembly,"AB 1622 BUDGET  Assembly Third Reading  By TING",51,26,0,3,80
809910,555743,2016-06-27,Senate,"Do pass",15,0,2,0,17
809910,555744,2016-06-27,Senate,"Assembly 3rd Reading ( Supplemental File 1)AB 1622 Co mmittee on 	Budget By",37,0,3,0,40
809910,556881,2016-06-30,Assembly,"AB 1622 BUDGET  Concurrence in Senate Amendments By TING",80,0,0,0,80
811410,519400,2016-03-14,Assembly,"Be adopted and re-referred to the Committee on Appropriations with 	recommendation:  To Consent Calendar",16,0,0,0,16
811410,530991,2016-04-11,Assembly,"ACR 115 MATHIS  Consent Calendar Second Day  Regular Session",77,0,0,2,79
811410,532371,2016-04-06,Assembly,"Be adopted, to Consent Calendar",18,0,0,2,20
811410,556169,2016-06-28,Senate,"Be adopted, but re-refer to the Committee on Appropriations 	Recommend Consent",10,0,1,0,11
811410,559461,2016-08-11,Senate,"Consent Calendar 2nd ACR115 Mathis By Berryhill",37,0,2,0,39
811411,529335,2016-04-06,Assembly,"Do pass and be re-referred to the Committee on Health",7,0,0,0,7
811411,531582,2016-04-12,Assembly,"Do pass as amended and be re-referred to the Committee on 	Appropriations",18,0,0,1,19
811411,549280,2016-05-27,Assembly,"Do pass as amended",20,0,0,0,20
811411,550551,2016-06-01,Assembly,"AB 1644 BONTA  Assembly Third Reading",80,0,0,0,80
811411,553103,2016-06-15,Senate,"Do pass, but re-refer to the Committee on Education",9,0,0,0,9
811411,556333,2016-06-29,Senate,"Do pass, but re-refer to the Committee on Appropriations",9,0,0,0,9
811411,558743,2016-08-01,Senate,"Placed on Appropriations Suspense file",7,0,0,0,7
811414,532250,2016-04-12,Senate,"Do pass, but re-refer to the Committee on Appropriations",4,0,1,0,5
811414,545196,2016-05-12,Senate,"Senate 3rd Reading SB866 Roth",38,0,2,0,40
811414,553115,2016-06-15,Assembly,"Do pass as amended and be re-referred to the Committee on Veterans 	Affairs",6,0,0,1,7
811414,556278,2016-06-28,Assembly,"Do pass and be re-referred to the Committee on Appropriations",7,0,0,2,9
811414,559007,2016-08-03,Assembly,"Do pass, to Consent Calendar",20,0,0,0,20
811414,559346,2016-08-11,Assembly,"SB 866 Roth  Consent Calendar Second Day  Regular Session",78,0,0,2,80
811414,560221,2016-08-18,Senate,"Special Consent SB866 Roth",36,0,3,0,39
811418,487068,2016-01-25,Assembly,"From committee:  Be adopted.  To third reading",11,0,0,0,11
811418,531050,2016-04-11,Senate,"Assembly 3rd Reading ACR114 Gallagher By Moorlach",36,0,4,0,40
811418,531051,2016-04-11,Senate,"Assembly 3rd Reading ACR114 Gallagher By Moorlach Reconsider",35,0,5,0,40
811418,531052,2016-04-11,Senate,"Assembly 3rd Reading ACR114 Gallagher By Moorlach",23,1,16,0,40
811419,486449,2016-01-21,Assembly,"From committee:  Be adopted.  To third reading",9,0,0,2,11
811419,550934,2016-06-02,Senate,"Special Consent # ACR113 Low By Liu",39,0,1,0,40
811422,520285,2016-03-14,Assembly,"Do pass and be re-referred to the Committee on Appropriations to 	Consent Calendar",8,0,0,1,9
811424,536183,2016-04-20,Assembly,"Do pass and be re-referred to the Committee on Appropriations",9,3,0,1,13
811424,549148,2016-05-27,Assembly,"Do pass",15,5,0,0,20
811424,550464,2016-06-01,Assembly,"AB 1643 GONZALEZ  Assembly Third Reading",60,20,0,0,80
811424,556402,2016-06-29,Senate,"Do pass, but re-refer to the Committee on Appropriations",4,1,0,0,5
811424,558724,2016-08-01,Senate,"Placed on Appropriations Suspense file",7,0,0,0,7
811424,559595,2016-08-11,Senate,"Do pass",5,2,0,0,7
811424,560475,2016-08-22,Senate,"Assembly 3rd Reading AB1643 Gonzalez By Block",24,14,1,0,39
811426,528310,2016-04-05,Senate,"Do pass as amended",7,0,0,0,7
811426,538054,2016-04-25,Senate,"Senate 3rd Reading SB867 Roth",39,0,1,0,40
811426,538055,2016-04-25,Senate,"Senate 3rd Reading SB867 Roth Reconsider",39,0,1,0,40
811426,538056,2016-04-25,Senate,"Senate 3rd Reading SB867 Roth",36,1,3,0,40
811426,552916,2016-06-14,Assembly,"Do pass",7,0,0,0,7
811426,559115,2016-08-04,Assembly,"SB 867 Roth  Senate Third Reading  By ARAMBULA",69,7,0,4,80
811427,559356,2016-08-11,Senate,"Senate 3rd Reading SCR97 Pan",36,0,3,0,39
811427,560165,2016-08-18,Assembly,"Be adopted, to Consent Calendar",9,0,0,2,11
811427,560523,2016-08-22,Assembly,"SCR 97 Pan  Consent Calendar Second Day",78,0,0,2,80
812646,528833,2016-04-06,Assembly,"Do pass, to Consent Calendar",13,0,0,0,13
812646,533283,2016-04-14,Assembly,"AB 1645 DABABNEH  Consent Calendar Second Day",76,0,0,4,80
812646,555113,2016-06-22,Senate,"Do pass and be placed on the Consent Calendar",8,0,1,0,9
812646,556906,2016-06-30,Senate,"Consent Calendar 2nd AB1645 Dababneh",37,0,3,0,40
812651,526788,2016-03-31,Assembly,"Be referred to Committee on Accountability and Administrative 	Review",8,0,0,3,11
812651,532915,2016-04-13,Assembly,"Do pass and be re-referred to the Committee on Appropriations",8,0,0,1,9
812665,527978,2016-04-05,Senate,"Do pass, but re-refer to the Committee on Public Safety",7,2,2,0,11
812665,534821,2016-04-19,Senate,"Do pass as amended, and re-refer to the Committee on Appropriations",5,2,0,0,7
812665,545810,2016-05-16,Senate,"Placed on Appropriations Suspense file",7,0,0,0,7
812665,549000,2016-05-27,Senate,"Do pass",5,2,0,0,7
812665,550485,2016-06-01,Senate,"Senate 3rd Reading SB868 Jackson",25,12,3,0,40
812665,554640,2016-06-21,Assembly,"Do pass and be re-referred to the Committee on Transportation",3,4,0,4,11
812674,526328,2016-03-30,Assembly,"Do pass and be re-referred to the Committee on Appropriations to 	Consent Calendar",15,0,0,0,15
812674,549161,2016-05-27,Assembly,"Do pass",20,0,0,0,20
812674,549979,2016-05-31,Assembly,"AB 1651 OBERNOLTE  Assembly Third Reading",80,0,0,0,80
812674,555592,2016-06-27,Senate,"Do pass, but re-refer to the Committee on Appropriations",9,0,2,0,11
812674,558916,2016-08-01,Senate,"Placed on Appropriations Suspense file",7,0,0,0,7
812674,559741,2016-08-11,Senate,"Do pass as amended",6,0,1,0,7
812674,560866,2016-08-23,Senate,"Assembly 3rd Reading AB1651 Obernolte By Hill",39,0,0,0,39
812674,561360,2016-08-29,Assembly,"AB 1651 OBERNOLTE  Concurrence in Senate Amendments",80,0,0,0,80
812677,489785,2016-02-01,Assembly,"From committee:  Be adopted.  To third reading",10,0,0,1,11
812677,513206,2016-03-03,Senate,"Assembly 3rd Reading ACR116 McCarty By McGuire",39,0,1,0,40
812681,525606,2016-03-29,Senate,"Do pass as amended, and re-refer to the Committee on Appropriations",5,2,0,0,7
812681,533152,2016-04-14,Senate,"Senate 3rd Reading SB869 Hill",25,13,2,0,40
812681,552644,2016-06-14,Assembly,"Do pass and be re-referred to the Committee on Appropriations",7,0,0,0,7
812681,556284,2016-06-29,Assembly,"Do pass",13,5,0,2,20
812681,560213,2016-08-18,Assembly,"SB 869 Hill  Senate Third Reading  By CHIU",61,17,0,2,80
812681,560912,2016-08-24,Senate,"Unfinished Business SB869 Hill Concurrence",27,12,0,0,39
812685,531567,2016-04-12,Assembly,"Do pass and be re-referred to the Committee on Appropriations",11,0,0,4,15
812685,549135,2016-05-27,Assembly,"Do pass as amended",20,0,0,0,20
812685,550730,2016-06-01,Assembly,"AB 1649 SALAS  Assembly Third Reading",72,6,0,2,80
812685,556014,2016-06-28,Senate,"Do pass, but re-refer to the Committee on Appropriations",2,1,6,0,9
812685,556015,2016-06-28,Senate,"Set, first hearing.  Failed passage in Committee.  Reconsideration 	granted",8,0,1,0,9
812689,525607,2016-03-29,Assembly,"Do pass and be re-referred to the Committee on Appropriations to 	Consent Calendar",16,0,0,0,16
812689,532249,2016-04-13,Assembly,"Do pass, to Consent Calendar",20,0,0,0,20
812689,537109,2016-04-21,Assembly,"AB 1650 FRAZIER  Consent Calendar Second Day  Regular Session",79,0,0,1,80
812689,552460,2016-06-13,Senate,"Do pass, but re-refer to the Committee on Appropriations Recommend 	Consent",9,0,0,0,9
812689,556787,2016-06-30,Senate,"Consent Calendar 2nd AB1650 Frazier",37,0,3,0,40
812689,559110,2016-08-04,Assembly,"AB 1650 FRAZIER  Concurrence in Senate Amendments",77,0,0,3,80
812693,528295,2016-04-05,Senate,"Do pass, but re-refer to the Committee on Appropriations",7,0,0,0,7
812693,534591,2016-04-18,Senate,"Placed on Appropriations Suspense file",7,0,0,0,7
812693,549231,2016-05-27,Senate,"Do pass",7,0,0,0,7
812693,549961,2016-05-31,Senate,"Senate 3rd Reading SB870 Roth",39,0,1,0,40
816031,517867,2016-03-10,Assembly,"From committee:  Be adopted.  To third reading",10,0,0,1,11
816037,510538,2016-03-01,Assembly,"Do pass and be re-referred to the Committee on Appropriations to 	Consent Calendar",7,0,0,0,7
816037,549060,2016-05-27,Assembly,"Do pass as amended",20,0,0,0,20
816037,550415,2016-06-01,Assembly,"AB 1654 SANTIAGO  Assembly Third Reading",80,0,0,0,80
816037,553124,2016-06-15,Senate,"Do pass, but re-refer to the Committee on Appropriations Recommend 	Consent",9,0,0,0,9
816037,559312,2016-08-11,Senate,"Consent Calendar 2nd AB1654 Santiago",37,0,2,0,39
816041,528005,2016-04-05,Assembly,"Do pass and be re-referred to the Committee on Transportation",11,0,0,0,11
816041,534132,2016-04-18,Assembly,"Do pass and be re-referred to the Committee on Appropriations",15,0,0,1,16
816041,542364,2016-05-04,Assembly,"Do pass, to Consent Calendar",20,0,0,0,20
816041,547028,2016-05-19,Assembly,"AB 1662 CHAU  Assembly Third Reading",67,2,0,11,80
816041,554663,2016-06-21,Senate,"Do pass, but re-refer to the Committee on Appropriations",6,1,0,0,7
816041,561726,2016-08-31,Senate,"Assembly 3rd Reading AB1662 Chau By Gaines",34,3,2,0,39
816041,561727,2016-08-31,Assembly,"AB 1662 CHAU  Concurrence in Senate Amendments",73,2,0,5,80
816046,519774,2016-03-15,Assembly,"Do pass and be re-referred to the Committee on Appropriations",18,0,0,1,19
816054,528782,2016-04-06,Assembly,"Do pass as amended",9,0,0,0,9
816054,549254,2016-05-27,Assembly,"Do pass",20,0,0,0,20
816054,550075,2016-05-31,Assembly,"AB 1661 MCCARTY  Assembly Third Reading",78,0,0,2,80
816054,555063,2016-06-22,Senate,"Do pass, but re-refer to the Committee on Appropriations",6,0,1,0,7
816054,558962,2016-08-01,Senate,"Placed on Appropriations Suspense file",7,0,0,0,7
816054,559753,2016-08-11,Senate,"Do pass as amended",7,0,0,0,7
816054,559979,2016-08-16,Senate,"Assembly 3rd Reading AB1661 McCarty By Jackson",38,0,1,0,39
816054,560855,2016-08-23,Assembly,"AB 1661 MCCARTY  Concurrence in Senate Amendments",78,0,0,2,80
816058,520415,2016-03-15,Assembly,"Do pass and be re-referred to the Committee on Appropriations",11,1,0,1,13
816058,549114,2016-05-27,Assembly,"Do pass as amended",14,6,0,0,20
816058,550897,2016-06-02,Assembly,"AB 1653 WEBER  Assembly Third Reading",59,17,0,4,80
816058,554965,2016-06-22,Senate,"Do pass as amended, and re-refer to the Committee on Business, 	Professions and Economic Development",9,0,0,0,9
816058,558808,2016-08-01,Senate,"Placed on Appropriations Suspense file",7,0,0,0,7
816058,559562,2016-08-11,Senate,"Do pass as amended",5,2,0,0,7
816058,560529,2016-08-22,Senate,"Assembly 3rd Reading AB1653 Weber By Leyva",29,10,0,0,39
816058,561151,2016-08-25,Assembly,"AB 1653 WEBER  Concurrence in Senate Amendments",59,16,0,5,80
816069,489051,2016-01-28,Assembly,"From committee:  Be adopted.  To third reading",10,0,0,1,11
816069,507279,2016-02-25,Senate,"Assembly 3rd Reading ACR117 Lackey By Bates",25,6,9,0,40
816075,528059,2016-04-04,Assembly,"Do pass as amended and be re-referred to the Committee on 	Transportation",9,0,0,0,9
816075,534341,2016-04-18,Assembly,"Do pass and be re-referred to the Committee on Appropriations",15,0,0,1,16
816085,486455,2016-01-21,Assembly,"From committee:  Be adopted.  To third reading",9,0,0,2,11
816085,507267,2016-02-25,Senate,"Assembly 3rd Reading ACR118 McCarty By Hall",37,0,3,0,40
816091,520510,2016-03-16,Assembly,"Amend, and do pass as amended and be re-referred to the Committee 	on Arts, Entertain, Sports, Tourism, & Internet Media with the 	recommendation:  To Consent Calendar",6,0,0,1,7
816091,541887,2016-05-03,Assembly,"Do pass as amended, to Consent Calendar",7,0,0,0,7
816091,545325,2016-05-12,Assembly,"AB 1660 COOPER  Consent Calendar Second Day  Regular Session",78,0,0,2,80
816091,552169,2016-06-08,Senate,"Do pass",9,0,0,0,9
816091,558626,2016-08-01,Senate,"Assembly 3rd Reading AB1660 Cooper By Cannella",38,0,1,0,39
816094,542194,2016-05-04,Assembly,"Do pass",8,0,0,1,9
816094,545332,2016-05-12,Assembly,"AB 1658 BIGELOW  Assembly Third Reading",78,0,0,2,80
816094,553275,2016-06-15,Senate,"Do pass",7,0,0,0,7
816094,559918,2016-08-15,Senate,"Assembly 3rd Reading AB1658 Bigelow By Gaines",37,0,2,0,39
817427,528287,2016-04-05,Senate,"Do pass",7,0,0,0,7
817427,529446,2016-04-07,Senate,"Senate 3rd Reading SB872 Hall",38,0,2,0,40
817427,557150,2016-06-29,Assembly,"Do pass",8,1,0,0,9
817427,559124,2016-08-04,Assembly,"SB 872 Hall  Senate Third Reading  By BLOOM",76,0,0,4,80
817427,560409,2016-08-19,Assembly,"SB 872 Hall  Senate Third Reading  Amendment  Set #1",73,0,0,7,80
817427,561311,2016-08-25,Assembly,"SB 872 Hall  Senate Third Reading  By BLOOM",79,0,0,1,80
817427,561484,2016-08-29,Senate,"Unfinished Business SB872 Hall Concurrence",39,0,0,0,39
817429,532183,2016-04-13,Assembly,"Do pass as amended and be re-referred to the Committee on 	Appropriations",9,0,0,0,9
817429,544828,2016-05-11,Assembly,"Do pass, to Consent Calendar",20,0,0,0,20
817429,547022,2016-05-19,Assembly,"AB 1666 BROUGH  Consent Calendar Second Day",76,0,0,4,80
817429,553100,2016-06-15,Senate,"Do pass, but re-refer to the Committee on Appropriations Recommend 	Consent",7,0,0,0,7
817429,556824,2016-06-30,Senate,"Consent Calendar 2nd AB1666 Brough",37,0,3,0,40
817431,510569,2016-03-01,Assembly,"Do pass and be re-referred to the Committee on Appropriations",5,2,0,0,7
817434,528680,2016-04-06,Assembly,"Do pass and be re-referred to the Committee on Revenue and Taxation",6,3,0,0,9
817434,538469,2016-04-25,Assembly,"Do pass",6,0,0,3,9
817434,545770,2016-05-16,Assembly,"AB 1665 BONILLA  Third Reading Urgency",77,0,0,3,80
817434,552674,2016-06-14,Senate,"Do pass, but re-refer to the Committee on Governance and Finance 	Recommend Consent",11,0,0,0,11
817434,554997,2016-06-22,Senate,"Do pass",6,0,1,0,7
817434,556730,2016-06-30,Senate,"Assembly 3rd Reading AB1665 Bonilla By Glazer Urgency Clau",36,1,3,0,40
817436,510623,2016-03-01,Assembly,"Do pass and be re-referred to the Committee on Appropriations",5,2,0,0,7
817436,549036,2016-05-27,Assembly,"Do pass as amended",13,6,0,1,20
817436,550419,2016-06-01,Assembly,"AB 1664 LEVINE  Assembly Third Reading",43,31,0,6,80
817436,552671,2016-06-14,Senate,"Do pass as amended, and re-refer to the Committee on Appropriations",5,2,0,0,7
817436,554431,2016-06-20,Senate,"Placed on Appropriations Suspense file",2,5,0,0,7
817436,554432,2016-06-20,Senate,"Do pass as amended",5,2,0,0,7
817437,489143,2016-01-28,Senate,"Senate 3rd Reading SR55 Bates",40,0,0,0,40
817438,539333,2016-04-27,Senate,"Do pass as amended, and re-refer to the Committee on Appropriations",6,0,1,0,7
817438,546086,2016-05-16,Senate,"Placed on Appropriations Suspense file",7,0,0,0,7
817441,517327,2016-03-09,Senate,"Do pass as amended, and re-refer to the Committee on Appropriations",8,0,1,0,9
817441,530467,2016-04-11,Senate,"Placed on Appropriations Suspense file",7,0,0,0,7
817441,549263,2016-05-27,Senate,"Do pass as amended",6,1,0,0,7
817441,550469,2016-06-01,Senate,"Senate 3rd Reading SB871 Liu",39,0,1,0,40
817443,525550,2016-03-29,Senate,"Do pass, but re-refer to the Committee on Judiciary",2,7,2,0,11
817443,527998,2016-04-05,Senate,"Reconsideration granted",8,0,3,0,11
817445,526252,2016-03-30,Senate,"Do pass as amended, and re-refer to the Committee on Appropriations",7,0,0,0,7
817445,534135,2016-04-18,Senate,"Placed on Appropriations Suspense file",7,0,0,0,7
817445,548961,2016-05-27,Senate,"Do pass",6,0,1,0,7
817445,549930,2016-05-31,Senate,"Senate 3rd Reading SB873 Beall",39,0,1,0,40
817445,553176,2016-06-15,Assembly,"Do pass and be re-referred to the Committee on Revenue and Taxation",6,0,0,1,7
817445,554648,2016-06-20,Assembly,"Do pass as amended and be re-referred to the Committee on 	Appropriations",9,0,0,0,9
817445,559286,2016-08-11,Assembly,"Do pass",15,0,0,5,20
817445,560371,2016-08-19,Assembly,"SB 873 Beall  Senate Third Reading  Amendment  Set #1",73,0,0,7,80
817445,560654,2016-08-23,Assembly,"Do pass as amended, to Consent Calendar",10,0,0,0,10
817445,561605,2016-08-30,Assembly,"SB 873 Beall  Senate Third Reading  By CALDERON",79,0,0,1,80
817445,561718,2016-08-31,Senate,"Unfinished Business SB873 Beall Concurrence",39,0,0,0,39
817446,542525,2016-05-03,Senate,"Do pass and be placed on the Consent Calendar",6,0,1,0,7
817446,545295,2016-05-12,Senate,"Consent Calendar 2nd SB875 Gaines",38,0,2,0,40
817446,552068,2016-06-08,Assembly,"Do pass, to Consent Calendar",9,0,0,1,10
817446,553727,2016-06-16,Assembly,"SB 875 Gaines  Consent Calendar Second Day",78,0,0,2,80
817446,559097,2016-08-04,Assembly,"SB 875 Gaines  Senate Third Reading  By GAINES",76,0,0,4,80
817446,559504,2016-08-11,Senate,"Special Consent SB875 Gaines Concurrence",37,0,2,0,39
818068,531268,2016-04-12,Senate,"Do pass, but re-refer to the Committee on Public Safety",11,0,0,0,11
818068,534812,2016-04-19,Senate,"Do pass, but re-refer to the Committee on Appropriations",6,1,0,0,7
818068,549066,2016-05-27,Senate,"Do pass",5,2,0,0,7
818068,549995,2016-05-31,Senate,"Senate 3rd Reading SB881 Hertzberg",32,7,1,0,40
818068,554627,2016-06-20,Assembly,"Do pass and be re-referred to the Committee on Public Safety",11,4,0,1,16
818068,555952,2016-06-28,Assembly,"Do pass as amended and be re-referred to the Committee on 	Appropriations",5,2,0,0,7
818068,559229,2016-08-11,Assembly,"Do pass as amended",13,1,0,6,20
818068,560403,2016-08-19,Assembly,"SB 881 Hertzberg  Senate Third Reading  By A.,E.,S.,T.,& I.M. 	Amendment  Set #1",73,0,0,7,80
818068,561386,2016-08-29,Assembly,"Do pass",15,0,0,1,16
818068,561590,2016-08-30,Assembly,"SB 881 Hertzberg  Senate Third Reading  By LOW",80,0,0,0,80
818068,561702,2016-08-31,Senate,"From committee:  That the Assembly Amendments be concurred in",10,0,1,0,11
818068,561703,2016-08-31,Senate,"Unfinished Business SB881 Hertzberg Concurrence",39,0,0,0,39
818070,534801,2016-04-19,Senate,"Do pass, but re-refer to the Committee on Appropriations",5,2,0,0,7
818070,545782,2016-05-16,Senate,"Placed on Appropriations Suspense file",2,4,1,0,7
818070,545783,2016-05-16,Senate,"Do pass as amended",5,2,0,0,7
818070,547038,2016-05-19,Senate,"Senate 3rd Reading SB880 Hall",24,14,2,0,40
818070,552667,2016-06-14,Assembly,"Do pass and be re-referred to the Committee on Appropriations",5,1,0,1,7
818070,556778,2016-06-30,Assembly,"SB 880 Hall  Senate Third Reading  By JONES-SAWYER",44,30,0,6,80
818073,526244,2016-03-29,Assembly,"Do pass as amended and be re-referred to the Committee on 	Appropriations",6,0,0,1,7
818075,541765,2016-05-03,Senate,"Do pass, but re-refer to the Committee on Governance and Finance",9,1,1,0,11
818075,544937,2016-05-11,Senate,"Do pass, but re-refer to the Committee on Appropriations",5,1,1,0,7
818075,547544,2016-05-23,Senate,"Placed on Appropriations Suspense file",7,0,0,0,7
818075,549266,2016-05-27,Senate,"Do pass",5,1,1,0,7
818075,550733,2016-06-01,Senate,"Senate 3rd Reading SB879 Beall Urgency Clause",28,9,3,0,40
818075,553227,2016-06-15,Assembly,"Do pass as amended and be re-referred to the Committee on 	Appropriations",4,2,0,1,7
818075,559248,2016-08-11,Assembly,"Do pass as amended",14,4,0,2,20
818075,560392,2016-08-19,Assembly,"SB 879 Beall  Third Reading Urgency  Amend By CHIU  Set #1",50,20,0,10,80
818077,519351,2016-03-14,Senate,"Senate 3rd Reading SCR98 Beall",38,0,2,0,40
818077,530513,2016-04-11,Assembly,"From committee:  Be adopted.  To third reading",9,0,0,2,11
818077,559265,2016-08-11,Senate,"Special Consent SCR98 Beall Concurrence",37,0,2,0,39
818079,529007,2016-04-06,Assembly,"Do pass and be re-referred to the Committee on Appropriations",17,0,0,4,21
818079,536630,2016-04-20,Assembly,"Do pass, to Consent Calendar",16,0,0,4,20
818079,539643,2016-04-28,Assembly,"AB 1670 DODD  Consent Calendar Second Day  Regular Session",76,0,0,4,80
818079,559855,2016-08-15,Senate,"Assembly 3rd Reading AB1670 Dodd By McGuire",38,0,1,0,39
818079,560522,2016-08-22,Assembly,"AB 1670 DODD  Concurrence in Senate Amendments",78,0,0,2,80
818081,519956,2016-03-15,Assembly,"Do pass and be re-referred to the Committee on Veterans Affairs to 	Consent Calendar",7,0,0,0,7
818081,532429,2016-04-12,Assembly,"Do pass and be re-referred to the Committee on Appropriations",9,0,0,0,9
818081,549094,2016-05-27,Assembly,"Do pass as amended",20,0,0,0,20
818081,550899,2016-06-02,Assembly,"AB 1672 MATHIS  Assembly Third Reading",77,0,0,3,80
818081,554622,2016-06-21,Senate,"Do pass, but re-refer to the Committee on Veterans Affairs 	Recommend Consent",7,0,0,0,7
818081,555938,2016-06-28,Senate,"Do pass, but re-refer to the Committee on Appropriations",5,0,0,0,5
818081,558809,2016-08-01,Senate,"Placed on Appropriations Suspense file",7,0,0,0,7
818084,531920,2016-04-12,Senate,"Do pass, but re-refer to the Committee on Appropriations",5,1,1,0,7
818084,544592,2016-04-25,Senate,"Placed on Appropriations Suspense file",7,0,0,0,7
818084,549217,2016-05-27,Senate,"Do pass as amended",5,2,0,0,7
818084,551174,2016-06-02,Senate,"Senate 3rd Reading SB882 Hertzberg",23,14,3,0,40
818084,556083,2016-06-28,Assembly,"Do pass",5,2,0,0,7
818084,559136,2016-08-04,Assembly,"SB 882 Hertzberg  Senate Third Reading  By JONES-SAWYER",45,29,0,6,80
818085,529339,2016-04-06,Assembly,"Do pass and be re-referred to the Committee on Local Government",5,2,0,0,7
818085,532339,2016-04-13,Assembly,"Do pass and be re-referred to the Committee on Appropriations",6,3,0,0,9
818085,536161,2016-04-20,Assembly,"Do pass",11,5,0,4,20
818085,543184,2016-05-05,Assembly,"AB 1669 HERNANDEZ  Assembly Third Reading",52,26,0,2,80
818085,555123,2016-06-22,Senate,"Do pass, but re-refer to the Committee on Appropriations",4,1,0,0,5
818085,558754,2016-08-01,Senate,"Placed on Appropriations Suspense file",7,0,0,0,7
818085,559776,2016-08-11,Senate,"Do pass",5,2,0,0,7
818085,559970,2016-08-16,Senate,"Assembly 3rd Reading AB1669 Roger Hern",22,13,4,0,39
818085,560816,2016-08-23,Assembly,"AB 1669 HERNANDEZ  Concurrence in Senate Amendments",50,28,0,2,80
818088,528013,2016-04-05,Senate,"Do pass, but re-refer to the Committee on Appropriations",7,0,0,0,7
818088,534592,2016-04-18,Senate,"Placed on Appropriations Suspense file",7,0,0,0,7
818088,549324,2016-05-27,Senate,"Do pass",7,0,0,0,7
818088,550073,2016-05-31,Senate,"Senate 3rd Reading SB883 Roth",39,0,1,0,40
818088,552769,2016-06-14,Assembly,"Do pass and be re-referred to the Committee on Appropriations",7,0,0,0,7
818088,556354,2016-06-29,Assembly,"Do pass, to Consent Calendar",18,0,0,2,20
818088,560559,2016-08-22,Assembly,"SB 883 Roth  Senate Third Reading  By ATKINS",79,0,0,1,80
818090,519983,2016-03-15,Assembly,"Do pass and be re-referred to the Committee on Business and 	Professions",18,0,0,1,19
818090,525773,2016-03-29,Assembly,"Do pass and be re-referred to the Committee on Appropriations",14,0,0,2,16
818090,549084,2016-05-27,Assembly,"Do pass",20,0,0,0,20
818090,549967,2016-05-31,Assembly,"AB 1668 CALDERON  Assembly Third Reading",77,2,0,1,80
818090,555271,2016-06-22,Senate,"Do pass, but re-refer to the Committee on Business, Professions and 	Economic Development",9,0,0,0,9
818090,555515,2016-06-27,Senate,"Do pass, but re-refer to the Committee on Appropriations",9,0,0,0,9
818090,558810,2016-08-01,Senate,"Placed on Appropriations Suspense file",7,0,0,0,7
818090,559586,2016-08-11,Senate,"Do pass as amended",7,0,0,0,7
818090,560222,2016-08-18,Senate,"Assembly 3rd Reading AB1668 Calderon By Stone",38,0,1,0,39
818090,560711,2016-08-23,Assembly,"AB 1668 CALDERON  Concurrence in Senate Amendments",77,2,0,1,80
818092,487003,2016-01-25,Assembly,"From committee:  Be adopted.  To third reading",11,0,0,0,11
818092,518444,2016-03-10,Senate,"Assembly 3rd Reading ACR119 Chiu By Pan",39,0,1,0,40
818094,528082,2016-04-05,Senate,"Be adopted",5,2,0,0,7
818094,529594,2016-04-07,Senate,"Senate 3rd Reading SJR20 Hall",23,12,5,0,40
818094,554704,2016-06-21,Assembly,"From committee:  Be adopted.  To third reading",5,2,0,0,7
818094,556792,2016-06-30,Assembly,"SJR 20 Hall  Senate Third Reading  By LOW",49,19,0,12,80
818096,533441,2016-04-13,Senate,"Do pass, but re-refer to the Committee on Appropriations",7,2,0,0,9
818096,549334,2016-05-27,Senate,"Do pass",5,2,0,0,7
818096,550458,2016-06-01,Senate,"Senate 3rd Reading SB877 Pan Reconsider",39,0,1,0,40
818096,550459,2016-06-01,Senate,"Senate 3rd Reading SB877 Pan",28,6,6,0,40
818096,550460,2016-06-01,Senate,"Senate 3rd Reading SB877 Pan",28,10,2,0,40
818096,556400,2016-06-28,Assembly,"Do pass and be re-referred to the Committee on Appropriations",16,0,0,2,18
818096,559239,2016-08-11,Assembly,"Do pass",15,4,0,1,20
818096,560730,2016-08-23,Assembly,"SB 877 Pan  Senate Third Reading  By BROWN",63,15,0,2,80
818096,561196,2016-08-25,Senate,"Unfinished Business SB877 Pan Concurrence",29,10,0,0,39
818099,532319,2016-04-13,Senate,"Do pass, but re-refer to the Committee on Appropriations",4,1,0,0,5
818099,544371,2016-04-25,Senate,"Placed on Appropriations Suspense file",7,0,0,0,7
818101,535267,2016-04-19,Assembly,"Do pass as amended and be re-referred to the Committee on 	Appropriations",5,2,0,0,7
818101,548278,2016-05-25,Assembly,"Do pass",14,6,0,0,20
818101,550129,2016-05-31,Assembly,"AB 1671 GOMEZ  Assembly Third Reading",52,26,0,2,80
818101,556621,2016-06-28,Senate,"Do pass as amended, and re-refer to the Committee on Appropriations",5,2,0,0,7
818101,559588,2016-08-11,Senate,"Do pass as amended",5,2,0,0,7
818101,561709,2016-08-31,Senate,"Assembly 3rd Reading ( Supplemental File 2)AB 1671 Go mez By",26,13,0,0,39
818101,561710,2016-08-31,Assembly,"AB 1671 GOMEZ  Concurrence in Senate Amendments",52,26,0,2,80
819413,528008,2016-04-05,Assembly,"From committee:  Be adopted.  To third reading",9,0,0,2,11
819413,553147,2016-06-14,Senate,"Be adopted",7,0,0,0,7
819413,558635,2016-08-01,Senate,"Assembly 3rd Reading ACR120 Mark Stone By Beall",39,0,0,0,39
819414,515919,2016-03-08,Assembly,"Do pass and be re-referred to the Committee on Appropriations",9,0,0,1,10
819414,532181,2016-04-06,Assembly,"Do pass, to Consent Calendar",18,0,0,2,20
819414,533112,2016-04-14,Assembly,"AB 1678 SANTIAGO  Consent Calendar Second Day  Regular Session",76,0,0,4,80
819414,544326,2016-05-10,Senate,"Do pass, but re-refer to the Committee on Appropriations Recommend 	Consent",7,0,0,0,7
819414,554421,2016-06-20,Senate,"Placed on Appropriations Suspense file",7,0,0,0,7
819414,559540,2016-08-11,Senate,"Do pass as amended",7,0,0,0,7
819414,560171,2016-08-18,Senate,"Assembly 3rd Reading AB1678 Santiago By Hancock",38,0,1,0,39
819414,560694,2016-08-23,Assembly,"AB 1678 SANTIAGO  Concurrence in Senate Amendments",80,0,0,0,80
819418,534332,2016-04-18,Assembly,"Do pass as amended and be re-referred to the Committee on 	Appropriations",10,4,0,2,16
819418,549440,2016-05-27,Assembly,"Do pass as amended",14,6,0,0,20
819418,550915,2016-06-02,Assembly,"AB 1677 TING  Assembly Third Reading",52,26,0,2,80
819418,559863,2016-08-15,Senate,"Assembly 3rd Reading AB1677 Ting By Hill",26,12,1,0,39
819421,526517,2016-03-29,Assembly,"Amend, and do pass as amended and be re-referred to the Committee 	on Appropriations with the recommendation:  To Consent Calendar",6,0,0,1,7
819421,536840,2016-04-20,Assembly,"Do pass, to Consent Calendar",16,0,0,4,20
819421,539725,2016-04-28,Assembly,"AB 1679 WEBER  Consent Calendar Second Day  Regular Session",76,0,0,4,80
819421,552144,2016-06-08,Senate,"Do pass, but re-refer to the Committee on Appropriations Recommend 	Consent",9,0,0,0,9
819421,555714,2016-06-27,Senate,"Placed on Appropriations Suspense file",6,0,1,0,7
819422,542399,2016-05-03,Senate,"Do pass as amended",6,0,1,0,7
819422,550470,2016-06-01,Senate,"Senate 3rd Reading SB885 Wolk",26,4,10,0,40
819425,520141,2016-03-15,Assembly,"Do pass as amended and be re-referred to the Committee on 	Appropriations",7,0,0,0,7
819425,532387,2016-04-13,Assembly,"Do pass, to Consent Calendar",20,0,0,0,20
819425,544009,2016-05-09,Assembly,"AB 1680 RODRIGUEZ  Assembly Third Reading",78,0,0,2,80
819425,554900,2016-06-21,Senate,"Do pass, but re-refer to the Committee on Appropriations",7,0,0,0,7
819425,560027,2016-08-16,Senate,"Assembly 3rd Reading AB1680 Rodriguez By Anderson",38,0,1,0,39
819429,528020,2016-04-05,Assembly,"Do pass and be re-referred to the Committee on Judiciary to Consent 	Calendar",7,0,0,0,7
819429,545124,2016-05-11,Assembly,"Do pass as amended, to Consent Calendar",20,0,0,0,20
819429,547087,2016-05-19,Assembly,"AB 1675 STONE  Consent Calendar Second Day  Regular Session",76,0,0,4,80
819429,554846,2016-06-21,Senate,"Do pass, but re-refer to the Committee on Appropriations",5,2,0,0,7
819429,558848,2016-08-01,Senate,"Placed on Appropriations Suspense file",7,0,0,0,7
819433,537081,2016-04-20,Assembly,"Do pass and be re-referred to the Committee on Appropriations",4,2,0,1,7
819433,548989,2016-05-27,Assembly,"Do pass as amended",13,6,0,1,20
819433,550924,2016-06-02,Assembly,"AB 1676 CAMPOS  Assembly Third Reading",47,29,0,4,80
819433,554996,2016-06-22,Senate,"Do pass, but re-refer to the Committee on Judiciary",5,0,0,0,5
819433,556269,2016-06-28,Senate,"Do pass, but re-refer to the Committee on Appropriations",7,0,0,0,7
819433,560718,2016-08-23,Senate,"Assembly 3rd Reading AB1676 Campos By Jackson",38,0,1,0,39
819433,561387,2016-08-29,Assembly,"AB 1676 CAMPOS  Concurrence in Senate Amendments",71,4,0,5,80
819438,519749,2016-03-15,Assembly,"Do pass as amended and be re-referred to the Committee on 	Appropriations",5,2,0,0,7
819438,549018,2016-05-27,Assembly,"Do pass as amended",14,6,0,0,20
819438,550393,2016-06-01,Assembly,"AB 1673 GIPSON  Assembly Third Reading",44,33,0,3,80
819438,552704,2016-06-14,Senate,"Do pass, but re-refer to the Committee on Appropriations",5,2,0,0,7
819438,554412,2016-06-20,Senate,"Placed on Appropriations Suspense file",2,5,0,0,7
819438,554413,2016-06-20,Senate,"Do pass",5,2,0,0,7
819438,556831,2016-06-30,Senate,"Assembly 3rd Reading AB1673 Gipson By Hall",23,14,3,0,40
819438,556832,2016-06-30,Assembly,"AB 1673 GIPSON  Concurrence in Senate Amendments",46,33,0,1,80
819442,528657,2016-04-06,Senate,"Do pass as amended, and re-refer to the Committee on Appropriations",9,0,0,0,9
819442,548968,2016-05-27,Senate,"Do pass as amended",7,0,0,0,7
819442,550869,2016-06-02,Senate,"Special Consent # SB884 Beall",39,0,1,0,40
819442,555247,2016-06-22,Assembly,"Do pass as amended and be re-referred to the Committee on 	Appropriations",7,0,0,0,7
819442,559017,2016-08-03,Assembly,"Do pass, to Consent Calendar",20,0,0,0,20
819442,560120,2016-08-18,Assembly,"SB 884 Beall  Senate Third Reading  By MAIENSCHEIN",77,0,0,3,80
819442,561193,2016-08-25,Senate,"Special Consent SB884 Beall",39,0,0,0,39
819444,510542,2016-03-01,Assembly,"Do pass and be re-referred to the Committee on Appropriations",5,2,0,0,7
819444,549079,2016-05-27,Assembly,"Do pass as amended",14,6,0,0,20
819444,550405,2016-06-01,Assembly,"AB 1674 SANTIAGO  Assembly Third Reading",44,33,0,3,80
819444,552639,2016-06-14,Senate,"Do pass, but re-refer to the Committee on Appropriations",5,2,0,0,7
819444,554427,2016-06-20,Senate,"Placed on Appropriations Suspense file",2,5,0,0,7
819444,554428,2016-06-20,Senate,"Do pass",5,2,0,0,7
819444,556752,2016-06-30,Senate,"Assembly 3rd Reading AB1674 Santiago By Pan",22,14,4,0,40
819444,556753,2016-06-30,Assembly,"AB 1674 SANTIAGO  Concurrence in Senate Amendments",44,34,0,2,80
821214,488940,2016-01-28,Assembly,"From committee:  Be adopted.  To third reading",10,0,0,1,11
821214,513159,2016-03-03,Senate,"Assembly 3rd Reading ACR122 Burke By Hancock",39,0,1,0,40
821219,529012,2016-04-06,Senate,"Do pass as amended, but re-refer to the Committee on Appropriations 	Recommend Consent",9,0,0,0,9
821230,519207,2016-03-14,Assembly,"Be adopted and re-referred to the Committee on Appropriations with 	recommendation:  To Consent Calendar",16,0,0,0,16
821230,532898,2016-04-06,Assembly,"Be adopted, to Consent Calendar",18,0,0,2,20
821230,533402,2016-04-14,Assembly,"ACR 121 GOMEZ  Assembly Third Reading",74,0,0,6,80
821230,561799,2016-08-31,Senate,"Assembly 3rd Reading ACR121 Gomez By Hernandez",39,0,0,0,39
821230,561800,2016-08-31,Assembly,"ACR 121 GOMEZ  Concurrence in Senate Amendments",76,0,0,4,80
821236,516108,2016-03-08,Senate,"Do pass, but re-refer to the Committee on Energy, Utilities and 	Communications",9,0,4,0,13
821236,535363,2016-04-19,Senate,"Do pass as amended, and re-refer to the Committee on Appropriations",9,2,0,0,11
821236,545927,2016-05-16,Senate,"Placed on Appropriations Suspense file",7,0,0,0,7
821236,549316,2016-05-27,Senate,"Do pass as amended",5,2,0,0,7
821236,551044,2016-06-02,Senate,"Senate 3rd Reading SB888 Allen",28,10,2,0,40
821236,555133,2016-06-22,Assembly,"Do pass and be re-referred to the Committee on Natural Resources",16,2,0,3,21
821236,559236,2016-08-11,Assembly,"Do pass",14,2,0,4,20
821236,559961,2016-06-27,Assembly,"Do pass as amended and be re-referred to the Committee on 	Appropriations",8,0,0,1,9
821236,560408,2016-08-19,Assembly,"SB 888 Allen  Senate Third Reading  Amend By WILK  Set #1",53,19,0,8,80
821236,561004,2016-08-24,Assembly,"SB 888 Allen  Senate Third Reading  By WILK",59,21,0,0,80
821236,561343,2016-08-26,Senate,"Unfinished Business SB888 Allen Concurrence",28,11,0,0,39
821241,531829,2016-04-12,Assembly,"Do pass and be re-referred to the Committee on Privacy and Consumer 	Protection",6,1,0,0,7
821241,541530,2016-05-03,Assembly,"Do pass as amended",11,0,0,0,11
821241,545366,2016-05-12,Assembly,"AB 1687 CALDERON  Assembly Third Reading",71,4,0,5,80
821241,556616,2016-06-28,Senate,"Do pass as amended",5,1,1,0,7
821241,559917,2016-08-15,Senate,"Assembly 3rd Reading AB1687 Calderon By Hertzberg",25,12,2,0,39
821241,560539,2016-08-22,Assembly,"AB 1687 CALDERON  Concurrence in Senate Amendments",61,15,0,4,80
821247,516020,2016-03-08,Assembly,"Do pass and be re-referred to the Committee on Appropriations",9,0,0,1,10
821247,532377,2016-04-06,Assembly,"Do pass, to Consent Calendar",18,0,0,2,20
821247,533107,2016-04-14,Assembly,"AB 1682 STONE  Consent Calendar Second Day  Regular Session",76,0,0,4,80
821247,556439,2016-06-28,Senate,"Do pass as amended, but re-refer to the Committee on Appropriations 	Recommend Consent",7,0,0,0,7
821247,559938,2016-08-16,Senate,"Assembly 3rd Reading AB1682 Mark Stone By Jackson",38,0,1,0,39
821247,560810,2016-08-23,Assembly,"AB 1682 STONE  Concurrence in Senate Amendments",80,0,0,0,80
821252,535247,2016-04-19,Senate,"Do pass as amended, and re-refer to the Committee on Appropriations",8,3,0,0,11
821252,547618,2016-05-23,Senate,"Placed on Appropriations Suspense file",7,0,0,0,7
821252,549411,2016-05-27,Senate,"Do pass as amended",5,2,0,0,7
821252,550394,2016-06-01,Senate,"Senate 3rd Reading SB886 Pavley",25,14,1,0,40
821252,557120,2016-06-29,Assembly,"Do pass as amended and be re-referred to the Committee on 	Appropriations",10,4,0,1,15
821258,525756,2016-03-29,Senate,"Do pass, but re-refer to the Committee on Environmental Quality",7,2,0,0,9
821258,536686,2016-04-20,Senate,"Do pass as amended, and re-refer to the Committee on Appropriations",6,1,0,0,7
821258,545964,2016-05-16,Senate,"Placed on Appropriations Suspense file",7,0,0,0,7
821258,549388,2016-05-27,Senate,"Do pass as amended",5,2,0,0,7
821258,550502,2016-06-01,Senate,"Senate 3rd Reading SB887 Pavley",30,9,1,0,40
821258,559366,2016-08-11,Assembly,"Do pass as amended",11,2,0,7,20
821258,559985,2016-06-27,Assembly,"Do pass as amended and be re-referred to the Committee on 	Appropriations",7,2,0,0,9
821258,560412,2016-08-19,Assembly,"SB 887 Pavley  Senate Third Reading  By V. A.  Amendment  Set #1",73,0,0,7,80
821258,561017,2016-08-24,Assembly,"SB 887 Pavley  Senate Third Reading  By WILK",75,1,0,4,80
821258,561339,2016-08-26,Senate,"Unfinished Business SB887 Pavley Concurrence",36,2,1,0,39
821274,545016,2016-05-11,Senate,"Do pass, but re-refer to the Committee on Appropriations",2,5,0,0,7
821274,545017,2016-05-11,Senate,"Set, first hearing.  Failed passage in Committee.  Reconsideration 	granted",7,0,0,0,7
821280,544288,2016-05-09,Assembly,"Do pass as amended and be re-referred to the Committee on 	Appropriations",9,0,0,0,9
821286,534329,2016-04-18,Assembly,"Do pass and be re-referred to the Committee on Appropriations",10,5,0,1,16
821286,542749,2016-05-04,Assembly,"Do pass",14,6,0,0,20
821286,545278,2016-05-12,Assembly,"AB 1685 GOMEZ  Assembly Third Reading",48,29,0,3,80
821286,552184,2016-06-08,Senate,"Do pass, but re-refer to the Committee on Transportation and 	Housing",4,2,1,0,7
821286,554756,2016-06-21,Senate,"Do pass, but re-refer to the Committee on Judiciary",7,4,0,0,11
821286,556432,2016-06-28,Senate,"Do pass as amended, and re-refer to the Committee on Appropriations",5,2,0,0,7
821286,561008,2016-08-24,Senate,"Assembly 3rd Reading AB1685 Gomez By Leno",26,13,0,0,39
821286,561628,2016-08-30,Assembly,"AB 1685 GOMEZ  Concurrence in Senate Amendments",51,28,0,1,80
821291,539328,2016-04-27,Senate,"Do pass, but re-refer to the Committee on Appropriations",2,2,3,0,7
821291,539329,2016-04-27,Senate,"Set, first hearing.  Failed passage in Committee.  Reconsideration 	granted",7,0,0,0,7
821296,520284,2016-03-15,Assembly,"Do pass as amended and be re-referred to the Committee on 	Appropriations",8,0,0,2,10
821296,532199,2016-04-06,Assembly,"Do pass, to Consent Calendar",18,0,0,2,20
821296,533429,2016-04-14,Assembly,"AB 1684 STONE  Consent Calendar Second Day  Regular Session",76,0,0,4,80
821296,553586,2016-06-14,Senate,"Do pass, but re-refer to the Committee on Appropriations Recommend 	Consent",7,0,0,0,7
821296,556800,2016-06-30,Senate,"Consent Calendar 2nd AB1684 Mark Stone",37,0,3,0,40
824805,529547,2016-04-06,Assembly,"Do pass and be re-referred to the Committee on Appropriations",5,0,0,2,7
824808,525583,2016-03-29,Senate,"Do pass, but re-refer to the Committee on Appropriations",4,0,1,0,5
824808,530468,2016-04-11,Senate,"Placed on Appropriations Suspense file",7,0,0,0,7
824809,489026,2016-01-28,Senate,"Senate 3rd Reading SR56 Bates",40,0,0,0,40
824811,534139,2016-04-18,Assembly,"Do pass as amended and be re-referred to the Committee on 	Appropriations",13,1,0,2,16
824811,544857,2016-05-11,Assembly,"Do pass as amended",15,5,0,0,20
824811,547557,2016-05-23,Assembly,"AB 1691 GIPSON  Assembly Third Reading",59,18,0,3,80
824811,554645,2016-06-21,Senate,"Do pass, but re-refer to the Committee on Environmental Quality",7,0,4,0,11
824811,556246,2016-06-29,Senate,"Do pass as amended, and re-refer to the Committee on Appropriations",5,0,2,0,7
824814,542807,2016-05-04,Assembly,"Do pass, to Consent Calendar",7,0,0,0,7
824814,545240,2016-05-12,Assembly,"AB 1692 BONILLA  Consent Calendar Second Day  Regular Session",78,0,0,2,80
824814,552525,2016-06-13,Senate,"Do pass",5,0,0,0,5
824814,558695,2016-08-01,Senate,"Assembly 3rd Reading AB1692 Bonilla By Wolk",38,0,1,0,39
824816,519944,2016-03-15,Assembly,"Do pass as amended and be re-referred to the Committee on 	Appropriations",17,1,0,1,19
824816,548951,2016-05-27,Assembly,"Do pass as amended",14,6,0,0,20
824816,550928,2016-06-02,Assembly,"AB 1696 HOLDEN  Assembly Third Reading",63,14,0,3,80
824816,555270,2016-06-22,Senate,"Do pass as amended, and re-refer to the Committee on Appropriations",8,1,0,0,9
824816,558744,2016-08-01,Senate,"Placed on Appropriations Suspense file",7,0,0,0,7
824816,559623,2016-08-11,Senate,"Do pass as amended",5,2,0,0,7
824816,559934,2016-08-16,Senate,"Assembly 3rd Reading AB1696 Holden By Pan",29,8,2,0,39
824816,560751,2016-08-23,Assembly,"AB 1696 HOLDEN  Concurrence in Senate Amendments",62,17,0,1,80
824817,541405,2016-05-03,Assembly,"Be adopted, to Consent Calendar",7,0,0,0,7
824817,542974,2016-05-05,Assembly,"ACR 124 CALDERON  Consent Calendar Second Day  Regular Session",79,0,0,1,80
824817,548653,2016-05-26,Senate,"Assembly 3rd Reading ACR124 Calderon By Allen",36,0,4,0,40
824819,535645,2016-04-18,Senate,"Do pass, but re-refer to the Committee on Appropriations",5,2,2,0,9
824819,548730,2016-05-26,Senate,"Senate 3rd Reading SB896 Nguyen",27,4,9,0,40
824819,554709,2016-06-21,Assembly,"Do pass and be re-referred to the Committee on Appropriations",13,1,0,2,16
824819,556500,2016-06-29,Assembly,"Do pass as amended",14,0,0,6,20
824819,559133,2016-08-04,Assembly,"SB 896 Nguyen  Senate Third Reading  By GONZALEZ",61,2,0,17,80
824819,559463,2016-08-11,Senate,"Unfinished Business SB896 Nguyen Concurrence",29,5,5,0,39
824820,536171,2016-04-20,Senate,"Do pass, but re-refer to the Committee on Appropriations",7,0,0,0,7
824820,549044,2016-05-27,Senate,"Do pass as amended",7,0,0,0,7
824820,550880,2016-06-02,Senate,"Special Consent #10 SB898 Nguyen",39,0,1,0,40
824820,554668,2016-06-20,Assembly,"Do pass as amended and be re-referred to the Committee on 	Appropriations",9,0,0,0,9
824820,559026,2016-08-03,Assembly,"Do pass",17,3,0,0,20
824820,560162,2016-08-18,Assembly,"SB 898 Nguyen  Senate Third Reading  By ALLEN",70,5,0,5,80
824820,561225,2016-08-25,Senate,"Special Consent SB898 Nguyen",39,0,0,0,39
824823,531263,2016-04-12,Senate,"Do pass as amended",5,1,1,0,7
824823,548637,2016-05-26,Senate,"Senate 3rd Reading SB899 Hueso",22,12,6,0,40
824824,519731,2016-03-15,Assembly,"Do pass and be re-referred to the Committee on Appropriations",5,2,0,0,7
824824,548960,2016-05-27,Assembly,"Do pass as amended",14,5,0,1,20
824824,550372,2016-06-01,Assembly,"AB 1695 BONTA  Assembly Third Reading",51,28,0,1,80
824824,552638,2016-06-14,Senate,"Do pass, but re-refer to the Committee on Appropriations",5,2,0,0,7
824824,554424,2016-06-20,Senate,"Placed on Appropriations Suspense file",2,5,0,0,7
824824,554425,2016-06-20,Senate,"Do pass",5,2,0,0,7
824824,556808,2016-06-30,Senate,"Assembly 3rd Reading AB1695 Bonta By Jackson",23,14,3,0,40
824824,556809,2016-06-30,Assembly,"AB 1695 BONTA  Concurrence in Senate Amendments",52,25,0,3,80
824827,546892,2016-05-18,Assembly,"Do pass",15,0,0,5,20
824827,547580,2016-05-23,Assembly,"AB 1693 GONZALEZ  Third Reading Urgency",69,3,0,8,80
824827,554523,2016-06-20,Senate,"Do pass",5,0,2,0,7
824827,555556,2016-06-27,Senate,"Assembly 3rd Reading AB1693 Gonzalez By Lara Urgency Clause",30,5,5,0,40
824828,526751,2016-03-31,Assembly,"Be referred to Committee on Jobs, Economic Development and The 	Economy",8,0,0,3,11
824828,535252,2016-04-19,Assembly,"Do pass as amended and be re-referred to the Committee on 	Appropriations",9,0,0,0,9
824828,549179,2016-05-27,Assembly,"Do pass",20,0,0,0,20
824828,550174,2016-05-31,Assembly,"AB 1697 BONILLA  Assembly Third Reading",80,0,0,0,80
824828,558901,2016-08-01,Senate,"Placed on Appropriations Suspense file",7,0,0,0,7
824828,559789,2016-08-11,Senate,"Do pass as amended",5,2,0,0,7
824828,560151,2016-08-18,Senate,"Assembly 3rd Reading AB1697 Bonilla By Roth",27,11,1,0,39
824828,560878,2016-08-23,Assembly,"AB 1697 BONILLA  Concurrence in Senate Amendments",80,0,0,0,80
824829,526782,2016-03-31,Assembly,"Be referred to Committee on Environmental Safety and Toxic 	Materials",8,0,0,3,11
824832,528888,2016-04-06,Senate,"Do pass",4,0,1,0,5
824832,547628,2016-05-23,Senate,"Senate 3rd Reading SB897 Roth",35,0,5,0,40
824832,555044,2016-06-22,Assembly,"Do pass",12,1,0,0,13
824832,560407,2016-08-19,Assembly,"SB 897 Roth  Senate Third Reading  By HIGHER ED.  Amendment  Set #1",73,0,0,7,80
824832,560601,2016-08-22,Assembly,"SB 897 Roth  Senate Third Reading  By COOPER",71,2,0,7,80
824832,561293,2016-08-25,Senate,"Unfinished Business SB897 Roth Concurrence",36,1,2,0,39
824834,519487,2016-03-14,Assembly,"Be adopted and re-referred to the Committee on Appropriations with 	recommendation:  To Consent Calendar",16,0,0,0,16
824834,530433,2016-04-11,Assembly,"ACR 123 STEINORTH  Consent Calendar Second Day  Regular Session",77,0,0,2,79
824834,532542,2016-04-06,Assembly,"Be adopted, to Consent Calendar",18,0,0,2,20
824834,559333,2016-08-11,Senate,"Consent Calendar 2nd ACR123 Steinorth",37,0,2,0,39
824835,526202,2016-03-29,Assembly,"Do pass and be re-referred to the Committee on Appropriations to 	Consent Calendar",6,0,0,1,7
824835,536334,2016-04-20,Assembly,"Do pass, to Consent Calendar",16,0,0,4,20
824835,539573,2016-04-28,Assembly,"AB 1688 RODRIGUEZ  Consent Calendar Second Day  Regular Session",76,0,0,4,80
824835,552666,2016-06-14,Senate,"Do pass, but re-refer to the Committee on Appropriations",4,0,1,0,5
824835,559937,2016-08-16,Senate,"Assembly 3rd Reading AB1688 Rodriguez By Jackson",39,0,0,0,39
824837,525572,2016-03-29,Senate,"Do pass, but re-refer to the Committee on Appropriations",8,1,0,0,9
824837,544376,2016-04-25,Senate,"Placed on Appropriations Suspense file",7,0,0,0,7
824837,549025,2016-05-27,Senate,"Do pass as amended",7,0,0,0,7
824837,550357,2016-06-01,Senate,"Senate 3rd Reading SB900 Jackson",32,5,3,0,40
824837,559340,2016-08-11,Assembly,"Do pass as amended",15,0,0,5,20
824837,559909,2016-06-27,Assembly,"Do pass and be re-referred to the Committee on Appropriations",9,0,0,0,9
824837,560386,2016-08-19,Assembly,"SB 900 Jackson  Senate Third Reading  By A.,E.,S.,T.,& I.M. 	Amendment  Set #1",73,0,0,7,80
824837,560989,2016-08-24,Assembly,"SB 900 Jackson  Senate Third Reading  By WILLIAMS",76,2,0,2,80
824837,561330,2016-08-26,Senate,"Unfinished Business SB900 Jackson Concurrence",31,5,3,0,39
824839,534781,2016-04-19,Senate,"Do pass, but re-refer to the Committee on Appropriations",5,2,0,0,7
824839,545780,2016-05-16,Senate,"Placed on Appropriations Suspense file",2,4,1,0,7
824839,545781,2016-05-16,Senate,"Do pass",5,2,0,0,7
824839,547037,2016-05-19,Senate,"Senate 3rd Reading SB894 Jackson",24,15,1,0,40
824839,552723,2016-06-14,Assembly,"Do pass and be re-referred to the Committee on Appropriations",5,2,0,0,7
824839,556761,2016-06-30,Assembly,"SB 894 Jackson  Senate Third Reading  By BONTA",48,27,0,5,80
824839,556762,2016-06-30,Senate,"Unfinished Business (S upplemental File 1)SB8 94 Jac kson Con",22,14,4,0,40
824840,528130,2016-04-05,Assembly,"Do pass and be re-referred to the Committee on Appropriations",10,2,0,1,13
824840,549299,2016-05-27,Assembly,"Do pass",14,6,0,0,20
824840,550420,2016-06-01,Assembly,"AB 1690 MEDINA  Assembly Third Reading",52,26,0,2,80
824840,555015,2016-06-22,Senate,"Do pass, but re-refer to the Committee on Appropriations",5,2,2,0,9
824840,558940,2016-08-01,Senate,"Placed on Appropriations Suspense file",7,0,0,0,7
824840,559709,2016-08-11,Senate,"Do pass",5,2,0,0,7
824840,560563,2016-08-22,Senate,"Assembly 3rd Reading AB1690 Medina By Leyva",23,14,2,0,39
827219,519738,2016-03-15,Assembly,"Amend, and do pass as amended and be re-referred to the Committee 	on Human Services with the recommendation:  To Consent Calendar",8,0,0,2,10
827219,538446,2016-04-26,Assembly,"Do pass",6,0,0,1,7
827219,540778,2016-05-02,Assembly,"AB 1702 STONE  Assembly Third Reading",76,0,0,4,80
827219,553130,2016-06-14,Senate,"Do pass as amended. To Consent Calendar",7,0,0,0,7
827219,556770,2016-06-30,Senate,"Consent Calendar 2nd AB1702 Mark Stone",37,0,3,0,40
827219,558633,2016-08-01,Assembly,"AB 1702 STONE  Concurrence in Senate Amendments",76,0,0,4,80
827242,535284,2016-04-19,Assembly,"Do pass and be re-referred to the Committee on Appropriations",6,0,0,1,7
827242,545035,2016-05-11,Assembly,"Do pass, to Consent Calendar",20,0,0,0,20
827242,547231,2016-05-19,Assembly,"AB 1708 GONZALEZ  Assembly Third Reading",75,1,0,4,80
827242,554699,2016-06-21,Senate,"Do pass as amended, and re-refer to the Committee on Appropriations",7,0,0,0,7
827242,558798,2016-08-01,Senate,"Placed on Appropriations Suspense file",7,0,0,0,7
827242,559620,2016-08-11,Senate,"Do pass as amended",7,0,0,0,7
827242,560646,2016-08-23,Senate,"Assembly 3rd Reading AB1708 Gonzalez By Glazer",39,0,0,0,39
827242,561523,2016-08-30,Assembly,"AB 1708 GONZALEZ  Concurrence in Senate Amendments",80,0,0,0,80
827264,559067,2016-08-03,Assembly,"Do pass",20,0,0,0,20
827264,559179,2016-08-08,Assembly,"AB 1701 GONZALEZ  Third Reading Urgency",74,0,0,6,80
827264,559739,2016-08-11,Senate,"Do pass",7,0,0,0,7
827264,560330,2016-08-18,Senate,"Assembly 3rd Reading AB1701 Gonzalez By Lara Urgency Clause",36,0,3,0,39
827287,525752,2016-03-29,Assembly,"Do pass and be re-referred to the Committee on Local Government",10,0,0,0,10
827310,525923,2016-03-29,Assembly,"Do pass as amended and be re-referred to the Committee on 	Appropriations",11,1,0,3,15
827310,549189,2016-05-27,Assembly,"Do pass as amended",15,0,0,5,20
827310,550651,2016-06-01,Assembly,"AB 1704 DODD  Assembly Third Reading",70,2,0,8,80
827310,556066,2016-06-28,Senate,"Do pass, but re-refer to the Committee on Appropriations",8,0,1,0,9
827310,558914,2016-08-01,Senate,"Placed on Appropriations Suspense file",7,0,0,0,7
827332,526222,2016-03-29,Assembly,"Do pass as amended and be re-referred to the Committee on 	Appropriations",6,0,0,1,7
827355,539993,2016-04-28,Assembly,"From committee:  Be adopted.  To third reading",11,0,0,0,11
827355,550948,2016-06-02,Senate,"Special Consent # ACR125 Chau",39,0,1,0,40
827378,520054,2016-03-15,Assembly,"Do pass and be re-referred to the Committee on Veterans Affairs to 	Consent Calendar",7,0,0,0,7
827378,526213,2016-03-29,Assembly,"Do pass and be re-referred to the Committee on Appropriations",8,0,0,1,9
827378,532944,2016-04-06,Assembly,"Do pass, to Consent Calendar",18,0,0,2,20
827378,533412,2016-04-14,Assembly,"AB 1706 CHAVEZ  Consent Calendar Second Day  Regular Session",76,0,0,4,80
827378,544304,2016-05-10,Senate,"Do pass, but re-refer to the Committee on Veterans Affairs 	Recommend Consent",11,0,2,0,13
827378,552708,2016-06-14,Senate,"Do pass, but re-refer to the Committee on Appropriations",5,0,0,0,5
827378,559589,2016-08-11,Senate,"Placed on Appropriations Suspense file",7,0,0,0,7
827400,520175,2016-03-15,Assembly,"Do pass",5,1,0,1,7
827400,526986,2016-03-31,Assembly,"AB 1705 RODRIGUEZ  Assembly Third Reading",60,4,0,15,79
827400,556585,2016-06-28,Senate,"Do pass",7,0,0,0,7
827400,558689,2016-08-01,Senate,"Assembly 3rd Reading AB1705 Rodriguez By Glazer",38,0,1,0,39
827400,559112,2016-08-04,Assembly,"AB 1705 RODRIGUEZ  Concurrence in Senate Amendments",74,2,0,4,80
827423,516845,2016-03-09,Senate,"Do pass, but re-refer to the Committee on Appropriations",8,0,1,0,9
827423,533170,2016-04-14,Senate,"Senate 3rd Reading SB906 Beall",38,0,2,0,40
827423,552693,2016-06-14,Assembly,"Do pass and be re-referred to the Committee on Human Services",13,0,0,0,13
827423,555937,2016-06-28,Assembly,"Do pass and be re-referred to the Committee on Appropriations",7,0,0,0,7
827423,558987,2016-08-03,Assembly,"Do pass, to Consent Calendar",20,0,0,0,20
827423,559269,2016-08-11,Assembly,"SB 906 Beall  Consent Calendar Second Day  Regular Session",78,0,0,2,80
827423,560768,2016-08-23,Assembly,"SB 906 Beall  Senate Third Reading  By GORDON",77,1,0,2,80
827423,561211,2016-08-25,Senate,"Unfinished Business SB906 Beall Concurrence",39,0,0,0,39
827445,526204,2016-03-30,Senate,"Do pass, but re-refer to the Committee on Appropriations",7,0,0,0,7
827445,530437,2016-04-11,Senate,"Placed on Appropriations Suspense file",7,0,0,0,7
827445,549124,2016-05-27,Senate,"Do pass",7,0,0,0,7
827445,549962,2016-05-31,Senate,"Senate 3rd Reading SB907 Galgiani Urgency Clause",39,0,1,0,40
827445,554713,2016-06-20,Assembly,"Do pass as amended and be re-referred to the Committee on 	Appropriations",9,0,0,0,9
827445,561777,2016-08-31,Assembly,"SB 907 Galgiani  Third Reading Urgency  By GONZALEZ",79,0,0,1,80
827445,561778,2016-08-31,Senate,"W/O REF. TO FILE SB907 Galgiani Urgency Clause",39,0,0,0,39
827468,511136,2016-03-01,Assembly,"Do pass and be re-referred to the Committee on Health to Consent 	Calendar",7,0,0,0,7
827468,525959,2016-03-29,Assembly,"Do pass, to Consent Calendar",18,0,0,1,19
827468,529436,2016-04-07,Assembly,"AB 1703 SANTIAGO  Consent Calendar Second Day  Regular Session",77,0,0,2,79
827468,552932,2016-06-14,Senate,"Do pass and be placed on the Consent Calendar",7,0,0,0,7
827468,557125,2016-06-30,Senate,"Consent Calendar 2nd AB1703 Santiago",37,0,3,0,40
827491,516306,2016-03-08,Assembly,"Do pass as amended, to Consent Calendar",9,0,0,1,10
827491,521132,2016-03-17,Assembly,"AB 1700 MAIENSCHEIN  Consent Calendar Second Day",65,0,0,14,79
827491,555213,2016-06-21,Senate,"Do pass and be placed on the Consent Calendar",7,0,0,0,7
827491,557005,2016-06-30,Senate,"Consent Calendar 2nd AB1700 Maienschein",37,0,3,0,40
827537,531334,2016-04-12,Senate,"Do pass, but re-refer to the Committee on Appropriations Recommend 	Consent",12,0,1,0,13
827537,539745,2016-04-28,Senate,"Consent Calendar 2nd SB905 Bates",37,0,3,0,40
827537,552011,2016-06-08,Assembly,"Do pass and be re-referred to the Committee on Appropriations to 	Consent Calendar",17,0,0,4,21
827537,556376,2016-06-29,Assembly,"Do pass, to Consent Calendar",18,0,0,2,20
827537,560206,2016-08-18,Assembly,"SB 905 Bates  Senate Third Reading  By CHAVEZ",79,0,0,1,80
827537,561162,2016-08-25,Senate,"Special Consent SB905 Bates",39,0,0,0,39
827558,541385,2016-05-03,Assembly,"Do pass, to Consent Calendar",10,0,0,0,10
827558,543771,2016-05-09,Assembly,"AB 1709 GALLAGHER  Consent Calendar Second Day  Regular Session",78,0,0,2,80
827558,553137,2016-06-14,Senate,"Do pass and be placed on the Consent Calendar",7,0,0,0,7
827558,556779,2016-06-30,Senate,"Consent Calendar 2nd AB1709 Gallagher",37,0,3,0,40
828433,492856,2016-02-08,Senate,"Senate 3rd Reading SCR99 McGuire",38,0,2,0,40
828433,507539,2016-02-25,Assembly,"From committee:  Be adopted.  To third reading",9,0,0,2,11
828433,518160,2016-03-10,Senate,"Unfinished Business SCR99 McGuire Concurrence",39,0,1,0,40
828437,528679,2016-04-06,Assembly,"Be adopted and be re-referred to the Committee on Utilities and 	Commerce",17,0,0,4,21
828437,538922,2016-04-27,Assembly,"Be adopted as amended",15,0,0,0,15
828437,542989,2016-05-05,Assembly,"AJR 28 OBERNOLTE  Assembly Third Reading",69,2,0,9,80
828437,552437,2016-06-13,Senate,"Be adopted",9,0,2,0,11
828437,560050,2016-08-17,Senate,"Assembly 3rd Reading AJR28 Obernolte By Leyva",33,1,5,0,39
828437,560662,2016-08-23,Assembly,"AJR 28 OBERNOLTE  Concurrence in Senate Amendments",74,0,0,6,80
828441,532231,2016-04-11,Assembly,"Do pass and be re-referred to the Committee on Revenue and Taxation",11,4,0,1,16
828441,535259,2016-04-18,Assembly,"Do pass and be re-referred to the Committee on Appropriations",6,3,0,0,9
828446,517306,2016-03-09,Senate,"Do pass as amended, but re-refer to the Committee on Appropriations 	Recommend Consent",8,0,1,0,9
828446,531036,2016-04-11,Senate,"Placed on Appropriations Suspense file",7,0,0,0,7
828446,549331,2016-05-27,Senate,"Do pass",7,0,0,0,7
828446,550085,2016-05-31,Senate,"Senate 3rd Reading SB911 Hertzberg",39,0,1,0,40
828446,555251,2016-06-22,Assembly,"Amend, and do pass as amended and be re-referred to the Committee 	on Appropriations with the recommendation:  To Consent Calendar",7,0,0,0,7
828446,559384,2016-08-11,Assembly,"Do pass as amended",20,0,0,0,20
828446,560113,2016-08-18,Assembly,"SB 911 Hertzberg  Senate Third Reading",77,0,0,3,80
828446,561139,2016-08-25,Senate,"Special Consent SB911 Hertzberg",39,0,0,0,39
828454,528970,2016-04-06,Senate,"Do pass, but re-refer to the Committee on Appropriations Recommend 	Consent",7,0,0,0,7
828454,537413,2016-04-21,Senate,"Consent Calendar 2nd SB909 Beall",39,0,1,0,40
828454,553467,2016-06-15,Assembly,"Do pass and be re-referred to the Committee on Revenue and Taxation",9,0,0,0,9
828454,554690,2016-06-20,Assembly,"Do pass as amended and be re-referred to the Committee on 	Appropriations",9,0,0,0,9
828454,559080,2016-08-03,Assembly,"Do pass, to Consent Calendar",20,0,0,0,20
828454,560411,2016-08-19,Assembly,"SB 909 Beall  Senate Third Reading  By W., P.& W.  Amendment  Set #1",73,0,0,7,80
828454,561035,2016-08-24,Assembly,"SB 909 Beall  Senate Third Reading  By GORDON",80,0,0,0,80
828454,561336,2016-08-26,Senate,"Unfinished Business SB909 Beall Concurrence",39,0,0,0,39
828459,528297,2016-04-05,Assembly,"Do pass as amended and be re-referred to the Committee on 	Appropriations",14,0,0,2,16
828459,549367,2016-05-27,Assembly,"Do pass",15,1,0,4,20
828459,550517,2016-06-01,Assembly,"AB 1715 HOLDEN  Assembly Third Reading",71,4,0,5,80
828464,489718,2016-02-01,Senate,"Senate 3rd Reading SCR101 Fuller",38,0,2,0,40
828464,559503,2016-08-11,Assembly,"Be adopted, to Consent Calendar",9,0,0,2,11
828464,560279,2016-08-18,Assembly,"SCR 101 Fuller  Consent Calendar Second Day  Regular Session",78,0,0,2,80
828469,493280,2016-02-08,Assembly,"From committee:  Be adopted.  To third reading",7,0,0,4,11
828469,519158,2016-03-14,Senate,"Assembly 3rd Reading ACR126 Ting By Monning",37,0,3,0,40
828474,517322,2016-03-09,Senate,"Do pass as amended, and re-refer to the Committee on Appropriations",8,0,1,0,9
828474,531044,2016-04-11,Senate,"Placed on Appropriations Suspense file",7,0,0,0,7
828474,549228,2016-05-27,Senate,"Do pass as amended",5,2,0,0,7
828474,550656,2016-06-01,Senate,"Senate 3rd Reading SB915 Liu",28,8,4,0,40
828483,520664,2016-03-15,Assembly,"Do pass and be re-referred to the Committee on Appropriations",6,3,0,4,13
828483,520665,2016-03-15,Assembly,"Reconsideration granted",10,0,0,3,13
828483,532234,2016-04-12,Assembly,"Reconsideration granted",13,0,0,0,13
828483,544474,2016-04-19,Assembly,"Do pass and be re-referred to the Committee on Appropriations",10,3,0,0,13
828483,549402,2016-05-27,Assembly,"Do pass as amended",19,0,0,1,20
828483,550383,2016-06-01,Assembly,"AB 1711 MCCARTY  Assembly Third Reading",78,2,0,0,80
828483,556416,2016-06-29,Senate,"Do pass as amended, and re-refer to the Committee on Appropriations",3,4,2,0,9
828483,556417,2016-06-29,Senate,"Set, first hearing.  Failed passage in Committee.  Reconsideration 	granted",9,0,0,0,9
828483,559414,2016-08-11,Senate,"Do pass, but re-refer to the Committee on Appropriations",8,0,1,0,9
828487,529387,2016-04-06,Senate,"Do pass, but re-refer to the Committee on Appropriations",7,2,0,0,9
828487,534134,2016-04-18,Senate,"Placed on Appropriations Suspense file",7,0,0,0,7
828487,549086,2016-05-27,Senate,"Do pass as amended",5,2,0,0,7
828487,550422,2016-06-01,Senate,"Senate 3rd Reading SB908 Hernandez",24,12,4,0,40
828487,556384,2016-06-28,Assembly,"Do pass as amended and be re-referred to the Committee on 	Appropriations",11,7,0,0,18
828487,558991,2016-08-03,Assembly,"Do pass",14,6,0,0,20
828487,560461,2016-08-22,Assembly,"SB 908 Hernandez  Senate Third Reading  By SANTIAGO",51,26,0,3,80
828487,560907,2016-08-24,Senate,"Unfinished Business SB908 Hernandez Concurrence",25,12,2,0,39
828492,528663,2016-04-06,Senate,"Do pass",4,0,1,0,5
828492,530425,2016-04-11,Senate,"Senate 3rd Reading SB914 Mendoza",36,0,4,0,40
828492,554984,2016-06-22,Assembly,"Do pass, to Consent Calendar",13,0,0,0,13
828492,556726,2016-06-30,Assembly,"SB 914 Mendoza  Consent Calendar Second Day  Regular Session",79,0,0,1,80
828501,535119,2016-04-19,Assembly,"Do pass and be re-referred to the Committee on Appropriations",8,4,0,3,15
828515,526489,2016-03-29,Assembly,"Do pass and be re-referred to the Committee on Appropriations to 	Consent Calendar",6,0,0,1,7
828515,549358,2016-05-27,Assembly,"Do pass as amended",20,0,0,0,20
828515,550387,2016-06-01,Assembly,"AB 1712 OBERNOLTE  Assembly Third Reading",80,0,0,0,80
828515,555172,2016-06-22,Senate,"Do pass, but re-refer to the Committee on Appropriations Recommend 	Consent",9,0,0,0,9
828515,558891,2016-08-01,Senate,"Placed on Appropriations Suspense file",7,0,0,0,7
828515,559674,2016-08-11,Senate,"Do pass as amended",7,0,0,0,7
828515,560246,2016-08-18,Senate,"Assembly 3rd Reading AB1712 Obernolte By McGuire",38,0,1,0,39
828515,560813,2016-08-23,Assembly,"AB 1712 OBERNOLTE  Concurrence in Senate Amendments",80,0,0,0,80
832318,527970,2016-04-05,Senate,"Do pass, but re-refer to the Committee on Natural Resources and 	Water",9,0,2,0,11
832318,531266,2016-04-12,Senate,"Do pass as amended, and re-refer to the Committee on Appropriations",8,0,1,0,9
832318,543782,2016-05-09,Senate,"Senate 3rd Reading SB919 Hertzberg",35,0,5,0,40
832318,553112,2016-06-15,Assembly,"Do pass and be re-referred to the Committee on Water, Parks and 	Wildlife",15,0,0,0,15
832318,556007,2016-06-28,Assembly,"Do pass and be re-referred to the Committee on Appropriations to 	Consent Calendar",15,0,0,0,15
832318,559033,2016-08-03,Assembly,"Do pass, to Consent Calendar",20,0,0,0,20
832318,560123,2016-08-18,Assembly,"SB 919 Hertzberg  Senate Third Reading  By OLSEN",78,0,0,2,80
832318,560935,2016-08-24,Senate,"Unfinished Business SB919 Hertzberg Concurrence",39,0,0,0,39
832322,538986,2016-04-27,Assembly,"Do pass and be re-referred to the Committee on Judiciary",1,4,0,2,7
832322,538987,2016-04-27,Assembly,"Reconsideration granted",7,0,0,0,7
832326,529529,2016-04-06,Assembly,"Do pass as amended and be re-referred to the Committee on Judiciary",6,0,0,1,7
832326,535277,2016-04-19,Assembly,"Do pass as amended and be re-referred to the Committee on 	Appropriations",10,0,0,0,10
832326,549329,2016-05-27,Assembly,"Do pass",20,0,0,0,20
832326,550243,2016-05-31,Assembly,"AB 1719 RODRIGUEZ  Assembly Third Reading",77,1,0,2,80
832326,553283,2016-06-15,Senate,"Do pass as amended, and re-refer to the Committee on Judiciary",9,0,0,0,9
832326,556317,2016-06-28,Senate,"Do pass, but re-refer to the Committee on Appropriations",7,0,0,0,7
832326,558965,2016-08-01,Senate,"Placed on Appropriations Suspense file",7,0,0,0,7
832326,559766,2016-08-11,Senate,"Do pass as amended",7,0,0,0,7
832326,560245,2016-08-18,Senate,"Assembly 3rd Reading AB1719 Rodriguez By Hill",38,0,1,0,39
832326,561442,2016-08-29,Assembly,"AB 1719 RODRIGUEZ  Concurrence in Senate Amendments",79,0,0,1,80
832334,542387,2016-05-03,Senate,"Do pass as amended",6,0,1,0,7
832334,547550,2016-05-23,Senate,"Senate 3rd Reading SB918 Vidak",37,0,3,0,40
832334,556567,2016-06-29,Assembly,"Do pass, to Consent Calendar",7,0,0,0,7
832334,560342,2016-08-18,Assembly,"SB 918 Vidak  Senate Third Reading  By LINDER",73,5,0,2,80
832334,560998,2016-08-24,Senate,"Unfinished Business SB918 Vidak Concurrence",39,0,0,0,39
832339,534903,2016-04-18,Assembly,"Do pass as amended and be re-referred to the Committee on 	Appropriations",6,0,0,3,9
832339,549244,2016-05-27,Assembly,"Do pass",14,2,0,4,20
832339,550378,2016-06-01,Assembly,"AB 1716 MCCARTY  Assembly Third Reading",59,20,0,1,80
832339,556077,2016-06-28,Senate,"Do pass as amended, and re-refer to the Committee on Appropriations",6,2,1,0,9
832339,559661,2016-08-11,Senate,"Do pass",5,2,0,0,7
832339,560779,2016-08-23,Senate,"Assembly 3rd Reading AB1716 McCarty By Pan",27,12,0,0,39
832339,561659,2016-08-30,Assembly,"AB 1716 MCCARTY  Concurrence in Senate Amendments",59,20,0,1,80
832344,532461,2016-04-11,Assembly,"Do pass and be re-referred to the Committee on Natural Resources",5,10,0,1,16
832344,532462,2016-04-11,Assembly,"Reconsideration granted",16,0,0,0,16
832349,519733,2016-03-15,Assembly,"Do pass and be re-referred to the Committee on Aging and Long",2,4,0,1,7
832349,519734,2016-03-15,Assembly,"Reconsideration granted",7,0,0,0,7
832349,537162,2016-04-20,Assembly,"Do pass and be re-referred to the Committee on Aging and Long",2,5,0,0,7
832354,535695,2016-04-19,Senate,"Be adopted, but re-refer to the Committee on Appropriations 	Recommend Consent",11,0,0,0,11
832354,543035,2016-05-05,Senate,"Consent Calendar 2nd SCR102 Nguyen",36,0,4,0,40
832354,552538,2016-06-13,Assembly,"Be adopted and re-referred to the Committee on Appropriations with 	recommendation:  To Consent Calendar",15,0,0,1,16
832354,556462,2016-06-29,Assembly,"Be adopted, to Consent Calendar",18,0,0,2,20
832354,558645,2016-08-01,Assembly,"SCR 102 Nguyen  Consent Calendar Second Day  Regular Session",76,0,0,4,80
832358,531270,2016-04-12,Senate,"Do pass, but re-refer to the Committee on Appropriations Recommend 	Consent",6,0,1,0,7
832358,544269,2016-04-25,Senate,"Placed on Appropriations Suspense file",7,0,0,0,7
832358,549209,2016-05-27,Senate,"Do pass as amended",7,0,0,0,7
832358,550821,2016-06-02,Senate,"Special Consent # SB917 Jackson",39,0,1,0,40
832358,555985,2016-06-28,Assembly,"Do pass and be re-referred to the Committee on Appropriations to 	Consent Calendar",10,0,0,0,10
832372,536193,2016-04-20,Senate,"Do pass as amended, and re-refer to the Committee on Appropriations",9,0,0,0,9
832372,545798,2016-05-16,Senate,"Placed on Appropriations Suspense file",7,0,0,0,7
832372,549064,2016-05-27,Senate,"Do pass",7,0,0,0,7
832372,549998,2016-05-31,Senate,"Senate 3rd Reading SB916 Allen",39,0,1,0,40
832372,555259,2016-06-22,Assembly,"Do pass and be re-referred to the Committee on Appropriations",7,0,0,0,7
832372,559268,2016-08-11,Assembly,"Do pass as amended",20,0,0,0,20
832372,560138,2016-08-18,Assembly,"SB 916 Allen  Senate Third Reading  By O'DONNELL",78,0,0,2,80
832372,561207,2016-08-25,Senate,"Special Consent SB916 Allen",39,0,0,0,39
833573,525931,2016-03-29,Assembly,"Be adopted as amended",7,0,0,0,7
833573,549444,2016-05-27,Assembly,"AJR 29 CHAVEZ  Assembly Third Reading",71,0,0,9,80
833573,554842,2016-06-21,Senate,"Be adopted",10,0,1,0,11
833573,559332,2016-08-11,Senate,"Special Consent AJR29 Ch",37,0,2,0,39
833574,520407,2016-03-15,Assembly,"Do pass and be re-referred to the Committee on Health",10,2,0,1,13
833574,531283,2016-04-12,Assembly,"Do pass and be re-referred to the Committee on Appropriations",13,3,0,3,19
833574,549166,2016-05-27,Assembly,"Do pass as amended",14,6,0,0,20
833574,550916,2016-06-02,Assembly,"AB 1726 BONTA  Assembly Third Reading",54,22,0,4,80
833574,555001,2016-06-22,Senate,"Do pass, but re-refer to the Committee on Health",7,2,0,0,9
833574,556822,2016-06-29,Senate,"Do pass, but re-refer to the Committee on Appropriations",7,0,2,0,9
833574,558768,2016-08-01,Senate,"Placed on Appropriations Suspense file",7,0,0,0,7
833574,559582,2016-08-11,Senate,"Do pass as amended",5,2,0,0,7
833574,560713,2016-08-23,Senate,"Assembly 3rd Reading AB1726 Bonta By Pan",39,0,0,0,39
833574,561389,2016-08-29,Assembly,"AB 1726 BONTA  Concurrence in Senate Amendments",75,1,0,4,80
833576,532182,2016-04-12,Assembly,"Do pass and be re-referred to the Committee on Appropriations",12,1,0,0,13
833576,549078,2016-05-27,Assembly,"Do pass as amended",15,1,0,4,20
833576,550872,2016-06-02,Assembly,"AB 1721 MEDINA  Assembly Third Reading",73,4,0,3,80
833576,556301,2016-06-29,Senate,"Do pass, but re-refer to the Committee on Appropriations",9,0,0,0,9
833576,558792,2016-08-01,Senate,"Placed on Appropriations Suspense file",7,0,0,0,7
833578,510565,2016-03-01,Assembly,"Do pass and be re-referred to the Committee on Appropriations to 	Consent Calendar",7,0,0,0,7
833578,549154,2016-05-27,Assembly,"Do pass as amended",20,0,0,0,20
833578,550446,2016-06-01,Assembly,"AB 1730 ATKINS  Assembly Third Reading",80,0,0,0,80
833578,554617,2016-06-21,Senate,"Do pass as amended, but re-refer to the Committee on Appropriations 	Recommend Consent",7,0,0,0,7
833578,558774,2016-08-01,Senate,"Placed on Appropriations Suspense file",7,0,0,0,7
833578,559618,2016-08-11,Senate,"Do pass",7,0,0,0,7
833578,561716,2016-08-31,Senate,"Assembly 3rd Reading AB1730 Atkins By Hancock",39,0,0,0,39
833578,561717,2016-08-31,Assembly,"AB 1730 ATKINS  Concurrence in Senate Amendments",78,0,0,2,80
833579,510647,2016-03-01,Assembly,"Do pass and be re-referred to the Committee on Appropriations to 	Consent Calendar",7,0,0,0,7
833579,548950,2016-05-27,Assembly,"Do pass as amended",20,0,0,0,20
833579,550447,2016-06-01,Assembly,"AB 1731 ATKINS  Assembly Third Reading",80,0,0,0,80
833579,554680,2016-06-21,Senate,"Do pass, but re-refer to the Committee on Appropriations Recommend 	Consent",7,0,0,0,7
833579,558739,2016-08-01,Senate,"Placed on Appropriations Suspense file",7,0,0,0,7
833580,519477,2016-03-14,Assembly,"Do pass and be re-referred to the Committee on Appropriations",12,0,0,0,12
833580,532815,2016-04-06,Assembly,"Do pass, to Consent Calendar",18,0,0,2,20
833580,533334,2016-04-14,Assembly,"AB 1722 WAGNER  Consent Calendar Second Day  Regular Session",76,0,0,4,80
833580,553503,2016-06-14,Senate,"Do pass, but re-refer to the Committee on Appropriations Recommend 	Consent",7,0,0,0,7
833580,557105,2016-06-30,Senate,"Consent Calendar 2nd AB1722 Wagner",37,0,3,0,40
833583,492975,2016-02-08,Assembly,"Be adopted as amended",7,0,0,4,11
833583,509518,2016-02-29,Senate,"Assembly 3rd Reading ACR127 Baker By Runner",40,0,0,0,40
833585,519440,2016-03-14,Assembly,"Be adopted and re-referred to the Committee on Appropriations with 	recommendation:  To Consent Calendar",16,0,0,0,16
833585,559147,2016-08-04,Assembly,"From committee:  Be adopted.  To third reading",9,0,0,2,11
833585,561457,2016-08-29,Senate,"Assembly 3rd Reading ACR128 Brown By Mitchell",39,0,0,0,39
833587,528001,2016-04-04,Assembly,"Do pass and be re-referred to the Committee on Judiciary",12,0,0,0,12
833587,538605,2016-04-26,Assembly,"Do pass",10,0,0,0,10
833587,539746,2016-04-28,Assembly,"AB 1723 DODD  Assembly Third Reading",77,0,0,3,80
833587,556534,2016-06-28,Senate,"Do pass as amended. To Consent Calendar",7,0,0,0,7
833587,559913,2016-08-15,Senate,"Assembly 3rd Reading AB1723 Dodd By Jackson",38,0,1,0,39
833587,560541,2016-08-22,Assembly,"AB 1723 DODD  Concurrence in Senate Amendments",79,0,0,1,80
833589,537125,2016-04-20,Assembly,"Do pass and be re-referred to the Committee on Judiciary",5,2,0,0,7
833590,532349,2016-04-13,Senate,"Do pass, but re-refer to the Committee on Appropriations Recommend 	Consent",8,0,1,0,9
833590,542985,2016-05-05,Senate,"Consent Calendar 2nd SB924 Roth",36,0,4,0,40
833590,555008,2016-06-22,Assembly,"Do pass and be re-referred to the Committee on Appropriations to 	Consent Calendar",13,0,0,0,13
833590,556281,2016-06-29,Assembly,"Do pass, to Consent Calendar",18,0,0,2,20
833590,559095,2016-08-04,Assembly,"SB 924 Roth  Consent Calendar Second Day  Regular Session",77,0,0,3,80
833593,526444,2016-03-30,Senate,"Do pass, but re-refer to the Committee on Appropriations",7,0,2,0,9
833593,540833,2016-05-02,Senate,"Senate 3rd Reading SB923 Hernandez",29,5,6,0,40
833593,554983,2016-06-21,Assembly,"Do pass and be re-referred to the Committee on Appropriations",17,0,0,1,18
833593,556373,2016-06-29,Assembly,"Do pass",18,0,0,2,20
833593,559094,2016-08-04,Assembly,"SB 923 Hernandez  Senate Third Reading  By WOOD",75,0,0,5,80
833593,559241,2016-08-11,Senate,"Unfinished Business SB923 Hernandez Concurrence",29,5,5,0,39
833602,507416,2016-02-25,Senate,"Senate 3rd Reading SCR103 Leyva",37,0,3,0,40
833602,540354,2016-04-28,Assembly,"From committee:  Be adopted.  To third reading",11,0,0,0,11
833602,548677,2016-05-26,Senate,"Unfinished Business SCR103 Leyva Concurrence",37,0,3,0,40
833604,519091,2016-03-14,Assembly,"Do pass, to Consent Calendar",16,0,0,0,16
833604,525043,2016-03-28,Assembly,"AB 1725 WAGNER  Consent Calendar Second Day  Regular Session",74,0,0,5,79
833604,552701,2016-06-14,Senate,"Do pass, but re-refer to the Committee on Rules Recommend Consent",11,0,0,0,11
833604,558758,2016-08-01,Senate,"Placed on Appropriations Suspense file",7,0,0,0,7
833608,528011,2016-04-05,Assembly,"Do pass as amended and be re-referred to the Committee on 	Appropriations",14,0,0,2,16
833608,536258,2016-04-20,Assembly,"Do pass",11,4,0,5,20
833608,543799,2016-05-09,Assembly,"AB 1732 TING  Assembly Third Reading",55,19,0,6,80
833608,554646,2016-06-21,Senate,"Do pass, but re-refer to the Committee on Appropriations",9,2,0,0,11
833608,560231,2016-08-18,Senate,"Assembly 3rd Reading AB1732 Ting By Leno",28,7,4,0,39
833608,560471,2016-08-22,Assembly,"AB 1732 TING  Concurrence in Senate Amendments",57,18,0,5,80
834833,531225,2016-04-12,Assembly,"Do pass as amended and be re-referred to the Committee on 	Appropriations",18,0,0,1,19
834833,538945,2016-04-27,Assembly,"Do pass, to Consent Calendar",19,0,0,1,20
834833,543008,2016-05-05,Assembly,"AB 1739 WALDRON  Consent Calendar Second Day  Regular Session",79,0,0,1,80
834833,556823,2016-06-29,Senate,"Do pass as amended, and re-refer to the Committee on Appropriations",8,0,1,0,9
834833,559541,2016-08-11,Senate,"Do pass",7,0,0,0,7
834833,560192,2016-08-18,Senate,"Assembly 3rd Reading AB1739 Waldron By Pan",36,0,3,0,39
834833,560688,2016-08-23,Assembly,"AB 1739 WALDRON  Concurrence in Senate Amendments",80,0,0,0,80
834835,535047,2016-04-19,Assembly,"Do pass and be re-referred to the Committee on Appropriations",7,0,0,0,7
834838,537340,2016-04-20,Senate,"Do pass as amended, and re-refer to the Committee on Appropriations",5,1,3,0,9
834839,519201,2016-03-14,Assembly,"Be adopted and re-referred to the Committee on Appropriations with 	recommendation:  To Consent Calendar",16,0,0,0,16
834839,531041,2016-04-11,Assembly,"ACR 130 GOMEZ  Consent Calendar Second Day  Regular Session",77,0,0,2,79
834839,532419,2016-04-06,Assembly,"Be adopted, to Consent Calendar",18,0,0,2,20
834844,510098,2016-02-29,Assembly,"From committee:  Be adopted.  To third reading",8,0,0,3,11
834847,526565,2016-03-30,Senate,"Do pass as amended, and re-refer to the Committee on Elections and 	Constitutional Amendments",7,0,0,0,7
834847,535113,2016-04-19,Senate,"Do pass",5,0,0,0,5
834847,538017,2016-04-25,Senate,"Senate 3rd Reading SB927 Anderson Urgency Clause",38,0,2,0,40
834847,553479,2016-06-15,Assembly,"Do pass and be re-referred to the Committee on Elections and 	Redistricting to Consent Calendar",9,0,0,0,9
834847,556531,2016-06-29,Assembly,"Do pass, to Consent Calendar",7,0,0,0,7
834847,559154,2016-08-04,Assembly,"SB 927 Anderson  Consent Calendar Second Day",77,0,0,3,80
834852,532748,2016-04-12,Assembly,"Do pass as amended and be re-referred to the Committee on 	Appropriations",13,0,0,0,13
834852,549456,2016-05-27,Assembly,"Do pass as amended",20,0,0,0,20
834852,550522,2016-06-01,Assembly,"AB 1741 RODRIGUEZ  Assembly Third Reading",80,0,0,0,80
834852,556443,2016-06-29,Senate,"Do pass as amended, and re-refer to the Committee on Appropriations",9,0,0,0,9
834852,559686,2016-08-11,Senate,"Do pass",7,0,0,0,7
834852,560066,2016-08-17,Senate,"Assembly 3rd Reading AB1741 Rodriguez By Hancock",39,0,0,0,39
834852,560864,2016-08-23,Assembly,"AB 1741 RODRIGUEZ  Concurrence in Senate Amendments",80,0,0,0,80
834859,538625,2016-04-26,Assembly,"Do pass, to Consent Calendar",10,0,0,0,10
834859,540976,2016-05-02,Assembly,"AB 1735 WALDRON  Consent Calendar Second Day  Regular Session",76,0,0,4,80
834859,553495,2016-06-14,Senate,"Do pass and be placed on the Consent Calendar",7,0,0,0,7
834859,556941,2016-06-30,Senate,"Consent Calendar 2nd AB1735 Waldron",37,0,3,0,40
834862,528794,2016-04-06,Senate,"Do pass, but re-refer to the Committee on Appropriations Recommend 	Consent",6,0,1,0,7
834862,539577,2016-04-28,Senate,"Consent Calendar 2nd SB930 Gaines",37,0,3,0,40
834862,552743,2016-06-14,Assembly,"Do pass and be re-referred to the Committee on Appropriations to 	Consent Calendar",7,0,0,0,7
834862,556457,2016-06-29,Assembly,"Do pass, to Consent Calendar",18,0,0,2,20
834862,559140,2016-08-04,Assembly,"SB 930 Gaines  Consent Calendar Second Day  Regular Session",77,0,0,3,80
834865,510281,2016-02-29,Assembly,"From committee:  Be adopted.  To third reading",8,0,0,3,11
834865,533204,2016-04-14,Senate,"Assembly 3rd Reading ACR129 Kim By Nguyen",38,0,2,0,40
834867,526496,2016-03-29,Assembly,"Do pass and be re-referred to the Committee on Appropriations",6,0,0,1,7
834867,549107,2016-05-27,Assembly,"Do pass as amended",15,2,0,3,20
834867,550876,2016-06-02,Assembly,"AB 1742 STONE  Assembly Third Reading",71,6,0,3,80
834867,556283,2016-06-28,Senate,"Do pass, but re-refer to the Committee on Appropriations",5,0,0,0,5
834867,558786,2016-08-01,Senate,"Placed on Appropriations Suspense file",7,0,0,0,7
834872,520122,2016-03-15,Assembly,"Do pass and be re-referred to the Committee on Local Government to 	Consent Calendar",7,0,0,0,7
834872,528982,2016-04-06,Assembly,"Do pass and be re-referred to the Committee on Appropriations to 	Consent Calendar",9,0,0,0,9
834873,520146,2016-03-15,Assembly,"Do pass and be re-referred to the Committee on Appropriations to 	Consent Calendar",7,0,0,0,7
834873,532224,2016-04-06,Assembly,"Do pass, to Consent Calendar",18,0,0,2,20
834873,533449,2016-04-14,Assembly,"AB 1744 COOPER  Consent Calendar Second Day  Regular Session",76,0,0,4,80
834873,554717,2016-06-21,Senate,"Do pass, but re-refer to the Committee on Appropriations Recommend 	Consent",7,0,0,0,7
834873,558856,2016-08-01,Senate,"Placed on Appropriations Suspense file",7,0,0,0,7
834873,559565,2016-08-11,Senate,"Do pass",7,0,0,0,7
834873,560243,2016-08-18,Senate,"Assembly 3rd Reading AB1744 Cooper By Galgiani",36,0,3,0,39
834873,560663,2016-08-23,Assembly,"AB 1744 COOPER  Concurrence in Senate Amendments",80,0,0,0,80
834875,539946,2016-04-28,Senate,"Senate 3rd Reading SCR104 Nguyen",34,0,6,0,40
834875,545829,2016-05-16,Assembly,"Be adopted, to Consent Calendar",10,0,0,1,11
834875,547018,2016-05-19,Assembly,"SCR 104 Nguyen  Consent Calendar Second Day  Regular Session",76,0,0,4,80
834878,534861,2016-04-19,Assembly,"Do pass as amended and be re-referred to the Committee on Judiciary",11,0,0,0,11
834878,541408,2016-05-03,Assembly,"Do pass as amended",10,0,0,0,10
834878,547026,2016-05-19,Assembly,"AB 1743 DABABNEH  Assembly Third Reading",76,0,0,4,80
834881,525592,2016-03-29,Assembly,"Do pass and be re-referred to the Committee on Appropriations",5,2,0,0,7
834881,549037,2016-05-27,Assembly,"Do pass",15,5,0,0,20
834881,550486,2016-06-01,Assembly,"AB 1738 MCCARTY  Assembly Third Reading",59,21,0,0,80
834881,554691,2016-06-21,Senate,"Do pass, but re-refer to the Committee on Environmental Quality",7,0,4,0,11
834885,536524,2016-04-20,Assembly,"Do pass as amended and be re-referred to the Committee on Revenue 	and Taxation",7,0,0,0,7
834885,544663,2016-05-09,Assembly,"Do pass as amended and be re-referred to the Committee on 	Appropriations",9,0,0,0,9
834888,520133,2016-03-14,Assembly,"Do pass, to Consent Calendar",8,0,0,1,9
834888,525259,2016-03-28,Assembly,"AB 1734 OBERNOLTE  Consent Calendar Second Day",74,0,0,5,79
834888,552942,2016-06-14,Senate,"Do pass and be placed on the Consent Calendar",9,0,0,0,9
834888,556959,2016-06-30,Senate,"Consent Calendar 2nd AB1734 Obernolte",37,0,3,0,40
834891,539055,2016-04-26,Senate,"Do pass",7,0,0,0,7
834891,541015,2016-05-02,Senate,"Senate 3rd Reading SB929 Vidak",38,0,2,0,40
835686,519067,2016-03-14,Assembly,"Do pass and be re-referred to the Committee on Appropriations",16,0,0,0,16
835686,532311,2016-04-06,Assembly,"Do pass, to Consent Calendar",18,0,0,2,20
835686,533181,2016-04-14,Assembly,"AB 1746 STONE  Consent Calendar Second Day  Regular Session",76,0,0,4,80
835688,532509,2016-04-13,Assembly,"Do pass as amended and be re-referred to the Committee on 	Appropriations",7,0,0,2,9
835688,544876,2016-05-11,Assembly,"Do pass",15,0,0,5,20
835688,546999,2016-05-19,Assembly,"AB 1757 WALDRON  Assembly Third Reading",57,5,0,18,80
835688,552926,2016-06-14,Senate,"Do pass, but re-refer to the Committee on Appropriations",8,0,3,0,11
835688,559795,2016-08-15,Senate,"Assembly 3rd Reading AB1757 Waldron By Bates",33,4,2,0,39
835690,525714,2016-03-29,Senate,"Do pass, but re-refer to the Committee on Appropriations",7,0,0,0,7
835690,530444,2016-04-11,Senate,"Placed on Appropriations Suspense file",7,0,0,0,7
835690,548984,2016-05-27,Senate,"Do pass as amended",7,0,0,0,7
835690,550874,2016-06-02,Senate,"Special Consent # SB938 Jackson",39,0,1,0,40
835690,555964,2016-06-28,Assembly,"Do pass as amended and be re-referred to the Committee on 	Appropriations",10,0,0,0,10
835690,558994,2016-08-03,Assembly,"Do pass as amended",18,0,0,2,20
835690,560356,2016-08-19,Assembly,"SB 938 Jackson  Senate Third Reading  Amendment  Set #1",73,0,0,7,80
835698,516098,2016-03-08,Senate,"Do pass, but re-refer to the Committee on Appropriations",12,0,1,0,13
835698,530492,2016-04-11,Senate,"Placed on Appropriations Suspense file",7,0,0,0,7
835701,533350,2016-04-13,Assembly,"Do pass and be re-referred to the Committee on Judiciary",7,0,0,0,7
835701,534876,2016-04-19,Assembly,"Do pass as amended and be re-referred to the Committee on 	Appropriations",9,1,0,0,10
835701,546596,2016-05-18,Assembly,"Do pass",20,0,0,0,20
835701,547545,2016-05-23,Assembly,,74,3,0,3,80
835701,553086,2016-06-15,Senate,"Do pass, but re-refer to the Committee on Judiciary",9,0,0,0,9
835701,556288,2016-06-28,Senate,"Do pass, but re-refer to the Committee on Appropriations",7,0,0,0,7
835701,558797,2016-08-01,Senate,"Placed on Appropriations Suspense file",7,0,0,0,7
835701,559573,2016-08-11,Senate,"Do pass",7,0,0,0,7
835701,560382,2016-08-19,Senate,"Assembly 3rd Reading AB1748 Mayes By Pan",37,0,2,0,39
835701,560969,2016-08-24,Assembly,,78,1,0,1,80
835702,525626,2016-03-29,Assembly,"Be adopted and re-referred to the Committee on Appropriations with 	recommendation:  To Consent Calendar",16,0,0,0,16
835702,549422,2016-05-27,Assembly,"Be adopted as amended",20,0,0,0,20
835702,551036,2016-06-02,Assembly,"ACR 131 PATTERSON  Assembly Third Reading",76,1,0,3,80
835702,554619,2016-06-20,Senate,"Be adopted as amended, but re-refer to the Committee on 	Appropriations Recommend Consent",9,0,0,0,9
835702,558735,2016-08-01,Senate,"Placed on Appropriations Suspense file",7,0,0,0,7
835705,520956,2016-03-16,Senate,"Do pass as amended, and re-refer to the Committee on Appropriations",9,0,0,0,9
835705,531039,2016-04-11,Senate,"Placed on Appropriations Suspense file",7,0,0,0,7
835705,549120,2016-05-27,Senate,"Do pass as amended",6,0,1,0,7
835705,550890,2016-06-02,Senate,"Senate 3rd Reading SB933 Allen",37,0,3,0,40
835705,555233,2016-06-22,Assembly,"Do pass and be re-referred to the Committee on Appropriations to 	Consent Calendar",7,0,0,0,7
835707,519055,2016-03-14,Assembly,"Do pass and be re-referred to the Committee on Appropriations",16,0,0,0,16
835709,536019,2016-04-18,Assembly,"Amend, and re-refer to the Committee on Natural Resources",9,0,0,0,9
835709,542385,2016-05-03,Assembly,"Do pass and be re-referred to the Committee on Appropriations",8,1,0,0,9
835709,546948,2016-05-18,Assembly,"Do pass",18,0,0,2,20
835709,549368,2016-05-27,Assembly,"AB 1749 MATHIS  Third Reading Urgency",69,1,0,10,80
835709,556645,2016-06-29,Senate,"Do pass",3,3,1,0,7
835709,556646,2016-06-29,Senate,"Set, first hearing.  Failed passage in Committee.  Reconsideration 	granted",6,0,1,0,7
835709,559220,2016-08-10,Senate,"Do pass",6,0,1,0,7
835711,502401,2016-02-18,Senate,"Senate 3rd Reading SCR105 Mendoza",39,0,1,0,40
835711,515873,2016-03-08,Assembly,"From committee:  Be adopted.  To third reading",10,0,0,1,11
835711,519112,2016-03-14,Senate,"Unfinished Business (S upplemental File 1)SCR 105 Men doza Con",38,0,2,0,40
835714,535721,2016-04-19,Assembly,"Do pass and be re-referred to the Committee on Appropriations",12,1,0,2,15
835714,549071,2016-05-27,Assembly,"Do pass",19,0,0,1,20
835714,549951,2016-05-31,Assembly,"AB 1755 DODD  Assembly Third Reading",75,4,0,1,80
835714,555939,2016-06-28,Senate,"Do pass, but re-refer to the Committee on Appropriations",8,0,1,0,9
835714,558779,2016-08-01,Senate,"Placed on Appropriations Suspense file",7,0,0,0,7
835714,560513,2016-08-22,Senate,"Assembly 3rd Reading AB1755 Dodd By Pavley",39,0,0,0,39
835714,561210,2016-08-25,Assembly,"AB 1755 DODD  Concurrence in Senate Amendments",75,0,0,5,80
835716,531498,2016-04-12,Assembly,"Do pass as amended and be re-referred to the Committee on 	Appropriations",15,0,0,1,16
835716,549283,2016-05-27,Assembly,"Do pass as amended",19,1,0,0,20
835716,551018,2016-06-02,Assembly,"AB 1751 LOW  Third Reading Urgency",77,0,0,3,80
835716,555669,2016-06-27,Senate,"Do pass, but re-refer to the Committee on Appropriations",9,0,0,0,9
835716,558822,2016-08-01,Senate,"Placed on Appropriations Suspense file",7,0,0,0,7
835716,559650,2016-08-11,Senate,"Do pass as amended",6,1,0,0,7
835716,560790,2016-08-23,Senate,"Assembly 3rd Reading AB1751 Low By Mendoza Urgency Cla",39,0,0,0,39
835716,561804,2016-08-31,Assembly,"AB 1751 LOW  Concurrence in Senate Amendments",78,0,0,2,80
835719,491763,2016-02-04,Assembly,"From committee:  Be adopted.  To third reading",11,0,0,0,11
835719,519070,2016-03-14,Senate,"Assembly 3rd Reading ACR132 Atkins By Jackson",36,0,4,0,40
835722,528815,2016-04-06,Assembly,"Do pass and be re-referred to the Committee on Appropriations to 	Consent Calendar",6,0,0,1,7
835722,536487,2016-04-20,Assembly,"Do pass, to Consent Calendar",16,0,0,4,20
835722,539646,2016-04-28,Assembly,"AB 1753 OBERNOLTE  Consent Calendar Second Day  Regular Session",76,0,0,4,80
835724,526223,2016-03-29,Assembly,"Do pass and be re-referred to the Committee on Education",5,1,0,1,7
835724,532255,2016-04-12,Assembly,"Do pass and be re-referred to the Committee on Appropriations",11,0,0,2,13
835724,549423,2016-05-27,Assembly,"Do pass as amended",14,5,0,1,20
835724,550947,2016-06-02,Assembly,"AB 1747 WEBER  Assembly Third Reading",70,7,0,3,80
835724,555134,2016-06-22,Senate,"Do pass, but re-refer to the Committee on Human Services",9,0,0,0,9
835724,556332,2016-06-28,Senate,"Do pass as amended, and re-refer to the Committee on Appropriations",4,1,0,0,5
835724,560053,2016-08-17,Senate,"Assembly 3rd Reading AB1747 Weber By Hancock",30,7,2,0,39
835724,560766,2016-08-23,Assembly,"AB 1747 WEBER  Concurrence in Senate Amendments",67,13,0,0,80
835726,516285,2016-03-08,Assembly,"Do pass, to Consent Calendar",9,0,0,1,10
835726,519089,2016-03-14,Assembly,"AB 1750 DODD  Consent Calendar Second Day",76,0,0,3,79
835726,553143,2016-06-14,Senate,"Do pass and be placed on the Consent Calendar",7,0,0,0,7
835726,556798,2016-06-30,Senate,"Consent Calendar 2nd AB1750 Dodd",37,0,3,0,40
835726,558624,2016-08-01,Assembly,"AB 1750 DODD  Concurrence in Senate Amendments",76,0,0,4,80
835729,531220,2016-04-12,Assembly,"Do pass as amended and be re-referred to the Committee on Human 	Services",7,0,0,0,7
835729,537083,2016-04-21,Assembly,"Do pass as amended and be re-referred to the Committee on 	Appropriations",6,0,0,1,7
835733,531245,2016-04-12,Assembly,"Do pass as amended and be re-referred to the Committee on 	Appropriations",6,0,0,1,7
835733,544855,2016-05-11,Assembly,"Do pass",19,1,0,0,20
835733,547040,2016-05-19,Assembly,"AB 1761 WEBER  Assembly Third Reading",69,3,0,8,80
835733,556383,2016-06-28,Senate,"Do pass, but re-refer to the Committee on Appropriations",6,1,0,0,7
835733,560757,2016-08-23,Senate,"Assembly 3rd Reading AB1761 Weber By Leno",36,1,2,0,39
835733,561429,2016-08-29,Assembly,"AB 1761 WEBER  Concurrence in Senate Amendments",68,6,0,6,80
835735,519763,2016-03-15,Assembly,"Amend, and do pass as amended and be re-referred to the Committee 	on Aging and Long",7,0,0,0,7
835735,534867,2016-04-19,Assembly,"Do pass and be re-referred to the Committee on Appropriations",6,0,0,1,7
835735,549178,2016-05-27,Assembly,"Do pass as amended",20,0,0,0,20
835735,550457,2016-06-01,Assembly,"AB 1754 WALDRON  Assembly Third Reading",80,0,0,0,80
835735,556399,2016-06-28,Senate,"Do pass, but re-refer to the Committee on Appropriations Recommend 	Consent",7,0,0,0,7
835735,558753,2016-08-01,Senate,"Placed on Appropriations Suspense file",7,0,0,0,7
835736,525585,2016-03-29,Assembly,"Do pass as amended and be re-referred to the Committee on 	Appropriations",5,1,0,1,7
835736,549001,2016-05-27,Assembly,"Do pass as amended",14,5,0,1,20
835736,550873,2016-06-02,Assembly,"AB 1762 CAMPOS  Assembly Third Reading",53,19,0,8,80
835736,556395,2016-06-28,Senate,"Do pass, but re-refer to the Committee on Appropriations",5,1,1,0,7
835736,558767,2016-08-01,Senate,"Placed on Appropriations Suspense file",7,0,0,0,7
835736,559600,2016-08-11,Senate,"Do pass as amended",5,2,0,0,7
835736,560753,2016-08-23,Senate,"Assembly 3rd Reading AB1762 Campos By Anderson",26,11,2,0,39
835736,561411,2016-08-29,Assembly,"AB 1762 CAMPOS  Concurrence in Senate Amendments",52,24,0,4,80
835739,530693,2016-04-11,Senate,"Do pass, but re-refer to the Committee on Appropriations Recommend 	Consent",9,0,0,0,9
835739,537086,2016-04-21,Senate,"Consent Calendar 2nd SB936 Hertzberg",39,0,1,0,40
835739,555678,2016-06-21,Assembly,"Do pass as amended and be re-referred to the Committee on 	Appropriations",9,0,0,0,9
835739,559048,2016-08-03,Assembly,"Do pass, to Consent Calendar",20,0,0,0,20
835739,559426,2016-08-11,Assembly,"SB 936 Hertzberg  Consent Calendar Second Day  Regular Session",78,0,0,2,80
835739,560155,2016-08-18,Senate,"Special Consent SB936 Hertzberg",36,0,3,0,39
835741,520625,2016-03-16,Assembly,"Do pass as amended and be re-referred to the Committee on 	Appropriations",6,0,0,1,7
835741,549450,2016-05-27,Assembly,"Do pass",20,0,0,0,20
835741,549921,2016-05-31,Assembly,"AB 1756 BONILLA  Assembly Third Reading",80,0,0,0,80
836704,501879,2016-02-18,Senate,"Senate 3rd Reading SCR106 Jackson",39,0,1,0,40
836704,519069,2016-03-14,Assembly,"Be adopted, to Consent Calendar",10,0,0,1,11
836704,521083,2016-03-17,Assembly,"SCR 106 Jackson  Consent Calendar Second Day  Regular Session",65,0,0,14,79
836706,528789,2016-04-06,Assembly,"Amend, and do pass as amended and be re-referred to the Committee 	on Local Government with the recommendation:  To Consent Calendar",15,0,0,0,15
836706,536571,2016-04-20,Assembly,"Do pass and be re-referred to the Committee on Appropriations to 	Consent Calendar",9,0,0,0,9
836706,542585,2016-05-04,Assembly,"Do pass, to Consent Calendar",20,0,0,0,20
836706,545183,2016-05-12,Assembly,"AB 1773 OBERNOLTE  Consent Calendar Second Day  Regular Session",78,0,0,2,80
836706,554827,2016-06-21,Senate,"Do pass, but re-refer to the Committee on Appropriations",10,0,1,0,11
836706,560232,2016-08-18,Senate,"Assembly 3rd Reading AB1773 Obernolte By Pavley",36,0,3,0,39
836708,518109,2016-03-10,Assembly,"From committee:  Be adopted.  To third reading",10,0,0,1,11
836708,533325,2016-04-14,Senate,"Assembly 3rd Reading ACR133 Chang By Leyva",38,0,2,0,40
836710,541894,2016-05-03,Assembly,"Do pass as amended, to Consent Calendar",10,0,0,0,10
836710,546718,2016-05-18,Assembly,"Do pass, to Consent Calendar",20,0,0,0,20
836710,550196,2016-05-31,Assembly,"AB 1779 GATTO  Assembly Third Reading",80,0,0,0,80
836710,555143,2016-06-21,Senate,"Do pass, but re-refer to the Committee on Appropriations Recommend 	Consent",7,0,0,0,7
836710,559282,2016-08-11,Senate,"Consent Calendar 2nd AB1779 Gatto",37,0,2,0,39
836713,520176,2016-03-15,Assembly,"Do pass as amended and be re-referred to the Committee on 	Appropriations",6,1,0,0,7
836713,546624,2016-05-18,Assembly,"Do pass as amended",19,1,0,0,20
836713,550009,2016-05-31,Assembly,"AB 1771 O'DONNELL  Assembly Third Reading",79,1,0,0,80
836713,556590,2016-06-28,Senate,"Do pass as amended, and re-refer to the Committee on Appropriations",7,0,0,0,7
836713,559671,2016-08-11,Senate,"Do pass as amended",7,0,0,0,7
836715,527688,2016-04-04,Senate,"Do pass, but re-refer to the Committee on Appropriations",9,0,0,0,9
836715,547759,2016-05-23,Senate,"Senate 3rd Reading SB945 Monning",32,0,8,0,40
836715,554701,2016-06-21,Assembly,"Do pass and be re-referred to the Committee on Appropriations",15,0,0,1,16
836715,559040,2016-08-03,Assembly,"Do pass",18,0,0,2,20
836715,560283,2016-08-18,Assembly,"SB 945 Monning  Senate Third Reading  By WALDRON",77,0,0,3,80
836715,560961,2016-08-24,Senate,"Unfinished Business SB945 Monning Concurrence",37,0,2,0,39
836718,534981,2016-04-18,Assembly,"Do pass and be re-referred to the Committee on Appropriations to 	Consent Calendar",9,0,0,0,9
836718,539249,2016-04-27,Assembly,"Do pass, to Consent Calendar",19,0,0,1,20
836718,543026,2016-05-05,Assembly,"AB 1775 OBERNOLTE  Consent Calendar Second Day  Regular Session",79,0,0,1,80
836718,553201,2016-06-15,Senate,"Do pass, but re-refer to the Committee on Appropriations",6,0,1,0,7
836718,559975,2016-08-16,Senate,"Assembly 3rd Reading AB1775 Obernolte By Moorlach",38,0,1,0,39
836721,525779,2016-03-29,Assembly,"Do pass and be re-referred to the Committee on Appropriations",7,0,0,0,7
836721,533006,2016-04-13,Assembly,"Do pass, to Consent Calendar",20,0,0,0,20
836721,537515,2016-04-21,Assembly,"AB 1776 OBERNOLTE  Consent Calendar Second Day  Regular Session",79,0,0,1,80
836721,553140,2016-06-15,Senate,"Do pass as amended, and re-refer to the Committee on Appropriations",7,0,0,0,7
836724,520811,2016-03-16,Senate,"Do pass, but re-refer to the Committee on Appropriations",8,1,0,0,9
836724,531217,2016-04-11,Senate,"Placed on Appropriations Suspense file",7,0,0,0,7
836726,536928,2016-04-20,Assembly,"Do pass and be re-referred to the Committee on Appropriations to 	Consent Calendar",21,0,0,0,21
836726,545057,2016-05-11,Assembly,"Do pass, to Consent Calendar",20,0,0,0,20
836726,547072,2016-05-19,Assembly,"AB 1767 BIGELOW  Consent Calendar Second Day  Regular Session",76,0,0,4,80
836726,560067,2016-08-17,Senate,"Assembly 3rd Reading AB1767 Bigelow By Berryhill Urgency C",39,0,0,0,39
836726,560784,2016-08-23,Assembly,"AB 1767 BIGELOW  Concurrence- Urgency Added",80,0,0,0,80
836728,527482,2016-04-04,Assembly,"Do pass and be re-referred to the Committee on Appropriations",15,0,0,1,16
836732,532353,2016-04-11,Assembly,"Do pass and be re-referred to the Committee on Appropriations",5,10,0,1,16
836732,532354,2016-04-11,Assembly,"Reconsideration granted",16,0,0,0,16
836734,520398,2016-03-15,Assembly,"Do pass and be re-referred to the Committee on Appropriations",11,0,0,2,13
836734,549062,2016-05-27,Assembly,"Do pass as amended",19,1,0,0,20
836734,550868,2016-06-02,Assembly,"AB 1778 QUIRK  Assembly Third Reading",75,0,0,5,80
836734,555011,2016-06-22,Senate,"Do pass, but re-refer to the Committee on Appropriations",9,0,0,0,9
836734,558781,2016-08-01,Senate,"Placed on Appropriations Suspense file",7,0,0,0,7
836734,559543,2016-08-11,Senate,"Do pass",7,0,0,0,7
836734,560047,2016-08-17,Senate,"Assembly 3rd Reading AB1778 Quirk By Hancock",39,0,0,0,39
836737,531553,2016-04-12,Assembly,"Do pass and be re-referred to the Committee on Appropriations",3,4,0,0,7
836737,531554,2016-04-12,Assembly,"Reconsideration granted",6,0,0,1,7
836737,537121,2016-04-20,Assembly,"Do pass and be re-referred to the Committee on Appropriations",4,3,0,0,7
836740,535109,2016-04-19,Senate,"Do pass, but re-refer to the Committee on Judiciary",10,0,1,0,11
836740,542386,2016-05-03,Senate,"Do pass, but re-refer to the Committee on Appropriations",6,0,1,0,7
836740,547610,2016-05-23,Senate,"Senate 3rd Reading SB940 Vidak Urgency Clause",38,0,2,0,40
836740,552617,2016-06-13,Assembly,"Do pass and be re-referred to the Committee on Appropriations to 	Consent Calendar",15,0,0,1,16
836740,556433,2016-06-29,Assembly,"Do pass, to Consent Calendar",18,0,0,2,20
836740,559151,2016-08-04,Assembly,"SB 940 Vidak  Consent Calendar Second Day  Regular Session",77,0,0,3,80
836742,520164,2016-03-15,Assembly,"Amend, and do pass as amended and be re-referred to the Committee 	on Appropriations with the recommendation:  To Consent Calendar",7,0,0,0,7
836742,532487,2016-04-13,Assembly,"Do pass, to Consent Calendar",20,0,0,0,20
836742,537281,2016-04-21,Assembly,"AB 1769 RODRIGUEZ  Consent Calendar Second Day  Regular Session",79,0,0,1,80
836742,552928,2016-06-14,Senate,"Do pass, but re-refer to the Committee on Appropriations Recommend 	Consent",7,0,0,0,7
836742,557094,2016-06-30,Senate,"Consent Calendar 2nd AB1769 Rodriguez",37,0,3,0,40
836744,534884,2016-04-19,Senate,"Do pass, but re-refer to the Committee on Appropriations",6,1,0,0,7
836744,547552,2016-05-23,Senate,"Placed on Appropriations Suspense file",7,0,0,0,7
836747,535478,2016-04-19,Assembly,"Do pass as amended and be re-referred to the Committee on 	Appropriations",14,0,0,5,19
836747,549191,2016-05-27,Assembly,"Do pass as amended",14,3,0,3,20
836747,551004,2016-06-02,Assembly,"AB 1763 GIPSON  Assembly Third Reading",67,5,0,8,80
836747,555286,2016-06-22,Senate,"Do pass as amended, and re-refer to the Committee on Appropriations",7,1,1,0,9
836747,558862,2016-08-01,Senate,"Placed on Appropriations Suspense file",7,0,0,0,7
836747,559783,2016-08-11,Senate,"Do pass",5,2,0,0,7
836747,560334,2016-08-18,Senate,"Assembly 3rd Reading AB1763 Gipson By Pan",24,12,3,0,39
836747,560812,2016-08-23,Assembly,"AB 1763 GIPSON  Concurrence in Senate Amendments",64,12,0,4,80
836750,525940,2016-03-29,Assembly,"Do pass as amended",9,0,0,1,10
836750,527776,2016-04-04,Assembly,"AB 1766 STONE  Assembly Third Reading",78,0,0,1,79
836750,556689,2016-06-28,Senate,"Do pass as amended",7,0,0,0,7
836750,559436,2016-08-11,Senate,"Special Consent AB1766 Mark Stone By Block",37,0,2,0,39
836750,559829,2016-08-15,Assembly,"AB 1766 STONE  Concurrence in Senate Amendments",78,0,0,2,80
836753,527981,2016-04-05,Senate,"Do pass, but re-refer to the Committee on Appropriations Recommend 	Consent",10,0,1,0,11
836753,545178,2016-05-12,Senate,"Senate 3rd Reading SB944 Committee On T.&H. (Beall)",37,0,3,0,40
836753,553138,2016-06-15,Assembly,"Do pass, to Consent Calendar",7,0,0,0,7
836753,554671,2016-06-21,Assembly,"Do pass and be re-referred to the Committee on Appropriations to 	Consent Calendar",10,0,0,0,10
836753,559004,2016-08-03,Assembly,"Do pass, to Consent Calendar",20,0,0,0,20
836753,560467,2016-08-22,Assembly,"SB 944 T.& H.  Senate Third Reading  By CHIU",79,0,0,1,80
836753,561363,2016-08-29,Senate,"Special Consent SB944 Committee On T.&H. (Beall)",39,0,0,0,39
836757,534840,2016-04-19,Assembly,"Do pass as amended and be re-referred to the Committee on 	Appropriations",15,0,0,1,16
836759,532362,2016-04-12,Senate,"Do pass as amended",3,0,2,0,5
836759,534127,2016-04-18,Senate,"Senate 3rd Reading SB939 Monning",34,0,6,0,40
836759,552656,2016-06-14,Assembly,"Do pass as amended and be re-referred to the Committee on Aging and 	Long",6,1,0,0,7
836759,554943,2016-06-21,Assembly,"Do pass",4,2,0,1,7
836759,555557,2016-06-27,Assembly,"SB 939 Monning  Senate Third Reading  By BROWN",50,23,0,7,80
836759,556743,2016-06-30,Senate,"Unfinished Business SB939 Monning Concurrence",37,0,3,0,40
836767,525881,2016-03-29,Senate,"Do pass as amended, and re-refer to the Committee on Appropriations",3,0,2,0,5
836767,534642,2016-04-18,Senate,"Placed on Appropriations Suspense file",7,0,0,0,7
836767,549333,2016-05-27,Senate,"Do pass as amended",5,2,0,0,7
836767,550725,2016-06-01,Senate,"Senate 3rd Reading SB947 Pan",29,9,2,0,40
836767,556130,2016-06-28,Assembly,"Do pass as amended",6,1,0,0,7
836767,560290,2016-08-18,Assembly,"SB 947 Pan  Senate Third Reading  By ARAMBULA  Amendment  Set #1",52,26,0,2,80
836767,560618,2016-08-22,Assembly,"SB 947 Pan  Senate Third Reading  By ARAMBULA",61,17,0,2,80
836767,561019,2016-08-24,Senate,"Unfinished Business SB947 Pan Concurrence",31,8,0,0,39
836773,533277,2016-04-12,Assembly,"Do pass and be re-referred to the Committee on Appropriations",5,2,0,0,7
836773,549410,2016-05-27,Assembly,"Do pass as amended",14,6,0,0,20
836773,551032,2016-06-02,Assembly,"AB 1770 ALEJO  Assembly Third Reading",53,25,0,2,80
836773,556447,2016-06-28,Senate,"Do pass, but re-refer to the Committee on Appropriations",3,0,2,0,5
836773,558954,2016-08-01,Senate,"Placed on Appropriations Suspense file",7,0,0,0,7
836773,559685,2016-08-11,Senate,"Do pass as amended",5,2,0,0,7
836773,560086,2016-08-17,Senate,"Assembly 3rd Reading AB1770 Alejo By Lara",29,7,3,0,39
836773,561459,2016-08-29,Assembly,"AB 1770 ALEJO  Concurrence in Senate Amendments",55,25,0,0,80
836777,525896,2016-03-29,Senate,"Do pass as amended, and re-refer to the Committee on Judiciary",4,0,1,0,5
836777,531281,2016-04-12,Senate,"Do pass as amended, and re-refer to the Committee on Appropriations",6,0,1,0,7
836777,549205,2016-05-27,Senate,"Do pass as amended",7,0,0,0,7
836777,550929,2016-06-02,Senate,"Special Consent # SB942 Liu",39,0,1,0,40
836777,554757,2016-06-21,Assembly,"Do pass and be re-referred to the Committee on Human Services to 	Consent Calendar",10,0,0,0,10
836777,556079,2016-06-28,Assembly,"Do pass and be re-referred to the Committee on Appropriations to 	Consent Calendar",7,0,0,0,7
836778,534847,2016-04-19,Assembly,"Do pass as amended and be re-referred to the Committee on 	Appropriations",13,1,0,5,19
836778,534848,2016-04-19,Assembly,"Reconsideration granted",19,0,0,0,19
836780,526423,2016-03-30,Assembly,"Do pass and be re-referred to the Committee on Appropriations",8,0,0,1,9
836780,549429,2016-05-27,Assembly,"Do pass",20,0,0,0,20
836780,550182,2016-05-31,Assembly,"AB 1765 IRWIN  Assembly Third Reading",80,0,0,0,80
836780,558931,2016-08-01,Senate,"Placed on Appropriations Suspense file",7,0,0,0,7
836780,559768,2016-08-11,Senate,"Do pass",7,0,0,0,7
836780,560609,2016-08-22,Senate,"Assembly 3rd Reading AB1765 Irwin By Block",39,0,0,0,39
837618,519988,2016-03-15,Assembly,"Do pass and be re-referred to the Committee on Appropriations to 	Consent Calendar",8,0,0,2,10
837618,532873,2016-04-06,Assembly,"Do pass, to Consent Calendar",18,0,0,2,20
837618,533398,2016-04-14,Assembly,"AB 1782 MAIENSCHEIN  Consent Calendar Second Day  Regular Session",76,0,0,4,80
837618,554469,2016-06-15,Senate,"Do pass, but re-refer to the Committee on Judiciary Recommend 	Consent",7,0,0,0,7
837618,556607,2016-06-28,Senate,"Do pass, but re-refer to the Committee on Appropriations",7,0,0,0,7
837618,558960,2016-08-01,Senate,"Placed on Appropriations Suspense file",7,0,0,0,7
837618,559677,2016-08-11,Senate,"Do pass",7,0,0,0,7
837618,560874,2016-08-23,Senate,"Assembly 3rd Reading AB1782 Maienschein By Jackson",39,0,0,0,39
837618,561458,2016-08-29,Assembly,"AB 1782 MAIENSCHEIN  Concurrence in Senate Amendments",79,0,0,1,80
837620,527918,2016-04-04,Senate,"Do pass, but re-refer to the Committee on Appropriations Recommend 	Consent",9,0,0,0,9
837620,534616,2016-04-18,Senate,"Do pass",7,0,0,0,7
837620,537172,2016-04-21,Senate,"Senate 3rd Reading SB952 Anderson",39,0,1,0,40
837620,552948,2016-06-14,Assembly,"Do pass and be re-referred to the Committee on Appropriations to 	Consent Calendar",16,0,0,0,16
837620,556719,2016-06-29,Assembly,"Do pass, to Consent Calendar",18,0,0,2,20
837620,559138,2016-08-04,Assembly,"SB 952 Anderson  Consent Calendar Second Day  Regular Session",77,0,0,3,80
837623,525817,2016-03-29,Senate,"Do pass, but re-refer to the Committee on Rules",10,0,1,0,11
837623,536911,2016-04-20,Senate,"Do pass as amended, and re-refer to the Committee on Appropriations",7,0,0,0,7
837626,532541,2016-04-13,Senate,"Do pass as amended, and re-refer to the Committee on Appropriations",6,0,1,0,7
837626,545370,2016-05-12,Senate,"Senate 3rd Reading SB957 Hueso",38,0,2,0,40
837626,557151,2016-06-29,Assembly,"Do pass and be re-referred to the Committee on Appropriations to 	Consent Calendar",9,0,0,0,9
837626,559015,2016-08-03,Assembly,"Do pass, to Consent Calendar",20,0,0,0,20
837626,559447,2016-08-11,Assembly,"SB 957 Hueso  Consent Calendar Second Day  Regular Session",78,0,0,2,80
837628,519206,2016-03-14,Assembly,"Do pass and be re-referred to the Committee on Appropriations",12,0,0,0,12
837628,532927,2016-04-06,Assembly,"Do pass, to Consent Calendar",18,0,0,2,20
837628,533407,2016-04-14,Assembly,"AB 1784 DABABNEH  Consent Calendar Second Day  Regular Session",76,0,0,4,80
837628,554526,2016-06-15,Senate,"Do pass, but re-refer to the Committee on Appropriations Recommend 	Consent",7,0,0,0,7
837628,559442,2016-08-11,Senate,"Consent Calendar 2nd AB1784 Dababneh",37,0,2,0,39
837628,559821,2016-08-15,Assembly,"AB 1784 DABABNEH  Concurrence in Senate Amendments",77,0,0,3,80
837632,530751,2016-04-11,Assembly,"Do pass and be re-referred to the Committee on Appropriations",9,0,0,0,9
837632,544878,2016-05-11,Assembly,"Do pass, to Consent Calendar",20,0,0,0,20
837632,547044,2016-05-19,Assembly,"AB 1789 SANTIAGO  Consent Calendar Second Day  Regular Session",76,0,0,4,80
837632,553481,2016-06-15,Senate,"Do pass, but re-refer to the Committee on Appropriations",6,0,1,0,7
837632,558894,2016-08-01,Senate,"Do pass",7,0,0,0,7
837632,559800,2016-08-15,Senate,"Assembly 3rd Reading AB1789 Santiago By Liu",38,0,1,0,39
837632,560531,2016-08-22,Assembly,"AB 1789 SANTIAGO  Concurrence in Senate Amendments",78,0,0,2,80
837635,544386,2016-05-09,Assembly,"Do pass as amended and be re-referred to the Committee on 	Appropriations",9,0,0,0,9
837643,526972,2016-03-31,Senate,"Senate 3rd Reading SR57 Nielsen",34,0,6,0,40
837647,530496,2016-04-11,Senate,"Do pass, but re-refer to the Committee on Judiciary",5,0,0,0,5
837647,535276,2016-04-19,Senate,"Do pass, but re-refer to the Committee on Appropriations",7,0,0,0,7
837647,549246,2016-05-27,Senate,"Do pass",7,0,0,0,7
837647,550157,2016-05-31,Senate,"Senate 3rd Reading SB950 Nielsen",39,0,1,0,40
837647,555045,2016-06-22,Assembly,"Do pass and be re-referred to the Committee on Judiciary",6,0,0,1,7
837647,556074,2016-06-28,Assembly,"Do pass as amended and be re-referred to the Committee on 	Appropriations",10,0,0,0,10
837647,559409,2016-08-11,Assembly,"Do pass",20,0,0,0,20
837647,560612,2016-08-22,Assembly,"SB 950 Nielsen  Senate Third Reading  By BONTA",75,1,0,4,80
837647,561485,2016-08-29,Senate,"Special Consent SB950 Nielsen",39,0,0,0,39
837654,516284,2016-03-08,Assembly,"Do pass as amended, to Consent Calendar",9,0,0,1,10
837654,521184,2016-03-17,Assembly,"AB 1796 WILK  Consent Calendar Second Day  Regular Session",65,0,0,14,79
837656,532189,2016-04-11,Assembly,"Do pass and be re-referred to the Committee on Appropriations",11,1,0,4,16
837656,544837,2016-05-11,Assembly,"Do pass",14,6,0,0,20
837656,549958,2016-05-31,Assembly,"AB 1785 QUIRK  Assembly Third Reading",48,22,0,10,80
837656,560040,2016-08-17,Senate,"Assembly 3rd Reading AB1785 Quirk By Beall",23,13,3,0,39
837656,560728,2016-08-23,Assembly,"AB 1785 QUIRK  Concurrence in Senate Amendments",52,20,0,8,80
837659,526271,2016-03-29,Assembly,"Do pass and be re-referred to the Committee on Appropriations to 	Consent Calendar",6,0,0,1,7
837659,532218,2016-04-13,Assembly,"Do pass, to Consent Calendar",20,0,0,0,20
837659,537134,2016-04-21,Assembly,"AB 1797 LACKEY  Consent Calendar Second Day  Regular Session",79,0,0,1,80
837659,552631,2016-06-14,Senate,"Do pass as amended, and re-refer to the Committee on Appropriations",4,0,1,0,5
837659,559837,2016-08-15,Senate,"Assembly 3rd Reading AB1797 Lackey By Mitchell",37,0,2,0,39
837659,560516,2016-08-22,Assembly,"AB 1797 LACKEY  Concurrence in Senate Amendments",79,0,0,1,80
837664,526261,2016-03-30,Senate,"Do pass as amended, and re-refer to the Committee on Public Safety",7,2,0,0,9
837664,534777,2016-04-19,Senate,"Do pass as amended, and re-refer to the Committee on Appropriations",5,2,0,0,7
837664,549029,2016-05-27,Senate,"Do pass",7,0,0,0,7
837664,549030,2016-05-27,Senate,"Set, first hearing.  Held in Committee.  Reconsideration of 	favorable vote granted",7,0,0,0,7
837664,549965,2016-05-31,Senate,"Senate 3rd Reading SB955 Beall",24,13,3,0,40
837664,555031,2016-06-21,Assembly,"Do pass as amended and be re-referred to the Committee on Public 	Safety",10,3,0,5,18
837664,555967,2016-06-28,Assembly,"Do pass and be re-referred to the Committee on Appropriations",6,1,0,0,7
837664,559024,2016-08-03,Assembly,"Do pass",14,6,0,0,20
837664,560462,2016-08-22,Assembly,"SB 955 Beall  Senate Third Reading  By JONES-SAWYER",50,24,0,6,80
837664,561543,2016-08-30,Senate,"Unfinished Business SB955 Beall Concurrence",27,12,0,0,39
837667,538626,2016-04-26,Assembly,"Do pass and be re-referred to the Committee on Judiciary to Consent 	Calendar",16,0,0,0,16
837667,541828,2016-05-03,Assembly,"Do pass as amended, to Consent Calendar",10,0,0,0,10
837667,545330,2016-05-12,Assembly,"AB 1793 HOLDEN  Consent Calendar Second Day  Regular Session",78,0,0,2,80
837667,551561,2016-06-06,Senate,"Do pass, but re-refer to the Committee on Judiciary Recommend 	Consent",8,0,1,0,9
837667,556458,2016-06-28,Senate,"Do pass as amended",7,0,0,0,7
837667,559363,2016-08-11,Senate,"Special Consent AB1793 Holden",37,0,2,0,39
837667,559852,2016-08-15,Assembly,"AB 1793 HOLDEN  Concurrence in Senate Amendments",78,0,0,2,80
837670,528114,2016-04-05,Assembly,"Do pass and be re-referred to the Committee on Veterans Affairs",13,0,0,0,13
837674,529355,2016-04-06,Assembly,"Do pass as amended and be re-referred to the Committee on 	Appropriations",7,0,0,0,7
837674,549407,2016-05-27,Assembly,"Do pass as amended",20,0,0,0,20
837674,551084,2016-06-02,Assembly,"AB 1783 DODD  Assembly Third Reading",79,0,0,1,80
837674,555114,2016-06-22,Senate,"Do pass, but re-refer to the Committee on Appropriations",9,0,0,0,9
837674,558703,2016-08-01,Senate,"Placed on Appropriations Suspense file",7,0,0,0,7
837674,559724,2016-08-11,Senate,"Do pass as amended",7,0,0,0,7
837674,560088,2016-08-17,Senate,"Assembly 3rd Reading AB1783 Dodd By Wolk",39,0,0,0,39
837674,561014,2016-08-24,Assembly,"AB 1783 DODD  Concurrence in Senate Amendments",80,0,0,0,80
837677,520168,2016-03-14,Assembly,"Do pass and be re-referred to the Committee on Appropriations",7,0,0,2,9
837677,530447,2016-04-11,Assembly,"AB 1787 GOMEZ  Assembly Third Reading",73,0,0,6,79
837677,532854,2016-04-06,Assembly,"Do pass",17,0,0,3,20
837677,552149,2016-06-08,Senate,"Do pass, but re-refer to the Committee on Appropriations",4,0,3,0,7
837677,556368,2016-06-29,Senate,"Do pass as amended, and re-refer to the Committee on Appropriations",6,0,1,0,7
837677,559890,2016-08-15,Senate,"Assembly 3rd Reading AB1787 Gomez By Nguyen",32,5,2,0,39
837677,561280,2016-08-25,Assembly,"Senate amendments be concurred in",9,0,0,0,9
837677,561667,2016-08-30,Assembly,"AB 1787 GOMEZ  Concurrence in Senate Amendments",69,9,0,2,80
837681,525584,2016-03-29,Assembly,"Do pass as amended and be re-referred to the Committee on 	Appropriations",10,5,0,0,15
837681,549434,2016-05-27,Assembly,"Do pass as amended",14,6,0,0,20
837681,550926,2016-06-02,Assembly,"AB 1792 WOOD  Assembly Third Reading",58,17,0,5,80
837681,556117,2016-06-28,Senate,"Do pass, but re-refer to the Committee on Appropriations Recommend 	Consent",8,0,1,0,9
837683,528893,2016-04-06,Senate,"Do pass, but re-refer to the Committee on Appropriations",5,1,1,0,7
837683,534627,2016-04-18,Senate,"Placed on Appropriations Suspense file",7,0,0,0,7
837683,549206,2016-05-27,Senate,"Do pass",5,2,0,0,7
837683,549917,2016-05-31,Senate,"Senate 3rd Reading SB953 Lara",26,11,3,0,40
837683,557055,2016-06-29,Assembly,"Do pass and be re-referred to the Committee on Appropriations",6,3,0,0,9
837683,559411,2016-08-11,Assembly,"Do pass as amended",14,6,0,0,20
837683,560175,2016-08-18,Assembly,"SB 953 Lara  Senate Third Reading  By GARCIA, C",78,0,0,2,80
837683,561285,2016-08-25,Senate,"Unfinished Business SB953 Lara Concurrence",37,2,0,0,39
837688,528775,2016-04-06,Assembly,"Do pass as amended and be re-referred to the Committee on 	Appropriations",8,0,0,1,9
837688,548963,2016-05-27,Assembly,"Do pass",20,0,0,0,20
837688,550560,2016-06-01,Assembly,"AB 1794 GARCIA, C.  Third Reading Urgency",50,0,0,30,80
837688,550907,2016-06-02,Assembly,"AB 1794 GARCIA, C.  Third Reading Urgency",78,0,0,2,80
837688,555124,2016-06-22,Senate,"Do pass, but re-refer to the Committee on Appropriations",5,1,1,0,7
837688,558943,2016-08-01,Senate,"Placed on Appropriations Suspense file",7,0,0,0,7
837688,559716,2016-08-11,Senate,"Do pass as amended",5,0,2,0,7
837688,560415,2016-08-19,Senate,"Assembly 3rd Reading AB1794 Cristina Garcia By Lara",31,4,4,0,39
837688,561044,2016-08-24,Assembly,"AB 1794 GARCIA, C.  Concurrence in Senate Amendments",80,0,0,0,80
837691,533460,2016-04-12,Assembly,"Amend, and do pass as amended and be re-referred to the Committee 	on Appropriations with the recommendation:  To Consent Calendar",7,0,0,0,7
837696,529015,2016-04-06,Assembly,"Do pass and be re-referred to the Committee on Appropriations to 	Consent Calendar",18,0,0,3,21
837696,536424,2016-04-20,Assembly,"Do pass, to Consent Calendar",16,0,0,4,20
837696,540256,2016-04-28,Assembly,"AB 1786 COOLEY  Consent Calendar Second Day  Regular Session",76,0,0,4,80
837696,552978,2016-06-14,Senate,"Do pass, but re-refer to the Committee on Appropriations Recommend 	Consent",12,0,1,0,13
837696,559456,2016-08-11,Senate,"Consent Calendar 2nd AB1786 Cooley",37,0,2,0,39
837699,528776,2016-04-06,Senate,"Do pass, but re-refer to the Committee on Appropriations",3,1,1,0,5
837699,537584,2016-04-21,Senate,"Senate 3rd Reading SB954 Hertzberg",28,11,1,0,40
837699,537585,2016-04-21,Senate,"Senate 3rd Reading SB954 Hertzberg Reconsider",39,0,1,0,40
837699,537586,2016-04-21,Senate,"Senate 3rd Reading SB954 Hertzberg",27,12,1,0,40
837699,555322,2016-06-22,Assembly,"Do pass and be re-referred to the Committee on Appropriations",6,1,0,0,7
837699,556401,2016-06-29,Assembly,"Do pass",12,5,0,3,20
837699,559159,2016-08-04,Assembly,"SB 954 Hertzberg  Senate Third Reading  By THURMOND",52,22,0,6,80
837699,559334,2016-08-11,Senate,"Unfinished Business SB954 Hertzberg Concurrence",23,12,4,0,39
837703,535720,2016-04-19,Assembly,"Do pass and be re-referred to the Committee on Rules to Consent 	Calendar",10,0,0,0,10
837703,541027,2016-05-02,Assembly,"Do pass and be re-referred to the Committee on Appropriations",11,0,0,0,11
837703,544902,2016-05-11,Assembly,"Do pass, to Consent Calendar",20,0,0,0,20
837703,547172,2016-05-19,Assembly,"AB 1788 MELENDEZ  Consent Calendar Second Day  Regular Session",76,0,0,4,80
837703,556407,2016-06-28,Senate,"Do pass, but re-refer to the Committee on Appropriations Recommend 	Consent",7,0,0,0,7
837703,558898,2016-08-01,Senate,"Placed on Appropriations Suspense file",7,0,0,0,7
837706,519755,2016-03-15,Assembly,"Do pass and be re-referred to the Committee on Appropriations",17,0,0,2,19
837706,549015,2016-05-27,Assembly,"Do pass as amended",15,4,0,1,20
837706,550842,2016-06-02,Assembly,"AB 1795 ATKINS  Assembly Third Reading",77,1,0,2,80
837706,553121,2016-06-15,Senate,"Do pass, but re-refer to the Committee on Appropriations",9,0,0,0,9
837706,558712,2016-08-01,Senate,"Placed on Appropriations Suspense file",7,0,0,0,7
837706,559572,2016-08-11,Senate,"Do pass as amended",5,0,2,0,7
837706,560033,2016-08-17,Senate,"Assembly 3rd Reading AB1795 Atkins By Pan",35,0,4,0,39
837706,561378,2016-08-29,Senate,"Assembly 3rd Reading AB1795 Atkins By Pan",39,0,0,0,39
837706,561574,2016-08-30,Assembly,"AB 1795 ATKINS  Concurrence in Senate Amendments",79,0,0,1,80
840584,520116,2016-03-15,Assembly,"Do pass, to Consent Calendar",7,0,0,0,7
840584,525101,2016-03-28,Assembly,"AB 1798 COOPER  Consent Calendar Second Day  Regular Session",74,0,0,5,79
840584,554840,2016-06-21,Senate,"Do pass",7,0,0,0,7
840584,559252,2016-08-11,Senate,"Special Consent AB1798 Cooper",37,0,2,0,39
840585,526460,2016-03-30,Senate,"Do pass and be placed on the Consent Calendar",7,0,0,0,7
840585,529582,2016-04-07,Senate,"Consent Calendar 2nd SB972 Committee On GOV. & F.(Hertzberg)",38,0,2,0,40
840585,542544,2016-05-04,Assembly,"Do pass, to Consent Calendar",9,0,0,0,9
840585,545252,2016-05-12,Assembly,"SB 972 GOV.& F.  Consent Calendar Second Day  Regular Session",78,0,0,2,80
840586,520130,2016-03-15,Assembly,"Do pass and be re-referred to the Committee on Appropriations",7,0,0,0,7
840588,533122,2016-04-14,Senate,"Senate 3rd Reading SCR107 Lara",37,0,3,0,40
840588,538113,2016-04-25,Assembly,"Be adopted, to Consent Calendar",9,0,0,2,11
840588,540019,2016-04-28,Assembly,"SCR 107 Lara  Consent Calendar Second Day  Regular Session",76,0,0,4,80
840590,526508,2016-03-30,Senate,"Do pass, but re-refer to the Committee on Appropriations",7,2,0,0,9
840590,544524,2016-04-25,Senate,"Placed on Appropriations Suspense file",7,0,0,0,7
840590,549225,2016-05-27,Senate,"Do pass as amended",5,2,0,0,7
840590,550691,2016-06-01,Senate,"Senate 3rd Reading SB959 Lara",24,14,2,0,40
840590,554885,2016-06-21,Assembly,"Do pass and be re-referred to the Committee on Accountability and 	Administrative Review",10,3,0,0,13
840590,556463,2016-06-29,Assembly,"Do pass and be re-referred to the Committee on Appropriations",6,2,0,1,9
840590,559469,2016-08-11,Assembly,"Do pass as amended",14,5,0,1,20
840590,560189,2016-08-18,Assembly,"SB 959 Lara  Senate Third Reading  By CHIU",52,25,0,3,80
840590,561650,2016-08-30,Senate,"Unfinished Business SB959 Lara Concurrence",25,14,0,0,39
840591,537101,2016-04-20,Senate,"Do pass as amended, and re-refer to the Committee on Appropriations",6,0,3,0,9
840591,547622,2016-05-23,Senate,"Placed on Appropriations Suspense file",7,0,0,0,7
840592,520153,2016-03-15,Assembly,"Do pass and be re-referred to the Committee on Appropriations",7,0,0,0,7
840592,532853,2016-04-06,Assembly,"Do pass, to Consent Calendar",18,0,0,2,20
840592,550049,2016-05-31,Assembly,"AB 1802 CHAVEZ  Assembly Third Reading",80,0,0,0,80
840592,556653,2016-06-28,Senate,"Do pass, but re-refer to the Committee on Appropriations",7,0,0,0,7
840594,519360,2016-03-14,Assembly,"Do pass and be re-referred to the Committee on Appropriations",16,0,0,0,16
840594,532727,2016-04-06,Assembly,"Do pass, to Consent Calendar",18,0,0,2,20
840594,533275,2016-04-14,Assembly,"AB 1813 FRAZIER  Consent Calendar Second Day  Regular Session",76,0,0,4,80
840594,552930,2016-06-14,Senate,"Do pass, but re-refer to the Committee on Appropriations Recommend 	Consent",11,0,0,0,11
840594,557053,2016-06-30,Senate,"Consent Calendar 2nd AB1813 Frazier",37,0,3,0,40
840596,519491,2016-03-14,Assembly,"Be adopted and re-referred to the Committee on Appropriations with 	recommendation:  To Consent Calendar",16,0,0,0,16
840596,530572,2016-04-11,Assembly,"ACR 135 DAHLE  Consent Calendar Second Day  Regular Session",77,0,0,2,79
840596,532856,2016-04-06,Assembly,"Be adopted, to Consent Calendar",18,0,0,2,20
840596,559313,2016-08-11,Senate,"Consent Calendar 2nd ACR135 Dahle",37,0,2,0,39
840598,534316,2016-04-18,Assembly,"Do pass and be re-referred to the Committee on Appropriations",5,9,0,2,16
840598,534317,2016-04-18,Assembly,"Reconsideration granted",15,0,0,1,16
840599,519601,2016-03-14,Assembly,"Be adopted and re-referred to the Committee on Appropriations with 	recommendation:  To Consent Calendar",16,0,0,0,16
840599,530454,2016-04-11,Assembly,"ACR 134 WILK  Consent Calendar Second Day  Regular Session",77,0,0,2,79
840599,532389,2016-04-06,Assembly,"Be adopted, to Consent Calendar",18,0,0,2,20
840599,559434,2016-08-11,Senate,"Consent Calendar 2nd ACR134 Wilk",37,0,2,0,39
840601,528305,2016-04-05,Senate,"Do pass, but re-refer to the Committee on Governance and Finance",4,1,0,0,5
840601,536908,2016-04-20,Senate,"Do pass as amended, and re-refer to the Committee on Appropriations",5,2,0,0,7
840601,549204,2016-05-27,Senate,"Do pass",5,2,0,0,7
840601,550116,2016-05-31,Senate,"Senate 3rd Reading SB958 Lara",26,11,3,0,40
840601,553278,2016-06-15,Assembly,"Do pass as amended and be re-referred to the Committee on Local 	Government",5,2,0,0,7
840601,556804,2016-06-29,Assembly,"Do pass and be re-referred to the Committee on Appropriations",6,3,0,0,9
840601,559415,2016-08-11,Assembly,"Do pass",14,6,0,0,20
840601,560128,2016-08-18,Assembly,"SB 958 Lara  Senate Third Reading  By SANTIAGO",47,29,0,4,80
840601,561522,2016-08-30,Senate,"Unfinished Business SB958 Lara Concurrence",26,12,1,0,39
840605,528678,2016-04-06,Senate,"Do pass and be placed on the Consent Calendar",7,0,0,0,7
840605,533110,2016-04-14,Senate,"Consent Calendar 2nd SB975 Committee On GOV. & F. (Hertzberg)",38,0,2,0,40
840605,553158,2016-06-15,Assembly,"Do pass, to Consent Calendar",9,0,0,0,9
840605,555291,2016-06-23,Assembly,"SB 975 GOV.& F.  Consent Calendar Second Day  Regular Session",79,0,0,1,80
840607,526238,2016-03-29,Assembly,"Do pass as amended and be re-referred to the Committee on 	Appropriations",5,1,0,1,7
840607,549464,2016-05-27,Assembly,"Do pass",14,6,0,0,20
840607,550914,2016-06-02,Assembly,"AB 1809 LOPEZ  Assembly Third Reading",52,28,0,0,80
840607,556422,2016-06-28,Senate,"Do pass, but re-refer to the Committee on Appropriations",4,1,0,0,5
840607,558846,2016-08-01,Senate,"Placed on Appropriations Suspense file",7,0,0,0,7
840609,526425,2016-03-30,Senate,"Do pass and be placed on the Consent Calendar",7,0,0,0,7
840609,529412,2016-04-07,Senate,"Consent Calendar 2nd SB971 Committee On GOV. & F.(Hertzberg)",38,0,2,0,40
840609,542892,2016-05-04,Assembly,"Do pass, to Consent Calendar",9,0,0,0,9
840609,545382,2016-05-12,Assembly,"SB 971 GOV.& F.  Consent Calendar Second Day  Regular Session",78,0,0,2,80
840611,536490,2016-04-20,Assembly,"Do pass as amended and be re-referred to the Committee on 	Appropriations",10,0,0,0,10
840611,549196,2016-05-27,Assembly,"Do pass",20,0,0,0,20
840611,549939,2016-05-31,Assembly,"AB 1826 STONE  Assembly Third Reading",77,0,0,3,80
840611,554673,2016-06-21,Senate,"Do pass, but re-refer to the Committee on Appropriations",5,0,0,0,5
840611,558742,2016-08-01,Senate,"Placed on Appropriations Suspense file",7,0,0,0,7
840611,559627,2016-08-11,Senate,"Do pass",7,0,0,0,7
840611,560054,2016-08-17,Senate,"Assembly 3rd Reading AB1826 Mark Stone By Monning",39,0,0,0,39
840611,560651,2016-08-23,Assembly,"AB 1826 STONE  Concurrence in Senate Amendments",76,1,0,3,80
840613,526583,2016-03-30,Senate,"Do pass and be placed on the Consent Calendar",7,0,0,0,7
840613,529433,2016-04-07,Senate,"Consent Calendar 2nd SB973 Committee On GOV. & F.(Hertzberg)",38,0,2,0,40
840613,542455,2016-05-04,Assembly,"Do pass, to Consent Calendar",9,0,0,0,9
840613,545437,2016-05-12,Assembly,"SB 973 GOV.& F.  Consent Calendar Second Day  Regular Session",78,0,0,2,80
840617,519826,2016-03-15,Assembly,"Do pass and be re-referred to the Committee on Appropriations to 	Consent Calendar",7,0,0,0,7
840617,532263,2016-04-06,Assembly,"Do pass, to Consent Calendar",18,0,0,2,20
840617,533151,2016-04-14,Assembly,"AB 1824 CHANG  Consent Calendar Second Day  Regular Session",76,0,0,4,80
840617,554708,2016-06-21,Senate,"Do pass, but re-refer to the Committee on Appropriations",7,0,0,0,7
840617,560159,2016-08-18,Senate,"Assembly 3rd Reading AB1824 Chang By Pavley",36,0,3,0,39
840617,560630,2016-08-23,Assembly,"AB 1824 CHANG  Concurrence in Senate Amendments",80,0,0,0,80
840618,539002,2016-04-27,Assembly,"Do pass as amended",7,0,0,0,7
840618,545306,2016-05-12,Assembly,,71,4,0,5,80
840618,552877,2016-06-14,Senate,"Do pass, but re-refer to the Committee on Judiciary",6,2,3,0,11
840620,526312,2016-03-30,Assembly,"Do pass and be re-referred to the Committee on Appropriations",8,1,0,1,10
840620,537045,2016-04-20,Assembly,"Do pass",14,2,0,4,20
840620,538091,2016-04-25,Assembly,"AB 1810 LEVINE  Assembly Third Reading",73,1,0,6,80
840620,554807,2016-06-21,Senate,"Do pass, but re-refer to the Committee on Appropriations",5,0,0,0,5
840620,560333,2016-08-18,Senate,"Assembly 3rd Reading AB1810 Levine By Galgiani",38,0,1,0,39
840620,560811,2016-08-23,Assembly,"AB 1810 LEVINE  Concurrence in Senate Amendments",80,0,0,0,80
840624,520107,2016-03-15,Assembly,"Do pass as amended and be re-referred to the Committee on Education",17,0,0,2,19
840624,544506,2016-04-19,Assembly,"Do pass and be re-referred to the Committee on Appropriations",13,0,0,0,13
840624,549463,2016-05-27,Assembly,"Do pass as amended",20,0,0,0,20
840624,550689,2016-06-01,Assembly,"AB 1823 BONILLA  Assembly Third Reading",80,0,0,0,80
840624,555273,2016-06-22,Senate,"Do pass, but re-refer to the Committee on Education Recommend 	Consent",9,0,0,0,9
840624,556471,2016-06-29,Senate,"Do pass as amended, and re-refer to the Committee on Appropriations",9,0,0,0,9
840624,559675,2016-08-11,Senate,"Do pass",7,0,0,0,7
840624,560879,2016-08-23,Senate,"Assembly 3rd Reading AB1823 Bonilla By Pan",39,0,0,0,39
840624,561494,2016-08-29,Assembly,"AB 1823 BONILLA  Concurrence in Senate Amendments",80,0,0,0,80
840629,527993,2016-04-04,Assembly,"Do pass as amended and be re-referred to the Committee on 	Appropriations",7,2,0,0,9
840632,526479,2016-03-30,Assembly,"Do pass and be re-referred to the Committee on Appropriations",9,0,0,1,10
840632,532964,2016-04-13,Assembly,"Do pass, to Consent Calendar",20,0,0,0,20
840632,537594,2016-04-21,Assembly,"AB 1811 DODD  Consent Calendar Second Day  Regular Session",79,0,0,1,80
840632,554844,2016-06-21,Senate,"Do pass, but re-refer to the Committee on Appropriations Recommend 	Consent",5,0,0,0,5
840632,559451,2016-08-11,Senate,"Consent Calendar 2nd AB1811 Dodd By Galgiani",37,0,2,0,39
840632,560061,2016-08-17,Assembly,"Senate amendments be concurred in",9,0,0,1,10
840632,560801,2016-08-23,Assembly,"AB 1811 DODD  Concurrence in Senate Amendments",78,0,0,2,80
840635,528340,2016-04-05,Senate,"Do pass, but re-refer to the Committee on Appropriations",5,0,0,0,5
840635,534637,2016-04-18,Senate,"Placed on Appropriations Suspense file",7,0,0,0,7
840636,536808,2016-04-20,Senate,"Do pass as amended, and re-refer to the Committee on Appropriations",7,0,0,0,7
840636,550276,2016-05-31,Senate,"Senate 3rd Reading SB970 Leyva",27,4,9,0,40
840636,559736,2016-08-10,Assembly,"Do pass",19,0,0,1,20
840636,559895,2016-06-27,Assembly,"Do pass as amended and be re-referred to the Committee on 	Appropriations",8,0,0,1,9
840636,560762,2016-08-23,Assembly,"SB 970 Leyva  Senate Third Reading  By WILLIAMS",77,0,0,3,80
840636,561803,2016-08-31,Senate,"Unfinished Business SB970 Leyva Concurrence",26,10,3,0,39
840637,539347,2016-04-27,Assembly,"Do pass",9,0,0,0,9
840637,543948,2016-05-09,Assembly,"AB 1825 GORDON  Assembly Third Reading",75,0,0,5,80
840637,554980,2016-06-21,Senate,"Do pass",7,0,0,0,7
840637,556794,2016-06-30,Senate,"Assembly 3rd Reading AB1825 Gordon By Leno",35,2,3,0,40
840641,525981,2016-03-29,Assembly,"Do pass as amended",14,0,0,2,16
840641,537487,2016-04-21,Assembly,"AB 1808 WOOD  Assembly Third Reading",74,1,0,5,80
840641,551428,2016-06-06,Senate,"Do pass, but re-refer to the Committee on Judiciary",7,0,2,0,9
840641,555131,2016-06-21,Senate,"Do pass, but re-refer to the Committee on Appropriations",7,0,0,0,7
840641,560313,2016-08-18,Senate,"Assembly 3rd Reading AB1808 Wood By Hill",37,1,1,0,39
840641,560853,2016-08-23,Assembly,"AB 1808 WOOD  Concurrence in Senate Amendments",77,2,0,1,80
840643,531243,2016-04-12,Assembly,"Do pass as amended and be re-referred to the Committee on 	Appropriations",16,0,0,0,16
840643,549131,2016-05-27,Assembly,"Do pass as amended",20,0,0,0,20
840643,550418,2016-06-01,Assembly,"AB 1807 BONTA  Assembly Third Reading",78,0,0,2,80
840643,555516,2016-06-27,Senate,"Do pass, but re-refer to the Committee on Appropriations",9,0,0,0,9
840643,558749,2016-08-01,Senate,"Placed on Appropriations Suspense file",7,0,0,0,7
840643,559538,2016-08-11,Senate,"Do pass as amended",7,0,0,0,7
840643,560771,2016-08-23,Senate,"Assembly 3rd Reading AB1807 Bonta By Wieckowski",39,0,0,0,39
840643,561431,2016-08-29,Assembly,"AB 1807 BONTA  Concurrence in Senate Amendments",78,0,0,2,80
840646,529343,2016-04-06,Senate,"Do pass as amended, and re-refer to the Committee on Appropriations",9,0,0,0,9
840646,543888,2016-05-09,Senate,"Senate 3rd Reading SB969 Nguyen",37,0,3,0,40
840646,553240,2016-06-14,Assembly,"Do pass as amended and be re-referred to the Committee on 	Appropriations",15,0,0,3,18
840646,556280,2016-06-29,Assembly,"Do pass, to Consent Calendar",18,0,0,2,20
840646,559104,2016-08-04,Assembly,"SB 969 Nguyen  Consent Calendar Second Day  Regular Session",77,0,0,3,80
840646,559263,2016-08-11,Senate,"Unfinished Business SB969 Nguyen Concurrence",35,0,4,0,39
840649,528883,2016-04-06,Senate,"Do pass, but re-refer to the Committee on Appropriations Recommend 	Consent",7,0,0,0,7
840649,537604,2016-04-21,Senate,"Consent Calendar 2nd SB974 Committee On GOV. & F.(Hertzberg)",39,0,1,0,40
840649,553175,2016-06-15,Assembly,"Do pass and be re-referred to the Committee on Appropriations to 	Consent Calendar",9,0,0,0,9
840649,556351,2016-06-29,Assembly,"Do pass, to Consent Calendar",18,0,0,2,20
840649,560129,2016-08-18,Assembly,"SB 974 GOV.& F.  Senate Third Reading  By EGGMAN",78,1,0,1,80
840649,561215,2016-08-25,Senate,"Special Consent SB974 GOV. & F. (Hertzberg)",39,0,0,0,39
840650,529031,2016-04-06,Assembly,"Do pass as amended",7,1,0,1,9
840650,533337,2016-04-14,Assembly,"AB 1817 STONE  Assembly Third Reading",53,16,0,11,80
840650,545054,2016-05-11,Senate,"Do pass",6,0,1,0,7
840650,548749,2016-05-26,Senate,"Assembly 3rd Reading AB1817 Mark Stone By Monning",28,8,4,0,40
840654,520152,2016-03-15,Assembly,"Do pass and be re-referred to the Committee on Appropriations to 	Consent Calendar",7,0,0,0,7
840656,519759,2016-03-15,Assembly,"Do pass and be re-referred to the Committee on Privacy and Consumer 	Protection",7,0,0,0,7
840656,534904,2016-04-19,Assembly,"Do pass and be re-referred to the Committee on Appropriations",4,6,0,1,11
840656,537204,2016-04-21,Assembly,"Do pass and be re-referred to the Committee on Appropriations",6,5,0,0,11
840656,542236,2016-05-04,Assembly,"Do pass",14,6,0,0,20
840656,547537,2016-05-23,Assembly,"AB 1820 QUIRK  Assembly Third Reading",43,25,0,12,80
840656,554660,2016-06-21,Senate,"Do pass, but re-refer to the Committee on Judiciary",5,2,0,0,7
840656,556259,2016-06-28,Senate,"Do pass, but re-refer to the Committee on Appropriations",0,7,0,0,7
840656,556260,2016-06-28,Senate,"Set, first hearing.  Failed passage in Committee.  Reconsideration 	granted",7,0,0,0,7
840657,528325,2016-04-05,Senate,"Do pass",4,3,0,0,7
840657,537977,2016-04-25,Senate,"Senate 3rd Reading SB966 Mitchell",18,16,6,0,40
840657,537978,2016-04-25,Senate,"Senate 3rd Reading SB966 Mitchell Reconsider",37,0,3,0,40
840657,550894,2016-06-02,Senate,"Senate 3rd Reading SB966 Mitchell",22,14,4,0,40
840657,555978,2016-06-28,Assembly,"Do pass",3,2,0,2,7
840660,525886,2016-03-29,Senate,"Do pass as amended, and re-refer to the Committee on Appropriations",9,0,2,0,11
840660,549234,2016-05-27,Senate,"Do pass as amended",7,0,0,0,7
840660,550710,2016-06-01,Senate,"Senate 3rd Reading SB968 Monning",36,0,4,0,40
840660,555110,2016-06-22,Assembly,"Amend, and do pass as amended and be re-referred to the Committee 	on Appropriations with the recommendation:  To Consent Calendar",15,0,0,0,15
840660,559398,2016-08-11,Assembly,"Do pass as amended",15,0,0,5,20
840660,561095,2016-08-24,Assembly,"SB 968 Monning  Third Reading Urgency  By ACHADJIAN",78,0,0,2,80
840660,561346,2016-08-26,Senate,"Unfinished Business SB968 Monning Urgency Clause Concurr",37,0,2,0,39
840661,536932,2016-04-20,Assembly,"Do pass as amended and be re-referred to the Committee on 	Appropriations",9,0,0,0,9
840661,543086,2016-05-05,Assembly,"AB 1816 DAHLE  Assembly Third Reading",77,0,0,3,80
840661,553409,2016-06-15,Senate,"Do pass",6,0,1,0,7
840661,559872,2016-08-15,Senate,"Assembly 3rd Reading AB1816 Dahle By Gaines",37,0,2,0,39
840661,560490,2016-08-22,Assembly,"AB 1816 DAHLE  Concurrence in Senate Amendments",79,0,0,1,80
840664,537618,2016-04-20,Assembly,"Do pass as amended and be re-referred to the Committee on 	Appropriations",14,0,0,1,15
843483,528096,2016-04-05,Assembly,"Do pass and be re-referred to the Committee on Governmental 	Organization",11,0,0,0,11
843483,536431,2016-04-20,Assembly,"Do pass and be re-referred to the Committee on Appropriations",21,0,0,0,21
843483,549055,2016-05-27,Assembly,"Do pass",20,0,0,0,20
843483,550071,2016-05-31,Assembly,"AB 1841 IRWIN  Assembly Third Reading",79,0,0,1,80
843483,552652,2016-06-14,Senate,"Do pass, but re-refer to the Committee on Judiciary",12,0,1,0,13
843483,556601,2016-06-28,Senate,"Do pass as amended, and re-refer to the Committee on Appropriations",7,0,0,0,7
843483,559673,2016-08-11,Senate,"Do pass as amended",7,0,0,0,7
843483,560775,2016-08-23,Senate,"Assembly 3rd Reading AB1841 Irwin By Jackson",39,0,0,0,39
843483,561454,2016-08-29,Assembly,"AB 1841 IRWIN  Concurrence in Senate Amendments",80,0,0,0,80
843491,528353,2016-04-05,Assembly,"Do pass and be re-referred to the Committee on Appropriations",7,0,0,0,7
843491,539132,2016-04-27,Assembly,"Do pass, to Consent Calendar",19,0,0,1,20
843491,545243,2016-05-12,Assembly,"AB 1848 CHIU  Assembly Third Reading",77,0,0,3,80
843491,554715,2016-06-21,Senate,"Do pass, but re-refer to the Committee on Appropriations",7,0,0,0,7
843491,558829,2016-08-01,Senate,"Placed on Appropriations Suspense file",7,0,0,0,7
843496,528099,2016-04-05,Assembly,"Do pass as amended and be re-referred to the Committee on Business 	and Professions",13,0,0,0,13
843496,535368,2016-04-19,Assembly,"Do pass as amended and be re-referred to the Committee on 	Appropriations",16,0,0,0,16
843496,545103,2016-05-11,Assembly,"Do pass, to Consent Calendar",20,0,0,0,20
843496,547086,2016-05-19,Assembly,"AB 1835 HOLDEN  Consent Calendar Second Day  Regular Session",76,0,0,4,80
843496,552528,2016-06-13,Senate,"Do pass, but re-refer to the Committee on Education",8,0,1,0,9
843496,556650,2016-06-29,Senate,"Do pass, but re-refer to the Committee on Appropriations",9,0,0,0,9
843496,559828,2016-08-15,Senate,"Assembly 3rd Reading AB1835 Holden By Wieckowski",38,0,1,0,39
843500,528006,2016-04-04,Assembly,"Amend, and do pass as amended and be re-referred to the Committee 	on Appropriations with the recommendation:  To Consent Calendar",9,0,0,0,9
843500,549157,2016-05-27,Assembly,"Do pass",20,0,0,0,20
843500,549929,2016-05-31,Assembly,"AB 1847 STONE  Assembly Third Reading",79,0,0,1,80
843500,555003,2016-06-22,Senate,"Do pass, but re-refer to the Committee on Appropriations",5,0,2,0,7
843500,558784,2016-08-01,Senate,"Placed on Appropriations Suspense file",7,0,0,0,7
843500,559619,2016-08-11,Senate,"Do pass",7,0,0,0,7
843500,559932,2016-08-16,Senate,"Assembly 3rd Reading AB1847 Mark Stone By Nguyen",38,0,1,0,39
843505,532465,2016-04-12,Assembly,"Do pass and be re-referred to the Committee on Education",12,0,0,1,13
843505,537220,2016-04-20,Assembly,"Do pass as amended and be re-referred to the Committee on 	Appropriations",6,0,0,1,7
843505,549406,2016-05-27,Assembly,"Do pass as amended",18,0,0,2,20
843505,550473,2016-06-01,Assembly,"AB 1846 LOPEZ  Assembly Third Reading",78,1,0,1,80
843505,553222,2016-06-15,Senate,"Do pass as amended, and re-refer to the Committee on Appropriations",8,1,0,0,9
843505,558948,2016-08-01,Senate,"Placed on Appropriations Suspense file",7,0,0,0,7
843509,527943,2016-04-05,Assembly,"Do pass and be re-referred to the Committee on Appropriations to 	Consent Calendar",7,0,0,0,7
843509,532242,2016-04-13,Assembly,"Do pass, to Consent Calendar",20,0,0,0,20
843509,537105,2016-04-21,Assembly,"AB 1829 LEVINE  Consent Calendar Second Day  Regular Session",79,0,0,1,80
843509,552714,2016-06-14,Senate,"Do pass, but re-refer to the Committee on Appropriations Recommend 	Consent",7,0,0,0,7
843509,556789,2016-06-30,Senate,"Consent Calendar 2nd AB1829 Levine",37,0,3,0,40
843513,525958,2016-03-29,Assembly,"Do pass and be re-referred to the Committee on Appropriations",15,0,0,0,15
843513,532648,2016-04-13,Assembly,"Do pass, to Consent Calendar",20,0,0,0,20
843513,537146,2016-04-21,Assembly,"AB 1845 DAHLE  Consent Calendar Second Day  Regular Session",79,0,0,1,80
843513,552941,2016-06-14,Senate,"Do pass as amended, but re-refer to the Committee on Appropriations 	Recommend Consent",9,0,0,0,9
843513,559842,2016-08-15,Senate,"Assembly 3rd Reading AB1845 Dahle By Gaines",38,0,1,0,39
843513,560476,2016-08-22,Assembly,"AB 1845 DAHLE  Concurrence in Senate Amendments",79,0,0,1,80
843518,527839,2016-04-04,Assembly,"Do pass and be re-referred to the Committee on Natural Resources",15,0,0,1,16
843518,534829,2016-04-18,Assembly,"Do pass as amended and be re-referred to the Committee on 	Appropriations",8,1,0,0,9
843522,535453,2016-04-19,Assembly,"Do pass and be re-referred to the Committee on Appropriations",17,0,0,2,19
843522,549312,2016-05-27,Assembly,"Do pass",14,4,0,2,20
843522,550713,2016-06-01,Assembly,"AB 1831 LOW  Assembly Third Reading",71,8,0,1,80
843522,555350,2016-06-22,Senate,"Do pass, but re-refer to the Committee on Appropriations",9,0,0,0,9
843522,558861,2016-08-01,Senate,"Placed on Appropriations Suspense file",7,0,0,0,7
843522,559591,2016-08-11,Senate,"Do pass as amended",7,0,0,0,7
843522,560063,2016-08-17,Senate,"Assembly 3rd Reading AB1831 Low By Hernandez",37,0,2,0,39
843522,560846,2016-08-23,Assembly,"AB 1831 LOW  Concurrence in Senate Amendments",80,0,0,0,80
843527,527964,2016-04-05,Assembly,"Do pass and be re-referred to the Committee on Appropriations",7,2,0,10,19
843527,532306,2016-04-05,Assembly,"Reconsideration granted",18,0,0,1,19
843531,544283,2016-04-19,Assembly,"Do pass and be re-referred to the Committee on Appropriations",11,2,0,0,13
843531,549095,2016-05-27,Assembly,"Do pass",20,0,0,0,20
843531,550019,2016-05-31,Assembly,"AB 1837 LOW  Assembly Third Reading",74,6,0,0,80
843531,553118,2016-06-15,Senate,"Do pass, but re-refer to the Committee on Governmental Organization",9,0,0,0,9
843531,558815,2016-08-01,Senate,"Placed on Appropriations Suspense file",7,0,0,0,7
843536,526226,2016-03-29,Assembly,"Do pass and be re-referred to the Committee on Appropriations to 	Consent Calendar",6,0,0,1,7
843536,532473,2016-04-13,Assembly,"Do pass, to Consent Calendar",20,0,0,0,20
843536,537310,2016-04-21,Assembly,"AB 1849 GIPSON  Consent Calendar Second Day  Regular Session",79,0,0,1,80
843536,552943,2016-06-14,Senate,"Do pass as amended, and re-refer to the Committee on Appropriations",4,0,1,0,5
843536,558902,2016-08-01,Senate,"Do pass",7,0,0,0,7
843536,560588,2016-08-22,Senate,"Assembly 3rd Reading AB1849 Gipson By Hancock",39,0,0,0,39
843536,561183,2016-08-25,Assembly,"AB 1849 GIPSON  Concurrence in Senate Amendments",79,0,0,1,80
843539,529385,2016-04-06,Assembly,"Do pass and be re-referred to the Committee on Appropriations",5,2,0,0,7
843539,532186,2016-04-13,Assembly,"Do pass",14,6,0,0,20
843539,537966,2016-04-25,Assembly,"AB 1843 STONE  Assembly Third Reading",48,28,0,4,80
843539,554987,2016-06-22,Senate,"Do pass, but re-refer to the Committee on Appropriations",4,1,0,0,5
843539,560115,2016-08-18,Senate,"Assembly 3rd Reading AB1843 Mark Stone By Leno",17,13,9,0,39
843539,560116,2016-08-18,Senate,"Assembly 3rd Reading AB1843 Mark Stone By Leno",36,0,3,0,39
843539,560487,2016-08-22,Senate,"Assembly 3rd Reading AB1843 Mark Stone By Leno",21,14,4,0,39
843539,561204,2016-08-25,Assembly,"AB 1843 STONE  Concurrence in Senate Amendments",41,36,0,3,80
843543,519781,2016-03-15,Assembly,"Do pass and be re-referred to the Committee on Judiciary",15,0,0,4,19
843543,525593,2016-03-29,Assembly,"Do pass and be re-referred to the Committee on Appropriations",10,0,0,0,10
843543,549186,2016-05-27,Assembly,"Do pass",20,0,0,0,20
843543,550472,2016-06-01,Assembly,"AB 1836 MAIENSCHEIN  Assembly Third Reading",80,0,0,0,80
843543,556366,2016-06-28,Senate,"Do pass as amended, and re-refer to the Committee on Appropriations",7,0,0,0,7
843543,559570,2016-08-11,Senate,"Do pass",7,0,0,0,7
843543,561354,2016-08-29,Senate,"Assembly 3rd Reading AB1836 Maienschein By Hertzberg",39,0,0,0,39
843543,561539,2016-08-30,Assembly,"AB 1836 MAIENSCHEIN  Concurrence in Senate Amendments",79,0,0,1,80
843548,532381,2016-04-13,Assembly,"Do pass as amended and be re-referred to the Committee on 	Appropriations",4,3,0,0,7
843557,525872,2016-03-29,Assembly,"Do pass and be re-referred to the Committee on Veterans Affairs",11,2,0,2,15
843557,532793,2016-04-12,Assembly,"Do pass and be re-referred to the Committee on Appropriations",9,0,0,0,9
843557,549058,2016-05-27,Assembly,"Do pass as amended",20,0,0,0,20
843557,550385,2016-06-01,Assembly,"AB 1844 GALLAGHER  Assembly Third Reading",78,2,0,0,80
843557,555982,2016-06-28,Senate,"Do pass, but re-refer to the Committee on Appropriations",8,0,1,0,9
843557,558814,2016-08-01,Senate,"Placed on Appropriations Suspense file",7,0,0,0,7
843561,526229,2016-03-29,Assembly,"Do pass and be re-referred to the Committee on Appropriations",6,0,0,1,7
843561,549437,2016-05-27,Assembly,"Do pass as amended",20,0,0,0,20
843561,550578,2016-06-01,Assembly,"AB 1838 TING  Assembly Third Reading",80,0,0,0,80
843561,556449,2016-06-28,Senate,"Do pass, but re-refer to the Committee on Appropriations",5,0,0,0,5
843561,558845,2016-08-01,Senate,"Placed on Appropriations Suspense file",7,0,0,0,7
843561,559732,2016-08-11,Senate,"Do pass",7,0,0,0,7
843561,560208,2016-08-18,Senate,"Assembly 3rd Reading AB1838 Ting By Mitchell",36,0,3,0,39
843561,561066,2016-08-24,Assembly,"AB 1838 TING  Concurrence in Senate Amendments",80,0,0,0,80
843570,525554,2016-03-29,Assembly,"Do pass and be re-referred to the Committee on Appropriations",13,0,0,2,15
843570,544866,2016-05-11,Assembly,"Do pass",15,1,0,4,20
843570,550411,2016-06-01,Assembly,"AB 1842 LEVINE  Assembly Third Reading",66,7,0,7,80
843570,556293,2016-06-29,Senate,"Do pass as amended, and re-refer to the Committee on Appropriations",5,1,1,0,7
843570,559797,2016-08-15,Senate,"Assembly 3rd Reading AB1842 Levine By Pavley",26,11,2,0,39
843570,560457,2016-08-22,Assembly,"AB 1842 LEVINE  Concurrence in Senate Amendments",61,17,0,2,80
843577,533355,2016-04-14,Assembly,"Be referred to Committee on Labor and Employment",11,0,0,0,11
843577,537222,2016-04-20,Assembly,"Do pass and be re-referred to the Committee on Appropriations",5,0,0,2,7
843577,545064,2016-05-11,Assembly,"Do pass",15,5,0,0,20
843577,547088,2016-05-19,Assembly,"AB 1840 GIPSON  Assembly Third Reading",55,18,0,7,80
843577,556548,2016-06-29,Senate,"Do pass, but re-refer to the Committee on Appropriations",4,1,0,0,5
843577,559801,2016-08-15,Senate,"Assembly 3rd Reading AB1840 Gipson By Mendoza",27,10,2,0,39
843577,561050,2016-08-24,Assembly,"AB 1840 GIPSON  Concurrence in Senate Amendments",59,18,0,3,80
845105,533411,2016-04-13,Senate,"Do pass as amended, and re-refer to the Committee on Appropriations",9,0,0,0,9
845105,548641,2016-05-26,Senate,"Senate 3rd Reading SB977 Pan",33,5,2,0,40
845105,554739,2016-06-21,Assembly,"Do pass and be re-referred to the Committee on Appropriations",6,1,0,0,7
845105,556430,2016-06-29,Assembly,"Do pass",13,5,0,2,20
845105,560306,2016-08-18,Assembly,"SB 977 Pan  Senate Third Reading  By COOPER",61,18,0,1,80
845105,561167,2016-08-25,Senate,"Unfinished Business SB977 Pan Concurrence",32,6,1,0,39
845106,528065,2016-04-05,Assembly,"Do pass and be re-referred to the Committee on Appropriations to 	Consent Calendar",16,0,0,0,16
845106,536310,2016-04-20,Assembly,"Do pass, to Consent Calendar",16,0,0,4,20
845106,539991,2016-04-28,Assembly,"AB 1874 WOOD  Consent Calendar Second Day  Regular Session",76,0,0,4,80
845106,554689,2016-06-20,Senate,"Do pass, but re-refer to the Committee on Appropriations Recommend 	Consent",9,0,0,0,9
845106,559385,2016-08-11,Senate,"Consent Calendar 2nd AB1874 Wood",37,0,2,0,39
845106,559893,2016-08-15,Assembly,"AB 1874 WOOD  Concurrence in Senate Amendments",77,0,0,3,80
845107,534897,2016-04-19,Senate,"Do pass, but re-refer to the Committee on Appropriations",11,0,0,0,11
845107,543804,2016-05-09,Senate,"Senate 3rd Reading SB998 Wieckowski",35,0,5,0,40
845107,555529,2016-06-27,Assembly,"Do pass and be re-referred to the Committee on Appropriations to 	Consent Calendar",15,0,0,1,16
845107,558996,2016-08-03,Assembly,"Do pass, to Consent Calendar",20,0,0,0,20
845107,560226,2016-08-18,Assembly,"SB 998 Wieckowski  Senate Third Reading  By LOW",79,0,0,1,80
845107,561159,2016-08-25,Senate,"Special Consent SB998 Wieckowski",39,0,0,0,39
845111,525581,2016-03-29,Assembly,"Do pass and be re-referred to the Committee on Appropriations",18,0,0,1,19
845111,549105,2016-05-27,Assembly,"Do pass as amended",19,0,0,1,20
845111,550441,2016-06-01,Assembly,"AB 1863 WOOD  Assembly Third Reading",78,1,0,1,80
845111,555290,2016-06-22,Senate,"Do pass, but re-refer to the Committee on Appropriations",9,0,0,0,9
845111,558756,2016-08-01,Senate,"Placed on Appropriations Suspense file",7,0,0,0,7
845111,559537,2016-08-11,Senate,"Do pass",7,0,0,0,7
845111,560520,2016-08-22,Senate,"Assembly 3rd Reading AB1863 Wood By Mitchell",39,0,0,0,39
845111,561130,2016-08-25,Assembly,"AB 1863 WOOD  Concurrence in Senate Amendments",78,0,0,2,80
845112,532401,2016-04-12,Senate,"Do pass as amended, and re-refer to the Committee on Appropriations",4,0,1,0,5
845112,549213,2016-05-27,Senate,"Do pass as amended",6,0,1,0,7
845112,550657,2016-06-01,Senate,"Senate 3rd Reading SB982 McGuire",38,0,2,0,40
845112,556184,2016-06-28,Assembly,"Do pass and be re-referred to the Committee on Appropriations",7,0,0,0,7
845112,559423,2016-08-11,Assembly,"Do pass as amended",20,0,0,0,20
845112,560707,2016-08-23,Assembly,"SB 982 McGuire  Senate Third Reading  By DODD",79,0,0,1,80
845112,561261,2016-08-25,Senate,"Unfinished Business SB982 McGuire Concurrence",39,0,0,0,39
845116,525939,2016-03-29,Senate,"Do pass, but re-refer to the Committee on Public Safety",11,0,0,0,11
845116,534339,2016-04-18,Senate,"Placed on Appropriations Suspense file",7,0,0,0,7
845116,549310,2016-05-27,Senate,"Do pass",7,0,0,0,7
845116,550055,2016-05-31,Senate,"Senate 3rd Reading SB986 Hill",39,0,1,0,40
845116,555630,2016-06-27,Assembly,"Do pass and be re-referred to the Committee on Appropriations",15,0,0,1,16
845117,519722,2016-03-15,Assembly,"Do pass and be re-referred to the Committee on Elections and 	Redistricting",7,0,0,0,7
845117,532195,2016-04-13,Assembly,"Do pass and be re-referred to the Committee on Appropriations",6,1,0,0,7
845117,549088,2016-05-27,Assembly,"Do pass",20,0,0,0,20
845117,549972,2016-05-31,Assembly,"AB 1869 MELENDEZ  Assembly Third Reading",79,0,0,1,80
845117,554981,2016-06-21,Senate,"Do pass, but re-refer to the Committee on Appropriations",7,0,0,0,7
845117,554982,2016-06-21,Senate,"Set, first hearing.  Held in Committee.  Reconsideration of 	favorable vote granted",7,0,0,0,7
845117,555520,2016-06-27,Senate,"Placed on Appropriations Suspense file",6,0,1,0,7
845119,528827,2016-04-06,Senate,"Do pass as amended, and re-refer to the Committee on Environmental 	Quality",5,1,1,0,7
845119,536465,2016-04-20,Senate,"Do pass, but re-refer to the Committee on Appropriations",5,2,0,0,7
845119,549002,2016-05-27,Senate,"Do pass",5,2,0,0,7
845119,550373,2016-06-01,Senate,"Senate 3rd Reading SB1000 Leyva",24,15,1,0,40
845119,556756,2016-06-29,Assembly,"Do pass and be re-referred to the Committee on Appropriations",6,3,0,0,9
845119,559557,2016-08-10,Assembly,"Do pass",14,5,0,1,20
845119,561770,2016-08-31,Assembly,"SB 1000 Leyva  Senate Third Reading  By MEDINA",47,28,0,5,80
845119,561771,2016-08-31,Senate,"Unfinished Business (S upplemental File 3)SB1 000 Ley va Con",25,13,1,0,39
845123,520114,2016-03-15,Assembly,"Do pass and be re-referred to the Committee on Appropriations to 	Consent Calendar",7,0,0,0,7
845124,532439,2016-04-11,Assembly,"Do pass and be re-referred to the Committee on Water, Parks and 	Wildlife",5,11,0,0,16
845124,532440,2016-04-11,Assembly,"Reconsideration granted",16,0,0,0,16
845125,529352,2016-04-06,Assembly,"Do pass and be re-referred to the Committee on Appropriations",5,2,0,0,7
845125,548376,2016-05-25,Assembly,"Do pass",14,6,0,0,20
845125,550217,2016-05-31,Assembly,"AB 1876 LOPEZ  Assembly Third Reading",53,27,0,0,80
845127,526759,2016-03-31,Assembly,"Be referred to Committee on Accountability and Administrative 	Review",8,0,0,3,11
845127,532413,2016-04-12,Assembly,"Do pass and be re-referred to the Committee on Appropriations",9,0,0,0,9
845127,538998,2016-04-27,Assembly,"Do pass, to Consent Calendar",19,0,0,1,20
845127,542999,2016-05-05,Assembly,"AB 1880 IRWIN  Consent Calendar Second Day  Regular Session",79,0,0,1,80
845127,552651,2016-06-14,Senate,"Do pass, but re-refer to the Committee on Appropriations Recommend 	Consent",12,0,1,0,13
845129,535367,2016-04-19,Assembly,"Do pass and be re-referred to the Committee on Appropriations",6,1,0,0,7
845132,537478,2016-04-20,Assembly,"Do pass and be re-referred to the Committee on Appropriations",5,0,0,2,7
845132,549405,2016-05-27,Assembly,"Do pass as amended",14,5,0,1,20
845132,551053,2016-06-02,Assembly,"AB 1872 GRAY  Assembly Third Reading",61,7,0,12,80
845134,528645,2016-04-06,Senate,"Do pass, but re-refer to the Committee on Appropriations",5,1,1,0,7
845134,534140,2016-04-18,Senate,"Placed on Appropriations Suspense file",7,0,0,0,7
845134,549077,2016-05-27,Senate,"Do pass as amended",5,2,0,0,7
845134,550369,2016-06-01,Senate,"Senate 3rd Reading SB987 McGuire",27,10,3,0,40
845134,554621,2016-06-20,Assembly,"Do pass as amended and be re-referred to the Committee on 	Appropriations",4,5,0,0,9
845138,535661,2016-04-19,Senate,"Do pass as amended, and re-refer to the Committee on Appropriations",5,0,0,0,5
845138,549298,2016-05-27,Senate,"Do pass, but re-refer to the Committee on Rules",7,0,0,0,7
845139,531674,2016-04-12,Assembly,"Do pass as amended and be re-referred to the Committee on 	Appropriations",15,0,0,1,16
845139,545014,2016-05-11,Assembly,"Do pass, to Consent Calendar",20,0,0,0,20
845139,547061,2016-05-19,Assembly,"AB 1859 GALLAGHER  Consent Calendar Second Day  Regular Session",76,0,0,4,80
845139,555581,2016-06-27,Senate,"Do pass, but re-refer to the Committee on Appropriations",9,0,0,0,9
845139,560862,2016-08-23,Senate,"Assembly 3rd Reading AB1859 Gallagher By Bates",39,0,0,0,39
845139,561499,2016-08-29,Assembly,"AB 1859 GALLAGHER  Concurrence in Senate Amendments",79,0,0,1,80
845143,535409,2016-04-19,Assembly,"Do pass and be re-referred to the Committee on Appropriations to 	Consent Calendar",11,0,0,0,11
845144,526227,2016-03-30,Senate,"Do pass as amended, and re-refer to the Committee on Appropriations",7,2,0,0,9
845144,544323,2016-04-25,Senate,"Placed on Appropriations Suspense file",7,0,0,0,7
845145,504293,2016-02-22,Senate,"Senate 3rd Reading SR58 Cannella",35,0,5,0,40
845147,535607,2016-04-19,Assembly,"Do pass and be re-referred to the Committee on Appropriations to 	Consent Calendar",7,0,0,0,7
845147,542860,2016-05-04,Assembly,"Do pass, to Consent Calendar",20,0,0,0,20
845147,545239,2016-05-12,Assembly,"AB 1864 COOLEY  Consent Calendar Second Day  Regular Session",78,0,0,2,80
845147,552903,2016-06-14,Senate,"Do pass, but re-refer to the Committee on Appropriations",7,0,0,0,7
845147,560328,2016-08-18,Senate,"Assembly 3rd Reading AB1864 Cooley By Gaines",38,0,1,0,39
845147,560889,2016-08-23,Assembly,"AB 1864 COOLEY  Concurrence in Senate Amendments",80,0,0,0,80
845149,532184,2016-04-11,Assembly,"Do pass as amended and be re-referred to the Committee on Revenue 	and Taxation",10,5,0,1,16
845149,534826,2016-04-18,Assembly,"Do pass and be re-referred to the Committee on Appropriations",6,3,0,0,9
845151,525891,2016-03-29,Senate,"Do pass, but re-refer to the Committee on Environmental Quality",9,0,0,0,9
845151,536903,2016-04-20,Senate,"Do pass, but re-refer to the Committee on Appropriations Recommend 	Consent",7,0,0,0,7
845151,549211,2016-05-27,Senate,"Do pass as amended",6,1,0,0,7
845151,550397,2016-06-01,Senate,"Senate 3rd Reading SB995 Pavley",39,0,1,0,40
845151,556090,2016-06-28,Assembly,"Do pass and be re-referred to the Committee on Appropriations to 	Consent Calendar",7,0,0,0,7
845152,536623,2016-04-20,Assembly,"Do pass and be re-referred to the Committee on Appropriations to 	Consent Calendar",7,0,0,0,7
845152,539103,2016-04-27,Assembly,"Do pass, to Consent Calendar",19,0,0,1,20
845152,543100,2016-05-05,Assembly,"AB 1875 CHAVEZ  Consent Calendar Second Day  Regular Session",79,0,0,1,80
845152,552541,2016-06-13,Senate,"Do pass, but re-refer to the Committee on Appropriations Recommend 	Consent",5,0,0,0,5
845152,559667,2016-08-11,Senate,"Placed on Appropriations Suspense file",7,0,0,0,7
845152,559668,2016-08-11,Senate,"Do pass",7,0,0,0,7
845152,560428,2016-08-19,Senate,"Assembly 3rd Reading AB1875 Ch",37,0,2,0,39
845154,526209,2016-03-29,Assembly,"Do pass and be re-referred to the Committee on Judiciary",6,0,0,1,7
845154,531620,2016-04-12,Assembly,"Amend, and do pass as amended and be re-referred to the Committee 	on Appropriations with the recommendation:  To Consent Calendar",10,0,0,0,10
845156,527862,2016-04-04,Assembly,"Do pass and be re-referred to the Committee on Appropriations to 	Consent Calendar",16,0,0,0,16
845156,549160,2016-05-27,Assembly,"Do pass as amended",20,0,0,0,20
845156,550649,2016-06-01,Assembly,"AB 1858 SANTIAGO  Assembly Third Reading",78,0,0,2,80
845156,558850,2016-08-01,Senate,"Placed on Appropriations Suspense file",7,0,0,0,7
845156,559730,2016-08-11,Senate,"Do pass as amended",7,0,0,0,7
845156,560084,2016-08-17,Senate,"Assembly 3rd Reading AB1858 Santiago By Bates",39,0,0,0,39
845156,560875,2016-08-23,Assembly,"AB 1858 SANTIAGO  Concurrence in Senate Amendments",80,0,0,0,80
845157,538933,2016-04-26,Senate,"Do pass as amended, but re-refer to the Committee on Rules 	Recommend Consent",7,0,0,0,7
845157,548645,2016-05-26,Senate,"Senate 3rd Reading SB983 Morrell",39,0,1,0,40
845157,554651,2016-06-21,Assembly,"Do pass",10,0,0,0,10
845157,559108,2016-08-04,Assembly,"SB 983 Morrell  Senate Third Reading  By WAGNER",75,1,0,4,80
845159,542808,2016-05-04,Assembly,"Do pass",1,5,0,1,7
845162,527662,2016-04-04,Senate,"Do pass, but re-refer to the Committee on Health",7,0,2,0,9
845162,533247,2016-04-13,Senate,"Do pass as amended, and re-refer to the Committee on Appropriations",7,1,1,0,9
845162,545892,2016-05-16,Senate,"Do pass",5,1,1,0,7
845162,547568,2016-05-23,Senate,"Senate 3rd Reading SB999 Pavley",29,6,5,0,40
845162,553157,2016-06-14,Assembly,"Do pass and be re-referred to the Committee on Business and 	Professions",13,0,0,5,18
845162,555941,2016-06-28,Assembly,"Do pass and be re-referred to the Committee on Appropriations",13,2,0,1,16
845162,559012,2016-08-03,Assembly,"Do pass",15,3,0,2,20
845162,560351,2016-08-19,Assembly,"SB 999 Pavley  Senate Third Reading  Amendment  Set #1",73,0,0,7,80
845162,560926,2016-08-24,Assembly,"SB 999 Pavley  Senate Third Reading  By GONZALEZ",68,8,0,4,80
845162,561317,2016-08-26,Senate,"Unfinished Business SB999 Pavley Concurrence",30,6,3,0,39
845164,532313,2016-04-13,Assembly,"Do pass as amended and be re-referred to the Committee on 	Appropriations",7,2,0,0,9
845170,529348,2016-04-06,Assembly,"Do pass and be re-referred to the Committee on Judiciary to Consent 	Calendar",7,0,0,0,7
845170,531557,2016-04-12,Assembly,"Do pass and be re-referred to the Committee on Appropriations to 	Consent Calendar",10,0,0,0,10
845170,539003,2016-04-27,Assembly,"Do pass as amended, to Consent Calendar",19,0,0,1,20
845170,543017,2016-05-05,Assembly,"AB 1850 GARCIA, E.  Consent Calendar Second Day  Regular Session",79,0,0,1,80
845170,552044,2016-06-08,Senate,"Do pass, but re-refer to the Committee on Appropriations Recommend 	Consent",9,0,0,0,9
845170,556813,2016-06-30,Senate,"Consent Calendar 2nd AB1850 Eduardo Garcia",37,0,3,0,40
845171,528797,2016-04-06,Senate,"Do pass, but re-refer to the Committee on Judiciary",6,1,0,0,7
845171,535614,2016-04-19,Senate,"Do pass, but re-refer to the Committee on Appropriations",7,0,0,0,7
845171,549307,2016-05-27,Senate,"Do pass as amended",7,0,0,0,7
845171,550660,2016-06-01,Senate,"Senate 3rd Reading SB984 Hueso",39,0,1,0,40
845171,556188,2016-06-27,Assembly,"Do pass as amended and be re-referred to the Committee on 	Appropriations",12,0,0,0,12
845171,559507,2016-08-11,Assembly,"Do pass as amended",20,0,0,0,20
845171,560291,2016-08-18,Assembly,"SB 984 Hueso  Senate Third Reading  By ALEJO",77,0,0,3,80
845171,561233,2016-08-25,Senate,"Special Consent SB984 Hueso",39,0,0,0,39
845173,520389,2016-03-16,Senate,"Do pass as amended, and re-refer to the Committee on Public Safety",7,2,0,0,9
845173,534805,2016-04-19,Senate,"Do pass, but re-refer to the Committee on Appropriations",5,2,0,0,7
845173,545803,2016-05-16,Senate,"Placed on Appropriations Suspense file",2,4,1,0,7
845173,545804,2016-05-16,Senate,"Do pass",5,2,0,0,7
845173,547032,2016-05-19,Senate,"Senate 3rd Reading SB1006 Wolk",24,14,2,0,40
845180,528095,2016-04-05,Senate,"Do pass, but re-refer to the Committee on Rules",5,1,1,0,7
845180,532396,2016-04-13,Senate,"Do pass, but re-refer to the Committee on Appropriations",4,1,0,0,5
845180,544282,2016-04-25,Senate,"Placed on Appropriations Suspense file",7,0,0,0,7
845180,549145,2016-05-27,Senate,"Do pass",5,2,0,0,7
845180,550018,2016-05-31,Senate,"Senate 3rd Reading SB1001 Mitchell",29,10,1,0,40
845180,555250,2016-06-22,Assembly,"Do pass and be re-referred to the Committee on Judiciary",6,1,0,0,7
845180,556006,2016-06-28,Assembly,"Do pass and be re-referred to the Committee on Appropriations",8,2,0,0,10
845180,559320,2016-08-11,Assembly,"Do pass",15,5,0,0,20
845180,560905,2016-08-24,Assembly,"SB 1001 Mitchell  Senate Third Reading  By CHIU",67,12,0,1,80
845180,561332,2016-08-26,Senate,"Unfinished Business SB1001 Mitchell Concurrence",28,10,1,0,39
845181,526210,2016-03-30,Senate,"Do pass, but re-refer to the Committee on Appropriations",7,0,0,0,7
845181,530438,2016-04-11,Senate,"Placed on Appropriations Suspense file",7,0,0,0,7
845181,549163,2016-05-27,Senate,"Do pass",7,0,0,0,7
845181,549916,2016-05-31,Senate,"Senate 3rd Reading SB996 Hill",39,0,1,0,40
845181,554696,2016-06-20,Assembly,"Do pass as amended and be re-referred to the Committee on 	Appropriations",9,0,0,0,9
845181,559237,2016-08-11,Assembly,"Do pass as amended",15,0,0,5,20
845181,560195,2016-08-18,Assembly,"SB 996 Hill  Senate Third Reading  By MULLIN",79,0,0,1,80
845181,561194,2016-08-25,Senate,"Special Consent SB996 Hill",39,0,0,0,39
845183,520160,2016-03-15,Assembly,"Do pass",7,0,0,0,7
845183,529534,2016-04-07,Assembly,"AB 1854 BLOOM  Assembly Third Reading",74,2,0,3,79
845183,552945,2016-06-14,Senate,"Do pass",7,0,0,0,7
845183,559859,2016-08-15,Senate,"Assembly 3rd Reading AB1854 Bloom By Hertzberg",38,0,1,0,39
845185,525879,2016-03-29,Assembly,"Do pass as amended",10,0,0,0,10
845185,530919,2016-04-11,Assembly,"AB 1867 STEINORTH  Assembly Third Reading",77,0,0,2,79
845185,553161,2016-06-14,Senate,"Do pass",7,0,0,0,7
845185,558699,2016-08-01,Senate,"Assembly 3rd Reading AB1867 Steinorth By Moorlach",39,0,0,0,39
845186,542471,2016-05-04,Assembly,"Do pass as amended",4,0,0,3,7
845186,550236,2016-05-31,Assembly,"AB 1853 COOPER  Assembly Third Reading",45,21,0,14,80
845186,555593,2016-06-27,Senate,"Do pass",4,1,0,0,5
845186,559921,2016-08-15,Senate,"Assembly 3rd Reading AB1853 Cooper By Moorlach",25,11,3,0,39
845186,560927,2016-08-24,Assembly,"AB 1853 COOPER  Concurrence in Senate Amendments",58,19,0,3,80
845187,538999,2016-04-26,Senate,"Do pass as amended",5,1,1,0,7
845187,545307,2016-05-12,Senate,"Senate 3rd Reading SB1007 Wieckowski",26,10,4,0,40
845187,554684,2016-06-21,Assembly,"Do pass",8,2,0,0,10
845187,560305,2016-08-18,Assembly,"SB 1007 Wieckowski  Senate Third Reading  By CHAU",53,26,0,1,80
845187,561096,2016-08-24,Senate,"Unfinished Business SB1007 Wieckowski Concurrence",29,10,0,0,39
845189,525542,2016-03-29,Senate,"Do pass",7,0,0,0,7
845189,533175,2016-04-14,Senate,"Senate 3rd Reading SB1005 Jackson",35,2,3,0,40
845189,552037,2016-06-08,Assembly,"Do pass",8,0,0,2,10
845189,553656,2016-06-16,Assembly,"SB 1005 Jackson  Senate Third Reading  By EGGMAN",63,1,0,16,80
845189,555287,2016-06-23,Senate,"Unfinished Business SB1005 Jackson Concurrence",34,0,6,0,40
845190,533182,2016-04-13,Senate,"Do pass as amended, and re-refer to the Committee on Appropriations",7,1,1,0,9
845190,549014,2016-05-27,Senate,"Do pass as amended",5,2,0,0,7
845190,550376,2016-06-01,Senate,"Senate 3rd Reading SB997 Lara",28,9,3,0,40
845190,555254,2016-06-23,Assembly,"Be referred to Committee on Judiciary",11,0,0,0,11
845190,555953,2016-06-28,Assembly,"Do pass",10,0,0,0,10
845190,560177,2016-08-18,Assembly,"SB 997 Lara  Senate Third Reading  By GARCIA, E",79,0,0,1,80
845190,561434,2016-08-29,Senate,"From committee:  That the Assembly Amendments be concurred in",7,0,0,0,7
845190,561529,2016-08-30,Senate,"Unfinished Business SB997 Lara Concurrence",39,0,0,0,39
845192,531514,2016-04-12,Senate,"Do pass as amended, and re-refer to the Committee on Appropriations",5,1,1,0,7
845192,548985,2016-05-27,Senate,"Do pass as amended",5,1,1,0,7
845192,550831,2016-06-02,Senate,"Senate 3rd Reading SB1004 Hill",29,8,3,0,40
845192,554693,2016-06-21,Assembly,"Do pass and be re-referred to the Committee on Appropriations",3,3,0,1,7
845192,554694,2016-06-21,Assembly,"Reconsideration granted",7,0,0,0,7
845192,555990,2016-06-28,Assembly,"Do pass as amended and be re-referred to the Committee on 	Appropriations",5,2,0,0,7
845192,559010,2016-08-03,Assembly,"Do pass",15,5,0,0,20
845192,560495,2016-08-22,Assembly,"SB 1004 Hill  Senate Third Reading  By GALLAGHER",58,18,0,4,80
845192,561208,2016-08-25,Senate,"Unfinished Business SB1004 Hill Concurrence",28,10,1,0,39
845194,530713,2016-04-11,Assembly,"Do pass and be re-referred to the Committee on Appropriations",9,0,0,0,9
845194,536838,2016-04-20,Assembly,"Do pass, to Consent Calendar",16,0,0,4,20
845194,539730,2016-04-28,Assembly,"AB 1856 DABABNEH  Consent Calendar Second Day  Regular Session",76,0,0,4,80
845194,553188,2016-06-15,Senate,"Do pass, but re-refer to the Committee on Appropriations Recommend 	Consent",7,0,0,0,7
845194,556844,2016-06-30,Senate,"Consent Calendar 2nd AB1856 Dababneh",37,0,3,0,40
845195,530483,2016-04-11,Senate,"Do pass as amended, and re-refer to the Committee on Health",7,0,2,0,9
845195,537258,2016-04-20,Senate,"Do pass, but re-refer to the Committee on Appropriations",6,1,2,0,9
845195,556254,2016-06-29,Senate,"Do pass, but re-refer to the Committee on Appropriations",7,0,0,0,7
845195,559323,2016-08-11,Senate,"Senate 3rd Reading SB994 Hill Urgency Clause",37,0,2,0,39
845199,532751,2016-04-13,Assembly,"Do pass and be re-referred to the Committee on Appropriations",9,0,0,0,9
845199,545096,2016-05-11,Assembly,"Do pass",6,14,0,0,20
845200,532406,2016-04-12,Senate,"Do pass, but re-refer to the Committee on Judiciary",4,0,1,0,5
845200,535301,2016-04-19,Senate,"Do pass as amended, but re-refer to the Committee on Appropriations 	Recommend Consent",7,0,0,0,7
845200,549143,2016-05-27,Senate,"Do pass as amended",7,0,0,0,7
845200,550887,2016-06-02,Senate,"Special Consent # SB980 Nielsen",39,0,1,0,40
845200,556387,2016-06-28,Assembly,"Do pass and be re-referred to the Committee on Appropriations",7,0,0,2,9
845201,536938,2016-04-20,Assembly,"Do pass and be re-referred to the Committee on Appropriations",5,0,0,2,7
845201,549098,2016-05-27,Assembly,"Do pass as amended",14,3,0,3,20
845201,550971,2016-06-02,Assembly,"AB 1878 JONES-SAWYER  Assembly Third Reading",57,19,0,4,80
845201,555847,2016-06-27,Senate,"Do pass, but re-refer to the Committee on Appropriations",3,1,1,0,5
845201,558930,2016-08-01,Senate,"Placed on Appropriations Suspense file",7,0,0,0,7
845201,559771,2016-08-11,Senate,"Do pass",5,2,0,0,7
845201,560314,2016-08-18,Senate,"Assembly 3rd Reading AB1878 Jones-Sawyer By Pan",24,12,3,0,39
845202,555059,2016-06-22,Senate,"Set, first hearing.  Failed passage in Committee.  Reconsideration 	granted",1,4,0,0,5
845202,555060,2016-06-22,Senate,"Do pass, but re-refer to the Committee on Appropriations",1,4,0,0,5
846759,533150,2016-04-12,Assembly,"Do pass and be re-referred to the Committee on Appropriations",7,0,0,0,7
846759,549268,2016-05-27,Assembly,"Do pass",20,0,0,0,20
846759,550631,2016-06-01,Assembly,"AB 1883 COOLEY  Assembly Third Reading",49,0,0,31,80
846759,550964,2016-06-02,Assembly,"AB 1883 COOLEY  Assembly Third Reading",77,0,0,3,80
846759,556503,2016-06-28,Senate,"Do pass, but re-refer to the Committee on Appropriations",5,0,0,0,5
846759,558937,2016-08-01,Senate,"Placed on Appropriations Suspense file",7,0,0,0,7
846761,528002,2016-04-04,Assembly,"Do pass and be re-referred to the Committee on Appropriations",6,2,0,1,9
846768,520817,2016-03-16,Senate,"Do pass as amended, and re-refer to the Committee on Appropriations",9,0,0,0,9
846768,531040,2016-04-11,Senate,"Placed on Appropriations Suspense file",7,0,0,0,7
846768,549208,2016-05-27,Senate,"Do pass as amended",6,1,0,0,7
846768,550965,2016-06-02,Senate,"Senate 3rd Reading SB1014 Liu",38,0,2,0,40
846768,555329,2016-06-22,Assembly,"Do pass as amended and be re-referred to the Committee on 	Appropriations",7,0,0,0,7
846771,526468,2016-03-30,Assembly,"Do pass and be re-referred to the Committee on Appropriations",8,0,0,2,10
846771,548953,2016-05-27,Assembly,"Do pass as amended",19,0,0,1,20
846771,550700,2016-06-01,Assembly,"AB 1907 DALY  Assembly Third Reading",69,9,0,2,80
846771,558877,2016-08-01,Senate,"Placed on Appropriations Suspense file",7,0,0,0,7
846771,559721,2016-08-11,Senate,"Do pass",7,0,0,0,7
846771,560104,2016-08-17,Senate,"Assembly 3rd Reading AB1907 Daly By Bates",35,4,0,0,39
846773,526465,2016-03-30,Senate,"Do pass",7,0,0,0,7
846773,529414,2016-04-07,Senate,"Senate 3rd Reading SB1011 Mendoza",38,0,2,0,40
846773,553463,2016-06-15,Assembly,"Do pass as amended and be re-referred to the Committee on Local 	Government",6,0,0,1,7
846773,556810,2016-06-29,Assembly,"Do pass and be re-referred to the Committee on Appropriations",5,0,0,4,9
846775,531659,2016-04-12,Assembly,"Do pass as amended and be re-referred to the Committee on 	Appropriations",4,2,0,1,7
846775,542631,2016-05-04,Assembly,"Do pass",13,5,0,2,20
846775,550962,2016-06-02,Assembly,"AB 1909 LOPEZ  Assembly Third Reading",60,18,0,2,80
846775,556429,2016-06-28,Senate,"Do pass, but re-refer to the Committee on Appropriations",6,1,0,0,7
846775,558863,2016-08-01,Senate,"Placed on Appropriations Suspense file",7,0,0,0,7
846775,559678,2016-08-11,Senate,"Do pass",6,0,1,0,7
846775,560540,2016-08-22,Senate,"Assembly 3rd Reading AB1909 Lopez By Leno",36,1,2,0,39
846777,531391,2016-04-12,Senate,"Do pass as amended",9,0,0,0,9
846777,545202,2016-05-12,Senate,"Senate 3rd Reading SB1020 Wieckowski",38,0,2,0,40
846782,526477,2016-03-29,Assembly,"Do pass and be re-referred to the Committee on Insurance",8,0,0,1,9
846782,536943,2016-04-20,Assembly,"Do pass and be re-referred to the Committee on Appropriations to 	Consent Calendar",13,0,0,0,13
846783,528999,2016-04-06,Assembly,"Do pass and be re-referred to the Committee on Revenue and Taxation",18,0,0,3,21
846783,535776,2016-04-18,Assembly,"Do pass and be re-referred to the Committee on Appropriations",9,0,0,0,9
846783,539008,2016-04-27,Assembly,"Do pass, to Consent Calendar",19,0,0,1,20
846783,542986,2016-05-05,Assembly,"AB 1901 QUIRK  Consent Calendar Second Day  Regular Session",79,0,0,1,80
846783,556639,2016-06-29,Senate,"Do pass, but re-refer to the Committee on Appropriations Recommend 	Consent",7,0,0,0,7
846783,558841,2016-08-01,Senate,"Do pass",7,0,0,0,7
846783,560272,2016-08-18,Senate,"Special Consent AB1901 Quirk",36,0,3,0,39
846783,561058,2016-08-24,Assembly,"AB 1901 QUIRK  Concurrence in Senate Amendments",80,0,0,0,80
846786,526435,2016-03-30,Assembly,"Amend, and do pass as amended and be re-referred to the Committee 	on Health with the recommendation:  To Consent Calendar",15,0,0,0,15
846786,549460,2016-05-27,Assembly,"Do pass as amended",20,0,0,0,20
846786,550484,2016-06-01,Assembly,"AB 1903 WILK  Assembly Third Reading",80,0,0,0,80
846786,552487,2016-06-13,Senate,"Do pass as amended, and re-refer to the Committee on Environmental 	Quality",11,0,0,0,11
846786,558933,2016-08-01,Senate,"Placed on Appropriations Suspense file",7,0,0,0,7
846789,525565,2016-03-29,Assembly,"Do pass and be re-referred to the Committee on Appropriations to 	Consent Calendar",16,0,0,0,16
846789,532370,2016-04-06,Assembly,"Do pass, to Consent Calendar",18,0,0,2,20
846789,533113,2016-04-14,Assembly,"AB 1917 OBERNOLTE  Consent Calendar Second Day  Regular Session",76,0,0,4,80
846789,551384,2016-06-06,Senate,"Do pass, but re-refer to the Committee on Appropriations Recommend 	Consent",8,0,1,0,9
846789,556751,2016-06-30,Senate,"Consent Calendar 2nd AB1917 Obernolte",37,0,3,0,40
846791,507423,2016-02-25,Assembly,"From committee:  Be adopted.  To third reading",9,0,0,2,11
846793,538026,2016-04-25,Assembly,"From committee:  Be adopted.  To third reading",9,0,0,2,11
846793,539649,2016-04-28,Assembly,"ACR 137 HARPER  Assembly Third Reading",36,19,0,25,80
846794,542522,2016-05-04,Assembly,"Do pass and be re-referred to the Committee on Appropriations",13,0,0,0,13
846794,546589,2016-05-18,Assembly,"Do pass, to Consent Calendar",20,0,0,0,20
846794,549224,2016-05-27,Assembly,"AB 1922 DALY  Consent Calendar Second Day",67,0,0,13,80
846794,555094,2016-06-22,Senate,"Do pass as amended, and re-refer to the Committee on Appropriations",6,0,3,0,9
846794,558941,2016-08-01,Senate,"Placed on Appropriations Suspense file",7,0,0,0,7
846794,559643,2016-08-11,Senate,"Do pass as amended",7,0,0,0,7
846794,560335,2016-08-18,Senate,"Assembly 3rd Reading AB1922 Daly By Roth",36,0,3,0,39
846794,561250,2016-08-25,Senate,"Assembly 3rd Reading AB1922 Daly By Roth",35,0,4,0,39
846794,561646,2016-08-30,Assembly,"AB 1922 DALY  Concurrence in Senate Amendments",79,0,0,1,80
846796,526455,2016-03-30,Assembly,"Do pass and be re-referred to the Committee on Appropriations to 	Consent Calendar",9,0,0,1,10
846796,532812,2016-04-13,Assembly,"Do pass, to Consent Calendar",20,0,0,0,20
846796,537511,2016-04-21,Assembly,"AB 1894 AGRI.  Consent Calendar Second Day  Regular Session",79,0,0,1,80
846796,554906,2016-06-21,Senate,"Do pass, but re-refer to the Committee on Appropriations Recommend 	Consent",5,0,0,0,5
846796,559450,2016-08-11,Senate,"Consent Calendar 2nd AB1894 Committee On AGRI. (Dodd)",37,0,2,0,39
846796,560108,2016-08-17,Assembly,"Senate amendments be concurred in",9,0,0,1,10
846796,560758,2016-08-23,Assembly,"AB 1894 AGRI.  Concurrence in Senate Amendments By DODD",79,0,0,1,80
846798,528097,2016-04-05,Assembly,"Do pass",3,7,0,0,10
846798,528098,2016-04-05,Assembly,"Reconsideration granted",10,0,0,0,10
846800,536241,2016-04-20,Assembly,"Do pass and be re-referred to the Committee on Appropriations",13,0,0,0,13
846800,549093,2016-05-27,Assembly,"Do pass",19,1,0,0,20
846800,550437,2016-06-01,Assembly,"AB 1899 CALDERON  Assembly Third Reading",78,2,0,0,80
846800,554963,2016-06-22,Senate,"Do pass, but re-refer to the Committee on Appropriations",9,0,0,0,9
846800,558805,2016-08-01,Senate,"Placed on Appropriations Suspense file",7,0,0,0,7
846800,559577,2016-08-11,Senate,"Do pass as amended",7,0,0,0,7
846800,560729,2016-08-23,Senate,"Assembly 3rd Reading AB1899 Calderon By Mendoza",38,0,1,0,39
846800,561611,2016-08-30,Assembly,"AB 1899 CALDERON  Concurrence in Senate Amendments",77,3,0,0,80
846803,539344,2016-04-27,Assembly,"Do pass, to Consent Calendar",9,0,0,0,9
846803,543062,2016-05-05,Assembly,"AB 1889 MULLIN  Consent Calendar Second Day  Regular Session",79,0,0,1,80
846803,558842,2016-08-01,Senate,"Placed on Appropriations Suspense file",7,0,0,0,7
846803,559738,2016-08-11,Senate,"Do pass as amended",5,2,0,0,7
846803,561227,2016-08-25,Senate,"Assembly 3rd Reading AB1889 Mullin By Galgiani",25,12,2,0,39
846803,561813,2016-08-31,Assembly,"Senate amendments be concurred in",10,5,0,1,16
846803,561814,2016-08-31,Assembly,"AB 1889 MULLIN  Concurrence in Senate Amendments",48,30,0,2,80
846806,542730,2016-05-03,Assembly,"Do pass as amended",8,1,0,0,9
846806,549339,2016-05-27,Assembly,"AB 1886 MCCARTY  Assembly Third Reading",69,1,0,10,80
846809,528862,2016-04-06,Senate,"Do pass, but re-refer to the Committee on Appropriations",5,0,2,0,7
846809,545263,2016-05-12,Senate,"Senate 3rd Reading SB1008 Lara",34,0,6,0,40
846809,552530,2016-06-13,Assembly,"Do pass and be re-referred to the Committee on Local Government",8,1,0,0,9
846809,556740,2016-06-29,Assembly,"Do pass and be re-referred to the Committee on Appropriations",8,0,0,1,9
846809,559030,2016-08-03,Assembly,"Do pass",20,0,0,0,20
846809,560343,2016-08-18,Assembly,"SB 1008 Lara  Senate Third Reading  By GIPSON",78,1,0,1,80
846809,561669,2016-08-30,Senate,"Unfinished Business SB1008 Lara Concurrence",34,2,3,0,39
846809,561670,2016-08-30,Senate,"Unfinished Business SB1008 Lara Concurrence",39,0,0,0,39
846809,561671,2016-08-30,Senate,"Unfinished Business SB1008 Lara Concurrence",35,2,2,0,39
846810,519717,2016-03-15,Assembly,"Do pass, to Consent Calendar",7,0,0,0,7
846810,525064,2016-03-28,Assembly,"AB 1906 MELENDEZ  Consent Calendar Second Day  Regular Session",74,0,0,5,79
846810,544358,2016-05-10,Senate,"Do pass and be placed on the Consent Calendar",7,0,0,0,7
846810,560035,2016-08-17,Senate,"Assembly 3rd Reading AB1906 Melendez By Morrell",39,0,0,0,39
846810,560700,2016-08-23,Assembly,"AB 1906 MELENDEZ  Concurrence in Senate Amendments",80,0,0,0,80
846813,519111,2016-03-14,Assembly,"Do pass and be re-referred to the Committee on Appropriations",16,0,0,0,16
846817,528108,2016-04-05,Assembly,"Do pass and be re-referred to the Committee on Human Services to 	Consent Calendar",10,0,0,0,10
846817,533462,2016-04-12,Assembly,"Do pass and be re-referred to the Committee on Appropriations to 	Consent Calendar",7,0,0,0,7
846817,542503,2016-05-04,Assembly,"Do pass, to Consent Calendar",20,0,0,0,20
846817,545255,2016-05-12,Assembly,"AB 1911 EGGMAN  Consent Calendar Second Day  Regular Session",78,0,0,2,80
846817,552904,2016-06-14,Senate,"Do pass as amended, but re-refer to the Committee on Judiciary 	Recommend Consent",4,0,1,0,5
846817,555017,2016-06-21,Senate,"Do pass, but re-refer to the Committee on Appropriations Recommend 	Consent",7,0,0,0,7
846817,558978,2016-08-01,Senate,"Placed on Appropriations Suspense file",7,0,0,0,7
846817,559780,2016-08-11,Senate,"Do pass as amended",7,0,0,0,7
846817,560190,2016-08-18,Senate,"Assembly 3rd Reading AB1911 Eggman By Hancock",38,0,1,0,39
846817,560684,2016-08-23,Assembly,"AB 1911 EGGMAN  Concurrence in Senate Amendments",80,0,0,0,80
846821,559121,2016-08-04,Assembly,"From committee:  Be adopted.  To third reading",9,0,0,2,11
846821,561479,2016-08-29,Senate,"Assembly 3rd Reading ACR136 Calderon By Allen",39,0,0,0,39
846824,542221,2016-05-04,Assembly,"Do pass",6,2,0,1,9
846824,545235,2016-05-12,Assembly,"AB 1919 QUIRK  Assembly Third Reading",48,30,0,2,80
846824,552776,2016-06-14,Senate,"Do pass",9,2,0,0,11
846824,559941,2016-08-16,Senate,"Assembly 3rd Reading AB1919 Quirk By Allen",27,11,1,0,39
846827,525909,2016-03-29,Senate,"Do pass, but re-refer to the Committee on Judiciary",6,0,5,0,11
846827,535606,2016-04-19,Senate,"Do pass, but re-refer to the Committee on Appropriations",5,1,1,0,7
846827,547598,2016-05-23,Senate,"Senate 3rd Reading SB1017 Hill Motions",21,8,11,0,40
846827,556927,2016-06-29,Assembly,"Do pass as amended and be re-referred to the Committee on 	Appropriations",9,5,0,1,15
846827,559536,2016-08-10,Assembly,"Do pass",12,5,0,3,20
846827,560370,2016-08-19,Assembly,"SB 1017 Hill  Senate Third Reading  Amendment  Set #1",73,0,0,7,80
846829,534938,2016-04-19,Senate,"Do pass, but re-refer to the Committee on Appropriations Recommend 	Consent",7,0,0,0,7
846831,525960,2016-03-29,Assembly,"Do pass and be re-referred to the Committee on Appropriations",7,0,0,0,7
846831,549049,2016-05-27,Assembly,"Do pass as amended",20,0,0,0,20
846831,550960,2016-06-02,Assembly,"AB 1904 WILK  Third Reading Urgency",76,0,0,4,80
846831,559029,2016-08-03,Senate,"Do pass, but re-refer to the Committee on Appropriations",7,0,0,0,7
846833,544672,2016-04-19,Assembly,"Do pass and be re-referred to the Committee on Appropriations",13,0,0,0,13
846833,549447,2016-05-27,Assembly,"Do pass as amended",20,0,0,0,20
846833,550412,2016-06-01,Assembly,"AB 1914 BONILLA  Assembly Third Reading",80,0,0,0,80
846833,553084,2016-06-15,Senate,"Do pass as amended, but re-refer to the Committee on Appropriations 	Recommend Consent",9,0,0,0,9
846833,558871,2016-08-01,Senate,"Placed on Appropriations Suspense file",7,0,0,0,7
846833,559733,2016-08-11,Senate,"Do pass",7,0,0,0,7
846833,559973,2016-08-16,Senate,"Assembly 3rd Reading AB1914 Bonilla By Block",38,0,1,0,39
846833,560850,2016-08-23,Assembly,"AB 1914 BONILLA  Concurrence in Senate Amendments",79,0,0,1,80
846835,529553,2016-04-06,Assembly,"Do pass and be re-referred to the Committee on Appropriations",6,0,0,1,7
846835,549389,2016-05-27,Assembly,"Do pass as amended",15,5,0,0,20
846835,550974,2016-06-02,Assembly,"AB 1890 DODD  Assembly Third Reading",55,23,0,2,80
846835,558973,2016-08-01,Senate,"Placed on Appropriations Suspense file",7,0,0,0,7
846835,559740,2016-08-11,Senate,"Do pass",5,2,0,0,7
846835,560560,2016-08-22,Senate,"Assembly 3rd Reading AB1890 Dodd By Mitchell",26,12,1,0,39
846835,561302,2016-08-25,Assembly,"AB 1890 DODD  Concurrence in Senate Amendments",55,24,0,1,80
846838,526273,2016-03-30,Assembly,"Do pass and be re-referred to the Committee on Revenue and Taxation",7,0,0,0,7
846838,534877,2016-04-18,Assembly,"Do pass and be re-referred to the Committee on Appropriations",9,0,0,0,9
846838,542369,2016-05-04,Assembly,"Do pass, to Consent Calendar",20,0,0,0,20
846838,545192,2016-05-12,Assembly,"AB 1920 CHAU  Consent Calendar Second Day  Regular Session",78,0,0,2,80
846838,552664,2016-06-14,Senate,"Do pass, but re-refer to the Committee on Appropriations Recommend 	Consent",11,0,0,0,11
846838,558804,2016-08-01,Senate,"Do pass",7,0,0,0,7
846838,560187,2016-08-18,Senate,"Special Consent AB1920 Chau",36,0,3,0,39
846838,560991,2016-08-24,Assembly,"AB 1920 CHAU  Concurrence in Senate Amendments",80,0,0,0,80
846839,526494,2016-03-29,Assembly,"Do pass and be re-referred to the Committee on Appropriations",6,0,0,1,7
846842,528652,2016-04-06,Senate,"Do pass, but re-refer to the Committee on Appropriations",4,1,0,0,5
846842,539634,2016-04-28,Senate,"Senate 3rd Reading SB1015 Leyva",25,10,5,0,40
846842,555249,2016-06-22,Assembly,"Do pass and be re-referred to the Committee on Appropriations",5,2,0,0,7
846842,559613,2016-08-10,Assembly,"Do pass",14,5,0,1,20
846842,560135,2016-08-18,Assembly,"SB 1015 Leyva  Senate Third Reading  By GARCIA, C",52,25,0,3,80
846845,525971,2016-03-29,Assembly,"Do pass as amended and be re-referred to the Committee on 	Appropriations",9,0,0,1,10
846845,532211,2016-04-13,Assembly,"Do pass, to Consent Calendar",20,0,0,0,20
846845,537113,2016-04-21,Assembly,"AB 1900 JONES-SAWYER  Consent Calendar Second Day  Regular Session",79,0,0,1,80
846845,555075,2016-06-21,Senate,"Do pass, but re-refer to the Committee on Appropriations Recommend 	Consent",7,0,0,0,7
846845,558899,2016-08-01,Senate,"Placed on Appropriations Suspense file",7,0,0,0,7
846845,559649,2016-08-11,Senate,"Do pass as amended",7,0,0,0,7
846845,560832,2016-08-23,Senate,"Assembly 3rd Reading AB1900 Jones-Sawyer By Lara Urgency Clause",39,0,0,0,39
846845,561500,2016-08-29,Assembly,"AB 1900 JONES-SAWYER  Concurrence in Senate Amendments",80,0,0,0,80
846849,532299,2016-04-12,Assembly,"Do pass and be re-referred to the Committee on Appropriations",12,1,0,0,13
846852,539449,2016-04-27,Assembly,"Do pass",5,2,0,0,7
846852,540837,2016-05-02,Assembly,"AB 1921 GONZALEZ  Assembly Third Reading",46,29,0,5,80
846852,554902,2016-06-21,Senate,"Do pass",4,1,0,0,5
846852,559802,2016-08-15,Senate,"Assembly 3rd Reading AB1921 Gonzalez By Hertzberg",26,11,2,0,39
846852,561636,2016-08-30,Assembly,"AB 1921 GONZALEZ  Concurrence in Senate Amendments",50,29,0,1,80
846855,525910,2016-03-29,Assembly,"Amend, and do pass as amended and be re-referred to the Committee 	on Privacy and Consumer Protection with the recommendation:  To 	Consent Calendar",7,0,0,0,7
846855,535183,2016-04-19,Assembly,"Do pass and be re-referred to the Committee on Appropriations to 	Consent Calendar",11,0,0,0,11
846855,542442,2016-05-04,Assembly,"Do pass, to Consent Calendar",20,0,0,0,20
846855,548992,2016-05-27,Assembly,"AB 1924 LOW  Third Reading Urgency",72,0,0,8,80
846855,556327,2016-06-28,Senate,"Do pass, but re-refer to the Committee on Appropriations Recommend 	Consent",7,0,0,0,7
846855,560650,2016-08-23,Senate,"Assembly 3rd Reading AB1924 Low By Leno Urgency Clause",39,0,0,0,39
846855,561556,2016-08-30,Assembly,"AB 1924 LOW  Concurrence in Senate Amendments",80,0,0,0,80
846857,528971,2016-04-06,Senate,"Do pass as amended, and re-refer to the Committee on Transportation 	and Housing",3,3,1,0,7
846857,528972,2016-04-06,Senate,"Reconsideration granted",6,0,1,0,7
846859,526441,2016-03-30,Assembly,"Do pass as amended",15,0,0,0,15
846859,539425,2016-04-27,Assembly,"Do pass, to Consent Calendar",19,0,0,1,20
846859,543102,2016-05-05,Assembly,"AB 1923 WOOD  Consent Calendar Second Day  Regular Session",79,0,0,1,80
846859,554889,2016-06-21,Senate,"Do pass, but re-refer to the Committee on Appropriations",10,0,1,0,11
846859,560789,2016-08-23,Senate,"Assembly 3rd Reading AB1923 Wood By Gaines",39,0,0,0,39
846859,561466,2016-08-29,Assembly,"AB 1923 WOOD  Concurrence in Senate Amendments",80,0,0,0,80
846861,531365,2016-04-12,Senate,"Do pass, but re-refer to the Committee on Appropriations",6,0,1,0,7
846861,544685,2016-04-25,Senate,"Placed on Appropriations Suspense file",7,0,0,0,7
846861,549215,2016-05-27,Senate,"Do pass",6,1,0,0,7
846861,550109,2016-05-31,Senate,"Senate 3rd Reading SB1016 Monning",39,0,1,0,40
846861,552862,2016-06-14,Assembly,"Do pass and be re-referred to the Committee on Appropriations",7,0,0,0,7
846861,559483,2016-08-11,Assembly,"Do pass",20,0,0,0,20
846861,560605,2016-08-22,Assembly,"SB 1016 Monning  Senate Third Reading  By LOW",78,0,0,2,80
846861,561455,2016-08-29,Senate,"Special Consent SB1016 Monning",39,0,0,0,39
846864,520422,2016-03-15,Assembly,"Do pass as amended and be re-referred to the Committee on 	Appropriations",8,1,0,4,13
846867,532423,2016-04-12,Assembly,"Do pass and be re-referred to the Committee on Business and 	Professions",9,4,0,0,13
846867,534928,2016-04-19,Assembly,"Do pass as amended and be re-referred to the Committee on 	Appropriations",8,7,0,1,16
846867,534929,2016-04-19,Assembly,"Reconsideration granted",16,0,0,0,16
846871,528183,2016-04-04,Assembly,"Do pass as amended",9,0,0,0,9
846871,537437,2016-04-21,Assembly,"AB 1891 DABABNEH  Assembly Third Reading",79,0,0,1,80
846871,553473,2016-06-15,Senate,"Do pass as amended",7,0,0,0,7
846871,559464,2016-08-11,Senate,"Special Consent AB1891 Dababneh By Nguyen",37,0,2,0,39
846871,560308,2016-08-18,Assembly,"AB 1891 DABABNEH  Concurrence in Senate Amendments",79,0,0,1,80
846874,534601,2016-04-18,Assembly,"Do pass and be re-referred to the Committee on Appropriations",5,10,0,1,16
846874,534602,2016-04-18,Assembly,"Reconsideration granted",15,0,0,1,16
846878,527987,2016-04-05,Assembly,"Do pass as amended and be re-referred to the Committee on 	Accountability and Administrative Review",8,2,0,0,10
846878,532261,2016-04-13,Assembly,"Do pass and be re-referred to the Committee on Appropriations",6,3,0,0,9
846878,542222,2016-05-04,Assembly,"Do pass",15,5,0,0,20
846878,543777,2016-05-09,Assembly,"AB 1887 LOW  Assembly Third Reading",54,21,0,5,80
846878,552673,2016-06-14,Senate,"Do pass as amended, and re-refer to the Committee on Judiciary",9,0,4,0,13
846878,556398,2016-06-28,Senate,"Do pass, but re-refer to the Committee on Appropriations",5,2,0,0,7
846878,560048,2016-08-17,Senate,"Assembly 3rd Reading AB1887 Low By Lara",26,12,1,0,39
846878,560645,2016-08-23,Assembly,"AB 1887 LOW  Concurrence in Senate Amendments",56,21,0,3,80
846879,533173,2016-04-13,Senate,"Do pass, but re-refer to the Committee on Appropriations",7,2,0,0,9
846879,549168,2016-05-27,Senate,"Do pass as amended",5,2,0,0,7
846879,550476,2016-06-01,Senate,"Senate 3rd Reading SB1010 Hernandez",25,10,5,0,40
846879,556397,2016-06-28,Assembly,"Do pass as amended and be re-referred to the Committee on 	Appropriations",12,4,0,2,18
846879,559289,2016-08-11,Assembly,"Do pass as amended",12,0,0,8,20
846886,531244,2016-04-12,Senate,"Do pass as amended, and re-refer to the Committee on Appropriations",12,0,1,0,13
846886,543793,2016-05-09,Senate,"Senate 3rd Reading SB1012 Nguyen",35,0,5,0,40
846886,556630,2016-06-29,Assembly,"Do pass and be re-referred to the Committee on Appropriations",8,0,0,1,9
846886,559043,2016-08-03,Assembly,"Do pass",20,0,0,0,20
846886,560280,2016-08-18,Assembly,"SB 1012 Nguyen  Senate Third Reading  By CHANG",78,0,0,2,80
846888,520556,2016-03-16,Assembly,"Amend, and do pass as amended and be re-referred to the Committee 	on Appropriations with the recommendation:  To Consent Calendar",6,0,0,1,7
846888,532967,2016-04-13,Assembly,"Do pass, to Consent Calendar",20,0,0,0,20
846888,537182,2016-04-21,Assembly,"AB 1918 O'DONNELL  Consent Calendar Second Day  Regular Session",79,0,0,1,80
846888,552093,2016-06-08,Senate,"Do pass, but re-refer to the Committee on Appropriations Recommend 	Consent",9,0,0,0,9
846888,556964,2016-06-30,Senate,"Consent Calendar 2nd AB1918 O'Donnell",37,0,3,0,40
846888,558679,2016-08-01,Assembly,"AB 1918 O'DONNELL  Concurrence in Senate Amendments",75,0,0,5,80
846893,528327,2016-04-04,Assembly,"Do pass as amended and be re-referred to the Committee on 	Appropriations",8,0,0,1,9
846897,534168,2016-04-18,Assembly,"Do pass and be re-referred to the Committee on Elections and 	Redistricting",5,10,0,1,16
846897,534169,2016-04-18,Assembly,"Reconsideration granted",15,0,0,1,16
847963,525748,2016-03-29,Assembly,"Do pass",7,0,0,0,7
847963,527457,2016-04-04,Assembly,"AB 1927 LACKEY  Assembly Third Reading",78,0,0,1,79
847963,544637,2016-05-10,Senate,"Do pass as amended. To Consent Calendar",7,0,0,0,7
847963,547214,2016-05-19,Senate,"Consent Calendar 2nd AB1927 Lackey",39,0,1,0,40
847963,547690,2016-05-23,Assembly,"AB 1927 LACKEY  Concurrence in Senate Amendments",76,0,0,4,80
847965,528111,2016-04-05,Senate,"Do pass as amended, and re-refer to the Committee on Environmental 	Quality",7,0,4,0,11
847965,536446,2016-04-20,Senate,"Do pass as amended, and re-refer to the Committee on Appropriations",5,1,1,0,7
847965,547620,2016-05-23,Senate,"Placed on Appropriations Suspense file",7,0,0,0,7
847967,531389,2016-04-12,Assembly,"Do pass as amended and be re-referred to the Committee on Judiciary",4,1,0,2,7
847967,535250,2016-04-19,Assembly,"Do pass as amended and be re-referred to the Committee on 	Appropriations",8,2,0,0,10
847967,548387,2016-05-25,Assembly,"Do pass",13,7,0,0,20
847967,550360,2016-06-01,Assembly,"AB 1957 QUIRK  Assembly Third Reading",28,36,0,16,80
847968,526006,2016-03-29,Assembly,"Do pass as amended, to Consent Calendar",10,0,0,0,10
847968,529605,2016-04-07,Assembly,"AB 1963 CALDERON  Consent Calendar Second Day  Regular Session",77,0,0,2,79
847968,553485,2016-06-14,Senate,"Do pass and be placed on the Consent Calendar",7,0,0,0,7
847968,556777,2016-06-30,Senate,"Consent Calendar 2nd AB1963 Calderon",37,0,3,0,40
847970,528301,2016-04-05,Senate,"Do pass, but re-refer to the Committee on Appropriations",9,0,2,0,11
847970,547615,2016-05-23,Senate,"Placed on Appropriations Suspense file",7,0,0,0,7
847970,549288,2016-05-27,Senate,"Do pass as amended",7,0,0,0,7
847970,551173,2016-06-02,Senate,"Special Consent # SB1028 Hill",39,0,1,0,40
847970,554971,2016-06-22,Assembly,"Do pass and be re-referred to the Committee on Appropriations to 	Consent Calendar",15,0,0,0,15
847970,559462,2016-08-11,Assembly,"Do pass",15,0,0,5,20
847970,560666,2016-08-23,Assembly,"SB 1028 Hill  Senate Third Reading  By BIGELOW",80,0,0,0,80
847970,561256,2016-08-25,Senate,"Unfinished Business SB1028 Hill Concurrence",39,0,0,0,39
847971,527962,2016-04-04,Assembly,"Do pass as amended and be re-referred to the Committee on 	Appropriations",9,0,0,0,9
847971,549438,2016-05-27,Assembly,"Do pass",20,0,0,0,20
847971,550218,2016-05-31,Assembly,"AB 1958 WOOD  Assembly Third Reading",80,0,0,0,80
847971,556069,2016-06-28,Senate,"Do pass as amended, and re-refer to the Committee on Appropriations",6,2,1,0,9
847971,559670,2016-08-11,Senate,"Do pass",7,0,0,0,7
847971,560697,2016-08-23,Senate,"Assembly 3rd Reading AB1958 Wood By McGuire",39,0,0,0,39
847971,561436,2016-08-29,Assembly,"AB 1958 WOOD  Concurrence in Senate Amendments",80,0,0,0,80
847975,535303,2016-04-19,Senate,"Do pass, but re-refer to the Committee on Appropriations",10,0,1,0,11
847975,547659,2016-05-23,Senate,"Senate 3rd Reading SB1041 Hueso",33,4,3,0,40
847975,557066,2016-06-29,Assembly,"Do pass as amended and be re-referred to the Committee on 	Appropriations",12,2,0,1,15
847976,527876,2016-04-04,Assembly,"Do pass and be re-referred to the Committee on Appropriations",6,5,0,5,16
847976,527877,2016-04-04,Assembly,"Reconsideration granted",16,0,0,0,16
847977,544734,2016-05-09,Assembly,"Do pass as amended and be re-referred to the Committee on 	Appropriations",9,0,0,0,9
847977,548442,2016-05-25,Assembly,"Do pass, to Consent Calendar",20,0,0,0,20
847977,550197,2016-05-31,Assembly,"AB 1944 JONES  Consent Calendar Second Day",80,0,0,0,80
847977,555066,2016-06-22,Senate,"Do pass, but re-refer to the Committee on Appropriations",5,0,2,0,7
847977,558958,2016-08-01,Senate,"Placed on Appropriations Suspense file",7,0,0,0,7
847981,526003,2016-03-29,Assembly,"Do pass and be re-referred to the Committee on Appropriations",15,2,0,2,19
847981,532659,2016-04-06,Assembly,"Do pass as amended",13,1,0,6,20
847981,533241,2016-04-14,Assembly,"AB 1947 CHIU  Assembly Third Reading",56,10,0,14,80
847984,535046,2016-04-19,Assembly,"Do pass as amended and be re-referred to the Committee on 	Appropriations",14,4,0,1,19
847984,542609,2016-05-04,Assembly,"Do pass as amended",15,5,0,0,20
847984,547799,2016-05-23,Assembly,"AB 1954 BURKE  Assembly Third Reading",53,23,0,4,80
847984,555421,2016-06-22,Senate,"Do pass as amended, and re-refer to the Committee on Appropriations",7,2,0,0,9
847984,558740,2016-08-01,Senate,"Placed on Appropriations Suspense file",7,0,0,0,7
847984,559635,2016-08-11,Senate,"Do pass",5,2,0,0,7
847984,560494,2016-08-22,Senate,"Assembly 3rd Reading AB1954 Burke By Mitchell",28,11,0,0,39
847984,561409,2016-08-29,Assembly,"AB 1954 BURKE  Concurrence in Senate Amendments",59,19,0,2,80
847987,531685,2016-04-12,Senate,"Do pass, but re-refer to the Committee on Appropriations",3,4,2,0,9
847988,535764,2016-04-18,Senate,"Do pass as amended, and re-refer to the Committee on Appropriations",9,0,0,0,9
847988,545194,2016-05-12,Senate,"Senate 3rd Reading SB1044 Nguyen",38,0,2,0,40
847988,554710,2016-06-21,Assembly,"Do pass and be re-referred to the Committee on Appropriations to 	Consent Calendar",15,0,0,1,16
847988,556483,2016-06-29,Assembly,"Do pass, to Consent Calendar",18,0,0,2,20
847988,559144,2016-08-04,Assembly,"SB 1044 Nguyen  Consent Calendar Second Day  Regular Session",77,0,0,3,80
847988,559478,2016-08-11,Senate,"Special Consent SB1044 Nguyen Concurrence",37,0,2,0,39
847990,529064,2016-04-06,Assembly,"Do pass and be re-referred to the Committee on Revenue and Taxation",9,0,0,0,9
847990,534873,2016-04-18,Assembly,"Do pass as amended and be re-referred to the Committee on 	Appropriations",9,0,0,0,9
847990,549054,2016-05-27,Assembly,"Do pass as amended",20,0,0,0,20
847990,550904,2016-06-02,Assembly,"AB 1952 GORDON  Assembly Third Reading",78,0,0,2,80
847990,554956,2016-06-22,Senate,"Do pass, but re-refer to the Committee on Appropriations",6,0,1,0,7
847990,558707,2016-08-01,Senate,"Placed on Appropriations Suspense file",7,0,0,0,7
847990,559587,2016-08-11,Senate,"Do pass",7,0,0,0,7
847990,560498,2016-08-22,Senate,"Assembly 3rd Reading AB1952 Gordon By Moorlach",39,0,0,0,39
847990,561218,2016-08-25,Assembly,"AB 1952 GORDON  Concurrence in Senate Amendments",79,0,0,1,80
847991,526386,2016-03-30,Senate,"Do pass and be placed on the Consent Calendar",8,0,1,0,9
847991,529548,2016-04-07,Senate,"Consent Calendar 2nd SB1038 Allen",38,0,2,0,40
847991,552915,2016-06-14,Assembly,"Do pass",13,0,0,0,13
847991,555361,2016-06-23,Assembly,"SB 1038 Allen  Senate Third Reading  By WOOD",78,0,0,2,80
847993,537558,2016-04-20,Senate,"Do pass as amended, and re-refer to the Committee on Appropriations",6,0,3,0,9
847993,549303,2016-05-27,Senate,"Do pass as amended",5,2,0,0,7
847993,550636,2016-06-01,Senate,"Senate 3rd Reading SB1034 Mitchell",25,12,3,0,40
847993,556279,2016-06-28,Assembly,"Do pass as amended and be re-referred to the Committee on 	Appropriations",13,1,0,4,18
847995,535220,2016-04-19,Assembly,"Do pass as amended and be re-referred to the Committee on 	Appropriations",18,0,0,1,19
847995,542246,2016-05-04,Assembly,"Do pass, to Consent Calendar",20,0,0,0,20
847995,545254,2016-05-12,Assembly,"AB 1931 RODRIGUEZ  Consent Calendar Second Day  Regular Session",78,0,0,2,80
847995,552160,2016-06-08,Senate,"Do pass, but re-refer to the Committee on Appropriations",7,0,2,0,9
847995,555864,2016-06-27,Senate,"Placed on Appropriations Suspense file",6,0,1,0,7
847996,533190,2016-04-13,Assembly,"Do pass and be re-referred to the Committee on Natural Resources",10,5,0,0,15
847996,535069,2016-04-18,Assembly,"Do pass as amended and be re-referred to the Committee on 	Appropriations",6,2,0,1,9
847996,546585,2016-05-18,Assembly,"Do pass",14,6,0,0,20
847996,547577,2016-05-23,Assembly,"AB 1937 GOMEZ  Assembly Third Reading",51,26,0,3,80
847996,554702,2016-06-21,Senate,"Do pass as amended, and re-refer to the Committee on Rules",7,3,1,0,11
847996,556315,2016-06-29,Senate,"Do pass, but re-refer to the Committee on Appropriations",5,2,0,0,7
847996,558711,2016-08-01,Senate,"Do pass",5,2,0,0,7
847996,560519,2016-08-22,Senate,"Assembly 3rd Reading AB1937 Gomez By Pavley",26,13,0,0,39
847996,561141,2016-08-25,Assembly,"AB 1937 GOMEZ  Concurrence in Senate Amendments",53,26,0,1,80
847997,525728,2016-03-29,Senate,"Do pass, but re-refer to the Committee on Environmental Quality",8,2,1,0,11
847997,536957,2016-04-20,Senate,"Do pass, but re-refer to the Committee on Appropriations",5,2,0,0,7
847997,544156,2016-05-09,Senate,"Senate 3rd Reading SB1030 McGuire",27,8,5,0,40
847997,553477,2016-06-15,Assembly,"Do pass and be re-referred to the Committee on Appropriations",6,3,0,0,9
847997,556489,2016-06-29,Assembly,"Do pass",12,6,0,2,20
847997,559149,2016-08-04,Assembly,"SB 1030 McGuire  Senate Third Reading  By DODD",54,22,0,4,80
848001,526259,2016-03-29,Assembly,"Do pass and be re-referred to the Committee on Appropriations",6,0,0,1,7
848001,548962,2016-05-27,Assembly,"Do pass as amended",20,0,0,0,20
848001,550356,2016-06-01,Assembly,"AB 1930 LACKEY  Assembly Third Reading",77,0,0,3,80
848001,552685,2016-06-14,Senate,"Do pass as amended, and re-refer to the Committee on Appropriations",4,0,1,0,5
848001,558726,2016-08-01,Senate,"Placed on Appropriations Suspense file",7,0,0,0,7
848001,559535,2016-08-11,Senate,"Do pass",7,0,0,0,7
848001,559930,2016-08-16,Senate,"Assembly 3rd Reading AB1930 Lackey By McGuire",37,0,2,0,39
848001,560725,2016-08-23,Assembly,"AB 1930 LACKEY  Concurrence in Senate Amendments",77,0,0,3,80
848002,532826,2016-04-11,Assembly,"Do pass, to Consent Calendar",16,0,0,0,16
848002,537155,2016-04-21,Assembly,"AB 1943 LINDER  Consent Calendar Second Day",79,0,0,1,80
848002,552774,2016-06-14,Senate,"Do pass and be placed on the Consent Calendar",11,0,0,0,11
848002,556972,2016-06-30,Senate,"Consent Calendar 2nd AB1943 Linder",37,0,3,0,40
848002,559886,2016-08-15,Assembly,"Senate amendments be concurred in",15,0,0,1,16
848002,560258,2016-08-18,Assembly,"AB 1943 LINDER  Concurrence in Senate Amendments",79,0,0,1,80
848004,528101,2016-04-05,Senate,"Do pass, but re-refer to the Committee on Rules",6,2,3,0,11
848004,535216,2016-04-19,Senate,"Do pass, but re-refer to the Committee on Appropriations",4,3,4,0,11
848004,535217,2016-04-19,Senate,"Reconsideration refused",11,0,0,0,11
848007,534782,2016-04-18,Senate,"Do pass as amended, and re-refer to the Committee on Appropriations",6,2,1,0,9
848007,547585,2016-05-23,Senate,"Placed on Appropriations Suspense file",7,0,0,0,7
848007,548991,2016-05-27,Senate,"Do pass as amended",5,2,0,0,7
848007,550384,2016-06-01,Senate,"Senate 3rd Reading SB1039 Hill",25,12,3,0,40
848007,555955,2016-06-28,Assembly,"Do pass as amended and be re-referred to the Committee on 	Appropriations",11,5,0,0,16
848007,559257,2016-08-11,Assembly,"Do pass",14,6,0,0,20
848007,560404,2016-08-19,Assembly,"SB 1039 Hill  Senate Third Reading  Amend By BONILLA  Set #1",49,22,0,9,80
848007,561187,2016-08-25,Assembly,"SB 1039 Hill  Senate Third Reading  Amend By BONILLA  Set #1",51,27,0,2,80
848007,561380,2016-08-29,Assembly,"SB 1039 Hill  Senate Third Reading  By BONILLA",51,29,0,0,80
848007,561582,2016-08-30,Senate,"Unfinished Business (S upplemental File 1)SB1 039 Hil l Con",26,12,1,0,39
848009,532611,2016-04-12,Senate,"Do pass, but re-refer to the Committee on Appropriations",4,0,1,0,5
848010,528335,2016-04-05,Senate,"Do pass, but re-refer to the Committee on Appropriations",7,0,0,0,7
848010,540909,2016-05-02,Senate,"Senate 3rd Reading SB1036 Hernandez",38,0,2,0,40
848010,552707,2016-06-14,Assembly,"Do pass and be re-referred to the Committee on Appropriations",5,0,0,2,7
848010,556307,2016-06-29,Assembly,"Do pass",18,0,0,2,20
848010,560132,2016-08-18,Assembly,"SB 1036 Hernandez  Senate Third Reading  By JONES-SAWYER",78,0,0,2,80
848013,531408,2016-04-12,Assembly,"Do pass and be re-referred to the Committee on Appropriations to 	Consent Calendar",7,0,0,0,7
848013,542558,2016-05-04,Assembly,"Do pass, to Consent Calendar",20,0,0,0,20
848013,545414,2016-05-12,Assembly,"AB 1941 LOPEZ  Consent Calendar Second Day  Regular Session",78,0,0,2,80
848013,552491,2016-06-13,Senate,"Do pass, but re-refer to the Committee on Appropriations Recommend 	Consent",9,0,0,0,9
848013,557047,2016-06-30,Senate,"Consent Calendar 2nd AB1941 Lopez",37,0,3,0,40
848013,559143,2016-08-04,Assembly,"AB 1941 LOPEZ  Concurrence in Senate Amendments",77,0,0,3,80
848016,535474,2016-04-19,Senate,"Do pass, but re-refer to the Committee on Appropriations Recommend 	Consent",7,0,0,0,7
848019,537566,2016-04-20,Assembly,"Do pass and be re-referred to the Committee on Appropriations",1,4,0,2,7
848020,507756,2016-02-25,Assembly,"From committee:  Be adopted.  To third reading",9,0,0,2,11
848022,509814,2016-02-29,Senate,"Senate 3rd Reading SR60 Fuller",40,0,0,0,40
848023,525947,2016-03-29,Assembly,"Do pass, to Consent Calendar",7,0,0,0,7
848023,530490,2016-04-11,Assembly,"AB 1953 WEBER  Assembly Third Reading",75,0,0,4,79
848023,553015,2016-06-14,Senate,"Do pass and be placed on the Consent Calendar",7,0,0,0,7
848023,557087,2016-06-30,Senate,"Consent Calendar 2nd AB1953 Weber",37,0,3,0,40
848026,525964,2016-03-29,Assembly,"Do pass and be re-referred to the Committee on Appropriations",11,1,0,3,15
848026,549352,2016-05-27,Assembly,"Do pass",14,5,0,1,20
848026,550456,2016-06-01,Assembly,"AB 1928 CAMPOS  Assembly Third Reading",56,22,0,2,80
848026,556180,2016-06-28,Senate,"Do pass, but re-refer to the Committee on Appropriations",6,2,1,0,9
848026,558722,2016-08-01,Senate,"Placed on Appropriations Suspense file",7,0,0,0,7
848026,559775,2016-08-11,Senate,"Do pass as amended",5,2,0,0,7
848026,560046,2016-08-17,Senate,"Assembly 3rd Reading AB1928 Campos By Wieckowski",27,12,0,0,39
848026,560861,2016-08-23,Assembly,"AB 1928 CAMPOS  Concurrence in Senate Amendments",58,22,0,0,80
848027,535269,2016-04-19,Senate,"Do pass, but re-refer to the Committee on Appropriations",11,0,0,0,11
848027,550521,2016-06-01,Senate,"Senate 3rd Reading SB1049 Hill",39,0,1,0,40
848027,557018,2016-06-29,Assembly,"Do pass as amended and be re-referred to the Committee on 	Appropriations",12,1,0,2,15
848029,533480,2016-04-13,Assembly,"Do pass as amended and be re-referred to the Committee on 	Appropriations",7,0,0,0,7
848031,528077,2016-04-05,Assembly,"Do pass as amended and be re-referred to the Committee on 	Appropriations",13,1,0,2,16
848032,535131,2016-04-19,Senate,"Do pass as amended, but re-refer to the Committee on Appropriations 	Recommend Consent",7,0,0,0,7
848032,549425,2016-05-27,Senate,"Do pass",7,0,0,0,7
848032,550250,2016-05-31,Senate,"Senate 3rd Reading SB1040 Hill",39,0,1,0,40
848032,552882,2016-06-14,Assembly,"Do pass as amended and be re-referred to the Committee on 	Appropriations",7,0,0,0,7
848032,559327,2016-08-11,Assembly,"Do pass as amended",20,0,0,0,20
848032,560194,2016-08-18,Assembly,"SB 1040 Hill  Senate Third Reading  By MAIENSCHEIN",78,0,0,2,80
848032,561156,2016-08-25,Senate,"Special Consent SB1040 Hill",39,0,0,0,39
848034,528083,2016-04-05,Assembly,"Do pass and be re-referred to the Committee on Appropriations to 	Consent Calendar",7,0,0,0,7
848034,532624,2016-04-13,Assembly,"Do pass, to Consent Calendar",20,0,0,0,20
848034,537378,2016-04-21,Assembly,"AB 1962 DODD  Consent Calendar Second Day  Regular Session",79,0,0,1,80
848034,554845,2016-06-21,Senate,"Do pass, but re-refer to the Committee on Appropriations Recommend 	Consent",7,0,0,0,7
848034,558873,2016-08-01,Senate,"Placed on Appropriations Suspense file",7,0,0,0,7
848034,559767,2016-08-11,Senate,"Do pass",7,0,0,0,7
848034,560247,2016-08-18,Senate,"Assembly 3rd Reading AB1962 Dodd By Pan",36,0,3,0,39
848034,561000,2016-08-24,Assembly,"AB 1962 DODD  Concurrence in Senate Amendments",80,0,0,0,80
848035,531211,2016-04-12,Senate,"Do pass, but re-refer to the Committee on Appropriations",12,0,1,0,13
848035,548642,2016-05-26,Senate,"Senate 3rd Reading SB1032 Galgiani",38,0,2,0,40
848035,556796,2016-06-30,Assembly,"Do pass and be re-referred to the Committee on Appropriations",20,0,0,1,21
848035,559027,2016-08-03,Assembly,"Do pass",20,0,0,0,20
848035,559817,2016-08-15,Assembly,"SB 1032 Galgiani  Senate Third Reading  By GRAY",75,1,0,4,80
848037,525994,2016-03-29,Assembly,"Do pass and be re-referred to the Committee on Appropriations",5,1,0,1,7
848038,532484,2016-04-11,Assembly,"Do pass and be re-referred to the Committee on Appropriations",16,0,0,0,16
848038,538957,2016-04-27,Assembly,"Do pass, to Consent Calendar",19,0,0,1,20
848038,543007,2016-05-05,Assembly,"AB 1932 OBERNOLTE  Consent Calendar Second Day  Regular Session",79,0,0,1,80
848038,554647,2016-06-21,Senate,"Do pass and be placed on the Consent Calendar",11,0,0,0,11
848038,559836,2016-08-15,Senate,"Assembly 3rd Reading AB1932 Obernolte By Morrell",38,0,1,0,39
848038,560508,2016-08-22,Assembly,"AB 1932 OBERNOLTE  Concurrence in Senate Amendments",79,0,0,1,80
848040,537391,2016-04-20,Assembly,"Do pass and be re-referred to the Committee on Judiciary to Consent 	Calendar",7,0,0,0,7
848040,537392,2016-04-21,Assembly,"Do pass and be re-referred to the Committee on Appropriations to 	Consent Calendar",10,0,0,0,10
848041,531671,2016-04-12,Assembly,"Do pass as amended",14,0,0,1,15
848044,528458,2016-04-05,Senate,"Do pass, but re-refer to the Committee on Appropriations",7,0,0,0,7
848044,534239,2016-04-18,Senate,"Placed on Appropriations Suspense file",7,0,0,0,7
848046,532643,2016-04-11,Assembly,"Do pass and be re-referred to the Committee on Appropriations",12,3,0,1,16
848046,549137,2016-05-27,Assembly,"Do pass as amended",15,3,0,2,20
848046,550953,2016-06-02,Assembly,"AB 1965 COOPER  Assembly Third Reading",55,23,0,2,80
848046,554729,2016-06-21,Senate,"Do pass, but re-refer to the Committee on Environmental Quality",8,1,2,0,11
848046,556474,2016-06-29,Senate,"Do pass, but re-refer to the Committee on Appropriations",3,0,4,0,7
848046,556475,2016-06-29,Senate,"Set, first hearing.  Failed passage in Committee.  Reconsideration 	granted",6,0,1,0,7
848047,507748,2016-02-25,Senate,"Senate 3rd Reading SCR109 Stone",37,0,3,0,40
848047,537314,2016-04-21,Assembly,"Be adopted, to Consent Calendar",9,0,0,2,11
848047,540121,2016-04-28,Assembly,"SCR 109 Stone  Consent Calendar Second Day  Regular Session",76,0,0,4,80
848049,526429,2016-03-30,Senate,"Do pass, but re-refer to the Committee on Appropriations",7,0,0,0,7
848049,549301,2016-05-27,Senate,"Do pass as amended",7,0,0,0,7
848049,550440,2016-06-01,Senate,"Senate 3rd Reading SB1029 Hertzberg",39,0,1,0,40
848049,557159,2016-06-29,Assembly,"Do pass and be re-referred to the Committee on Appropriations",9,0,0,0,9
848049,559360,2016-08-11,Assembly,"Do pass as amended",20,0,0,0,20
848049,560285,2016-08-18,Assembly,"SB 1029 Hertzberg  Senate Third Reading  By EGGMAN",78,0,0,2,80
848049,560916,2016-08-24,Senate,"Unfinished Business SB1029 Hertzberg Concurrence",39,0,0,0,39
848053,528158,2016-04-05,Assembly,"Do pass",5,1,0,1,7
848053,540289,2016-04-28,Assembly,"AB 1945 STONE  Assembly Third Reading",77,0,0,3,80
848053,552763,2016-06-14,Senate,"Do pass as amended",7,0,0,0,7
848053,560876,2016-08-23,Senate,"Assembly 3rd Reading AB1945 Mark Stone By Mitchell",39,0,0,0,39
848053,561495,2016-08-29,Assembly,"AB 1945 STONE  Concurrence in Senate Amendments",80,0,0,0,80
848056,509278,2016-02-29,Senate,"Senate 3rd Reading SCR108 Monning",40,0,0,0,40
848056,533157,2016-04-14,Assembly,"From committee:  Be adopted.  To third reading",11,0,0,0,11
848056,539733,2016-04-28,Senate,"Unfinished Business SCR108 Monning Concurrence",37,0,3,0,40
848057,528299,2016-04-05,Assembly,"Do pass and be re-referred to the Committee on Veterans Affairs",13,0,0,0,13
848057,532412,2016-04-12,Assembly,"Do pass and be re-referred to the Committee on Appropriations",9,0,0,0,9
848057,542634,2016-05-04,Assembly,"Do pass, to Consent Calendar",20,0,0,0,20
848057,545174,2016-05-12,Assembly,"AB 1936 CHAVEZ  Consent Calendar Second Day  Regular Session",78,0,0,2,80
848057,552140,2016-06-08,Senate,"Do pass, but re-refer to the Committee on Appropriations Recommend 	Consent",9,0,0,0,9
848057,559628,2016-08-11,Senate,"Placed on Appropriations Suspense file",4,2,1,0,7
848058,526586,2016-03-30,Senate,"Do pass, but re-refer to the Committee on Appropriations",8,1,0,0,9
848058,530696,2016-04-11,Senate,"Placed on Appropriations Suspense file",7,0,0,0,7
848059,535117,2016-04-19,Assembly,"Do pass and be re-referred to the Committee on Appropriations",6,0,0,1,7
848060,534590,2016-04-18,Assembly,"Do pass and be re-referred to the Committee on Appropriations",15,0,0,1,16
848060,542476,2016-05-04,Assembly,"Do pass as amended, to Consent Calendar",20,0,0,0,20
848060,545432,2016-05-12,Assembly,"AB 1960 LACKEY  Consent Calendar Second Day  Regular Session",78,0,0,2,80
848060,560809,2016-08-23,Senate,"Assembly 3rd Reading AB1960 Lackey By Galgiani",39,0,0,0,39
848060,561511,2016-08-29,Assembly,"AB 1960 LACKEY  Concurrence in Senate Amendments",80,0,0,0,80
848063,530684,2016-04-11,Senate,"Do pass, but re-refer to the Committee on Appropriations",7,0,2,0,9
848063,545871,2016-05-16,Senate,"Placed on Appropriations Suspense file",7,0,0,0,7
848063,549197,2016-05-27,Senate,"Do pass as amended",5,0,2,0,7
848063,550538,2016-06-01,Senate,"Senate 3rd Reading SB1033 Hill",15,13,12,0,40
848063,550539,2016-06-01,Senate,"Senate 3rd Reading SB1033 Hill Reconsider",39,0,1,0,40
848065,544652,2016-04-19,Assembly,"Do pass as amended and be re-referred to the Committee on 	Appropriations",12,0,0,1,13
848066,537495,2016-04-20,Assembly,"Do pass and be re-referred to the Committee on Privacy and Consumer 	Protection",6,0,0,1,7
848066,537496,2016-04-21,Assembly,"Do pass and be re-referred to the Committee on Appropriations",10,0,0,1,11
848066,546981,2016-05-18,Assembly,"Do pass",19,1,0,0,20
848066,551125,2016-06-02,Assembly,"AB 1940 COOPER  Assembly Third Reading",71,7,0,2,80
848066,556600,2016-06-28,Senate,"Do pass, but re-refer to the Committee on Appropriations",3,4,0,0,7
848068,525851,2016-03-29,Senate,"Do pass, but re-refer to the Committee on Appropriations",7,0,0,0,7
848068,544801,2016-04-25,Senate,"Placed on Appropriations Suspense file",7,0,0,0,7
848068,549187,2016-05-27,Senate,"Do pass",7,0,0,0,7
848068,550175,2016-05-31,Senate,"Senate 3rd Reading SB1046 Hill",39,0,1,0,40
848068,555549,2016-06-27,Assembly,"Do pass and be re-referred to the Committee on Business and 	Professions",10,0,0,6,16
848068,556023,2016-06-28,Assembly,"Do pass and be re-referred to the Committee on Appropriations",16,0,0,0,16
848068,559261,2016-08-11,Assembly,"Do pass as amended",20,0,0,0,20
848068,560345,2016-08-19,Assembly,"SB 1046 Hill  Senate Third Reading  By HEALTH  Amendment  Set #1",73,0,0,7,80
848068,560723,2016-08-23,Assembly,"SB 1046 Hill  Senate Third Reading  By COOLEY",79,0,0,1,80
848068,561188,2016-08-25,Senate,"Unfinished Business SB1046 Hill Concurrence",39,0,0,0,39
848069,534888,2016-04-19,Assembly,"Do pass as amended and be re-referred to the Committee on 	Appropriations",16,0,0,0,16
848069,546600,2016-05-18,Assembly,"Do pass, to Consent Calendar",20,0,0,0,20
848069,549061,2016-05-27,Assembly,"AB 1950 MAIENSCHEIN  Consent Calendar Second Day  Regular Session",67,0,0,13,80
848069,555553,2016-06-27,Senate,"Do pass, but re-refer to the Committee on Appropriations",8,0,1,0,9
848069,558801,2016-08-01,Senate,"Placed on Appropriations Suspense file",7,0,0,0,7
848071,537630,2016-04-20,Assembly,"Do pass and be re-referred to the Committee on Appropriations",6,0,0,1,7
848071,542812,2016-05-04,Assembly,"Do pass",16,4,0,0,20
848071,547261,2016-05-19,Assembly,"AB 1926 COOPER  Assembly Third Reading",60,15,0,5,80
848071,552087,2016-06-08,Senate,"Do pass as amended, and re-refer to the Committee on Appropriations",3,1,1,0,5
848071,560578,2016-08-22,Senate,"Assembly 3rd Reading AB1926 Cooper By Mendoza",26,12,1,0,39
848071,561283,2016-08-25,Assembly,"AB 1926 COOPER  Concurrence in Senate Amendments",64,12,0,4,80
848072,526433,2016-03-30,Senate,"Do pass as amended, and re-refer to the Committee on Appropriations",7,0,0,0,7
848072,537453,2016-04-21,Senate,"Senate 3rd Reading SB1027 Nielsen",39,0,1,0,40
848072,553476,2016-06-15,Assembly,"Do pass and be re-referred to the Committee on Water, Parks and 	Wildlife to Consent Calendar",9,0,0,0,9
848072,556133,2016-06-28,Assembly,"Do pass and be re-referred to the Committee on Appropriations to 	Consent Calendar",15,0,0,0,15
848072,559036,2016-08-03,Assembly,"Do pass, to Consent Calendar",20,0,0,0,20
848072,559233,2016-08-11,Assembly,"SB 1027 Nielsen  Consent Calendar Second Day  Regular Session",78,0,0,2,80
848074,532334,2016-04-13,Assembly,"Do pass and be re-referred to the Committee on Local Government",6,0,0,1,7
848074,536196,2016-04-20,Assembly,"Do pass and be re-referred to the Committee on Appropriations",8,0,0,1,9
848074,544827,2016-05-11,Assembly,"Do pass",15,1,0,4,20
848074,550871,2016-06-02,Assembly,"AB 1934 SANTIAGO  Assembly Third Reading",68,9,0,3,80
848074,560705,2016-08-23,Senate,"Assembly 3rd Reading AB1934 Santiago By McGuire",39,0,0,0,39
848074,561374,2016-08-29,Assembly,"AB 1934 SANTIAGO  Concurrence in Senate Amendments",74,6,0,0,80
848075,527614,2016-04-04,Assembly,"Do pass as amended and be re-referred to the Committee on 	Appropriations",14,2,0,0,16
848075,538943,2016-04-27,Assembly,"Do pass",12,6,0,2,20
848075,545179,2016-05-12,Assembly,"AB 1964 BLOOM  Assembly Third Reading",50,19,0,11,80
848075,558790,2016-08-01,Senate,"Placed on Appropriations Suspense file",7,0,0,0,7
848075,559528,2016-08-11,Senate,"Do pass as amended",5,1,1,0,7
849240,528516,2016-04-05,Senate,"Do pass as amended, and re-refer to the Committee on Appropriations",7,0,0,0,7
849240,549242,2016-05-27,Senate,"Do pass",7,0,0,0,7
849240,549924,2016-05-31,Senate,"Senate 3rd Reading SB1075 Runner By Anderson",38,0,2,0,40
849240,554824,2016-06-21,Assembly,"Do pass",7,0,0,0,7
849241,528140,2016-04-05,Assembly,"Do pass as amended and be re-referred to the Committee on Health",15,0,0,1,16
849241,535123,2016-04-19,Assembly,"Do pass and be re-referred to the Committee on Appropriations",17,0,0,2,19
849241,543130,2016-05-05,Assembly,"AB 2024 WOOD  Assembly Third Reading",79,0,0,1,80
849241,551438,2016-06-06,Senate,"Do pass as amended, and re-refer to the Committee on Health",8,0,1,0,9
849241,555405,2016-06-22,Senate,"Do pass, but re-refer to the Committee on Appropriations",8,0,1,0,9
849241,558935,2016-08-01,Senate,"Placed on Appropriations Suspense file",7,0,0,0,7
849241,559682,2016-08-11,Senate,"Do pass as amended",7,0,0,0,7
849241,561315,2016-08-25,Senate,"Assembly 3rd Reading AB2024 Wood By Hernandez",38,0,1,0,39
849241,561696,2016-08-31,Assembly,"AB 2024 WOOD  Concurrence in Senate Amendments",78,0,0,2,80
849242,531898,2016-04-12,Assembly,"Do pass and be re-referred to the Committee on Appropriations to 	Consent Calendar",7,0,0,0,7
849242,542785,2016-05-04,Assembly,"Do pass, to Consent Calendar",20,0,0,0,20
849242,545471,2016-05-12,Assembly,"AB 1999 ACHADJIAN  Consent Calendar Second Day  Regular Session",78,0,0,2,80
849242,552929,2016-06-14,Senate,"Do pass, but re-refer to the Committee on Appropriations Recommend 	Consent",7,0,0,0,7
849242,555730,2016-06-27,Senate,"Placed on Appropriations Suspense file",6,0,1,0,7
849242,559744,2016-08-11,Senate,"Do pass",7,0,0,0,7
849242,560619,2016-08-22,Senate,"Assembly 3rd Reading AB1999 Achadjian By Monning",39,0,0,0,39
849243,525597,2016-03-29,Senate,"Do pass as amended, and re-refer to the Committee on Appropriations",4,2,1,0,7
849243,534180,2016-04-18,Senate,"Placed on Appropriations Suspense file",7,0,0,0,7
849244,525934,2016-03-29,Assembly,"Do pass as amended, to Consent Calendar",10,0,0,0,10
849244,529560,2016-04-07,Assembly,"AB 2020 OBERNOLTE  Consent Calendar Second Day",77,0,0,2,79
849245,525552,2016-03-29,Assembly,"Do pass as amended and be re-referred to the Committee on 	Appropriations",14,0,0,1,15
849246,539062,2016-04-27,Assembly,"Do pass and be re-referred to the Committee on Local Government",5,2,0,0,7
849246,542430,2016-05-04,Assembly,"Do pass",7,1,0,1,9
849246,545217,2016-05-12,Assembly,"AB 2031 BONTA  Assembly Third Reading",51,27,0,2,80
849246,552634,2016-06-14,Senate,"Do pass, but re-refer to the Committee on Governance and Finance",8,3,0,0,11
849246,556352,2016-06-29,Senate,"Do pass as amended",4,2,1,0,7
849246,560731,2016-08-23,Senate,"Assembly 3rd Reading AB2031 Bonta By Beall",27,12,0,0,39
849246,561365,2016-08-29,Assembly,"AB 2031 BONTA  Concurrence in Senate Amendments",53,26,0,1,80
849248,533200,2016-04-13,Assembly,"Do pass as amended and be re-referred to the Committee on 	Appropriations",5,0,0,2,7
849248,549377,2016-05-27,Assembly,"Do pass as amended",14,1,0,5,20
849248,551140,2016-06-02,Assembly,"AB 2016 ALEJO  Assembly Third Reading",61,7,0,12,80
849248,555127,2016-06-22,Senate,"Do pass, but re-refer to the Committee on Appropriations",9,0,0,0,9
849248,558917,2016-08-01,Senate,"Placed on Appropriations Suspense file",7,0,0,0,7
849248,559717,2016-08-11,Senate,"Do pass as amended",5,2,0,0,7
849248,560081,2016-08-17,Senate,"Assembly 3rd Reading AB2016 Alejo By Hall",32,5,2,0,39
849248,560835,2016-08-23,Assembly,"AB 2016 ALEJO  Concurrence in Senate Amendments",60,13,0,7,80
849249,538689,2016-04-26,Assembly,"Do pass",6,0,0,1,7
849249,543264,2016-05-05,Assembly,"AB 2005 RIDLEY-THOMAS  Assembly Third Reading",79,0,0,1,80
849249,552901,2016-06-14,Senate,"Do pass",6,1,0,0,7
849249,560059,2016-08-17,Senate,"Assembly 3rd Reading AB2005 Ridley-Thomas By Leno",36,3,0,0,39
849249,560802,2016-08-23,Assembly,"AB 2005 RIDLEY-THOMAS  Concurrence in Senate Amendments",80,0,0,0,80
849253,533444,2016-04-12,Assembly,"Do pass and be re-referred to the Committee on Privacy and Consumer 	Protection",6,1,0,0,7
849253,534943,2016-04-19,Assembly,"Do pass as amended and be re-referred to the Committee on 	Appropriations",11,0,0,0,11
849253,546986,2016-05-18,Assembly,"Do pass",19,0,0,1,20
849253,550256,2016-05-31,Assembly,"AB 2036 LOPEZ  Assembly Third Reading",79,0,0,1,80
849253,552767,2016-06-14,Senate,"Do pass as amended, and re-refer to the Committee on Appropriations",4,0,1,0,5
849253,558834,2016-08-01,Senate,"Placed on Appropriations Suspense file",7,0,0,0,7
849253,559676,2016-08-11,Senate,"Do pass as amended",7,0,0,0,7
849253,560829,2016-08-23,Senate,"Assembly 3rd Reading AB2036 Lopez By Jackson",39,0,0,0,39
849253,561464,2016-08-29,Assembly,"AB 2036 LOPEZ  Concurrence in Senate Amendments",80,0,0,0,80
849254,536677,2016-04-20,Senate,"Do pass, but re-refer to the Committee on Appropriations",9,0,0,0,9
849255,526215,2016-03-29,Assembly,"Do pass as amended and be re-referred to the Committee on 	Appropriations",6,0,0,1,7
849256,535867,2016-04-19,Senate,"Do pass as amended, and re-refer to the Committee on Appropriations",7,0,0,0,7
849256,545294,2016-05-12,Senate,"Senate 3rd Reading SB1070 Hancock",35,1,4,0,40
849257,533442,2016-04-12,Assembly,"Do pass and be re-referred to the Committee on Appropriations to 	Consent Calendar",7,0,0,0,7
849257,549052,2016-05-27,Assembly,"Do pass",20,0,0,0,20
849257,550386,2016-06-01,Assembly,"AB 2015 MCCARTY  Assembly Third Reading",80,0,0,0,80
849257,556594,2016-06-28,Senate,"Do pass, but re-refer to the Committee on Appropriations Recommend 	Consent",5,0,0,0,5
849257,559452,2016-08-11,Senate,"Consent Calendar 2nd AB2015 McCarty",37,0,2,0,39
849258,536322,2016-04-20,Assembly,"Do pass as amended and be re-referred to the Committee on 	Appropriations",6,1,0,0,7
849259,541509,2016-05-03,Assembly,"Do pass",5,0,0,2,7
849259,549100,2016-05-27,Assembly,"AB 2007 MCCARTY  Assembly Third Reading  Amend By MCCARTY  Set #1",48,23,0,9,80
849259,550082,2016-05-31,Assembly,"AB 2007 MCCARTY  Assembly Third Reading",56,19,0,5,80
849259,556802,2016-06-29,Senate,"Do pass",8,0,1,0,9
849259,559850,2016-08-15,Senate,"Assembly 3rd Reading AB2007 McCarty By Hernandez",33,4,2,0,39
849259,560557,2016-08-22,Assembly,"AB 2007 MCCARTY  Concurrence in Senate Amendments",70,7,0,3,80
849261,525562,2016-03-29,Assembly,"Do pass as amended and be re-referred to the Committee on 	Appropriations",7,0,0,0,7
849261,536061,2016-04-20,Assembly,"Do pass, to Consent Calendar",16,0,0,4,20
849261,539596,2016-04-28,Assembly,"AB 2022 GORDON  Consent Calendar Second Day  Regular Session",76,0,0,4,80
849261,553150,2016-06-15,Senate,"Do pass, but re-refer to the Committee on Appropriations",7,0,0,0,7
849261,558795,2016-08-01,Senate,"Do pass",7,0,0,0,7
849261,560172,2016-08-18,Senate,"Assembly 3rd Reading AB2022 Gordon By Bates",38,0,1,0,39
849261,560956,2016-08-24,Assembly,"AB 2022 GORDON  Concurrence in Senate Amendments",79,1,0,0,80
849262,539330,2016-04-27,Assembly,"Do pass",5,2,0,0,7
849262,543003,2016-05-05,Assembly,"AB 2021 RIDLEY-THOMAS  Assembly Third Reading",55,22,0,3,80
849262,552165,2016-06-08,Senate,"Do pass",4,1,0,0,5
849262,560624,2016-08-22,Senate,"Assembly 3rd Reading AB2021 Ridley-Thomas By Liu",26,13,0,0,39
849264,534314,2016-04-18,Assembly,"Do pass and be re-referred to the Committee on Appropriations",4,6,0,6,16
849264,534315,2016-04-18,Assembly,"Reconsideration granted",15,0,0,1,16
849265,526427,2016-03-30,Assembly,"Do pass and be re-referred to the Committee on Appropriations",6,1,0,0,7
849265,532789,2016-04-13,Assembly,"Do pass",14,6,0,0,20
849265,537304,2016-04-21,Assembly,"AB 1970 LOW  Assembly Third Reading",52,26,0,2,80
849265,554914,2016-06-21,Senate,"Do pass, but re-refer to the Committee on Appropriations",4,1,0,0,5
849265,558950,2016-08-01,Senate,"Placed on Appropriations Suspense file",7,0,0,0,7
849265,559746,2016-08-11,Senate,"Do pass",5,2,0,0,7
849265,560102,2016-08-17,Senate,"Assembly 3rd Reading AB1970 Low By Allen",25,13,1,0,39
849266,541393,2016-05-03,Assembly,"Do pass, to Consent Calendar",17,0,0,1,18
849266,543798,2016-05-09,Assembly,"AB 1977 WOOD  Consent Calendar Second Day  Regular Session",78,0,0,2,80
849266,556821,2016-06-29,Senate,"Do pass",8,0,1,0,9
849266,560056,2016-08-17,Senate,"Assembly 3rd Reading AB1977 Wood By McGuire Urgency Cla",39,0,0,0,39
849266,560657,2016-08-23,Assembly,"AB 1977 WOOD  Concurrence- Urgency Added",80,0,0,0,80
849267,531377,2016-04-12,Senate,"Do pass, but re-refer to the Committee on Appropriations Recommend 	Consent",10,0,1,0,11
849267,539753,2016-04-28,Senate,"Consent Calendar 2nd SB1066 Beall",37,0,3,0,40
849267,555770,2016-06-27,Assembly,"Do pass and be re-referred to the Committee on Appropriations to 	Consent Calendar",15,0,0,1,16
849268,533158,2016-04-12,Assembly,"Do pass as amended and be re-referred to the Committee on 	Appropriations",13,0,0,0,13
849268,542670,2016-05-04,Assembly,"Do pass, to Consent Calendar",20,0,0,0,20
849268,545223,2016-05-12,Assembly,"AB 1996 GORDON  Consent Calendar Second Day  Regular Session",78,0,0,2,80
849268,552524,2016-06-13,Senate,"Do pass as amended, and re-refer to the Committee on Education",8,0,1,0,9
849268,560883,2016-08-23,Senate,"Assembly 3rd Reading AB1996 Gordon By Bates",39,0,0,0,39
849268,561837,2016-08-31,Assembly,"AB 1996 GORDON  Concurrence in Senate Amendments",79,0,0,1,80
849269,525754,2016-03-29,Senate,"Do pass as amended, and re-refer to the Committee on Judiciary",4,0,1,0,5
849269,531277,2016-04-12,Senate,"Do pass as amended, but re-refer to the Committee on Appropriations 	Recommend Consent",6,0,1,0,7
849269,545801,2016-05-16,Senate,"Placed on Appropriations Suspense file",7,0,0,0,7
849270,535081,2016-04-18,Assembly,"Do pass and be re-referred to the Committee on Judiciary",3,4,0,2,9
849270,535082,2016-04-18,Assembly,"Reconsideration granted",9,0,0,0,9
849271,528091,2016-04-05,Assembly,"Do pass and be re-referred to the Committee on Appropriations",3,7,0,0,10
849271,528092,2016-04-05,Assembly,"Reconsideration granted",10,0,0,0,10
849272,533248,2016-04-12,Assembly,"Do pass as amended and be re-referred to the Committee on 	Appropriations",7,0,0,0,7
849273,538541,2016-04-26,Assembly,"Do pass and be re-referred to the Committee on Arts, Entertain, 	Sports, Tourism, & Internet Media",4,9,0,3,16
849273,538542,2016-04-26,Assembly,"Reconsideration granted",7,7,0,2,16
849275,538971,2016-04-26,Senate,"Do pass",6,1,0,0,7
849275,541056,2016-05-02,Senate,"Senate 3rd Reading SB1065 Monning",26,9,5,0,40
849275,556075,2016-06-28,Assembly,"Do pass as amended",10,0,0,0,10
849275,559636,2016-08-10,Assembly,"Do pass, to Consent Calendar",19,0,0,1,20
849275,561020,2016-08-24,Assembly,"SB 1065 Monning  Senate Third Reading  By CHIU",79,0,0,1,80
849275,561345,2016-08-26,Senate,"Unfinished Business SB1065 Monning Concurrence",39,0,0,0,39
849276,525935,2016-03-29,Assembly,"Do pass as amended and be re-referred to the Committee on Judiciary",6,0,0,1,7
849276,534819,2016-04-19,Assembly,"Do pass and be re-referred to the Committee on Appropriations",9,0,0,1,10
849276,549119,2016-05-27,Assembly,"Do pass",17,0,0,3,20
849276,550442,2016-06-01,Assembly,"AB 2027 QUIRK  Assembly Third Reading",73,0,0,7,80
849276,556363,2016-06-28,Senate,"Do pass, but re-refer to the Committee on Appropriations",6,0,1,0,7
849276,558806,2016-08-01,Senate,"Placed on Appropriations Suspense file",7,0,0,0,7
849276,559624,2016-08-11,Senate,"Do pass as amended",7,0,0,0,7
849276,560145,2016-08-18,Senate,"Assembly 3rd Reading AB2027 Quirk By De Le",38,0,1,0,39
849276,560923,2016-08-24,Assembly,"AB 2027 QUIRK  Concurrence in Senate Amendments",73,1,0,6,80
849277,531718,2016-04-12,Senate,"Do pass as amended, and re-refer to the Committee on Appropriations",6,0,1,0,7
849277,549350,2016-05-27,Senate,"Do pass as amended",5,2,0,0,7
849277,550584,2016-06-01,Senate,"Senate 3rd Reading SB1060 Leno",31,7,2,0,40
849277,554928,2016-06-21,Assembly,"Do pass as amended and be re-referred to the Committee on Human 	Services",9,0,0,1,10
849277,556106,2016-06-28,Assembly,"Do pass and be re-referred to the Committee on Appropriations to 	Consent Calendar",7,0,0,0,7
849277,559424,2016-08-11,Assembly,"Do pass",20,0,0,0,20
849277,560242,2016-08-18,Assembly,"SB 1060 Leno  Senate Third Reading  By WILLIAMS",78,0,0,2,80
849277,560994,2016-08-24,Senate,"Unfinished Business SB1060 Leno Concurrence",39,0,0,0,39
849278,539341,2016-04-27,Assembly,"Do pass, to Consent Calendar",7,0,0,0,7
849278,543046,2016-05-05,Assembly,"AB 2010 RIDLEY-THOMAS  Consent Calendar Second Day  Regular Session",79,0,0,1,80
849278,552061,2016-06-08,Senate,"Do pass and be placed on the Consent Calendar",5,0,0,0,5
849278,556928,2016-06-30,Senate,"Consent Calendar 2nd AB2010 Ridley-Thomas",37,0,3,0,40
849278,558643,2016-08-01,Assembly,"AB 2010 RIDLEY-THOMAS  Concurrence in Senate Amendments",75,0,0,5,80
849279,536114,2016-04-20,Assembly,"Do pass and be re-referred to the Committee on Appropriations",2,3,0,2,7
849279,536115,2016-04-20,Assembly,"Reconsideration granted",7,0,0,0,7
849280,525956,2016-03-29,Assembly,"Do pass and be re-referred to the Committee on Appropriations to 	Consent Calendar",13,0,0,2,15
849280,536433,2016-04-20,Assembly,"Do pass, to Consent Calendar",16,0,0,4,20
849280,540276,2016-04-28,Assembly,"AB 2001 MATHIS  Consent Calendar Second Day  Regular Session",76,0,0,4,80
849280,552924,2016-06-14,Senate,"Do pass as amended, but re-refer to the Committee on Appropriations 	Recommend Consent",9,0,0,0,9
849280,559945,2016-08-16,Senate,"Assembly 3rd Reading AB2001 Mathis By Berryhill",38,0,1,0,39
849280,560890,2016-08-23,Assembly,"AB 2001 MATHIS  Concurrence in Senate Amendments",79,0,0,1,80
849282,528284,2016-04-05,Senate,"Do pass as amended, but re-refer to the Committee on Appropriations 	Recommend Consent",7,0,0,0,7
849282,537313,2016-04-21,Senate,"Consent Calendar 2nd SB1054 Pavley",39,0,1,0,40
849282,554743,2016-06-21,Assembly,"Amend, and do pass as amended and be re-referred to the Committee 	on Appropriations with the recommendation:  To Consent Calendar",7,0,0,0,7
849282,559023,2016-08-03,Assembly,"Do pass, to Consent Calendar",20,0,0,0,20
849282,560806,2016-08-23,Assembly,"SB 1054 Pavley  Senate Third Reading  By JONES-SAWYER",80,0,0,0,80
849282,561296,2016-08-25,Senate,"Unfinished Business SB1054 Pavley Concurrence",39,0,0,0,39
849284,535887,2016-04-19,Assembly,"Do pass as amended and be re-referred to the Committee on 	Appropriations",16,0,0,3,19
849284,549381,2016-05-27,Assembly,"Do pass as amended",16,2,0,2,20
849284,550900,2016-06-02,Assembly,"AB 2004 BLOOM  Assembly Third Reading",69,6,0,5,80
849284,556742,2016-06-29,Senate,"Do pass, but re-refer to the Committee on Appropriations",5,0,4,0,9
849284,558769,2016-08-01,Senate,"Placed on Appropriations Suspense file",7,0,0,0,7
849285,544731,2016-04-19,Assembly,"Do pass as amended and be re-referred to the Committee on 	Appropriations",13,0,0,0,13
849285,544992,2016-05-11,Assembly,"Do pass",19,1,0,0,20
849285,547863,2016-05-23,Assembly,"AB 1985 WILLIAMS  Assembly Third Reading",73,2,0,5,80
849285,553208,2016-06-15,Senate,"Do pass as amended, and re-refer to the Committee on Appropriations",9,0,0,0,9
849285,558840,2016-08-01,Senate,"Placed on Appropriations Suspense file",7,0,0,0,7
849285,559699,2016-08-11,Senate,"Do pass",7,0,0,0,7
849285,559925,2016-08-16,Senate,"Assembly 3rd Reading AB1985 Williams By Block",38,0,1,0,39
849285,560860,2016-08-23,Assembly,"AB 1985 WILLIAMS  Concurrence in Senate Amendments",75,4,0,1,80
849286,530520,2016-04-11,Assembly,"Be referred to Committee on Public Safety",9,0,0,2,11
849286,535307,2016-04-19,Assembly,"Do pass and be re-referred to the Committee on Appropriations to 	Consent Calendar",7,0,0,0,7
849286,542579,2016-05-04,Assembly,"Do pass, to Consent Calendar",20,0,0,0,20
849286,545442,2016-05-12,Assembly,"AB 1998 CAMPOS  Consent Calendar Second Day  Regular Session",78,0,0,2,80
849286,556490,2016-06-28,Senate,"Do pass, but re-refer to the Committee on Appropriations",7,0,0,0,7
849286,558843,2016-08-01,Senate,"Placed on Appropriations Suspense file",7,0,0,0,7
849286,559774,2016-08-11,Senate,"Do pass as amended",7,0,0,0,7
849286,560077,2016-08-17,Senate,"Assembly 3rd Reading AB1998 Campos By Hernandez",39,0,0,0,39
849286,560872,2016-08-23,Assembly,"AB 1998 CAMPOS  Concurrence in Senate Amendments",80,0,0,0,80
849287,529016,2016-04-06,Assembly,"Do pass and be re-referred to the Committee on Appropriations",17,0,0,4,21
849287,536548,2016-04-20,Assembly,"Do pass, to Consent Calendar",16,0,0,4,20
849287,539618,2016-04-28,Assembly,"AB 2011 COOPER  Consent Calendar Second Day  Regular Session",76,0,0,4,80
849287,552737,2016-06-14,Senate,"Do pass, but re-refer to the Committee on Appropriations",12,0,1,0,13
849287,560793,2016-08-23,Senate,"Assembly 3rd Reading AB2011 Cooper By Hall Urgency Clause",39,0,0,0,39
849287,561460,2016-08-29,Assembly,"AB 2011 COOPER  Concurrence- Urgency Added",80,0,0,0,80
849288,527949,2016-04-05,Senate,"Do pass, but re-refer to the Committee on Education",10,0,1,0,11
849288,532279,2016-04-13,Senate,"Do pass, but re-refer to the Committee on Appropriations",9,0,0,0,9
849288,543800,2016-05-09,Senate,"Senate 3rd Reading SB1072 Mendoza",35,0,5,0,40
849288,552451,2016-06-13,Assembly,"Do pass and be re-referred to the Committee on Education",13,0,0,3,16
849288,555248,2016-06-22,Assembly,"Do pass as amended and be re-referred to the Committee on 	Appropriations",7,0,0,0,7
849288,559243,2016-08-11,Assembly,"Do pass",15,2,0,3,20
849288,560394,2016-08-19,Assembly,"SB 1072 Mendoza  Senate Third Reading  Amendment  Set #1",73,0,0,7,80
849288,560710,2016-08-23,Assembly,"SB 1072 Mendoza  Senate Third Reading",70,10,0,0,80
849288,561333,2016-08-26,Senate,"Unfinished Business SB1072 Mendoza Concurrence",39,0,0,0,39
849289,526085,2016-03-29,Assembly,"Do pass and be re-referred to the Committee on Veterans Affairs",15,0,0,0,15
849289,532519,2016-04-12,Assembly,"Do pass and be re-referred to the Committee on Appropriations",9,0,0,0,9
849289,548986,2016-05-27,Assembly,"Do pass as amended",20,0,0,0,20
849289,550479,2016-06-01,Assembly,"AB 1972 CHAU  Assembly Third Reading",79,0,0,1,80
849289,555966,2016-06-28,Senate,"Do pass, but re-refer to the Committee on Appropriations Recommend 	Consent",8,0,1,0,9
849289,558728,2016-08-01,Senate,"Placed on Appropriations Suspense file",7,0,0,0,7
849291,525788,2016-03-29,Assembly,"Do pass and be re-referred to the Committee on Appropriations",9,1,0,0,10
849291,549249,2016-05-27,Assembly,"Do pass as amended",17,2,0,1,20
849291,551142,2016-06-02,Assembly,"AB 2000 CAMPOS  Assembly Third Reading",68,9,0,3,80
849291,556512,2016-06-28,Senate,"Do pass, but re-refer to the Committee on Appropriations",6,0,1,0,7
849291,558879,2016-08-01,Senate,"Placed on Appropriations Suspense file",7,0,0,0,7
849292,535357,2016-04-19,Senate,"Do pass, but re-refer to the Committee on Judiciary",11,0,0,0,11
849292,542496,2016-05-03,Senate,"Do pass as amended",6,0,1,0,7
849292,547793,2016-05-23,Senate,"Senate 3rd Reading SB1051 Hancock",37,0,3,0,40
849292,554811,2016-06-20,Assembly,"Do pass and be re-referred to the Committee on Privacy and Consumer 	Protection",16,0,0,0,16
849292,556100,2016-06-28,Assembly,"Do pass as amended",10,0,0,1,11
849292,560339,2016-08-18,Assembly,"SB 1051 Hancock  Senate Third Reading  By BONTA",68,9,0,3,80
849292,561051,2016-08-24,Senate,"Unfinished Business SB1051 Hancock Concurrence",39,0,0,0,39
849293,533092,2016-04-12,Assembly,"Do pass and be re-referred to the Committee on Appropriations",13,0,0,0,13
849293,549382,2016-05-27,Assembly,"Do pass as amended",19,0,0,1,20
849293,550614,2016-06-01,Assembly,"AB 2018 RIDLEY-THOMAS  Assembly Third Reading",79,0,0,1,80
849293,553204,2016-06-15,Senate,"Do pass as amended, and re-refer to the Committee on Appropriations",9,0,0,0,9
849293,558925,2016-08-01,Senate,"Placed on Appropriations Suspense file",7,0,0,0,7
849294,531901,2016-04-12,Senate,"Do pass, but re-refer to the Committee on Appropriations Recommend 	Consent",6,0,1,0,7
849294,544601,2016-04-25,Senate,"Placed on Appropriations Suspense file",7,0,0,0,7
849294,549335,2016-05-27,Senate,"Do pass as amended",7,0,0,0,7
849294,550463,2016-06-01,Senate,"Senate 3rd Reading SB1064 Hancock",39,0,1,0,40
849294,556125,2016-06-28,Assembly,"Do pass, to Consent Calendar",7,0,0,0,7
849294,560510,2016-08-22,Assembly,"SB 1064 Hancock  Senate Third Reading  By GONZALEZ",79,0,0,1,80
849294,561498,2016-08-29,Senate,"Special Consent SB1064 Hancock",39,0,0,0,39
849295,527677,2016-04-04,Senate,"Do pass, but re-refer to the Committee on Rules",9,0,0,0,9
849295,532436,2016-04-12,Senate,"Do pass, but re-refer to the Committee on Appropriations",4,0,1,0,5
849295,543789,2016-05-09,Senate,"Senate 3rd Reading SB1059 Monning",36,0,4,0,40
849295,552633,2016-06-14,Assembly,"Do pass as amended and be re-referred to the Committee on Veterans 	Affairs",13,0,0,0,13
849295,556324,2016-06-28,Assembly,"Do pass and be re-referred to the Committee on Appropriations",7,0,0,2,9
849295,559001,2016-08-03,Assembly,"Do pass",20,0,0,0,20
849295,560214,2016-08-18,Assembly,"SB 1059 Monning  Senate Third Reading  By IRWIN",79,0,0,1,80
849295,561180,2016-08-25,Senate,"Special Consent SB1059 Monning",39,0,0,0,39
849296,529345,2016-04-06,Senate,"Do pass as amended, but re-refer to the Committee on Judiciary 	Recommend Consent",9,0,0,0,9
849296,543221,2016-05-05,Senate,"Consent Calendar 2nd SB1067 Huff",36,0,4,0,40
849296,553498,2016-06-14,Assembly,"Amend, and do pass as amended and be re-referred to the Committee 	on Appropriations with the recommendation:  To Consent Calendar",15,0,0,3,18
849296,556533,2016-06-29,Assembly,"Do pass, to Consent Calendar",18,0,0,2,20
849296,559117,2016-08-04,Assembly,"SB 1067 Huff  Consent Calendar Second Day  Regular Session",77,0,0,3,80
849296,559501,2016-08-11,Senate,"Special Consent SB1067 Huff Concurrence",37,0,2,0,39
849297,544322,2016-04-19,Assembly,"Do pass and be re-referred to the Committee on Appropriations",7,6,0,0,13
849300,533137,2016-04-12,Assembly,"Do pass and be re-referred to the Committee on Appropriations to 	Consent Calendar",7,0,0,0,7
849300,549070,2016-05-27,Assembly,"Do pass as amended",20,0,0,0,20
849300,550492,2016-06-01,Assembly,"AB 1997 STONE  Assembly Third Reading",80,0,0,0,80
849300,556435,2016-06-28,Senate,"Do pass as amended, and re-refer to the Committee on Appropriations",5,0,0,0,5
849300,559610,2016-08-11,Senate,"Do pass as amended",6,0,1,0,7
849300,560955,2016-08-24,Senate,"Assembly 3rd Reading AB1997 Mark Stone By McGuire",39,0,0,0,39
849300,561591,2016-08-30,Assembly,"AB 1997 STONE  Concurrence in Senate Amendments",80,0,0,0,80
849301,533020,2016-04-13,Assembly,"Do pass and be re-referred to the Committee on Appropriations",9,0,0,0,9
849301,539004,2016-04-27,Assembly,"Do pass, to Consent Calendar",19,0,0,1,20
849301,542971,2016-05-05,Assembly,"AB 1974 GALLAGHER  Consent Calendar Second Day  Regular Session",79,0,0,1,80
849301,553136,2016-06-15,Senate,"Do pass as amended, and re-refer to the Committee on Appropriations",7,0,0,0,7
849301,560736,2016-08-23,Senate,"Assembly 3rd Reading AB1974 Gallagher By Vidak",39,0,0,0,39
849301,561583,2016-08-30,Assembly,"AB 1974 GALLAGHER  Concurrence in Senate Amendments",80,0,0,0,80
849302,537372,2016-04-20,Assembly,"Do pass and be re-referred to the Committee on Appropriations",5,2,0,0,7
849302,549027,2016-05-27,Assembly,"Do pass as amended",14,6,0,0,20
849302,550949,2016-06-02,Assembly,"AB 1978 GONZALEZ  Assembly Third Reading",51,23,0,6,80
849302,556461,2016-06-29,Senate,"Do pass, but re-refer to the Committee on Appropriations",4,1,0,0,5
849302,558977,2016-08-01,Senate,"Placed on Appropriations Suspense file",7,0,0,0,7
849302,559761,2016-08-11,Senate,"Do pass",5,2,0,0,7
849302,561249,2016-08-25,Senate,"Assembly 3rd Reading AB1978 Gonzalez By Leyva",35,1,3,0,39
849302,561542,2016-08-30,Assembly,"AB 1978 GONZALEZ  Concurrence in Senate Amendments",68,7,0,5,80
849304,531895,2016-04-12,Assembly,"Do pass as amended and be re-referred to the Committee on 	Appropriations",13,0,0,3,16
849304,545062,2016-05-11,Assembly,"Do pass",20,0,0,0,20
849304,547197,2016-05-19,Assembly,"AB 2025 GONZALEZ  Assembly Third Reading",69,3,0,8,80
849304,552481,2016-06-13,Senate,"Do pass, but re-refer to the Committee on Labor and Industrial 	Relations",8,0,1,0,9
849304,556504,2016-06-29,Senate,"Do pass, but re-refer to the Committee on Appropriations",5,0,0,0,5
849304,558945,2016-08-01,Senate,"Placed on Appropriations Suspense file",7,0,0,0,7
849304,559729,2016-08-11,Senate,"Do pass",7,0,0,0,7
849304,560845,2016-08-23,Senate,"Assembly 3rd Reading AB2025 Gonzalez By Nguyen",39,0,0,0,39
849304,561624,2016-08-30,Assembly,"AB 2025 GONZALEZ  Concurrence in Senate Amendments",78,1,0,1,80
849305,529048,2016-04-06,Assembly,"Do pass and be re-referred to the Committee on Appropriations to 	Consent Calendar",6,0,0,1,7
849306,535385,2016-04-19,Senate,"Do pass, but re-refer to the Committee on Appropriations",5,1,1,0,7
849306,545993,2016-05-16,Senate,"Placed on Appropriations Suspense file",7,0,0,0,7
849306,549026,2016-05-27,Senate,"Do pass as amended",5,2,0,0,7
849306,550417,2016-06-01,Senate,"Senate 3rd Reading SB1052 Lara",24,14,2,0,40
849306,555975,2016-06-28,Assembly,"Do pass and be re-referred to the Committee on Appropriations",5,2,0,0,7
849306,559231,2016-08-11,Assembly,"Do pass",14,6,0,0,20
849306,560692,2016-08-23,Assembly,"SB 1052 Lara  Senate Third Reading  By BLOOM",50,28,0,2,80
849306,561566,2016-08-30,Senate,"Unfinished Business (S upplemental File 1)SB1 052 Lar a Con",26,13,0,0,39
849307,534795,2016-04-19,Senate,"Do pass, but re-refer to the Committee on Governance and Finance",10,1,0,0,11
849307,536326,2016-04-20,Senate,"Do pass as amended, and re-refer to the Committee on Appropriations",6,0,1,0,7
849307,545778,2016-05-16,Senate,"Senate 3rd Reading SB1069 Wieckowski",29,3,8,0,40
849307,553151,2016-06-15,Assembly,"Do pass as amended and be re-referred to the Committee on Local 	Government",6,0,0,1,7
849307,556767,2016-06-29,Assembly,"Do pass and be re-referred to the Committee on Appropriations",6,2,0,1,9
849307,559564,2016-08-10,Assembly,"Do pass",15,3,0,2,20
849307,560395,2016-08-19,Assembly,"SB 1069 Wieckowski  Senate Third Reading  Amendment  Set #1",73,0,0,7,80
849307,561402,2016-08-29,Assembly,"SB 1069 Wieckowski  Senate Third Reading  By ATKINS",55,23,0,2,80
849307,561592,2016-08-30,Senate,"Unfinished Business (S upplemental File 2)SB1 069 Wie ckowski Con",30,2,7,0,39
849308,535596,2016-04-19,Senate,"Do pass, but re-refer to the Committee on Appropriations",11,0,0,0,11
849308,548744,2016-05-26,Senate,"Senate 3rd Reading SB1055 Hueso",39,0,1,0,40
849308,557070,2016-06-29,Assembly,"Do pass and be re-referred to the Committee on Appropriations to 	Consent Calendar",15,0,0,0,15
849308,559074,2016-08-03,Assembly,"Do pass, to Consent Calendar",20,0,0,0,20
849308,559272,2016-08-11,Assembly,"SB 1055 Hueso  Consent Calendar Second Day  Regular Session",78,0,0,2,80
849310,526200,2016-03-30,Assembly,"Do pass and be re-referred to the Committee on Natural Resources",6,1,0,0,7
849310,534832,2016-04-18,Assembly,"Do pass and be re-referred to the Committee on Appropriations",7,2,0,0,9
849310,549132,2016-05-27,Assembly,"Do pass",14,6,0,0,20
849310,550883,2016-06-02,Assembly,"AB 2002 STONE  Assembly Third Reading",54,23,0,3,80
849310,554683,2016-06-21,Senate,"Do pass, but re-refer to the Committee on Natural Resources and 	Water",4,1,0,0,5
849310,555989,2016-06-28,Senate,"Do pass, but re-refer to the Committee on Appropriations",6,2,1,0,9
849310,558811,2016-08-01,Senate,"Placed on Appropriations Suspense file",7,0,0,0,7
849310,559566,2016-08-11,Senate,"Do pass",5,2,0,0,7
849310,561755,2016-08-31,Senate,"Assembly 3rd Reading AB2002 Mark Stone By Allen",22,13,4,0,39
849310,561756,2016-08-31,Senate,"Assembly 3rd Reading AB2002 Mark Stone By Allen",39,0,0,0,39
849311,536559,2016-04-20,Assembly,"Do pass and be re-referred to the Committee on Appropriations to 	Consent Calendar",9,0,0,0,9
849311,545030,2016-05-11,Assembly,"Do pass, to Consent Calendar",20,0,0,0,20
849311,547112,2016-05-19,Assembly,"AB 2032 LINDER  Consent Calendar Second Day  Regular Session",76,0,0,4,80
849311,553232,2016-06-15,Senate,"Do pass, but re-refer to the Committee on Appropriations Recommend 	Consent",7,0,0,0,7
849311,556889,2016-06-30,Senate,"Consent Calendar 2nd AB2032 Linder",37,0,3,0,40
849311,559130,2016-08-04,Assembly,"AB 2032 LINDER  Concurrence in Senate Amendments",77,0,0,3,80
849312,526076,2016-03-29,Assembly,"Do pass and be re-referred to the Committee on Appropriations",2,2,0,3,7
849313,529028,2016-04-06,Assembly,"Do pass and be re-referred to the Committee on Appropriations to 	Consent Calendar",6,0,0,1,7
849313,536986,2016-04-20,Assembly,"Do pass, to Consent Calendar",16,0,0,4,20
849313,540257,2016-04-28,Assembly,"AB 2028 COOPER  Consent Calendar Second Day  Regular Session",76,0,0,4,80
849313,555701,2016-06-27,Senate,"Do pass, but re-refer to the Committee on Appropriations Recommend 	Consent",5,0,0,0,5
849313,559417,2016-08-11,Senate,"Consent Calendar 2nd AB2028 Cooper",37,0,2,0,39
849313,560717,2016-08-23,Assembly,"AB 2028 COOPER  Concurrence in Senate Amendments",79,0,0,1,80
849314,542420,2016-05-04,Assembly,"Do pass",8,0,0,1,9
849314,545320,2016-05-12,Assembly,"AB 2030 MULLIN  Assembly Third Reading",73,1,0,6,80
849314,554884,2016-06-21,Senate,"Do pass and be placed on the Consent Calendar",11,0,0,0,11
849314,557110,2016-06-30,Senate,"Consent Calendar 2nd AB2030 Mullin",37,0,3,0,40
849314,559155,2016-08-04,Assembly,"AB 2030 MULLIN  Concurrence in Senate Amendments",75,1,0,4,80
849315,533086,2016-04-12,Assembly,"Do pass and be re-referred to the Committee on Appropriations",12,0,0,1,13
849315,549401,2016-05-27,Assembly,"Do pass as amended",14,6,0,0,20
849315,550837,2016-06-02,Assembly,"AB 2009 LOPEZ  Assembly Third Reading",57,18,0,5,80
849315,555054,2016-06-22,Senate,"Do pass, but re-refer to the Committee on Appropriations",8,1,0,0,9
849315,558887,2016-08-01,Senate,"Placed on Appropriations Suspense file",7,0,0,0,7
849315,559770,2016-08-11,Senate,"Do pass",5,2,0,0,7
849315,561403,2016-08-29,Senate,"Assembly 3rd Reading AB2009 Lopez By Lara",28,11,0,0,39
849316,533251,2016-04-13,Senate,"Do pass as amended, and re-refer to the Committee on Appropriations",8,1,0,0,9
849316,545247,2016-05-12,Senate,"Senate 3rd Reading SB1076 Hernandez",32,5,3,0,40
849316,556253,2016-06-28,Assembly,"Do pass and be re-referred to the Committee on Appropriations",16,2,0,0,18
849316,559020,2016-08-03,Assembly,"Do pass",16,4,0,0,20
849316,560521,2016-08-22,Assembly,"SB 1076 Hernandez  Senate Third Reading  By BURKE",65,12,0,3,80
849316,560965,2016-08-24,Senate,"Unfinished Business SB1076 Hernandez Concurrence",34,5,0,0,39
849317,532206,2016-04-11,Assembly,"Amend, and do pass as amended and be re-referred to the Committee 	on Appropriations with the recommendation:  To Consent Calendar",16,0,0,0,16
849318,536902,2016-04-20,Senate,"Do pass as amended, and re-refer to the Committee on Appropriations",7,0,0,0,7
849318,547625,2016-05-23,Senate,"Placed on Appropriations Suspense file",7,0,0,0,7
849318,549248,2016-05-27,Senate,"Do pass as amended",5,0,2,0,7
849318,550704,2016-06-01,Senate,"Senate 3rd Reading SB1073 Monning",33,2,5,0,40
849318,556067,2016-06-28,Assembly,"Do pass and be re-referred to the Committee on Appropriations",7,0,0,0,7
849318,559407,2016-08-11,Assembly,"Do pass as amended",11,0,0,9,20
849318,560416,2016-08-19,Assembly,"SB 1073 Monning  Senate Third Reading  By BUDGET  Amendment  Set #1",73,0,0,7,80
849318,560851,2016-08-23,Assembly,"Do pass",9,0,0,0,9
849318,561284,2016-08-25,Assembly,"SB 1073 Monning  Senate Third Reading  By STONE",78,0,0,2,80
849318,561426,2016-08-29,Senate,"From committee:  That the Assembly Amendments be concurred in",7,0,0,0,7
849318,561560,2016-08-30,Senate,"Unfinished Business SB1073 Monning Concurrence",39,0,0,0,39
849321,531959,2016-04-12,Assembly,"Do pass and be re-referred to the Committee on Appropriations",7,0,0,0,7
849321,549443,2016-05-27,Assembly,"Do pass",16,1,0,3,20
849321,550623,2016-06-01,Assembly,"AB 2013 JONES-SAWYER  Assembly Third Reading",63,14,0,3,80
849321,556617,2016-06-28,Senate,"Do pass, but re-refer to the Committee on Appropriations",4,3,0,0,7
849321,558892,2016-08-01,Senate,"Placed on Appropriations Suspense file",7,0,0,0,7
849321,559725,2016-08-11,Senate,"Do pass as amended",5,2,0,0,7
849321,561011,2016-08-24,Senate,"Assembly 3rd Reading AB2013 Jones-Sawyer By Leno",22,15,2,0,39
849321,561647,2016-08-30,Assembly,"AB 2013 JONES-SAWYER  Concurrence in Senate Amendments",64,14,0,2,80
849322,537021,2016-04-20,Assembly,"Do pass and be re-referred to the Committee on Appropriations",21,0,0,0,21
849322,542403,2016-05-04,Assembly,"Do pass, to Consent Calendar",20,0,0,0,20
849322,545485,2016-05-12,Assembly,"AB 1971 COOPER  Consent Calendar Second Day  Regular Session",78,0,0,2,80
849322,552682,2016-06-14,Senate,"Do pass as amended, and re-refer to the Committee on Appropriations",12,0,1,0,13
849323,528808,2016-04-06,Assembly,"Do pass and be re-referred to the Committee on Appropriations to 	Consent Calendar",18,0,0,3,21
849323,546721,2016-05-18,Assembly,"Do pass, to Consent Calendar",20,0,0,0,20
849323,549042,2016-05-27,Assembly,"AB 1980 IRWIN  Consent Calendar Second Day  Regular Session",67,0,0,13,80
849323,559988,2016-08-16,Senate,"Assembly 3rd Reading AB1980 Irwin",39,0,0,0,39
849325,526412,2016-03-30,Assembly,"Do pass and be re-referred to the Committee on Appropriations to 	Consent Calendar",9,0,0,1,10
849325,532345,2016-04-06,Assembly,"Do pass, to Consent Calendar",18,0,0,2,20
849325,533483,2016-04-14,Assembly,"AB 1976 IRWIN  Consent Calendar Second Day  Regular Session",76,0,0,4,80
849325,554758,2016-06-21,Senate,"Do pass as amended, and re-refer to the Committee on Appropriations",5,0,0,0,5
849325,560796,2016-08-23,Senate,"Assembly 3rd Reading AB1976 Irwin By Jackson",39,0,0,0,39
849325,561619,2016-08-30,Assembly,"Senate amendments be concurred in",18,0,0,3,21
849325,561783,2016-08-31,Assembly,"AB 1976 IRWIN  Concurrence in Senate Amendments",79,0,0,1,80
849326,525903,2016-03-29,Assembly,"Do pass",7,0,0,0,7
849326,530478,2016-04-11,Assembly,"AB 2012 BIGELOW  Assembly Third Reading",77,0,0,2,79
849326,554934,2016-06-21,Senate,"Do pass as amended, and re-refer to the Committee on Appropriations",7,0,0,0,7
849326,558947,2016-08-01,Senate,"Placed on Appropriations Suspense file",7,0,0,0,7
849326,559749,2016-08-11,Senate,"Do pass as amended",7,0,0,0,7
849326,560072,2016-08-17,Senate,"Assembly 3rd Reading AB2012 Bigelow By Hall",39,0,0,0,39
849326,560843,2016-08-23,Assembly,"AB 2012 BIGELOW  Concurrence in Senate Amendments",79,0,0,1,80
849328,528423,2016-04-05,Assembly,"Do pass as amended and be re-referred to the Committee on 	Appropriations",5,1,0,1,7
849328,539034,2016-04-27,Assembly,"Do pass",13,5,0,2,20
849328,545465,2016-05-12,Assembly,"AB 1993 IRWIN  Assembly Third Reading  Amend By IRWIN  Set #1",50,25,0,5,80
849328,547213,2016-05-19,Assembly,"AB 1993 IRWIN  Assembly Third Reading",54,19,0,7,80
849328,556579,2016-06-28,Senate,"Do pass as amended, and re-refer to the Committee on Appropriations",7,0,0,0,7
849328,559648,2016-08-11,Senate,"Do pass",6,1,0,0,7
849328,561253,2016-08-25,Senate,"Assembly 3rd Reading AB1993 Irwin By Pavley",25,13,1,0,39
849328,561594,2016-08-30,Assembly,"AB 1993 IRWIN  Concurrence in Senate Amendments",55,22,0,3,80
849330,527628,2016-04-04,Assembly,"Do pass and be re-referred to the Committee on Appropriations to 	Consent Calendar",16,0,0,0,16
849330,536300,2016-04-20,Assembly,"Do pass, to Consent Calendar",16,0,0,4,20
849330,539795,2016-04-28,Assembly,"AB 2034 SALAS  Consent Calendar Second Day  Regular Session",76,0,0,4,80
849331,519635,2016-03-14,Assembly,"Be adopted and re-referred to the Committee on Appropriations with 	recommendation:  To Consent Calendar",16,0,0,0,16
849331,530455,2016-04-11,Assembly,"ACR 138 LACKEY  Consent Calendar Second Day  Regular Session",77,0,0,2,79
849331,532602,2016-04-06,Assembly,"Be adopted, to Consent Calendar",18,0,0,2,20
849331,560365,2016-08-19,Senate,"Assembly 3rd Reading ACR138 Lackey By Fuller",37,0,2,0,39
849331,561070,2016-08-24,Assembly,"ACR 138 LACKEY  Concurrence in Senate Amendments",79,0,0,1,80
849332,533367,2016-04-14,Assembly,"Be referred to Committee on Utilities and Commerce",11,0,0,0,11
849332,537369,2016-04-20,Assembly,"Do pass as amended and be re-referred to the Committee on 	Appropriations",14,0,0,1,15
849332,544979,2016-05-11,Assembly,"Do pass, to Consent Calendar",20,0,0,0,20
849332,549412,2016-05-27,Assembly,"AB 1979 BIGELOW  Assembly Third Reading",72,0,0,8,80
849332,554837,2016-06-21,Senate,"Do pass, but re-refer to the Committee on Appropriations",10,0,1,0,11
849332,560798,2016-08-23,Senate,"Assembly 3rd Reading AB1979 Bigelow By Hueso",37,0,2,0,39
849332,561490,2016-08-29,Assembly,"AB 1979 BIGELOW  Concurrence in Senate Amendments",80,0,0,0,80
849333,547629,2016-05-23,Senate,"Placed on Appropriations Suspense file",7,0,0,0,7
849333,549302,2016-05-27,Senate,"Do pass as amended",5,2,0,0,7
849333,551163,2016-06-02,Senate,"Senate 3rd Reading SB1074 Hueso",29,9,2,0,40
849333,556907,2016-06-29,Assembly,"Do pass and be re-referred to the Committee on Appropriations",14,0,0,1,15
849333,559405,2016-08-11,Assembly,"Do pass",15,0,0,5,20
849333,561519,2016-08-29,Assembly,"SB 1074 Hueso  Senate Third Reading  By GARCIA, E",80,0,0,0,80
849333,561795,2016-08-31,Senate,"Unfinished Business SB1074 Hueso Concurrence",30,9,0,0,39
849334,531753,2016-04-12,Assembly,"Do pass as amended and be re-referred to the Committee on 	Appropriations",12,2,0,1,15
849336,535795,2016-04-18,Assembly,"Do pass as amended and be re-referred to the Committee on 	Appropriations",9,0,0,0,9
849336,549369,2016-05-27,Assembly,"Do pass as amended",20,0,0,0,20
849336,550647,2016-06-01,Assembly,"AB 2029 DAHLE  Assembly Third Reading",80,0,0,0,80
849336,556115,2016-06-28,Senate,"Do pass as amended, and re-refer to the Committee on Appropriations",7,0,2,0,9
849336,559666,2016-08-11,Senate,"Do pass as amended",6,0,1,0,7
849336,560788,2016-08-23,Senate,"Assembly 3rd Reading AB2029 Dahle By Hueso",39,0,0,0,39
849336,561491,2016-08-29,Assembly,"AB 2029 DAHLE  Concurrence in Senate Amendments",80,0,0,0,80
849337,530445,2016-04-11,Senate,"Do pass, but re-refer to the Committee on Appropriations",5,0,0,0,5
849337,534162,2016-04-18,Senate,"Placed on Appropriations Suspense file",7,0,0,0,7
849339,525547,2016-03-29,Senate,"Do pass, but re-refer to the Committee on Appropriations",7,2,0,0,9
849339,534170,2016-04-18,Senate,"Senate 3rd Reading SB1062 Lara",29,9,2,0,40
849339,552647,2016-06-14,Assembly,"Do pass as amended and be re-referred to the Committee on Arts, 	Entertain, Sports, Tourism, & Internet Media",12,2,0,1,15
849339,554623,2016-06-21,Assembly,"Do pass and be re-referred to the Committee on Appropriations",4,2,0,1,7
849339,556336,2016-06-29,Assembly,"Do pass",16,2,0,2,20
849339,559100,2016-08-04,Assembly,"SB 1062 Lara  Senate Third Reading  By BONTA",65,7,0,8,80
849339,559279,2016-08-11,Senate,"Unfinished Business SB1062 Lara Concurrence",27,10,2,0,39
849340,513062,2016-03-03,Assembly,"From committee:  Be adopted.  To third reading",8,0,0,3,11
849341,521305,2016-03-17,Senate,"Senate 3rd Reading SCR110 Mendoza",32,0,8,0,40
849341,537636,2016-04-21,Assembly,"Be adopted, to Consent Calendar",9,0,0,2,11
849341,539624,2016-04-28,Assembly,"SCR 110 Mendoza  Consent Calendar Second Day  Regular Session",76,0,0,4,80
849342,544372,2016-04-19,Assembly,"Do pass and be re-referred to the Committee on Appropriations",13,0,0,0,13
849342,549012,2016-05-27,Assembly,"Do pass as amended",17,1,0,2,20
849342,550852,2016-06-02,Assembly,"AB 1995 WILLIAMS  Assembly Third Reading",67,8,0,5,80
849342,554962,2016-06-22,Senate,"Do pass as amended, and re-refer to the Committee on Appropriations",8,1,0,0,9
849342,558746,2016-08-01,Senate,"Placed on Appropriations Suspense file",7,0,0,0,7
849342,559611,2016-08-11,Senate,"Do pass",6,0,1,0,7
849342,560150,2016-08-18,Senate,"Assembly 3rd Reading AB1995 Williams By Leyva",33,1,5,0,39
849342,560957,2016-08-24,Assembly,"AB 1995 WILLIAMS  Concurrence in Senate Amendments",73,4,0,3,80
849343,532692,2016-04-13,Senate,"Do pass, but re-refer to the Committee on Appropriations",4,1,0,0,5
849343,544533,2016-04-25,Senate,"Placed on Appropriations Suspense file",7,0,0,0,7
849343,549240,2016-05-27,Senate,"Do pass",5,2,0,0,7
849343,550077,2016-05-31,Senate,"Senate 3rd Reading SB1063 Hall",26,13,1,0,40
849343,555325,2016-06-22,Assembly,"Do pass and be re-referred to the Committee on Appropriations",5,1,0,1,7
849343,559525,2016-08-11,Assembly,"Do pass",14,5,0,1,20
849343,560792,2016-08-23,Assembly,"SB 1063 Hall  Senate Third Reading  By BURKE",60,14,0,6,80
849343,561301,2016-08-25,Senate,"Unfinished Business SB1063 Hall Concurrence",26,13,0,0,39
849344,536457,2016-04-20,Senate,"Do pass as amended, and re-refer to the Committee on Appropriations",8,0,1,0,9
849344,545894,2016-05-16,Senate,"Placed on Appropriations Suspense file",7,0,0,0,7
849344,549220,2016-05-27,Senate,"Do pass",5,2,0,0,7
849344,549985,2016-05-31,Senate,"Senate 3rd Reading SB1050 De Le",32,6,2,0,40
849345,532947,2016-04-13,Senate,"Do pass, but re-refer to the Committee on Appropriations Recommend 	Consent",9,0,0,0,9
849345,543824,2016-05-09,Senate,"Senate 3rd Reading SB1068 Leyva",36,0,4,0,40
849345,544476,2016-04-25,Senate,"Do pass",7,0,0,0,7
849345,553830,2016-06-15,Assembly,"Do pass and be re-referred to the Committee on Appropriations to 	Consent Calendar",7,0,0,0,7
849345,559715,2016-08-10,Assembly,"Do pass, to Consent Calendar",19,0,0,1,20
849345,560270,2016-08-18,Assembly,"SB 1068 Leyva  Consent Calendar Second Day",78,0,0,2,80
849346,528272,2016-04-05,Assembly,"Do pass as amended and be re-referred to the Committee on Education",16,0,0,3,19
849346,544340,2016-04-19,Assembly,"Do pass and be re-referred to the Committee on Appropriations",13,0,0,0,13
849346,548982,2016-05-27,Assembly,"Do pass as amended",19,0,0,1,20
849346,550824,2016-06-02,Assembly,"AB 2017 MCCARTY  Assembly Third Reading",77,0,0,3,80
849346,555265,2016-06-22,Senate,"Do pass, but re-refer to the Committee on Education",8,0,1,0,9
849346,556299,2016-06-29,Senate,"Do pass as amended, and re-refer to the Committee on Appropriations",9,0,0,0,9
849346,559578,2016-08-11,Senate,"Do pass as amended",5,0,2,0,7
849346,560738,2016-08-23,Senate,"Assembly 3rd Reading AB2017 McCarty By Hancock",39,0,0,0,39
849346,561362,2016-08-29,Assembly,"AB 2017 MCCARTY  Concurrence in Senate Amendments",80,0,0,0,80
850693,531419,2016-04-12,Assembly,"Do pass and be re-referred to the Committee on Appropriations",10,1,0,4,15
850693,549033,2016-05-27,Assembly,"Do pass as amended",14,2,0,4,20
850693,551041,2016-06-02,Assembly,"AB 2087 LEVINE  Assembly Third Reading",52,20,0,8,80
850693,556076,2016-06-28,Senate,"Do pass as amended, and re-refer to the Committee on Appropriations",6,2,1,0,9
850693,559653,2016-08-11,Senate,"Do pass as amended",5,2,0,0,7
850693,561758,2016-08-31,Senate,"Assembly 3rd Reading AB2087 Levine By Allen",25,12,2,0,39
850693,561759,2016-08-31,Assembly,"AB 2087 LEVINE  Concurrence in Senate Amendments",52,24,0,4,80
850694,539010,2016-04-27,Assembly,"Do pass",3,3,0,1,7
850695,533245,2016-04-13,Assembly,"Do pass as amended and be re-referred to the Committee on 	Appropriations",9,4,0,2,15
850698,527992,2016-04-04,Assembly,"Do pass as amended and be re-referred to the Committee on 	Appropriations",9,0,0,0,9
850699,544391,2016-04-19,Assembly,"Do pass as amended and be re-referred to the Committee on 	Appropriations",13,0,0,0,13
850699,544834,2016-05-11,Assembly,"Do pass, to Consent Calendar",20,0,0,0,20
850699,547010,2016-05-19,Assembly,"AB 2056 GARCIA, E.  Consent Calendar Second Day  Regular Session",76,0,0,4,80
850699,553162,2016-06-15,Senate,"Do pass, but re-refer to the Committee on Appropriations Recommend 	Consent",9,0,0,0,9
850699,558788,2016-08-01,Senate,"Placed on Appropriations Suspense file",7,0,0,0,7
850699,559561,2016-08-11,Senate,"Do pass",7,0,0,0,7
850699,560502,2016-08-22,Senate,"Assembly 3rd Reading AB2056 Eduardo Garcia By Lara",39,0,0,0,39
850700,544644,2016-05-09,Assembly,"Do pass as amended and be re-referred to the Committee on 	Appropriations",9,0,0,0,9
850701,527887,2016-04-04,Assembly,"Do pass",16,0,0,0,16
850701,529384,2016-04-07,Assembly,"AB 2073 HOLDEN  Assembly Third Reading",77,0,0,2,79
850701,552944,2016-06-14,Senate,"Do pass and be placed on the Consent Calendar",11,0,0,0,11
850701,557161,2016-06-30,Senate,"Consent Calendar 2nd AB2073 Holden",37,0,3,0,40
850702,536379,2016-04-19,Senate,"Do pass as amended, and re-refer to the Committee on Appropriations",3,4,0,0,7
850705,531973,2016-04-12,Senate,"Do pass, but re-refer to the Committee on Appropriations Recommend 	Consent",12,0,1,0,13
850705,539575,2016-04-28,Senate,"Consent Calendar 2nd SB1105 Mendoza",37,0,3,0,40
850705,552141,2016-06-08,Assembly,"Do pass and be re-referred to the Committee on Appropriations to 	Consent Calendar",17,0,0,4,21
850705,556419,2016-06-29,Assembly,"Do pass, to Consent Calendar",18,0,0,2,20
850705,560442,2016-08-19,Assembly,"SB 1105 Mendoza  Senate Third Reading  Amendment  Set #1",73,0,0,7,80
850706,526074,2016-03-29,Assembly,"Do pass and be re-referred to the Committee on Appropriations to 	Consent Calendar",10,0,0,0,10
850706,532227,2016-04-06,Assembly,"Do pass, to Consent Calendar",18,0,0,2,20
850706,533134,2016-04-14,Assembly,"AB 2080 GALLAGHER  Consent Calendar Second Day  Regular Session",76,0,0,4,80
850707,527967,2016-04-05,Assembly,"Do pass",5,1,0,1,7
850707,537127,2016-04-21,Assembly,"AB 2147 EGGMAN  Assembly Third Reading",76,1,0,3,80
850707,554666,2016-06-21,Senate,"Do pass",5,1,1,0,7
850707,559848,2016-08-15,Senate,"Assembly 3rd Reading AB2147 Eggman By Galgiani",35,3,1,0,39
850708,538492,2016-04-26,Assembly,"From committee:  Be adopted.  To third reading",2,8,0,0,10
850709,531201,2016-04-12,Assembly,"Do pass",5,0,0,2,7
850709,537955,2016-04-25,Assembly,"AB 2165 BONTA  Assembly Third Reading",73,2,0,5,80
850709,554624,2016-06-21,Senate,"Do pass as amended",7,0,0,0,7
850709,561152,2016-08-25,Senate,"Assembly 3rd Reading AB2165 Bonta By Roth",37,0,2,0,39
850709,561558,2016-08-30,Assembly,"AB 2165 BONTA  Concurrence in Senate Amendments",77,0,0,3,80
850710,527955,2016-04-05,Assembly,"Do pass and be re-referred to the Committee on Appropriations",17,0,0,2,19
850711,532734,2016-04-11,Assembly,"Do pass and be re-referred to the Committee on Appropriations",16,0,0,0,16
850711,539464,2016-04-27,Assembly,"Do pass",19,0,0,1,20
850711,544183,2016-05-09,Assembly,"AB 2126 MULLIN  Assembly Third Reading",77,0,0,3,80
850711,554912,2016-06-21,Senate,"Do pass, but re-refer to the Committee on Appropriations Recommend 	Consent",11,0,0,0,11
850711,558908,2016-08-01,Senate,"Do pass",7,0,0,0,7
850711,560219,2016-08-18,Senate,"Special Consent AB2126 Mullin",36,0,3,0,39
850712,525843,2016-03-29,Assembly,"Do pass and be re-referred to the Committee on Appropriations",5,2,0,0,7
850712,536541,2016-04-20,Assembly,"Do pass as amended",15,0,0,5,20
850712,546148,2016-05-16,Assembly,"AB 2088 LINDER  Assembly Third Reading",76,2,0,2,80
850712,554706,2016-06-21,Senate,"Do pass, but re-refer to the Committee on Appropriations",6,0,1,0,7
850712,558934,2016-08-01,Senate,"Do pass",7,0,0,0,7
850712,560106,2016-08-17,Senate,"Assembly 3rd Reading AB2088 Linder By Stone",39,0,0,0,39
850712,560858,2016-08-23,Assembly,"AB 2088 LINDER  Concurrence in Senate Amendments",78,2,0,0,80
850715,529344,2016-04-06,Assembly,"Do pass as amended and be re-referred to the Committee on 	Appropriations",7,0,0,0,7
850715,549365,2016-05-27,Assembly,"Do pass as amended",20,0,0,0,20
850715,550536,2016-06-01,Assembly,"AB 2091 LOPEZ  Assembly Third Reading",78,1,0,1,80
850715,553207,2016-06-15,Senate,"Do pass as amended, and re-refer to the Committee on Appropriations",8,0,1,0,9
850715,558716,2016-08-01,Senate,"Placed on Appropriations Suspense file",7,0,0,0,7
850718,528211,2016-04-05,Assembly,"Do pass and be re-referred to the Committee on Appropriations",18,0,0,1,19
850718,549363,2016-05-27,Assembly,"Do pass as amended",14,0,0,6,20
850718,550933,2016-06-02,Assembly,"AB 2077 BURKE  Assembly Third Reading",80,0,0,0,80
850718,555289,2016-06-22,Senate,"Do pass as amended, and re-refer to the Committee on Appropriations",9,0,0,0,9
850718,559615,2016-08-11,Senate,"Do pass",7,0,0,0,7
850718,561174,2016-08-25,Senate,"Assembly 3rd Reading AB2077 Burke By Hernandez",39,0,0,0,39
850718,561691,2016-08-31,Assembly,"AB 2077 BURKE  Concurrence in Senate Amendments",79,0,0,1,80
850719,525753,2016-03-29,Senate,"Do pass, but re-refer to the Committee on Appropriations",9,0,0,0,9
850719,530885,2016-04-11,Senate,"Placed on Appropriations Suspense file",7,0,0,0,7
850720,526635,2016-03-30,Senate,"Do pass and be placed on the Consent Calendar",8,0,1,0,9
850720,529516,2016-04-07,Senate,"Consent Calendar 2nd SB1123 Leyva",38,0,2,0,40
850720,553836,2016-06-15,Assembly,"Do pass, to Consent Calendar",7,0,0,0,7
850720,555293,2016-06-23,Assembly,"SB 1123 Leyva  Consent Calendar Second Day  Regular Session",79,0,0,1,80
850721,528016,2016-04-05,Assembly,"Do pass and be re-referred to the Committee on Appropriations",10,0,0,0,10
850721,536661,2016-04-20,Assembly,"Do pass, to Consent Calendar",16,0,0,4,20
850721,540278,2016-04-28,Assembly,"AB 2101 GORDON  Consent Calendar Second Day  Regular Session",76,0,0,4,80
850721,553295,2016-06-14,Senate,"Do pass as amended, and re-refer to the Committee on Appropriations",7,0,0,0,7
850721,558719,2016-08-01,Senate,"Placed on Appropriations Suspense file",7,0,0,0,7
850722,544314,2016-05-09,Assembly,"Do pass and be re-referred to the Committee on Appropriations",9,0,0,0,9
850724,534864,2016-04-19,Assembly,"Do pass and be re-referred to the Committee on Appropriations",18,0,0,1,19
850724,542397,2016-05-04,Assembly,"Do pass, to Consent Calendar",20,0,0,0,20
850724,545181,2016-05-12,Assembly,"AB 2050 STEINORTH  Consent Calendar Second Day  Regular Session",78,0,0,2,80
850726,532445,2016-04-11,Assembly,"Do pass and be re-referred to the Committee on Appropriations",5,8,0,3,16
850726,532446,2016-04-11,Assembly,"Reconsideration granted",16,0,0,0,16
850727,544455,2016-04-19,Assembly,"Do pass and be re-referred to the Committee on Appropriations",13,0,0,0,13
850727,549380,2016-05-27,Assembly,"Do pass as amended",20,0,0,0,20
850727,550370,2016-06-01,Assembly,"AB 2137 SANTIAGO  Assembly Third Reading",79,0,0,1,80
850727,556524,2016-06-29,Senate,"Do pass, but re-refer to the Committee on Appropriations Recommend 	Consent",9,0,0,0,9
850727,559280,2016-08-11,Senate,"Consent Calendar 2nd AB2137 Santiago",37,0,2,0,39
850728,518323,2016-03-10,Assembly,"From committee:  Be adopted.  To third reading",10,0,0,1,11
850728,550935,2016-06-02,Senate,"Special Consent # ACR139 Thurmond",39,0,1,0,40
850729,532034,2016-04-12,Assembly,"Do pass and be re-referred to the Committee on Privacy and Consumer 	Protection to Consent Calendar",19,0,0,0,19
850729,541508,2016-05-03,Assembly,"Do pass, to Consent Calendar",11,0,0,0,11
850729,545173,2016-05-12,Assembly,"AB 2119 CHU  Consent Calendar Second Day  Regular Session",78,0,0,2,80
850729,556375,2016-06-28,Senate,"Do pass as amended, but re-refer to the Committee on Appropriations 	Recommend Consent",7,0,0,0,7
850729,559665,2016-08-11,Senate,"Do pass as amended",7,0,0,0,7
850729,560527,2016-08-22,Senate,"Assembly 3rd Reading AB2119 Chu By Beall",39,0,0,0,39
850729,561234,2016-08-25,Assembly,"AB 2119 CHU  Concurrence in Senate Amendments",79,0,0,1,80
850730,529555,2016-04-06,Senate,"Do pass as amended, and re-refer to the Committee on Appropriations",9,0,0,0,9
850730,544804,2016-04-25,Senate,"Placed on Appropriations Suspense file",7,0,0,0,7
850730,549149,2016-05-27,Senate,"Do pass as amended",7,0,0,0,7
850730,550829,2016-06-02,Senate,"Senate 3rd Reading SB1090 Mitchell",39,0,1,0,40
850730,556250,2016-06-28,Assembly,"Do pass and be re-referred to the Committee on Appropriations",18,0,0,0,18
850730,559305,2016-08-11,Assembly,"Do pass as amended",20,0,0,0,20
850730,560656,2016-08-23,Assembly,"SB 1090 Mitchell  Senate Third Reading  By BURKE",79,0,0,1,80
850730,561326,2016-08-26,Senate,"Unfinished Business SB1090 Mitchell Concurrence",38,0,1,0,39
850731,533166,2016-04-12,Assembly,"Do pass and be re-referred to the Committee on Appropriations to 	Consent Calendar",7,0,0,0,7
850731,549129,2016-05-27,Assembly,"Do pass as amended",20,0,0,0,20
850731,550462,2016-06-01,Assembly,"AB 2057 STONE  Assembly Third Reading",80,0,0,0,80
850731,552728,2016-06-14,Senate,"Do pass, but re-refer to the Committee on Appropriations",4,0,1,0,5
850731,558778,2016-08-01,Senate,"Placed on Appropriations Suspense file",7,0,0,0,7
850731,559526,2016-08-11,Senate,"Do pass as amended",7,0,0,0,7
850731,560634,2016-08-23,Senate,"Assembly 3rd Reading AB2057 Mark Stone By Leyva",39,0,0,0,39
850731,561425,2016-08-29,Assembly,"AB 2057 STONE  Concurrence in Senate Amendments",80,0,0,0,80
850732,533094,2016-04-12,Assembly,"Do pass and be re-referred to the Committee on Appropriations",13,0,0,0,13
850732,539138,2016-04-27,Assembly,"Do pass, to Consent Calendar",19,0,0,1,20
850732,542980,2016-05-05,Assembly,"AB 2154 MEDINA  Consent Calendar Second Day  Regular Session",79,0,0,1,80
850732,552147,2016-06-08,Senate,"Do pass, but re-refer to the Committee on Appropriations",9,0,0,0,9
850732,559978,2016-08-16,Senate,"Assembly 3rd Reading AB2154 Medina By Block",36,1,2,0,39
850732,560668,2016-08-23,Assembly,"AB 2154 MEDINA  Concurrence in Senate Amendments",79,0,0,1,80
850733,532702,2016-04-13,Assembly,"Do pass and be re-referred to the Committee on Appropriations",4,2,0,1,7
850733,538946,2016-04-27,Assembly,"Do pass",16,3,0,1,20
850733,543029,2016-05-05,Assembly,"AB 2089 QUIRK  Assembly Third Reading",69,3,0,8,80
850733,554826,2016-06-21,Senate,"Do pass, but re-refer to the Committee on Appropriations",4,1,0,0,5
850733,558907,2016-08-01,Senate,"Placed on Appropriations Suspense file",7,0,0,0,7
850733,559688,2016-08-11,Senate,"Do pass as amended",5,2,0,0,7
850733,560068,2016-08-17,Senate,"Assembly 3rd Reading AB2089 Quirk By Mitchell",26,11,2,0,39
850733,560069,2016-08-17,Senate,"Assembly 3rd Reading AB2089 Quirk By Mitchell",38,0,1,0,39
850733,560677,2016-08-23,Senate,"Assembly 3rd Reading AB2089 Quirk By Mitchell",27,11,1,0,39
850733,561350,2016-08-29,Assembly,"AB 2089 QUIRK  Concurrence in Senate Amendments",71,7,0,2,80
850735,528326,2016-04-05,Assembly,"Do pass as amended and be re-referred to the Committee on 	Appropriations",9,0,0,0,9
850735,539205,2016-04-27,Assembly,"Do pass as amended, to Consent Calendar",19,0,0,1,20
850735,543104,2016-05-05,Assembly,"AB 2105 RODRIGUEZ  Consent Calendar Second Day  Regular Session",79,0,0,1,80
850735,555070,2016-06-22,Senate,"Do pass, but re-refer to the Committee on Appropriations",5,0,0,0,5
850735,559867,2016-08-15,Senate,"Assembly 3rd Reading AB2105 Rodriguez By Mendoza",37,0,2,0,39
850735,560570,2016-08-22,Assembly,"AB 2105 RODRIGUEZ  Concurrence in Senate Amendments",77,0,0,3,80
850737,532784,2016-04-11,Assembly,"Do pass and be re-referred to the Committee on Agriculture",16,0,0,0,16
850737,536572,2016-04-20,Assembly,"Do pass and be re-referred to the Committee on Appropriations to 	Consent Calendar",10,0,0,0,10
850739,535595,2016-04-19,Assembly,"Do pass as amended and be re-referred to the Committee on 	Appropriations",18,0,0,1,19
850742,533500,2016-04-13,Assembly,"Do pass and be re-referred to the Committee on Privacy and Consumer 	Protection to Consent Calendar",7,0,0,0,7
850742,534979,2016-04-19,Assembly,"Amend, and do pass as amended and be re-referred to the Committee 	on Appropriations with the recommendation:  To Consent Calendar",11,0,0,0,11
850742,544990,2016-05-11,Assembly,"Do pass, to Consent Calendar",20,0,0,0,20
850742,546998,2016-05-19,Assembly,"AB 2097 MELENDEZ  Consent Calendar Second Day  Regular Session",76,0,0,4,80
850742,553173,2016-06-15,Senate,"Do pass, but re-refer to the Committee on Appropriations Recommend 	Consent",9,0,0,0,9
850742,559448,2016-08-11,Senate,"Consent Calendar 2nd AB2097 Melendez",37,0,2,0,39
850743,532433,2016-04-11,Assembly,"Do pass and be re-referred to the Committee on Local Government",5,11,0,0,16
850743,532434,2016-04-11,Assembly,"Reconsideration granted",16,0,0,0,16
850745,533511,2016-04-13,Senate,"Do pass, but re-refer to the Committee on Appropriations",9,0,0,0,9
850745,549201,2016-05-27,Senate,"Do pass as amended",7,0,0,0,7
850745,550921,2016-06-02,Senate,"Special Consent # SB1095 Pan",39,0,1,0,40
850745,554978,2016-06-21,Assembly,"Do pass and be re-referred to the Committee on Appropriations",17,0,0,1,18
850745,559303,2016-08-11,Assembly,"Do pass as amended",20,0,0,0,20
850745,560201,2016-08-18,Assembly,"SB 1095 Pan  Senate Third Reading  By WOOD",78,0,0,2,80
850745,560981,2016-08-24,Senate,"Unfinished Business SB1095 Pan Concurrence",39,0,0,0,39
850747,525569,2016-03-29,Assembly,"Do pass as amended and be re-referred to the Committee on 	Appropriations",18,0,0,1,19
850747,532192,2016-04-13,Assembly,"Do pass, to Consent Calendar",20,0,0,0,20
850747,537070,2016-04-21,Assembly,"AB 2053 GONZALEZ  Consent Calendar Second Day  Regular Session",79,0,0,1,80
850747,555226,2016-06-22,Senate,"Do pass, but re-refer to the Committee on Appropriations Recommend 	Consent",9,0,0,0,9
850747,558738,2016-08-01,Senate,"Do pass",7,0,0,0,7
850747,560734,2016-08-23,Senate,"Assembly 3rd Reading AB2053 Gonzalez By Hernandez",39,0,0,0,39
850747,561589,2016-08-30,Assembly,"AB 2053 GONZALEZ  Concurrence in Senate Amendments",79,1,0,0,80
850750,528654,2016-04-06,Assembly,"Do pass and be re-referred to the Committee on Appropriations to 	Consent Calendar",13,0,0,0,13
850750,536287,2016-04-20,Assembly,"Do pass, to Consent Calendar",16,0,0,4,20
850750,539622,2016-04-28,Assembly,"AB 2086 COOLEY  Consent Calendar Second Day  Regular Session",76,0,0,4,80
850750,552036,2016-06-08,Senate,"Do pass, but re-refer to the Committee on Appropriations",4,0,1,0,5
850750,558748,2016-08-01,Senate,"Placed on Appropriations Suspense file",7,0,0,0,7
850750,559550,2016-08-11,Senate,"Do pass",7,0,0,0,7
850750,560525,2016-08-22,Senate,"Assembly 3rd Reading AB2086 Cooley By Mendoza Urgency Cla",39,0,0,0,39
850750,561140,2016-08-25,Assembly,"AB 2086 COOLEY  Concurrence in Senate Amendments",79,0,0,1,80
850751,542382,2016-05-03,Senate,"Do pass",6,0,1,0,7
850751,545774,2016-05-16,Senate,"Senate 3rd Reading SB1092 Monning",36,0,4,0,40
850751,554653,2016-06-21,Assembly,"Do pass",10,0,0,0,10
850751,555246,2016-06-23,Assembly,"SB 1092 Monning  Senate Third Reading  By COOLEY",77,0,0,3,80
850751,555543,2016-06-27,Senate,"Unfinished Business SB1092 Monning Concurrence",38,0,2,0,40
850752,528795,2016-04-06,Assembly,"Do pass and be re-referred to the Committee on Appropriations",6,0,0,1,7
850752,536381,2016-04-20,Assembly,"Do pass, to Consent Calendar",16,0,0,4,20
850752,540232,2016-04-28,Assembly,"AB 2155 RIDLEY-THOMAS  Consent Calendar Second Day  Regular Session",76,0,0,4,80
850752,552543,2016-06-13,Senate,"Do pass, but re-refer to the Committee on Appropriations",3,0,2,0,5
850752,558875,2016-08-01,Senate,"Placed on Appropriations Suspense file",7,0,0,0,7
850752,559728,2016-08-11,Senate,"Do pass",5,2,0,0,7
850752,560419,2016-08-19,Senate,"Assembly 3rd Reading AB2155 Ridley-Thomas By Pan",23,13,3,0,39
850756,529615,2016-04-06,Assembly,"Amend, and do pass as amended and be re-referred to the Committee 	on Appropriations with the recommendation:  To Consent Calendar",7,0,0,0,7
850756,539281,2016-04-27,Assembly,"Do pass, to Consent Calendar",19,0,0,1,20
850756,543032,2016-05-05,Assembly,"AB 2063 GALLAGHER  Consent Calendar Second Day  Regular Session",79,0,0,1,80
850756,552092,2016-06-08,Senate,"Do pass, but re-refer to the Committee on Appropriations Recommend 	Consent",9,0,0,0,9
850756,556975,2016-06-30,Senate,"Consent Calendar 2nd AB2063 Gallagher",37,0,3,0,40
850757,537034,2016-04-20,Assembly,"Do pass and be re-referred to the Committee on Appropriations to 	Consent Calendar",21,0,0,0,21
850757,544849,2016-05-11,Assembly,"Do pass, to Consent Calendar",20,0,0,0,20
850757,547162,2016-05-19,Assembly,"AB 2102 HERNANDEZ  Consent Calendar Second Day  Regular Session",76,0,0,4,80
850758,527456,2016-04-04,Assembly,"Be referred to Committee on Natural Resources",10,0,0,1,11
850758,534872,2016-04-18,Assembly,"Do pass and be re-referred to the Committee on Appropriations",5,1,0,3,9
850758,548964,2016-05-27,Assembly,"Do pass as amended",14,6,0,0,20
850758,550911,2016-06-02,Assembly,"AB 2139 WILLIAMS  Assembly Third Reading",58,22,0,0,80
850758,552691,2016-06-14,Senate,"Do pass, but re-refer to the Committee on Environmental Quality",7,2,0,0,9
850758,556316,2016-06-29,Senate,"Do pass as amended, and re-refer to the Committee on Appropriations",6,1,0,0,7
850758,559560,2016-08-11,Senate,"Do pass as amended",6,1,0,0,7
850758,560057,2016-08-17,Senate,"Assembly 3rd Reading AB2139 Williams By Monning",28,11,0,0,39
850758,560664,2016-08-23,Assembly,"AB 2139 WILLIAMS  Concurrence in Senate Amendments",57,22,0,1,80
850759,532235,2016-04-12,Assembly,"Do pass and be re-referred to the Committee on Appropriations",9,0,0,0,9
850759,549169,2016-05-27,Assembly,"Do pass as amended",20,0,0,0,20
850759,550922,2016-06-02,Assembly,"AB 2085 IRWIN  Assembly Third Reading",77,0,0,3,80
850759,552637,2016-06-14,Senate,"Do pass, but re-refer to the Committee on Judiciary",5,0,0,0,5
850759,556355,2016-06-28,Senate,"Do pass, but re-refer to the Committee on Appropriations Recommend 	Consent",7,0,0,0,7
850759,558771,2016-08-01,Senate,"Placed on Appropriations Suspense file",7,0,0,0,7
850759,559606,2016-08-11,Senate,"Do pass",7,0,0,0,7
850759,560041,2016-08-17,Senate,"Assembly 3rd Reading AB2085 Irwin By Roth",38,0,1,0,39
850760,531922,2016-04-12,Assembly,"Do pass as amended and be re-referred to the Committee on 	Appropriations",13,1,0,2,16
850761,539319,2016-04-27,Senate,"Do pass as amended, and re-refer to the Committee on Appropriations",7,0,0,0,7
850761,546014,2016-05-16,Senate,"Placed on Appropriations Suspense file",7,0,0,0,7
850763,527874,2016-04-04,Assembly,"Do pass and be re-referred to the Committee on Appropriations",16,0,0,0,16
850763,548957,2016-05-27,Assembly,"Do pass",20,0,0,0,20
850763,550050,2016-05-31,Assembly,"AB 2107 FRAZIER  Assembly Third Reading",78,0,0,2,80
850763,558876,2016-08-01,Senate,"Placed on Appropriations Suspense file",7,0,0,0,7
850763,559722,2016-08-11,Senate,"Do pass",7,0,0,0,7
850763,561236,2016-08-25,Senate,"Assembly 3rd Reading AB2107 Frazier By Beall",39,0,0,0,39
850764,533149,2016-04-12,Assembly,"Do pass as amended and be re-referred to the Committee on 	Appropriations",7,0,0,0,7
850766,533082,2016-04-12,Assembly,"Do pass and be re-referred to the Committee on Appropriations",7,5,0,1,13
850766,549403,2016-05-27,Assembly,"Do pass",13,6,0,1,20
850766,550525,2016-06-01,Assembly,"AB 2163 LOW  Assembly Third Reading",49,27,0,4,80
850766,556467,2016-06-29,Senate,"Do pass, but re-refer to the Committee on Appropriations",8,1,0,0,9
850768,544281,2016-04-19,Assembly,"Do pass and be re-referred to the Committee on Appropriations",11,0,0,2,13
850769,525988,2016-03-29,Assembly,"Do pass as amended",8,1,0,1,10
850769,529380,2016-04-07,Assembly,"AB 2159 GONZALEZ  Assembly Third Reading",53,20,0,6,79
850769,553088,2016-06-14,Senate,"Do pass",5,2,0,0,7
850769,558639,2016-08-01,Senate,"Assembly 3rd Reading AB2159 Gonzalez By Hall",28,11,0,0,39
850770,536477,2016-04-20,Assembly,"Do pass and be re-referred to the Committee on Appropriations",13,4,0,4,21
850770,542639,2016-05-04,Assembly,"Do pass",15,5,0,0,20
850770,549282,2016-05-27,Assembly,"AB 2082 CAMPOS  Assembly Third Reading",54,17,0,9,80
850771,527886,2016-04-04,Assembly,"Do pass and be re-referred to the Committee on Appropriations",16,0,0,0,16
850773,527867,2016-04-04,Assembly,"Do pass and be re-referred to the Committee on Appropriations",6,5,0,5,16
850773,527868,2016-04-04,Assembly,"Reconsideration granted",16,0,0,0,16
850776,531921,2016-04-12,Senate,"Do pass, but re-refer to the Committee on Appropriations",6,0,1,0,7
850776,544527,2016-04-25,Senate,"Placed on Appropriations Suspense file",7,0,0,0,7
850778,526769,2016-03-31,Assembly,"Be referred to Committee on Revenue and Taxation",8,0,0,3,11
850778,535605,2016-04-18,Assembly,"Do pass as amended and be re-referred to the Committee on 	Appropriations",9,0,0,0,9
850778,549348,2016-05-27,Assembly,"Do pass",14,4,0,2,20
850778,550720,2016-06-01,Assembly,"AB 2149 BONILLA  Assembly Third Reading",57,22,0,1,80
850778,556267,2016-06-29,Senate,"Do pass as amended, and re-refer to the Committee on Appropriations",5,1,1,0,7
850779,537345,2016-04-20,Assembly,"Do pass and be re-referred to the Committee on Appropriations",5,0,0,2,7
850779,549400,2016-05-27,Assembly,"Do pass as amended",14,1,0,5,20
850779,550863,2016-06-02,Assembly,"AB 2133 CHU  Assembly Third Reading",77,0,0,3,80
850780,525567,2016-03-29,Assembly,"Do pass as amended and be re-referred to the Committee on 	Appropriations",10,0,0,0,10
850780,532265,2016-04-13,Assembly,"Do pass, to Consent Calendar",20,0,0,0,20
850780,537136,2016-04-21,Assembly,"AB 2093 STEINORTH  Consent Calendar Second Day  Regular Session",79,0,0,1,80
850780,553104,2016-06-14,Senate,"Do pass",7,0,0,0,7
850780,559826,2016-08-15,Senate,"Assembly 3rd Reading AB2093 Steinorth By Roth Urgency Clause",38,0,1,0,39
850780,560484,2016-08-22,Assembly,"AB 2093 STEINORTH  Concurrence- Urgency Added",79,0,0,1,80
850781,525718,2016-03-29,Senate,"Do pass",5,2,0,0,7
850781,529573,2016-04-07,Senate,"Senate 3rd Reading SB1130 Wieckowski",24,11,5,0,40
850781,552186,2016-06-08,Assembly,"Do pass",7,2,0,1,10
850781,553642,2016-06-16,Assembly,"SB 1130 Wieckowski  Senate Third Reading  By STONE",48,27,0,5,80
850782,532414,2016-04-11,Assembly,"Do pass and be re-referred to the Committee on Appropriations",16,0,0,0,16
850782,549159,2016-05-27,Assembly,"Do pass as amended",20,0,0,0,20
850782,550431,2016-06-01,Assembly,"AB 2090 ALEJO  Assembly Third Reading",77,1,0,2,80
850782,554761,2016-06-21,Senate,"Do pass, but re-refer to the Committee on Environmental Quality",9,0,2,0,11
850782,556476,2016-06-29,Senate,"Do pass, but re-refer to the Committee on Appropriations",4,0,3,0,7
850782,558821,2016-08-01,Senate,"Placed on Appropriations Suspense file",7,0,0,0,7
850786,529347,2016-04-06,Assembly,"Do pass as amended, to Consent Calendar",7,0,0,0,7
850786,537553,2016-04-21,Assembly,"AB 2116 GALLAGHER  Consent Calendar Second Day  Regular Session",79,0,0,1,80
850786,552131,2016-06-08,Senate,"Do pass as amended. To Consent Calendar",9,0,0,0,9
850786,557059,2016-06-30,Senate,"Consent Calendar 2nd AB2116 Gallagher",37,0,3,0,40
850786,558693,2016-08-01,Assembly,"AB 2116 GALLAGHER  Concurrence in Senate Amendments",76,0,0,4,80
850787,544660,2016-05-09,Assembly,"Do pass as amended and be re-referred to the Committee on 	Appropriations",9,0,0,0,9
850787,546578,2016-05-18,Assembly,"Do pass, to Consent Calendar",20,0,0,0,20
850787,549122,2016-05-27,Assembly,"AB 2127 O'DONNELL  Consent Calendar Second Day  Regular Session",67,0,0,13,80
850787,554838,2016-06-21,Senate,"Do pass, but re-refer to the Committee on Governance and Finance 	Recommend Consent",11,0,0,0,11
850787,556460,2016-06-29,Senate,"Do pass, but re-refer to the Committee on Appropriations",5,1,1,0,7
850787,558913,2016-08-01,Senate,"Do pass",6,0,1,0,7
850787,559983,2016-08-16,Senate,"Assembly 3rd Reading AB2127 O'Donnell By Vidak",37,1,1,0,39
850788,525776,2016-03-29,Senate,"Do pass, but re-refer to the Committee on Appropriations",8,0,1,0,9
850788,533123,2016-04-14,Senate,"Senate 3rd Reading SB1089 Pavley",33,0,7,0,40
850788,552653,2016-06-14,Assembly,"Do pass as amended and be re-referred to the Committee on 	Appropriations",10,4,0,1,15
850788,556385,2016-06-29,Assembly,"Do pass as amended",12,6,0,2,20
850788,559106,2016-08-04,Assembly,"SB 1089 Pavley  Senate Third Reading  By GARCIA, E.  Amend By 	GARCIA, E.  Set #1",49,25,0,6,80
850788,560119,2016-08-18,Assembly,"SB 1089 Pavley  Senate Third Reading  By GARCIA, E",53,23,0,4,80
850788,560939,2016-08-24,Senate,"Unfinished Business SB1089 Pavley Concurrence",27,12,0,0,39
850789,526196,2016-03-30,Assembly,"Do pass and be re-referred to the Committee on Revenue and Taxation",7,0,0,0,7
850789,544267,2016-05-09,Assembly,"Do pass as amended and be re-referred to the Committee on 	Appropriations",9,0,0,0,9
850789,549021,2016-05-27,Assembly,"Do pass as amended",16,0,0,4,20
850789,550878,2016-06-02,Assembly,"AB 2140 HERNANDEZ  Assembly Third Reading",75,0,0,5,80
850789,554985,2016-06-22,Senate,"Do pass, but re-refer to the Committee on Appropriations",4,1,2,0,7
850789,558791,2016-08-01,Senate,"Placed on Appropriations Suspense file",7,0,0,0,7
850790,535209,2016-04-18,Senate,"Do pass as amended, and re-refer to the Committee on Appropriations",9,0,0,0,9
850790,545365,2016-05-12,Senate,"Senate 3rd Reading SB1085 Roth",38,0,2,0,40
850790,552995,2016-06-14,Assembly,"Do pass as amended and be re-referred to the Committee on 	Appropriations",12,2,0,2,16
850790,559092,2016-08-03,Assembly,"Do pass",20,0,0,0,20
850790,560331,2016-08-18,Assembly,"SB 1085 Roth  Senate Third Reading  By COOLEY",79,0,0,1,80
850790,561276,2016-08-25,Senate,"Special Consent SB1085 Roth",39,0,0,0,39
850791,533406,2016-04-12,Assembly,"Do pass and be re-referred to the Committee on Appropriations",7,0,0,0,7
850791,549051,2016-05-27,Assembly,"Do pass as amended",20,0,0,0,20
850791,550885,2016-06-02,Assembly,"AB 2150 SANTIAGO  Assembly Third Reading",80,0,0,0,80
850791,555080,2016-06-22,Senate,"Do pass, but re-refer to the Committee on Appropriations Recommend 	Consent",9,0,0,0,9
850792,525952,2016-03-29,Assembly,"Do pass and be re-referred to the Committee on Jobs, Economic 	Development and The Economy to Consent Calendar",7,0,0,0,7
850792,535723,2016-04-19,Assembly,"Do pass as amended and be re-referred to the Committee on 	Appropriations",9,0,0,0,9
850792,544927,2016-05-11,Assembly,"Do pass, to Consent Calendar",20,0,0,0,20
850792,547193,2016-05-19,Assembly,"AB 2061 WALDRON  Consent Calendar Second Day  Regular Session",76,0,0,4,80
850792,552909,2016-06-14,Senate,"Do pass, but re-refer to the Committee on Appropriations Recommend 	Consent",7,0,0,0,7
850792,557032,2016-06-30,Senate,"Consent Calendar 2nd AB2061 Waldron",37,0,3,0,40
850793,535702,2016-04-19,Senate,"Do pass, but re-refer to the Committee on Appropriations Recommend 	Consent",7,0,0,0,7
850793,543165,2016-05-05,Senate,"Consent Calendar 2nd SB1121 Leno",36,0,4,0,40
850793,554747,2016-06-21,Assembly,"Do pass as amended and be re-referred to the Committee on Public 	Safety",11,0,0,0,11
850793,556037,2016-06-28,Assembly,"Do pass and be re-referred to the Committee on Appropriations to 	Consent Calendar",7,0,0,0,7
850793,559700,2016-08-10,Assembly,"Do pass, to Consent Calendar",19,0,0,1,20
850793,560354,2016-08-19,Assembly,"SB 1121 Leno  Senate Third Reading  By B.& P.  Amendment  Set #1",73,0,0,7,80
850793,560773,2016-08-23,Assembly,"SB 1121 Leno  Senate Third Reading  By OBERNOLTE",80,0,0,0,80
850793,561238,2016-08-25,Senate,"Unfinished Business SB1121 Leno Concurrence",39,0,0,0,39
850798,531296,2016-04-12,Senate,"Do pass, but re-refer to the Committee on Environmental Quality",7,2,0,0,9
850798,545768,2016-05-16,Senate,"Placed on Appropriations Suspense file",7,0,0,0,7
850803,535271,2016-04-19,Assembly,"Do pass as amended and be re-referred to the Committee on 	Appropriations",5,9,0,5,19
850804,528739,2016-04-06,Senate,"Do pass, but re-refer to the Committee on Health",5,0,0,0,5
850804,537318,2016-04-20,Senate,"Do pass, but re-refer to the Committee on Appropriations Recommend 	Consent",9,0,0,0,9
850804,549202,2016-05-27,Senate,"Do pass as amended",5,2,0,0,7
850805,535678,2016-04-19,Senate,"Do pass, but re-refer to the Committee on Appropriations",6,1,0,0,7
850805,549219,2016-05-27,Senate,"Do pass as amended",5,0,2,0,7
850805,551061,2016-06-02,Senate,"Senate 3rd Reading SB1110 Hancock",32,4,4,0,40
850805,556141,2016-06-28,Assembly,"Do pass and be re-referred to the Committee on Appropriations",6,1,0,0,7
850806,531226,2016-04-12,Assembly,"Do pass as amended and be re-referred to the Committee on 	Appropriations",4,1,0,2,7
850806,549387,2016-05-27,Assembly,"Do pass",14,6,0,0,20
850806,550438,2016-06-01,Assembly,"AB 2153 GARCIA, C.  Assembly Third Reading  Amend By GARCIA, C. 	Set #1",60,2,0,18,80
850806,551091,2016-06-02,Assembly,"Do pass",5,0,0,2,7
850806,551092,2016-06-02,Assembly,"AB 2153 GARCIA, C.  Third Reading Urgency",55,16,0,9,80
850806,559050,2016-08-03,Senate,"Do pass as amended, and re-refer to the Committee on Judiciary",5,1,1,0,7
850806,559680,2016-08-11,Senate,"Placed on Appropriations Suspense file",7,0,0,0,7
850806,559681,2016-08-11,Senate,"Do pass",5,2,0,0,7
850806,561676,2016-08-31,Senate,"Do pass",5,2,0,0,7
850806,561677,2016-08-31,Senate,"W/O REF. TO FILE AB2153 Cristina Garcia By Lara Urgency Clause",27,11,1,0,39
850806,561678,2016-09-01,Assembly,"AB 2153 GARCIA, C.  Concurrence in Senate Amendments",55,23,0,2,80
850808,531392,2016-04-12,Senate,"Do pass, but re-refer to the Committee on Appropriations",9,3,1,0,13
850808,544724,2016-04-25,Senate,"Placed on Appropriations Suspense file",7,0,0,0,7
850808,549318,2016-05-27,Senate,"Do pass",5,2,0,0,7
850809,534931,2016-04-19,Senate,"Do pass, but re-refer to the Committee on Appropriations",4,1,0,0,5
850809,549004,2016-05-27,Senate,"Do pass",5,2,0,0,7
850809,549931,2016-05-31,Senate,"Senate 3rd Reading SB1107 Allen",26,12,2,0,40
850809,553092,2016-06-15,Assembly,"Do pass as amended and be re-referred to the Committee on 	Appropriations",5,2,0,0,7
850809,559302,2016-08-11,Assembly,"Do pass as amended",14,6,0,0,20
850809,561549,2016-08-30,Assembly,"SB 1107 Allen  Senate Third Reading  By GONZALEZ",55,22,0,3,80
850809,561748,2016-08-31,Senate,"Unfinished Business SB1107 Allen Concurrence",27,12,0,0,39
850810,530569,2016-04-11,Assembly,"Be referred to Committee on Water, Parks and Wildlife",9,0,0,2,11
850812,536286,2016-04-20,Assembly,"Do pass and be re-referred to the Committee on Appropriations",18,0,0,3,21
850812,549153,2016-05-27,Assembly,"Do pass as amended",14,4,0,2,20
850812,550903,2016-06-02,Assembly,"AB 2121 GONZALEZ  Assembly Third Reading",64,11,0,5,80
850812,558730,2016-08-01,Senate,"Placed on Appropriations Suspense file",7,0,0,0,7
850812,559571,2016-08-11,Senate,"Do pass as amended",5,0,2,0,7
850812,560030,2016-08-17,Senate,"Assembly 3rd Reading AB2121 Gonzalez By Hill",37,2,0,0,39
850812,561573,2016-08-30,Assembly,"Senate amendments be concurred in",17,0,0,4,21
850812,561686,2016-08-31,Assembly,"AB 2121 GONZALEZ  Concurrence in Senate Amendments",63,12,0,5,80
850813,531778,2016-04-12,Senate,"Do pass as amended, and re-refer to the Committee on Appropriations",12,0,1,0,13
850813,544774,2016-04-25,Senate,"Placed on Appropriations Suspense file",7,0,0,0,7
850814,531981,2016-04-12,Senate,"Do pass, but re-refer to the Committee on Appropriations Recommend 	Consent",12,0,1,0,13
850814,539571,2016-04-28,Senate,"Consent Calendar 2nd SB1120 Wolk",37,0,3,0,40
850814,556564,2016-06-29,Assembly,"Do pass and be re-referred to the Committee on Appropriations",8,0,0,1,9
850814,559056,2016-08-03,Assembly,"Do pass, to Consent Calendar",20,0,0,0,20
850814,560148,2016-08-18,Assembly,"SB 1120 Wolk  Senate Third Reading  By BONILLA",79,0,0,1,80
850814,561278,2016-08-25,Senate,"Special Consent SB1120 Wolk",39,0,0,0,39
850816,535231,2016-04-19,Senate,"Do pass, but re-refer to the Committee on Appropriations Recommend 	Consent",7,0,0,0,7
850816,543259,2016-05-05,Senate,"Consent Calendar 2nd SB1127 Hancock",36,0,4,0,40
850816,552914,2016-06-14,Assembly,"Do pass and be re-referred to the Committee on Appropriations to 	Consent Calendar",7,0,0,0,7
850818,537689,2016-04-20,Assembly,"Do pass as amended and be re-referred to the Committee on 	Appropriations",8,4,0,3,15
850818,549034,2016-05-27,Assembly,"Do pass",14,6,0,0,20
850818,550544,2016-06-01,Assembly,"AB 2120 WEBER  Assembly Third Reading",51,26,0,3,80
850818,555935,2016-06-27,Senate,"Do pass, but re-refer to the Committee on Appropriations",7,2,2,0,11
850818,558976,2016-08-01,Senate,"Placed on Appropriations Suspense file",7,0,0,0,7
850819,531241,2016-04-12,Assembly,"Do pass as amended and be re-referred to the Committee on 	Appropriations",19,0,0,0,19
850819,546543,2016-05-18,Assembly,"Do pass",14,0,0,6,20
850819,547574,2016-05-23,Assembly,"AB 2115 WOOD  Assembly Third Reading",71,0,0,9,80
850819,556757,2016-06-29,Senate,"Do pass as amended, and re-refer to the Committee on Appropriations",7,0,2,0,9
850819,560480,2016-08-22,Senate,"Assembly 3rd Reading AB2115 Wood By Nguyen",36,3,0,0,39
850819,561213,2016-08-25,Assembly,"AB 2115 WOOD  Concurrence in Senate Amendments",72,0,0,8,80
850820,542521,2016-05-04,Senate,"Do pass, but re-refer to the Committee on Appropriations",6,0,1,0,7
850820,545996,2016-05-16,Senate,"Placed on Appropriations Suspense file",7,0,0,0,7
850821,531585,2016-04-12,Assembly,"Do pass and be re-referred to the Committee on Education",7,0,0,0,7
850821,537337,2016-04-20,Assembly,"Amend, and do pass as amended and be re-referred to the Committee 	on Appropriations with the recommendation:  To Consent Calendar",7,0,0,0,7
850821,549397,2016-05-27,Assembly,"Do pass as amended",20,0,0,0,20
850821,550436,2016-06-01,Assembly,"AB 2124 GARCIA, E.  Assembly Third Reading",79,0,0,1,80
850822,526236,2016-03-29,Assembly,"Do pass as amended and be re-referred to the Committee on 	Environmental Safety and Toxic Materials",6,0,0,1,7
850822,531579,2016-04-12,Assembly,"Amend, and do pass as amended and be re-referred to the Committee 	on Appropriations with the recommendation:  To Consent Calendar",7,0,0,0,7
850822,548973,2016-05-27,Assembly,"Do pass as amended",20,0,0,0,20
850822,550558,2016-06-01,Assembly,"AB 2099 STONE  Assembly Third Reading",78,1,0,1,80
850822,552742,2016-06-14,Senate,"Do pass as amended, and re-refer to the Committee on Appropriations",4,0,1,0,5
850823,528836,2016-04-06,Senate,"Do pass, but re-refer to the Committee on Health",8,1,0,0,9
850823,537301,2016-04-20,Senate,"Do pass, but re-refer to the Committee on Appropriations",9,0,0,0,9
850823,549238,2016-05-27,Senate,"Do pass",7,0,0,0,7
850823,550226,2016-05-31,Senate,"Senate 3rd Reading SB1113 Beall",39,0,1,0,40
850823,553641,2016-06-15,Assembly,"Do pass and be re-referred to the Committee on Health",7,0,0,0,7
850823,554947,2016-06-21,Assembly,"Do pass as amended and be re-referred to the Committee on 	Appropriations",17,0,0,1,18
850823,559330,2016-08-11,Assembly,"Do pass as amended",20,0,0,0,20
850823,560183,2016-08-18,Assembly,"SB 1113 Beall  Senate Third Reading  By MAIENSCHEIN",77,0,0,3,80
850823,561142,2016-08-25,Senate,"Special Consent SB1113 Beall",39,0,0,0,39
850824,542508,2016-05-04,Senate,"Do pass as amended, and re-refer to the Committee on Appropriations",6,0,1,0,7
850824,547586,2016-05-23,Senate,"Placed on Appropriations Suspense file",7,0,0,0,7
850825,534910,2016-04-18,Senate,"Do pass, but re-refer to the Committee on Appropriations",8,0,1,0,9
850825,545769,2016-05-16,Senate,"Placed on Appropriations Suspense file",7,0,0,0,7
850828,535731,2016-04-18,Senate,"Do pass, but re-refer to the Committee on Appropriations",9,0,0,0,9
850828,543779,2016-05-09,Senate,"Senate 3rd Reading SB1125 Nguyen",36,0,4,0,40
850829,526501,2016-03-29,Assembly,"Do pass and be re-referred to the Committee on Appropriations to 	Consent Calendar",6,0,0,1,7
850829,549446,2016-05-27,Assembly,"Do pass as amended",20,0,0,0,20
850829,550617,2016-06-01,Assembly,"AB 2054 THURMOND  Assembly Third Reading",80,0,0,0,80
850829,556571,2016-06-28,Senate,"Do pass as amended, but re-refer to the Committee on Appropriations 	Recommend Consent",5,0,0,0,5
850829,558833,2016-08-01,Senate,"Placed on Appropriations Suspense file",7,0,0,0,7
850830,536574,2016-04-20,Assembly,"Do pass",21,0,0,0,21
850830,539644,2016-04-28,Assembly,"AB 2135 LEVINE  Assembly Third Reading",79,0,0,1,80
850830,552759,2016-06-14,Senate,"Do pass",11,0,2,0,13
850830,558686,2016-08-01,Senate,"Assembly 3rd Reading AB2135 Levine By Berryhill",38,0,1,0,39
850831,537575,2016-04-20,Assembly,"Do pass and be re-referred to the Committee on Appropriations",3,4,0,0,7
850832,532254,2016-04-13,Senate,"Do pass as amended, and re-refer to the Committee on Appropriations",8,0,1,0,9
850832,545767,2016-05-16,Senate,"Senate 3rd Reading SB1091 Liu",37,0,3,0,40
850832,554953,2016-06-22,Assembly,"Do pass, to Consent Calendar",13,0,0,0,13
850832,560966,2016-08-24,Assembly,"SB 1091 Liu  Senate Third Reading  By BROWN",80,0,0,0,80
850832,561325,2016-08-26,Senate,"Unfinished Business SB1091 Liu Concurrence",39,0,0,0,39
850833,528273,2016-04-05,Senate,"Do pass, but re-refer to the Committee on Governance and Finance",5,0,0,0,5
850833,539335,2016-04-27,Senate,"Do pass as amended",5,0,2,0,7
850833,545410,2016-05-12,Senate,"Senate 3rd Reading SB1108 Allen",34,0,6,0,40
850833,553302,2016-06-15,Assembly,"Do pass and be re-referred to the Committee on Local Government",5,2,0,0,7
850833,557051,2016-06-29,Assembly,"Do pass",6,1,0,2,9
850833,560340,2016-08-18,Assembly,"SB 1108 Allen  Senate Third Reading  By WILLIAMS",62,14,0,4,80
850833,561013,2016-08-24,Senate,"Unfinished Business SB1108 Allen Concurrence",35,3,1,0,39
850834,533084,2016-04-12,Assembly,"Do pass and be re-referred to the Committee on Appropriations",12,1,0,0,13
850835,525738,2016-03-29,Assembly,"Do pass and be re-referred to the Committee on Appropriations",8,0,0,2,10
850836,525845,2016-03-29,Assembly,"Do pass and be re-referred to the Committee on Appropriations to 	Consent Calendar",7,0,0,0,7
850837,535696,2016-04-19,Senate,"Do pass, but re-refer to the Committee on Appropriations",11,0,0,0,11
850837,545980,2016-05-16,Senate,"Placed on Appropriations Suspense file",7,0,0,0,7
850837,549233,2016-05-27,Senate,"Do pass as amended",7,0,0,0,7
850837,551007,2016-06-02,Senate,"Special Consent # SB1122 Cannella",39,0,1,0,40
850839,535225,2016-04-19,Assembly,"Do pass and be re-referred to the Committee on Appropriations to 	Consent Calendar",7,0,0,0,7
850841,526064,2016-03-29,Senate,"Do pass, but re-refer to the Committee on Appropriations",9,0,0,0,9
850841,543773,2016-05-09,Senate,"Senate 3rd Reading SB1111 Pavley",36,0,4,0,40
850841,556078,2016-06-28,Assembly,"Do pass as amended and be re-referred to the Committee on 	Appropriations",15,0,0,0,15
850841,559324,2016-08-11,Assembly,"Do pass as amended",15,0,0,5,20
850841,560410,2016-08-19,Assembly,"SB 1111 Pavley  Senate Third Reading  Amendment  Set #1",73,0,0,7,80
850841,561047,2016-08-24,Assembly,"SB 1111 Pavley  Senate Third Reading  By LEVINE",55,24,0,1,80
850841,561344,2016-08-26,Senate,"Unfinished Business SB1111 Pavley Concurrence",27,12,0,0,39
850842,527944,2016-04-05,Assembly,"Do pass and be re-referred to the Committee on Water, Parks and 	Wildlife",10,0,0,1,11
850842,534860,2016-04-19,Assembly,"Do pass as amended and be re-referred to the Committee on 	Appropriations",10,3,0,2,15
850842,544868,2016-05-11,Assembly,"Do pass as amended",15,5,0,0,20
850842,547020,2016-05-19,Assembly,"AB 2148 HOLDEN  Assembly Third Reading",57,18,0,5,80
850842,555996,2016-06-28,Senate,"Do pass as amended, and re-refer to the Committee on Appropriations",6,2,1,0,9
850842,559553,2016-08-11,Senate,"Do pass",5,2,0,0,7
850842,560635,2016-08-23,Senate,"Assembly 3rd Reading AB2148 Holden By Jackson",26,13,0,0,39
850842,561525,2016-08-30,Assembly,"AB 2148 HOLDEN  Concurrence in Senate Amendments",58,22,0,0,80
850843,531903,2016-04-12,Assembly,"Do pass and be re-referred to the Committee on Appropriations",5,12,0,2,19
850844,535848,2016-04-19,Assembly,"Do pass",7,0,0,0,7
850844,539800,2016-04-28,Assembly,"AB 2083 CHU  Assembly Third Reading",78,0,0,2,80
850844,556367,2016-06-28,Senate,"Do pass, but re-refer to the Committee on Appropriations Recommend 	Consent",7,0,0,0,7
850844,559465,2016-08-11,Senate,"Special Consent AB2083 Chu",37,0,2,0,39
850844,560244,2016-08-18,Assembly,"AB 2083 CHU  Concurrence in Senate Amendments",79,0,0,1,80
850845,535112,2016-04-19,Senate,"Do pass, but re-refer to the Committee on Appropriations",4,1,0,0,5
850845,549322,2016-05-27,Senate,"Do pass as amended",5,2,0,0,7
850845,550409,2016-06-01,Senate,"Senate 3rd Reading SB1094 Hernandez",25,14,1,0,40
850845,556356,2016-06-29,Assembly,"Do pass and be re-referred to the Committee on Appropriations",5,2,0,0,7
850845,559245,2016-08-11,Assembly,"Do pass as amended",14,6,0,0,20
850845,560359,2016-08-19,Assembly,"SB 1094 Hernandez  Senate Third Reading  By TRANS.  Amendment  Set 	#1",73,0,0,7,80
850845,560968,2016-08-24,Assembly,"SB 1094 Hernandez  Senate Third Reading  By GONZALEZ",52,28,0,0,80
850845,561328,2016-08-26,Senate,"Unfinished Business SB1094 Hernandez Concurrence",25,13,1,0,39
850846,526384,2016-03-30,Assembly,"Do pass as amended and be re-referred to the Committee on 	Appropriations",15,0,0,0,15
850846,532457,2016-04-13,Assembly,"Do pass, to Consent Calendar",20,0,0,0,20
850846,543214,2016-05-05,Assembly,"AB 2168 WILLIAMS  Assembly Third Reading",78,0,0,2,80
850846,554751,2016-06-21,Senate,"Do pass as amended, and re-refer to the Committee on Appropriations",10,0,1,0,11
850846,560021,2016-08-16,Senate,"Assembly 3rd Reading AB2168 Williams By Cannella",38,0,1,0,39
850846,560649,2016-08-23,Assembly,"AB 2168 WILLIAMS  Concurrence in Senate Amendments",79,0,0,1,80
850847,535856,2016-04-19,Senate,"Do pass, but re-refer to the Committee on Appropriations",5,2,0,0,7
850847,548700,2016-05-26,Senate,"Senate 3rd Reading SB1084 Hancock",26,11,3,0,40
850847,554823,2016-06-21,Assembly,"Do pass and be re-referred to the Committee on Appropriations",5,2,0,0,7
850847,559061,2016-08-03,Assembly,"Do pass",14,6,0,0,20
850847,560602,2016-08-22,Assembly,"SB 1084 Hancock  Senate Third Reading  By JONES-SAWYER",49,29,0,2,80
850847,560985,2016-08-24,Senate,"Unfinished Business SB1084 Hancock Concurrence",26,12,1,0,39
850849,529554,2016-04-06,Assembly,"Amend, and do pass as amended and be re-referred to the Committee 	on Appropriations with the recommendation:  To Consent Calendar",7,0,0,0,7
850849,549455,2016-05-27,Assembly,"Do pass as amended",20,0,0,0,20
850849,550594,2016-06-01,Assembly,"AB 2122 MCCARTY  Assembly Third Reading",80,0,0,0,80
850851,532677,2016-04-13,Senate,"Do pass",6,0,1,0,7
850851,534119,2016-04-18,Senate,"Senate 3rd Reading SB1082 McGuire Motions",39,0,1,0,40
850851,553472,2016-06-15,Assembly,"Do pass",9,0,0,0,9
850851,555229,2016-06-23,Assembly,"SB 1082 McGuire  Senate Third Reading  By LEVINE",75,1,0,4,80
850852,531925,2016-04-12,Senate,"Do pass, but re-refer to the Committee on Judiciary",11,0,0,0,11
850852,535204,2016-04-19,Senate,"Do pass, but re-refer to the Committee on Appropriations",7,0,0,0,7
850852,545206,2016-05-12,Senate,"Senate 3rd Reading SB1106 Leyva",38,0,2,0,40
850853,533142,2016-04-12,Assembly,"Amend, and do pass as amended and be re-referred to the Committee 	on Appropriations with the recommendation:  To Consent Calendar",7,0,0,0,7
850853,546576,2016-05-18,Assembly,"Do pass, to Consent Calendar",20,0,0,0,20
850853,549155,2016-05-27,Assembly,"AB 2062 LOPEZ  Consent Calendar Second Day  Regular Session",67,0,0,13,80
850853,552772,2016-06-14,Senate,"Do pass, but re-refer to the Committee on Appropriations",4,0,1,0,5
850853,558890,2016-08-01,Senate,"Placed on Appropriations Suspense file",7,0,0,0,7
850853,559693,2016-08-11,Senate,"Do pass",7,0,0,0,7
850853,560610,2016-08-22,Senate,"Assembly 3rd Reading AB2062 Lopez By McGuire",39,0,0,0,39
850853,561231,2016-08-25,Assembly,"AB 2062 LOPEZ  Concurrence in Senate Amendments",79,0,0,1,80
850854,535304,2016-04-19,Assembly,"Do pass and be re-referred to the Committee on Veterans Affairs to 	Consent Calendar",10,0,0,0,10
850854,538539,2016-04-26,Assembly,"Do pass",9,0,0,0,9
850854,540897,2016-05-02,Assembly,"AB 2128 ACHADJIAN  Assembly Third Reading",76,0,0,4,80
850854,553129,2016-06-14,Senate,"Do pass and be placed on the Consent Calendar",7,0,0,0,7
850854,557108,2016-06-30,Senate,"Consent Calendar 2nd AB2128 Achadjian",37,0,3,0,40
850854,558631,2016-08-01,Assembly,"AB 2128 ACHADJIAN  Concurrence in Senate Amendments",75,0,0,5,80
850857,532043,2016-04-12,Assembly,"Do pass and be re-referred to the Committee on Appropriations to 	Consent Calendar",7,0,0,0,7
850857,542920,2016-05-04,Assembly,"Do pass, to Consent Calendar",20,0,0,0,20
850857,545322,2016-05-12,Assembly,"AB 2106 IRWIN  Consent Calendar Second Day  Regular Session",78,0,0,2,80
850857,551422,2016-06-06,Senate,"Do pass as amended, but re-refer to the Committee on Judiciary 	Recommend Consent",8,0,1,0,9
850857,560082,2016-08-17,Senate,"Assembly 3rd Reading AB2106 Irwin By Wieckowski",39,0,0,0,39
850857,561264,2016-08-25,Assembly,"Senate amendments be concurred in",6,0,0,1,7
850857,561627,2016-08-30,Assembly,"AB 2106 IRWIN  Concurrence in Senate Amendments",80,0,0,0,80
850859,535715,2016-04-19,Assembly,"Do pass as amended and be re-referred to the Committee on Arts, 	Entertain, Sports, Tourism, & Internet Media",11,5,0,0,16
850859,541858,2016-05-03,Assembly,"Do pass, to Consent Calendar",7,0,0,0,7
850859,544105,2016-05-09,Assembly,"AB 2138 LOW  Consent Calendar Second Day",78,0,0,2,80
850859,551560,2016-06-06,Senate,"Do pass, but re-refer to the Committee on Appropriations",8,0,1,0,9
850859,559880,2016-08-15,Senate,"Assembly 3rd Reading AB2138 Low By Pan",38,0,1,0,39
850859,560586,2016-08-22,Assembly,"AB 2138 LOW  Concurrence in Senate Amendments",78,0,0,2,80
850860,538683,2016-04-26,Assembly,"Do pass as amended",12,2,0,2,16
850860,546896,2016-05-18,Assembly,"Do pass",19,0,0,1,20
850861,531422,2016-04-12,Assembly,"Do pass as amended and be re-referred to the Committee on 	Appropriations",12,6,0,1,19
850861,549269,2016-05-27,Assembly,"Do pass as amended",12,7,0,1,20
850861,551155,2016-06-02,Assembly,"AB 2079 CALDERON  Assembly Third Reading",43,25,0,12,80
850861,555327,2016-06-22,Senate,"Do pass, but re-refer to the Committee on Appropriations",6,2,1,0,9
850861,558895,2016-08-01,Senate,"Placed on Appropriations Suspense file",7,0,0,0,7
850861,559692,2016-08-11,Senate,"Do pass as amended",5,2,0,0,7
850862,528069,2016-04-05,Assembly,"Do pass and be re-referred to the Committee on Arts, Entertain, 	Sports, Tourism, & Internet Media to Consent Calendar",11,0,0,0,11
850862,531572,2016-04-12,Assembly,"Do pass as amended and be re-referred to the Committee on 	Appropriations",7,0,0,0,7
850862,542728,2016-05-04,Assembly,"Do pass, to Consent Calendar",20,0,0,0,20
850862,545291,2016-05-12,Assembly,"AB 2068 HOLDEN  Consent Calendar Second Day  Regular Session",78,0,0,2,80
850862,552162,2016-06-08,Senate,"Do pass, but re-refer to the Committee on Appropriations",4,0,1,0,5
850862,559810,2016-08-15,Senate,"Assembly 3rd Reading AB2068 Holden By Mitchell",38,0,1,0,39
850863,535689,2016-04-19,Senate,"Do pass as amended, and re-refer to the Committee on Appropriations",11,0,0,0,11
850863,548669,2016-05-26,Senate,"Senate 3rd Reading SB1112 Cannella",39,0,1,0,40
850863,556820,2016-06-29,Assembly,"Amend, and do pass as amended and be re-referred to the Committee 	on Appropriations with the recommendation:  To Consent Calendar",15,0,0,0,15
850863,559642,2016-08-10,Assembly,"Do pass as amended, to Consent Calendar",19,0,0,1,20
850863,560299,2016-08-18,Assembly,"SB 1112 Cannella  Consent Calendar Second Day  Regular Session",78,0,0,2,80
850863,561223,2016-08-25,Senate,"Special Consent SB1112 Cannella Urgency Clause",39,0,0,0,39
850865,533088,2016-04-12,Assembly,"Do pass and be re-referred to the Committee on Appropriations",13,0,0,0,13
850865,549376,2016-05-27,Assembly,"Do pass as amended",20,0,0,0,20
850865,550494,2016-06-01,Assembly,"AB 2069 MEDINA  Assembly Third Reading",77,0,0,3,80
850865,553209,2016-06-15,Senate,"Do pass as amended, and re-refer to the Committee on Appropriations",9,0,0,0,9
850865,559915,2016-08-15,Senate,"Assembly 3rd Reading AB2069 Medina By Block",38,0,1,0,39
850865,560617,2016-08-22,Assembly,"AB 2069 MEDINA  Concurrence in Senate Amendments",76,0,0,4,80
850866,525930,2016-03-29,Assembly,"Do pass and be re-referred to the Committee on Appropriations",7,0,0,0,7
850866,545081,2016-05-11,Assembly,"Do pass, to Consent Calendar",20,0,0,0,20
850866,549089,2016-05-27,Assembly,"AB 2078 KIM  Assembly Third Reading",72,0,0,8,80
850866,554828,2016-06-21,Senate,"Do pass, but re-refer to the Committee on Appropriations",7,0,0,0,7
850866,558905,2016-08-01,Senate,"Placed on Appropriations Suspense file",7,0,0,0,7
850867,528275,2016-04-05,Assembly,"Do pass as amended and be re-referred to the Committee on 	Appropriations",18,0,0,1,19
850867,549436,2016-05-27,Assembly,"Do pass as amended",20,0,0,0,20
850867,550579,2016-06-01,Assembly,"AB 2048 GRAY  Assembly Third Reading",80,0,0,0,80
850867,557064,2016-06-29,Senate,"Do pass, but re-refer to the Committee on Appropriations Recommend 	Consent",8,0,1,0,9
850867,558949,2016-08-01,Senate,"Placed on Appropriations Suspense file",7,0,0,0,7
850867,559679,2016-08-11,Senate,"Do pass as amended",7,0,0,0,7
850867,560080,2016-08-17,Senate,"Assembly 3rd Reading AB2048 Gray By Cannella",39,0,0,0,39
850867,560839,2016-08-23,Assembly,"AB 2048 GRAY  Concurrence in Senate Amendments",80,0,0,0,80
850868,526484,2016-03-29,Assembly,"Do pass as amended and be re-referred to the Committee on 	Appropriations",5,1,0,1,7
850870,535657,2016-04-19,Senate,"Do pass, but re-refer to the Committee on Appropriations",7,0,0,0,7
850870,549419,2016-05-27,Senate,"Do pass",7,0,0,0,7
850870,550126,2016-05-31,Senate,"Senate 3rd Reading SB1088 Nguyen",37,0,3,0,40
850870,556063,2016-06-28,Assembly,"Do pass and be re-referred to the Committee on Appropriations",4,3,0,0,7
850870,556064,2016-06-28,Assembly,MOTIONDCX153**,4,2,0,1,7
850870,559196,2016-06-28,Assembly,"Do pass and be re-referred to the Committee on Appropriations",6,0,0,1,7
850870,560149,2016-08-18,Assembly,"SB 1088 Nguyen  Senate Third Reading  By KIM",77,1,0,2,80
850870,561262,2016-08-25,Senate,"Special Consent SB1088 Nguyen",39,0,0,0,39
850871,525922,2016-03-29,Senate,"Do pass, but re-refer to the Committee on Judiciary Recommend 	Consent",7,0,0,0,7
850871,531677,2016-04-12,Senate,"Do pass as amended. To Consent Calendar",6,0,1,0,7
850871,537382,2016-04-21,Senate,"Consent Calendar 2nd SB1087 Anderson",39,0,1,0,40
850871,552191,2016-06-08,Assembly,"Do pass, to Consent Calendar",9,0,0,1,10
850871,553702,2016-06-16,Assembly,"SB 1087 Anderson  Consent Calendar Second Day  Regular Session",78,0,0,2,80
850871,557084,2016-06-30,Senate,"Special Consent # SB1087 Anderson",37,0,3,0,40
850872,538952,2016-04-26,Senate,"Do pass",6,1,0,0,7
850872,545285,2016-05-12,Senate,"Senate 3rd Reading SB1078 Jackson",24,12,4,0,40
850872,554783,2016-06-21,Assembly,"Do pass",8,2,0,0,10
850872,560432,2016-08-19,Assembly,"SB 1078 Jackson  Senate Third Reading  Amendment  Set #1",73,0,0,7,80
850872,561492,2016-08-29,Assembly,"SB 1078 Jackson  Senate Third Reading  By CHAU",48,26,0,6,80
850872,561599,2016-08-30,Senate,"Unfinished Business (S upplemental File 1)SB1 078 Jac kson Con",24,13,2,0,39
850873,533097,2016-04-12,Assembly,"Do pass as amended and be re-referred to the Committee on 	Appropriations",13,0,0,0,13
850873,549370,2016-05-27,Assembly,"Do pass as amended",20,0,0,0,20
850873,550493,2016-06-01,Assembly,"AB 2164 O'DONNELL  Assembly Third Reading",78,0,0,2,80
850873,553213,2016-06-15,Senate,"Do pass, but re-refer to the Committee on Appropriations",9,0,0,0,9
850873,558882,2016-08-01,Senate,"Placed on Appropriations Suspense file",7,0,0,0,7
850873,559757,2016-08-11,Senate,"Do pass as amended",7,0,0,0,7
850873,560229,2016-08-18,Senate,"Assembly 3rd Reading AB2164 O'Donnell By Hertzberg",38,0,1,0,39
850873,561449,2016-08-29,Assembly,"AB 2164 O'DONNELL  Concurrence in Senate Amendments",78,0,0,2,80
850874,528220,2016-04-05,Assembly,"Do pass as amended and be re-referred to the Committee on Insurance",15,0,0,1,16
850874,542762,2016-05-04,Assembly,"Do pass, to Consent Calendar",13,0,0,0,13
850874,545222,2016-05-12,Assembly,"AB 2161 QUIRK  Consent Calendar Second Day  Regular Session",78,0,0,2,80
850874,555119,2016-06-22,Senate,"Do pass and be placed on the Consent Calendar",8,0,1,0,9
850874,557104,2016-06-30,Senate,"Consent Calendar 2nd AB2161 Quirk",37,0,3,0,40
850875,538829,2016-04-26,Assembly,"Do pass and be re-referred to the Committee on Privacy and Consumer 	Protection to Consent Calendar",10,0,0,0,10
850875,541506,2016-05-03,Assembly,"Do pass, to Consent Calendar",11,0,0,0,11
850875,545274,2016-05-12,Assembly,"AB 2051 O'DONNELL  Consent Calendar Second Day  Regular Session",78,0,0,2,80
850875,556365,2016-06-28,Senate,"Do pass as amended",7,0,0,0,7
850875,559342,2016-08-11,Senate,"Special Consent AB2051 O'Donnell",37,0,2,0,39
850875,559799,2016-08-15,Assembly,"AB 2051 O'DONNELL  Concurrence in Senate Amendments",78,0,0,2,80
850876,534723,2016-04-18,Assembly,"Do pass and be re-referred to the Committee on Appropriations",10,3,0,3,16
850880,537338,2016-04-20,Senate,"Do pass as amended, and re-refer to the Committee on Appropriations",9,0,0,0,9
850880,549223,2016-05-27,Senate,"Do pass as amended",7,0,0,0,7
850880,551118,2016-06-02,Senate,"Senate 3rd Reading SB1098 Cannella",38,0,2,0,40
850880,556262,2016-06-28,Assembly,"Do pass as amended and be re-referred to the Committee on 	Appropriations",18,0,0,0,18
850880,559224,2016-08-11,Assembly,"Do pass as amended",20,0,0,0,20
850880,560952,2016-08-24,Assembly,"SB 1098 Cannella  Senate Third Reading  By WOOD",79,0,0,1,80
850880,561321,2016-08-26,Senate,"Unfinished Business SB1098 Cannella Concurrence",39,0,0,0,39
850881,534362,2016-04-18,Assembly,"Do pass, to Consent Calendar",15,0,0,1,16
850881,550690,2016-06-01,Assembly,"AB 2167 ACHADJIAN  Assembly Third Reading",80,0,0,0,80
850881,559421,2016-08-11,Senate,"Special Consent AB2167 Achadjian",37,0,2,0,39
850881,560263,2016-08-18,Assembly,"AB 2167 ACHADJIAN  Concurrence in Senate Amendments",79,0,0,1,80
850883,529029,2016-04-06,Assembly,"Do pass as amended and be re-referred to the Committee on 	Appropriations",9,0,0,0,9
850883,546612,2016-05-18,Assembly,"Do pass",20,0,0,0,20
850883,547536,2016-05-23,Assembly,"AB 2143 IRWIN  Assembly Third Reading",77,0,0,3,80
850883,553125,2016-06-15,Senate,"Do pass, but re-refer to the Committee on Judiciary Recommend 	Consent",7,0,0,0,7
850883,555019,2016-06-21,Senate,"Do pass as amended, and re-refer to the Committee on Appropriations",7,0,0,0,7
850883,559838,2016-08-15,Senate,"Assembly 3rd Reading AB2143 Irwin By Leno",38,0,1,0,39
850883,560517,2016-08-22,Assembly,"AB 2143 IRWIN  Concurrence in Senate Amendments",78,0,0,2,80
850886,537631,2016-04-20,Assembly,"Do pass as amended and be re-referred to the Committee on 	Appropriations",7,0,0,0,7
850886,545101,2016-05-11,Assembly,"Do pass, to Consent Calendar",20,0,0,0,20
850886,547587,2016-05-23,Assembly,"AB 2072 CHANG  Assembly Third Reading",77,0,0,3,80
850886,553211,2016-06-15,Senate,"Do pass as amended, and re-refer to the Committee on Appropriations",6,0,3,0,9
850886,558929,2016-08-01,Senate,"Placed on Appropriations Suspense file",7,0,0,0,7
850887,532540,2016-04-13,Senate,"Do pass, but re-refer to the Committee on Appropriations",5,0,2,0,7
850888,526301,2016-03-30,Assembly,"Do pass and be re-referred to the Committee on Transportation",2,5,0,0,7
850888,526302,2016-03-30,Assembly,"Reconsideration granted",7,0,0,0,7
850890,526298,2016-03-30,Assembly,"Do pass and be re-referred to the Committee on Transportation",2,5,0,0,7
850890,526299,2016-03-30,Assembly,"Reconsideration granted",7,0,0,0,7
850891,544377,2016-04-19,Assembly,"Do pass and be re-referred to the Committee on Appropriations",4,7,0,2,13
850891,544378,2016-04-19,Assembly,"Reconsideration granted",13,0,0,0,13
850892,532760,2016-04-13,Assembly,"Do pass and be re-referred to the Committee on Appropriations to 	Consent Calendar",10,0,0,0,10
850892,539446,2016-04-27,Assembly,"Do pass, to Consent Calendar",19,0,0,1,20
850892,543097,2016-05-05,Assembly,"AB 2074 RODRIGUEZ  Consent Calendar Second Day  Regular Session",79,0,0,1,80
850893,528455,2016-04-05,Senate,"Do pass",10,0,1,0,11
850893,533470,2016-04-14,Senate,"Senate 3rd Reading SB1128 Glazer",37,0,3,0,40
850893,555551,2016-06-27,Assembly,"Do pass",15,0,0,1,16
850893,560197,2016-08-18,Assembly,"SB 1128 Glazer  Senate Third Reading  By CHIU",75,0,0,5,80
850894,527971,2016-04-05,Assembly,"Do pass",2,5,0,0,7
850894,527972,2016-04-05,Assembly,"Reconsideration granted",7,0,0,0,7
850894,537149,2016-04-20,Assembly,"Do pass",1,5,0,1,7
850895,525785,2016-03-29,Assembly,"Do pass as amended and be re-referred to the Committee on 	Environmental Safety and Toxic Materials",18,0,0,1,19
850895,531417,2016-04-12,Assembly,"Do pass and be re-referred to the Committee on Appropriations",7,0,0,0,7
850895,549372,2016-05-27,Assembly,"Do pass as amended",19,1,0,0,20
850895,550995,2016-06-02,Assembly,"AB 2125 CHIU  Assembly Third Reading",76,4,0,0,80
850895,553228,2016-06-15,Senate,"Do pass, but re-refer to the Committee on Rules",7,0,0,0,7
850895,555705,2016-06-27,Senate,"Do pass, but re-refer to the Committee on Appropriations",9,0,0,0,9
850895,558963,2016-08-01,Senate,"Placed on Appropriations Suspense file",7,0,0,0,7
850895,559785,2016-08-11,Senate,"Do pass",7,0,0,0,7
850895,560436,2016-08-19,Senate,"Assembly 3rd Reading AB2125 Chiu By Pan",37,0,2,0,39
850895,561026,2016-08-24,Assembly,"AB 2125 CHIU  Concurrence in Senate Amendments",77,3,0,0,80
850896,535192,2016-04-19,Senate,"Do pass",5,2,0,0,7
850896,540863,2016-05-02,Senate,"Senate 3rd Reading SB1129 Monning",23,14,3,0,40
850896,553016,2016-06-14,Assembly,"Do pass",5,2,0,0,7
850896,560312,2016-08-18,Assembly,"SB 1129 Monning  Senate Third Reading  By GARCIA, C",41,29,0,10,80
850896,561042,2016-08-24,Senate,"Unfinished Business SB1129 Monning Concurrence",24,14,1,0,39
850897,532663,2016-04-13,Assembly,"Do pass as amended and be re-referred to the Committee on 	Appropriations",7,0,0,0,7
850897,539579,2016-04-28,Assembly,"AB 2071 HARPER  Assembly Third Reading",77,0,0,3,80
850897,554886,2016-06-21,Senate,"Do pass as amended",5,0,0,0,5
850897,559412,2016-08-11,Senate,"Special Consent AB2071 Harper",37,0,2,0,39
850897,559866,2016-08-15,Assembly,"AB 2071 HARPER  Concurrence in Senate Amendments",76,0,0,4,80
850898,525541,2016-03-29,Senate,"Do pass as amended, and re-refer to the Committee on Environmental 	Quality",7,2,0,0,9
850898,536148,2016-04-20,Senate,"Do pass, but re-refer to the Committee on Appropriations",5,2,0,0,7
850898,545773,2016-05-16,Senate,"Placed on Appropriations Suspense file",7,0,0,0,7
851516,525765,2016-03-29,Assembly,"Do pass as amended",10,0,0,0,10
851516,549986,2016-05-31,Assembly,"AB 2349 CHIU  Assembly Third Reading",78,0,0,2,80
851516,555036,2016-06-21,Senate,"Do pass",7,0,0,0,7
851516,559910,2016-08-15,Senate,"Assembly 3rd Reading AB2349 Chiu By Leno",37,0,2,0,39
851516,560532,2016-08-22,Assembly,"AB 2349 CHIU  Concurrence in Senate Amendments",77,0,0,3,80
851517,527994,2016-04-04,Assembly,"Do pass and be re-referred to the Committee on Appropriations",9,0,0,0,9
851517,549256,2016-05-27,Assembly,"Do pass",19,1,0,0,20
851517,550395,2016-06-01,Assembly,"AB 2189 IRWIN  Assembly Third Reading",72,5,0,3,80
851517,556126,2016-06-28,Senate,"Do pass, but re-refer to the Committee on Appropriations",8,0,1,0,9
851517,558920,2016-08-01,Senate,"Placed on Appropriations Suspense file",7,0,0,0,7
851517,559697,2016-08-11,Senate,"Do pass",7,0,0,0,7
851517,560070,2016-08-17,Senate,"Assembly 3rd Reading AB2189 Irwin By Pavley",36,0,3,0,39
851518,526786,2016-03-31,Assembly,"Be referred to Committee on Veterans Affairs",8,0,0,3,11
851518,532697,2016-04-12,Assembly,"Do pass and be re-referred to the Committee on Accountability and 	Administrative Review",8,0,0,1,9
851518,532698,2016-04-13,Assembly,"Do pass as amended and be re-referred to the Committee on 	Appropriations",9,0,0,0,9
851518,539000,2016-04-27,Assembly,"Do pass, to Consent Calendar",19,0,0,1,20
851518,542987,2016-05-05,Assembly,"AB 2247 WILLIAMS  Consent Calendar Second Day  Regular Session",79,0,0,1,80
851518,552688,2016-06-14,Senate,"Do pass, but re-refer to the Committee on Appropriations Recommend 	Consent",12,0,1,0,13
851518,558803,2016-08-01,Senate,"Do pass",7,0,0,0,7
851518,560401,2016-08-19,Senate,"Assembly 3rd Reading AB2247 Williams By Lara",36,0,3,0,39
851518,560943,2016-08-24,Assembly,"AB 2247 WILLIAMS  Concurrence in Senate Amendments",80,0,0,0,80
851519,531380,2016-04-12,Senate,"Do pass as amended",6,0,1,0,7
851519,537283,2016-04-21,Senate,"Senate 3rd Reading SB1229 Jackson",39,0,1,0,40
851519,554801,2016-06-21,Assembly,"Do pass as amended",9,0,0,1,10
851519,559145,2016-08-04,Assembly,"SB 1229 Jackson  Senate Third Reading  By TING",76,0,0,4,80
851519,559374,2016-08-11,Senate,"Special Consent SB1229 Jackson Concurrence",37,0,2,0,39
851520,536909,2016-04-20,Assembly,"Do pass and be re-referred to the Committee on Appropriations",7,0,0,0,7
851520,549445,2016-05-27,Assembly,"Do pass as amended",20,0,0,0,20
851520,550610,2016-06-01,Assembly,"AB 2348 LEVINE  Assembly Third Reading",76,4,0,0,80
851520,558828,2016-08-01,Senate,"Placed on Appropriations Suspense file",7,0,0,0,7
851520,559735,2016-08-11,Senate,"Do pass",5,2,0,0,7
851520,561316,2016-08-25,Senate,"Assembly 3rd Reading AB2348 Levine By Vidak",28,11,0,0,39
851521,532914,2016-04-12,Senate,"Do pass, but re-refer to the Committee on Education",4,0,1,0,5
851521,536580,2016-04-20,Senate,"Do pass as amended. To Consent Calendar",9,0,0,0,9
851521,539623,2016-04-28,Senate,"Consent Calendar 2nd SB1180 Jackson",37,0,3,0,40
851521,553684,2016-06-15,Assembly,"Do pass and be re-referred to the Committee on Veterans Affairs to 	Consent Calendar",7,0,0,0,7
851521,556275,2016-06-28,Assembly,"Do pass and be re-referred to the Committee on Appropriations",7,0,0,2,9
851521,559255,2016-08-11,Assembly,"Do pass",20,0,0,0,20
851521,560124,2016-08-18,Assembly,"SB 1180 Jackson  Senate Third Reading  By MATHIS",77,0,0,3,80
851522,526462,2016-03-30,Assembly,"Do pass and be re-referred to the Committee on Appropriations",9,0,0,0,9
851522,549146,2016-05-27,Assembly,"Do pass as amended",20,0,0,0,20
851522,550466,2016-06-01,Assembly,"AB 2358 BIGELOW  Assembly Third Reading",80,0,0,0,80
851522,559951,2016-08-16,Senate,"Assembly 3rd Reading AB2358 Gonzalez By Hall Urgency Clause",38,0,1,0,39
851522,560686,2016-08-23,Assembly,"AB 2358 GONZALEZ  Concurrence- Urgency Added",79,0,0,1,80
851523,529369,2016-04-06,Senate,"Do pass, but re-refer to the Committee on Public Safety",9,0,0,0,9
851523,535460,2016-04-19,Senate,"Do pass, but re-refer to the Committee on Appropriations Recommend 	Consent",7,0,0,0,7
851523,548837,2016-05-26,Senate,"Senate 3rd Reading SB1238 Pan",39,0,1,0,40
851523,554959,2016-06-21,Assembly,"Do pass and be re-referred to the Committee on Public Safety to 	Consent Calendar",17,0,0,1,18
851523,555946,2016-06-28,Assembly,"Do pass and be re-referred to the Committee on Appropriations to 	Consent Calendar",7,0,0,0,7
851523,559021,2016-08-03,Assembly,"Do pass, to Consent Calendar",20,0,0,0,20
851523,559249,2016-08-11,Assembly,"SB 1238 Pan  Consent Calendar Second Day  Regular Session",78,0,0,2,80
851524,531958,2016-04-12,Senate,"Do pass, but re-refer to the Committee on Appropriations",4,1,2,0,7
851524,549250,2016-05-27,Senate,"Do pass as amended",5,2,0,0,7
851524,550670,2016-06-01,Senate,"Senate 3rd Reading SB1202 Leno",21,15,4,0,40
851524,556144,2016-06-28,Assembly,"Do pass and be re-referred to the Committee on Appropriations",5,2,0,0,7
851525,531548,2016-04-12,Assembly,"Do pass and be re-referred to the Committee on Appropriations",19,0,0,0,19
851525,549362,2016-05-27,Assembly,"Do pass as amended",20,0,0,0,20
851525,550512,2016-06-01,Assembly,"AB 2260 WOOD  Assembly Third Reading",79,0,0,1,80
851525,555380,2016-06-22,Senate,"Do pass, but re-refer to the Committee on Appropriations",9,0,0,0,9
851525,558881,2016-08-01,Senate,"Placed on Appropriations Suspense file",7,0,0,0,7
851527,513385,2016-03-03,Assembly,"From committee:  Be adopted.  To third reading",8,0,0,3,11
851527,533467,2016-04-14,Senate,"Assembly 3rd Reading ACR141 Wood By Nielsen",38,0,2,0,40
851528,547551,2016-05-23,Senate,"Do pass",7,0,0,0,7
851528,548658,2016-05-26,Senate,"Senate 3rd Reading SB1186 Lara Urgency Clause",36,1,3,0,40
851528,553083,2016-06-15,Assembly,"Do pass",20,0,0,0,20
851528,555243,2016-06-23,Assembly,"SB 1186 Lara  Third Reading Urgency  By GONZALEZ",75,0,0,5,80
851528,555552,2016-06-27,Senate,"Unfinished Business SB1186 Lara By Leno Urgency Clause Concurr",37,0,3,0,40
851529,532238,2016-04-12,Senate,"Do pass, but re-refer to the Committee on Judiciary Recommend 	Consent",5,0,0,0,5
851529,549332,2016-05-27,Senate,"Do pass",7,0,0,0,7
851529,549933,2016-05-31,Senate,"Senate 3rd Reading SB1220 McGuire",39,0,1,0,40
851529,552770,2016-06-14,Assembly,"Do pass and be re-referred to the Committee on Appropriations to 	Consent Calendar",7,0,0,0,7
851531,528896,2016-04-06,Assembly,"Amend, and do pass as amended and be re-referred to the Committee 	on Appropriations with the recommendation:  To Consent Calendar",15,0,0,0,15
851532,530544,2016-04-11,Senate,"Do pass, but re-refer to the Committee on Judiciary",3,1,5,0,9
851532,530545,2016-04-11,Senate,"Reconsideration granted",9,0,0,0,9
851532,535060,2016-04-18,Senate,"Do pass, but re-refer to the Committee on Judiciary",9,0,0,0,9
851533,535371,2016-04-19,Senate,"Do pass, but re-refer to the Committee on Appropriations",2,8,1,0,11
851533,535372,2016-04-19,Senate,"Reconsideration granted",11,0,0,0,11
851535,531387,2016-04-12,Assembly,"Do pass as amended",7,0,0,0,7
851535,540807,2016-05-02,Assembly,"AB 2361 SANTIAGO  Assembly Third Reading",71,3,0,6,80
851535,554630,2016-06-21,Senate,"Do pass, but re-refer to the Committee on Appropriations",7,0,0,0,7
851535,560153,2016-08-18,Senate,"Assembly 3rd Reading AB2361 Santiago By Glazer",38,0,1,0,39
851535,560974,2016-08-24,Assembly,"AB 2361 SANTIAGO  Concurrence in Senate Amendments",75,4,0,1,80
851537,536682,2016-04-20,Senate,"Do pass, but re-refer to the Committee on Judiciary",2,5,0,0,7
851537,536683,2016-04-20,Senate,"Set, first hearing.  Failed passage in Committee.  Reconsideration 	granted",7,0,0,0,7
851540,536234,2016-04-20,Assembly,"Do pass and be re-referred to the Committee on Appropriations",7,0,0,0,7
851540,548993,2016-05-27,Assembly,"Do pass as amended",20,0,0,0,20
851540,550380,2016-06-01,Assembly,"AB 2285 MCCARTY  Assembly Third Reading",79,0,0,1,80
851540,556335,2016-06-29,Senate,"Do pass as amended, and re-refer to the Committee on Appropriations",9,0,0,0,9
851541,542384,2016-05-03,Senate,"Do pass as amended",6,0,1,0,7
851541,543791,2016-05-09,Senate,"Senate 3rd Reading SB1255 Moorlach",35,0,5,0,40
851541,552058,2016-06-08,Assembly,"Do pass",7,1,0,2,10
851541,555509,2016-06-27,Assembly,"SB 1255 Moorlach  Senate Third Reading  By WILK",66,4,0,10,80
851541,556791,2016-06-30,Senate,"Unfinished Business SB1255 Moorlach Concurrence",38,0,2,0,40
851542,544811,2016-04-19,Assembly,"Do pass and be re-referred to the Committee on Appropriations",4,7,0,2,13
851542,544812,2016-04-19,Assembly,"Reconsideration granted",13,0,0,0,13
851543,529346,2016-04-06,Assembly,"Do pass as amended and be re-referred to the Committee on 	Appropriations",7,0,0,0,7
851543,536314,2016-04-20,Assembly,"Do pass, to Consent Calendar",16,0,0,4,20
851543,539989,2016-04-28,Assembly,"AB 2306 FRAZIER  Consent Calendar Second Day  Regular Session",76,0,0,4,80
851543,556452,2016-06-29,Senate,"Do pass, but re-refer to the Committee on Appropriations",9,0,0,0,9
851543,558872,2016-08-01,Senate,"Placed on Appropriations Suspense file",7,0,0,0,7
851543,559689,2016-08-11,Senate,"Do pass as amended",7,0,0,0,7
851543,560545,2016-08-22,Senate,"Assembly 3rd Reading AB2306 Frazier By Monning",39,0,0,0,39
851543,561181,2016-08-25,Assembly,"AB 2306 FRAZIER  Concurrence in Senate Amendments",78,1,0,1,80
851544,525767,2016-03-29,Assembly,"Do pass as amended and be re-referred to the Committee on 	Appropriations",10,0,0,0,10
851544,532892,2016-04-13,Assembly,"Do pass, to Consent Calendar",20,0,0,0,20
851544,538014,2016-04-25,Assembly,"AB 2269 WALDRON  Assembly Third Reading",77,0,0,3,80
851544,556306,2016-06-28,Senate,"Do pass as amended, and re-refer to the Committee on Appropriations",7,0,0,0,7
851544,559531,2016-08-11,Senate,"Do pass",7,0,0,0,7
851544,559933,2016-08-16,Senate,"Assembly 3rd Reading AB2269 Waldron By Monning",38,0,1,0,39
851544,560644,2016-08-23,Assembly,"AB 2269 WALDRON  Concurrence in Senate Amendments",79,0,0,1,80
851545,532004,2016-04-12,Senate,"Do pass as amended, and re-refer to the Committee on Governance and 	Finance",11,0,2,0,13
851545,545311,2016-05-12,Senate,"Senate 3rd Reading SB1138 Hueso",38,0,2,0,40
851545,552146,2016-06-08,Assembly,"Do pass and be re-referred to the Committee on Appropriations to 	Consent Calendar",17,0,0,4,21
851545,556591,2016-06-29,Assembly,"Do pass, to Consent Calendar",18,0,0,2,20
851545,559134,2016-08-04,Assembly,"SB 1138 Hueso  Consent Calendar Second Day  Regular Session",77,0,0,3,80
851545,559304,2016-08-11,Senate,"Unfinished Business SB1138 Hueso Concurrence",37,0,2,0,39
851546,529338,2016-04-06,Senate,"Do pass, but re-refer to the Committee on Education Recommend 	Consent",9,0,0,0,9
851546,532712,2016-04-13,Senate,"Do pass as amended, but re-refer to the Committee on Appropriations 	Recommend Consent",9,0,0,0,9
851546,545989,2016-05-16,Senate,"Placed on Appropriations Suspense file",7,0,0,0,7
851547,528105,2016-04-05,Assembly,"Do pass and be re-referred to the Committee on Privacy and Consumer 	Protection to Consent Calendar",10,0,0,0,10
851547,535153,2016-04-19,Assembly,"Do pass and be re-referred to the Committee on Appropriations",11,0,0,0,11
851547,545056,2016-05-11,Assembly,"Do pass, to Consent Calendar",20,0,0,0,20
851547,549361,2016-05-27,Assembly,"AB 2263 BAKER  Assembly Third Reading",70,0,0,10,80
851547,556655,2016-06-28,Senate,"Do pass, but re-refer to the Committee on Appropriations",5,1,1,0,7
851547,559914,2016-08-15,Senate,"Assembly 3rd Reading AB2263 Baker By Galgiani",30,2,7,0,39
851549,532686,2016-04-13,Assembly,"Do pass as amended",7,0,0,0,7
851549,538119,2016-04-25,Assembly,"AB 2252 TING  Assembly Third Reading",75,0,0,5,80
851549,554908,2016-06-21,Senate,"Do pass and be placed on the Consent Calendar",5,0,0,0,5
851549,556900,2016-06-30,Senate,"Consent Calendar 2nd AB2252 Ting",37,0,3,0,40
851551,533108,2016-04-13,Senate,"Do pass as amended, and re-refer to the Committee on Appropriations",7,2,0,0,9
851551,549175,2016-05-27,Senate,"Do pass",5,2,0,0,7
851551,549938,2016-05-31,Senate,"Senate 3rd Reading SB1139 Lara",28,11,1,0,40
851551,556345,2016-06-28,Assembly,"Do pass as amended and be re-referred to the Committee on 	Appropriations",13,4,0,1,18
851551,558992,2016-08-03,Assembly,"Do pass",14,5,0,1,20
851551,560211,2016-08-18,Assembly,"SB 1139 Lara  Senate Third Reading  By ARAMBULA",56,20,0,4,80
851551,561565,2016-08-30,Senate,"Unfinished Business SB1139 Lara Concurrence",28,11,0,0,39
851552,539094,2016-04-27,Assembly,"Do pass as amended",7,0,0,0,7
851552,545413,2016-05-12,Assembly,"AB 2176 CAMPOS  Assembly Third Reading",77,0,0,3,80
851552,552939,2016-06-14,Senate,"Do pass as amended, and re-refer to the Committee on Judiciary",10,0,1,0,11
851552,556609,2016-06-28,Senate,"Do pass as amended",7,0,0,0,7
851552,560904,2016-08-24,Senate,"Assembly 3rd Reading AB2176 Campos By Wieckowski",39,0,0,0,39
851552,561572,2016-08-30,Assembly,"AB 2176 CAMPOS  Concurrence in Senate Amendments",79,0,0,1,80
851553,529574,2016-04-06,Assembly,"Do pass and be re-referred to the Committee on Appropriations to 	Consent Calendar",7,0,0,0,7
851553,532912,2016-04-13,Assembly,"Do pass, to Consent Calendar",20,0,0,0,20
851553,537207,2016-04-21,Assembly,"AB 2259 MEDINA  Consent Calendar Second Day  Regular Session",79,0,0,1,80
851553,552132,2016-06-08,Senate,"Do pass, but re-refer to the Committee on Appropriations Recommend 	Consent",9,0,0,0,9
851553,554516,2016-06-20,Senate,"Placed on Appropriations Suspense file",7,0,0,0,7
851553,559723,2016-08-11,Senate,"Do pass",7,0,0,0,7
851553,560576,2016-08-22,Senate,"Assembly 3rd Reading AB2259 Medina By Liu",39,0,0,0,39
851554,544669,2016-04-19,Assembly,"Do pass",2,9,0,2,13
851554,544670,2016-04-19,Assembly,"Reconsideration granted",13,0,0,0,13
851555,526467,2016-03-29,Assembly,"Do pass and be re-referred to the Committee on Appropriations",8,0,0,1,9
851555,532726,2016-04-13,Assembly,"Do pass, to Consent Calendar",20,0,0,0,20
851555,537246,2016-04-21,Assembly,"AB 2254 ACHADJIAN  Consent Calendar Second Day  Regular Session",79,0,0,1,80
851555,552782,2016-06-14,Senate,"Do pass, but re-refer to the Committee on Appropriations Recommend 	Consent",5,0,0,0,5
851555,559508,2016-08-11,Senate,"Consent Calendar 2nd AB2254 Achadjian",37,0,2,0,39
851555,561832,2016-08-31,Assembly,"AB 2254 ACHADJIAN  Concurrence in Senate Amendments",79,0,0,1,80
851557,529046,2016-04-06,Assembly,"Do pass and be re-referred to the Committee on Education to Consent 	Calendar",18,0,0,3,21
851557,542432,2016-05-04,Assembly,"Do pass, to Consent Calendar",20,0,0,0,20
851557,544619,2016-04-19,Assembly,"Do pass and be re-referred to the Committee on Appropriations",13,0,0,0,13
851557,545301,2016-05-12,Assembly,"AB 2215 MEDINA  Consent Calendar Second Day  Regular Session",78,0,0,2,80
851557,552715,2016-06-14,Senate,"Do pass, but re-refer to the Committee on Appropriations Recommend 	Consent",12,0,1,0,13
851557,559361,2016-08-11,Senate,"Consent Calendar 2nd AB2215 Medina",37,0,2,0,39
851559,537033,2016-04-20,Assembly,"Do pass and be re-referred to the Committee on Appropriations to 	Consent Calendar",7,0,0,0,7
851559,544903,2016-05-11,Assembly,"Do pass, to Consent Calendar",20,0,0,0,20
851559,547226,2016-05-19,Assembly,"AB 2375 BAKER  Consent Calendar Second Day  Regular Session",76,0,0,4,80
851559,555746,2016-06-27,Senate,"Do pass, but re-refer to the Committee on Appropriations",5,0,0,0,5
851559,560898,2016-08-23,Senate,"Assembly 3rd Reading AB2375 P.E., R., and S.S. (Bonta) By Pan",39,0,0,0,39
851559,561662,2016-08-30,Assembly,"AB 2375 P.E., R.& S.S.  Concurrence in Senate Amendments By BONTA",80,0,0,0,80
851560,531843,2016-04-12,Senate,"Do pass, but re-refer to the Committee on Appropriations Recommend 	Consent",12,0,1,0,13
851560,543204,2016-05-05,Senate,"Consent Calendar 2nd SB1240 Hall Urgency Clause",36,0,4,0,40
851560,556916,2016-06-30,Assembly,"Do pass and be re-referred to the Committee on Appropriations",20,0,0,1,21
851560,559046,2016-08-03,Assembly,"Do pass, to Consent Calendar",20,0,0,0,20
851562,536907,2016-04-20,Assembly,"Do pass and be re-referred to the Committee on Appropriations",6,1,0,0,7
851562,549277,2016-05-27,Assembly,"Do pass",14,3,0,3,20
851562,550696,2016-06-01,Assembly,"AB 2363 LOW  Assembly Third Reading",54,23,0,3,80
851563,535640,2016-04-19,Senate,"Be adopted, but re-refer to the Committee on Appropriations 	Recommend Consent",11,0,0,0,11
851563,543099,2016-05-05,Senate,"Consent Calendar 2nd SCR111 Mendoza",36,0,4,0,40
851563,552537,2016-06-13,Assembly,"Be adopted and re-referred to the Committee on Appropriations with 	recommendation:  To Consent Calendar",15,0,0,1,16
851563,556459,2016-06-29,Assembly,"Be adopted, to Consent Calendar",18,0,0,2,20
851563,558630,2016-08-01,Assembly,"SCR 111 Mendoza  Consent Calendar Second Day  Regular Session",76,0,0,4,80
851564,527837,2016-04-04,Assembly,"Do pass and be re-referred to the Committee on Appropriations",16,0,0,0,16
851564,549433,2016-05-27,Assembly,"Do pass",20,0,0,0,20
851564,550267,2016-05-31,Assembly,"AB 2170 FRAZIER  Assembly Third Reading",80,0,0,0,80
851564,554830,2016-06-21,Senate,"Do pass, but re-refer to the Committee on Environmental Quality",10,0,1,0,11
851564,556541,2016-06-29,Senate,"Do pass as amended, and re-refer to the Committee on Appropriations",7,0,0,0,7
851564,559657,2016-08-11,Senate,"Placed on Appropriations Suspense file",7,0,0,0,7
851564,559658,2016-08-11,Senate,"Do pass as amended",7,0,0,0,7
851564,561688,2016-08-31,Senate,"Assembly 3rd Reading AB2170 Frazier By Hueso Motions",21,13,5,0,39
851564,561689,2016-08-31,Assembly,"AB 2170 FRAZIER  Concurrence in Senate Amendments",77,1,0,2,80
851565,532054,2016-04-12,Assembly,"Do pass and be re-referred to the Committee on Appropriations",10,4,0,1,15
851566,525835,2016-03-29,Assembly,"Do pass as amended and be re-referred to the Committee on 	Appropriations",2,4,0,1,7
851567,525739,2016-03-29,Senate,"Do pass as amended, and re-refer to the Committee on Appropriations",9,0,0,0,9
851567,540245,2016-04-28,Senate,"Senate 3rd Reading SB1136 Morrell",37,0,3,0,40
851567,552532,2016-06-13,Assembly,"Do pass as amended and be re-referred to the Committee on 	Appropriations",8,0,0,1,9
851568,539338,2016-04-26,Senate,"Do pass",2,4,1,0,7
851568,539339,2016-04-26,Senate,"Set, first hearing.  Failed passage in Committee.  Reconsideration 	granted",7,0,0,0,7
851569,535634,2016-04-18,Senate,"Do pass, but re-refer to the Committee on Appropriations",9,0,0,0,9
851569,549281,2016-05-27,Senate,"Senate 3rd Reading SB1261 Stone",35,0,5,0,40
851569,556137,2016-06-28,Assembly,"Do pass and be re-referred to the Committee on Appropriations to 	Consent Calendar",16,0,0,0,16
851569,559041,2016-08-03,Assembly,"Do pass, to Consent Calendar",20,0,0,0,20
851569,559306,2016-08-11,Assembly,"SB 1261 Stone  Consent Calendar Second Day  Regular Session",78,0,0,2,80
851570,533106,2016-04-12,Assembly,"Do pass as amended and be re-referred to the Committee on Public 	Safety",7,0,0,0,7
851570,534871,2016-04-19,Assembly,"Do pass and be re-referred to the Committee on Appropriations",7,0,0,0,7
851570,545224,2016-05-12,Assembly,"AB 2380 ALEJO  Assembly Third Reading",78,0,0,2,80
851570,556285,2016-06-28,Senate,"Do pass",7,0,0,0,7
851570,559827,2016-08-15,Senate,"Assembly 3rd Reading AB2380 Alejo By Cannella",38,0,1,0,39
851570,560496,2016-08-22,Assembly,"AB 2380 ALEJO  Concurrence in Senate Amendments",78,0,0,2,80
851571,531534,2016-04-12,Senate,"Do pass as amended, and re-refer to the Committee on Appropriations",12,0,1,0,13
851571,549028,2016-05-27,Senate,"Do pass",7,0,0,0,7
851571,549994,2016-05-31,Senate,"Senate 3rd Reading SB1176 Galgiani",38,0,2,0,40
851571,555526,2016-06-21,Assembly,"Do pass and be re-referred to the Committee on Appropriations",9,0,0,0,9
851571,559354,2016-08-11,Assembly,"Do pass as amended",20,0,0,0,20
851571,560350,2016-08-19,Assembly,"SB 1176 Galgiani  Senate Third Reading  Amendment  Set #1",73,0,0,7,80
851571,560932,2016-08-24,Assembly,"SB 1176 Galgiani  Senate Third Reading  By GARCIA, E",80,0,0,0,80
851571,561414,2016-08-29,Senate,"Unfinished Business SB1176 Galgiani Concurrence",39,0,0,0,39
851573,534926,2016-04-19,Senate,"Do pass, but re-refer to the Committee on Appropriations",5,2,0,0,7
851573,545808,2016-05-16,Senate,"Placed on Appropriations Suspense file",2,4,1,0,7
851573,545809,2016-05-16,Senate,"Do pass as amended",5,2,0,0,7
851573,547021,2016-05-19,Senate,"Senate 3rd Reading SB1235 De Le",24,15,1,0,40
851573,552697,2016-06-14,Assembly,"Do pass and be re-referred to the Committee on Appropriations",5,2,0,0,7
851573,556784,2016-06-30,Assembly,"SB 1235 De Leon  Senate Third Reading  By MCCARTY  Motion to 	Appeal the Decision  of the Chair  By WAGNER",29,50,0,1,80
851573,556785,2016-06-30,Assembly,"SB 1235 De Leon  Senate Third Reading  By MCCARTY",46,30,0,4,80
851573,556786,2016-06-30,Senate,"Unfinished Business (S upplemental File 1)SB1 235 De Le",23,14,3,0,40
851574,525932,2016-03-29,Senate,"Do pass, but re-refer to the Committee on Appropriations Recommend 	Consent",9,0,0,0,9
851574,533469,2016-04-14,Senate,"Consent Calendar 2nd SB1172 Hancock",38,0,2,0,40
851574,552442,2016-06-13,Assembly,"Do pass as amended and be re-referred to the Committee on Local 	Government",9,0,0,0,9
851574,556735,2016-06-29,Assembly,"Do pass and be re-referred to the Committee on Appropriations to 	Consent Calendar",9,0,0,0,9
851574,559000,2016-08-03,Assembly,"Do pass as amended, to Consent Calendar",20,0,0,0,20
851574,559835,2016-08-15,Assembly,"SB 1172 Hancock  Consent Calendar Second Day",78,0,0,2,80
851574,561203,2016-08-25,Senate,"Special Consent SB1172 Hancock",39,0,0,0,39
851575,542596,2016-05-04,Assembly,"Do pass as amended",14,6,0,0,20
851575,544292,2016-04-19,Assembly,"Do pass and be re-referred to the Committee on Appropriations",10,3,0,0,13
851575,545279,2016-05-12,Assembly,"AB 2294 GOMEZ  Assembly Third Reading",51,26,0,3,80
851575,552164,2016-06-08,Senate,"Do pass as amended, and re-refer to the Committee on Appropriations",7,2,0,0,9
851575,558939,2016-08-01,Senate,"Placed on Appropriations Suspense file",7,0,0,0,7
851575,559782,2016-08-11,Senate,"Do pass",5,2,0,0,7
851575,560842,2016-08-23,Senate,"Assembly 3rd Reading AB2294 Gomez By Allen",25,14,0,0,39
851575,561465,2016-08-29,Assembly,"AB 2294 GOMEZ  Concurrence in Senate Amendments",52,27,0,1,80
851577,526781,2016-03-31,Assembly,"Be referred to Committee on Education",8,0,0,3,11
851578,534849,2016-04-18,Assembly,"Do pass as amended and be re-referred to the Committee on 	Appropriations",9,2,0,1,12
851578,549182,2016-05-27,Assembly,"Do pass as amended",15,5,0,0,20
851578,550836,2016-06-02,Assembly,"AB 2251 STONE  Assembly Third Reading",56,24,0,0,80
851578,556291,2016-06-29,Senate,"Do pass as amended, and re-refer to the Committee on Judiciary",5,2,0,0,7
851578,559585,2016-08-11,Senate,"Do pass",5,2,0,0,7
851578,561200,2016-08-25,Senate,"From Committee:  That the measure be returned to the Senate floor 	for consideration",5,2,0,0,7
851578,561392,2016-08-29,Senate,"Assembly 3rd Reading AB2251 Mark Stone By Leno",26,12,1,0,39
851578,561705,2016-08-31,Assembly,"AB 2251 STONE  Concurrence in Senate Amendments",53,24,0,3,80
851579,534887,2016-04-18,Senate,"Do pass, but re-refer to the Committee on Appropriations",6,0,3,0,9
851579,545776,2016-05-16,Senate,"Placed on Appropriations Suspense file",7,0,0,0,7
851579,549092,2016-05-27,Senate,"Do pass as amended",5,0,2,0,7
851580,528807,2016-04-06,Senate,"Do pass as amended, and re-refer to the Committee on Appropriations",7,0,0,0,7
851580,544051,2016-05-09,Senate,"Senate 3rd Reading SB1266 McGuire",36,0,4,0,40
851580,553460,2016-06-15,Assembly,"Do pass and be re-referred to the Committee on Appropriations to 	Consent Calendar",9,0,0,0,9
851580,556618,2016-06-29,Assembly,"Do pass, to Consent Calendar",18,0,0,2,20
851580,559127,2016-08-04,Assembly,"SB 1266 McGuire  Consent Calendar Second Day  Regular Session",77,0,0,3,80
851581,531289,2016-04-12,Assembly,"Do pass and be re-referred to the Committee on Appropriations",2,5,0,0,7
851581,531290,2016-04-12,Assembly,"Reconsideration granted",6,0,0,1,7
851581,537090,2016-04-20,Assembly,"Do pass and be re-referred to the Committee on Appropriations",3,4,0,0,7
851582,538624,2016-04-26,Assembly,"Do pass, to Consent Calendar",10,0,0,0,10
851582,540801,2016-05-02,Assembly,"AB 2296 LOW  Consent Calendar Second Day  Regular Session",76,0,0,4,80
851582,553489,2016-06-14,Senate,"Do pass as amended. To Consent Calendar",7,0,0,0,7
851582,556749,2016-06-30,Senate,"Consent Calendar 2nd AB2296 Low",37,0,3,0,40
851582,559178,2016-08-08,Assembly,"AB 2296 LOW  Concurrence in Senate Amendments",76,0,0,4,80
851584,531443,2016-04-12,Senate,"Do pass, but re-refer to the Committee on Appropriations",6,0,1,0,7
851584,544481,2016-04-25,Senate,"Placed on Appropriations Suspense file",7,0,0,0,7
851586,536941,2016-04-20,Senate,"Do pass, but re-refer to the Committee on Budget and Fiscal Review",2,4,3,0,9
851586,536942,2016-04-20,Senate,"Set, first hearing.  Failed passage in Committee.  Reconsideration 	granted",9,0,0,0,9
851587,528209,2016-04-05,Assembly,"Do pass as amended and be re-referred to the Committee on Privacy 	and Consumer Protection",7,0,0,0,7
851587,535147,2016-04-19,Assembly,"Do pass and be re-referred to the Committee on Appropriations",11,0,0,0,11
851587,539039,2016-04-27,Assembly,"Do pass, to Consent Calendar",19,0,0,1,20
851587,545242,2016-05-12,Assembly,"AB 2387 MULLIN  Assembly Third Reading",78,0,0,2,80
851587,552996,2016-06-14,Senate,"Do pass, but re-refer to the Committee on Judiciary Recommend 	Consent",11,0,0,0,11
851587,556602,2016-06-28,Senate,"Do pass, but re-refer to the Committee on Appropriations Recommend 	Consent",7,0,0,0,7
851587,560595,2016-08-22,Senate,"Assembly 3rd Reading AB2387 Mullin By Hill",39,0,0,0,39
851587,561305,2016-08-25,Assembly,"AB 2387 MULLIN  Concurrence in Senate Amendments",78,0,0,2,80
851588,527464,2016-04-04,Senate,"Do pass, but re-refer to the Committee on Judiciary",7,1,1,0,9
851589,535230,2016-04-19,Assembly,"Do pass and be re-referred to the Committee on Appropriations",4,3,0,0,7
851589,544935,2016-05-11,Assembly,"Do pass",7,13,0,0,20
851590,533155,2016-04-12,Assembly,"Do pass and be re-referred to the Committee on Appropriations",6,0,0,1,7
851590,549383,2016-05-27,Assembly,"Do pass",20,0,0,0,20
851590,550161,2016-05-31,Assembly,"AB 2231 CALDERON  Assembly Third Reading",75,0,0,5,80
851590,556446,2016-06-28,Senate,"Do pass, but re-refer to the Committee on Appropriations",4,0,1,0,5
851590,558860,2016-08-01,Senate,"Placed on Appropriations Suspense file",7,0,0,0,7
851590,559788,2016-08-11,Senate,"Do pass as amended",7,0,0,0,7
851590,560880,2016-08-23,Senate,"Assembly 3rd Reading AB2231 Calderon By McGuire",39,0,0,0,39
851590,561516,2016-08-29,Assembly,"AB 2231 CALDERON  Concurrence in Senate Amendments",79,0,0,1,80
851591,535087,2016-04-18,Senate,"Do pass, but re-refer to the Committee on Appropriations",9,0,0,0,9
851591,549296,2016-05-27,Senate,"Do pass as amended",7,0,0,0,7
851591,550545,2016-06-01,Senate,"Senate 3rd Reading SB1193 Hill",39,0,1,0,40
851591,556061,2016-06-28,Assembly,"Do pass and be re-referred to the Committee on Appropriations",13,0,0,3,16
851591,559410,2016-08-11,Assembly,"Do pass",15,0,0,5,20
851591,560749,2016-08-23,Assembly,"SB 1193 Hill  Senate Third Reading  By SALAS",76,1,0,3,80
851591,561269,2016-08-25,Senate,"Unfinished Business SB1193 Hill Concurrence",37,1,1,0,39
851592,529145,2016-04-06,Assembly,"Do pass and be re-referred to the Committee on Appropriations to 	Consent Calendar",18,0,0,3,21
851592,545094,2016-05-11,Assembly,"Do pass, to Consent Calendar",20,0,0,0,20
851592,547109,2016-05-19,Assembly,"AB 2226 BIGELOW  Consent Calendar Second Day  Regular Session",76,0,0,4,80
851592,560844,2016-08-23,Senate,"Assembly 3rd Reading AB2226 Bigelow By McGuire",38,1,0,0,39
851594,526577,2016-03-30,Senate,"Do pass as amended, but re-refer to the Committee on Appropriations 	Recommend Consent",8,0,1,0,9
851594,534272,2016-04-18,Senate,"Placed on Appropriations Suspense file",7,0,0,0,7
851594,549323,2016-05-27,Senate,"Do pass as amended",7,0,0,0,7
851594,551026,2016-06-02,Senate,"Special Consent # SB1169 McGuire",39,0,1,0,40
851594,555292,2016-06-22,Assembly,"Amend, and do pass as amended and be re-referred to the Committee 	on Appropriations with the recommendation:  To Consent Calendar",7,0,0,0,7
851594,559009,2016-08-03,Assembly,"Do pass, to Consent Calendar",20,0,0,0,20
851594,559349,2016-08-11,Assembly,"SB 1169 McGuire  Consent Calendar Second Day  Regular Session",78,0,0,2,80
851594,560182,2016-08-18,Senate,"Special Consent SB1169 McGuire",36,0,3,0,39
851595,529467,2016-04-07,Assembly,"Be referred to Committee on Revenue and Taxation",9,0,0,2,11
851595,535722,2016-04-18,Assembly,"Do pass and be re-referred to the Committee on Appropriations to 	Consent Calendar",9,0,0,0,9
851597,536898,2016-04-20,Assembly,"Do pass as amended and be re-referred to the Committee on 	Appropriations",9,4,0,0,13
851597,548979,2016-05-27,Assembly,"Do pass as amended",14,6,0,0,20
851597,550956,2016-06-02,Assembly,"AB 2197 GARCIA, C.  Assembly Third Reading",51,27,0,2,80
851597,555117,2016-06-22,Senate,"Do pass, but re-refer to the Committee on Appropriations",4,1,0,0,5
851597,558975,2016-08-01,Senate,"Placed on Appropriations Suspense file",7,0,0,0,7
851597,559754,2016-08-11,Senate,"Do pass",5,2,0,0,7
851597,560488,2016-08-22,Senate,"Assembly 3rd Reading AB2197 Cristina Garcia By Mitchell",25,13,1,0,39
851598,542218,2016-05-03,Senate,"Do pass and be placed on the Consent Calendar",6,0,1,0,7
851598,545221,2016-05-12,Senate,"Consent Calendar 2nd SB1158 Anderson",38,0,2,0,40
851600,532140,2016-04-12,Senate,"Do pass, but re-refer to the Committee on Rules",3,5,5,0,13
851600,532141,2016-04-12,Senate,"Set, first hearing.  Failed passage in Committee.  Reconsideration 	granted",12,0,1,0,13
851601,542756,2016-05-03,Senate,"Do pass and be placed on the Consent Calendar",6,0,1,0,7
851601,545216,2016-05-12,Senate,"Consent Calendar 2nd SB1265 Moorlach",38,0,2,0,40
851601,556095,2016-06-28,Assembly,"Do pass, to Consent Calendar",10,0,0,0,10
851601,558634,2016-08-01,Assembly,"SB 1265 Moorlach  Consent Calendar Second Day  Regular Session",76,0,0,4,80
851603,529393,2016-04-06,Assembly,"Do pass as amended and be re-referred to the Committee on 	Appropriations",7,0,0,0,7
851603,539091,2016-04-27,Assembly,"Do pass, to Consent Calendar",19,0,0,1,20
851603,543243,2016-05-05,Assembly,"AB 2336 OLSEN  Consent Calendar Second Day  Regular Session",79,0,0,1,80
851603,552189,2016-06-08,Senate,"Do pass, but re-refer to the Committee on Appropriations",2,2,5,0,9
851603,552190,2016-06-08,Senate,"Set, first hearing.  Failed passage in Committee.  Reconsideration 	granted",9,0,0,0,9
851603,556569,2016-06-29,Senate,"Do pass, but re-refer to the Committee on Appropriations",9,0,0,0,9
851605,535677,2016-04-19,Assembly,"Do pass and be re-referred to the Committee on Appropriations",19,0,0,0,19
851606,544470,2016-04-19,Assembly,"Do pass and be re-referred to the Committee on Appropriations",12,0,0,1,13
851606,549259,2016-05-27,Assembly,"Do pass",15,1,0,4,20
851606,550728,2016-06-01,Assembly,"AB 2364 HOLDEN  Assembly Third Reading",64,8,0,8,80
851606,556553,2016-06-29,Senate,"Do pass, but re-refer to the Committee on Appropriations",8,0,1,0,9
851606,558878,2016-08-01,Senate,"Placed on Appropriations Suspense file",7,0,0,0,7
851606,559755,2016-08-11,Senate,"Do pass",5,2,0,0,7
851606,560073,2016-08-17,Senate,"Assembly 3rd Reading AB2364 Holden By Leyva",28,8,3,0,39
851607,538459,2016-04-26,Assembly,"Do pass as amended",10,0,0,0,10
851607,543023,2016-05-05,Assembly,"AB 2300 WOOD  Assembly Third Reading",77,0,0,3,80
851607,556337,2016-06-28,Senate,"Do pass",7,0,0,0,7
851608,530541,2016-04-11,Senate,"Do pass, but re-refer to the Committee on Education",8,0,1,0,9
851608,536555,2016-04-20,Senate,"Do pass, but re-refer to the Committee on Appropriations",9,0,0,0,9
851608,549141,2016-05-27,Senate,"Do pass",7,0,0,0,7
851608,550012,2016-05-31,Senate,"Senate 3rd Reading SB1192 Hill",37,0,3,0,40
851608,552687,2016-06-14,Assembly,"Do pass as amended and be re-referred to the Committee on Business 	and Professions",10,0,0,3,13
851608,555977,2016-06-28,Assembly,"Do pass and be re-referred to the Committee on Appropriations",12,2,0,2,16
851608,559281,2016-08-11,Assembly,"Do pass as amended",16,1,0,3,20
851608,560353,2016-08-19,Assembly,"SB 1192 Hill  Senate Third Reading  Amendment  Set #1",73,0,0,7,80
851608,560722,2016-08-23,Assembly,"SB 1192 Hill  Senate Third Reading  By MEDINA",62,9,0,9,80
851608,561173,2016-08-25,Senate,"From committee:  That the Assembly Amendments be concurred in",7,2,0,0,9
851608,561368,2016-08-29,Senate,"Unfinished Business SB1192 Hill Concurrence",28,9,2,0,39
851610,529356,2016-04-06,Assembly,"Do pass as amended and be re-referred to the Committee on 	Appropriations",7,0,0,0,7
851610,549386,2016-05-27,Assembly,"Do pass as amended",20,0,0,0,20
851610,550511,2016-06-01,Assembly,"AB 2290 SANTIAGO  Assembly Third Reading",77,3,0,0,80
851610,553214,2016-06-15,Senate,"Do pass as amended, and re-refer to the Committee on Appropriations",9,0,0,0,9
851610,558870,2016-08-01,Senate,"Placed on Appropriations Suspense file",7,0,0,0,7
851610,559787,2016-08-11,Senate,"Do pass",6,1,0,0,7
851610,560795,2016-08-23,Senate,"Assembly 3rd Reading AB2290 Santiago By Hancock",38,0,1,0,39
851610,561668,2016-08-30,Assembly,"AB 2290 SANTIAGO  Concurrence in Senate Amendments",78,1,0,1,80
851611,534120,2016-04-18,Senate,"Do pass, but re-refer to the Committee on Judiciary",9,0,0,0,9
851611,545968,2016-05-16,Senate,"Placed on Appropriations Suspense file",7,0,0,0,7
851611,549326,2016-05-27,Senate,"Do pass as amended",7,0,0,0,7
851611,551066,2016-06-02,Senate,"Senate 3rd Reading SB1177 Galgiani",39,0,1,0,40
851611,554722,2016-06-21,Assembly,"Do pass as amended and be re-referred to the Committee on 	Appropriations",13,0,0,3,16
851611,559397,2016-08-11,Assembly,"Do pass",20,0,0,0,20
851611,560682,2016-08-23,Assembly,"SB 1177 Galgiani  Senate Third Reading  By GOMEZ",78,0,0,2,80
851611,561270,2016-08-25,Senate,"From committee:  That the Assembly Amendments be concurred in",7,0,2,0,9
851611,561447,2016-08-29,Senate,"Unfinished Business SB1177 Galgiani Concurrence",39,0,0,0,39
851612,534828,2016-04-19,Assembly,"Do pass as amended and be re-referred to the Committee on 	Appropriations",10,3,0,6,19
851613,528197,2016-04-05,Senate,"Do pass, but re-refer to the Committee on Appropriations",6,0,1,0,7
851613,544456,2016-04-25,Senate,"Placed on Appropriations Suspense file",7,0,0,0,7
851614,531209,2016-04-12,Assembly,"Do pass and be re-referred to the Committee on Local Government",6,3,0,2,11
851614,536177,2016-04-20,Assembly,"Do pass as amended and be re-referred to the Committee on 	Appropriations",8,0,0,1,9
851614,544873,2016-05-11,Assembly,"Do pass",19,0,0,1,20
851614,547007,2016-05-19,Assembly,"AB 2320 CALDERON  Assembly Third Reading",76,0,0,4,80
851614,554655,2016-06-21,Senate,"Do pass, but re-refer to the Committee on Appropriations",7,0,0,0,7
851614,558708,2016-08-01,Senate,"Placed on Appropriations Suspense file",7,0,0,0,7
851614,559583,2016-08-11,Senate,"Do pass as amended",7,0,0,0,7
851614,560114,2016-08-18,Senate,"Assembly 3rd Reading AB2320 Calderon By Hancock",38,0,1,0,39
851614,560947,2016-08-24,Assembly,"AB 2320 CALDERON  Concurrence in Senate Amendments",80,0,0,0,80
851615,537029,2016-04-20,Assembly,"Do pass and be re-referred to the Committee on Appropriations",6,1,0,0,7
851615,549430,2016-05-27,Assembly,"Do pass",14,3,0,3,20
851615,550528,2016-06-01,Assembly,"AB 2310 SANTIAGO  Assembly Third Reading",54,23,0,3,80
851617,531842,2016-04-12,Assembly,"Do pass as amended and be re-referred to the Committee on Health",14,0,0,2,16
851617,535265,2016-04-19,Assembly,"Do pass as amended and be re-referred to the Committee on 	Appropriations",18,0,0,1,19
851618,536904,2016-04-20,Assembly,"Do pass and be re-referred to the Committee on Appropriations to 	Consent Calendar",21,0,0,0,21
851618,542506,2016-05-04,Assembly,"Do pass, to Consent Calendar",20,0,0,0,20
851618,545474,2016-05-12,Assembly,"AB 2287 WILK  Consent Calendar Second Day  Regular Session",78,0,0,2,80
851619,528981,2016-04-06,Assembly,"Do pass and be re-referred to the Committee on Natural Resources to 	Consent Calendar",15,0,0,0,15
851619,535171,2016-04-18,Assembly,"Do pass and be re-referred to the Committee on Appropriations to 	Consent Calendar",9,0,0,0,9
851619,549121,2016-05-27,Assembly,"Do pass as amended",20,0,0,0,20
851619,550432,2016-06-01,Assembly,"AB 2206 WILLIAMS  Assembly Third Reading",78,0,0,2,80
851619,554734,2016-06-21,Senate,"Do pass as amended, and re-refer to the Committee on Environmental 	Quality",6,1,4,0,11
851620,532228,2016-04-11,Assembly,"Do pass and be re-referred to the Committee on Judiciary",4,9,0,3,16
851620,532229,2016-04-11,Assembly,"Reconsideration granted",16,0,0,0,16
851620,534125,2016-04-18,Assembly,"Do pass and be re-referred to the Committee on Judiciary",15,0,0,1,16
851620,537393,2016-04-21,Assembly,"Amend, and do pass as amended and be re-referred to the Committee 	on Appropriations with the recommendation:  To Consent Calendar",10,0,0,0,10
851621,527835,2016-04-04,Assembly,"Do pass",16,0,0,0,16
851621,530518,2016-04-11,Assembly,"AB 2374 CHIU  Assembly Third Reading",77,0,0,2,79
851621,554917,2016-06-21,Senate,"Do pass and be placed on the Consent Calendar",11,0,0,0,11
851621,560580,2016-08-22,Senate,"Assembly 3rd Reading AB2374 Chiu By Beall",39,0,0,0,39
851621,561290,2016-08-25,Assembly,"AB 2374 CHIU  Concurrence in Senate Amendments",78,0,0,2,80
851622,533024,2016-04-13,Assembly,"Do pass and be re-referred to the Committee on Local Government",5,2,0,0,7
851622,542959,2016-05-04,Assembly,"Do pass",8,0,0,1,9
851622,549117,2016-05-27,Assembly,"AB 2220 COOPER  Assembly Third Reading",60,11,0,9,80
851622,556555,2016-06-29,Senate,"Do pass",7,0,0,0,7
851622,559908,2016-08-15,Senate,"Assembly 3rd Reading AB2220 Cooper By Cannella",33,4,2,0,39
851623,535652,2016-04-19,Senate,"Do pass, but re-refer to the Committee on Appropriations",5,0,0,0,5
851623,545888,2016-05-16,Senate,"Do pass",7,0,0,0,7
851623,549394,2016-05-27,Senate,"Senate 3rd Reading SB1270 Galgiani",36,0,4,0,40
851623,556552,2016-06-29,Assembly,"Do pass and be re-referred to the Committee on Appropriations to 	Consent Calendar",9,0,0,1,10
851623,559072,2016-08-03,Assembly,"Do pass, to Consent Calendar",20,0,0,0,20
851623,560882,2016-08-23,Assembly,"SB 1270 Galgiani  Senate Third Reading  By DODD",76,4,0,0,80
851624,536919,2016-04-20,Assembly,"Do pass and be re-referred to the Committee on Appropriations",20,0,0,1,21
851624,542623,2016-05-04,Assembly,"Do pass, to Consent Calendar",20,0,0,0,20
851624,545402,2016-05-12,Assembly,"AB 2384 GALLAGHER  Consent Calendar Second Day  Regular Session",78,0,0,2,80
851624,552760,2016-06-14,Senate,"Do pass, but re-refer to the Committee on Appropriations",12,0,1,0,13
851624,559819,2016-08-15,Senate,"Assembly 3rd Reading AB2384 Gallagher By Fuller",38,0,1,0,39
851624,560537,2016-08-22,Assembly,"AB 2384 GALLAGHER  Concurrence in Senate Amendments",79,0,0,1,80
851625,525917,2016-03-29,Senate,"Do pass, but re-refer to the Committee on Appropriations Recommend 	Consent",9,0,0,0,9
851625,533135,2016-04-14,Senate,"Consent Calendar 2nd SB1133 Wolk",38,0,2,0,40
851625,552440,2016-06-13,Assembly,"Do pass as amended and be re-referred to the Committee on 	Appropriations",9,0,0,0,9
851625,556420,2016-06-29,Assembly,"Do pass, to Consent Calendar",18,0,0,2,20
851625,559120,2016-08-04,Assembly,"SB 1133 Wolk  Consent Calendar Second Day  Regular Session",77,0,0,3,80
851625,559509,2016-08-11,Senate,"Special Consent SB1133 Wolk Concurrence",37,0,2,0,39
851626,525617,2016-03-29,Assembly,"Do pass",3,4,0,0,7
851626,531202,2016-04-12,Assembly,"Reconsideration granted",7,0,0,0,7
851626,537107,2016-04-20,Assembly,"Do pass",2,5,0,0,7
851627,532292,2016-04-13,Assembly,"Do pass and be re-referred to the Committee on Local Government",7,0,0,0,7
851627,536294,2016-04-20,Assembly,"Do pass and be re-referred to the Committee on Appropriations",8,0,0,1,9
851627,544831,2016-05-11,Assembly,"Do pass",19,1,0,0,20
851627,550927,2016-06-02,Assembly,"AB 2208 SANTIAGO  Assembly Third Reading",78,0,0,2,80
851627,554685,2016-06-21,Senate,"Do pass as amended, and re-refer to the Committee on Appropriations",11,0,0,0,11
851627,558772,2016-08-01,Senate,"Placed on Appropriations Suspense file",7,0,0,0,7
851627,559542,2016-08-11,Senate,"Do pass as amended",7,0,0,0,7
851627,560154,2016-08-18,Senate,"Assembly 3rd Reading AB2208 Santiago By McGuire",38,0,1,0,39
851627,560941,2016-08-24,Assembly,"AB 2208 SANTIAGO  Concurrence in Senate Amendments",80,0,0,0,80
851628,542705,2016-05-04,Assembly,"Do pass, to Consent Calendar",20,0,0,0,20
851628,544595,2016-04-19,Assembly,"Do pass and be re-referred to the Committee on Appropriations",13,0,0,0,13
851628,545204,2016-05-12,Assembly,"AB 2317 MULLIN  Consent Calendar Second Day  Regular Session",78,0,0,2,80
851628,552053,2016-06-08,Senate,"Do pass, but re-refer to the Committee on Appropriations",9,0,0,0,9
851628,555587,2016-06-27,Senate,"Do pass as amended",6,0,1,0,7
851628,559898,2016-08-15,Senate,"Assembly 3rd Reading AB2317 Mullin By Leyva",38,0,1,0,39
851628,560699,2016-08-23,Assembly,"AB 2317 MULLIN  Concurrence in Senate Amendments",79,0,0,1,80
851629,530449,2016-04-11,Assembly,"Be referred to Committee on Local Government",9,0,0,2,11
851629,536190,2016-04-20,Assembly,"Do pass and be re-referred to the Committee on Appropriations",9,0,0,0,9
851629,546594,2016-05-18,Assembly,"Do pass, to Consent Calendar",20,0,0,0,20
851629,549076,2016-05-27,Assembly,"AB 2180 TING  Consent Calendar Second Day  Regular Session",67,0,0,13,80
851629,554961,2016-06-22,Senate,"Do pass, but re-refer to the Committee on Appropriations",5,0,2,0,7
851629,558727,2016-08-01,Senate,"Placed on Appropriations Suspense file",7,0,0,0,7
851629,559559,2016-08-11,Senate,"Do pass as amended",5,0,2,0,7
851629,560948,2016-08-24,Senate,"Assembly 3rd Reading AB2180 Ting By Hernandez",33,1,5,0,39
851629,561608,2016-08-30,Assembly,"AB 2180 TING  Concurrence in Senate Amendments",80,0,0,0,80
851630,532197,2016-04-13,Senate,"Do pass, but re-refer to the Committee on Appropriations",4,1,0,0,5
851630,544324,2016-04-25,Senate,"Placed on Appropriations Suspense file",7,0,0,0,7
851630,549151,2016-05-27,Senate,"Do pass",5,2,0,0,7
851630,550027,2016-05-31,Senate,"Senate 3rd Reading SB1160 Mendoza",26,12,2,0,40
851630,555023,2016-06-22,Assembly,"Do pass and be re-referred to the Committee on Appropriations",8,4,0,1,13
851630,559301,2016-08-11,Assembly,"Do pass",14,5,0,1,20
851630,561320,2016-08-25,Assembly,"Do pass as amended",12,0,0,1,13
851630,561598,2016-08-30,Assembly,"SB 1160 Mendoza  Senate Third Reading  By DALY",80,0,0,0,80
851630,561699,2016-08-31,Senate,"From committee:  That the Assembly Amendments be concurred in",5,0,0,0,5
851630,561700,2016-08-31,Senate,"Unfinished Business SB1160 Mendoza Concurrence",35,3,1,0,39
851631,527968,2016-04-04,Assembly,"Do pass as amended and be re-referred to the Committee on 	Agriculture",8,1,0,0,9
851631,532351,2016-04-13,Assembly,"Do pass and be re-referred to the Committee on Appropriations",10,0,0,0,10
851631,549003,2016-05-27,Assembly,"Do pass as amended",20,0,0,0,20
851631,550832,2016-06-02,Assembly,"AB 2223 GRAY  Assembly Third Reading",76,0,0,4,80
851632,531934,2016-04-12,Assembly,"Do pass as amended and be re-referred to the Committee on 	Appropriations",19,0,0,0,19
851632,549063,2016-05-27,Assembly,"Do pass as amended",20,0,0,0,20
851632,550619,2016-06-01,Assembly,"AB 2216 BONTA  Assembly Third Reading",77,1,0,2,80
851632,555372,2016-06-22,Senate,"Do pass, but re-refer to the Committee on Appropriations",9,0,0,0,9
851632,558900,2016-08-01,Senate,"Placed on Appropriations Suspense file",7,0,0,0,7
851634,529059,2016-04-06,Assembly,"Do pass and be re-referred to the Committee on Appropriations",8,0,0,1,9
851635,535420,2016-04-19,Senate,"Do pass, but re-refer to the Committee on Appropriations",7,0,0,0,7
851635,549069,2016-05-27,Senate,"Do pass as amended",6,1,0,0,7
851635,550870,2016-06-02,Senate,"Senate 3rd Reading SB1143 Leno",36,0,4,0,40
851635,556009,2016-06-28,Assembly,"Do pass and be re-referred to the Committee on Appropriations to 	Consent Calendar",7,0,0,0,7
851635,559338,2016-08-11,Assembly,"Do pass as amended",20,0,0,0,20
851635,560218,2016-08-18,Assembly,"SB 1143 Leno  Senate Third Reading  By GALLAGHER",77,0,0,3,80
851635,561164,2016-08-25,Senate,"Special Consent SB1143 Leno",39,0,0,0,39
851637,542582,2016-05-04,Assembly,"Do pass",6,0,0,1,7
851637,545225,2016-05-12,Assembly,"AB 2316 O'DONNELL  Assembly Third Reading",66,4,0,10,80
851637,556323,2016-06-29,Senate,"Do pass as amended",9,0,0,0,9
851637,560769,2016-08-23,Senate,"Assembly 3rd Reading AB2316 O'Donnell By Leyva",30,8,1,0,39
851637,561421,2016-08-29,Assembly,"AB 2316 O'DONNELL  Concurrence in Senate Amendments",70,5,0,5,80
851638,531215,2016-04-12,Assembly,"Do pass and be re-referred to the Committee on Appropriations",16,0,0,0,16
851638,549103,2016-05-27,Assembly,"Do pass",20,0,0,0,20
851638,549966,2016-05-31,Assembly,"AB 2330 RIDLEY-THOMAS  Assembly Third Reading",80,0,0,0,80
851638,554721,2016-06-20,Senate,"Do pass, but re-refer to the Committee on Appropriations Recommend 	Consent",9,0,0,0,9
851638,558745,2016-08-01,Senate,"Do pass",7,0,0,0,7
851638,560764,2016-08-23,Senate,"Assembly 3rd Reading AB2330 Ridley-Thomas By Mendoza",39,0,0,0,39
851638,561397,2016-08-29,Assembly,"AB 2330 RIDLEY-THOMAS  Concurrence in Senate Amendments",80,0,0,0,80
851639,528329,2016-04-05,Assembly,"Do pass",6,0,0,1,7
851639,529455,2016-04-07,Assembly,"AB 2295 BAKER  Assembly Third Reading",76,0,0,3,79
851639,544618,2016-05-10,Senate,"Do pass",7,0,0,0,7
851639,551390,2016-06-06,Senate,"Assembly 3rd Reading AB2295 Baker By Glazer",32,0,8,0,40
851639,552333,2016-06-09,Assembly,"AB 2295 BAKER  Concurrence in Senate Amendments",74,0,0,6,80
851640,531203,2016-04-12,Assembly,"Amend, and do pass as amended and be re-referred to the Committee 	on Appropriations with the recommendation:  To Consent Calendar",7,0,0,0,7
851640,538965,2016-04-27,Assembly,MOTIONDCX304**,19,0,0,1,20
851640,549359,2016-05-27,Assembly,"Do pass",20,0,0,0,20
851640,550123,2016-05-31,Assembly,"AB 2177 MAIENSCHEIN  Assembly Third Reading",80,0,0,0,80
851640,556603,2016-06-28,Senate,"Do pass as amended, but re-refer to the Committee on Appropriations 	Recommend Consent",7,0,0,0,7
851640,559446,2016-08-11,Senate,"Consent Calendar 2nd AB2177 Maienschein",37,0,2,0,39
851640,559883,2016-08-15,Assembly,"AB 2177 MAIENSCHEIN  Concurrence in Senate Amendments",78,0,0,2,80
851641,536498,2016-04-20,Senate,"Do pass, but re-refer to the Committee on Appropriations",2,7,0,0,9
851642,533447,2016-04-13,Assembly,"Do pass as amended and be re-referred to the Committee on 	Appropriations",7,0,0,0,7
851643,532701,2016-04-13,Senate,"Do pass, but re-refer to the Committee on Appropriations",8,1,0,0,9
851643,543785,2016-05-09,Senate,"Senate 3rd Reading SB1214 Allen",27,9,4,0,40
851643,554720,2016-06-21,Assembly,"Do pass as amended and be re-referred to the Committee on 	Appropriations",11,0,0,2,13
851643,559003,2016-08-03,Assembly,"Do pass",17,3,0,0,20
851643,561201,2016-08-25,Assembly,"SB 1214 Allen  Senate Third Reading  By CHIU",66,12,0,2,80
851643,561390,2016-08-29,Senate,"Unfinished Business SB1214 Allen Concurrence",30,7,2,0,39
851645,527630,2016-04-04,Senate,"Do pass, but re-refer to the Committee on Appropriations",9,0,0,0,9
851645,534582,2016-04-18,Senate,"Placed on Appropriations Suspense file",7,0,0,0,7
851646,529351,2016-04-06,Assembly,"Do pass and be re-referred to the Committee on Appropriations to 	Consent Calendar",7,0,0,0,7
851647,531384,2016-04-12,Assembly,"Amend, and do pass as amended and be re-referred to the Committee 	on Appropriations with the recommendation:  To Consent Calendar",16,0,0,0,16
851647,539166,2016-04-27,Assembly,"Do pass, to Consent Calendar",19,0,0,1,20
851647,543127,2016-05-05,Assembly,"AB 2194 SALAS  Consent Calendar Second Day  Regular Session",79,0,0,1,80
851647,555596,2016-06-27,Senate,"Do pass as amended, and re-refer to the Committee on Appropriations",8,0,1,0,9
851647,559659,2016-08-11,Senate,"Do pass as amended",7,0,0,0,7
851647,561178,2016-08-25,Senate,"Assembly 3rd Reading AB2194 Salas By Hill",39,0,0,0,39
851647,561776,2016-08-31,Assembly,"AB 2194 SALAS  Concurrence in Senate Amendments",77,1,0,2,80
851648,528399,2016-04-04,Assembly,"Do pass as amended",9,0,0,0,9
851648,533297,2016-04-14,Assembly,"AB 2291 ACHADJIAN  Assembly Third Reading",74,0,0,6,80
851648,553233,2016-06-15,Senate,"Do pass",6,1,0,0,7
851648,558698,2016-08-01,Senate,"Assembly 3rd Reading AB2291 Achadjian By Moorlach",35,1,3,0,39
851648,559126,2016-08-04,Assembly,"AB 2291 ACHADJIAN  Concurrence in Senate Amendments",74,1,0,5,80
851649,531035,2016-04-11,Assembly,"Do pass and be re-referred to the Committee on Appropriations",9,0,0,0,9
851649,544943,2016-05-11,Assembly,"Do pass as amended",20,0,0,0,20
851649,547098,2016-05-19,Assembly,"AB 2371 FRAZIER  Assembly Third Reading",75,0,0,5,80
851649,556632,2016-06-29,Senate,"Do pass, but re-refer to the Committee on Appropriations",6,0,1,0,7
851649,558909,2016-08-01,Senate,"Do pass",7,0,0,0,7
851649,560894,2016-08-23,Senate,"Assembly 3rd Reading AB2371 Frazier By Beall",38,0,1,0,39
851649,561404,2016-08-29,Assembly,"AB 2371 FRAZIER  Concurrence in Senate Amendments",79,0,0,1,80
851653,537384,2016-04-20,Senate,"Do pass as amended, and re-refer to the Committee on Appropriations",6,2,1,0,9
851653,547563,2016-05-23,Senate,"Placed on Appropriations Suspense file",7,0,0,0,7
851653,548949,2016-05-27,Senate,"Do pass",5,2,0,0,7
851653,550817,2016-06-02,Senate,"Senate 3rd Reading SB1189 Pan",24,14,2,0,40
851653,556011,2016-06-28,Assembly,"Do pass and be re-referred to the Committee on Appropriations",7,0,0,0,7
851653,559551,2016-08-10,Assembly,"Do pass",19,0,0,1,20
851653,560383,2016-08-19,Assembly,"SB 1189 Pan  Senate Third Reading  Amendment  Set #1",73,0,0,7,80
851653,560672,2016-08-23,Assembly,"SB 1189 Pan  Senate Third Reading  By IRWIN",79,0,0,1,80
851653,560972,2016-08-24,Senate,"Unfinished Business SB1189 Pan Concurrence",38,1,0,0,39
851654,531564,2016-04-12,Assembly,"Do pass as amended and be re-referred to the Committee on 	Appropriations",6,1,0,0,7
851655,529368,2016-04-06,Senate,"Do pass, but re-refer to the Committee on Appropriations",8,1,0,0,9
851655,544280,2016-04-25,Senate,"Placed on Appropriations Suspense file",7,0,0,0,7
851655,549170,2016-05-27,Senate,"Do pass as amended",5,2,0,0,7
851655,550856,2016-06-02,Senate,"Senate 3rd Reading SB1135 Monning",29,10,1,0,40
851655,556391,2016-06-28,Assembly,"Do pass as amended and be re-referred to the Committee on 	Appropriations",13,4,0,1,18
851655,558998,2016-08-03,Assembly,"Do pass",15,5,0,0,20
851655,560137,2016-08-18,Assembly,"SB 1135 Monning  Senate Third Reading  By SANTIAGO",58,19,0,3,80
851655,560930,2016-08-24,Senate,"Unfinished Business SB1135 Monning Concurrence",28,11,0,0,39
851657,537690,2016-04-20,Assembly,"Do pass and be re-referred to the Committee on Appropriations",5,1,0,1,7
851657,542809,2016-05-04,Assembly,"Do pass",15,5,0,0,20
851657,547267,2016-05-19,Assembly,"AB 2272 THURMOND  Assembly Third Reading",49,23,0,8,80
851657,555067,2016-06-22,Senate,"Do pass, but re-refer to the Committee on Appropriations",4,1,0,0,5
851657,558825,2016-08-01,Senate,"Placed on Appropriations Suspense file",7,0,0,0,7
851657,559696,2016-08-11,Senate,"Do pass as amended",5,2,0,0,7
851657,561074,2016-08-24,Senate,"Assembly 3rd Reading AB2272 Thurmond By Leno",25,13,1,0,39
851657,561633,2016-08-30,Assembly,"AB 2272 THURMOND  Concurrence in Senate Amendments",52,26,0,2,80
851659,530728,2016-04-11,Assembly,"Do pass and be re-referred to the Committee on Appropriations",6,3,0,0,9
851660,525895,2016-03-29,Senate,"Do pass and be placed on the Consent Calendar",7,0,0,0,7
851660,529415,2016-04-07,Senate,"Consent Calendar 2nd SB1171 Committee On JUD. (Jackson)",38,0,2,0,40
851660,552046,2016-06-08,Assembly,"Do pass, to Consent Calendar",9,0,0,1,10
851660,553662,2016-06-16,Assembly,"SB 1171 JUD.  Consent Calendar Second Day  Regular Session",78,0,0,2,80
851660,556783,2016-06-30,Senate,"Special Consent # SB1171 Committee On JUD. (Jackson)",37,0,3,0,40
851661,525697,2016-03-29,Assembly,"Do pass and be re-referred to the Committee on Appropriations to 	Consent Calendar",18,0,0,1,19
851661,549426,2016-05-27,Assembly,"Do pass",20,0,0,0,20
851661,550249,2016-05-31,Assembly,"AB 2279 COOLEY  Assembly Third Reading",80,0,0,0,80
851661,555324,2016-06-22,Senate,"Do pass, but re-refer to the Committee on Appropriations Recommend 	Consent",9,0,0,0,9
851661,558885,2016-08-01,Senate,"Placed on Appropriations Suspense file",7,0,0,0,7
851661,559773,2016-08-11,Senate,"Do pass as amended",7,0,0,0,7
851661,560079,2016-08-17,Senate,"Assembly 3rd Reading AB2279 Cooley By Hertzberg",39,0,0,0,39
851661,560888,2016-08-23,Assembly,"AB 2279 COOLEY  Concurrence in Senate Amendments",79,1,0,0,80
851662,529365,2016-04-06,Assembly,"Do pass as amended and be re-referred to the Committee on 	Appropriations",7,0,0,0,7
851662,548998,2016-05-27,Assembly,"Do pass as amended",20,0,0,0,20
851662,550425,2016-06-01,Assembly,"AB 2350 O'DONNELL  Assembly Third Reading",78,0,0,2,80
851662,555030,2016-06-22,Senate,"Do pass as amended, and re-refer to the Committee on Appropriations",9,0,0,0,9
851662,558770,2016-08-01,Senate,"Do pass",7,0,0,0,7
851662,560638,2016-08-23,Senate,"Assembly 3rd Reading AB2350 O'Donnell By Lara",39,0,0,0,39
851663,530957,2016-04-11,Assembly,"Do pass and be re-referred to the Committee on Appropriations",9,0,0,0,9
851663,536349,2016-04-20,Assembly,"Do pass, to Consent Calendar",16,0,0,4,20
851663,539914,2016-04-28,Assembly,"AB 2201 BROUGH  Consent Calendar Second Day  Regular Session",76,0,0,4,80
851663,552128,2016-06-08,Senate,"Do pass, but re-refer to the Committee on Appropriations",7,0,0,0,7
851663,560014,2016-08-16,Senate,"Assembly 3rd Reading AB2201 Brough By Berryhill",39,0,0,0,39
851665,526566,2016-03-30,Assembly,"Do pass as amended and be re-referred to the Committee on Local 	Government",5,2,0,0,7
851665,542419,2016-05-04,Assembly,"Do pass as amended",8,0,0,1,9
851665,545193,2016-05-12,Assembly,"AB 2389 RIDLEY-THOMAS  Assembly Third Reading",59,16,0,5,80
851665,552142,2016-06-08,Senate,"Do pass, but re-refer to the Committee on Governance and Finance",5,0,0,0,5
851665,556556,2016-06-29,Senate,"Do pass",6,0,1,0,7
851665,559943,2016-08-16,Senate,"Assembly 3rd Reading AB2389 Ridley-Thomas By Allen",34,5,0,0,39
851667,527864,2016-04-04,Assembly,"Do pass and be re-referred to the Committee on Appropriations to 	Consent Calendar",16,0,0,0,16
851667,536530,2016-04-20,Assembly,"Do pass, to Consent Calendar",16,0,0,4,20
851667,539607,2016-04-28,Assembly,"AB 2289 FRAZIER  Consent Calendar Second Day  Regular Session",76,0,0,4,80
851667,552922,2016-06-14,Senate,"Do pass, but re-refer to the Committee on Appropriations Recommend 	Consent",11,0,0,0,11
851667,556766,2016-06-30,Senate,"Consent Calendar 2nd AB2289 Frazier",37,0,3,0,40
851672,539337,2016-04-27,Senate,"Do pass as amended, and re-refer to the Committee on Appropriations",7,0,0,0,7
851672,545969,2016-05-16,Senate,"Placed on Appropriations Suspense file",7,0,0,0,7
851673,531252,2016-04-12,Assembly,"Do pass as amended and be re-referred to the Committee on Rules",12,1,0,2,15
851674,542840,2016-05-04,Assembly,"Do pass, to Consent Calendar",7,0,0,0,7
851674,545287,2016-05-12,Assembly,"AB 2376 BONILLA  Consent Calendar Second Day  Regular Session",78,0,0,2,80
851674,555564,2016-06-27,Senate,"Do pass and be placed on the Consent Calendar",5,0,0,0,5
851674,556859,2016-06-30,Senate,"Consent Calendar 2nd AB2376 Committee on Public Em ployees, 	Retirement, a",37,0,3,0,40
851674,558673,2016-08-01,Assembly,"AB 2376 P.E., R.& S.S.  Concurrence in Senate Amendments By BONTA",76,0,0,4,80
851675,539463,2016-04-27,Senate,"Do pass as amended, and re-refer to the Committee on Appropriations",6,0,1,0,7
851675,546120,2016-05-16,Senate,"Placed on Appropriations Suspense file",7,0,0,0,7
851677,531303,2016-04-12,Assembly,"Do pass and be re-referred to the Committee on Appropriations",5,2,0,0,7
851677,549108,2016-05-27,Assembly,"Do pass as amended",13,7,0,0,20
851677,550917,2016-06-02,Assembly,"AB 2298 WEBER  Assembly Third Reading",42,34,0,4,80
851677,554832,2016-06-21,Senate,"Do pass, but re-refer to the Committee on Appropriations",5,2,0,0,7
851677,558928,2016-08-01,Senate,"Placed on Appropriations Suspense file",7,0,0,0,7
851677,559756,2016-08-11,Senate,"Do pass as amended",5,2,0,0,7
851677,560800,2016-08-23,Senate,"Assembly 3rd Reading AB2298 Weber By Mitchell",24,9,6,0,39
851677,561488,2016-08-29,Assembly,"AB 2298 WEBER  Concurrence in Senate Amendments",42,29,0,9,80
851678,530690,2016-04-11,Senate,"Do pass as amended, and re-refer to the Committee on Appropriations",3,0,2,0,5
851678,544671,2016-04-25,Senate,"Placed on Appropriations Suspense file",7,0,0,0,7
851678,549317,2016-05-27,Senate,"Do pass",5,0,2,0,7
851678,549964,2016-05-31,Senate,"Senate 3rd Reading SB1203 Hertzberg",29,4,7,0,40
851678,555126,2016-06-22,Assembly,"Do pass and be re-referred to the Committee on Appropriations",6,0,0,1,7
851678,559480,2016-08-11,Assembly,"Do pass",18,1,0,1,20
851678,560336,2016-08-18,Assembly,"SB 1203 Hertzberg  Senate Third Reading  By BONTA",74,1,0,5,80
851679,526311,2016-03-30,Assembly,"Do pass and be re-referred to the Committee on Judiciary to Consent 	Calendar",7,0,0,0,7
851679,531700,2016-04-12,Assembly,"Do pass and be re-referred to the Committee on Appropriations to 	Consent Calendar",10,0,0,0,10
851679,549374,2016-05-27,Assembly,"Do pass",20,0,0,0,20
851679,550155,2016-05-31,Assembly,"AB 2318 LOW  Assembly Third Reading",80,0,0,0,80
851679,554642,2016-06-21,Senate,"Do pass, but re-refer to the Committee on Appropriations",5,0,0,0,5
851679,558884,2016-08-01,Senate,"Placed on Appropriations Suspense file",7,0,0,0,7
851679,559751,2016-08-11,Senate,"Do pass as amended",7,0,0,0,7
851679,561475,2016-08-29,Senate,"Assembly 3rd Reading AB2318 Low By Hill",39,0,0,0,39
851679,561821,2016-08-31,Assembly,"AB 2318 LOW  Concurrence in Senate Amendments",79,0,0,1,80
851680,525841,2016-03-29,Assembly,"Do pass and be re-referred to the Committee on Appropriations",7,0,0,0,7
851680,549465,2016-05-27,Assembly,"Do pass",20,0,0,0,20
851680,550142,2016-05-31,Assembly,"AB 2327 COOLEY  Assembly Third Reading",80,0,0,0,80
851680,556566,2016-06-28,Senate,"Do pass, but re-refer to the Committee on Appropriations",7,0,0,0,7
851680,558926,2016-08-01,Senate,"Placed on Appropriations Suspense file",7,0,0,0,7
851682,525534,2016-03-29,Assembly,"Do pass and be re-referred to the Committee on Transportation",6,0,0,1,7
851682,534138,2016-04-18,Assembly,"Do pass as amended and be re-referred to the Committee on 	Appropriations",15,0,0,1,16
851683,544468,2016-04-19,Assembly,"Do pass and be re-referred to the Committee on Appropriations",9,4,0,0,13
851683,549346,2016-05-27,Assembly,"Do pass as amended",14,6,0,0,20
851683,551134,2016-06-02,Assembly,"AB 2183 GATTO  Assembly Third Reading",50,28,0,2,80
851683,555138,2016-06-22,Senate,"Do pass, but re-refer to the Committee on Appropriations",3,2,4,0,9
851684,533169,2016-04-13,Assembly,"Do pass as amended and be re-referred to the Committee on 	Appropriations",10,4,0,1,15
851685,529337,2016-04-06,Assembly,"Do pass and be re-referred to the Committee on Judiciary",7,0,0,0,7
851685,535679,2016-04-19,Assembly,"Do pass as amended and be re-referred to the Committee on 	Appropriations",10,0,0,0,10
851685,542456,2016-05-04,Assembly,"Do pass",20,0,0,0,20
851685,547207,2016-05-19,Assembly,"AB 2337 BURKE  Assembly Third Reading",73,0,0,7,80
851685,552021,2016-06-08,Senate,"Do pass, but re-refer to the Committee on Judiciary",3,0,2,0,5
851685,555057,2016-06-21,Senate,"Do pass, but re-refer to the Committee on Appropriations",7,0,0,0,7
851685,559813,2016-08-15,Senate,"Assembly 3rd Reading AB2337 Burke By Jackson",38,0,1,0,39
851685,560534,2016-08-22,Assembly,"AB 2337 BURKE  Concurrence in Senate Amendments",78,0,0,2,80
851686,542394,2016-05-04,Assembly,"Do pass, to Consent Calendar",7,0,0,0,7
851686,545199,2016-05-12,Assembly,"AB 2212 HARPER  Consent Calendar Second Day  Regular Session",78,0,0,2,80
851686,552020,2016-06-08,Senate,"Do pass",9,0,0,0,9
851686,560133,2016-08-18,Senate,"Assembly 3rd Reading AB2212 Harper By Vidak",38,0,1,0,39
851686,560915,2016-08-24,Assembly,"AB 2212 HARPER  Concurrence in Senate Amendments",79,0,0,1,80
851687,528637,2016-04-05,Assembly,"Do pass as amended and be re-referred to the Committee on 	Accountability and Administrative Review",9,0,0,0,9
851687,549118,2016-05-27,Assembly,"Do pass as amended",20,0,0,0,20
851687,550867,2016-06-02,Assembly,"AB 2270 BONTA  Assembly Third Reading",78,0,0,2,80
851687,555510,2016-06-27,Senate,"Do pass, but re-refer to the Committee on Appropriations",8,1,0,0,9
851687,558751,2016-08-01,Senate,"Placed on Appropriations Suspense file",7,0,0,0,7
851688,534939,2016-04-19,Assembly,"Do pass and be re-referred to the Committee on Local Government",13,1,0,2,16
851688,536315,2016-04-20,Assembly,"Do pass and be re-referred to the Committee on Appropriations",7,1,0,1,9
851688,544865,2016-05-11,Assembly,"Do pass as amended",15,2,0,3,20
851688,547002,2016-05-19,Assembly,"AB 2385 JONES-SAWYER  Assembly Third Reading",55,16,0,9,80
851688,554644,2016-06-20,Senate,"Do pass as amended, and re-refer to the Committee on Appropriations",7,1,1,0,9
851688,558776,2016-08-01,Senate,"Placed on Appropriations Suspense file",7,0,0,0,7
851688,559563,2016-08-11,Senate,"Do pass as amended",5,2,0,0,7
851688,560673,2016-08-23,Senate,"Assembly 3rd Reading AB2385 Jones-Sawyer By Allen",30,9,0,0,39
851688,561427,2016-08-29,Assembly,"AB 2385 JONES-SAWYER  Concurrence in Senate Amendments",60,14,0,6,80
851689,526588,2016-03-30,Assembly,"Do pass and be re-referred to the Committee on Appropriations",5,1,0,1,7
851689,532340,2016-04-13,Assembly,"Do pass",16,0,0,4,20
851689,544022,2016-05-09,Assembly,"AB 2250 RIDLEY-THOMAS  Third Reading Urgency  Amend By HARPER  Set 	#1  Motion to  Lay on the Table  By CALDERON",51,26,0,3,80
851689,544023,2016-05-09,Assembly,"AB 2250 RIDLEY-THOMAS  Third Reading Urgency",51,0,0,29,80
851690,536439,2016-04-20,Assembly,"Do pass as amended and be re-referred to the Committee on 	Appropriations",8,0,0,1,9
851690,546619,2016-05-18,Assembly,"Do pass",20,0,0,0,20
851690,547558,2016-05-23,Assembly,"AB 2257 MAIENSCHEIN  Assembly Third Reading",77,0,0,3,80
851690,556334,2016-06-29,Senate,"Do pass, but re-refer to the Committee on Appropriations",7,0,0,0,7
851690,559815,2016-08-15,Senate,"Assembly 3rd Reading AB2257 Maienschein By Hill",38,0,1,0,39
851690,560478,2016-08-22,Assembly,"AB 2257 MAIENSCHEIN  Concurrence in Senate Amendments",79,0,0,1,80
851692,531403,2016-04-12,Senate,"Do pass, but re-refer to the Committee on Appropriations",5,1,1,0,7
851692,549330,2016-05-27,Senate,"Do pass as amended",6,1,0,0,7
851692,550400,2016-06-01,Senate,"Senate 3rd Reading SB1157 Mitchell",32,6,2,0,40
851692,554672,2016-06-21,Assembly,"Do pass",7,0,0,0,7
851692,560929,2016-08-24,Assembly,"SB 1157 Mitchell  Senate Third Reading  By WEBER",48,20,0,12,80
851692,561407,2016-08-29,Senate,"Unfinished Business SB1157 Mitchell Concurrence",29,6,4,0,39
851693,525925,2016-03-29,Assembly,"Do pass, to Consent Calendar",10,0,0,0,10
851693,527769,2016-04-04,Assembly,"AB 2211 LINDER  Consent Calendar Second Day",78,0,0,1,79
851693,553483,2016-06-14,Senate,"Do pass and be placed on the Consent Calendar",7,0,0,0,7
851693,556852,2016-06-30,Senate,"Consent Calendar 2nd AB2211 Linder",37,0,3,0,40
851694,526332,2016-03-30,Assembly,"Do pass and be re-referred to the Committee on Appropriations to 	Consent Calendar",9,0,0,1,10
851694,549247,2016-05-27,Assembly,"Do pass as amended",19,0,0,1,20
851694,551035,2016-06-02,Assembly,"AB 2324 EGGMAN  Assembly Third Reading",79,0,0,1,80
851694,554750,2016-06-21,Senate,"Do pass, but re-refer to the Committee on Appropriations",4,0,1,0,5
851694,558922,2016-08-01,Senate,"Placed on Appropriations Suspense file",7,0,0,0,7
851694,559750,2016-08-11,Senate,"Do pass as amended",7,0,0,0,7
851694,560090,2016-08-17,Senate,"Assembly 3rd Reading AB2324 Eggman By Wolk",39,0,0,0,39
851694,560885,2016-08-23,Assembly,"AB 2324 EGGMAN  Concurrence in Senate Amendments",80,0,0,0,80
851697,542640,2016-05-04,Assembly,"Do pass",5,2,0,0,7
851697,547089,2016-05-19,Assembly,"AB 2393 CAMPOS  Assembly Third Reading",53,22,0,5,80
851697,553215,2016-06-15,Senate,"Do pass",8,1,0,0,9
851697,560493,2016-08-22,Senate,"Assembly 3rd Reading AB2393 Campos By Liu",28,10,1,0,39
851697,561202,2016-08-25,Assembly,"AB 2393 CAMPOS  Concurrence in Senate Amendments",57,22,0,1,80
851699,544658,2016-05-09,Assembly,"Do pass as amended and be re-referred to the Committee on 	Appropriations",9,0,0,0,9
851699,549005,2016-05-27,Assembly,"Do pass",20,0,0,0,20
851699,549942,2016-05-31,Assembly,"AB 2392 NAZARIAN  Assembly Third Reading",79,0,0,1,80
851700,532217,2016-04-13,Senate,"Do pass as amended, and re-refer to the Committee on Appropriations",5,0,0,0,5
851700,543772,2016-05-09,Senate,"Senate 3rd Reading SB1175 Mendoza",36,0,4,0,40
851700,555000,2016-06-22,Assembly,"Do pass and be re-referred to the Committee on Appropriations to 	Consent Calendar",13,0,0,0,13
851700,556414,2016-06-29,Assembly,"Do pass, to Consent Calendar",18,0,0,2,20
851700,559103,2016-08-04,Assembly,"SB 1175 Mendoza  Consent Calendar Second Day  Regular Session",77,0,0,3,80
851700,559283,2016-08-11,Senate,"Special Consent SB1175 Mendoza Concurrence",37,0,2,0,39
851701,542871,2016-05-04,Assembly,"Do pass, to Consent Calendar",13,0,0,0,13
851701,545378,2016-05-12,Assembly,"AB 2354 CALDERON  Consent Calendar Second Day  Regular Session",78,0,0,2,80
851701,555058,2016-06-22,Senate,"Do pass, but re-refer to the Committee on Judiciary",9,0,0,0,9
851701,559982,2016-08-16,Senate,"Assembly 3rd Reading AB2354 Calderon By Roth",38,0,1,0,39
851701,560807,2016-08-23,Assembly,"AB 2354 CALDERON  Concurrence in Senate Amendments",79,0,0,1,80
851702,526567,2016-03-30,Senate,"Do pass as amended, and re-refer to the Committee on Environmental 	Quality",7,0,0,0,7
851702,536927,2016-04-20,Senate,"Do pass, but re-refer to the Committee on Appropriations",7,0,0,0,7
851702,547593,2016-05-23,Senate,"Placed on Appropriations Suspense file",7,0,0,0,7
851702,549059,2016-05-27,Senate,"Do pass as amended",7,0,0,0,7
851702,550433,2016-06-01,Senate,"Senate 3rd Reading SB1170 Wieckowski",36,1,3,0,40
851702,556774,2016-06-29,Assembly,"Do pass and be re-referred to the Committee on Appropriations",6,2,0,1,9
851703,532471,2016-04-11,Assembly,"Do pass and be re-referred to the Committee on Appropriations",16,0,0,0,16
851703,549274,2016-05-27,Assembly,"Do pass as amended",18,2,0,0,20
851703,551105,2016-06-02,Assembly,"AB 2222 HOLDEN  Assembly Third Reading",72,7,0,1,80
851703,554829,2016-06-21,Senate,"Do pass, but re-refer to the Committee on Environmental Quality",7,0,4,0,11
851703,556247,2016-06-29,Senate,"Do pass as amended, and re-refer to the Committee on Appropriations",6,0,1,0,7
851704,530556,2016-04-11,Senate,"Do pass, but re-refer to the Committee on Appropriations",8,0,1,0,9
851704,539572,2016-04-28,Senate,"Senate 3rd Reading SB1209 Morrell",37,0,3,0,40
851704,552918,2016-06-14,Assembly,"Do pass and be re-referred to the Committee on Appropriations to 	Consent Calendar",16,0,0,0,16
851704,556633,2016-06-29,Assembly,"Do pass, to Consent Calendar",18,0,0,2,20
851704,559162,2016-08-04,Assembly,"SB 1209 Morrell  Consent Calendar Second Day  Regular Session",77,0,0,3,80
851707,527940,2016-04-05,Assembly,"Do pass and be re-referred to the Committee on Local Government",6,1,0,0,7
851707,532281,2016-04-13,Assembly,"Do pass and be re-referred to the Committee on Appropriations",8,1,0,0,9
851707,538976,2016-04-27,Assembly,"Do pass",18,1,0,1,20
851707,545176,2016-05-12,Assembly,"AB 2228 COOLEY  Assembly Third Reading",68,10,0,2,80
851707,552680,2016-06-14,Senate,"Do pass, but re-refer to the Committee on Appropriations",6,1,0,0,7
851707,559807,2016-08-15,Senate,"Assembly 3rd Reading AB2228 Cooley By Glazer",31,6,2,0,39
851708,535638,2016-04-19,Senate,"Do pass, but re-refer to the Committee on Appropriations",10,0,1,0,11
851708,545830,2016-05-16,Senate,"Placed on Appropriations Suspense file",7,0,0,0,7
851709,532910,2016-04-12,Assembly,"Do pass and be re-referred to the Committee on Education",10,2,0,1,13
851709,537544,2016-04-20,Assembly,"Do pass as amended and be re-referred to the Committee on 	Appropriations",6,0,0,1,7
851709,549270,2016-05-27,Assembly,"Do pass as amended",14,6,0,0,20
851709,551054,2016-06-02,Assembly,"AB 2308 HERNANDEZ  Assembly Third Reading",56,24,0,0,80
851709,555052,2016-06-22,Senate,"Do pass as amended, and re-refer to the Committee on Appropriations",8,0,1,0,9
851709,558819,2016-08-01,Senate,"Placed on Appropriations Suspense file",7,0,0,0,7
851709,559568,2016-08-11,Senate,"Do pass",5,2,0,0,7
851709,560028,2016-08-17,Senate,"Assembly 3rd Reading AB2308 Roger Hern",28,9,2,0,39
851709,560671,2016-08-23,Assembly,"AB 2308 HERNANDEZ  Concurrence in Senate Amendments",55,24,0,1,80
851711,530507,2016-04-11,Senate,"Do pass, but re-refer to the Committee on Appropriations",7,0,2,0,9
851711,539614,2016-04-28,Senate,"Senate 3rd Reading SB1165 Cannella",37,0,3,0,40
851711,552919,2016-06-14,Assembly,"Do pass as amended and be re-referred to the Committee on 	Appropriations",16,0,0,0,16
851711,556412,2016-06-29,Assembly,"Do pass, to Consent Calendar",18,0,0,2,20
851711,559150,2016-08-04,Assembly,"SB 1165 Cannella  Consent Calendar Second Day  Regular Session",77,0,0,3,80
851711,559484,2016-08-11,Senate,"Special Consent SB1165 Cannella Concurrence",37,0,2,0,39
851712,531555,2016-04-12,Assembly,"Do pass and be re-referred to the Committee on Appropriations",14,0,0,1,15
851712,549271,2016-05-27,Assembly,"Do pass",20,0,0,0,20
851712,550076,2016-05-31,Assembly,"AB 2357 DAHLE  Assembly Third Reading",78,0,0,2,80
851713,527766,2016-04-04,Senate,"Do pass, but re-refer to the Committee on Appropriations",8,0,1,0,9
851713,544721,2016-04-25,Senate,"Placed on Appropriations Suspense file",7,0,0,0,7
851713,549140,2016-05-27,Senate,"Do pass",7,0,0,0,7
851713,549973,2016-05-31,Senate,"Senate 3rd Reading SB1132 Galgiani",39,0,1,0,40
851713,554835,2016-06-21,Assembly,"Do pass and be re-referred to the Committee on Appropriations",15,0,0,1,16
851713,560536,2016-08-22,Assembly,"SB 1132 Galgiani  Senate Third Reading  By SALAS",79,0,0,1,80
851713,561644,2016-08-30,Senate,"Unfinished Business (S upplemental File 2)SB1 132 Gal giani Con",39,0,0,0,39
851714,539313,2016-04-27,Senate,"Do pass as amended, and re-refer to the Committee on Appropriations",6,0,1,0,7
851714,546009,2016-05-16,Senate,"Placed on Appropriations Suspense file",7,0,0,0,7
851714,549218,2016-05-27,Senate,"Do pass",7,0,0,0,7
851714,550024,2016-05-31,Senate,"Senate 3rd Reading SB1216 Hueso",39,0,1,0,40
851714,554843,2016-06-20,Assembly,"Do pass as amended and be re-referred to the Committee on 	Appropriations",9,0,0,0,9
851714,559420,2016-08-11,Assembly,"Do pass",14,0,0,6,20
851714,560427,2016-08-19,Assembly,"SB 1216 Hueso  Senate Third Reading  Amendment  Set #1",73,0,0,7,80
851717,531404,2016-04-12,Senate,"Do pass, but re-refer to the Committee on Appropriations",6,3,0,0,9
851717,547592,2016-05-23,Senate,"Senate 3rd Reading SB1190 Jackson",23,12,5,0,40
851717,559294,2016-08-11,Assembly,"Do pass as amended",11,4,0,5,20
851717,559894,2016-06-27,Assembly,"Do pass and be re-referred to the Committee on Appropriations",6,3,0,0,9
851717,560372,2016-08-19,Assembly,"SB 1190 Jackson  Senate Third Reading  By A.,E.,S.,T.,& I.M. 	Amendment  Set #1",73,0,0,7,80
851717,561418,2016-08-29,Assembly,"Do pass as amended",11,7,0,2,20
851717,561728,2016-08-31,Assembly,"SB 1190 Jackson  Senate Third Reading  By O'DONNELL",15,48,0,17,80
851718,552016,2016-06-08,Senate,"Do pass as amended, and re-refer to the Committee on Appropriations",5,1,1,0,7
851718,558700,2016-08-01,Senate,"Placed on Appropriations Suspense file",7,0,0,0,7
851719,539345,2016-04-26,Senate,"Do pass, but re-refer to the Committee on Appropriations",5,1,1,0,7
851719,545368,2016-05-12,Senate,"Senate 3rd Reading SB1241 Wieckowski",25,13,2,0,40
851719,554711,2016-06-21,Assembly,"Do pass and be re-referred to the Committee on Appropriations",7,3,0,0,10
851719,556339,2016-06-29,Assembly,"Do pass",12,6,0,2,20
851719,560385,2016-08-19,Assembly,"SB 1241 Wieckowski  Senate Third Reading  Amendment  Set #1",73,0,0,7,80
851719,561147,2016-08-25,Assembly,"Do pass as amended",8,1,0,1,10
851719,561741,2016-08-31,Assembly,"SB 1241 Wieckowski  Senate Third Reading  By ALEJO",54,21,0,5,80
851719,561742,2016-08-31,Senate,"W/O REF. TO FILE SB1241 Wieckowski",24,13,2,0,39
851720,527615,2016-04-04,Senate,"Do pass, but re-refer to the Committee on Veterans Affairs",9,0,0,0,9
851720,532466,2016-04-12,Senate,"Do pass, but re-refer to the Committee on Appropriations",5,0,0,0,5
851720,544359,2016-04-25,Senate,"Placed on Appropriations Suspense file",7,0,0,0,7
851720,549090,2016-05-27,Senate,"Do pass as amended",7,0,0,0,7
851720,550889,2016-06-02,Senate,"Special Consent # SB1155 Morrell",39,0,1,0,40
851720,554658,2016-06-21,Assembly,"Do pass as amended and be re-referred to the Committee on Veterans 	Affairs",15,0,0,1,16
851720,556349,2016-06-28,Assembly,"Do pass and be re-referred to the Committee on Appropriations",7,0,0,2,9
851722,535215,2016-04-19,Assembly,"Do pass as amended and be re-referred to the Committee on 	Appropriations",17,0,0,2,19
851723,525885,2016-03-29,Senate,"Do pass as amended, and re-refer to the Committee on Environmental 	Quality",9,0,2,0,11
851723,528826,2016-04-06,Senate,"Do pass, but re-refer to the Committee on Appropriations",6,0,1,0,7
851725,526590,2016-03-30,Senate,"Do pass, but re-refer to the Committee on Human Services Recommend 	Consent",8,0,1,0,9
851725,532399,2016-04-12,Senate,"Do pass as amended, but re-refer to the Committee on Appropriations 	Recommend Consent",5,0,0,0,5
851727,536368,2016-04-20,Assembly,"Do pass and be re-referred to the Committee on Banking and Finance",4,2,0,1,7
851727,537346,2016-04-21,Assembly,"Do pass as amended and be re-referred to the Committee on 	Appropriations",7,4,0,1,12
851727,549378,2016-05-27,Assembly,"Do pass as amended",14,6,0,0,20
851727,551031,2016-06-02,Assembly,"AB 2282 CALDERON  Assembly Third Reading",52,24,0,4,80
851727,559473,2016-08-11,Senate,"Do pass, but re-refer to the Committee on Appropriations",6,1,2,0,9
851727,559602,2016-08-11,Senate,"Do pass as amended",5,2,0,0,7
851728,525749,2016-03-29,Senate,"Do pass, but re-refer to the Committee on Judiciary",4,0,1,0,5
851728,525750,2016-03-29,Senate,"Do pass, but re-refer to the Committee on Judiciary",4,0,1,0,5
851728,531416,2016-04-12,Senate,"Do pass as amended, and re-refer to the Committee on Appropriations",6,0,1,0,7
851728,549257,2016-05-27,Senate,"Do pass as amended",7,0,0,0,7
851728,550952,2016-06-02,Senate,"Special Consent # SB1232 Leno",39,0,1,0,40
851728,556127,2016-06-28,Assembly,"Amend, and do pass as amended and be re-referred to the Committee 	on Appropriations with the recommendation:  To Consent Calendar",7,0,0,0,7
851728,559063,2016-08-03,Assembly,"Do pass, to Consent Calendar",20,0,0,0,20
851728,559428,2016-08-11,Assembly,"SB 1232 Leno  Consent Calendar Second Day  Regular Session",78,0,0,2,80
851728,560193,2016-08-18,Senate,"Special Consent SB1232 Leno",36,0,3,0,39
851730,528320,2016-04-05,Assembly,"Do pass and be re-referred to the Committee on Appropriations",13,1,0,2,16
851730,536355,2016-04-20,Assembly,"Do pass",11,0,0,9,20
851730,539719,2016-04-28,Assembly,"AB 2286 MULLIN  Assembly Third Reading",56,15,0,9,80
851731,539036,2016-04-26,Senate,"Do pass as amended",6,1,0,0,7
851731,543811,2016-05-09,Senate,"Senate 3rd Reading SB1257 Block",26,9,5,0,40
851731,555999,2016-06-28,Assembly,"Do pass as amended",6,3,0,1,10
851731,559131,2016-08-04,Assembly,"SB 1257 Block  Senate Third Reading  By TING",42,31,0,7,80
851731,559922,2016-08-15,Senate,"Unfinished Business SB1257 Block Concurrence",26,12,1,0,39
851733,533256,2016-04-13,Senate,"Do pass as amended",8,0,1,0,9
851733,537608,2016-04-21,Senate,"Senate 3rd Reading SB1273 Moorlach",38,0,2,0,40
851733,556256,2016-06-28,Assembly,"Do pass as amended",18,0,0,0,18
851734,526458,2016-03-29,Assembly,"Do pass as amended and be re-referred to the Committee on 	Appropriations",6,0,0,1,7
851734,547016,2016-05-18,Assembly,"Do pass",20,0,0,0,20
851734,547564,2016-05-23,Assembly,"AB 2346 BAKER  Assembly Third Reading",76,0,0,4,80
851734,556649,2016-06-28,Senate,"Do pass as amended, and re-refer to the Committee on Appropriations",5,0,0,0,5
851734,560542,2016-08-22,Senate,"Assembly 3rd Reading AB2346 Baker By McGuire",38,0,1,0,39
851734,561243,2016-08-25,Assembly,"AB 2346 BAKER  Concurrence in Senate Amendments",78,0,0,2,80
851735,529026,2016-04-06,Assembly,"Do pass",17,0,0,4,21
851735,533272,2016-04-14,Assembly,"AB 2218 BURKE  Assembly Third Reading",75,0,0,5,80
851735,560202,2016-08-18,Senate,"From Committee:  That the measure be returned to the Senate floor 	for consideration",11,0,2,0,13
851735,561277,2016-08-25,Senate,"Assembly 3rd Reading AB2218 Burke By Hall",37,0,2,0,39
851735,561643,2016-08-30,Assembly,"Senate amendments be concurred in",16,0,0,5,21
851735,561760,2016-08-31,Assembly,"AB 2218 BURKE  Concurrence in Senate Amendments",71,7,0,2,80
851737,529121,2016-04-06,Senate,"Do pass, but re-refer to the Committee on Appropriations",4,2,1,0,7
851737,543819,2016-05-09,Senate,"Senate 3rd Reading SB1263 Wieckowski",21,13,6,0,40
851737,552766,2016-06-14,Assembly,"Do pass and be re-referred to the Committee on Water, Parks and 	Wildlife",5,0,0,2,7
851737,556070,2016-06-28,Assembly,"Do pass as amended and be re-referred to the Committee on 	Appropriations",10,4,0,1,15
851737,559035,2016-08-03,Assembly,"Do pass",14,6,0,0,20
851737,560122,2016-08-18,Assembly,"SB 1263 Wieckowski  Senate Third Reading  By GARCIA, E",39,30,0,11,80
851737,560352,2016-08-19,Assembly,"SB 1263 Wieckowski  Motion to Reconsider  By GARCIA, E",50,21,0,9,80
851737,561169,2016-08-25,Assembly,"SB 1263 Wieckowski  Senate Third Reading  By GARCIA, E",43,30,0,7,80
851737,561372,2016-08-29,Senate,"Unfinished Business SB1263 Wieckowski Concurrence",24,14,1,0,39
851738,531344,2016-04-12,Assembly,"Do pass and be re-referred to the Committee on Appropriations to 	Consent Calendar",16,0,0,0,16
851738,549453,2016-05-27,Assembly,"Do pass",20,0,0,0,20
851738,550167,2016-05-31,Assembly,"AB 2193 SALAS  Assembly Third Reading",80,0,0,0,80
851738,555704,2016-06-27,Senate,"Do pass, but re-refer to the Committee on Appropriations",9,0,0,0,9
851738,558775,2016-08-01,Senate,"Placed on Appropriations Suspense file",7,0,0,0,7
851738,559772,2016-08-11,Senate,"Do pass as amended",7,0,0,0,7
851738,560441,2016-08-19,Senate,"Assembly 3rd Reading AB2193 Salas By Hill",36,0,3,0,39
851738,560963,2016-08-24,Assembly,"AB 2193 SALAS  Concurrence in Senate Amendments",80,0,0,0,80
851739,534865,2016-04-18,Senate,"Do pass, but re-refer to the Committee on Appropriations",2,3,4,0,9
851739,534866,2016-04-18,Senate,"Set, first hearing.  Failed passage in Committee.  Reconsideration 	granted",9,0,0,0,9
851740,535042,2016-04-18,Senate,"Do pass, but re-refer to the Committee on Appropriations",9,0,0,0,9
851740,545229,2016-05-12,Senate,"Senate 3rd Reading SB1196 Hill",38,0,2,0,40
851740,556099,2016-06-28,Assembly,"Do pass and be re-referred to the Committee on Appropriations to 	Consent Calendar",16,0,0,0,16
851740,559031,2016-08-03,Assembly,"Do pass, to Consent Calendar",20,0,0,0,20
851740,561064,2016-08-24,Assembly,"Do pass",16,0,0,0,16
851740,561547,2016-08-30,Assembly,"SB 1196 Hill  Senate Third Reading  By BONILLA",79,0,0,1,80
851740,561808,2016-08-31,Senate,"Unfinished Business SB1196 Hill Concurrence",37,0,2,0,39
851741,532352,2016-04-13,Senate,"Do pass as amended, and re-refer to the Committee on Appropriations",9,0,0,0,9
851741,545777,2016-05-16,Senate,"Placed on Appropriations Suspense file",7,0,0,0,7
851741,549035,2016-05-27,Senate,"Do pass as amended",7,0,0,0,7
851741,550857,2016-06-02,Senate,"Senate 3rd Reading SB1156 Huff",39,0,1,0,40
851741,555235,2016-06-22,Assembly,"Do pass as amended and be re-referred to the Committee on 	Appropriations",7,0,0,0,7
851741,559251,2016-08-11,Assembly,"Do pass",20,0,0,0,20
851741,561355,2016-08-29,Assembly,"SB 1156 Huff  Senate Third Reading  By OLSEN",79,0,0,1,80
851742,528106,2016-04-05,Assembly,"Do pass as amended and be re-referred to the Committee on 	Appropriations",16,0,0,0,16
851742,549454,2016-05-27,Assembly,"Do pass as amended",20,0,0,0,20
851742,550643,2016-06-01,Assembly,"AB 2331 DABABNEH  Assembly Third Reading",79,0,0,1,80
851742,555724,2016-06-27,Senate,"Do pass, but re-refer to the Committee on Appropriations Recommend 	Consent",9,0,0,0,9
851742,558974,2016-08-01,Senate,"Do pass",7,0,0,0,7
851742,560658,2016-08-23,Senate,"Assembly 3rd Reading AB2331 Dababneh By Block",39,0,0,0,39
851742,561476,2016-08-29,Assembly,"AB 2331 DABABNEH  Concurrence in Senate Amendments",80,0,0,0,80
851743,535232,2016-04-19,Senate,"Do pass as amended, and re-refer to the Committee on Appropriations",11,0,0,0,11
851743,545822,2016-05-16,Senate,"Placed on Appropriations Suspense file",7,0,0,0,7
851743,549067,2016-05-27,Senate,"Do pass as amended",7,0,0,0,7
851743,550881,2016-06-02,Senate,"Special Consent # SB1222 Hertzberg",39,0,1,0,40
851743,556816,2016-06-29,Assembly,"Do pass and be re-referred to the Committee on Appropriations to 	Consent Calendar",15,0,0,0,15
851743,558988,2016-08-03,Assembly,"Do pass, to Consent Calendar",20,0,0,0,20
851743,560387,2016-08-19,Assembly,"SB 1222 Hertzberg  Senate Third Reading  Amendment  Set #1",73,0,0,7,80
851743,561575,2016-08-30,Assembly,"Do pass as amended, to Consent Calendar",14,0,0,1,15
851743,561681,2016-08-31,Assembly,"SB 1222 Hertzberg  Senate Third Reading  By GARCIA, C",79,0,0,1,80
851743,561682,2016-08-31,Senate,"W/O REF. TO FILE SB1222 Hertzberg Motions",39,0,0,0,39
851744,535620,2016-04-19,Assembly,"Do pass and be re-referred to the Committee on Appropriations to 	Consent Calendar",16,0,0,3,19
851744,539360,2016-04-27,Assembly,"Do pass, to Consent Calendar",19,0,0,1,20
851744,543075,2016-05-05,Assembly,"AB 2325 BONILLA  Consent Calendar Second Day  Regular Session",79,0,0,1,80
851744,552085,2016-06-08,Senate,"Do pass, but re-refer to the Committee on Appropriations Recommend 	Consent",7,0,2,0,9
851744,560055,2016-08-17,Senate,"Assembly 3rd Reading AB2325 Bonilla By Gaines",39,0,0,0,39
851744,560780,2016-08-23,Assembly,"AB 2325 BONILLA  Concurrence in Senate Amendments",78,0,0,2,80
851746,527963,2016-04-05,Senate,"Do pass, but re-refer to the Committee on Appropriations",7,0,0,0,7
851746,534126,2016-04-18,Senate,"Placed on Appropriations Suspense file",7,0,0,0,7
851746,548990,2016-05-27,Senate,"Do pass as amended",6,1,0,0,7
851746,550480,2016-06-01,Senate,"Senate 3rd Reading SB1134 Leno",39,0,1,0,40
851746,556005,2016-06-28,Assembly,"Do pass and be re-referred to the Committee on Appropriations",7,0,0,0,7
851746,559314,2016-08-11,Assembly,"Do pass",20,0,0,0,20
851746,560160,2016-08-18,Assembly,"SB 1134 Leno  Senate Third Reading  By LACKEY",78,0,0,2,80
851746,561216,2016-08-25,Senate,"Special Consent SB1134 Leno",39,0,0,0,39
851747,525918,2016-03-29,Assembly,"Do pass and be re-referred to the Committee on Appropriations",6,1,0,0,7
851748,532245,2016-04-12,Senate,"Do pass, but re-refer to the Committee on Governance and Finance",5,0,0,0,5
851748,539167,2016-04-27,Senate,"Do pass as amended, and re-refer to the Committee on Appropriations",7,0,0,0,7
851748,545792,2016-05-16,Senate,"Placed on Appropriations Suspense file",7,0,0,0,7
851749,537032,2016-04-20,Assembly,"Do pass and be re-referred to the Committee on Appropriations",6,1,0,0,7
851749,549087,2016-05-27,Assembly,"Do pass",14,3,0,3,20
851749,550626,2016-06-01,Assembly,"AB 2225 LOW  Assembly Third Reading",54,22,0,4,80
851750,537037,2016-04-20,Assembly,"Do pass and be re-referred to the Committee on Appropriations",6,1,0,0,7
851750,549194,2016-05-27,Assembly,"Do pass",14,3,0,3,20
851750,550507,2016-06-01,Assembly,"AB 2377 P.E., R.& S.S.  Assembly Third Reading  Motion to  Suspend 	the Rules  By JONES",30,47,0,3,80
851750,550508,2016-06-01,Assembly,"AB 2377 P.E., R.& S.S.  Assembly Third Reading  By BONTA",52,25,0,3,80
851751,539304,2016-04-27,Senate,"Do pass as amended",5,1,1,0,7
851751,548676,2016-05-26,Senate,"Senate 3rd Reading SB1233 McGuire",35,2,3,0,40
851751,557029,2016-06-29,Assembly,"Do pass as amended",9,0,0,0,9
851752,537336,2016-04-20,Assembly,"Amend, and do pass as amended and be re-referred to the Committee 	on Appropriations with the recommendation:  To Consent Calendar",7,0,0,0,7
851752,549459,2016-05-27,Assembly,"Do pass",20,0,0,0,20
851752,550078,2016-05-31,Assembly,"AB 2353 MCCARTY  Assembly Third Reading",78,0,0,2,80
851752,553224,2016-06-15,Senate,"Do pass as amended, and re-refer to the Committee on Appropriations",9,0,0,0,9
851752,558868,2016-08-01,Senate,"Placed on Appropriations Suspense file",7,0,0,0,7
851752,559784,2016-08-11,Senate,"Do pass as amended",7,0,0,0,7
851752,560445,2016-08-19,Senate,"Assembly 3rd Reading AB2353 McCarty By Mendoza",36,0,3,0,39
851752,561072,2016-08-24,Assembly,"AB 2353 MCCARTY  Concurrence in Senate Amendments",80,0,0,0,80
851753,529024,2016-04-06,Assembly,"Do pass and be re-referred to the Committee on Appropriations",17,0,0,4,21
851753,536685,2016-04-20,Assembly,"Do pass, to Consent Calendar",16,0,0,4,20
851753,539967,2016-04-28,Assembly,"AB 2172 JONES  Consent Calendar Second Day  Regular Session",76,0,0,4,80
851753,560274,2016-08-18,Senate,"Assembly 3rd Reading AB2172 Jones By Hall",36,0,3,0,39
851753,561069,2016-08-24,Assembly,"AB 2172 JONES  Concurrence in Senate Amendments",80,0,0,0,80
851755,525654,2016-03-29,Assembly,"Do pass as amended and be re-referred to the Committee on 	Appropriations",18,0,0,1,19
851755,532625,2016-04-13,Assembly,"Do pass, to Consent Calendar",20,0,0,0,20
851755,543120,2016-05-05,Assembly,"AB 2341 LACKEY  Assembly Third Reading",76,1,0,3,80
851755,556706,2016-06-28,Senate,"Do pass, but re-refer to the Committee on Appropriations",6,1,0,0,7
851755,558910,2016-08-01,Senate,"Placed on Appropriations Suspense file",7,0,0,0,7
851757,531965,2016-04-12,Assembly,"Do pass and be re-referred to the Committee on Appropriations",19,0,0,0,19
851757,549449,2016-05-27,Assembly,"Do pass",20,0,0,0,20
851757,549960,2016-05-31,Assembly,"AB 2394 GARCIA, E.  Assembly Third Reading",78,0,0,2,80
851757,555283,2016-06-22,Senate,"Do pass, but re-refer to the Committee on Appropriations",8,0,1,0,9
851757,558972,2016-08-01,Senate,"Placed on Appropriations Suspense file",7,0,0,0,7
851757,559727,2016-08-11,Senate,"Do pass as amended",7,0,0,0,7
851757,560281,2016-08-18,Senate,"Assembly 3rd Reading AB2394 Eduardo Garcia By Nguyen",38,0,1,0,39
851757,561071,2016-08-24,Assembly,"AB 2394 GARCIA, E.  Concurrence in Senate Amendments",77,1,0,2,80
851758,528372,2016-04-04,Assembly,"Do pass as amended and be re-referred to the Committee on 	Accountability and Administrative Review",6,1,0,2,9
851758,532729,2016-04-13,Assembly,"Do pass and be re-referred to the Committee on Appropriations",8,0,0,1,9
851759,526473,2016-03-29,Assembly,"Do pass and be re-referred to the Committee on Appropriations",8,0,0,1,9
851759,532690,2016-04-13,Assembly,"Do pass, to Consent Calendar",20,0,0,0,20
851759,537197,2016-04-21,Assembly,"AB 2273 IRWIN  Consent Calendar Second Day  Regular Session",79,0,0,1,80
851759,552669,2016-06-14,Senate,"Do pass, but re-refer to the Committee on Appropriations",5,0,0,0,5
851759,560039,2016-08-17,Senate,"Assembly 3rd Reading AB2273 Irwin By Nielsen",38,0,1,0,39
851760,525570,2016-03-29,Assembly,"Do pass as amended and be re-referred to the Committee on 	Appropriations",13,2,0,4,19
851761,537158,2016-04-20,Assembly,"Do pass and be re-referred to the Committee on Appropriations",5,2,0,0,7
851761,546542,2016-05-18,Assembly,"Do pass",14,6,0,0,20
851761,550439,2016-06-01,Assembly,"AB 2261 HERNANDEZ  Assembly Third Reading",49,31,0,0,80
851761,554977,2016-06-22,Senate,"Do pass, but re-refer to the Committee on Judiciary",4,1,0,0,5
851761,556377,2016-06-28,Senate,"Do pass, but re-refer to the Committee on Appropriations",5,2,0,0,7
851763,528080,2016-04-05,Assembly,"Do pass and be re-referred to the Committee on Appropriations",17,0,0,2,19
851763,548978,2016-05-27,Assembly,"Do pass as amended",15,1,0,4,20
851763,551164,2016-06-02,Assembly,"AB 2399 NAZARIAN  Assembly Third Reading",79,0,0,1,80
851764,527875,2016-04-04,Assembly,"Do pass and be re-referred to the Committee on Local Government to 	Consent Calendar",16,0,0,0,16
851764,539318,2016-04-27,Assembly,"Do pass, to Consent Calendar",9,0,0,0,9
851764,543028,2016-05-05,Assembly,"AB 2196 LOW  Consent Calendar Second Day  Regular Session",79,0,0,1,80
851764,552953,2016-06-14,Senate,"Do pass and be placed on the Consent Calendar",11,0,0,0,11
851764,557036,2016-06-30,Senate,"Consent Calendar 2nd AB2196 Low",37,0,3,0,40
851764,559887,2016-08-15,Assembly,"Senate amendments be concurred in",15,0,0,1,16
851764,560169,2016-08-18,Assembly,"AB 2196 LOW  Concurrence in Senate Amendments",79,0,0,1,80
851765,530493,2016-04-11,Assembly,"Be referred to Committee on Public Safety",9,0,0,2,11
851765,535274,2016-04-19,Assembly,"Do pass and be re-referred to the Committee on Appropriations",7,0,0,0,7
851767,531912,2016-04-12,Assembly,"Do pass as amended and be re-referred to the Committee on 	Appropriations",19,0,0,0,19
851769,535685,2016-04-19,Senate,"Do pass as amended, and re-refer to the Committee on Appropriations",10,1,0,0,11
851769,547600,2016-05-23,Senate,"Senate 3rd Reading SB1259 Runner By Cannella",36,0,4,0,40
851770,525883,2016-03-29,Assembly,"Do pass",7,0,0,0,7
851770,527560,2016-04-04,Assembly,"AB 2245 COOPER  Assembly Third Reading",77,0,0,2,79
851770,554749,2016-06-21,Senate,"Do pass as amended",7,0,0,0,7
851771,525858,2016-03-29,Senate,"Do pass, but re-refer to the Committee on Veterans Affairs",9,0,0,0,9
851771,532336,2016-04-12,Senate,"Do pass, but re-refer to the Committee on Appropriations Recommend 	Consent",5,0,0,0,5
851771,549193,2016-05-27,Senate,"Do pass",7,0,0,0,7
851771,549925,2016-05-31,Senate,"Senate 3rd Reading SB1227 Lara",39,0,1,0,40
851771,555255,2016-06-22,Assembly,"Do pass and be re-referred to the Committee on Veterans Affairs to 	Consent Calendar",7,0,0,0,7
851771,556318,2016-06-28,Assembly,"Do pass and be re-referred to the Committee on Appropriations",7,0,0,2,9
851771,558999,2016-08-03,Assembly,"Do pass, to Consent Calendar",20,0,0,0,20
851771,560215,2016-08-18,Assembly,"SB 1227 Lara  Senate Third Reading  By EGGMAN",79,0,0,1,80
851771,561568,2016-08-30,Senate,"Unfinished Business (S upplemental File 1)SB1 227 Lar a Con",39,0,0,0,39
851772,533263,2016-04-12,Assembly,"Do pass and be re-referred to the Committee on Appropriations",7,0,0,0,7
851772,549379,2016-05-27,Assembly,"Do pass",20,0,0,0,20
851772,550141,2016-05-31,Assembly,"AB 2256 MAIENSCHEIN  Assembly Third Reading",80,0,0,0,80
851773,533132,2016-04-12,Senate,"Do pass, but re-refer to the Committee on Appropriations Recommend 	Consent",5,0,0,0,5
851773,544563,2016-04-25,Senate,"Placed on Appropriations Suspense file",7,0,0,0,7
851773,549138,2016-05-27,Senate,"Do pass",7,0,0,0,7
851773,550005,2016-05-31,Senate,"Senate 3rd Reading SB1226 Beall",39,0,1,0,40
851773,556179,2016-06-28,Assembly,"Do pass as amended and be re-referred to the Committee on 	Appropriations",7,0,0,0,7
851773,559076,2016-08-03,Assembly,"Do pass, to Consent Calendar",20,0,0,0,20
851773,560869,2016-08-23,Assembly,"SB 1226 Beall  Senate Third Reading  By SALAS",78,1,0,1,80
851773,561228,2016-08-25,Senate,"Unfinished Business SB1226 Beall Concurrence",39,0,0,0,39
851774,526790,2016-03-31,Assembly,"Be referred to Committee on Utilities and Commerce",8,0,0,3,11
851774,537181,2016-04-20,Assembly,"Do pass as amended and be re-referred to the Committee on 	Appropriations",9,4,0,2,15
851774,544841,2016-05-11,Assembly,"Do pass",14,6,0,0,20
851774,547571,2016-05-23,Assembly,"AB 2313 WILLIAMS  Assembly Third Reading",57,20,0,3,80
851774,555554,2016-06-27,Senate,"Do pass as amended, and re-refer to the Committee on Appropriations",9,0,2,0,11
851774,559532,2016-08-11,Senate,"Do pass as amended",6,1,0,0,7
851774,560770,2016-08-23,Senate,"Assembly 3rd Reading AB2313 Williams By Hertzberg",37,2,0,0,39
851774,561612,2016-08-30,Assembly,"AB 2313 WILLIAMS  Concurrence in Senate Amendments",59,19,0,2,80
851775,530488,2016-04-11,Senate,"Do pass, but re-refer to the Committee on Appropriations",3,2,0,0,5
851775,549112,2016-05-27,Senate,"Do pass as amended",5,2,0,0,7
851775,550888,2016-06-02,Senate,"Senate 3rd Reading SB1234 De Le",26,13,1,0,40
851775,555223,2016-06-22,Assembly,"Do pass and be re-referred to the Committee on Appropriations",6,1,0,0,7
851775,559256,2016-08-11,Assembly,"Do pass as amended",14,6,0,0,20
851775,561165,2016-08-25,Assembly,"SB 1234 De Leon  Senate Third Reading  By GATTO",52,26,0,2,80
851775,561693,2016-08-31,Senate,"W/O REF. TO FILE SB1234 De Le",27,12,0,0,39
851777,529375,2016-04-06,Senate,"Do pass, but re-refer to the Committee on Rules",8,0,1,0,9
851777,534844,2016-04-19,Senate,"Do pass, but re-refer to the Committee on Appropriations",5,2,0,0,7
851777,545814,2016-05-16,Senate,"Placed on Appropriations Suspense file",7,0,0,0,7
851777,549102,2016-05-27,Senate,"Do pass as amended",5,2,0,0,7
851777,550879,2016-06-02,Senate,"Senate 3rd Reading SB1159 Hernandez",25,12,3,0,40
851777,554994,2016-06-21,Assembly,"Do pass and be re-referred to the Committee on Privacy and Consumer 	Protection",14,3,0,1,18
851777,555956,2016-06-28,Assembly,"Do pass as amended and be re-referred to the Committee on 	Appropriations",11,0,0,0,11
851777,559266,2016-08-11,Assembly,"Do pass as amended",16,4,0,0,20
851777,560379,2016-08-19,Assembly,"SB 1159 Hernandez  Senate Third Reading  By PUB. S.  Amendment  Set 	#1",73,0,0,7,80
851777,560683,2016-08-23,Assembly,"SB 1159 Hernandez  Senate Third Reading  By BONTA",60,19,0,1,80
851777,561163,2016-08-25,Senate,"Unfinished Business SB1159 Hernandez Concurrence",29,8,2,0,39
851779,528290,2016-04-05,Assembly,"Do pass as amended and be re-referred to the Committee on 	Appropriations",11,0,0,0,11
851779,542594,2016-05-04,Assembly,"Do pass, to Consent Calendar",20,0,0,0,20
851779,545316,2016-05-12,Assembly,"AB 2307 CHAU  Consent Calendar Second Day  Regular Session",78,0,0,2,80
851779,554929,2016-06-20,Senate,"Do pass, but re-refer to the Committee on Appropriations",9,0,0,0,9
851779,559853,2016-08-15,Senate,"Assembly 3rd Reading AB2307 Chau By Hill",38,0,1,0,39
851781,539089,2016-04-27,Assembly,"Do pass as amended",3,2,0,2,7
851781,539090,2016-04-27,Assembly,"Reconsideration granted",7,0,0,0,7
851782,537027,2016-04-20,Assembly,"Do pass as amended and be re-referred to the Committee on 	Appropriations",6,1,0,0,7
851782,548371,2016-05-25,Assembly,"Do pass",18,2,0,0,20
851782,551145,2016-06-02,Assembly,"AB 2280 RIDLEY-THOMAS  Assembly Third Reading",74,4,0,2,80
851782,561472,2016-08-29,Senate,"Do pass",7,0,0,0,7
851782,561652,2016-08-30,Senate,"Assembly 2nd Reading AB2280 Ridley-Thomas By Hertzberg Urgency C",38,0,1,0,39
851782,561788,2016-08-31,Assembly,"Senate amendments be concurred in",10,0,0,0,10
851782,561789,2016-08-31,Assembly,"AB 2280 RIDLEY-THOMAS  Concurrence- Urgency Added",78,0,0,2,80
851783,525880,2016-03-29,Senate,"Do pass, but re-refer to the Committee on Appropriations",9,0,2,0,11
851783,549297,2016-05-27,Senate,"Do pass",7,0,0,0,7
851783,550096,2016-05-31,Senate,"Senate 3rd Reading SB1207 Hueso",38,0,2,0,40
851783,556917,2016-06-29,Assembly,"Do pass and be re-referred to the Committee on Natural Resources to 	Consent Calendar",15,0,0,0,15
851783,556918,2016-06-30,Assembly,"Do pass and be re-referred to the Committee on Appropriations to 	Consent Calendar",7,0,0,2,9
851783,559404,2016-08-11,Assembly,"Do pass",15,0,0,5,20
851783,560204,2016-08-18,Assembly,"SB 1207 Hueso  Senate Third Reading  By WILLIAMS",76,0,0,4,80
851783,561133,2016-08-25,Senate,"Special Consent SB1207 Hueso",39,0,0,0,39
851784,529397,2016-04-06,Assembly,"Do pass and be re-referred to the Committee on Appropriations",7,0,0,0,7
851784,549200,2016-05-27,Assembly,"Do pass",16,0,0,4,20
851784,550468,2016-06-01,Assembly,"AB 2246 O'DONNELL  Assembly Third Reading",67,6,0,7,80
851784,553087,2016-06-15,Senate,"Do pass, but re-refer to the Committee on Appropriations",9,0,0,0,9
851784,558796,2016-08-01,Senate,"Placed on Appropriations Suspense file",7,0,0,0,7
851784,559567,2016-08-11,Senate,"Do pass",6,0,1,0,7
851784,560642,2016-08-23,Senate,"Assembly 3rd Reading AB2246 O'Donnell By Leno",38,0,1,0,39
851784,561412,2016-08-29,Assembly,"AB 2246 O'DONNELL  Concurrence in Senate Amendments",65,11,0,4,80
851786,527960,2016-04-05,Senate,"Do pass, but re-refer to the Committee on Appropriations",7,0,4,0,11
851786,549046,2016-05-27,Senate,"Do pass",6,1,0,0,7
851786,550410,2016-06-01,Senate,"Senate 3rd Reading SB1250 McGuire",34,5,1,0,40
851787,531791,2016-04-12,Senate,"Do pass as amended, and re-refer to the Committee on Appropriations",8,1,4,0,13
851789,528086,2016-04-05,Senate,"Do pass as amended, and re-refer to the Committee on Environmental 	Quality",9,0,2,0,11
851789,536600,2016-04-20,Senate,"Do pass as amended, and re-refer to the Committee on Appropriations",7,0,0,0,7
851791,532230,2016-04-13,Senate,"Do pass, but re-refer to the Committee on Appropriations",5,0,2,0,7
851791,549136,2016-05-27,Senate,"Do pass",5,1,1,0,7
851792,535655,2016-04-19,Assembly,"Do pass and be re-referred to the Committee on Appropriations",16,1,0,2,19
851793,534896,2016-04-18,Assembly,"Do pass as amended and be re-referred to the Committee on 	Appropriations",4,5,0,0,9
851793,537123,2016-04-21,Assembly,"Do pass as amended and be re-referred to the Committee on 	Appropriations",5,0,0,4,9
851793,538464,2016-04-21,Assembly,"Reconsideration granted",8,0,0,1,9
851793,549072,2016-05-27,Assembly,"Do pass as amended",13,1,0,6,20
851793,550902,2016-06-02,Assembly,"AB 2243 WOOD  Third Reading Urgency",60,12,0,8,80
851793,554979,2016-06-22,Senate,"Do pass as amended, and re-refer to the Committee on Appropriations",5,1,1,0,7
851795,528646,2016-04-06,Senate,"Do pass, but re-refer to the Committee on Appropriations",4,1,0,0,5
851795,534118,2016-04-18,Senate,"Placed on Appropriations Suspense file",7,0,0,0,7
851795,548996,2016-05-27,Senate,"Do pass as amended",5,2,0,0,7
851795,550388,2016-06-01,Senate,"Senate 3rd Reading SB1167 Leyva",25,12,3,0,40
851795,555269,2016-06-22,Assembly,"Do pass and be re-referred to the Committee on Appropriations",5,2,0,0,7
851795,559291,2016-08-11,Assembly,"Do pass as amended",13,6,0,1,20
851795,560366,2016-08-19,Assembly,"SB 1167 Mendoza  Senate Third Reading  By L. GOV.  Amendment  Set #1",73,0,0,7,80
851795,560940,2016-08-24,Assembly,"SB 1167 Mendoza  Senate Third Reading  By THURMOND",48,28,0,4,80
851795,561319,2016-08-26,Senate,"Unfinished Business SB1167 Mendoza Concurrence",26,12,1,0,39
851797,537610,2016-04-20,Assembly,"Do pass and be re-referred to the Committee on Appropriations",14,0,0,1,15
851797,549253,2016-05-27,Assembly,"Do pass",20,0,0,0,20
851797,550183,2016-05-31,Assembly,"AB 2271 QUIRK  Assembly Third Reading",80,0,0,0,80
851797,555585,2016-06-27,Senate,"Do pass as amended, and re-refer to the Committee on Appropriations",6,2,3,0,11
851798,531581,2016-04-12,Assembly,"Do pass as amended and be re-referred to the Committee on 	Appropriations",7,0,0,0,7
851798,544867,2016-05-11,Assembly,"Do pass, to Consent Calendar",20,0,0,0,20
851798,547008,2016-05-19,Assembly,"AB 2221 GARCIA, C.  Consent Calendar Second Day  Regular Session",76,0,0,4,80
851798,554677,2016-06-21,Senate,"Do pass, but re-refer to the Committee on Appropriations Recommend 	Consent",7,0,0,0,7
851798,558942,2016-08-01,Senate,"Placed on Appropriations Suspense file",7,0,0,0,7
851798,559726,2016-08-11,Senate,"Do pass as amended",7,0,0,0,7
851798,560847,2016-08-23,Senate,"Assembly 3rd Reading AB2221 Cristina Garcia By McGuire",39,0,0,0,39
851798,561510,2016-08-29,Assembly,"AB 2221 GARCIA, C.  Concurrence in Senate Amendments",80,0,0,0,80
851800,536963,2016-04-20,Assembly,"Do pass and be re-referred to the Committee on Appropriations",1,5,0,1,7
851800,536964,2016-04-20,Assembly,"Reconsideration granted",7,0,0,0,7
851801,539332,2016-04-27,Assembly,"Do pass, to Consent Calendar",7,0,0,0,7
851801,543047,2016-05-05,Assembly,"AB 2265 STONE  Consent Calendar Second Day  Regular Session",79,0,0,1,80
851801,552163,2016-06-08,Senate,"Do pass and be placed on the Consent Calendar",5,0,0,0,5
851801,556849,2016-06-30,Senate,"Consent Calendar 2nd AB2265 Mark Stone",37,0,3,0,40
851802,528033,2016-04-05,Assembly,"Do pass as amended and be re-referred to the Committee on 	Appropriations",16,0,0,0,16
851802,536353,2016-04-20,Assembly,"Do pass, to Consent Calendar",16,0,0,4,20
851802,539653,2016-04-28,Assembly,"AB 2235 THURMOND  Consent Calendar Second Day  Regular Session",76,0,0,4,80
851802,552480,2016-06-13,Senate,"Do pass as amended, and re-refer to the Committee on Appropriations",9,0,0,0,9
851802,560329,2016-08-18,Senate,"Assembly 3rd Reading AB2235 Thurmond By Hill",38,0,1,0,39
851802,561046,2016-08-24,Assembly,"AB 2235 THURMOND  Concurrence in Senate Amendments",80,0,0,0,80
851803,525916,2016-03-29,Assembly,"Do pass and be re-referred to the Committee on Appropriations to 	Consent Calendar",10,0,0,0,10
851803,532666,2016-04-06,Assembly,"Do pass, to Consent Calendar",18,0,0,2,20
851803,533243,2016-04-14,Assembly,"AB 2232 OBERNOLTE  Consent Calendar Second Day  Regular Session",76,0,0,4,80
851803,544626,2016-05-10,Senate,"Do pass, but re-refer to the Committee on Appropriations Recommend 	Consent",7,0,0,0,7
851803,556933,2016-06-30,Senate,"Consent Calendar 2nd AB2232 Obernolte",37,0,3,0,40
851804,532214,2016-04-13,Senate,"Do pass, but re-refer to the Committee on Judiciary",4,1,0,0,5
851804,534851,2016-04-19,Senate,"Do pass as amended, and re-refer to the Committee on Appropriations",4,2,1,0,7
851804,549127,2016-05-27,Senate,"Do pass",5,2,0,0,7
851804,550429,2016-06-01,Senate,"Senate 3rd Reading SB1166 Jackson",22,14,4,0,40
851804,555252,2016-06-22,Assembly,"Do pass and be re-referred to the Committee on Appropriations",2,1,0,4,7
851805,534886,2016-04-18,Assembly,"Do pass as amended and be re-referred to the Committee on 	Appropriations",9,0,0,0,9
851806,536408,2016-04-20,Assembly,"Do pass and be re-referred to the Committee on Appropriations",6,1,0,0,7
851807,532526,2016-04-13,Assembly,"Do pass and be re-referred to the Committee on Local Government",5,2,0,0,7
851807,536551,2016-04-20,Assembly,"Do pass and be re-referred to the Committee on Appropriations",6,2,0,1,9
851807,545077,2016-05-11,Assembly,"Do pass",14,6,0,0,20
851807,551197,2016-06-02,Assembly,"AB 2299 BLOOM  Assembly Third Reading",51,24,0,5,80
851807,552773,2016-06-14,Senate,"Do pass, but re-refer to the Committee on Governance and Finance",7,0,4,0,11
851807,556560,2016-06-29,Senate,"Do pass, but re-refer to the Committee on Appropriations",4,0,3,0,7
851807,561645,2016-08-30,Senate,"Assembly 3rd Reading AB2299 Bloom By Wieckowski",31,4,4,0,39
851807,561791,2016-08-31,Assembly,"AB 2299 BLOOM  Concurrence in Senate Amendments",60,15,0,5,80
851808,531411,2016-04-12,Senate,"Do pass, but re-refer to the Committee on Appropriations Recommend 	Consent",6,0,1,0,7
851808,544593,2016-04-25,Senate,"Placed on Appropriations Suspense file",7,0,0,0,7
851808,549420,2016-05-27,Senate,"Do pass as amended",7,0,0,0,7
851808,551063,2016-06-02,Senate,"Special Consent # SB1200 Jackson",39,0,1,0,40
851808,556131,2016-06-28,Assembly,"Do pass and be re-referred to the Committee on Appropriations to 	Consent Calendar",7,0,0,0,7
851808,559065,2016-08-03,Assembly,"Do pass, to Consent Calendar",20,0,0,0,20
851808,559427,2016-08-11,Assembly,"SB 1200 Jackson  Consent Calendar Second Day  Regular Session",78,0,0,2,80
851810,555588,2016-06-27,Senate,"Do pass",6,0,1,0,7
851810,556875,2016-06-30,Senate,"Senate 3rd Reading SB1187 Lara Urgency Clause",30,5,5,0,40
851810,559684,2016-08-10,Assembly,"Do pass as amended",19,0,0,1,20
851810,560161,2016-08-18,Assembly,"SB 1187 Lara  Third Reading Urgency  By GONZALEZ",74,3,0,3,80
851810,560999,2016-08-24,Senate,"Unfinished Business SB1187 Lara Urgency Clause Concurr",38,0,1,0,39
851811,529049,2016-04-06,Assembly,"Do pass and be re-referred to the Committee on Public Safety",18,0,0,3,21
851811,535628,2016-04-19,Assembly,"Do pass and be re-referred to the Committee on Appropriations to 	Consent Calendar",7,0,0,0,7
851813,529617,2016-04-06,Assembly,"Do pass and be re-referred to the Committee on Appropriations",6,1,0,0,7
851813,542869,2016-05-04,Assembly,"Do pass",16,4,0,0,20
851813,547252,2016-05-19,Assembly,"AB 2288 BURKE  Assembly Third Reading",63,12,0,5,80
851813,552059,2016-06-08,Senate,"Do pass, but re-refer to the Committee on Appropriations",3,1,1,0,5
851813,558927,2016-08-01,Senate,"Do pass",6,0,1,0,7
851813,560703,2016-08-23,Senate,"Assembly 3rd Reading AB2288 Burke By Leyva",27,10,2,0,39
851813,561441,2016-08-29,Assembly,"AB 2288 BURKE  Concurrence in Senate Amendments",68,12,0,0,80
851814,528014,2016-04-04,Assembly,"Do pass and be re-referred to the Committee on Appropriations to 	Consent Calendar",12,0,0,0,12
851814,532369,2016-04-13,Assembly,"Do pass, to Consent Calendar",20,0,0,0,20
851814,537481,2016-04-21,Assembly,"AB 2274 DABABNEH  Consent Calendar Second Day  Regular Session",79,0,0,1,80
851814,554475,2016-06-15,Senate,"Do pass, but re-refer to the Committee on Appropriations Recommend 	Consent",7,0,0,0,7
851814,559851,2016-08-15,Senate,"Assembly 3rd Reading AB2274 Dababneh By Glazer",38,0,1,0,39
851814,560466,2016-08-22,Assembly,"AB 2274 DABABNEH  Concurrence in Senate Amendments",78,0,0,2,80
851815,536180,2016-04-20,Senate,"Do pass, but re-refer to the Committee on Rules",7,0,0,0,7
851815,542416,2016-05-04,Senate,"Do pass",6,0,1,0,7
851815,550839,2016-06-02,Senate,"Senate 3rd Reading SB1147 Galgiani",38,0,2,0,40
851817,535878,2016-04-19,Assembly,"Do pass and be re-referred to the Committee on Appropriations to 	Consent Calendar",10,0,0,0,10
851817,542628,2016-05-04,Assembly,"Do pass, to Consent Calendar",20,0,0,0,20
851817,545212,2016-05-12,Assembly,"AB 2258 EGGMAN  Consent Calendar Second Day  Regular Session",78,0,0,2,80
851817,553134,2016-06-14,Senate,"Do pass and be placed on the Consent Calendar",7,0,0,0,7
851817,560752,2016-08-23,Senate,"Assembly 3rd Reading AB2258 Eggman By Glazer",39,0,0,0,39
851817,561361,2016-08-29,Assembly,"AB 2258 EGGMAN  Concurrence in Senate Amendments",80,0,0,0,80
851818,528071,2016-04-05,Assembly,"Do pass, to Consent Calendar",7,0,0,0,7
851818,530629,2016-04-11,Assembly,"AB 2390 BROWN  Consent Calendar Second Day",77,0,0,2,79
851819,529319,2016-04-06,Assembly,"Do pass and be re-referred to the Committee on Arts, Entertain, 	Sports, Tourism, & Internet Media",7,0,0,0,7
851819,531410,2016-04-12,Assembly,"Do pass as amended and be re-referred to the Committee on 	Appropriations",7,0,0,0,7
851819,549451,2016-05-27,Assembly,"Do pass as amended",20,0,0,0,20
851819,550932,2016-06-02,Assembly,"AB 2182 MULLIN  Assembly Third Reading",80,0,0,0,80
851819,555184,2016-06-22,Senate,"Do pass, but re-refer to the Committee on Appropriations Recommend 	Consent",9,0,0,0,9
851819,558904,2016-08-01,Senate,"Placed on Appropriations Suspense file",7,0,0,0,7
851819,559719,2016-08-11,Senate,"Do pass",7,0,0,0,7
851819,560435,2016-08-19,Senate,"Assembly 3rd Reading AB2182 Mullin By Hernandez",37,0,2,0,39
851821,534870,2016-04-18,Assembly,"Do pass and be re-referred to the Committee on Appropriations to 	Consent Calendar",9,0,0,0,9
851822,525080,2016-03-28,Senate,"Senate 3rd Reading SCR112 Fuller",36,0,4,0,40
851822,554641,2016-06-21,Assembly,"Be adopted, to Consent Calendar",7,0,0,0,7
851822,555227,2016-06-23,Assembly,"SCR 112 Fuller  Consent Calendar Second Day  Regular Session",79,0,0,1,80
851824,531409,2016-04-12,Assembly,"Do pass and be re-referred to the Committee on Appropriations to 	Consent Calendar",16,0,0,0,16
851824,549104,2016-05-27,Assembly,"Do pass",20,0,0,0,20
851824,550062,2016-05-31,Assembly,"AB 2190 SALAS  Assembly Third Reading",80,0,0,0,80
851824,555568,2016-06-27,Senate,"Do pass, but re-refer to the Committee on Appropriations",9,0,0,0,9
851824,558896,2016-08-01,Senate,"Placed on Appropriations Suspense file",7,0,0,0,7
851824,559742,2016-08-11,Senate,"Do pass as amended",7,0,0,0,7
851824,560433,2016-08-19,Senate,"Assembly 3rd Reading AB2190 Salas By Hill",36,0,3,0,39
851824,560960,2016-08-24,Assembly,"AB 2190 SALAS  Concurrence in Senate Amendments",79,1,0,0,80
851825,531071,2016-04-11,Assembly,"Do pass as amended and be re-referred to the Committee on 	Appropriations",9,0,0,0,9
851825,539295,2016-04-27,Assembly,"Do pass, to Consent Calendar",19,0,0,1,20
851825,543144,2016-05-05,Assembly,"AB 2396 MCCARTY  Consent Calendar Second Day  Regular Session",79,0,0,1,80
851825,552129,2016-06-08,Senate,"Do pass, but re-refer to the Committee on Appropriations Recommend 	Consent",6,0,1,0,7
851825,554525,2016-06-20,Senate,"Do pass",7,0,0,0,7
851825,560262,2016-08-18,Senate,"Assembly 3rd Reading AB2396 McCarty By Wieckowski",36,0,3,0,39
851825,561040,2016-08-24,Assembly,"AB 2396 MCCARTY  Concurrence in Senate Amendments",80,0,0,0,80
851826,526591,2016-03-30,Senate,"Do pass, but re-refer to the Committee on Appropriations Recommend 	Consent",8,0,1,0,9
851826,533446,2016-04-14,Senate,"Consent Calendar 2nd SB1211 Huff",38,0,2,0,40
851826,553647,2016-06-15,Assembly,"Do pass and be re-referred to the Committee on Appropriations to 	Consent Calendar",7,0,0,0,7
851826,556310,2016-06-29,Assembly,"Do pass, to Consent Calendar",18,0,0,2,20
851826,559118,2016-08-04,Assembly,"SB 1211 Huff  Consent Calendar Second Day  Regular Session",77,0,0,3,80
851827,535289,2016-04-19,Assembly,"Do pass as amended and be re-referred to the Committee on 	Appropriations",6,0,0,1,7
851829,525823,2016-03-29,Senate,"Do pass, but re-refer to the Committee on Appropriations",7,0,0,0,7
851829,530887,2016-04-11,Senate,"Placed on Appropriations Suspense file",7,0,0,0,7
851829,549320,2016-05-27,Senate,"Do pass",7,0,0,0,7
851829,550251,2016-05-31,Senate,"Senate 3rd Reading SB1182 Galgiani",37,0,3,0,40
851829,552851,2016-06-14,Assembly,"Do pass and be re-referred to the Committee on Appropriations",7,0,0,0,7
851829,559489,2016-08-11,Assembly,"Do pass as amended",20,0,0,0,20
851829,560309,2016-08-18,Assembly,"SB 1182 Galgiani  Senate Third Reading  By GARCIA, C",77,0,0,3,80
851829,561309,2016-08-25,Senate,"Special Consent SB1182 Galgiani",39,0,0,0,39
851830,528843,2016-04-06,Senate,"Do pass, but re-refer to the Committee on Judiciary",7,2,0,0,9
851830,535174,2016-04-19,Senate,"Do pass, but re-refer to the Committee on Appropriations",5,2,0,0,7
851830,545848,2016-05-16,Senate,"Do pass",5,2,0,0,7
851830,548681,2016-05-26,Senate,"Senate 3rd Reading SB1146 Lara",26,13,1,0,40
851830,554625,2016-06-21,Assembly,"Do pass as amended and be re-referred to the Committee on Judiciary",8,2,0,3,13
851830,556795,2016-06-30,Assembly,"Do pass and be re-referred to the Committee on Appropriations",7,2,0,1,10
851830,559326,2016-08-11,Assembly,"Do pass as amended",13,3,0,4,20
851830,560652,2016-08-23,Assembly,"SB 1146 Lara  Senate Third Reading  By LOW",45,28,0,7,80
851830,561579,2016-08-30,Senate,"Unfinished Business (S upplemental File 1)SB1 146 Lar a Con",25,13,1,0,39
851831,531489,2016-04-12,Senate,"Do pass",5,1,1,0,7
851831,537374,2016-04-21,Senate,"Senate 3rd Reading SB1242 Lara",31,8,1,0,40
851831,552852,2016-06-14,Assembly,"Do pass as amended",5,0,0,2,7
851831,559794,2016-08-15,Assembly,"SB 1242 Lara  Senate Third Reading  By THURMOND",52,21,0,7,80
851831,561057,2016-08-24,Senate,"Unfinished Business SB1242 Lara Concurrence",31,8,0,0,39
851832,525582,2016-03-29,Assembly,"Do pass as amended and be re-referred to the Committee on 	Transportation",7,0,0,0,7
851832,534167,2016-04-18,Assembly,"Do pass and be re-referred to the Committee on Appropriations",15,0,0,1,16
851833,525426,2016-03-28,Assembly,"Be referred to Committee on Housing and Community Development",11,0,0,0,11
851834,527988,2016-04-04,Assembly,"Do pass and be re-referred to the Committee on Judiciary",2,7,0,0,9
851834,527989,2016-04-04,Assembly,"Reconsideration granted",9,0,0,0,9
851835,525912,2016-03-29,Senate,"Do pass, but re-refer to the Committee on Governance and Finance",7,2,0,0,9
851835,536394,2016-04-20,Senate,"Do pass, but re-refer to the Committee on Appropriations",5,2,0,0,7
851835,548675,2016-05-26,Senate,"Senate 3rd Reading SB1262 Pavley",22,13,5,0,40
851835,555997,2016-06-28,Assembly,"Do pass and be re-referred to the Committee on Local Government",13,0,0,2,15
851835,556776,2016-06-29,Assembly,"Do pass and be re-referred to the Committee on Appropriations",8,0,0,1,9
851835,559032,2016-08-03,Assembly,"Do pass",14,0,0,6,20
851835,560205,2016-08-18,Assembly,"SB 1262 Pavley  Senate Third Reading  By LEVINE",76,0,0,4,80
851835,560902,2016-08-24,Senate,"Unfinished Business SB1262 Pavley Concurrence",39,0,0,0,39
851837,529522,2016-04-06,Assembly,"Do pass as amended and be re-referred to the Committee on 	Appropriations",7,0,0,0,7
851837,549279,2016-05-27,Assembly,"Do pass as amended",20,0,0,0,20
851837,550668,2016-06-01,Assembly,"AB 2329 BONILLA  Assembly Third Reading",79,0,0,1,80
851837,555095,2016-06-22,Senate,"Do pass as amended, but re-refer to the Committee on Appropriations 	Recommend Consent",9,0,0,0,9
851837,558866,2016-08-01,Senate,"Placed on Appropriations Suspense file",7,0,0,0,7
851837,561847,2016-08-31,Senate,"Assembly 3rd Reading ( Supplemental File 1)AB 2329 Bo nilla By",39,0,0,0,39
851837,561848,2016-08-31,Assembly,"AB 2329 BONILLA  Concurrence in Senate Amendments",79,0,0,1,80
851838,531574,2016-04-12,Senate,"Do pass, but re-refer to the Committee on Appropriations",11,0,2,0,13
851838,544264,2016-04-25,Senate,"Placed on Appropriations Suspense file",7,0,0,0,7
851838,548974,2016-05-27,Senate,"Do pass as amended",7,0,0,0,7
851838,550474,2016-06-01,Senate,"Senate 3rd Reading SB1219 Hancock",38,0,2,0,40
851838,555559,2016-06-21,Assembly,"Do pass as amended and be re-referred to the Committee on 	Appropriations",8,0,0,1,9
851838,559277,2016-08-11,Assembly,"Do pass as amended",20,0,0,0,20
851838,560399,2016-08-19,Assembly,"SB 1219 Hancock  Senate Third Reading  Amendment  Set #1",73,0,0,7,80
851838,560719,2016-08-23,Assembly,"SB 1219 Hancock  Senate Third Reading  By JONES-SAWYER",79,1,0,0,80
851838,561195,2016-08-25,Senate,"Unfinished Business SB1219 Hancock Concurrence",39,0,0,0,39
851840,531531,2016-04-12,Assembly,"Do pass and be re-referred to the Committee on Appropriations to 	Consent Calendar",16,0,0,0,16
851840,549264,2016-05-27,Assembly,"Do pass",20,0,0,0,20
851840,550047,2016-05-31,Assembly,"AB 2191 SALAS  Assembly Third Reading",79,1,0,0,80
851840,555726,2016-06-27,Senate,"Do pass, but re-refer to the Committee on Appropriations",9,0,0,0,9
851840,558865,2016-08-01,Senate,"Placed on Appropriations Suspense file",7,0,0,0,7
851840,559764,2016-08-11,Senate,"Do pass as amended",7,0,0,0,7
851840,560437,2016-08-19,Senate,"Assembly 3rd Reading AB2191 Salas By Hill",36,0,3,0,39
851840,561059,2016-08-24,Assembly,"AB 2191 SALAS  Concurrence in Senate Amendments",78,1,0,1,80
851841,536449,2016-04-20,Assembly,"Do pass and be re-referred to the Committee on Appropriations",20,0,0,1,21
851841,549341,2016-05-27,Assembly,"Do pass as amended",20,0,0,0,20
851841,550979,2016-06-02,Assembly,"AB 2311 BROWN  Assembly Third Reading",79,0,0,1,80
851841,558736,2016-08-01,Senate,"Placed on Appropriations Suspense file",7,0,0,0,7
851841,559781,2016-08-11,Senate,"Do pass as amended",7,0,0,0,7
851841,560095,2016-08-17,Senate,"Assembly 3rd Reading AB2311 Brown By Morrell",39,0,0,0,39
851841,560781,2016-08-23,Assembly,"AB 2311 BROWN  Concurrence in Senate Amendments",79,1,0,0,80
851843,531942,2016-04-12,Senate,"Do pass, but re-refer to the Committee on Appropriations Recommend 	Consent",6,0,1,0,7
851843,539992,2016-04-28,Senate,"Consent Calendar 2nd SB1221 Hertzberg",37,0,3,0,40
851843,552878,2016-06-14,Assembly,"Do pass and be re-referred to the Committee on Appropriations to 	Consent Calendar",7,0,0,0,7
851843,556312,2016-06-29,Assembly,"Do pass, to Consent Calendar",18,0,0,2,20
851843,560615,2016-08-22,Assembly,"SB 1221 Hertzberg  Senate Third Reading  By MAIENSCHEIN",79,0,0,1,80
851843,561487,2016-08-29,Senate,"Special Consent SB1221 Hertzberg",39,0,0,0,39
851844,519110,2016-03-14,Assembly,"From committee:  Be adopted.  To third reading",10,0,0,1,11
851844,550843,2016-06-02,Senate,"Special Consent # ACR140 Obernolte",39,0,1,0,40
851845,544335,2016-04-19,Assembly,"Do pass and be re-referred to the Committee on Appropriations",12,1,0,0,13
851845,549375,2016-05-27,Assembly,"Do pass as amended",16,1,0,3,20
851845,550999,2016-06-02,Assembly,"AB 2386 WILLIAMS  Assembly Third Reading",63,12,0,5,80
851845,555118,2016-06-22,Senate,"Do pass, but re-refer to the Committee on Appropriations",7,2,0,0,9
851845,558889,2016-08-01,Senate,"Placed on Appropriations Suspense file",7,0,0,0,7
851845,559640,2016-08-11,Senate,"Do pass",5,2,0,0,7
851845,560422,2016-08-19,Senate,"Assembly 3rd Reading AB2386 Williams By Pan",22,14,3,0,39
851848,536672,2016-04-20,Senate,"Do pass, but re-refer to the Committee on Judiciary",5,2,0,0,7
851848,542413,2016-05-03,Senate,"Do pass as amended",4,2,1,0,7
851851,531547,2016-04-12,Assembly,"Do pass and be re-referred to the Committee on Appropriations to 	Consent Calendar",16,0,0,0,16
851851,549295,2016-05-27,Assembly,"Do pass",20,0,0,0,20
851851,550084,2016-05-31,Assembly,"AB 2192 SALAS  Assembly Third Reading",80,0,0,0,80
851851,555583,2016-06-27,Senate,"Do pass, but re-refer to the Committee on Appropriations",7,1,1,0,9
851851,558701,2016-08-01,Senate,"Placed on Appropriations Suspense file",7,0,0,0,7
851851,559711,2016-08-11,Senate,"Do pass as amended",5,2,0,0,7
851851,560286,2016-08-18,Senate,"Assembly 3rd Reading AB2192 Salas By Cannella",30,8,1,0,39
851851,561063,2016-08-24,Assembly,"AB 2192 SALAS  Concurrence in Senate Amendments",62,12,0,6,80
851852,535007,2016-04-19,Senate,"Do pass as amended, and re-refer to the Committee on Appropriations",8,1,2,0,11
851852,545292,2016-05-12,Senate,"Senate 3rd Reading SB1199 Hall",27,7,6,0,40
851852,555125,2016-06-22,Assembly,"Do pass and be re-referred to the Committee on Local Government",19,0,0,2,21
851852,556799,2016-06-29,Assembly,"Do pass and be re-referred to the Committee on Appropriations to 	Consent Calendar",9,0,0,0,9
851852,559694,2016-08-10,Assembly,"Do pass, to Consent Calendar",19,0,0,1,20
851852,560234,2016-08-18,Assembly,"SB 1199 Hall  Consent Calendar Second Day  Regular Session",78,0,0,2,80
851853,533189,2016-04-13,Assembly,"Do pass as amended",10,2,0,3,15
851855,532699,2016-04-13,Senate,"Do pass, but re-refer to the Committee on Appropriations",7,2,0,0,9
851855,544490,2016-04-25,Senate,"Placed on Appropriations Suspense file",7,0,0,0,7
851855,549343,2016-05-27,Senate,"Do pass as amended",5,2,0,0,7
851855,550930,2016-06-02,Senate,"Senate 3rd Reading SB1225 Mendoza",26,10,4,0,40
851855,555323,2016-06-22,Assembly,"Do pass and be re-referred to the Committee on Appropriations",5,1,0,1,7
851857,526965,2016-03-29,Assembly,"Do pass as amended and be re-referred to the Committee on 	Appropriations",12,0,0,3,15
851857,548386,2016-05-25,Assembly,"Do pass",14,0,0,6,20
851857,550499,2016-06-01,Assembly,"AB 2373 GRAY  Assembly Third Reading",50,0,0,30,80
851857,551158,2016-06-02,Assembly,"AB 2373 GRAY  Assembly Third Reading",72,2,0,6,80
851858,534330,2016-04-18,Assembly,"Do pass and be re-referred to the Committee on Appropriations",8,4,0,4,16
851858,534331,2016-04-18,Assembly,"Reconsideration granted",15,0,0,1,16
851859,525892,2016-03-29,Senate,"Do pass as amended, and re-refer to the Committee on Rules",4,0,1,0,5
851859,535618,2016-04-19,Senate,"Do pass, but re-refer to the Committee on Appropriations Recommend 	Consent",7,0,0,0,7
851859,547616,2016-05-23,Senate,"Placed on Appropriations Suspense file",7,0,0,0,7
851860,533139,2016-04-12,Assembly,"Do pass and be re-referred to the Committee on Appropriations to 	Consent Calendar",7,0,0,0,7
851860,549113,2016-05-27,Assembly,"Do pass",20,0,0,0,20
851860,550010,2016-05-31,Assembly,"AB 2368 GORDON  Assembly Third Reading",80,0,0,0,80
851860,553142,2016-06-15,Senate,"Do pass, but re-refer to the Committee on Human Services",9,0,0,0,9
851860,556319,2016-06-28,Senate,"Do pass, but re-refer to the Committee on Appropriations Recommend 	Consent",5,0,0,0,5
851860,558729,2016-08-01,Senate,"Placed on Appropriations Suspense file",7,0,0,0,7
851860,559576,2016-08-11,Senate,"Do pass",7,0,0,0,7
851860,560468,2016-08-22,Senate,"Assembly 3rd Reading AB2368 Gordon By Beall",39,0,0,0,39
851861,531288,2016-04-12,Assembly,"Do pass as amended and be re-referred to the Committee on 	Appropriations",10,0,0,0,10
851861,542230,2016-05-04,Assembly,"Do pass, to Consent Calendar",20,0,0,0,20
851861,545197,2016-05-12,Assembly,"AB 2244 GATTO  Consent Calendar Second Day  Regular Session",78,0,0,2,80
851861,554989,2016-06-21,Senate,"Do pass, but re-refer to the Committee on Appropriations",7,0,0,0,7
851861,558773,2016-08-01,Senate,"Placed on Appropriations Suspense file",7,0,0,0,7
851861,559539,2016-08-11,Senate,"Do pass",7,0,0,0,7
851861,559942,2016-08-16,Senate,"Assembly 3rd Reading AB2244 Gatto",36,1,2,0,39
851861,560659,2016-08-23,Assembly,"AB 2244 GATTO  Concurrence in Senate Amendments",79,0,0,1,80
851862,542501,2016-05-04,Senate,"Do pass as amended, and re-refer to the Committee on Appropriations",5,0,2,0,7
851862,547597,2016-05-23,Senate,"Placed on Appropriations Suspense file",7,0,0,0,7
851864,535015,2016-04-19,Senate,"Do pass, but re-refer to the Committee on Appropriations",6,5,0,0,11
851864,549342,2016-05-27,Senate,"Do pass as amended",7,0,0,0,7
851864,550504,2016-06-01,Senate,"Senate 3rd Reading SB1239 Gaines",18,18,4,0,40
851864,550505,2016-06-01,Senate,"Senate 3rd Reading SB1239 Gaines Reconsider",39,0,1,0,40
851865,532891,2016-04-13,Senate,"Do pass, but re-refer to the Committee on Appropriations",5,1,3,0,9
851865,544355,2016-04-25,Senate,"Placed on Appropriations Suspense file",7,0,0,0,7
851866,526580,2016-03-30,Senate,"Do pass, but re-refer to the Committee on Appropriations",8,0,1,0,9
851866,537607,2016-04-21,Senate,"Senate 3rd Reading SB1178 Vidak Urgency Clause",36,0,4,0,40
851866,553739,2016-06-15,Assembly,"Do pass and be re-referred to the Committee on Appropriations to 	Consent Calendar",7,0,0,0,7
851866,556498,2016-06-29,Assembly,"Do pass, to Consent Calendar",18,0,0,2,20
851866,559135,2016-08-04,Assembly,"SB 1178 Vidak  Consent Calendar Second Day  Regular Session",77,0,0,3,80
851867,532682,2016-04-13,Assembly,"Do pass and be re-referred to the Committee on Appropriations",2,3,0,2,7
851868,530741,2016-04-11,Senate,"Do pass, but re-refer to the Committee on Governmental Organization",2,3,0,0,5
851868,530742,2016-04-11,Senate,"Set, first hearing.  Failed passage in Committee.  Reconsideration 	granted",5,0,0,0,5
851869,527659,2016-04-04,Assembly,"Do pass and be re-referred to the Committee on Revenue and Taxation",16,0,0,0,16
851869,535656,2016-04-18,Assembly,"Do pass as amended and be re-referred to the Committee on 	Appropriations",9,0,0,0,9
851871,536164,2016-04-20,Senate,"Do pass, but re-refer to the Committee on Judiciary",4,3,0,0,7
851871,542219,2016-05-03,Senate,"Do pass as amended",4,1,2,0,7
851871,549948,2016-05-31,Senate,"Senate 3rd Reading SB1150 Leno",18,18,4,0,40
851871,549949,2016-05-31,Senate,"Senate 3rd Reading SB1150 Leno Reconsider",37,0,3,0,40
851871,550392,2016-06-01,Senate,"Senate 3rd Reading SB1150 Leno",21,14,5,0,40
851871,554703,2016-06-20,Assembly,"Do pass as amended and be re-referred to the Committee on Judiciary",8,2,0,2,12
851871,556000,2016-06-28,Assembly,"Do pass as amended",7,3,0,0,10
851871,560360,2016-08-19,Assembly,"SB 1150 Leno  Senate Third Reading  Amendment  Set #1",73,0,0,7,80
851871,560507,2016-08-22,Assembly,"SB 1150 Leno  Senate Third Reading  By STONE",49,26,0,5,80
851871,560962,2016-08-24,Senate,"Unfinished Business SB1150 Leno Concurrence",22,13,4,0,39
851872,535246,2016-04-19,Assembly,"Do pass as amended and be re-referred to the Committee on 	Appropriations",5,2,0,0,7
851872,549360,2016-05-27,Assembly,"Do pass",19,1,0,0,20
851872,550478,2016-06-01,Assembly,"AB 2199 CAMPOS  Assembly Third Reading",77,3,0,0,80
851872,554950,2016-06-21,Senate,"Do pass as amended, and re-refer to the Committee on Appropriations",7,0,0,0,7
851872,558839,2016-08-01,Senate,"Placed on Appropriations Suspense file",7,0,0,0,7
851873,531413,2016-04-12,Senate,"Do pass, but re-refer to the Committee on Appropriations",6,0,1,0,7
851873,544529,2016-04-25,Senate,"Placed on Appropriations Suspense file",7,0,0,0,7
851873,549418,2016-05-27,Senate,"Do pass",7,0,0,0,7
851873,549999,2016-05-31,Senate,"Senate 3rd Reading SB1137 Hertzberg",39,0,1,0,40
851873,554657,2016-06-21,Assembly,"Do pass and be re-referred to the Committee on Privacy and Consumer 	Protection",7,0,0,0,7
851873,556097,2016-06-28,Assembly,"Do pass and be re-referred to the Committee on Appropriations",11,0,0,0,11
851873,559471,2016-08-11,Assembly,"Do pass",20,0,0,0,20
851873,560444,2016-08-19,Assembly,"SB 1137 Hertzberg  Senate Third Reading  By INS.  Amendment  Set #1",73,0,0,7,80
851873,560833,2016-08-23,Assembly,"SB 1137 Hertzberg  Senate Third Reading  By LOW",80,0,0,0,80
851873,561247,2016-08-25,Senate,"Unfinished Business SB1137 Hertzberg Concurrence",39,0,0,0,39
851875,535052,2016-04-18,Senate,"Do pass as amended, and re-refer to the Committee on Appropriations",9,0,0,0,9
851875,549325,2016-05-27,Senate,"Do pass as amended",7,0,0,0,7
851875,550434,2016-06-01,Senate,"Senate 3rd Reading SB1194 Hill",39,0,1,0,40
851875,556071,2016-06-28,Assembly,"Do pass and be re-referred to the Committee on Appropriations to 	Consent Calendar",16,0,0,0,16
851875,559419,2016-08-11,Assembly,"Do pass",20,0,0,0,20
851875,560429,2016-08-19,Assembly,"SB 1194 Hill  Senate Third Reading  Amendment  Set #1",73,0,0,7,80
851877,536588,2016-04-20,Senate,"Do pass, but re-refer to the Committee on Appropriations Recommend 	Consent",7,0,0,0,7
851877,545293,2016-05-12,Senate,"Consent Calendar 2nd SB1260 Allen",38,0,2,0,40
851877,553014,2016-06-14,Assembly,"Do pass and be re-referred to the Committee on Appropriations",7,0,0,0,7
851877,556508,2016-06-29,Assembly,"Do pass, to Consent Calendar",18,0,0,2,20
851877,559160,2016-08-04,Assembly,"SB 1260 Allen  Consent Calendar Second Day  Regular Session",77,0,0,3,80
851878,531683,2016-04-12,Senate,"Do pass, but re-refer to the Committee on Appropriations Recommend 	Consent",9,0,0,0,9
851878,544667,2016-04-25,Senate,"Placed on Appropriations Suspense file",7,0,0,0,7
851878,549306,2016-05-27,Senate,"Do pass",7,0,0,0,7
851878,549934,2016-05-31,Senate,"Senate 3rd Reading SB1188 McGuire",37,0,3,0,40
851878,556119,2016-06-28,Assembly,"Do pass and be re-referred to the Committee on Appropriations to 	Consent Calendar",15,0,0,0,15
851878,559392,2016-08-11,Assembly,"Do pass",15,0,0,5,20
851878,560236,2016-08-18,Assembly,"SB 1188 McGuire  Senate Third Reading  By DAHLE",77,0,0,3,80
851879,532225,2016-04-12,Assembly,"Do pass and be re-referred to the Committee on Appropriations",11,2,0,0,13
851880,532226,2016-04-13,Assembly,"Do pass and be re-referred to the Committee on Jobs, Economic 	Development and The Economy",6,1,0,0,7
851880,535233,2016-04-19,Assembly,"Do pass and be re-referred to the Committee on Appropriations",6,0,0,3,9
851882,525682,2016-03-29,Assembly,"Do pass as amended and be re-referred to the Committee on Health",16,0,0,0,16
851882,531924,2016-04-12,Assembly,"Do pass as amended and be re-referred to the Committee on 	Appropriations",19,0,0,0,19
851882,549262,2016-05-27,Assembly,"Do pass",20,0,0,0,20
851882,550052,2016-05-31,Assembly,"AB 2179 GIPSON  Assembly Third Reading",80,0,0,0,80
851882,554853,2016-06-20,Senate,"Do pass as amended, and re-refer to the Committee on Health",9,0,0,0,9
851882,556998,2016-06-29,Senate,"Do pass, but re-refer to the Committee on Appropriations Recommend 	Consent",8,0,1,0,9
851882,559703,2016-08-11,Senate,"Do pass as amended",7,0,0,0,7
851882,560447,2016-08-19,Senate,"Assembly 3rd Reading AB2179 Gipson By Mitchell",36,0,3,0,39
851882,561065,2016-08-24,Assembly,"AB 2179 GIPSON  Concurrence in Senate Amendments",79,1,0,0,80
851883,542376,2016-05-03,Senate,"Do pass",2,4,1,0,7
851883,542377,2016-05-03,Senate,"Set, first hearing.  Failed passage in Committee.  Reconsideration 	granted",6,0,1,0,7
851885,544787,2016-05-09,Assembly,"Do pass as amended and be re-referred to the Committee on 	Appropriations",9,0,0,0,9
851885,549260,2016-05-27,Assembly,"Do pass as amended",20,0,0,0,20
851885,550970,2016-06-02,Assembly,"AB 2334 MULLIN  Assembly Third Reading",78,0,0,2,80
851885,555116,2016-06-22,Senate,"Do pass, but re-refer to the Committee on Appropriations",5,0,2,0,7
851885,558982,2016-08-01,Senate,"Placed on Appropriations Suspense file",7,0,0,0,7
851886,535120,2016-04-19,Senate,"Do pass as amended, and re-refer to the Committee on Appropriations",10,0,1,0,11
851886,545999,2016-05-16,Senate,"Placed on Appropriations Suspense file",7,0,0,0,7
851886,549340,2016-05-27,Senate,"Do pass",6,1,0,0,7
851886,550098,2016-05-31,Senate,"Senate 3rd Reading SB1212 Hueso",35,3,2,0,40
851886,556921,2016-06-29,Assembly,"Do pass and be re-referred to the Committee on Appropriations to 	Consent Calendar",15,0,0,0,15
851886,559401,2016-08-11,Assembly,"Do pass as amended",15,0,0,5,20
851886,560803,2016-08-23,Assembly,"SB 1212 Hueso  Senate Third Reading  By DODD",79,0,0,1,80
851886,561144,2016-08-25,Senate,"Unfinished Business SB1212 Hueso Concurrence",37,1,1,0,39
851887,544313,2016-05-09,Assembly,"Do pass as amended and be re-referred to the Committee on 	Appropriations",9,0,0,0,9
851887,548341,2016-05-25,Assembly,"Do pass, to Consent Calendar",20,0,0,0,20
851887,550149,2016-05-31,Assembly,"AB 2365 GIPSON  Consent Calendar Second Day  Regular Session",80,0,0,0,80
851887,556464,2016-06-29,Senate,"Do pass, but re-refer to the Committee on Appropriations Recommend 	Consent",7,0,0,0,7
851887,559431,2016-08-11,Senate,"Consent Calendar 2nd AB2365 Gipson",37,0,2,0,39
851888,531930,2016-04-12,Assembly,"Do pass as amended and be re-referred to the Committee on Judiciary",5,1,0,1,7
851888,538535,2016-04-26,Assembly,"Do pass as amended",9,0,0,1,10
851888,543048,2016-05-05,Assembly,"AB 2362 CHU  Assembly Third Reading",76,0,0,4,80
851888,555049,2016-06-21,Senate,"Do pass",7,0,0,0,7
851888,560112,2016-08-17,Senate,"Assembly 3rd Reading AB2362 Chu By Hueso",39,0,0,0,39
851889,527976,2016-04-04,Assembly,"Do pass and be re-referred to the Committee on Judiciary",11,1,0,0,12
851889,531560,2016-04-12,Assembly,"Do pass as amended and be re-referred to the Committee on 	Appropriations",10,0,0,0,10
851890,532505,2016-04-11,Assembly,"Do pass and be re-referred to the Committee on Appropriations",15,0,0,1,16
851890,549357,2016-05-27,Assembly,"Do pass as amended",19,1,0,0,20
851890,551151,2016-06-02,Assembly,"AB 2322 CHU  Assembly Third Reading",67,12,0,1,80
851890,558969,2016-08-01,Senate,"Placed on Appropriations Suspense file",7,0,0,0,7
851891,542361,2016-05-04,Assembly,"Do pass as amended",13,0,0,0,13
851891,547539,2016-05-23,Assembly,"AB 2230 CHU  Assembly Third Reading",77,0,0,3,80
851891,556330,2016-06-29,Senate,"Do pass, but re-refer to the Committee on Rules",5,0,0,0,5
851891,559793,2016-08-15,Senate,"Assembly 3rd Reading AB2230 Chu By Mendoza",38,0,1,0,39
851891,560669,2016-08-22,Assembly,"Senate amendments be concurred in",7,0,0,0,7
851891,560976,2016-08-24,Assembly,"AB 2230 CHU  Concurrence in Senate Amendments",80,0,0,0,80
851892,538692,2016-04-26,Assembly,"Do pass, to Consent Calendar",16,0,0,0,16
851892,540870,2016-05-02,Assembly,"AB 2217 HADLEY  Consent Calendar Second Day  Regular Session",76,0,0,4,80
851892,553127,2016-06-14,Senate,"Do pass and be placed on the Consent Calendar",7,0,0,0,7
851892,558641,2016-08-01,Senate,"Assembly 3rd Reading AB2217 Hadley By Moorlach",38,1,0,0,39
851893,527946,2016-04-04,Assembly,"Do pass as amended and be re-referred to the Committee on 	Appropriations",9,0,0,0,9
851894,534280,2016-04-18,Assembly,"Do pass and be re-referred to the Committee on Appropriations to 	Consent Calendar",15,0,0,1,16
851894,549390,2016-05-27,Assembly,"Do pass as amended",20,0,0,0,20
851894,550515,2016-06-01,Assembly,"AB 2175 JONES  Assembly Third Reading",80,0,0,0,80
851895,533128,2016-04-13,Assembly,"Do pass as amended and be re-referred to the Committee on 	Appropriations",10,3,0,2,15
851897,528980,2016-04-06,Assembly,"Do pass and be re-referred to the Committee on Aging and Long",13,0,0,0,13
851897,535616,2016-04-19,Assembly,"Do pass and be re-referred to the Committee on Appropriations",6,0,0,1,7
851897,542431,2016-05-04,Assembly,"Do pass, to Consent Calendar",20,0,0,0,20
851897,545308,2016-05-12,Assembly,"AB 2366 DABABNEH  Consent Calendar Second Day  Regular Session",78,0,0,2,80
851897,555062,2016-06-22,Senate,"Do pass, but re-refer to the Committee on Appropriations",8,0,1,0,9
851897,561255,2016-08-25,Senate,"Assembly 3rd Reading AB2366 Dababneh By Gaines",37,0,2,0,39
851897,561564,2016-08-30,Assembly,"AB 2366 DABABNEH  Concurrence in Senate Amendments",80,0,0,0,80
851898,528087,2016-04-05,Assembly,"Amend, and do pass as amended and be re-referred to the Committee 	on Appropriations with the recommendation:  To Consent Calendar",7,0,0,0,7
851898,539383,2016-04-27,Assembly,"Do pass, to Consent Calendar",19,0,0,1,20
851898,543077,2016-05-05,Assembly,"AB 2278 LINDER  Consent Calendar Second Day  Regular Session",79,0,0,1,80
851898,554909,2016-06-21,Senate,"Do pass, but re-refer to the Committee on Appropriations Recommend 	Consent",7,0,0,0,7
851898,558944,2016-08-01,Senate,"Placed on Appropriations Suspense file",7,0,0,0,7
851899,535050,2016-04-18,Assembly,"Do pass as amended and be re-referred to the Committee on 	Appropriations",9,0,0,0,9
851900,525890,2016-03-29,Assembly,"Do pass as amended and be re-referred to the Committee on 	Appropriations",9,0,0,1,10
851900,532468,2016-04-13,Assembly,"Do pass, to Consent Calendar",20,0,0,0,20
851900,537405,2016-04-21,Assembly,"AB 2219 WAGNER  Consent Calendar Second Day  Regular Session",79,0,0,1,80
851900,554957,2016-06-21,Senate,"Do pass as amended, and re-refer to the Committee on Appropriations",2,5,0,0,7
851900,554958,2016-06-21,Senate,"Set, first hearing.  Failed passage in Committee.  Reconsideration 	granted",7,0,0,0,7
851902,532874,2016-04-11,Assembly,"Do pass as amended and be re-referred to the Committee on 	Appropriations",16,0,0,0,16
851904,533188,2016-04-13,Assembly,"Do pass as amended and be re-referred to the Committee on 	Appropriations",7,0,0,0,7
851904,538994,2016-04-27,Assembly,"Do pass, to Consent Calendar",19,0,0,1,20
851904,543138,2016-05-05,Assembly,"AB 2248 HOLDEN  Consent Calendar Second Day  Regular Session",79,0,0,1,80
851904,552159,2016-06-08,Senate,"Do pass, but re-refer to the Committee on Appropriations Recommend 	Consent",9,0,0,0,9
851904,556908,2016-06-30,Senate,"Consent Calendar 2nd AB2248 Holden",37,0,3,0,40
851905,525908,2016-03-29,Assembly,"Do pass as amended and be re-referred to the Committee on Judiciary",15,0,0,0,15
851905,531947,2016-04-12,Assembly,"Amend, and do pass as amended and be re-referred to the Committee 	on Appropriations with the recommendation:  To Consent Calendar",10,0,0,0,10
851905,549347,2016-05-27,Assembly,"Do pass as amended",20,0,0,0,20
851905,550920,2016-06-02,Assembly,"AB 2249 COOLEY  Assembly Third Reading",80,0,0,0,80
851905,552761,2016-06-14,Senate,"Do pass, but re-refer to the Committee on Judiciary",9,0,0,0,9
851905,556669,2016-06-28,Senate,"Do pass as amended, and re-refer to the Committee on Appropriations",7,0,0,0,7
851905,559644,2016-08-11,Senate,"Do pass",7,0,0,0,7
851905,560834,2016-08-23,Senate,"Assembly 3rd Reading AB2249 Cooley By Pavley",39,0,0,0,39
851905,561456,2016-08-29,Assembly,"AB 2249 COOLEY  Concurrence in Senate Amendments",80,0,0,0,80
851906,537366,2016-04-20,Assembly,"Do pass as amended and be re-referred to the Committee on 	Appropriations",14,0,0,1,15
851908,530485,2016-04-11,Senate,"Do pass, but re-refer to the Committee on Appropriations",8,0,1,0,9
851908,544341,2016-04-25,Senate,"Placed on Appropriations Suspense file",7,0,0,0,7
851908,549019,2016-05-27,Senate,"Do pass",6,0,1,0,7
851908,549947,2016-05-31,Senate,"Senate 3rd Reading SB1174 McGuire",36,3,1,0,40
851908,555016,2016-06-21,Assembly,"Do pass as amended and be re-referred to the Committee on Business 	and Professions",13,0,0,5,18
851908,555963,2016-06-28,Assembly,"Do pass and be re-referred to the Committee on Appropriations",16,0,0,0,16
851908,559534,2016-08-10,Assembly,"Do pass",19,0,0,1,20
851908,560373,2016-08-19,Assembly,"SB 1174 McGuire  Senate Third Reading  Amendment  Set #1",73,0,0,7,80
851908,560653,2016-08-23,Assembly,"SB 1174 McGuire  Senate Third Reading  By BURKE",80,0,0,0,80
851908,561137,2016-08-25,Senate,"Unfinished Business SB1174 McGuire Concurrence",38,0,1,0,39
851909,530705,2016-04-11,Senate,"Do pass, but re-refer to the Committee on Appropriations Recommend 	Consent",5,0,0,0,5
851909,537285,2016-04-21,Senate,"Consent Calendar 2nd SB1162 Berryhill",39,0,1,0,40
851909,555065,2016-06-22,Assembly,"Do pass and be re-referred to the Committee on Appropriations to 	Consent Calendar",6,0,0,1,7
851909,556411,2016-06-29,Assembly,"Do pass, to Consent Calendar",18,0,0,2,20
851909,559128,2016-08-04,Assembly,"SB 1162 Berryhill, T.  Consent Calendar Second Day  Regular Session",77,0,0,3,80
851909,560173,2016-08-18,Senate,"Special Consent SB1162 Berryhill",36,0,3,0,39
851910,532943,2016-04-13,Assembly,"Do pass and be re-referred to the Committee on Education",5,1,0,1,7
851910,537367,2016-04-20,Assembly,"Do pass and be re-referred to the Committee on Appropriations",5,0,0,2,7
851911,534863,2016-04-19,Assembly,"Amend, and do pass as amended and be re-referred to the Committee 	on Appropriations with the recommendation:  To Consent Calendar",16,0,0,3,19
851911,549272,2016-05-27,Assembly,"Do pass",20,0,0,0,20
851911,550064,2016-05-31,Assembly,"AB 2207 WOOD  Assembly Third Reading",80,0,0,0,80
851911,555374,2016-06-22,Senate,"Do pass as amended, and re-refer to the Committee on Appropriations",9,0,0,0,9
851911,558720,2016-08-01,Senate,"Placed on Appropriations Suspense file",7,0,0,0,7
851911,559708,2016-08-11,Senate,"Do pass as amended",7,0,0,0,7
851911,560228,2016-08-18,Senate,"Assembly 3rd Reading AB2207 Wood By Pan",38,0,1,0,39
851911,560954,2016-08-24,Assembly,"AB 2207 WOOD  Concurrence in Senate Amendments",80,0,0,0,80
851915,535224,2016-04-19,Senate,"Do pass as amended, but re-refer to the Committee on Appropriations 	Recommend Consent",7,0,0,0,7
851915,545189,2016-05-12,Senate,"Consent Calendar 2nd SB1179 Vidak",38,0,2,0,40
851915,552043,2016-06-08,Assembly,"Do pass and be re-referred to the Committee on Local Government to 	Consent Calendar",9,0,0,1,10
851915,556829,2016-06-29,Assembly,"Do pass and be re-referred to the Committee on Appropriations to 	Consent Calendar",9,0,0,0,9
851915,559014,2016-08-03,Assembly,"Do pass, to Consent Calendar",20,0,0,0,20
851915,559308,2016-08-11,Assembly,"SB 1179 Vidak  Consent Calendar Second Day  Regular Session",78,0,0,2,80
851915,560184,2016-08-18,Senate,"Special Consent SB1179 Vidak",36,0,3,0,39
852974,532244,2016-04-12,Senate,"Do pass as amended, and re-refer to the Committee on Judiciary",4,0,1,0,5
852974,542879,2016-05-03,Senate,"Do pass, but re-refer to the Committee on Rules",6,0,1,0,7
852974,550044,2016-05-31,Senate,"Senate 3rd Reading SB1336 Jackson",38,1,1,0,40
852974,554686,2016-06-21,Assembly,"Do pass and be re-referred to the Committee on Human Services",8,0,0,2,10
852974,556062,2016-06-28,Assembly,"Do pass as amended",5,0,0,2,7
852974,559639,2016-08-10,Assembly,"Do pass",19,0,0,1,20
852974,560374,2016-08-19,Assembly,"SB 1336 Jackson  Senate Third Reading  Amend By ARAMBULA  Set #2",49,20,0,11,80
852974,561062,2016-08-24,Assembly,"Do pass as amended",5,0,0,2,7
852974,561570,2016-08-30,Assembly,"SB 1336 Jackson  Senate Third Reading  By ARAMBULA",76,0,0,4,80
852974,561683,2016-08-31,Senate,"Unfinished Business SB1336 Jackson Concurrence",39,0,0,0,39
852975,527664,2016-04-04,Assembly,"Do pass and be re-referred to the Committee on Appropriations",16,0,0,0,16
852975,536527,2016-04-20,Assembly,"Do pass, to Consent Calendar",16,0,0,4,20
852975,539654,2016-04-28,Assembly,"AB 2469 FRAZIER  Consent Calendar Second Day  Regular Session",76,0,0,4,80
852975,554911,2016-06-21,Senate,"Do pass, but re-refer to the Committee on Appropriations Recommend 	Consent",11,0,0,0,11
852975,559460,2016-08-11,Senate,"Consent Calendar 2nd AB2469 Frazier Urgency Clause",37,0,2,0,39
852975,559843,2016-08-15,Assembly,"AB 2469 FRAZIER  Concurrence in Senate Amendments",78,0,0,2,80
852976,544452,2016-05-09,Assembly,"Do pass and be re-referred to the Committee on Appropriations",3,4,0,2,9
852977,529317,2016-04-06,Assembly,"Do pass and be re-referred to the Committee on Appropriations",5,1,0,1,7
852978,541396,2016-05-03,Assembly,"Do pass as amended",10,0,0,0,10
852978,546587,2016-05-18,Assembly,"Do pass, to Consent Calendar",20,0,0,0,20
852978,550000,2016-05-31,Assembly,"AB 2427 CHAU  Assembly Third Reading",80,0,0,0,80
852978,554939,2016-06-21,Senate,"Do pass as amended, and re-refer to the Committee on Appropriations",7,0,0,0,7
852978,560944,2016-08-24,Senate,"Assembly 3rd Reading AB2427 Chau By Block",39,0,0,0,39
852978,561593,2016-08-30,Assembly,"AB 2427 CHAU  Concurrence in Senate Amendments",79,0,0,1,80
852979,532527,2016-04-13,Senate,"Do pass, but re-refer to the Committee on Appropriations",5,0,0,0,5
852979,544560,2016-04-25,Senate,"Placed on Appropriations Suspense file",7,0,0,0,7
852979,549337,2016-05-27,Senate,"Do pass as amended",7,0,0,0,7
852979,551147,2016-06-02,Senate,"Special Consent # SB1379 Mendoza",39,0,1,0,40
852979,555069,2016-06-22,Assembly,"Do pass and be re-referred to the Committee on Appropriations to 	Consent Calendar",13,0,0,0,13
852979,559073,2016-08-03,Assembly,"Do pass, to Consent Calendar",20,0,0,0,20
852979,560449,2016-08-19,Assembly,"SB 1379 Mendoza  Senate Third Reading  By CALDERON  Amend By 	CALDERON  Set #1",48,11,0,21,80
852979,561656,2016-08-30,Assembly,"Do pass",9,3,0,1,13
852979,561833,2016-08-31,Assembly,"SB 1379 Mendoza  Senate Third Reading  By MEDINA",50,27,0,3,80
852979,561834,2016-08-31,Senate,"W/O REF. TO FILE SB1379 Mendoza",21,16,2,0,39
852980,538558,2016-04-26,Assembly,"Do pass as amended",7,3,0,0,10
852980,543114,2016-05-05,Assembly,"AB 2748 GATTO  Assembly Third Reading",30,32,0,18,80
852980,551068,2016-06-02,Assembly,"Do pass as amended",7,3,0,0,10
852980,551069,2016-06-02,Assembly,"AB 2748 GATTO  Assembly Third Reading",53,18,0,9,80
852980,554952,2016-06-21,Senate,"Do pass, but re-refer to the Committee on Environmental Quality",4,2,1,0,7
852980,556359,2016-06-29,Senate,"Do pass",5,2,0,0,7
852980,560696,2016-08-23,Senate,"Assembly 3rd Reading AB2748 Gatto By Monning",23,13,3,0,39
852980,561534,2016-08-30,Assembly,"AB 2748 GATTO  Concurrence in Senate Amendments",54,23,0,3,80
852983,528282,2016-04-05,Assembly,"Do pass as amended and be re-referred to the Committee on Business 	and Professions",11,0,0,2,13
852983,531407,2016-04-12,Assembly,"Do pass as amended and be re-referred to the Committee on 	Appropriations",15,0,0,1,16
852983,549439,2016-05-27,Assembly,"Do pass as amended",20,0,0,0,20
852983,550925,2016-06-02,Assembly,"AB 2581 MEDINA  Third Reading Urgency",62,12,0,6,80
852984,534809,2016-04-19,Assembly,"Do pass and be re-referred to the Committee on Appropriations",7,0,0,0,7
852984,542199,2016-05-04,Assembly,"Do pass",20,0,0,0,20
852984,545211,2016-05-12,Assembly,"AB 2510 LINDER  Assembly Third Reading",77,0,0,3,80
852984,554652,2016-06-21,Senate,"Do pass, but re-refer to the Committee on Appropriations",7,0,0,0,7
852984,559834,2016-08-15,Senate,"Assembly 3rd Reading AB2510 Linder By Glazer",36,0,3,0,39
852984,560506,2016-08-22,Assembly,"AB 2510 LINDER  Concurrence in Senate Amendments",78,0,0,2,80
852985,526587,2016-03-30,Senate,"Do pass as amended, and re-refer to the Committee on Appropriations",8,1,0,0,9
852985,534111,2016-04-18,Senate,"Placed on Appropriations Suspense file",7,0,0,0,7
852985,549309,2016-05-27,Senate,"Do pass",6,0,1,0,7
852985,549959,2016-05-31,Senate,"Senate 3rd Reading SB1460 Leno",31,8,1,0,40
852986,537341,2016-04-20,Assembly,"Do pass and be re-referred to the Committee on Appropriations to 	Consent Calendar",7,0,0,0,7
852987,542818,2016-05-04,Assembly,"Do pass",2,3,0,2,7
852989,535470,2016-04-19,Assembly,"Do pass",3,3,0,1,7
852991,535287,2016-04-18,Assembly,"Do pass as amended and be re-referred to the Committee on 	Appropriations",6,1,0,2,9
852993,542720,2016-05-04,Assembly,"Do pass as amended",7,0,0,0,7
852993,549167,2016-05-27,Assembly,"AB 2826 WEBER  Assembly Third Reading",68,0,0,12,80
852993,556648,2016-06-29,Senate,"Do pass and be placed on the Consent Calendar",9,0,0,0,9
852993,559524,2016-08-11,Senate,"Consent Calendar 2nd AB2826 Weber",37,0,2,0,39
852993,560297,2016-08-18,Assembly,"AB 2826 WEBER  Concurrence in Senate Amendments",78,0,0,2,80
852994,535627,2016-04-19,Senate,"Do pass, but re-refer to the Committee on Appropriations",11,0,0,0,11
852994,548703,2016-05-26,Senate,"Senate 3rd Reading SB1298 Hertzberg",39,0,1,0,40
852994,557128,2016-06-29,Assembly,"Do pass as amended",5,3,0,1,9
852994,559364,2016-08-11,Assembly,"SB 1298 Hertzberg  Senate Third Reading  By GORDON  Amend By GORDON 	Set #1",49,27,0,4,80
852995,531341,2016-04-12,Senate,"Do pass, but re-refer to the Committee on Appropriations",10,0,3,0,13
852995,544710,2016-04-25,Senate,"Placed on Appropriations Suspense file",7,0,0,0,7
852995,549292,2016-05-27,Senate,"Do pass",7,0,0,0,7
852995,550089,2016-05-31,Senate,"Senate 3rd Reading SB1385 Leyva",39,0,1,0,40
852995,556914,2016-06-30,Assembly,"Do pass and be re-referred to the Committee on Appropriations",20,0,0,1,21
852995,559406,2016-08-11,Assembly,"Do pass as amended",20,0,0,0,20
852995,561030,2016-08-24,Assembly,"SB 1385 Leyva  Senate Third Reading  By BROWN",80,0,0,0,80
852995,561829,2016-08-31,Senate,"Unfinished Business SB1385 Leyva Concurrence",39,0,0,0,39
852998,537623,2016-04-20,Assembly,"Do pass and be re-referred to the Committee on Appropriations to 	Consent Calendar",7,0,0,0,7
852998,549384,2016-05-27,Assembly,"Do pass as amended",20,0,0,0,20
852998,550891,2016-06-02,Assembly,"AB 2656 O'DONNELL  Assembly Third Reading",80,0,0,0,80
852998,555109,2016-06-22,Senate,"Do pass, but re-refer to the Committee on Appropriations Recommend 	Consent",9,0,0,0,9
852998,558874,2016-08-01,Senate,"Placed on Appropriations Suspense file",7,0,0,0,7
852998,559720,2016-08-11,Senate,"Do pass",7,0,0,0,7
852998,560303,2016-08-18,Senate,"Assembly 3rd Reading AB2656 O'Donnell By McGuire",38,0,1,0,39
852998,561637,2016-08-30,Assembly,"AB 2656 O'DONNELL  Concurrence in Senate Amendments",80,0,0,0,80
853000,544542,2016-05-09,Assembly,"Do pass as amended and be re-referred to the Committee on 	Appropriations",9,0,0,0,9
853001,537531,2016-04-20,Assembly,"Do pass and be re-referred to the Committee on Appropriations to 	Consent Calendar",14,0,0,1,15
853001,542460,2016-05-04,Assembly,"Do pass, to Consent Calendar",20,0,0,0,20
853001,545318,2016-05-12,Assembly,"AB 2798 GATTO  Consent Calendar Second Day  Regular Session",78,0,0,2,80
853001,552641,2016-06-13,Senate,"Do pass as amended, and re-refer to the Committee on Appropriations",10,1,0,0,11
853002,539314,2016-04-26,Senate,"Do pass",6,1,0,0,7
853002,544233,2016-05-09,Senate,"Senate 3rd Reading SB1351 De Le",32,1,7,0,40
853003,536050,2016-04-20,Senate,"Do pass as amended, and re-refer to the Committee on Appropriations",7,0,0,0,7
853003,549130,2016-05-27,Senate,"Senate 3rd Reading SB1416 Stone",37,0,3,0,40
853003,554629,2016-06-20,Assembly,"Do pass and be re-referred to the Committee on Appropriations to 	Consent Calendar",9,0,0,0,9
853003,558995,2016-08-03,Assembly,"Do pass, to Consent Calendar",20,0,0,0,20
853003,559259,2016-08-11,Assembly,"SB 1416 Stone  Consent Calendar Second Day  Regular Session",78,0,0,2,80
853003,559931,2016-08-16,Senate,"Unfinished Business SB1416 Stone Concurrence",37,0,2,0,39
853004,537352,2016-04-20,Assembly,"Do pass as amended and be re-referred to the Committee on 	Appropriations",7,0,0,0,7
853004,546625,2016-05-18,Assembly,"Do pass, to Consent Calendar",20,0,0,0,20
853004,549278,2016-05-27,Assembly,"AB 2845 WILLIAMS  Consent Calendar Second Day  Regular Session",67,0,0,13,80
853004,553174,2016-06-15,Senate,"Do pass, but re-refer to the Committee on Appropriations",9,0,0,0,9
853004,558764,2016-08-01,Senate,"Placed on Appropriations Suspense file",7,0,0,0,7
853004,559516,2016-08-11,Senate,"Do pass",6,1,0,0,7
853004,560326,2016-08-18,Senate,"Assembly 3rd Reading AB2845 Williams By Pan",34,3,2,0,39
853004,560911,2016-08-24,Assembly,"AB 2845 WILLIAMS  Concurrence in Senate Amendments",79,0,0,1,80
853005,532684,2016-04-13,Assembly,"Do pass and be re-referred to the Committee on Appropriations",7,0,0,0,7
853005,549040,2016-05-27,Assembly,"Do pass",20,0,0,0,20
853005,550212,2016-05-31,Assembly,"AB 2823 GATTO  Assembly Third Reading",78,1,0,1,80
853005,555574,2016-06-27,Senate,"Do pass, but re-refer to the Committee on Judiciary",0,4,1,0,5
853006,534891,2016-04-19,Assembly,"Do pass as amended and be re-referred to the Committee on 	Appropriations",11,5,0,3,19
853006,546622,2016-05-18,Assembly,"Do pass",14,6,0,0,20
853006,549920,2016-05-31,Assembly,"AB 2436 HERNANDEZ  Assembly Third Reading",25,38,0,17,80
853008,532520,2016-04-13,Senate,"Do pass, but re-refer to the Committee on Appropriations",1,3,1,0,5
853008,532521,2016-04-13,Senate,"Reconsideration granted",4,0,1,0,5
853009,533431,2016-04-13,Assembly,"Do pass as amended and be re-referred to the Committee on 	Appropriations",10,3,0,2,15
853009,549427,2016-05-27,Assembly,"Do pass as amended",14,6,0,0,20
853009,551162,2016-06-02,Assembly,"AB 2460 IRWIN  Assembly Third Reading",52,26,0,2,80
853009,555702,2016-06-27,Senate,"Do pass, but re-refer to the Committee on Appropriations",6,3,2,0,11
853009,558812,2016-08-01,Senate,"Placed on Appropriations Suspense file",7,0,0,0,7
853010,531440,2016-04-12,Senate,"Do pass, but re-refer to the Committee on Environmental Quality",7,3,1,0,11
853010,536561,2016-04-20,Senate,"Do pass, but re-refer to the Committee on Appropriations",5,2,0,0,7
853010,545973,2016-05-16,Senate,"Placed on Appropriations Suspense file",7,0,0,0,7
853010,549192,2016-05-27,Senate,"Do pass",5,2,0,0,7
853010,550475,2016-06-01,Senate,"Senate 3rd Reading SB1277 Hancock",26,13,1,0,40
853010,559912,2016-06-27,Assembly,"Do pass and be re-referred to the Committee on Appropriations",6,3,0,0,9
853011,533168,2016-04-13,Assembly,"Do pass and be re-referred to the Committee on Appropriations to 	Consent Calendar",10,0,0,0,10
853011,539457,2016-04-27,Assembly,"Do pass, to Consent Calendar",19,0,0,1,20
853011,543051,2016-05-05,Assembly,"AB 2635 AGRI.  Consent Calendar Second Day  Regular Session",79,0,0,1,80
853011,554910,2016-06-21,Senate,"Do pass, but re-refer to the Committee on Appropriations Recommend 	Consent",5,0,0,0,5
853011,559669,2016-08-11,Senate,"Do pass",7,0,0,0,7
853011,560311,2016-08-18,Senate,"Assembly 3rd Reading AB2635 Committee On AGRI.(Dodd) By Pan",38,0,1,0,39
853012,527455,2016-04-04,Assembly,"Be referred to Committee on Accountability and Administrative 	Review",8,2,0,1,11
853012,532223,2016-04-13,Assembly,"Do pass and be re-referred to the Committee on Judiciary",5,1,0,3,9
853012,535257,2016-04-19,Assembly,"Do pass as amended and be re-referred to the Committee on 	Appropriations",10,0,0,0,10
853012,549351,2016-05-27,Assembly,"Do pass as amended",11,0,0,9,20
853012,551075,2016-06-02,Assembly,"AB 2844 BLOOM  Assembly Third Reading  Motion to  Suspend the Rules 	By ALLEN",26,50,0,4,80
853012,551076,2016-06-02,Assembly,"AB 2844 BLOOM  Assembly Third Reading",64,0,0,16,80
853012,556544,2016-06-28,Senate,"Do pass, but re-refer to the Committee on Appropriations",5,2,0,0,7
853012,558897,2016-08-01,Senate,"Placed on Appropriations Suspense file",7,0,0,0,7
853012,559522,2016-08-11,Senate,"Do pass as amended",4,0,3,0,7
853012,559523,2016-08-11,Senate,"Set, first hearing.  Held in Committee.  Reconsideration of 	favorable vote granted",6,0,1,0,7
853012,560959,2016-08-24,Senate,"Assembly 3rd Reading AB2844 Bloom By Block",34,1,4,0,39
853012,561626,2016-08-30,Assembly,"AB 2844 BLOOM  Concurrence in Senate Amendments",69,1,0,10,80
853014,532926,2016-04-13,Assembly,"Do pass and be re-referred to the Committee on Public Safety to 	Consent Calendar",10,0,0,0,10
853014,535240,2016-04-19,Assembly,"Do pass, to Consent Calendar",7,0,0,0,7
853014,539792,2016-04-28,Assembly,"AB 2805 OLSEN  Consent Calendar Second Day  Regular Session",76,0,0,4,80
853014,556311,2016-06-28,Senate,"Do pass and be placed on the Consent Calendar",7,0,0,0,7
853014,559352,2016-08-11,Senate,"Placed on Appropriations Suspense file",7,0,0,0,7
853014,559353,2016-08-11,Senate,"Do pass as amended",7,0,0,0,7
853014,560032,2016-08-17,Senate,"Assembly 3rd Reading AB2805 Olsen By Cannella",39,0,0,0,39
853014,560680,2016-08-23,Assembly,"AB 2805 OLSEN  Concurrence in Senate Amendments",80,0,0,0,80
853015,528112,2016-04-05,Senate,"Do pass and be placed on the Consent Calendar",7,0,0,0,7
853015,530431,2016-04-11,Senate,"Consent Calendar 2nd SB1452 Wieckowski",36,0,4,0,40
853015,552130,2016-06-08,Assembly,"Do pass, to Consent Calendar",9,0,0,1,10
853016,526475,2016-03-30,Senate,"Do pass as amended, and re-refer to the Committee on Appropriations",8,0,1,0,9
853016,534575,2016-04-18,Senate,"Placed on Appropriations Suspense file",7,0,0,0,7
853016,549091,2016-05-27,Senate,"Do pass as amended",7,0,0,0,7
853016,550909,2016-06-02,Senate,"Special Consent # SB1375 Jackson",39,0,1,0,40
853016,553686,2016-06-15,Assembly,"Do pass and be re-referred to the Committee on Arts, Entertain, 	Sports, Tourism, & Internet Media to Consent Calendar",7,0,0,0,7
853016,554740,2016-06-21,Assembly,"Do pass and be re-referred to the Committee on Appropriations to 	Consent Calendar",7,0,0,0,7
853016,559518,2016-08-11,Assembly,"Do pass",20,0,0,0,20
853016,560865,2016-08-23,Assembly,"SB 1375 Jackson  Senate Third Reading  By BONILLA",80,0,0,0,80
853016,561038,2016-08-24,Senate,"Unfinished Business SB1375 Jackson Concurrence",39,0,0,0,39
853017,532680,2016-04-13,Assembly,"Do pass and be re-referred to the Committee on Appropriations",5,2,0,0,7
853017,538932,2016-04-27,Assembly,"Do pass as amended",13,5,0,2,20
853017,547632,2016-05-23,Assembly,"AB 2455 CHIU  Assembly Third Reading",52,23,0,5,80
853017,553123,2016-06-15,Senate,"Do pass, but re-refer to the Committee on Elections and 	Constitutional Amendments",7,2,0,0,9
853017,554712,2016-06-21,Senate,"Do pass, but re-refer to the Committee on Appropriations",4,1,0,0,5
853017,558824,2016-08-01,Senate,"Do pass",4,2,1,0,7
853017,560238,2016-08-18,Senate,"Assembly 3rd Reading AB2455 Chiu By Allen",26,12,1,0,39
853017,561018,2016-08-24,Assembly,"AB 2455 CHIU  Concurrence in Senate Amendments",55,24,0,1,80
853018,535680,2016-04-19,Assembly,"Do pass as amended and be re-referred to the Committee on 	Appropriations",12,5,0,2,19
853018,549276,2016-05-27,Assembly,"Do pass",14,6,0,0,20
853018,550723,2016-06-01,Assembly,"AB 2640 GIPSON  Assembly Third Reading",57,20,0,3,80
853018,557078,2016-06-29,Senate,"Do pass as amended, and re-refer to the Committee on Appropriations",7,1,1,0,9
853018,559186,2016-08-08,Senate,"Placed on Appropriations Suspense file",7,0,0,0,7
853018,559660,2016-08-11,Senate,"Do pass as amended",5,2,0,0,7
853018,560307,2016-08-18,Senate,"Assembly 3rd Reading AB2640 Gipson By Lara",26,11,2,0,39
853018,561091,2016-08-24,Assembly,"AB 2640 GIPSON  Concurrence in Senate Amendments",60,18,0,2,80
853021,535184,2016-04-19,Assembly,"Do pass as amended and be re-referred to the Committee on 	Appropriations",14,1,0,4,19
853021,549232,2016-05-27,Assembly,"Do pass as amended",14,6,0,0,20
853021,550906,2016-06-02,Assembly,"AB 2439 NAZARIAN  Assembly Third Reading",54,24,0,2,80
853021,557121,2016-06-29,Senate,"Do pass as amended, and re-refer to the Committee on Appropriations",7,0,2,0,9
853021,559734,2016-08-11,Senate,"Do pass as amended",5,2,0,0,7
853021,560821,2016-08-23,Senate,"Assembly 3rd Reading AB2439 Nazarian By Hall",32,7,0,0,39
853021,561481,2016-08-29,Assembly,"AB 2439 NAZARIAN  Concurrence in Senate Amendments",59,21,0,0,80
853023,535306,2016-04-19,Assembly,"Do pass and be re-referred to the Committee on Appropriations to 	Consent Calendar",7,0,0,0,7
853023,537276,2016-04-21,Assembly,"Do pass and be re-referred to the Committee on Appropriations",8,3,0,4,15
853023,549349,2016-05-27,Assembly,"Do pass as amended",14,2,0,4,20
853023,551103,2016-06-02,Assembly,"AB 2777 NAZARIAN  Assembly Third Reading",23,34,0,23,80
853024,531678,2016-04-12,Assembly,"Do pass and be re-referred to the Committee on Appropriations to 	Consent Calendar",10,0,0,0,10
853024,539532,2016-04-27,Assembly,"Do pass, to Consent Calendar",19,0,0,1,20
853024,543173,2016-05-05,Assembly,"AB 2843 CHAU  Consent Calendar Second Day  Regular Session",79,0,0,1,80
853024,554998,2016-06-21,Senate,"Do pass as amended, but re-refer to the Committee on Appropriations 	Recommend Consent",7,0,0,0,7
853024,560614,2016-08-22,Senate,"Assembly 3rd Reading AB2843 Chau By Wieckowski",38,0,1,0,39
853024,561314,2016-08-25,Assembly,"AB 2843 CHAU  Concurrence in Senate Amendments",79,0,0,1,80
853025,530442,2016-04-11,Assembly,"Do pass as amended and be re-referred to the Committee on 	Appropriations",9,0,0,0,9
853025,534927,2016-04-19,Assembly,"Do pass and be re-referred to the Committee on Appropriations",6,0,0,1,7
853025,544848,2016-05-11,Assembly,"Do pass, to Consent Calendar",20,0,0,0,20
853025,547004,2016-05-19,Assembly,"AB 2497 WAGNER  Consent Calendar Second Day  Regular Session",76,0,0,4,80
853025,553177,2016-06-15,Senate,"Do pass, but re-refer to the Committee on Appropriations",7,0,0,0,7
853025,558717,2016-08-01,Senate,"Placed on Appropriations Suspense file",7,0,0,0,7
853026,534843,2016-04-19,Assembly,"Do pass and be re-referred to the Committee on Appropriations",5,2,0,0,7
853028,534878,2016-04-19,Senate,"Do pass, but re-refer to the Committee on Appropriations",5,2,0,0,7
853028,545786,2016-05-16,Senate,"Placed on Appropriations Suspense file",2,5,0,0,7
853028,545787,2016-05-16,Senate,"Do pass",5,2,0,0,7
853028,547042,2016-05-19,Senate,"Senate 3rd Reading SB1407 De Le",24,14,2,0,40
853028,552706,2016-06-14,Assembly,"Do pass and be re-referred to the Committee on Appropriations",5,2,0,0,7
853028,559592,2016-08-10,Assembly,"Do pass",14,5,0,1,20
853029,539223,2016-04-26,Senate,"Do pass",6,0,1,0,7
853029,540934,2016-05-02,Senate,"Senate 3rd Reading SB1342 Mendoza",38,0,2,0,40
853029,552166,2016-06-08,Assembly,"Do pass, to Consent Calendar",9,0,0,1,10
853029,553682,2016-06-16,Assembly,"SB 1342 Mendoza  Consent Calendar Second Day  Regular Session",78,0,0,2,80
853029,556904,2016-06-30,Senate,"Special Consent # SB1342 Mendoza",37,0,3,0,40
853031,532538,2016-04-13,Assembly,"Do pass as amended and be re-referred to the Committee on 	Appropriations",5,2,0,0,7
853031,549251,2016-05-27,Assembly,"Do pass as amended",14,5,0,1,20
853031,550976,2016-06-02,Assembly,"AB 2523 MULLIN  Assembly Third Reading",51,26,0,3,80
853031,554817,2016-06-21,Senate,"Do pass, but re-refer to the Committee on Appropriations",4,1,0,0,5
853031,558816,2016-08-01,Senate,"Placed on Appropriations Suspense file",7,0,0,0,7
853031,559554,2016-08-11,Senate,"Do pass as amended",5,2,0,0,7
853031,561415,2016-08-29,Senate,"Assembly 3rd Reading AB2523 Mullin By Allen",25,14,0,0,39
853031,561416,2016-08-29,Senate,"Assembly 3rd Reading AB2523 Mullin By Allen",39,0,0,0,39
853033,534827,2016-04-19,Assembly,"Do pass as amended and be re-referred to the Committee on 	Appropriations",11,1,0,7,19
853034,536170,2016-04-20,Assembly,"Do pass and be re-referred to the Committee on Appropriations",10,0,0,3,13
853034,549267,2016-05-27,Assembly,"Do pass as amended",15,0,0,5,20
853034,551074,2016-06-02,Assembly,"AB 2493 ATKINS  Assembly Third Reading",73,0,0,7,80
853034,555121,2016-06-22,Senate,"Do pass, but re-refer to the Committee on Appropriations",5,0,0,0,5
853034,558858,2016-08-01,Senate,"Placed on Appropriations Suspense file",7,0,0,0,7
853034,559713,2016-08-11,Senate,"Do pass",5,0,2,0,7
853034,559952,2016-08-16,Senate,"Assembly 3rd Reading AB2493 Atkins By Mendoza",38,0,1,0,39
853035,532212,2016-04-13,Assembly,"Do pass and be re-referred to the Committee on Local Government",5,1,0,1,7
853035,536125,2016-04-20,Assembly,"Do pass and be re-referred to the Committee on Appropriations",7,0,0,2,9
853035,544883,2016-05-11,Assembly,"Do pass",14,2,0,4,20
853035,549188,2016-05-27,Assembly,"AB 2501 BLOOM  Assembly Third Reading",50,11,0,19,80
853035,561134,2016-08-25,Senate,"Assembly 3rd Reading AB2501 Bloom By Allen",34,3,2,0,39
853035,561723,2016-08-31,Assembly,"AB 2501 BLOOM  Concurrence in Senate Amendments",74,4,0,2,80
853036,537459,2016-04-20,Senate,"Do pass as amended, and re-refer to the Committee on Appropriations",5,0,4,0,9
853036,545926,2016-05-16,Senate,"Placed on Appropriations Suspense file",7,0,0,0,7
853036,549321,2016-05-27,Senate,"Do pass as amended",7,0,0,0,7
853036,550611,2016-06-01,Senate,"Senate 3rd Reading SB1300 Hernandez Urgency Clause",36,1,3,0,40
853036,556369,2016-06-28,Assembly,"Do pass as amended and be re-referred to the Committee on 	Appropriations",16,0,0,2,18
853036,559355,2016-08-11,Assembly,"Do pass as amended",19,0,0,1,20
853036,560400,2016-08-19,Assembly,"SB 1300 Hernandez  Third Reading Urgency  ByA& A.R.  Amendment  Set 	#1",73,0,0,7,80
853036,560720,2016-08-23,Assembly,"SB 1300 Hernandez  Third Reading Urgency  By WOOD",76,1,0,3,80
853036,561184,2016-08-25,Senate,"Unfinished Business SB1300 Hernandez Urgency Clause Concurr",37,1,1,0,39
853038,534325,2016-04-18,Assembly,"Do pass and be re-referred to the Committee on Appropriations",10,5,0,1,16
853038,549344,2016-05-27,Assembly,"Do pass as amended",14,6,0,0,20
853038,551133,2016-06-02,Assembly,"AB 2428 TING  Assembly Third Reading",52,26,0,2,80
853038,558851,2016-08-01,Senate,"Placed on Appropriations Suspense file",7,0,0,0,7
853039,533459,2016-04-12,Assembly,"Do pass and be re-referred to the Committee on Appropriations",6,1,0,0,7
853039,542636,2016-05-04,Assembly,"Do pass",20,0,0,0,20
853039,545374,2016-05-12,Assembly,"AB 2813 BLOOM  Assembly Third Reading",77,0,0,3,80
853039,552920,2016-06-14,Senate,"Do pass, but re-refer to the Committee on Appropriations",7,0,0,0,7
853039,560176,2016-08-18,Senate,"Assembly 3rd Reading AB2813 Bloom By Hancock",35,0,4,0,39
853039,561068,2016-08-24,Assembly,"AB 2813 BLOOM  Concurrence in Senate Amendments",79,0,0,1,80
853040,529341,2016-04-06,Senate,"Do pass, but re-refer to the Committee on Human Services",9,0,0,0,9
853040,532606,2016-04-12,Senate,"Do pass as amended, but re-refer to the Committee on Appropriations 	Recommend Consent",5,0,0,0,5
853040,547542,2016-05-23,Senate,"Placed on Appropriations Suspense file",7,0,0,0,7
853040,549409,2016-05-27,Senate,"Do pass as amended",7,0,0,0,7
853040,550846,2016-06-02,Senate,"Special Consent # SB1466 Mitchell",39,0,1,0,40
853040,553268,2016-06-14,Assembly,"Do pass and be re-referred to the Committee on Human Services to 	Consent Calendar",15,0,0,3,18
853040,556118,2016-06-28,Assembly,"Do pass and be re-referred to the Committee on Appropriations",7,0,0,0,7
853040,559393,2016-08-11,Assembly,"Do pass as amended",20,0,0,0,20
853040,560804,2016-08-23,Assembly,"SB 1466 Mitchell  Senate Third Reading  By BONILLA",79,0,0,1,80
853040,561440,2016-08-29,Senate,"Unfinished Business SB1466 Mitchell Concurrence",39,0,0,0,39
853043,535229,2016-04-19,Senate,"Do pass, but re-refer to the Committee on Appropriations",11,0,0,0,11
853043,547741,2016-05-23,Senate,"Do pass",6,1,0,0,7
853043,549315,2016-05-27,Senate,"Senate 3rd Reading SB1393 De Le",27,8,5,0,40
853043,557050,2016-06-29,Assembly,"Do pass and be re-referred to the Committee on Appropriations",10,4,0,1,15
853043,559090,2016-08-03,Assembly,"Do pass",14,6,0,0,20
853043,561830,2016-08-31,Assembly,"SB 1393 De Leon  Senate Third Reading  By WILLIAMS",51,25,0,4,80
853043,561831,2016-08-31,Senate,"W/O REF. TO FILE SB1393 De Le",27,11,1,0,39
853044,536589,2016-04-20,Assembly,"Do pass and be re-referred to the Committee on Appropriations to 	Consent Calendar",7,0,0,0,7
853044,549053,2016-05-27,Assembly,"Do pass",20,0,0,0,20
853044,549978,2016-05-31,Assembly,"AB 2833 COOLEY  Assembly Third Reading",80,0,0,0,80
853044,555536,2016-06-27,Senate,"Do pass, but re-refer to the Committee on Appropriations",5,0,0,0,5
853044,559940,2016-08-16,Senate,"Assembly 3rd Reading AB2833 Cooley By Morrell",38,0,1,0,39
853044,560970,2016-08-24,Assembly,"AB 2833 COOLEY  Concurrence in Senate Amendments",80,0,0,0,80
853046,536505,2016-04-20,Senate,"Do pass, but re-refer to the Committee on Appropriations",2,1,2,0,5
853047,535615,2016-04-19,Assembly,"Do pass and be re-referred to the Committee on Appropriations",6,10,0,3,19
853050,533103,2016-04-12,Senate,"Do pass, but re-refer to the Committee on Appropriations",1,4,2,0,7
853051,538684,2016-04-26,Assembly,"Do pass",7,3,0,0,10
853051,550103,2016-05-31,Assembly,"AB 2667 THURMOND  Assembly Third Reading",38,36,0,6,80
853052,526290,2016-03-30,Assembly,"Do pass and be re-referred to the Committee on Local Government to 	Consent Calendar",7,0,0,0,7
853052,528908,2016-04-06,Assembly,"Do pass and be re-referred to the Committee on Appropriations",9,0,0,0,9
853052,537062,2016-04-20,Assembly,"Do pass, to Consent Calendar",16,0,0,4,20
853052,540244,2016-04-28,Assembly,"AB 2558 STEINORTH  Consent Calendar Second Day  Regular Session",76,0,0,4,80
853052,554933,2016-06-21,Senate,"Do pass, but re-refer to the Committee on Appropriations Recommend 	Consent",5,0,0,0,5
853052,559377,2016-08-11,Senate,"Consent Calendar 2nd AB2558 Steinorth",37,0,2,0,39
853056,538701,2016-04-26,Assembly,"Do pass and be re-referred to the Committee on Judiciary",6,0,0,1,7
853056,541514,2016-05-03,Assembly,"Do pass",10,0,0,0,10
853056,547085,2016-05-19,Assembly,"AB 2723 CHAVEZ  Assembly Third Reading",75,0,0,5,80
853056,552994,2016-06-14,Senate,"Do pass, but re-refer to the Committee on Judiciary",4,0,1,0,5
853056,555007,2016-06-21,Senate,"Do pass, but re-refer to the Committee on Appropriations",6,1,0,0,7
853056,559194,2016-08-08,Senate,"Placed on Appropriations Suspense file",7,0,0,0,7
853057,532548,2016-04-13,Assembly,"Do pass as amended and be re-referred to the Committee on Utilities 	and Commerce",9,0,0,0,9
853057,537368,2016-04-20,Assembly,"Do pass as amended and be re-referred to the Committee on 	Appropriations",14,0,0,1,15
853058,531712,2016-04-12,Senate,"Do pass, but re-refer to the Committee on Appropriations",6,2,1,0,9
853058,545825,2016-05-16,Senate,"Placed on Appropriations Suspense file",7,0,0,0,7
853058,549237,2016-05-27,Senate,"Do pass as amended",5,2,0,0,7
853058,551058,2016-06-02,Senate,"Senate 3rd Reading SB1396 Wolk",25,13,2,0,40
853059,528292,2016-04-05,Assembly,"Do pass and be re-referred to the Committee on Privacy and Consumer 	Protection",10,0,0,0,10
853059,534995,2016-04-19,Assembly,"Do pass and be re-referred to the Committee on Appropriations",11,0,0,0,11
853059,544978,2016-05-11,Assembly,"Do pass, to Consent Calendar",20,0,0,0,20
853059,547070,2016-05-19,Assembly,"AB 2707 RIDLEY-THOMAS  Consent Calendar Second Day  Regular Session",76,0,0,4,80
853059,553416,2016-06-14,Senate,"Do pass, but re-refer to the Committee on Appropriations",6,0,1,0,7
853059,559856,2016-08-15,Senate,"Assembly 3rd Reading AB2707 Ridley-Thomas By Jackson",38,0,1,0,39
853059,560514,2016-08-22,Assembly,"AB 2707 RIDLEY-THOMAS  Concurrence in Senate Amendments",77,0,0,3,80
853060,527985,2016-04-04,Assembly,"Do pass and be re-referred to the Committee on Appropriations",12,0,0,0,12
853060,532917,2016-04-13,Assembly,"Do pass, to Consent Calendar",20,0,0,0,20
853060,537557,2016-04-21,Assembly,"AB 2637 WILK  Consent Calendar Second Day  Regular Session",79,0,0,1,80
853060,554506,2016-06-15,Senate,"Do pass as amended, and re-refer to the Committee on Judiciary",7,0,0,0,7
853060,556610,2016-06-28,Senate,"Do pass, but re-refer to the Committee on Appropriations",7,0,0,0,7
853060,558826,2016-08-01,Senate,"Placed on Appropriations Suspense file",7,0,0,0,7
853060,559626,2016-08-11,Senate,"Do pass",7,0,0,0,7
853060,561001,2016-08-24,Senate,"Assembly 3rd Reading AB2637 Wilk By Jackson",39,0,0,0,39
853060,561835,2016-08-31,Assembly,"AB 2637 WILK  Concurrence in Senate Amendments",78,1,0,1,80
853061,532378,2016-04-13,Assembly,"Do pass and be re-referred to the Committee on Health",6,1,0,0,7
853061,534820,2016-04-19,Assembly,"Do pass as amended and be re-referred to the Committee on 	Appropriations",14,2,0,3,19
853061,549111,2016-05-27,Assembly,"Do pass as amended",15,5,0,0,20
853061,550901,2016-06-02,Assembly,"AB 2821 CHIU  Assembly Third Reading",63,13,0,4,80
853061,555239,2016-06-22,Senate,"Do pass, but re-refer to the Committee on Transportation and 	Housing",9,0,0,0,9
853061,558733,2016-08-01,Senate,"Placed on Appropriations Suspense file",7,0,0,0,7
853061,559341,2016-08-11,Senate,"Do pass as amended",7,0,0,0,7
853061,560675,2016-08-23,Senate,"Assembly 3rd Reading AB2821 Chiu By Hernandez",36,3,0,0,39
853061,561352,2016-08-29,Assembly,"AB 2821 CHIU  Concurrence in Senate Amendments",63,16,0,1,80
853062,526263,2016-03-30,Senate,"Do pass",4,4,1,0,9
853062,526264,2016-03-30,Senate,"Set, first hearing.  Failed passage in Committee.  Reconsideration 	granted",9,0,0,0,9
853062,536262,2016-04-20,Senate,"Do pass",5,4,0,0,9
853062,547589,2016-05-23,Senate,"Senate 3rd Reading SB1457 Morrell",15,18,7,0,40
853062,547590,2016-05-23,Senate,"Senate 3rd Reading SB1457 Morrell Reconsider",38,0,2,0,40
853064,528727,2016-04-06,Senate,"Do pass, but re-refer to the Committee on Appropriations",6,0,1,0,7
853064,543810,2016-05-09,Senate,"Senate 3rd Reading SB1386 Wolk",26,7,7,0,40
853064,544541,2016-04-25,Senate,"Do pass",5,0,2,0,7
853064,559055,2016-08-03,Assembly,"Do pass",14,5,0,1,20
853064,559984,2016-06-27,Assembly,"Do pass as amended and be re-referred to the Committee on 	Appropriations",7,1,0,1,9
853064,560277,2016-08-18,Assembly,"SB 1386 Wolk  Senate Third Reading  By MCCARTY",45,26,0,9,80
853064,561053,2016-08-24,Senate,"Unfinished Business SB1386 Wolk Concurrence",26,12,1,0,39
853065,532515,2016-04-13,Senate,"Do pass, but re-refer to the Committee on Appropriations Recommend 	Consent",9,0,0,0,9
853065,540805,2016-05-02,Senate,"Senate 3rd Reading SB1455 Block",38,0,2,0,40
853065,544714,2016-04-25,Senate,"Do pass",6,0,1,0,7
853065,553643,2016-06-15,Assembly,"Do pass and be re-referred to the Committee on Veterans Affairs to 	Consent Calendar",7,0,0,0,7
853065,556608,2016-06-28,Assembly,"Do pass and be re-referred to the Committee on Appropriations",7,0,0,2,9
853065,559044,2016-08-03,Assembly,"Do pass, to Consent Calendar",20,0,0,0,20
853065,559418,2016-08-11,Assembly,"SB 1455 Block  Consent Calendar Second Day  Regular Session",78,0,0,2,80
853065,560252,2016-08-18,Senate,"Special Consent SB1455 Block",36,0,3,0,39
853067,538662,2016-04-26,Assembly,"Do pass as amended and be re-referred to the Committee on 	Appropriations",6,0,0,1,7
853067,549043,2016-05-27,Assembly,"Do pass as amended",19,0,0,1,20
853067,550592,2016-06-01,Assembly,"AB 2809 RODRIGUEZ  Assembly Third Reading",74,1,0,5,80
853067,552780,2016-06-14,Senate,"Do pass as amended, and re-refer to the Committee on Appropriations",4,0,1,0,5
853067,558823,2016-08-01,Senate,"Placed on Appropriations Suspense file",7,0,0,0,7
853067,559486,2016-08-11,Senate,"Do pass as amended",5,2,0,0,7
853068,532259,2016-04-12,Assembly,"Do pass and be re-referred to the Committee on Appropriations",9,2,0,2,13
853072,538550,2016-04-26,Senate,"Do pass, but re-refer to the Committee on Rules",9,0,2,0,11
853072,545828,2016-05-16,Senate,"Placed on Appropriations Suspense file",7,0,0,0,7
853072,549190,2016-05-27,Senate,"Do pass",5,2,0,0,7
853072,549922,2016-05-31,Senate,"Senate 3rd Reading SB1413 Leno",29,7,4,0,40
853072,553237,2016-06-15,Assembly,"Do pass and be re-referred to the Committee on Education",6,1,0,0,7
853072,555362,2016-06-22,Assembly,"Do pass",6,0,0,1,7
853072,561025,2016-08-24,Assembly,"SB 1413 Leno  Senate Third Reading  By TING",62,18,0,0,80
853072,561462,2016-08-29,Senate,"Unfinished Business SB1413 Leno Concurrence",30,8,1,0,39
853073,532696,2016-04-13,Assembly,"Do pass as amended and be re-referred to the Committee on 	Appropriations",4,2,0,1,7
853074,528816,2016-04-06,Assembly,"Do pass as amended",13,0,0,0,13
853074,541844,2016-05-03,Assembly,"Do pass as amended",10,0,0,0,10
853074,550137,2016-05-31,Assembly,"AB 2591 DABABNEH  Assembly Third Reading",80,0,0,0,80
853074,555040,2016-06-22,Senate,"Do pass, but re-refer to the Committee on Judiciary",8,0,1,0,9
853074,556358,2016-06-28,Senate,"Do pass as amended",7,0,0,0,7
853074,560147,2016-08-18,Senate,"Assembly 3rd Reading AB2591 Dababneh By Hall",36,0,3,0,39
853074,561410,2016-08-29,Assembly,"AB 2591 DABABNEH  Concurrence in Senate Amendments",79,0,0,1,80
853075,526199,2016-03-30,Assembly,"Do pass and be re-referred to the Committee on Local Government",6,1,0,0,7
853075,532198,2016-04-13,Assembly,"Do pass and be re-referred to the Committee on Appropriations",7,1,0,1,9
853076,533445,2016-04-13,Assembly,"Do pass and be re-referred to the Committee on Revenue and Taxation",5,2,0,0,7
853076,538694,2016-04-25,Assembly,"Do pass",5,3,0,1,9
853076,546006,2016-05-16,Assembly,"AB 2429 THURMOND  Assembly Third Reading",48,28,0,4,80
853077,529527,2016-04-06,Assembly,"Amend, and do pass as amended and be re-referred to the Committee 	on Appropriations with the recommendation:  To Consent Calendar",7,0,0,0,7
853078,531223,2016-04-12,Assembly,"Do pass and be re-referred to the Committee on Appropriations",2,5,0,0,7
853078,531224,2016-04-12,Assembly,"Reconsideration granted",6,0,0,1,7
853078,537148,2016-04-20,Assembly,"Do pass and be re-referred to the Committee on Appropriations",2,5,0,0,7
853080,536568,2016-04-20,Senate,"Do pass as amended, and re-refer to the Committee on Appropriations",4,2,3,0,9
853080,536569,2016-04-20,Senate,"Set, first hearing.  Failed passage in Committee.  Reconsideration 	granted",9,0,0,0,9
853081,532691,2016-04-13,Assembly,"Do pass and be re-referred to the Committee on Appropriations",10,0,0,0,10
853081,539438,2016-04-27,Assembly,"Do pass, to Consent Calendar",19,0,0,1,20
853081,543093,2016-05-05,Assembly,"AB 2504 AGRI.  Consent Calendar Second Day  Regular Session",79,0,0,1,80
853082,531562,2016-04-12,Assembly,"Do pass as amended and be re-referred to the Committee on Privacy 	and Consumer Protection",7,0,0,0,7
853082,535241,2016-04-19,Assembly,"Do pass and be re-referred to the Committee on Appropriations",10,0,0,1,11
853082,542371,2016-05-04,Assembly,"Do pass, to Consent Calendar",20,0,0,0,20
853082,547169,2016-05-19,Assembly,"AB 2533 SANTIAGO  Assembly Third Reading",71,1,0,8,80
853082,556274,2016-06-28,Senate,"Do pass, but re-refer to the Committee on Appropriations",3,4,0,0,7
853083,535625,2016-04-18,Assembly,"Do pass as amended and be re-referred to the Committee on 	Appropriations",11,0,0,1,12
853084,534881,2016-04-19,Senate,"Do pass, but re-refer to the Committee on Appropriations",7,0,0,0,7
853084,545813,2016-05-16,Senate,"Placed on Appropriations Suspense file",7,0,0,0,7
853084,549065,2016-05-27,Senate,"Do pass",7,0,0,0,7
853084,549988,2016-05-31,Senate,"Senate 3rd Reading SB1406 Mendoza",39,0,1,0,40
853084,554676,2016-06-21,Assembly,"Amend, and do pass as amended and be re-referred to the Committee 	on Appropriations with the recommendation:  To Consent Calendar",10,0,0,0,10
853084,558985,2016-08-03,Assembly,"Do pass, to Consent Calendar",20,0,0,0,20
853084,559223,2016-08-11,Assembly,"SB 1406 Mendoza  Consent Calendar Second Day  Regular Session",78,0,0,2,80
853084,560126,2016-08-18,Senate,"Special Consent SB1406 Mendoza",36,0,3,0,39
853085,531399,2016-04-12,Assembly,"Do pass and be re-referred to the Committee on Appropriations",13,1,0,1,15
853085,546638,2016-05-18,Assembly,"Do pass",20,0,0,0,20
853085,547661,2016-05-23,Assembly,"AB 2551 GALLAGHER  Assembly Third Reading",73,1,0,6,80
853085,556615,2016-06-29,Senate,"Do pass as amended, and re-refer to the Committee on Appropriations",6,0,1,0,7
853085,560822,2016-08-23,Senate,"Assembly 3rd Reading AB2551 Gallagher By Nielsen",36,1,2,0,39
853085,561554,2016-08-30,Assembly,"AB 2551 GALLAGHER  Concurrence in Senate Amendments",78,2,0,0,80
853086,531376,2016-04-12,Assembly,"Do pass as amended and be re-referred to the Committee on Business 	and Professions",9,4,0,6,19
853086,532191,2016-04-12,Assembly,"Reconsideration granted",19,0,0,0,19
853088,541857,2016-05-03,Assembly,"Do pass as amended, to Consent Calendar",10,0,0,0,10
853088,545251,2016-05-12,Assembly,"AB 2846 MAIENSCHEIN  Consent Calendar Second Day  Regular Session",78,0,0,2,80
853088,555216,2016-06-21,Senate,"Do pass and be placed on the Consent Calendar",7,0,0,0,7
853088,556971,2016-06-30,Senate,"Consent Calendar 2nd AB2846 Maienschein",37,0,3,0,40
853089,528102,2016-04-05,Senate,"Do pass, but re-refer to the Committee on Appropriations Recommend 	Consent",7,0,0,0,7
853089,544605,2016-04-25,Senate,"Placed on Appropriations Suspense file",7,0,0,0,7
853090,527512,2016-04-04,Assembly,"Be referred to Committee on Utilities and Commerce",10,0,0,1,11
853090,537110,2016-04-20,Assembly,"Do pass and be re-referred to the Committee on Appropriations to 	Consent Calendar",14,0,0,1,15
853090,546599,2016-05-18,Assembly,"Do pass, to Consent Calendar",20,0,0,0,20
853090,549007,2016-05-27,Assembly,"AB 2746 OBERNOLTE  Consent Calendar Second Day  Regular Session",67,0,0,13,80
853090,554670,2016-06-21,Senate,"Do pass, but re-refer to the Committee on Appropriations",10,0,1,0,11
853090,560168,2016-08-18,Senate,"Assembly 3rd Reading AB2746 Obernolte By Hertzberg",36,0,3,0,39
853091,535295,2016-04-19,Senate,"Do pass, but re-refer to the Committee on Appropriations",9,1,1,0,11
853091,549327,2016-05-27,Senate,"Do pass",5,1,1,0,7
853091,549932,2016-05-31,Senate,"Senate 3rd Reading SB1414 Wolk",30,9,1,0,40
853091,556815,2016-06-29,Assembly,"Do pass as amended and be re-referred to the Committee on 	Appropriations",10,4,0,1,15
853091,559476,2016-08-11,Assembly,"Do pass",12,3,0,5,20
853091,560413,2016-08-19,Assembly,"SB 1414 Wolk  Senate Third Reading  By A.,E.,S.,T.,& I.M. 	Amendment  Set #1",73,0,0,7,80
853091,560782,2016-08-23,Assembly,"SB 1414 Wolk  Senate Third Reading  By WILLIAMS",79,1,0,0,80
853091,561308,2016-08-25,Senate,"Unfinished Business SB1414 Wolk Concurrence",39,0,0,0,39
853092,527821,2016-04-04,Assembly,"Be referred to Committee on Utilities and Commerce",10,0,0,1,11
853092,533409,2016-04-13,Assembly,"Do pass and be re-referred to the Committee on Appropriations",14,0,0,1,15
853093,534889,2016-04-18,Assembly,"Do pass and be re-referred to the Committee on Appropriations to 	Consent Calendar",9,0,0,0,9
853093,548977,2016-05-27,Assembly,"Do pass",20,0,0,0,20
853093,549952,2016-05-31,Assembly,"AB 2579 LOW  Assembly Third Reading",80,0,0,0,80
853094,535037,2016-04-18,Assembly,"Amend, and do pass as amended and be re-referred to the Committee 	on Appropriations with the recommendation:  To Consent Calendar",9,0,0,0,9
853094,544967,2016-05-11,Assembly,"Do pass, to Consent Calendar",20,0,0,0,20
853094,547644,2016-05-23,Assembly,"AB 2430 GAINES  Assembly Third Reading",76,0,0,4,80
853094,556578,2016-06-29,Senate,"Do pass, but re-refer to the Committee on Appropriations",5,0,2,0,7
853094,558923,2016-08-01,Senate,"Do pass",7,0,0,0,7
853094,560093,2016-08-17,Senate,"Assembly 3rd Reading AB2430 Beth Gaines By Beall",38,0,1,0,39
853095,529080,2016-04-06,Senate,"Do pass, but re-refer to the Committee on Appropriations",6,1,2,0,9
853095,534604,2016-04-18,Senate,"Placed on Appropriations Suspense file",7,0,0,0,7
853099,528965,2016-04-06,Senate,"Do pass as amended, and re-refer to the Committee on Appropriations",9,0,0,0,9
853099,544713,2016-04-25,Senate,"Placed on Appropriations Suspense file",7,0,0,0,7
853099,549373,2016-05-27,Senate,"Do pass",7,0,0,0,7
853099,549968,2016-05-31,Senate,"Senate 3rd Reading SB1412 Block",39,0,1,0,40
853099,554718,2016-06-21,Assembly,"Do pass and be re-referred to the Committee on Appropriations",13,0,0,0,13
853099,559371,2016-08-11,Assembly,"Do pass",20,0,0,0,20
853099,560240,2016-08-18,Assembly,"SB 1412 Block  Senate Third Reading  By MEDINA",76,0,0,4,80
853100,539426,2016-04-27,Assembly,"Do pass and be re-referred to the Committee on Local Government",5,2,0,0,7
853100,542421,2016-05-04,Assembly,"Do pass",6,2,0,1,9
853100,550128,2016-05-31,Assembly,"AB 2492 ALEJO  Assembly Third Reading",51,29,0,0,80
853100,553122,2016-06-15,Senate,"Do pass, but re-refer to the Committee on Transportation and 	Housing",5,2,0,0,7
853100,559857,2016-08-15,Senate,"Assembly 3rd Reading AB2492 Alejo By Lara",28,10,1,0,39
853100,560596,2016-08-22,Assembly,"AB 2492 ALEJO  Concurrence in Senate Amendments",55,22,0,3,80
853102,534184,2016-04-18,Assembly,"Do pass and be re-referred to the Committee on Appropriations",15,0,0,1,16
853102,542410,2016-05-04,Assembly,"Do pass as amended, to Consent Calendar",20,0,0,0,20
853102,545214,2016-05-12,Assembly,"AB 2718 GOMEZ  Consent Calendar Second Day  Regular Session",78,0,0,2,80
853104,528285,2016-04-05,Senate,"Do pass as amended, and re-refer to the Committee on Appropriations",5,2,0,0,7
853104,544562,2016-04-25,Senate,"Placed on Appropriations Suspense file",7,0,0,0,7
853104,549210,2016-05-27,Senate,"Do pass as amended",5,2,0,0,7
853104,550818,2016-06-02,Senate,"Senate 3rd Reading SB1332 Mendoza",25,13,2,0,40
853104,555968,2016-06-28,Assembly,"Do pass and be re-referred to the Committee on Appropriations",5,2,0,0,7
853104,559260,2016-08-11,Assembly,"Do pass as amended",14,6,0,0,20
853104,560369,2016-08-19,Assembly,"SB 1332 Mendoza  Senate Third Reading  Amendment  Set #1",73,0,0,7,80
853104,560637,2016-08-23,Assembly,"SB 1332 Mendoza  Senate Third Reading  By JONES-SAWYER",47,30,0,3,80
853104,561219,2016-08-25,Senate,"Unfinished Business SB1332 Mendoza Concurrence",25,13,1,0,39
853105,531199,2016-04-12,Senate,"Do pass, but re-refer to the Committee on Appropriations",8,1,0,0,9
853105,544338,2016-04-25,Senate,"Placed on Appropriations Suspense file",7,0,0,0,7
853105,549009,2016-05-27,Senate,"Do pass as amended",7,0,0,0,7
853105,550366,2016-06-01,Senate,"Senate 3rd Reading SB1287 McGuire",39,0,1,0,40
853105,555945,2016-06-28,Assembly,"Do pass as amended and be re-referred to the Committee on 	Appropriations",11,4,0,0,15
853105,559234,2016-08-11,Assembly,"Do pass",11,4,0,5,20
853105,561171,2016-08-25,Assembly,"SB 1287 McGuire  Senate Third Reading  By WOOD",56,22,0,2,80
853105,561375,2016-08-29,Senate,"Unfinished Business SB1287 McGuire Concurrence",31,7,1,0,39
853106,532923,2016-04-12,Assembly,"Do pass and be re-referred to the Committee on Appropriations",13,0,0,0,13
853106,539209,2016-04-27,Assembly,"Do pass, to Consent Calendar",19,0,0,1,20
853106,543001,2016-05-05,Assembly,"AB 2732 CHANG  Consent Calendar Second Day  Regular Session",79,0,0,1,80
853106,552135,2016-06-08,Senate,"Do pass, but re-refer to the Committee on Appropriations",9,0,0,0,9
853106,559981,2016-08-16,Senate,"Assembly 3rd Reading AB2732 Chang By Allen",38,0,1,0,39
853106,560819,2016-08-23,Assembly,"AB 2732 CHANG  Concurrence in Senate Amendments",79,0,0,1,80
853107,533025,2016-04-13,Assembly,"Do pass as amended and be re-referred to the Committee on 	Appropriations",7,1,0,1,9
853107,542412,2016-05-04,Assembly,"Do pass",15,5,0,0,20
853107,545169,2016-05-12,Assembly,"AB 2414 GARCIA, E.  Assembly Third Reading",50,25,0,5,80
853107,555177,2016-06-22,Senate,"Do pass as amended, and re-refer to the Committee on Appropriations",4,1,2,0,7
853107,558936,2016-08-01,Senate,"Placed on Appropriations Suspense file",7,0,0,0,7
853107,559745,2016-08-11,Senate,"Do pass as amended",5,2,0,0,7
853107,561470,2016-08-29,Senate,"Assembly 3rd Reading AB2414 Eduardo Garcia By Hueso",27,11,1,0,39
853107,561661,2016-08-30,Assembly,"AB 2414 GARCIA, E.  Concurrence in Senate Amendments",55,25,0,0,80
853108,526389,2016-03-30,Senate,"Do pass, but re-refer to the Committee on Appropriations",8,0,1,0,9
853108,531055,2016-04-11,Senate,"Placed on Appropriations Suspense file",7,0,0,0,7
853110,535379,2016-04-19,Senate,"Do pass, but re-refer to the Committee on Appropriations Recommend 	Consent",11,0,0,0,11
853110,546005,2016-05-16,Senate,"Do pass",6,0,1,0,7
853110,548679,2016-05-26,Senate,"Senate 3rd Reading SB1429 Nielsen",39,0,1,0,40
853110,554847,2016-06-20,Assembly,"Do pass and be re-referred to the Committee on Appropriations to 	Consent Calendar",16,0,0,0,16
853110,556294,2016-06-29,Assembly,"Do pass, to Consent Calendar",18,0,0,2,20
853110,559132,2016-08-04,Assembly,"SB 1429 Nielsen  Consent Calendar Second Day  Regular Session",77,0,0,3,80
853111,528958,2016-04-06,Assembly,"Do pass and be re-referred to the Committee on Appropriations to 	Consent Calendar",18,0,0,3,21
853111,536377,2016-04-20,Assembly,"Do pass, to Consent Calendar",16,0,0,4,20
853111,540241,2016-04-28,Assembly,"AB 2619 GRAY  Consent Calendar Second Day  Regular Session",76,0,0,4,80
853112,528675,2016-04-06,Senate,"Do pass as amended, and re-refer to the Committee on Environmental 	Quality",5,1,1,0,7
853112,536341,2016-04-20,Senate,"Do pass, but re-refer to the Committee on Appropriations",5,2,0,0,7
853112,547530,2016-05-23,Senate,"Do pass",4,2,1,0,7
853112,550866,2016-06-02,Senate,"Senate 3rd Reading SB1318 Wolk",23,13,4,0,40
853113,535703,2016-04-19,Assembly,"Do pass and be re-referred to the Committee on Appropriations",14,2,0,3,19
853113,549398,2016-05-27,Assembly,"Do pass as amended",14,6,0,0,20
853113,550823,2016-06-02,Assembly,"AB 2424 GOMEZ  Assembly Third Reading",57,22,0,1,80
853113,557072,2016-06-29,Senate,"Do pass as amended, and re-refer to the Committee on Appropriations",7,0,2,0,9
853114,538924,2016-04-27,Assembly,"Do pass as amended and be re-referred to the Committee on Local 	Government",7,0,0,0,7
853114,542404,2016-05-04,Assembly,"Do pass",7,0,0,2,9
853114,545191,2016-05-12,Assembly,"AB 2406 THURMOND  Assembly Third Reading",76,0,0,4,80
853114,552681,2016-06-14,Senate,"Do pass",11,0,0,0,11
853114,560724,2016-08-23,Senate,"Assembly 3rd Reading AB2406 Thurmond By McGuire Urgency Cla",39,0,0,0,39
853114,561399,2016-08-29,Assembly,"AB 2406 THURMOND  Concurrence- Urgency Added",77,0,0,3,80
853115,539082,2016-04-27,Assembly,"Do pass as amended",5,2,0,0,7
853115,547635,2016-05-23,Assembly,"AB 2686 MULLIN  Assembly Third Reading",57,20,0,3,80
853115,554753,2016-06-21,Senate,"Do pass",4,1,0,0,5
853115,560554,2016-08-22,Senate,"Assembly 3rd Reading AB2686 Mullin By Hertzberg",27,11,1,0,39
853115,561160,2016-08-25,Assembly,"AB 2686 MULLIN  Concurrence in Senate Amendments",61,16,0,3,80
853116,533185,2016-04-12,Assembly,"Do pass and be re-referred to the Committee on Appropriations to 	Consent Calendar",7,0,0,0,7
853116,549139,2016-05-27,Assembly,"Do pass",20,0,0,0,20
853116,549935,2016-05-31,Assembly,"AB 2565 SALAS  Assembly Third Reading",80,0,0,0,80
853116,556276,2016-06-28,Senate,"Do pass, but re-refer to the Committee on Appropriations Recommend 	Consent",5,0,0,0,5
853119,532268,2016-04-12,Senate,"Do pass as amended, and re-refer to the Committee on Rules",3,0,2,0,5
853119,534791,2016-04-19,Senate,"Do pass as amended, and re-refer to the Committee on Appropriations",9,1,1,0,11
853119,549185,2016-05-27,Senate,"Do pass",5,2,0,0,7
853119,549927,2016-05-31,Senate,"Senate 3rd Reading SB1380 Mitchell",29,7,4,0,40
853119,556409,2016-06-29,Assembly,"Do pass as amended and be re-referred to the Committee on 	Appropriations",5,2,0,0,7
853119,559240,2016-08-11,Assembly,"Do pass",14,5,0,1,20
853119,561364,2016-08-29,Assembly,"SB 1380 Mitchell  Senate Third Reading  By CHIU",55,24,0,1,80
853119,561687,2016-08-31,Senate,"Unfinished Business SB1380 Mitchell Concurrence",30,8,1,0,39
853120,539315,2016-04-27,Senate,"Do pass and be placed on the Consent Calendar",7,0,0,0,7
853120,543022,2016-05-05,Senate,"Consent Calendar 2nd SB1360 Bates",36,0,4,0,40
853120,553471,2016-06-15,Assembly,"Do pass, to Consent Calendar",9,0,0,0,9
853120,555365,2016-06-23,Assembly,"SB 1360 Bates  Consent Calendar Second Day  Regular Session",79,0,0,1,80
853121,525901,2016-03-29,Assembly,"Do pass and be re-referred to the Committee on Local Government",10,3,0,2,15
853121,532693,2016-04-13,Assembly,"Do pass as amended and be re-referred to the Committee on 	Appropriations",8,1,0,0,9
853123,532921,2016-04-13,Assembly,"Do pass as amended and be re-referred to the Committee on Housing 	and Community Development",5,3,0,1,9
853123,539085,2016-04-27,Assembly,"Do pass",5,2,0,0,7
853124,535726,2016-04-18,Assembly,"Do pass as amended and be re-referred to the Committee on 	Appropriations",9,0,0,0,9
853125,538691,2016-04-26,Assembly,"Do pass, to Consent Calendar",6,0,0,1,7
853125,543133,2016-05-05,Assembly,"AB 2568 ATKINS  Consent Calendar Second Day",79,0,0,1,80
853125,552150,2016-06-08,Senate,"Do pass, but re-refer to the Committee on Human Services",7,0,2,0,9
853125,556592,2016-06-28,Senate,"Do pass as amended",5,0,0,0,5
853125,559655,2016-08-11,Senate,"Do pass",7,0,0,0,7
853125,560564,2016-08-22,Senate,"Assembly 3rd Reading AB2568 Atkins By Block",39,0,0,0,39
853125,561273,2016-08-25,Assembly,"AB 2568 ATKINS  Concurrence in Senate Amendments",78,0,0,2,80
853126,537527,2016-04-20,Assembly,"Do pass as amended and be re-referred to the Committee on 	Appropriations",7,0,0,0,7
853126,549286,2016-05-27,Assembly,"Do pass",20,0,0,0,20
853126,550228,2016-05-31,Assembly,"AB 2785 O'DONNELL  Assembly Third Reading",80,0,0,0,80
853126,555053,2016-06-22,Senate,"Do pass, but re-refer to the Committee on Appropriations",9,0,0,0,9
853126,558838,2016-08-01,Senate,"Placed on Appropriations Suspense file",7,0,0,0,7
853126,559762,2016-08-11,Senate,"Do pass",7,0,0,0,7
853126,560101,2016-08-17,Senate,"Assembly 3rd Reading AB2785 O'Donnell By Lara",39,0,0,0,39
853126,560867,2016-08-23,Assembly,"AB 2785 O'DONNELL  Concurrence in Senate Amendments",79,0,0,1,80
853127,529342,2016-04-06,Assembly,"Do pass and be re-referred to the Committee on Appropriations to 	Consent Calendar",7,0,0,0,7
853127,532367,2016-04-13,Assembly,"Do pass, to Consent Calendar",20,0,0,0,20
853127,537100,2016-04-21,Assembly,"AB 2780 HOLDEN  Consent Calendar Second Day  Regular Session",79,0,0,1,80
853127,554948,2016-06-21,Senate,"Do pass, but re-refer to the Committee on Appropriations Recommend 	Consent",7,0,0,0,7
853127,559348,2016-08-11,Senate,"Consent Calendar 2nd AB2780 Holden",37,0,2,0,39
853127,559804,2016-08-15,Assembly,"AB 2780 HOLDEN  Concurrence in Senate Amendments",78,0,0,2,80
853128,531074,2016-04-11,Senate,"Do pass, but re-refer to the Committee on Appropriations",6,1,2,0,9
853128,539698,2016-04-28,Senate,"Senate 3rd Reading SB1470 Wieckowski",25,10,5,0,40
853129,525556,2016-03-29,Senate,"Do pass as amended, and re-refer to the Committee on Environmental 	Quality",7,2,0,0,9
853129,536239,2016-04-20,Senate,"Do pass as amended, and re-refer to the Committee on Appropriations",5,1,1,0,7
853130,528293,2016-04-05,Senate,"Do pass as amended, and re-refer to the Committee on Environmental 	Quality",8,1,2,0,11
853130,536278,2016-04-20,Senate,"Do pass as amended, and re-refer to the Committee on Appropriations",5,2,0,0,7
853130,545826,2016-05-16,Senate,"Placed on Appropriations Suspense file",7,0,0,0,7
853130,549083,2016-05-27,Senate,"Do pass as amended",5,2,0,0,7
853130,550421,2016-06-01,Senate,"Senate 3rd Reading SB1441 Leno",28,11,1,0,40
853130,556818,2016-06-29,Assembly,"Do pass and be re-referred to the Committee on Appropriations",10,5,0,0,15
853130,559612,2016-08-10,Assembly,"Do pass as amended",13,6,0,1,20
853130,560348,2016-08-19,Assembly,"SB 1441 Leno  Senate Third Reading  By TRANS.  Amendment  Set #1",73,0,0,7,80
853130,561423,2016-08-29,Assembly,"SB 1441 Leno  Senate Third Reading  By MULLIN",29,33,0,18,80
853131,531438,2016-04-12,Assembly,"Do pass and be re-referred to the Committee on Appropriations to 	Consent Calendar",19,0,0,0,19
853131,549448,2016-05-27,Assembly,"Do pass",20,0,0,0,20
853131,550624,2016-06-01,Assembly,"AB 2696 GAINES  Assembly Third Reading",80,0,0,0,80
853131,553238,2016-06-15,Senate,"Do pass, but re-refer to the Committee on Appropriations Recommend 	Consent",9,0,0,0,9
853131,557028,2016-06-30,Senate,"Consent Calendar 2nd AB2696 Beth Gaines",37,0,3,0,40
853132,527449,2016-04-04,Assembly,"Do pass and be re-referred to the Committee on Appropriations to 	Consent Calendar",16,0,0,0,16
853132,536143,2016-04-20,Assembly,"Do pass, to Consent Calendar",16,0,0,4,20
853132,539598,2016-04-28,Assembly,"AB 2682 CHANG  Consent Calendar Second Day  Regular Session",76,0,0,4,80
853132,552670,2016-06-14,Senate,"Do pass, but re-refer to the Committee on Appropriations Recommend 	Consent",11,0,0,0,11
853133,544293,2016-05-09,Assembly,"Do pass as amended and be re-referred to the Committee on 	Appropriations",9,0,0,0,9
853135,529431,2016-04-06,Senate,"Do pass as amended, and re-refer to the Committee on Appropriations",7,2,0,0,9
853136,539029,2016-04-27,Assembly,"Do pass as amended",9,0,0,0,9
853136,543124,2016-05-05,Assembly,"AB 2613 ACHADJIAN  Assembly Third Reading",78,0,0,2,80
853136,553221,2016-06-15,Senate,"Do pass as amended",7,0,0,0,7
853136,558696,2016-08-01,Senate,"Assembly 3rd Reading AB2613 Achadjian By Monning",39,0,0,0,39
853136,559125,2016-08-04,Assembly,"AB 2613 ACHADJIAN  Concurrence in Senate Amendments",77,0,0,3,80
853138,534905,2016-04-18,Assembly,"Do pass and be re-referred to the Committee on Agriculture",9,0,0,0,9
853138,537482,2016-04-21,Assembly,"Do pass as amended and be re-referred to the Committee on 	Appropriations",7,0,0,3,10
853138,549075,2016-05-27,Assembly,"Do pass as amended",14,0,0,6,20
853138,550875,2016-06-02,Assembly,"AB 2678 GRAY  Assembly Third Reading",75,2,0,3,80
853138,555002,2016-06-22,Senate,"Do pass, but re-refer to the Committee on Appropriations",5,0,2,0,7
853138,558759,2016-08-01,Senate,"Placed on Appropriations Suspense file",7,0,0,0,7
853139,527945,2016-04-05,Senate,"Do pass, but re-refer to the Committee on Appropriations",7,0,0,0,7
853139,534137,2016-04-18,Senate,"Placed on Appropriations Suspense file",7,0,0,0,7
853139,549045,2016-05-27,Senate,"Do pass as amended",6,1,0,0,7
853139,550844,2016-06-02,Senate,"Senate 3rd Reading SB1389 Glazer",32,5,3,0,40
853139,555936,2016-06-28,Assembly,"Do pass and be re-referred to the Committee on Appropriations",7,0,0,0,7
853139,559345,2016-08-11,Assembly,"Do pass as amended",17,3,0,0,20
853139,560687,2016-08-23,Assembly,"SB 1389 Glazer  Senate Third Reading  By COOLEY",63,13,0,4,80
853139,561166,2016-08-25,Senate,"Unfinished Business SB1389 Glazer Concurrence",33,6,0,0,39
853141,533455,2016-04-12,Assembly,"Do pass as amended and be re-referred to the Committee on Judiciary",7,0,0,0,7
853141,547605,2016-05-23,Assembly,"AB 2580 OLSEN  Assembly Third Reading",77,0,0,3,80
853142,532963,2016-04-13,Assembly,"Do pass and be re-referred to the Committee on Appropriations",0,5,0,2,7
853144,532786,2016-04-12,Assembly,"Do pass and be re-referred to the Committee on Appropriations",13,0,0,0,13
853147,535070,2016-04-19,Senate,"Do pass as amended, and re-refer to the Committee on Appropriations",4,1,2,0,7
853148,528056,2016-04-05,Assembly,"Do pass and be re-referred to the Committee on Appropriations to 	Consent Calendar",7,0,0,0,7
853149,535086,2016-04-19,Assembly,"Do pass and be re-referred to the Committee on Appropriations",6,2,0,2,10
853149,546584,2016-05-18,Assembly,"Do pass",14,5,0,1,20
853149,547595,2016-05-23,Assembly,"AB 2446 GORDON  Assembly Third Reading",50,23,0,7,80
853149,553135,2016-06-15,Senate,"Do pass, but re-refer to the Committee on Judiciary",5,2,0,0,7
853149,556357,2016-06-28,Senate,"Do pass, but re-refer to the Committee on Appropriations",5,2,0,0,7
853149,560117,2016-08-18,Senate,"Assembly 3rd Reading AB2446 Gordon By Leno",23,13,3,0,39
853149,560919,2016-08-24,Assembly,"AB 2446 GORDON  Concurrence in Senate Amendments",53,26,0,1,80
853150,531571,2016-04-12,Assembly,"Do pass and be re-referred to the Committee on Appropriations",4,0,0,3,7
853151,537193,2016-04-20,Senate,"Do pass",2,1,6,0,9
853151,537194,2016-04-20,Senate,"Reconsideration granted",9,0,0,0,9
853152,533099,2016-04-12,Assembly,"Do pass",9,0,0,0,9
853152,537468,2016-04-21,Assembly,"AB 2562 V. A.  Assembly Third Reading",79,0,0,1,80
853152,552700,2016-06-14,Senate,"Do pass",5,0,0,0,5
853152,560674,2016-08-23,Senate,"Assembly 3rd Reading AB2562 Committee On V.A. (Irwin) By Nielsen",39,0,0,0,39
853154,531445,2016-04-12,Assembly,"Do pass and be re-referred to the Committee on Appropriations",3,4,0,0,7
853154,531446,2016-04-12,Assembly,"Reconsideration granted",6,0,0,1,7
853156,527977,2016-04-04,Assembly,"Do pass as amended and be re-referred to the Committee on 	Appropriations",7,2,0,0,9
853157,528276,2016-04-05,Assembly,"Do pass as amended and be re-referred to the Committee on Local 	Government",9,0,0,0,9
853157,532525,2016-04-13,Assembly,"Do pass and be re-referred to the Committee on Appropriations to 	Consent Calendar",8,0,0,1,9
853159,532737,2016-04-13,Senate,"Do pass, but re-refer to the Committee on Appropriations",8,1,0,0,9
853159,544265,2016-04-25,Senate,"Placed on Appropriations Suspense file",7,0,0,0,7
853163,544643,2016-05-09,Assembly,"Do pass as amended and be re-referred to the Committee on 	Appropriations",9,0,0,0,9
853164,527840,2016-04-04,Assembly,"Do pass as amended and be re-referred to the Committee on Natural 	Resources",15,0,0,1,16
853164,535730,2016-04-18,Assembly,"Do pass as amended and be re-referred to the Committee on 	Appropriations",8,1,0,0,9
853165,544869,2016-05-11,Senate,"Do pass",7,0,0,0,7
853165,549404,2016-05-27,Senate,"Senate 3rd Reading SB1304 Huff Urgency Clause",36,0,4,0,40
853165,554855,2016-06-20,Assembly,"Do pass as amended",9,0,0,0,9
853165,561437,2016-08-29,Assembly,"SB 1304 Huff  Third Reading Urgency  By RIDLEY-THOMAS",78,0,0,2,80
853165,561552,2016-08-30,Senate,"Unfinished Business (S upplemental File 2)SB1 304 Huf f Urg",39,0,0,0,39
853166,531558,2016-04-12,Senate,"Do pass",7,2,0,0,9
853166,546140,2016-05-16,Senate,"Senate 3rd Reading SB1340 Wolk",21,12,7,0,40
853166,552654,2016-06-14,Assembly,"Do pass and be re-referred to the Committee on Local Government",6,8,0,1,15
853166,552655,2016-06-14,Assembly,"Reconsideration granted",9,0,0,6,15
853166,556041,2016-06-28,Assembly,"Do pass and be re-referred to the Committee on Local Government",9,5,0,1,15
853166,556803,2016-06-29,Assembly,"Do pass and be re-referred to the Committee on Appropriations",5,3,0,1,9
853166,559544,2016-08-10,Assembly,"Do pass",14,5,0,1,20
853166,560167,2016-08-18,Assembly,"SB 1340 Wolk  Senate Third Reading  By EGGMAN",47,31,0,2,80
853166,560900,2016-08-24,Senate,"Unfinished Business SB1340 Wolk Concurrence",25,14,0,0,39
853169,532938,2016-04-11,Assembly,"Do pass and be re-referred to the Committee on Appropriations",10,0,0,6,16
853170,534883,2016-04-19,Senate,"Do pass, but re-refer to the Committee on Environmental Quality",11,0,0,0,11
853170,537120,2016-04-20,Senate,"Do pass, but re-refer to the Committee on Appropriations",7,0,0,0,7
853170,545807,2016-05-16,Senate,"Placed on Appropriations Suspense file",7,0,0,0,7
853171,532777,2016-04-13,Assembly,"Do pass as amended and be re-referred to the Committee on Privacy 	and Consumer Protection",7,0,0,0,7
853171,534971,2016-04-19,Assembly,"Do pass and be re-referred to the Committee on Appropriations",8,1,0,2,11
853174,536445,2016-04-20,Assembly,"Do pass and be re-referred to the Committee on Appropriations to 	Consent Calendar",7,0,0,0,7
853174,538938,2016-04-27,Assembly,"Do pass, to Consent Calendar",19,0,0,1,20
853174,543041,2016-05-05,Assembly,"AB 2404 COOLEY  Consent Calendar Second Day  Regular Session",79,0,0,1,80
853174,555761,2016-06-27,Senate,"Do pass, but re-refer to the Committee on Appropriations Recommend 	Consent",5,0,0,0,5
853174,559258,2016-08-11,Senate,"Consent Calendar 2nd AB2404 Cooley By Pan",37,0,2,0,39
853174,559864,2016-08-15,Assembly,"AB 2404 COOLEY  Concurrence in Senate Amendments",78,0,0,2,80
853175,544351,2016-05-09,Assembly,"Do pass as amended and be re-referred to the Committee on 	Appropriations",9,0,0,0,9
853176,536564,2016-04-20,Senate,"Do pass, but re-refer to the Committee on Appropriations",5,0,2,0,7
853176,549207,2016-05-27,Senate,"Do pass",6,1,0,0,7
853176,550138,2016-05-31,Senate,"Senate 3rd Reading SB1325 De Le",30,1,9,0,40
853176,555983,2016-06-28,Assembly,"Do pass and be re-referred to the Committee on Appropriations",7,0,0,0,7
853176,559054,2016-08-03,Assembly,"Do pass, to Consent Calendar",20,0,0,0,20
853176,560575,2016-08-22,Assembly,"SB 1325 De Leon  Senate Third Reading  By CALDERON",79,0,0,1,80
853176,561340,2016-08-26,Senate,"Unfinished Business SB1325 De Le",36,0,3,0,39
853179,528669,2016-04-06,Senate,"Do pass as amended, and re-refer to the Committee on Appropriations",4,2,1,0,7
853179,549150,2016-05-27,Senate,"Do pass",5,2,0,0,7
853179,550461,2016-06-01,Senate,"Senate 3rd Reading SB1383 Lara",21,13,6,0,40
853179,559292,2016-08-11,Assembly,"Do pass as amended",11,4,0,5,20
853179,559897,2016-06-27,Assembly,"Do pass and be re-referred to the Committee on Appropriations",6,1,0,2,9
853179,560376,2016-08-19,Assembly,"SB 1383 Lara  Senate Third Reading  Amend By THURMOND  Set #1",46,22,0,12,80
853179,561744,2016-08-30,Assembly,"Do pass as amended",6,1,0,2,9
853179,561745,2016-08-31,Senate,"From committee:  That the Assembly Amendments be concurred in",5,2,0,0,7
853179,561746,2016-08-31,Assembly,"SB 1383 Lara  Senate Third Reading  By THURMOND",44,24,0,12,80
853179,561747,2016-08-31,Senate,"W/O REF. TO FILE SB1383 Lara",25,12,2,0,39
853180,536922,2016-04-20,Senate,"Do pass, but re-refer to the Committee on Appropriations",6,1,0,0,7
853180,549313,2016-05-27,Senate,"Do pass as amended",6,1,0,0,7
853180,551102,2016-06-02,Senate,"Senate 3rd Reading SB1398 Leyva",36,0,4,0,40
853180,556145,2016-06-28,Assembly,"Do pass as amended and be re-referred to the Committee on 	Appropriations",5,1,0,1,7
853180,559609,2016-08-10,Assembly,"Do pass",17,2,0,1,20
853180,561521,2016-08-29,Assembly,"SB 1398 Leyva  Senate Third Reading  By QUIRK",72,7,0,1,80
853180,561792,2016-08-31,Senate,"Unfinished Business SB1398 Leyva Concurrence",39,0,0,0,39
853181,538463,2016-04-25,Assembly,"Do pass as amended and be re-referred to the Committee on Local 	Government",11,1,0,0,12
853181,542505,2016-05-04,Assembly,"Do pass as amended",9,0,0,0,9
853181,547596,2016-05-23,Assembly,"AB 2693 DABABNEH  Assembly Third Reading",75,0,0,5,80
853181,553183,2016-06-15,Senate,"Do pass as amended, and re-refer to the Committee on Judiciary",6,0,1,0,7
853181,556421,2016-06-28,Senate,"Do pass as amended",7,0,0,0,7
853181,560990,2016-08-24,Senate,"Assembly 3rd Reading AB2693 Dababneh By Jackson",39,0,0,0,39
853181,561528,2016-08-30,Assembly,"AB 2693 DABABNEH  Concurrence in Senate Amendments",80,0,0,0,80
853182,542198,2016-05-04,Assembly,"Subject matter be referred",13,0,0,0,13
853184,532594,2016-04-11,Assembly,"Do pass and be re-referred to the Committee on Appropriations to 	Consent Calendar",16,0,0,0,16
853185,535945,2016-04-19,Senate,"Do pass as amended, but re-refer to the Committee on Appropriations 	Recommend Consent",7,0,0,0,7
853185,549227,2016-05-27,Senate,"Do pass",7,0,0,0,7
853185,550131,2016-05-31,Senate,"Senate 3rd Reading SB1295 Nielsen",39,0,1,0,40
853185,554821,2016-06-21,Assembly,"Amend, and do pass as amended and be re-referred to the Committee 	on Appropriations with the recommendation:  To Consent Calendar",7,0,0,0,7
853185,559037,2016-08-03,Assembly,"Do pass",20,0,0,0,20
853185,560544,2016-08-22,Assembly,"SB 1295 Nielsen  Senate Third Reading  By IRWIN",78,1,0,1,80
853185,561489,2016-08-29,Senate,"Special Consent SB1295 Nielsen",39,0,0,0,39
853186,535718,2016-04-18,Assembly,"Do pass and be re-referred to the Committee on Appropriations",9,0,0,0,9
853188,531425,2016-04-12,Assembly,"Do pass and be re-referred to the Committee on Appropriations",12,4,0,3,19
853188,549391,2016-05-27,Assembly,"Do pass as amended",14,0,0,6,20
853188,550931,2016-06-02,Assembly,"AB 2425 BROWN  Assembly Third Reading",52,23,0,5,80
853190,533343,2016-04-14,Assembly,"Be referred to Committee on Health",11,0,0,0,11
853190,535315,2016-04-19,Assembly,"Do pass and be re-referred to the Committee on Appropriations to 	Consent Calendar",16,0,0,3,19
853190,542446,2016-05-04,Assembly,"Do pass, to Consent Calendar",20,0,0,0,20
853190,545424,2016-05-12,Assembly,"AB 2750 GOMEZ  Consent Calendar Second Day  Regular Session",78,0,0,2,80
853190,552139,2016-06-08,Senate,"Do pass, but re-refer to the Committee on Appropriations",7,0,2,0,9
853190,555699,2016-06-27,Senate,"Do pass",6,0,1,0,7
853190,559482,2016-08-11,Senate,"Special Consent AB2750 Gomez",37,0,2,0,39
853190,560301,2016-08-18,Assembly,"AB 2750 GOMEZ  Concurrence in Senate Amendments",79,0,0,1,80
853191,536335,2016-04-20,Senate,"Do pass, but re-refer to the Committee on Appropriations",7,0,0,0,7
853191,549096,2016-05-27,Senate,"Do pass",5,0,2,0,7
853191,550004,2016-05-31,Senate,"Senate 3rd Reading SB1464 De Le",26,5,9,0,40
853191,559344,2016-08-11,Assembly,"Do pass",12,1,0,7,20
853191,559906,2016-06-27,Assembly,"Do pass and be re-referred to the Committee on Appropriations",7,1,0,1,9
853191,561157,2016-08-25,Assembly,"SB 1464 De Leon  Senate Third Reading  By GOMEZ",72,3,0,5,80
853192,542719,2016-05-03,Assembly,"Do pass as amended and be re-referred to the Committee on 	Appropriations",9,0,0,0,9
853192,546843,2016-05-18,Assembly,"Do pass, to Consent Calendar",20,0,0,0,20
853192,549290,2016-05-27,Assembly,"AB 2788 GATTO  Consent Calendar Second Day  Regular Session",67,0,0,13,80
853194,531414,2016-04-12,Assembly,"Do pass and be re-referred to the Committee on Appropriations",13,0,0,2,15
853194,549461,2016-05-27,Assembly,"Do pass as amended",20,0,0,0,20
853194,550541,2016-06-01,Assembly,"AB 2515 WEBER  Assembly Third Reading",79,1,0,0,80
853194,556140,2016-06-28,Senate,"Do pass, but re-refer to the Committee on Appropriations",8,0,1,0,9
853194,558789,2016-08-01,Senate,"Placed on Appropriations Suspense file",7,0,0,0,7
853194,559575,2016-08-11,Senate,"Do pass",7,0,0,0,7
853194,560463,2016-08-22,Senate,"Assembly 3rd Reading AB2515 Weber By Hueso",38,0,1,0,39
853195,531590,2016-04-12,Assembly,"Do pass and be re-referred to the Committee on Education",10,0,0,1,11
853195,542645,2016-05-04,Assembly,"Do pass, to Consent Calendar",7,0,0,0,7
853195,545266,2016-05-12,Assembly,"AB 2799 CHAU  Consent Calendar Second Day  Regular Session",78,0,0,2,80
853195,553272,2016-06-14,Senate,"Do pass as amended. To Consent Calendar",7,0,0,0,7
853195,560897,2016-08-23,Senate,"Assembly 3rd Reading AB2799 Chau By Allen",39,0,0,0,39
853195,561443,2016-08-29,Assembly,"AB 2799 CHAU  Concurrence in Senate Amendments",80,0,0,0,80
853197,528084,2016-04-05,Assembly,"Do pass as amended, to Consent Calendar",10,0,0,0,10
853197,536176,2016-04-20,Assembly,"Do pass, to Consent Calendar",16,0,0,4,20
853197,539664,2016-04-28,Assembly,"AB 2458 OBERNOLTE  Consent Calendar Second Day  Regular Session",76,0,0,4,80
853197,556494,2016-06-28,Senate,"Do pass, but re-refer to the Committee on Appropriations Recommend 	Consent",7,0,0,0,7
853197,558957,2016-08-01,Senate,"Placed on Appropriations Suspense file",7,0,0,0,7
853198,529545,2016-04-06,Assembly,"Do pass, to Consent Calendar",7,0,0,0,7
853198,533468,2016-04-14,Assembly,"AB 2537 O'DONNELL  Consent Calendar Second Day  Regular Session",76,0,0,4,80
853198,552195,2016-06-08,Senate,"Do pass and be placed on the Consent Calendar",9,0,0,0,9
853198,556930,2016-06-30,Senate,"Consent Calendar 2nd AB2537 O'Donnell",37,0,3,0,40
853199,535258,2016-04-19,Senate,"Do pass, but re-refer to the Committee on Appropriations Recommend 	Consent",11,0,0,0,11
853199,543103,2016-05-05,Senate,"Consent Calendar 2nd SB1399 Hueso",36,0,4,0,40
853199,552536,2016-06-13,Assembly,"Do pass and be re-referred to the Committee on Appropriations to 	Consent Calendar",15,0,0,1,16
853199,556436,2016-06-29,Assembly,"Do pass, to Consent Calendar",18,0,0,2,20
853199,559129,2016-08-04,Assembly,"SB 1399 Hueso  Consent Calendar Second Day  Regular Session",77,0,0,3,80
853201,528045,2016-04-05,Assembly,"Do pass as amended and be re-referred to the Committee on 	Appropriations",16,0,0,0,16
853201,549442,2016-05-27,Assembly,"Do pass as amended",20,0,0,0,20
853201,550585,2016-06-01,Assembly,"AB 2485 SANTIAGO  Assembly Third Reading",79,0,0,1,80
853201,555720,2016-06-27,Senate,"Do pass, but re-refer to the Committee on Appropriations",9,0,0,0,9
853201,558864,2016-08-01,Senate,"Placed on Appropriations Suspense file",7,0,0,0,7
853201,559765,2016-08-11,Senate,"Do pass as amended",7,0,0,0,7
853201,560163,2016-08-18,Senate,"Assembly 3rd Reading AB2485 Santiago By Galgiani Urgency Cl",38,0,1,0,39
853201,561087,2016-08-24,Assembly,"AB 2485 SANTIAGO  Concurrence- Urgency Added",80,0,0,0,80
853202,536562,2016-04-20,Assembly,"Do pass as amended and be re-referred to the Committee on 	Appropriations",9,0,0,0,9
853202,544850,2016-05-11,Assembly,"Do pass, to Consent Calendar",20,0,0,0,20
853202,547166,2016-05-19,Assembly,"AB 2450 ACHADJIAN  Consent Calendar Second Day  Regular Session",76,0,0,4,80
853202,556551,2016-06-29,Senate,"Do pass as amended, and re-refer to the Committee on Appropriations",5,0,2,0,7
853202,560005,2016-08-16,Senate,"Assembly 3rd Reading AB2450 Achadjian By Monning",38,0,1,0,39
853202,560859,2016-08-23,Assembly,"AB 2450 ACHADJIAN  Concurrence in Senate Amendments",79,0,0,1,80
853203,537523,2016-04-20,Assembly,"Amend, and do pass as amended and be re-referred to the Committee 	on Appropriations with the recommendation:  To Consent Calendar",7,0,0,0,7
853203,544838,2016-05-11,Assembly,"Do pass, to Consent Calendar",20,0,0,0,20
853203,547013,2016-05-19,Assembly,"AB 2535 RIDLEY-THOMAS  Consent Calendar Second Day  Regular Session",76,0,0,4,80
853203,552049,2016-06-08,Senate,"Do pass, but re-refer to the Committee on Appropriations Recommend 	Consent",4,0,1,0,5
853203,556748,2016-06-30,Senate,"Consent Calendar 2nd AB2535 Ridley-Thomas",37,0,3,0,40
853204,535909,2016-04-19,Assembly,"Do pass and be re-referred to the Committee on Appropriations",7,0,0,0,7
853204,542957,2016-05-04,Assembly,"Do pass",19,1,0,0,20
853204,543944,2016-05-09,Assembly,"AB 2820 CHIU  Assembly Third Reading",68,10,0,2,80
853204,552902,2016-06-14,Senate,"Do pass, but re-refer to the Committee on Appropriations",6,0,1,0,7
853204,560787,2016-08-23,Senate,"Assembly 3rd Reading AB2820 Chiu By Pavley",31,0,8,0,39
853204,561413,2016-08-29,Assembly,"AB 2820 CHIU  Concurrence in Senate Amendments",67,11,0,2,80
853205,533438,2016-04-14,Assembly,"Be referred to Committee on Accountability and Administrative 	Review",11,0,0,0,11
853206,535273,2016-04-19,Senate,"Do pass, but re-refer to the Committee on Appropriations",11,0,0,0,11
853206,547611,2016-05-23,Senate,"Senate 3rd Reading SB1305 Morrell",39,0,1,0,40
853206,555713,2016-06-27,Assembly,"Do pass and be re-referred to the Committee on Appropriations to 	Consent Calendar",15,0,0,1,16
853206,559057,2016-08-03,Assembly,"Do pass, to Consent Calendar",20,0,0,0,20
853206,559365,2016-08-11,Assembly,"SB 1305 Morrell  Consent Calendar Second Day  Regular Session",78,0,0,2,80
853207,528457,2016-04-05,Senate,"Do pass as amended",7,0,0,0,7
853207,533322,2016-04-14,Senate,"Senate 3rd Reading SB1431 Morrell",38,0,2,0,40
853207,552136,2016-06-08,Assembly,"Do pass as amended, to Consent Calendar",9,0,0,1,10
853207,553808,2016-06-16,Assembly,"SB 1431 Morrell  Consent Calendar Second Day  Regular Session",78,0,0,2,80
853207,557095,2016-06-30,Senate,"Special Consent # SB1431 Morrell",37,0,3,0,40
853208,536680,2016-04-20,Assembly,"Do pass as amended and be re-referred to the Committee on 	Appropriations",2,5,0,0,7
853208,536681,2016-04-20,Assembly,"Reconsideration granted",7,0,0,0,7
853209,528773,2016-04-06,Senate,"Do pass, but re-refer to the Committee on Agriculture",6,0,1,0,7
853209,535264,2016-04-19,Senate,"Do pass, but re-refer to the Committee on Appropriations",5,0,0,0,5
853209,545887,2016-05-16,Senate,"Placed on Appropriations Suspense file",7,0,0,0,7
853212,530689,2016-04-11,Assembly,"Do pass as amended and be re-referred to the Committee on Local 	Government",9,0,0,0,9
853212,536426,2016-04-20,Assembly,"Do pass and be re-referred to the Committee on Appropriations",8,0,0,1,9
853212,545161,2016-05-11,Assembly,"Do pass, to Consent Calendar",20,0,0,0,20
853212,547045,2016-05-19,Assembly,"AB 2797 CHIU  Consent Calendar Second Day  Regular Session",76,0,0,4,80
853212,553220,2016-06-15,Senate,"Do pass, but re-refer to the Committee on Natural Resources and 	Water",6,1,0,0,7
853212,556065,2016-06-28,Senate,"Do pass, but re-refer to the Committee on Appropriations",6,2,1,0,9
853212,559706,2016-08-11,Senate,"Placed on Appropriations Suspense file",7,0,0,0,7
853212,560785,2016-08-23,Senate,"Assembly 3rd Reading AB2797 Chiu By Leno",32,7,0,0,39
853212,561474,2016-08-29,Assembly,"AB 2797 CHIU  Concurrence in Senate Amendments",80,0,0,0,80
853214,531955,2016-04-12,Assembly,"Do pass and be re-referred to the Committee on Appropriations",2,4,0,1,7
853216,531396,2016-04-12,Senate,"Do pass, but re-refer to the Committee on Appropriations",7,2,0,0,9
853216,547613,2016-05-23,Senate,"Placed on Appropriations Suspense file",7,0,0,0,7
853216,549300,2016-05-27,Senate,"Do pass",5,1,1,0,7
853216,550061,2016-05-31,Senate,"Senate 3rd Reading SB1374 Lara",30,8,2,0,40
853216,556044,2016-06-28,Assembly,"Do pass and be re-referred to the Committee on Local Government",11,4,0,0,15
853216,556894,2016-06-29,Assembly,"Do pass as amended and be re-referred to the Committee on 	Appropriations",5,3,0,1,9
853216,559498,2016-08-11,Assembly,"Do pass as amended",11,3,0,6,20
853216,560389,2016-08-19,Assembly,"SB 1374 Lara  Senate Third Reading  Amendment  Set #1",73,0,0,7,80
853216,560824,2016-08-23,Assembly,"SB 1374 Lara  Senate Third Reading  By GARCIA, C",57,20,0,3,80
853216,561394,2016-08-29,Senate,"From committee:  That the Assembly Amendments be concurred in",7,0,0,0,7
853216,561648,2016-08-30,Senate,"Unfinished Business SB1374 Lara Concurrence",29,7,3,0,39
853219,542660,2016-05-04,Assembly,"Do pass",2,5,0,0,7
853222,532050,2016-04-12,Assembly,"Do pass as amended and be re-referred to the Committee on Judiciary",15,0,0,1,16
853223,535753,2016-04-19,Senate,"Do pass, but re-refer to the Committee on Appropriations",8,3,0,0,11
853223,545771,2016-05-16,Senate,"Placed on Appropriations Suspense file",7,0,0,0,7
853225,535826,2016-04-19,Assembly,"Do pass and be re-referred to the Committee on Appropriations",3,3,0,1,7
853226,534733,2016-04-18,Assembly,"Do pass and be re-referred to the Committee on Appropriations to 	Consent Calendar",15,0,0,1,16
853226,542450,2016-05-04,Assembly,"Do pass, to Consent Calendar",20,0,0,0,20
853226,545253,2016-05-12,Assembly,"AB 2731 O'DONNELL  Consent Calendar Second Day  Regular Session",78,0,0,2,80
853226,552876,2016-06-14,Senate,"Do pass and be placed on the Consent Calendar",11,0,0,0,11
853226,561138,2016-08-25,Senate,"Assembly 3rd Reading AB2731 O'Donnell By Hall",39,0,0,0,39
853227,530451,2016-04-11,Assembly,"Do pass as amended and be re-referred to the Committee on 	Appropriations",8,0,0,1,9
853227,549081,2016-05-27,Assembly,"Do pass as amended",15,3,0,2,20
853227,550845,2016-06-02,Assembly,"AB 2530 GORDON  Assembly Third Reading",59,11,0,10,80
853227,556270,2016-06-29,Senate,"Do pass, but re-refer to the Committee on Appropriations",5,2,0,0,7
853227,558757,2016-08-01,Senate,"Do pass",5,2,0,0,7
853227,560459,2016-08-22,Senate,"Assembly 3rd Reading AB2530 Gordon By Wieckowski",22,16,1,0,39
853227,561170,2016-08-25,Assembly,"AB 2530 GORDON  Concurrence in Senate Amendments",55,21,0,4,80
853228,533417,2016-04-12,Assembly,"Do pass and be re-referred to the Committee on Appropriations to 	Consent Calendar",7,0,0,0,7
853228,539080,2016-04-27,Assembly,"Do pass, to Consent Calendar",19,0,0,1,20
853228,543255,2016-05-05,Assembly,"AB 2869 CHAVEZ  Consent Calendar Second Day  Regular Session",79,0,0,1,80
853229,537343,2016-04-20,Assembly,"Do pass as amended and be re-referred to the Committee on 	Appropriations",7,0,0,0,7
853229,542852,2016-05-04,Assembly,"Do pass, to Consent Calendar",20,0,0,0,20
853229,545283,2016-05-12,Assembly,"AB 2864 CHAU  Consent Calendar Second Day  Regular Session",78,0,0,2,80
853229,552154,2016-06-08,Senate,"Do pass, but re-refer to the Committee on Appropriations",5,0,4,0,9
853229,559916,2016-08-15,Senate,"Assembly 3rd Reading AB2864 Chau By Pan",35,1,3,0,39
853231,536136,2016-04-18,Assembly,"Do pass and be re-referred to the Committee on Appropriations to 	Consent Calendar",9,0,0,0,9
853231,549421,2016-05-27,Assembly,"Do pass as amended",20,0,0,0,20
853231,550828,2016-06-02,Assembly,"AB 2653 GARCIA, E.  Assembly Third Reading",77,0,0,3,80
853231,556505,2016-06-29,Senate,"Do pass as amended, and re-refer to the Committee on Appropriations",6,0,1,0,7
853231,559190,2016-08-08,Senate,"Placed on Appropriations Suspense file",7,0,0,0,7
853232,532269,2016-04-12,Assembly,"Do pass and be re-referred to the Committee on Appropriations",13,0,0,0,13
853232,549013,2016-05-27,Assembly,"Do pass as amended",20,0,0,0,20
853232,550375,2016-06-01,Assembly,"AB 2506 THURMOND  Assembly Third Reading",78,1,0,1,80
853232,554969,2016-06-22,Senate,"Do pass as amended, and re-refer to the Committee on Appropriations",9,0,0,0,9
853232,558818,2016-08-01,Senate,"Placed on Appropriations Suspense file",7,0,0,0,7
853232,559545,2016-08-11,Senate,"Do pass as amended",7,0,0,0,7
853232,561132,2016-08-25,Senate,"Assembly 3rd Reading AB2506 Thurmond By Beall",39,0,0,0,39
853232,561732,2016-08-31,Assembly,"AB 2506 THURMOND  Concurrence in Senate Amendments",79,0,0,1,80
853233,535362,2016-04-19,Senate,"Do pass, but re-refer to the Committee on Appropriations",5,1,1,0,7
853233,549164,2016-05-27,Senate,"Do pass as amended",5,0,2,0,7
853233,550993,2016-06-02,Senate,"Senate 3rd Reading SB1433 Mitchell",26,8,6,0,40
853233,556120,2016-06-28,Assembly,"Do pass and be re-referred to the Committee on Appropriations",7,0,0,0,7
853233,559400,2016-08-11,Assembly,"Do pass",16,2,0,2,20
853233,560261,2016-08-18,Assembly,"SB 1433 Mitchell  Senate Third Reading  By GARCIA, C",68,2,0,10,80
853234,528653,2016-04-06,Senate,"Do pass, but re-refer to the Committee on Appropriations",4,0,3,0,7
853240,536924,2016-04-20,Senate,"Do pass as amended, and re-refer to the Committee on Appropriations",7,0,0,0,7
853240,547619,2016-05-23,Senate,"Placed on Appropriations Suspense file",7,0,0,0,7
853240,549216,2016-05-27,Senate,"Do pass",7,0,0,0,7
853240,550026,2016-05-31,Senate,"Senate 3rd Reading SB1456 Galgiani",38,0,2,0,40
853240,556134,2016-06-28,Assembly,"Do pass and be re-referred to the Committee on Appropriations",7,0,0,0,7
853240,559396,2016-08-11,Assembly,"Do pass",15,0,0,5,20
853240,560854,2016-08-23,Assembly,"SB 1456 Galgiani  Senate Third Reading  By MATHIS",80,0,0,0,80
853240,561177,2016-08-25,Senate,"Unfinished Business SB1456 Galgiani Concurrence",39,0,0,0,39
853242,529390,2016-04-06,Assembly,"Do pass, to Consent Calendar",7,0,0,0,7
853242,533432,2016-04-14,Assembly,"AB 2519 CALDERON  Consent Calendar Second Day  Regular Session",76,0,0,4,80
853242,553414,2016-06-15,Senate,"Do pass as amended, and re-refer to the Committee on Appropriations",9,0,0,0,9
853242,558827,2016-08-01,Senate,"Placed on Appropriations Suspense file",7,0,0,0,7
853243,531228,2016-04-12,Assembly,"Do pass and be re-referred to the Committee on Appropriations",2,3,0,2,7
853243,531229,2016-04-12,Assembly,"Reconsideration granted",6,0,0,1,7
853243,537244,2016-04-20,Assembly,"Do pass and be re-referred to the Committee on Appropriations",4,2,0,1,7
853245,536687,2016-04-20,Senate,"Do pass as amended, and re-refer to the Committee on Appropriations",7,0,0,0,7
853245,549230,2016-05-27,Senate,"Do pass",6,1,0,0,7
853245,550181,2016-05-31,Senate,"Senate 3rd Reading SB1328 Lara",25,8,7,0,40
853245,556058,2016-06-28,Assembly,"Do pass and be re-referred to the Committee on Appropriations",12,3,0,0,15
853245,559395,2016-08-11,Assembly,"Do pass",11,3,0,6,20
853245,560693,2016-08-23,Assembly,"SB 1328 Lara  Senate Third Reading",77,2,0,1,80
853245,561638,2016-08-30,Senate,"Unfinished Business SB1328 Lara Concurrence",26,12,1,0,39
853246,531952,2016-04-12,Assembly,"Do pass and be re-referred to the Committee on Appropriations to 	Consent Calendar",7,0,0,0,7
853246,536361,2016-04-20,Assembly,"Do pass, to Consent Calendar",16,0,0,4,20
853246,540266,2016-04-28,Assembly,"AB 2417 COOLEY  Consent Calendar Second Day  Regular Session",76,0,0,4,80
853246,554898,2016-06-21,Senate,"Do pass, but re-refer to the Committee on Appropriations Recommend 	Consent",7,0,0,0,7
853246,558918,2016-08-01,Senate,"Do pass",7,0,0,0,7
853246,560282,2016-08-18,Senate,"Special Consent AB2417 Cooley By Mitchell",36,0,3,0,39
853247,532933,2016-04-13,Senate,"Do pass, but re-refer to the Committee on Appropriations",6,1,2,0,9
853247,543776,2016-05-09,Senate,"Senate 3rd Reading SB1451 Mendoza",34,1,5,0,40
853247,555061,2016-06-22,Assembly,"Do pass and be re-referred to the Committee on Appropriations",13,0,0,0,13
853247,556523,2016-06-29,Assembly,"Do pass, to Consent Calendar",18,0,0,2,20
853247,560304,2016-08-18,Assembly,"SB 1451 Mendoza  Senate Third Reading  By DALY",79,0,0,1,80
853247,561060,2016-08-24,Senate,"Unfinished Business SB1451 Mendoza Concurrence",38,1,0,0,39
853248,519501,2016-03-14,Senate,"Senate 3rd Reading SR63 Roth",38,0,2,0,40
853249,536511,2016-04-20,Senate,"Do pass, but re-refer to the Committee on Appropriations",5,2,0,0,7
853249,549289,2016-05-27,Senate,"Do pass",5,2,0,0,7
853249,550092,2016-05-31,Senate,"Senate 3rd Reading SB1387 De Le",22,13,5,0,40
853249,559337,2016-08-11,Assembly,"Do pass",11,4,0,5,20
853249,559904,2016-06-27,Assembly,"Do pass and be re-referred to the Committee on Appropriations",6,2,0,1,9
853249,560390,2016-08-19,Assembly,"SB 1387 De Leon  Senate Third Reading  Amendment  Set #1",73,0,0,7,80
853249,561769,2016-08-31,Assembly,"SB 1387 De Leon  Senate Third Reading  By GARCIA, C",30,36,0,14,80
853251,526430,2016-03-30,Assembly,"Do pass as amended and be re-referred to the Committee on 	Appropriations",14,0,0,1,15
853251,539170,2016-04-27,Assembly,"Do pass as amended, to Consent Calendar",19,0,0,1,20
853252,534874,2016-04-19,Assembly,"Do pass as amended and be re-referred to the Committee on 	Appropriations",14,3,0,2,19
853253,526478,2016-03-29,Assembly,"Do pass as amended",6,0,0,1,7
853253,537993,2016-04-25,Assembly,"AB 2448 BURKE  Assembly Third Reading",76,0,0,4,80
853253,544583,2016-05-10,Senate,"Do pass as amended. To Consent Calendar",5,0,0,0,5
853253,559814,2016-08-15,Senate,"Assembly 3rd Reading AB2448 Burke By Mitchell",38,0,1,0,39
853253,560479,2016-08-22,Assembly,"AB 2448 BURKE  Concurrence in Senate Amendments",78,0,0,2,80
853254,531459,2016-04-12,Senate,"Do pass, but re-refer to the Committee on Appropriations",11,0,2,0,13
853254,540822,2016-05-02,Senate,"Senate 3rd Reading SB1285 Leno",38,0,2,0,40
853254,557015,2016-06-30,Assembly,"Do pass as amended and be re-referred to the Committee on Rules",12,0,0,9,21
853254,559701,2016-08-10,Assembly,"Do pass, to Consent Calendar",19,0,0,1,20
853254,560288,2016-08-18,Assembly,"SB 1285 Leno  Consent Calendar Second Day  Regular Session",78,0,0,2,80
853254,561267,2016-08-25,Senate,"Special Consent SB1285 Leno",39,0,0,0,39
853255,531561,2016-04-12,Assembly,"Do pass as amended and be re-referred to the Committee on 	Appropriations",14,0,0,1,15
853255,539043,2016-04-27,Assembly,"Do pass, to Consent Calendar",19,0,0,1,20
853255,543002,2016-05-05,Assembly,"AB 2488 DABABNEH  Consent Calendar Second Day  Regular Session",79,0,0,1,80
853255,552781,2016-06-14,Senate,"Do pass as amended, and re-refer to the Committee on Appropriations",9,0,0,0,9
853255,561010,2016-08-24,Senate,"Assembly 3rd Reading AB2488 Dababneh By Hertzberg",39,0,0,0,39
853255,561663,2016-08-30,Assembly,"AB 2488 DABABNEH  Concurrence in Senate Amendments",79,0,0,1,80
853257,528453,2016-04-05,Assembly,"Do pass and be re-referred to the Committee on Aging and Long",7,0,0,0,7
853257,535603,2016-04-19,Assembly,"Do pass and be re-referred to the Committee on Appropriations to 	Consent Calendar",6,0,0,1,7
853257,542945,2016-05-04,Assembly,"Do pass, to Consent Calendar",20,0,0,0,20
853257,545355,2016-05-12,Assembly,"AB 2721 RODRIGUEZ  Consent Calendar Second Day  Regular Session",78,0,0,2,80
853257,552912,2016-06-14,Senate,"Do pass, but re-refer to the Committee on Appropriations Recommend 	Consent",7,0,0,0,7
853257,556775,2016-06-30,Senate,"Consent Calendar 2nd AB2721 Rodriguez",37,0,3,0,40
853259,532312,2016-04-13,Assembly,"Do pass and be re-referred to the Committee on Local Government",6,1,0,0,7
853259,536325,2016-04-20,Assembly,"Do pass and be re-referred to the Committee on Appropriations",7,0,0,2,9
853259,544874,2016-05-11,Assembly,"Do pass",14,2,0,4,20
853259,547005,2016-05-19,Assembly,"AB 2442 HOLDEN  Assembly Third Reading",63,8,0,9,80
853259,554695,2016-06-21,Senate,"Do pass, but re-refer to the Committee on Appropriations",9,0,2,0,11
853259,560755,2016-08-23,Senate,"Assembly 3rd Reading AB2442 Holden By Beall",39,0,0,0,39
853259,561391,2016-08-29,Assembly,"AB 2442 HOLDEN  Concurrence in Senate Amendments",67,10,0,3,80
853260,531346,2016-04-12,Assembly,"Do pass as amended and be re-referred to the Committee on 	Appropriations",10,3,0,6,19
853261,535077,2016-04-19,Assembly,"Do pass and be re-referred to the Committee on Appropriations",4,2,0,1,7
853262,544331,2016-05-09,Assembly,"Do pass and be re-referred to the Committee on Appropriations",9,0,0,0,9
853263,535255,2016-04-19,Assembly,"Do pass as amended and be re-referred to the Committee on 	Appropriations",11,1,0,3,15
853263,549424,2016-05-27,Assembly,"Do pass as amended",14,2,0,4,20
853263,555228,2016-06-23,Assembly,"AB 2444 GARCIA, E.  Third Reading Urgency",56,18,0,6,80
853263,555993,2016-06-28,Senate,"Do pass, but re-refer to the Committee on Governance and Finance",6,2,1,0,9
853263,556437,2016-06-29,Senate,"Do pass, but re-refer to the Committee on Appropriations",4,1,2,0,7
853263,558852,2016-08-01,Senate,"Placed on Appropriations Suspense file",7,0,0,0,7
853263,559737,2016-08-11,Senate,"Do pass as amended",5,2,0,0,7
853266,532237,2016-04-12,Assembly,"Do pass and be re-referred to the Committee on Appropriations",9,0,0,0,9
853267,528952,2016-04-06,Assembly,"Do pass and be re-referred to the Committee on Appropriations",17,0,0,4,21
853267,537055,2016-04-20,Assembly,"Do pass, to Consent Calendar",16,0,0,4,20
853267,540246,2016-04-28,Assembly,"AB 2739 CHIU  Consent Calendar Second Day  Regular Session",76,0,0,4,80
853267,553023,2016-06-14,Senate,"Do pass, but re-refer to the Committee on Appropriations",12,0,1,0,13
853267,559881,2016-08-15,Senate,"Assembly 3rd Reading AB2739 Chiu By Leno Urgency Clause",37,0,2,0,39
853268,526592,2016-03-30,Senate,"Do pass as amended, and re-refer to the Committee on Appropriations",8,0,1,0,9
853268,534174,2016-04-18,Senate,"Placed on Appropriations Suspense file",7,0,0,0,7
853268,549245,2016-05-27,Senate,"Do pass",5,1,1,0,7
853268,550139,2016-05-31,Senate,"Senate 3rd Reading SB1435 Jackson",30,3,7,0,40
853268,555314,2016-06-22,Assembly,"Do pass as amended and be re-referred to the Committee on 	Appropriations",5,1,0,1,7
853268,559075,2016-08-03,Assembly,"Do pass as amended",14,5,0,1,20
853268,561480,2016-08-29,Assembly,"SB 1435 Jackson  Senate Third Reading  By BURKE",54,18,0,8,80
853268,561550,2016-08-30,Senate,"Unfinished Business (S upplemental File 1)SB1 435 Jac kson Con",33,2,4,0,39
853270,533253,2016-04-13,Senate,"Do pass as amended, but re-refer to the Committee on Appropriations 	Recommend Consent",9,0,0,0,9
853270,549229,2016-05-27,Senate,"Do pass",7,0,0,0,7
853270,550022,2016-05-31,Senate,"Senate 3rd Reading SB1335 Mitchell",39,0,1,0,40
853270,554964,2016-06-21,Assembly,"Do pass and be re-referred to the Committee on Appropriations to 	Consent Calendar",17,0,0,1,18
853270,559298,2016-08-11,Assembly,"Do pass",20,0,0,0,20
853271,533121,2016-04-12,Assembly,"Do pass and be re-referred to the Committee on Appropriations",7,0,0,0,7
853273,535245,2016-04-19,Senate,"Do pass, but re-refer to the Committee on Appropriations",4,1,0,0,5
853275,533238,2016-04-13,Senate,"Do pass, but re-refer to the Committee on Appropriations",9,0,0,0,9
853276,528342,2016-04-05,Assembly,"From committee:  Be adopted.  To third reading",7,2,0,1,10
853276,537573,2016-04-21,Assembly,"AJR 32 ALEJO  Assembly Third Reading",54,22,0,4,80
853276,553490,2016-06-14,Senate,"Be adopted",4,2,1,0,7
853276,559899,2016-08-15,Senate,"Assembly 3rd Reading AJR32 Alejo By Hertzberg",26,12,1,0,39
853276,560538,2016-08-22,Assembly,"AJR 32 ALEJO  Concurrence in Senate Amendments",54,20,0,6,80
853277,538615,2016-04-25,Assembly,"Do pass, to Consent Calendar",12,0,0,0,12
853277,540940,2016-05-02,Assembly,"AB 2416 WILK  Consent Calendar Second Day",76,0,0,4,80
853277,553427,2016-06-14,Senate,"Do pass as amended. To Consent Calendar",7,0,0,0,7
853277,556857,2016-06-30,Senate,"Consent Calendar 2nd AB2416 Wilk",37,0,3,0,40
853277,558664,2016-08-01,Assembly,"AB 2416 WILK  Concurrence in Senate Amendments",76,0,0,4,80
853278,535389,2016-04-19,Assembly,"Do pass as amended and be re-referred to the Committee on 	Appropriations",7,0,0,0,7
853278,549408,2016-05-27,Assembly,"Do pass as amended",20,0,0,0,20
853278,550451,2016-06-01,Assembly,"AB 2687 ACHADJIAN  Assembly Third Reading",79,0,0,1,80
853278,556381,2016-06-28,Senate,"Do pass, but re-refer to the Committee on Appropriations",7,0,0,0,7
853278,558979,2016-08-01,Senate,"Placed on Appropriations Suspense file",7,0,0,0,7
853278,559687,2016-08-11,Senate,"Do pass",7,0,0,0,7
853278,560250,2016-08-18,Senate,"Assembly 3rd Reading AB2687 Achadjian By Monning",38,0,1,0,39
853281,536540,2016-04-20,Assembly,"Do pass and be re-referred to the Committee on Appropriations",8,0,0,1,9
853281,546550,2016-05-18,Assembly,"Do pass, to Consent Calendar",20,0,0,0,20
853281,549156,2016-05-27,Assembly,"AB 2470 GONZALEZ  Consent Calendar Second Day  Regular Session",67,0,0,13,80
853281,555012,2016-06-22,Senate,"Do pass, but re-refer to the Committee on Appropriations",5,0,2,0,7
853281,559948,2016-08-16,Senate,"Assembly 3rd Reading AB2470 Gonzalez By Anderson",36,0,3,0,39
853283,535767,2016-04-19,Assembly,"Do pass and be re-referred to the Committee on Appropriations",5,6,0,4,15
853284,542359,2016-05-04,Assembly,"Do pass, to Consent Calendar",20,0,0,0,20
853284,544536,2016-04-19,Assembly,"Do pass and be re-referred to the Committee on Appropriations",13,0,0,0,13
853284,545449,2016-05-12,Assembly,"AB 2791 MEDINA  Consent Calendar Second Day  Regular Session",78,0,0,2,80
853284,552134,2016-06-08,Senate,"Do pass, but re-refer to the Committee on Appropriations Recommend 	Consent",9,0,0,0,9
853284,556896,2016-06-30,Senate,"Consent Calendar 2nd AB2791 Medina",37,0,3,0,40
853285,547897,2016-05-24,Senate,"Do pass, but re-refer to the Committee on Appropriations",5,0,0,0,5
853285,549172,2016-05-27,Senate,"Placed on Appropriations Suspense file",7,0,0,0,7
853285,549173,2016-05-27,Senate,"Do pass",7,0,0,0,7
853285,550028,2016-05-31,Senate,"Senate 3rd Reading SB1354 Galgiani Urgency Clause",38,0,2,0,40
853285,556320,2016-06-29,Assembly,"Do pass and be re-referred to the Committee on Appropriations to 	Consent Calendar",9,0,0,1,10
853287,528277,2016-04-05,Assembly,"Do pass as amended and be re-referred to the Committee on 	Appropriations",15,0,0,1,16
853287,539007,2016-04-27,Assembly,"Do pass, to Consent Calendar",19,0,0,1,20
853287,543107,2016-05-05,Assembly,"AB 2529 LINDER  Consent Calendar Second Day  Regular Session",79,0,0,1,80
853287,554925,2016-06-20,Senate,"Do pass, but re-refer to the Committee on Appropriations",9,0,0,0,9
853287,560417,2016-08-19,Senate,"Assembly 3rd Reading AB2529 Linder By Berryhill",37,0,2,0,39
853288,544361,2016-05-09,Assembly,"Do pass as amended and be re-referred to the Committee on 	Appropriations",9,0,0,0,9
853289,531401,2016-04-12,Assembly,"Do pass and be re-referred to the Committee on Appropriations to 	Consent Calendar",10,0,0,0,10
853289,539246,2016-04-27,Assembly,"Do pass, to Consent Calendar",19,0,0,1,20
853289,542970,2016-05-05,Assembly,"AB 2872 PATTERSON  Consent Calendar Second Day  Regular Session",79,0,0,1,80
853289,553128,2016-06-15,Senate,"Do pass, but re-refer to the Committee on Judiciary Recommend 	Consent",9,0,0,0,9
853289,555006,2016-06-21,Senate,"Do pass, but re-refer to the Committee on Appropriations Recommend 	Consent",7,0,0,0,7
853289,559878,2016-08-15,Senate,"Assembly 3rd Reading AB2872 Patterson By Cannella",38,0,1,0,39
853289,560464,2016-08-22,Assembly,"AB 2872 PATTERSON  Concurrence in Senate Amendments",78,0,0,2,80
853290,528283,2016-04-05,Assembly,"Do pass as amended",10,0,0,0,10
853290,543832,2016-05-09,Assembly,"AB 2566 NAZARIAN  Assembly Third Reading",72,2,0,6,80
853290,553417,2016-06-14,Senate,"Do pass",6,1,0,0,7
853290,559862,2016-08-15,Senate,"Assembly 3rd Reading AB2566 Nazarian By Lara",32,4,3,0,39
853290,560600,2016-08-22,Assembly,"AB 2566 NAZARIAN  Concurrence in Senate Amendments",74,2,0,4,80
853292,528190,2016-04-05,Assembly,"Do pass and be re-referred to the Committee on Appropriations",10,0,0,1,11
853292,549258,2016-05-27,Assembly,"Do pass as amended",20,0,0,0,20
853292,550428,2016-06-01,Assembly,"AB 2828 CHAU  Assembly Third Reading",79,1,0,0,80
853292,555092,2016-06-21,Senate,"Do pass, but re-refer to the Committee on Appropriations",7,0,0,0,7
853292,558924,2016-08-01,Senate,"Placed on Appropriations Suspense file",7,0,0,0,7
853292,559517,2016-08-11,Senate,"Do pass",7,0,0,0,7
853292,560857,2016-08-23,Senate,"Assembly 3rd Reading AB2828 Chau By Leno",39,0,0,0,39
853294,531491,2016-04-12,Assembly,"Do pass as amended and be re-referred to the Committee on Privacy 	and Consumer Protection",10,0,0,0,10
853294,535067,2016-04-19,Assembly,"Do pass and be re-referred to the Committee on Appropriations",9,0,0,2,11
853294,544875,2016-05-11,Assembly,"Do pass, to Consent Calendar",20,0,0,0,20
853294,547591,2016-05-23,Assembly,"AB 2611 LOW  Assembly Third Reading",76,0,0,4,80
853294,555014,2016-06-21,Senate,"Do pass, but re-refer to the Committee on Public Safety",6,1,0,0,7
853294,556292,2016-06-28,Senate,"Do pass, but re-refer to the Committee on Appropriations",6,1,0,0,7
853294,559820,2016-08-15,Senate,"Assembly 3rd Reading AB2611 Low By Galgiani",23,6,10,0,39
853295,531915,2016-04-12,Assembly,"Do pass as amended and be re-referred to the Committee on 	Appropriations",10,0,0,0,10
853295,542209,2016-05-04,Assembly,"Do pass, to Consent Calendar",20,0,0,0,20
853295,545447,2016-05-12,Assembly,"AB 2853 GATTO  Consent Calendar Second Day  Regular Session",78,0,0,2,80
853295,553199,2016-06-14,Senate,"Do pass as amended, and re-refer to the Committee on Appropriations",7,0,0,0,7
853295,559854,2016-08-15,Senate,"Assembly 3rd Reading AB2853 Gatto By Liu",38,0,1,0,39
853295,560549,2016-08-22,Assembly,"AB 2853 GATTO  Concurrence in Senate Amendments",79,0,0,1,80
853296,544638,2016-05-09,Assembly,"Do pass and be re-referred to the Committee on Appropriations",9,0,0,0,9
853297,526314,2016-03-30,Assembly,"Do pass as amended and be re-referred to the Committee on 	Appropriations",9,0,0,0,9
853298,544317,2016-05-09,Assembly,"Do pass as amended and be re-referred to the Committee on 	Appropriations",9,0,0,0,9
853299,528650,2016-04-06,Senate,"Do pass, but re-refer to the Committee on Judiciary",9,0,0,0,9
853299,534143,2016-04-18,Senate,"Placed on Appropriations Suspense file",7,0,0,0,7
853299,549184,2016-05-27,Senate,"Do pass as amended",6,0,1,0,7
853299,550910,2016-06-02,Senate,"Senate 3rd Reading SB1439 Block",36,1,3,0,40
853299,554662,2016-06-21,Assembly,"Do pass and be re-referred to the Committee on Appropriations",12,0,0,1,13
853299,558984,2016-08-03,Assembly,"Do pass, to Consent Calendar",20,0,0,0,20
853299,560141,2016-08-18,Assembly,"SB 1439 Block  Senate Third Reading  By BONILLA",78,0,0,2,80
853299,560953,2016-08-24,Senate,"Unfinished Business SB1439 Block Concurrence",38,1,0,0,39
853300,544072,2016-05-09,Assembly,"Do pass and be re-referred to the Committee on Appropriations",10,0,0,1,11
853300,546899,2016-05-18,Assembly,"Do pass, to Consent Calendar",20,0,0,0,20
853300,549082,2016-05-27,Assembly,"AB 2704 GIPSON  Consent Calendar Second Day  Regular Session",67,0,0,13,80
853300,560621,2016-08-22,Senate,"Assembly 3rd Reading AB2704 Gipson By Hertzberg",38,0,1,0,39
853301,536582,2016-04-20,Senate,"Do pass and be placed on the Consent Calendar",7,0,0,0,7
853302,529524,2016-04-06,Senate,"Do pass, but re-refer to the Committee on Public Safety",9,0,0,0,9
853302,535262,2016-04-19,Senate,"Do pass as amended, and re-refer to the Committee on Appropriations",7,0,0,0,7
853302,549319,2016-05-27,Senate,"Do pass as amended",7,0,0,0,7
853302,550936,2016-06-02,Senate,"Special Consent # SB1404 Leno",39,0,1,0,40
853302,554851,2016-06-21,Assembly,"Do pass and be re-referred to the Committee on Health",7,0,0,0,7
853302,556522,2016-06-28,Assembly,"Do pass and be re-referred to the Committee on Appropriations",18,0,0,0,18
853303,533140,2016-04-13,Assembly,"Do pass as amended and be re-referred to the Committee on 	Appropriations",7,0,0,0,7
853305,530739,2016-04-11,Senate,"Do pass, but re-refer to the Committee on Appropriations Recommend 	Consent",5,0,0,0,5
853305,537178,2016-04-21,Senate,"Consent Calendar 2nd SB1352 Committee On P.E. & R. (Pan)",39,0,1,0,40
853305,555165,2016-06-22,Assembly,"Do pass and be re-referred to the Committee on Appropriations to 	Consent Calendar",6,0,0,1,7
853305,556481,2016-06-29,Assembly,"Do pass, to Consent Calendar",18,0,0,2,20
853305,559158,2016-08-04,Assembly,"SB 1352 P.E.& R.  Consent Calendar Second Day  Regular Session",77,0,0,3,80
853305,559440,2016-08-11,Senate,"Special Consent SB1352 Committee On P.E. and R. (Pan) Concurrence",37,0,2,0,39
853309,535592,2016-04-19,Assembly,"Do pass as amended and be re-referred to the Committee on 	Appropriations",15,0,0,4,19
853311,542504,2016-05-04,Assembly,"Do pass",5,6,0,4,15
853312,532257,2016-04-13,Assembly,"Do pass and be re-referred to the Committee on Appropriations",5,2,0,0,7
853312,539283,2016-04-27,Assembly,"Do pass as amended",13,6,0,1,20
853312,550289,2016-05-31,Assembly,"AB 2466 WEBER  Assembly Third Reading",41,37,0,2,80
853312,554848,2016-06-21,Senate,"Do pass, but re-refer to the Committee on Appropriations",4,1,0,0,5
853312,559955,2016-08-16,Senate,"Assembly 3rd Reading AB2466 Weber By Hertzberg",23,13,3,0,39
853313,544582,2016-04-19,Assembly,"Do pass as amended and be re-referred to the Committee on 	Appropriations",13,0,0,0,13
853314,530733,2016-04-11,Senate,"Do pass, but re-refer to the Committee on Judiciary",3,2,0,0,5
853314,535237,2016-04-19,Senate,"Do pass, but re-refer to the Committee on Appropriations",5,2,0,0,7
853314,543814,2016-05-09,Senate,"Senate 3rd Reading SB1353 Pan",25,10,5,0,40
853314,555130,2016-06-22,Assembly,"Do pass and be re-referred to the Committee on Appropriations",6,0,0,1,7
853314,556509,2016-06-29,Assembly,"Do pass, to Consent Calendar",18,0,0,2,20
853314,559119,2016-08-04,Assembly,"SB 1353 Pan  Consent Calendar Second Day  Regular Session",77,0,0,3,80
853314,559891,2016-08-15,Senate,"From committee:  That the Assembly Amendments be concurred in",5,0,0,0,5
853314,561093,2016-08-24,Senate,"Unfinished Business SB1353 Pan Concurrence",39,0,0,0,39
853316,535725,2016-04-19,Assembly,"Do pass and be re-referred to the Committee on Appropriations",7,0,0,0,7
853317,537139,2016-04-20,Assembly,"Do pass as amended and be re-referred to the Committee on 	Appropriations",14,0,0,1,15
853317,549039,2016-05-27,Assembly,"Do pass",20,0,0,0,20
853317,550069,2016-05-31,Assembly,"AB 2861 TING  Assembly Third Reading",80,0,0,0,80
853317,555738,2016-06-27,Senate,"Do pass, but re-refer to the Committee on Appropriations",9,0,2,0,11
853317,558847,2016-08-01,Senate,"Placed on Appropriations Suspense file",7,0,0,0,7
853317,559520,2016-08-11,Senate,"Do pass",7,0,0,0,7
853317,561029,2016-08-24,Senate,"Assembly 3rd Reading AB2861 Ting By Hueso",39,0,0,0,39
853317,561660,2016-08-30,Assembly,"AB 2861 TING  Concurrence in Senate Amendments",80,0,0,0,80
853319,531260,2016-04-12,Senate,"Do pass, but re-refer to the Committee on Appropriations",6,0,1,0,7
853319,544329,2016-04-25,Senate,"Placed on Appropriations Suspense file",7,0,0,0,7
853320,535472,2016-04-19,Assembly,"Do pass as amended and be re-referred to the Committee on 	Appropriations",11,6,0,2,19
853320,549101,2016-05-27,Assembly,"Do pass as amended",14,6,0,0,20
853320,550884,2016-06-02,Assembly,"AB 2467 GOMEZ  Assembly Third Reading",33,36,0,11,80
853321,525760,2016-03-29,Senate,"Do pass as amended, and re-refer to the Committee on Health",4,0,1,0,5
853321,537399,2016-04-20,Senate,"Do pass as amended, and re-refer to the Committee on Appropriations",7,0,2,0,9
853321,545961,2016-05-16,Senate,"Placed on Appropriations Suspense file",7,0,0,0,7
853321,549214,2016-05-27,Senate,"Do pass as amended",7,0,0,0,7
853321,550706,2016-06-01,Senate,"Senate 3rd Reading SB1339 Monning",39,0,1,0,40
853321,556124,2016-06-28,Assembly,"Do pass as amended and be re-referred to the Committee on 	Appropriations",7,0,0,0,7
853321,559042,2016-08-03,Assembly,"Do pass",20,0,0,0,20
853321,560440,2016-08-19,Assembly,"SB 1339 Monning  Senate Third Reading  By L.& E.  Amendment  Set #1",73,0,0,7,80
853321,560585,2016-08-22,Assembly,"SB 1339 Monning  Senate Third Reading  By BONILLA",77,1,0,2,80
853321,561297,2016-08-25,Senate,"Unfinished Business SB1339 Monning Concurrence",39,0,0,0,39
853323,527975,2016-04-05,Assembly,"Do pass and be re-referred to the Committee on Banking and Finance",10,0,0,0,10
853323,535799,2016-04-18,Assembly,"Do pass and be re-referred to the Committee on Appropriations",11,0,0,1,12
853323,549314,2016-05-27,Assembly,"Do pass as amended",20,0,0,0,20
853323,550407,2016-06-01,Assembly,"AB 2759 LEVINE  Assembly Third Reading",80,0,0,0,80
853323,553226,2016-06-15,Senate,"Do pass as amended, and re-refer to the Committee on Judiciary",7,0,0,0,7
853323,556353,2016-06-28,Senate,"Do pass as amended, and re-refer to the Committee on Appropriations",7,0,0,0,7
853323,559193,2016-08-08,Senate,"Placed on Appropriations Suspense file",7,0,0,0,7
853323,559672,2016-08-11,Senate,"Do pass as amended",5,0,2,0,7
853323,560535,2016-08-22,Senate,"Assembly 3rd Reading AB2759 Levine By Vidak",39,0,0,0,39
853323,561298,2016-08-25,Assembly,"AB 2759 LEVINE  Concurrence in Senate Amendments",78,0,0,2,80
853324,534731,2016-04-18,Assembly,"Do pass and be re-referred to the Committee on Appropriations to 	Consent Calendar",15,0,0,1,16
853324,542511,2016-05-04,Assembly,"Do pass, to Consent Calendar",20,0,0,0,20
853324,545323,2016-05-12,Assembly,"AB 2542 GATTO  Consent Calendar Second Day  Regular Session",78,0,0,2,80
853324,552923,2016-06-14,Senate,"Do pass, but re-refer to the Committee on Appropriations Recommend 	Consent",11,0,0,0,11
853324,558919,2016-08-01,Senate,"Do pass",7,0,0,0,7
853324,560257,2016-08-18,Senate,"Special Consent AB2542 Gatto By Hertzberg",36,0,3,0,39
853325,528818,2016-04-06,Senate,"Do pass, but re-refer to the Committee on Health",7,2,0,0,9
853325,537332,2016-04-20,Senate,"Do pass, but re-refer to the Committee on Appropriations",8,0,1,0,9
853325,545981,2016-05-16,Senate,"Placed on Appropriations Suspense file",7,0,0,0,7
853326,536668,2016-04-20,Senate,"Do pass, but re-refer to the Committee on Rules",4,2,1,0,7
853326,549226,2016-05-27,Senate,"Do pass as amended",5,2,0,0,7
853326,550968,2016-06-02,Senate,"Senate 3rd Reading SB1282 Leno",15,18,7,0,40
853326,550969,2016-06-02,Senate,"Senate 3rd Reading SB1282 Leno Reconsider",38,0,2,0,40
853328,532531,2016-04-13,Assembly,"Do pass and be re-referred to the Committee on Local Government",6,1,0,0,7
853328,536440,2016-04-20,Assembly,"Do pass and be re-referred to the Committee on Appropriations",6,3,0,0,9
853330,526377,2016-03-30,Assembly,"Do pass and be re-referred to the Committee on Revenue and Taxation",7,0,0,0,7
853330,544659,2016-05-09,Assembly,"Do pass as amended and be re-referred to the Committee on 	Appropriations",9,0,0,0,9
853330,548972,2016-05-27,Assembly,"Do pass as amended",19,0,0,1,20
853330,550638,2016-06-01,Assembly,"AB 2817 CHIU  Assembly Third Reading",79,0,0,1,80
853330,555161,2016-06-22,Senate,"Do pass, but re-refer to the Committee on Transportation and 	Housing",5,0,2,0,7
853330,558893,2016-08-01,Senate,"Placed on Appropriations Suspense file",7,0,0,0,7
853332,534716,2016-04-18,Assembly,"Do pass as amended and be re-referred to the Committee on 	Appropriations",9,2,0,5,16
853332,549413,2016-05-27,Assembly,"Do pass as amended",14,3,0,3,20
853332,551038,2016-06-02,Assembly,"AB 2730 ALEJO  Assembly Third Reading",55,23,0,2,80
853332,559189,2016-08-08,Senate,"Placed on Appropriations Suspense file",7,0,0,0,7
853332,559662,2016-08-11,Senate,"Do pass",7,0,0,0,7
853332,560254,2016-08-18,Senate,"Assembly 3rd Reading AB2730 Alejo By Monning",38,0,1,0,39
853333,534855,2016-04-18,Assembly,"Do pass and be re-referred to the Committee on Insurance",9,0,0,0,9
853333,536189,2016-04-20,Assembly,"Do pass as amended and be re-referred to the Committee on 	Appropriations",13,0,0,0,13
853333,549183,2016-05-27,Assembly,"Do pass",20,0,0,0,20
853333,550017,2016-05-31,Assembly,"AB 2728 ATKINS  Assembly Third Reading",80,0,0,0,80
853333,555024,2016-06-22,Senate,"Do pass, but re-refer to the Committee on Governance and Finance 	Recommend Consent",8,0,1,0,9
853333,556287,2016-06-29,Senate,"Do pass, but re-refer to the Committee on Appropriations",7,0,0,0,7
853333,558763,2016-08-01,Senate,"Placed on Appropriations Suspense file",7,0,0,0,7
853333,559527,2016-08-11,Senate,"Do pass",7,0,0,0,7
853333,561226,2016-08-25,Senate,"Assembly 3rd Reading AB2728 Atkins By Roth",39,0,0,0,39
853333,561538,2016-08-30,Assembly,"AB 2728 ATKINS  Concurrence in Senate Amendments",80,0,0,0,80
853334,533359,2016-04-13,Assembly,"Do pass and be re-referred to the Committee on Education",7,0,0,0,7
853334,544738,2016-04-19,Assembly,"Do pass and be re-referred to the Committee on Appropriations",13,0,0,0,13
853335,537084,2016-04-20,Assembly,"Do pass as amended and be re-referred to the Committee on 	Appropriations",7,0,0,0,7
853336,536489,2016-04-20,Senate,"Do pass",9,0,0,0,9
853336,545965,2016-05-16,Senate,"Senate 3rd Reading SB1343 Wolk",35,0,5,0,40
853336,555375,2016-06-22,Assembly,"Do pass",7,0,0,0,7
853336,559141,2016-08-04,Assembly,"SB 1343 Wolk  Senate Third Reading  By OLSEN",77,0,0,3,80
853337,542733,2016-05-03,Senate,"Do pass as amended",4,2,1,0,7
853337,549976,2016-05-31,Senate,"Senate 3rd Reading SB1428 Hernandez",26,13,1,0,40
853338,534900,2016-04-19,Assembly,"Do pass and be re-referred to the Committee on Appropriations to 	Consent Calendar",16,0,0,3,19
853339,525537,2016-03-28,Senate,"Senate 3rd Reading SR62 McGuire",36,0,4,0,40
853340,528093,2016-04-05,Assembly,"Do pass and be re-referred to the Committee on Appropriations",11,0,0,0,11
853342,536219,2016-04-20,Assembly,"Do pass as amended and be re-referred to the Committee on 	Appropriations",7,0,0,0,7
853342,546590,2016-05-18,Assembly,"Do pass, to Consent Calendar",20,0,0,0,20
853342,549073,2016-05-27,Assembly,"AB 2783 GARCIA, E.  Consent Calendar Second Day  Regular Session",67,0,0,13,80
853342,554620,2016-06-21,Senate,"Do pass as amended, and re-refer to the Committee on Environmental 	Quality",10,0,1,0,11
853342,556347,2016-06-29,Senate,"Do pass, but re-refer to the Committee on Appropriations",2,3,2,0,7
853342,556348,2016-06-29,Senate,"Set, first hearing.  Failed passage in Committee.  Reconsideration 	granted",6,0,1,0,7
853343,527958,2016-04-05,Assembly,"Do pass as amended and be re-referred to the Committee on Privacy 	and Consumer Protection",10,0,0,0,10
853343,534906,2016-04-19,Assembly,"Do pass and be re-referred to the Committee on Appropriations to 	Consent Calendar",11,0,0,0,11
853343,544862,2016-05-11,Assembly,"Do pass, to Consent Calendar",20,0,0,0,20
853343,547035,2016-05-19,Assembly,"AB 2498 BONTA  Consent Calendar Second Day  Regular Session",76,0,0,4,80
853343,553113,2016-06-14,Senate,"Do pass as amended, and re-refer to the Committee on Public Safety",7,0,0,0,7
853343,556403,2016-06-28,Senate,"Do pass, but re-refer to the Committee on Appropriations",7,0,0,0,7
853343,558787,2016-08-01,Senate,"Placed on Appropriations Suspense file",7,0,0,0,7
853343,559574,2016-08-11,Senate,"Do pass as amended",7,0,0,0,7
853343,560763,2016-08-23,Senate,"Assembly 3rd Reading AB2498 Bonta By Mitchell",39,0,0,0,39
853343,561400,2016-08-29,Assembly,"AB 2498 BONTA  Concurrence in Senate Amendments",80,0,0,0,80
853344,536563,2016-04-20,Assembly,"Do pass and be re-referred to the Committee on Appropriations",7,0,0,2,9
853344,546722,2016-05-18,Assembly,"Do pass as amended",17,3,0,0,20
853344,549392,2016-05-27,Assembly,"AB 2737 BONTA  Assembly Third Reading",59,10,0,11,80
853344,556923,2016-06-29,Senate,"Do pass, but re-refer to the Committee on Appropriations",7,0,2,0,9
853344,560704,2016-08-23,Senate,"Assembly 3rd Reading AB2737 Bonta By Wieckowski",28,9,2,0,39
853344,561486,2016-08-29,Assembly,"AB 2737 BONTA  Concurrence in Senate Amendments",66,12,0,2,80
853345,531794,2016-04-12,Senate,"Do pass, but re-refer to the Committee on Judiciary",12,0,1,0,13
853345,535261,2016-04-19,Senate,"Do pass as amended, but re-refer to the Committee on Appropriations 	Recommend Consent",7,0,0,0,7
853345,548667,2016-05-26,Senate,"Senate 3rd Reading SB1442 Liu",39,0,1,0,40
853345,556004,2016-06-28,Assembly,"Do pass as amended and be re-referred to the Committee on 	Appropriations",10,0,0,0,10
853345,559018,2016-08-03,Assembly,"Do pass as amended, to Consent Calendar",20,0,0,0,20
853345,560130,2016-08-18,Assembly,"SB 1442 Liu  Senate Third Reading  By RIDLEY-THOMAS",79,0,0,1,80
853345,561205,2016-08-25,Senate,"Special Consent SB1442 Liu",39,0,0,0,39
853346,527956,2016-04-05,Assembly,"Do pass as amended and be re-referred to the Committee on Revenue 	and Taxation",9,0,0,0,9
853346,544294,2016-05-09,Assembly,"Do pass as amended and be re-referred to the Committee on 	Appropriations",9,0,0,0,9
853347,536045,2016-04-20,Assembly,"Do pass as amended and be re-referred to the Committee on Judiciary",6,1,0,0,7
853347,541333,2016-05-03,Assembly,"Do pass",9,0,0,1,10
853347,543775,2016-05-09,Assembly,"AB 2584 DALY  Assembly Third Reading",64,9,0,7,80
853347,554643,2016-06-21,Senate,"Do pass as amended",10,1,0,0,11
853347,559811,2016-08-15,Senate,"Assembly 3rd Reading AB2584 Daly By Mendoza",36,0,3,0,39
853347,560746,2016-08-23,Assembly,"AB 2584 DALY  Concurrence in Senate Amendments",68,11,0,1,80
853348,544628,2016-05-09,Assembly,"Do pass as amended and be re-referred to the Committee on 	Appropriations",9,0,0,0,9
853351,536557,2016-04-20,Senate,"Be adopted, but re-refer to the Committee on Elections and 	Constitutional Amendments",6,0,3,0,9
853352,531575,2016-04-12,Assembly,"Do pass and be re-referred to the Committee on Appropriations to 	Consent Calendar",19,0,0,0,19
853352,539186,2016-04-27,Assembly,"Do pass, to Consent Calendar",19,0,0,1,20
853352,542976,2016-05-05,Assembly,"AB 2747 HADLEY  Consent Calendar Second Day  Regular Session",79,0,0,1,80
853352,557152,2016-06-29,Senate,"Do pass as amended, and re-refer to the Committee on Appropriations",8,0,1,0,9
853352,559900,2016-08-15,Senate,"Assembly 3rd Reading AB2747 Hadley By Hernandez",38,0,1,0,39
853352,560497,2016-08-22,Assembly,"AB 2747 HADLEY  Concurrence in Senate Amendments",79,0,0,1,80
853353,544596,2016-04-19,Assembly,"Do pass and be re-referred to the Committee on Appropriations",13,0,0,0,13
853354,539321,2016-04-27,Senate,"Do pass as amended, and re-refer to the Committee on Appropriations",7,0,0,0,7
853354,545978,2016-05-16,Senate,"Placed on Appropriations Suspense file",7,0,0,0,7
853354,549203,2016-05-27,Senate,"Do pass",7,0,0,0,7
853354,550086,2016-05-31,Senate,"Senate 3rd Reading SB1338 Lara",39,0,1,0,40
853357,526324,2016-03-30,Assembly,"Do pass and be re-referred to the Committee on Appropriations to 	Consent Calendar",9,0,0,1,10
853357,549457,2016-05-27,Assembly,"Do pass",20,0,0,0,20
853357,549977,2016-05-31,Assembly,"AB 2511 LEVINE  Assembly Third Reading",80,0,0,0,80
853357,554834,2016-06-21,Senate,"Do pass, but re-refer to the Committee on Appropriations Recommend 	Consent",5,0,0,0,5
853357,558794,2016-08-01,Senate,"Placed on Appropriations Suspense file",7,0,0,0,7
853357,559691,2016-08-11,Senate,"Do pass",7,0,0,0,7
853357,560332,2016-08-18,Senate,"Assembly 3rd Reading AB2511 Levine By Cannella",38,0,1,0,39
853358,527984,2016-04-04,Assembly,"Do pass and be re-referred to the Committee on Accountability and 	Administrative Review to Consent Calendar",9,0,0,0,9
853358,532318,2016-04-13,Assembly,"Do pass and be re-referred to the Committee on Appropriations",8,0,0,1,9
853358,549199,2016-05-27,Assembly,"Do pass",20,0,0,0,20
853358,550029,2016-05-31,Assembly,"AB 2543 GORDON  Assembly Third Reading",78,0,0,2,80
853358,558734,2016-08-01,Senate,"Placed on Appropriations Suspense file",7,0,0,0,7
853359,528859,2016-04-06,Assembly,"Do pass as amended and be re-referred to the Committee on 	Transportation",9,0,0,0,9
853359,534324,2016-04-18,Assembly,"Do pass",15,0,0,1,16
853359,538040,2016-04-25,Assembly,"AB 2690 RIDLEY-THOMAS  Assembly Third Reading",77,0,0,3,80
853359,559321,2016-08-11,Senate,"Consent Calendar 2nd AB2690 Ridley-Thomas",37,0,2,0,39
853360,525897,2016-03-29,Assembly,"Do pass and be re-referred to the Committee on Appropriations",2,5,0,0,7
853360,525898,2016-03-29,Assembly,"Reconsideration granted",6,0,0,1,7
853360,537653,2016-04-20,Assembly,"Do pass and be re-referred to the Committee on Appropriations",2,5,0,0,7
853362,532271,2016-04-13,Senate,"Do pass, but re-refer to the Committee on Health",8,0,1,0,9
853362,537245,2016-04-20,Senate,"Do pass as amended, and re-refer to the Committee on Appropriations",8,0,1,0,9
853362,545775,2016-05-16,Senate,"Placed on Appropriations Suspense file",7,0,0,0,7
853362,549165,2016-05-27,Senate,"Do pass",7,0,0,0,7
853362,549926,2016-05-31,Senate,"Senate 3rd Reading SB1384 Liu",39,0,1,0,40
853362,555020,2016-06-21,Assembly,"Do pass and be re-referred to the Committee on Insurance",6,0,0,1,7
853362,555021,2016-06-22,Assembly,"Do pass and be re-referred to the Committee on Appropriations to 	Consent Calendar",13,0,0,0,13
853362,558993,2016-08-03,Assembly,"Do pass",20,0,0,0,20
853362,560980,2016-08-24,Assembly,"SB 1384 Liu  Senate Third Reading  By ALLEN",80,0,0,0,80
853362,561358,2016-08-29,Senate,"Unfinished Business SB1384 Liu Concurrence",39,0,0,0,39
853363,532368,2016-04-12,Assembly,"Do pass as amended and be re-referred to the Committee on 	Appropriations",12,1,0,0,13
853365,542647,2016-05-04,Assembly,"Do pass, to Consent Calendar",20,0,0,0,20
853365,544608,2016-04-19,Assembly,"Do pass and be re-referred to the Committee on Appropriations",13,0,0,0,13
853365,545493,2016-05-12,Assembly,"AB 2766 LOPEZ  Consent Calendar Second Day  Regular Session",78,0,0,2,80
853365,552153,2016-06-08,Senate,"Do pass, but re-refer to the Committee on Appropriations",9,0,0,0,9
853365,561089,2016-08-24,Senate,"Assembly 3rd Reading AB2766 Lopez By Glazer",39,0,0,0,39
853365,561655,2016-08-30,Assembly,"AB 2766 LOPEZ  Concurrence in Senate Amendments",80,0,0,0,80
853367,528978,2016-04-06,Senate,"Do pass as amended, and re-refer to the Committee on Appropriations",9,0,0,0,9
853367,544567,2016-04-25,Senate,"Placed on Appropriations Suspense file",7,0,0,0,7
853367,549212,2016-05-27,Senate,"Do pass as amended",7,0,0,0,7
853367,550506,2016-06-01,Senate,"Senate 3rd Reading SB1432 Huff",38,1,1,0,40
853367,555427,2016-06-22,Assembly,"Do pass as amended and be re-referred to the Committee on 	Appropriations",7,0,0,0,7
853368,528090,2016-04-05,Assembly,"Do pass as amended and be re-referred to the Committee on 	Environmental Safety and Toxic Materials",9,0,0,0,9
853368,531431,2016-04-12,Assembly,"Do pass and be re-referred to the Committee on Appropriations to 	Consent Calendar",7,0,0,0,7
853368,539005,2016-04-27,Assembly,"Do pass, to Consent Calendar",19,0,0,1,20
853368,543142,2016-05-05,Assembly,"AB 2605 NAZARIAN  Consent Calendar Second Day  Regular Session",79,0,0,1,80
853368,552542,2016-06-13,Senate,"Do pass, but re-refer to the Committee on Appropriations Recommend 	Consent",9,0,0,0,9
853368,556877,2016-06-30,Senate,"Consent Calendar 2nd AB2605 Nazarian",37,0,3,0,40
853369,544285,2016-05-09,Assembly,"Do pass and be re-referred to the Committee on Appropriations",4,4,0,1,9
853370,538960,2016-04-27,Assembly,"Do pass and be re-referred to the Committee on Appropriations",19,0,0,2,21
853370,554960,2016-06-22,Assembly,"Do pass as amended",14,1,0,5,20
853371,528987,2016-04-06,Assembly,"Do pass as amended and be re-referred to the Committee on 	Appropriations",17,0,0,4,21
853371,549147,2016-05-27,Assembly,"Do pass",20,0,0,0,20
853371,549987,2016-05-31,Assembly,"AB 2808 GIPSON  Assembly Third Reading",79,0,0,1,80
853371,558951,2016-08-01,Senate,"Placed on Appropriations Suspense file",7,0,0,0,7
853371,559515,2016-08-11,Senate,"Do pass",7,0,0,0,7
853371,560265,2016-08-18,Senate,"Assembly 3rd Reading AB2808 Gipson By Block",38,0,1,0,39
853372,531896,2016-04-12,Senate,"Do pass and be placed on the Consent Calendar",6,0,1,0,7
853372,537406,2016-04-21,Senate,"Consent Calendar 2nd SB1324 Hancock",39,0,1,0,40
853372,552947,2016-06-14,Assembly,"Do pass",7,0,0,0,7
853372,560581,2016-08-22,Assembly,"SB 1324 Hancock  Senate Third Reading  By BONTA",79,0,0,1,80
853372,561263,2016-08-25,Senate,"From committee:  That the Assembly Amendments be concurred in",7,0,0,0,7
853372,561514,2016-08-29,Senate,"Unfinished Business SB1324 Hancock Concurrence",39,0,0,0,39
853375,534824,2016-04-19,Senate,"Do pass, but re-refer to the Committee on Appropriations",5,2,0,0,7
853375,545832,2016-05-16,Senate,"Placed on Appropriations Suspense file",7,0,0,0,7
853375,548956,2016-05-27,Senate,"Do pass as amended",5,2,0,0,7
853375,550491,2016-06-01,Senate,"Senate 3rd Reading SB1289 Lara",24,14,2,0,40
853375,555943,2016-06-28,Assembly,"Do pass as amended and be re-referred to the Committee on 	Appropriations",7,3,0,0,10
853375,559285,2016-08-11,Assembly,"Do pass",14,6,0,0,20
853375,560364,2016-08-19,Assembly,"SB 1289 Lara  Senate Third Reading  Amendment  Set #1",73,0,0,7,80
853375,560759,2016-08-23,Assembly,"SB 1289 Lara  Senate Third Reading  By JONES-SAWYER",51,28,0,1,80
853375,561581,2016-08-30,Senate,"Unfinished Business (S upplemental File 1)SB1 289 Lar a Con",25,13,1,0,39
853376,528100,2016-04-05,Assembly,"Do pass as amended and be re-referred to the Committee on Business 	and Professions",18,0,0,1,19
853376,535248,2016-04-19,Assembly,"Do pass as amended and be re-referred to the Committee on 	Appropriations",13,0,0,3,16
853377,537131,2016-04-20,Assembly,"Do pass and be re-referred to the Committee on Appropriations",7,0,0,0,7
853378,528819,2016-04-06,Senate,"Do pass",7,0,0,0,7
853378,534521,2016-04-18,Senate,"Senate 3rd Reading SB1371 Galgiani",39,0,1,0,40
853381,537601,2016-04-20,Assembly,"Do pass and be re-referred to the Committee on Appropriations",3,3,0,1,7
853382,532774,2016-04-11,Assembly,"Do pass",10,5,0,1,16
853382,537484,2016-04-21,Assembly,"AB 2509 TING  Assembly Third Reading",45,27,0,8,80
853383,536030,2016-04-18,Assembly,"Do pass and be re-referred to the Committee on Appropriations to 	Consent Calendar",9,0,0,0,9
853383,549287,2016-05-27,Assembly,"Do pass as amended",20,0,0,0,20
853383,550527,2016-06-01,Assembly,"AB 2812 GORDON  Assembly Third Reading",80,0,0,0,80
853383,556647,2016-06-29,Senate,"Do pass, but re-refer to the Committee on Appropriations Recommend 	Consent",7,0,0,0,7
853383,558980,2016-08-01,Senate,"Placed on Appropriations Suspense file",7,0,0,0,7
853383,559521,2016-08-11,Senate,"Do pass as amended",7,0,0,0,7
853383,560098,2016-08-17,Senate,"Assembly 3rd Reading AB2812 Gordon By Pan",39,0,0,0,39
853383,560831,2016-08-23,Assembly,"AB 2812 GORDON  Concurrence in Senate Amendments",80,0,0,0,80
853384,530448,2016-04-11,Assembly,"Be referred to Committee on Business and Professions",9,0,0,2,11
853384,535266,2016-04-19,Assembly,"Do pass and be re-referred to the Committee on Appropriations to 	Consent Calendar",16,0,0,0,16
853384,544906,2016-05-11,Assembly,"Do pass, to Consent Calendar",20,0,0,0,20
853384,547224,2016-05-19,Assembly,"AB 2672 BONILLA  Consent Calendar Second Day  Regular Session",76,0,0,4,80
853386,531508,2016-04-12,Senate,"Do pass, but re-refer to the Committee on Appropriations Recommend 	Consent",12,0,1,0,13
853386,539895,2016-04-28,Senate,"Consent Calendar 2nd SB1313 Hall",37,0,3,0,40
853386,552103,2016-06-08,Assembly,"Do pass and be re-referred to the Committee on Appropriations to 	Consent Calendar",17,0,0,4,21
853386,559698,2016-08-10,Assembly,"Do pass, to Consent Calendar",19,0,0,1,20
853386,560808,2016-08-23,Assembly,"SB 1313 Hall  Third Reading Urgency  By DODD",80,0,0,0,80
853386,561299,2016-08-25,Senate,"Unfinished Business SB1313 Hall Urgency Clause Concurr",39,0,0,0,39
853388,537035,2016-04-20,Assembly,"Do pass and be re-referred to the Committee on Appropriations",12,8,0,1,21
853388,546708,2016-05-18,Assembly,"Do pass",14,6,0,0,20
853388,549022,2016-05-27,Assembly,"AB 2770 NAZARIAN  Assembly Third Reading",44,26,0,10,80
853388,555700,2016-06-27,Senate,"Do pass, but re-refer to the Committee on Appropriations",8,0,1,0,9
853388,558880,2016-08-01,Senate,"Placed on Appropriations Suspense file",7,0,0,0,7
853388,559695,2016-08-11,Senate,"Do pass as amended",5,2,0,0,7
853388,560078,2016-08-17,Senate,"Assembly 3rd Reading AB2770 Nazarian By Beall",27,11,1,0,39
853388,561651,2016-08-30,Assembly,"Senate amendments be concurred in",11,6,0,4,21
853388,561818,2016-08-31,Assembly,"AB 2770 NAZARIAN  Concurrence in Senate Amendments",50,28,0,2,80
853390,529519,2016-04-06,Assembly,"Do pass and be re-referred to the Committee on Appropriations",5,2,0,0,7
853390,549284,2016-05-27,Assembly,"Do pass as amended",14,6,0,0,20
853390,550847,2016-06-02,Assembly,"AB 2757 GONZALEZ  Assembly Third Reading  Amend By GONZALEZ  Set #1",45,28,0,7,80
853390,550848,2016-06-02,Assembly,"AB 2757 GONZALEZ  Assembly Third Reading",38,35,0,7,80
853391,530502,2016-04-11,Assembly,"Be referred to Committee on Privacy and Consumer Protection",9,0,0,2,11
853391,535020,2016-04-19,Assembly,"Do pass and be re-referred to the Committee on Governmental 	Organization",11,0,0,0,11
853391,536428,2016-04-20,Assembly,"Do pass and be re-referred to the Committee on Appropriations",19,0,0,2,21
853392,532675,2016-04-13,Senate,"Do pass as amended",6,0,1,0,7
853392,540840,2016-05-02,Senate,"Senate 3rd Reading SB1367 Runner By Galgiani",38,0,2,0,40
853393,539276,2016-04-27,Senate,"Do pass as amended",8,0,1,0,9
853393,545800,2016-05-16,Senate,"Senate 3rd Reading SB1408 Allen",34,0,6,0,40
853393,548325,2016-05-25,Assembly,"Do pass as amended",15,0,0,3,18
853393,549047,2016-05-27,Assembly,"SB 1408 Allen  Third Reading Urgency  By WOOD",72,0,0,8,80
853393,549048,2016-05-27,Senate,"W/O REF. TO FILE SB1408 Allen Urgency Clause Concurr",38,0,2,0,40
853394,534902,2016-04-19,Assembly,"Do pass and be re-referred to the Committee on Labor and Employment",10,2,0,4,16
853394,537370,2016-04-20,Assembly,"Do pass as amended and be re-referred to the Committee on 	Appropriations",5,1,0,1,7
853394,545082,2016-05-11,Assembly,"Do pass",14,6,0,0,20
853394,547607,2016-05-23,Assembly,"AB 2437 TING  Assembly Third Reading",50,27,0,3,80
853394,554839,2016-06-20,Senate,"Do pass as amended, and re-refer to the Committee on Appropriations",6,1,2,0,9
853394,560099,2016-08-17,Senate,"Assembly 3rd Reading AB2437 Ting By Hill",26,13,0,0,39
853394,560814,2016-08-23,Assembly,"AB 2437 TING  Concurrence in Senate Amendments",54,25,0,1,80
853395,533507,2016-04-13,Assembly,"Do pass and be re-referred to the Committee on Appropriations to 	Consent Calendar",15,0,0,0,15
853395,539311,2016-04-27,Assembly,"Do pass, to Consent Calendar",19,0,0,1,20
853395,542968,2016-05-05,Assembly,"AB 2570 QUIRK  Consent Calendar Second Day  Regular Session",79,0,0,1,80
853395,555729,2016-06-27,Senate,"Do pass as amended, and re-refer to the Committee on Appropriations",9,0,2,0,11
853395,558747,2016-08-01,Senate,"Placed on Appropriations Suspense file",7,0,0,0,7
853395,559603,2016-08-11,Senate,"Do pass as amended",6,0,1,0,7
853395,560037,2016-08-17,Senate,"Assembly 3rd Reading AB2570 Quirk By Hertzberg",39,0,0,0,39
853395,560038,2016-08-17,Senate,"Assembly 3rd Reading AB2570 Quirk By Hertzberg",39,0,0,0,39
853395,560733,2016-08-23,Senate,"Assembly 3rd Reading AB2570 Quirk By Hertzberg",39,0,0,0,39
853395,561584,2016-08-30,Assembly,"Senate amendments be concurred in",14,0,0,1,15
853395,561694,2016-08-31,Assembly,"AB 2570 QUIRK  Concurrence in Senate Amendments",79,0,0,1,80
853396,528003,2016-04-04,Assembly,"Do pass as amended and be re-referred to the Committee on Judiciary",7,2,0,0,9
853396,531242,2016-04-12,Assembly,"Do pass and be re-referred to the Committee on Appropriations",7,2,0,1,10
853396,546598,2016-05-18,Assembly,"Do pass",14,6,0,0,20
853396,550882,2016-06-02,Assembly,"AB 2756 THURMOND  Assembly Third Reading",64,13,0,3,80
853396,552648,2016-06-14,Senate,"Do pass, but re-refer to the Committee on Judiciary",7,1,1,0,9
853396,556338,2016-06-28,Senate,"Do pass, but re-refer to the Committee on Appropriations",7,0,0,0,7
853396,559946,2016-08-16,Senate,"Assembly 3rd Reading AB2756 Thurmond By Lara",36,3,0,0,39
853398,534857,2016-04-18,Assembly,"Do pass and be re-referred to the Committee on Appropriations",6,2,0,1,9
853398,549171,2016-05-27,Assembly,"Do pass as amended",13,6,0,1,20
853398,550838,2016-06-02,Assembly,"AB 2616 BURKE  Assembly Third Reading",49,26,0,5,80
853398,555944,2016-06-28,Senate,"Do pass as amended, and re-refer to the Committee on Appropriations",6,2,1,0,9
853398,559598,2016-08-11,Senate,"Placed on Appropriations Suspense file",7,0,0,0,7
853398,559599,2016-08-11,Senate,"Do pass as amended",5,2,0,0,7
853398,561351,2016-08-29,Senate,"Assembly 3rd Reading AB2616 Burke By Allen",26,13,0,0,39
853398,561548,2016-08-30,Assembly,"AB 2616 BURKE  Concurrence in Senate Amendments",51,25,0,4,80
853399,535496,2016-04-19,Senate,"Do pass, but re-refer to the Committee on Appropriations",4,3,0,0,7
853399,549353,2016-05-27,Senate,"Do pass",5,2,0,0,7
853399,551072,2016-06-02,Senate,"Senate 3rd Reading SB1322 Mitchell",28,10,2,0,40
853399,556113,2016-06-28,Assembly,"Do pass",6,1,0,0,7
853399,560139,2016-08-18,Assembly,"SB 1322 Mitchell  Senate Third Reading  By STONE",42,29,0,9,80
853399,560938,2016-08-24,Senate,"Unfinished Business SB1322 Mitchell Concurrence",29,9,1,0,39
853400,526316,2016-03-30,Assembly,"Do pass and be re-referred to the Committee on Judiciary to Consent 	Calendar",9,0,0,1,10
853400,538457,2016-04-26,Assembly,"Do pass",10,0,0,0,10
853400,539637,2016-04-28,Assembly,"AB 2755 GALLAGHER  Assembly Third Reading",76,0,0,4,80
853400,553496,2016-06-14,Senate,"Do pass",6,0,1,0,7
853400,558670,2016-08-01,Senate,"Assembly 3rd Reading AB2755 Gallagher By Cannella",39,0,0,0,39
853401,531264,2016-04-12,Assembly,"Do pass and be re-referred to the Committee on Privacy and Consumer 	Protection",5,2,0,0,7
853401,534817,2016-04-19,Assembly,"Do pass and be re-referred to the Committee on Appropriations",5,3,0,3,11
853402,535071,2016-04-18,Assembly,"Do pass as amended and be re-referred to the Committee on 	Appropriations",6,3,0,0,9
853402,548958,2016-05-27,Assembly,"Do pass as amended",14,6,0,0,20
853402,550834,2016-06-02,Assembly,"AB 2722 BURKE  Assembly Third Reading",51,26,0,3,80
853402,556364,2016-06-29,Senate,"Do pass as amended, and re-refer to the Committee on Appropriations",5,2,0,0,7
853402,559177,2016-08-08,Senate,"Placed on Appropriations Suspense file",7,0,0,0,7
853402,559630,2016-08-11,Senate,"Do pass as amended",5,2,0,0,7
853402,561724,2016-08-31,Senate,"Assembly 3rd Reading ( Supplemental File 1)AB 2722 Bu rke By",25,12,2,0,39
853402,561725,2016-08-31,Assembly,"AB 2722 BURKE  Concurrence in Senate Amendments",49,27,0,4,80
853403,532935,2016-04-13,Senate,"Do pass as amended, and re-refer to the Committee on Appropriations",8,0,1,0,9
853403,548712,2016-05-26,Senate,"Senate 3rd Reading SB1302 McGuire Urgency Clause",39,0,1,0,40
853403,555168,2016-06-22,Assembly,"Do pass and be re-referred to the Committee on Appropriations to 	Consent Calendar",13,0,0,0,13
853403,559045,2016-08-03,Assembly,"Do pass, to Consent Calendar",20,0,0,0,20
853403,560548,2016-08-22,Assembly,"SB 1302 McGuire  Third Reading Urgency  By COOLEY",79,0,0,1,80
853403,561657,2016-08-30,Senate,"Unfinished Business SB1302 McGuire Urgency Clause Concurr",39,0,0,0,39
853404,531933,2016-04-12,Assembly,"Do pass and be re-referred to the Committee on Transportation",7,0,0,0,7
853404,534277,2016-04-18,Assembly,"Do pass and be re-referred to the Committee on Appropriations",14,0,0,2,16
853404,542889,2016-05-04,Assembly,"Do pass",20,0,0,0,20
853404,543858,2016-05-09,Assembly,"AB 2559 FRAZIER  Assembly Third Reading",76,0,0,4,80
853404,560420,2016-08-19,Senate,"Assembly 3rd Reading AB2559 Frazier By Beall",37,0,2,0,39
853404,560910,2016-08-24,Assembly,"AB 2559 FRAZIER  Concurrence in Senate Amendments",79,0,0,1,80
853405,537150,2016-04-20,Assembly,"Do pass and be re-referred to the Committee on Appropriations",4,2,0,1,7
853405,549006,2016-05-27,Assembly,"Do pass as amended",13,6,0,1,20
853406,532813,2016-04-11,Assembly,"Do pass and be re-referred to the Committee on Appropriations",16,0,0,0,16
853406,548976,2016-05-27,Assembly,"Do pass",20,0,0,0,20
853406,550261,2016-05-31,Assembly,"AB 2796 BLOOM  Assembly Third Reading",78,1,0,1,80
853406,559188,2016-08-08,Senate,"Placed on Appropriations Suspense file",7,0,0,0,7
853407,527950,2016-04-04,Assembly,"Do pass as amended and be re-referred to the Committee on 	Environmental Safety and Toxic Materials",6,2,0,1,9
853407,531234,2016-04-12,Assembly,"Do pass as amended and be re-referred to the Committee on 	Appropriations",4,3,0,0,7
853407,548955,2016-05-27,Assembly,"Do pass as amended",12,6,0,2,20
853407,550827,2016-06-02,Assembly,"AB 2729 WILLIAMS  Assembly Third Reading",62,14,0,4,80
853407,555947,2016-06-28,Senate,"Do pass as amended, and re-refer to the Committee on Appropriations",6,2,1,0,9
853407,559171,2016-08-08,Senate,"Placed on Appropriations Suspense file",7,0,0,0,7
853407,559593,2016-08-11,Senate,"Do pass",6,1,0,0,7
853407,560121,2016-08-18,Senate,"Assembly 3rd Reading AB2729 Williams By Jackson",30,6,3,0,39
853407,560922,2016-08-24,Assembly,"AB 2729 WILLIAMS  Concurrence in Senate Amendments",60,17,0,3,80
853409,532222,2016-04-12,Senate,"Do pass, but re-refer to the Committee on Appropriations",4,0,1,0,5
853409,548948,2016-05-27,Senate,"Do pass",7,0,0,0,7
853409,550033,2016-05-31,Senate,"Senate 3rd Reading SB1427 Pavley",39,0,1,0,40
853409,555992,2016-06-28,Assembly,"Amend, and do pass as amended and be re-referred to the Committee 	on Appropriations with the recommendation:  To Consent Calendar",7,0,0,0,7
853410,544273,2016-05-09,Assembly,"Do pass as amended and be re-referred to the Committee on 	Appropriations",9,0,0,0,9
853410,548971,2016-05-27,Assembly,"Do pass as amended",14,0,0,6,20
853410,550371,2016-06-01,Assembly,"AB 2818 CHIU  Assembly Third Reading",80,0,0,0,80
853410,556404,2016-06-29,Senate,"Do pass, but re-refer to the Committee on Appropriations",6,0,1,0,7
853410,558737,2016-08-01,Senate,"Placed on Appropriations Suspense file",7,0,0,0,7
853410,559274,2016-08-11,Senate,"Do pass",7,0,0,0,7
853410,560511,2016-08-22,Senate,"Assembly 3rd Reading AB2818 Chiu By Allen",39,0,0,0,39
853410,561224,2016-08-25,Assembly,"AB 2818 CHIU  Concurrence in Senate Amendments",79,0,0,1,80
853411,532801,2016-04-12,Assembly,"Do pass as amended and be re-referred to the Committee on 	Appropriations",13,0,0,0,13
853412,526862,2016-03-31,Assembly,"Be referred to Committee on Privacy and Consumer Protection",8,0,0,3,11
853412,541513,2016-05-03,Assembly,"Do pass and be re-referred to the Committee on Appropriations",11,0,0,0,11
853412,549273,2016-05-27,Assembly,"Do pass",20,0,0,0,20
853412,550065,2016-05-31,Assembly,"AB 2623 GORDON  Assembly Third Reading",77,2,0,1,80
853412,558921,2016-08-01,Senate,"Do pass",7,0,0,0,7
853412,560142,2016-08-18,Senate,"Assembly 3rd Reading AB2623 Gordon By Galgiani",38,0,1,0,39
853412,561005,2016-08-24,Assembly,"AB 2623 GORDON  Concurrence in Senate Amendments",79,0,0,1,80
853413,532251,2016-04-13,Assembly,"Do pass and be re-referred to the Committee on Local Government",6,0,0,1,7
853413,536202,2016-04-20,Assembly,"Do pass and be re-referred to the Committee on Appropriations",8,0,0,1,9
853413,544858,2016-05-11,Assembly,"Do pass, to Consent Calendar",20,0,0,0,20
853413,547039,2016-05-19,Assembly,"AB 2556 NAZARIAN  Consent Calendar Second Day  Regular Session",76,0,0,4,80
853413,554618,2016-06-21,Senate,"Do pass, but re-refer to the Committee on Appropriations Recommend 	Consent",11,0,0,0,11
853413,559318,2016-08-11,Senate,"Consent Calendar 2nd AB2556 Nazarian",37,0,2,0,39
853413,561135,2016-08-25,Senate,"Assembly 3rd Reading AB2556 Nazarian By Beall",39,0,0,0,39
853413,561540,2016-08-30,Assembly,"AB 2556 NAZARIAN  Concurrence in Senate Amendments",79,1,0,0,80
853414,529004,2016-04-06,Assembly,"Amend, and do pass as amended and be re-referred to the Committee 	on Natural Resources with the recommendation:  To Consent Calendar",15,0,0,0,15
853414,535057,2016-04-18,Assembly,"Do pass and be re-referred to the Committee on Appropriations to 	Consent Calendar",9,0,0,0,9
853414,549050,2016-05-27,Assembly,"Do pass",20,0,0,0,20
853414,549918,2016-05-31,Assembly,"AB 2630 SALAS  Assembly Third Reading",80,0,0,0,80
853414,555584,2016-06-27,Senate,"Do pass as amended, and re-refer to the Committee on Appropriations",6,0,5,0,11
853414,559704,2016-08-11,Senate,"Placed on Appropriations Suspense file",7,0,0,0,7
853419,537351,2016-04-20,Assembly,"Do pass as amended and be re-referred to the Committee on 	Appropriations",7,0,0,0,7
853420,534925,2016-04-19,Assembly,"Do pass and be re-referred to the Committee on Appropriations to 	Consent Calendar",7,0,0,0,7
853420,542712,2016-05-04,Assembly,"Do pass, to Consent Calendar",20,0,0,0,20
853420,545249,2016-05-12,Assembly,"AB 2839 THURMOND  Consent Calendar Second Day  Regular Session",78,0,0,2,80
853420,556670,2016-06-28,Senate,"Do pass, but re-refer to the Committee on Appropriations Recommend 	Consent",7,0,0,0,7
853420,558959,2016-08-01,Senate,"Placed on Appropriations Suspense file",7,0,0,0,7
853420,559519,2016-08-11,Senate,"Do pass",7,0,0,0,7
853420,560443,2016-08-19,Senate,"Assembly 3rd Reading AB2839 Thurmond By Leno",36,0,3,0,39
853421,528252,2016-04-05,Senate,"Do pass, but re-refer to the Committee on Environmental Quality",7,0,4,0,11
853421,536918,2016-04-20,Senate,"Do pass, but re-refer to the Committee on Appropriations",5,1,1,0,7
853421,545967,2016-05-16,Senate,"Do pass",5,1,1,0,7
853421,548870,2016-05-26,Senate,"Senate 3rd Reading SB1453 De Le",26,10,4,0,40
853421,557138,2016-06-29,Assembly,"Do pass and be re-referred to the Committee on Appropriations",10,4,0,1,15
853421,559070,2016-08-03,Assembly,"Do pass",14,6,0,0,20
853422,531227,2016-04-12,Senate,"Do pass, but re-refer to the Committee on Governance and Finance",6,2,1,0,9
853422,536292,2016-04-20,Senate,"Do pass as amended, and re-refer to the Committee on Appropriations",5,2,0,0,7
853422,550862,2016-06-02,Senate,"Senate 3rd Reading SB1317 Wolk",21,17,2,0,40
853426,538437,2016-04-25,Assembly,"Do pass",9,0,0,0,9
853426,540831,2016-05-02,Assembly,"AB 2691 HOLDEN  Assembly Third Reading",75,0,0,5,80
853426,552106,2016-06-08,Senate,"Do pass as amended",6,1,0,0,7
853426,559882,2016-08-15,Senate,"Assembly 3rd Reading AB2691 Holden By Hertzberg",37,0,2,0,39
853426,560558,2016-08-22,Assembly,"AB 2691 HOLDEN  Concurrence in Senate Amendments",78,0,0,2,80
853427,536385,2016-04-19,Senate,"Do pass, but re-refer to the Committee on Appropriations",3,4,0,0,7
853427,536386,2016-04-19,Senate,"Set, first hearing.  Failed passage in Committee.  Reconsideration 	granted",7,0,0,0,7
853428,536298,2016-04-20,Assembly,"Do pass and be re-referred to the Committee on Appropriations",5,0,0,4,9
853428,548952,2016-05-27,Assembly,"Do pass as amended",18,0,0,2,20
853428,550826,2016-06-02,Assembly,"AB 2476 DALY  Assembly Third Reading",71,4,0,5,80
853428,556390,2016-06-29,Senate,"Do pass as amended, and re-refer to the Committee on Appropriations",7,0,0,0,7
853428,560042,2016-08-17,Senate,"Assembly 3rd Reading AB2476 Daly By Glazer",36,0,3,0,39
853428,560698,2016-08-23,Assembly,"AB 2476 DALY  Concurrence in Senate Amendments",75,3,0,2,80
853429,535243,2016-04-19,Assembly,"Do pass as amended and be re-referred to the Committee on 	Appropriations",9,0,0,0,9
853431,532347,2016-04-13,Assembly,"Do pass and be re-referred to the Committee on Business and 	Professions",7,2,0,1,10
853431,534798,2016-04-19,Assembly,"Do pass and be re-referred to the Committee on Appropriations",13,1,0,2,16
853431,549020,2016-05-27,Assembly,"Do pass",15,1,0,4,20
853431,550368,2016-06-01,Assembly,"AB 2516 WOOD  Assembly Third Reading",63,9,0,8,80
853431,554697,2016-06-21,Senate,"Do pass as amended, and re-refer to the Committee on Appropriations",5,0,0,0,5
853431,558721,2016-08-01,Senate,"Placed on Appropriations Suspense file",7,0,0,0,7
853431,559569,2016-08-11,Senate,"Do pass",5,2,0,0,7
853431,560185,2016-08-18,Senate,"Assembly 3rd Reading AB2516 Wood By Hertzberg",29,9,1,0,39
853431,560951,2016-08-24,Assembly,"AB 2516 WOOD  Concurrence in Senate Amendments",62,9,0,9,80
853433,534327,2016-04-18,Assembly,"Do pass and be re-referred to the Committee on Appropriations to 	Consent Calendar",15,0,0,1,16
853433,542578,2016-05-04,Assembly,"Do pass, to Consent Calendar",20,0,0,0,20
853433,545421,2016-05-12,Assembly,"AB 2847 PATTERSON  Consent Calendar Second Day  Regular Session",78,0,0,2,80
853433,559871,2016-08-15,Senate,"Assembly 3rd Reading AB2847 Patterson By Vidak",37,0,2,0,39
853433,560607,2016-08-22,Assembly,"AB 2847 PATTERSON  Concurrence in Senate Amendments",79,0,0,1,80
853434,529325,2016-04-06,Assembly,"Do pass as amended and be re-referred to the Committee on 	Appropriations",7,0,0,0,7
853436,544782,2016-04-19,Assembly,"Do pass and be re-referred to the Committee on Appropriations",3,10,0,0,13
853436,544783,2016-04-19,Assembly,"Reconsideration granted",13,0,0,0,13
853437,535847,2016-04-18,Assembly,"Do pass and be re-referred to the Committee on Appropriations",8,0,0,1,9
853439,544383,2016-04-19,Assembly,"Do pass and be re-referred to the Committee on Appropriations",6,6,0,1,13
853439,544384,2016-04-19,Assembly,"Reconsideration granted",13,0,0,0,13
853441,531551,2016-04-12,Assembly,"Do pass and be re-referred to the Committee on Appropriations",2,4,0,1,7
853441,531552,2016-04-12,Assembly,"Reconsideration granted",6,0,0,1,7
853441,537128,2016-04-20,Assembly,"Do pass and be re-referred to the Committee on Appropriations",2,4,0,1,7
853442,531294,2016-04-12,Senate,"Do pass, but re-refer to the Committee on Appropriations",11,1,1,0,13
853442,544342,2016-04-25,Senate,"Placed on Appropriations Suspense file",7,0,0,0,7
853442,548966,2016-05-27,Senate,"Do pass as amended",7,0,0,0,7
853442,550358,2016-06-01,Senate,"Senate 3rd Reading SB1465 De Le",35,1,4,0,40
853442,554664,2016-06-21,Assembly,"Do pass and be re-referred to the Committee on Appropriations",7,0,0,0,7
853442,559247,2016-08-11,Assembly,"Do pass as amended",19,0,0,1,20
853442,561613,2016-08-30,Assembly,"SB 1465 De Leon  Senate Third Reading  By RENDON",71,6,0,3,80
853442,561722,2016-08-31,Senate,"Unfinished Business SB1465 De Le",36,1,2,0,39
853443,537622,2016-04-20,Assembly,"Do pass and be re-referred to the Committee on Appropriations",9,2,0,4,15
853443,549057,2016-05-27,Assembly,"Do pass",14,6,0,0,20
853443,550714,2016-06-01,Assembly,"AB 2868 GATTO  Assembly Third Reading",51,27,0,2,80
853443,555862,2016-06-27,Senate,"Do pass as amended, and re-refer to the Committee on Appropriations",7,2,2,0,11
853443,559191,2016-08-08,Senate,"Placed on Appropriations Suspense file",7,0,0,0,7
853443,559499,2016-08-11,Senate,"Do pass",5,2,0,0,7
853443,561037,2016-08-24,Senate,"From Committee:  That the measure be returned to the Senate floor 	for consideration",6,5,0,0,11
853443,561824,2016-08-31,Senate,"Assembly 3rd Reading ( Supplemental File 2)AB 2868 Ga tto By",24,12,3,0,39
853443,561825,2016-08-31,Assembly,"AB 2868 GATTO  Concurrence in Senate Amendments",49,28,0,3,80
853444,536972,2016-04-19,Senate,"Do pass as amended, and re-refer to the Committee on Appropriations",3,4,0,0,7
853444,536973,2016-04-19,Senate,"Set, first hearing.  Failed passage in Committee.  Reconsideration 	granted",7,0,0,0,7
853448,531428,2016-04-12,Assembly,"Do pass as amended and be re-referred to the Committee on 	Transportation",12,2,0,2,16
853448,534342,2016-04-18,Assembly,"Do pass and be re-referred to the Committee on Appropriations",14,0,0,2,16
853448,549097,2016-05-27,Assembly,"Do pass",18,0,0,2,20
853448,550107,2016-05-31,Assembly,"AB 2790 NAZARIAN  Assembly Third Reading",73,3,0,4,80
853448,559200,2016-08-09,Senate,"Do pass, but re-refer to the Committee on Appropriations",13,0,0,0,13
853448,560031,2016-08-17,Senate,"Assembly 3rd Reading AB2790 Nazarian By Pan Urgency Clause",39,0,0,0,39
853448,561520,2016-08-29,Assembly,"Senate amendments be concurred in",10,0,0,1,11
853448,561654,2016-08-30,Assembly,"AB 2790 NAZARIAN  Concurrence- Urgency Added",79,0,0,1,80
853449,542703,2016-05-04,Assembly,"Do pass",7,0,0,0,7
853449,547565,2016-05-23,Assembly,"AB 2815 O'DONNELL  Assembly Third Reading",74,1,0,5,80
853449,553217,2016-06-15,Senate,"Do pass, but re-refer to the Committee on Appropriations",9,0,0,0,9
853449,559879,2016-08-15,Senate,"Assembly 3rd Reading AB2815 O'Donnell By Hancock",38,0,1,0,39
853449,560553,2016-08-22,Assembly,"AB 2815 O'DONNELL  Concurrence in Senate Amendments",74,2,0,4,80
853451,532687,2016-04-13,Senate,"Do pass as amended, and re-refer to the Committee on Appropriations",3,4,2,0,9
853451,532688,2016-04-13,Senate,"Set, first hearing.  Failed passage in Committee.  Reconsideration 	granted",9,0,0,0,9
853452,544776,2016-05-09,Assembly,"Do pass as amended and be re-referred to the Committee on 	Appropriations",9,0,0,0,9
853453,530567,2016-04-11,Assembly,"Be referred to Committee on Insurance",9,0,0,2,11
853453,536586,2016-04-20,Assembly,"Do pass and be re-referred to the Committee on Appropriations",9,4,0,0,13
853453,549255,2016-05-27,Assembly,"Do pass as amended",14,6,0,0,20
853453,551139,2016-06-02,Assembly,"AB 2588 CHU  Assembly Third Reading",50,29,0,1,80
853453,555071,2016-06-22,Senate,"Do pass, but re-refer to the Committee on Appropriations",5,2,2,0,9
853453,558853,2016-08-01,Senate,"Placed on Appropriations Suspense file",7,0,0,0,7
853453,559690,2016-08-11,Senate,"Do pass as amended",5,2,0,0,7
853453,560791,2016-08-23,Senate,"Assembly 3rd Reading AB2588 Chu By Block",25,13,1,0,39
853453,561450,2016-08-29,Assembly,"AB 2588 CHU  Concurrence in Senate Amendments",50,29,0,1,80
853454,528288,2016-04-05,Assembly,"Do pass",15,0,0,4,19
853454,540269,2016-04-28,Assembly,"AB 2531 BURKE  Assembly Third Reading",65,3,0,12,80
853454,553218,2016-06-15,Senate,"Do pass, but re-refer to the Committee on Appropriations",9,0,0,0,9
853454,553219,2016-06-15,Senate,"Set, first hearing.  Held in Committee.  Reconsideration of 	favorable vote granted",9,0,0,0,9
853454,561509,2016-08-29,Senate,"Assembly 3rd Reading AB2531 Burke By Pan",26,11,2,0,39
853456,526005,2016-03-29,Assembly,"Do pass and be re-referred to the Committee on Privacy and Consumer 	Protection",19,0,0,0,19
853456,534973,2016-04-19,Assembly,"Do pass and be re-referred to the Committee on Appropriations",11,0,0,0,11
853456,549428,2016-05-27,Assembly,"Do pass",20,0,0,0,20
853456,550094,2016-05-31,Assembly,"AB 2636 LINDER  Assembly Third Reading",80,0,0,0,80
853456,556658,2016-06-28,Senate,"Do pass as amended, and re-refer to the Committee on Appropriations",7,0,0,0,7
853456,559183,2016-08-08,Senate,"Placed on Appropriations Suspense file",7,0,0,0,7
853456,559633,2016-08-11,Senate,"Do pass as amended",7,0,0,0,7
853456,560446,2016-08-19,Senate,"Assembly 3rd Reading AB2636 Linder By Hertzberg",36,0,3,0,39
853456,561033,2016-08-24,Assembly,"AB 2636 LINDER  Concurrence in Senate Amendments",80,0,0,0,80
853457,536242,2016-04-20,Assembly,"Do pass and be re-referred to the Committee on Appropriations to 	Consent Calendar",7,0,0,0,7
853457,538958,2016-04-27,Assembly,"Do pass",19,0,0,1,20
853457,540824,2016-05-02,Assembly,"AB 2735 JONES-SAWYER  Assembly Third Reading",76,0,0,4,80
853458,535076,2016-04-18,Senate,"Do pass, but re-refer to the Committee on Appropriations",8,0,1,0,9
853458,548815,2016-05-26,Senate,"Senate 3rd Reading SB1331 Pavley",39,0,1,0,40
853458,556068,2016-06-28,Assembly,"Do pass as amended and be re-referred to the Committee on 	Appropriations",16,0,0,0,16
853458,559081,2016-08-03,Assembly,"Do pass, to Consent Calendar",20,0,0,0,20
853458,560805,2016-08-23,Assembly,"SB 1331 Pavley  Senate Third Reading  By LEVINE",80,0,0,0,80
853458,561251,2016-08-25,Senate,"Unfinished Business SB1331 Pavley Concurrence",39,0,0,0,39
853460,539088,2016-04-27,Senate,"Do pass, but re-refer to the Committee on Appropriations",7,0,0,0,7
853462,538690,2016-04-26,Assembly,"Do pass, to Consent Calendar",6,0,0,1,7
853462,543049,2016-05-05,Assembly,"AB 2767 LOPEZ  Consent Calendar Second Day  Regular Session",79,0,0,1,80
853462,552908,2016-06-14,Senate,"Do pass as amended",4,0,1,0,5
853462,560341,2016-08-18,Senate,"Assembly 3rd Reading AB2767 Lopez By Liu",37,0,2,0,39
853462,561021,2016-08-24,Assembly,"AB 2767 LOPEZ  Concurrence in Senate Amendments",79,0,0,1,80
853464,528081,2016-04-05,Senate,"Do pass, but re-refer to the Committee on Natural Resources and 	Water",9,0,2,0,11
853464,531599,2016-04-12,Senate,"Do pass as amended, but re-refer to the Committee on Appropriations 	Recommend Consent",9,0,0,0,9
853464,545998,2016-05-16,Senate,"Placed on Appropriations Suspense file",7,0,0,0,7
853464,549308,2016-05-27,Senate,"Do pass",7,0,0,0,7
853464,550099,2016-05-31,Senate,"Senate 3rd Reading SB1463 Moorlach",38,0,2,0,40
853464,555122,2016-06-22,Assembly,"Do pass and be re-referred to the Committee on Natural Resources",15,0,0,0,15
853464,559399,2016-08-11,Assembly,"Do pass",15,0,0,5,20
853464,559896,2016-06-27,Assembly,"Do pass as amended and be re-referred to the Committee on 	Appropriations",9,0,0,0,9
853464,560327,2016-08-18,Assembly,"SB 1463 Moorlach  Senate Third Reading  By GATTO",75,0,0,5,80
853464,561310,2016-08-25,Senate,"Special Consent SB1463 Moorlach",39,0,0,0,39
853469,530434,2016-04-11,Assembly,"Be referred to Committee on Local Government",9,0,0,2,11
853470,537085,2016-04-20,Assembly,"Do pass",4,2,0,1,7
853470,550477,2016-06-01,Assembly,"AB 2607 TING  Assembly Third Reading",41,37,0,2,80
853470,552635,2016-06-14,Senate,"Do pass, but re-refer to the Committee on Appropriations",4,2,1,0,7
853470,554415,2016-06-20,Senate,"Placed on Appropriations Suspense file",2,5,0,0,7
853470,554416,2016-06-20,Senate,"Do pass",5,2,0,0,7
853470,556750,2016-06-30,Senate,"Assembly 3rd Reading AB2607 Ting By Jackson",21,14,5,0,40
853471,534792,2016-04-19,Assembly,"Do pass as amended and be re-referred to the Committee on 	Appropriations",8,0,0,2,10
853471,549180,2016-05-27,Assembly,"Do pass as amended",15,1,0,4,20
853471,550893,2016-06-02,Assembly,"AB 2873 THURMOND  Assembly Third Reading",60,14,0,6,80
853471,554967,2016-06-21,Senate,"Do pass, but re-refer to the Committee on Appropriations",5,2,0,0,7
853471,558706,2016-08-01,Senate,"Placed on Appropriations Suspense file",7,0,0,0,7
853471,559238,2016-08-11,Senate,"Do pass as amended",5,2,0,0,7
853471,560640,2016-08-23,Senate,"Assembly 3rd Reading AB2873 Thurmond By Jackson",26,13,0,0,39
853471,560641,2016-08-23,Senate,"Assembly 3rd Reading AB2873 Thurmond By Jackson",39,0,0,0,39
853472,529659,2016-04-06,Assembly,"Do pass as amended and be re-referred to the Committee on 	Appropriations",5,0,0,2,7
853473,539125,2016-04-26,Senate,"Do pass, but re-refer to the Committee on Rules",2,4,1,0,7
853473,539126,2016-04-26,Senate,"Set, first hearing.  Failed passage in Committee.  Reconsideration 	granted",7,0,0,0,7
853474,532810,2016-04-13,Assembly,"Do pass and be re-referred to the Committee on Appropriations to 	Consent Calendar",10,0,0,0,10
853474,539269,2016-04-27,Assembly,"Do pass, to Consent Calendar",19,0,0,1,20
853474,543246,2016-05-05,Assembly,"AB 2483 AGRI.  Consent Calendar Second Day  Regular Session",79,0,0,1,80
853474,554899,2016-06-21,Senate,"Do pass, but re-refer to the Committee on Appropriations Recommend 	Consent",5,0,0,0,5
853474,559284,2016-08-11,Senate,"Consent Calendar 2nd AB2483 Committee On AGRI. (Dodd)",37,0,2,0,39
853476,527808,2016-04-04,Assembly,"Be referred to Committee on Water, Parks and Wildlife",10,0,0,1,11
853476,538537,2016-04-26,Assembly,"Do pass, to Consent Calendar",12,0,0,3,15
853476,540900,2016-05-02,Assembly,"AB 2651 GOMEZ  Consent Calendar Second Day  Regular Session",76,0,0,4,80
853476,552151,2016-06-08,Senate,"Do pass, but re-refer to the Committee on Appropriations",6,0,1,0,7
853476,554433,2016-06-20,Senate,"Placed on Appropriations Suspense file",7,0,0,0,7
853476,559712,2016-08-11,Senate,"Do pass",5,0,2,0,7
853476,561041,2016-08-24,Senate,"Assembly 3rd Reading AB2651 Gomez By Hertzberg Urgency C",32,6,1,0,39
853476,561630,2016-08-30,Assembly,"AB 2651 GOMEZ  Concurrence- Urgency Added",74,2,0,4,80
853477,528870,2016-04-06,Senate,"Do pass, but re-refer to the Committee on Appropriations",5,0,2,0,7
853477,549336,2016-05-27,Senate,"Do pass",6,1,0,0,7
853477,550041,2016-05-31,Senate,"Senate 3rd Reading SB1425 Pavley",26,11,3,0,40
853477,559470,2016-08-11,Assembly,"Do pass as amended",11,4,0,5,20
853477,559947,2016-06-27,Assembly,"Do pass and be re-referred to the Committee on Appropriations",9,0,0,0,9
853477,560425,2016-08-19,Assembly,"SB 1425 Pavley  Senate Third Reading  By A.,E.,S.,T.,& I.M. 	Amendment  Set #1",73,0,0,7,80
853477,561043,2016-08-24,Assembly,"SB 1425 Pavley  Senate Third Reading  By WILLIAMS",53,22,0,5,80
853477,561477,2016-08-29,Senate,"Unfinished Business SB1425 Pavley Concurrence",26,11,2,0,39
853478,544650,2016-05-09,Assembly,"Do pass as amended and be re-referred to the Committee on 	Appropriations",9,0,0,0,9
853479,531231,2016-04-12,Assembly,"Do pass as amended and be re-referred to the Committee on 	Appropriations",15,0,0,0,15
853479,549177,2016-05-27,Assembly,"Do pass as amended",20,0,0,0,20
853479,550363,2016-06-01,Assembly,,80,0,0,0,80
853480,528686,2016-04-06,Senate,"Do pass as amended, and re-refer to the Committee on Appropriations",9,0,0,0,9
853480,544725,2016-04-25,Senate,"Placed on Appropriations Suspense file",7,0,0,0,7
853480,549328,2016-05-27,Senate,"Do pass as amended",7,0,0,0,7
853480,550972,2016-06-02,Senate,"Special Consent # SB1359 Block",39,0,1,0,40
853480,554745,2016-06-21,Assembly,"Do pass and be re-referred to the Committee on Appropriations",13,0,0,0,13
853480,559381,2016-08-11,Assembly,"Do pass",20,0,0,0,20
853480,560157,2016-08-18,Assembly,"SB 1359 Block  Senate Third Reading  By ALEJO",76,0,0,4,80
853480,561313,2016-08-25,Senate,"Special Consent SB1359 Block",39,0,0,0,39
853481,532518,2016-04-13,Senate,"Do pass, but re-refer to the Committee on Appropriations",6,0,1,0,7
853481,544539,2016-04-25,Senate,"Placed on Appropriations Suspense file",7,0,0,0,7
853482,531910,2016-04-12,Assembly,"Do pass as amended and be re-referred to the Committee on 	Appropriations",16,0,0,0,16
853482,542624,2016-05-04,Assembly,"Do pass, to Consent Calendar",20,0,0,0,20
853482,545312,2016-05-12,Assembly,"AB 2632 OLSEN  Consent Calendar Second Day  Regular Session",78,0,0,2,80
853482,551549,2016-06-06,Senate,"Do pass, but re-refer to the Committee on Appropriations",8,0,1,0,9
853482,559919,2016-08-15,Senate,"Assembly 3rd Reading AB2632 Olsen By Bates",37,0,2,0,39
853483,531279,2016-04-12,Senate,"Do pass as amended, and re-refer to the Committee on Appropriations",5,1,1,0,7
853484,531906,2016-04-12,Senate,"Do pass, but re-refer to the Committee on Appropriations Recommend 	Consent",6,0,1,0,7
853484,544686,2016-04-25,Senate,"Placed on Appropriations Suspense file",7,0,0,0,7
853485,533013,2016-04-13,Assembly,"Do pass and be re-referred to the Committee on Appropriations",10,0,0,0,10
853485,539395,2016-04-27,Assembly,"Do pass, to Consent Calendar",19,0,0,1,20
853485,543063,2016-05-05,Assembly,"AB 2716 DODD  Consent Calendar Second Day  Regular Session",79,0,0,1,80
853485,554913,2016-06-21,Senate,"Do pass, but re-refer to the Committee on Appropriations",5,0,0,0,5
853485,558915,2016-08-01,Senate,"Do pass",7,0,0,0,7
853485,559844,2016-08-15,Senate,"Assembly 3rd Reading AB2716 Dodd By Cannella",38,0,1,0,39
853486,526449,2016-03-29,Assembly,"Do pass and be re-referred to the Committee on Education",8,0,0,1,9
853486,544369,2016-04-19,Assembly,"Do pass and be re-referred to the Committee on Appropriations",13,0,0,0,13
853486,549123,2016-05-27,Assembly,"Do pass as amended",20,0,0,0,20
853486,550444,2016-06-01,Assembly,"AB 2494 HERNANDEZ  Assembly Third Reading",79,0,0,1,80
853486,554999,2016-06-22,Senate,"Do pass, but re-refer to the Committee on Veterans Affairs",9,0,0,0,9
853486,555965,2016-06-28,Senate,"Do pass, but re-refer to the Committee on Appropriations",5,0,0,0,5
853486,558765,2016-08-01,Senate,"Placed on Appropriations Suspense file",7,0,0,0,7
853487,527831,2016-04-04,Assembly,"Do pass as amended and be re-referred to the Committee on Local 	Government",16,0,0,0,16
853487,536529,2016-04-20,Assembly,"Do pass and be re-referred to the Committee on Appropriations",6,3,0,0,9
853487,549356,2016-05-27,Assembly,"Do pass as amended",19,1,0,0,20
853487,550905,2016-06-02,Assembly,"AB 2586 GATTO  Assembly Third Reading",66,11,0,3,80
853487,561148,2016-08-25,Senate,"Assembly 3rd Reading AB2586 Gatto By Hill",23,11,5,0,39
853487,561546,2016-08-30,Assembly,"AB 2586 GATTO  Concurrence in Senate Amendments",67,7,0,6,80
853488,529430,2016-04-06,Assembly,"Do pass as amended",7,0,0,0,7
853488,537485,2016-04-21,Assembly,"AB 2738 OLSEN  Assembly Third Reading",74,2,0,4,80
853488,552076,2016-06-08,Senate,"Do pass",9,0,0,0,9
853488,559868,2016-08-15,Senate,"Assembly 3rd Reading AB2738 Olsen By Pan",37,0,2,0,39
853489,544389,2016-04-19,Assembly,"Do pass as amended and be re-referred to the Committee on 	Appropriations",10,3,0,0,13
853489,549181,2016-05-27,Assembly,"Do pass",14,6,0,0,20
853489,550362,2016-06-01,Assembly,"AB 2652 EGGMAN  Assembly Third Reading",55,25,0,0,80
853490,535866,2016-04-19,Assembly,"Do pass and be re-referred to the Committee on Appropriations",5,2,0,0,7
853490,542944,2016-05-04,Assembly,"Do pass",14,6,0,0,20
853490,550148,2016-05-31,Assembly,"AB 2765 WEBER  Assembly Third Reading",58,19,0,3,80
853490,556593,2016-06-28,Senate,"Do pass, but re-refer to the Committee on Appropriations",7,0,0,0,7
853490,558813,2016-08-01,Senate,"Placed on Appropriations Suspense file",7,0,0,0,7
853490,559546,2016-08-11,Senate,"Do pass",5,1,1,0,7
853490,560978,2016-08-24,Senate,"Assembly 3rd Reading AB2765 Weber By Mitchell",30,9,0,0,39
853491,535155,2016-04-18,Assembly,"Do pass and be re-referred to the Committee on Appropriations",2,6,0,1,9
853491,535156,2016-04-18,Assembly,"Reconsideration granted",9,0,0,0,9
853492,528784,2016-04-06,Senate,"Do pass as amended, and re-refer to the Committee on Appropriations",7,0,0,0,7
853492,544585,2016-04-25,Senate,"Placed on Appropriations Suspense file",7,0,0,0,7
853493,535049,2016-04-18,Assembly,"Do pass as amended and be re-referred to the Committee on 	Appropriations",8,0,0,1,9
853493,549414,2016-05-27,Assembly,"Do pass as amended",20,0,0,0,20
853493,550600,2016-06-01,Assembly,"AB 2715 GARCIA, E.  Assembly Third Reading",79,0,0,1,80
853493,552482,2016-06-13,Senate,"Do pass as amended, and re-refer to the Committee on Transportation 	and Housing",9,1,1,0,11
853493,558844,2016-08-01,Senate,"Placed on Appropriations Suspense file",7,0,0,0,7
853494,532941,2016-04-11,Assembly,"Do pass and be re-referred to the Committee on Appropriations",13,0,0,3,16
853495,537493,2016-04-20,Assembly,"Do pass and be re-referred to the Committee on Judiciary",2,4,0,1,7
853496,528088,2016-04-05,Senate,"Do pass and be placed on the Consent Calendar",7,0,0,0,7
853496,530667,2016-04-11,Senate,"Consent Calendar 2nd SB1284 Hernandez",36,0,4,0,40
853496,552158,2016-06-08,Assembly,"Do pass, to Consent Calendar",9,0,0,1,10
853496,553706,2016-06-16,Assembly,"SB 1284 Hernandez  Consent Calendar Second Day  Regular Session",78,0,0,2,80
853497,532703,2016-04-13,Senate,"Do pass as amended, and re-refer to the Committee on Rules",5,0,2,0,7
853497,534959,2016-04-19,Senate,"Do pass as amended, and re-refer to the Committee on Appropriations",4,2,1,0,7
853497,545896,2016-05-16,Senate,"Placed on Appropriations Suspense file",7,0,0,0,7
853497,549311,2016-05-27,Senate,"Do pass as amended",7,0,0,0,7
853497,550648,2016-06-01,Senate,"Senate 3rd Reading SB1329 Hertzberg",37,1,2,0,40
853497,554732,2016-06-20,Assembly,"Do pass and be re-referred to the Committee on Appropriations",9,0,0,0,9
853497,559403,2016-08-11,Assembly,"Do pass",15,0,0,5,20
853498,541507,2016-05-03,Assembly,"Do pass",8,0,0,3,11
853498,545305,2016-05-12,Assembly,"AB 2688 GORDON  Assembly Third Reading",54,14,0,12,80
853498,556520,2016-06-28,Senate,"Do pass",5,2,0,0,7
853499,528270,2016-04-05,Senate,"Do pass as amended, and re-refer to the Committee on Environmental 	Quality",8,1,2,0,11
853499,536583,2016-04-20,Senate,"Do pass, but re-refer to the Committee on Appropriations",5,2,0,0,7
853500,537112,2016-04-20,Assembly,"Do pass as amended",7,0,0,0,7
853500,543954,2016-05-09,Assembly,"AB 2513 WILLIAMS  Assembly Third Reading",78,0,0,2,80
853500,556273,2016-06-28,Senate,"Do pass, but re-refer to the Committee on Appropriations",7,0,0,0,7
853500,558883,2016-08-01,Senate,"Placed on Appropriations Suspense file",7,0,0,0,7
853501,529441,2016-04-06,Senate,"Do pass, but re-refer to the Committee on Public Safety",7,0,2,0,9
853501,535279,2016-04-19,Senate,"Do pass, but re-refer to the Committee on Appropriations",5,1,1,0,7
853501,547614,2016-05-23,Senate,"Placed on Appropriations Suspense file",7,0,0,0,7
853503,531412,2016-04-12,Senate,"Do pass, but re-refer to the Committee on Public Safety",11,0,0,0,11
853503,535221,2016-04-19,Senate,"Do pass as amended, and re-refer to the Committee on Appropriations",5,1,1,0,7
853503,548954,2016-05-27,Senate,"Senate 3rd Reading SB1311 Glazer",36,2,2,0,40
853503,555628,2016-06-27,Assembly,"Do pass and be re-referred to the Committee on Appropriations",15,0,0,1,16
853503,558986,2016-08-03,Assembly,"Do pass, to Consent Calendar",20,0,0,0,20
853503,559375,2016-08-11,Assembly,"SB 1311 Glazer  Consent Calendar Second Day  Regular Session",78,0,0,2,80
853504,526803,2016-03-31,Assembly,"Be referred to Committee on Health",8,0,0,3,11
853504,535376,2016-04-19,Assembly,"Do pass and be re-referred to the Committee on Appropriations",11,3,0,5,19
853505,539037,2016-04-26,Senate,"Do pass and be placed on the Consent Calendar",7,0,0,0,7
853505,543254,2016-05-05,Senate,"Consent Calendar 2nd SB1281 Block",36,0,4,0,40
853505,552157,2016-06-08,Assembly,"Do pass as amended",9,0,0,1,10
853505,553704,2016-06-16,Assembly,"SB 1281 Block  Senate Third Reading  By WILLIAMS",78,0,0,2,80
853505,557011,2016-06-30,Senate,"Special Consent # SB1281 Block",37,0,3,0,40
853506,535766,2016-04-19,Assembly,"Do pass and be re-referred to the Committee on Appropriations",7,9,0,3,19
853507,533499,2016-04-13,Assembly,"Amend, and do pass as amended and be re-referred to the Committee 	on Appropriations with the recommendation:  To Consent Calendar",7,0,0,0,7
853507,546022,2016-05-16,Assembly,"AB 2621 GOMEZ  Assembly Third Reading",75,0,0,5,80
853507,552081,2016-06-08,Senate,"Do pass",9,0,0,0,9
853507,560830,2016-08-23,Senate,"Assembly 3rd Reading AB2621 Gomez By Allen",39,0,0,0,39
853507,561513,2016-08-29,Assembly,"AB 2621 GOMEZ  Concurrence in Senate Amendments",80,0,0,0,80
853511,535094,2016-04-19,Senate,"Do pass, but re-refer to the Committee on Appropriations",6,3,2,0,11
853511,547561,2016-05-23,Senate,"Placed on Appropriations Suspense file",7,0,0,0,7
853511,549198,2016-05-27,Senate,"Do pass as amended",5,1,1,0,7
853512,537073,2016-04-20,Assembly,"Do pass and be re-referred to the Committee on Appropriations",6,1,0,0,7
853512,542211,2016-05-04,Assembly,"Do pass",15,5,0,0,20
853512,547011,2016-05-19,Assembly,"AB 2532 CHIU  Assembly Third Reading",54,20,0,6,80
853512,552023,2016-06-08,Senate,"Do pass, but re-refer to the Committee on Appropriations",3,1,1,0,5
853512,559809,2016-08-15,Senate,"Assembly 3rd Reading AB2532 Chiu By Hueso",28,9,2,0,39
853514,530577,2016-04-11,Assembly,"Be referred to Committee on Local Government",9,0,0,2,11
853514,536437,2016-04-20,Assembly,"Do pass as amended and be re-referred to the Committee on 	Appropriations",8,0,0,1,9
853514,545092,2016-05-11,Assembly,"Do pass, to Consent Calendar",20,0,0,0,20
853514,547107,2016-05-19,Assembly,"AB 2801 GALLAGHER  Consent Calendar Second Day  Regular Session",76,0,0,4,80
853514,553482,2016-06-15,Senate,"Do pass, but re-refer to the Committee on Appropriations Recommend 	Consent",7,0,0,0,7
853514,559849,2016-08-15,Senate,"Assembly 3rd Reading AB2801 Gallagher By Moorlach",38,0,1,0,39
853515,542426,2016-05-04,Assembly,"Do pass, to Consent Calendar",13,0,0,0,13
853515,545228,2016-05-12,Assembly,"AB 2503 OBERNOLTE  Consent Calendar Second Day  Regular Session",78,0,0,2,80
853515,552039,2016-06-08,Senate,"Do pass, but re-refer to the Committee on Appropriations Recommend 	Consent",4,0,1,0,5
853515,561730,2016-08-31,Senate,"Assembly 3rd Reading AB2503 Obernolte By Mendoza",39,0,0,0,39
853515,561731,2016-08-31,Assembly,"AB 2503 OBERNOLTE  Concurrence in Senate Amendments",79,0,0,1,80
853516,535297,2016-04-19,Assembly,"Do pass and be re-referred to the Committee on Appropriations",2,2,0,3,7
853518,535283,2016-04-19,Assembly,"Do pass as amended and be re-referred to the Committee on 	Appropriations",8,1,0,1,10
853518,549431,2016-05-27,Assembly,"Do pass as amended",15,2,0,3,20
853518,550855,2016-06-02,Assembly,"AB 2629 HERNANDEZ  Assembly Third Reading",52,26,0,2,80
853518,556652,2016-06-28,Senate,"Do pass, but re-refer to the Committee on Appropriations",5,1,1,0,7
853518,558777,2016-08-01,Senate,"Placed on Appropriations Suspense file",7,0,0,0,7
853518,559656,2016-08-11,Senate,"Do pass as amended",5,2,0,0,7
853518,560561,2016-08-22,Senate,"Assembly 3rd Reading AB2629 Roger Hern",24,13,2,0,39
853518,561265,2016-08-25,Assembly,"AB 2629 HERNANDEZ  Concurrence in Senate Amendments",51,27,0,2,80
853519,537629,2016-04-20,Assembly,"Do pass, to Consent Calendar",7,0,0,0,7
853519,539713,2016-04-28,Assembly,"AB 2598 TING  Consent Calendar Second Day  Regular Session",76,0,0,4,80
853520,539323,2016-04-27,Senate,"Do pass and be placed on the Consent Calendar",7,0,0,0,7
853520,543112,2016-05-05,Senate,"Consent Calendar 2nd SB1422 Glazer",36,0,4,0,40
853520,553465,2016-06-15,Assembly,"Do pass and be re-referred to the Committee on Utilities and 	Commerce to Consent Calendar",9,0,0,0,9
853520,557052,2016-06-29,Assembly,"Do pass, to Consent Calendar",15,0,0,0,15
853520,559148,2016-08-04,Assembly,"SB 1422 Glazer  Consent Calendar Second Day  Regular Session",77,0,0,3,80
853522,534846,2016-04-18,Assembly,"Do pass and be re-referred to the Committee on Appropriations",6,2,0,1,9
853523,527479,2016-04-04,Assembly,"Be referred to Committee on Utilities and Commerce",10,0,0,1,11
853523,539213,2016-04-27,Assembly,"Do pass as amended",9,3,0,3,15
853527,531273,2016-04-12,Assembly,"Do pass and be re-referred to the Committee on Appropriations",15,0,0,1,16
853527,538953,2016-04-27,Assembly,"Do pass, to Consent Calendar",19,0,0,1,20
853527,543013,2016-05-05,Assembly,"AB 2679 COOLEY  Consent Calendar Second Day  Regular Session",79,0,0,1,80
853527,552456,2016-06-13,Senate,"Do pass, but re-refer to the Committee on Appropriations",8,0,1,0,9
853527,561206,2016-08-25,Senate,"From Committee:  That the measure be returned to the Senate floor 	for consideration",8,0,1,0,9
853527,561406,2016-08-29,Senate,"Assembly 3rd Reading AB2679 Cooley By McGuire",32,7,0,0,39
853527,561714,2016-08-31,Assembly,"Senate amendments be concurred in",16,0,0,2,18
853527,561715,2016-08-31,Assembly,"AB 2679 COOLEY  Concurrence in Senate Amendments",70,5,0,5,80
853529,525972,2016-03-29,Assembly,"Do pass and be re-referred to the Committee on Appropriations",7,0,0,0,7
853529,549364,2016-05-27,Assembly,"Do pass as amended",16,1,0,3,20
853529,551064,2016-06-02,Assembly,"AB 2524 IRWIN  Assembly Third Reading",78,0,0,2,80
853529,556557,2016-06-28,Senate,"Do pass, but re-refer to the Committee on Appropriations Recommend 	Consent",7,0,0,0,7
853529,558849,2016-08-01,Senate,"Placed on Appropriations Suspense file",7,0,0,0,7
853529,559634,2016-08-11,Senate,"Do pass as amended",7,0,0,0,7
853529,561056,2016-08-24,Senate,"Assembly 3rd Reading AB2524 Irwin By Block",39,0,0,0,39
853529,561600,2016-08-30,Assembly,"AB 2524 IRWIN  Concurrence in Senate Amendments",80,0,0,0,80
853530,544277,2016-05-09,Assembly,"Do pass as amended and be re-referred to the Committee on 	Appropriations",9,0,0,0,9
853531,533320,2016-04-13,Senate,"Do pass as amended, but re-refer to the Committee on Appropriations 	Recommend Consent",9,0,0,0,9
853531,546011,2016-05-16,Senate,"Placed on Appropriations Suspense file",7,0,0,0,7
853532,530930,2016-04-11,Senate,"Do pass, but re-refer to the Committee on Appropriations",6,1,2,0,9
853532,544379,2016-04-25,Senate,"Placed on Appropriations Suspense file",7,0,0,0,7
853532,549304,2016-05-27,Senate,"Do pass as amended",5,2,0,0,7
853532,550942,2016-06-02,Senate,"Senate 3rd Reading SB1400 Wieckowski",21,16,3,0,40
853533,537263,2016-04-20,Assembly,"Do pass as amended and be re-referred to the Committee on 	Appropriations",6,1,0,0,7
853533,549031,2016-05-27,Assembly,"Do pass as amended",19,1,0,0,20
853533,550861,2016-06-02,Assembly,"AB 2536 CHAU  Assembly Third Reading",75,4,0,1,80
853533,554986,2016-06-22,Senate,"Do pass, but re-refer to the Committee on Appropriations",8,0,1,0,9
853533,560377,2016-08-19,Senate,"Assembly 3rd Reading AB2536 Chau By Beall",35,1,3,0,39
853533,560979,2016-08-24,Assembly,"AB 2536 CHAU  Concurrence in Senate Amendments",76,2,0,2,80
853534,531435,2016-04-12,Assembly,"Do pass and be re-referred to the Committee on Appropriations to 	Consent Calendar",14,0,0,1,15
853534,544983,2016-05-11,Assembly,"Do pass, to Consent Calendar",20,0,0,0,20
853534,547229,2016-05-19,Assembly,"AB 2549 RIDLEY-THOMAS  Consent Calendar Second Day  Regular Session",76,0,0,4,80
853534,552982,2016-06-14,Senate,"Do pass, but re-refer to the Committee on Appropriations Recommend 	Consent",9,0,0,0,9
853534,559390,2016-08-11,Senate,"Consent Calendar 2nd AB2549 W., P., & W.(Levine)",37,0,2,0,39
853534,559877,2016-08-15,Assembly,"AB 2549 W., P.& W.  Concurrence in Senate Amendments By LEVINE",77,0,0,3,80
853535,531669,2016-04-12,Assembly,"Do pass as amended and be re-referred to the Committee on 	Appropriations",7,0,0,0,7
853535,548969,2016-05-27,Assembly,"Do pass as amended",20,0,0,0,20
853535,551079,2016-06-02,Assembly,"AB 2440 GATTO  Assembly Third Reading",77,0,0,3,80
853535,556654,2016-06-28,Senate,"Do pass, but re-refer to the Committee on Appropriations",7,0,0,0,7
853535,558886,2016-08-01,Senate,"Placed on Appropriations Suspense file",7,0,0,0,7
853536,532425,2016-04-12,Senate,"Do pass, but re-refer to the Committee on Governance and Finance",4,0,1,0,5
853536,539092,2016-04-27,Senate,"Do pass, but re-refer to the Committee on Appropriations",7,0,0,0,7
853536,549085,2016-05-27,Senate,"Do pass",7,0,0,0,7
853536,549996,2016-05-31,Senate,"Senate 3rd Reading SB1458 Bates",39,0,1,0,40
853536,553156,2016-06-14,Assembly,"Do pass and be re-referred to the Committee on Revenue and Taxation",7,0,0,2,9
853536,554705,2016-06-20,Assembly,"Amend, and do pass as amended and be re-referred to the Committee 	on Appropriations with the recommendation:  To Consent Calendar",9,0,0,0,9
853536,559002,2016-08-03,Assembly,"Do pass, to Consent Calendar",20,0,0,0,20
853536,560180,2016-08-18,Assembly,"SB 1458 Bates  Senate Third Reading  By BROUGH",79,0,0,1,80
853536,561220,2016-08-25,Senate,"Special Consent SB1458 Bates",39,0,0,0,39
853537,528644,2016-04-06,Assembly,"Do pass",13,0,0,0,13
853537,530549,2016-04-11,Assembly,"AB 2710 COOLEY  Assembly Third Reading",77,0,0,2,79
853537,555068,2016-06-22,Senate,"Do pass and be placed on the Consent Calendar",8,0,1,0,9
853537,556902,2016-06-30,Senate,"Consent Calendar 2nd AB2710 Cooley",37,0,3,0,40
853537,558676,2016-08-01,Assembly,"AB 2710 COOLEY  Concurrence in Senate Amendments",76,0,0,4,80
853538,537628,2016-04-20,Assembly,"Do pass as amended and be re-referred to the Committee on 	Appropriations",10,3,0,2,15
853538,549261,2016-05-27,Assembly,"Do pass as amended",15,5,0,0,20
853538,550997,2016-06-02,Assembly,"AB 2454 WILLIAMS  Assembly Third Reading",58,20,0,2,80
853538,555722,2016-06-27,Senate,"Do pass as amended, and re-refer to the Committee on Appropriations",6,3,2,0,11
853538,560456,2016-08-22,Senate,"Assembly 3rd Reading AB2454 Williams By Hueso",26,13,0,0,39
853538,561155,2016-08-25,Assembly,"AB 2454 WILLIAMS  Concurrence in Senate Amendments",56,21,0,3,80
853539,529353,2016-04-06,Senate,"Do pass as amended, and re-refer to the Committee on Appropriations",9,0,0,0,9
853539,544266,2016-04-25,Senate,"Placed on Appropriations Suspense file",7,0,0,0,7
853540,529340,2016-04-06,Senate,"Do pass, but re-refer to the Committee on Rules",9,0,0,0,9
853540,532463,2016-04-12,Senate,"Do pass as amended, but re-refer to the Committee on Appropriations 	Recommend Consent",5,0,0,0,5
853540,549305,2016-05-27,Senate,"Do pass as amended",7,0,0,0,7
853540,550951,2016-06-02,Senate,"Senate 3rd Reading SB1291 Beall",39,0,1,0,40
853540,554970,2016-06-21,Assembly,"Do pass and be re-referred to the Committee on Appropriations",17,0,0,1,18
853540,559275,2016-08-11,Assembly,"Do pass as amended",20,0,0,0,20
853540,560223,2016-08-18,Assembly,"SB 1291 Beall  Senate Third Reading  By CHIU",78,0,0,2,80
853540,561337,2016-08-26,Senate,"Unfinished Business SB1291 Beall Concurrence",38,0,1,0,39
853541,531953,2016-04-12,Assembly,"Do pass and be re-referred to the Committee on Appropriations to 	Consent Calendar",14,0,0,1,15
853541,539060,2016-04-27,Assembly,"Do pass, to Consent Calendar",19,0,0,1,20
853541,543115,2016-05-05,Assembly,"AB 2874 GAINES  Consent Calendar Second Day  Regular Session",79,0,0,1,80
853541,552998,2016-06-14,Senate,"Do pass, but re-refer to the Committee on Appropriations Recommend 	Consent",9,0,0,0,9
853541,556733,2016-06-30,Senate,"Consent Calendar 2nd AB2874 Beth Gaines",37,0,3,0,40
853541,558688,2016-08-01,Assembly,"AB 2874 GAINES  Concurrence in Senate Amendments",76,0,0,4,80
853542,528074,2016-04-05,Assembly,"Do pass and be re-referred to the Committee on Education",9,0,0,2,11
853542,537530,2016-04-20,Assembly,"Do pass and be re-referred to the Committee on Appropriations",7,0,0,0,7
853542,546633,2016-05-18,Assembly,"Do pass, to Consent Calendar",20,0,0,0,20
853542,548965,2016-05-27,Assembly,"AB 2609 CHAU  Consent Calendar Second Day  Regular Session",67,0,0,13,80
853542,552526,2016-06-13,Senate,"Do pass, but re-refer to the Committee on Judiciary",9,0,0,0,9
853542,556528,2016-06-28,Senate,"Do pass, but re-refer to the Committee on Appropriations Recommend 	Consent",7,0,0,0,7
853542,559457,2016-08-11,Senate,"Consent Calendar 2nd AB2609 Chau",37,0,2,0,39
853543,531258,2016-04-12,Senate,"Do pass, but re-refer to the Committee on Environmental Quality",7,2,0,0,9
853543,536034,2016-04-20,Senate,"Do pass as amended, and re-refer to the Committee on Appropriations",5,2,0,0,7
853543,545788,2016-05-16,Senate,"Placed on Appropriations Suspense file",7,0,0,0,7
853543,549011,2016-05-27,Senate,"Do pass as amended",5,2,0,0,7
853543,550819,2016-06-02,Senate,"Senate 3rd Reading SB1363 Monning",27,12,1,0,40
853543,559309,2016-08-11,Assembly,"Do pass as amended",11,2,0,7,20
853543,559902,2016-06-27,Assembly,"Do pass as amended and be re-referred to the Committee on 	Appropriations",8,0,0,1,9
853543,560188,2016-08-18,Assembly,"SB 1363 Monning  Senate Third Reading  By WILLIAMS",60,15,0,5,80
853543,560977,2016-08-24,Senate,"Unfinished Business SB1363 Monning Concurrence",27,11,1,0,39
853545,534813,2016-04-19,Assembly,"Do pass and be re-referred to the Committee on Appropriations",5,2,0,0,7
853545,542207,2016-05-04,Assembly,"Do pass",14,5,0,1,20
853545,548980,2016-05-27,Assembly,"AB 2590 WEBER  Assembly Third Reading",47,24,0,9,80
853545,556248,2016-06-28,Senate,"Do pass, but re-refer to the Committee on Appropriations",5,2,0,0,7
853545,558709,2016-08-01,Senate,"Placed on Appropriations Suspense file",7,0,0,0,7
853545,559556,2016-08-11,Senate,"Do pass as amended",5,2,0,0,7
853545,561146,2016-08-25,Senate,"Assembly 3rd Reading AB2590 Weber By Hancock",26,13,0,0,39
853545,561536,2016-08-30,Assembly,"AB 2590 WEBER  Concurrence in Senate Amendments",50,27,0,3,80
853546,534131,2016-04-18,Assembly,"Do pass and be re-referred to the Committee on Appropriations",14,0,0,2,16
853547,532296,2016-04-13,Assembly,"Do pass and be re-referred to the Committee on Local Government",6,1,0,0,7
853547,536052,2016-04-20,Assembly,"Do pass and be re-referred to the Committee on Appropriations",5,2,0,2,9
853549,544270,2016-04-19,Assembly,"Do pass and be re-referred to the Committee on Appropriations",10,3,0,0,13
853549,549024,2016-05-27,Assembly,"Do pass as amended",14,6,0,0,20
853549,550820,2016-06-02,Assembly,"AB 2822 CHIU  Assembly Third Reading",55,25,0,0,80
853549,556298,2016-06-29,Senate,"Do pass as amended, and re-refer to the Committee on Appropriations",8,1,0,0,9
853549,559173,2016-08-08,Senate,"Placed on Appropriations Suspense file",7,0,0,0,7
853549,559317,2016-08-11,Senate,"Do pass as amended",5,2,0,0,7
853549,560380,2016-08-19,Senate,"Assembly 3rd Reading AB2822 Chiu By Pan",28,8,3,0,39
853550,526811,2016-03-31,Assembly,"Be referred to Committee on Water, Parks and Wildlife",8,0,0,3,11
853550,535699,2016-04-19,Assembly,"Do pass and be re-referred to the Committee on Appropriations",10,3,0,2,15
853550,544966,2016-05-11,Assembly,"Do pass",15,3,0,2,20
853550,547688,2016-05-23,Assembly,"AB 2594 GORDON  Assembly Third Reading",57,12,0,11,80
853550,553225,2016-06-15,Senate,"Do pass, but re-refer to the Committee on Rules",5,2,0,0,7
853550,556138,2016-06-28,Senate,"Do pass as amended, and re-refer to the Committee on Appropriations",8,0,1,0,9
853550,560579,2016-08-22,Senate,"Assembly 3rd Reading AB2594 Gordon By Pavley",38,0,1,0,39
853550,561271,2016-08-25,Assembly,"AB 2594 GORDON  Concurrence in Senate Amendments",78,0,0,2,80
853551,534750,2016-04-18,Assembly,"Do pass as amended, to Consent Calendar",15,0,0,1,16
853551,540296,2016-04-28,Assembly,"AB 2491 NAZARIAN  Consent Calendar Second Day",76,0,0,4,80
853551,554650,2016-06-21,Senate,"Do pass and be placed on the Consent Calendar",11,0,0,0,11
853551,559830,2016-08-15,Senate,"Assembly 3rd Reading AB2491 Nazarian By Allen",38,0,1,0,39
853551,560754,2016-08-23,Senate,"Assembly 3rd Reading AB2491 Nazarian By Allen",39,0,0,0,39
853551,561424,2016-08-29,Assembly,"AB 2491 NAZARIAN  Concurrence in Senate Amendments",80,0,0,0,80
853552,538620,2016-04-26,Assembly,"Do pass",7,1,0,8,16
853552,538621,2016-04-26,Assembly,"Reconsideration granted",8,4,0,4,16
853553,541774,2016-05-03,Assembly,"Do pass, to Consent Calendar",10,0,0,0,10
853553,543816,2016-05-09,Assembly,"AB 2761 LOW  Consent Calendar Second Day  Regular Session",78,0,0,2,80
853553,553415,2016-06-14,Senate,"Do pass as amended. To Consent Calendar",7,0,0,0,7
853553,560454,2016-08-22,Senate,"Assembly 3rd Reading AB2761 Low By Roth",39,0,0,0,39
853553,561445,2016-08-29,Assembly,"AB 2761 LOW  Concurrence in Senate Amendments",75,3,0,2,80
853554,537554,2016-04-20,Senate,"Do pass, but re-refer to the Committee on Appropriations",5,1,3,0,9
853554,550967,2016-06-02,Senate,"Senate 3rd Reading SB1365 Hernandez",26,11,3,0,40
853554,556331,2016-06-28,Assembly,"Do pass and be re-referred to the Committee on Appropriations",18,0,0,0,18
853554,558989,2016-08-03,Assembly,"Do pass, to Consent Calendar",20,0,0,0,20
853554,560967,2016-08-24,Assembly,"SB 1365 Hernandez  Senate Third Reading  By WOOD",80,0,0,0,80
853554,561432,2016-08-29,Senate,"Unfinished Business SB1365 Hernandez Concurrence",26,13,0,0,39
853555,534997,2016-04-18,Assembly,"Do pass as amended and be re-referred to the Committee on 	Appropriations",5,0,0,4,9
853555,546551,2016-05-18,Assembly,"Do pass as amended",14,6,0,0,20
853555,550646,2016-06-01,Assembly,"AB 2622 NAZARIAN  Assembly Third Reading",50,28,0,2,80
853555,556651,2016-06-29,Senate,"Do pass as amended, and re-refer to the Committee on Appropriations",7,0,0,0,7
853555,559714,2016-08-11,Senate,"Do pass",7,0,0,0,7
853556,531610,2016-04-12,Assembly,"Do pass and be re-referred to the Committee on Appropriations",9,6,0,0,15
853556,549435,2016-05-27,Assembly,"Do pass as amended",14,6,0,0,20
853556,550898,2016-06-02,Assembly,"AB 2480 BLOOM  Assembly Third Reading",50,25,0,5,80
853556,556002,2016-06-28,Senate,"Do pass, but re-refer to the Committee on Appropriations",6,2,1,0,9
853556,558702,2016-08-01,Senate,"Placed on Appropriations Suspense file",7,0,0,0,7
853556,559605,2016-08-11,Senate,"Do pass as amended",5,2,0,0,7
853556,560767,2016-08-23,Senate,"Assembly 3rd Reading AB2480 Bloom By Pavley",23,13,3,0,39
853556,561420,2016-08-29,Assembly,"AB 2480 BLOOM  Concurrence in Senate Amendments",49,25,0,6,80
853557,534964,2016-04-18,Assembly,"Do pass as amended and be re-referred to the Committee on 	Appropriations",9,0,0,0,9
853557,549291,2016-05-27,Assembly,"Do pass",20,0,0,0,20
853557,550290,2016-05-31,Assembly,"AB 2564 COOPER  Assembly Third Reading",80,0,0,0,80
853557,556640,2016-06-29,Senate,"Do pass as amended, and re-refer to the Committee on Appropriations",0,2,5,0,7
853557,556641,2016-06-29,Senate,"Set, first hearing.  Failed passage in Committee.  Reconsideration 	granted",6,0,1,0,7
853558,537169,2016-04-20,Assembly,"Do pass as amended and be re-referred to the Committee on 	Appropriations",6,0,0,1,7
853558,549056,2016-05-27,Assembly,"Do pass as amended",20,0,0,0,20
853558,550379,2016-06-01,Assembly,"AB 2569 MELENDEZ  Assembly Third Reading",78,0,0,2,80
853558,556378,2016-06-28,Senate,"Do pass as amended, and re-refer to the Committee on Appropriations",4,3,0,0,7
853559,528203,2016-04-05,Assembly,"Do pass as amended, to Consent Calendar",7,0,0,0,7
853559,537303,2016-04-21,Assembly,"AB 2457 BLOOM  Consent Calendar Second Day  Regular Session",79,0,0,1,80
853559,552931,2016-06-14,Senate,"Do pass and be placed on the Consent Calendar",7,0,0,0,7
853559,557024,2016-06-30,Senate,"Consent Calendar 2nd AB2457 Bloom",37,0,3,0,40
853559,558655,2016-08-01,Assembly,"AB 2457 BLOOM  Concurrence in Senate Amendments",76,0,0,4,80
853561,542903,2016-05-04,Assembly,"Do pass, to Consent Calendar",20,0,0,0,20
853561,544382,2016-04-19,Assembly,"Do pass and be re-referred to the Committee on Appropriations",13,0,0,0,13
853561,545190,2016-05-12,Assembly,"AB 2654 BONILLA  Consent Calendar Second Day  Regular Session",78,0,0,2,80
853561,552133,2016-06-08,Senate,"Do pass, but re-refer to the Committee on Appropriations Recommend 	Consent",9,0,0,0,9
853561,556871,2016-06-30,Senate,"Consent Calendar 2nd AB2654 Bonilla",37,0,3,0,40
853563,531929,2016-04-12,Assembly,"Do pass and be re-referred to the Committee on Appropriations to 	Consent Calendar",7,0,0,0,7
853563,549462,2016-05-27,Assembly,"Do pass as amended",20,0,0,0,20
853563,550559,2016-06-01,Assembly,"AB 2499 MAIENSCHEIN  Assembly Third Reading",80,0,0,0,80
853563,556589,2016-06-28,Senate,"Do pass, but re-refer to the Committee on Appropriations Recommend 	Consent",7,0,0,0,7
853563,558857,2016-08-01,Senate,"Placed on Appropriations Suspense file",7,0,0,0,7
853563,559779,2016-08-11,Senate,"Do pass as amended",7,0,0,0,7
853563,560085,2016-08-17,Senate,"Assembly 3rd Reading AB2499 Maienschein By Monning",39,0,0,0,39
853563,560887,2016-08-23,Assembly,"AB 2499 MAIENSCHEIN  Concurrence in Senate Amendments",80,0,0,0,80
853564,540787,2016-05-02,Assembly,"Be referred to Committee on Banking and Finance",11,0,0,0,11
853564,543021,2016-05-05,Assembly,"Do pass and be re-referred to the Committee on Appropriations",11,0,0,1,12
853564,546581,2016-05-18,Assembly,"Do pass, to Consent Calendar",20,0,0,0,20
853564,548981,2016-05-27,Assembly,"AB 2638 GATTO  Consent Calendar Second Day  Regular Session",67,0,0,13,80
853565,533404,2016-04-12,Assembly,"Do pass and be re-referred to the Committee on Appropriations",7,0,0,0,7
853565,549396,2016-05-27,Assembly,"Do pass as amended",19,0,0,1,20
853565,550519,2016-06-01,Assembly,"AB 2552 HOLDEN  Assembly Third Reading",78,0,0,2,80
853566,531539,2016-04-12,Assembly,"Do pass and be re-referred to the Committee on Appropriations",5,2,0,0,7
853566,538991,2016-04-27,Assembly,"Do pass",13,5,0,2,20
853566,547583,2016-05-23,Assembly,"AB 2792 BONTA  Assembly Third Reading",44,29,0,7,80
853566,556258,2016-06-28,Senate,"Do pass, but re-refer to the Committee on Appropriations",5,2,0,0,7
853566,559175,2016-08-08,Senate,"Placed on Appropriations Suspense file",7,0,0,0,7
853566,559590,2016-08-11,Senate,"Do pass as amended",5,2,0,0,7
853566,561192,2016-08-25,Senate,"Assembly 3rd Reading AB2792 Bonta By Leno",26,10,3,0,39
853566,561586,2016-08-30,Assembly,"AB 2792 BONTA  Concurrence in Senate Amendments",46,29,0,5,80
853568,532924,2016-04-13,Assembly,"Do pass and be re-referred to the Committee on Appropriations to 	Consent Calendar",10,0,0,0,10
853570,537400,2016-04-20,Assembly,"Do pass and be re-referred to the Committee on Appropriations",5,0,0,2,7
853570,549110,2016-05-27,Assembly,"Do pass as amended",19,0,0,1,20
853570,550450,2016-06-01,Assembly,"AB 2548 WEBER  Assembly Third Reading",75,1,0,4,80
853570,556362,2016-06-29,Senate,"Do pass as amended, and re-refer to the Committee on Appropriations",8,0,1,0,9
853570,559629,2016-08-11,Senate,"Do pass",7,0,0,0,7
853570,560945,2016-08-24,Senate,"Assembly 3rd Reading AB2548 Weber By Liu",39,0,0,0,39
853570,561603,2016-08-30,Assembly,"AB 2548 WEBER  Concurrence in Senate Amendments",78,0,0,2,80
853572,537024,2016-04-20,Assembly,"Do pass and be re-referred to the Committee on Appropriations",6,1,0,0,7
853572,549452,2016-05-27,Assembly,"Do pass",14,3,0,3,20
853572,550639,2016-06-01,Assembly,"AB 2835 COOPER  Assembly Third Reading",53,24,0,3,80
853572,555589,2016-06-27,Senate,"Do pass, but re-refer to the Committee on Appropriations",3,2,0,0,5
853572,558903,2016-08-01,Senate,"Placed on Appropriations Suspense file",7,0,0,0,7
853572,559514,2016-08-11,Senate,"Do pass as amended",5,2,0,0,7
853573,533488,2016-04-12,Assembly,"Do pass and be re-referred to the Committee on Appropriations",7,0,0,0,7
853574,533368,2016-04-14,Assembly,"Be referred to Committee on Education",11,0,0,0,11
853574,537349,2016-04-20,Assembly,"Do pass and be re-referred to the Committee on Appropriations",6,0,0,1,7
853574,545119,2016-05-11,Assembly,"Do pass",17,3,0,0,20
853574,547173,2016-05-19,Assembly,"AB 2546 CALDERON  Assembly Third Reading",65,8,0,7,80
853574,556691,2016-06-29,Senate,"Do pass, but re-refer to the Committee on Appropriations",5,1,3,0,9
853574,558938,2016-08-01,Senate,"Do pass",7,0,0,0,7
853574,560008,2016-08-16,Senate,"Assembly 3rd Reading AB2546 Calderon By Mendoza",35,0,4,0,39
853574,560739,2016-08-23,Assembly,"AB 2546 CALDERON  Concurrence in Senate Amendments",66,10,0,4,80
853577,539343,2016-04-27,Assembly,"Do pass as amended",9,0,0,0,9
853577,545297,2016-05-12,Assembly,"AB 2618 NAZARIAN  Assembly Third Reading",77,1,0,2,80
853577,553396,2016-06-15,Senate,"Do pass",6,1,0,0,7
853577,560838,2016-08-23,Senate,"Assembly 3rd Reading AB2618 Nazarian By Hancock",32,7,0,0,39
853577,561604,2016-08-30,Assembly,"AB 2618 NAZARIAN  Concurrence in Senate Amendments",80,0,0,0,80
853578,531351,2016-04-12,Assembly,"Do pass and be re-referred to the Committee on Appropriations",5,3,0,3,11
853578,535177,2016-04-19,Assembly,"Do pass and be re-referred to the Committee on Appropriations",6,2,0,3,11
853579,535244,2016-04-19,Assembly,"Amend, and do pass as amended and be re-referred to the Committee 	on Appropriations with the recommendation:  To Consent Calendar",16,0,0,3,19
853579,549417,2016-05-27,Assembly,"Do pass as amended",20,0,0,0,20
853579,550526,2016-06-01,Assembly,"AB 2589 GOMEZ  Assembly Third Reading",80,0,0,0,80
853579,555326,2016-06-22,Senate,"Do pass as amended, and re-refer to the Committee on Appropriations",8,0,1,0,9
853579,558715,2016-08-01,Senate,"Placed on Appropriations Suspense file",7,0,0,0,7
853580,526446,2016-03-30,Assembly,"Do pass and be re-referred to the Committee on Appropriations",9,0,0,1,10
853580,549393,2016-05-27,Assembly,"Do pass",20,0,0,0,20
853580,550259,2016-05-31,Assembly,"AB 2714 COOPER  Assembly Third Reading",77,0,0,3,80
853583,525875,2016-03-29,Assembly,"Do pass and be re-referred to the Committee on Appropriations",13,1,0,1,15
853583,536850,2016-04-20,Assembly,"Do pass",16,0,0,4,20
853583,538032,2016-04-25,Assembly,"AB 2555 W., P.& W.  Assembly Third Reading  By LEVINE",69,0,0,11,80
853585,532524,2016-04-13,Assembly,"Do pass and be re-referred to the Committee on Local Government",6,0,0,1,7
853585,536610,2016-04-20,Assembly,"Do pass as amended and be re-referred to the Committee on 	Appropriations",9,0,0,0,9
853585,546750,2016-05-18,Assembly,"Do pass, to Consent Calendar",20,0,0,0,20
853585,549399,2016-05-27,Assembly,"AB 2685 LOPEZ  Consent Calendar Second Day  Regular Session",67,0,0,13,80
853585,554881,2016-06-21,Senate,"Do pass, but re-refer to the Committee on Appropriations",11,0,0,0,11
853585,560107,2016-08-17,Senate,"Assembly 3rd Reading AB2685 Lopez By Hernandez",38,0,1,0,39
853586,535521,2016-04-18,Assembly,"Do pass and be re-referred to the Committee on Appropriations",7,2,0,0,9
853586,549142,2016-05-27,Assembly,"Do pass",14,6,0,0,20
853586,550481,2016-06-01,Assembly,"AB 2800 QUIRK  Assembly Third Reading",59,19,0,2,80
853586,552771,2016-06-14,Senate,"Do pass as amended, and re-refer to the Committee on Environmental 	Quality",7,2,0,0,9
853586,556576,2016-06-29,Senate,"Do pass as amended, and re-refer to the Committee on Appropriations",6,1,0,0,7
853586,559185,2016-08-08,Senate,"Placed on Appropriations Suspense file",7,0,0,0,7
853586,559474,2016-08-11,Senate,"Do pass",6,1,0,0,7
853586,560608,2016-08-22,Senate,"Assembly 3rd Reading AB2800 Quirk By Hill",32,6,1,0,39
853586,561303,2016-08-25,Assembly,"AB 2800 QUIRK  Concurrence in Senate Amendments",59,19,0,2,80
853588,532232,2016-04-12,Assembly,"Do pass and be re-referred to the Committee on Jobs, Economic 	Development and The Economy",12,1,0,0,13
853588,535064,2016-04-19,Assembly,"Do pass as amended and be re-referred to the Committee on 	Appropriations",9,0,0,0,9
853588,549395,2016-05-27,Assembly,"Do pass",20,0,0,0,20
853588,549928,2016-05-31,Assembly,"AB 2664 IRWIN  Assembly Third Reading",80,0,0,0,80
853588,556470,2016-06-29,Senate,"Do pass, but re-refer to the Committee on Appropriations",9,0,0,0,9
853588,558932,2016-08-01,Senate,"Placed on Appropriations Suspense file",7,0,0,0,7
853588,559769,2016-08-11,Senate,"Do pass",7,0,0,0,7
853588,560174,2016-08-18,Senate,"Assembly 3rd Reading AB2664 Irwin By Roth",38,0,1,0,39
853588,561048,2016-08-24,Assembly,"AB 2664 IRWIN  Concurrence in Senate Amendments",80,0,0,0,80
853590,535181,2016-04-19,Senate,"Do pass as amended, and re-refer to the Committee on Appropriations",9,2,0,0,11
853590,547752,2016-05-23,Senate,"Senate 3rd Reading SB1345 Berryhill",25,7,8,0,40
853590,555591,2016-06-27,Assembly,"Do pass and be re-referred to the Committee on Appropriations",14,0,0,2,16
853590,559051,2016-08-03,Assembly,"Do pass, to Consent Calendar",20,0,0,0,20
853590,559455,2016-08-11,Assembly,"SB 1345 Berryhill, T.  Consent Calendar Second Day  Regular Session",78,0,0,2,80
853590,559972,2016-08-16,Senate,"Unfinished Business SB1345 Berryhill Concurrence",30,6,3,0,39
853592,537191,2016-04-21,Assembly,"Be referred to Committee on Business and Professions",9,0,0,2,11
853592,538430,2016-04-26,Assembly,"Do pass, to Consent Calendar",16,0,0,0,16
853592,540776,2016-05-02,Assembly,"AB 2810 EGGMAN  Consent Calendar Second Day  Regular Session",76,0,0,4,80
853592,551381,2016-06-06,Senate,"Do pass",8,0,1,0,9
853592,559296,2016-08-11,Senate,"Special Consent AB2810 Eggman By Wieckowski",37,0,2,0,39
853592,559840,2016-08-15,Assembly,"AB 2810 EGGMAN  Concurrence in Senate Amendments",78,0,0,2,80
853593,532026,2016-04-12,Assembly,"Do pass and be re-referred to the Committee on Appropriations to 	Consent Calendar",16,0,0,0,16
853593,539020,2016-04-27,Assembly,"Do pass, to Consent Calendar",19,0,0,1,20
853593,543187,2016-05-05,Assembly,"AB 2859 LOW  Consent Calendar Second Day  Regular Session",79,0,0,1,80
853593,552544,2016-06-13,Senate,"Do pass as amended, but re-refer to the Committee on Appropriations 	Recommend Consent",9,0,0,0,9
853593,558970,2016-08-01,Senate,"Do pass as amended",7,0,0,0,7
853593,560877,2016-08-23,Senate,"Assembly 3rd Reading AB2859 Low By Hill",39,0,0,0,39
853593,561515,2016-08-29,Assembly,"AB 2859 LOW  Concurrence in Senate Amendments",79,0,0,1,80
853594,533195,2016-04-13,Assembly,"Do pass as amended and be re-referred to the Committee on 	Appropriations",7,0,0,0,7
853594,542742,2016-05-04,Assembly,"Do pass, to Consent Calendar",20,0,0,0,20
853594,545314,2016-05-12,Assembly,"AB 2615 WOOD  Consent Calendar Second Day  Regular Session",78,0,0,2,80
853594,552125,2016-06-08,Senate,"Do pass as amended, and re-refer to the Committee on Appropriations",9,0,0,0,9
853594,560577,2016-08-22,Senate,"Assembly 3rd Reading AB2615 Wood By Liu",39,0,0,0,39
853594,561279,2016-08-25,Assembly,"AB 2615 WOOD  Concurrence in Senate Amendments",79,0,0,1,80
853596,531681,2016-04-12,Senate,"Do pass, but re-refer to the Committee on Judiciary Recommend 	Consent",6,0,1,0,7
853596,535105,2016-04-19,Senate,"Do pass as amended, but re-refer to the Committee on Appropriations 	Recommend Consent",7,0,0,0,7
853597,535623,2016-04-19,Senate,"Do pass as amended, and re-refer to the Committee on Appropriations",6,2,3,0,11
853597,549221,2016-05-27,Senate,"Do pass as amended",6,1,0,0,7
853597,550954,2016-06-02,Senate,"Senate 3rd Reading SB1397 Huff",19,17,4,0,40
853597,550955,2016-06-02,Senate,"Senate 3rd Reading SB1397 Huff Reconsider",38,0,2,0,40
853598,532728,2016-04-11,Assembly,"Do pass and be re-referred to the Committee on Appropriations to 	Consent Calendar",16,0,0,0,16
853598,538934,2016-04-27,Assembly,"Do pass, to Consent Calendar",19,0,0,1,20
853598,543207,2016-05-05,Assembly,"AB 2741 SALAS  Consent Calendar Second Day  Regular Session",79,0,0,1,80
853598,552967,2016-06-14,Senate,"Do pass, but re-refer to the Committee on Appropriations Recommend 	Consent",11,0,0,0,11
853598,555855,2016-06-27,Senate,"Placed on Appropriations Suspense file",6,0,1,0,7
853598,559743,2016-08-11,Senate,"Do pass",7,0,0,0,7
853598,561073,2016-08-24,Senate,"Assembly 3rd Reading AB2741 Salas By Cannella",39,0,0,0,39
853598,561840,2016-08-31,Assembly,"AB 2741 SALAS  Concurrence in Senate Amendments",79,0,0,1,80
853599,526218,2016-03-30,Senate,"Do pass as amended, and re-refer to the Committee on Appropriations",8,0,1,0,9
853599,544307,2016-04-25,Senate,"Placed on Appropriations Suspense file",7,0,0,0,7
853599,549099,2016-05-27,Senate,"Do pass",6,1,0,0,7
853599,550006,2016-05-31,Senate,"Senate 3rd Reading SB1314 Block",39,0,1,0,40
853599,554656,2016-06-21,Assembly,"Do pass and be re-referred to the Committee on Appropriations",13,0,0,0,13
853599,559299,2016-08-11,Assembly,"Do pass",20,0,0,0,20
853599,560134,2016-08-18,Assembly,"SB 1314 Block  Senate Third Reading  By CHAVEZ",77,0,0,3,80
853599,561214,2016-08-25,Senate,"Special Consent SB1314 Block",39,0,0,0,39
853601,537513,2016-04-20,Assembly,"Do pass as amended and be re-referred to the Committee on 	Appropriations",7,0,0,0,7
853602,535263,2016-04-19,Assembly,"Do pass as amended and be re-referred to the Committee on 	Appropriations",16,0,0,0,16
853602,542477,2016-05-04,Assembly,"Do pass, to Consent Calendar",20,0,0,0,20
853602,545238,2016-05-12,Assembly,"AB 2745 HOLDEN  Consent Calendar Second Day  Regular Session",78,0,0,2,80
853602,552529,2016-06-13,Senate,"Do pass, but re-refer to the Committee on Appropriations",8,0,1,0,9
853602,559870,2016-08-15,Senate,"Assembly 3rd Reading AB2745 Holden By Hill",38,0,1,0,39
853604,526448,2016-03-29,Assembly,"Do pass and be re-referred to the Committee on Appropriations",8,0,0,1,9
853604,532830,2016-04-13,Assembly,"Do pass, to Consent Calendar",20,0,0,0,20
853604,537280,2016-04-21,Assembly,"AB 2563 V. A.  Consent Calendar Second Day  Regular Session",79,0,0,1,80
853604,552657,2016-06-14,Senate,"Do pass, but re-refer to the Committee on Appropriations Recommend 	Consent",5,0,0,0,5
853604,559290,2016-08-11,Senate,"Consent Calendar 2nd AB2563 Committee On V.A. (Irwin) By Nielsen",37,0,2,0,39
853605,538538,2016-04-26,Assembly,"Do pass as amended",7,1,0,2,10
853605,545779,2016-05-16,Assembly,"AB 2819 CHIU  Assembly Third Reading",41,30,0,9,80
853605,555076,2016-06-21,Senate,"Do pass",5,2,0,0,7
853605,559874,2016-08-15,Senate,"Assembly 3rd Reading AB2819 Chiu By Hertzberg",21,11,7,0,39
853606,536452,2016-04-20,Senate,"Do pass as amended, and re-refer to the Committee on Appropriations",9,0,0,0,9
853606,545962,2016-05-16,Senate,"Placed on Appropriations Suspense file",7,0,0,0,7
853606,549222,2016-05-27,Senate,"Do pass",7,0,0,0,7
853606,549989,2016-05-31,Senate,"Senate 3rd Reading SB1309 Leyva",39,0,1,0,40
853606,555381,2016-06-22,Assembly,"Do pass as amended and be re-referred to the Committee on 	Appropriations",7,0,0,0,7
853607,534862,2016-04-19,Senate,"Do pass, but re-refer to the Committee on Appropriations",4,3,0,0,7
853607,546997,2016-05-19,Senate,"Senate 3rd Reading SB1446 Hancock",22,15,3,0,40
853607,552724,2016-06-14,Assembly,"Do pass and be re-referred to the Committee on Appropriations",5,2,0,0,7
853607,556764,2016-06-30,Assembly,"SB 1446 Hancock  Senate Third Reading  By LOW",44,31,0,5,80
853608,531278,2016-04-12,Senate,"Do pass, but re-refer to the Committee on Appropriations",8,0,5,0,13
853608,548970,2016-05-27,Senate,"Do pass as amended",6,1,0,0,7
853608,550445,2016-06-01,Senate,"Senate 3rd Reading SB1426 Hall",32,4,4,0,40
853609,530752,2016-04-11,Assembly,"Do pass and be re-referred to the Committee on Appropriations",8,1,0,0,9
853609,536320,2016-04-20,Assembly,"Do pass",15,0,0,5,20
853609,547617,2016-05-23,Assembly,"AB 2438 WALDRON  Assembly Third Reading",71,2,0,7,80
853609,556562,2016-06-29,Senate,"Do pass, but re-refer to the Committee on Appropriations",2,3,2,0,7
853609,556563,2016-06-29,Senate,"Set, first hearing.  Failed passage in Committee.  Reconsideration 	granted",6,0,1,0,7
853610,534908,2016-04-19,Senate,"Do pass as amended, and re-refer to the Committee on Appropriations",8,3,0,0,11
853610,545959,2016-05-16,Senate,"Placed on Appropriations Suspense file",7,0,0,0,7
853610,549239,2016-05-27,Senate,"Do pass as amended",5,2,0,0,7
853610,551030,2016-06-02,Senate,"Senate 3rd Reading SB1279 Hancock",26,12,2,0,40
853610,555519,2016-06-27,Assembly,"Do pass and be re-referred to the Committee on Appropriations",10,5,0,1,16
853610,558990,2016-08-03,Assembly,"Do pass as amended",14,6,0,0,20
853610,560492,2016-08-22,Assembly,"SB 1279 Hancock  Senate Third Reading  By BONTA",50,26,0,4,80
853610,560946,2016-08-24,Senate,"Unfinished Business SB1279 Hancock Concurrence",26,13,0,0,39
853611,537177,2016-04-20,Assembly,"Do pass and be re-referred to the Committee on Appropriations",7,0,0,0,7
853611,549371,2016-05-27,Assembly,"Do pass as amended",20,0,0,0,20
853611,550686,2016-06-01,Assembly,"AB 2862 O'DONNELL  Assembly Third Reading",80,0,0,0,80
853611,553223,2016-06-15,Senate,"Do pass, but re-refer to the Committee on Appropriations",9,0,0,0,9
853611,558800,2016-08-01,Senate,"Placed on Appropriations Suspense file",7,0,0,0,7
853611,559293,2016-08-11,Senate,"Do pass",7,0,0,0,7
853611,560647,2016-08-23,Senate,"Assembly 3rd Reading AB2862 O'Donnell By Hancock",39,0,0,0,39
853611,561530,2016-08-30,Assembly,"AB 2862 O'DONNELL  Concurrence in Senate Amendments",80,0,0,0,80
853613,532685,2016-04-13,Assembly,"Do pass as amended and be re-referred to the Committee on 	Appropriations",4,2,0,1,7
853614,534319,2016-04-18,Assembly,"Do pass and be re-referred to the Committee on Appropriations",15,0,0,1,16
853614,542581,2016-05-04,Assembly,"Do pass, to Consent Calendar",20,0,0,0,20
853614,545340,2016-05-12,Assembly,"AB 2620 DABABNEH  Consent Calendar Second Day  Regular Session",78,0,0,2,80
853614,552935,2016-06-14,Senate,"Do pass, but re-refer to the Committee on Appropriations",11,0,0,0,11
853614,555725,2016-06-27,Senate,"Placed on Appropriations Suspense file",6,0,1,0,7
853614,559718,2016-08-11,Senate,"Do pass",7,0,0,0,7
853614,561797,2016-08-31,Senate,"Assembly 3rd Reading AB2620 Dababneh By Galgiani",39,0,0,0,39
853614,561798,2016-08-31,Assembly,"AB 2620 DABABNEH  Concurrence in Senate Amendments",76,0,0,4,80
853615,527850,2016-04-04,Assembly,"Do pass and be re-referred to the Committee on Appropriations to 	Consent Calendar",16,0,0,0,16
853615,549385,2016-05-27,Assembly,"Do pass as amended",20,0,0,0,20
853615,550501,2016-06-01,Assembly,"AB 2411 FRAZIER  Assembly Third Reading",80,0,0,0,80
853616,519407,2016-03-14,Assembly,"Be adopted and re-referred to the Committee on Appropriations with 	recommendation:  To Consent Calendar",16,0,0,0,16
853616,530469,2016-04-11,Assembly,"ACR 142 WILLIAMS  Consent Calendar Second Day  Regular Session",77,0,0,2,79
853616,532613,2016-04-06,Assembly,"Be adopted, to Consent Calendar",18,0,0,2,20
853616,552936,2016-06-14,Senate,"Be adopted, but re-refer to the Committee on Appropriations 	Recommend Consent",11,0,0,0,11
853616,556870,2016-06-30,Senate,"Consent Calendar 2nd ACR142 Williams",37,0,3,0,40
853617,531919,2016-04-12,Senate,"Do pass as amended, and re-refer to the Committee on Appropriations",6,0,1,0,7
853617,549293,2016-05-27,Senate,"Do pass",7,0,0,0,7
853617,550091,2016-05-31,Senate,"Senate 3rd Reading SB1444 Hertzberg",39,0,1,0,40
853617,556116,2016-06-28,Assembly,"Do pass and be re-referred to the Committee on Appropriations",11,0,0,0,11
853617,559064,2016-08-03,Assembly,"Do pass, to Consent Calendar",20,0,0,0,20
853617,559422,2016-08-11,Assembly,"SB 1444 Hertzberg  Consent Calendar Second Day  Regular Session",78,0,0,2,80
853618,531699,2016-04-12,Senate,"Do pass, but re-refer to the Committee on Appropriations",7,2,0,0,9
853618,549252,2016-05-27,Senate,"Do pass",6,1,0,0,7
853618,550257,2016-05-31,Senate,"Senate 3rd Reading SB1333 Block",28,11,1,0,40
853618,556010,2016-06-28,Assembly,"Do pass and be re-referred to the Committee on Appropriations",9,5,0,1,15
853618,559443,2016-08-11,Assembly,"Do pass as amended",11,4,0,5,20
853618,560439,2016-08-19,Assembly,"SB 1333 Block  Senate Third Reading  Amendment  Set #1",73,0,0,7,80
853618,561245,2016-08-25,Assembly,"SB 1333 Block  Senate Third Reading  By BLOOM",50,26,0,4,80
853618,561634,2016-08-30,Senate,"Unfinished Business SB1333 Block Concurrence",26,10,3,0,39
853619,536154,2016-04-20,Assembly,"Do pass as amended and be re-referred to the Committee on 	Appropriations",5,0,0,2,7
853620,531964,2016-04-12,Senate,"Do pass as amended, and re-refer to the Committee on Appropriations",9,0,0,0,9
853620,548711,2016-05-26,Senate,"Senate 3rd Reading SB1347 Nielsen",39,0,1,0,40
853621,537353,2016-04-20,Senate,"Do pass as amended, and re-refer to the Committee on Appropriations",7,0,2,0,9
853621,549294,2016-05-27,Senate,"Do pass",7,0,0,0,7
853621,550093,2016-05-31,Senate,"Senate 3rd Reading SB1471 Hernandez",39,0,1,0,40
853621,554968,2016-06-21,Assembly,"Do pass and be re-referred to the Committee on Appropriations",17,0,0,1,18
853622,535290,2016-04-19,Senate,"Do pass, but re-refer to the Committee on Appropriations",3,1,1,0,5
853622,547718,2016-05-23,Senate,"Senate 3rd Reading SB1288 Leno",24,12,4,0,40
853622,556444,2016-06-29,Assembly,"Do pass and be re-referred to the Committee on Appropriations",5,2,0,0,7
853622,559038,2016-08-03,Assembly,"Do pass",14,6,0,0,20
853622,560198,2016-08-18,Assembly,"SB 1288 Leno  Senate Third Reading  By CHIU",48,26,0,6,80
853622,561009,2016-08-24,Senate,"Unfinished Business SB1288 Leno Concurrence",26,12,1,0,39
853623,525763,2016-03-29,Assembly,"Do pass and be re-referred to the Committee on Appropriations to 	Consent Calendar",7,0,0,0,7
853623,532178,2016-04-13,Assembly,"Do pass, to Consent Calendar",20,0,0,0,20
853623,537226,2016-04-21,Assembly,"AB 2505 QUIRK  Consent Calendar Second Day  Regular Session",79,0,0,1,80
853623,552696,2016-06-14,Senate,"Do pass, but re-refer to the Committee on Appropriations Recommend 	Consent",7,0,0,0,7
853623,557054,2016-06-30,Senate,"Consent Calendar 2nd AB2505 Quirk",37,0,3,0,40
853625,526437,2016-03-30,Assembly,"Do pass and be re-referred to the Committee on Appropriations",9,0,0,0,9
853626,542502,2016-05-04,Assembly,"Do pass and be re-referred to the Committee on Appropriations to 	Consent Calendar",7,0,0,0,7
853626,546547,2016-05-18,Assembly,"Do pass, to Consent Calendar",20,0,0,0,20
853626,549152,2016-05-27,Assembly,"AB 2659 ED.  Consent Calendar Second Day  Regular Session",67,0,0,13,80
853626,553163,2016-06-15,Senate,"Do pass, but re-refer to the Committee on Appropriations Recommend 	Consent",9,0,0,0,9
853626,559315,2016-08-11,Senate,"Consent Calendar 2nd AB2659 Committee On ED. (O'Donnell)",37,0,2,0,39
853626,559845,2016-08-15,Assembly,"AB 2659 ED.  Concurrence in Senate Amendments By O'DONNELL",77,0,0,3,80
853627,541557,2016-05-03,Assembly,"Do pass as amended, to Consent Calendar",10,0,0,0,10
853627,545213,2016-05-12,Assembly,"AB 2827 LEVINE  Consent Calendar Second Day",78,0,0,2,80
853628,535654,2016-04-19,Senate,"Do pass, but re-refer to the Committee on Appropriations Recommend 	Consent",7,0,0,0,7
853628,539617,2016-04-28,Senate,"Consent Calendar 2nd SB1330 Galgiani",37,0,3,0,40
853628,553076,2016-06-14,Assembly,"Do pass, to Consent Calendar",7,0,0,0,7
853628,555319,2016-06-23,Assembly,"SB 1330 Galgiani  Consent Calendar Second Day  Regular Session",79,0,0,1,80
853628,560430,2016-08-19,Assembly,"SB 1330 Galgiani  Senate Third Reading  Amendment  Set #1",73,0,0,7,80
853628,560924,2016-08-24,Assembly,"SB 1330 Galgiani  Senate Third Reading  By GRAY",79,0,0,1,80
853628,561367,2016-08-29,Senate,"Unfinished Business SB1330 Galgiani Concurrence",39,0,0,0,39
853629,534965,2016-04-18,Assembly,"Do pass as amended and be re-referred to the Committee on 	Appropriations",7,0,0,2,9
853629,549162,2016-05-27,Assembly,"Do pass as amended",14,2,0,4,20
853629,551159,2016-06-02,Assembly,"AB 2534 NAZARIAN  Assembly Third Reading",59,20,0,1,80
853629,556136,2016-06-28,Senate,"Do pass as amended, and re-refer to the Committee on Appropriations",6,2,1,0,9
853629,558953,2016-08-01,Senate,"Placed on Appropriations Suspense file",7,0,0,0,7
853630,527951,2016-04-05,Senate,"Do pass, but re-refer to the Committee on Appropriations",4,0,1,0,5
853630,544310,2016-04-25,Senate,"Placed on Appropriations Suspense file",7,0,0,0,7
853630,549176,2016-05-27,Senate,"Do pass",7,0,0,0,7
853630,550014,2016-05-31,Senate,"Senate 3rd Reading SB1349 Hertzberg",38,0,2,0,40
853630,553186,2016-06-15,Assembly,"Do pass and be re-referred to the Committee on Appropriations",7,0,0,0,7
853630,559288,2016-08-11,Assembly,"Do pass as amended",20,0,0,0,20
853630,561401,2016-08-29,Assembly,"SB 1349 Hertzberg  Senate Third Reading  By MULLIN",80,0,0,0,80
853630,561585,2016-08-30,Senate,"Unfinished Business (S upplemental File 1)SB1 349 Her tzberg Con",38,0,1,0,39
853631,534933,2016-04-19,Assembly,"Do pass as amended and be re-referred to the Committee on 	Appropriations",10,1,0,5,16
853632,534787,2016-04-19,Assembly,"Do pass as amended and be re-referred to the Committee on 	Appropriations",9,0,0,0,9
853632,544877,2016-05-11,Assembly,"Do pass, to Consent Calendar",20,0,0,0,20
853632,546996,2016-05-19,Assembly,"AB 2719 GARCIA, E.  Consent Calendar Second Day  Regular Session",76,0,0,4,80
853632,555034,2016-06-22,Senate,"Do pass as amended, and re-refer to the Committee on Appropriations",5,0,0,0,5
853632,560681,2016-08-23,Senate,"Assembly 3rd Reading AB2719 Eduardo Garcia By Leno",39,0,0,0,39
853632,561366,2016-08-29,Assembly,"AB 2719 GARCIA, E.  Concurrence in Senate Amendments",80,0,0,0,80
853633,532653,2016-04-13,Senate,"Do pass, but re-refer to the Committee on Appropriations",6,0,1,0,7
853633,540247,2016-04-28,Senate,"Senate 3rd Reading SB1436 Bates",37,0,3,0,40
853633,553461,2016-06-15,Assembly,"Do pass and be re-referred to the Committee on Appropriations",9,0,0,0,9
853633,556518,2016-06-29,Assembly,"Do pass, to Consent Calendar",18,0,0,2,20
853633,559139,2016-08-04,Assembly,"SB 1436 Bates  Consent Calendar Second Day  Regular Session",77,0,0,3,80
853634,544662,2016-05-09,Assembly,"Do pass and be re-referred to the Committee on Appropriations",9,0,0,0,9
853635,541380,2016-05-03,Assembly,"Do pass as amended",10,0,0,1,11
853635,550851,2016-06-02,Assembly,"AB 2724 GATTO  Assembly Third Reading",54,17,0,9,80
853635,554637,2016-06-21,Senate,"Do pass, but re-refer to the Committee on Judiciary",7,2,2,0,11
853635,556392,2016-06-28,Senate,"Do pass as amended",5,2,0,0,7
853635,559172,2016-08-08,Senate,"Do pass",5,2,0,0,7
853635,560901,2016-08-24,Senate,"Assembly 3rd Reading AB2724 Gatto By Jackson",25,13,1,0,39
853635,561562,2016-08-30,Assembly,"AB 2724 GATTO  Concurrence in Senate Amendments",47,24,0,9,80
853636,535639,2016-04-19,Assembly,"Do pass and be re-referred to the Committee on Appropriations to 	Consent Calendar",16,0,0,0,16
853636,542617,2016-05-04,Assembly,"Do pass, to Consent Calendar",20,0,0,0,20
853636,545317,2016-05-12,Assembly,"AB 2560 OBERNOLTE  Consent Calendar Second Day  Regular Session",78,0,0,2,80
853636,554924,2016-06-20,Senate,"Do pass, but re-refer to the Committee on Appropriations",8,0,1,0,9
853636,560344,2016-08-18,Senate,"Assembly 3rd Reading AB2560 Obernolte By Block",36,0,3,0,39
853637,528799,2016-04-06,Assembly,"Do pass and be re-referred to the Committee on Natural Resources to 	Consent Calendar",15,0,0,0,15
853637,535793,2016-04-18,Assembly,"Do pass and be re-referred to the Committee on Appropriations to 	Consent Calendar",9,0,0,0,9
853637,546575,2016-05-18,Assembly,"Do pass, to Consent Calendar",20,0,0,0,20
853637,548994,2016-05-27,Assembly,"AB 2700 BROWN  Consent Calendar Second Day  Regular Session",67,0,0,13,80
853638,535234,2016-04-19,Assembly,"Do pass and be re-referred to the Committee on Appropriations",16,0,0,0,16
853638,542708,2016-05-04,Assembly,"Do pass, to Consent Calendar",20,0,0,0,20
853638,545170,2016-05-12,Assembly,"AB 2744 GORDON  Consent Calendar Second Day  Regular Session",78,0,0,2,80
853638,552488,2016-06-13,Senate,"Do pass as amended, and re-refer to the Committee on Appropriations",6,0,3,0,9
853638,559960,2016-08-16,Senate,"Assembly 3rd Reading AB2744 Gordon By Hill",37,0,2,0,39
853638,560823,2016-08-23,Assembly,"AB 2744 GORDON  Concurrence in Senate Amendments",80,0,0,0,80
853640,535061,2016-04-18,Assembly,"Do pass and be re-referred to the Committee on Appropriations",9,0,0,0,9
853640,549275,2016-05-27,Assembly,"Do pass",19,0,0,1,20
853640,550057,2016-05-31,Assembly,"AB 2781 GARCIA, E.  Assembly Third Reading",78,0,0,2,80
853640,556572,2016-06-29,Senate,"Do pass as amended, and re-refer to the Committee on Appropriations",6,1,0,0,7
853640,559192,2016-08-08,Senate,"Placed on Appropriations Suspense file",7,0,0,0,7
853641,525919,2016-03-29,Senate,"Do pass as amended, and re-refer to the Committee on Health",4,0,1,0,5
853641,534639,2016-04-18,Senate,"Placed on Appropriations Suspense file",7,0,0,0,7
853643,528110,2016-04-05,Senate,"Do pass, but re-refer to the Committee on Appropriations",7,0,0,0,7
853643,534629,2016-04-18,Senate,"Placed on Appropriations Suspense file",7,0,0,0,7
853643,549416,2016-05-27,Senate,"Do pass",7,0,0,0,7
853643,550020,2016-05-31,Senate,"Senate 3rd Reading SB1323 Bates",37,0,3,0,40
853643,554854,2016-06-21,Assembly,"Do pass and be re-referred to the Committee on Appropriations",5,1,0,1,7
853644,539331,2016-04-27,Assembly,"Do pass",14,0,0,1,15
853644,547692,2016-05-23,Assembly,"AB 2763 GATTO  Assembly Third Reading",75,2,0,3,80
853644,554805,2016-06-21,Senate,"Do pass, but re-refer to the Committee on Energy, Utilities and 	Communications",11,0,0,0,11
853644,555754,2016-06-27,Senate,"Do pass as amended",9,0,2,0,11
853644,559195,2016-08-08,Senate,"Do pass",7,0,0,0,7
853644,559977,2016-08-16,Senate,"Assembly 3rd Reading AB2763 Gatto By Glazer",38,0,1,0,39
853644,560794,2016-08-23,Assembly,"AB 2763 GATTO  Concurrence in Senate Amendments",79,1,0,0,80
853645,526481,2016-03-29,Assembly,"Do pass and be re-referred to the Committee on Appropriations",8,0,0,1,9
853645,536461,2016-04-20,Assembly,"Do pass, to Consent Calendar",16,0,0,4,20
853645,540293,2016-04-28,Assembly,"AB 2561 V. A.  Consent Calendar Second Day  Regular Session",76,0,0,4,80
853645,552716,2016-06-14,Senate,"Do pass, but re-refer to the Committee on Appropriations Recommend 	Consent",5,0,0,0,5
853645,558741,2016-08-01,Senate,"Do pass",7,0,0,0,7
853645,561711,2016-08-31,Senate,"Do pass as amended, and re-refer to the Committee on Appropriations",8,0,1,0,9
853645,561712,2016-09-01,Assembly,"AB 2561 IRWIN  Concurrence- Urgency Added",77,0,0,3,80
853645,561713,2016-09-01,Senate,"W/O REF. TO FILE AB2561 Irwin By Hill Urgency Clause",38,0,1,0,39
853645,562266,2016-08-31,Senate,"W/O REF. TO FILE AB2561 Irwin By Hill Urgency Clause",38,0,0,1,39
853646,535632,2016-04-19,Assembly,"Do pass as amended and be re-referred to the Committee on 	Appropriations",16,0,0,0,16
853646,546887,2016-05-18,Assembly,"Do pass, to Consent Calendar",20,0,0,0,20
853646,549174,2016-05-27,Assembly,"AB 2486 BAKER  Consent Calendar Second Day  Regular Session",67,0,0,13,80
853646,554626,2016-06-20,Senate,"Do pass, but re-refer to the Committee on Appropriations Recommend 	Consent",9,0,0,0,9
853646,558911,2016-08-01,Senate,"Do pass",7,0,0,0,7
853646,560207,2016-08-18,Senate,"Special Consent AB2486 Baker By Glazer",36,0,3,0,39
853647,542206,2016-05-04,Assembly,"Do pass as amended",8,0,0,1,9
853647,545483,2016-05-12,Assembly,"AB 2471 QUIRK  Assembly Third Reading",69,0,0,11,80
853647,555182,2016-06-22,Senate,"Do pass, but re-refer to the Committee on Appropriations",4,1,2,0,7
853649,532062,2016-04-12,Assembly,"Do pass as amended and be re-referred to the Committee on 	Appropriations",7,0,0,0,7
853650,528793,2016-04-06,Senate,"Do pass as amended",6,0,1,0,7
853650,533437,2016-04-14,Senate,"Senate 3rd Reading SB1315 Bates",37,0,3,0,40
853650,553462,2016-06-15,Assembly,"Do pass, to Consent Calendar",9,0,0,0,9
853650,555409,2016-06-23,Assembly,"SB 1315 Bates  Consent Calendar Second Day  Regular Session",79,0,0,1,80
853651,534935,2016-04-19,Assembly,"Do pass",2,5,0,0,7
853652,531096,2016-04-11,Senate,"Do pass, but re-refer to the Committee on Appropriations Recommend 	Consent",9,0,0,0,9
853652,544287,2016-04-25,Senate,"Placed on Appropriations Suspense file",7,0,0,0,7
853652,549106,2016-05-27,Senate,"Do pass as amended",7,0,0,0,7
853652,550886,2016-06-02,Senate,"Special Consent # SB1348 Cannella",39,0,1,0,40
853652,554698,2016-06-21,Assembly,"Do pass and be re-referred to the Committee on Appropriations to 	Consent Calendar",15,0,0,1,16
853652,556360,2016-06-29,Assembly,"Do pass, to Consent Calendar",18,0,0,2,20
853652,559107,2016-08-04,Assembly,"SB 1348 Cannella  Consent Calendar Second Day  Regular Session",77,0,0,3,80
853653,535346,2016-04-19,Assembly,"Do pass, to Consent Calendar",7,0,0,0,7
853653,544046,2016-05-09,Assembly,"AB 2655 WEBER  Assembly Third Reading",78,0,0,2,80
853653,552925,2016-06-14,Senate,"Do pass and be placed on the Consent Calendar",7,0,0,0,7
853653,556913,2016-06-30,Senate,"Consent Calendar 2nd AB2655 Weber",37,0,3,0,40
853654,529359,2016-04-06,Assembly,"Do pass and be re-referred to the Committee on Veterans Affairs to 	Consent Calendar",7,0,0,0,7
853654,532432,2016-04-12,Assembly,"Do pass and be re-referred to the Committee on Appropriations",9,0,0,0,9
853654,536111,2016-04-20,Assembly,"Do pass, to Consent Calendar",16,0,0,4,20
853654,539633,2016-04-28,Assembly,"AB 2574 CHAVEZ  Consent Calendar Second Day  Regular Session",76,0,0,4,80
853654,552689,2016-06-14,Senate,"Do pass, but re-refer to the Committee on Agriculture",5,0,0,0,5
853654,554707,2016-06-21,Senate,"Do pass, but re-refer to the Committee on Appropriations",5,0,0,0,5
853655,536912,2016-04-20,Assembly,"Do pass as amended and be re-referred to the Committee on 	Appropriations",6,1,0,0,7
853655,548987,2016-05-27,Assembly,"Do pass as amended",14,2,0,4,20
853655,551141,2016-06-02,Assembly,"AB 2441 THURMOND  Assembly Third Reading",56,19,0,5,80
853655,558952,2016-08-01,Senate,"Placed on Appropriations Suspense file",7,0,0,0,7
854210,533414,2016-04-12,Assembly,"Do pass and be re-referred to the Committee on Appropriations to 	Consent Calendar",7,0,0,0,7
854210,542661,2016-05-04,Assembly,"Do pass, to Consent Calendar",20,0,0,0,20
854210,545227,2016-05-12,Assembly,"AB 2877 HUM. S.  Consent Calendar Second Day  Regular Session",78,0,0,2,80
854210,552933,2016-06-14,Senate,"Do pass, but re-refer to the Committee on Appropriations Recommend 	Consent",4,0,1,0,5
854210,559494,2016-08-11,Senate,"Consent Calendar 2nd AB2877 Committee On HUM. S. (Bonilla)",37,0,2,0,39
855034,537104,2016-04-21,Senate,"Senate 3rd Reading SCR114 Fuller",39,0,1,0,40
855034,540020,2016-04-28,Assembly,"Be adopted, to Consent Calendar",11,0,0,0,11
855034,543053,2016-05-05,Assembly,"SCR 114 Fuller  Consent Calendar Second Day  Regular Session",79,0,0,1,80
855054,548689,2016-05-26,Senate,"Senate 3rd Reading SCR113 Fuller",39,0,1,0,40
855054,559197,2016-08-08,Assembly,"Be adopted, to Consent Calendar",10,0,0,1,11
855054,559491,2016-08-11,Assembly,"SCR 113 Fuller  Consent Calendar Second Day  Regular Session",78,0,0,2,80
855758,533528,2016-04-13,Assembly,"Be adopted and re-referred to the Committee on Appropriations with 	recommendation:  To Consent Calendar",7,0,0,0,7
855758,536499,2016-04-20,Assembly,"Be adopted, to Consent Calendar",16,0,0,4,20
855758,538019,2016-04-25,Assembly,"ACR 144 MULLIN  Consent Calendar Second Day",77,0,0,3,80
855758,552152,2016-06-08,Senate,"Be adopted, but re-refer to the Committee on Appropriations 	Recommend Consent",9,0,0,0,9
855758,556850,2016-06-30,Senate,"Consent Calendar 2nd ACR144 Mullin",37,0,3,0,40
855770,529559,2016-04-07,Senate,"Senate 3rd Reading SCR115 Liu",38,0,2,0,40
855770,559161,2016-08-04,Assembly,"Be adopted, to Consent Calendar",9,0,0,2,11
855770,559459,2016-08-11,Assembly,"SCR 115 Liu  Consent Calendar Second Day  Regular Session",78,0,0,2,80
855783,519476,2016-03-14,Assembly,"From committee:  Be adopted.  To third reading",10,0,0,1,11
856382,535249,2016-04-19,Assembly,"Do pass and be re-referred to the Committee on Labor and Employment",7,3,0,0,10
856382,542473,2016-05-04,Assembly,"Do pass",5,2,0,0,7
856389,528810,2016-04-06,Assembly,"Do pass and be re-referred to the Committee on Appropriations to 	Consent Calendar",13,0,0,0,13
856389,532738,2016-04-13,Assembly,"Do pass, to Consent Calendar",20,0,0,0,20
856389,537605,2016-04-21,Assembly,"AB 2886 INS.  Consent Calendar Second Day  Regular Session",79,0,0,1,80
856389,552138,2016-06-08,Senate,"Do pass, but re-refer to the Committee on Appropriations Recommend 	Consent",4,0,1,0,5
856389,558906,2016-08-01,Senate,"Do pass",7,0,0,0,7
856389,560302,2016-08-18,Senate,"Special Consent AB2886 Committee On INS.(Daly) By Mendoza",36,0,3,0,39
856396,519128,2016-03-14,Senate,"Senate 3rd Reading SR64 Jackson",37,0,3,0,40
856400,528113,2016-04-05,Assembly,"Do pass and be re-referred to the Committee on Appropriations",10,0,0,0,10
856400,549125,2016-05-27,Assembly,"Do pass",20,0,0,0,20
856400,550011,2016-05-31,Assembly,"AB 2882 JUD.  Assembly Third Reading  By STONE",80,0,0,0,80
856400,555018,2016-06-21,Senate,"Do pass, but re-refer to the Committee on Appropriations Recommend 	Consent",7,0,0,0,7
856400,558785,2016-08-01,Senate,"Placed on Appropriations Suspense file",7,0,0,0,7
856400,559267,2016-08-11,Senate,"Do pass as amended",7,0,0,0,7
856400,560357,2016-08-19,Senate,"Assembly 3rd Reading AB2882 Committee On JUD.(Stone) By Wieckowski",36,0,3,0,39
856400,560933,2016-08-24,Assembly,"AB 2882 JUD.  Concurrence in Senate Amendments By STONE",80,0,0,0,80
856405,528639,2016-04-06,Assembly,"Do pass and be re-referred to the Committee on Appropriations to 	Consent Calendar",13,0,0,0,13
856405,549109,2016-05-27,Assembly,"Do pass as amended",20,0,0,0,20
856405,550430,2016-06-01,Assembly,"AB 2883 INS.  Assembly Third Reading  By DALY",80,0,0,0,80
856405,554954,2016-06-22,Senate,"Do pass as amended, but re-refer to the Committee on Appropriations 	Recommend Consent",5,0,0,0,5
856405,559287,2016-08-11,Senate,"Consent Calendar 2nd AB2883 Committee On INS. (Daly)",37,0,2,0,39
856405,559841,2016-08-15,Assembly,"AB 2883 INS.  Concurrence in Senate Amendments By DALY",78,0,0,2,80
856413,528638,2016-04-06,Assembly,"Do pass, to Consent Calendar",13,0,0,0,13
856413,533405,2016-04-14,Assembly,"AB 2885 INS.  Consent Calendar Second Day  Regular Session",76,0,0,4,80
856413,555174,2016-06-22,Senate,"Do pass and be placed on the Consent Calendar",8,0,1,0,9
856419,536359,2016-04-20,Assembly,"Do pass, to Consent Calendar",13,0,0,0,13
856419,540011,2016-04-28,Assembly,"AB 2887 INS.  Consent Calendar Second Day  Regular Session",76,0,0,4,80
856419,555111,2016-06-22,Senate,"Do pass, but re-refer to the Committee on Appropriations Recommend 	Consent",8,0,1,0,9
856419,559253,2016-08-11,Senate,"Consent Calendar 2nd AB2887 Committee On INS. (Daly)",37,0,2,0,39
856425,538543,2016-04-26,Assembly,"Do pass",10,0,0,0,10
856425,550230,2016-05-31,Assembly,"AB 2878 JUD.  Assembly Third Reading  By STONE",10,50,0,20,80
856425,551017,2016-06-02,Assembly,"AB 2878 JUD.  Assembly Third Reading  By STONE",79,0,0,1,80
856425,561807,2016-08-31,Senate,"W/O REF. TO FILE AB2878 Committee on JUD. By Jackson",25,13,1,0,39
856433,535223,2016-04-19,Assembly,"Do pass and be re-referred to the Committee on Appropriations to 	Consent Calendar",10,0,0,0,10
856433,542550,2016-05-04,Assembly,"Do pass, to Consent Calendar",20,0,0,0,20
856433,545376,2016-05-12,Assembly,"AB 2881 JUD.  Consent Calendar Second Day  Regular Session",78,0,0,2,80
856433,555136,2016-06-21,Senate,"Do pass as amended, but re-refer to the Committee on Appropriations 	Recommend Consent",7,0,0,0,7
856433,560760,2016-08-23,Senate,"Assembly 3rd Reading AB2881 Committee On JUD. (Stone) By Anderson",39,0,0,0,39
856433,561393,2016-08-29,Assembly,"AB 2881 JUD.  Concurrence in Senate Amendments By STONE",80,0,0,0,80
856439,535877,2016-04-19,Assembly,"Do pass and be re-referred to the Committee on Appropriations",9,0,0,1,10
856439,542438,2016-05-04,Assembly,"Do pass, to Consent Calendar",20,0,0,0,20
856439,550912,2016-06-02,Assembly,"AB 2880 JUD.  Assembly Third Reading  By STONE",76,3,0,1,80
856445,528788,2016-04-06,Assembly,"Do pass and be re-referred to the Committee on Appropriations to 	Consent Calendar",13,0,0,0,13
856445,532308,2016-04-13,Assembly,"Do pass, to Consent Calendar",20,0,0,0,20
856445,537116,2016-04-21,Assembly,"AB 2884 INS.  Consent Calendar Second Day  Regular Session",79,0,0,1,80
856445,555115,2016-06-22,Senate,"Do pass, but re-refer to the Committee on Appropriations Recommend 	Consent",8,0,1,0,9
856445,560083,2016-08-17,Senate,"Assembly 3rd Reading AB2884 Committee On INS.(Daly) By Roth",39,0,0,0,39
856445,560786,2016-08-23,Assembly,"AB 2884 INS.  Concurrence in Senate Amendments By DALY",80,0,0,0,80
857269,531943,2016-04-12,Senate,"Do pass, but re-refer to the Committee on Appropriations Recommend 	Consent",9,0,0,0,9
857269,539636,2016-04-28,Senate,"Consent Calendar 2nd SB1473 Committee On N.R. & W. (Pavley)",37,0,3,0,40
857269,552726,2016-06-14,Assembly,"Do pass and be re-referred to the Committee on Natural Resources to 	Consent Calendar",14,0,0,1,15
857269,559049,2016-08-03,Assembly,"Do pass, to Consent Calendar",20,0,0,0,20
857269,559923,2016-06-27,Assembly,"Do pass and be re-referred to the Committee on Appropriations",8,0,0,1,9
857269,560136,2016-08-18,Assembly,"SB 1473 N.R.& W.  Senate Third Reading  By LEVINE",79,0,0,1,80
857269,561306,2016-08-25,Senate,"Special Consent SB1473 Committee On N.R. & W. (Pavley)",39,0,0,0,39
857270,535666,2016-04-19,Assembly,"Amend, and do pass as amended and be re-referred to the Committee 	on Appropriations with the recommendation:  To Consent Calendar",16,0,0,3,19
857270,539148,2016-04-27,Assembly,"Do pass, to Consent Calendar",19,0,0,1,20
857270,542973,2016-05-05,Assembly,"AB 2889 HEALTH  Consent Calendar Second Day  Regular Session",79,0,0,1,80
857270,553024,2016-06-14,Senate,"Do pass, but re-refer to the Committee on Appropriations Recommend 	Consent",12,0,1,0,13
857270,559468,2016-08-11,Senate,"Consent Calendar 2nd AB2889 Committee On HEALTH (Wood)",37,0,2,0,39
857271,531897,2016-04-12,Assembly,"Do pass and be re-referred to the Committee on Appropriations to 	Consent Calendar",7,0,0,0,7
857271,539188,2016-04-27,Assembly,"Do pass, to Consent Calendar",19,0,0,1,20
857271,543055,2016-05-05,Assembly,"AB 2891 E.S.& T.M.  Consent Calendar Second Day  Regular Session",79,0,0,1,80
857271,553229,2016-06-15,Senate,"Do pass, but re-refer to the Committee on Appropriations Recommend 	Consent",7,0,0,0,7
857271,558956,2016-08-01,Senate,"Placed on Appropriations Suspense file",7,0,0,0,7
857271,559490,2016-08-11,Senate,"Do pass",5,2,0,0,7
857271,560778,2016-08-23,Senate,"Assembly 3rd Reading AB2891 Committee On E.S. & T.M. (Alejo) By Leno",26,13,0,0,39
857271,561288,2016-08-25,Assembly,"Senate amendments be concurred in",5,0,0,2,7
857271,561622,2016-08-30,Assembly,"AB 2891 E.S.& T.M.  Concurrence in Senate Amendments By ALEJO",79,0,0,1,80
857272,516447,2016-03-08,Assembly,"From committee:  Be adopted.  To third reading",10,0,0,1,11
857272,538325,2016-04-25,Senate,"Assembly 3rd Reading ACR147 Dodd",39,0,1,0,40
857273,531629,2016-04-12,Assembly,"Do pass and be re-referred to the Committee on Appropriations to 	Consent Calendar",7,0,0,0,7
857273,542960,2016-05-04,Assembly,"Do pass, to Consent Calendar",20,0,0,0,20
857273,545230,2016-05-12,Assembly,"AB 2893 E.S.& T.M.  Consent Calendar Second Day  Regular Session",78,0,0,2,80
857273,552232,2016-06-08,Senate,"Do pass, but re-refer to the Committee on Appropriations Recommend 	Consent",6,0,1,0,7
857273,556755,2016-06-30,Senate,"Consent Calendar 2nd AB2893 Committee On E.S. & T.M. (Alejo)",37,0,3,0,40
857273,559101,2016-08-04,Assembly,"AB 2893 E.S.& T.M.  Concurrence in Senate Amendments By ALEJO",77,0,0,3,80
857277,526417,2016-03-30,Assembly,"Be adopted and be re-referred to the Committee on Appropriations",2,3,0,2,7
857278,531635,2016-04-12,Assembly,"Do pass and be re-referred to the Committee on Appropriations",6,0,0,1,7
857278,549285,2016-05-27,Assembly,"Do pass as amended",20,0,0,0,20
857278,550703,2016-06-01,Assembly,"AB 2892 E.S.& T.M.  Assembly Third Reading  By ALEJO",78,1,0,1,80
857278,556561,2016-06-29,Senate,"Do pass, but re-refer to the Committee on Appropriations Recommend 	Consent",7,0,0,0,7
857278,559884,2016-08-15,Senate,"Assembly 3rd Reading AB2892 Committee On E.S. & T.M. (Alejo) By 	Allen",38,0,1,0,39
857278,560465,2016-08-22,Assembly,"AB 2892 E.S.& T.M.  Concurrence in Senate Amendments By ALEJO",75,1,0,4,80
857279,525677,2016-03-29,Assembly,"Be adopted, to Consent Calendar",10,0,0,0,10
857279,540828,2016-05-02,Senate,"Assembly 3rd Reading ACR146 Weber By Anderson",37,0,3,0,40
857280,531200,2016-04-12,Assembly,"Do pass and be re-referred to the Committee on Appropriations",5,1,0,1,7
857280,538921,2016-04-27,Assembly,"Do pass",13,6,0,1,20
857280,545203,2016-05-12,Assembly,"AB 2890 E.S.& T.M.  Assembly Third Reading  By ALEJO",51,26,0,3,80
857280,553153,2016-06-15,Senate,"Do pass, but re-refer to the Committee on Appropriations",5,2,0,0,7
857280,559808,2016-08-15,Senate,"Assembly 3rd Reading AB2890 Committee On E.S. & T.M. (Alejo) By Hill",27,11,1,0,39
857280,560458,2016-08-22,Assembly,"AB 2890 E.S.& T.M.  Concurrence in Senate Amendments By ALEJO",53,24,0,3,80
857281,532361,2016-04-13,Assembly,"Do pass and be re-referred to the Committee on Appropriations to 	Consent Calendar",10,0,0,0,10
857281,539027,2016-04-27,Assembly,"Do pass, to Consent Calendar",19,0,0,1,20
857281,543128,2016-05-05,Assembly,"AB 2888 AGRI.  Consent Calendar Second Day  Regular Session",79,0,0,1,80
857281,556620,2016-06-28,Senate,"Do pass as amended, and re-refer to the Committee on Appropriations",6,0,1,0,7
857281,559176,2016-08-08,Senate,"Placed on Appropriations Suspense file",7,0,0,0,7
857281,559273,2016-08-11,Senate,"Do pass",7,0,0,0,7
857281,559939,2016-08-16,Senate,"Assembly 3rd Reading AB2888 Low By Beall",34,0,5,0,39
857281,560648,2016-08-23,Assembly,"Senate amendments be concurred in",5,0,0,1,6
857281,561433,2016-08-29,Assembly,"AB 2888 LOW  Concurrence in Senate Amendments",77,1,0,2,80
857283,534869,2016-04-19,Senate,"Do pass and be placed on the Consent Calendar",7,0,0,0,7
857283,539576,2016-04-28,Senate,"Consent Calendar 2nd SB1474 Committee On PUB. S. (Hancock)",37,0,3,0,40
857283,552649,2016-06-14,Assembly,"Do pass, to Consent Calendar",7,0,0,0,7
857283,555264,2016-06-23,Assembly,"SB 1474 PUB. S.  Consent Calendar Second Day  Regular Session",79,0,0,1,80
857992,519292,2016-03-14,Assembly,"From committee:  Be adopted.  To third reading",10,0,0,1,11
857997,542822,2016-05-04,Assembly,"Do pass, to Consent Calendar",7,0,0,0,7
857997,545393,2016-05-12,Assembly,"AB 2897 L.& E.  Consent Calendar Second Day  Regular Session",78,0,0,2,80
857997,556581,2016-06-29,Senate,"Do pass",4,0,1,0,5
858003,527621,2016-04-04,Senate,"Senate 3rd Reading SCR116 Mendoza",39,0,1,0,40
858003,537196,2016-04-21,Assembly,"Be adopted, to Consent Calendar",9,0,0,2,11
858003,543205,2016-05-05,Senate,"Unfinished Business SCR116 Mendoza Concurrence",37,0,3,0,40
858007,542966,2016-05-04,Assembly,"Do pass, to Consent Calendar",7,0,0,0,7
858007,545250,2016-05-12,Assembly,"AB 2896 L.& E.  Consent Calendar Second Day  Regular Session",78,0,0,2,80
858007,555175,2016-06-22,Senate,"Do pass, but re-refer to the Committee on Appropriations Recommend 	Consent",5,0,0,0,5
858009,537103,2016-04-20,Assembly,"Do pass and be re-referred to the Committee on Appropriations",5,2,0,0,7
858009,549008,2016-05-27,Assembly,"Do pass as amended",14,6,0,0,20
858009,550858,2016-06-02,Assembly,"AB 2895 HERNANDEZ  Assembly Third Reading",44,30,0,6,80
858009,555009,2016-06-22,Senate,"Do pass, but re-refer to the Committee on Appropriations",4,1,0,0,5
858015,537339,2016-04-20,Assembly,"Do pass and be re-referred to the Committee on Appropriations",6,0,0,1,7
858015,546704,2016-05-18,Assembly,"Do pass",14,6,0,0,20
858015,547787,2016-05-23,Assembly,"AB 2899 HERNANDEZ  Assembly Third Reading",52,24,0,4,80
858015,556568,2016-06-29,Senate,"Do pass, but re-refer to the Committee on Appropriations",4,1,0,0,5
858015,560993,2016-08-24,Senate,"Assembly 3rd Reading AB2899 Roger Hern",25,12,2,0,39
858022,529462,2016-04-06,Assembly,"Do pass and be re-referred to the Committee on Appropriations",7,0,0,0,7
858022,546903,2016-05-18,Assembly,"Do pass, to Consent Calendar",20,0,0,0,20
858022,549366,2016-05-27,Assembly,"AB 2898 L.& E.  Consent Calendar Second Day  Regular Session",67,0,0,13,80
858022,556445,2016-06-29,Senate,"Do pass, but re-refer to the Committee on Appropriations",5,0,0,0,5
858626,538044,2016-04-25,Senate,"Senate 3rd Reading SR65 Moorlach",37,0,3,0,40
858645,559362,2016-08-11,Senate,"Senate 3rd Reading SR66 Roth",36,0,3,0,39
859525,535881,2016-04-19,Assembly,"Be adopted and re-referred to the Committee on Appropriations with 	recommendation:  To Consent Calendar",10,0,0,0,10
859525,542454,2016-05-04,Assembly,"Be adopted, to Consent Calendar",20,0,0,0,20
859525,544019,2016-05-09,Assembly,"ACR 148 CHAU  Consent Calendar Second Day  Regular Session",78,0,0,2,80
859525,553425,2016-06-14,Senate,"Be adopted and be placed on the Consent Calendar",7,0,0,0,7
859525,559905,2016-08-15,Senate,"Assembly 3rd Reading ACR148 Chau By Roth",38,0,1,0,39
859525,560503,2016-08-22,Assembly,"ACR 148 CHAU  Concurrence in Senate Amendments",78,0,0,2,80
859541,533293,2016-04-13,Assembly,"Do pass and be re-referred to the Committee on Appropriations to 	Consent Calendar",15,0,0,0,15
859541,539225,2016-04-27,Assembly,"Do pass, to Consent Calendar",19,0,0,1,20
859541,543005,2016-05-05,Assembly,"AB 2903 U.& C.  Consent Calendar Second Day  Regular Session",79,0,0,1,80
859541,552540,2016-06-13,Senate,"Do pass, but re-refer to the Committee on Appropriations",11,0,0,0,11
859556,532913,2016-04-13,Assembly,"Do pass and be re-referred to the Committee on Appropriations to 	Consent Calendar",9,0,0,0,9
859556,539121,2016-04-27,Assembly,"Do pass, to Consent Calendar",19,0,0,1,20
859556,542978,2016-05-05,Assembly,"AB 2904A& A.R.  Consent Calendar Second Day  Regular Session",79,0,0,1,80
859556,552997,2016-06-14,Senate,"Do pass, but re-refer to the Committee on Appropriations Recommend 	Consent",12,0,1,0,13
859556,559453,2016-08-11,Senate,"Consent Calendar 2nd AB2904 Committee On A. & A.R. (Garcia, C.)",37,0,2,0,39
859575,537624,2016-04-20,Assembly,"Do pass and be re-referred to the Committee on Appropriations to 	Consent Calendar",14,0,0,1,15
859575,542711,2016-05-04,Assembly,"Do pass, to Consent Calendar",20,0,0,0,20
859575,545245,2016-05-12,Assembly,"AB 2902 U.& C.  Consent Calendar Second Day  Regular Session",78,0,0,2,80
859575,555708,2016-06-27,Senate,"Do pass as amended, and re-refer to the Committee on Appropriations",9,0,2,0,11
859592,535122,2016-04-19,Assembly,"Do pass and be re-referred to the Committee on Appropriations to 	Consent Calendar",9,0,0,0,9
859592,549144,2016-05-27,Assembly,"Do pass as amended",20,0,0,0,20
859592,550443,2016-06-01,Assembly,"AB 2900 J., E.D.& E.  Assembly Third Reading  By GARCIA, E",79,0,0,1,80
859592,554638,2016-06-20,Senate,"Do pass, but re-refer to the Committee on Appropriations Recommend 	Consent",9,0,0,0,9
859592,558802,2016-08-01,Senate,"Placed on Appropriations Suspense file",7,0,0,0,7
859592,559347,2016-08-11,Senate,"Do pass as amended",7,0,0,0,7
859592,560964,2016-08-24,Senate,"Assembly 3rd Reading AB2900 Committee On J., E.D., & E. (Garcia, 	E.) By Hill",39,0,0,0,39
859592,561435,2016-08-29,Assembly,"Senate amendments be concurred in",9,0,0,0,9
859592,561736,2016-08-31,Assembly,"AB 2900 J., E.D.& E.  Concurrence in Senate Amendments By GARCIA, E",79,0,0,1,80
859610,535158,2016-04-19,Assembly,"Do pass and be re-referred to the Committee on Appropriations to 	Consent Calendar",9,0,0,0,9
859610,545069,2016-05-11,Assembly,"Do pass, to Consent Calendar",20,0,0,0,20
859610,547024,2016-05-19,Assembly,"AB 2901 J., E.D.& E.  Consent Calendar Second Day  Regular Session",76,0,0,4,80
859610,552505,2016-06-13,Senate,"Do pass, but re-refer to the Committee on Appropriations Recommend 	Consent",9,0,0,0,9
859610,556716,2016-06-30,Senate,"Consent Calendar 2nd AB2901 Committee On J., E.D., & E. (Garcia , 	E.)",37,0,3,0,40
860762,538700,2016-04-26,Assembly,"From committee:  Be adopted.  To third reading",9,0,0,0,9
860762,543054,2016-05-05,Assembly,"AJR 33 BONILLA  Assembly Third Reading",78,0,0,2,80
860762,552921,2016-06-14,Senate,"Be adopted and be placed on the Consent Calendar",5,0,0,0,5
860762,556950,2016-06-30,Senate,"Consent Calendar 2nd AJR33 Bonilla",37,0,3,0,40
860763,526775,2016-03-31,Assembly,"From committee:  Be adopted.  To third reading",8,0,0,3,11
860763,550943,2016-06-02,Senate,"Special Consent # ACR150 Atkins By Galgiani",39,0,1,0,40
860765,531214,2016-04-12,Senate,"Do pass, but re-refer to the Committee on Appropriations Recommend 	Consent",12,0,1,0,13
860765,543121,2016-05-05,Senate,"Consent Calendar 2nd SB1475 Committee On G.O. (Hall)",36,0,4,0,40
860765,554850,2016-06-20,Assembly,"Do pass and be re-referred to the Committee on Appropriations to 	Consent Calendar",11,0,0,1,12
860765,556501,2016-06-29,Assembly,"Do pass, to Consent Calendar",18,0,0,2,20
860765,559153,2016-08-04,Assembly,"SB 1475 G.O.  Consent Calendar Second Day  Regular Session",77,0,0,3,80
860767,519437,2016-03-14,Assembly,"From committee:  Be adopted.  To third reading",10,0,0,1,11
860767,550937,2016-06-02,Senate,"Special Consent # ACR151 Mullin",39,0,1,0,40
860768,535254,2016-04-19,Assembly,"Do pass and be re-referred to the Committee on Appropriations to 	Consent Calendar",9,0,0,0,9
860772,534576,2016-04-18,Assembly,"Do pass and be re-referred to the Committee on Appropriations to 	Consent Calendar",15,0,0,1,16
860772,544987,2016-05-11,Assembly,"Do pass, to Consent Calendar",20,0,0,0,20
860772,547093,2016-05-19,Assembly,"AB 2906 TRANS.  Consent Calendar Second Day  Regular Session",76,0,0,4,80
860772,554633,2016-06-21,Senate,"Do pass, but re-refer to the Committee on Appropriations Recommend 	Consent",11,0,0,0,11
860772,559357,2016-08-11,Senate,"Consent Calendar 2nd AB2906 Committee On TRANS. (Frazier)",37,0,2,0,39
860772,559812,2016-08-15,Assembly,"AB 2906 TRANS.  Concurrence in Senate Amendments By FRAZIER",78,0,0,2,80
860775,536552,2016-04-20,Senate,"Do pass, but re-refer to the Committee on Appropriations",7,0,0,0,7
860775,540010,2016-04-28,Senate,"Senate 3rd Reading SB1476 Committee On GOV. & F. (Hertzberg)",37,0,3,0,40
860775,553017,2016-06-13,Assembly,"Do pass as amended",9,0,0,0,9
860775,559860,2016-08-15,Assembly,"SB 1476 GOV.& F.  Senate Third Reading  By RIDLEY-THOMAS",78,0,0,2,80
860775,561240,2016-08-25,Senate,"Special Consent SB1476 GOV. & F. (Hertzberg)",39,0,0,0,39
860776,535827,2016-04-18,Assembly,"Be adopted, as amended, to Consent Calendar",9,0,0,0,9
860776,539659,2016-04-28,Assembly,"ACR 149 GIPSON  Consent Calendar Second Day  Regular Session",76,0,0,4,80
860776,555176,2016-06-22,Senate,"Be adopted as amended",6,0,1,0,7
860776,559425,2016-08-11,Senate,"Special Consent ACR149 Gipson",37,0,2,0,39
860776,559822,2016-08-15,Assembly,"ACR 149 GIPSON  Concurrence in Senate Amendments",78,0,0,2,80
860779,533450,2016-04-13,Senate,"Be adopted, but re-refer to the Committee on Appropriations",9,0,0,0,9
860779,545302,2016-05-12,Senate,"Senate 3rd Reading SCR117 Pan",38,0,2,0,40
860779,553082,2016-06-14,Assembly,"Be adopted and re-referred to the Committee on Appropriations with 	recommendation:  To Consent Calendar",15,0,0,3,18
860779,556451,2016-06-29,Assembly,"Be adopted, to Consent Calendar",18,0,0,2,20
860779,558690,2016-08-01,Assembly,"SCR 117 Pan  Consent Calendar Second Day  Regular Session",76,0,0,4,80
861875,542979,2016-05-05,Assembly,"From committee:  Be adopted.  To third reading",11,0,0,0,11
861875,550940,2016-06-02,Senate,"Special Consent # ACR152 Bloom",39,0,1,0,40
861881,538699,2016-04-25,Assembly,"Do pass, to Consent Calendar",12,0,0,0,12
861881,540850,2016-05-02,Assembly,"AB 2907 B.& F.  Consent Calendar Second Day  Regular Session",76,0,0,4,80
861881,556426,2016-06-29,Senate,"Do pass and be placed on the Consent Calendar",7,0,0,0,7
861881,559389,2016-08-11,Senate,"Consent Calendar 2nd AB2907 Committee On B. & F. (Dababneh)",37,0,2,0,39
861881,560217,2016-08-18,Assembly,"AB 2907 B.& F.  Concurrence in Senate Amendments By DABABNEH",79,0,0,1,80
861884,542411,2016-05-04,Assembly,"Do pass, to Consent Calendar",20,0,0,0,20
861884,544302,2016-04-19,Assembly,"Do pass and be re-referred to the Committee on Appropriations",13,0,0,0,13
861884,545172,2016-05-12,Assembly,"AB 2908 HIGHER ED.  Consent Calendar Second Day  Regular Session",78,0,0,2,80
861884,552048,2016-06-08,Senate,"Do pass, but re-refer to the Committee on Appropriations Recommend 	Consent",9,0,0,0,9
861884,556765,2016-06-30,Senate,"Consent Calendar 2nd AB2908 Committee On HIGHER ED. (Medina)",37,0,3,0,40
862432,517805,2016-03-10,Senate,"W/O REF. TO FILE SR67 De Le",26,7,7,0,40
862438,531570,2016-04-12,Assembly,"Do pass and be re-referred to the Committee on Appropriations to 	Consent Calendar",14,0,0,1,15
862438,539015,2016-04-27,Assembly,"Do pass, to Consent Calendar",19,0,0,1,20
862438,543015,2016-05-05,Assembly,"AB 2909A& A.R.  Consent Calendar Second Day  Regular Session",79,0,0,1,80
862438,556072,2016-06-28,Senate,"Do pass, but re-refer to the Committee on Appropriations",5,0,4,0,9
862438,556073,2016-06-28,Senate,"Set, first hearing.  Held in Committee.  Reconsideration of 	favorable vote granted",5,0,4,0,9
862438,559187,2016-08-08,Senate,"Placed on Appropriations Suspense file",7,0,0,0,7
862440,521281,2016-03-17,Senate,"Senate 3rd Reading SR68 Berryhill",32,0,8,0,40
862441,533254,2016-04-13,Senate,"Do pass and be placed on the Consent Calendar",9,0,0,0,9
862441,537124,2016-04-21,Senate,"Consent Calendar 2nd SB1477 Committee On HEALTH (Hernandez)",39,0,1,0,40
862441,553595,2016-06-14,Assembly,"Do pass, to Consent Calendar",15,0,0,3,18
862441,555392,2016-06-23,Assembly,"SB 1477 HEALTH  Consent Calendar Second Day  Regular Session",79,0,0,1,80
862441,560418,2016-08-19,Assembly,"SB 1477 HEALTH  Senate Third Reading  By WOOD  Amendment  Set #1",73,0,0,7,80
862441,561016,2016-08-24,Assembly,"SB 1477 HEALTH  Senate Third Reading  By WOOD",78,0,0,2,80
862441,561497,2016-08-29,Senate,"Unfinished Business SB1477 Committee On HEALTH (Hernandez) 	Concurrence",39,0,0,0,39
862444,537099,2016-04-20,Assembly,"Be adopted and be re-referred to the Committee on Appropriations",12,1,0,2,15
862444,549128,2016-05-27,Assembly,"Be adopted as amended",20,0,0,0,20
862444,550877,2016-06-02,Assembly,"ACA 11 GATTO  Assembly Third Reading",61,9,0,10,80
863071,525160,2016-03-28,Assembly,"From committee:  Be adopted.  To third reading",10,0,0,1,11
863086,535227,2016-04-18,Senate,"Do pass, but re-refer to the Committee on Appropriations Recommend 	Consent",9,0,0,0,9
863086,545377,2016-05-12,Senate,"Consent Calendar 2nd SB1478 Committee On B.P.&E.D. (Hill)",38,0,2,0,40
863086,552855,2016-06-14,Assembly,"Do pass and be re-referred to the Committee on Appropriations to 	Consent Calendar",16,0,0,0,16
863086,556622,2016-06-29,Assembly,"Do pass, to Consent Calendar",18,0,0,2,20
863086,560616,2016-08-22,Assembly,"SB 1478 B. P.& E.D.  Senate Third Reading  By COOPER",79,0,0,1,80
863086,561496,2016-08-29,Senate,"Special Consent SB1478 Committee On B.P.&E.D. (Hill)",39,0,0,0,39
863100,535724,2016-04-18,Senate,"Do pass, but re-refer to the Committee on Appropriations Recommend 	Consent",9,0,0,0,9
863100,545286,2016-05-12,Senate,"Consent Calendar 2nd SB1479 Committee On B.P.&E.D. (Hill)",38,0,2,0,40
863100,552906,2016-06-14,Assembly,"Do pass and be re-referred to the Committee on Appropriations to 	Consent Calendar",16,0,0,0,16
863100,556502,2016-06-29,Assembly,"Do pass, to Consent Calendar",18,0,0,2,20
863100,560574,2016-08-22,Assembly,"SB 1479 B. P.& E.D.  Senate Third Reading  By COOPER",79,0,0,1,80
863100,561428,2016-08-29,Senate,"Special Consent SB1479 Committee On B.P.&E.D. (Hill)",39,0,0,0,39
864507,550524,2016-06-01,Assembly,"From committee:  Be adopted.  To third reading",11,0,0,0,11
864517,525232,2016-03-28,Assembly,"From committee:  Be adopted.  To third reading",11,0,0,0,11
864517,561198,2016-08-25,Senate,"Assembly 3rd Reading ACR154 Gipson By Leyva",39,0,0,0,39
865057,532607,2016-04-12,Senate,"Be adopted and be placed on the Consent Calendar",5,0,0,0,5
865057,555331,2016-06-23,Senate,"Senate 3rd Reading SR69 Glazer",35,0,5,0,40
865067,539404,2016-04-27,Assembly,"Do pass, to Consent Calendar",7,0,0,0,7
865067,543092,2016-05-05,Assembly,"AB 2911 E.& R.  Consent Calendar Second Day  Regular Session",79,0,0,1,80
865067,552137,2016-06-08,Senate,"Do pass and be placed on the Consent Calendar",5,0,0,0,5
865067,560817,2016-08-23,Senate,"Assembly 3rd Reading AB2911 Committee On E. & R. (Weber) By Allen",39,0,0,0,39
865067,561478,2016-08-29,Assembly,"AB 2911 E.& R.  Concurrence in Senate Amendments By WEBER",80,0,0,0,80
865079,535729,2016-04-18,Assembly,"Do pass and be re-referred to the Committee on Appropriations to 	Consent Calendar",9,0,0,0,9
865079,542626,2016-05-04,Assembly,"Do pass, to Consent Calendar",20,0,0,0,20
865079,545231,2016-05-12,Assembly,"AB 2912 NAT. RES.  Consent Calendar Second Day  Regular Session",78,0,0,2,80
865079,555948,2016-06-28,Senate,"Do pass as amended, but re-refer to the Committee on Appropriations 	Recommend Consent",8,0,1,0,9
865079,559359,2016-08-11,Senate,"Consent Calendar 2nd AB2912 Committee On NAT. RES. (Williams)",37,0,2,0,39
865079,559796,2016-08-15,Assembly,"AB 2912 NAT. RES.  Concurrence in Senate Amendments By WILLIAMS",78,0,0,2,80
865087,526726,2016-03-31,Senate,"Senate 3rd Reading SCR118 Glazer",36,0,4,0,40
865087,559276,2016-08-11,Assembly,"Be adopted, to Consent Calendar",9,0,0,2,11
865087,560216,2016-08-18,Assembly,"SCR 118 Glazer  Consent Calendar Second Day  Regular Session",78,0,0,2,80
865097,539087,2016-04-27,Assembly,"Do pass, to Consent Calendar",9,0,0,0,9
865097,543110,2016-05-05,Assembly,"AB 2910 L. GOV.  Consent Calendar Second Day  Regular Session",79,0,0,1,80
865097,552065,2016-06-08,Senate,"Do pass and be placed on the Consent Calendar",7,0,0,0,7
865097,558678,2016-08-01,Senate,"Assembly 3rd Reading AB2910 Committee On L. GOV. (Eggman) By 	Hertzberg",39,0,0,0,39
865097,559123,2016-08-04,Assembly,"AB 2910 L. GOV.  Concurrence in Senate Amendments By EGGMAN",77,0,0,3,80
865784,538693,2016-04-26,Senate,"Be adopted",9,0,2,0,11
865784,539631,2016-04-28,Senate,"Senate 3rd Reading SJR22 Hueso",37,0,3,0,40
865784,555517,2016-06-21,Assembly,"Be adopted as amended",9,0,0,0,9
865784,559152,2016-08-04,Assembly,"SJR 22 Hueso  Senate Third Reading  By GARCIA, E",76,0,0,4,80
865784,559477,2016-08-11,Senate,"Special Consent SJR22 Hueso Concurrence",37,0,2,0,39
865796,533179,2016-04-14,Assembly,"From committee:  Be adopted.  To third reading",11,0,0,0,11
865796,534157,2016-04-18,Assembly,"AJR 34 ACHADJIAN  Assembly Third Reading",78,0,0,2,80
865796,534158,2016-04-18,Senate,"W/O REF. TO FILE AJR34 Achadjian By De Le",37,0,3,0,40
865811,554463,2016-06-20,Senate,"Senate 3rd Reading SCR119 Hertzberg",35,0,5,0,40
865811,555547,2016-06-27,Assembly,"Be adopted, to Consent Calendar",10,0,0,1,11
865811,557037,2016-06-30,Assembly,"SCR 119 Hertzberg  Consent Calendar Second Day  Regular Session",79,0,0,1,80
865825,526793,2016-03-31,Senate,"Senate 3rd Reading SCR120 Hill",36,0,4,0,40
865825,529550,2016-04-07,Assembly,"From committee:  Be adopted.  To third reading",9,0,0,2,11
865825,529551,2016-04-07,Assembly,"SCR 120 Hill  Senate Third Reading  By MULLIN",77,0,0,2,79
866211,543098,2016-05-05,Assembly,"Do pass, to Consent Calendar",21,0,0,0,21
866211,545260,2016-05-12,Assembly,"AB 2915 G.O.  Consent Calendar Second Day  Regular Session",78,0,0,2,80
866211,560555,2016-08-22,Senate,"Assembly 3rd Reading AB2915 Eduardo Garcia By Hall Urgency Clause",38,0,1,0,39
866211,561241,2016-08-25,Assembly,"AB 2915 GARCIA, E.  Concurrence- Urgency Added",79,0,0,1,80
866225,536917,2016-04-20,Senate,"Do pass and be placed on the Consent Calendar",7,0,0,0,7
866225,539966,2016-04-28,Senate,"Consent Calendar 2nd SB1480 Committee On GOV. & F. (Hertzberg)",37,0,3,0,40
866225,552692,2016-06-13,Assembly,"Do pass, to Consent Calendar",9,0,0,0,9
866225,555393,2016-06-23,Assembly,"SB 1480 GOV.& F.  Consent Calendar Second Day  Regular Session",79,0,0,1,80
866225,555575,2016-06-27,Senate,"Unfinished Business SB1480 Committee On GOV. & F. (Hertzberg) 	Concurrence",38,0,2,0,40
866239,543095,2016-05-05,Assembly,"Do pass, to Consent Calendar",21,0,0,0,21
866239,545359,2016-05-12,Assembly,"AB 2914 G.O.  Consent Calendar Second Day  Regular Session",78,0,0,2,80
866239,552748,2016-06-14,Senate,"Do pass and be placed on the Consent Calendar",12,0,1,0,13
866239,556912,2016-06-30,Senate,"Consent Calendar 2nd AB2914 Committee On G.O. (Hall)",37,0,3,0,40
866255,538678,2016-04-26,Assembly,"Be adopted and re-referred to the Committee on Appropriations with 	recommendation:  To Consent Calendar",6,0,0,1,7
866255,549038,2016-05-27,Assembly,"From committee:  Be adopted.  To third reading",20,0,0,0,20
866255,550540,2016-06-01,Assembly,"AJR 35 BROWN  Assembly Third Reading",80,0,0,0,80
866255,556532,2016-06-28,Senate,"Be adopted and be placed on the Consent Calendar",5,0,0,0,5
866255,559432,2016-08-11,Senate,"Consent Calendar 2nd AJR35 Brown",37,0,2,0,39
866273,536900,2016-04-20,Assembly,"Do pass and be re-referred to the Committee on Appropriations to 	Consent Calendar",21,0,0,0,21
866273,542538,2016-05-04,Assembly,"Do pass, to Consent Calendar",20,0,0,0,20
866273,545481,2016-05-12,Assembly,"AB 2913 G.O.  Consent Calendar Second Day  Regular Session",78,0,0,2,80
866273,561054,2016-08-24,Senate,"Assembly 3rd Reading AB2913 Committee On G.O. (Gray) By Hall",39,0,0,0,39
866273,561577,2016-08-30,Assembly,"AB 2913 G.O.  Concurrence in Senate Amendments By GRAY",78,0,0,2,80
866290,533114,2016-04-14,Senate,"Senate 3rd Reading SR70 Allen",36,0,4,0,40
866308,536915,2016-04-20,Senate,"Do pass, but re-refer to the Committee on Appropriations Recommend 	Consent",7,0,0,0,7
866308,543274,2016-05-05,Senate,"Consent Calendar 2nd SB1481 Committee On GOV. & F. (Hertzberg)",36,0,4,0,40
866308,552694,2016-06-13,Assembly,"Do pass, to Consent Calendar",9,0,0,0,9
866308,555373,2016-06-23,Assembly,"SB 1481 GOV.& F.  Consent Calendar Second Day  Regular Session",79,0,0,1,80
866308,555577,2016-06-27,Senate,"Unfinished Business SB1481 Committee On GOV. & F. (Hertzberg) 	Concurrence",38,0,2,0,40
868836,535239,2016-04-19,Senate,"Be adopted",11,0,0,0,11
868836,539583,2016-04-28,Senate,"Senate 3rd Reading SJR23 Bates",37,0,3,0,40
868836,553399,2016-06-15,Assembly,"Be adopted, to Consent Calendar",15,0,0,0,15
868836,555300,2016-06-23,Assembly,"SJR 23 Bates  Consent Calendar Second Day",79,0,0,1,80
868838,530926,2016-04-11,Senate,"Senate 3rd Reading SCR121 Wieckowski",36,0,4,0,40
868838,538049,2016-04-25,Assembly,"Be adopted, to Consent Calendar",9,0,0,2,11
868838,540077,2016-04-28,Assembly,"SCR 121 Wieckowski  Consent Calendar Second Day  Regular Session",76,0,0,4,80
868838,543825,2016-05-09,Senate,"Unfinished Business SCR121 Wieckowski Concurrence",37,0,3,0,40
868841,529419,2016-04-07,Senate,"Senate 3rd Reading SCR122 Beall",38,0,2,0,40
868841,537987,2016-04-25,Assembly,"Be adopted, to Consent Calendar",9,0,0,2,11
868841,543143,2016-05-05,Senate,"Unfinished Business SCR122 Beall Concurrence",37,0,3,0,40
868843,527847,2016-04-04,Assembly,"From committee:  Be adopted.  To third reading",10,0,0,1,11
868843,530896,2016-04-11,Assembly,"ACR 155 CAMPOS  Assembly Third Reading",69,0,0,10,79
868843,560253,2016-08-18,Senate,"Assembly 3rd Reading ACR155 Campos By Mitchell",36,0,3,0,39
868845,530960,2016-04-11,Assembly,"From committee:  Be adopted.  To third reading",9,0,0,2,11
868845,548936,2016-05-26,Senate,"Assembly 3rd Reading ACR156 Low By Pan",36,0,4,0,40
869176,554901,2016-06-21,Assembly,"Be adopted and be re-referred to the Committee on Appropriations",12,0,0,1,13
869176,556322,2016-06-29,Assembly,"Be adopted, to Consent Calendar",18,0,0,2,20
869176,558723,2016-08-01,Assembly,"ACR 158 HOLDEN  Consent Calendar Second Day  Regular Session",76,0,0,4,80
869176,559207,2016-08-09,Senate,"Be adopted, but re-refer to the Committee on Appropriations",8,0,1,0,9
869176,560361,2016-08-19,Senate,"Assembly 3rd Reading ACR158 Holden By Pan",37,0,2,0,39
869182,534617,2016-04-18,Assembly,"Be adopted and re-referred to the Committee on Appropriations with 	recommendation:  To Consent Calendar",15,0,0,1,16
869182,544880,2016-05-11,Assembly,"Be adopted, to Consent Calendar",20,0,0,0,20
869182,545793,2016-05-16,Assembly,"ACR 159 SALAS  Consent Calendar Second Day  Regular Session",77,0,0,3,80
869182,559449,2016-08-11,Senate,"Consent Calendar 2nd ACR159 Salas",37,0,2,0,39
869186,534318,2016-04-18,Assembly,"Be adopted and re-referred to the Committee on Appropriations with 	recommendation:  To Consent Calendar",15,0,0,1,16
869186,544993,2016-05-11,Assembly,"Be adopted, to Consent Calendar",20,0,0,0,20
869186,545789,2016-05-16,Assembly,"ACR 157 HADLEY  Consent Calendar Second Day",77,0,0,3,80
869186,559495,2016-08-11,Senate,"Consent Calendar 2nd ACR157 Hadley",37,0,2,0,39
869190,529370,2016-04-07,Assembly,"From committee:  Be adopted.  To third reading",9,0,0,2,11
869469,540876,2016-05-02,Assembly,"Be adopted, to Consent Calendar",11,0,0,0,11
869469,543010,2016-05-05,Assembly,"HR 45  Consent Calendar Second Day  Regular Session",79,0,0,1,80
869470,538013,2016-04-25,Senate,"Senate 3rd Reading SCR123 Jackson",38,0,2,0,40
869470,540827,2016-05-02,Assembly,"Be adopted, to Consent Calendar",11,0,0,0,11
869470,543040,2016-05-05,Assembly,"SCR 123 Jackson  Consent Calendar Second Day  Regular Session",79,0,0,1,80
869471,534580,2016-04-18,Assembly,"Be adopted, to Consent Calendar",15,0,0,1,16
869471,558625,2016-08-01,Senate,"Assembly 3rd Reading ACR160 Hadley By Allen",39,0,0,0,39
869472,538051,2016-04-25,Senate,"Senate 3rd Reading SCR124 Fuller",38,0,2,0,40
869472,540861,2016-05-02,Assembly,"Be adopted, to Consent Calendar",11,0,0,0,11
869472,543227,2016-05-05,Assembly,"SCR 124 Fuller  Consent Calendar Second Day  Regular Session",79,0,0,1,80
869473,537599,2016-04-21,Assembly,"From committee:  Be adopted.  To third reading",9,0,0,2,11
869473,548671,2016-05-26,Senate,"Assembly 3rd Reading ACR161 Waldron By Nguyen",36,0,4,0,40
869474,533481,2016-04-14,Assembly,"From committee:  Be adopted.  To third reading",11,0,0,0,11
869474,545324,2016-05-12,Senate,"Assembly 3rd Reading ACR162 Dababneh By Glazer",38,0,2,0,40
869683,556843,2016-06-30,Senate,"Senate 3rd Reading SCR126 Lara",37,0,3,0,40
869683,559182,2016-08-08,Assembly,"Be adopted, to Consent Calendar",10,0,0,1,11
869683,559376,2016-08-11,Assembly,"SCR 126 Lara  Consent Calendar Second Day  Regular Session",78,0,0,2,80
869684,530479,2016-04-11,Assembly,"From committee:  Be adopted.  To third reading",9,0,0,2,11
869686,530450,2016-04-11,Senate,"Senate 3rd Reading SR71 Berryhill",36,0,4,0,40
870037,533374,2016-04-14,Assembly,"From committee:  Be adopted.  To third reading",11,0,0,0,11
870043,534578,2016-04-18,Assembly,"Be adopted and re-referred to the Committee on Appropriations with 	recommendation:  To Consent Calendar",15,0,0,1,16
870043,544909,2016-05-11,Assembly,"Be adopted, to Consent Calendar",20,0,0,0,20
870043,545942,2016-05-16,Assembly,"ACR 163 ATKINS  Consent Calendar Second Day  Regular Session",77,0,0,3,80
870043,559430,2016-08-11,Senate,"Consent Calendar 2nd ACR163 Atkins By Block",37,0,2,0,39
870050,533427,2016-04-14,Assembly,"From committee:  Be adopted.  To third reading",11,0,0,0,11
870050,545345,2016-05-12,Senate,"Assembly 3rd Reading ACR164 Patterson By Vidak",38,0,2,0,40
870833,554434,2016-06-20,Senate,"Senate 3rd Reading SCR127 Lara",37,0,3,0,40
870833,559170,2016-08-08,Assembly,"Be adopted, to Consent Calendar",10,0,0,1,11
870833,559358,2016-08-11,Assembly,"SCR 127 Lara  Consent Calendar Second Day  Regular Session",78,0,0,2,80
871213,540783,2016-05-02,Senate,"Senate 3rd Reading SCR128 Mendoza",37,0,3,0,40
871213,550465,2016-06-01,Assembly,"From committee:  Be adopted.  To third reading",11,0,0,0,11
871531,534284,2016-04-18,Assembly,"Be adopted and re-referred to the Committee on Appropriations with 	recommendation:  To Consent Calendar",15,0,0,1,16
871531,544871,2016-05-11,Assembly,"Be adopted, to Consent Calendar",20,0,0,0,20
871531,545812,2016-05-16,Assembly,"ACR 165 BIGELOW  Consent Calendar Second Day  Regular Session",77,0,0,3,80
871531,559322,2016-08-11,Senate,"Consent Calendar 2nd ACR165 Bigelow",37,0,2,0,39
871536,538088,2016-04-25,Senate,"Senate 3rd Reading SCR129 Leyva",39,0,1,0,40
871536,545237,2016-05-12,Assembly,"Be adopted, to Consent Calendar",10,0,0,1,11
871536,547228,2016-05-19,Assembly,"SCR 129 Leyva  Consent Calendar Second Day  Regular Session",76,0,0,4,80
871543,541046,2016-05-02,Senate,"Senate 3rd Reading SCR130 Mendoza",38,0,2,0,40
871543,545453,2016-05-12,Assembly,"From committee:  Be adopted.  To third reading",10,0,0,1,11
871543,552264,2016-06-09,Senate,"Unfinished Business SCR130 Mendoza Concurrence",32,0,8,0,40
872014,555408,2016-06-23,Assembly,"From committee:  Be adopted.  To third reading",11,0,0,0,11
872407,541861,2016-05-03,Assembly,"From committee:  Be adopted.  To third reading",7,0,0,0,7
872407,550074,2016-05-31,Senate,"Assembly 3rd Reading ACR166 Chu By Nielsen",39,0,1,0,40
872782,539918,2016-04-28,Assembly,"From committee:  Be adopted.  To third reading",11,0,0,0,11
872782,550959,2016-06-02,Senate,"Special Consent # ACR168 Medina",39,0,1,0,40
872783,542604,2016-05-04,Assembly,"Be adopted, to Consent Calendar",9,0,0,0,9
872783,550918,2016-06-02,Senate,"Special Consent # ACR169 Dahle",39,0,1,0,40
872784,537976,2016-04-25,Assembly,"From committee:  Be adopted.  To third reading",9,0,0,2,11
873023,539696,2016-04-28,Senate,"Senate 3rd Reading SCR132 Galgiani",37,0,3,0,40
873026,545908,2016-05-16,Assembly,"From committee:  Be adopted.  To third reading",10,0,0,1,11
873026,557012,2016-06-30,Senate,"Special Consent # ACR170 Bonta By Pan",37,0,3,0,40
873030,537299,2016-04-21,Senate,"Senate 3rd Reading SCR131 Beall",39,0,1,0,40
873030,539671,2016-04-28,Assembly,"From committee:  Be adopted.  To third reading",11,0,0,0,11
873030,545205,2016-05-12,Senate,"Unfinished Business SCR131 Beall Concurrence",38,0,2,0,40
873433,543932,2016-05-09,Senate,"Senate 3rd Reading SR72 Huff",33,0,7,0,40
873439,541151,2016-05-02,Senate,"Senate 3rd Reading SCR133 Beall",38,0,2,0,40
873439,555404,2016-06-23,Assembly,"Be adopted, to Consent Calendar",11,0,0,0,11
873439,557014,2016-06-30,Assembly,"SCR 133 Beall  Consent Calendar Second Day  Regular Session",79,0,0,1,80
873452,539626,2016-04-28,Assembly,"From committee:  Be adopted.  To third reading",11,0,0,0,11
873452,548738,2016-05-26,Senate,"Assembly 3rd Reading ACR172 Hadley By Stone",36,0,4,0,40
873460,543256,2016-05-05,Assembly,"From committee:  Be adopted.  To third reading",11,0,0,0,11
873460,557008,2016-06-30,Senate,"Special Consent # ACR171 Rodriguez",37,0,3,0,40
873735,547882,2016-05-23,Assembly,"From committee:  Be adopted.  To third reading",10,0,0,1,11
873735,559920,2016-08-15,Senate,"Assembly 3rd Reading ACR173 Cooley By McGuire",38,0,1,0,39
874026,552533,2016-06-13,Assembly,"Be adopted and re-referred to the Committee on Appropriations with 	recommendation:  To Consent Calendar",15,0,0,1,16
874026,556495,2016-06-29,Assembly,"Be adopted, to Consent Calendar",18,0,0,2,20
874026,558672,2016-08-01,Assembly,"ACR 174 BIGELOW  Consent Calendar Second Day  Regular Session",76,0,0,4,80
874026,559204,2016-08-09,Senate,"Be adopted, but re-refer to the Committee on Appropriations 	Recommend Consent",11,0,0,0,11
874026,560103,2016-08-17,Senate,"Consent Calendar 2nd ACR174 Bigelow",39,0,0,0,39
874030,540865,2016-05-02,Senate,"Senate 3rd Reading SR73 Nguyen",37,0,3,0,40
874033,553159,2016-06-14,Assembly,"From committee:  Be adopted.  To third reading",8,0,0,1,9
874033,555512,2016-06-27,Assembly,"AJR 37 BONTA  Assembly Third Reading",75,0,0,5,80
874033,559295,2016-08-11,Senate,"Special Consent AJR37 Bonta By Pan",37,0,2,0,39
874038,552070,2016-06-08,Senate,"Be adopted, but re-refer to the Committee on Appropriations",4,1,0,0,5
874038,552484,2016-06-13,Senate,"Be adopted",2,5,0,0,7
874038,553687,2016-06-16,Senate,"Senate 3rd Reading SCA14 Wolk",27,8,5,0,40
874038,554806,2016-06-21,Assembly,"Be adopted and be re-referred to the Committee on Appropriations",7,2,0,2,11
874038,554949,2016-06-22,Assembly,"Be adopted",14,5,0,1,20
874292,552238,2016-06-08,Senate,"Be adopted, but re-refer to the Committee on Appropriations 	Recommend Consent",7,0,2,0,9
874292,556993,2016-06-30,Senate,"Consent Calendar 2nd SCR134 Pan",37,0,3,0,40
874292,561641,2016-08-30,Assembly,"From committee:  Be adopted.  To third reading",16,0,0,2,18
874292,561752,2016-08-31,Assembly,"SCR 134 Pan  Senate Third Reading  By LOW",79,0,0,1,80
874521,545911,2016-05-16,Senate,"Senate 3rd Reading SCR135 Bates",36,0,4,0,40
874521,547627,2016-05-23,Assembly,"Be adopted, to Consent Calendar",10,0,0,1,11
874521,549236,2016-05-27,Assembly,"SCR 135 Bates  Consent Calendar Second Day  Regular Session",67,0,0,13,80
874746,545232,2016-05-12,Senate,"Senate 3rd Reading SCR136 Leyva",38,0,2,0,40
874746,547105,2016-05-19,Assembly,"Be adopted, to Consent Calendar",11,0,0,0,11
874746,549016,2016-05-27,Assembly,"SCR 136 Leyva  Consent Calendar Second Day  Regular Session",67,0,0,13,80
874754,552126,2016-06-08,Assembly,"From committee:  Be adopted.  To third reading",7,1,0,2,10
874754,552479,2016-06-13,Assembly,"AJR 38 GARCIA, E.  Assembly Third Reading",61,9,0,10,80
874754,556611,2016-06-28,Senate,"Be adopted",6,1,0,0,7
874754,559861,2016-08-15,Senate,"Assembly 3rd Reading AJR38 Eduardo Garcia By Mendoza",30,4,5,0,39
874763,543891,2016-05-09,Assembly,"From committee:  Be adopted.  To third reading",10,0,0,1,11
874763,556835,2016-06-30,Senate,"Special Consent # ACR175 Achadjian By Monning",37,0,3,0,40
874771,547209,2016-05-19,Assembly,"From committee:  Be adopted.  To third reading",11,0,0,0,11
874973,552143,2016-06-08,Assembly,"From committee:  Be adopted.  To third reading",9,0,0,1,10
874973,559368,2016-08-11,Senate,"Special Consent ACR176 Cristina Garcia",37,0,2,0,39
875547,552478,2016-06-13,Assembly,"Be adopted and re-referred to the Committee on Appropriations with 	recommendation:  To Consent Calendar",15,0,0,1,16
875547,556695,2016-06-29,Assembly,"Be adopted, to Consent Calendar",18,0,0,2,20
875547,558669,2016-08-01,Assembly,"ACR 177 FRAZIER  Consent Calendar Second Day  Regular Session",76,0,0,4,80
875547,559208,2016-08-09,Senate,"Be adopted, but re-refer to the Committee on Appropriations 	Recommend Consent",11,0,0,0,11
875547,560105,2016-08-17,Senate,"Consent Calendar 2nd ACR177 Frazier",39,0,0,0,39
875548,545391,2016-05-12,Assembly,"From committee:  Be adopted.  To third reading",10,0,0,1,11
875549,548692,2016-05-26,Senate,"Senate 3rd Reading SR74 Beall",37,0,3,0,40
875550,552879,2016-06-14,Senate,"Be adopted, but re-refer to the Committee on Appropriations 	Recommend Consent",11,0,0,0,11
875550,557040,2016-06-30,Senate,"Consent Calendar 2nd SCR137 Wolk",37,0,3,0,40
875550,559873,2016-08-15,Assembly,"Be adopted and be re-referred to the Committee on Appropriations",15,0,0,1,16
875550,561493,2016-08-29,Assembly,"Be adopted, to Consent Calendar",19,0,0,1,20
875550,561836,2016-08-31,Assembly,"SCR 137 Wolk  Consent Calendar Second Day  Regular Session",79,0,0,1,80
875880,543169,2016-05-05,Senate,"W/O REF. TO FILE SR75 De Le",36,0,4,0,40
875882,555525,2016-06-27,Assembly,"Be adopted and be re-referred to the Committee on Appropriations",15,0,0,1,16
875882,556371,2016-06-29,Assembly,"Be adopted, to Consent Calendar",18,0,0,2,20
875882,558640,2016-08-01,Assembly,"ACR 178 GIPSON  Consent Calendar Second Day  Regular Session",76,0,0,4,80
875882,559198,2016-08-09,Senate,"Be adopted, but re-refer to the Committee on Appropriations 	Recommend Consent",11,0,0,0,11
875882,560058,2016-08-17,Senate,"Consent Calendar 2nd ACR178 Gipson",39,0,0,0,39
875882,560679,2016-08-23,Assembly,"ACR 178 GIPSON  Concurrence in Senate Amendments",79,0,0,1,80
875886,545472,2016-05-12,Assembly,"From committee:  Be adopted.  To third reading",10,0,0,1,11
875886,557016,2016-06-30,Senate,"Special Consent # ACR179 Cooley",37,0,3,0,40
876447,547864,2016-05-23,Senate,"Senate 3rd Reading SCR140 Cannella",38,0,2,0,40
876447,551692,2016-06-06,Assembly,"Be adopted, to Consent Calendar",9,0,0,2,11
876447,552271,2016-06-09,Assembly,"SCR 140 Cannella  Consent Calendar Second Day",76,0,0,4,80
876448,555771,2016-06-27,Assembly,"Be adopted and re-referred to the Committee on Appropriations with 	recommendation:  To Consent Calendar",15,0,0,1,16
876448,556473,2016-06-29,Assembly,"Be adopted, to Consent Calendar",18,0,0,2,20
876448,558675,2016-08-01,Assembly,"ACR 180 OBERNOLTE  Consent Calendar Second Day  Regular Session",76,0,0,4,80
876448,559206,2016-08-09,Senate,"Be adopted, but re-refer to the Committee on Appropriations 	Recommend Consent",11,0,0,0,11
876448,560276,2016-08-18,Senate,"Consent Calendar 2nd ACR180 Obernolte",36,0,3,0,39
876448,561006,2016-08-24,Assembly,"ACR 180 OBERNOLTE  Concurrence in Senate Amendments",79,0,0,1,80
876449,554754,2016-06-21,Senate,"Be adopted, but re-refer to the Committee on Appropriations 	Recommend Consent",11,0,0,0,11
876449,556725,2016-06-30,Senate,"Consent Calendar 2nd SCR139 Gaines",37,0,3,0,40
876449,559865,2016-08-15,Assembly,"Be adopted and be re-referred to the Committee on Appropriations",15,0,0,1,16
876449,561473,2016-08-29,Assembly,"Be adopted, to Consent Calendar",19,0,0,1,20
876449,561838,2016-08-31,Assembly,"SCR 139 Gaines  Consent Calendar Second Day  Regular Session",79,0,0,1,80
876449,561839,2016-08-31,Senate,"Unfinished Business (S upplemental File 3)SCR 139 Gai nes Con",39,0,0,0,39
876451,552386,2016-06-09,Senate,"Senate 3rd Reading SCR138 Nielsen",32,0,8,0,40
876451,558691,2016-08-01,Assembly,"Be adopted, to Consent Calendar",10,0,0,1,11
876451,559109,2016-08-04,Assembly,"SCR 138 Nielsen  Consent Calendar Second Day  Regular Session",77,0,0,3,80
876452,545947,2016-05-16,Senate,"Senate 3rd Reading SR76 Runner By Hill",37,0,3,0,40
876715,560062,2016-08-17,Senate,"Senate 3rd Reading SCR142 Fuller",37,0,2,0,39
876715,560591,2016-08-22,Assembly,"Be adopted, to Consent Calendar",9,0,0,2,11
876715,561085,2016-08-24,Assembly,"SCR 142 Fuller  Consent Calendar Second Day",77,0,0,3,80
876717,545886,2016-05-16,Assembly,"From committee:  Be adopted.  To third reading",10,0,0,1,11
876717,559492,2016-08-11,Senate,"Special Consent ACR183 Cooley",37,0,2,0,39
876718,548688,2016-05-26,Senate,"Senate 3rd Reading SCR141 Nielsen",38,0,2,0,40
876718,550724,2016-06-01,Assembly,"From committee:  Be adopted.  To third reading",11,0,0,0,11
876718,552252,2016-06-09,Senate,"Unfinished Business SCR141 Nielsen Concurrence",37,0,3,0,40
877140,548702,2016-05-26,Senate,"Senate 3rd Reading SCR143 Cannella",38,0,2,0,40
877140,551429,2016-06-06,Assembly,"Be adopted, to Consent Calendar",9,0,0,2,11
877140,552248,2016-06-09,Assembly,"SCR 143 Cannella  Consent Calendar Second Day  Regular Session",76,0,0,4,80
877141,547205,2016-05-19,Assembly,"From committee:  Be adopted.  To third reading",11,0,0,0,11
877141,556812,2016-06-30,Senate,"Special Consent # ACR184 Salas",37,0,3,0,40
877436,558687,2016-08-01,Assembly,"From committee:  Be adopted.  To third reading",10,0,0,1,11
877436,560266,2016-08-18,Senate,"Assembly 3rd Reading ACR185 Linder By Vidak",38,0,1,0,39
877738,552265,2016-06-09,Assembly,"From committee:  Be adopted.  To third reading",7,0,0,4,11
877738,559475,2016-08-11,Senate,"Special Consent ACR186 Bigelow",37,0,2,0,39
877962,552156,2016-06-08,Senate,"Be adopted and be placed on the Consent Calendar",9,0,0,0,9
877962,557144,2016-06-30,Senate,"Consent Calendar 2nd SR77 Fuller",37,0,3,0,40
878240,556143,2016-06-28,Senate,"Be adopted, but re-refer to the Committee on Appropriations 	Recommend Consent",8,0,1,0,9
878240,559387,2016-08-11,Senate,"Consent Calendar 2nd SCR144 Gaines",37,0,2,0,39
878249,547942,2016-05-24,Assembly,"Be adopted as amended",5,0,0,2,7
878257,549195,2016-05-27,Assembly,"From committee:  Be adopted.  To third reading",10,0,0,1,11
878257,556989,2016-06-30,Senate,"Special Consent # ACR187 Gomez",37,0,3,0,40
878265,550066,2016-05-31,Senate,"Senate 3rd Reading SCR145 Gaines",38,0,2,0,40
878265,559441,2016-08-11,Assembly,"Be adopted, to Consent Calendar",9,0,0,2,11
878265,560227,2016-08-18,Assembly,"SCR 145 Gaines  Consent Calendar Second Day  Regular Session",78,0,0,2,80
879309,553419,2016-06-14,Assembly,"Be adopted as amended",8,0,0,1,9
879309,559458,2016-08-11,Senate,"Special Consent ACR188 Melendez",37,0,2,0,39
879642,553650,2016-06-16,Senate,"Senate 3rd Reading SCR146 McGuire",39,0,1,0,40
879642,555563,2016-06-27,Assembly,"Be adopted, to Consent Calendar",10,0,0,1,11
879642,556734,2016-06-30,Assembly,"SCR 146 McGuire  Consent Calendar Second Day  Regular Session",79,0,0,1,80
879804,552501,2016-06-13,Assembly,"From committee:  Be adopted.  To third reading",11,0,0,0,11
879804,559433,2016-08-11,Senate,"Special Consent ACR189 Patterson",37,0,2,0,39
879960,553742,2016-06-16,Assembly,"From committee:  Be adopted.  To third reading",10,0,0,1,11
879960,559510,2016-08-11,Senate,"Special Consent ACR190 Waldron By Nguyen",37,0,2,0,39
880149,554859,2016-06-20,Assembly,"Be adopted and re-referred to the Committee on Appropriations with 	recommendation:  To Consent Calendar",16,0,0,0,16
880149,556427,2016-06-29,Assembly,"Be adopted, to Consent Calendar",18,0,0,2,20
880149,558642,2016-08-01,Assembly,"ACR 191 GALLAGHER  Consent Calendar Second Day  Regular Session",76,0,0,4,80
880149,559203,2016-08-09,Senate,"Be adopted, but re-refer to the Committee on Appropriations 	Recommend Consent",11,0,0,0,11
880149,560091,2016-08-17,Senate,"Consent Calendar 2nd ACR191 Gallagher",39,0,0,0,39
880149,560825,2016-08-23,Assembly,"ACR 191 GALLAGHER  Concurrence in Senate Amendments",80,0,0,0,80
880153,551399,2016-06-06,Assembly,"From committee:  Be adopted.  To third reading",9,0,0,2,11
880153,556860,2016-06-30,Senate,"Special Consent # ACR192 Gordon By Mitchell",37,0,3,0,40
880364,553717,2016-06-16,Assembly,"From committee:  Be adopted.  To third reading",10,0,0,1,11
880368,553645,2016-06-16,Assembly,"From committee:  Be adopted.  To third reading",10,0,0,1,11
880368,559382,2016-08-11,Senate,"Special Consent ACR193 Calderon By Wieckowski",37,0,2,0,39
880468,554746,2016-06-21,Senate,"Be adopted, but re-refer to the Committee on Appropriations 	Recommend Consent",11,0,0,0,11
880468,559383,2016-08-11,Senate,"Consent Calendar 2nd SCR147 Anderson",37,0,2,0,39
880468,561504,2016-08-29,Assembly,"Be adopted, to Consent Calendar",15,0,0,1,16
880468,561842,2016-08-31,Assembly,"SCR 147 Anderson  Consent Calendar Second Day  Regular Session",79,0,0,1,80
880473,555629,2016-06-27,Assembly,"From committee:  Be adopted.  To third reading",14,0,0,2,16
880473,557019,2016-06-30,Assembly,"AJR 42 DODD  Assembly Third Reading",78,0,0,2,80
880473,559869,2016-08-15,Senate,"Assembly 3rd Reading AJR42 Dodd By Wolk",38,0,1,0,39
880473,560562,2016-08-22,Assembly,"AJR 42 DODD  Concurrence in Senate Amendments",77,0,0,3,80
880580,555268,2016-06-23,Senate,"Senate 3rd Reading SCR148 Bates",35,0,5,0,40
880580,558685,2016-08-01,Assembly,"Be adopted, to Consent Calendar",10,0,0,1,11
880580,559096,2016-08-04,Assembly,"SCR 148 Bates  Consent Calendar Second Day  Regular Session",77,0,0,3,80
880903,556897,2016-06-30,Assembly,"AJR 43 WILLIAMS  Assembly Third Reading",44,29,0,7,80
880903,559211,2016-08-10,Senate,"Be adopted",5,1,1,0,7
880903,559907,2016-06-27,Assembly,"From committee:  Be adopted.  To third reading",7,0,0,2,9
880903,560676,2016-08-23,Senate,"Assembly 3rd Reading AJR43 Williams By Jackson",23,15,1,0,39
881263,556945,2016-06-30,Senate,"Senate 3rd Reading SR79 Lara",29,1,10,0,40
881275,559146,2016-08-04,Assembly,"From committee:  Be adopted.  To third reading",9,0,0,2,11
881275,561172,2016-08-25,Senate,"Assembly 3rd Reading ACR194 Low By Hill",39,0,0,0,39
881284,553688,2016-06-16,Assembly,"From committee:  Be adopted.  To third reading",8,0,0,3,11
881387,554744,2016-06-21,Assembly,"From committee:  Be adopted.  To third reading",7,2,0,1,10
881387,555274,2016-06-23,Assembly,"AJR 45 CHIU  Assembly Third Reading",52,11,0,17,80
881387,559199,2016-08-09,Senate,"Be adopted",5,1,1,0,7
881387,560486,2016-08-22,Senate,"Assembly 3rd Reading AJR45 Chiu By Leno",29,5,5,0,39
881387,561022,2016-08-24,Assembly,"AJR 45 CHIU  Concurrence in Senate Amendments",55,11,0,14,80
881405,556380,2016-06-28,Senate,"Be adopted, but re-refer to the Committee on Appropriations 	Recommend Consent",10,0,1,0,11
881405,559380,2016-08-11,Senate,"Consent Calendar 2nd SCR149 Gaines",37,0,2,0,39
881405,561502,2016-08-29,Assembly,"Be adopted, to Consent Calendar",15,0,0,1,16
881405,561841,2016-08-31,Assembly,"SCR 149 Gaines  Consent Calendar Second Day  Regular Session",79,0,0,1,80
881413,555241,2016-06-23,Senate,"Senate 3rd Reading SR80 Pavley",36,0,4,0,40
881424,559466,2016-08-11,Senate,"Senate 3rd Reading SCR150 Gaines",36,0,3,0,39
881424,560397,2016-08-19,Assembly,"Be adopted, to Consent Calendar",8,0,0,3,11
881424,560849,2016-08-23,Assembly,"SCR 150 Gaines  Consent Calendar Second Day",80,0,0,0,80
881424,561027,2016-08-24,Senate,"Unfinished Business SCR150 Gaines Concurrence",39,0,0,0,39
881433,556135,2016-06-28,Assembly,"Be adopted, to Consent Calendar",7,0,0,0,7
881433,558644,2016-08-01,Assembly,"AJR 44 HOLDEN  Consent Calendar Second Day",76,0,0,4,80
881433,560225,2016-08-18,Senate,"Special Consent AJR44 Holden",36,0,3,0,39
881686,559310,2016-08-11,Senate,"Consent Calendar 2nd SCR152 Gaines",37,0,2,0,39
881686,561506,2016-08-29,Assembly,"Be adopted, to Consent Calendar",15,0,0,1,16
881686,561827,2016-08-31,Assembly,"SCR 152 Gaines  Consent Calendar Second Day  Regular Session",79,0,0,1,80
881686,561828,2016-08-31,Senate,"Unfinished Business (S upplemental File 3)SCR 152 Gai nes Con",39,0,0,0,39
881694,559413,2016-08-11,Senate,"Consent Calendar 2nd SCR151 Gaines",37,0,2,0,39
881694,561503,2016-08-29,Assembly,"Be adopted, as amended, to Consent Calendar",15,0,0,1,16
881694,561845,2016-08-31,Assembly,"SCR 151 Gaines  Consent Calendar First Day  Regular Session",79,0,0,1,80
881694,561846,2016-08-31,Senate,"Unfinished Business (S upplemental File 3)SCR 151 Gai nes Con",39,0,0,0,39
881851,555263,2016-06-23,Senate,"Senate 3rd Reading SCR153 Hueso",36,0,4,0,40
881851,558964,2016-08-02,Assembly,"From committee:  Be adopted.  To third reading",7,0,0,0,7
881851,561143,2016-08-25,Senate,"Special Consent SCR153 Hueso",39,0,0,0,39
881855,558855,2016-08-02,Assembly,"From committee:  Be adopted.  To third reading",7,0,0,0,7
881855,559113,2016-08-04,Assembly,"ACR 195 HOLDEN  Assembly Third Reading",77,0,0,3,80
881855,559114,2016-08-04,Senate,"W/O REF. TO FILE ACR195 Holden By De Le",37,0,2,0,39
881992,558694,2016-08-01,Assembly,"From committee:  Be adopted.  To third reading",10,0,0,1,11
881992,561076,2016-08-24,Senate,"Assembly 3rd Reading ACR196 Steinorth By Nguyen",39,0,0,0,39
882001,556931,2016-06-30,Senate,"Senate 3rd Reading SCR154 Liu",38,0,2,0,40
882001,559184,2016-08-08,Assembly,"Be adopted, to Consent Calendar",10,0,0,1,11
882001,559454,2016-08-11,Assembly,"SCR 154 Liu  Consent Calendar Second Day  Regular Session",78,0,0,2,80
882007,555330,2016-06-23,Senate,"Senate 3rd Reading SR81 Hall",35,0,5,0,40
882108,555627,2016-06-27,Assembly,"Be adopted and re-referred to the Committee on Appropriations with 	recommendation:  To Consent Calendar",15,0,0,1,16
882108,556296,2016-06-29,Assembly,"Be adopted, to Consent Calendar",18,0,0,2,20
882108,558677,2016-08-01,Assembly,"ACR 197 GATTO  Consent Calendar Second Day  Regular Session",76,0,0,4,80
882108,559202,2016-08-09,Senate,"Be adopted, but re-refer to the Committee on Appropriations 	Recommend Consent",11,0,0,0,11
882108,560051,2016-08-17,Senate,"Consent Calendar 2nd ACR197 Gatto",39,0,0,0,39
882108,560797,2016-08-23,Assembly,"ACR 197 GATTO  Concurrence in Senate Amendments",79,0,0,1,80
882242,555224,2016-06-23,Assembly,"From committee:  Be adopted.  To third reading",11,0,0,0,11
882312,556956,2016-06-30,Senate,"Senate 3rd Reading SCR156 Berryhill",37,0,3,0,40
882312,559502,2016-08-11,Assembly,"Be adopted, to Consent Calendar",9,0,0,2,11
882312,560140,2016-08-18,Assembly,"SCR 156 Berryhill, T.  Consent Calendar Second Day  Regular Session",78,0,0,2,80
882318,556382,2016-06-28,Assembly,"Be adopted, to Consent Calendar",18,0,0,0,18
882318,560156,2016-08-18,Senate,"Special Consent ACR198 Gordon",36,0,3,0,39
882512,556851,2016-06-30,Senate,"Senate 3rd Reading SCR157 Cannella",38,0,2,0,40
882512,559142,2016-08-04,Assembly,"Be adopted, to Consent Calendar",9,0,0,2,11
882512,559429,2016-08-11,Assembly,"SCR 157 Cannella  Consent Calendar Second Day  Regular Session",78,0,0,2,80
882514,559487,2016-08-11,Assembly,"From committee:  Be adopted.  To third reading",9,0,0,2,11
882514,561512,2016-08-29,Senate,"Assembly 3rd Reading ACR199 Bonta By Monning",38,0,1,0,39
882673,560295,2016-08-18,Assembly,"Be adopted as amended",5,0,0,4,9
882673,561239,2016-08-25,Assembly,"AJR 46 BONTA  Assembly Third Reading",59,1,0,20,80
882673,561674,2016-08-30,Senate,"Assembly 3rd Reading AJR46 Bonta By Hancock",27,2,10,0,39
883000,556780,2016-06-30,Assembly,"From committee:  Be adopted.  To third reading",7,1,0,3,11
883000,556781,2016-06-30,Assembly,"HR 56 SANTIAGO  Assembly Third Reading",60,12,0,8,80
883085,559181,2016-08-08,Assembly,"Be adopted, to Consent Calendar",10,0,0,1,11
883085,559437,2016-08-11,Assembly,"HR 57  Consent Calendar Second Day",78,0,0,2,80
883159,559369,2016-08-11,Senate,"Special Consent SR82 Huff",37,0,2,0,39
883165,559201,2016-08-09,Senate,"Be adopted, but re-refer to the Committee on Appropriations",9,2,2,0,13
883165,559663,2016-08-11,Senate,"Placed on Appropriations Suspense file",7,0,0,0,7
883165,559664,2016-08-11,Senate,"Be adopted",5,2,0,0,7
883165,560278,2016-08-18,Senate,"Senate 3rd Reading SCR158 Pan",24,12,3,0,39
883169,558623,2016-08-01,Assembly,"From committee:  Be adopted.  To third reading",10,0,0,1,11
883174,560899,2016-08-22,Assembly,"From committee:  Be adopted.  To third reading",6,0,0,1,7
884322,559439,2016-08-11,Senate,"Senate 3rd Reading SR83 Wolk",36,0,3,0,39
884323,559180,2016-08-08,Assembly,"From committee:  Be adopted.  To third reading",10,0,0,1,11
884324,559444,2016-08-11,Senate,"Senate 3rd Reading SCR160 McGuire",36,0,3,0,39
884324,560260,2016-08-18,Assembly,"Be adopted, to Consent Calendar",9,0,0,2,11
884324,560543,2016-08-22,Assembly,"SCR 160 McGuire  Consent Calendar Second Day  Regular Session",78,0,0,2,80
884325,559445,2016-08-11,Senate,"Senate 3rd Reading SCR159 Morrell",36,0,3,0,39
884325,560268,2016-08-18,Assembly,"Be adopted, to Consent Calendar",9,0,0,2,11
884325,560582,2016-08-22,Assembly,"SCR 159 Morrell  Consent Calendar Second Day  Regular Session",78,0,0,2,80
884358,559976,2016-08-16,Senate,"Senate 3rd Reading SCR161 De Le",38,0,1,0,39
884358,561483,2016-08-29,Assembly,"From committee:  Be adopted.  To third reading",9,0,0,0,9
884359,559966,2016-08-16,Senate,"Senate 3rd Reading SJR24 Beall",38,0,1,0,39
884359,561508,2016-08-29,Assembly,"From committee:  Be adopted.  To third reading",15,0,0,1,16
884359,561826,2016-08-31,Assembly,"SJR 24 Beall  Senate Third Reading  By FRAZIER",78,0,0,2,80
884360,559350,2016-08-11,Assembly,"From committee:  Be adopted.  To third reading",9,0,0,2,11
884387,559949,2016-08-16,Senate,"Senate 3rd Reading SCR163 Fuller",38,0,1,0,39
884387,560567,2016-08-22,Assembly,"Be adopted, to Consent Calendar",9,0,0,2,11
884387,560914,2016-08-24,Assembly,"SCR 163 Fuller  Consent Calendar Second Day  Regular Session",77,0,0,3,80
884388,560267,2016-08-18,Senate,"Senate 3rd Reading SCR162 Fuller",36,0,3,0,39
884388,561452,2016-08-29,Assembly,"Be adopted, to Consent Calendar",10,0,0,1,11
884388,561815,2016-08-31,Assembly,"SCR 162 Fuller  Consent Calendar Second Day  Regular Session",79,0,0,1,80
884390,559379,2016-08-11,Senate,"Senate 3rd Reading SCR164 Leyva",33,0,6,0,39
884390,560298,2016-08-18,Assembly,"Be adopted, to Consent Calendar",9,0,0,2,11
884390,560569,2016-08-22,Assembly,"SCR 164 Leyva  Consent Calendar Second Day  Regular Session",78,0,0,2,80
884391,559496,2016-08-11,Senate,"Senate 3rd Reading SJR26 De Le",34,0,5,0,39
884391,561640,2016-08-30,Assembly,"From committee:  Be adopted.  To third reading",13,0,0,5,18
884391,561816,2016-08-31,Assembly,"SJR 26 De Leon  Senate Third Reading  By GARCIA, E",67,1,0,12,80
884391,561817,2016-08-31,Senate,"Unfinished Business (S upplemental File 3)SJR 26 De Le",39,0,0,0,39
884392,559481,2016-08-11,Senate,"Senate 3rd Reading SJR25 Wieckowski",21,14,4,0,39
884392,560818,2016-08-23,Assembly,"From committee:  Be adopted.  To third reading",7,3,0,0,10
884396,560255,2016-08-18,Senate,"Senate 3rd Reading SR85 Nielsen",38,0,1,0,39
884427,560431,2016-08-19,Assembly,"From committee:  Be adopted.  To third reading",8,0,0,3,11
884427,561673,2016-08-30,Senate,"Assembly 3rd Reading ACR200 Lopez By Mendoza",39,0,0,0,39
884435,560181,2016-08-18,Assembly,"From committee:  Be adopted.  To third reading",9,0,0,2,11
884436,561307,2016-08-25,Assembly,"From committee:  Be adopted.  To third reading",6,0,0,1,7
884438,561377,2016-08-29,Assembly,"From committee:  Be adopted.  To third reading",7,0,0,4,11
884438,561775,2016-08-31,Senate,"Assembly 3rd Reading ( Supplemental File 1)AC R201 Go nzalez By",29,0,10,0,39
884439,560029,2016-08-17,Senate,"Senate 3rd Reading SR86 Beall",39,0,0,0,39
884542,560241,2016-08-18,Senate,"Senate 3rd Reading SR87 Beall",36,0,3,0,39
884573,560275,2016-08-18,Senate,"Senate 3rd Reading SCR165 Nguyen",35,0,4,0,39
884573,561675,2016-08-30,Assembly,"From committee:  Be adopted.  To third reading",10,0,0,1,11
884573,561820,2016-08-31,Senate,"Unfinished Business SCR165 Nguyen Concurrence",35,1,3,0,39
884648,561357,2016-08-29,Assembly,"From committee:  Be adopted.  To third reading",10,0,0,1,11
884648,561757,2016-08-31,Senate,"Assembly 3rd Reading ACR203 Chau By Pan",39,0,0,0,39
884677,561232,2016-08-25,Senate,"Senate 3rd Reading SJR28 Lara",31,2,6,0,39
884677,561793,2016-08-31,Assembly,"From committee:  Be adopted.  To third reading",8,0,0,2,10
884677,561794,2016-08-31,Assembly,"SJR 28 Lara  Senate Third Reading",58,8,0,14,80
884721,561664,2016-08-30,Assembly,"From committee:  Be adopted.  To third reading",10,0,0,1,11
884721,561708,2016-08-31,Senate,"Assembly 3rd Reading ( Supplemental File 1)AC R204 Qu irk By",39,0,0,0,39
884730,561684,2016-08-31,Senate,"Senate 3rd Reading SR88 Moorlach",39,0,0,0,39
884745,561527,2016-08-30,Senate,"Senate 3rd Reading (Su pplemental File 2)SJR2 9 Hern andez",39,0,0,0,39
884745,561781,2016-08-31,Assembly,"From committee:  Be adopted.  To third reading",14,0,0,4,18
884745,561782,2016-08-31,Assembly,"SJR 29 Hernandez  Senate Third Reading  By CHIU",60,0,0,20,80
