bill_id,roll_call_id,date,chamber,description,yea,nay,nv,absent,total
59869,5836,2009-03-18,Assembly,"Do pass",7,3,1,0,11
59869,5837,2009-04-13,Assembly,"AB1 MONNING  Assembly Third Reading",51,28,1,0,80
59869,5838,2009-06-17,Senate,"Do pass",8,1,0,0,9
59869,5839,2009-08-24,Senate,"Assembly 3rd Reading AB1 Monning By Hancock",26,13,1,0,40
59870,5826,2009-04-28,Assembly,"Do pass and be re-referred to the Committee on Appropriations",13,6,0,0,19
59870,5827,2009-05-28,Assembly,"Do pass as amended",12,5,0,0,17
59870,5828,2009-06-03,Assembly,"AB2 DE LA TORRE  Assembly Third Reading",45,26,9,0,80
59870,5829,2009-07-08,Senate,"Do pass, but re-refer to the Committee on Judiciary",6,4,1,0,11
59870,5830,2009-07-14,Senate,"Do pass as amended, and re-refer to the Committee on Appropriations",3,2,0,0,5
59870,5831,2009-08-17,Senate,"Placed on Appropriations Suspense file",13,0,0,0,13
59870,5832,2009-08-27,Senate,"Do pass",7,4,2,0,13
59870,5833,2009-09-08,Senate,"Assembly 3rd Reading AB2 De La Torre By Florez",24,13,3,0,40
59870,5834,2009-09-10,Assembly,"AB2 DE LA TORRE  Concurrence in Senate Amendments",49,26,5,0,80
59871,5817,2009-04-20,Assembly,"Be referred to Committee on Labor and Employment",10,0,1,0,11
59871,5818,2009-04-22,Assembly,"Do pass and be re-referred to the Committee on Appropriations",5,2,0,0,7
59871,5819,2009-05-28,Assembly,"Do pass as amended",12,0,5,0,17
59871,5820,2009-06-03,Assembly,"AB3 PEREZ, V.M.  Assembly Third Reading",52,25,3,0,80
59871,5821,2009-07-08,Senate,"Do pass, but re-refer to the Committee on Appropriations",4,2,0,0,6
59871,5822,2009-08-17,Senate,"Placed on Appropriations Suspense file",13,0,0,0,13
59871,5823,2009-08-27,Senate,"Do pass as amended",8,5,0,0,13
59871,5824,2009-09-09,Senate,"Assembly 3rd Reading AB3 V. Manuel Perez By Price",26,12,2,0,40
59871,5825,2009-09-10,Assembly,"AB3 PEREZ, V.M.  Concurrence in Senate Amendments",55,23,2,0,80
59873,25876,2009-03-03,Assembly,"Do pass, to Consent Calendar",10,0,0,0,10
59873,25877,2009-03-12,Assembly,"AB 5 EVANS  Consent Calendar Second Day",74,0,0,6,80
59873,25878,2009-06-09,Senate,"Do pass and be placed on the Consent Calendar",5,0,0,0,5
59873,25879,2009-06-15,Senate,"Consent Calendar 2nd AB5 Evans",36,0,4,0,40
59874,5812,2009-04-21,Assembly,"Do pass as amended and be re-referred to the Committee on Appropriations",5,2,0,0,7
59874,5813,2009-05-13,Assembly,"Do pass",11,5,0,0,16
59874,5814,2009-05-28,Assembly,"AB6 SALDANA  Assembly Third Reading",49,28,3,0,80
59874,5815,2009-07-07,Senate,"Do pass, but re-refer to the Committee on Appropriations",3,2,0,0,5
59874,5816,2009-08-31,Senate,"Assembly 3rd Reading AB6 Saldana By Corbett",21,15,4,0,40
59875,4043,2009-04-30,Assembly,"Do pass as amended and be re-referred to the Committee on Appropriations",6,0,1,0,7
59875,4044,2009-05-20,Assembly,"Do pass",12,2,2,0,16
59875,4045,2009-06-02,Assembly,"AB7 KREKORIAN  Assembly Third Reading",61,15,4,0,80
59875,4046,2009-07-07,Senate,"Do pass as amended, and re-refer to the Committee on Appropriations",3,2,0,0,5
59875,4047,2010-05-05,Senate,"Do pass as amended",5,1,2,0,8
59876,5804,2009-04-01,Assembly,"Do pass and re-refer to Committee on Appropriations with recommendation:  To Consent Calendar",11,0,0,0,11
59876,5805,2009-05-28,Assembly,"Do pass as amended",17,0,0,0,17
59876,5806,2009-06-02,Assembly,"AB8 BROWNLEY  Assembly Third Reading",78,0,2,0,80
59876,5807,2009-07-15,Senate,"Do pass as amended, and re-refer to the Committee on Appropriations",8,0,1,0,9
59876,5808,2009-08-17,Senate,"Placed on Appropriations Suspense file",13,0,0,0,13
59876,5809,2009-08-27,Senate,"Do pass",10,3,0,0,13
59876,5810,2009-09-09,Senate,"Assembly 3rd Reading AB8 Brownley By Hancock",31,6,3,0,40
59876,5811,2009-09-10,Assembly,"AB8 Brownley  Concurrence in Senate Amendments",79,0,1,0,80
59877,25322,2009-05-05,Assembly,"Do pass",6,0,0,1,7
59877,25323,2009-05-18,Assembly,"AB9 PEREZ, J.  Assembly Third Reading",72,3,0,5,80
59877,25324,2009-07-07,Senate,"Do pass, but re-refer to the Committee on Appropriations",5,0,0,0,5
59877,25325,2009-09-03,Senate,"Assembly 3rd Reading AB9 John A. Perez By DeSaulnier",38,0,2,0,40
59877,25326,2009-09-11,Assembly,"AB9 PEREZ, J.  Concurrence in Senate Amendments",78,1,0,0,79
59878,5802,2009-05-05,Assembly,"Do pass",2,3,2,0,7
59878,5803,2009-05-05,Assembly,"Set first hearing.  Failed passage.  Reconsideration granted",6,0,1,0,7
59879,25362,2009-04-13,Assembly,"Do pass as amended",8,0,0,1,9
59879,25363,2009-04-30,Assembly,"AB 11 DE LEON  Assembly Third Reading",75,0,0,5,80
59879,25364,2009-07-08,Senate,"Do pass as amended",6,0,2,0,8
59879,25365,2009-08-27,Senate,"Assembly 3rd Reading AB11 De Leon Urgency Clause",38,0,2,0,40
59879,25366,2009-08-31,Assembly,"AB 11 DE LEON  Concurrence in Senate Amendments",77,0,0,2,79
59880,2897,2009-04-14,Assembly,"Do pass and be re-referred to the Committee on Appropriations",5,0,2,0,7
59880,2898,2010-01-21,Assembly,"Do pass as amended",13,4,0,0,17
59880,2899,2010-01-27,Assembly,"AB 12 BEALL  Assembly Third Reading",72,0,6,0,78
59880,6121,2010-06-10,Senate,"Do pass, but re-refer to the Committee on Judiciary",3,0,1,0,4
59880,9283,2010-06-22,Senate,"Do pass as amended, and re-refer to the Committee on Appropriations",4,0,1,0,5
59880,19851,2010-08-09,Senate,"Placed on Appropriations Suspense file",10,0,1,0,11
59880,20039,2010-08-12,Senate,"Do pass as amended",11,0,0,0,11
59880,21818,2010-08-31,Senate,"W/O REF. TO FILE AB12 Beall By Liu",27,9,3,0,39
59880,21819,2010-08-31,Assembly,"AB 12 Beall  Concurrence in Senate Amendments",73,2,0,3,78
59881,5798,2009-04-14,Assembly,"Do pass and be re-referred to the Committee on Natural Resources",10,2,1,0,13
59881,5799,2009-04-20,Assembly,"Do pass as amended and be re-referred to the Committee on Appropriations",6,3,0,0,9
59881,5800,2009-05-28,Assembly,"Do pass",12,5,0,0,17
59881,5801,2009-06-03,Assembly,"AB 13 SALAS  Assembly Third Reading",50,26,4,0,80
59882,25377,2009-03-31,Assembly,"Do pass",7,0,0,0,7
59882,25378,2009-04-13,Assembly,"AB 14 FUENTES  Assembly Third Reading  Amend By FUENTES  Set #1",73,0,0,7,80
59882,25379,2009-04-20,Assembly,"AB 14 FUENTES  Assembly Third Reading",74,0,0,6,80
59882,25380,2009-06-09,Senate,"Do pass",7,0,0,0,7
59882,25381,2009-09-02,Senate,"Assembly 3rd Reading AB14 Fuentes By Padilla",31,2,7,0,40
59882,25382,2009-09-09,Assembly,"AB 14 FUENTES  Concurrence in Senate Amendments",77,0,0,2,79
59883,1642,2009-04-01,Assembly,"Amend, and do pass as amended and be re-referred to the Committee on Revenue and Taxation with the recommendation:  To Consent Calendar",7,0,0,0,7
59883,1643,2009-05-18,Assembly,"Do pass as amended and be re-referred to the Committee on Appropriations",9,0,0,0,9
59883,1644,2009-05-28,Assembly,"Do pass",17,0,0,0,17
59883,1645,2009-06-01,Assembly,"AB 15 FUENTES  Third Reading Urgency",79,0,1,0,80
59883,1646,2009-07-08,Senate,"Do pass, but re-refer to the Committee on Appropriations Recommend Consent",8,0,0,0,8
59883,1647,2009-08-17,Senate,"Placed on Appropriations Suspense file",13,0,0,0,13
59883,1648,2009-08-27,Senate,"Do pass as amended",9,3,1,0,13
59883,8773,2010-06-15,Senate,"Do pass",5,2,0,0,7
59883,21641,2010-08-24,Senate,"Assembly 3rd Reading AB15 Fuentes By Leno",21,13,5,0,39
59883,21642,2010-08-25,Assembly,"AB 15 FUENTES  Concurrence in Senate Amendments",57,17,0,4,78
59884,5797,2009-03-31,Assembly,"Do pass as amended and be re-referred to the Committee on Appropriations",7,0,0,0,7
59885,26321,2009-04-28,Assembly,"Do pass as amended and be re-referred to the Committee on 	Appropriations",7,0,0,0,7
59885,26322,2009-05-28,Assembly,"Do pass as amended",17,0,0,0,17
59885,26323,2009-06-03,Assembly,"AB 17 SWANSON  Third Reading Urgency",77,0,0,3,80
59885,26324,2009-07-14,Senate,"Do pass as amended, and re-refer to the Committee on 	Appropriations",6,0,1,0,7
59885,26325,2009-08-31,Senate,"Special Consent #17 AB17 Swanson",36,0,4,0,40
59885,26326,2009-09-02,Assembly,"AB 17 SWANSON  Concurrence in Senate Amendments",77,0,0,2,79
59886,5841,2009-03-31,Assembly,"Do pass and be re-referred to the Committee on Local Government",2,4,1,0,7
59886,5842,2009-04-21,Assembly,"Reconsideration granted",7,0,0,0,7
59886,5843,2009-05-05,Assembly,"Do pass and be re-referred to the Committee on Local Government to Consent Calendar",7,0,0,0,7
59886,5844,2009-05-13,Assembly,"Do pass, to Consent Calendar",7,0,0,0,7
59886,5845,2009-05-21,Assembly,"AB 18 KNIGHT  Consent Calendar Second Day  Regular Session",77,0,3,0,80
59886,5846,2009-06-17,Senate,"Do pass and be placed on the Consent Calendar",5,0,0,0,5
59886,5847,2009-06-24,Senate,"Consent Calendar 2nd AB18 Knight",40,0,0,0,40
59886,5848,2009-08-27,Senate,"Special Consent #16 AB18 Knight By Hollingsworth",38,0,2,0,40
59886,5849,2009-08-31,Assembly,"AB 18 KNIGHT  Concurrence in Senate Amendments",78,0,1,0,79
59887,5868,2009-04-13,Assembly,"Do pass as amended and be re-referred to the Committee on Appropriations",6,3,0,0,9
59887,5869,2009-05-28,Assembly,"Do pass",12,5,0,0,17
59887,5870,2009-06-02,Assembly,"AB 19 RUSKIN  Assembly Third Reading",47,32,1,0,80
59887,5871,2009-07-06,Senate,"Do pass, but re-refer to the Committee on Appropriations",5,2,0,0,7
59887,5872,2009-08-17,Senate,"Placed on Appropriations Suspense file",13,0,0,0,13
59888,26366,2009-03-03,Assembly,"Do pass as amended and be re-referred to the Committee on Business 	and Professions",9,0,0,0,9
59888,26367,2009-03-17,Assembly,"Do pass and be re-referred to the Committee on Appropriations",10,0,0,1,11
59888,26368,2009-04-01,Assembly,"Do pass, to Consent Calendar",16,0,0,1,17
59888,26369,2009-04-20,Assembly,"AB 20 SOLORIO  Assembly Third Reading",75,0,0,5,80
59888,26370,2009-06-10,Senate,"Do pass, but re-refer to the Committee on Judiciary",8,0,1,0,9
59888,26371,2009-06-23,Senate,"Do pass as amended, and re-refer to the Committee on 	Appropriations",5,0,0,0,5
59888,26372,2009-08-17,Senate,"Special Consent #14 AB20 Solorio",35,0,5,0,40
59888,26373,2009-08-20,Assembly,"AB 20 SOLORIO  Concurrence in Senate Amendments",78,0,0,1,79
59889,5862,2009-03-25,Assembly,"Do pass and be re-referred to the Committee on Environmental Safety and Toxic Materials",5,1,2,0,8
59889,5863,2009-04-14,Assembly,"Do pass and be re-referred to the Committee on Appropriations",5,0,2,0,7
59889,5864,2009-05-28,Assembly,"Do pass",12,5,0,0,17
59889,5865,2009-06-01,Assembly,"AB 21 LOWENTHAL  Assembly Third Reading",51,26,3,0,80
59889,5866,2009-09-12,Senate,"W/O REF. TO FILE AB21 Krekorian By Simitian",21,10,9,0,40
59889,5867,2009-09-12,Assembly,"AB 21 KREKORIAN  Concurrence in Senate Amendments",50,26,3,0,79
59890,26514,2009-03-31,Assembly,"Do pass as amended, to Consent Calendar",7,0,0,0,7
59890,26515,2009-04-20,Assembly,"AB 22 TORRES  Consent Calendar Second Day",75,0,0,5,80
59890,26516,2009-06-09,Senate,"Do pass as amended",7,0,0,0,7
59890,26517,2009-06-22,Senate,"Special Consent #9 AB22 Torres",40,0,0,0,40
59890,26518,2009-07-06,Assembly,"AB 22 TORRES  Concurrence in Senate Amendments",76,0,0,3,79
59891,26339,2009-03-24,Assembly,"Do pass and be re-referred to the Committee on Appropriations",19,0,0,0,19
59891,26340,2009-04-01,Assembly,"Do pass as amended",16,0,0,1,17
59891,26341,2009-04-02,Assembly,"AB 23 JONES  Third Reading Urgency",74,0,0,6,80
59891,26342,2009-04-15,Senate,"Do pass, but re-refer to the Committee on Appropriations",11,0,0,0,11
59891,26343,2009-05-06,Senate,"Assembly 3rd Reading AB23 Jones Urgency Clause",35,0,4,0,39
59891,26344,2009-05-11,Assembly,"AB 23 JONES  Concurrence in Senate Amendments",80,0,0,0,80
59892,5854,2009-03-17,Assembly,"Do pass and be re-referred to the Committee on Appropriations",9,0,0,0,9
59892,5855,2009-05-28,Assembly,"Do pass as amended",12,5,0,0,17
59892,5856,2009-06-02,Assembly,"AB 24 BLOCK  Assembly Third Reading",74,1,5,0,80
59892,5857,2009-07-15,Senate,"Do pass as amended, and re-refer to the Committee on Appropriations",5,0,4,0,9
59892,5858,2009-08-17,Senate,"Placed on Appropriations Suspense file",13,0,0,0,13
59892,5859,2009-08-27,Senate,"Do pass as amended",8,5,0,0,13
59892,5860,2009-09-03,Senate,"Assembly 3rd Reading AB24 Block By Ducheny",28,4,8,0,40
59892,5861,2009-09-09,Assembly,"AB 24 BLOCK  Concurrence in Senate Amendments",76,2,1,0,79
59893,5850,2010-01-12,Assembly,"Do pass and be re-referred to the Committee on Judiciary to Consent Calendar",7,0,0,0,7
59893,5851,2010-01-14,Assembly,"Do pass and be re-referred to the Committee on Appropriations",7,0,2,0,9
59893,5852,2010-01-21,Assembly,"Do pass, to Consent Calendar",17,0,0,0,17
59893,5853,2010-01-27,Assembly,"AB 25 GILMORE  Consent Calendar Second Day  Regular Session",68,0,10,0,78
59893,19085,2010-08-02,Senate,"Do pass as amended, and re-refer to the Committee on 	Appropriations",6,0,1,0,7
59893,19918,2010-08-12,Senate,"Assembly 3rd Reading AB25 Committee on E.S. & T.M.(Nava) Urgency 	Clause",32,0,6,0,38
59893,20966,2010-08-24,Assembly,"Senate amendments be concurred in",7,0,0,1,8
59893,21447,2010-08-26,Assembly,"AB 25 E.S.& T.M.  Concurrence- Urgency Added  By NAVA",77,0,0,1,78
59894,5873,2009-03-17,Assembly,"Do pass and be re-referred to the Committee on Appropriations",6,4,1,0,11
59895,25202,2009-03-17,Assembly,"Do pass and re-refer to Committee on Appropriations with 	recommendation:  To Consent Calendar",6,0,0,1,7
59895,25203,2009-05-28,Assembly,"Do pass",17,0,0,0,17
59895,25204,2009-06-01,Assembly,"AB 27 JEFFRIES  Assembly Third Reading",79,0,0,1,80
59895,25205,2009-06-23,Senate,"Do pass, but re-refer to the Committee on Appropriations",7,0,0,0,7
59895,25206,2009-07-09,Senate,"Special Consent #12 AB27 Jeffries",34,0,6,0,40
59896,5874,2009-05-04,Assembly,"Do pass and be re-referred to the Committee on Local Government",3,6,0,0,9
59896,5875,2009-05-04,Assembly,"Set first hearing.  Failed passage.  Reconsideration granted",9,0,0,0,9
59897,5876,2009-04-14,Assembly,"Do pass and be re-referred to the Committee on Appropriations",13,5,1,0,19
59898,25853,2009-03-31,Assembly,"Do pass and be re-referred to the Committee on Appropriations",5,2,0,0,7
59898,25854,2009-05-06,Assembly,"Do pass",11,5,0,0,16
59898,25855,2009-05-21,Assembly,"AB 30 PRICE  Assembly Third Reading",49,29,0,2,80
59898,25856,2009-07-07,Senate,"Do pass, but re-refer to the Committee on Appropriations",3,2,0,0,5
59898,25857,2009-08-17,Senate,"Placed on Appropriations Suspense file",13,0,0,0,13
59898,25858,2009-08-27,Senate,"Do pass as amended",8,5,0,0,13
59898,25859,2009-09-03,Senate,"Assembly 3rd Reading AB30 Price",22,15,3,0,40
59898,25860,2009-09-10,Assembly,"AB 30  Concurrence in Senate Amendments By CARTER",50,28,0,2,80
59899,25308,2009-03-31,Assembly,"Do pass and re-refer to Committee on Appropriations with 	recommendation:  To Consent Calendar",7,0,0,0,7
59899,25309,2009-05-28,Assembly,"Do pass",17,0,0,0,17
59899,25310,2009-06-01,Assembly,"AB 31 PRICE  Assembly Third Reading",79,0,0,1,80
59899,25311,2009-06-23,Senate,"Do pass, but re-refer to the Committee on Appropriations",10,0,3,0,13
59899,25312,2009-07-13,Senate,"Do pass as amended",12,0,1,0,13
59899,25313,2009-08-24,Senate,"Assembly 3rd Reading AB31 Price",36,0,4,0,40
59899,25314,2009-08-27,Assembly,"AB 31  Concurrence in Senate Amendments",76,0,0,3,79
59900,24032,2009-04-16,Assembly,"Be referred to Committee on Judiciary",10,0,0,1,11
59900,24033,2009-04-28,Assembly,"Do pass and re-refer to Committee on Appropriations with 	recommendation:  To Consent Calendar",7,0,0,0,7
59900,24034,2009-05-13,Assembly,"Do pass, to Consent Calendar",16,0,0,0,16
59900,24035,2009-05-21,Assembly,"AB 32 LIEU  Consent Calendar Second Day  Regular Session",77,0,0,3,80
59900,24036,2009-06-23,Senate,"Do pass, but re-refer to the Committee on Appropriations",5,0,0,0,5
59900,24037,2009-07-16,Senate,"Special Consent #13 AB32 Lieu",36,0,4,0,40
59900,24038,2009-08-17,Assembly,"AB 32 LIEU  Concurrence in Senate Amendments",76,0,0,3,79
59901,3646,2009-04-13,Assembly,"Do pass and be re-referred to the Committee on Business and Professions",11,0,0,0,11
59901,3647,2009-04-28,Assembly,"Do pass and be re-referred to the Committee on Appropriations",7,0,4,0,11
59901,3648,2009-05-28,Assembly,"Do pass",17,0,0,0,17
59901,3649,2009-06-01,Assembly,"AB 33 NAVA  Assembly Third Reading",77,0,3,0,80
59901,3650,2009-07-09,Senate,"Do pass as amended, and re-refer to the Committee on Business, Professions and Economic Development",10,0,2,0,12
59901,9841,2010-06-29,Senate,"Do pass as amended, and re-refer to the Committee on Appropriations",7,0,0,0,7
59901,19161,2010-08-02,Senate,"Placed on Appropriations Suspense file",10,0,1,0,11
59901,20021,2010-08-12,Senate,"Do pass",11,0,0,0,11
59901,21010,2010-08-24,Senate,"Assembly 3rd Reading AB33 Nava By Correa",35,0,4,0,39
59901,21361,2010-08-26,Assembly,"Senate amendments be concurred in",5,0,0,2,7
59901,21528,2010-08-27,Assembly,"AB 33 NAVA  Concurrence in Senate Amendments",75,0,0,3,78
59902,4243,2009-04-20,Assembly,"Do pass and be re-referred to the Committee on Business and Professions",10,1,0,0,11
59902,4244,2009-04-28,Assembly,"Do pass and be re-referred to the Committee on Appropriations",9,0,2,0,11
59902,4245,2009-05-28,Assembly,"Do pass as amended",13,4,0,0,17
59902,4246,2009-06-02,Assembly,"AB 34 NAVA  Assembly Third Reading",65,6,9,0,80
59902,4247,2009-07-09,Senate,"Do pass, but re-refer to the Committee on Business, Professions and Economic Development",10,0,2,0,12
59902,4248,2009-07-13,Senate,"Do pass, but re-refer to the Committee on Appropriations",8,1,1,0,10
59902,4249,2009-08-17,Senate,"Placed on Appropriations Suspense file",13,0,0,0,13
59902,4250,2009-08-27,Senate,"Do pass",13,0,0,0,13
59902,4251,2009-09-09,Senate,"Assembly 3rd Reading AB34 Nava Reconsider",40,0,0,0,40
59902,9168,2010-06-22,Senate,"Do pass, but re-refer to the Committee on Appropriations",7,0,0,0,7
59902,19178,2010-08-02,Senate,"Placed on Appropriations Suspense file",10,0,1,0,11
59902,19993,2010-08-12,Senate,"Do pass",11,0,0,0,11
59902,20961,2010-08-24,Senate,"Assembly 3rd Reading AB34 Nava By Correa",36,0,3,0,39
59902,21383,2010-08-26,Assembly,"Senate amendments be concurred in",5,0,0,2,7
59902,21530,2010-08-27,Assembly,"AB 34 NAVA  Concurrence in Senate Amendments",73,1,0,4,78
59903,3497,2010-01-05,Assembly,"Do pass and be re-referred to the Committee on Jobs, Economic Development and The Economy",7,0,1,0,8
59903,3498,2010-01-13,Assembly,"Do pass and be re-referred to the Committee on Appropriations",7,0,0,0,7
59903,3499,2010-01-21,Assembly,"Do pass",12,5,0,0,17
59903,3500,2010-01-27,Assembly,"AB 35 FURUTANI  Assembly Third Reading",52,17,9,0,78
59903,9341,2010-06-23,Senate,"Do pass as amended, and re-refer to the Committee on Appropriations",5,2,2,0,9
59903,19569,2010-08-02,Senate,"Placed on Appropriations Suspense file",10,0,1,0,11
59905,26757,2009-03-17,Assembly,"Do pass as amended and be re-referred to the Committee on 	Appropriations",9,0,0,0,9
59905,26758,2009-04-22,Assembly,"Do pass, to Consent Calendar",16,0,0,1,17
59905,26759,2009-05-04,Assembly,"AB 37 FURUTANI  Assembly Third Reading",80,0,0,0,80
59905,26760,2009-06-10,Senate,"Do pass, but re-refer to the Committee on Appropriations",8,0,1,0,9
59905,26761,2009-08-17,Senate,"Special Consent #14 AB37 Furutani",35,0,5,0,40
59905,26762,2009-08-20,Assembly,"AB 37 FURUTANI  Concurrence in Senate Amendments",77,0,0,2,79
59906,5877,2009-03-17,Assembly,"Do pass and be re-referred to the Committee on Veterans Affairs",9,0,0,0,9
59906,5878,2009-04-14,Assembly,"Do pass and be re-referred to the Committee on Appropriations",8,0,1,0,9
59907,5879,2009-04-14,Assembly,"Do pass and be re-referred to the Committee on Appropriations",9,1,3,0,13
59907,5880,2009-05-28,Assembly,"Do pass",12,5,0,0,17
59907,5881,2009-06-03,Assembly,"AB 39 HUFFMAN  Assembly Third Reading",46,28,6,0,80
59907,5882,2009-07-13,Senate,"Assembly 3rd Reading AB39 Huffman By Simitian",21,14,5,0,40
59907,5883,2009-07-16,Assembly,"AB 39 HUFFMAN  Concurrence in Senate Amendments",1,66,12,0,79
59908,5884,2009-04-20,Assembly,"Do pass and re-refer to Committee on Appropriations with recommendation:  To Consent Calendar",15,0,0,0,15
59908,5885,2009-05-28,Assembly,"Do pass",17,0,0,0,17
59908,5886,2009-06-01,Assembly,"AB 40 FUENTES  Assembly Third Reading",77,0,3,0,80
59909,4356,2010-01-06,Assembly,"Do pass as amended and be re-referred to the Committee on Appropriations",7,4,1,0,12
59909,4357,2010-01-06,Assembly,"Do pass as amended and be re-referred to the Committee on Appropriations",7,4,1,0,12
59909,4358,2010-01-21,Assembly,"Do pass as amended",12,5,0,0,17
59909,4359,2010-01-27,Assembly,"AB 41 SOLORIO  Assembly Third Reading",44,28,6,0,78
59909,9031,2010-06-16,Senate,"Do pass as amended, and re-refer to the Committee on Appropriations",7,2,2,0,11
59909,10889,2010-07-15,Senate,"Do pass",6,2,2,0,10
59909,20560,2010-08-19,Senate,"Assembly 3rd Reading AB41 Solorio By Price",23,12,3,0,38
59909,20880,2010-08-23,Assembly,"AB 41 SOLORIO  Concurrence in Senate Amendments",50,27,0,1,78
59910,5887,2009-03-23,Assembly,"Do pass as amended and be re-referred to the Committee on Natural Resources",13,0,2,0,15
59910,5888,2009-04-13,Assembly,"Do pass as amended and be re-referred to the Committee on Appropriations",7,0,2,0,9
59910,5889,2009-05-28,Assembly,"Do pass as amended",12,0,5,0,17
59910,5890,2009-06-03,Assembly,"AB 42 BLAKESLEE  Assembly Third Reading",75,0,5,0,80
59910,5891,2009-07-07,Senate,"Do pass, but re-refer to the Committee on Appropriations",11,0,0,0,11
59910,5892,2009-08-24,Senate,"Special Consent #15 AB42 Blakeslee",39,0,1,0,40
59910,5893,2009-08-31,Assembly,"AB 42 BLAKESLEE  Concurrence in Senate Amendments",74,0,5,0,79
59911,5895,2009-04-22,Assembly,"Do pass as amended and be re-referred to the Committee on Appropriations",10,0,0,0,10
59911,5896,2009-05-13,Assembly,"Do pass",16,0,0,0,16
59911,5897,2009-05-28,Assembly,"AB 43 BLAKESLEE  Assembly Third Reading",78,0,2,0,80
59911,5898,2009-06-22,Senate,"Do pass as amended, and re-refer to the Committee on Appropriations",8,3,1,0,12
59911,5899,2009-09-03,Senate,"Assembly 3rd Reading AB43 Blakeslee By Alquist",30,6,4,0,40
59911,5900,2009-09-09,Assembly,"AB 43 BLAKESLEE  Concurrence in Senate Amendments",76,0,3,0,79
59912,228,2009-03-23,Assembly,"Do pass as amended and be re-referred to the Committee on Appropriations.",14,0,1,0,15
59912,229,2009-05-28,Assembly,"Do pass as amended.",17,0,0,0,17
59912,230,2009-06-02,Assembly,"AB 44 BLAKESLEE  Assembly Third Reading",77,0,3,0,80
59912,10193,2010-06-30,Senate,"Do pass as amended",3,2,0,0,5
59912,21425,2010-08-26,Senate,"Assembly 3rd Reading AB44 Blakeslee",27,4,8,0,39
59912,21729,2010-08-30,Assembly,"Senate amendments be concurred in",8,0,0,1,9
59912,21730,2010-08-30,Assembly,"AB 44 Blakeslee  Concurrence in Senate Amendments By Smyth",73,3,0,2,78
59913,25026,2009-05-13,Assembly,"Do pass",6,0,0,1,7
59913,25027,2009-05-28,Assembly,"AB 45 BLAKESLEE  Assembly Third Reading",78,0,0,2,80
59913,25028,2009-06-17,Senate,"Do pass as amended, and re-refer to the Committee on Environmental 	Quality",4,1,0,0,5
59913,25029,2009-07-06,Senate,"Do pass as amended, and re-refer to the Committee on 	Appropriations",4,2,1,0,7
59913,25030,2009-08-17,Senate,"Do pass",9,3,1,0,13
59913,25031,2009-09-04,Senate,"Assembly 3rd Reading AB45 Blakeslee By Simitian",30,7,3,0,40
59913,25032,2009-09-09,Assembly,"AB 45 BLAKESLEE  Concurrence in Senate Amendments",78,0,0,1,79
59914,9,2009-03-23,Assembly,"Do pass as amended and be re-referred to the Committee on Appropriations.",14,0,1,0,15
59914,10,2009-05-28,Assembly,"Do pass.",17,0,0,0,17
59914,11,2009-06-01,Assembly,"AB 46 BLAKESLEE  Assembly Third Reading",76,0,4,0,80
59914,12,2009-07-07,Senate,"Do pass as amended, and re-refer to the Committee on Appropriations.",11,0,0,0,11
59914,13,2009-08-17,Senate,"Placed on Appropriations Suspense file.",13,0,0,0,13
59914,14,2009-08-27,Senate,"Do pass as amended.",13,0,0,0,13
59914,8978,2010-06-17,Senate,"Do pass",4,0,1,0,5
59914,8979,2010-06-17,Senate,"W/O REF. TO FILE AB46 Monning Urgency Clause",33,0,6,0,39
59914,9107,2010-06-21,Assembly,"Senate amendments be concurred in",7,0,0,0,7
59914,9108,2010-06-21,Assembly,"AB 46 MONNING  Concurrence- Urgency Added",75,0,4,0,79
59915,5894,2009-04-13,Assembly,"Do pass as amended and be re-referred to the Committee on Appropriations",8,0,1,0,9
59916,24019,2009-03-31,Assembly,"Do pass as amended and be re-referred to the Committee on Business 	and Professions",8,0,0,1,9
59916,24020,2009-04-21,Assembly,"Do pass and be re-referred to the Committee on Appropriations",10,0,0,1,11
59916,24021,2009-05-28,Assembly,"Do pass as amended",12,0,0,5,17
59916,24022,2009-06-02,Assembly,"AB 48 PORTANTINO  Assembly Third Reading",70,4,0,6,80
59916,24023,2009-07-06,Senate,"Do pass as amended, and re-refer to the Committee on Education",6,1,3,0,10
59916,24024,2009-07-15,Senate,"Do pass as amended, and re-refer to the Committee on Appropriations",7,0,2,0,9
59916,24025,2009-08-17,Senate,"Placed on Appropriations Suspense file",13,0,0,0,13
59916,24026,2009-08-27,Senate,"Do pass as amended",12,1,0,0,13
59916,24027,2009-08-27,Senate,"Reconsideration granted",12,0,1,0,13
59916,24028,2009-08-27,Senate,"Do pass as amended",12,1,0,0,13
59916,24029,2009-09-09,Senate,"Assembly 3rd Reading AB48 Portantino Reconsider",40,0,0,0,40
59916,24030,2009-09-11,Senate,"Assembly 3rd Reading AB48 Portantino By Negrete McLeod",26,10,4,0,40
59916,24031,2009-09-12,Assembly,"AB 48 PORTANTINO  Concurrence in Senate Amendments",44,17,0,18,79
59917,5905,2009-04-14,Assembly,"Do pass and be re-referred to the Committee on Appropriations",7,4,2,0,13
59917,5906,2009-05-28,Assembly,"Do pass as amended",12,5,0,0,17
59917,5907,2009-06-03,Assembly,"AB 49 FEUER  Assembly Third Reading",43,30,7,0,80
59917,5908,2009-07-06,Senate,"Do pass, but re-refer to the Committee on Appropriations",7,3,1,0,11
59917,5909,2009-07-13,Senate,"Assembly 3rd Reading AB49 Feuer By Pavley",21,13,6,0,40
59917,5910,2009-07-16,Assembly,"AB 49 FEUER  Concurrence in Senate Amendments",1,66,12,0,79
59918,5186,2009-04-01,Assembly,"Do pass as amended and be re-referred to the Committee on Revenue and Taxation",7,0,0,0,7
59918,5187,2009-05-18,Assembly,"Do pass and be re-referred to the Committee on Appropriations",9,0,0,0,9
59918,5188,2009-05-28,Assembly,"Do pass as amended",17,0,0,0,17
59918,5189,2009-06-02,Assembly,"AB 50 NAVA  Third Reading Urgency",78,0,2,0,80
59918,5190,2009-06-23,Senate,"Do pass as amended, and re-refer to the Committee on Revenue and Taxation",10,0,3,0,13
59918,5191,2009-07-08,Senate,"Do pass, but re-refer to the Committee on Appropriations Recommend Consent",8,0,0,0,8
59918,5192,2009-07-23,Senate,"Placed on Appropriations Suspense file",13,0,0,0,13
59918,5193,2009-08-27,Senate,"Do pass as amended",8,5,0,0,13
59918,5194,2009-09-09,Senate,"Assembly 3rd Reading AB50 Nava Reconsider",40,0,0,0,40
59918,21907,2010-08-30,Senate,"Assembly 3rd Reading AB50 Nava Urgency Clause",23,12,4,0,39
59919,3516,2009-04-27,Assembly,"Do pass as amended and be re-referred to the Committee on Appropriations",13,0,2,0,15
59919,3517,2009-05-28,Assembly,"Do pass as amended",15,0,2,0,17
59919,3518,2009-06-02,Assembly,"AB 51 BLAKESLEE  Assembly Third Reading",65,2,13,0,80
59919,10366,2010-06-29,Senate,"Do pass, but re-refer to the Committee on Appropriations",6,0,5,0,11
59919,19232,2010-08-02,Senate,"Placed on Appropriations Suspense file",10,0,1,0,11
59920,5902,2009-03-24,Assembly,"Do pass as amended and be re-referred to the Committee on Appropriations",14,2,3,0,19
59920,5903,2009-05-28,Assembly,"Do pass as amended",13,2,2,0,17
59920,5904,2009-06-02,Assembly,"AB 52 PORTANTINO  Third Reading Urgency",68,8,4,0,80
59920,19337,2010-08-04,Senate,"Do pass as amended, and re-refer to the Committee on Appropriations",3,1,4,0,8
59920,19338,2010-08-04,Senate,"Set, final hearing.  Failed passage in Committee.  Reconsideration 	granted",6,0,2,0,8
59920,19808,2010-08-11,Senate,"Do pass, but re-refer to the Committee on Appropriations",5,3,0,0,8
59920,19996,2010-08-12,Senate,"Placed on Appropriations Suspense file",11,0,0,0,11
59920,21893,2010-08-31,Senate,"W/O REF. TO FILE AB52 Portantino Urgency Clause",34,2,3,0,39
59920,21894,2010-08-31,Assembly,"AB 52 Portantino  Concurrence- Urgency Added",76,0,0,2,78
59921,5901,2009-04-01,Assembly,"Do pass as amended and be re-referred to the Committee on Appropriations",6,0,0,0,6
59924,5912,2009-03-31,Assembly,"Do pass as amended and be re-referred to the Committee on Appropriations",13,6,0,0,19
59924,5913,2009-05-28,Assembly,"Do pass as amended",12,5,0,0,17
59924,5914,2009-06-03,Assembly,"AB 56 PORTANTINO  Assembly Third Reading",50,26,4,0,80
59924,5915,2009-07-15,Senate,"Do pass, but re-refer to the Committee on Appropriations",7,2,2,0,11
59924,5916,2009-08-17,Senate,"Placed on Appropriations Suspense file",13,0,0,0,13
59924,5917,2009-08-27,Senate,"Do pass as amended",8,5,0,0,13
59924,5918,2009-09-02,Senate,"Assembly 3rd Reading AB56 Portantino",24,13,3,0,40
59924,5919,2009-09-08,Assembly,"AB 56 PORTANTINO  Concurrence in Senate Amendments",50,28,1,0,79
59925,5920,2009-04-14,Assembly,"Do pass and be re-referred to the Committee on Higher Education",13,6,0,0,19
59925,5921,2009-04-21,Assembly,"Do pass and be re-referred to the Committee on Appropriations",6,3,0,0,9
59925,5922,2009-05-06,Assembly,"Do pass",10,5,1,0,16
59925,5923,2009-05-21,Assembly,"AB 57 PRICE  Assembly Third Reading",48,31,1,0,80
59925,5924,2009-06-25,Senate,"Do pass, but re-refer to the Committee on Appropriations",7,4,0,0,11
59925,5925,2009-09-01,Senate,"Assembly 3rd Reading AB57 Price",22,14,4,0,40
59926,24107,2009-04-01,Assembly,"Do pass and be re-referred to the Committee on Public Safety",18,1,0,0,19
59926,24108,2009-04-21,Assembly,"Do pass and be re-referred to the Committee on Appropriations",7,0,0,0,7
59926,24109,2009-05-06,Assembly,"Do pass",16,0,0,0,16
59926,24110,2009-05-14,Assembly,"AB 58 JEFFRIES  Assembly Third Reading",71,1,0,8,80
59926,24111,2009-06-09,Senate,"Do pass, but re-refer to the Committee on Appropriations",7,0,0,0,7
59926,24112,2009-06-29,Senate,"Special Consent #11 AB58 Jeffries",40,0,0,0,40
59927,25233,2009-04-22,Assembly,"Do pass and be re-referred to the Committee on Appropriations",13,3,0,3,19
59927,25234,2009-05-06,Assembly,"Do pass as amended",14,2,0,0,16
59927,25235,2009-05-18,Assembly,"AB 59 JEFFRIES  Assembly Third Reading",75,1,0,4,80
59927,25236,2009-06-23,Senate,"Do pass, but re-refer to the Committee on Appropriations",11,0,2,0,13
59927,25237,2009-08-27,Senate,"Assembly 3rd Reading AB59 Jeffries By Denham",38,0,2,0,40
59927,25238,2009-09-01,Assembly,"AB 59 JEFFRIES  Concurrence in Senate Amendments",77,0,0,2,79
59928,5926,2009-04-01,Assembly,"Do pass as amended and re-refer to Committee on Appropriations with recommendation:  To Consent Calendar",11,0,0,0,11
59929,5927,2009-03-31,Assembly,"Do pass and be re-referred to the Committee on Appropriations",7,0,0,0,7
59929,5928,2009-05-28,Assembly,"Do pass",17,0,0,0,17
59929,5929,2009-06-01,Assembly,"AB 61 NAVA  Assembly Third Reading",79,0,1,0,80
59929,5930,2009-06-23,Senate,"Do pass, but re-refer to the Committee on Appropriations",2,3,2,0,7
59929,5931,2009-06-23,Senate,"Set, first hearing.  Failed passage in Committee.  Reconsideration granted",6,0,1,0,7
59930,24103,2009-04-20,Assembly,"Do pass, to Consent Calendar",12,0,0,2,14
59930,24104,2009-04-27,Assembly,"AB 62 PORTANTINO  Consent Calendar Second Day  Regular Session",77,0,0,3,80
59930,24105,2009-06-09,Senate,"Do pass",7,0,4,0,11
59930,24106,2009-06-22,Senate,"Special Consent #9 AB62 Portantino",40,0,0,0,40
59931,25722,2009-03-17,Assembly,"Do pass",6,4,0,1,11
59931,25723,2009-03-23,Assembly,"AB 63 MENDOZA  Assembly Third Reading",50,28,0,2,80
59931,25724,2009-06-09,Senate,"Do pass",3,2,0,0,5
59931,25725,2009-06-22,Senate,"Assembly 3rd Reading AB63 Mendoza By Corbett",28,11,1,0,40
59932,5932,2009-04-01,Assembly,"Do pass and be re-referred to the Committee on Natural Resources",8,5,2,0,15
59932,5933,2009-04-29,Assembly,"Do pass as amended and be re-referred to the Committee on Appropriations",6,3,0,0,9
59932,5934,2009-05-28,Assembly,"Do pass",12,5,0,0,17
59932,5935,2009-06-03,Assembly,"AB 64 KREKORIAN  Assembly Third Reading",44,31,5,0,80
59932,5936,2009-07-07,Senate,"Do pass, but re-refer to the Committee on Rules",6,5,0,0,11
59932,5937,2009-08-17,Senate,"Placed on Appropriations Suspense file",13,0,0,0,13
59932,5938,2009-08-27,Senate,"Do pass",8,5,0,0,13
59932,5939,2009-09-10,Senate,"Do pass as amended",6,3,2,0,11
59932,5940,2009-09-11,Senate,"Assembly 3rd Reading AB64 Krekorian By Simitian",23,14,3,0,40
59932,5941,2009-09-12,Assembly,"AB 64 KREKORIAN  Concurrence in Senate Amendments",50,28,1,0,79
59933,24093,2009-04-01,Assembly,"Do pass and be re-referred to the Committee on Appropriations",5,1,0,0,6
59933,24094,2009-05-28,Assembly,"Do pass as amended",12,5,0,0,17
59933,24095,2009-06-03,Assembly,"AB 65 HAYASHI  Assembly Third Reading",51,24,0,5,80
59933,24096,2009-06-22,Senate,"Do pass, but re-refer to the Committee on Appropriations",4,2,1,0,7
59933,24097,2009-07-06,Senate,"Placed on Appropriations Suspense file",11,0,2,0,13
59933,24098,2009-08-27,Senate,"Do pass",8,5,0,0,13
59933,24099,2009-08-27,Senate,"Reconsideration granted",13,0,0,0,13
59933,24100,2009-08-27,Senate,"Do pass",8,5,0,0,13
59933,24101,2009-09-02,Senate,"Assembly 3rd Reading AB65 Hayashi By Correa",22,15,3,0,40
59933,24102,2009-09-08,Assembly,"AB 65 HAYASHI  Concurrence in Senate Amendments",49,26,0,4,79
59934,24089,2009-03-18,Assembly,"Do pass",9,1,0,1,11
59934,24090,2009-03-26,Assembly,"AB 66 ANDERSON  Assembly Third Reading",72,0,0,8,80
59934,24091,2009-06-17,Senate,"Do pass",9,0,0,0,9
59934,24092,2009-09-01,Senate,"Assembly 3rd Reading AB66 Anderson By Wyland",35,0,5,0,40
59935,5942,2009-04-27,Assembly,"Be referred to Committee on Elections and Redistricting",10,0,1,0,11
59935,5943,2009-04-30,Assembly,"Do pass and be re-referred to the Committee on Judiciary",5,0,2,0,7
59936,5944,2009-04-13,Assembly,"Do pass as amended and be re-referred to the Committee on Appropriations",6,3,0,0,9
59938,5945,2009-03-18,Assembly,"Do pass and re-refer to Committee on Appropriations with recommendation:  To Consent Calendar",10,0,1,0,11
59938,5946,2009-04-01,Assembly,"Do pass",16,0,1,0,17
59938,5947,2009-04-13,Assembly,"AB 70 DUVALL  Assembly Third Reading",78,1,1,0,80
59938,19769,2010-08-11,Senate,"Do pass, but re-refer to the Committee on Appropriations",3,5,1,0,9
59940,5955,2009-04-22,Assembly,"Do pass and be re-referred to the Committee on Appropriations",3,7,1,0,11
59940,5956,2009-04-22,Assembly,"Set first hearing.  Failed passage.  Reconsideration granted",10,0,1,0,11
59941,24083,2009-03-17,Assembly,"Do pass",7,3,0,0,10
59941,24084,2009-04-02,Assembly,"AB 73 HAYASHI  Assembly Third Reading",44,29,0,7,80
59941,24085,2009-05-20,Senate,"Do pass, but re-refer to the Committee on Judiciary",3,2,0,0,5
59941,24086,2009-06-16,Senate,"Do pass",3,2,0,0,5
59941,24087,2009-09-01,Senate,"Assembly 3rd Reading AB73 Hayashi By Hancock",21,17,2,0,40
59941,24088,2009-09-03,Assembly,"AB 73 HAYASHI  Concurrence in Senate Amendments",47,29,0,3,79
59942,24076,2009-04-28,Assembly,"Do pass and be re-referred to the Committee on Appropriations",13,0,0,0,13
59942,24077,2009-05-28,Assembly,"Do pass",17,0,0,0,17
59942,24078,2009-06-01,Assembly,"AB 74 CHESBRO  Assembly Third Reading",77,0,0,3,80
59942,24079,2009-06-23,Senate,"Do pass, but re-refer to the Committee on Appropriations Recommend 	Consent",11,0,0,0,11
59942,24080,2009-06-29,Senate,"Placed on Appropriations Suspense file",13,0,0,0,13
59942,24081,2009-08-27,Senate,"Do pass",13,0,0,0,13
59942,24082,2009-09-04,Senate,"Special Consent #19 AB74 Chesbro",40,0,0,0,40
59943,5951,2009-03-24,Assembly,"Do pass as amended and re-refer to Committee on Appropriations with recommendation:  To Consent Calendar",18,0,1,0,19
59943,5952,2009-05-28,Assembly,"Do pass",17,0,0,0,17
59943,5953,2009-06-01,Assembly,"AB 75 HUFFMAN  Third Reading Urgency",79,0,1,0,80
59943,5954,2009-07-08,Senate,"Do pass, but re-refer to the Committee on Appropriations Recommend Consent",11,0,0,0,11
59944,25639,2009-04-01,Assembly,"Do pass and be re-referred to the Committee on Appropriations",10,0,0,0,10
59944,25640,2009-05-28,Assembly,"Do pass",17,0,0,0,17
59944,25641,2009-06-01,Assembly,"AB 76 YAMADA  Assembly Third Reading",77,0,0,3,80
59944,25642,2009-06-22,Senate,"Do pass, but re-refer to the Committee on Appropriations",11,0,1,0,12
59944,25643,2009-06-29,Senate,"Do pass",11,0,2,0,13
59944,25644,2009-07-16,Senate,"Assembly 3rd Reading AB76 Yamada By Alquist",31,3,6,0,40
59946,5949,2009-03-03,Assembly,"Do pass and be re-referred to the Committee on Education",9,0,0,0,9
59946,5950,2009-04-15,Assembly,"Do pass as amended and be re-referred to the Committee on Appropriations",10,0,1,0,11
59947,5957,2009-04-01,Assembly,"Amend, and do pass as amended and be re-referred to the Committee on Revenue and Taxation with the recommendation:  To Consent Calendar",7,0,0,0,7
59947,5958,2009-05-18,Assembly,"Do pass as amended and be re-referred to the Committee on Appropriations",9,0,0,0,9
59947,5959,2009-05-28,Assembly,"Do pass",17,0,0,0,17
59947,5960,2009-06-01,Assembly,"AB 79 DUVALL  Third Reading Urgency",79,0,1,0,80
59947,5961,2009-07-08,Senate,"Do pass, but re-refer to the Committee on Appropriations Recommend Consent",8,0,0,0,8
59947,5962,2009-07-23,Senate,"Placed on Appropriations Suspense file",13,0,0,0,13
59948,5963,2009-03-24,Assembly,"Do pass, to Consent Calendar",11,0,2,0,13
59948,5964,2009-04-02,Assembly,"AB 80 BLAKESLEE  Consent Calendar Second Day",75,0,5,0,80
59948,5965,2009-07-06,Senate,"Do pass as amended, and re-refer to the Committee on Appropriations",5,0,2,0,7
59948,5966,2009-08-27,Senate,"Special Consent #16 AB80 Blakeslee",38,0,2,0,40
59949,24072,2009-04-01,Assembly,"Do pass as amended and re-refer to Committee on Appropriations 	with recommendation:  To Consent Calendar",11,0,0,0,11
59949,24073,2009-04-30,Assembly,"AB 81 STRICKLAND  Assembly Third Reading",76,0,0,4,80
59949,24074,2009-06-17,Senate,"Do pass and be placed on the Consent Calendar",9,0,0,0,9
59949,24075,2009-06-24,Senate,"Consent Calendar 2nd AB81 Audra Strickland",40,0,0,0,40
59950,5967,2009-03-24,Assembly,"Do pass and be re-referred to the Committee on Judiciary",7,0,0,0,7
59950,5968,2009-03-31,Assembly,"Do pass and be re-referred to the Committee on Appropriations",10,0,0,0,10
59950,5969,2009-05-28,Assembly,"Do pass as amended",17,0,0,0,17
59950,5970,2009-06-02,Assembly,"AB 82 EVANS  Assembly Third Reading",78,0,2,0,80
59950,5971,2009-06-23,Senate,"Do pass, but re-refer to the Committee on Judiciary",4,0,0,0,4
59950,5972,2009-07-14,Senate,"Do pass, but re-refer to the Committee on Appropriations",5,0,0,0,5
59950,5973,2009-08-17,Senate,"Placed on Appropriations Suspense file",13,0,0,0,13
59950,5974,2009-08-27,Senate,"Do pass",13,0,0,0,13
59950,5975,2009-09-09,Senate,"Assembly 3rd Reading AB82 Evans By Alquist",37,0,3,0,40
59950,5976,2009-09-10,Assembly,"AB 82 Evans  Concurrence in Senate Amendments",79,0,1,0,80
59951,25343,2009-03-03,Assembly,"Do pass as amended",10,0,0,0,10
59951,25344,2009-03-12,Assembly,"AB 83 FEUER  Third Reading Urgency",75,0,0,5,80
59951,25345,2009-06-09,Senate,"Do pass as amended",5,0,0,0,5
59951,25346,2009-06-22,Senate,"Special Consent #9 AB83 Feuer By Benoit",40,0,0,0,40
59951,25347,2009-06-25,Assembly,"AB 83 FEUER  Concurrence in Senate Amendments",75,0,0,4,79
59952,5977,2009-03-31,Assembly,"Do pass and be re-referred to the Committee on Appropriations",7,0,0,0,7
59952,5978,2009-04-22,Assembly,"Do pass",12,4,1,0,17
59952,5979,2009-04-30,Assembly,"AB 84 HILL  Assembly Third Reading",70,0,10,0,80
59952,5980,2009-06-16,Senate,"Do pass, but re-refer to the Committee on Appropriations",4,1,0,0,5
59952,5981,2009-06-29,Senate,"Do pass",7,5,1,0,13
59952,5982,2009-08-24,Senate,"Assembly 3rd Reading AB84 Hill By Hancock",26,13,1,0,40
59952,5983,2009-08-27,Assembly,"AB 84 HILL  Concurrence in Senate Amendments",74,0,5,0,79
59953,24066,2009-04-21,Assembly,"Do pass and be re-referred to the Committee on Judiciary to Consent 	Calendar",10,0,0,1,11
59953,24067,2009-05-12,Assembly,"Do pass, to Consent Calendar",10,0,0,0,10
59953,24068,2009-05-18,Assembly,"AB 85 BERRYHILL, T.  Consent Calendar Second Day  Regular Session",77,0,0,3,80
59953,24069,2009-06-22,Senate,"Do pass as amended",10,0,0,0,10
59953,24070,2009-07-09,Senate,"Special Consent #12 AB85 Tom Berryhill",34,0,6,0,40
59953,24071,2009-07-13,Assembly,"AB 85 BERRYHILL, T.  Concurrence in Senate Amendments",75,0,0,4,79
59954,24159,2009-04-01,Assembly,"Do pass and be re-referred to the Committee on Appropriations",6,0,0,0,6
59954,24160,2009-04-22,Assembly,"Do pass, to Consent Calendar",16,0,0,1,17
59954,24161,2009-05-04,Assembly,"AB 86 NAVA  Assembly Third Reading",79,0,0,1,80
59954,24162,2009-06-08,Senate,"Do pass, but re-refer to the Committee on Appropriations",4,1,2,0,7
59954,24163,2009-07-06,Senate,"Do pass",9,1,3,0,13
59954,24164,2009-07-16,Senate,"Assembly 3rd Reading AB86 Nava By Negrete McLeod",27,6,7,0,40
59955,5990,2009-04-13,Assembly,"Do pass as amended and be re-referred to the Committee on Appropriations",6,3,0,0,9
59956,5984,2009-04-22,Assembly,"Do pass and be re-referred to the Committee on Appropriations",4,2,0,0,6
59956,5985,2009-05-28,Assembly,"Do pass as amended",12,0,5,0,17
59956,5986,2009-06-03,Assembly,"AB 88 DAVIS  Assembly Third Reading",48,29,3,0,80
59956,5987,2009-08-24,Senate,"Do pass, but re-refer to the Committee on Appropriations",5,2,0,0,7
59956,5988,2009-08-27,Senate,"Placed on Appropriations Suspense file",13,0,0,0,13
59956,5989,2009-09-12,Senate,"Assembly 3rd Reading AB88 Committee on P.E.,R.& S.S.(Hernan Reconsider",39,0,1,0,40
59959,24150,2009-04-14,Assembly,"Do pass as amended and be re-referred to the Committee on 	Transportation",6,0,0,1,7
59959,24151,2009-04-27,Assembly,"Do pass as amended and be re-referred to the Committee on 	Appropriations",12,0,0,2,14
59959,24152,2009-05-28,Assembly,"Do pass as amended",13,0,0,4,17
59959,24153,2009-06-02,Assembly,"AB 91 FEUER  Assembly Third Reading",77,0,0,3,80
59959,24154,2009-07-07,Senate,"Do pass as amended, and re-refer to the Committee on Appropriations",5,1,1,0,7
59959,24155,2009-08-17,Senate,"Placed on Appropriations Suspense file",13,0,0,0,13
59959,24156,2009-08-27,Senate,"Do pass",13,0,0,0,13
59959,24157,2009-09-03,Senate,"Assembly 3rd Reading AB91 Feuer By Padilla",31,4,5,0,40
59959,24158,2009-09-09,Assembly,"AB 91 FEUER  Concurrence in Senate Amendments",78,0,0,1,79
59960,24146,2009-05-20,Assembly,"Do pass",15,0,0,1,16
59960,24147,2009-06-01,Assembly,"AB 92 DE LEON  Third Reading Urgency",79,0,0,1,80
59960,24148,2009-06-29,Senate,"Do pass",11,0,2,0,13
59960,24149,2009-08-24,Senate,"Assembly 3rd Reading AB92 De Leon Urgency Clause",39,0,1,0,40
59961,25825,2009-05-06,Assembly,"Do pass",16,0,0,0,16
59961,25826,2009-05-14,Assembly,"AB 93 DE LEON  Third Reading Urgency",73,0,0,7,80
59961,25827,2009-06-29,Senate,"Do pass",10,0,3,0,13
59961,25828,2009-08-24,Senate,"Assembly 3rd Reading AB93 De Leon Urgency Clause",33,2,5,0,40
59962,24137,2009-04-13,Assembly,"Do pass as amended and be re-referred to the Committee on 	Appropriations",7,1,0,1,9
59962,24138,2009-05-28,Assembly,"Do pass",13,4,0,0,17
59962,24139,2009-06-01,Assembly,"AB 94 EVANS  Assembly Third Reading",70,7,0,3,80
59962,24140,2009-06-23,Senate,"Do pass, but re-refer to the Committee on Revenue and Taxation",7,3,1,0,11
59962,24141,2009-07-08,Senate,"Do pass as amended, and re-refer to the Committee on Appropriations",5,3,0,0,8
59962,24142,2009-08-17,Senate,"Placed on Appropriations Suspense file",13,0,0,0,13
59962,24143,2009-08-27,Senate,"Do pass as amended",8,5,0,0,13
59962,24144,2009-09-03,Senate,"Assembly 3rd Reading AB94 Evans By Wolk",24,12,4,0,40
59962,24145,2009-09-09,Assembly,"AB 94 EVANS  Concurrence in Senate Amendments",67,9,0,3,79
59963,5991,2010-01-04,Assembly,"Be referred to Committee on Higher Education",10,0,1,0,11
59963,5992,2010-01-04,Assembly,"Be referred to Committee on Arts, Entertain, Sports, Tourism, & Internet Media",10,0,1,0,11
59964,24130,2009-03-24,Assembly,"Do pass as amended and be re-referred to the Committee on 	Appropriations",6,0,0,1,7
59964,24131,2009-04-22,Assembly,"Do pass",16,0,0,1,17
59964,24132,2009-04-30,Assembly,"AB 96 RUSKIN  Third Reading Urgency",76,0,0,4,80
59964,24133,2009-05-20,Senate,"Do pass as amended, and re-refer to the Committee on 	Appropriations",6,1,0,0,7
59964,24134,2009-06-29,Senate,"Do pass as amended",12,1,0,0,13
59964,24135,2009-07-09,Senate,"Assembly 3rd Reading AB96 Ruskin Urgency Clause",27,7,6,0,40
59964,24136,2009-07-16,Assembly,"AB 96 RUSKIN  Concurrence in Senate Amendments",70,0,0,9,79
59965,5993,2009-04-01,Assembly,"Do pass as amended and be re-referred to the Committee on Appropriations",8,3,0,0,11
59965,5994,2009-05-28,Assembly,"Do pass as amended",12,5,0,0,17
59965,5995,2009-06-03,Assembly,"AB 97 TORLAKSON  Assembly Third Reading",49,27,4,0,80
59965,5996,2009-07-15,Senate,"Do pass as amended, and re-refer to the Committee on Appropriations",6,2,1,0,9
59965,5997,2009-08-17,Senate,"Placed on Appropriations Suspense file",13,0,0,0,13
59965,21544,2010-08-26,Senate,"That the Assembly amendments be concurred in, but first be 	re-referred to the Committee on Appropriations",7,0,2,0,9
59965,21545,2010-08-27,Senate,"Be re-referred to the Committee on Rules pursuant to Senate Rule 	29.10",8,2,1,0,11
59965,21745,2010-08-30,Senate,"W/O REF. TO FILE AB97 Torlakson By Liu",22,10,7,0,39
59965,21851,2010-08-31,Assembly,"AB 97 Torlakson  Concurrence in Senate Amendments",51,25,0,2,78
59966,5998,2009-03-24,Assembly,"Do pass as amended and be re-referred to the Committee on Appropriations",13,4,2,0,19
59966,5999,2009-05-28,Assembly,"Do pass",12,5,0,0,17
59966,6000,2009-06-02,Assembly,"AB 98 DE LA TORRE  Assembly Third Reading",50,27,3,0,80
59966,6001,2009-07-08,Senate,"Do pass, but re-refer to the Committee on Appropriations",7,4,0,0,11
59966,6002,2009-07-23,Senate,"Placed on Appropriations Suspense file",13,0,0,0,13
59966,6003,2009-08-27,Senate,"Do pass",8,5,0,0,13
59966,6004,2009-09-09,Senate,"Assembly 3rd Reading AB98 De La Torre By Negrete McLeod",23,11,6,0,40
59966,6005,2009-09-10,Assembly,"AB 98 De La Torre  Concurrence in Senate Amendments",51,27,2,0,80
59967,24125,2009-03-31,Assembly,"Do pass",8,3,0,0,11
59967,24126,2009-04-13,Assembly,"AB 99 DE LEON  Assembly Third Reading",48,28,0,4,80
59967,24127,2009-07-14,Senate,"Do pass",5,2,0,0,7
59967,24128,2009-09-01,Senate,"Assembly 3rd Reading AB99 De Leon By Cedillo",22,13,5,0,40
59967,24129,2009-09-08,Assembly,"AB 99 DE LEON  Concurrence in Senate Amendments",46,28,0,5,79
59968,498,2009-04-22,Assembly,"Do pass as amended and be re-referred to the Committee on Appropriations.",7,1,3,0,11
59969,6006,2009-03-31,Assembly,"Do pass and re-refer to Committee on Appropriations with recommendation:  To Consent Calendar",7,0,0,0,7
59969,6007,2009-04-22,Assembly,"Do pass, to Consent Calendar",16,0,1,0,17
59969,6008,2009-05-04,Assembly,"AB 101 ANDERSON  Consent Calendar Second Day  Regular Session",79,0,1,0,80
59969,6009,2009-06-16,Senate,"Do pass, but re-refer to the Committee on Appropriations Recommend Consent",5,0,0,0,5
59969,6010,2009-06-29,Senate,"Placed on Appropriations Suspense file",13,0,0,0,13
59969,6011,2009-08-27,Senate,"Do pass as amended",12,0,1,0,13
59969,6012,2009-09-04,Senate,"Special Consent #19 AB101 Anderson",40,0,0,0,40
59969,6013,2009-09-09,Assembly,"AB 101 ANDERSON  Concurrence in Senate Amendments",78,0,1,0,79
59970,6014,2009-04-14,Assembly,"Do pass and be re-referred to the Committee on Appropriations",10,0,3,0,13
59970,6015,2009-05-28,Assembly,"Do pass as amended",17,0,0,0,17
59970,6016,2009-06-02,Assembly,"AB 102 SMYTH  Assembly Third Reading",76,0,4,0,80
59971,6017,2009-05-18,Assembly,"Do pass and be re-referred to the Committee on Appropriations",6,3,0,0,9
59972,6018,2009-04-13,Assembly,"Do pass and re-refer to Committee on Appropriations with recommendation:  To Consent Calendar",7,0,2,0,9
59972,6019,2009-05-28,Assembly,"Do pass",17,0,0,0,17
59972,6020,2009-06-01,Assembly,"AB 104 CALDERON  Assembly Third Reading",76,0,4,0,80
59974,6031,2009-03-31,Assembly,"Do pass as amended and be re-referred to the Committee on Appropriations",5,2,0,0,7
59975,26978,2009-03-17,Assembly,"Do pass and re-refer to Committee on Appropriations with 	recommendation:  To Consent Calendar",10,0,0,1,11
59975,26979,2009-04-01,Assembly,"Do pass",16,0,0,1,17
59975,26980,2009-04-13,Assembly,"AB 107 GALGIANI  Assembly Third Reading",79,0,0,1,80
59975,26981,2009-06-08,Senate,"Do pass, but re-refer to the Committee on Appropriations",7,0,3,0,10
59975,26982,2009-06-29,Senate,"Do pass",11,0,2,0,13
59975,26983,2009-07-09,Senate,"Special Consent #12 AB107 Galgiani By Cox",34,0,6,0,40
59975,26984,2009-07-13,Assembly,"AB 107 GALGIANI  Concurrence in Senate Amendments",75,0,0,4,79
59976,26395,2009-03-31,Assembly,"Do pass and be re-referred to the Committee on Appropriations",13,6,0,0,19
59976,26396,2009-04-22,Assembly,"Do pass",11,5,0,1,17
59976,26397,2009-05-11,Assembly,"AB 108 HAYASHI  Assembly Third Reading",48,29,0,3,80
59976,26398,2009-06-17,Senate,"Do pass as amended, and re-refer to the Committee on Judiciary",7,3,1,0,11
59976,26399,2009-07-14,Senate,"Do pass as amended, and re-refer to the Committee on 	Appropriations",3,2,0,0,5
59976,26400,2009-08-17,Senate,"Placed on Appropriations Suspense file",13,0,0,0,13
59976,26401,2009-08-27,Senate,"Do pass",8,5,0,0,13
59976,26402,2009-09-02,Senate,"Assembly 3rd Reading AB108 Hayashi By Cedillo",23,14,3,0,40
59976,26403,2009-09-08,Assembly,"AB 108 HAYASHI  Concurrence in Senate Amendments",50,29,0,0,79
59977,6029,2009-03-17,Assembly,"Do pass as amended and be re-referred to the Committee on Governmental Organization",7,3,0,0,10
59977,6030,2009-04-30,Assembly,"Do pass as amended and be re-referred to the Committee on Appropriations",3,10,6,0,19
59978,24118,2009-04-13,Assembly,"Do pass and be re-referred to the Committee on Appropriations",9,0,0,0,9
59978,24119,2009-05-28,Assembly,"Do pass",16,1,0,0,17
59978,24120,2009-06-01,Assembly,"AB 110 SMYTH  Assembly Third Reading",76,1,0,3,80
59978,24121,2009-06-23,Senate,"Do pass, but re-refer to the Committee on Rules",9,1,1,0,11
59978,24122,2009-07-06,Senate,"Placed on Appropriations Suspense file",11,0,2,0,13
59978,24123,2009-08-27,Senate,"Do pass",12,0,1,0,13
59978,24124,2009-09-02,Senate,"Assembly 3rd Reading AB110 Smyth By Runner",34,4,2,0,40
59980,24113,2009-03-23,Assembly,"Do pass as amended",14,0,0,0,14
59980,24114,2009-04-22,Assembly,"Do pass",16,0,0,1,17
59980,24115,2009-04-30,Assembly,"AB 112 BEALL  Assembly Third Reading",74,0,0,6,80
59980,24116,2009-06-09,Senate,"Do pass, but re-refer to the Committee on Appropriations Recommend 	Consent",11,0,0,0,11
59980,24117,2009-07-09,Senate,"Special Consent #12 AB112 Beall",34,0,6,0,40
59981,6023,2009-04-27,Assembly,"Do pass as amended and be re-referred to the Committee on Appropriations",2,3,9,0,14
59981,6024,2009-04-27,Assembly,"Set second hearing.  Failed passage.  Reconsideration granted",14,0,0,0,14
59981,6025,2010-01-07,Assembly,"Be referred to Committee on Health",10,0,1,0,11
59981,6026,2010-01-12,Assembly,"Do pass and be re-referred to the Committee on Appropriations",18,0,1,0,19
59981,6027,2010-01-21,Assembly,"Do pass, to Consent Calendar",17,0,0,0,17
59981,6028,2010-01-27,Assembly,"AB 113 PORTANTINO  Consent Calendar Second Day  Regular Session",68,0,10,0,78
59981,8993,2010-06-16,Senate,"Do pass as amended, and re-refer to the Committee on Appropriations",8,0,1,0,9
59981,20500,2010-08-18,Senate,"Assembly 3rd Reading AB113 Portantino By Alquist",31,1,6,0,38
59981,20600,2010-08-19,Assembly,"AB 113 PORTANTINO  Concurrence in Senate Amendments",77,0,0,2,79
59982,6033,2009-03-17,Assembly,"Do pass and be re-referred to the Committee on Appropriations",4,0,3,0,7
59982,6034,2009-04-01,Assembly,"Do pass",11,5,1,0,17
59982,6035,2009-05-26,Assembly,"AB 114 CARTER  Assembly Third Reading",57,18,5,0,80
59982,6036,2009-06-16,Senate,"Do pass, but re-refer to the Committee on Appropriations",3,2,2,0,7
59982,6037,2009-06-16,Senate,"Set, first hearing.  Failed passage in Committee.  Reconsideration granted",5,0,2,0,7
59982,6038,2009-07-14,Senate,"Do pass, but re-refer to the Committee on Appropriations",5,2,0,0,7
59982,21033,2010-08-24,Senate,"Assembly 3rd Reading AB114 Carter By Wright",26,10,3,0,39
59982,21171,2010-08-25,Assembly,"AB 114 CARTER  Concurrence in Senate Amendments",54,23,0,1,78
59983,6039,2009-03-17,Assembly,"Do pass and be re-referred to the Committee on Appropriations",19,0,0,0,19
59983,6040,2009-04-22,Assembly,"Do pass, to Consent Calendar",16,0,1,0,17
59983,6041,2009-05-04,Assembly,"AB 115 BEALL  Consent Calendar Second Day  Regular Session",79,0,1,0,80
59983,6042,2009-05-20,Senate,"Do pass, but re-refer to the Committee on Appropriations",6,2,3,0,11
59983,6043,2009-08-24,Senate,"Assembly 3rd Reading AB115 Beall By Alquist",26,13,1,0,40
59983,6044,2009-08-27,Assembly,"AB 115 BEALL  Concurrence in Senate Amendments",75,0,4,0,79
59984,24209,2009-04-01,Assembly,"Do pass as amended and be re-referred to the Committee on 	Appropriations",7,0,0,0,7
59984,24210,2009-04-29,Assembly,"Do pass",16,0,0,0,16
59984,24211,2009-05-11,Assembly,"AB 116 BEALL  Assembly Third Reading",77,3,0,0,80
59984,24212,2009-06-09,Senate,"Do pass, but re-refer to the Committee on Appropriations",10,1,0,0,11
59984,24213,2009-06-29,Senate,"Do pass",13,0,0,0,13
59984,24214,2009-08-24,Senate,"Assembly 3rd Reading AB116 Beall By DeSaulnier",36,0,4,0,40
59985,24203,2009-03-17,Assembly,"Do pass and re-refer to Committee on Appropriations with 	recommendation:  To Consent Calendar",10,0,0,1,11
59985,24204,2009-04-01,Assembly,"Do pass, to Consent Calendar",16,0,0,1,17
59985,24205,2009-04-16,Assembly,"AB 117 NIELLO  Consent Calendar Second Day",70,0,0,10,80
59985,24206,2009-06-08,Senate,"Do pass as amended, and re-refer to the Committee on Appropriations",7,0,3,0,10
59985,24207,2009-07-09,Senate,"Special Consent #12 AB117 Niello",34,0,6,0,40
59985,24208,2009-08-17,Assembly,"AB 117 NIELLO  Concurrence in Senate Amendments",76,0,0,3,79
59986,6045,2010-01-11,Assembly,"Do pass and be re-referred to the Committee on Appropriations",3,6,0,0,9
59987,26540,2009-03-31,Assembly,"Do pass and be re-referred to the Committee on Appropriations",13,6,0,0,19
59987,26541,2009-04-22,Assembly,"Do pass",10,5,0,2,17
59987,26542,2009-05-11,Assembly,"AB 119 JONES  Assembly Third Reading",51,29,0,0,80
59987,26543,2009-06-10,Senate,"Do pass, but re-refer to the Committee on Judiciary",7,3,1,0,11
59987,26544,2009-06-23,Senate,"Do pass, but re-refer to the Committee on Appropriations",3,1,1,0,5
59987,26545,2009-09-01,Senate,"Assembly 3rd Reading AB119 Jones By Leno",24,13,3,0,40
59987,26546,2009-09-03,Assembly,"AB 119 JONES  Concurrence in Senate Amendments",49,28,0,2,79
59988,6046,2009-05-12,Assembly,"Do pass as amended",11,0,0,0,11
59988,6047,2009-06-03,Assembly,"AB 120 HAYASHI  Assembly Third Reading",78,0,2,0,80
59988,6048,2009-07-06,Senate,"Do pass as amended, and re-refer to the Committee on Rules",9,0,1,0,10
59988,6049,2009-08-17,Senate,"Special Consent #14 AB120 Hayashi By Aanestad",35,0,5,0,40
59988,6050,2009-09-11,Assembly,"AB 120 HAYASHI  Concurrence in Senate Amendments",78,0,1,0,79
59989,24198,2009-03-17,Assembly,"Do pass and be re-referred to the Committee on Appropriations",9,0,0,1,10
59989,24199,2009-04-01,Assembly,"Do pass",16,0,0,1,17
59989,24200,2009-04-20,Assembly,"AB 121 HERNANDEZ  Assembly Third Reading",74,0,0,6,80
59989,24201,2009-06-16,Senate,"Do pass, but re-refer to the Committee on Appropriations",5,0,0,0,5
59989,24202,2009-08-24,Senate,"Assembly 3rd Reading AB121 Hernandez By Harman",39,0,1,0,40
59990,24193,2009-04-01,Assembly,"Do pass as amended and be re-referred to the Committee on 	Appropriations",8,1,0,2,11
59990,24194,2009-05-28,Assembly,"Do pass as amended",12,5,0,0,17
59990,24195,2009-06-03,Assembly,"AB 122 COTO  Assembly Third Reading",51,24,0,5,80
59990,24196,2009-12-17,Senate,"Assembly 3rd Reading AB122 Coto Urgency Clause",30,4,5,0,39
59990,24197,2010-01-25,Assembly,"AB 122 COTO  Concurrence- Urgency Added",63,2,0,13,78
59991,24188,2009-03-24,Assembly,"Do pass and re-refer to Committee on Appropriations with 	recommendation:  To Consent Calendar",7,0,0,0,7
59991,24189,2009-04-01,Assembly,"Do pass, to Consent Calendar",16,0,0,1,17
59991,24190,2009-04-16,Assembly,"AB 123 PORTANTINO  Consent Calendar Second Day  Regular Session",70,0,0,10,80
59991,24191,2009-06-09,Senate,"Do pass, but re-refer to the Committee on Appropriations Recommend 	Consent",5,0,0,0,5
59991,24192,2009-06-29,Senate,"Special Consent #11 AB123 Portantino",40,0,0,0,40
59992,24183,2009-03-17,Assembly,"Do pass, to Consent Calendar",10,0,0,1,11
59992,24184,2009-03-23,Assembly,"AB 124 GALGIANI  Consent Calendar Second Day  Regular Session",77,0,0,3,80
59992,24185,2009-06-08,Senate,"Do pass as amended",7,0,3,0,10
59992,24186,2009-06-29,Senate,"Special Consent #11 AB124 Galgiani By Denham",40,0,0,0,40
59992,24187,2009-07-06,Assembly,"AB 124 GALGIANI  Concurrence in Senate Amendments",77,0,0,2,79
59993,6051,2009-04-01,Assembly,"Do pass and be re-referred to the Committee on Appropriations",4,2,0,0,6
59993,6052,2009-05-28,Assembly,"Do pass as amended",12,5,0,0,17
59993,6053,2009-06-03,Assembly,"AB 125 DE LEON  Assembly Third Reading",47,30,3,0,80
59993,6054,2009-06-22,Senate,"Do pass, but re-refer to the Committee on Appropriations",4,2,1,0,7
59993,6055,2009-07-13,Senate,"Placed on Appropriations Suspense file",12,0,1,0,13
59995,6056,2010-01-12,Assembly,"Do pass and be re-referred to the Committee on Appropriations",11,0,0,0,11
59995,6057,2010-01-21,Assembly,"Do pass",17,0,0,0,17
59995,6058,2010-01-25,Assembly,"AB 127 Jeffries  Assembly Third Reading",64,1,13,0,78
59995,6059,2010-06-09,Senate,"Do pass as amended, and re-refer to the Committee on Appropriations",6,0,5,0,11
59995,9924,2010-06-28,Senate,"Placed on Appropriations Suspense file",10,0,1,0,11
59996,6060,2009-04-22,Assembly,"Do pass and be re-referred to the Committee on Appropriations",7,1,2,0,10
59997,24175,2009-03-31,Assembly,"Do pass and be re-referred to the Committee on Revenue and Taxation",9,0,0,1,10
59997,24176,2009-04-27,Assembly,"Do pass as amended and be re-referred to the Committee on 	Appropriations",8,0,0,1,9
59997,24177,2009-05-20,Assembly,"Do pass, to Consent Calendar",15,0,0,1,16
59997,24178,2009-05-28,Assembly,"AB 129 MA  Consent Calendar Second Day  Regular Session",76,0,0,4,80
59997,24179,2009-06-16,Senate,"Do pass, but re-refer to the Committee on Appropriations Recommend 	Consent",5,0,0,0,5
59997,24180,2009-09-01,Senate,"Assembly 3rd Reading AB129 Ma By Padilla",33,0,7,0,40
59997,24181,2009-09-04,Senate,"Assembly 3rd Reading AB129 Ma Urgency Clause",39,0,1,0,40
59997,24182,2009-09-11,Assembly,"AB 129 MA  Concurrence in Senate Amendments",79,0,0,0,79
59998,24165,2009-03-17,Assembly,"Do pass and be re-referred to the Committee on Appropriations",2,4,0,1,7
59998,24166,2009-03-17,Assembly,"Set first hearing.  Failed passage.  Reconsideration granted",6,0,0,1,7
59998,24167,2009-04-13,Assembly,"Be referred to Committee on Judiciary",9,0,0,2,11
59998,24168,2009-04-21,Assembly,"Do pass as amended and be re-referred to the Committee on 	Appropriations",10,0,0,0,10
59998,24169,2009-05-28,Assembly,"Do pass",17,0,0,0,17
59998,24170,2009-06-01,Assembly,"AB 130 JEFFRIES  Assembly Third Reading",79,0,0,1,80
59998,24171,2009-06-23,Senate,"Do pass as amended, and re-refer to the Committee on 	Appropriations",5,0,0,0,5
59998,24172,2009-08-17,Senate,"Do pass",9,0,4,0,13
59998,24173,2009-08-31,Senate,"Assembly 3rd Reading AB130 Jeffries By Huff",32,2,6,0,40
59998,24174,2009-09-02,Assembly,"AB 130 JEFFRIES  Concurrence in Senate Amendments",77,0,0,2,79
59999,24251,2009-03-17,Assembly,"Do pass as amended and be re-referred to the Committee on 	Appropriations",10,0,0,0,10
59999,24252,2009-05-28,Assembly,"Do pass",14,3,0,0,17
59999,24253,2009-06-01,Assembly,"AB 131 EVANS  Assembly Third Reading",72,5,0,3,80
59999,24254,2009-06-23,Senate,"Do pass, but re-refer to the Committee on Appropriations",3,2,0,0,5
59999,24255,2009-09-03,Senate,"Assembly 3rd Reading AB131 Evans By Corbett",25,12,3,0,40
59999,24256,2009-09-09,Assembly,"AB 131 EVANS  Concurrence in Senate Amendments",68,9,0,2,79
60000,6061,2009-04-01,Assembly,"Do pass and be re-referred to the Committee on Appropriations",8,3,0,0,11
60000,6062,2009-05-04,Assembly,"AB 132 MENDOZA  Assembly Third Reading",50,28,2,0,80
60000,6063,2009-06-17,Senate,"Do pass, but re-refer to the Committee on Judiciary",5,2,2,0,9
60000,6064,2009-07-07,Senate,"Do pass as amended",3,2,0,0,5
60000,6065,2009-09-03,Senate,"Assembly 3rd Reading AB132 Mendoza By Romero",24,14,2,0,40
60000,6066,2009-09-09,Assembly,"AB 132 MENDOZA  Concurrence in Senate Amendments",49,29,1,0,79
60001,2771,2010-01-13,Assembly,"Do pass",5,0,2,0,7
60001,2772,2010-01-19,Assembly,"AB 133 SMYTH  Assembly Third Reading",71,0,7,0,78
60001,6112,2010-06-09,Senate,"Do pass and be placed on the Consent Calendar",3,0,2,0,5
60001,9067,2010-06-17,Senate,"Consent Calendar 2nd AB133 Smyth",33,0,6,0,39
60001,9088,2010-06-21,Assembly,"AB 133 SMYTH  Concurrence in Senate Amendments",76,0,3,0,79
60002,26374,2009-04-13,Assembly,"Do pass and re-refer to Committee on Appropriations with 	recommendation:  To Consent Calendar",10,0,0,4,14
60002,26375,2009-04-22,Assembly,"Do pass, to Consent Calendar",16,0,0,1,17
60002,26376,2009-05-04,Assembly,"AB 134 BLAKESLEE  Consent Calendar Second Day  Regular Session",79,0,0,1,80
60002,26377,2009-06-09,Senate,"Do pass, but re-refer to the Committee on Appropriations Recommend 	Consent",11,0,0,0,11
60002,26378,2009-07-09,Senate,"Special Consent #12 AB134 Blakeslee",34,0,6,0,40
60002,26379,2009-08-17,Assembly,"AB 134 BLAKESLEE  Concurrence in Senate Amendments",77,0,0,2,79
60003,6067,2009-04-13,Assembly,"Do pass as amended and be re-referred to the Committee on Appropriations",9,0,0,0,9
60003,6068,2009-05-28,Assembly,"Do pass as amended, to Consent Calendar",17,0,0,0,17
60003,6069,2009-06-03,Assembly,"AB 135 JEFFRIES  Consent Calendar Second Day",77,0,3,0,80
60003,6070,2009-07-06,Senate,"Do pass as amended, but re-refer to the Committee on Appropriations Recommend Consent",10,0,1,0,11
60004,24257,2009-04-01,Assembly,"Do pass and be re-referred to the Committee on Appropriations",19,0,0,0,19
60004,24258,2009-05-06,Assembly,"Do pass",15,1,0,0,16
60004,24259,2009-05-14,Assembly,"AB 136 SILVA  Assembly Third Reading",72,0,0,8,80
60004,24260,2009-06-23,Senate,"Do pass, but re-refer to the Committee on Appropriations",9,0,4,0,13
60004,24261,2009-09-01,Senate,"Assembly 3rd Reading AB136 Silva Urgency Clause",33,0,7,0,40
60004,24262,2009-09-03,Assembly,"AB 136 SILVA  Concurrence in Senate Amendments",75,0,0,4,79
60006,26387,2009-04-28,Assembly,"Do pass and be re-referred to the Committee on Appropriations",9,1,0,1,11
60006,26388,2009-05-28,Assembly,"Do pass",12,5,0,0,17
60006,26389,2009-06-01,Assembly,"AB 138 HAYASHI  Assembly Third Reading",73,6,0,1,80
60006,26390,2009-06-29,Senate,"Do pass, but re-refer to the Committee on Appropriations",9,0,1,0,10
60006,26391,2009-07-13,Senate,"Placed on Appropriations Suspense file",12,0,1,0,13
60006,26392,2009-08-27,Senate,"Do pass as amended",8,2,3,0,13
60006,26393,2009-09-03,Senate,"Assembly 3rd Reading AB138 Hayashi By Yee",28,6,6,0,40
60006,26394,2009-09-09,Assembly,"AB 138 HAYASHI  Concurrence in Senate Amendments",74,4,0,1,79
60007,880,2010-01-13,Assembly,"Do pass as amended.",5,0,2,0,7
60007,881,2010-01-25,Assembly,"AB 139 BROWNLEY  Assembly Third Reading",67,0,11,0,78
60007,882,2010-05-05,Senate,"Do pass and be placed on the Consent Calendar.",5,0,0,0,5
60007,883,2010-05-13,Senate,"Consent Calendar 2nd AB139 Brownley",31,0,7,0,38
60007,9077,2010-06-17,Assembly,"AB 139 BROWNLEY  Concurrence in Senate Amendments",70,0,9,0,79
60008,24246,2009-03-24,Assembly,"Do pass and re-refer to Committee on Appropriations with 	recommendation:  To Consent Calendar",7,0,0,0,7
60008,24247,2009-04-01,Assembly,"Do pass, to Consent Calendar",16,0,0,1,17
60008,24248,2009-04-16,Assembly,"AB 140 BEALL  Consent Calendar Second Day  Regular Session",70,0,0,10,80
60008,24249,2009-06-09,Senate,"Do pass, but re-refer to the Committee on Appropriations Recommend 	Consent",5,0,0,0,5
60008,24250,2009-06-29,Senate,"Special Consent #11 AB140 Beall",40,0,0,0,40
60010,27107,2009-04-14,Assembly,"Do pass, to Consent Calendar",10,0,0,0,10
60010,27108,2009-04-20,Assembly,"AB 142 HAYASHI  Consent Calendar Second Day  Regular Session",75,0,0,5,80
60010,27109,2010-02-23,Senate,"Do pass, but re-refer to the Committee on Appropriations",9,0,2,0,11
60010,27110,2010-03-15,Senate,"Do pass",9,0,2,0,11
60010,27111,2010-03-22,Senate,"Assembly 3rd Reading AB142 Hayashi Urgency Clause",32,0,7,0,39
60010,27112,2010-03-23,Assembly,"Senate amendments be concurred in",18,0,0,4,22
60010,27113,2010-03-25,Assembly,"AB 142 HAYASHI  Concurrence- Urgency Added",68,1,0,10,79
60011,24240,2009-03-23,Assembly,"Do pass and be re-referred to the Committee on Appropriations",9,0,0,0,9
60011,24241,2009-04-01,Assembly,"Do pass, to Consent Calendar",16,0,0,1,17
60011,24242,2009-04-16,Assembly,"AB 143 JEFFRIES  Consent Calendar Second Day  Regular Session",70,0,0,10,80
60011,24243,2009-06-10,Senate,"Do pass, but re-refer to the Committee on Appropriations Recommend 	Consent",7,0,1,0,8
60011,24244,2009-07-09,Senate,"Special Consent #12 AB143 Jeffries",34,0,6,0,40
60011,24245,2009-07-13,Assembly,"AB 143 JEFFRIES  Concurrence in Senate Amendments",74,0,0,5,79
60012,24234,2009-04-13,Assembly,"Do pass as amended and be re-referred to the Committee on 	Appropriations",12,1,0,1,14
60012,24235,2009-04-29,Assembly,"Do pass",16,0,0,0,16
60012,24236,2009-05-18,Assembly,"AB 144 MA  Assembly Third Reading",73,3,0,4,80
60012,24237,2009-07-07,Senate,"Do pass, but re-refer to the Committee on Appropriations",7,3,1,0,11
60012,24238,2009-08-31,Senate,"Assembly 3rd Reading AB144 Ma By Alquist",23,10,7,0,40
60012,24239,2009-09-02,Assembly,"AB 144 MA  Concurrence in Senate Amendments",69,7,0,3,79
60013,695,2009-04-13,Assembly,"Do pass and be re-referred to the Committee on Appropriations.",14,0,0,0,14
60013,696,2009-04-22,Assembly,"Do pass, to Consent Calendar.",16,0,1,0,17
60013,697,2009-05-04,Assembly,"AB 145 DE LEON  Consent Calendar Second Day  Regular Session",79,0,1,0,80
60013,8920,2010-06-15,Senate,"Do pass, but re-refer to the Committee on Appropriations",8,0,1,0,9
60013,19707,2010-08-09,Senate,"Special Consent #30 AB145 De Leon",34,0,4,0,38
60013,19913,2010-08-12,Assembly,"AB 145 DE LEON  Concurrence in Senate Amendments",78,0,0,1,79
60014,6071,2009-03-18,Assembly,"Do pass as amended",8,1,2,0,11
60014,6072,2009-04-02,Assembly,"AB 146 MENDOZA  Assembly Third Reading",52,22,6,0,80
60014,6073,2009-06-17,Senate,"Do pass as amended",5,1,3,0,9
60014,6074,2009-09-03,Senate,"Assembly 3rd Reading AB146 Mendoza By Oropeza",22,14,4,0,40
60014,6075,2009-09-09,Assembly,"AB 146 MENDOZA  Concurrence in Senate Amendments",53,21,5,0,79
60015,6076,2009-04-21,Assembly,"Do pass and be re-referred to the Committee on Judiciary",5,2,0,0,7
60015,6077,2009-04-28,Assembly,"Do pass as amended and be re-referred to the Committee on Appropriations",7,3,0,0,10
60015,6078,2009-05-28,Assembly,"Do pass as amended",12,5,0,0,17
60015,6079,2009-06-03,Assembly,"AB 147 SALDANA  Assembly Third Reading",42,32,6,0,80
60015,6080,2009-07-06,Senate,"Do pass, but re-refer to the Committee on Appropriations",5,2,0,0,7
60015,6081,2009-08-17,Senate,"Do pass",8,4,1,0,13
60015,6082,2009-09-03,Senate,"Assembly 3rd Reading AB147 Saldana By Hancock",23,15,2,0,40
60015,6083,2009-09-09,Assembly,"AB 147 SALDANA  Concurrence in Senate Amendments",49,28,2,0,79
60016,6084,2009-03-18,Assembly,"Do pass and be re-referred to the Committee on Appropriations",10,0,1,0,11
60016,6085,2009-05-28,Assembly,"Do pass",12,4,1,0,17
60016,6086,2009-06-01,Assembly,"AB 148 COTO  Assembly Third Reading",55,23,2,0,80
60019,6091,2009-03-31,Assembly,"Do pass and be re-referred to the Committee on Appropriations",7,0,0,0,7
60019,6092,2010-01-07,Assembly,"Be referred to Committee on Business and Professions",10,0,1,0,11
60019,6093,2010-01-12,Assembly,"Do pass and be re-referred to the Committee on Appropriations",11,0,0,0,11
60019,6094,2010-01-21,Assembly,"Do pass as amended",12,0,5,0,17
60019,6095,2010-01-27,Assembly,"AB 151 JONES  Assembly Third Reading  FORMERLY FILE ITEM1",68,0,10,0,78
60019,9417,2010-06-22,Senate,"Do pass, but re-refer to the Committee on Appropriations",8,0,3,0,11
60019,19183,2010-08-02,Senate,"Placed on Appropriations Suspense file",10,0,1,0,11
60019,19995,2010-08-12,Senate,"Do pass as amended",7,4,0,0,11
60019,21134,2010-08-25,Senate,"Assembly 3rd Reading AB151 Jones By Runner",24,9,6,0,39
60019,21405,2010-08-26,Assembly,"AB 151 JONES  Concurrence in Senate Amendments",53,23,0,2,78
60021,6087,2009-03-23,Assembly,"Do pass and be re-referred to the Committee on Judiciary",9,0,5,0,14
60021,6088,2009-04-14,Assembly,"Do pass and be re-referred to the Committee on Appropriations",7,2,1,0,10
60021,6089,2009-04-29,Assembly,"Do pass",11,5,0,0,16
60021,6090,2009-05-11,Assembly,"AB 153 MA  Assembly Third Reading",53,16,11,0,80
60021,9775,2010-06-29,Senate,"Do pass, but re-refer to the Committee on Rules",6,3,0,0,9
60021,20477,2010-08-18,Senate,"Do pass, but re-refer to the Committee on Appropriations",6,1,2,0,9
60021,21564,2010-08-27,Senate,"Do pass as amended",8,3,0,0,11
60021,21653,2010-08-30,Senate,"Assembly 2nd Reading AB153 Hernandez Urgency Clause",28,6,5,0,39
60021,21883,2010-08-31,Assembly,"AB 153 HERNANDEZ  Concurrence- Urgency Added",62,10,0,6,78
60022,24228,2009-03-24,Assembly,"Do pass as amended and re-refer to Committee on Appropriations 	with recommendation:  To Consent Calendar",7,0,0,0,7
60022,24229,2009-05-28,Assembly,"Do pass",17,0,0,0,17
60022,24230,2009-06-01,Assembly,"AB 154 EVANS  Assembly Third Reading",79,0,0,1,80
60022,24231,2009-06-23,Senate,"Do pass, but re-refer to the Committee on Appropriations Recommend 	Consent",5,0,0,0,5
60022,24232,2009-09-04,Senate,"Assembly 3rd Reading AB154 Evans By Liu",39,0,1,0,40
60022,24233,2009-09-09,Assembly,"AB 154 EVANS  Concurrence in Senate Amendments",78,0,0,1,79
60023,2317,2009-04-22,Assembly,"Do pass and be re-referred to the Committee on Appropriations",4,3,0,0,7
60023,2318,2009-05-28,Assembly,"Do pass as amended",12,5,0,0,17
60023,2319,2009-06-03,Assembly,"AB 155 MENDOZA  Assembly Third Reading",47,25,8,0,80
60023,2320,2010-04-19,Senate,"Do pass, but re-refer to the Committee on Appropriations",3,2,0,0,5
60023,2321,2010-05-24,Senate,"Placed on Appropriations Suspense file",10,0,1,0,11
60023,2322,2010-05-27,Senate,"Do pass as amended",6,4,1,0,11
60023,21022,2010-08-24,Senate,"That the Assembly amendments be concurred in, but first be 	re-referred to the Committee on Appropriations",3,1,0,0,4
60023,21673,2010-08-30,Senate,"From Committee:  Amendments returned to Senate floor for 	consideration",6,4,1,0,11
60025,6100,2009-05-18,Assembly,"Do pass as amended and be re-referred to the Committee on Appropriations",9,0,0,0,9
60025,6101,2009-05-28,Assembly,"Do pass, to Consent Calendar",17,0,0,0,17
60025,6102,2009-06-02,Assembly,"AB 157 ANDERSON  Consent Calendar Second Day  Regular Session",76,0,4,0,80
60025,10174,2010-07-01,Senate,"Do pass, but re-refer to the Committee on Appropriations",5,0,0,0,5
60025,20834,2010-08-23,Senate,"Assembly 3rd Reading AB157 Anderson By Hollingsworth",36,0,3,0,39
60025,21090,2010-08-25,Assembly,"AB 157 ANDERSON  Concurrence in Senate Amendments",76,0,0,2,78
60026,24224,2009-03-17,Assembly,"Do pass",10,0,0,1,11
60026,24225,2009-03-23,Assembly,"AB 158 MENDOZA  Assembly Third Reading",76,0,0,4,80
60026,24226,2009-06-09,Senate,"Do pass",7,0,0,0,7
60026,24227,2009-06-22,Senate,"Special Consent #9 AB158 Mendoza By Calderon",40,0,0,0,40
60027,6099,2009-03-17,Assembly,"Do pass as amended and be re-referred to the Committee on Appropriations",19,0,0,0,19
60029,6097,2009-03-23,Assembly,"Do pass as amended, to Consent Calendar",10,0,1,0,11
60029,6098,2009-04-02,Assembly,"AB 161 ADAMS  Consent Calendar Second Day  Regular Session",75,0,5,0,80
60030,25964,2009-03-23,Assembly,"Do pass and be re-referred to the Committee on Appropriations",14,0,0,1,15
60030,25965,2009-04-22,Assembly,"Do pass, to Consent Calendar",16,0,0,1,17
60030,25966,2009-05-04,Assembly,"AB 162 RUSKIN  Consent Calendar Second Day  Regular Session",79,0,0,1,80
60030,25967,2009-07-07,Senate,"Do pass, but re-refer to the Committee on Appropriations",11,0,0,0,11
60030,25968,2009-08-24,Senate,"Special Consent #15 AB162 Ruskin",39,0,1,0,40
60030,25969,2009-08-27,Assembly,"AB 162 RUSKIN  Concurrence in Senate Amendments",77,0,0,2,79
60031,6104,2009-04-21,Assembly,"Do pass and be re-referred to the Committee on Appropriations",17,0,2,0,19
60033,6105,2009-04-21,Assembly,"Do pass as amended and re-refer to Committee on Appropriations with recommendation:  To Consent Calendar",7,0,0,0,7
60034,24215,2009-03-23,Assembly,"Do pass and re-refer to Committee on Appropriations with 	recommendation:  To Consent Calendar",14,0,0,0,14
60034,24216,2009-05-28,Assembly,"Do pass",17,0,0,0,17
60034,24217,2009-06-01,Assembly,"AB 166 LIEU  Assembly Third Reading",79,0,0,1,80
60034,24218,2009-06-23,Senate,"Do pass, but re-refer to the Committee on Judiciary Recommend 	Consent",11,0,0,0,11
60034,24219,2009-07-07,Senate,"Do pass as amended, but re-refer to the Committee on 	Appropriations Recommend Consent",5,0,0,0,5
60034,24220,2009-08-17,Senate,"Placed on Appropriations Suspense file",13,0,0,0,13
60034,24221,2009-08-27,Senate,"Do pass",13,0,0,0,13
60034,24222,2009-09-04,Senate,"Assembly 3rd Reading AB166 Lieu By DeSaulnier",39,0,1,0,40
60034,24223,2009-09-09,Assembly,"AB 166 LIEU  Concurrence in Senate Amendments",77,0,0,2,79
60035,25573,2009-03-18,Assembly,"Do pass as amended and re-refer to Committee on Appropriations 	with recommendation:  To Consent Calendar",10,0,0,1,11
60035,25574,2009-04-22,Assembly,"Do pass, to Consent Calendar",16,0,0,1,17
60035,25575,2009-05-04,Assembly,"AB 167 ADAMS  Consent Calendar Second Day  Regular Session",79,0,0,1,80
60035,25576,2009-06-10,Senate,"Do pass as amended, and re-refer to the Committee on Appropriations",8,0,1,0,9
60035,25577,2009-06-29,Senate,"Placed on Appropriations Suspense file",13,0,0,0,13
60035,25578,2009-08-27,Senate,"Do pass",12,0,1,0,13
60035,25579,2009-09-02,Senate,"Assembly 3rd Reading AB167 Adams By Huff",32,0,8,0,40
60035,25580,2009-09-08,Assembly,"AB 167 ADAMS  Concurrence in Senate Amendments",78,0,0,1,79
60036,6106,2009-03-17,Assembly,"Do pass as amended and be re-referred to the Committee on Judiciary",6,0,1,0,7
60036,6107,2009-03-31,Assembly,"Do pass as amended and be re-referred to the Committee on Appropriations",10,0,0,0,10
60037,25531,2009-03-17,Assembly,"Do pass and re-refer to Committee on Appropriations with 	recommendation:  To Consent Calendar",6,0,0,1,7
60037,25532,2009-04-01,Assembly,"Do pass as amended",16,0,0,1,17
60037,25533,2009-04-20,Assembly,"AB 169 PORTANTINO  Assembly Third Reading",75,0,0,5,80
60037,25534,2009-05-20,Senate,"Do pass, but re-refer to the Committee on Public Safety",6,2,3,0,11
60037,25535,2009-06-23,Senate,"Do pass, but re-refer to the Committee on Appropriations",7,0,0,0,7
60037,25536,2009-09-02,Senate,"Assembly 3rd Reading AB169 Portantino By Liu",32,0,8,0,40
60038,25842,2009-03-17,Assembly,"Do pass, to Consent Calendar",10,0,0,0,10
60038,25843,2009-03-23,Assembly,"AB 170 MENDOZA  Consent Calendar Second Day  Regular Session",77,0,0,3,80
60038,25844,2009-06-09,Senate,"Do pass",5,0,0,0,5
60038,25845,2009-06-22,Senate,"Special Consent #9 AB170 Mendoza By Harman",40,0,0,0,40
60039,24294,2009-03-31,Assembly,"Do pass and be re-referred to the Committee on Judiciary",11,0,0,0,11
60039,24295,2009-04-14,Assembly,"Do pass and be re-referred to the Committee on Appropriations",10,0,0,0,10
60039,24296,2009-04-29,Assembly,"Do pass, to Consent Calendar",16,0,0,0,16
60039,24297,2009-05-11,Assembly,"AB 171 JONES  Consent Calendar Second Day  Regular Session",78,0,0,2,80
60039,24298,2009-06-08,Senate,"Do pass, but re-refer to the Committee on Judiciary",7,0,3,0,10
60039,24299,2009-06-23,Senate,"Do pass as amended, and re-refer to the Committee on 	Appropriations",4,0,1,0,5
60039,24300,2009-08-27,Senate,"Assembly 3rd Reading AB171 Jones By Aanestad",38,0,2,0,40
60039,24301,2009-08-31,Assembly,"AB 171 JONES  Concurrence in Senate Amendments",78,0,0,1,79
60040,24302,2009-04-30,Assembly,"Do pass and be re-referred to the Committee on Appropriations",15,0,0,4,19
60040,24303,2009-05-13,Assembly,"Do pass, to Consent Calendar",16,0,0,0,16
60040,24304,2009-05-21,Assembly,"AB 172 SMYTH  Consent Calendar Second Day  Regular Session",77,0,0,3,80
60040,24305,2009-07-08,Senate,"Do pass, but re-refer to the Committee on Appropriations Recommend 	Consent",11,0,2,0,13
60040,24306,2009-08-27,Senate,"Special Consent #16 AB172 Smyth",38,0,2,0,40
60040,24307,2009-09-01,Assembly,"AB 172 SMYTH  Concurrence in Senate Amendments",75,0,0,4,79
60040,24308,2009-09-11,Assembly,"AB 172 Smyth  Concurrence in Senate Amendments",77,0,0,2,79
60040,24309,2009-09-11,Senate,"Assembly 3rd Reading AB172 Smyth By Runner",32,0,8,0,40
60041,6120,2009-04-29,Assembly,"Do pass and be re-referred to the Committee on Appropriations",8,3,0,0,11
60042,26858,2009-03-18,Assembly,"Do pass and be re-referred to the Committee on Natural Resources",10,0,0,1,11
60042,26859,2009-04-13,Assembly,"Do pass and re-refer to Committee on Appropriations with 	recommendation:  To Consent Calendar",9,0,0,0,9
60042,26860,2009-04-29,Assembly,"Do pass, to Consent Calendar",16,0,0,0,16
60042,26861,2009-05-14,Assembly,"AB 174 CARTER  Assembly Third Reading",75,0,0,5,80
60042,26862,2009-06-17,Senate,"Do pass, but re-refer to the Committee on Rules",9,0,0,0,9
60042,26863,2009-08-17,Senate,"Special Consent #14 AB174 Carter",35,0,5,0,40
60042,26864,2009-08-24,Assembly,"AB 174 CARTER  Concurrence in Senate Amendments",76,0,0,3,79
60043,26621,2009-03-17,Assembly,"Do pass and be re-referred to the Committee on Business and 	Professions",19,0,0,0,19
60043,26622,2009-04-28,Assembly,"Do pass and re-refer to Committee on Appropriations with 	recommendation:  To Consent Calendar",10,0,0,1,11
60043,26623,2009-05-13,Assembly,"Do pass",16,0,0,0,16
60043,26624,2009-05-21,Assembly,"AB 175 GALGIANI  Assembly Third Reading",77,0,0,3,80
60043,26625,2009-06-17,Senate,"Do pass as amended, and re-refer to the Committee on Business, 	Professions and Economic Development",10,0,1,0,11
60043,26626,2009-06-29,Senate,"Do pass, but re-refer to the Committee on Appropriations",10,0,0,0,10
60043,26627,2009-08-17,Senate,"Placed on Appropriations Suspense file",13,0,0,0,13
60043,26628,2009-08-27,Senate,"Do pass",13,0,0,0,13
60043,26629,2009-09-04,Senate,"Special Consent #19 AB175 Galgiani",40,0,0,0,40
60043,26630,2009-09-09,Assembly,"AB 175 GALGIANI  Concurrence in Senate Amendments",78,0,0,1,79
60044,24289,2009-03-17,Assembly,"Do pass, to Consent Calendar",10,0,0,0,10
60044,24290,2009-03-23,Assembly,"AB 176 SILVA  Consent Calendar Second Day  Regular Session",77,0,0,3,80
60044,24291,2009-06-09,Senate,"Do pass and be placed on the Consent Calendar",5,0,0,0,5
60044,24292,2009-06-15,Senate,"Consent Calendar 2nd AB176 Silva",36,0,4,0,40
60044,24293,2009-06-18,Assembly,"AB 176 SILVA  Concurrence in Senate Amendments",69,0,0,10,79
60045,3651,2010-01-05,Assembly,"Do pass and be re-referred to the Committee on Appropriations to Consent Calendar",6,0,1,0,7
60045,3652,2010-01-21,Assembly,"Do pass",17,0,0,0,17
60045,3653,2010-01-25,Assembly,"AB 177 Ruskin  Assembly Third Reading",67,0,11,0,78
60045,6548,2010-06-09,Senate,"Do pass, but re-refer to the Committee on Veterans Affairs",6,0,5,0,11
60045,9526,2010-06-22,Senate,"Do pass as amended, and re-refer to the Committee on Appropriations",4,0,1,0,5
60045,20489,2010-08-18,Senate,"Assembly 3rd Reading AB177 Ruskin By Price",33,0,5,0,38
60045,20914,2010-08-23,Assembly,"AB 177 RUSKIN  Concurrence in Senate Amendments",76,0,0,2,78
60047,6117,2009-04-21,Assembly,"Do pass and be re-referred to the Committee on Appropriations",7,0,0,0,7
60047,6118,2009-05-28,Assembly,"Do pass",17,0,0,0,17
60047,6119,2009-06-01,Assembly,"AB 179 PORTANTINO  Assembly Third Reading",79,0,1,0,80
60048,6114,2009-05-04,Assembly,"AB 180 BUDGET  Assembly Third Reading  By EVANS",51,0,29,0,80
60048,6115,2009-06-24,Senate,"Do pass",25,15,0,0,40
60048,6116,2009-06-24,Senate,"Assembly 3rd Reading AB180 Committee on BUDGET (Evans) Reconsider",40,0,0,0,40
60049,6122,2009-05-04,Assembly,"AB 181 BUDGET  Assembly Third Reading  By EVANS",51,0,29,0,80
60050,6123,2009-05-04,Assembly,"AB 182 BUDGET  Assembly Third Reading  By EVANS",51,0,29,0,80
60050,6124,2009-09-12,Senate,"Assembly 3rd Reading AB182 Committee on BUDGET (Evans) Reconsider",39,0,1,0,40
60050,6125,2009-10-14,Senate,"Assembly 3rd Reading AB182 Committee on BUDGET (Evans) Urgency Clause",27,9,4,0,40
60051,26317,2009-05-04,Assembly,"AB 183 BUDGET  Assembly Third Reading  By EVANS",51,0,0,29,80
60051,26318,2010-03-22,Senate,"Do pass",15,0,0,0,15
60051,26319,2010-03-22,Senate,"W/O REF. TO FILE AB183 Caballero",29,1,9,0,39
60051,26320,2010-03-22,Assembly,"AB 183 CABALLERO  Concurrence in Senate Amendments",67,2,0,10,79
60052,6126,2009-05-04,Assembly,"AB 184 BUDGET  Assembly Third Reading  By EVANS",51,0,29,0,80
60052,6127,2009-09-12,Senate,"Assembly 3rd Reading AB184 Block Reconsider",40,0,0,0,40
60052,19795,2010-08-11,Senate,"Do pass, but re-refer to the Committee on Appropriations",7,0,2,0,9
60052,20011,2010-08-12,Senate,"Placed on Appropriations Suspense file",11,0,0,0,11
60052,20012,2010-08-12,Senate,"Do pass as amended",11,0,0,0,11
60052,20461,2010-08-18,Senate,"Assembly 3rd Reading AB184 Block Urgency Clause",34,0,4,0,38
60052,20782,2010-08-23,Assembly,"AB 184 BLOCK  Concurrence- Urgency Added",77,0,0,1,78
60053,6128,2009-05-04,Assembly,"AB 185 BUDGET  Assembly Third Reading  By EVANS",51,0,29,0,80
60053,21769,2010-08-30,Senate,"Do pass",11,0,0,0,11
60053,21874,2010-08-31,Senate,"Assembly 3rd Reading AB185 Buchanan By Kehoe",36,0,3,0,39
60053,21875,2010-08-31,Assembly,"AB 185 Buchanan  Concurrence in Senate Amendments",76,0,0,2,78
60054,6129,2009-05-04,Assembly,"AB 186 BUDGET  Assembly Third Reading  By EVANS",51,0,29,0,80
60054,6130,2010-03-22,Senate,"Do pass",10,5,0,0,15
60055,24285,2009-05-04,Assembly,"AB 187 BUDGET  Assembly Third Reading  By EVANS",51,0,0,29,80
60055,24286,2009-09-12,Senate,"Assembly 3rd Reading AB187 Committee on BUDGET (Evans) Reconsider",39,0,1,0,40
60055,24287,2009-10-14,Senate,"Assembly 3rd Reading AB187 Committee on BUDGET (Evans) Urgency 	Clause",34,2,4,0,40
60055,24288,2009-10-26,Assembly,"AB 187 BUDGET  Concurrence- Urgency Added  By EVANS",69,4,0,6,79
60056,24281,2009-05-04,Assembly,"AB 188 BUDGET  Assembly Third Reading  By EVANS",51,0,0,29,80
60056,24282,2009-10-14,Senate,"Assembly 3rd Reading AB188 Committee on BUDGET (Evans) Suspend 	Joint Rules",29,0,11,0,40
60056,24283,2009-10-14,Senate,"Assembly 3rd Reading AB188 Jones Urgency Clause",28,9,3,0,40
60056,24284,2009-10-26,Assembly,"AB 188 Jones  Concurrence- Urgency Added",61,8,0,10,79
60057,24276,2009-05-04,Assembly,"AB 189 BUDGET  Assembly Third Reading  By EVANS",51,0,0,29,80
60057,24277,2009-09-12,Senate,"Assembly 3rd Reading AB189 Committee on BUDGET (Evans) Urgency 	Clause",25,0,15,0,40
60057,24278,2009-09-12,Senate,"Assembly 3rd Reading AB189 Committee on BUDGET (Evans) Reconsider",39,0,1,0,40
60057,24279,2009-10-14,Senate,"Assembly 3rd Reading AB189 Committee on BUDGET (Evans) Urgency 	Clause",37,0,3,0,40
60057,24280,2009-10-26,Assembly,"AB 189 BUDGET  Concurrence- Urgency Added  By EVANS",64,9,0,6,79
60058,2741,2009-05-04,Assembly,"AB 190 BUDGET  Assembly Third Reading  By EVANS",51,0,29,0,80
60058,2742,2010-05-27,Senate,"Assembly 3rd Reading AB190 Committee on BUDGET (Evans) By Ducheny",26,6,6,0,38
60058,2743,2010-05-28,Assembly,"AB 190 BUDGET  Concurrence in Senate Amendments By EVANS",6,52,21,0,79
60059,6131,2009-05-04,Assembly,"AB 191 BUDGET  Assembly Third Reading  By EVANS",51,0,29,0,80
60059,9006,2010-06-17,Senate,"Assembly 3rd Reading AB191 Committee on BUDGET (Evans) By Ducheny",32,0,7,0,39
60059,9082,2010-06-21,Assembly,"AB 191 BUDGET  Concurrence- Urgency Added  By BLUMENFIELD",76,0,3,0,79
60060,6132,2009-05-04,Assembly,"AB 192 BUDGET  Assembly Third Reading  By EVANS",51,0,29,0,80
60061,6135,2009-05-04,Assembly,"AB 193 BUDGET  Assembly Third Reading  By EVANS",51,0,29,0,80
60061,6136,2009-06-26,Senate,"Do pass",23,13,4,0,40
60061,6137,2009-06-26,Senate,"Assembly 3rd Reading AB193 Committee on BUDGET (Evans) Reconsider",36,0,4,0,40
60062,6138,2009-05-04,Assembly,"AB 194 BUDGET  Assembly Third Reading  By EVANS",51,0,29,0,80
60062,21770,2010-08-30,Senate,"Do pass",7,3,1,0,11
60062,21771,2010-08-30,Senate,"W/O REF. TO FILE AB194 Torrico By Ducheny",27,10,2,0,39
60062,21877,2010-08-31,Assembly,"Senate amendments be concurred in",6,0,0,0,6
60062,21878,2010-08-31,Assembly,"AB 194 TORRICO  Concurrence- Urgency Added",76,0,0,2,78
60063,6139,2009-05-04,Assembly,"AB 195 BUDGET  Assembly Third Reading  By EVANS",51,0,29,0,80
60063,6140,2009-06-26,Senate,"Do pass",23,13,4,0,40
60063,6141,2009-06-26,Senate,"Assembly 3rd Reading AB195 Committee on BUDGET (Evans) Urgency Clause",22,14,4,0,40
60063,6142,2009-06-26,Senate,"Assembly 3rd Reading AB195 Committee on BUDGET (Evans) Reconsider",36,0,4,0,40
60064,6143,2009-05-04,Assembly,"AB 196 BUDGET  Assembly Third Reading  By EVANS",51,0,29,0,80
60064,6144,2009-06-26,Senate,"Do pass",23,13,4,0,40
60064,6145,2009-06-26,Senate,"Assembly 3rd Reading AB196 Committee on BUDGET (Evans) Reconsider",36,0,4,0,40
60064,6146,2009-09-12,Senate,"Assembly 3rd Supp 1 AB196 Committee on BUDGET (Evans) Urgency Clause",25,7,8,0,40
60065,6147,2009-05-04,Assembly,"AB 197 BUDGET  Assembly Third Reading  By EVANS",51,0,29,0,80
60066,6148,2009-05-04,Assembly,"AB 198 BUDGET  Assembly Third Reading  By EVANS",51,0,29,0,80
60067,6149,2009-05-04,Assembly,"AB 199 BUDGET  Assembly Third Reading  By EVANS",51,0,29,0,80
60068,379,2009-05-04,Assembly,"AB 200 BUDGET  Assembly Third Reading  By EVANS",51,0,29,0,80
60069,6150,2009-05-04,Assembly,"AB 201 BUDGET  Assembly Third Reading  By EVANS",51,0,29,0,80
60070,6151,2009-05-04,Assembly,"AB 202 BUDGET  Assembly Third Reading  By EVANS",51,0,29,0,80
60071,6152,2009-05-04,Assembly,"AB 203 BUDGET  Assembly Third Reading  By EVANS",51,0,29,0,80
60072,6153,2009-05-04,Assembly,"AB 204 BUDGET  Assembly Third Reading  By EVANS",51,0,29,0,80
60073,6154,2009-05-04,Assembly,"AB 205 BUDGET  Assembly Third Reading  By EVANS",51,0,29,0,80
60074,6158,2009-05-04,Assembly,"AB 206 BUDGET  Assembly Third Reading  By EVANS",51,0,29,0,80
60075,6157,2009-05-04,Assembly,"AB 207 BUDGET  Assembly Third Reading  By EVANS",51,0,29,0,80
60076,6156,2009-05-04,Assembly,"AB 208 BUDGET  Assembly Third Reading  By EVANS",51,0,29,0,80
60077,6155,2009-05-04,Assembly,"AB 209 BUDGET  Assembly Third Reading  By EVANS",51,0,29,0,80
60078,24270,2009-03-31,Assembly,"Do pass and be re-referred to the Committee on Natural Resources",11,0,0,0,11
60078,24271,2009-04-20,Assembly,"Do pass",8,0,0,1,9
60078,24272,2009-05-11,Assembly,"AB 210 HAYASHI  Assembly Third Reading",74,4,0,2,80
60078,24273,2009-06-16,Senate,"Do pass, but re-refer to the Committee on Environmental Quality",10,0,1,0,11
60078,24274,2009-07-06,Senate,"Do pass",7,0,0,0,7
60078,24275,2009-07-16,Senate,"Assembly 3rd Reading AB210 Hayashi By Pavley",33,2,5,0,40
60079,6159,2009-04-01,Assembly,"Do pass as amended and be re-referred to the Committee on Appropriations",11,0,0,0,11
60079,6160,2009-05-28,Assembly,"Do pass as amended",13,3,1,0,17
60079,6161,2009-06-02,Assembly,"AB 211 MENDOZA  Assembly Third Reading",76,0,4,0,80
60079,6162,2009-07-01,Senate,"Do pass, but re-refer to the Committee on Appropriations",6,0,3,0,9
60079,6163,2009-07-13,Senate,"Placed on Appropriations Suspense file",12,0,1,0,13
60079,20030,2010-08-12,Senate,"Do pass as amended",11,0,0,0,11
60079,21318,2010-08-23,Senate,"Assembly 3rd Reading AB211 Mendoza By Wyland",34,0,5,0,39
60079,21319,2010-08-26,Assembly,"AB 211 MENDOZA  Concurrence in Senate Amendments",75,3,0,0,78
60080,6164,2009-04-13,Assembly,"Do pass and be re-referred to the Committee on Appropriations",6,3,0,0,9
60081,6165,2009-03-23,Assembly,"Do pass as amended",14,0,0,0,14
60081,6166,2009-04-02,Assembly,"AB 213 LOWENTHAL  Assembly Third Reading",75,0,5,0,80
60081,6167,2009-06-09,Senate,"Do pass",11,0,0,0,11
60081,6168,2009-08-24,Senate,"Special Consent #15 AB213 Bonnie Lowenthal By Lowenthal",39,0,1,0,40
60081,6169,2009-08-27,Assembly,"AB 213 LOWENTHAL  Concurrence in Senate Amendments",77,0,2,0,79
60082,6170,2009-04-14,Assembly,"Do pass as amended and be re-referred to the Committee on Appropriations",12,4,3,0,19
60083,26481,2009-04-14,Assembly,"Do pass as amended and be re-referred to the Committee on 	Appropriations",13,4,0,2,19
60083,26482,2009-05-06,Assembly,"Do pass",13,0,0,3,16
60083,26483,2009-05-18,Assembly,"AB 215 FEUER  Assembly Third Reading",65,11,0,4,80
60083,26484,2009-06-17,Senate,"Do pass as amended, and re-refer to the Committee on Appropriations",8,2,1,0,11
60083,26485,2009-09-04,Senate,"Assembly 3rd Reading AB215 Feuer By Alquist",30,9,1,0,40
60083,26486,2009-09-09,Assembly,"AB 215 FEUER  Concurrence in Senate Amendments",68,9,0,2,79
60084,6171,2009-04-28,Assembly,"Do pass as amended and be re-referred to the Committee on Appropriations",8,2,0,0,10
60085,6172,2009-04-21,Assembly,"Do pass as amended and re-refer to Committee on Appropriations with recommendation:  To Consent Calendar",19,0,0,0,19
60085,6173,2009-05-28,Assembly,"Do pass as amended",17,0,0,0,17
60085,6174,2009-06-02,Assembly,"AB 217 BEALL  Assembly Third Reading",78,0,2,0,80
60085,6175,2009-07-08,Senate,"Do pass, but re-refer to the Committee on Appropriations",10,1,0,0,11
60085,6176,2009-07-23,Senate,"Placed on Appropriations Suspense file",13,0,0,0,13
60085,6177,2009-08-27,Senate,"Do pass",11,2,0,0,13
60085,6178,2009-09-02,Senate,"Assembly 3rd Reading AB217 Beall By Cedillo",28,4,8,0,40
60086,1792,2009-03-17,Assembly,"Do pass and be re-referred to the Committee on Appropriations",9,0,0,0,9
60086,1793,2009-05-28,Assembly,"Do pass",13,4,0,0,17
60086,1794,2009-06-01,Assembly,"AB 218 PORTANTINO  Assembly Third Reading",74,5,1,0,80
60086,1795,2009-07-08,Senate,"Do pass, but re-refer to the Committee on Appropriations",8,1,0,0,9
60086,1796,2009-07-23,Senate,"Placed on Appropriations Suspense file",13,0,0,0,13
60087,6179,2009-03-25,Assembly,"Do pass",8,0,0,0,8
60087,6180,2009-04-02,Assembly,"AB 219 RUSKIN  Assembly Third Reading",74,0,6,0,80
60087,6181,2009-07-07,Senate,"Do pass and be placed on the Consent Calendar",4,0,1,0,5
60087,21218,2010-08-23,Senate,"Assembly 3rd Reading AB219 Ruskin By Florez",36,0,3,0,39
60087,21219,2010-08-25,Assembly,"Senate amendments be concurred in",8,0,0,0,8
60087,21420,2010-08-26,Assembly,"AB 219 RUSKIN  Concurrence in Senate Amendments",77,0,0,1,78
60088,6187,2010-01-13,Assembly,"Do pass as amended and be re-referred to the Committee on Appropriations",9,0,2,0,11
60088,6188,2010-01-21,Assembly,"Do pass",16,0,1,0,17
60088,6189,2010-01-27,Assembly,"AB 220 BROWNLEY  Assembly Third Reading",72,0,6,0,78
60088,10201,2010-06-30,Senate,"Do pass, but re-refer to the Committee on Appropriations",6,1,2,0,9
60088,19218,2010-08-02,Senate,"Placed on Appropriations Suspense file",10,0,1,0,11
60089,26846,2009-03-31,Assembly,"Do pass and be re-referred to the Committee on Health",10,1,0,0,11
60089,26847,2009-04-21,Assembly,"Do pass and be re-referred to the Committee on Appropriations",17,0,0,2,19
60089,26848,2009-05-06,Assembly,"Do pass",16,0,0,0,16
60089,26849,2009-05-14,Assembly,"AB 221 PORTANTINO  Assembly Third Reading",74,0,0,6,80
60089,26850,2009-07-08,Senate,"Do pass, but re-refer to the Committee on Appropriations",10,1,0,0,11
60089,26851,2009-09-03,Senate,"Assembly 3rd Reading AB221 Portantino Urgency Clause",35,3,2,0,40
60089,26852,2009-09-11,Assembly,"AB 221 PORTANTINO  Concurrence in Senate Amendments",79,0,0,0,79
60090,6183,2009-04-27,Assembly,"Do pass as amended and be re-referred to the Committee on Appropriations",11,0,4,0,15
60090,6184,2009-05-20,Assembly,"Do pass",14,1,1,0,16
60090,6185,2009-06-01,Assembly,"AB 222 ADAMS  Assembly Third Reading",54,13,13,0,80
60090,6186,2009-07-07,Senate,"Do pass, but re-refer to the Committee on Environmental Quality",6,1,4,0,11
60090,10140,2010-06-28,Senate,"Do pass as amended, and re-refer to the Committee on Appropriations",7,0,0,0,7
60090,21904,2010-08-30,Senate,"Do pass as amended, and re-refer to the Committee on Appropriations",4,0,1,0,5
60090,21905,2010-08-31,Senate,"W/O REF. TO FILE AB222 Adams By DeSaulnier",28,7,4,0,39
60090,21906,2010-08-31,Assembly,"AB 222 Adams  Concurrence- Urgency Added",72,2,0,4,78
60091,2005,2009-04-01,Assembly,"Do pass and be re-referred to the Committee on Appropriations",6,3,2,0,11
60091,2006,2010-01-07,Assembly,"Be referred to Committee on Health",10,0,1,0,11
60091,2007,2010-01-12,Assembly,"Do pass and be re-referred to the Committee on Appropriations",18,0,1,0,19
60091,2008,2010-01-21,Assembly,"Do pass, to Consent Calendar",17,0,0,0,17
60091,2009,2010-01-27,Assembly,"AB 223 MA  Consent Calendar Second Day  Regular Session",68,0,10,0,78
60091,6022,2010-06-09,Senate,"Do pass as amended, and re-refer to the Committee on Appropriations",5,0,4,0,9
60091,9899,2010-06-28,Senate,"Do pass",9,0,2,0,11
60091,20982,2010-08-24,Senate,"Assembly 3rd Reading AB223 Ma By Price",30,4,5,0,39
60091,21438,2010-08-26,Assembly,"AB 223 MA  Concurrence in Senate Amendments",66,6,0,6,78
60092,24263,2009-03-17,Assembly,"Do pass as amended and be re-referred to the Committee on 	Appropriations",9,0,0,0,9
60092,24264,2009-04-01,Assembly,"Do pass as amended",16,0,0,1,17
60092,24265,2009-04-20,Assembly,"AB 224 PORTANTINO  Assembly Third Reading",75,0,0,5,80
60092,24266,2009-08-27,Senate,"Do pass as amended",5,0,0,0,5
60092,24267,2009-09-04,Senate,"Special Consent #19 AB224 Portantino By Simitian",40,0,0,0,40
60092,24268,2009-09-10,Assembly,"Senate amendments be concurred in",10,0,0,0,10
60092,24269,2009-09-11,Assembly,"AB 224 PORTANTINO  Concurrence- Urgency Added",78,0,0,1,79
60094,6193,2009-04-13,Assembly,"Do pass and be re-referred to the Committee on Judiciary",6,3,0,0,9
60094,6194,2009-04-21,Assembly,"Do pass as amended and be re-referred to the Committee on Appropriations",7,3,0,0,10
60094,6195,2009-05-20,Assembly,"Do pass",10,4,2,0,16
60094,6196,2009-06-01,Assembly,"AB 226 RUSKIN  Assembly Third Reading",47,31,2,0,80
60094,6197,2009-06-23,Senate,"Do pass, but re-refer to the Committee on Judiciary",7,4,0,0,11
60094,6198,2009-07-14,Senate,"Do pass as amended, and re-refer to the Committee on Appropriations",3,2,0,0,5
60094,6199,2009-08-17,Senate,"Placed on Appropriations Suspense file",13,0,0,0,13
60094,6200,2009-08-27,Senate,"Do pass",8,5,0,0,13
60094,21725,2010-08-30,Senate,"Do pass",5,1,0,0,6
60094,21726,2010-08-30,Senate,"W/O REF. TO FILE AB226 Torrico Urgency Clause",27,8,4,0,39
60094,21816,2010-08-31,Assembly,"Senate amendments be concurred in",6,0,0,0,6
60094,21817,2010-08-31,Assembly,"AB 226 TORRICO  Concurrence- Urgency Added",75,0,0,3,78
60096,3660,2009-04-13,Assembly,"Do pass as amended and be re-referred to the Committee on Natural Resources",9,5,1,0,15
60096,3661,2009-04-27,Assembly,"Do pass and be re-referred to the Committee on Appropriations",6,3,0,0,9
60096,3662,2009-05-06,Assembly,"Do pass",10,5,1,0,16
60096,3663,2009-05-18,Assembly,"AB 228 HUFFMAN  Assembly Third Reading",45,31,4,0,80
60096,10267,2010-06-29,Senate,"Do pass as amended, and re-refer to the Committee on Appropriations",0,1,10,0,11
60097,6191,2010-01-11,Assembly,"Do pass, to Consent Calendar",8,0,1,0,9
60097,6192,2010-01-19,Assembly,"AB 229 CALDERON  Consent Calendar Second Day",71,0,7,0,78
60097,8729,2010-06-15,Senate,"Do pass",5,0,0,0,5
60097,9611,2010-06-28,Senate,"Special Consent #28 AB229 Charles Calderon",32,0,7,0,39
60098,6201,2010-01-11,Assembly,"Do pass, to Consent Calendar",8,0,1,0,9
60098,6202,2010-01-19,Assembly,"AB 230 CALDERON  Consent Calendar Second Day  Regular Session",71,0,7,0,78
60099,6203,2009-04-20,Assembly,"Do pass as amended and be re-referred to the Committee on Appropriations",6,3,0,0,9
60099,6204,2009-05-28,Assembly,"Do pass",11,5,1,0,17
60099,6205,2009-06-02,Assembly,"AB 231 HUFFMAN  Assembly Third Reading",45,31,4,0,80
60099,19084,2010-08-02,Senate,"Do pass as amended, and re-refer to the Committee on 	Appropriations",5,0,2,0,7
60099,21014,2010-08-24,Senate,"Assembly 3rd Reading AB231 Huber Urgency Clause",28,1,10,0,39
60099,21970,2010-08-31,Assembly,"AB 231 Huber  Concurrence- Urgency Added",57,10,0,11,78
60100,24345,2009-04-01,Assembly,"Do pass and be re-referred to the Committee on Appropriations",6,0,0,0,6
60100,24346,2009-04-22,Assembly,"Do pass, to Consent Calendar",16,0,0,1,17
60100,24347,2009-05-04,Assembly,"AB 232 HILL  Consent Calendar Second Day  Regular Session",79,0,0,1,80
60100,24348,2009-06-08,Senate,"Do pass, but re-refer to the Committee on Appropriations Recommend 	Consent",7,0,0,0,7
60100,24349,2009-06-29,Senate,"Special Consent #11 AB232 Hill",40,0,0,0,40
60101,6206,2009-05-18,Assembly,"Do pass as amended and be re-referred to the Committee on Appropriations",9,0,0,0,9
60102,1955,2009-04-20,Assembly,"Do pass as amended and be re-referred to the Committee on Water, Parks and Wildlife",15,0,0,0,15
60102,1956,2009-04-28,Assembly,"Do pass and re-refer to Committee on Appropriations with recommendation:  To Consent Calendar",13,0,0,0,13
60102,1957,2009-05-13,Assembly,"Do pass as amended, to Consent Calendar",16,0,0,0,16
60102,1958,2009-05-21,Assembly,"AB 234 HUFFMAN  Consent Calendar Second Day  Regular Session",77,0,3,0,80
60102,1959,2009-07-07,Senate,"Do pass as amended, and re-refer to the Committee on Environmental Quality",11,0,0,0,11
60102,1960,2009-08-24,Senate,"Placed on Appropriations Suspense file",13,0,0,0,13
60102,8707,2010-06-14,Senate,"Do pass, but re-refer to the Committee on Natural Resources and Water",5,2,0,0,7
60102,9737,2010-06-29,Senate,"Do pass as amended, and re-refer to the Committee on Appropriations",6,3,0,0,9
60102,19134,2010-08-02,Senate,"Do pass as amended",7,1,3,0,11
60102,21157,2010-08-23,Senate,"Assembly 3rd Reading AB234 Huffman By Leno",21,14,4,0,39
60102,21369,2010-08-26,Assembly,"Senate amendments be concurred in",6,3,0,0,9
60102,21685,2010-08-30,Assembly,"AB 234 HUFFMAN  Concurrence in Senate Amendments",45,28,0,5,78
60103,26533,2009-03-31,Assembly,"Do pass as amended and be re-referred to the Committee on 	Appropriations",19,0,0,0,19
60103,26534,2009-04-29,Assembly,"Do pass, to Consent Calendar",16,0,0,0,16
60103,26535,2009-05-11,Assembly,"AB 235 HAYASHI  Consent Calendar Second Day  Regular Session",78,0,0,2,80
60103,26536,2009-06-17,Senate,"Do pass, but re-refer to the Committee on Appropriations",8,2,1,0,11
60103,26537,2009-06-29,Senate,"Do pass",10,1,2,0,13
60103,26538,2009-08-27,Senate,"Assembly 3rd Reading AB235 Hayashi By Correa",34,3,3,0,40
60103,26539,2009-08-31,Assembly,"AB 235 HAYASHI  Concurrence in Senate Amendments",78,0,0,1,79
60104,26839,2009-04-22,Assembly,"Do pass and be re-referred to the Committee on Appropriations",6,1,0,0,7
60104,26840,2009-05-28,Assembly,"Do pass",12,5,0,0,17
60104,26841,2009-06-02,Assembly,"AB 236 SWANSON  Assembly Third Reading",51,27,0,2,80
60104,26842,2009-07-08,Senate,"Do pass, but re-refer to the Committee on Appropriations",4,2,0,0,6
60104,26843,2009-08-17,Senate,"Do pass",8,5,0,0,13
60104,26844,2009-09-03,Senate,"Assembly 3rd Reading AB236 Swanson By Price",24,15,1,0,40
60104,26845,2009-09-09,Assembly,"AB 236 SWANSON  Concurrence in Senate Amendments",51,26,0,2,79
60105,6207,2009-04-14,Assembly,"Do pass as amended and be re-referred to the Committee on Appropriations",7,0,0,0,7
60105,6208,2009-05-06,Assembly,"Do pass, to Consent Calendar",16,0,0,0,16
60105,6209,2009-05-14,Assembly,"AB 237 CARTER  Consent Calendar Second Day  Regular Session",73,0,7,0,80
60105,6210,2009-06-09,Senate,"Do pass as amended, and re-refer to the Committee on Rules",8,1,2,0,11
60107,24350,2009-03-18,Assembly,"Do pass and re-refer to Committee on Appropriations with 	recommendation:  To Consent Calendar",10,0,0,1,11
60107,24351,2009-04-01,Assembly,"Do pass",16,0,0,1,17
60107,24352,2009-04-20,Assembly,"AB 239 BROWNLEY  Assembly Third Reading",76,0,0,4,80
60107,24353,2009-06-10,Senate,"Do pass as amended, but re-refer to the Committee on Appropriations 	Recommend Consent",8,0,1,0,9
60107,24354,2009-07-09,Senate,"Special Consent #12 AB239 Brownley",34,0,6,0,40
60107,24355,2009-08-20,Assembly,"AB 239 BROWNLEY  Concurrence in Senate Amendments",77,0,0,2,79
60108,24339,2009-03-17,Assembly,"Do pass and re-refer to Committee on Appropriations with 	recommendation:  To Consent Calendar",10,0,0,1,11
60108,24340,2009-04-01,Assembly,"Do pass",16,0,0,1,17
60108,24341,2009-04-13,Assembly,"AB 240 MONNING  Assembly Third Reading",78,0,0,2,80
60108,24342,2009-07-08,Senate,"Do pass, but re-refer to the Committee on Appropriations Recommend 	Consent",11,0,2,0,13
60108,24343,2009-09-09,Senate,"Special Consent #20 AB240 Monning By Simitian",40,0,0,0,40
60108,24344,2009-09-11,Assembly,"AB 240 MONNING  Concurrence in Senate Amendments",79,0,0,0,79
60109,6211,2009-04-14,Assembly,"Do pass and be re-referred to the Committee on Business and Professions",5,2,0,0,7
60109,6212,2009-04-28,Assembly,"Do pass and be re-referred to the Committee on Appropriations",8,2,1,0,11
60109,6213,2009-05-13,Assembly,"Do pass",13,3,0,0,16
60109,6214,2009-05-21,Assembly,"AB 241 NAVA  Assembly Third Reading",60,14,6,0,80
60109,6215,2009-07-14,Senate,"Do pass as amended, and re-refer to the Committee on Appropriations",3,3,1,0,7
60109,6216,2009-07-14,Senate,"Set, first hearing.  Failed passage in Committee.  Reconsideration granted",6,0,1,0,7
60109,6217,2009-07-16,Senate,"Do pass as amended, and re-refer to the Committee on Appropriations",4,0,3,0,7
60109,6218,2009-09-02,Senate,"Assembly 3rd Reading AB241 Nava By Florez",25,9,6,0,40
60109,6219,2009-09-08,Assembly,"AB 241 NAVA  Concurrence in Senate Amendments",59,17,3,0,79
60110,26873,2009-04-14,Assembly,"Do pass as amended and be re-referred to the Committee on 	Appropriations",7,0,0,0,7
60110,26874,2009-05-28,Assembly,"Do pass as amended",17,0,0,0,17
60110,26875,2009-06-02,Assembly,"AB 242 NAVA  Assembly Third Reading",77,0,0,3,80
60110,26876,2009-07-14,Senate,"Do pass, but re-refer to the Committee on Appropriations",6,0,1,0,7
60110,26877,2009-09-01,Senate,"Assembly 3rd Reading AB242 Nava By Strickland",30,1,9,0,40
60111,6220,2009-04-14,Assembly,"Do pass and be re-referred to the Committee on Appropriations",6,0,1,0,7
60111,6221,2009-05-20,Assembly,"Do pass as amended",13,1,2,0,16
60111,6222,2009-06-02,Assembly,"AB 243 NAVA  Assembly Third Reading",65,12,3,0,80
60111,6223,2009-07-14,Senate,"Do pass as amended, and re-refer to the Committee on Appropriations",7,0,0,0,7
60111,6224,2009-08-17,Senate,"Do pass",9,0,4,0,13
60111,6225,2009-09-03,Senate,"Assembly 3rd Reading AB243 Nava By Florez",28,4,8,0,40
60111,6226,2009-09-09,Assembly,"AB 243 NAVA  Concurrence in Senate Amendments",74,0,5,0,79
60112,451,2009-04-28,Assembly,"Do pass as amended and be re-referred to the Committee on Appropriations.",12,5,2,0,19
60112,452,2009-05-28,Assembly,"Do pass.",12,5,0,0,17
60112,453,2009-06-01,Assembly,"AB 244 BEALL  Assembly Third Reading",50,29,1,0,80
60112,454,2009-07-15,Senate,"Do pass, but re-refer to the Committee on Appropriations.",6,3,2,0,11
60112,455,2009-08-17,Senate,"Do pass.",8,4,1,0,13
60112,456,2009-09-03,Senate,"Assembly 3rd Reading AB244 Beall By Ashburn",24,11,5,0,40
60112,457,2009-09-09,Assembly,"AB 244 BEALL  Concurrence in Senate Amendments",49,26,4,0,79
60113,6227,2009-04-14,Assembly,"Do pass and be re-referred to the Committee on Judiciary",9,0,2,0,11
60113,6228,2009-05-28,Assembly,"Do pass as amended",14,3,0,0,17
60113,6229,2009-06-02,Assembly,"AB 245 MA  Assembly Third Reading",76,1,3,0,80
60113,6230,2009-06-29,Senate,"Do pass, but re-refer to the Committee on Judiciary",10,0,0,0,10
60113,6231,2009-09-03,Senate,"Assembly 3rd Reading AB245 Ma By Florez",38,0,2,0,40
60113,6232,2009-09-09,Assembly,"AB 245 MA  Concurrence in Senate Amendments",78,0,1,0,79
60114,26351,2009-04-01,Assembly,"Do pass and re-refer to Committee on Appropriations with 	recommendation:  To Consent Calendar",19,0,0,0,19
60114,26352,2009-04-22,Assembly,"Do pass, to Consent Calendar",16,0,0,1,17
60114,26353,2009-05-04,Assembly,"AB 246 PRICE  Consent Calendar Second Day  Regular Session",79,0,0,1,80
60114,26354,2009-06-23,Senate,"Do pass as amended, and re-refer to the Committee on 	Appropriations",12,0,1,0,13
60114,26355,2009-08-27,Senate,"Assembly 3rd Reading AB246 Price Urgency Clause",38,0,2,0,40
60114,26356,2009-09-09,Assembly,"Senate amendments be concurred in",15,0,0,4,19
60114,26357,2009-09-11,Assembly,"AB 246  Concurrence in Senate Amendments By COTO",78,0,0,1,79
60115,26813,2009-03-31,Assembly,"Do pass and re-refer to Committee on Appropriations with 	recommendation:  To Consent Calendar",7,0,0,0,7
60115,26814,2009-04-22,Assembly,"Do pass, to Consent Calendar",16,0,0,1,17
60115,26815,2009-05-04,Assembly,"AB 247 EMMERSON  Consent Calendar Second Day  Regular Session",79,0,0,1,80
60115,26816,2009-06-09,Senate,"Do pass, but re-refer to the Committee on Appropriations",7,0,0,0,7
60115,26817,2009-06-29,Senate,"Special Consent #11 AB247 Emmerson",40,0,0,0,40
60116,24332,2009-03-24,Assembly,"Do pass and re-refer to Committee on Appropriations with 	recommendation:  To Consent Calendar",6,0,0,1,7
60116,24333,2009-04-01,Assembly,"Do pass, to Consent Calendar",16,0,0,1,17
60116,24334,2009-04-16,Assembly,"AB 248 LOWENTHAL  Consent Calendar Second Day  Regular Session",70,0,0,10,80
60116,24335,2009-06-22,Senate,"Do pass as amended, and re-refer to the Committee on 	Appropriations",6,1,0,0,7
60116,24336,2009-07-06,Senate,"Do pass as amended",11,0,2,0,13
60116,24337,2009-08-27,Senate,"Assembly 3rd Reading AB248 Bonnie Lowenthal By Kehoe",36,2,2,0,40
60116,24338,2009-08-31,Assembly,"AB 248 LOWENTHAL  Concurrence in Senate Amendments",78,0,0,1,79
60117,6233,2009-04-28,Assembly,"Do pass as amended and be re-referred to the Committee on Appropriations",17,0,2,0,19
60117,6234,2009-05-20,Assembly,"Do pass, to Consent Calendar",15,0,1,0,16
60117,6235,2009-05-28,Assembly,"AB 249 CARTER  Consent Calendar Second Day  Regular Session",76,0,4,0,80
60117,6236,2009-06-17,Senate,"Do pass, but re-refer to the Committee on Appropriations",10,0,1,0,11
60117,6237,2009-08-24,Senate,"Assembly 3rd Reading AB249 Carter By Aanestad",38,0,2,0,40
60118,24328,2009-05-12,Assembly,"Do pass",7,0,0,0,7
60118,24329,2009-05-18,Assembly,"AB 250 MILLER  Assembly Third Reading",74,0,0,6,80
60118,24330,2009-06-16,Senate,"Do pass",6,0,1,0,7
60118,24331,2009-08-24,Senate,"Assembly 3rd Reading AB250 Miller By Benoit",38,0,2,0,40
60119,6238,2009-04-22,Assembly,"Do pass",2,2,3,0,7
60120,6239,2009-03-31,Assembly,"Do pass and be re-referred to the Committee on Appropriations",11,0,0,0,11
60120,6240,2009-04-22,Assembly,"Do pass, to Consent Calendar",16,0,1,0,17
60120,6241,2009-05-04,Assembly,"AB 252 CARTER  Consent Calendar Second Day  Regular Session",79,0,1,0,80
60120,6242,2009-06-08,Senate,"Do pass, but re-refer to the Committee on Appropriations",7,0,3,0,10
60120,6243,2009-07-16,Senate,"Assembly 3rd Reading AB252 Carter By Negrete McLeod",35,1,4,0,40
60122,24322,2009-04-27,Assembly,"Do pass and be re-referred to the Committee on Appropriations",12,0,0,2,14
60122,24323,2009-05-13,Assembly,"Do pass, to Consent Calendar",15,0,0,1,16
60122,24324,2009-05-21,Assembly,"AB 254 JEFFRIES  Consent Calendar Second Day  Regular Session",77,0,0,3,80
60122,24325,2009-06-23,Senate,"Do pass as amended, and re-refer to the Committee on 	Appropriations",11,0,0,0,11
60122,24326,2009-08-27,Senate,"Assembly 3rd Reading AB254 Jeffries By Huff",35,0,5,0,40
60122,24327,2009-08-31,Assembly,"AB 254 JEFFRIES  Concurrence in Senate Amendments",78,0,0,1,79
60125,6244,2009-04-30,Assembly,"Do pass as amended and be re-referred to the Committee on Appropriations",7,0,0,0,7
60125,6245,2009-05-20,Assembly,"Do pass, to Consent Calendar",15,0,1,0,16
60125,6246,2009-05-28,Assembly,"AB 257 ADAMS  Consent Calendar Second Day  Regular Session",76,0,4,0,80
60125,6247,2009-07-07,Senate,"Do pass, but re-refer to the Committee on Appropriations Recommend Consent",5,0,0,0,5
60125,6248,2009-08-17,Senate,"Placed on Appropriations Suspense file",13,0,0,0,13
60126,24318,2009-03-17,Assembly,"Do pass, to Consent Calendar",6,0,0,1,7
60126,24319,2009-03-23,Assembly,"AB 258 MA  Consent Calendar Second Day  Regular Session",77,0,0,3,80
60126,24320,2009-06-09,Senate,"Do pass",7,0,0,0,7
60126,24321,2009-06-22,Senate,"Special Consent #9 AB258 Ma",40,0,0,0,40
60128,26878,2009-03-23,Assembly,"Do pass and be re-referred to the Committee on Judiciary",7,3,0,1,11
60128,26879,2009-04-14,Assembly,"Do pass and be re-referred to the Committee on Appropriations",7,3,0,0,10
60128,26880,2009-05-28,Assembly,"Do pass",12,5,0,0,17
60128,26881,2009-06-01,Assembly,"AB 260 LIEU  Assembly Third Reading",50,28,0,2,80
60128,26882,2009-07-09,Senate,"Do pass, but re-refer to the Committee on Judiciary",7,3,2,0,12
60128,26883,2009-07-14,Senate,"Do pass as amended, and re-refer to the Committee on 	Appropriations",3,2,0,0,5
60128,26884,2009-08-17,Senate,"Placed on Appropriations Suspense file",13,0,0,0,13
60128,26885,2009-08-27,Senate,"Do pass",8,5,0,0,13
60128,26886,2009-09-08,Senate,"Assembly 3rd Reading AB260 Lieu By Corbett",22,18,0,0,40
60128,26887,2009-09-10,Assembly,"AB 260 LIEU  Concurrence in Senate Amendments",50,26,0,4,80
60129,6255,2009-03-18,Assembly,"Do pass and be re-referred to the Committee on Judiciary",10,0,1,0,11
60129,6256,2009-03-31,Assembly,"Do pass",10,0,0,0,10
60129,6257,2009-04-20,Assembly,"AB 261 SALAS  Assembly Third Reading",76,0,4,0,80
60129,6258,2009-06-17,Senate,"Do pass, but re-refer to the Committee on Judiciary",9,0,0,0,9
60129,6259,2009-07-07,Senate,"Do pass as amended. To Consent Calendar",5,0,0,0,5
60129,6260,2009-07-16,Senate,"Consent Calendar 2nd AB261 Salas",36,0,4,0,40
60129,6261,2009-08-17,Assembly,"AB 261 SALAS  Concurrence in Senate Amendments",77,0,2,0,79
60130,24310,2009-04-27,Assembly,"Do pass and be re-referred to the Committee on Appropriations",11,3,0,1,15
60130,24311,2009-05-28,Assembly,"Do pass",13,4,0,0,17
60130,24312,2009-06-02,Assembly,"AB 262 BASS  Assembly Third Reading",58,15,0,7,80
60130,24313,2009-07-07,Senate,"Do pass as amended, and re-refer to the Committee on Appropriations",11,0,0,0,11
60130,24314,2009-08-24,Senate,"Placed on Appropriations Suspense file",13,0,0,0,13
60130,24315,2009-08-27,Senate,"Do pass as amended",12,0,1,0,13
60130,24316,2009-09-03,Senate,"Assembly 3rd Reading AB262 Bass By Padilla",37,0,3,0,40
60130,24317,2009-09-10,Assembly,"AB 262 BASS  Concurrence in Senate Amendments By FUENTES",76,1,0,3,80
60132,6249,2009-04-01,Assembly,"Do pass and re-refer to Committee on Appropriations with recommendation:  To Consent Calendar",19,0,0,0,19
60132,6250,2009-04-22,Assembly,"Do pass as amended, to Consent Calendar",16,0,1,0,17
60132,6251,2009-05-04,Assembly,"AB 264 COOK  Consent Calendar Second Day  Regular Session",79,0,1,0,80
60132,6252,2009-07-08,Senate,"Do pass and be placed on the Consent Calendar",7,0,2,0,9
60132,6253,2009-07-16,Senate,"Consent Calendar 2nd AB264 Cook",36,0,4,0,40
60132,6254,2009-08-24,Assembly,"AB 264 COOK  Concurrence in Senate Amendments",76,0,3,0,79
60133,24396,2009-05-05,Assembly,"Do pass, to Consent Calendar",7,0,0,0,7
60133,24397,2009-05-11,Assembly,"AB 265 COOK  Consent Calendar Second Day  Regular Session",78,0,0,2,80
60133,24398,2009-06-23,Senate,"Do pass",12,0,1,0,13
60133,24399,2009-06-29,Senate,"Special Consent #11 AB265 Cook",40,0,0,0,40
60134,6262,2009-04-13,Assembly,"Do pass as amended and be re-referred to the Committee on Appropriations",11,2,1,0,14
60134,6263,2009-05-28,Assembly,"Do pass",12,5,0,0,17
60134,6264,2009-06-01,Assembly,"AB 266 CARTER  Assembly Third Reading",58,20,2,0,80
60135,6265,2009-05-11,Assembly,"Do pass as amended",6,3,0,0,9
60135,6266,2009-06-03,Assembly,"AB 267 TORLAKSON  Assembly Third Reading",46,30,4,0,80
60135,6267,2009-07-08,Senate,"Do pass",5,3,0,0,8
60135,6268,2009-07-08,Senate,"Do pass, but re-refer to the Committee on Revenue and Taxation",6,3,0,0,9
60135,6269,2009-09-03,Senate,"Assembly 3rd Reading AB267 Torlakson By Wolk",24,14,2,0,40
60135,6270,2009-09-10,Assembly,"AB 267 TORLAKSON  Concurrence in Senate Amendments",48,29,3,0,80
60136,6271,2009-04-14,Assembly,"Do pass and be re-referred to the Committee on Appropriations",2,5,0,0,7
60136,6272,2009-04-14,Assembly,"Set first hearing.  Failed passage.  Reconsideration granted",7,0,0,0,7
60137,25785,2009-04-21,Assembly,"Do pass and re-refer to Committee on Appropriations with 	recommendation:  To Consent Calendar",7,0,0,0,7
60137,25786,2009-04-29,Assembly,"Do pass, to Consent Calendar",16,0,0,0,16
60137,25787,2009-05-11,Assembly,"AB 269 SILVA  Consent Calendar Second Day  Regular Session",78,0,0,2,80
60137,25788,2009-06-16,Senate,"Do pass, but re-refer to the Committee on Appropriations Recommend 	Consent",5,0,0,0,5
60137,25789,2009-06-29,Senate,"Special Consent #11 AB269 Silva",40,0,0,0,40
60138,6273,2009-03-24,Assembly,"Do pass as amended and be re-referred to the Committee on Judiciary",6,0,1,0,7
60138,6274,2009-04-21,Assembly,"Do pass as amended and be re-referred to the Committee on Appropriations",9,1,0,0,10
60139,25053,2009-05-06,Assembly,"Do pass, to Consent Calendar",7,0,0,0,7
60139,25054,2009-05-14,Assembly,"AB 271 SOLORIO  Consent Calendar Second Day  Regular Session",73,0,0,7,80
60139,25055,2009-06-25,Senate,"Do pass and be placed on the Consent Calendar",6,0,0,0,6
60139,25056,2009-07-09,Senate,"Consent Calendar 2nd AB271 Solorio",34,0,6,0,40
60140,6275,2009-04-22,Assembly,"Do pass as amended and be re-referred to the Committee on Appropriations",8,1,2,0,11
60142,24400,2009-04-13,Assembly,"Do pass and be re-referred to the Committee on Appropriations",9,0,0,0,9
60142,24401,2009-05-28,Assembly,"Do pass",17,0,0,0,17
60142,24402,2009-06-01,Assembly,"AB 274 PORTANTINO  Assembly Third Reading",79,0,0,1,80
60142,24403,2009-07-06,Senate,"Do pass as amended, and re-refer to the Committee on 	Appropriations",5,2,0,0,7
60142,24404,2009-08-17,Senate,"Placed on Appropriations Suspense file",13,0,0,0,13
60142,24405,2009-08-27,Senate,"Do pass as amended",8,5,0,0,13
60142,24406,2009-09-09,Senate,"Assembly 3rd Reading AB274 Portantino By Simitian",26,12,2,0,40
60142,24407,2009-09-10,Assembly,"AB 274 Portantino  Concurrence in Senate Amendments",55,23,0,2,80
60143,24390,2009-03-17,Assembly,"Do pass as amended and be re-referred to the Committee on 	Appropriations",5,0,0,2,7
60143,24391,2009-05-28,Assembly,"Do pass",16,0,0,1,17
60143,24392,2009-06-02,Assembly,"AB 275 SOLORIO  Third Reading Urgency",76,0,0,4,80
60143,24393,2009-07-14,Senate,"Do pass, but re-refer to the Committee on Appropriations",5,0,2,0,7
60143,24394,2009-08-17,Senate,"Do pass",9,0,4,0,13
60143,24395,2009-09-03,Senate,"Assembly 3rd Reading AB275 Solorio Urgency Clause",30,4,6,0,40
60144,6276,2009-04-21,Assembly,"Do pass and be re-referred to the Committee on Appropriations",11,0,0,0,11
60145,6277,2009-05-06,Assembly,"Do pass as amended",5,2,0,0,7
60145,6278,2009-05-21,Assembly,"AB 277 AMMIANO  Assembly Third Reading",50,29,1,0,80
60145,6279,2009-06-16,Senate,"Do pass",6,4,1,0,11
60145,6280,2009-07-16,Senate,"Assembly 3rd Reading AB277 Ammiano By Yee",23,12,5,0,40
60146,2116,2009-05-11,Assembly,"Do pass, to Consent Calendar",9,0,0,0,9
60146,2117,2009-05-18,Assembly,"AB 278 CALDERON  Consent Calendar Second Day  Regular Session",77,0,3,0,80
60146,10350,2010-06-30,Senate,"Do pass as amended, and re-refer to the Committee on Appropriations",6,2,1,0,9
60146,19157,2010-08-02,Senate,"Placed on Appropriations Suspense file",10,0,1,0,11
60146,20262,2010-08-12,Senate,"Do pass as amended",7,4,0,0,11
60146,20557,2010-08-19,Senate,"Assembly 3rd Reading AB278 Monning By Alquist",23,12,3,0,38
60146,21135,2010-08-24,Assembly,"Senate amendments be concurred in",18,0,0,0,18
60146,21324,2010-08-26,Assembly,"AB 278 MONNING  Concurrence in Senate Amendments",58,19,0,1,78
60148,6281,2009-04-01,Assembly,"Do pass and be re-referred to the Committee on Appropriations",10,0,0,0,10
60149,24383,2009-04-29,Assembly,"Do pass as amended and be re-referred to the Committee on 	Appropriations",8,0,0,0,8
60149,24384,2009-05-28,Assembly,"Do pass",17,0,0,0,17
60149,24385,2009-06-01,Assembly,"AB 281 DE LEON  Assembly Third Reading",77,0,0,3,80
60149,24386,2009-07-07,Senate,"Do pass, but re-refer to the Committee on Appropriations",4,0,1,0,5
60149,24387,2009-07-23,Senate,"Do pass as amended",13,0,0,0,13
60149,24388,2009-09-04,Senate,"Assembly 3rd Reading AB281 De Leon Urgency Clause",38,0,2,0,40
60149,24389,2009-09-11,Assembly,"AB 281 DE LEON  Concurrence in Senate Amendments",78,0,0,1,79
60150,25418,2009-04-20,Assembly,"Do pass and re-refer to Committee on Appropriations with 	recommendation:  To Consent Calendar",12,0,0,2,14
60150,25419,2009-04-29,Assembly,"Do pass, to Consent Calendar",16,0,0,0,16
60150,25420,2009-05-11,Assembly,"AB 282 TRANS.  Consent Calendar Second Day  Regular Session",78,0,0,2,80
60150,25421,2009-07-07,Senate,"Do pass as amended, but re-refer to the Committee on Appropriations 	Recommend Consent",10,0,1,0,11
60150,25422,2009-09-04,Senate,"Assembly 3rd Reading AB282 Committee on TRANS. (Eng) By Lowenthal",39,0,1,0,40
60150,25423,2009-09-09,Assembly,"AB 282 TRANS.  Concurrence in Senate Amendments By ENG",78,0,0,1,79
60151,6282,2009-04-20,Assembly,"Do pass as amended and be re-referred to the Committee on Appropriations",5,3,1,0,9
60153,24377,2009-03-23,Assembly,"Do pass and be re-referred to the Committee on Judiciary",10,0,0,1,11
60153,24378,2009-03-31,Assembly,"Do pass, to Consent Calendar",10,0,0,0,10
60153,24379,2009-04-13,Assembly,"AB 285 TRAN  Consent Calendar Second Day",78,0,0,2,80
60153,24380,2009-06-09,Senate,"Do pass",5,0,0,0,5
60153,24381,2009-06-22,Senate,"Special Consent #9 AB285 Tran",40,0,0,0,40
60153,24382,2009-06-25,Assembly,"AB 285 TRAN  Concurrence in Senate Amendments",77,0,0,2,79
60154,24369,2009-04-01,Assembly,"Do pass and be re-referred to the Committee on Transportation",5,2,0,0,7
60154,24370,2009-04-27,Assembly,"Do pass and be re-referred to the Committee on Appropriations",8,5,0,1,14
60154,24371,2009-05-28,Assembly,"Do pass",12,5,0,0,17
60154,24372,2009-06-03,Assembly,"AB 286 SALAS  Assembly Third Reading",48,29,0,3,80
60154,24373,2009-07-07,Senate,"Do pass, but re-refer to the Committee on Appropriations",7,3,1,0,11
60154,24374,2009-08-17,Senate,"Do pass",8,1,4,0,13
60154,24375,2009-09-03,Senate,"Assembly 3rd Reading AB286 Salas By Lowenthal",24,13,3,0,40
60154,24376,2009-09-10,Assembly,"AB 286 SALAS  Concurrence in Senate Amendments",49,28,0,3,80
60155,25811,2009-04-28,Assembly,"Do pass and be re-referred to the Committee on Appropriations",5,2,0,0,7
60155,25812,2009-05-13,Assembly,"Do pass",12,4,0,0,16
60155,25813,2009-05-21,Assembly,"AB 287 BEALL  Assembly Third Reading  Amend By BEALL  Set #1",50,24,0,6,80
60155,25814,2009-05-28,Assembly,"AB 287 BEALL  Assembly Third Reading",53,24,0,3,80
60155,25815,2009-06-23,Senate,"Do pass, but re-refer to the Committee on Appropriations",4,1,0,0,5
60155,25816,2009-08-17,Senate,"Placed on Appropriations Suspense file",13,0,0,0,13
60155,25817,2009-08-27,Senate,"Do pass as amended",8,5,0,0,13
60155,25818,2009-09-03,Senate,"Assembly 3rd Reading AB287 Beall By Alquist",26,10,4,0,40
60155,25819,2009-09-09,Assembly,"AB 287 BEALL  Concurrence in Senate Amendments",50,25,0,4,79
60156,4310,2009-04-01,Assembly,"Do pass and be re-referred to the Committee on Appropriations",7,0,0,0,7
60156,4311,2009-04-22,Assembly,"Do pass, to Consent Calendar",16,0,1,0,17
60156,4312,2009-05-04,Assembly,"AB 288 NESTANDE  Consent Calendar Second Day  Regular Session",79,0,1,0,80
60156,4313,2009-05-20,Senate,"Do pass, but re-refer to the Committee on Appropriations Recommend Consent",5,0,0,0,5
60156,10215,2010-06-29,Senate,"Do pass as amended",3,1,5,0,9
60156,10216,2010-06-29,Senate,"Set, second hearing.  Failed passage in Committee. Reconsideration granted",9,0,0,0,9
60157,4790,2009-04-27,Assembly,"Do pass",13,0,1,0,14
60157,4791,2009-05-18,Assembly,"AB 289 GALGIANI  Assembly Third Reading",72,3,5,0,80
60157,10167,2010-06-29,Senate,"Do pass as amended, and re-refer to the Committee on Appropriations",8,0,1,0,9
60157,19176,2010-08-02,Senate,"Placed on Appropriations Suspense file",10,0,1,0,11
60157,20225,2010-08-12,Senate,"Do pass as amended",7,3,1,0,11
60157,21540,2010-08-27,Senate,"Assembly 3rd Reading AB289 Galgiani Urgency Clause",23,8,8,0,39
60157,21541,2010-08-27,Senate,"Assembly 3rd Reading AB289 Galgiani Suspend Senate Rules",21,11,7,0,39
60157,21542,2010-08-27,Senate,"Assembly 3rd Reading AB289 Galgiani By DeSaulnier",21,9,9,0,39
60157,21856,2010-08-31,Assembly,"AB 289 Galgiani  Concurrence in Senate Amendments",56,18,0,4,78
60159,6283,2009-04-13,Assembly,"Do pass as amended and be re-referred to the Committee on Appropriations",6,3,0,0,9
60159,6284,2009-05-13,Assembly,"Do pass",9,6,1,0,16
60159,6285,2009-05-28,Assembly,"AB 291 SALDANA  Assembly Third Reading",44,29,7,0,80
60159,6286,2009-06-23,Senate,"Do pass, but re-refer to the Committee on Appropriations",6,4,1,0,11
60159,6287,2009-08-17,Senate,"Do pass",7,4,2,0,13
60159,6288,2009-09-09,Senate,"Assembly 3rd Reading AB291 Saldana Reconsider",39,0,1,0,40
60159,21572,2010-08-27,Senate,"Assembly 3rd Reading AB291 Saldana By Ducheny",32,0,7,0,39
60159,21658,2010-08-30,Assembly,"AB 291 Saldaa  Concurrence in Senate Amendments",67,8,0,3,78
60160,26125,2009-04-13,Assembly,"Do pass as amended and be re-referred to the Committee on 	Appropriations",8,0,0,1,9
60160,26126,2009-04-29,Assembly,"Do pass",16,0,0,0,16
60160,26127,2009-05-11,Assembly,"AB 292 YAMADA  Assembly Third Reading",79,0,0,1,80
60160,26128,2009-06-10,Senate,"Do pass, but re-refer to the Committee on Appropriations",6,1,1,0,8
60160,26129,2009-06-29,Senate,"Do pass",11,0,2,0,13
60160,26130,2009-08-20,Senate,"Assembly 3rd Reading AB292 Yamada By Leno",31,1,8,0,40
60160,26131,2009-08-24,Assembly,"AB 292 YAMADA  Concurrence in Senate Amendments",75,0,0,4,79
60161,24364,2009-04-01,Assembly,"Do pass as amended and be re-referred to the Committee on 	Appropriations",17,1,0,1,19
60161,24365,2009-04-22,Assembly,"Do pass",11,2,0,4,17
60161,24366,2009-05-11,Assembly,"AB 293 MENDOZA  Assembly Third Reading",64,10,0,6,80
60161,24367,2009-06-23,Senate,"Do pass, but re-refer to the Committee on Appropriations",12,0,1,0,13
60161,24368,2009-09-09,Senate,"Assembly 3rd Reading AB293 Mendoza By Negrete McLeod",30,3,7,0,40
60163,24356,2009-04-14,Assembly,"Do pass and re-refer to Committee on Appropriations with 	recommendation:  To Consent Calendar",6,0,0,1,7
60163,24357,2009-05-28,Assembly,"Do pass as amended",17,0,0,0,17
60163,24358,2009-06-02,Assembly,"AB 295 AMMIANO  Assembly Third Reading",78,0,0,2,80
60163,24359,2009-06-23,Senate,"Do pass, but re-refer to the Committee on Appropriations",5,0,0,0,5
60163,24360,2009-08-17,Senate,"Placed on Appropriations Suspense file",13,0,0,0,13
60163,24361,2009-08-27,Senate,"Do pass",12,0,1,0,13
60163,24362,2009-09-10,Senate,"Assembly 3rd Reading AB295 Ammiano By Liu",39,0,1,0,40
60163,24363,2009-09-11,Assembly,"AB 295 Ammiano  Concurrence in Senate Amendments",79,0,0,0,79
60164,6290,2009-04-29,Assembly,"Do pass as amended and be re-referred to the Committee on Appropriations",7,2,2,0,11
60164,6291,2009-05-20,Assembly,"Do pass as amended",11,4,1,0,16
60164,6292,2009-05-28,Assembly,"AB 296 SOLORIO  Assembly Third Reading",47,31,2,0,80
60164,6293,2009-07-15,Senate,"Do pass, but re-refer to the Committee on Appropriations",7,0,2,0,9
60164,6294,2009-08-17,Senate,"Placed on Appropriations Suspense file",13,0,0,0,13
60165,24449,2009-03-31,Assembly,"Do pass and be re-referred to the Committee on Appropriations",7,0,0,0,7
60165,24450,2009-04-22,Assembly,"Do pass, to Consent Calendar",16,0,0,1,17
60165,24451,2009-05-04,Assembly,"AB 297 SOLORIO  Consent Calendar Second Day  Regular Session",79,0,0,1,80
60165,24452,2009-06-09,Senate,"Do pass, but re-refer to the Committee on Appropriations",7,0,0,0,7
60165,24453,2009-06-29,Senate,"Special Consent #11 AB297 Solorio",40,0,0,0,40
60166,6289,2009-03-31,Assembly,"Do pass",3,7,0,0,10
60167,27004,2009-04-01,Assembly,"Do pass and be re-referred to the Committee on Appropriations",9,0,0,1,10
60167,27005,2009-04-22,Assembly,"Do pass",16,0,0,1,17
60167,27006,2009-05-11,Assembly,"AB 299 INS.  Assembly Third Reading  By COTO",78,1,0,1,80
60167,27007,2009-07-09,Senate,"Do pass as amended, and re-refer to the Committee on 	Appropriations",11,0,1,0,12
60167,27008,2009-08-27,Senate,"Special Consent #16 AB299 Committee on INS. (Coto)",38,0,2,0,40
60167,27009,2009-09-01,Assembly,"AB 299 INS.  Concurrence in Senate Amendments By COTO",77,1,0,1,79
60168,716,2009-04-15,Assembly,"Do pass as amended and be re-referred to the Committee on Water, Parks and Wildlife.",7,0,0,0,7
60168,717,2009-04-28,Assembly,"Do pass and be re-referred to the Committee on Appropriations.",11,0,2,0,13
60168,718,2009-05-20,Assembly,"Do pass.",15,0,1,0,16
60168,719,2009-05-28,Assembly,"AB 300 CABALLERO  Assembly Third Reading",73,0,7,0,80
60168,720,2009-06-17,Senate,"Do pass as amended, and re-refer to the Committee on Natural Resources and Water.",5,0,0,0,5
60169,6307,2009-03-24,Assembly,"Do pass as amended and be re-referred to the Committee on Appropriations",5,1,1,0,7
60169,6308,2009-04-22,Assembly,"Do pass",11,4,2,0,17
60169,6309,2009-05-11,Assembly,"AB 301 FUENTES  Assembly Third Reading",49,27,4,0,80
60169,6310,2009-06-10,Senate,"Do pass, but re-refer to the Committee on Environmental Quality",7,3,1,0,11
60169,6311,2009-06-22,Senate,"Do pass, but re-refer to the Committee on Appropriations",5,2,0,0,7
60169,6312,2009-07-06,Senate,"Placed on Appropriations Suspense file",11,0,2,0,13
60169,20041,2010-08-12,Senate,"Do pass as amended",7,4,0,0,11
60169,20785,2010-08-23,Senate,"Assembly 3rd Reading AB301 Fuentes By Pavley",22,14,3,0,39
60169,20958,2010-08-24,Assembly,"AB 301 FUENTES  Concurrence in Senate Amendments",50,27,0,1,78
60170,5264,2009-03-24,Assembly,"Do pass and be re-referred to the Committee on Appropriations",5,2,0,0,7
60170,5265,2009-05-28,Assembly,"Do pass as amended",12,5,0,0,17
60170,5266,2009-06-03,Assembly,"AB 302 BEALL  Assembly Third Reading",48,29,3,0,80
60170,8849,2010-06-15,Senate,"Do pass, but re-refer to the Committee on Appropriations",6,0,1,0,7
60170,20426,2010-08-18,Senate,"Assembly 3rd Reading AB302 Beall By Alquist",29,0,9,0,38
60170,20686,2010-08-20,Assembly,"AB 302 BEALL  Concurrence in Senate Amendments",75,0,0,4,79
60171,26463,2009-04-21,Assembly,"Do pass as amended and be re-referred to the Committee on 	Appropriations",18,0,0,1,19
60171,26464,2009-05-28,Assembly,"Do pass as amended",17,0,0,0,17
60171,26465,2009-06-02,Assembly,"AB 303 BEALL  Assembly Third Reading",78,0,0,2,80
60171,26466,2009-07-08,Senate,"Do pass, but re-refer to the Committee on Appropriations",11,0,0,0,11
60171,26467,2009-08-17,Senate,"Placed on Appropriations Suspense file",13,0,0,0,13
60171,26468,2009-08-27,Senate,"Do pass as amended",13,0,0,0,13
60171,26469,2009-09-02,Senate,"Assembly 3rd Reading AB303 Beall By Alquist",34,0,6,0,40
60171,26470,2009-09-08,Assembly,"AB 303 BEALL  Concurrence in Senate Amendments",79,0,0,0,79
60172,6306,2009-04-28,Assembly,"Do pass and be re-referred to the Committee on Appropriations",5,2,0,0,7
60173,24454,2009-04-21,Assembly,"Do pass and be re-referred to the Committee on Public Safety",6,0,0,1,7
60173,24455,2009-04-28,Assembly,"Do pass as amended and re-refer to Committee on Appropriations 	with recommendation:  To Consent Calendar",7,0,0,0,7
60173,24456,2009-05-20,Assembly,"Do pass, to Consent Calendar",15,0,0,1,16
60173,24457,2009-06-02,Assembly,"AB 305 NAVA  Assembly Third Reading",79,0,0,1,80
60173,24458,2009-07-06,Senate,"Do pass, but re-refer to the Committee on Appropriations",5,2,0,0,7
60173,24459,2009-09-02,Senate,"Assembly 3rd Reading AB305 Nava By DeSaulnier",22,11,7,0,40
60174,24443,2009-03-31,Assembly,"Do pass as amended and re-refer to Committee on Appropriations 	with recommendation:  To Consent Calendar",7,0,0,0,7
60174,24444,2009-04-22,Assembly,"Do pass, to Consent Calendar",16,0,0,1,17
60174,24445,2009-05-04,Assembly,"AB 306 FULLER  Consent Calendar Second Day  Regular Session",79,0,0,1,80
60174,24446,2009-06-16,Senate,"Do pass, but re-refer to the Committee on Appropriations Recommend 	Consent",5,0,0,0,5
60174,24447,2009-06-29,Senate,"Do pass",11,0,2,0,13
60174,24448,2009-07-09,Senate,"Special Consent #12 AB306 Fuller",34,0,6,0,40
60175,26654,2009-05-05,Assembly,"Do pass",10,0,0,1,11
60175,26655,2009-05-14,Assembly,"AB 307 COOK  Assembly Third Reading",75,0,0,5,80
60175,26656,2009-07-08,Senate,"Do pass, but re-refer to the Committee on Public Safety",3,2,0,0,5
60175,26657,2009-07-14,Senate,"Do pass, but re-refer to the Committee on Appropriations",3,3,1,0,7
60175,26658,2009-07-14,Senate,"Set, first hearing.  Failed passage in Committee.  Reconsideration 	granted",6,0,1,0,7
60175,26659,2009-08-25,Senate,"Do pass, but re-refer to the Committee on Appropriations",5,0,2,0,7
60175,26660,2009-09-03,Senate,"Assembly 3rd Reading AB307 Cook Urgency Clause",38,0,2,0,40
60175,26661,2009-09-10,Assembly,"Senate amendments be concurred in",7,0,0,0,7
60175,26662,2009-09-11,Assembly,"AB 307 COOK  Concurrence- Urgency Added",79,0,0,0,79
60176,6301,2009-03-31,Assembly,"Do pass and be re-referred to the Committee on Appropriations",7,0,0,0,7
60176,6302,2009-04-29,Assembly,"Do pass",15,0,1,0,16
60176,6303,2009-05-14,Assembly,"AB 308 COOK  Assembly Third Reading",74,0,6,0,80
60176,6304,2009-06-16,Senate,"Do pass, but re-refer to the Committee on Appropriations",4,0,1,0,5
60176,6305,2009-06-29,Senate,"Placed on Appropriations Suspense file",13,0,0,0,13
60176,10304,2010-06-30,Senate,"Do pass, but re-refer to the Committee on Appropriations",5,0,0,0,5
60176,19816,2010-08-09,Senate,"Placed on Appropriations Suspense file",10,0,1,0,11
60176,20003,2010-08-12,Senate,"Do pass",11,0,0,0,11
60176,20909,2010-08-23,Senate,"Assembly 3rd Reading AB308 Cook Urgency Clause",36,0,3,0,39
60176,21163,2010-08-25,Assembly,"Senate amendments be concurred in",9,0,0,0,9
60176,21164,2010-08-25,Assembly,"Be referred to Committee on Appropriations",9,0,0,0,9
60176,21378,2010-08-26,Assembly,"Senate amendments be concurred in",16,0,0,1,17
60176,21595,2010-08-27,Assembly,"AB 308 COOK  Concurrence- Urgency Added",74,0,0,4,78
60177,6299,2009-04-21,Assembly,"Do pass and be re-referred to the Committee on Business and Professions",6,1,0,0,7
60177,6300,2009-04-28,Assembly,"Do pass and be re-referred to the Committee on Appropriations",11,0,0,0,11
60179,6318,2009-04-27,Assembly,"Do pass as amended and be re-referred to the Committee on Appropriations",7,1,1,0,9
60179,6319,2009-05-20,Assembly,"Do pass",13,1,2,0,16
60179,6320,2009-05-28,Assembly,"AB 311 MA  Assembly Third Reading",60,4,16,0,80
60179,6321,2009-07-08,Senate,"Do pass, but re-refer to the Committee on Appropriations",8,0,0,0,8
60179,6322,2009-07-23,Senate,"Do pass as amended",10,3,0,0,13
60179,6323,2009-09-04,Senate,"Assembly 3rd Reading AB311 Ma By Runner",36,3,1,0,40
60179,6324,2009-09-09,Assembly,"AB 311 MA  Concurrence in Senate Amendments",57,15,7,0,79
60180,6325,2010-01-12,Assembly,"Do pass and be re-referred to the Committee on Appropriations",5,2,0,0,7
60181,24438,2009-04-15,Assembly,"Do pass",7,0,0,0,7
60181,24439,2009-04-30,Assembly,"AB 313 FLETCHER  Assembly Third Reading",75,0,0,5,80
60181,24440,2009-06-09,Senate,"Do pass",11,0,0,0,11
60181,24441,2009-08-24,Senate,"Assembly 3rd Reading AB313 Fletcher By Wyland",40,0,0,0,40
60181,24442,2009-08-27,Assembly,"AB 313 FLETCHER  Concurrence in Senate Amendments",75,0,0,4,79
60182,6295,2009-04-29,Assembly,"Do pass as amended and be re-referred to the Committee on Appropriations",8,1,2,0,11
60182,6296,2009-05-28,Assembly,"Do pass",12,5,0,0,17
60182,6297,2009-06-03,Assembly,"AB 314 BROWNLEY  Assembly Third Reading",50,28,2,0,80
60182,6298,2009-07-08,Senate,"Do pass as amended, and re-refer to the Committee on Appropriations",7,2,0,0,9
60183,6315,2009-04-29,Assembly,"Do pass and be re-referred to the Committee on Appropriations",8,2,1,0,11
60183,6316,2009-05-28,Assembly,"Do pass as amended",12,5,0,0,17
60183,6317,2009-06-03,Assembly,"AB 315 DE LEON  Assembly Third Reading",47,30,3,0,80
60184,26547,2009-03-31,Assembly,"Do pass and be re-referred to the Committee on Appropriations",7,0,0,0,7
60184,26548,2009-05-28,Assembly,"Do pass",17,0,0,0,17
60184,26549,2009-06-01,Assembly,"AB 316 SOLORIO  Assembly Third Reading",79,0,0,1,80
60184,26550,2009-06-23,Senate,"Do pass as amended, and re-refer to the Committee on Appropriations",7,0,0,0,7
60184,26551,2009-07-13,Senate,"Placed on Appropriations Suspense file",12,0,1,0,13
60184,26552,2009-08-27,Senate,"Do pass",8,5,0,0,13
60184,26553,2009-09-08,Senate,"Assembly 3rd Reading AB316 Solorio By Wright",35,4,1,0,40
60184,26554,2009-09-10,Assembly,"AB 316 SOLORIO  Concurrence in Senate Amendments",79,0,0,1,80
60185,3705,2010-01-07,Assembly,"Be referred to Committee on Education",10,0,1,0,11
60185,3706,2010-01-13,Assembly,"Do pass as amended and re-refer to Committee on Appropriations with recommendation:  To Consent Calendar",10,0,1,0,11
60185,3707,2010-01-21,Assembly,"Do pass",17,0,0,0,17
60185,3708,2010-01-27,Assembly,"AB 317 SOLORIO  Third Reading Urgency",73,0,5,0,78
60185,3709,2010-05-05,Senate,"Do pass, but re-refer to the Committee on Appropriations",7,0,1,0,8
60185,10609,2010-07-15,Senate,"Placed on Appropriations Suspense file",8,0,2,0,10
60186,26145,2009-03-23,Assembly,"Do pass as amended and be re-referred to the Committee on Business 	and Professions",14,0,0,0,14
60186,26146,2009-04-14,Assembly,"Do pass and be re-referred to the Committee on Appropriations",9,0,0,2,11
60186,26147,2009-04-29,Assembly,"Do pass",16,0,0,0,16
60186,26148,2009-05-11,Assembly,"AB 318 EMMERSON  Assembly Third Reading",80,0,0,0,80
60186,26149,2009-06-09,Senate,"Do pass, but re-refer to the Committee on Business, Professions and 	Economic Development Recommend Consent",11,0,0,0,11
60186,26150,2009-06-22,Senate,"Do pass, but re-refer to the Committee on Appropriations",9,1,0,0,10
60186,26151,2009-07-06,Senate,"Do pass",11,0,2,0,13
60186,26152,2009-09-01,Senate,"Assembly 3rd Reading AB318 Emmerson By Ducheny",33,0,7,0,40
60186,26153,2009-09-03,Assembly,"AB 318 EMMERSON  Concurrence in Senate Amendments",77,0,0,2,79
60187,6313,2009-04-21,Assembly,"Do pass and be re-referred to the Committee on Appropriations",2,5,0,0,7
60187,6314,2009-04-21,Assembly,"Set first hearing.  Failed passage.  Reconsideration granted",7,0,0,0,7
60188,6343,2009-03-31,Assembly,"Do pass as amended and be re-referred to the Committee on Appropriations",7,0,0,0,7
60188,6344,2009-05-28,Assembly,"Do pass as amended",13,3,1,0,17
60188,6345,2009-06-02,Assembly,"AB 320 SOLORIO  Assembly Third Reading",76,1,3,0,80
60188,6346,2009-07-14,Senate,"Do pass as amended, and re-refer to the Committee on Appropriations",7,0,0,0,7
60188,6347,2009-08-24,Senate,"Placed on Appropriations Suspense file",13,0,0,0,13
60188,6348,2009-09-11,Senate,"Assembly 3rd Reading AB320 Solorio Urgency Clause",22,2,16,0,40
60188,6349,2009-09-11,Senate,"Assembly 3rd Reading AB320 Solorio By Ducheny",29,2,9,0,40
60188,6350,2009-09-12,Assembly,"AB 320 SOLORIO  Concurrence in Senate Amendments",71,4,4,0,79
60189,6342,2009-04-13,Assembly,"Do pass as amended and be re-referred to the Committee on Appropriations",8,0,1,0,9
60190,6336,2009-03-31,Assembly,"Do pass and re-refer to Committee on Appropriations with recommendation:  To Consent Calendar",7,0,0,0,7
60190,6337,2009-04-22,Assembly,"Do pass, to Consent Calendar",16,0,1,0,17
60190,6338,2009-05-04,Assembly,"AB 322 SILVA  Consent Calendar Second Day  Regular Session",79,0,1,0,80
60190,6339,2009-06-09,Senate,"Do pass, but re-refer to the Committee on Appropriations",7,0,0,0,7
60190,6340,2009-09-04,Senate,"Special Consent #19 AB322 Silva By Benoit",40,0,0,0,40
60190,6341,2009-09-09,Assembly,"AB 322 SILVA  Concurrence in Senate Amendments",77,0,2,0,79
60191,6334,2009-04-21,Assembly,"Do pass and be re-referred to the Committee on Appropriations",4,4,3,0,11
60191,6335,2009-04-21,Assembly,"Set first hearing.  Failed passage.  Reconsideration granted",11,0,0,0,11
60192,6326,2009-04-21,Assembly,"Do pass and be re-referred to the Committee on Appropriations",5,1,0,0,6
60192,6327,2009-05-28,Assembly,"Do pass as amended",12,5,0,0,17
60192,6328,2009-06-03,Assembly,"AB 324 BEALL  Assembly Third Reading",53,21,6,0,80
60192,6329,2009-06-23,Senate,"Do pass, but re-refer to the Committee on Appropriations",4,1,0,0,5
60192,6330,2009-08-17,Senate,"Placed on Appropriations Suspense file",13,0,0,0,13
60192,6331,2009-08-27,Senate,"Do pass as amended",8,5,0,0,13
60192,6332,2009-09-08,Senate,"Assembly 3rd Reading AB324 Beall By Maldonado",26,14,0,0,40
60192,6333,2009-09-10,Assembly,"AB 324 BEALL  Concurrence in Senate Amendments",60,17,3,0,80
60193,6358,2009-04-28,Assembly,"Do pass and be re-referred to the Committee on Appropriations",5,2,0,0,7
60196,25104,2009-04-22,Assembly,"Do pass as amended and be re-referred to the Committee on Judiciary",10,0,0,0,10
60196,25105,2009-05-05,Assembly,"Do pass as amended",10,0,0,0,10
60196,25106,2009-05-14,Assembly,"AB 328 CALDERON  Assembly Third Reading",72,0,0,8,80
60196,25107,2009-07-09,Senate,"Do pass, but re-refer to the Committee on Judiciary Recommend 	Consent",11,0,1,0,12
60196,25108,2009-08-17,Senate,"Special Consent #14 AB328 Charles Calderon",35,0,5,0,40
60196,25109,2009-08-31,Assembly,"AB 328 CALDERON  Concurrence in Senate Amendments",76,0,0,3,79
60197,26193,2009-04-21,Assembly,"Do pass as amended and be re-referred to the Committee on Banking 	and Finance",7,2,0,1,10
60197,26194,2009-05-04,Assembly,"Do pass as amended",9,0,0,2,11
60197,26195,2009-05-14,Assembly,"AB 329 FEUER  Assembly Third Reading",68,2,0,10,80
60197,26196,2009-06-17,Senate,"Do pass, but re-refer to the Committee on Judiciary",9,2,1,0,12
60197,26197,2009-09-01,Senate,"Assembly 3rd Reading AB329 Feuer By Wolk",28,7,5,0,40
60197,26198,2009-09-03,Assembly,"AB 329 FEUER  Concurrence in Senate Amendments",72,2,0,5,79
60198,6359,2009-03-31,Assembly,"Do pass and be re-referred to the Committee on Appropriations",7,0,0,0,7
60198,6360,2009-04-22,Assembly,"Do pass",16,0,1,0,17
60198,6361,2009-05-26,Assembly,"AB 330 SALDANA  Assembly Third Reading",76,0,4,0,80
60198,6362,2009-07-07,Senate,"Do pass, but re-refer to the Committee on Appropriations",3,2,0,0,5
60198,6363,2009-08-31,Senate,"Assembly 3rd Reading AB330 Saldana By Hancock",23,11,6,0,40
60198,6364,2009-09-02,Assembly,"AB 330 SALDANA  Concurrence in Senate Amendments",73,0,6,0,79
60199,6376,2009-05-12,Assembly,"Do pass as amended",10,0,0,0,10
60199,6377,2009-05-28,Assembly,"AB 331 HALL  Assembly Third Reading",76,0,4,0,80
60200,6378,2009-04-01,Assembly,"Do pass, to Consent Calendar",11,0,0,0,11
60200,6379,2009-04-16,Assembly,"AB 332 FUENTES  Consent Calendar Second Day  Regular Session",70,0,10,0,80
60200,6380,2009-06-17,Senate,"Do pass",7,0,2,0,9
60200,6381,2009-06-24,Senate,"Special Consent #10 AB332 Fuentes",40,0,0,0,40
60201,24433,2009-04-29,Assembly,"Do pass as amended and be re-referred to the Committee on 	Appropriations",7,0,0,0,7
60201,24434,2009-05-20,Assembly,"Do pass, to Consent Calendar",15,0,0,1,16
60201,24435,2009-05-28,Assembly,"AB 333 FUENTES  Consent Calendar Second Day  Regular Session",76,0,0,4,80
60201,24436,2009-06-17,Senate,"Do pass, but re-refer to the Committee on Appropriations",5,0,0,0,5
60201,24437,2009-07-09,Senate,"Special Consent #12 AB333 Fuentes",34,0,6,0,40
60203,6351,2009-04-01,Assembly,"Do pass and be re-referred to the Committee on Judiciary",5,2,0,0,7
60203,6352,2009-04-28,Assembly,"Do pass",7,3,0,0,10
60203,6353,2009-05-18,Assembly,"AB 335 FUENTES  Assembly Third Reading",45,30,5,0,80
60203,6354,2009-06-25,Senate,"Do pass, but re-refer to the Committee on Judiciary",4,2,0,0,6
60203,6355,2009-07-14,Senate,"Do pass, but re-refer to the Committee on Appropriations",3,2,0,0,5
60203,6356,2009-09-01,Senate,"Assembly 3rd Reading AB335 Fuentes By Corbett",22,15,3,0,40
60203,6357,2009-09-09,Assembly,"AB 335 FUENTES  Concurrence in Senate Amendments",48,29,2,0,79
60205,6386,2009-03-31,Assembly,"Do pass and be re-referred to the Committee on Appropriations",7,0,0,0,7
60205,6387,2009-05-28,Assembly,"Do pass as amended",13,4,0,0,17
60205,6388,2009-06-03,Assembly,"AB 337 TORRES  Assembly Third Reading",52,25,3,0,80
60205,6389,2009-07-07,Senate,"Do pass, but re-refer to the Committee on Appropriations",6,1,0,0,7
60205,6390,2009-07-23,Senate,"Do pass",9,2,2,0,13
60205,6391,2009-09-01,Senate,"Assembly 3rd Reading AB337 Torres By Leno",26,11,3,0,40
60206,6365,2009-04-01,Assembly,"Do pass and be re-referred to the Committee on Appropriations",4,2,1,0,7
60206,6366,2009-04-22,Assembly,"Do pass",11,5,1,0,17
60206,6367,2009-06-01,Assembly,"AB 338 MA  Assembly Third Reading",48,31,1,0,80
60206,6368,2009-07-08,Senate,"Do pass",3,2,0,0,5
60206,6369,2009-09-03,Senate,"Assembly 3rd Reading AB338 Ma By Kehoe",22,16,2,0,40
60206,6370,2009-09-10,Assembly,"AB 338 MA  Concurrence in Senate Amendments",48,29,3,0,80
60207,6371,2009-04-22,Assembly,"Do pass as amended and re-refer to Committee on Appropriations with recommendation:  To Consent Calendar",10,0,1,0,11
60207,6372,2009-05-06,Assembly,"Do pass, to Consent Calendar",16,0,0,0,16
60207,6373,2009-05-14,Assembly,"AB 339 TORRES  Consent Calendar Second Day  Regular Session",73,0,7,0,80
60207,6374,2009-06-17,Senate,"Do pass, but re-refer to the Committee on Appropriations",8,0,1,0,9
60207,6375,2009-07-09,Senate,"Special Consent #12 AB339 Torres",34,0,6,0,40
60210,6383,2009-04-21,Assembly,"Do pass and be re-referred to the Committee on Appropriations",18,0,1,0,19
60210,6384,2009-05-06,Assembly,"Do pass",11,0,5,0,16
60210,6385,2009-05-28,Assembly,"AB 342 BASS  Third Reading Urgency",78,0,2,0,80
60210,10270,2010-06-30,Senate,"Do pass, but re-refer to the Committee on Appropriations",7,1,1,0,9
60210,19295,2010-08-02,Senate,"Placed on Appropriations Suspense file",10,0,1,0,11
60210,20267,2010-08-12,Senate,"Do pass",10,0,1,0,11
60210,27386,2010-10-07,Senate,"Assembly 2nd Reading AB342 John A. Perez Urgency Clause",29,1,9,0,39
60210,27387,2010-10-07,Assembly,"AB 342 PEREZ, J.  Concurrence in Senate Amendments By MONNING",66,3,0,9,78
60211,24424,2009-04-22,Assembly,"Do pass and be re-referred to the Committee on Judiciary to Consent 	Calendar",10,0,0,1,11
60211,24425,2009-04-28,Assembly,"Do pass as amended and re-refer to Committee on Appropriations 	with recommendation:  To Consent Calendar",10,0,0,0,10
60211,24426,2009-05-28,Assembly,"Do pass as amended",17,0,0,0,17
60211,24427,2009-06-02,Assembly,"AB 343 SALDANA  Assembly Third Reading",77,0,0,3,80
60211,24428,2009-07-01,Senate,"Do pass, but re-refer to the Committee on Judiciary Recommend 	Consent",8,0,1,0,9
60211,24429,2009-07-14,Senate,"Do pass, but re-refer to the Committee on Appropriations",5,0,0,0,5
60211,24430,2009-08-17,Senate,"Placed on Appropriations Suspense file",13,0,0,0,13
60211,24431,2009-08-27,Senate,"Do pass",13,0,0,0,13
60211,24432,2009-09-02,Senate,"Assembly 3rd Reading AB343 Saldana By Kehoe",34,0,6,0,40
60212,24416,2009-04-13,Assembly,"Do pass as amended and re-refer to Committee on Appropriations 	with recommendation:  To Consent Calendar",10,0,0,4,14
60212,24417,2009-05-28,Assembly,"Do pass",17,0,0,0,17
60212,24418,2009-06-01,Assembly,"AB 344 CABALLERO  Assembly Third Reading",79,0,0,1,80
60212,24419,2009-06-23,Senate,"Do pass, but re-refer to the Committee on Appropriations Recommend 	Consent",11,0,0,0,11
60212,24420,2009-07-06,Senate,"Placed on Appropriations Suspense file",11,0,2,0,13
60212,24421,2009-08-27,Senate,"Do pass as amended",13,0,0,0,13
60212,24422,2009-09-02,Senate,"Assembly 3rd Reading AB344 Caballero By Denham",35,0,5,0,40
60212,24423,2009-09-08,Assembly,"AB 344 CABALLERO  Concurrence in Senate Amendments",79,0,0,0,79
60213,6401,2009-04-15,Assembly,"Do pass as amended and re-refer to Committee on Appropriations with recommendation:  To Consent Calendar",10,0,1,0,11
60214,2731,2009-04-01,Assembly,"Do pass as amended and be re-referred to the Committee on Appropriations",11,0,0,0,11
60214,2732,2009-05-28,Assembly,"Do pass as amended",13,3,1,0,17
60214,2733,2009-06-02,Assembly,"AB 346 TORLAKSON  Assembly Third Reading",71,4,5,0,80
60214,2734,2009-07-15,Senate,"Do pass as amended, and re-refer to the Committee on Appropriations",8,0,1,0,9
60214,8817,2010-06-16,Senate,"Do pass, but re-refer to the Committee on Appropriations Recommend Consent",6,0,3,0,9
60214,9615,2010-06-28,Senate,"Assembly 2nd Reading AB346 Conway Urgency Clause",28,0,11,0,39
60214,10099,2010-07-01,Assembly,"AB 346 CONWAY  Concurrence- Urgency Added",77,0,2,0,79
60215,24408,2009-04-27,Assembly,"Do pass as amended and be re-referred to the Committee on 	Appropriations",6,2,0,1,9
60215,24409,2009-05-20,Assembly,"Do pass",11,4,0,1,16
60215,24410,2010-01-27,Assembly,"Do pass, to Consent Calendar",9,0,0,0,9
60215,24411,2010-01-27,Assembly,"AB 347 BASS  Assembly Third Reading",64,3,0,11,78
60215,24412,2010-02-11,Senate,"Do pass, but re-refer to the Committee on Appropriations",5,0,0,0,5
60215,24413,2010-02-12,Senate,"Do pass as amended",7,0,4,0,11
60215,24414,2010-02-22,Senate,"Assembly 3rd Reading AB347 Bass By Steinberg",39,0,0,0,39
60215,24415,2010-03-04,Assembly,"AB 347 BASS  Concurrence in Senate Amendments",76,0,0,3,79
60216,24497,2009-04-15,Assembly,"Do pass and be re-referred to the Committee on Elections and 	Redistricting to Consent Calendar",7,0,0,0,7
60216,24498,2009-05-05,Assembly,"Do pass, to Consent Calendar",7,0,0,0,7
60216,24499,2009-05-11,Assembly,"AB 348 SALAS  Consent Calendar Second Day  Regular Session",78,0,0,2,80
60216,24500,2009-06-17,Senate,"Do pass and be placed on the Consent Calendar",5,0,0,0,5
60216,24501,2009-06-24,Senate,"Consent Calendar 2nd AB348 Salas",40,0,0,0,40
60217,4153,2009-04-29,Assembly,"Do pass and be re-referred to the Committee on Appropriations",7,0,0,0,7
60217,4154,2009-05-13,Assembly,"Do pass, to Consent Calendar",16,0,0,0,16
60217,4155,2009-05-21,Assembly,"AB 349 SILVA  Consent Calendar Second Day  Regular Session",77,0,3,0,80
60218,8241,2009-03-23,Assembly,"Do pass as amended and be re-referred to the Committee on Judiciary",8,1,2,0,11
60218,8242,2009-04-28,Assembly,"Do pass and be re-referred to the Committee on Appropriations",9,1,0,0,10
60218,8243,2009-05-28,Assembly,"Do pass as amended",12,4,1,0,17
60218,8244,2009-06-02,Assembly,"AB 350 LIEU  Assembly Third Reading",56,22,2,0,80
60218,8245,2009-07-09,Senate,"Do pass, but re-refer to the Committee on Judiciary",10,0,2,0,12
60218,9248,2010-06-22,Senate,"Do pass, but re-refer to the Committee on Appropriations",1,2,2,0,5
60218,9249,2010-06-22,Senate,"Set, second hearing.  Failed passage in Committee. Reconsideration granted",4,0,1,0,5
60219,6396,2009-04-01,Assembly,"Do pass as amended",7,3,1,0,11
60219,6397,2009-06-02,Assembly,"AB 351 SALAS  Third Reading Urgency  Amend By SALAS  Set #1",45,23,12,0,80
60220,6398,2009-04-15,Assembly,"Amend, and do pass as amended and be re-referred to the Committee on Governmental Organization with the recommendation:  To Consent Calendar",10,0,1,0,11
60220,6399,2009-04-30,Assembly,"Do pass, to Consent Calendar",16,0,3,0,19
60220,6400,2009-05-11,Assembly,"AB 352 STRICKLAND  Consent Calendar Second Day  Regular Session",78,0,2,0,80
60220,8899,2010-06-15,Senate,"Do pass",5,0,0,0,5
60220,9587,2010-06-28,Senate,"Special Consent #28 AB352 Audra Strickland",32,0,7,0,39
60220,10065,2010-07-01,Assembly,"AB 352 STRICKLAND  Concurrence in Senate Amendments",77,0,2,0,79
60222,6402,2009-04-21,Assembly,"Do pass as amended and re-refer to Committee on Appropriations with recommendation:  To Consent Calendar",19,0,0,0,19
60222,6403,2009-05-20,Assembly,"Do pass",11,2,3,0,16
60222,6404,2009-05-28,Assembly,"AB 354 ARAMBULA  Assembly Third Reading",74,2,4,0,80
60222,6405,2009-06-17,Senate,"Do pass as amended, and re-refer to the Committee on Appropriations",9,0,2,0,11
60222,10210,2010-06-28,Senate,"Placed on Appropriations Suspense file",10,0,1,0,11
60222,20148,2010-08-12,Senate,"Do pass as amended",11,0,0,0,11
60222,20741,2010-08-20,Senate,"Assembly 3rd Reading AB354 Arambula By Kehoe",25,5,8,0,38
60222,20875,2010-08-23,Assembly,"AB 354 ARAMBULA  Concurrence in Senate Amendments",76,0,0,2,78
60223,6406,2009-03-31,Assembly,"Do pass and re-refer to Committee on Appropriations with recommendation:  To Consent Calendar",10,0,0,0,10
60223,6407,2009-05-06,Assembly,"Do pass, to Consent Calendar",16,0,0,0,16
60223,6408,2009-05-14,Assembly,"AB 355 AMMIANO  Consent Calendar Second Day  Regular Session",73,0,7,0,80
60224,24502,2009-04-14,Assembly,"Do pass as amended and be re-referred to the Committee on Business 	and Professions",16,0,0,3,19
60224,24503,2009-04-28,Assembly,"Do pass and be re-referred to the Committee on Appropriations",10,0,0,1,11
60224,24504,2009-05-13,Assembly,"Do pass, to Consent Calendar",16,0,0,0,16
60224,24505,2009-05-21,Assembly,"AB 356 FLETCHER  Consent Calendar Second Day  Regular Session",77,0,0,3,80
60224,24506,2009-06-22,Senate,"Do pass, but re-refer to the Committee on Appropriations",10,0,0,0,10
60224,24507,2009-07-06,Senate,"Do pass as amended",11,0,2,0,13
60224,24508,2009-09-02,Senate,"Special Consent #18 AB356 Fletcher By Pavley",39,0,1,0,40
60224,24509,2009-09-10,Assembly,"AB 356 FLETCHER  Concurrence in Senate Amendments",76,0,0,4,80
60225,6409,2009-04-21,Assembly,"Do pass and be re-referred to the Committee on Appropriations",1,5,1,0,7
60225,6410,2009-04-21,Assembly,"Set second hearing.  Failed passage.  Reconsideration granted",7,0,0,0,7
60225,6411,2010-01-12,Assembly,"Do pass and be re-referred to the Committee on Appropriations",1,5,1,0,7
60226,6392,2009-05-12,Assembly,"Do pass",5,2,0,0,7
60226,6393,2009-06-01,Assembly,"AB 358 AMMIANO  Assembly Third Reading",47,32,1,0,80
60226,6394,2009-06-23,Senate,"Do pass",5,2,0,0,7
60226,6395,2009-08-24,Senate,"Assembly 3rd Reading AB358 Ammiano By Leno",21,18,1,0,40
60227,24489,2009-04-28,Assembly,"Do pass and be re-referred to the Committee on Appropriations",17,0,0,2,19
60227,24490,2009-05-28,Assembly,"Do pass as amended",12,5,0,0,17
60227,24491,2009-06-02,Assembly,"AB 359 NAVA  Assembly Third Reading",77,1,0,2,80
60227,24492,2009-07-08,Senate,"Do pass as amended, and re-refer to the Committee on Appropriations",11,0,0,0,11
60227,24493,2009-08-24,Senate,"Placed on Appropriations Suspense file",13,0,0,0,13
60227,24494,2009-08-27,Senate,"Do pass",13,0,0,0,13
60227,24495,2009-09-10,Senate,"Special Consent #21 AB359 Nava By Oropeza",40,0,0,0,40
60227,24496,2009-09-11,Assembly,"AB 359 Nava  Concurrence in Senate Amendments",78,0,0,1,79
60228,6423,2009-04-22,Assembly,"Do pass and be re-referred to the Committee on Appropriations",4,2,0,0,6
60229,24484,2009-04-22,Assembly,"Do pass as amended",10,0,0,0,10
60229,24485,2009-05-18,Assembly,"AB 361 LOWENTHAL  Assembly Third Reading",77,0,0,3,80
60229,24486,2009-06-25,Senate,"Do pass",4,1,1,0,6
60229,24487,2009-09-04,Senate,"Assembly 3rd Reading AB361 Bonnie Lowenthal By DeSaulnier",33,6,1,0,40
60229,24488,2009-09-09,Assembly,"AB 361 LOWENTHAL  Concurrence in Senate Amendments",78,0,0,1,79
60230,6424,2009-04-21,Assembly,"Do pass as amended and be re-referred to the Committee on Appropriations",6,1,0,0,7
60230,6425,2009-05-13,Assembly,"Do pass",13,1,2,0,16
60230,6426,2009-05-21,Assembly,"AB 362 MILLER  Assembly Third Reading",55,7,18,0,80
60230,6427,2009-06-23,Senate,"Do pass as amended, and re-refer to the Committee on Appropriations",7,0,0,0,7
60230,6428,2009-09-02,Senate,"Assembly 3rd Reading AB362 Miller By Cedillo",34,0,6,0,40
60230,6429,2009-09-08,Assembly,"AB 362 MILLER  Concurrence in Senate Amendments",63,7,9,0,79
60232,413,2009-04-01,Assembly,"Do pass and be re-referred to the Committee on Appropriations.",8,3,0,0,11
60234,6419,2009-04-21,Assembly,"Do pass and be re-referred to the Committee on Appropriations",17,0,2,0,19
60234,6420,2009-05-28,Assembly,"Do pass as amended",13,3,1,0,17
60234,6421,2009-06-02,Assembly,"AB 366 RUSKIN  Assembly Third Reading",77,0,3,0,80
60234,6422,2009-07-15,Senate,"Do pass, but re-refer to the Committee on Appropriations",10,0,1,0,11
60235,6418,2009-04-28,Assembly,"Do pass as amended and be re-referred to the Committee on Appropriations",17,0,2,0,19
60236,6412,2009-04-13,Assembly,"Do pass and be re-referred to the Committee on Appropriations",6,3,0,0,9
60236,6413,2009-04-22,Assembly,"Do pass",11,5,1,0,17
60236,6414,2009-05-11,Assembly,"AB 368 SKINNER  Assembly Third Reading",48,30,2,0,80
60236,6415,2009-06-23,Senate,"Do pass, but re-refer to the Committee on Appropriations",8,4,1,0,13
60236,6416,2009-08-31,Senate,"Assembly 3rd Reading AB368 Skinner By Wolk",23,13,4,0,40
60236,6417,2009-09-02,Assembly,"AB 368 SKINNER  Concurrence in Senate Amendments",47,28,4,0,79
60237,6436,2009-04-28,Assembly,"Do pass and re-refer to Committee on Appropriations with recommendation:  To Consent Calendar",18,0,1,0,19
60237,6437,2009-05-28,Assembly,"Do pass",14,3,0,0,17
60237,6438,2009-06-03,Assembly,"AB 369 YAMADA  Assembly Third Reading",78,0,2,0,80
60237,6439,2009-07-08,Senate,"Do pass, but re-refer to the Committee on Appropriations",11,0,0,0,11
60237,6440,2009-07-23,Senate,"Placed on Appropriations Suspense file",13,0,0,0,13
60237,6441,2009-08-27,Senate,"Do pass",12,0,1,0,13
60237,6442,2009-09-02,Senate,"Assembly 3rd Reading AB369 Yamada By Denham",35,0,5,0,40
60237,6443,2009-09-08,Assembly,"AB 369 YAMADA  Concurrence in Senate Amendments",77,0,2,0,79
60238,24478,2009-03-31,Assembly,"Do pass and be re-referred to the Committee on Appropriations",11,0,0,0,11
60238,24479,2009-04-22,Assembly,"Do pass",14,1,0,2,17
60238,24480,2009-05-11,Assembly,"AB 370 ENG  Assembly Third Reading",77,0,0,3,80
60238,24481,2009-06-08,Senate,"Do pass, but re-refer to the Committee on Public Safety",7,0,3,0,10
60238,24482,2009-08-27,Senate,"Assembly 3rd Reading AB370 Eng By Negrete McLeod",38,0,2,0,40
60238,24483,2009-08-31,Assembly,"AB 370 ENG  Concurrence in Senate Amendments",77,0,0,2,79
60240,6430,2009-04-27,Assembly,"Do pass and be re-referred to the Committee on Appropriations",10,0,0,0,10
60242,6431,2009-04-01,Assembly,"Do pass as amended and re-refer to Committee on Appropriations with recommendation:  To Consent Calendar",11,0,0,0,11
60242,6432,2009-05-28,Assembly,"Do pass as amended",13,3,1,0,17
60242,6433,2009-06-02,Assembly,"AB 374 BLOCK  Assembly Third Reading",75,1,4,0,80
60242,6434,2009-07-15,Senate,"Do pass, but re-refer to the Committee on Appropriations",8,0,1,0,9
60242,6435,2009-09-02,Senate,"Assembly 3rd Reading AB374 Block By Hancock",29,2,9,0,40
60243,6455,2009-03-31,Assembly,"Do pass",10,0,0,0,10
60243,6456,2009-06-02,Assembly,"AB 375 NIELSEN  Assembly Third Reading",79,0,1,0,80
60244,6454,2009-04-27,Assembly,"Do pass as amended and be re-referred to the Committee on Appropriations",6,3,0,0,9
60245,6450,2009-04-13,Assembly,"Do pass and be re-referred to the Committee on Appropriations",10,1,0,0,11
60245,6451,2009-04-29,Assembly,"Do pass",9,0,7,0,16
60245,6452,2009-05-11,Assembly,"AB 377 MENDOZA  Assembly Third Reading",53,8,19,0,80
60245,6453,2009-06-17,Senate,"Do pass as amended, and re-refer to the Committee on Judiciary",7,1,4,0,12
60246,6445,2009-04-14,Assembly,"Do pass and be re-referred to the Committee on Appropriations",5,0,2,0,7
60246,6446,2009-04-29,Assembly,"Do pass as amended",11,5,0,0,16
60246,6447,2009-05-14,Assembly,"AB 378 COOK  Assembly Third Reading",62,4,14,0,80
60246,6448,2009-06-23,Senate,"Do pass, but re-refer to the Committee on Appropriations",4,1,0,0,5
60246,6449,2009-07-13,Senate,"Do pass",7,1,5,0,13
60246,21741,2010-08-30,Senate,"From Committee:  Amendments held in committee pursuant to Senate 	Rule 29.10",5,3,1,0,9
60247,6444,2009-04-22,Assembly,"Do pass and be re-referred to the Committee on Appropriations",4,2,0,0,6
60248,6469,2009-04-13,Assembly,"Do pass and be re-referred to the Committee on Labor and Employment",11,3,1,0,15
60248,6470,2009-04-22,Assembly,"Do pass and be re-referred to the Committee on Appropriations",6,1,0,0,7
60249,24471,2009-04-01,Assembly,"Do pass as amended and be re-referred to the Committee on 	Appropriations",10,0,0,0,10
60249,24472,2009-04-29,Assembly,"Do pass, to Consent Calendar",16,0,0,0,16
60249,24473,2009-05-11,Assembly,"AB 381 BLOCK  Consent Calendar Second Day  Regular Session",78,0,0,2,80
60249,24474,2009-06-25,Senate,"Do pass, but re-refer to the Committee on Appropriations",6,0,0,0,6
60249,24475,2009-07-06,Senate,"Do pass",11,0,2,0,13
60249,24476,2009-08-27,Senate,"Assembly 3rd Reading AB381 Block By DeSaulnier",37,0,3,0,40
60249,24477,2009-09-01,Assembly,"AB 381 BLOCK  Concurrence in Senate Amendments",78,0,0,1,79
60250,6463,2009-03-31,Assembly,"Do pass and be re-referred to the Committee on Appropriations",7,0,0,0,7
60250,6464,2009-04-22,Assembly,"Do pass",12,3,2,0,17
60250,6465,2009-05-11,Assembly,"AB 382 AMMIANO  Assembly Third Reading",65,9,6,0,80
60250,6466,2009-07-07,Senate,"Do pass, but re-refer to the Committee on Appropriations",5,2,0,0,7
60250,6467,2009-09-03,Senate,"Assembly 3rd Reading AB382 Ammiano By Romero",24,14,2,0,40
60250,6468,2009-09-09,Assembly,"AB 382 AMMIANO  Concurrence in Senate Amendments",65,9,5,0,79
60251,6460,2009-03-31,Assembly,"Do pass and be re-referred to the Committee on Appropriations",7,0,0,0,7
60251,6461,2009-05-28,Assembly,"Do pass",14,3,0,0,17
60251,6462,2009-06-01,Assembly,"AB 383 LIEU  Assembly Third Reading",79,0,1,0,80
60252,3851,2010-01-07,Assembly,"Be referred to Committee on Revenue and Taxation",10,0,1,0,11
60252,3852,2010-01-11,Assembly,"Do pass and be re-referred to the Committee on Appropriations",8,0,1,0,9
60252,3853,2010-01-21,Assembly,"Do pass",17,0,0,0,17
60252,3854,2010-01-27,Assembly,"AB 384 MA  Assembly Third Reading",62,8,8,0,78
60252,8749,2010-06-09,Senate,"Do pass, but re-refer to the Committee on Appropriations",3,0,2,0,5
60252,9894,2010-06-28,Senate,"Do pass",10,0,1,0,11
60252,20366,2010-08-12,Senate,"Assembly 3rd Reading AB384 Ma By Wolk",33,0,5,0,38
60252,20367,2010-08-17,Assembly,"AB 384 MA  Concurrence in Senate Amendments",76,0,0,3,79
60253,6457,2009-03-31,Assembly,"Do pass and be re-referred to the Committee on Appropriations to Consent Calendar",9,0,0,0,9
60253,6458,2009-05-28,Assembly,"Do pass",13,4,0,0,17
60253,6459,2009-06-01,Assembly,"AB 385 BLOCK  Assembly Third Reading",76,1,3,0,80
60254,24465,2009-04-21,Assembly,"Do pass and be re-referred to the Committee on Appropriations",9,0,0,0,9
60254,24466,2009-05-06,Assembly,"Do pass, to Consent Calendar",16,0,0,0,16
60254,24467,2009-05-18,Assembly,"AB 386 RUSKIN  Assembly Third Reading",77,0,0,3,80
60254,24468,2009-07-01,Senate,"Do pass as amended, and re-refer to the Committee on Appropriations",8,0,1,0,9
60254,24469,2009-09-10,Senate,"Special Consent #21 AB386 Ruskin By Huff",40,0,0,0,40
60254,24470,2009-09-11,Assembly,"AB 386 Ruskin  Concurrence in Senate Amendments",79,0,0,0,79
60256,24460,2009-03-31,Assembly,"Do pass and re-refer to Committee on Appropriations with 	recommendation:  To Consent Calendar",7,0,0,0,7
60256,24461,2009-04-22,Assembly,"Do pass, to Consent Calendar",16,0,0,1,17
60256,24462,2009-05-04,Assembly,"AB 388 MILLER  Consent Calendar Second Day  Regular Session",79,0,0,1,80
60256,24463,2009-06-09,Senate,"Do pass, but re-refer to the Committee on Appropriations",7,0,0,0,7
60256,24464,2009-06-29,Senate,"Special Consent #11 AB388 Miller",40,0,0,0,40
60257,24552,2009-04-22,Assembly,"Do pass as amended and be re-referred to the Committee on 	Appropriations",10,0,0,0,10
60257,24553,2009-05-13,Assembly,"Do pass as amended, to Consent Calendar",16,0,0,0,16
60257,24554,2009-05-21,Assembly,"AB 389 SALDANA  Consent Calendar Second Day  Regular Session",77,0,0,3,80
60257,24555,2009-06-22,Senate,"Do pass, but re-refer to the Committee on Appropriations",11,0,1,0,12
60257,24556,2009-07-09,Senate,"Special Consent #12 AB389 Saldana",34,0,6,0,40
60257,24557,2009-07-13,Assembly,"AB 389 SALDANA  Concurrence in Senate Amendments",74,0,0,5,79
60258,6476,2010-01-12,Assembly,"Do pass and be re-referred to the Committee on Health",4,3,0,0,7
60259,3109,2010-01-13,Assembly,"Do pass as amended and be re-referred to the Committee on Appropriations",7,3,1,0,11
60259,3110,2010-01-21,Assembly,"Do pass as amended",12,0,5,0,17
60259,3111,2010-01-27,Assembly,"AB 391 TORLAKSON  Assembly Third Reading",44,27,7,0,78
60259,9337,2010-06-23,Senate,"Do pass as amended, and re-refer to the Committee on Appropriations",5,2,2,0,9
60259,19509,2010-08-02,Senate,"Placed on Appropriations Suspense file",10,0,1,0,11
60259,20158,2010-08-12,Senate,"Do pass",7,4,0,0,11
60259,20898,2010-08-23,Senate,"Assembly 3rd Reading AB391 Torlakson By Hancock",23,12,4,0,39
60259,21024,2010-08-24,Assembly,"AB 391 TORLAKSON  Concurrence in Senate Amendments",52,24,0,2,78
60260,24558,2009-04-14,Assembly,"Do pass and be re-referred to the Committee on Appropriations",13,0,0,6,19
60260,24559,2009-04-29,Assembly,"Do pass as amended",16,0,0,0,16
60260,24560,2009-05-14,Assembly,"AB 392 FEUER  Third Reading Urgency",72,0,0,8,80
60260,24561,2009-06-10,Senate,"Do pass, but re-refer to the Committee on Appropriations",9,1,1,0,11
60260,24562,2009-07-13,Senate,"Do pass",10,0,3,0,13
60260,24563,2009-07-16,Senate,"Assembly 3rd Reading AB392 Feuer Urgency Clause",33,3,4,0,40
60262,6471,2009-04-30,Assembly,"Do pass and be re-referred to the Committee on Appropriations",7,0,0,0,7
60262,6472,2009-05-28,Assembly,"Do pass",12,5,0,0,17
60262,6473,2009-06-01,Assembly,"AB 394 FUENTES  Assembly Third Reading",53,24,3,0,80
60263,24544,2009-04-01,Assembly,"Do pass and be re-referred to the Committee on Appropriations",6,1,0,0,7
60263,24545,2009-05-28,Assembly,"Do pass",12,5,0,0,17
60263,24546,2009-06-01,Assembly,"AB 395 FUENTES  Assembly Third Reading",51,28,0,1,80
60263,24547,2009-06-25,Senate,"Do pass, but re-refer to the Committee on Appropriations",5,1,0,0,6
60263,24548,2009-07-13,Senate,"Placed on Appropriations Suspense file",12,0,1,0,13
60263,24549,2009-08-27,Senate,"Do pass",9,4,0,0,13
60263,24550,2009-09-04,Senate,"Assembly 3rd Reading AB395 Fuentes By Ducheny",26,13,1,0,40
60263,24551,2009-09-09,Assembly,"AB 395 FUENTES  Concurrence in Senate Amendments",54,21,0,4,79
60264,6474,2009-04-14,Assembly,"Do pass and be re-referred to the Committee on Judiciary",8,0,3,0,11
60264,6475,2009-04-28,Assembly,"Do pass as amended and be re-referred to the Committee on Appropriations",9,0,1,0,10
60266,24535,2009-03-31,Assembly,"Amend, and do pass as amended and be re-referred to the Committee 	on Human Services with the recommendation:  To Consent Calendar",19,0,0,0,19
60266,24536,2009-04-28,Assembly,"Do pass and re-refer to Committee on Appropriations with 	recommendation:  To Consent Calendar",7,0,0,0,7
60266,24537,2009-05-13,Assembly,"Do pass, to Consent Calendar",16,0,0,0,16
60266,24538,2009-05-21,Assembly,"AB 398 MONNING  Consent Calendar Second Day  Regular Session",77,0,0,3,80
60266,24539,2009-06-23,Senate,"Do pass, but re-refer to the Committee on Health",4,1,0,0,5
60266,24540,2009-07-15,Senate,"Do pass as amended, and re-refer to the Committee on Appropriations",9,1,1,0,11
60266,24541,2009-08-17,Senate,"Do pass",9,0,4,0,13
60266,24542,2009-08-31,Senate,"Assembly 3rd Reading AB398 Monning By Leno",35,0,5,0,40
60266,24543,2009-09-02,Assembly,"AB 398 MONNING  Concurrence in Senate Amendments",63,9,0,7,79
60267,24527,2009-04-01,Assembly,"Do pass and re-refer to Committee on Appropriations with 	recommendation:  To Consent Calendar",6,0,0,0,6
60267,24528,2009-04-22,Assembly,"Do pass, to Consent Calendar",16,0,0,1,17
60267,24529,2009-05-04,Assembly,"AB 399 BROWNLEY  Consent Calendar Second Day  Regular Session",79,0,0,1,80
60267,24530,2009-06-08,Senate,"Do pass, but re-refer to the Committee on Appropriations",7,0,0,0,7
60267,24531,2009-06-22,Senate,"Assembly 3rd Reading AB399 Brownley Correa",40,0,0,0,40
60267,24532,2009-09-04,Senate,"Do pass",7,0,0,0,7
60267,24533,2009-09-08,Senate,"Assembly 3rd Reading AB399 Brownley By Correa",33,6,1,0,40
60267,24534,2009-09-10,Assembly,"AB 399 BROWNLEY  Concurrence in Senate Amendments",57,22,0,1,80
60268,24520,2009-03-31,Assembly,"Do pass and re-refer to Committee on Appropriations with 	recommendation:  To Consent Calendar",11,0,0,0,11
60268,24521,2009-05-06,Assembly,"Do pass",16,0,0,0,16
60268,24522,2009-05-14,Assembly,"AB 400 DE LEON  Assembly Third Reading",75,0,0,5,80
60268,24523,2009-06-23,Senate,"Do pass, but re-refer to the Committee on Appropriations Recommend 	Consent",12,0,1,0,13
60268,24524,2009-07-06,Senate,"Do pass",11,0,2,0,13
60268,24525,2009-07-16,Senate,"Special Consent #13 AB400 De Leon",36,0,4,0,40
60268,24526,2009-08-17,Assembly,"AB 400 DE LEON  Concurrence in Senate Amendments",77,0,0,2,79
60269,25899,2009-04-13,Assembly,"Do pass, to Consent Calendar",11,0,0,0,11
60269,25900,2009-04-20,Assembly,"AB 401 RUSKIN  Consent Calendar Second Day  Regular Session",75,0,0,5,80
60269,25901,2009-06-17,Senate,"Do pass and be placed on the Consent Calendar",11,0,1,0,12
60269,25902,2009-06-24,Senate,"Consent Calendar 2nd AB401 Ruskin",40,0,0,0,40
60270,6485,2009-03-31,Assembly,"Do pass and be re-referred to the Committee on Labor and Employment",6,2,1,0,9
60270,6486,2009-04-22,Assembly,"Do pass and be re-referred to the Committee on Appropriations",5,1,1,0,7
60270,6487,2009-05-28,Assembly,"Do pass as amended",12,5,0,0,17
60270,6488,2009-06-03,Assembly,"AB 402 DAVIS  Assembly Third Reading",50,28,2,0,80
60270,6489,2009-07-08,Senate,"Do pass as amended, and re-refer to the Committee on Appropriations",5,1,0,0,6
60270,6490,2009-08-17,Senate,"Do pass as amended",9,3,1,0,13
60270,6491,2009-09-03,Senate,"Assembly 3rd Reading AB402 Davis By DeSaulnier",24,13,3,0,40
60270,6492,2009-09-09,Assembly,"AB 402 DAVIS  Concurrence in Senate Amendments",49,27,3,0,79
60271,24515,2009-03-31,Assembly,"Do pass and re-refer to Committee on Appropriations with 	recommendation:  To Consent Calendar",11,0,0,0,11
60271,24516,2009-04-22,Assembly,"Do pass, to Consent Calendar",16,0,0,1,17
60271,24517,2009-05-04,Assembly,"AB 403 FULLER  Consent Calendar Second Day  Regular Session",79,0,0,1,80
60271,24518,2009-06-08,Senate,"Do pass, but re-refer to the Committee on Appropriations",7,0,3,0,10
60271,24519,2009-06-29,Senate,"Special Consent #11 AB403 Fuller",40,0,0,0,40
60272,24510,2009-04-27,Assembly,"Do pass and re-refer to Committee on Appropriations with 	recommendation:  To Consent Calendar",8,0,0,1,9
60272,24511,2009-05-13,Assembly,"Do pass, to Consent Calendar",16,0,0,0,16
60272,24512,2009-05-21,Assembly,"AB 404 ENG  Consent Calendar Second Day  Regular Session",77,0,0,3,80
60272,24513,2009-07-08,Senate,"Do pass, but re-refer to the Committee on Appropriations Recommend 	Consent",8,0,0,0,8
60272,24514,2009-08-24,Senate,"Special Consent #15 AB404 Eng",39,0,1,0,40
60273,6484,2009-04-01,Assembly,"Do pass as amended and be re-referred to the Committee on Appropriations",4,2,1,0,7
60274,6483,2009-04-01,Assembly,"Do pass as amended and be re-referred to the Committee on Appropriations",8,1,2,0,11
60275,25886,2009-04-14,Assembly,"Do pass as amended and be re-referred to the Committee on 	Appropriations",6,0,0,1,7
60275,25887,2009-04-29,Assembly,"Do pass",16,0,0,0,16
60275,25888,2009-05-11,Assembly,"AB 407 BEALL  Assembly Third Reading",80,0,0,0,80
60275,25889,2009-06-09,Senate,"Do pass, but re-refer to the Committee on Judiciary",5,0,0,0,5
60275,25890,2009-09-09,Senate,"Assembly 3rd Reading AB407 Beall By Alquist",38,0,2,0,40
60275,25891,2009-09-10,Assembly,"AB 407 Beall  Concurrence in Senate Amendments",78,0,0,2,80
60276,45,2010-01-07,Assembly,"Be referred to Committee on Water, Parks and Wildlife.",10,0,1,0,11
60276,46,2010-01-12,Assembly,"Do pass and be re-referred to the Committee on Appropriations.",8,2,2,0,12
60276,47,2010-01-21,Assembly,"Do pass.",12,5,0,0,17
60276,48,2010-01-27,Assembly,"AB 408 SALDANA  Assembly Third Reading",43,27,8,0,78
60276,9190,2010-06-22,Senate,"Do pass as amended, and re-refer to the Committee on Appropriations",5,3,1,0,9
60276,19192,2010-08-02,Senate,"Do pass",7,3,1,0,11
60276,21910,2010-08-30,Senate,"Assembly 3rd Reading AB408 Saldana By Kehoe",23,11,5,0,39
60276,21911,2010-08-31,Assembly,"AB 408 SALDANA  Concurrence in Senate Amendments",48,26,0,4,78
60277,24604,2009-04-22,Assembly,"Do pass, to Consent Calendar",10,0,0,0,10
60277,24605,2009-05-04,Assembly,"AB 409 GARRICK  Consent Calendar Second Day  Regular Session",79,0,0,1,80
60277,24606,2009-06-17,Senate,"Do pass and be placed on the Consent Calendar",11,0,1,0,12
60277,24607,2009-06-24,Senate,"Consent Calendar 2nd AB409 Garrick",40,0,0,0,40
60278,6502,2009-04-14,Assembly,"Do pass and be re-referred to the Committee on Appropriations",13,0,0,0,13
60278,6503,2009-05-28,Assembly,"Do pass",17,0,0,0,17
60278,6504,2009-06-01,Assembly,"AB 410 DE LA TORRE  Assembly Third Reading",75,3,2,0,80
60278,6505,2009-06-23,Senate,"Do pass, but re-refer to the Committee on Environmental Quality",11,0,0,0,11
60278,6506,2009-07-06,Senate,"Do pass as amended, and re-refer to the Committee on Appropriations",7,0,0,0,7
60278,6507,2009-08-17,Senate,"Placed on Appropriations Suspense file",13,0,0,0,13
60279,6508,2009-04-28,Assembly,"Do pass as amended and be re-referred to the Committee on Appropriations",16,1,2,0,19
60279,6509,2009-05-28,Assembly,"Do pass as amended",17,0,0,0,17
60279,6510,2009-06-02,Assembly,"AB 411 GARRICK  Assembly Third Reading",78,0,2,0,80
60279,6511,2009-09-08,Senate,"Do pass, but re-refer to the Committee on Appropriations",6,2,3,0,11
60280,24599,2009-03-31,Assembly,"Do pass and be re-referred to the Committee on Appropriations",7,0,0,0,7
60280,24600,2009-04-22,Assembly,"Do pass, to Consent Calendar",16,0,0,1,17
60280,24601,2009-05-04,Assembly,"AB 412 CARTER  Consent Calendar Second Day  Regular Session",79,0,0,1,80
60280,24602,2009-06-09,Senate,"Do pass, but re-refer to the Committee on Appropriations",7,0,0,0,7
60280,24603,2009-06-29,Senate,"Special Consent #11 AB412 Carter",40,0,0,0,40
60281,6478,2009-04-27,Assembly,"Do pass as amended and be re-referred to the Committee on Appropriations",11,1,3,0,15
60281,6479,2009-05-28,Assembly,"Do pass as amended",12,5,0,0,17
60281,6480,2009-06-02,Assembly,"AB 413 FUENTES  Assembly Third Reading",68,6,6,0,80
60281,6481,2009-07-07,Senate,"Do pass, but re-refer to the Committee on Appropriations",11,0,0,0,11
60281,6482,2009-08-27,Senate,"Do pass",12,0,1,0,13
60284,6493,2009-04-14,Assembly,"Do pass and be re-referred to the Committee on Health",4,1,2,0,7
60284,6494,2009-04-28,Assembly,"Do pass and be re-referred to the Committee on Appropriations",16,0,3,0,19
60285,6495,2009-04-28,Assembly,"Do pass as amended and be re-referred to the Committee on Appropriations",18,0,1,0,19
60285,6496,2009-05-28,Assembly,"Do pass",12,0,5,0,17
60285,6497,2009-06-01,Assembly,"AB 417 BEALL  Assembly Third Reading",78,0,2,0,80
60285,6498,2009-07-08,Senate,"Do pass as amended, and re-refer to the Committee on Appropriations",11,0,0,0,11
60285,6499,2009-08-17,Senate,"Placed on Appropriations Suspense file",13,0,0,0,13
60286,6500,2009-04-14,Assembly,"Do pass and be re-referred to the Committee on Appropriations",4,2,5,0,11
60286,6501,2009-04-14,Assembly,"Set second hearing.  Failed passage.  Reconsideration granted",10,0,1,0,11
60287,5381,2010-01-13,Assembly,"Do pass as amended",5,0,2,0,7
60287,5382,2010-01-27,Assembly,"AB 419 CABALLERO  Assembly Third Reading",73,0,5,0,78
60287,5383,2010-06-09,Senate,"Do pass and be placed on the Consent Calendar",3,0,2,0,5
60287,9058,2010-06-17,Senate,"Consent Calendar 2nd AB419 Caballero",33,0,6,0,39
60287,9110,2010-06-21,Assembly,"AB 419 CABALLERO  Concurrence in Senate Amendments",76,0,3,0,79
60288,6524,2009-04-14,Assembly,"Do pass as amended and be re-referred to the Committee on Appropriations",17,0,2,0,19
60289,6522,2009-04-14,Assembly,"Do pass and be re-referred to the Committee on Education",6,0,1,0,7
60289,6523,2009-04-22,Assembly,"Do pass as amended and be re-referred to the Committee on Appropriations",9,0,2,0,11
60290,6521,2009-04-14,Assembly,"Do pass as amended and be re-referred to the Committee on Appropriations",4,1,2,0,7
60291,6513,2009-04-27,Assembly,"Do pass as amended and be re-referred to the Committee on Appropriations",11,1,3,0,15
60291,6514,2009-05-28,Assembly,"Do pass",12,5,0,0,17
60291,6515,2009-06-03,Assembly,"AB 423 TORRES  Assembly Third Reading",63,15,2,0,80
60291,6516,2009-07-07,Senate,"Do pass as amended, and re-refer to the Committee on Appropriations",11,0,0,0,11
60291,6517,2009-08-17,Senate,"Placed on Appropriations Suspense file",13,0,0,0,13
60291,6518,2009-08-27,Senate,"Do pass",12,0,1,0,13
60291,6519,2009-09-03,Senate,"Assembly 3rd Reading AB423 Torres By Benoit",35,0,5,0,40
60291,6520,2009-09-09,Assembly,"AB 423 TORRES  Concurrence in Senate Amendments",66,8,5,0,79
60292,6533,2010-01-12,Assembly,"Do pass and be re-referred to the Committee on Appropriations",7,4,0,0,11
60292,6534,2010-01-21,Assembly,"Do pass",12,5,0,0,17
60292,6535,2010-01-27,Assembly,"AB 424 TORRES  Assembly Third Reading",46,24,8,0,78
60292,9039,2010-06-15,Senate,"Do pass as amended, and re-refer to the Committee on Appropriations",8,1,2,0,11
60292,10734,2010-07-15,Senate,"Placed on Appropriations Suspense file",8,0,2,0,10
60292,20271,2010-08-12,Senate,"Do pass",7,4,0,0,11
60292,21490,2010-08-25,Senate,"Assembly 3rd Reading AB424 Torres",21,10,8,0,39
60292,21882,2010-08-31,Assembly,"AB 424 Torres  Concurrence in Senate Amendments",52,25,0,1,78
60293,24593,2009-04-13,Assembly,"Do pass as amended and be re-referred to the Committee on 	Appropriations",13,0,0,1,14
60293,24594,2009-05-06,Assembly,"Do pass, to Consent Calendar",16,0,0,0,16
60293,24595,2009-05-14,Assembly,"AB 425 COOK  Consent Calendar Second Day  Regular Session",73,0,0,7,80
60293,24596,2009-06-16,Senate,"Do pass, but re-refer to the Committee on Appropriations Recommend 	Consent",11,0,0,0,11
60293,24597,2009-06-29,Senate,"Do pass",12,0,1,0,13
60293,24598,2009-07-09,Senate,"Special Consent #12 AB425 Cook",34,0,6,0,40
60296,24585,2009-04-21,Assembly,"Amend, and do pass as amended and be re-referred to the Committee 	on Public Safety with the recommendation:  To Consent Calendar",10,0,0,0,10
60296,24586,2009-04-28,Assembly,"Do pass and re-refer to Committee on Appropriations with 	recommendation:  To Consent Calendar",7,0,0,0,7
60296,24587,2009-05-20,Assembly,"Do pass, to Consent Calendar",15,0,0,1,16
60296,24588,2009-05-28,Assembly,"AB 428 FLETCHER  Consent Calendar Second Day  Regular Session",76,0,0,4,80
60296,24589,2009-06-16,Senate,"Do pass, but re-refer to the Committee on Judiciary",6,0,1,0,7
60296,24590,2009-07-07,Senate,"Do pass, but re-refer to the Committee on Appropriations Recommend 	Consent",5,0,0,0,5
60296,24591,2009-09-01,Senate,"Assembly 3rd Reading AB428 Fletcher By Strickland",32,0,8,0,40
60296,24592,2009-09-03,Assembly,"AB 428 FLETCHER  Concurrence in Senate Amendments",77,0,0,2,79
60297,6525,2009-04-22,Assembly,"Do pass as amended and be re-referred to the Committee on Appropriations",8,0,3,0,11
60297,6526,2009-05-28,Assembly,"Do pass",17,0,0,0,17
60297,6527,2009-06-02,Assembly,"AB 429 BROWNLEY  Assembly Third Reading",79,0,1,0,80
60297,6528,2009-07-15,Senate,"Do pass as amended, and re-refer to the Committee on Appropriations",8,0,1,0,9
60297,6529,2009-08-17,Senate,"Placed on Appropriations Suspense file",13,0,0,0,13
60297,6530,2009-08-27,Senate,"Do pass as amended",13,0,0,0,13
60297,6531,2009-09-10,Senate,"Assembly 3rd Reading AB429 Brownley By Liu",35,0,5,0,40
60297,6532,2009-09-11,Assembly,"AB 429 Brownley  Concurrence in Senate Amendments",79,0,0,0,79
60298,24579,2009-03-31,Assembly,"Do pass and re-refer to Committee on Appropriations with 	recommendation:  To Consent Calendar",7,0,0,0,7
60298,24580,2009-04-22,Assembly,"Do pass, to Consent Calendar",16,0,0,1,17
60298,24581,2009-05-14,Assembly,"AB 430 HAGMAN  Assembly Third Reading",75,0,0,5,80
60298,24582,2009-06-09,Senate,"Do pass, but re-refer to the Committee on Appropriations",7,0,0,0,7
60298,24583,2009-06-29,Senate,"Special Consent #11 AB430 Hagman",40,0,0,0,40
60298,24584,2009-07-06,Assembly,"AB 430 HAGMAN  Concurrence in Senate Amendments",77,0,0,2,79
60301,6546,2009-04-15,Assembly,"Do pass and be re-referred to the Committee on Natural Resources",5,2,0,0,7
60301,6547,2009-04-27,Assembly,"Do pass and be re-referred to the Committee on Appropriations",6,3,0,0,9
60302,163,2009-04-01,Assembly,"Do pass and be re-referred to the Committee on Appropriations.",10,1,0,0,11
60302,164,2009-05-28,Assembly,"Do pass as amended.",12,5,0,0,17
60302,165,2009-06-03,Assembly,"AB 434 BLOCK  Assembly Third Reading",52,25,3,0,80
60302,166,2009-07-08,Senate,"Do pass as amended, and re-refer to the Committee on Appropriations.",9,0,0,0,9
60302,167,2009-08-17,Senate,"Placed on Appropriations Suspense file.",13,0,0,0,13
60302,20007,2010-08-12,Senate,"Do pass as amended",11,0,0,0,11
60302,20855,2010-08-23,Senate,"Assembly 3rd Reading AB434 Block By Kehoe",34,0,5,0,39
60302,20989,2010-08-24,Assembly,"AB 434 BLOCK  Concurrence in Senate Amendments",75,1,0,2,78
60303,8617,2009-04-27,Assembly,"Do pass and be re-referred to the Committee on Appropriations",15,0,0,0,15
60303,8618,2009-05-28,Assembly,"Do pass",17,0,0,0,17
60303,8619,2009-06-01,Assembly,"AB 435 DE LA TORRE  Assembly Third Reading",77,0,3,0,80
60303,8620,2009-07-07,Senate,"Do pass as amended, and re-refer to the Committee on Appropriations",9,2,0,0,11
60303,19740,2010-08-10,Senate,"Do pass, but re-refer to the Committee on Rules",3,1,1,0,5
60304,6540,2009-03-31,Assembly,"Do pass as amended and be re-referred to the Committee on Appropriations",5,2,0,0,7
60304,6541,2009-04-22,Assembly,"Do pass",11,5,1,0,17
60304,6542,2009-05-28,Assembly,"AB 436 SALDANA  Assembly Third Reading",47,28,5,0,80
60304,6543,2009-07-07,Senate,"Do pass, but re-refer to the Committee on Appropriations",3,2,0,0,5
60304,6544,2009-09-09,Senate,"Assembly 3rd Reading AB436 Saldana By Liu",21,18,1,0,40
60304,6545,2009-09-10,Assembly,"AB 436 Saldana  Concurrence in Senate Amendments",49,29,2,0,80
60306,4814,2009-04-14,Assembly,"Do pass and be re-referred to the Committee on Public Safety",4,2,1,0,7
60306,4815,2009-04-28,Assembly,"Do pass and be re-referred to the Committee on Appropriations",5,2,0,0,7
60306,4816,2009-05-13,Assembly,"Do pass",11,5,0,0,16
60306,4817,2009-05-21,Assembly,"AB 438 BEALL  Assembly Third Reading",47,31,2,0,80
60306,4818,2009-06-09,Senate,"Do pass, but re-refer to the Committee on Public Safety",3,2,0,0,5
60306,4819,2009-07-07,Senate,"Do pass, but re-refer to the Committee on Appropriations",5,2,0,0,7
60306,4820,2009-08-17,Senate,"Placed on Appropriations Suspense file",13,0,0,0,13
60308,6553,2009-05-05,Assembly,"Do pass",8,0,1,0,9
60308,6554,2009-05-18,Assembly,"AB 440 BEALL  Assembly Third Reading",66,8,6,0,80
60308,6555,2009-07-15,Senate,"Do pass as amended",4,3,2,0,9
60308,6556,2009-07-15,Senate,"Set, second hearing.  Failed passage in Committee. Reconsideration granted",8,0,1,0,9
60309,6557,2009-04-21,Assembly,"Do pass and be re-referred to the Committee on Appropriations",7,0,0,0,7
60309,6558,2009-04-29,Assembly,"Do pass",16,0,0,0,16
60309,6559,2009-05-11,Assembly,"AB 441 HALL  Assembly Third Reading",78,2,0,0,80
60309,9482,2010-06-22,Senate,"Do pass, but re-refer to the Committee on Appropriations",9,0,2,0,11
60309,21256,2010-08-23,Senate,"Assembly 3rd Reading AB441 Hall By Florez",30,3,6,0,39
60309,21439,2010-08-26,Assembly,"Senate amendments be concurred in",18,0,0,3,21
60309,21529,2010-08-27,Assembly,"AB 441 HALL  Concurrence in Senate Amendments",69,3,0,6,78
60310,6536,2009-03-31,Assembly,"Do pass as amended",6,3,1,0,10
60310,6537,2009-04-20,Assembly,"AB 442 ARAMBULA  Assembly Third Reading",43,29,8,0,80
60310,6538,2009-06-09,Senate,"Do pass",3,2,0,0,5
60310,6539,2009-08-24,Senate,"Assembly 3rd Reading AB442 Arambula By Leno",24,15,1,0,40
60311,6561,2009-04-15,Assembly,"Do pass as amended and be re-referred to the Committee on Appropriations",8,0,0,0,8
60311,6562,2009-05-28,Assembly,"Do pass",17,0,0,0,17
60311,6563,2009-06-01,Assembly,"AB 443 GALGIANI  Assembly Third Reading",79,0,1,0,80
60311,6564,2009-07-07,Senate,"Do pass, but re-refer to the Committee on Appropriations",3,0,2,0,5
60311,6565,2009-08-17,Senate,"Do pass",9,0,4,0,13
60311,6566,2009-08-31,Senate,"Assembly 3rd Reading AB443 Galgiani By Maldonado",31,1,8,0,40
60311,6567,2009-09-02,Assembly,"AB 443 GALGIANI  Concurrence in Senate Amendments",75,2,2,0,79
60312,6568,2009-04-14,Assembly,"Do pass as amended and be re-referred to the Committee on Local Government",13,0,0,0,13
60312,6569,2009-04-22,Assembly,"Do pass and be re-referred to the Committee on Appropriations to Consent Calendar",7,0,0,0,7
60312,6570,2009-05-28,Assembly,"Do pass",17,0,0,0,17
60312,6571,2009-06-01,Assembly,"AB 444 CABALLERO  Assembly Third Reading",79,0,1,0,80
60312,6572,2009-07-01,Senate,"Do pass, but re-refer to the Committee on Appropriations Recommend Consent",5,0,0,0,5
60312,6573,2009-07-13,Senate,"Placed on Appropriations Suspense file",12,0,1,0,13
60312,6574,2009-08-27,Senate,"Do pass as amended",13,0,0,0,13
60312,6575,2009-09-02,Senate,"Assembly 3rd Reading AB444 Caballero By Wolk",34,0,6,0,40
60312,6576,2009-09-08,Assembly,"AB 444 CABALLERO  Concurrence in Senate Amendments",78,0,1,0,79
60314,6550,2009-04-22,Assembly,"Do pass as amended and re-refer to Committee on Appropriations with recommendation:  To Consent Calendar",6,0,0,0,6
60314,6551,2009-05-20,Assembly,"Do pass, to Consent Calendar",15,0,1,0,16
60314,6552,2009-05-28,Assembly,"AB 446 NIELLO  Consent Calendar Second Day  Regular Session",76,0,4,0,80
60316,6560,2009-04-28,Assembly,"Do pass and be re-referred to the Committee on Appropriations",10,1,0,0,11
60318,6584,2009-04-28,Assembly,"Do pass and be re-referred to the Committee on Appropriations",10,2,1,0,13
60319,421,2009-04-29,Assembly,"Do pass and re-refer to Committee on Appropriations with recommendation:  To Consent Calendar.",11,0,0,0,11
60319,422,2009-05-28,Assembly,"Do pass as amended.",17,0,0,0,17
60319,423,2009-06-02,Assembly,"AB 451 DE LEON  Assembly Third Reading",76,1,3,0,80
60319,424,2009-07-15,Senate,"Do pass, but re-refer to the Committee on Appropriations.",6,0,3,0,9
60319,9171,2010-06-22,Senate,"Do pass as amended, and re-refer to the Committee on Appropriations",7,0,0,0,7
60319,9172,2010-06-22,Senate,"Do pass as amended, and re-refer to the Committee on Appropriations",7,0,0,0,7
60321,6577,2009-04-20,Assembly,"Do pass and be re-referred to the Committee on Appropriations",3,6,0,0,9
60321,6578,2009-04-20,Assembly,"Set first hearing.  Failed passage.  Reconsideration granted",9,0,0,0,9
60321,6579,2009-04-27,Assembly,"Amend, and re-refer to the Committee on Natural Resources",9,0,0,0,9
60321,6580,2009-05-04,Assembly,"Do pass as amended and be re-referred to the Committee on Appropriations",5,1,3,0,9
60322,6581,2009-03-31,Assembly,"Do pass and be re-referred to the Committee on Appropriations",2,7,0,0,9
60322,6582,2009-03-31,Assembly,"Set first hearing.  Failed passage.  Reconsideration granted",9,0,0,0,9
60322,6583,2009-04-21,Assembly,"Do pass and be re-referred to the Committee on Appropriations",2,7,0,0,9
60324,4538,2009-04-28,Assembly,"Do pass and re-refer to Committee on Appropriations with recommendation:  To Consent Calendar",10,0,1,0,11
60324,4539,2009-05-13,Assembly,"Do pass, to Consent Calendar",16,0,0,0,16
60324,4540,2009-06-01,Assembly,"AB 456 EMMERSON  Assembly Third Reading",78,0,2,0,80
60325,24574,2009-03-31,Assembly,"Do pass",10,0,0,0,10
60325,24575,2009-04-20,Assembly,"AB 457 MONNING  Assembly Third Reading",76,0,0,4,80
60325,24576,2009-06-09,Senate,"Do pass as amended, and re-refer to the Committee on 	Appropriations",5,0,0,0,5
60325,24577,2009-07-09,Senate,"Special Consent #12 AB457 Monning",34,0,6,0,40
60325,24578,2009-07-13,Assembly,"AB 457 MONNING  Concurrence in Senate Amendments",76,0,0,3,79
60326,6599,2009-04-28,Assembly,"Do pass as amended and be re-referred to the Committee on Appropriations",6,0,1,0,7
60326,6600,2009-05-14,Assembly,"AB 458 COOK  Assembly Third Reading",74,0,6,0,80
60326,6601,2009-06-09,Senate,"Do pass",2,5,0,0,7
60326,6602,2009-06-09,Senate,"Set, first hearing.  Failed passage in Committee.  Reconsideration granted",7,0,0,0,7
60327,26476,2009-03-31,Assembly,"Do pass as amended, to Consent Calendar",10,0,0,0,10
60327,26477,2009-04-16,Assembly,"AB 459 LOWENTHAL  Consent Calendar Second Day  Regular Session",70,0,0,10,80
60327,26478,2009-06-09,Senate,"Do pass as amended",5,0,0,0,5
60327,26479,2009-06-22,Senate,"Special Consent #9 AB459 Bonnie Lowenthal",40,0,0,0,40
60327,26480,2009-06-25,Assembly,"AB 459 LOWENTHAL  Concurrence in Senate Amendments",77,0,0,2,79
60329,6587,2009-03-31,Assembly,"Do pass and re-refer to Committee on Appropriations with recommendation:  To Consent Calendar",7,0,0,0,7
60329,6588,2009-05-28,Assembly,"Do pass",17,0,0,0,17
60329,6589,2009-06-01,Assembly,"AB 461 GAINES  Third Reading Urgency",78,0,2,0,80
60330,6615,2009-03-31,Assembly,"Do pass and be re-referred to the Committee on Revenue and Taxation",3,3,3,0,9
60330,6616,2009-03-31,Assembly,"Set first hearing.  Failed passage.  Reconsideration granted",9,0,0,0,9
60330,6617,2009-04-21,Assembly,"Do pass and be re-referred to the Committee on Revenue and Taxation",3,3,3,0,9
60331,26471,2009-04-20,Assembly,"Do pass as amended and be re-referred to the Committee on 	Appropriations",13,0,0,1,14
60331,26472,2009-05-06,Assembly,"Do pass, to Consent Calendar",16,0,0,0,16
60331,26473,2009-05-14,Assembly,"AB 463 TRAN  Consent Calendar Second Day  Regular Session",73,0,0,7,80
60331,26474,2009-06-16,Senate,"Do pass, but re-refer to the Committee on Appropriations",10,0,1,0,11
60331,26475,2009-07-09,Senate,"Special Consent #12 AB463 Tran",34,0,6,0,40
60333,6597,2009-05-06,Assembly,"Do pass as amended",9,0,2,0,11
60333,6598,2009-05-18,Assembly,"AB 465 COTO  Assembly Third Reading",73,2,5,0,80
60334,25645,2009-04-22,Assembly,"Do pass and be re-referred to the Committee on Appropriations",7,0,0,0,7
60334,25646,2009-05-06,Assembly,"Do pass, to Consent Calendar",16,0,0,0,16
60334,25647,2009-05-14,Assembly,"AB 466 COTO  Consent Calendar Second Day  Regular Session",73,0,0,7,80
60334,25648,2009-06-17,Senate,"Do pass, but re-refer to the Committee on Appropriations Recommend 	Consent",5,0,0,0,5
60334,25649,2009-08-27,Senate,"Assembly 3rd Reading AB466 Coto By Maldonado",32,1,7,0,40
60334,25650,2009-08-31,Assembly,"AB 466 COTO  Concurrence in Senate Amendments",78,0,0,1,79
60336,24569,2009-04-01,Assembly,"Do pass",4,2,0,0,6
60336,24570,2009-05-11,Assembly,"AB 468 HAYASHI  Assembly Third Reading",50,30,0,0,80
60336,24571,2009-06-22,Senate,"Do pass, but re-refer to the Committee on Appropriations",4,2,1,0,7
60336,24572,2009-08-27,Senate,"Assembly 3rd Reading AB468 Hayashi By Corbett",22,15,3,0,40
60336,24573,2009-08-31,Assembly,"AB 468 HAYASHI  Concurrence in Senate Amendments",47,30,0,2,79
60337,6604,2009-04-27,Assembly,"Do pass and be re-referred to the Committee on Appropriations",6,2,1,0,9
60337,6605,2009-05-13,Assembly,"Do pass",11,5,0,0,16
60337,6606,2009-05-26,Assembly,"AB 469 ENG  Assembly Third Reading",49,30,1,0,80
60337,6607,2009-07-08,Senate,"Do pass as amended, and re-refer to the Committee on Appropriations",5,2,1,0,8
60337,6608,2009-08-17,Senate,"Do pass",8,3,2,0,13
60337,6609,2009-08-31,Senate,"Assembly 3rd Reading AB469 Eng By Wolk",22,14,4,0,40
60337,6610,2009-09-02,Assembly,"AB 469 ENG  Concurrence in Senate Amendments",47,30,2,0,79
60338,24564,2009-05-06,Assembly,"Do pass, to Consent Calendar",9,0,0,1,10
60338,24565,2009-05-14,Assembly,"AB 470 NIELLO  Consent Calendar Second Day  Regular Session",73,0,0,7,80
60338,24566,2009-06-17,Senate,"Do pass, but re-refer to the Committee on Judiciary Recommend 	Consent",11,0,1,0,12
60338,24567,2009-06-23,Senate,"Do pass and be placed on the Consent Calendar",5,0,0,0,5
60338,24568,2009-06-29,Senate,"Consent Calendar 2nd AB470 Niello",40,0,0,0,40
60339,6611,2009-04-28,Assembly,"Do pass as amended and be re-referred to the Committee on Appropriations",10,0,0,0,10
60339,6612,2009-05-20,Assembly,"Do pass, to Consent Calendar",15,0,1,0,16
60339,6613,2009-05-28,Assembly,"AB 471 NAVA  Consent Calendar Second Day  Regular Session",76,0,4,0,80
60339,6614,2009-06-23,Senate,"Do pass as amended, and re-refer to the Committee on Appropriations",3,2,0,0,5
60339,10240,2010-06-29,Senate,"Do pass as amended, and re-refer to the Committee on Appropriations",3,1,1,0,5
60339,20694,2010-08-20,Senate,"Assembly 3rd Reading AB471 Nava By Corbett",23,9,6,0,38
60339,21269,2010-08-25,Assembly,"Senate amendments be concurred in",9,0,0,1,10
60339,21538,2010-08-27,Assembly,"AB 471 NAVA  Concurrence in Senate Amendments",74,0,0,4,78
60340,6590,2009-04-30,Assembly,"Do pass and re-refer to Committee on Appropriations with recommendation:  To Consent Calendar",16,0,3,0,19
60340,6591,2009-05-13,Assembly,"Do pass, to Consent Calendar",16,0,0,0,16
60340,6592,2009-05-21,Assembly,"AB 472 BLUMENFIELD  Consent Calendar Second Day  Regular Session",77,0,3,0,80
60340,6593,2009-07-08,Senate,"Do pass as amended, and re-refer to the Committee on Appropriations",7,1,5,0,13
60340,6594,2009-08-17,Senate,"Do pass as amended",10,0,3,0,13
60340,6595,2009-09-01,Senate,"Assembly 3rd Reading AB472 Blumenfield By Alquist",33,2,5,0,40
60340,6596,2009-09-03,Assembly,"AB 472 BLUMENFIELD  Concurrence in Senate Amendments",77,0,2,0,79
60341,6626,2009-04-13,Assembly,"Do pass and be re-referred to the Committee on Local Government",6,3,0,0,9
60341,6627,2009-04-29,Assembly,"Do pass",5,2,0,0,7
60341,6628,2009-05-18,Assembly,"AB 473 BLUMENFIELD  Assembly Third Reading",48,29,3,0,80
60341,6629,2009-06-22,Senate,"Do pass",5,2,0,0,7
60341,6630,2009-09-03,Senate,"Assembly 3rd Reading AB473 Blumenfield By Ducheny",24,11,5,0,40
60341,6631,2009-09-09,Assembly,"AB 473 BLUMENFIELD  Concurrence in Senate Amendments",52,25,2,0,79
60342,24652,2009-04-22,Assembly,"Do pass as amended",5,0,0,2,7
60342,24653,2009-05-21,Assembly,"AB 474 BLUMENFIELD  Assembly Third Reading",61,14,0,5,80
60342,24654,2009-07-08,Senate,"Do pass",3,1,1,0,5
60342,24655,2009-09-09,Senate,"Assembly 3rd Reading AB474 Blumenfield By Price",26,10,4,0,40
60342,24656,2009-09-10,Assembly,"AB 474 Blumenfield  Concurrence in Senate Amendments",62,15,0,3,80
60344,6618,2009-04-01,Assembly,"Do pass as amended and be re-referred to the Committee on Appropriations",8,3,0,0,11
60344,6619,2009-05-28,Assembly,"Do pass as amended",12,5,0,0,17
60344,6620,2009-06-03,Assembly,"AB 476 TORLAKSON  Assembly Third Reading",52,26,2,0,80
60344,6621,2009-07-08,Senate,"Do pass, but re-refer to the Committee on Appropriations",7,1,1,0,9
60344,6622,2009-08-17,Senate,"Placed on Appropriations Suspense file",13,0,0,0,13
60344,6623,2009-08-27,Senate,"Do pass",7,5,1,0,13
60344,6624,2009-09-04,Senate,"Assembly 3rd Reading AB476 Torlakson By Hancock",26,13,1,0,40
60344,6625,2009-09-10,Assembly,"AB 476 TORLAKSON  Concurrence in Senate Amendments",50,28,2,0,80
60346,6645,2009-04-13,Assembly,"Do pass and be re-referred to the Committee on Appropriations",6,3,0,0,9
60346,6646,2009-05-28,Assembly,"Do pass",12,5,0,0,17
60346,6647,2009-06-01,Assembly,"AB 478 CHESBRO  Assembly Third Reading",50,29,1,0,80
60346,6648,2009-07-06,Senate,"Do pass, but re-refer to the Committee on Appropriations",5,2,0,0,7
60347,6640,2009-04-13,Assembly,"Do pass as amended and be re-referred to the Committee on Appropriations",6,3,0,0,9
60347,6641,2009-05-28,Assembly,"Do pass",11,5,1,0,17
60347,6642,2009-06-02,Assembly,"AB 479 CHESBRO  Assembly Third Reading",41,32,7,0,80
60347,6643,2009-07-06,Senate,"Do pass as amended, and re-refer to the Committee on Appropriations",5,2,0,0,7
60347,6644,2009-08-17,Senate,"Placed on Appropriations Suspense file",13,0,0,0,13
60348,6635,2009-04-21,Assembly,"Do pass and be re-referred to the Committee on Appropriations",11,0,0,0,11
60348,6636,2009-05-28,Assembly,"Do pass as amended",17,0,0,0,17
60348,6637,2009-06-02,Assembly,"AB 480 TRAN  Assembly Third Reading",78,0,2,0,80
60348,6638,2009-07-08,Senate,"Do pass, but re-refer to the Committee on Appropriations Recommend Consent",11,0,2,0,13
60348,6639,2009-08-17,Senate,"Placed on Appropriations Suspense file",13,0,0,0,13
60350,4485,2009-04-15,Assembly,"Do pass as amended and be re-referred to the Committee on Appropriations",8,2,1,0,11
60350,4486,2009-05-28,Assembly,"Do pass as amended",12,5,0,0,17
60350,4487,2009-06-03,Assembly,"AB 482 MENDOZA  Assembly Third Reading",48,30,2,0,80
60350,4488,2009-07-15,Senate,"Do pass, but re-refer to the Committee on Appropriations",6,1,2,0,9
60350,4489,2010-06-09,Senate,"Do pass, but re-refer to the Committee on Judiciary",4,0,2,0,6
60350,9786,2010-06-29,Senate,"Do pass as amended, and re-refer to the Committee on Appropriations",3,1,1,0,5
60350,19187,2010-08-02,Senate,"Do pass",7,3,0,1,11
60350,20821,2010-08-23,Senate,"Assembly 3rd Reading AB482 Mendoza Reconsider",36,0,0,3,39
60350,21403,2010-08-26,Senate,"Assembly 3rd Reading AB482 Mendoza By Leno",21,14,0,4,39
60350,21712,2010-08-30,Assembly,"Senate amendments be concurred in",7,3,0,0,10
60350,21850,2010-08-31,Assembly,"AB 482 MENDOZA  Concurrence in Senate Amendments",45,30,0,3,78
60350,22027,2010-08-23,Senate,"Assembly 3rd Reading AB482 Mendoza By Leno",19,16,0,4,39
60351,24643,2009-04-01,Assembly,"Do pass and be re-referred to the Committee on Judiciary",10,0,0,0,10
60351,24644,2009-04-27,Assembly,"Do pass and be re-referred to the Committee on Appropriations",10,0,0,0,10
60351,24645,2009-05-13,Assembly,"Do pass",16,0,0,0,16
60351,24646,2009-05-21,Assembly,"AB 483 BUCHANAN  Assembly Third Reading",78,0,0,2,80
60351,24647,2009-06-17,Senate,"Do pass as amended, and re-refer to the Committee on Judiciary",8,1,3,0,12
60351,24648,2009-07-14,Senate,"Do pass, but re-refer to the Committee on Appropriations",4,1,0,0,5
60351,24649,2009-08-24,Senate,"Do pass",8,5,0,0,13
60351,24650,2009-09-08,Senate,"Assembly 3rd Reading AB483 Buchanan By Corbett",33,7,0,0,40
60351,24651,2009-09-10,Assembly,"AB 483 BUCHANAN  Concurrence in Senate Amendments",78,0,0,2,80
60352,6660,2009-04-14,Assembly,"Do pass and be re-referred to the Committee on Revenue and Taxation",5,4,2,0,11
60352,6661,2009-04-14,Assembly,"Set first hearing.  Failed passage.  Reconsideration granted",10,0,1,0,11
60352,6662,2009-04-21,Assembly,"Do pass and be re-referred to the Committee on Revenue and Taxation",4,5,2,0,11
60353,26454,2009-04-22,Assembly,"Do pass and be re-referred to the Committee on Judiciary",7,0,0,0,7
60353,26455,2009-04-27,Assembly,"Do pass and be re-referred to the Committee on Appropriations",9,1,0,0,10
60353,26456,2009-05-13,Assembly,"Do pass",11,4,0,1,16
60353,26457,2009-05-26,Assembly,"AB 485 CARTER  Assembly Third Reading",66,8,0,6,80
60353,26458,2009-06-25,Senate,"Do pass, but re-refer to the Committee on Judiciary",6,0,0,0,6
60353,26459,2009-07-07,Senate,"Do pass as amended, and re-refer to the Committee on 	Appropriations",3,2,0,0,5
60353,26460,2009-08-17,Senate,"Do pass",9,3,1,0,13
60353,26461,2009-09-01,Senate,"Assembly 3rd Reading AB485 Carter By Hollingsworth",28,7,5,0,40
60353,26462,2009-09-03,Assembly,"AB 485 CARTER  Concurrence in Senate Amendments",66,9,0,4,79
60354,24639,2009-04-15,Assembly,"Do pass, to Consent Calendar",7,0,0,0,7
60354,24640,2009-04-23,Assembly,"AB 486 CHESBRO  Consent Calendar Second Day  Regular Session",71,0,0,9,80
60354,24641,2009-06-09,Senate,"Do pass and be placed on the Consent Calendar",9,0,3,0,12
60354,24642,2009-06-15,Senate,"Consent Calendar 2nd AB486 Chesbro",36,0,4,0,40
60355,24633,2009-04-01,Assembly,"Do pass as amended and be re-referred to the Committee on 	Appropriations",8,0,0,3,11
60355,24634,2009-05-28,Assembly,"Do pass as amended",12,0,0,5,17
60355,24635,2009-06-02,Assembly,"AB 487 BROWNLEY  Assembly Third Reading",78,0,0,2,80
60355,24636,2009-07-01,Senate,"Do pass, but re-refer to the Committee on Appropriations Recommend 	Consent",8,0,1,0,9
60355,24637,2009-08-24,Senate,"Special Consent #15 AB487 Brownley",39,0,1,0,40
60355,24638,2009-08-27,Assembly,"AB 487 BROWNLEY  Concurrence in Senate Amendments",77,0,0,2,79
60356,26016,2009-04-14,Assembly,"Do pass as amended and be re-referred to the Committee on 	Appropriations",6,0,0,1,7
60356,26017,2009-04-29,Assembly,"Do pass",16,0,0,0,16
60356,26018,2009-05-14,Assembly,"AB 488 TORRES  Assembly Third Reading",72,0,0,8,80
60356,26019,2009-06-09,Senate,"Do pass as amended, and re-refer to the Committee on Appropriations",5,0,0,0,5
60356,26020,2009-07-23,Senate,"Do pass",13,0,0,0,13
60356,26021,2009-08-24,Senate,"Special Consent #15 AB488 Torres By Negrete McLeod",39,0,1,0,40
60356,26022,2009-08-27,Assembly,"AB 488 TORRES  Concurrence in Senate Amendments",75,0,0,4,79
60357,6663,2009-04-28,Assembly,"Do pass and be re-referred to the Committee on Appropriations",8,4,1,0,13
60357,6664,2009-05-28,Assembly,"Do pass",12,5,0,0,17
60357,6665,2009-06-02,Assembly,"AB 489 HUFFMAN  Assembly Third Reading",44,31,5,0,80
60357,6666,2009-07-06,Senate,"Do pass as amended, and re-refer to the Committee on Appropriations",7,3,1,0,11
60357,6667,2009-08-17,Senate,"Do pass",8,5,0,0,13
60357,6668,2009-09-04,Senate,"Assembly 3rd Reading AB489 Huffman Reconsider",39,0,1,0,40
60358,25915,2009-03-31,Assembly,"Do pass and be re-referred to the Committee on Agriculture",11,0,0,0,11
60358,25916,2009-04-29,Assembly,"Do pass as amended and re-refer to Committee on Appropriations 	with recommendation:  To Consent Calendar",8,0,0,0,8
60358,25917,2009-05-13,Assembly,"Do pass",12,1,0,3,16
60358,25918,2009-05-21,Assembly,"AB 490 SMYTH  Assembly Third Reading",77,0,0,3,80
60358,25919,2009-06-29,Senate,"Do pass as amended, and re-refer to the Committee on Appropriations",10,0,0,0,10
60358,25920,2009-08-27,Senate,"Special Consent #16 AB490 Smyth By Strickland",38,0,2,0,40
60358,25921,2009-09-01,Assembly,"AB 490 SMYTH  Concurrence in Senate Amendments",78,0,0,1,79
60359,6632,2009-04-21,Assembly,"Do pass and be re-referred to the Committee on Appropriations",6,1,0,0,7
60359,6633,2009-04-29,Assembly,"Do pass as amended",16,0,0,0,16
60359,6634,2009-05-14,Assembly,"AB 491 GARRICK  Assembly Third Reading",70,0,10,0,80
60360,6649,2009-05-05,Assembly,"Do pass as amended",5,0,4,0,9
60360,6650,2009-05-21,Assembly,"AB 492 CONWAY  Assembly Third Reading",54,11,15,0,80
60360,6651,2009-07-15,Senate,"Do pass",4,3,2,0,9
60360,6652,2009-07-15,Senate,"Set, first hearing.  Failed passage in Committee.  Reconsideration granted",8,0,1,0,9
60361,6679,2009-04-22,Assembly,"Do pass as amended and be re-referred to the Committee on Labor and Employment",2,7,1,0,10
60362,24626,2009-04-15,Assembly,"Do pass and be re-referred to the Committee on Agriculture",6,0,0,1,7
60362,24627,2009-04-29,Assembly,"Do pass and be re-referred to the Committee on Appropriations",5,1,0,2,8
60362,24628,2009-05-13,Assembly,"Do pass",12,3,0,1,16
60362,24629,2009-06-01,Assembly,"AB 494 CABALLERO  Assembly Third Reading",63,11,0,6,80
60362,24630,2009-07-08,Senate,"Do pass as amended, and re-refer to the Committee on 	Appropriations",3,2,0,0,5
60362,24631,2009-08-31,Senate,"Assembly 3rd Reading AB494 Caballero By Ducheny",27,9,4,0,40
60362,24632,2009-09-03,Assembly,"AB 494 CABALLERO  Concurrence in Senate Amendments",65,10,0,4,79
60363,6653,2009-04-15,Assembly,"Do pass as amended and be re-referred to the Committee on Appropriations",9,1,1,0,11
60364,6654,2009-04-28,Assembly,"Do pass",7,4,0,0,11
60364,6655,2009-05-28,Assembly,"AB 496 DAVIS  Assembly Third Reading",49,30,1,0,80
60364,19754,2010-08-10,Senate,"Do pass, but re-refer to the Committee on Appropriations",4,0,1,0,5
60364,20054,2010-08-12,Senate,"Placed on Appropriations Suspense file",11,0,0,0,11
60365,6656,2009-04-20,Assembly,"Do pass",10,0,4,0,14
60365,6657,2009-05-18,Assembly,"AB 497 BLOCK  Assembly Third Reading",73,0,7,0,80
60365,6658,2009-06-23,Senate,"Do pass as amended",3,4,4,0,11
60365,6659,2009-06-23,Senate,"Set, second hearing.  Failed passage in Committee. Reconsideration granted",10,0,1,0,11
60366,630,2010-01-07,Assembly,"Be referred to Committee on Transportation.",10,0,1,0,11
60366,631,2010-01-11,Assembly,"Do pass and be re-referred to the Committee on Appropriations.",14,0,0,0,14
60366,632,2010-01-21,Assembly,"Do pass as amended.",17,0,0,0,17
60366,633,2010-01-27,Assembly,"AB 498 HAYASHI  Assembly Third Reading",72,1,5,0,78
60366,8917,2010-06-15,Senate,"Do pass, but re-refer to the Committee on Appropriations",8,0,1,0,9
60366,9643,2010-06-28,Senate,"Placed on Appropriations Suspense file",10,0,1,0,11
60366,20183,2010-08-12,Senate,"Do pass as amended",11,0,0,0,11
60366,20748,2010-08-19,Senate,"Assembly 3rd Reading AB498 Hayashi By Denham",34,0,4,0,38
60366,20921,2010-08-23,Assembly,"AB 498 HAYASHI  Concurrence in Senate Amendments",77,0,0,1,78
60367,6669,2009-04-13,Assembly,"Do pass and be re-referred to the Committee on Judiciary",6,3,0,0,9
60367,6670,2009-04-21,Assembly,"Do pass and be re-referred to the Committee on Appropriations",7,3,0,0,10
60367,6671,2009-04-29,Assembly,"Do pass",11,5,0,0,16
60367,6672,2009-05-21,Assembly,"AB 499 HILL  Assembly Third Reading  Amend By HILL  Set #1",51,27,2,0,80
60367,6673,2009-05-28,Assembly,"AB 499 HILL  Assembly Third Reading",47,30,3,0,80
60367,6674,2009-06-22,Senate,"Do pass, but re-refer to the Committee on Appropriations",5,2,0,0,7
60367,21697,2010-08-30,Senate,"Assembly 3rd Reading AB499 Hill By Corbett",22,15,2,0,39
60367,21793,2010-08-31,Assembly,"AB 499 HILL  Concurrence in Senate Amendments",49,28,0,1,78
60369,26380,2009-04-21,Assembly,"Do pass and be re-referred to the Committee on Appropriations",11,0,0,0,11
60369,26381,2009-05-06,Assembly,"Do pass",16,0,0,0,16
60369,26382,2009-05-28,Assembly,"AB 501 EMMERSON  Assembly Third Reading",80,0,0,0,80
60369,26383,2009-06-29,Senate,"Do pass, but re-refer to the Committee on Appropriations",10,0,0,0,10
60369,26384,2009-07-06,Senate,"Do pass",11,0,2,0,13
60369,26385,2009-08-17,Senate,"Special Consent #14 AB501 Emmerson By Kehoe",35,0,5,0,40
60369,26386,2009-08-20,Assembly,"AB 501 EMMERSON  Concurrence in Senate Amendments",78,0,0,1,79
60370,6676,2009-04-22,Assembly,"Do pass and be re-referred to the Committee on Appropriations",4,2,0,0,6
60370,6677,2009-05-28,Assembly,"Do pass as amended",12,0,5,0,17
60370,6678,2009-06-03,Assembly,"AB 502 FURUTANI  Assembly Third Reading",49,28,3,0,80
60371,6685,2009-03-31,Assembly,"Do pass as amended and be re-referred to the Committee on Appropriations",19,0,0,0,19
60371,6686,2009-04-29,Assembly,"Do pass",16,0,0,0,16
60371,6687,2009-05-11,Assembly,"AB 503 FURUTANI  Assembly Third Reading",80,0,0,0,80
60371,6688,2009-06-10,Senate,"Do pass as amended, and re-refer to the Committee on Appropriations",8,1,2,0,11
60371,6689,2009-07-13,Senate,"Do pass",11,0,2,0,13
60371,6690,2009-09-02,Senate,"Assembly 3rd Reading AB503 Furutani By Wolk",39,0,1,0,40
60371,6691,2009-09-08,Assembly,"AB 503 FURUTANI  Concurrence in Senate Amendments",78,0,1,0,79
60372,6692,2009-03-31,Assembly,"Do pass and be re-referred to the Committee on Appropriations",7,0,0,0,7
60372,6693,2009-05-28,Assembly,"Do pass as amended",17,0,0,0,17
60372,6694,2009-06-02,Assembly,"AB 504 FURUTANI  Assembly Third Reading",76,0,4,0,80
60372,6695,2009-07-14,Senate,"Do pass, but re-refer to the Committee on Appropriations",7,0,0,0,7
60372,6696,2009-09-01,Senate,"Assembly 3rd Reading AB504 Furutani By Liu",36,0,4,0,40
60372,6697,2009-09-03,Assembly,"AB 504 FURUTANI  Concurrence in Senate Amendments",77,0,2,0,79
60373,6698,2010-01-12,Assembly,"Do pass and be re-referred to the Committee on Appropriations",4,2,1,0,7
60374,26558,2009-04-01,Assembly,"Do pass and re-refer to Committee on Appropriations with 	recommendation:  To Consent Calendar",6,0,0,0,6
60374,26559,2009-04-22,Assembly,"Do pass, to Consent Calendar",16,0,0,1,17
60374,26560,2009-05-04,Assembly,"AB 506 FURUTANI  Consent Calendar Second Day  Regular Session",79,0,0,1,80
60374,26561,2009-06-22,Senate,"Do pass, but re-refer to the Committee on Appropriations",7,0,0,0,7
60374,26562,2009-07-13,Senate,"Do pass",11,0,2,0,13
60374,26563,2009-08-17,Senate,"Special Consent #14 AB506 Furutani",35,0,5,0,40
60374,26564,2009-08-20,Assembly,"AB 506 FURUTANI  Concurrence in Senate Amendments",78,0,0,1,79
60375,6675,2009-04-21,Assembly,"Do pass as amended and be re-referred to the Committee on Appropriations",5,2,0,0,7
60376,6714,2009-04-13,Assembly,"Do pass as amended and be re-referred to the Committee on Appropriations",9,4,1,0,14
60377,6715,2009-03-31,Assembly,"Do pass as amended",7,0,0,0,7
60377,6716,2009-04-20,Assembly,"AB 509 ANDERSON  Assembly Third Reading",76,0,4,0,80
60378,25731,2009-04-14,Assembly,"Do pass and be re-referred to the Committee on Appropriations",4,2,0,1,7
60378,25732,2009-05-28,Assembly,"Do pass",12,5,0,0,17
60378,25733,2009-06-01,Assembly,"AB 510 EVANS  Assembly Third Reading",50,28,0,2,80
60378,25734,2009-06-23,Senate,"Do pass, but re-refer to the Committee on Appropriations",3,2,0,0,5
60378,25735,2009-07-13,Senate,"Placed on Appropriations Suspense file",12,0,1,0,13
60378,25736,2010-02-11,Senate,"Assembly 3rd Reading AB510 Skinner By Kehoe",27,5,7,0,39
60378,25737,2010-02-18,Assembly,"AB 510 SKINNER  Concurrence in Senate Amendments",61,4,0,14,79
60379,6680,2009-04-28,Assembly,"Do pass as amended and be re-referred to the Committee on Appropriations",19,0,0,0,19
60379,6681,2009-05-28,Assembly,"Do pass",14,3,0,0,17
60379,6682,2009-06-01,Assembly,"AB 511 DE LA TORRE  Assembly Third Reading",69,5,6,0,80
60379,6683,2009-07-08,Senate,"Do pass as amended, and re-refer to the Committee on Appropriations",10,1,0,0,11
60379,6684,2009-08-17,Senate,"Placed on Appropriations Suspense file",13,0,0,0,13
60381,6699,2009-04-28,Assembly,"Do pass as amended and be re-referred to the Committee on Appropriations",12,3,4,0,19
60381,6700,2009-05-28,Assembly,"Do pass",12,5,0,0,17
60381,6701,2009-06-02,Assembly,"AB 513 DE LEON  Assembly Third Reading",50,28,2,0,80
60381,6702,2009-07-15,Senate,"Do pass as amended, and re-refer to the Committee on Appropriations",6,3,2,0,11
60381,6703,2009-08-17,Senate,"Placed on Appropriations Suspense file",13,0,0,0,13
60381,6704,2009-08-27,Senate,"Do pass as amended",8,5,0,0,13
60381,6705,2009-09-03,Senate,"Assembly 3rd Reading AB513 De Leon By Pavley",24,15,1,0,40
60381,6706,2009-09-09,Assembly,"AB 513 DE LEON  Concurrence in Senate Amendments",49,28,2,0,79
60382,6727,2009-04-22,Assembly,"Do pass and be re-referred to the Committee on Appropriations",5,2,0,0,7
60383,26565,2009-04-14,Assembly,"Do pass and be re-referred to the Committee on Judiciary",10,0,0,1,11
60383,26566,2009-04-21,Assembly,"Do pass and re-refer to Committee on Appropriations with 	recommendation:  To Consent Calendar",10,0,0,0,10
60383,26567,2009-05-06,Assembly,"Do pass, to Consent Calendar",16,0,0,0,16
60383,26568,2009-05-14,Assembly,"AB 515 HAGMAN  Consent Calendar Second Day  Regular Session",73,0,0,7,80
60383,26569,2009-06-09,Senate,"Do pass, but re-refer to the Committee on Appropriations",5,0,0,0,5
60383,26570,2009-07-13,Senate,"Do pass as amended",11,0,2,0,13
60383,26571,2009-09-02,Senate,"Special Consent #18 AB515 Hagman By Calderon",39,0,1,0,40
60383,26572,2009-09-08,Assembly,"AB 515 HAGMAN  Concurrence in Senate Amendments",79,0,0,0,79
60384,6724,2009-05-06,Assembly,"Do pass as amended",3,6,1,0,10
60384,6725,2009-05-06,Assembly,"Set first hearing.  Failed passage.  Reconsideration granted",10,0,0,0,10
60384,6726,2010-01-06,Assembly,"Do pass as amended",5,6,1,0,12
60385,6707,2009-04-14,Assembly,"Do pass and be re-referred to the Committee on Appropriations",17,0,2,0,19
60385,6708,2009-04-29,Assembly,"Do pass",16,0,0,0,16
60385,6709,2009-05-26,Assembly,"AB 517 MA  Assembly Third Reading",78,0,2,0,80
60385,6710,2009-07-15,Senate,"Do pass as amended, and re-refer to the Committee on Appropriations",8,2,1,0,11
60385,6711,2009-08-24,Senate,"Do pass",8,2,3,0,13
60385,6712,2009-09-01,Senate,"Assembly 3rd Reading AB517 Ma By Alquist",23,15,2,0,40
60385,6713,2009-09-03,Assembly,"AB 517 MA  Concurrence in Senate Amendments",77,0,2,0,79
60386,6723,2009-04-15,Assembly,"Do pass as amended and be re-referred to the Committee on Appropriations",8,2,1,0,11
60387,6718,2009-04-27,Assembly,"Do pass as amended and be re-referred to the Committee on Appropriations",14,0,0,0,14
60387,6719,2009-05-13,Assembly,"Do pass, to Consent Calendar",16,0,0,0,16
60387,6720,2009-05-21,Assembly,"AB 519 DUVALL  Consent Calendar Second Day  Regular Session",77,0,3,0,80
60387,6721,2009-06-23,Senate,"Do pass as amended, and re-refer to the Committee on Judiciary",11,0,0,0,11
60387,6722,2009-07-14,Senate,"Do pass as amended, and re-refer to the Committee on Appropriations",5,0,0,0,5
60387,21298,2010-08-24,Senate,"Assembly 3rd Reading AB519 Solorio By Lowenthal",23,10,6,0,39
60387,21299,2010-08-25,Assembly,"AB 519 SOLORIO  Concurrence in Senate Amendments",58,16,0,4,78
60389,26492,2009-04-13,Assembly,"Do pass as amended",12,2,0,1,15
60389,26493,2009-05-04,Assembly,"AB 521 DE LA TORRE  Assembly Third Reading",67,12,0,1,80
60389,26494,2009-07-07,Senate,"Do pass",11,0,0,0,11
60389,26495,2009-09-01,Senate,"Assembly 3rd Reading AB521 De La Torre By Padilla",27,5,8,0,40
60389,26496,2009-09-03,Assembly,"AB 521 DE LA TORRE  Concurrence in Senate Amendments",62,13,0,4,79
60391,27025,2009-04-14,Assembly,"Do pass and be re-referred to the Committee on Appropriations",17,0,0,2,19
60391,27026,2009-04-29,Assembly,"Do pass, to Consent Calendar",16,0,0,0,16
60391,27027,2009-05-11,Assembly,"AB 523 HUFFMAN  Consent Calendar Second Day  Regular Session",78,0,0,2,80
60391,27028,2009-07-08,Senate,"Do pass as amended, and re-refer to the Committee on Appropriations",9,0,2,0,11
60391,27029,2009-08-27,Senate,"Special Consent #16 AB523 Huffman",38,0,2,0,40
60391,27030,2009-08-31,Assembly,"AB 523 HUFFMAN  Concurrence in Senate Amendments",78,0,0,1,79
60392,24620,2009-05-04,Assembly,"Be referred to Committee on Judiciary",10,0,0,1,11
60392,24621,2009-05-12,Assembly,"Do pass as amended",8,2,0,0,10
60392,24622,2009-06-02,Assembly,"AB 524 BASS  Assembly Third Reading",55,14,0,11,80
60392,24623,2009-07-14,Senate,"Do pass as amended, and re-refer to the Committee on 	Appropriations",3,2,0,0,5
60392,24624,2009-09-08,Senate,"Assembly 3rd Reading AB524 Bass By Price",25,15,0,0,40
60392,24625,2009-09-10,Assembly,"AB 524 BASS  Concurrence in Senate Amendments",57,20,0,3,80
60394,6736,2009-04-21,Assembly,"Do pass and be re-referred to the Committee on Health",11,0,0,0,11
60394,6737,2009-04-28,Assembly,"Do pass and be re-referred to the Committee on Appropriations",18,0,1,0,19
60394,6738,2009-05-28,Assembly,"Do pass as amended",12,5,0,0,17
60394,6739,2009-06-02,Assembly,"AB 526 FUENTES  Assembly Third Reading",68,9,3,0,80
60394,6740,2009-07-06,Senate,"Do pass, but re-refer to the Committee on Appropriations",6,2,2,0,10
60394,6741,2009-08-24,Senate,"Placed on Appropriations Suspense file",13,0,0,0,13
60395,6729,2009-04-01,Assembly,"Do pass as amended",5,2,0,0,7
60395,6730,2009-04-20,Assembly,"AB 527 FUENTES  Assembly Third Reading",45,28,7,0,80
60395,6731,2009-07-08,Senate,"Do pass",2,2,2,0,6
60395,6732,2009-07-08,Senate,"Set, second hearing.  Failed passage in Committee. Reconsideration granted",5,0,1,0,6
60395,6733,2009-07-16,Senate,"Do pass",4,0,2,0,6
60395,6734,2009-09-03,Senate,"Assembly 3rd Reading AB527 Fuentes By DeSaulnier",23,16,1,0,40
60395,6735,2009-09-10,Assembly,"AB 527 FUENTES  Concurrence in Senate Amendments",46,29,5,0,80
60396,26497,2009-04-22,Assembly,"Do pass and be re-referred to the Committee on Elections and 	Redistricting to Consent Calendar",7,0,0,0,7
60396,26498,2009-05-05,Assembly,"Do pass, to Consent Calendar",7,0,0,0,7
60396,26499,2009-05-11,Assembly,"AB 528 SILVA  Consent Calendar Second Day  Regular Session",78,0,0,2,80
60396,26500,2009-06-17,Senate,"Do pass and be placed on the Consent Calendar",5,0,0,0,5
60396,26501,2009-06-24,Senate,"Consent Calendar 2nd AB528 Silva",40,0,0,0,40
60396,26502,2009-07-06,Assembly,"AB 528 SILVA  Concurrence in Senate Amendments",78,0,0,1,79
60398,24615,2009-04-21,Assembly,"Do pass as amended",10,0,0,0,10
60398,24616,2009-05-18,Assembly,"AB 530 KREKORIAN  Assembly Third Reading",77,0,0,3,80
60398,24617,2009-06-16,Senate,"Do pass as amended, and re-refer to the Committee on 	Appropriations",5,0,0,0,5
60398,24618,2009-09-02,Senate,"Special Consent #18 AB530 Krekorian By Corbett",39,0,1,0,40
60398,24619,2009-09-08,Assembly,"AB 530 KREKORIAN  Concurrence in Senate Amendments",79,0,0,0,79
60399,25599,2009-04-20,Assembly,"Do pass as amended and be re-referred to the Committee on 	Appropriations",15,0,0,0,15
60399,25600,2009-05-28,Assembly,"Do pass",17,0,0,0,17
60399,25601,2009-06-01,Assembly,"AB 531 SALDANA  Assembly Third Reading",77,1,0,2,80
60399,25602,2009-07-07,Senate,"Do pass, but re-refer to the Committee on Appropriations",11,0,0,0,11
60399,25603,2009-08-31,Senate,"Assembly 3rd Reading AB531 Saldana By Wright",35,0,5,0,40
60399,25604,2009-09-02,Assembly,"AB 531 SALDANA  Concurrence in Senate Amendments",78,0,0,1,79
60400,26487,2009-05-12,Assembly,"Do pass",7,0,0,0,7
60400,26488,2009-05-18,Assembly,"AB 532 LIEU  Assembly Third Reading",75,0,0,5,80
60400,26489,2009-06-16,Senate,"Do pass as amended",6,0,1,0,7
60400,26490,2009-09-01,Senate,"Assembly 3rd Reading AB532 Lieu By Pavley",25,6,9,0,40
60400,26491,2009-09-03,Assembly,"AB 532 LIEU  Concurrence in Senate Amendments",77,0,0,2,79
60401,6745,2009-04-01,Assembly,"Do pass as amended and be re-referred to the Committee on Appropriations",8,1,2,0,11
60402,6746,2009-04-01,Assembly,"Do pass",3,5,3,0,11
60402,6747,2009-04-01,Assembly,"Set first hearing.  Failed passage.  Reconsideration granted",11,0,0,0,11
60403,6748,2010-01-05,Assembly,"Do pass and be re-referred to the Committee on Aging and Longterm Care",16,0,3,0,19
60403,6749,2010-01-12,Assembly,"Do pass as amended and be re-referred to the Committee on Appropriations",5,0,0,0,5
60405,3388,2009-04-29,Assembly,"Do pass and be re-referred to the Committee on Appropriations",8,0,0,0,8
60405,3389,2010-01-21,Assembly,"Do pass as amended",12,4,1,0,17
60405,3390,2010-01-27,Assembly,"AB 537 ARAMBULA  Assembly Third Reading",66,3,9,0,78
60405,9319,2010-06-22,Senate,"Do pass as amended, and re-refer to the Committee on Appropriations",4,1,0,0,5
60405,19257,2010-08-02,Senate,"Placed on Appropriations Suspense file",10,0,1,0,11
60405,20204,2010-08-12,Senate,"Do pass as amended",7,4,0,0,11
60405,20947,2010-08-23,Senate,"Assembly 3rd Reading AB537 Arambula By Leno",23,12,4,0,39
60405,21061,2010-08-24,Assembly,"AB 537 ARAMBULA  Concurrence in Senate Amendments",56,14,0,8,78
60406,6762,2009-03-31,Assembly,"Do pass and be re-referred to the Committee on Appropriations",7,0,0,0,7
60406,6763,2009-04-22,Assembly,"Do pass, to Consent Calendar",16,0,1,0,17
60406,6764,2009-05-04,Assembly,"AB 538 ARAMBULA  Consent Calendar Second Day  Regular Session",79,0,1,0,80
60406,6765,2009-06-09,Senate,"Do pass as amended, and re-refer to the Committee on Appropriations",7,0,0,0,7
60406,6766,2009-07-09,Senate,"Special Consent #12 AB538 Arambula",34,0,6,0,40
60406,6767,2009-07-16,Assembly,"AB 538 ARAMBULA  Concurrence in Senate Amendments",72,0,7,0,79
60407,26577,2009-04-14,Assembly,"Do pass and be re-referred to the Committee on Public Employees, 	Retirement and Social Security to Consent Calendar",9,0,0,2,11
60407,26578,2009-04-22,Assembly,"Do pass and re-refer to Committee on Appropriations with 	recommendation:  To Consent Calendar",6,0,0,0,6
60407,26579,2009-05-06,Assembly,"Do pass, to Consent Calendar",16,0,0,0,16
60407,26580,2009-05-14,Assembly,"AB 539 MONNING  Consent Calendar Second Day  Regular Session",73,0,0,7,80
60407,26581,2009-06-23,Senate,"Do pass, but re-refer to the Committee on Appropriations Recommend 	Consent",12,0,1,0,13
60407,26582,2009-07-09,Senate,"Special Consent #12 AB539 Monning",34,0,6,0,40
60408,26503,2009-04-14,Assembly,"Do pass and re-refer to Committee on Appropriations with 	recommendation:  To Consent Calendar",9,0,0,2,11
60408,26504,2009-04-29,Assembly,"Do pass, to Consent Calendar",16,0,0,0,16
60408,26505,2009-05-11,Assembly,"AB 540 MONNING  Consent Calendar Second Day  Regular Session",78,0,0,2,80
60408,26506,2009-06-23,Senate,"Do pass, but re-refer to the Committee on Appropriations",12,0,1,0,13
60408,26507,2009-07-09,Senate,"Special Consent #12 AB540 Monning",34,0,6,0,40
60410,6742,2009-04-28,Assembly,"Do pass as amended and be re-referred to the Committee on Appropriations",13,3,3,0,19
60410,6743,2009-05-28,Assembly,"Do pass",12,5,0,0,17
60410,6744,2009-06-01,Assembly,"AB 542 FEUER  Assembly Third Reading",50,26,4,0,80
60410,10196,2010-06-30,Senate,"Do pass as amended, and re-refer to the Committee on Appropriations",6,2,1,0,9
60410,19228,2010-08-02,Senate,"Placed on Appropriations Suspense file",10,0,1,0,11
60410,20136,2010-08-12,Senate,"Do pass as amended",7,3,1,0,11
60410,20844,2010-08-23,Senate,"Assembly 3rd Reading AB542 Feuer By Alquist",22,13,4,0,39
60410,21099,2010-08-25,Assembly,"AB 542 FEUER  Concurrence in Senate Amendments",52,26,0,0,78
60411,6750,2009-04-28,Assembly,"Do pass as amended and be re-referred to the Committee on Appropriations",18,0,1,0,19
60411,6751,2009-05-28,Assembly,"Do pass as amended",17,0,0,0,17
60411,6752,2009-06-02,Assembly,"AB 543 MA  Assembly Third Reading",78,0,2,0,80
60411,6753,2009-07-08,Senate,"Do pass, but re-refer to the Committee on Appropriations",10,1,0,0,11
60411,6754,2009-08-17,Senate,"Do pass as amended",12,0,1,0,13
60411,6755,2009-09-01,Senate,"Assembly 3rd Reading AB543 Ma Urgency Clause",32,1,7,0,40
60411,6756,2009-09-03,Assembly,"AB 543 MA  Concurrence in Senate Amendments",77,0,2,0,79
60412,24608,2009-04-13,Assembly,"Be referred to Committee on Education",9,0,0,2,11
60412,24609,2009-04-29,Assembly,"Do pass as amended and be re-referred to the Committee on 	Appropriations",11,0,0,0,11
60412,24610,2009-05-20,Assembly,"Do pass, to Consent Calendar",15,0,0,1,16
60412,24611,2009-05-28,Assembly,"AB 544 COTO  Consent Calendar Second Day  Regular Session",76,0,0,4,80
60412,24612,2009-07-01,Senate,"Do pass as amended, but re-refer to the Committee on Appropriations 	Recommend Consent",8,0,1,0,9
60412,24613,2009-08-24,Senate,"Special Consent #15 AB544 Coto",39,0,1,0,40
60412,24614,2009-08-27,Assembly,"AB 544 COTO  Concurrence in Senate Amendments",77,0,0,2,79
60415,25033,2009-04-15,Assembly,"Do pass and be re-referred to the Committee on Appropriations",8,0,0,0,8
60415,25034,2009-04-29,Assembly,"Do pass",16,0,0,0,16
60415,25035,2009-05-11,Assembly,"AB 547 MENDOZA  Assembly Third Reading",80,0,0,0,80
60415,25036,2009-07-07,Senate,"Do pass, but re-refer to the Committee on Appropriations",4,0,1,0,5
60415,25037,2009-07-23,Senate,"Do pass",13,0,0,0,13
60415,25038,2009-08-31,Senate,"Assembly 3rd Reading AB547 Mendoza By Florez",35,0,5,0,40
60416,6757,2009-04-15,Assembly,"Do pass and be re-referred to the Committee on Appropriations",7,0,0,0,7
60416,6758,2009-05-28,Assembly,"Do pass as amended",13,3,1,0,17
60416,6759,2009-06-03,Assembly,"AB 548 KREKORIAN  Assembly Third Reading",78,0,2,0,80
60416,6760,2009-07-01,Senate,"Do pass, but re-refer to the Committee on Appropriations Recommend Consent",5,0,0,0,5
60416,6761,2009-07-13,Senate,"Do pass",12,0,1,0,13
60416,9371,2010-06-23,Senate,"Do pass, but re-refer to the Committee on Appropriations",7,0,2,0,9
60416,10940,2010-07-15,Senate,"Placed on Appropriations Suspense file",8,0,2,0,10
60417,6773,2010-01-12,Assembly,"Do pass and be re-referred to the Committee on Appropriations",11,0,0,0,11
60417,6774,2010-01-21,Assembly,"Do pass as amended",15,1,1,0,17
60417,6775,2010-01-27,Assembly,"AB 549 FURUTANI  Assembly Third Reading",68,4,6,0,78
60417,9686,2010-06-28,Senate,"Do pass as amended, and re-refer to the Committee on Appropriations",5,2,2,0,9
60417,19227,2010-08-02,Senate,"Placed on Appropriations Suspense file",10,0,1,0,11
60417,20131,2010-08-12,Senate,"Do pass as amended",7,4,0,0,11
60417,21088,2010-08-25,Senate,"Assembly 3rd Reading AB549 Furutani By Negrete McLeod",33,1,5,0,39
60417,21480,2010-08-26,Assembly,"AB 549 FURUTANI  Concurrence in Senate Amendments",67,7,0,4,78
60418,6776,2009-04-20,Assembly,"Do pass and be re-referred to the Committee on Appropriations",11,0,0,0,11
60419,6777,2009-04-27,Assembly,"Do pass and be re-referred to the Committee on Appropriations",6,0,3,0,9
60419,6778,2010-01-21,Assembly,"Do pass as amended",12,0,5,0,17
60419,6779,2010-01-27,Assembly,"AB 551 FURUTANI  Assembly Third Reading",72,0,6,0,78
60420,27273,2009-03-31,Assembly,"Do pass and be re-referred to the Committee on Appropriations",7,0,0,2,9
60420,27274,2009-05-28,Assembly,"Do pass as amended",12,5,0,0,17
60420,27275,2009-06-03,Assembly,"AB 552 FURUTANI  Assembly Third Reading",55,20,0,5,80
60420,27276,2010-03-23,Senate,"Do pass as amended, and re-refer to the Committee on 	Appropriations",5,0,2,0,7
60420,27277,2010-04-26,Senate,"Do pass",8,1,2,0,11
60420,27278,2010-05-10,Senate,"Assembly 3rd Reading AB552 Solorio Urgency Clause",30,0,8,0,38
60420,27279,2010-05-20,Assembly,"Senate amendments be concurred in",5,0,0,2,7
60420,27280,2010-05-28,Assembly,"AB 552 SOLORIO  Concurrence- Urgency Added",62,0,0,17,79
60422,6785,2009-04-29,Assembly,"Do pass as amended and be re-referred to the Committee on Appropriations",11,0,0,0,11
60423,6783,2009-04-27,Assembly,"Do pass and be re-referred to the Committee on Education",7,0,2,0,9
60423,6784,2009-04-29,Assembly,"Do pass as amended and be re-referred to the Committee on Appropriations",11,0,0,0,11
60425,6768,2009-04-29,Assembly,"Do pass and re-refer to Committee on Appropriations with recommendation:  To Consent Calendar",8,0,0,0,8
60425,6769,2009-05-13,Assembly,"Do pass, to Consent Calendar",16,0,0,0,16
60425,6770,2009-05-21,Assembly,"AB 557 CABALLERO  Consent Calendar Second Day  Regular Session",77,0,3,0,80
60425,6771,2009-07-07,Senate,"Do pass, but re-refer to the Committee on Appropriations",5,0,0,0,5
60425,6772,2009-08-24,Senate,"Special Consent #15 AB557 Caballero By Maldonado",39,0,1,0,40
60426,4305,2009-04-01,Assembly,"Do pass and be re-referred to the Committee on Housing and Community Development",7,0,0,0,7
60426,4306,2010-01-04,Assembly,"Be referred to Committee on Public Safety",10,0,1,0,11
60426,4307,2010-01-12,Assembly,"Do pass and be re-referred to the Committee on Appropriations",7,0,0,0,7
60426,4308,2010-01-21,Assembly,"Do pass",15,0,2,0,17
60426,4309,2010-01-27,Assembly,"AB 558 PORTANTINO  Assembly Third Reading",72,0,6,0,78
60426,8726,2010-06-15,Senate,"Do pass, but re-refer to the Committee on Appropriations",7,0,0,0,7
60426,20128,2010-08-11,Senate,"Assembly 3rd Reading AB558 Portantino By Hancock",33,0,5,0,38
60426,20300,2010-08-16,Assembly,"AB 558 PORTANTINO  Concurrence in Senate Amendments",72,1,0,6,79
60428,6804,2009-04-20,Assembly,"Do pass and be re-referred to the Committee on Appropriations",10,3,2,0,15
60428,6805,2009-04-29,Assembly,"Do pass",11,5,0,0,16
60428,6806,2009-05-14,Assembly,"AB 560 SKINNER  Assembly Third Reading",47,22,11,0,80
60428,6807,2009-07-07,Senate,"Do pass as amended, and re-refer to the Committee on Appropriations",9,1,1,0,11
60428,6808,2009-08-17,Senate,"Placed on Appropriations Suspense file",13,0,0,0,13
60428,6809,2009-08-27,Senate,"Do pass as amended",12,1,0,0,13
60429,24701,2009-03-31,Assembly,"Do pass and re-refer to Committee on Appropriations with 	recommendation:  To Consent Calendar",7,0,0,0,7
60429,24702,2009-04-22,Assembly,"Do pass, to Consent Calendar",16,0,0,1,17
60429,24703,2009-05-04,Assembly,"AB 561 CARTER  Consent Calendar Second Day  Regular Session",79,0,0,1,80
60429,24704,2009-06-09,Senate,"Do pass as amended, and re-refer to the Committee on Appropriations",7,0,0,0,7
60429,24705,2009-07-09,Senate,"Special Consent #12 AB561 Carter",34,0,6,0,40
60429,24706,2009-07-13,Assembly,"AB 561 CARTER  Concurrence in Senate Amendments",77,0,0,2,79
60430,6781,2009-04-21,Assembly,"Do pass and be re-referred to the Committee on Judiciary",8,3,8,0,19
60430,6782,2009-04-21,Assembly,"Set second hearing.  Failed passage.  Reconsideration granted",19,0,0,0,19
60431,24707,2009-04-20,Assembly,"Do pass and be re-referred to the Committee on Appropriations",9,0,0,0,9
60431,24708,2009-04-29,Assembly,"Do pass as amended, to Consent Calendar",16,0,0,0,16
60431,24709,2009-05-11,Assembly,"AB 563 COOK  Consent Calendar Second Day  Regular Session",78,0,0,2,80
60431,24710,2009-06-23,Senate,"Do pass as amended, and re-refer to the Committee on Revenue and 	Taxation",6,0,1,0,7
60431,24711,2009-07-08,Senate,"Do pass, but re-refer to the Committee on Appropriations",8,0,0,0,8
60431,24712,2009-08-27,Senate,"Special Consent #16 AB563 Cook By Denham",38,0,2,0,40
60431,24713,2009-09-08,Senate,"Assembly 3rd Reading AB563 Cook Urgency Clause",40,0,0,0,40
60431,24714,2009-09-11,Assembly,"AB 563 COOK  Concurrence- Urgency Added",78,0,0,1,79
60432,6786,2009-04-20,Assembly,"Do pass as amended",3,7,4,0,14
60432,6787,2009-04-20,Assembly,"Set first hearing.  Failed passage.  Reconsideration granted",14,0,0,0,14
60432,6788,2009-04-27,Assembly,"Do pass as amended",8,3,3,0,14
60432,6789,2009-05-14,Assembly,"AB 564 PORTANTINO  Assembly Third Reading  Amend By PORTANTINO  Set #1",47,20,13,0,80
60432,6790,2009-05-18,Assembly,"AB 564 PORTANTINO  Assembly Third Reading",51,17,12,0,80
60432,6791,2009-07-15,Senate,"Do pass as amended, and re-refer to the Committee on Appropriations",7,2,2,0,11
60432,6792,2009-08-17,Senate,"Placed on Appropriations Suspense file",13,0,0,0,13
60432,6793,2009-08-27,Senate,"Do pass as amended",13,0,0,0,13
60432,6794,2009-09-09,Senate,"Assembly 3rd Reading AB564 Portantino Reconsider",40,0,0,0,40
60432,9760,2010-06-28,Senate,"Assembly 3rd Reading AB564 Portantino By Yee",28,4,7,0,39
60432,21310,2010-08-24,Assembly,"Senate amendments be concurred in",18,0,0,0,18
60432,21504,2010-08-26,Assembly,"AB 564 PORTANTINO  Concurrence in Senate Amendments",75,0,0,3,78
60434,6821,2009-04-29,Assembly,"Do pass and be re-referred to the Committee on Appropriations",5,2,0,0,7
60434,6822,2009-04-29,Assembly,"Do pass and be re-referred to the Committee on Local Government",4,2,1,0,7
60434,6823,2009-05-13,Assembly,"Do pass",9,6,1,0,16
60434,6824,2009-05-28,Assembly,"AB 566 NAVA  Assembly Third Reading",41,31,8,0,80
60434,6825,2009-06-23,Senate,"Do pass, but re-refer to the Committee on Appropriations",5,4,2,0,11
60434,6826,2009-06-23,Senate,"Set, first hearing.  Failed passage in Committee.  Reconsideration granted",10,0,1,0,11
60434,6827,2009-07-14,Senate,"Do pass as amended",7,4,0,0,11
60434,6828,2009-09-09,Senate,"Assembly 3rd Reading AB566 Nava Reconsider",40,0,0,0,40
60434,6829,2009-09-10,Senate,"Assembly 3rd Reading AB566 Nava By Wolk",21,14,5,0,40
60434,6830,2009-09-12,Assembly,"AB 566 Nava  Concurrence in Senate Amendments",44,28,7,0,79
60435,24691,2009-04-14,Assembly,"Do pass and be re-referred to the Committee on Public Employees, 	Retirement and Social Security to Consent Calendar",9,0,0,2,11
60435,24692,2009-04-22,Assembly,"Do pass as amended and re-refer to Committee on Appropriations 	with recommendation:  To Consent Calendar",6,0,0,0,6
60435,24693,2009-05-06,Assembly,"Do pass, to Consent Calendar",16,0,0,0,16
60435,24694,2009-05-14,Assembly,"AB 567 VILLINES  Consent Calendar Second Day  Regular Session",73,0,0,7,80
60435,24695,2009-06-09,Senate,"Do pass, but re-refer to the Committee on Judiciary",9,0,3,0,12
60435,24696,2009-07-14,Senate,"Do pass as amended, but re-refer to the Committee on 	Appropriations Recommend Consent",5,0,0,0,5
60435,24697,2009-08-17,Senate,"Placed on Appropriations Suspense file",13,0,0,0,13
60435,24698,2009-08-27,Senate,"Do pass as amended",12,0,1,0,13
60435,24699,2009-09-04,Senate,"Special Consent #19 AB567 Villines",40,0,0,0,40
60435,24700,2009-09-09,Assembly,"AB 567 VILLINES  Concurrence in Senate Amendments",78,0,0,1,79
60436,24684,2009-04-28,Assembly,"Do pass as amended and be re-referred to the Committee on 	Appropriations",10,0,0,0,10
60436,24685,2009-05-20,Assembly,"Do pass, to Consent Calendar",15,0,0,1,16
60436,24686,2009-05-28,Assembly,"AB 568 LIEU  Consent Calendar Second Day  Regular Session",76,0,0,4,80
60436,24687,2009-07-14,Senate,"Do pass as amended, and re-refer to the Committee on 	Appropriations",4,0,1,0,5
60436,24688,2009-08-17,Senate,"Do pass as amended",8,0,5,0,13
60436,24689,2009-09-09,Senate,"Assembly 3rd Reading AB568 Lieu By Wright",35,2,3,0,40
60436,24690,2009-09-10,Assembly,"AB 568 Lieu  Concurrence in Senate Amendments",79,0,0,1,80
60437,98,2009-04-22,Assembly,"Do pass as amended and be re-referred to the Committee on Appropriations.",7,0,0,0,7
60437,99,2009-05-13,Assembly,"Do pass.",16,0,0,0,16
60437,100,2009-05-21,Assembly,"AB 569 EMMERSON  Assembly Third Reading",72,2,6,0,80
60437,101,2009-06-25,Senate,"Do pass as amended, and re-refer to the Committee on Appropriations.",6,0,0,0,6
60437,9480,2010-06-23,Senate,"Do pass, but re-refer to the Committee on Appropriations",5,0,1,0,6
60437,21268,2010-08-25,Senate,"Assembly 3rd Reading AB569 Emmerson By Emmerson",27,1,11,0,39
60437,21454,2010-08-26,Assembly,"AB 569  Concurrence in Senate Amendments By BERRYHILL, B",70,4,0,4,78
60438,24678,2009-04-15,Assembly,"Do pass and be re-referred to the Committee on Appropriations",5,0,0,2,7
60438,24679,2009-04-29,Assembly,"Do pass",11,2,0,3,16
60438,24680,2009-05-11,Assembly,"AB 570 ARAMBULA  Assembly Third Reading",55,21,0,4,80
60438,24681,2009-06-09,Senate,"Do pass as amended, and re-refer to the Committee on Appropriations",8,3,0,0,11
60438,24682,2009-08-24,Senate,"Assembly 3rd Reading AB570 Arambula By Lowenthal",23,12,5,0,40
60438,24683,2009-08-27,Assembly,"AB 570 ARAMBULA  Concurrence in Senate Amendments",50,22,0,7,79
60439,6797,2009-04-14,Assembly,"Do pass as amended and be re-referred to the Committee on Appropriations",10,2,1,0,13
60439,6798,2009-04-29,Assembly,"Do pass",11,5,0,0,16
60439,6799,2009-05-26,Assembly,"AB 571 SALDANA  Assembly Third Reading",50,25,5,0,80
60439,6800,2009-07-06,Senate,"Do pass as amended, and re-refer to the Committee on Appropriations",7,2,2,0,11
60439,6801,2009-08-17,Senate,"Do pass",8,1,4,0,13
60439,6802,2009-08-31,Senate,"Assembly 3rd Reading AB571 Saldana By Ducheny",28,7,5,0,40
60439,6803,2009-09-02,Assembly,"AB 571 SALDANA  Concurrence in Senate Amendments",50,24,5,0,79
60440,6817,2009-04-29,Assembly,"Do pass as amended and be re-referred to the Committee on Appropriations",8,3,0,0,11
60440,6818,2009-05-28,Assembly,"AB 572 BROWNLEY  Assembly Third Reading",51,29,0,0,80
60440,6819,2009-06-17,Senate,"Do pass, but re-refer to the Committee on Judiciary",6,1,2,0,9
60440,6820,2009-07-01,Senate,"Do pass as amended",3,2,0,0,5
60440,21019,2010-08-24,Senate,"Assembly 3rd Reading AB572 Brownley By Simitian",21,14,4,0,39
60440,21512,2010-08-26,Assembly,"AB 572 BROWNLEY  Concurrence in Senate Amendments",51,27,0,0,78
60441,25413,2009-05-05,Assembly,"Do pass and be re-referred to the Committee on Rules",9,0,0,0,9
60441,25414,2009-06-02,Assembly,"Do pass",8,0,0,3,11
60441,25415,2009-06-03,Assembly,"AB 573 PORTANTINO  Third Reading Urgency",78,0,0,2,80
60441,25416,2009-06-24,Senate,"Do pass",5,0,0,0,5
60441,25417,2009-07-09,Senate,"Special Consent #12 AB573 Portantino",34,0,6,0,40
60442,6811,2009-04-21,Assembly,"Do pass as amended and be re-referred to the Committee on Appropriations",13,4,2,0,19
60442,6812,2009-05-06,Assembly,"Do pass",11,5,0,0,16
60442,6813,2009-05-18,Assembly,"AB 574 HILL  Assembly Third Reading",46,25,9,0,80
60442,6814,2009-06-17,Senate,"Do pass, but re-refer to the Committee on Appropriations",6,3,2,0,11
60442,6815,2009-06-29,Senate,"Do pass",7,5,1,0,13
60442,6816,2009-08-27,Senate,"Assembly 3rd Reading AB574 Hill By Leno",21,15,4,0,40
60444,24672,2009-03-31,Assembly,"Do pass and be re-referred to the Committee on Appropriations",7,0,0,0,7
60444,24673,2009-04-22,Assembly,"Do pass",16,0,0,1,17
60444,24674,2009-04-30,Assembly,"AB 576 TORRES  Assembly Third Reading",76,0,0,4,80
60444,24675,2009-06-09,Senate,"Do pass, but re-refer to the Committee on Appropriations",7,0,0,0,7
60444,24676,2009-07-16,Senate,"Special Consent #13 AB576 Torres",36,0,4,0,40
60444,24677,2009-08-17,Assembly,"AB 576 TORRES  Concurrence in Senate Amendments",75,0,0,4,79
60445,24665,2009-04-21,Assembly,"Do pass and be re-referred to the Committee on Health to Consent 	Calendar",6,0,0,0,6
60445,24666,2009-04-28,Assembly,"Do pass and re-refer to Committee on Appropriations with 	recommendation:  To Consent Calendar",18,0,0,1,19
60445,24667,2009-05-06,Assembly,"Do pass, to Consent Calendar",16,0,0,0,16
60445,24668,2009-05-14,Assembly,"AB 577 LOWENTHAL  Consent Calendar Second Day  Regular Session",73,0,0,7,80
60445,24669,2009-06-17,Senate,"Do pass, but re-refer to the Committee on Appropriations",9,0,2,0,11
60445,24670,2009-09-02,Senate,"Assembly 3rd Reading AB577 Bonnie Lowenthal By Leno",35,0,5,0,40
60445,24671,2009-09-08,Assembly,"AB 577 LOWENTHAL  Concurrence in Senate Amendments",79,0,0,0,79
60446,6795,2009-05-05,Assembly,"Do pass, to Consent Calendar",10,0,0,0,10
60446,6796,2009-05-11,Assembly,"AB 578 HUBER  Consent Calendar Second Day  Regular Session",78,0,2,0,80
60447,6837,2009-04-21,Assembly,"Do pass and be re-referred to the Committee on Appropriations",10,0,1,0,11
60447,6838,2009-05-28,Assembly,"Do pass as amended",13,0,4,0,17
60447,6839,2009-06-02,Assembly,"AB 579 HUBER  Assembly Third Reading",75,1,4,0,80
60447,6840,2009-07-08,Senate,"Do pass, but re-refer to the Committee on Appropriations",9,0,4,0,13
60447,6841,2009-08-24,Senate,"Placed on Appropriations Suspense file",13,0,0,0,13
60447,6842,2009-08-27,Senate,"Do pass as amended",13,0,0,0,13
60447,6843,2009-09-04,Senate,"Special Consent #19 AB579 Huber",40,0,0,0,40
60447,6844,2009-09-11,Assembly,"AB 579 HUBER  Concurrence in Senate Amendments",78,1,0,0,79
60448,6834,2009-04-14,Assembly,"Do pass as amended and be re-referred to the Committee on Appropriations",7,0,0,0,7
60448,6835,2009-05-28,Assembly,"Do pass as amended",12,0,5,0,17
60448,6836,2009-06-02,Assembly,"AB 580 HUBER  Assembly Third Reading",74,0,6,0,80
60449,6832,2009-03-31,Assembly,"Do pass and be re-referred to the Committee on Appropriations",8,0,1,0,9
60449,6833,2010-01-04,Assembly,"Be referred to Committee on Higher Education",10,0,1,0,11
60451,6852,2009-03-31,Assembly,"Do pass, to Consent Calendar",11,0,0,0,11
60451,6853,2009-04-13,Assembly,"AB 583 HAYASHI  Consent Calendar Second Day  Regular Session",78,0,2,0,80
60451,6854,2009-06-29,Senate,"Do pass as amended",8,2,0,0,10
60451,6855,2009-07-16,Senate,"Assembly 3rd Reading AB583 Hayashi By Negrete McLeod",23,12,5,0,40
60451,6856,2009-07-16,Senate,"Assembly 3rd Reading AB583 Hayashi Reconsider",36,0,4,0,40
60451,21052,2010-08-24,Senate,"Assembly 3rd Reading AB583 Hayashi By Negrete McLeod",27,9,3,0,39
60451,21199,2010-08-25,Assembly,"AB 583 HAYASHI  Concurrence in Senate Amendments",67,11,0,0,78
60452,1456,2010-01-11,Assembly,"Do pass as amended and be re-referred to the Committee on Appropriations",14,0,0,0,14
60452,1457,2010-01-21,Assembly,"Do pass",17,0,0,0,17
60452,1458,2010-01-25,Assembly,"AB 584 Huber  Assembly Third Reading",67,0,11,0,78
60452,8933,2010-06-15,Senate,"Do pass, but re-refer to the Committee on Appropriations",7,1,1,0,9
60452,19871,2010-08-11,Senate,"Assembly 3rd Reading AB584 Huber By Pavley",34,0,4,0,38
60452,20294,2010-08-16,Assembly,"AB 584 HUBER  Concurrence in Senate Amendments",71,0,0,8,79
60453,12719,2009-04-14,Assembly,"Do pass, to Consent Calendar",10,0,0,0,10
60453,12720,2009-04-20,Assembly,"AB 585 DUVALL  Consent Calendar Second Day  Regular Session",75,0,5,0,80
60453,12721,2009-07-07,Senate,"Do pass",5,0,0,0,5
60453,12722,2009-09-08,Senate,"Assembly 3rd Reading AB585 Duvall By Denham",24,10,6,0,40
60453,12723,2010-04-29,Senate,"Assembly 3rd Reading AB585 Cook By Denham",34,0,4,0,38
60453,12724,2010-05-03,Assembly,"AB 585 COOK  Concurrence in Senate Amendments",76,0,3,0,79
60454,1835,2009-05-06,Assembly,"Do pass as amended and be re-referred to the Committee on Appropriations",7,2,1,0,10
60454,1836,2009-05-28,Assembly,"Do pass",12,5,0,0,17
60454,1837,2009-06-02,Assembly,"AB 586 HUBER  Assembly Third Reading",49,29,2,0,80
60454,1838,2009-07-08,Senate,"Do pass, but re-refer to the Committee on Appropriations",4,1,1,0,6
60454,1839,2009-08-24,Senate,"Placed on Appropriations Suspense file",13,0,0,0,13
60454,1840,2010-05-03,Senate,"Do pass",6,0,0,0,6
60454,9113,2010-06-17,Senate,"Assembly 3rd Reading AB586 Ma Urgency Clause",33,0,6,0,39
60454,9246,2010-06-23,Assembly,"Senate amendments be concurred in",11,1,0,0,12
60454,9583,2010-06-28,Assembly,"AB 586 MA  Concurrence- Urgency Added",74,0,5,0,79
60457,4500,2009-03-31,Assembly,"Do pass and be re-referred to the Committee on Veterans Affairs to Consent Calendar",7,0,0,0,7
60457,4501,2009-04-14,Assembly,"Do pass as amended and be re-referred to the Committee on Appropriations",8,0,1,0,9
60457,4502,2009-05-28,Assembly,"Do pass as amended",17,0,0,0,17
60457,4503,2009-06-02,Assembly,"AB 589 COOK  Assembly Third Reading",78,0,2,0,80
60457,4504,2009-06-23,Senate,"Do pass, but re-refer to the Committee on Public Safety",6,0,1,0,7
60457,4505,2009-07-07,Senate,"Do pass, but re-refer to the Committee on Appropriations",7,0,0,0,7
60457,4506,2009-07-23,Senate,"Placed on Appropriations Suspense file",13,0,0,0,13
60457,8803,2010-06-15,Senate,"Do pass, but re-refer to the Committee on Public Safety",2,5,2,0,9
60457,8804,2010-06-15,Senate,"Set, second hearing.  Failed passage in Committee. Reconsideration granted",8,0,1,0,9
60458,24657,2009-04-21,Assembly,"Do pass as amended and be re-referred to the Committee on 	Appropriations",7,2,0,1,10
60458,24658,2009-05-28,Assembly,"Do pass",12,5,0,0,17
60458,24659,2009-06-01,Assembly,"AB 590 FEUER  Assembly Third Reading",50,29,0,1,80
60458,24660,2009-07-14,Senate,"Do pass",3,2,0,0,5
60458,24661,2009-08-24,Senate,"Do pass, but re-refer to the Committee on Appropriations",3,1,1,0,5
60458,24662,2009-08-27,Senate,"Do pass",8,5,0,0,13
60458,24663,2009-09-09,Senate,"Assembly 3rd Reading AB590 Feuer By Leno",23,13,4,0,40
60458,24664,2009-09-10,Assembly,"AB 590 Feuer  Concurrence in Senate Amendments",52,26,0,2,80
60459,8471,2009-04-22,Assembly,"Do pass and be re-referred to the Committee on Health",10,0,0,0,10
60459,8472,2009-04-28,Assembly,"Do pass and be re-referred to the Committee on Appropriations",19,0,0,0,19
60459,8473,2009-05-28,Assembly,"Do pass as amended",12,5,0,0,17
60459,8474,2009-06-02,Assembly,"AB 591 DE LA TORRE  Assembly Third Reading",76,1,3,0,80
60459,8475,2009-07-09,Senate,"Do pass, but re-refer to the Committee on Health",8,1,3,0,12
60459,8476,2009-07-15,Senate,"Do pass as amended, and re-refer to the Committee on Appropriations",7,3,1,0,11
60459,8477,2009-08-17,Senate,"Placed on Appropriations Suspense file",13,0,0,0,13
60459,10337,2010-06-30,Senate,"Do pass as amended, and re-refer to the Committee on Appropriations",5,2,2,0,9
60459,19205,2010-08-02,Senate,"Placed on Appropriations Suspense file",10,0,1,0,11
60460,6845,2009-04-20,Assembly,"Do pass and be re-referred to the Committee on Appropriations",13,0,1,0,14
60462,6831,2009-04-27,Assembly,"Be referred to Committee on Local Government",10,0,1,0,11
60463,26705,2009-05-12,Assembly,"Do pass and be re-referred to the Committee on Appropriations",7,0,0,0,7
60463,26706,2009-05-28,Assembly,"Do pass",17,0,0,0,17
60463,26707,2009-06-01,Assembly,"AB 595 ADAMS  Third Reading Urgency",79,0,0,1,80
60463,26708,2009-06-23,Senate,"Do pass, but re-refer to the Committee on Public Safety",5,0,0,0,5
60463,26709,2009-07-13,Senate,"Do pass",12,0,1,0,13
60463,26710,2009-08-17,Senate,"Special Consent #14 AB595 Adams",35,0,5,0,40
60464,6862,2009-04-29,Assembly,"Do pass as amended and be re-referred to the Committee on Appropriations",5,2,0,0,7
60466,6861,2009-04-28,Assembly,"Do pass as amended and be re-referred to the Committee on Appropriations",13,5,1,0,19
60467,6846,2009-04-21,Assembly,"Do pass and be re-referred to the Committee on Appropriations",17,0,2,0,19
60467,6847,2009-05-06,Assembly,"Do pass, to Consent Calendar",16,0,0,0,16
60467,6848,2009-05-18,Assembly,"AB 599 HALL  Assembly Third Reading",76,0,4,0,80
60467,6849,2009-07-08,Senate,"Do pass, but re-refer to the Committee on Public Safety",10,0,1,0,11
60467,6850,2009-08-31,Senate,"Assembly 3rd Reading AB599 Hall By Strickland",36,0,4,0,40
60467,6851,2009-09-02,Assembly,"AB 599 HALL  Concurrence in Senate Amendments",76,0,3,0,79
60468,6871,2009-04-14,Assembly,"Do pass and be re-referred to the Committee on Appropriations",8,3,0,0,11
60468,6872,2009-04-29,Assembly,"Do pass",11,5,0,0,16
60468,6873,2009-05-11,Assembly,"AB 600 HALL  Third Reading Urgency",58,17,5,0,80
60468,6874,2009-07-08,Senate,"Do pass, but re-refer to the Committee on Appropriations",10,0,3,0,13
60468,6875,2009-08-31,Senate,"Assembly 3rd Reading AB600 Hall Urgency Clause",36,0,4,0,40
60469,27054,2009-04-22,Assembly,"Do pass and be re-referred to the Committee on Appropriations",9,0,0,1,10
60469,27055,2009-05-28,Assembly,"Do pass as amended",17,0,0,0,17
60469,27056,2009-06-02,Assembly,"AB 601 GARRICK  Assembly Third Reading",75,0,0,5,80
60469,27057,2009-07-09,Senate,"Do pass, but re-refer to the Committee on Appropriations Recommend 	Consent",11,0,1,0,12
60469,27058,2009-08-17,Senate,"Do pass",12,0,1,0,13
60469,27059,2009-08-31,Senate,"Assembly 3rd Reading AB601 Garrick By Runner",36,0,4,0,40
60470,6857,2009-03-31,Assembly,"Do pass and re-refer to Committee on Appropriations with recommendation:  To Consent Calendar",11,0,0,0,11
60470,6858,2009-04-22,Assembly,"Do pass, to Consent Calendar",16,0,1,0,17
60470,6859,2009-05-04,Assembly,"AB 602 PRICE  Consent Calendar Second Day  Regular Session",79,0,1,0,80
60470,9867,2010-06-29,Senate,"Do pass",6,3,0,0,9
60470,21635,2010-08-24,Senate,"Assembly 3rd Reading AB602 Feuer By Steinberg",27,5,7,0,39
60470,21636,2010-08-25,Assembly,"Senate amendments be concurred in",6,1,0,3,10
60470,21637,2010-08-25,Assembly,"Be referred to Committee on Local Government",6,1,0,3,10
60470,21638,2010-08-26,Assembly,"Senate amendments be concurred in",3,2,0,4,9
60470,21639,2010-08-26,Assembly,"Set first hearing.  Failed passage.  Reconsideration granted",9,0,0,0,9
60470,21691,2010-08-30,Assembly,"Senate amendments be concurred in",5,1,0,3,9
60470,21692,2010-08-30,Assembly,"AB 602 Feuer  Concurrence in Senate Amendments",53,20,0,5,78
60471,6860,2009-05-12,Assembly,"Do pass as amended",6,3,1,0,10
60472,27201,2009-04-29,Assembly,"Do pass as amended and re-refer to Committee on Appropriations 	with recommendation:  To Consent Calendar",8,0,0,0,8
60472,27202,2009-05-28,Assembly,"Do pass",17,0,0,0,17
60472,27203,2009-06-01,Assembly,"AB 604 FULLER  Assembly Third Reading",78,0,0,2,80
60472,27204,2009-07-07,Senate,"Do pass, but re-refer to the Committee on Appropriations",4,1,0,0,5
60472,27205,2009-08-17,Senate,"Placed on Appropriations Suspense file",13,0,0,0,13
60472,27206,2009-08-27,Senate,"Do pass as amended",13,0,0,0,13
60472,27207,2010-04-12,Senate,"Do pass",10,0,1,0,11
60472,27208,2010-04-15,Senate,"Assembly 3rd Reading AB604 De Leon Urgency Clause",36,0,3,0,39
60472,27209,2010-04-22,Assembly,"AB 604 DE LEON  Concurrence in Senate Amendments",75,0,0,4,79
60473,1530,2009-04-30,Assembly,"Do pass and be re-referred to the Committee on Appropriations",16,0,3,0,19
60473,1531,2009-05-13,Assembly,"Do pass",16,0,0,0,16
60473,1532,2009-05-21,Assembly,"AB 605 PORTANTINO  Assembly Third Reading",76,1,3,0,80
60473,1533,2009-07-08,Senate,"Do pass, but re-refer to the Committee on Appropriations",10,0,3,0,13
60473,9240,2010-06-22,Senate,"Do pass as amended, and re-refer to the Committee on Appropriations",8,1,2,0,11
60473,19535,2010-08-02,Senate,"Do pass",8,1,2,0,11
60473,20633,2010-08-18,Senate,"Assembly 3rd Reading AB605 Portantino By Calderon",27,6,5,0,38
60473,21446,2010-08-26,Assembly,"Senate amendments be concurred in",18,0,0,3,21
60473,21533,2010-08-27,Assembly,"AB 605 PORTANTINO  Concurrence in Senate Amendments",61,8,0,9,78
60474,26723,2009-04-15,Assembly,"Do pass and be re-referred to the Committee on Judiciary",7,1,0,0,8
60474,26724,2009-04-21,Assembly,"Do pass and re-refer to Committee on Appropriations with 	recommendation:  To Consent Calendar",10,0,0,0,10
60474,26725,2009-05-28,Assembly,"Do pass",17,0,0,0,17
60474,26726,2009-06-01,Assembly,"AB 606 MA  Assembly Third Reading",75,1,0,4,80
60474,26727,2009-07-07,Senate,"Do pass as amended, and re-refer to the Committee on Public Safety",3,2,0,0,5
60474,26728,2009-08-17,Senate,"Do pass",10,1,2,0,13
60474,26729,2009-09-01,Senate,"Assembly 3rd Reading AB606 Ma By Maldonado",25,13,2,0,40
60474,26730,2009-09-03,Assembly,"AB 606 MA  Concurrence in Senate Amendments",70,3,0,6,79
60476,6863,2009-04-21,Assembly,"Do pass and re-refer to Committee on Appropriations with recommendation:  To Consent Calendar",10,0,1,0,11
60476,6864,2009-04-29,Assembly,"Do pass, to Consent Calendar",16,0,0,0,16
60476,6865,2009-05-11,Assembly,"AB 608 EVANS  Consent Calendar Second Day  Regular Session",78,0,2,0,80
60476,6866,2009-06-09,Senate,"Do pass, but re-refer to the Committee on Appropriations Recommend Consent",9,0,3,0,12
60476,6867,2009-06-29,Senate,"Special Consent #11 AB608 Evans",40,0,0,0,40
60477,6887,2009-05-06,Assembly,"Do pass",6,0,0,0,6
60477,6888,2009-06-03,Assembly,"AB 609 CONWAY  Assembly Third Reading",77,0,3,0,80
60477,9612,2010-06-28,Senate,"Do pass",5,1,0,0,6
60477,21118,2010-08-23,Senate,"Assembly 3rd Reading AB609 Conway By Ducheny",28,6,5,0,39
60477,21119,2010-08-24,Assembly,"AB 609 CONWAY  Concurrence in Senate Amendments",73,1,0,4,78
60479,6877,2009-04-22,Assembly,"Do pass and be re-referred to the Committee on Appropriations",16,1,2,0,19
60479,6878,2009-05-06,Assembly,"Do pass",13,3,0,0,16
60479,6879,2009-05-14,Assembly,"AB 611 FONG  Assembly Third Reading",70,1,9,0,80
60479,6880,2009-06-23,Senate,"Do pass, but re-refer to the Committee on Appropriations",12,0,1,0,13
60479,6881,2009-07-13,Senate,"Do pass",8,1,4,0,13
60479,6882,2009-08-31,Senate,"Assembly 3rd Reading AB611 Fong By Yee",28,6,6,0,40
60480,6883,2009-04-28,Assembly,"Do pass as amended and be re-referred to the Committee on Appropriations",9,0,1,0,10
60480,6884,2009-05-20,Assembly,"Do pass",15,0,1,0,16
60480,6885,2009-05-28,Assembly,"AB 612 BEALL  Assembly Third Reading",80,0,0,0,80
60481,6886,2009-04-28,Assembly,"Do pass as amended and be re-referred to the Committee on Appropriations",18,0,1,0,19
60482,6868,2009-04-21,Assembly,"Do pass and be re-referred to the Committee on Appropriations",2,5,0,0,7
60482,6869,2009-04-21,Assembly,"Set second hearing.  Failed passage.  Reconsideration granted",7,0,0,0,7
60482,6870,2010-01-12,Assembly,"Do pass and be re-referred to the Committee on Appropriations",2,5,0,0,7
60484,6892,2009-04-28,Assembly,"Do pass and be re-referred to the Committee on Appropriations",7,0,0,0,7
60485,6891,2009-04-28,Assembly,"Do pass and be re-referred to the Committee on Appropriations",7,0,4,0,11
60486,6876,2009-04-28,Assembly,"Do pass as amended and be re-referred to the Committee on Appropriations",10,0,1,0,11
60487,6908,2009-04-27,Assembly,"Do pass and re-refer to Committee on Appropriations with recommendation:  To Consent Calendar",13,0,1,0,14
60487,6909,2009-05-06,Assembly,"Do pass, to Consent Calendar",16,0,0,0,16
60487,6910,2009-05-14,Assembly,"AB 619 BLUMENFIELD  Consent Calendar Second Day  Regular Session",73,0,7,0,80
60487,9765,2010-06-29,Senate,"Do pass as amended, and re-refer to the Committee on Appropriations",8,0,1,0,9
60487,19483,2010-08-02,Senate,"Do pass",9,0,2,0,11
60487,20064,2010-08-12,Senate,"Assembly 3rd Reading AB619 Blumenfield By Lowenthal",32,1,5,0,38
60487,21288,2010-08-23,Assembly,"Senate amendments be concurred in",8,2,0,4,14
60487,21289,2010-08-25,Assembly,"AB 619 BLUMENFIELD  Concurrence in Senate Amendments",56,12,0,10,78
60488,25892,2009-04-21,Assembly,"Do pass and be re-referred to the Committee on Appropriations",9,0,0,2,11
60488,25893,2009-05-06,Assembly,"Do pass",11,0,0,5,16
60488,25894,2009-05-18,Assembly,"AB 620 PEREZ, J.  Assembly Third Reading",66,4,0,10,80
60488,25895,2009-06-22,Senate,"Do pass, but re-refer to the Committee on Rules",9,0,1,0,10
60488,25896,2009-07-14,Senate,"Do pass as amended, and re-refer to the Committee on 	Appropriations",4,0,1,0,5
60488,25897,2009-09-01,Senate,"Assembly 3rd Reading AB620 John A. Perez By Corbett",35,0,5,0,40
60488,25898,2009-09-08,Assembly,"AB 620 PEREZ, J.  Concurrence in Senate Amendments",60,15,0,4,79
60489,6907,2010-01-04,Assembly,"Be referred to Committee on Judiciary",10,0,1,0,11
60491,6893,2009-04-21,Assembly,"Do pass and be re-referred to the Committee on Appropriations",11,0,0,0,11
60491,6894,2009-05-06,Assembly,"Do pass as amended",16,0,0,0,16
60491,6895,2009-05-14,Assembly,"AB 623 EMMERSON  Assembly Third Reading",75,0,5,0,80
60491,6896,2009-07-06,Senate,"Do pass as amended, and re-refer to the Committee on Appropriations",9,0,1,0,10
60491,6897,2009-08-17,Senate,"Placed on Appropriations Suspense file",13,0,0,0,13
60491,6898,2009-08-27,Senate,"Do pass as amended",13,0,0,0,13
60491,6899,2009-09-10,Senate,"Special Consent #21 AB623 Emmerson By Negrete McLeod",40,0,0,0,40
60491,6900,2009-09-11,Assembly,"AB 623 Emmerson  Concurrence in Senate Amendments",79,0,0,0,79
60493,6902,2009-04-21,Assembly,"Do pass and be re-referred to the Committee on Appropriations",8,3,0,0,11
60493,6903,2009-05-06,Assembly,"Do pass",10,5,1,0,16
60493,6904,2009-05-18,Assembly,"AB 625 LIEU  Assembly Third Reading",47,27,6,0,80
60493,6905,2009-06-23,Senate,"Do pass, but re-refer to the Committee on Appropriations",8,1,4,0,13
60493,6906,2009-08-27,Senate,"Assembly 3rd Reading AB625 Lieu By Wright",23,12,5,0,40
60494,24758,2009-04-28,Assembly,"Do pass as amended and be re-referred to the Committee on 	Appropriations",9,4,0,0,13
60494,24759,2009-05-28,Assembly,"Do pass",12,5,0,0,17
60494,24760,2009-06-02,Assembly,"AB 626 ENG  Assembly Third Reading",50,28,0,2,80
60494,24761,2009-07-06,Senate,"Do pass, but re-refer to the Committee on Appropriations",7,3,1,0,11
60494,24762,2009-08-17,Senate,"Do pass",8,4,1,0,13
60494,24763,2009-09-01,Senate,"Assembly 3rd Reading AB626 Eng By Padilla",21,13,6,0,40
60494,24764,2009-09-03,Assembly,"AB 626 ENG  Concurrence in Senate Amendments",48,28,0,3,79
60495,6918,2009-04-14,Assembly,"Do pass and be re-referred to the Committee on Appropriations",4,2,1,0,7
60495,6919,2009-05-28,Assembly,"Do pass as amended",12,5,0,0,17
60495,6920,2009-06-03,Assembly,"AB 627 BROWNLEY  Assembly Third Reading",49,28,3,0,80
60495,6921,2009-07-08,Senate,"Do pass, but re-refer to the Committee on Health",7,2,0,0,9
60495,6922,2009-07-15,Senate,"Do pass, but re-refer to the Committee on Appropriations",7,3,1,0,11
60495,6923,2009-08-24,Senate,"Placed on Appropriations Suspense file",13,0,0,0,13
60495,6924,2009-08-27,Senate,"Do pass as amended",8,5,0,0,13
60495,6925,2009-09-02,Senate,"Assembly 3rd Reading AB627 Brownley By Pavley",23,12,5,0,40
60495,6926,2009-09-08,Assembly,"AB 627 BROWNLEY  Concurrence in Senate Amendments",50,29,0,0,79
60496,26685,2009-04-20,Assembly,"Do pass and be re-referred to the Committee on Appropriations",14,0,0,0,14
60496,26686,2009-04-29,Assembly,"Do pass",16,0,0,0,16
60496,26687,2009-05-11,Assembly,"AB 628 BLOCK  Assembly Third Reading",79,0,0,1,80
60496,26688,2009-07-14,Senate,"Do pass, but re-refer to the Committee on Public Safety",9,1,1,0,11
60496,26689,2009-09-01,Senate,"Assembly 3rd Reading AB628 Block By Ducheny",32,2,6,0,40
60496,26690,2009-09-03,Assembly,"AB 628 BLOCK  Concurrence in Senate Amendments",77,0,0,2,79
60497,6889,2009-04-15,Assembly,"Do pass as amended and be re-referred to the Committee on Environmental Safety and Toxic Materials",10,0,1,0,11
60497,6890,2009-04-28,Assembly,"Do pass as amended and be re-referred to the Committee on Appropriations",7,0,0,0,7
60499,6917,2009-04-28,Assembly,"Do pass and be re-referred to the Committee on Appropriations",2,5,0,0,7
60500,6911,2009-03-31,Assembly,"Do pass and be re-referred to the Committee on Judiciary",5,3,1,0,9
60500,6912,2009-05-05,Assembly,"Do pass as amended",7,3,0,0,10
60500,6913,2009-05-21,Assembly,"AB 632 DAVIS  Assembly Third Reading",46,28,6,0,80
60500,6914,2009-07-07,Senate,"Do pass",4,1,0,0,5
60500,6915,2009-08-27,Senate,"Assembly 3rd Reading AB632 Davis By Leno",25,13,2,0,40
60500,6916,2009-08-31,Assembly,"AB 632 DAVIS  Concurrence in Senate Amendments",49,27,3,0,79
60501,965,2010-01-12,Assembly,"Do pass and be re-referred to the Committee on Appropriations.",7,0,0,0,7
60501,966,2010-01-21,Assembly,"Do pass.",14,2,1,0,17
60501,967,2010-01-27,Assembly,"AB 633 AMMIANO  Assembly Third Reading",59,9,10,0,78
60501,8744,2010-06-15,Senate,"Do pass, but re-refer to the Committee on Appropriations",5,0,2,0,7
60501,19340,2010-08-02,Senate,"Placed on Appropriations Suspense file",10,0,1,0,11
60501,20122,2010-08-12,Senate,"Do pass as amended",7,4,0,0,11
60501,21285,2010-08-25,Senate,"Assembly 3rd Reading AB633 Ammiano By Cedillo",26,9,4,0,39
60501,21461,2010-08-26,Assembly,"AB 633 AMMIANO  Concurrence in Senate Amendments",63,14,0,1,78
60502,6935,2010-01-12,Assembly,"Do pass",9,0,0,0,9
60502,6936,2010-01-19,Assembly,"AB 634 HARKEY  Assembly Third Reading",71,0,7,0,78
60502,6937,2010-06-10,Senate,"Do pass",5,0,0,0,5
60502,9654,2010-06-28,Senate,"Special Consent #28 AB634 Harkey",32,0,7,0,39
60503,6938,2009-05-06,Assembly,"Do pass",16,0,3,0,19
60503,6939,2009-05-14,Assembly,"AB 635 PEREZ, V.M.  Assembly Third Reading",73,0,7,0,80
60503,19733,2010-08-10,Senate,"Do pass, but re-refer to the Committee on Appropriations",6,2,3,0,11
60503,20023,2010-08-12,Senate,"Placed on Appropriations Suspense file",11,0,0,0,11
60503,21556,2010-08-27,Senate,"Assembly 3rd Reading AB635 Committee on ACC. & ADM. REV. (De 	Urgency Clause",33,1,5,0,39
60503,21759,2010-08-30,Assembly,"Senate amendments be concurred in",10,0,0,0,10
60503,21760,2010-08-30,Assembly,"AB 635 Accountability and Admini Concurrence- Urgency Added  By DE 	LA TORRE",77,0,0,1,78
60504,26218,2009-04-20,Assembly,"Do pass and be re-referred to the Committee on Transportation",15,0,0,0,15
60504,26219,2009-04-27,Assembly,"Do pass and re-refer to Committee on Appropriations with 	recommendation:  To Consent Calendar",13,0,0,1,14
60504,26220,2009-05-06,Assembly,"Do pass, to Consent Calendar",16,0,0,0,16
60504,26221,2009-05-14,Assembly,"AB 636 JONES  Consent Calendar Second Day  Regular Session",73,0,0,7,80
60504,26222,2009-07-07,Senate,"Do pass, but re-refer to the Committee on Transportation and 	Housing",11,0,0,0,11
60504,26223,2009-07-14,Senate,"Do pass as amended, and re-refer to the Committee on Appropriations",8,3,0,0,11
60504,26224,2009-08-17,Senate,"Placed on Appropriations Suspense file",13,0,0,0,13
60504,26225,2009-08-27,Senate,"Do pass as amended",10,2,1,0,13
60504,26226,2009-09-09,Senate,"Assembly 3rd Reading AB636 Jones By Wolk",26,6,8,0,40
60504,26227,2009-09-10,Assembly,"AB 636 Jones  Concurrence in Senate Amendments",79,0,0,1,80
60505,26596,2009-04-22,Assembly,"Do pass and re-refer to Committee on Appropriations with 	recommendation:  To Consent Calendar",6,0,0,0,6
60505,26597,2009-05-06,Assembly,"Do pass, to Consent Calendar",16,0,0,0,16
60505,26598,2009-05-14,Assembly,"AB 637 HILL  Consent Calendar Second Day  Regular Session",73,0,0,7,80
60505,26599,2009-06-08,Senate,"Do pass, but re-refer to the Committee on Appropriations Recommend 	Consent",7,0,0,0,7
60505,26600,2009-07-09,Senate,"Special Consent #12 AB637 Hill",34,0,6,0,40
60508,6951,2009-04-14,Assembly,"Do pass as amended and be re-referred to the Committee on Appropriations",7,0,0,0,7
60508,6952,2009-05-06,Assembly,"Do pass, to Consent Calendar",16,0,0,0,16
60508,6953,2009-05-21,Assembly,"AB 640 HUBER  Assembly Third Reading  Amend By HAGMAN  Set #1 Motion to  Lay on the Table  By TORRICO",49,29,2,0,80
60508,6954,2009-05-21,Assembly,"AB 640 HUBER  Assembly Third Reading",77,1,2,0,80
60508,6955,2009-06-16,Senate,"Do pass, but re-refer to the Committee on Appropriations",2,3,2,0,7
60508,6956,2009-06-16,Senate,"Set, first hearing.  Failed passage in Committee.  Reconsideration granted",6,0,1,0,7
60508,10257,2010-06-29,Senate,"Do pass, but re-refer to the Committee on Appropriations",4,2,1,0,7
60508,20512,2010-08-18,Senate,"Assembly 3rd Reading AB640 Huber By Wright",26,6,6,0,38
60509,6957,2009-04-28,Assembly,"Do pass and be re-referred to the Committee on Appropriations",3,6,2,0,11
60510,6928,2009-04-27,Assembly,"Do pass and be re-referred to the Committee on Water, Parks and Wildlife",0,7,2,0,9
60510,6929,2009-04-27,Assembly,"Set first hearing.  Failed passage.  Reconsideration granted",9,0,0,0,9
60511,6930,2009-04-28,Assembly,"Do pass and be re-referred to the Committee on Appropriations",5,2,0,0,7
60511,6931,2009-05-28,Assembly,"Do pass as amended",12,5,0,0,17
60511,6932,2009-06-03,Assembly,"AB 643 SKINNER  Assembly Third Reading",48,28,4,0,80
60511,6933,2009-06-23,Senate,"Do pass as amended, and re-refer to the Committee on Appropriations",4,1,0,0,5
60511,6934,2009-07-13,Senate,"Placed on Appropriations Suspense file",12,0,1,0,13
60512,24752,2009-04-29,Assembly,"Do pass and be re-referred to the Committee on Appropriations",7,0,0,0,7
60512,24753,2009-05-13,Assembly,"Do pass, to Consent Calendar",16,0,0,0,16
60512,24754,2009-05-21,Assembly,"AB 644 CABALLERO  Consent Calendar Second Day  Regular Session",77,0,0,3,80
60512,24755,2009-06-16,Senate,"Do pass as amended, and re-refer to the Committee on Appropriations",9,1,1,0,11
60512,24756,2009-09-01,Senate,"Assembly 3rd Reading AB644 Caballero By Denham",27,5,8,0,40
60512,24757,2009-09-03,Assembly,"AB 644 CABALLERO  Concurrence in Senate Amendments",76,0,0,3,79
60513,26010,2009-04-14,Assembly,"Do pass and re-refer to Committee on Appropriations with 	recommendation:  To Consent Calendar",9,0,0,2,11
60513,26011,2009-04-29,Assembly,"Do pass, to Consent Calendar",16,0,0,0,16
60513,26012,2009-05-11,Assembly,"AB 645 NIELLO  Consent Calendar Second Day  Regular Session",78,0,0,2,80
60513,26013,2009-06-22,Senate,"Do pass, but re-refer to the Committee on Appropriations",10,0,0,0,10
60513,26014,2009-07-09,Senate,"Special Consent #12 AB645 Niello",34,0,6,0,40
60513,26015,2009-08-17,Assembly,"AB 645 NIELLO  Concurrence in Senate Amendments",77,0,0,2,79
60514,5029,2009-04-21,Assembly,"Do pass and be re-referred to the Committee on Health",6,4,1,0,11
60514,5030,2009-04-28,Assembly,"Do pass as amended",14,0,5,0,19
60514,5031,2009-05-20,Assembly,"Do pass",15,0,1,0,16
60514,5032,2009-05-28,Assembly,"AB 646 SWANSON  Assembly Third Reading",57,15,8,0,80
60514,5033,2009-06-29,Senate,"Do pass, but re-refer to the Committee on Health",5,3,2,0,10
60514,5034,2009-06-29,Senate,"Set, first hearing.  Failed passage in Committee.  Reconsideration granted",10,0,0,0,10
60514,9905,2010-06-28,Senate,"Do pass, but re-refer to the Committee on Health",4,2,3,0,9
60515,25663,2009-04-20,Assembly,"Do pass as amended and be re-referred to the Committee on 	Appropriations",14,0,0,0,14
60515,25664,2009-05-06,Assembly,"Do pass, to Consent Calendar",16,0,0,0,16
60515,25665,2009-05-14,Assembly,"AB 647 YAMADA  Consent Calendar Second Day  Regular Session",73,0,0,7,80
60515,25666,2009-07-07,Senate,"Do pass as amended, and re-refer to the Committee on Appropriations",10,0,1,0,11
60515,25667,2009-08-27,Senate,"Special Consent #16 AB647 Yamada",38,0,2,0,40
60515,25668,2009-08-31,Assembly,"AB 647 YAMADA  Concurrence in Senate Amendments",78,0,0,1,79
60516,6940,2009-04-21,Assembly,"Do pass and be re-referred to the Committee on Health",9,0,2,0,11
60516,6941,2009-04-28,Assembly,"Do pass as amended and be re-referred to the Committee on Appropriations",18,0,1,0,19
60516,6942,2009-05-20,Assembly,"Do pass",15,0,1,0,16
60516,6943,2009-06-01,Assembly,"AB 648 CHESBRO  Assembly Third Reading",77,0,3,0,80
60516,6944,2009-06-29,Senate,"Do pass, but re-refer to the Committee on Health",4,4,2,0,10
60516,6945,2009-06-29,Senate,"Set, first hearing.  Failed passage in Committee.  Reconsideration granted",10,0,0,0,10
60517,6979,2009-04-21,Assembly,"Do pass and be re-referred to the Committee on Judiciary",9,0,0,0,9
60517,6980,2009-04-28,Assembly,"Do pass as amended and be re-referred to the Committee on Appropriations",10,0,0,0,10
60518,6976,2009-05-06,Assembly,"Do pass and be re-referred to the Committee on Appropriations",5,2,0,0,7
60518,6977,2009-05-28,Assembly,"Do pass as amended",12,5,0,0,17
60518,6978,2009-06-02,Assembly,"AB 650 HILL  Assembly Second Reading  Amend By HILL  Set #1",50,27,3,0,80
60520,24746,2009-04-27,Assembly,"Do pass as amended",14,0,0,0,14
60520,24747,2009-05-11,Assembly,"AB 652 SKINNER  Assembly Third Reading",78,1,0,1,80
60520,24748,2009-06-09,Senate,"Do pass as amended",11,0,0,0,11
60520,24749,2009-06-22,Senate,"Special Consent #9 AB652 Skinner",40,0,0,0,40
60520,24750,2009-08-31,Senate,"Special Consent #17 AB652 Skinner By Corbett",36,0,4,0,40
60520,24751,2009-09-02,Assembly,"AB 652 SKINNER  Concurrence in Senate Amendments",77,0,0,2,79
60521,6960,2009-05-05,Assembly,"Do pass and be re-referred to the Committee on Public Safety to Consent Calendar",10,0,0,0,10
60521,6961,2009-05-12,Assembly,"Do pass as amended, to Consent Calendar",7,0,0,0,7
60521,6962,2009-05-28,Assembly,"AB 653 FEUER  Consent Calendar Second Day  Regular Session",76,0,4,0,80
60521,6963,2009-06-23,Senate,"Do pass, but re-refer to the Committee on Public Safety Recommend Consent",5,0,0,0,5
60521,6964,2009-07-07,Senate,"Do pass",7,0,0,0,7
60521,6965,2009-07-16,Senate,"Special Consent #13 AB653 Feuer",36,0,4,0,40
60521,6966,2009-08-17,Assembly,"AB 653 FEUER  Concurrence in Senate Amendments",77,0,2,0,79
60522,24739,2009-04-22,Assembly,"Do pass as amended and re-refer to Committee on Appropriations 	with recommendation:  To Consent Calendar",6,0,0,0,6
60522,24740,2009-05-28,Assembly,"Do pass as amended",17,0,0,0,17
60522,24741,2009-06-02,Assembly,"AB 654 MENDOZA  Assembly Third Reading",77,0,0,3,80
60522,24742,2009-06-22,Senate,"Do pass, but re-refer to the Committee on Appropriations Recommend 	Consent",7,0,0,0,7
60522,24743,2009-07-06,Senate,"Placed on Appropriations Suspense file",11,0,2,0,13
60522,24744,2009-08-27,Senate,"Do pass",13,0,0,0,13
60522,24745,2009-09-02,Senate,"Assembly 3rd Reading AB654 Mendoza By Ashburn",32,0,8,0,40
60523,1541,2009-04-14,Assembly,"Do pass as amended and be re-referred to the Committee on Judiciary",8,0,3,0,11
60523,1542,2009-05-12,Assembly,"Do pass as amended, to Consent Calendar",10,0,0,0,10
60523,1543,2009-05-28,Assembly,"AB 655 EMMERSON  Consent Calendar Second Day",76,0,4,0,80
60523,10040,2010-06-29,Senate,"Do pass as amended",4,0,1,0,5
60523,20705,2010-08-20,Senate,"Assembly 3rd Reading AB655 Emmerson By Emmerson",31,0,7,0,38
60523,20831,2010-08-23,Assembly,"AB 655  Concurrence in Senate Amendments By COOK",76,0,0,2,78
60524,4298,2009-07-07,Assembly,"Do pass as amended and be re-referred to the Committee on Revenue and Taxation",5,3,1,0,9
60524,4299,2010-01-11,Assembly,"Do pass as amended and be re-referred to the Committee on Appropriations",5,2,2,0,9
60524,4300,2010-01-21,Assembly,"Do pass as amended",12,5,0,0,17
60524,4301,2010-01-27,Assembly,"AB 656 TORRICO  Assembly Third Reading",41,28,9,0,78
60525,6967,2009-04-14,Assembly,"Do pass and be re-referred to the Committee on Labor and Employment",12,4,3,0,19
60525,6968,2009-04-22,Assembly,"Do pass as amended and be re-referred to the Committee on Appropriations",5,2,0,0,7
60525,6969,2009-05-28,Assembly,"Do pass as amended",12,5,0,0,17
60525,6970,2009-06-03,Assembly,"AB 657 HERNANDEZ  Assembly Third Reading",50,28,2,0,80
60525,6971,2009-07-08,Senate,"Do pass, but re-refer to the Committee on Appropriations",10,1,0,0,11
60525,6972,2009-07-23,Senate,"Placed on Appropriations Suspense file",13,0,0,0,13
60525,6973,2009-08-27,Senate,"Do pass as amended",9,4,0,0,13
60525,6974,2009-09-02,Senate,"Assembly 3rd Reading AB657 Hernandez By Alquist",22,11,7,0,40
60525,6975,2009-09-08,Assembly,"AB 657 HERNANDEZ  Concurrence in Senate Amendments",51,28,0,0,79
60526,6946,2010-01-07,Assembly,"Be referred to Committee on Revenue and Taxation",10,0,1,0,11
60526,6947,2010-01-11,Assembly,"Do pass as amended and be re-referred to the Committee on Appropriations",8,0,1,0,9
60526,6948,2010-01-21,Assembly,"Do pass",17,0,0,0,17
60526,6949,2010-01-25,Assembly,"AB 658 Hayashi  Assembly Third Reading",65,1,12,0,78
60526,6950,2010-06-09,Senate,"Do pass, but re-refer to the Committee on Appropriations",3,0,2,0,5
60526,20315,2010-08-12,Senate,"Assembly 3rd Reading AB658 Hayashi By Wolk",30,2,6,0,38
60526,20363,2010-08-17,Assembly,"AB 658 HAYASHI  Concurrence in Senate Amendments",74,1,0,4,79
60527,6990,2009-05-04,Assembly,"Do pass as amended and be re-referred to the Committee on Appropriations",8,0,1,0,9
60527,6991,2009-05-20,Assembly,"Do pass, to Consent Calendar",15,0,1,0,16
60527,6992,2009-05-28,Assembly,"AB 659 HAYASHI  Consent Calendar Second Day  Regular Session",76,0,4,0,80
60527,6993,2009-07-08,Senate,"Do pass as amended, and re-refer to the Committee on Appropriations",8,0,0,0,8
60527,6994,2009-08-27,Senate,"Special Consent #16 AB659 Hayashi By Wolk",38,0,2,0,40
60527,6995,2009-08-31,Assembly,"AB 659 HAYASHI  Concurrence in Senate Amendments",77,0,2,0,79
60528,6996,2009-04-22,Assembly,"Do pass and be re-referred to the Committee on Business and Professions",11,4,4,0,19
60528,6997,2009-04-28,Assembly,"Do pass and be re-referred to the Committee on Appropriations",7,4,0,0,11
60528,6998,2009-05-28,Assembly,"Do pass",12,5,0,0,17
60528,6999,2009-06-01,Assembly,"AB 660 TORRICO  Assembly Third Reading",49,30,1,0,80
60528,7000,2009-06-23,Senate,"Do pass as amended, and re-refer to the Committee on Public Safety",9,3,1,0,13
60528,19723,2010-08-02,Senate,"Placed on Appropriations Suspense file",10,0,1,0,11
60529,7001,2009-04-15,Assembly,"Do pass and be re-referred to the Committee on Appropriations",10,0,1,0,11
60530,6958,2009-04-30,Assembly,"Do pass and be re-referred to the Committee on Appropriations",5,12,2,0,19
60530,6959,2009-04-30,Assembly,"Reconsideration granted",17,0,2,0,19
60531,7009,2009-04-21,Assembly,"Do pass as amended and be re-referred to the Committee on Appropriations",7,2,1,0,10
60531,7010,2009-05-28,Assembly,"Do pass",12,5,0,0,17
60531,7011,2009-06-01,Assembly,"AB 663 JONES  Assembly Third Reading",51,28,1,0,80
60531,7012,2009-06-23,Senate,"Do pass, but re-refer to the Committee on Appropriations",3,1,1,0,5
60531,20066,2010-08-09,Senate,"Placed on Appropriations Suspense file",10,0,1,0,11
60532,6981,2009-04-22,Assembly,"Do pass as amended and be re-referred to the Committee on Appropriations",7,3,0,0,10
60533,24733,2009-04-28,Assembly,"Do pass and re-refer to Committee on Appropriations with 	recommendation:  To Consent Calendar",7,0,0,0,7
60533,24734,2009-05-28,Assembly,"Do pass",17,0,0,0,17
60533,24735,2009-06-01,Assembly,"AB 665 TORRICO  Assembly Third Reading",78,0,0,2,80
60533,24736,2009-06-23,Senate,"Do pass, but re-refer to the Committee on Appropriations Recommend 	Consent",5,0,0,0,5
60533,24737,2009-09-01,Senate,"Assembly 3rd Reading AB665 Torrico By Liu",36,0,4,0,40
60533,24738,2009-09-03,Assembly,"AB 665 TORRICO  Concurrence in Senate Amendments",77,0,0,2,79
60534,6982,2009-04-22,Assembly,"Do pass as amended",5,2,0,0,7
60534,6983,2009-05-13,Assembly,"Do pass",9,5,2,0,16
60534,6984,2009-06-03,Assembly,"AB 666 JONES  Assembly Third Reading",57,19,4,0,80
60534,6985,2009-07-08,Senate,"Do pass, but re-refer to the Committee on Appropriations",3,2,0,0,5
60534,6986,2009-08-17,Senate,"Placed on Appropriations Suspense file",13,0,0,0,13
60534,6987,2009-08-27,Senate,"Do pass as amended",8,5,0,0,13
60534,6988,2009-09-04,Senate,"Assembly 3rd Reading AB666 Jones By Kehoe",24,12,4,0,40
60534,6989,2009-09-09,Assembly,"AB 666 JONES  Concurrence in Senate Amendments",59,18,2,0,79
60535,24727,2009-04-14,Assembly,"Do pass and be re-referred to the Committee on Business and 	Professions to Consent Calendar",19,0,0,0,19
60535,24728,2009-04-28,Assembly,"Do pass and re-refer to Committee on Appropriations with 	recommendation:  To Consent Calendar",10,0,0,1,11
60535,24729,2009-05-13,Assembly,"Do pass, to Consent Calendar",16,0,0,0,16
60535,24730,2009-05-21,Assembly,"AB 667 BLOCK  Consent Calendar Second Day  Regular Session",77,0,0,3,80
60535,24731,2009-06-22,Senate,"Do pass, but re-refer to the Committee on Appropriations",10,0,0,0,10
60535,24732,2009-07-09,Senate,"Special Consent #12 AB667 Block By Alquist",34,0,6,0,40
60536,3005,2009-04-21,Assembly,"Do pass and be re-referred to the Committee on Appropriations",7,0,0,0,7
60536,3006,2009-05-28,Assembly,"Do pass as amended",17,0,0,0,17
60536,3007,2009-06-02,Assembly,"AB 668 LIEU  Assembly Third Reading",76,0,4,0,80
60536,9318,2010-06-22,Senate,"Do pass as amended, and re-refer to the Committee on Appropriations",7,0,0,0,7
60536,21194,2010-08-24,Senate,"Assembly 3rd Reading AB668 Lieu By Correa",33,0,6,0,39
60536,21406,2010-08-26,Assembly,"Senate amendments be concurred in",5,0,0,2,7
60536,21606,2010-08-27,Assembly,"AB 668 LIEU  Concurrence in Senate Amendments",75,0,0,3,78
60537,24721,2009-05-05,Assembly,"Do pass, to Consent Calendar",9,0,0,0,9
60537,24722,2009-05-14,Assembly,"AB 669 FONG  Consent Calendar Second Day",73,0,0,7,80
60537,24723,2009-06-17,Senate,"Do pass, but re-refer to the Committee on Rules Recommend Consent",9,0,0,0,9
60537,24724,2009-07-13,Senate,"Do pass",12,0,1,0,13
60537,24725,2009-09-08,Senate,"Assembly 3rd Reading AB669 Fong By Liu",40,0,0,0,40
60537,24726,2009-09-10,Assembly,"AB 669 FONG  Concurrence in Senate Amendments",76,0,0,4,80
60538,7002,2009-04-20,Assembly,"Do pass and be re-referred to the Committee on Appropriations",5,7,2,0,14
60538,7003,2009-04-20,Assembly,"Set first hearing.  Failed passage.  Reconsideration granted",14,0,0,0,14
60539,24715,2009-04-28,Assembly,"Do pass as amended and re-refer to Committee on Appropriations 	with recommendation:  To Consent Calendar",7,0,0,0,7
60539,24716,2009-05-20,Assembly,"Do pass as amended, to Consent Calendar",15,0,0,1,16
60539,24717,2009-06-02,Assembly,"AB 671 KREKORIAN  Consent Calendar Second Day",76,0,0,4,80
60539,24718,2009-07-14,Senate,"Do pass, but re-refer to the Committee on Appropriations",7,0,0,0,7
60539,24719,2009-09-02,Senate,"Special Consent #18 AB671 Krekorian By Benoit",39,0,1,0,40
60539,24720,2009-09-09,Assembly,"AB 671 KREKORIAN  Concurrence in Senate Amendments",77,0,0,2,79
60540,25790,2009-04-27,Assembly,"Do pass as amended and re-refer to Committee on Appropriations 	with recommendation:  To Consent Calendar",13,0,0,1,14
60540,25791,2009-05-28,Assembly,"Do pass, to Consent Calendar",17,0,0,0,17
60540,25792,2009-06-03,Assembly,"AB 672 BASS  Assembly Third Reading",78,0,0,2,80
60540,25793,2009-07-07,Senate,"Do pass, but re-refer to the Committee on Appropriations Recommend 	Consent",10,0,1,0,11
60540,25794,2009-08-17,Senate,"Do pass",12,0,1,0,13
60540,25795,2009-08-27,Senate,"Special Consent #16 AB672 Bass",38,0,2,0,40
60541,7030,2009-04-15,Assembly,"Do pass as amended and re-refer to Committee on Appropriations with recommendation:  To Consent Calendar",10,0,1,0,11
60541,7031,2009-05-13,Assembly,"Do pass, to Consent Calendar",16,0,0,0,16
60541,7032,2009-05-21,Assembly,"AB 673 CARTER  Consent Calendar Second Day  Regular Session",77,0,3,0,80
60541,7033,2009-07-08,Senate,"Do pass, but re-refer to the Committee on Appropriations",9,0,0,0,9
60541,7034,2009-08-24,Senate,"Special Consent #15 AB673 Carter",39,0,1,0,40
60542,1020,2010-01-12,Assembly,"Do pass and be re-referred to the Committee on Appropriations.",7,0,0,0,7
60542,1021,2010-01-21,Assembly,"Do pass as amended, to Consent Calendar.",17,0,0,0,17
60542,1022,2010-01-28,Assembly,"AB 674 SALAS  Consent Calendar Second Day",73,0,5,0,78
60542,9851,2010-06-29,Senate,"Do pass, but re-refer to the Committee on Appropriations",7,0,0,0,7
60542,19165,2010-08-02,Senate,"Placed on Appropriations Suspense file",10,0,1,0,11
60542,20024,2010-08-12,Senate,"Do pass as amended",10,0,1,0,11
60542,20559,2010-08-19,Senate,"Assembly 3rd Reading AB674 Salas",35,0,3,0,38
60542,20799,2010-08-23,Assembly,"AB 674 SALAS  Concurrence in Senate Amendments",77,0,0,1,78
60544,7024,2009-05-18,Assembly,"Do pass as amended and be re-referred to the Committee on Appropriations",9,0,0,0,9
60545,7025,2009-04-22,Assembly,"Do pass and be re-referred to the Committee on Appropriations",5,2,0,0,7
60545,7026,2009-05-28,Assembly,"Do pass",12,5,0,0,17
60545,7027,2009-06-02,Assembly,"AB 677 SOLORIO  Assembly Third Reading",49,30,1,0,80
60545,7028,2009-07-08,Senate,"Do pass, but re-refer to the Committee on Appropriations",4,1,1,0,6
60545,7029,2009-08-17,Senate,"Do pass",8,3,2,0,13
60545,20578,2010-08-18,Senate,"Assembly 3rd Reading AB677 Solorio By Wright",22,11,5,0,38
60545,21160,2010-08-25,Assembly,"AB 677 SOLORIO  Concurrence in Senate Amendments",50,25,0,3,78
60546,7004,2009-04-29,Assembly,"Do pass as amended and be re-referred to the Committee on Appropriations",8,2,1,0,11
60546,7005,2009-05-20,Assembly,"Do pass",11,4,1,0,16
60546,7006,2009-05-28,Assembly,"AB 678 HALL  Assembly Third Reading",51,28,1,0,80
60546,7007,2009-07-15,Senate,"Do pass, but re-refer to the Committee on Appropriations",7,1,1,0,9
60546,7008,2009-08-17,Senate,"Placed on Appropriations Suspense file",13,0,0,0,13
60548,24811,2009-05-12,Assembly,"Do pass as amended",8,2,0,0,10
60548,24812,2009-05-28,Assembly,"AB 680 HALL  Assembly Third Reading",64,13,0,3,80
60548,24813,2009-07-07,Senate,"Do pass",4,1,0,0,5
60548,24814,2009-09-09,Senate,"Assembly 3rd Reading AB680 Hall By Corbett",26,9,5,0,40
60548,24815,2010-01-27,Assembly,"AB 680 HALL  Concurrence in Senate Amendments",54,12,0,12,78
60549,24803,2009-04-14,Assembly,"Do pass and be re-referred to the Committee on Judiciary to Consent 	Calendar",19,0,0,0,19
60549,24804,2009-05-05,Assembly,"Do pass, to Consent Calendar",10,0,0,0,10
60549,24805,2009-05-11,Assembly,"AB 681 HERNANDEZ  Consent Calendar Second Day  Regular Session",78,0,0,2,80
60549,24806,2009-06-16,Senate,"Do pass as amended",4,0,1,0,5
60549,24807,2009-06-29,Senate,"Special Consent #11 AB681 Hernandez",40,0,0,0,40
60549,24808,2009-07-06,Assembly,"AB 681 HERNANDEZ  Concurrence in Senate Amendments",78,0,0,1,79
60549,24809,2009-08-31,Senate,"Special Consent #17 AB681 Hernandez By Corbett",36,0,4,0,40
60549,24810,2009-09-02,Assembly,"AB 681 HERNANDEZ  Concurrence in Senate Amendments",77,0,0,2,79
60550,7041,2009-04-14,Assembly,"Do pass as amended and be re-referred to the Committee on Appropriations",4,2,1,0,7
60550,7042,2009-05-28,Assembly,"Do pass as amended",12,5,0,0,17
60550,7043,2009-06-03,Assembly,"AB 682 LOWENTHAL  Assembly Third Reading",49,28,3,0,80
60550,7044,2009-06-23,Senate,"Do pass as amended, and re-refer to the Committee on Appropriations",4,1,0,0,5
60550,7045,2009-07-13,Senate,"Placed on Appropriations Suspense file",12,0,1,0,13
60551,7040,2009-04-29,Assembly,"Do pass as amended and re-refer to Committee on Appropriations with recommendation:  To Consent Calendar",11,0,0,0,11
60552,2282,2009-04-14,Assembly,"Do pass and be re-referred to the Committee on Appropriations",15,1,3,0,19
60552,2283,2009-04-29,Assembly,"Do pass",15,0,1,0,16
60552,2284,2009-05-18,Assembly,"AB 684 MA  Assembly Third Reading",76,0,4,0,80
60553,7016,2009-04-15,Assembly,"Do pass as amended and be re-referred to the Committee on Appropriations",8,2,1,0,11
60553,7017,2009-05-06,Assembly,"Do pass",11,5,0,0,16
60553,7018,2009-05-18,Assembly,"AB 685 DAVIS  Assembly Third Reading",48,28,4,0,80
60553,7019,2009-07-15,Senate,"Do pass as amended, and re-refer to the Committee on Appropriations",6,2,1,0,9
60553,7020,2009-08-17,Senate,"Placed on Appropriations Suspense file",13,0,0,0,13
60553,7021,2009-08-27,Senate,"Do pass as amended",8,5,0,0,13
60553,7022,2009-09-03,Senate,"Assembly 3rd Reading AB685 Davis By Romero",26,13,1,0,40
60553,7023,2009-09-09,Assembly,"AB 685 DAVIS  Concurrence in Senate Amendments",49,28,2,0,79
60554,7060,2009-05-05,Assembly,"Do pass",5,0,2,0,7
60554,7061,2009-05-18,Assembly,"AB 686 RUSKIN  Assembly Third Reading",65,6,9,0,80
60554,7062,2009-07-07,Senate,"Do pass",5,0,0,0,5
60554,7063,2009-08-27,Senate,"Assembly 3rd Reading AB686 Ruskin By Walters",35,0,5,0,40
60556,24796,2009-04-14,Assembly,"Do pass and be re-referred to the Committee on Appropriations",7,0,0,0,7
60556,24797,2009-04-29,Assembly,"Do pass, to Consent Calendar",16,0,0,0,16
60556,24798,2009-05-11,Assembly,"AB 688 ENG  Consent Calendar Second Day  Regular Session",78,0,0,2,80
60556,24799,2009-06-16,Senate,"Do pass",6,0,1,0,7
60556,24800,2009-06-24,Senate,"Special Consent #10 AB688 Eng",40,0,0,0,40
60556,24801,2009-08-24,Senate,"Special Consent #15 AB688 Eng By Benoit",39,0,1,0,40
60556,24802,2009-08-27,Assembly,"AB 688 ENG  Concurrence in Senate Amendments",77,0,0,2,79
60557,7013,2009-04-20,Assembly,"Do pass and be re-referred to the Committee on Governmental Organization",6,2,1,0,9
60557,7014,2009-04-30,Assembly,"Do pass and be re-referred to the Committee on Appropriations",12,2,5,0,19
60557,7015,2009-05-13,Assembly,"Do pass",11,5,0,0,16
60558,7046,2009-05-05,Assembly,"Do pass as amended",7,1,1,0,9
60558,7047,2009-05-21,Assembly,"AB 690 AMMIANO  Assembly Third Reading",50,28,2,0,80
60558,7048,2009-07-15,Senate,"Do pass as amended",5,1,3,0,9
60558,7049,2009-09-02,Senate,"Assembly 3rd Reading AB690 Ammiano By Hancock",22,15,3,0,40
60558,7050,2009-09-08,Assembly,"AB 690 AMMIANO  Concurrence in Senate Amendments",49,30,0,0,79
60559,24790,2009-04-22,Assembly,"Do pass as amended and be re-referred to the Committee on 	Appropriations",7,0,0,4,11
60559,24791,2009-05-20,Assembly,"Do pass",14,0,0,2,16
60559,24792,2009-05-28,Assembly,"AB 691 GILMORE  Assembly Third Reading",74,3,0,3,80
60559,24793,2009-07-15,Senate,"Do pass as amended, and re-refer to the Committee on Appropriations",8,0,1,0,9
60559,24794,2009-08-31,Senate,"Assembly 3rd Reading AB691 Gilmore By Benoit",36,0,4,0,40
60559,24795,2009-09-02,Assembly,"AB 691 GILMORE  Concurrence in Senate Amendments",73,2,0,4,79
60560,7051,2009-04-13,Assembly,"Do pass",7,0,2,0,9
60560,7052,2009-05-04,Assembly,"AB 692 CALDERON  Assembly Third Reading  Amend By CALDERON  Set #1",51,28,1,0,80
60560,7053,2009-05-11,Assembly,"AB 692 CALDERON  Assembly Third Reading",51,17,12,0,80
60560,7054,2009-07-08,Senate,"Do pass as amended",5,2,1,0,8
60560,7055,2009-09-01,Senate,"Assembly 3rd Reading AB692 Charles Calderon By Calderon",22,12,6,0,40
60560,7056,2009-09-03,Assembly,"AB 692 CALDERON  Concurrence in Senate Amendments",49,27,3,0,79
60562,7035,2009-04-13,Assembly,"Do pass and be re-referred to the Committee on Local Government",6,0,3,0,9
60562,7036,2009-05-06,Assembly,"Do pass",5,0,2,0,7
60562,7037,2009-05-28,Assembly,"AB 694 SALDANA  Assembly Third Reading",48,30,2,0,80
60562,7038,2009-07-06,Senate,"Do pass",7,3,1,0,11
60562,7039,2009-09-03,Senate,"Assembly 3rd Reading AB694 Saldana By Kehoe",24,15,1,0,40
60564,7066,2009-04-27,Assembly,"Do pass and be re-referred to the Committee on Judiciary",3,6,0,0,9
60564,7067,2009-04-27,Assembly,"Set first hearing.  Failed passage.  Reconsideration granted",9,0,0,0,9
60565,7064,2009-05-11,Assembly,"Do pass, to Consent Calendar",9,0,0,0,9
60565,7065,2009-05-18,Assembly,"AB 697 CALDERON  Consent Calendar Second Day  Regular Session",77,0,3,0,80
60566,24784,2009-04-13,Assembly,"Do pass and be re-referred to the Committee on Natural Resources to 	Consent Calendar",13,0,0,2,15
60566,24785,2009-04-27,Assembly,"Do pass and re-refer to Committee on Appropriations with 	recommendation:  To Consent Calendar",9,0,0,0,9
60566,24786,2009-05-06,Assembly,"Do pass, to Consent Calendar",16,0,0,0,16
60566,24787,2009-05-14,Assembly,"AB 698 SKINNER  Consent Calendar Second Day  Regular Session",73,0,0,7,80
60566,24788,2009-07-07,Senate,"Do pass, but re-refer to the Committee on Appropriations",11,0,0,0,11
60566,24789,2009-08-24,Senate,"Special Consent #15 AB698 Skinner",39,0,1,0,40
60567,7059,2009-04-21,Assembly,"Do pass as amended and be re-referred to the Committee on Appropriations",7,0,0,0,7
60568,7057,2009-03-31,Assembly,"Do pass and be re-referred to the Committee on Revenue and Taxation",5,3,1,0,9
60568,7058,2009-04-27,Assembly,"Do pass and be re-referred to the Committee on Appropriations",6,1,2,0,9
60569,7077,2009-04-01,Assembly,"Do pass as amended and be re-referred to the Committee on Appropriations",11,0,0,0,11
60570,7078,2009-04-15,Assembly,"Do pass as amended and be re-referred to the Committee on Veterans Affairs",6,0,1,0,7
60570,7079,2009-04-28,Assembly,"Do pass and be re-referred to the Committee on Appropriations",6,0,3,0,9
60570,7080,2009-05-28,Assembly,"Do pass as amended",12,5,0,0,17
60570,7081,2009-06-02,Assembly,"AB 702 SALAS  Assembly Third Reading",78,0,2,0,80
60570,7082,2009-06-23,Senate,"Do pass, but re-refer to the Committee on Transportation and Housing",6,0,1,0,7
60570,10101,2010-06-29,Senate,"Do pass as amended",8,0,1,0,9
60570,20610,2010-08-19,Senate,"Assembly 3rd Reading AB702 Salas Urgency Clause",35,0,3,0,38
60570,21417,2010-08-25,Assembly,"Senate amendments be concurred in",8,0,0,1,9
60570,21418,2010-08-26,Assembly,"AB 702 SALAS  Concurrence- Urgency Added",78,0,0,0,78
60572,7068,2009-04-22,Assembly,"Do pass and be re-referred to the Committee on Appropriations",4,1,1,0,6
60574,25228,2009-05-12,Assembly,"Do pass and re-refer to Committee on Appropriations with 	recommendation:  To Consent Calendar",7,0,0,0,7
60574,25229,2009-05-26,Assembly,"AB 706 HUM. S.  Third Reading Urgency  By BEALL",79,0,0,1,80
60574,25230,2009-06-23,Senate,"Do pass as amended. To Consent Calendar",5,0,0,0,5
60574,25231,2009-06-29,Senate,"Consent Calendar 2nd AB706 Committee on HUMAN S. (Beall)",40,0,0,0,40
60574,25232,2009-07-06,Assembly,"AB 706 HUM. S.  Concurrence in Senate Amendments By BEALL",78,0,0,1,79
60576,24777,2009-04-28,Assembly,"Do pass and be re-referred to the Committee on Appropriations",13,0,0,0,13
60576,24778,2009-05-13,Assembly,"Do pass, to Consent Calendar",16,0,0,0,16
60576,24779,2009-05-21,Assembly,"AB 708 HUFFMAN  Consent Calendar Second Day  Regular Session",77,0,0,3,80
60576,24780,2009-06-23,Senate,"Do pass, but re-refer to the Committee on Public Safety",11,0,0,0,11
60576,24781,2009-07-07,Senate,"Do pass as amended, and re-refer to the Committee on Appropriations",7,0,0,0,7
60576,24782,2009-09-01,Senate,"Assembly 3rd Reading AB708 Huffman By Simitian",35,0,5,0,40
60576,24783,2009-09-03,Assembly,"AB 708 HUFFMAN  Concurrence in Senate Amendments",78,0,0,1,79
60577,7069,2009-04-27,Assembly,"Do pass and be re-referred to the Committee on Appropriations",10,2,3,0,15
60578,7070,2009-04-14,Assembly,"Do pass and be re-referred to the Committee on Appropriations",8,0,1,0,9
60578,7071,2009-04-28,Assembly,"Do pass and be re-referred to the Committee on Appropriations",18,0,1,0,19
60578,7072,2009-05-13,Assembly,"Do pass",16,0,0,0,16
60578,7073,2009-05-26,Assembly,"AB 710 YAMADA  Assembly Third Reading",80,0,0,0,80
60578,7074,2009-06-23,Senate,"Do pass, but re-refer to the Committee on Health",6,0,1,0,7
60578,7075,2009-07-08,Senate,"Do pass as amended, and re-refer to the Committee on Appropriations",11,0,0,0,11
60578,7076,2009-08-17,Senate,"Placed on Appropriations Suspense file",13,0,0,0,13
60579,478,2009-04-27,Assembly,"Do pass as amended and be re-referred to the Committee on Appropriations.",6,2,1,0,9
60579,479,2009-05-28,Assembly,"Do pass as amended.",12,5,0,0,17
60579,480,2009-06-03,Assembly,"AB 711 CALDERON  Assembly Third Reading",48,29,3,0,80
60579,481,2009-07-08,Senate,"Do pass as amended, and re-refer to the Committee on Appropriations.",5,2,1,0,8
60579,482,2010-04-19,Senate,"Do pass, but re-refer to the Committee on Rules.",1,7,3,0,11
60579,483,2010-04-19,Senate,"Do pass as amended.",7,2,2,0,11
60579,484,2010-04-26,Senate,"Assembly 2nd Reading AB711 Charles Calderon Urgency Clause",27,9,3,0,39
60579,485,2010-04-29,Assembly,"Senate amendments be concurred in.",6,3,0,0,9
60579,486,2010-06-01,Assembly,"AB 711 CALDERON  Concurrence- Urgency Added",55,19,5,0,79
60580,24773,2009-04-21,Assembly,"Do pass, to Consent Calendar",10,0,0,0,10
60580,24774,2009-04-27,Assembly,"AB 712 EVANS  Consent Calendar Second Day  Regular Session",77,0,0,3,80
60580,24775,2009-06-09,Senate,"Do pass and be placed on the Consent Calendar",5,0,0,0,5
60580,24776,2009-09-03,Senate,"Assembly 3rd Reading AB712 Evans By Lowenthal",32,0,8,0,40
60581,7089,2009-04-28,Assembly,"Do pass and be re-referred to the Committee on Appropriations",5,2,0,0,7
60582,26049,2009-04-14,Assembly,"Do pass and re-refer to Committee on Appropriations with 	recommendation:  To Consent Calendar",7,0,0,0,7
60582,26050,2009-04-29,Assembly,"Do pass, to Consent Calendar",16,0,0,0,16
60582,26051,2009-05-11,Assembly,"AB 714 FEUER  Consent Calendar Second Day  Regular Session",78,0,0,2,80
60582,26052,2009-06-16,Senate,"Do pass, but re-refer to the Committee on Appropriations",6,0,1,0,7
60582,26053,2009-06-29,Senate,"Special Consent #11 AB714 Feuer",40,0,0,0,40
60583,1071,2009-05-06,Assembly,"Do pass.",7,0,0,0,7
60583,1072,2009-05-14,Assembly,"AB 715 CABALLERO  Assembly Third Reading",75,0,5,0,80
60583,9027,2010-06-16,Senate,"Do pass, but re-refer to the Committee on Rules",3,1,1,0,5
60583,10909,2010-07-15,Senate,"Placed on Appropriations Suspense file",8,0,2,0,10
60584,7090,2009-04-28,Assembly,"Do pass and be re-referred to the Committee on Appropriations",8,0,1,0,9
60584,7091,2009-05-28,Assembly,"Do pass as amended",13,4,0,0,17
60584,7092,2009-06-03,Assembly,"AB 716 HUBER  Assembly Third Reading",74,0,6,0,80
60584,7093,2009-06-23,Senate,"Do pass, but re-refer to the Committee on Transportation and Housing",6,0,1,0,7
60584,7094,2009-07-07,Senate,"Do pass as amended, and re-refer to the Committee on Appropriations",9,1,1,0,11
60584,7095,2009-09-01,Senate,"Assembly 3rd Reading AB716 Huber By Wolk",33,0,7,0,40
60584,7096,2009-09-03,Assembly,"AB 716 HUBER  Concurrence in Senate Amendments",75,1,3,0,79
60585,25713,2009-04-01,Assembly,"Do pass",10,0,0,1,11
60585,25714,2009-04-30,Assembly,"AB 717 COOK  Assembly Third Reading",72,0,0,8,80
60585,25715,2009-09-11,Senate,"W/O REF. TO FILE AB717 Cook By Huff",40,0,0,0,40
60585,25716,2009-09-12,Assembly,"AB 717 COOK  Concurrence in Senate Amendments",79,0,0,0,79
60586,1781,2009-04-21,Assembly,"Do pass and be re-referred to the Committee on Business and Professions",17,0,2,0,19
60586,1782,2009-04-28,Assembly,"Do pass, to Consent Calendar",10,0,1,0,11
60586,1783,2009-05-11,Assembly,"AB 718 EMMERSON  Consent Calendar Second Day",78,0,2,0,80
60586,1784,2009-06-25,Senate,"Do pass, but re-refer to the Committee on Business, Professions and Economic Development",11,0,0,0,11
60586,1785,2009-07-06,Senate,"Do pass as amended, and re-refer to the Committee on Appropriations",9,0,1,0,10
60586,1786,2009-08-17,Senate,"Placed on Appropriations Suspense file",13,0,0,0,13
60587,24765,2009-04-14,Assembly,"Do pass and be re-referred to the Committee on Appropriations",6,0,0,1,7
60587,24766,2009-05-28,Assembly,"Do pass",17,0,0,0,17
60587,24767,2009-06-01,Assembly,"AB 719 LOWENTHAL  Assembly Third Reading",75,0,0,5,80
60587,24768,2009-06-23,Senate,"Do pass, but re-refer to the Committee on Appropriations",4,1,0,0,5
60587,24769,2009-07-13,Senate,"Placed on Appropriations Suspense file",12,0,1,0,13
60587,24770,2009-08-27,Senate,"Do pass",8,5,0,0,13
60587,24771,2009-09-02,Senate,"Assembly 3rd Reading AB719 Bonnie Lowenthal By Liu",22,12,6,0,40
60587,24772,2009-09-09,Assembly,"AB 719 LOWENTHAL  Concurrence in Senate Amendments",78,0,0,1,79
60588,24856,2009-05-06,Assembly,"Do pass and be re-referred to the Committee on Housing and 	Community Development",7,0,0,0,7
60588,24857,2009-05-13,Assembly,"Do pass as amended",6,0,0,0,6
60588,24858,2009-05-26,Assembly,"AB 720 CABALLERO  Assembly Third Reading",78,0,0,2,80
60588,24859,2009-07-07,Senate,"Do pass as amended. To Consent Calendar",10,0,1,0,11
60588,24860,2009-07-16,Senate,"Consent Calendar 2nd AB720 Caballero",36,0,4,0,40
60588,24861,2009-08-17,Assembly,"AB 720 CABALLERO  Concurrence in Senate Amendments",76,0,0,3,79
60589,7102,2009-04-28,Assembly,"Do pass and be re-referred to the Committee on Appropriations",3,1,7,0,11
60592,7084,2009-04-14,Assembly,"Do pass and be re-referred to the Committee on Appropriations",9,0,1,0,10
60592,7085,2009-05-28,Assembly,"Do pass",17,0,0,0,17
60592,7086,2009-06-02,Assembly,"AB 724 DE VORE  Assembly Third Reading",79,0,1,0,80
60592,7087,2009-07-14,Senate,"Do pass, but re-refer to the Committee on Appropriations",2,3,0,0,5
60592,7088,2009-07-14,Senate,"Set, first hearing.  Failed passage in Committee.  Reconsideration granted",4,0,1,0,5
60592,9043,2010-06-15,Senate,"Do pass, but re-refer to the Committee on Appropriations",3,2,0,0,5
60592,19847,2010-08-09,Senate,"Do pass",2,6,3,0,11
60592,19848,2010-08-09,Senate,"Set, first hearing.  Failed passage in Committee.  Reconsideration 	granted",10,0,1,0,11
60593,7121,2009-04-01,Assembly,"Do pass and be re-referred to the Committee on Appropriations",10,0,0,0,10
60593,7122,2009-04-22,Assembly,"Do pass",13,1,3,0,17
60593,7123,2009-05-11,Assembly,"AB 725 JONES  Assembly Third Reading",78,1,1,0,80
60593,7124,2009-07-09,Senate,"Do pass, but re-refer to the Committee on Appropriations",7,2,3,0,12
60593,7125,2009-08-31,Senate,"Assembly 3rd Reading AB725 Jones By Florez",24,12,4,0,40
60593,7126,2009-09-02,Assembly,"AB 725 JONES  Concurrence in Senate Amendments",75,0,4,0,79
60594,7119,2009-04-20,Assembly,"Do pass, to Consent Calendar",12,0,2,0,14
60594,7120,2009-04-27,Assembly,"AB 726 NIELSEN  Consent Calendar Second Day  Regular Session",77,0,3,0,80
60595,7103,2009-04-14,Assembly,"Do pass and re-refer to Committee on Appropriations with recommendation:  To Consent Calendar",9,0,2,0,11
60595,7104,2009-05-28,Assembly,"Do pass",17,0,0,0,17
60595,7105,2009-06-01,Assembly,"AB 727 NIELSEN  Assembly Third Reading",78,0,2,0,80
60595,7106,2009-06-23,Senate,"Do pass, but re-refer to the Committee on Appropriations",11,1,1,0,13
60595,7107,2009-07-13,Senate,"Placed on Appropriations Suspense file",12,0,1,0,13
60597,26691,2009-04-20,Assembly,"Do pass as amended",11,0,0,3,14
60597,26692,2009-05-06,Assembly,"Do pass, to Consent Calendar",16,0,0,0,16
60597,26693,2009-05-14,Assembly,"AB 729 EVANS  Consent Calendar Second Day  Regular Session",73,0,0,7,80
60597,26694,2009-06-23,Senate,"Do pass as amended, and re-refer to the Committee on Appropriations",11,0,0,0,11
60597,26695,2009-07-13,Senate,"Do pass",9,1,3,0,13
60597,26696,2009-08-31,Senate,"Assembly 3rd Reading AB729 Evans By Wolk",35,0,5,0,40
60597,26697,2009-09-02,Assembly,"AB 729 EVANS  Concurrence in Senate Amendments",77,0,0,2,79
60598,7109,2009-04-14,Assembly,"Do pass and be re-referred to the Committee on Judiciary",12,3,4,0,19
60598,7110,2009-04-21,Assembly,"Do pass as amended and be re-referred to the Committee on Appropriations",9,1,0,0,10
60598,7111,2009-05-13,Assembly,"Do pass",11,0,5,0,16
60598,7112,2009-05-28,Assembly,"AB 730 DE LA TORRE  Assembly Third Reading",53,23,4,0,80
60598,7113,2009-07-08,Senate,"Do pass, but re-refer to the Committee on Judiciary",8,3,0,0,11
60598,7114,2009-07-14,Senate,"Do pass as amended, and re-refer to the Committee on Appropriations",3,2,0,0,5
60598,7115,2009-08-24,Senate,"Do pass",8,5,0,0,13
60598,7116,2009-09-03,Senate,"Assembly 3rd Reading AB730 De La Torre By Lowenthal",22,16,2,0,40
60598,7117,2009-09-09,Assembly,"AB 730 DE LA TORRE  Concurrence in Senate Amendments",51,25,3,0,79
60599,7118,2009-04-14,Assembly,"Do pass and be re-referred to the Committee on Appropriations",6,1,0,0,7
60600,7097,2009-04-13,Assembly,"Do pass and re-refer to Committee on Appropriations with recommendation:  To Consent Calendar",10,0,4,0,14
60600,7098,2009-04-29,Assembly,"Do pass, to Consent Calendar",16,0,0,0,16
60600,7099,2009-05-11,Assembly,"AB 732 JEFFRIES  Consent Calendar Second Day  Regular Session",78,0,2,0,80
60600,7100,2009-06-09,Senate,"Do pass as amended, and re-refer to the Committee on Appropriations",11,0,0,0,11
60600,7101,2009-06-29,Senate,"Placed on Appropriations Suspense file",13,0,0,0,13
60601,7127,2009-04-20,Assembly,"Do pass and be re-referred to the Committee on Appropriations",13,0,1,0,14
60601,7128,2009-04-29,Assembly,"Do pass",16,0,0,0,16
60601,7129,2009-05-14,Assembly,"AB 733 GALGIANI  Assembly Third Reading",73,0,7,0,80
60601,7130,2009-07-07,Senate,"Do pass, but re-refer to the Committee on Appropriations",9,1,1,0,11
60601,7131,2009-08-31,Senate,"Assembly 3rd Reading AB733 Galgiani By Lowenthal",31,4,5,0,40
60602,7132,2009-04-30,Assembly,"Do pass and re-refer to Committee on Appropriations with recommendation:  To Consent Calendar",16,0,3,0,19
60602,7133,2009-05-13,Assembly,"Do pass",16,0,0,0,16
60602,7134,2009-05-26,Assembly,"AB 734 HILL  Assembly Third Reading",78,0,2,0,80
60603,24862,2009-04-15,Assembly,"Do pass as amended and be re-referred to the Committee on 	Appropriations",7,0,0,1,8
60603,24863,2009-04-29,Assembly,"Do pass, to Consent Calendar",16,0,0,0,16
60603,24864,2009-05-11,Assembly,"AB 735 AGRI.  Consent Calendar Second Day  Regular Session",78,0,0,2,80
60603,24865,2009-07-07,Senate,"Do pass, but re-refer to the Committee on Appropriations",5,0,0,0,5
60603,24866,2009-08-24,Senate,"Special Consent #15 AB735 Committee on AGRI. (Galgiani)",39,0,1,0,40
60605,2747,2009-04-14,Assembly,"Do pass, to Consent Calendar",7,0,0,0,7
60605,2748,2009-04-20,Assembly,"AB 737 E.S.& T.M.  Consent Calendar Second Day  Regular Session",75,0,5,0,80
60605,2749,2009-07-06,Senate,"Do pass and be placed on the Consent Calendar",7,0,0,0,7
60605,12764,2010-07-15,Senate,"Placed on Appropriations Suspense file",8,0,2,0,10
60605,20269,2010-08-12,Senate,"Do pass as amended",7,3,1,0,11
60605,21025,2010-08-24,Senate,"Assembly 3rd Reading AB737 Chesbro By Padilla",17,15,7,0,39
60605,21026,2010-08-24,Senate,"Assembly 3rd Reading AB737 Chesbro Reconsider",35,0,4,0,39
60605,21676,2010-08-30,Senate,"W/O REF. TO FILE AB737 Chesbro By Padilla",21,11,7,0,39
60605,21776,2010-08-31,Assembly,"AB 737 CHESBRO  Concurrence in Senate Amendments",46,29,0,3,78
60606,7141,2009-04-14,Assembly,"Do pass and re-refer to Committee on Appropriations with recommendation:  To Consent Calendar",7,0,0,0,7
60609,7139,2009-04-21,Assembly,"Do pass and be re-referred to the Committee on Appropriations",2,5,0,0,7
60609,7140,2009-04-21,Assembly,"Set first hearing.  Failed passage.  Reconsideration granted",7,0,0,0,7
60610,7135,2009-05-05,Assembly,"Do pass as amended",5,0,2,0,7
60610,7136,2009-05-28,Assembly,"AB 742 SALDANA  Assembly Third Reading",50,29,1,0,80
60610,7137,2009-07-07,Senate,"Do pass",3,2,0,0,5
60610,7138,2009-09-03,Senate,"Assembly 3rd Reading AB742 Saldana By Leno",22,13,5,0,40
60611,2822,2009-04-21,Assembly,"Do pass and be re-referred to the Committee on Human Services",10,0,0,0,10
60611,2823,2009-04-28,Assembly,"Do pass and be re-referred to the Committee on Appropriations",7,0,0,0,7
60611,2824,2010-01-21,Assembly,"Do pass as amended",13,0,4,0,17
60611,2825,2010-01-27,Assembly,"AB 743 PORTANTINO  Assembly Third Reading  FORMERLY FILE ITEM2",67,0,11,0,78
60611,6113,2010-06-10,Senate,"Do pass, but re-refer to the Committee on Judiciary",3,0,1,0,4
60611,10064,2010-06-29,Senate,"Do pass as amended, and re-refer to the Committee on Appropriations",4,0,1,0,5
60611,19438,2010-08-02,Senate,"Placed on Appropriations Suspense file",10,0,1,0,11
60611,20243,2010-08-12,Senate,"Do pass",11,0,0,0,11
60611,20449,2010-08-18,Senate,"Assembly 3rd Reading AB743 Portantino By Wolk",33,0,5,0,38
60611,20532,2010-08-19,Assembly,"AB 743 PORTANTINO  Concurrence in Senate Amendments",78,0,0,1,79
60612,7153,2009-04-27,Assembly,"Do pass and be re-referred to the Committee on Appropriations",12,1,1,0,14
60612,7154,2009-05-28,Assembly,"Do pass as amended",13,4,0,0,17
60612,7155,2009-06-03,Assembly,"AB 744 TORRICO  Assembly Third Reading",58,18,4,0,80
60612,7156,2009-07-16,Senate,"Do pass, but re-refer to the Committee on Appropriations",6,1,4,0,11
60612,7157,2009-08-24,Senate,"Placed on Appropriations Suspense file",13,0,0,0,13
60613,7145,2009-05-05,Assembly,"Do pass as amended",19,0,0,0,19
60613,7146,2009-05-14,Assembly,"AB 745 COTO  Assembly Third Reading",73,0,7,0,80
60613,7147,2009-07-09,Senate,"Do pass",8,0,4,0,12
60613,7148,2009-09-02,Senate,"Assembly 3rd Reading AB745 Coto By Cedillo",31,0,9,0,40
60614,7149,2009-05-06,Assembly,"Do pass",2,2,3,0,7
60614,7150,2009-05-06,Assembly,"Set second hearing.  Failed passage.  Reconsideration granted",7,0,0,0,7
60614,7151,2009-05-13,Assembly,"Do pass",4,0,3,0,7
60614,7152,2009-05-21,Assembly,"AB 746 COTO  Assembly Third Reading",66,7,7,0,80
60615,7171,2009-04-22,Assembly,"Do pass as amended and be re-referred to the Committee on Higher Education",10,0,1,0,11
60615,7172,2009-05-05,Assembly,"Do pass and re-refer to Committee on Appropriations with recommendation:  To Consent Calendar",9,0,0,0,9
60615,7173,2009-05-14,Assembly,"AB 747 EMMERSON  Assembly Third Reading",74,0,6,0,80
60616,7174,2009-04-14,Assembly,"Do pass and be re-referred to the Committee on Appropriations",5,1,1,0,7
60616,7175,2009-04-29,Assembly,"Do pass",12,0,4,0,16
60616,7176,2009-05-14,Assembly,"AB 748 GILMORE  Assembly Third Reading",68,3,9,0,80
60616,7177,2009-07-14,Senate,"Do pass, but re-refer to the Committee on Appropriations",2,5,0,0,7
60616,7178,2009-07-14,Senate,"Set, second hearing.  Failed passage in Committee. Reconsideration granted",7,0,0,0,7
60616,9362,2010-06-22,Senate,"Do pass, but re-refer to the Committee on Appropriations",4,0,1,0,5
60617,7158,2009-04-22,Assembly,"Do pass and be re-referred to the Committee on Appropriations",4,2,0,0,6
60618,25000,2009-04-14,Assembly,"Do pass and be re-referred to the Committee on Appropriations",7,0,0,0,7
60618,25001,2009-05-28,Assembly,"Do pass",12,5,0,0,17
60618,25002,2009-06-02,Assembly,"AB 750 BASS  Assembly Third Reading",53,24,0,3,80
60618,25003,2009-07-07,Senate,"Do pass, but re-refer to the Committee on Appropriations",5,2,0,0,7
60618,25004,2009-07-23,Senate,"Placed on Appropriations Suspense file",13,0,0,0,13
60618,25005,2009-08-27,Senate,"Do pass as amended",8,5,0,0,13
60618,25006,2009-09-04,Senate,"Assembly 3rd Reading AB750 Bass By Leno",24,16,0,0,40
60618,25007,2009-09-09,Assembly,"AB 750 BASS  Concurrence in Senate Amendments",51,25,0,3,79
60619,7142,2009-04-14,Assembly,"Do pass and be re-referred to the Committee on Appropriations",2,3,2,0,7
60619,7143,2009-04-14,Assembly,"Reconsideration granted",7,0,0,0,7
60620,7183,2009-04-14,Assembly,"Do pass and re-refer to Committee on Appropriations with recommendation:  To Consent Calendar",7,0,0,0,7
60620,7184,2009-04-29,Assembly,"Do pass, to Consent Calendar",16,0,0,0,16
60620,7185,2009-05-11,Assembly,"AB 752 ARAMBULA  Consent Calendar Second Day  Regular Session",78,0,2,0,80
60620,7186,2009-06-22,Senate,"Do pass, but re-refer to the Committee on Appropriations Recommend Consent",7,0,0,0,7
60621,26742,2009-04-21,Assembly,"Do pass and re-refer to Committee on Appropriations with 	recommendation:  To Consent Calendar",7,0,0,0,7
60621,26743,2009-04-29,Assembly,"Do pass, to Consent Calendar",16,0,0,0,16
60621,26744,2009-05-11,Assembly,"AB 753 ADAMS  Consent Calendar Second Day  Regular Session",78,0,0,2,80
60621,26745,2009-06-16,Senate,"Do pass, but re-refer to the Committee on Appropriations Recommend 	Consent",5,0,0,0,5
60621,26746,2009-09-04,Senate,"Assembly 3rd Reading AB753 Adams By Walters",39,0,1,0,40
60621,26747,2009-09-09,Assembly,"AB 753 ADAMS  Concurrence in Senate Amendments",78,0,0,1,79
60622,7187,2009-04-21,Assembly,"Do pass as amended and re-refer to Committee on Appropriations with recommendation:  To Consent Calendar",19,0,0,0,19
60622,7188,2009-05-28,Assembly,"Do pass as amended",12,0,5,0,17
60622,7189,2009-06-02,Assembly,"AB 754 CHESBRO  Assembly Third Reading",78,0,2,0,80
60622,7190,2009-07-15,Senate,"Do pass, but re-refer to the Committee on Appropriations",10,0,1,0,11
60622,7191,2009-08-17,Senate,"Placed on Appropriations Suspense file",13,0,0,0,13
60622,7192,2009-08-27,Senate,"Do pass as amended",13,0,0,0,13
60623,7159,2009-05-06,Assembly,"Do pass",5,1,0,0,6
60623,7160,2009-05-18,Assembly,"AB 755 BROWNLEY  Assembly Third Reading",50,25,5,0,80
60623,7161,2009-07-16,Senate,"Do pass as amended, and re-refer to the Committee on Appropriations",4,1,2,0,7
60623,7162,2009-08-31,Senate,"Assembly 3rd Reading AB755 Brownley By Liu",24,12,4,0,40
60623,7163,2009-09-02,Assembly,"AB 755 BROWNLEY  Concurrence in Senate Amendments",49,26,4,0,79
60624,7164,2009-04-21,Assembly,"Do pass and be re-referred to the Committee on Appropriations",7,4,0,0,11
60624,7165,2009-05-28,Assembly,"Do pass as amended",12,5,0,0,17
60624,7166,2009-06-03,Assembly,"AB 756 ENG  Assembly Third Reading",51,27,2,0,80
60624,7167,2009-07-08,Senate,"Do pass, but re-refer to the Committee on Appropriations",7,4,2,0,13
60624,7168,2009-08-17,Senate,"Do pass as amended",9,4,0,0,13
60624,7169,2009-09-09,Senate,"Assembly 3rd Reading AB756 Eng By Leno",24,14,2,0,40
60624,7170,2009-09-10,Assembly,"AB 756 Eng  Concurrence in Senate Amendments",52,26,2,0,80
60626,24848,2009-04-20,Assembly,"Do pass and be re-referred to the Committee on Appropriations",11,4,0,0,15
60626,24849,2009-05-28,Assembly,"Do pass",12,5,0,0,17
60626,24850,2009-06-02,Assembly,"AB 758 SKINNER  Assembly Third Reading",50,29,0,1,80
60626,24851,2009-07-07,Senate,"Do pass as amended, and re-refer to the Committee on Appropriations",11,0,0,0,11
60626,24852,2009-08-17,Senate,"Placed on Appropriations Suspense file",13,0,0,0,13
60626,24853,2009-08-27,Senate,"Do pass as amended",11,2,0,0,13
60626,24854,2009-09-10,Senate,"Assembly 3rd Reading AB758 Skinner By Hancock",27,8,5,0,40
60626,24855,2009-09-11,Assembly,"AB 758 Skinner  Concurrence in Senate Amendments",51,27,0,1,79
60627,7195,2009-04-28,Assembly,"Do pass and be re-referred to the Committee on Appropriations",7,4,0,0,11
60627,7196,2009-05-13,Assembly,"Do pass",11,5,0,0,16
60627,7197,2009-05-28,Assembly,"AB 759 MA  Assembly Third Reading",52,28,0,0,80
60627,7198,2009-07-08,Senate,"Do pass as amended",5,3,0,0,8
60627,7199,2009-08-17,Senate,"Placed on Appropriations Suspense file",13,0,0,0,13
60627,7200,2009-08-27,Senate,"Do pass",8,5,0,0,13
60627,7201,2009-09-09,Senate,"Assembly 3rd Reading AB759 Ma Reconsider",39,0,1,0,40
60627,19785,2010-08-11,Senate,"From Committee:  Amendments returned with further amendements to 	Senate floor for consideration",4,0,1,0,5
60627,20892,2010-08-23,Senate,"Assembly 3rd Reading AB759 Ma By Wolk",31,2,6,0,39
60627,21341,2010-08-26,Assembly,"Senate amendments be concurred in",9,0,0,0,9
60627,21583,2010-08-27,Assembly,"AB 759 MA  Concurrence in Senate Amendments",75,0,0,3,78
60629,7179,2009-05-13,Assembly,"Do pass",4,0,2,0,6
60629,7180,2009-06-08,Assembly,"Do pass",4,2,0,0,6
60629,7181,2009-06-22,Assembly,"AB 761 CALDERON  Assembly Third Reading",38,27,14,0,79
60629,7182,2009-06-25,Assembly,"AB 761 CALDERON  Assembly Third Reading",42,27,10,0,79
60629,10305,2010-06-29,Senate,"Do pass",1,3,1,0,5
60629,10306,2010-06-29,Senate,"Set, first hearing.  Failed passage in Committee.  Reconsideration granted",4,0,1,0,5
60630,26748,2009-04-21,Assembly,"Do pass and be re-referred to the Committee on Appropriations to 	Consent Calendar",6,0,0,0,6
60630,26749,2009-04-29,Assembly,"Do pass, to Consent Calendar",16,0,0,0,16
60630,26750,2009-06-01,Assembly,"AB 762 LOWENTHAL  Assembly Third Reading",78,0,0,2,80
60630,26751,2009-06-23,Senate,"Do pass, but re-refer to the Committee on Appropriations Recommend 	Consent",5,0,0,0,5
60630,26752,2009-09-01,Senate,"Assembly 3rd Reading AB762 Bonnie Lowenthal By Wolk",33,0,7,0,40
60630,26753,2009-09-03,Assembly,"AB 762 LOWENTHAL  Concurrence in Senate Amendments",77,0,0,2,79
60631,25192,2009-04-01,Assembly,"Do pass and be re-referred to the Committee on Appropriations",19,0,0,0,19
60631,25193,2009-04-22,Assembly,"Do pass",16,0,0,1,17
60631,25194,2009-05-11,Assembly,"AB 763 CHESBRO  Assembly Third Reading",78,0,0,2,80
60631,25195,2009-06-09,Senate,"Do pass, but re-refer to the Committee on Appropriations",9,0,3,0,12
60631,25196,2009-07-16,Senate,"Assembly 3rd Reading AB763 Chesbro Urgency Clause",32,0,8,0,40
60631,25197,2009-07-24,Assembly,"AB 763 CHESBRO  Concurrence- Urgency Added",77,0,0,2,79
60632,7207,2009-04-13,Assembly,"Do pass and be re-referred to the Committee on Business and Professions",8,3,0,0,11
60632,7208,2009-04-28,Assembly,"Do pass and be re-referred to the Committee on Appropriations",6,3,2,0,11
60632,7209,2009-05-13,Assembly,"Do pass",11,5,0,0,16
60632,7210,2009-06-02,Assembly,"AB 764 NAVA  Assembly Third Reading  Amend By NAVA  Set #1",48,29,3,0,80
60632,7211,2009-06-03,Assembly,"AB 764 NAVA  Assembly Third Reading",46,28,6,0,80
60632,7212,2009-07-09,Senate,"Do pass, but re-refer to the Committee on Judiciary",7,3,2,0,12
60632,7213,2009-07-14,Senate,"Do pass as amended, and re-refer to the Committee on Appropriations",4,1,0,0,5
60632,7214,2009-09-01,Senate,"Assembly 3rd Reading AB764 Nava By Negrete McLeod",22,16,2,0,40
60632,7215,2009-09-09,Assembly,"AB 764 NAVA  Concurrence in Senate Amendments",53,24,2,0,79
60633,7216,2009-05-18,Assembly,"Do pass as amended and be re-referred to the Committee on Appropriations",9,0,0,0,9
60633,7217,2009-05-28,Assembly,"Do pass",17,0,0,0,17
60633,7218,2009-06-01,Assembly,"AB 765 CABALLERO  Assembly Third Reading",71,4,5,0,80
60633,7219,2009-08-26,Senate,"Do pass, but re-refer to the Committee on Appropriations",8,0,0,0,8
60633,7220,2009-08-27,Senate,"Placed on Appropriations Suspense file",13,0,0,0,13
60635,25155,2009-04-23,Assembly,"Be referred to Committee on Housing and Community Development",8,0,0,3,11
60635,25156,2009-04-29,Assembly,"Do pass as amended and be re-referred to the Committee on 	Appropriations",7,0,0,0,7
60635,25157,2009-05-28,Assembly,"Do pass",17,0,0,0,17
60635,25158,2009-06-01,Assembly,"AB 767 AMMIANO  Third Reading Urgency",78,0,0,2,80
60635,25159,2009-06-16,Senate,"Do pass, but re-refer to the Committee on Appropriations Recommend 	Consent",11,0,0,0,11
60635,25160,2009-06-29,Senate,"Do pass",11,0,2,0,13
60635,25161,2009-07-09,Senate,"Special Consent #12 AB767 Ammiano",34,0,6,0,40
60636,7193,2009-04-21,Assembly,"Do pass and be re-referred to the Committee on Public Safety",6,0,0,0,6
60636,7194,2009-04-28,Assembly,"Do pass and be re-referred to the Committee on Appropriations",4,0,3,0,7
60637,7221,2009-05-06,Assembly,"Do pass as amended",10,0,1,0,11
60637,7222,2009-05-21,Assembly,"AB 769 TORRES  Assembly Third Reading",79,0,1,0,80
60637,7223,2009-06-17,Senate,"Do pass as amended",7,0,2,0,9
60637,7224,2009-08-31,Senate,"Assembly 3rd Reading AB769 Torres By Hancock",30,3,7,0,40
60637,7225,2009-09-02,Assembly,"AB 769 TORRES  Concurrence in Senate Amendments",77,0,2,0,79
60638,25764,2009-04-14,Assembly,"Do pass as amended and be re-referred to the Committee on 	Appropriations",6,0,0,1,7
60638,25765,2009-05-20,Assembly,"Do pass, to Consent Calendar",15,0,0,1,16
60638,25766,2009-05-28,Assembly,"AB 770 TORRES  Consent Calendar Second Day  Regular Session",76,0,0,4,80
60638,25767,2009-06-23,Senate,"Do pass, but re-refer to the Committee on Appropriations Recommend 	Consent",5,0,0,0,5
60638,25768,2009-07-16,Senate,"Special Consent #13 AB770 Torres",36,0,4,0,40
60640,7202,2009-05-06,Assembly,"Do pass",5,2,0,0,7
60640,7203,2009-05-28,Assembly,"AB 772 AMMIANO  Assembly Third Reading",50,30,0,0,80
60640,7204,2009-07-08,Senate,"Do pass as amended",3,2,0,0,5
60640,7205,2009-08-31,Senate,"Assembly 3rd Reading AB772 Ammiano By Cedillo",23,13,4,0,40
60640,7206,2009-09-08,Assembly,"AB 772 AMMIANO  Concurrence in Senate Amendments",47,30,2,0,79
60641,26769,2009-04-28,Assembly,"Do pass as amended and be re-referred to the Committee on 	Appropriations",16,1,0,2,19
60641,26770,2009-05-28,Assembly,"Do pass as amended",12,5,0,0,17
60641,26771,2009-06-02,Assembly,"AB 773 LIEU  Assembly Third Reading",56,19,0,5,80
60641,26772,2009-07-08,Senate,"Do pass, but re-refer to the Committee on Appropriations",8,3,0,0,11
60641,26773,2009-08-17,Senate,"Do pass",7,5,1,0,13
60641,26774,2009-09-10,Senate,"Assembly 3rd Reading AB773 Lieu By Oropeza",23,14,3,0,40
60641,26775,2009-09-11,Assembly,"AB 773 Lieu  Concurrence in Senate Amendments",62,17,0,0,79
60642,24843,2009-05-05,Assembly,"Do pass, to Consent Calendar",9,0,0,0,9
60642,24844,2009-05-14,Assembly,"AB 774 COOK  Consent Calendar Second Day  Regular Session",73,0,0,7,80
60642,24845,2009-06-17,Senate,"Do pass",9,0,0,0,9
60642,24846,2009-08-27,Senate,"Assembly 3rd Reading AB774 Cook By Lowenthal",38,0,2,0,40
60642,24847,2009-08-31,Assembly,"AB 774 COOK  Concurrence in Senate Amendments",74,3,0,2,79
60644,7229,2009-04-28,Assembly,"Do pass and be re-referred to the Committee on Appropriations",4,4,1,0,9
60645,7230,2009-04-14,Assembly,"Do pass and be re-referred to the Committee on Appropriations",7,0,0,0,7
60647,7226,2009-04-22,Assembly,"Do pass and be re-referred to the Committee on Appropriations",4,2,0,0,6
60647,7227,2009-05-28,Assembly,"Do pass as amended",12,0,5,0,17
60647,7228,2009-06-03,Assembly,"AB 779 HAYASHI  Assembly Third Reading",49,28,3,0,80
60648,7243,2009-04-30,Assembly,"Do pass and be re-referred to the Committee on Appropriations",5,2,0,0,7
60649,7244,2010-01-12,Assembly,"Do pass as amended, to Consent Calendar",9,0,0,0,9
60649,7245,2010-01-27,Assembly,"AB 781 JEFFRIES  Consent Calendar Second Day  Regular Session",68,0,10,0,78
60649,9534,2010-06-22,Senate,"Do pass as amended",4,0,1,0,5
60653,7253,2009-04-14,Assembly,"Do pass and be re-referred to the Committee on Appropriations",5,0,2,0,7
60654,7231,2009-04-28,Assembly,"Do pass and be re-referred to the Committee on Appropriations",13,6,0,0,19
60654,7232,2009-05-28,Assembly,"Do pass",10,5,2,0,17
60654,7233,2009-06-03,Assembly,"AB 786 JONES  Assembly Third Reading",48,28,4,0,80
60654,7234,2009-07-15,Senate,"Do pass, but re-refer to the Committee on Appropriations",7,3,1,0,11
60654,7235,2009-08-24,Senate,"Placed on Appropriations Suspense file",13,0,0,0,13
60654,7236,2009-08-27,Senate,"Do pass as amended",8,5,0,0,13
60655,7237,2009-04-23,Assembly,"Be referred to Committee on Elections and Redistricting",8,0,3,0,11
60655,7238,2009-04-30,Assembly,"Do pass and be re-referred to the Committee on Appropriations",7,0,0,0,7
60655,7239,2009-05-28,Assembly,"Do pass as amended",13,4,0,0,17
60655,7240,2009-06-02,Assembly,"AB 787 HILL  Assembly Third Reading",74,1,5,0,80
60655,7241,2009-07-07,Senate,"Do pass, but re-refer to the Committee on Appropriations",5,0,0,0,5
60655,7242,2009-08-17,Senate,"Placed on Appropriations Suspense file",13,0,0,0,13
60655,9936,2010-06-29,Senate,"Do pass as amended, and re-refer to the Committee on Appropriations",8,0,1,0,9
60655,19441,2010-08-02,Senate,"Placed on Appropriations Suspense file",10,0,1,0,11
60655,20250,2010-08-12,Senate,"Do pass",7,4,0,0,11
60655,21107,2010-08-25,Senate,"Assembly 3rd Reading AB787 Hill By Yee",27,5,7,0,39
60655,21493,2010-08-26,Assembly,"Senate amendments be concurred in",12,0,0,2,14
60655,21566,2010-08-27,Assembly,"AB 787 HILL  Concurrence in Senate Amendments",60,12,0,6,78
60657,25076,2009-05-12,Assembly,"Do pass",7,0,0,0,7
60657,25077,2009-05-28,Assembly,"AB 789 DE LEON  Assembly Third Reading",78,0,0,2,80
60657,25078,2009-07-14,Senate,"Do pass as amended",6,0,1,0,7
60657,25079,2009-09-01,Senate,"Assembly 3rd Reading AB789 De Leon By Pavley",26,6,8,0,40
60657,25080,2009-09-08,Assembly,"AB 789 DE LEON  Concurrence in Senate Amendments",78,0,0,1,79
60658,5050,2009-04-22,Assembly,"Do pass and be re-referred to the Committee on Appropriations",4,1,1,0,6
60658,5051,2009-05-28,Assembly,"Do pass as amended",12,5,0,0,17
60658,5052,2009-06-03,Assembly,"AB 790 RUSKIN  Assembly Third Reading",46,30,4,0,80
60658,5053,2010-03-08,Senate,"Be re-referred to the Committee on Rules",1,3,2,0,6
60658,5054,2010-03-08,Senate,"Do pass, but re-refer to the Committee on Appropriations",4,1,1,0,6
60658,5055,2010-03-15,Senate,"Committee amendments",3,7,1,0,11
60658,5056,2010-03-15,Senate,"Committee amendments",3,7,1,0,11
60658,5057,2010-03-15,Senate,"Do pass",7,3,1,0,11
60658,5058,2010-04-08,Senate,"Assembly 3rd Reading AB790 Hernandez Reconsider",34,0,5,0,39
60659,7258,2009-04-29,Assembly,"Do pass as amended and be re-referred to the Committee on Appropriations",7,3,1,0,11
60659,7259,2009-05-20,Assembly,"Do pass",11,4,1,0,16
60659,7260,2009-05-28,Assembly,"AB 791 SWANSON  Assembly Third Reading",46,29,5,0,80
60660,7246,2009-05-12,Assembly,"Do pass, to Consent Calendar",11,0,0,0,11
60660,7247,2009-05-18,Assembly,"AB 792 DUVALL  Consent Calendar Second Day  Regular Session",77,0,3,0,80
60661,7248,2009-04-21,Assembly,"Do pass as amended",7,3,0,0,10
60661,7249,2009-05-18,Assembly,"AB 793 JONES  Assembly Third Reading",49,28,3,0,80
60661,7250,2009-06-16,Senate,"Do pass",3,2,0,0,5
60661,7251,2009-09-04,Senate,"Assembly 3rd Reading AB793 Jones By Corbett",24,16,0,0,40
60662,26908,2009-04-01,Assembly,"Do pass as amended and re-refer to Committee on Appropriations 	with recommendation:  To Consent Calendar",11,0,0,0,11
60662,26909,2009-04-22,Assembly,"Do pass, to Consent Calendar",16,0,0,1,17
60662,26910,2009-05-04,Assembly,"AB 794 HAGMAN  Consent Calendar Second Day  Regular Session",79,0,0,1,80
60662,26911,2009-06-10,Senate,"Do pass, but re-refer to the Committee on Appropriations Recommend 	Consent",8,0,1,0,9
60662,26912,2009-07-09,Senate,"Special Consent #12 AB794 Hagman",34,0,6,0,40
60664,7270,2009-04-01,Assembly,"Do pass",8,2,1,0,11
60664,7271,2009-05-11,Assembly,"AB 796 CARTER  Assembly Third Reading",51,29,0,0,80
60664,7272,2009-06-17,Senate,"Do pass",6,1,2,0,9
60664,7273,2009-09-01,Senate,"Assembly 3rd Reading AB796 Carter By Simitian",23,15,2,0,40
60664,7274,2009-09-08,Assembly,"AB 796 CARTER  Concurrence in Senate Amendments",49,28,2,0,79
60665,7254,2009-04-28,Assembly,"Do pass as amended and be re-referred to the Committee on Appropriations",10,0,1,0,11
60665,7255,2009-05-20,Assembly,"Do pass",15,0,1,0,16
60665,7256,2009-05-28,Assembly,"AB 797 MA  Assembly Third Reading",76,0,4,0,80
60665,7257,2009-06-29,Senate,"Do pass, but re-refer to the Committee on Appropriations",10,0,0,0,10
60666,26831,2009-04-13,Assembly,"Do pass and be re-referred to the Committee on Appropriations",11,3,0,0,14
60666,26832,2009-05-28,Assembly,"Do pass",12,5,0,0,17
60666,26833,2009-06-02,Assembly,"AB 798 NAVA  Assembly Third Reading",51,25,0,4,80
60666,26834,2009-07-07,Senate,"Do pass, but re-refer to the Committee on Appropriations",9,1,1,0,11
60666,26835,2009-08-17,Senate,"Placed on Appropriations Suspense file",13,0,0,0,13
60666,26836,2009-08-27,Senate,"Do pass",10,3,0,0,13
60666,26837,2009-09-03,Senate,"Assembly 3rd Reading AB798 Nava By Lowenthal",29,4,7,0,40
60666,26838,2009-09-09,Assembly,"AB 798 NAVA  Concurrence in Senate Amendments",51,25,0,3,79
60668,24837,2009-04-22,Assembly,"Do pass and be re-referred to the Committee on Appropriations to 	Consent Calendar",10,0,0,0,10
60668,24838,2009-05-13,Assembly,"Do pass, to Consent Calendar",16,0,0,0,16
60668,24839,2009-05-21,Assembly,"AB 800 DUVALL  Consent Calendar Second Day  Regular Session",77,0,0,3,80
60668,24840,2009-07-09,Senate,"Do pass as amended, and re-refer to the Committee on 	Appropriations",10,0,2,0,12
60668,24841,2009-08-27,Senate,"Special Consent #16 AB800 Duvall By Runner",38,0,2,0,40
60668,24842,2009-08-31,Assembly,"AB 800 DUVALL  Concurrence in Senate Amendments",77,0,0,2,79
60670,7275,2009-05-06,Assembly,"Do pass as amended",10,0,0,0,10
60670,7276,2009-06-02,Assembly,"AB 802 DUVALL  Assembly Third Reading",79,0,1,0,80
60671,7261,2009-04-22,Assembly,"Do pass and be re-referred to the Committee on Appropriations",2,4,0,0,6
60672,7262,2009-04-14,Assembly,"Do pass as amended and be re-referred to the Committee on Judiciary",13,0,0,0,13
60672,7263,2009-04-21,Assembly,"Do pass as amended and re-refer to Committee on Appropriations with recommendation:  To Consent Calendar",10,0,0,0,10
60672,7264,2009-05-28,Assembly,"Do pass",17,0,0,0,17
60672,7265,2009-06-02,Assembly,"AB 804 HALL  Assembly Third Reading",79,0,1,0,80
60672,7266,2009-06-23,Senate,"Do pass, but re-refer to the Committee on Judiciary Recommend Consent",11,0,0,0,11
60672,7267,2009-07-14,Senate,"Do pass as amended. To Consent Calendar",5,0,0,0,5
60672,7268,2009-08-20,Senate,"Consent Calendar 2nd AB804 Hall",40,0,0,0,40
60672,7269,2009-08-31,Assembly,"AB 804 HALL  Concurrence in Senate Amendments",74,0,5,0,79
60673,26895,2009-04-13,Assembly,"Do pass and re-refer to Committee on Appropriations with 	recommendation:  To Consent Calendar",10,0,0,4,14
60673,26896,2009-04-22,Assembly,"Do pass, to Consent Calendar",16,0,0,1,17
60673,26897,2009-05-04,Assembly,"AB 805 FUENTES  Consent Calendar Second Day  Regular Session",79,0,0,1,80
60673,26898,2009-06-09,Senate,"Do pass, but re-refer to the Committee on Appropriations",9,0,2,0,11
60673,26899,2009-09-02,Senate,"Special Consent #18 AB805 Fuentes By Lowenthal",39,0,1,0,40
60673,26900,2009-09-09,Assembly,"AB 805 FUENTES  Concurrence in Senate Amendments",77,0,0,2,79
60674,7282,2009-05-12,Assembly,"Do pass as amended",5,2,0,0,7
60674,7283,2009-06-02,Assembly,"AB 806 FUENTES  Assembly Third Reading",44,32,4,0,80
60674,7284,2009-07-14,Senate,"Do pass",5,2,0,0,7
60674,7285,2009-09-02,Senate,"Assembly 3rd Reading AB806 Fuentes By Cedillo",23,14,3,0,40
60675,7286,2009-04-14,Assembly,"Do pass and be re-referred to the Committee on Appropriations",7,0,0,0,7
60675,7287,2009-05-28,Assembly,"Do pass as amended",13,0,4,0,17
60675,7288,2009-06-02,Assembly,"AB 807 FUENTES  Assembly Third Reading",75,1,4,0,80
60675,7289,2009-07-07,Senate,"Do pass as amended, and re-refer to the Committee on Appropriations",5,0,2,0,7
60675,7290,2009-08-17,Senate,"Do pass",7,1,5,0,13
60675,7291,2009-09-03,Senate,"Assembly 3rd Reading AB807 Fuentes By Leno",27,7,6,0,40
60675,7292,2009-09-09,Assembly,"AB 807 FUENTES  Concurrence in Senate Amendments",76,1,2,0,79
60678,7296,2009-05-13,Assembly,"Do pass, to Consent Calendar",7,0,0,0,7
60678,7297,2009-05-21,Assembly,"AB 810 CABALLERO  Consent Calendar Second Day  Regular Session",77,0,3,0,80
60679,7298,2009-04-13,Assembly,"Do pass and be re-referred to the Committee on Appropriations",11,0,0,0,11
60679,7299,2009-05-13,Assembly,"Do pass",16,0,0,0,16
60679,7300,2009-05-26,Assembly,"AB 811 PEREZ, J.  Assembly Third Reading",79,0,1,0,80
60679,7301,2009-07-14,Senate,"Do pass as amended, and re-refer to the Committee on Appropriations",6,0,1,0,7
60679,7302,2009-08-31,Senate,"Assembly 3rd Reading AB811 John A. Perez By Wright",32,4,4,0,40
60679,7303,2009-09-02,Assembly,"AB 811 PEREZ, J.  Concurrence in Senate Amendments",76,0,3,0,79
60680,7277,2009-04-16,Assembly,"Be referred to Committee on Health",10,0,1,0,11
60680,7278,2009-04-28,Assembly,"Do pass as amended and be re-referred to the Committee on Appropriations",12,4,3,0,19
60681,24821,2009-04-30,Assembly,"Do pass as amended and be re-referred to the Committee on 	Appropriations",16,0,0,3,19
60681,24822,2009-05-13,Assembly,"Do pass",16,0,0,0,16
60681,24823,2009-05-28,Assembly,"AB 813 HALL  Assembly Third Reading",76,0,0,4,80
60681,24824,2009-07-08,Senate,"Do pass, but re-refer to the Committee on Appropriations",9,1,3,0,13
60681,24825,2009-09-08,Senate,"Do pass, but re-refer to the Committee on Appropriations",9,1,3,0,13
60681,24826,2009-09-12,Senate,"Assembly 3rd Reading AB813 John A. Perez Reconsider",39,0,1,0,40
60681,24827,2009-10-14,Senate,"Assembly 3rd Reading AB813 John A. Perez Urgency Clause",31,3,6,0,40
60681,24828,2009-10-26,Assembly,"Senate amendments be concurred in",13,1,0,5,19
60681,24829,2009-10-26,Assembly,"AB 813 PEREZ, J.  Concurrence- Urgency Added",66,4,0,9,79
60682,7279,2009-04-14,Assembly,"Do pass and be re-referred to the Committee on Appropriations",7,0,0,0,7
60682,7280,2009-05-28,Assembly,"Do pass as amended",12,0,5,0,17
60682,7281,2009-06-03,Assembly,"AB 814 KREKORIAN  Assembly Third Reading",72,3,5,0,80
60682,9689,2010-06-29,Senate,"Do pass as amended, and re-refer to the Committee on Appropriations",4,0,1,0,5
60682,19377,2010-08-02,Senate,"Do pass",8,0,3,0,11
60682,20562,2010-08-19,Senate,"Assembly 3rd Reading AB814 Hill By Ashburn",30,1,7,0,38
60682,21326,2010-08-26,Assembly,"Senate amendments be concurred in",5,0,0,2,7
60682,21580,2010-08-27,Assembly,"AB 814 HILL  Concurrence in Senate Amendments",74,0,0,4,78
60683,7306,2009-05-05,Assembly,"Do pass as amended and be re-referred to the Committee on Local Government",10,0,0,0,10
60683,7307,2009-05-13,Assembly,"Do pass as amended",6,0,1,0,7
60683,7308,2009-06-03,Assembly,"AB 815 MA  Assembly Third Reading",75,0,5,0,80
60683,10156,2010-06-29,Senate,"Do pass, but re-refer to the Committee on Appropriations",8,0,3,0,11
60683,19701,2010-08-02,Senate,"Do pass",9,0,2,0,11
60683,20040,2010-08-11,Senate,"Assembly 3rd Reading AB815 Caballero By Denham",34,0,4,0,38
60683,21207,2010-08-24,Assembly,"Senate amendments be concurred in",8,1,0,1,10
60683,21208,2010-08-25,Assembly,"AB 815 CABALLERO  Concurrence in Senate Amendments",60,17,0,1,78
60684,7304,2009-04-22,Assembly,"Do pass and be re-referred to the Committee on Appropriations",2,6,2,0,10
60684,7305,2009-04-22,Assembly,"Reconsideration granted",10,0,0,0,10
60686,25070,2009-04-21,Assembly,"Do pass as amended and re-refer to Committee on Appropriations 	with recommendation:  To Consent Calendar",19,0,0,0,19
60686,25071,2009-05-13,Assembly,"Do pass, to Consent Calendar",16,0,0,0,16
60686,25072,2009-05-21,Assembly,"AB 818 HERNANDEZ  Consent Calendar Second Day  Regular Session",77,0,0,3,80
60686,25073,2009-07-08,Senate,"Do pass as amended, and re-refer to the Committee on Appropriations",10,1,0,0,11
60686,25074,2009-08-31,Senate,"Assembly 3rd Reading AB818 Hernandez By Negrete McLeod",35,1,4,0,40
60686,25075,2009-09-02,Assembly,"AB 818 HERNANDEZ  Concurrence in Senate Amendments",77,0,0,2,79
60687,7293,2009-04-28,Assembly,"Do pass and be re-referred to the Committee on Appropriations",7,0,0,0,7
60687,7294,2009-05-28,Assembly,"Do pass as amended",12,5,0,0,17
60687,7295,2009-06-02,Assembly,"AB 819 CALDERON  Third Reading Urgency",77,0,3,0,80
60687,9953,2010-06-29,Senate,"Do pass as amended, and re-refer to the Committee on Appropriations",7,0,0,0,7
60687,20417,2010-08-18,Senate,"Assembly 3rd Reading AB819 Charles Calderon Urgency Clause",34,0,4,0,38
60687,20621,2010-08-19,Assembly,"AB 819 CALDERON  Concurrence in Senate Amendments",78,0,0,1,79
60688,25407,2009-04-22,Assembly,"Do pass and re-refer to Committee on Appropriations with 	recommendation:  To Consent Calendar",6,0,0,0,6
60688,25408,2009-05-06,Assembly,"Do pass, to Consent Calendar",16,0,0,0,16
60688,25409,2009-05-14,Assembly,"AB 820 CONWAY  Consent Calendar Second Day  Regular Session",73,0,0,7,80
60688,25410,2009-06-08,Senate,"Do pass, but re-refer to the Committee on Appropriations Recommend 	Consent",7,0,0,0,7
60688,25411,2009-06-29,Senate,"Do pass",11,0,2,0,13
60688,25412,2009-07-09,Senate,"Special Consent #12 AB820 Conway",34,0,6,0,40
60689,7318,2009-04-22,Assembly,"Do pass as amended and be re-referred to the Committee on Appropriations",7,2,2,0,11
60691,7309,2009-04-13,Assembly,"Do pass as amended and be re-referred to the Committee on Appropriations",10,1,3,0,14
60691,7310,2009-05-28,Assembly,"Do pass",12,5,0,0,17
60691,7311,2009-06-02,Assembly,"AB 823 HILL  Assembly Third Reading  Amend By HILL  Set #1",49,28,3,0,80
60691,7312,2009-06-03,Assembly,"AB 823 HILL  Assembly Third Reading",56,19,5,0,80
60691,7313,2009-07-07,Senate,"Do pass as amended, and re-refer to the Committee on Appropriations",7,3,1,0,11
60691,7314,2009-08-24,Senate,"Placed on Appropriations Suspense file",13,0,0,0,13
60691,7315,2009-08-27,Senate,"Do pass as amended",8,5,0,0,13
60691,7316,2009-09-02,Senate,"Assembly 3rd Reading AB823 Hill By Yee",23,10,7,0,40
60691,7317,2009-09-08,Assembly,"AB 823 HILL  Concurrence in Senate Amendments",57,22,0,0,79
60692,24816,2009-04-20,Assembly,"Do pass as amended and be re-referred to the Committee on 	Appropriations",9,0,0,0,9
60692,24817,2009-05-13,Assembly,"Do pass, to Consent Calendar",16,0,0,0,16
60692,24818,2009-05-26,Assembly,"AB 824 HARKEY  Assembly Third Reading",80,0,0,0,80
60692,24819,2009-07-08,Senate,"Do pass, but re-refer to the Committee on Appropriations Recommend 	Consent",8,0,0,0,8
60692,24820,2009-08-27,Senate,"Special Consent #16 AB824 Harkey",38,0,2,0,40
60693,25974,2009-04-28,Assembly,"Do pass as amended and be re-referred to the Committee on 	Appropriations",12,0,0,1,13
60693,25975,2009-05-20,Assembly,"Do pass, to Consent Calendar",15,0,0,1,16
60693,25976,2009-05-28,Assembly,"AB 825 BLAKESLEE  Consent Calendar Second Day  Regular Session",76,0,0,4,80
60693,25977,2009-06-23,Senate,"Do pass, but re-refer to the Committee on Appropriations Recommend 	Consent",11,0,0,0,11
60693,25978,2009-07-06,Senate,"Do pass as amended",11,0,2,0,13
60693,25979,2009-07-16,Senate,"Special Consent #13 AB825 Blakeslee",36,0,4,0,40
60693,25980,2009-08-17,Assembly,"AB 825 BLAKESLEE  Concurrence in Senate Amendments",77,0,0,2,79
60695,7329,2009-05-13,Assembly,"Do pass",5,2,0,0,7
60695,7330,2009-05-28,Assembly,"AB 827 YAMADA  Assembly Third Reading",48,32,0,0,80
60695,7331,2009-07-01,Senate,"Do pass as amended",3,2,0,0,5
60695,21746,2010-08-30,Senate,"From Committee:  Amendments returned to Senate floor for 	consideration",11,0,0,0,11
60695,21747,2010-08-30,Senate,"That the Assembly amendments be concurred in, but first be 	re-referred to the Committee on Appropriations",4,0,0,0,4
60695,21748,2010-08-30,Senate,"W/O REF. TO FILE AB827 De La Torre Urgency Clause",37,0,2,0,39
60695,21852,2010-08-31,Assembly,"Senate amendments be concurred in",6,1,0,2,9
60695,21853,2010-08-31,Assembly,"AB 827 DE LA TORRE  Concurrence- Urgency Added",69,3,0,6,78
60696,7320,2009-04-14,Assembly,"Do pass as amended and be re-referred to the Committee on Natural Resources",7,3,1,0,11
60696,7321,2009-04-27,Assembly,"Do pass and be re-referred to the Committee on Appropriations",6,3,0,0,9
60696,7322,2009-05-06,Assembly,"Do pass",10,5,1,0,16
60696,7323,2009-05-21,Assembly,"AB 828 LIEU  Assembly Third Reading  Amend By LIEU  Set #1",49,29,2,0,80
60696,7324,2009-05-28,Assembly,"AB 828 LIEU  Assembly Third Reading",50,30,0,0,80
60696,7325,2009-07-07,Senate,"Do pass, but re-refer to the Committee on Environmental Quality",6,3,2,0,11
60696,7326,2009-07-13,Senate,"Do pass as amended, and re-refer to the Committee on Appropriations",5,2,0,0,7
60696,7327,2009-09-03,Senate,"Assembly 3rd Reading AB828 Lieu By Lowenthal",24,10,6,0,40
60696,7328,2009-09-09,Assembly,"AB 828 LIEU  Concurrence in Senate Amendments",49,28,2,0,79
60697,7319,2009-05-18,Assembly,"Do pass as amended and be re-referred to the Committee on Appropriations",6,0,3,0,9
60698,25515,2009-04-14,Assembly,"Do pass as amended and re-refer to Committee on Appropriations 	with recommendation:  To Consent Calendar",19,0,0,0,19
60698,25516,2009-05-13,Assembly,"Do pass, to Consent Calendar",16,0,0,0,16
60698,25517,2009-05-21,Assembly,"AB 830 COOK  Consent Calendar Second Day  Regular Session",77,0,0,3,80
60698,25518,2009-07-15,Senate,"Do pass as amended. To Consent Calendar",10,0,1,0,11
60698,25519,2009-08-24,Senate,"Do pass as amended",8,0,5,0,13
60698,25520,2009-08-31,Senate,"Special Consent #17 AB830 Cook",36,0,4,0,40
60698,25521,2009-09-02,Assembly,"AB 830 COOK  Concurrence in Senate Amendments",76,0,0,3,79
60700,7343,2009-04-28,Assembly,"Do pass as amended and be re-referred to the Committee on Appropriations",16,0,3,0,19
60703,7332,2009-04-15,Assembly,"Do pass and be re-referred to the Committee on Environmental Safety and Toxic Materials",1,4,3,0,8
60703,7333,2009-04-15,Assembly,"Set first hearing.  Failed passage.  Reconsideration granted",7,0,1,0,8
60704,7335,2009-04-22,Assembly,"Do pass as amended and be re-referred to the Committee on Appropriations",7,1,3,0,11
60704,7336,2009-05-28,Assembly,"Do pass",12,5,0,0,17
60704,7337,2009-06-01,Assembly,"AB 836 TORLAKSON  Assembly Third Reading",50,27,3,0,80
60704,7338,2009-07-15,Senate,"Do pass as amended, and re-refer to the Committee on Appropriations",6,1,2,0,9
60704,7339,2009-08-17,Senate,"Placed on Appropriations Suspense file",13,0,0,0,13
60704,7340,2009-08-27,Senate,"Do pass",7,5,1,0,13
60704,7341,2009-09-09,Senate,"Assembly 3rd Reading AB836 Torlakson By Alquist",24,13,3,0,40
60704,7342,2009-09-10,Assembly,"AB 836 Torlakson  Concurrence in Senate Amendments",51,26,3,0,80
60705,7334,2009-04-15,Assembly,"Do pass as amended and re-refer to Committee on Appropriations with recommendation:  To Consent Calendar",10,0,1,0,11
60706,7344,2009-04-22,Assembly,"Do pass and be re-referred to the Committee on Appropriations",5,2,0,0,7
60706,7345,2009-05-28,Assembly,"Do pass",12,5,0,0,17
60706,7346,2009-06-02,Assembly,"AB 838 SWANSON  Assembly Third Reading",49,30,1,0,80
60706,7347,2009-07-08,Senate,"Do pass, but re-refer to the Committee on Appropriations",4,2,0,0,6
60706,7348,2009-08-17,Senate,"Placed on Appropriations Suspense file",13,0,0,0,13
60706,7349,2009-08-27,Senate,"Do pass",7,5,1,0,13
60706,7350,2009-09-04,Senate,"Assembly 3rd Reading AB838 Swanson By Hancock",24,15,1,0,40
60707,24915,2009-04-14,Assembly,"Do pass and be re-referred to the Committee on Judiciary to Consent 	Calendar",19,0,0,0,19
60707,24916,2009-04-27,Assembly,"Do pass and re-refer to Committee on Appropriations with 	recommendation:  To Consent Calendar",10,0,0,0,10
60707,24917,2009-05-13,Assembly,"Do pass, to Consent Calendar",16,0,0,0,16
60707,24918,2009-05-21,Assembly,"AB 839 EMMERSON  Consent Calendar Second Day  Regular Session",77,0,0,3,80
60707,24919,2009-06-17,Senate,"Do pass, but re-refer to the Committee on Judiciary",6,0,5,0,11
60707,24920,2009-07-07,Senate,"Do pass, but re-refer to the Committee on Appropriations Recommend 	Consent",5,0,0,0,5
60707,24921,2009-09-01,Senate,"Assembly 3rd Reading AB839 Emmerson By Harman",32,0,8,0,40
60707,24922,2009-09-03,Assembly,"AB 839 EMMERSON  Concurrence in Senate Amendments",77,0,0,2,79
60710,7351,2009-04-22,Assembly,"Do pass and be re-referred to the Committee on Appropriations",4,2,1,0,7
60711,7352,2009-04-22,Assembly,"Do pass and be re-referred to the Committee on Appropriations",5,1,0,0,6
60712,7353,2009-04-29,Assembly,"Do pass and be re-referred to the Committee on Appropriations",3,5,3,0,11
60712,7354,2009-04-29,Assembly,"Set second hearing.  Failed passage.  Reconsideration granted",11,0,0,0,11
60713,7359,2009-04-14,Assembly,"Do pass and re-refer to Committee on Appropriations with recommendation:  To Consent Calendar",7,0,0,0,7
60713,7360,2009-05-28,Assembly,"Do pass",13,3,1,0,17
60713,7361,2009-06-02,Assembly,"AB 845 BASS  Assembly Third Reading",79,0,1,0,80
60713,7362,2009-07-07,Senate,"Do pass, but re-refer to the Committee on Appropriations",7,0,0,0,7
60713,7363,2009-07-23,Senate,"Placed on Appropriations Suspense file",13,0,0,0,13
60713,7364,2009-08-27,Senate,"Do pass",13,0,0,0,13
60713,7365,2009-09-04,Senate,"Special Consent #19 AB845 Bass",40,0,0,0,40
60713,7366,2009-09-09,Assembly,"AB 845 BASS  Concurrence in Senate Amendments",78,0,1,0,79
60714,7356,2009-04-21,Assembly,"Do pass and be re-referred to the Committee on Appropriations",7,3,0,0,10
60714,7357,2009-05-28,Assembly,"Do pass as amended",12,5,0,0,17
60714,7358,2009-06-03,Assembly,"AB 846 TORRICO  Assembly Third Reading",47,30,3,0,80
60714,9889,2010-06-29,Senate,"Do pass as amended, and re-refer to the Committee on Appropriations",5,3,3,0,11
60714,9890,2010-06-29,Senate,"Set, final hearing.  Failed passage in Committee.  Reconsideration granted",8,0,3,0,11
60715,7355,2009-07-06,Assembly,"Do pass as amended and be re-referred to the Committee on Appropriations",4,4,1,0,9
60717,7374,2009-04-22,Assembly,"Do pass and be re-referred to the Committee on Appropriations",5,2,0,0,7
60718,7375,2009-04-28,Assembly,"Do pass as amended and re-refer to Committee on Appropriations with recommendation:  To Consent Calendar",10,0,0,0,10
60719,26824,2009-04-01,Assembly,"Do pass and re-refer to Committee on Appropriations with 	recommendation:  To Consent Calendar",11,0,0,0,11
60719,26825,2009-04-22,Assembly,"Do pass, to Consent Calendar",16,0,0,0,16
60719,26826,2009-05-21,Assembly,"AB 851 BROWNLEY  Assembly Third Reading",78,0,0,0,78
60719,26827,2009-07-08,Senate,"Do pass as amended, and re-refer to the Committee on Appropriations",9,0,0,0,9
60719,26828,2009-08-17,Senate,"Do pass",8,0,0,0,8
60719,26829,2009-09-04,Senate,"Assembly 3rd Reading AB851 Brownley By Huff",39,0,0,0,39
60719,26830,2009-09-09,Assembly,"AB 851 BROWNLEY  Concurrence in Senate Amendments",78,0,0,0,78
60720,7367,2009-04-27,Assembly,"Do pass as amended and be re-referred to the Committee on Appropriations",6,1,2,0,9
60720,7368,2009-05-20,Assembly,"Do pass",12,3,1,0,16
60720,7369,2009-05-28,Assembly,"AB 852 FONG  Assembly Third Reading",52,27,1,0,80
60720,7370,2009-07-08,Senate,"Do pass as amended, and re-refer to the Committee on Appropriations",5,2,1,0,8
60720,7371,2009-09-03,Senate,"Assembly 3rd Reading AB852 Fong By Alquist",22,14,4,0,40
60720,7372,2009-09-09,Assembly,"AB 852 FONG  Concurrence in Senate Amendments",50,26,3,0,79
60721,1,2009-05-13,Assembly,"Do pass as amended.",5,2,0,0,7
60721,2,2009-05-26,Assembly,"AB 853 ARAMBULA  Assembly Third Reading",47,30,3,0,80
60721,9895,2010-06-30,Senate,"Do pass as amended, and re-refer to the Committee on Rules",3,2,0,0,5
60721,19127,2010-08-02,Senate,"Do pass",7,2,0,0,9
60721,20840,2010-08-23,Senate,"Assembly 3rd Reading AB853 Arambula By Kehoe",22,14,0,0,36
60721,20976,2010-08-24,Assembly,"AB 853 ARAMBULA  Concurrence in Senate Amendments",46,29,0,0,75
60722,24908,2009-04-22,Assembly,"Do pass and be re-referred to the Committee on Appropriations",7,0,0,0,7
60722,24909,2009-05-28,Assembly,"Do pass as amended",17,0,0,0,17
60722,24910,2009-06-02,Assembly,"AB 854 ARAMBULA  Assembly Third Reading",78,0,0,0,78
60722,24911,2009-07-08,Senate,"Do pass as amended, and re-refer to the Committee on 	Appropriations",5,1,0,0,6
60722,24912,2009-08-17,Senate,"Do pass",11,0,0,0,11
60722,24913,2009-09-02,Senate,"Assembly 3rd Reading AB854 Arambula By DeSaulnier",24,2,0,0,26
60722,24914,2009-09-08,Assembly,"AB 854 ARAMBULA  Concurrence in Senate Amendments",79,0,0,0,79
60724,24900,2009-04-29,Assembly,"Do pass and be re-referred to the Committee on Appropriations",8,0,0,0,8
60724,24901,2009-05-28,Assembly,"Do pass",17,0,0,0,17
60724,24902,2009-06-01,Assembly,"AB 856 CABALLERO  Assembly Third Reading",76,0,0,0,76
60724,24903,2009-07-06,Senate,"Do pass, but re-refer to the Committee on Food and Agriculture",4,1,0,0,5
60724,24904,2009-07-07,Senate,"Do pass, but re-refer to the Committee on Appropriations",5,0,0,0,5
60724,24905,2009-08-24,Senate,"Do pass as amended",11,0,0,0,11
60724,24906,2009-09-03,Senate,"Assembly 3rd Reading AB856 Caballero By Maldonado",34,0,0,0,34
60724,24907,2009-09-11,Assembly,"AB 856 CABALLERO  Concurrence in Senate Amendments",78,0,0,0,78
60725,7387,2009-04-22,Assembly,"Do pass and be re-referred to the Committee on Appropriations",6,1,0,0,7
60725,7388,2009-05-28,Assembly,"Do pass as amended",13,4,0,0,17
60725,7389,2009-06-02,Assembly,"AB 857 GALGIANI  Third Reading Urgency",60,14,6,0,80
60725,7390,2009-07-08,Senate,"Do pass, but re-refer to the Committee on Appropriations",4,2,0,0,6
60725,7391,2009-08-17,Senate,"Placed on Appropriations Suspense file",13,0,0,0,13
60726,7385,2009-04-14,Assembly,"Do pass and be re-referred to the Committee on Appropriations",2,0,5,0,7
60726,7386,2009-04-14,Assembly,"Reconsideration granted",7,0,0,0,7
60727,7373,2009-04-13,Assembly,"Do pass as amended and be re-referred to the Committee on Appropriations",8,6,0,0,14
60729,7377,2009-04-13,Assembly,"Be referred to Committee on Health",9,0,2,0,11
60729,7378,2009-04-28,Assembly,"Do pass as amended and re-refer to Committee on Appropriations with recommendation:  To Consent Calendar",18,0,1,0,19
60729,7379,2009-05-20,Assembly,"Do pass, to Consent Calendar",15,0,1,0,16
60729,7380,2009-05-28,Assembly,"AB 861 RUSKIN  Consent Calendar Second Day  Regular Session",76,0,4,0,80
60729,7381,2009-06-17,Senate,"Do pass, but re-refer to the Committee on Appropriations",9,0,2,0,11
60729,7382,2009-06-29,Senate,"Placed on Appropriations Suspense file",13,0,0,0,13
60729,7383,2009-08-27,Senate,"Do pass",13,0,0,0,13
60729,7384,2009-09-02,Senate,"Assembly 3rd Reading AB861 Ruskin By Yee",35,0,5,0,40
60731,24896,2009-05-11,Assembly,"Do pass, to Consent Calendar",14,0,0,0,14
60731,24897,2009-05-18,Assembly,"AB 863 NIELLO  Consent Calendar Second Day  Regular Session",77,0,0,0,77
60731,24898,2009-06-17,Senate,"Do pass and be placed on the Consent Calendar",5,0,0,0,5
60731,24899,2009-06-24,Senate,"Consent Calendar 2nd AB863 Niello",40,0,0,0,40
60732,7376,2009-04-22,Assembly,"Do pass and be re-referred to the Committee on Appropriations",14,0,5,0,19
60734,24891,2009-05-06,Assembly,"Do pass as amended, to Consent Calendar",9,0,0,0,9
60734,24892,2009-05-20,Assembly,"Do pass, to Consent Calendar",15,0,0,0,15
60734,24893,2009-05-28,Assembly,"AB 866 NIELLO  Consent Calendar Second Day  Regular Session",76,0,0,0,76
60734,24894,2009-07-09,Senate,"Do pass, but re-refer to the Committee on Appropriations Recommend 	Consent",11,0,0,0,11
60734,24895,2009-08-27,Senate,"Special Consent #16 AB866 Niello",38,0,0,0,38
60735,7395,2009-04-21,Assembly,"Do pass and be re-referred to the Committee on Business and Professions",8,0,1,0,9
60735,7396,2009-04-28,Assembly,"Do pass and be re-referred to the Committee on Appropriations",8,0,3,0,11
60735,7397,2009-05-28,Assembly,"Do pass",13,4,0,0,17
60735,7398,2009-06-03,Assembly,"AB 867 NAVA  Assembly Third Reading",71,7,2,0,80
60735,7399,2009-07-15,Senate,"Do pass as amended, and re-refer to the Committee on Appropriations",8,0,1,0,9
60735,7400,2009-08-17,Senate,"Placed on Appropriations Suspense file",13,0,0,0,13
60735,20103,2010-08-12,Senate,"Do pass as amended",11,0,0,0,11
60735,20956,2010-08-24,Senate,"Assembly 3rd Reading AB867 Nava By Ashburn",31,1,0,0,32
60735,21241,2010-08-25,Assembly,"AB 867 NAVA  Concurrence in Senate Amendments",76,0,0,0,76
60736,7401,2009-04-22,Assembly,"Do pass as amended and be re-referred to the Committee on Appropriations",9,0,2,0,11
60736,7402,2009-05-20,Assembly,"Do pass",14,0,2,0,16
60736,7403,2009-05-28,Assembly,"AB 868 PEREZ, V.M.  Assembly Third Reading",75,2,3,0,80
60737,7393,2009-04-15,Assembly,"Do pass as amended",2,2,3,0,7
60737,7394,2009-04-29,Assembly,"Reconsideration granted",7,0,0,0,7
60738,25605,2009-04-14,Assembly,"Do pass and be re-referred to the Committee on Appropriations",7,0,0,0,7
60738,25606,2009-04-29,Assembly,"Do pass, to Consent Calendar",16,0,0,0,16
60738,25607,2009-05-14,Assembly,"AB 870 HUBER  Assembly Third Reading",74,0,0,0,74
60738,25608,2009-06-16,Senate,"Do pass, but re-refer to the Committee on Appropriations",6,0,0,0,6
60738,25609,2009-09-01,Senate,"Assembly 3rd Reading AB870 Huber By Correa",30,4,0,0,34
60738,25610,2009-09-03,Assembly,"AB 870 HUBER  Concurrence in Senate Amendments",77,0,0,0,77
60739,7392,2009-04-22,Assembly,"Do pass as amended and be re-referred to the Committee on Appropriations",6,0,5,0,11
60741,24885,2009-04-20,Assembly,"Do pass and re-refer to Committee on Appropriations with 	recommendation:  To Consent Calendar",14,0,0,0,14
60741,24886,2009-04-29,Assembly,"Do pass as amended, to Consent Calendar",16,0,0,0,16
60741,24887,2009-05-11,Assembly,"AB 873 PRICE  Consent Calendar Second Day  Regular Session",78,0,0,0,78
60741,24888,2009-06-16,Senate,"Do pass as amended, but re-refer to the Committee on Appropriations 	Recommend Consent",11,0,0,0,11
60741,24889,2009-07-16,Senate,"Special Consent #13 AB873 Price",36,0,0,0,36
60741,24890,2009-08-20,Assembly,"AB 873  Concurrence in Senate Amendments By ANDERSON",77,0,0,0,77
60742,7408,2009-04-14,Assembly,"Do pass as amended, to Consent Calendar",10,0,0,0,10
60742,7409,2009-05-04,Assembly,"AB 874 SALDANA  Assembly Third Reading",76,0,4,0,80
60745,7412,2009-04-28,Assembly,"Do pass and be re-referred to the Committee on Appropriations",9,0,2,0,11
60747,7404,2009-04-22,Assembly,"Do pass as amended and be re-referred to the Committee on Appropriations",10,0,0,0,10
60747,7405,2009-05-13,Assembly,"Do pass, to Consent Calendar",16,0,0,0,16
60747,7406,2009-05-21,Assembly,"AB 879 HERNANDEZ  Consent Calendar Second Day  Regular Session",77,0,3,0,80
60748,7407,2009-05-12,Assembly,"Do pass and be re-referred to the Committee on Appropriations",11,0,0,0,11
60749,25997,2009-05-04,Assembly,"Be referred to Committee on Local Government",7,3,0,0,10
60749,25998,2009-05-04,Assembly,"Be referred to Committee on Appropriations",7,3,0,0,10
60749,25999,2009-05-13,Assembly,"Do pass and be re-referred to the Committee on Appropriations",4,2,0,0,6
60749,26000,2009-05-20,Assembly,"Do pass",11,4,0,0,15
60749,26001,2009-05-28,Assembly,"AB 881 HUFFMAN  Assembly Third Reading",50,29,0,0,79
60749,26002,2009-07-07,Senate,"Do pass, but re-refer to the Committee on Appropriations",6,4,0,0,10
60749,26003,2009-08-31,Senate,"Assembly 3rd Reading AB881 Huffman By Wiggins",22,14,0,0,36
60749,26004,2009-09-02,Assembly,"AB 881 HUFFMAN  Concurrence in Senate Amendments",48,27,0,0,75
60750,7419,2009-04-27,Assembly,"Do pass as amended and be re-referred to the Committee on Appropriations",12,0,2,0,14
60750,7420,2009-05-13,Assembly,"Do pass",16,0,0,0,16
60750,7421,2009-05-26,Assembly,"AB 882 FULLER  Assembly Third Reading",78,0,2,0,80
60750,7422,2009-07-07,Senate,"Do pass, but re-refer to the Committee on Appropriations",9,0,2,0,11
60750,7423,2009-09-03,Senate,"Assembly 3rd Reading AB882 Fuller By Benoit",36,0,4,0,40
60750,7424,2009-09-09,Assembly,"AB 882 FULLER  Concurrence in Senate Amendments",78,0,1,0,79
60753,7410,2009-04-21,Assembly,"Do pass and be re-referred to the Committee on Human Services to Consent Calendar",6,0,0,0,6
60753,7411,2009-05-12,Assembly,"Do pass and re-refer to Committee on Appropriations with recommendation:  To Consent Calendar",7,0,0,0,7
60756,7413,2009-04-01,Assembly,"Do pass as amended and be re-referred to the Committee on Appropriations",13,1,5,0,19
60756,7414,2009-04-22,Assembly,"Do pass",11,5,1,0,17
60756,7415,2009-05-21,Assembly,"AB 888 PRICE  Assembly Third Reading",50,25,5,0,80
60756,7416,2009-06-23,Senate,"Do pass, but re-refer to the Committee on Appropriations",11,1,1,0,13
60756,7417,2009-08-27,Senate,"Assembly 3rd Reading AB888 Price",26,10,4,0,40
60756,7418,2009-09-03,Assembly,"AB 888  Concurrence in Senate Amendments By MENDOZA",49,26,4,0,79
60757,24878,2009-04-14,Assembly,"Do pass and re-refer to Committee on Appropriations with 	recommendation:  To Consent Calendar",13,0,0,0,13
60757,24879,2009-04-29,Assembly,"Do pass, to Consent Calendar",16,0,0,0,16
60757,24880,2009-05-11,Assembly,"AB 889 JONES  Consent Calendar Second Day  Regular Session",78,0,0,0,78
60757,24881,2009-06-09,Senate,"Do pass, but re-refer to the Committee on Governmental Organization 	Recommend Consent",10,0,0,0,10
60757,24882,2009-06-23,Senate,"Do pass as amended, but re-refer to the Committee on 	Appropriations Recommend Consent",12,0,0,0,12
60757,24883,2009-08-17,Senate,"Special Consent #14 AB889 Jones",35,0,0,0,35
60757,24884,2009-08-27,Assembly,"AB 889 JONES  Concurrence in Senate Amendments",75,0,0,0,75
60758,24872,2009-04-28,Assembly,"Do pass and be re-referred to the Committee on Appropriations",7,0,0,0,7
60758,24873,2009-05-28,Assembly,"Do pass as amended",12,0,0,0,12
60758,24874,2009-06-02,Assembly,"AB 890 PEREZ, J.  Assembly Third Reading",76,1,0,0,77
60758,24875,2009-07-06,Senate,"Do pass, but re-refer to the Committee on Appropriations",7,0,0,0,7
60758,24876,2009-08-31,Senate,"Assembly 3rd Reading AB890 John A. Perez By Pavley",31,3,0,0,34
60758,24877,2009-09-02,Assembly,"AB 890 PEREZ, J.  Concurrence in Senate Amendments",77,0,0,0,77
60760,26888,2009-04-13,Assembly,"Do pass as amended and be re-referred to the Committee on 	Appropriations",14,0,0,0,14
60760,26889,2009-05-28,Assembly,"Do pass",17,0,0,0,17
60760,26890,2009-06-01,Assembly,"AB 892 FURUTANI  Assembly Third Reading",78,0,0,0,78
60760,26891,2009-07-07,Senate,"Do pass as amended, and re-refer to the Committee on Environmental 	Quality",9,0,0,0,9
60760,26892,2009-07-13,Senate,"Do pass, but re-refer to the Committee on Appropriations Recommend 	Consent",7,0,0,0,7
60760,26893,2009-08-27,Senate,"Special Consent #16 AB892 Furutani",38,0,0,0,38
60760,26894,2009-08-31,Assembly,"AB 892 FURUTANI  Concurrence in Senate Amendments",78,0,0,0,78
60762,26818,2009-04-21,Assembly,"Do pass and re-refer to Committee on Appropriations with 	recommendation:  To Consent Calendar",7,0,0,0,7
60762,26819,2009-05-13,Assembly,"Do pass, to Consent Calendar",16,0,0,0,16
60762,26820,2009-05-21,Assembly,"AB 894 FURUTANI  Consent Calendar Second Day  Regular Session",77,0,0,0,77
60762,26821,2009-07-07,Senate,"Do pass, but re-refer to the Committee on Appropriations Recommend 	Consent",5,0,0,0,5
60762,26822,2009-09-09,Senate,"Assembly 3rd Reading AB894 Furutani By DeSaulnier",35,0,0,0,35
60762,26823,2009-09-10,Assembly,"AB 894 Furutani  Concurrence in Senate Amendments",78,0,0,0,78
60764,26913,2009-04-14,Assembly,"Do pass and be re-referred to the Committee on Appropriations",15,0,0,0,15
60764,26914,2009-05-28,Assembly,"Do pass",17,0,0,0,17
60764,26915,2009-06-01,Assembly,"AB 896 GALGIANI  Assembly Third Reading",78,0,0,0,78
60764,26916,2009-06-17,Senate,"Do pass, but re-refer to the Committee on Appropriations",9,1,0,0,10
60764,26917,2009-06-29,Senate,"Placed on Appropriations Suspense file",13,0,0,0,13
60764,26918,2009-09-12,Senate,"W/O REF. TO FILE AB896 Galgiani By Alquist",29,7,0,0,36
60764,26919,2009-09-12,Assembly,"AB 896 GALGIANI  Concurrence in Senate Amendments",76,0,0,0,76
60766,7425,2009-05-05,Assembly,"Do pass",6,4,1,0,11
60766,7426,2009-05-21,Assembly,"AB 898 LIEU  Assembly Third Reading",49,29,2,0,80
60766,7427,2009-06-23,Senate,"Do pass as amended",4,1,0,0,5
60766,20044,2010-08-11,Senate,"Assembly 3rd Reading AB898 Lieu By DeSaulnier",29,4,0,0,33
60766,20390,2010-08-17,Assembly,"AB 898 LIEU  Concurrence in Senate Amendments",53,24,0,0,77
60767,25093,2009-05-13,Assembly,"Do pass",4,2,0,0,6
60767,25094,2009-05-28,Assembly,"AB 899 TORRES  Assembly Third Reading",78,0,0,0,78
60767,25095,2009-06-23,Senate,"Do pass as amended",11,0,0,0,11
60767,25096,2009-08-24,Senate,"Assembly 3rd Reading AB899 Torres By Lowenthal",39,0,0,0,39
60767,25097,2009-08-27,Assembly,"AB 899 TORRES  Concurrence in Senate Amendments",76,0,0,0,76
60768,7428,2009-04-14,Assembly,"Do pass and be re-referred to the Committee on Appropriations",13,0,0,0,13
60768,7429,2009-05-28,Assembly,"Do pass",17,0,0,0,17
60768,7430,2009-06-02,Assembly,"AB 900 DE LEON  Assembly Third Reading",78,0,2,0,80
60768,7431,2009-07-06,Senate,"Do pass as amended, and re-refer to the Committee on Appropriations",8,1,2,0,11
60768,7432,2009-08-17,Senate,"Placed on Appropriations Suspense file",13,0,0,0,13
60768,21735,2010-08-30,Senate,"That the Assembly amendments be concurred in, but first be 	re-referred to the Committee on Appropriations",4,0,0,0,4
60768,21736,2010-08-30,Senate,"From Committee:  Amendments returned to Senate floor for 	consideration",11,0,0,0,11
60768,21737,2010-08-30,Senate,"W/O REF. TO FILE AB900 De Leon Urgency Clause",37,0,0,0,37
60768,21838,2010-08-31,Assembly,"Senate amendments be concurred in",8,0,0,0,8
60768,21839,2010-08-31,Assembly,"AB 900 DE LEON  Concurrence- Urgency Added",75,0,0,0,75
60771,7438,2009-04-20,Assembly,"Do pass and be re-referred to the Committee on Environmental Safety and Toxic Materials",7,1,1,0,9
60771,7439,2009-04-28,Assembly,"Do pass and be re-referred to the Committee on Appropriations",7,0,0,0,7
60771,7440,2009-05-13,Assembly,"Do pass",15,1,0,0,16
60771,7441,2009-05-28,Assembly,"AB 903 CHESBRO  Assembly Third Reading",77,2,1,0,80
60771,7442,2009-06-22,Senate,"Do pass as amended, and re-refer to the Committee on Appropriations",6,1,0,0,7
60771,7443,2009-08-17,Senate,"Placed on Appropriations Suspense file",13,0,0,0,13
60772,25242,2009-04-29,Assembly,"Do pass as amended and be re-referred to the Committee on 	Appropriations",7,0,0,0,7
60772,25243,2009-05-20,Assembly,"Do pass",15,0,0,0,15
60772,25244,2009-05-28,Assembly,"AB 904 PEREZ, V.M.  Assembly Third Reading",79,0,0,0,79
60772,25245,2009-07-08,Senate,"Do pass as amended, and re-refer to the Committee on 	Appropriations",5,0,0,0,5
60772,25246,2009-08-27,Senate,"Special Consent #16 AB904 V. Manuel Perez",38,0,0,0,38
60772,25247,2009-08-31,Assembly,"AB 904 PEREZ, V.M.  Concurrence in Senate Amendments",78,0,0,0,78
60773,24867,2009-04-15,Assembly,"Do pass and be re-referred to the Committee on Appropriations",8,0,0,0,8
60773,24868,2009-04-29,Assembly,"Do pass, to Consent Calendar",16,0,0,0,16
60773,24869,2009-05-11,Assembly,"AB 905 AGRI.  Consent Calendar Second Day  Regular Session",78,0,0,0,78
60773,24870,2009-07-07,Senate,"Do pass, but re-refer to the Committee on Appropriations Recommend 	Consent",4,0,0,0,4
60773,24871,2009-08-24,Senate,"Special Consent #15 AB905 Committee on AGRI. (Galgiani)",39,0,0,0,39
60774,25806,2009-05-05,Assembly,"Do pass as amended, to Consent Calendar",10,0,0,0,10
60774,25807,2009-05-14,Assembly,"AB 906 HILL  Consent Calendar Second Day  Regular Session",73,0,0,0,73
60774,25808,2009-06-17,Senate,"Do pass as amended",5,0,0,0,5
60774,25809,2009-08-17,Senate,"Special Consent #14 AB906 Hill By Strickland",35,0,0,0,35
60774,25810,2009-08-20,Assembly,"AB 906 HILL  Concurrence in Senate Amendments",77,0,0,0,77
60775,7433,2009-04-27,Assembly,"Do pass as amended and be re-referred to the Committee on Appropriations",6,3,0,0,9
60775,7434,2009-05-20,Assembly,"Do pass",9,4,3,0,16
60775,7435,2009-06-01,Assembly,"AB 907 CHESBRO  Assembly Third Reading",43,31,6,0,80
60775,7436,2009-07-06,Senate,"Do pass as amended, and re-refer to the Committee on Appropriations",5,2,0,0,7
60775,7437,2009-08-17,Senate,"Do pass",8,4,1,0,13
60777,3014,2009-04-30,Assembly,"Do pass and be re-referred to the Committee on Appropriations",7,0,0,0,7
60777,3015,2009-05-13,Assembly,"Do pass",11,5,0,0,16
60777,3016,2009-05-28,Assembly,"AB 909 FEUER  Assembly Third Reading",56,22,2,0,80
60777,3017,2009-07-07,Senate,"Do pass, but re-refer to the Committee on Appropriations",3,1,1,0,5
60777,9158,2010-06-22,Senate,"Do pass as amended",6,1,2,0,9
60777,20038,2010-08-12,Senate,"Assembly 3rd Reading AB909 Hill By Lowenthal",26,8,0,0,34
60777,21204,2010-08-23,Assembly,"Senate amendments be concurred in",10,0,0,0,10
60777,21205,2010-08-25,Assembly,"AB 909 HILL  Concurrence in Senate Amendments",63,11,0,0,74
60779,7444,2009-04-21,Assembly,"Do pass and be re-referred to the Committee on Appropriations",11,3,5,0,19
60779,7445,2009-05-28,Assembly,"Do pass as amended",12,5,0,0,17
60779,7446,2009-06-03,Assembly,"AB 911 LIEU  Assembly Third Reading",45,31,4,0,80
60779,7447,2009-07-15,Senate,"Do pass as amended, and re-refer to the Committee on Appropriations",9,1,1,0,11
60779,7448,2009-08-17,Senate,"Do pass as amended",10,0,3,0,13
60779,7449,2009-09-09,Senate,"Assembly 3rd Reading AB911 Lieu By Strickland",32,3,5,0,40
60779,7450,2009-09-10,Assembly,"AB 911 Lieu  Concurrence in Senate Amendments",79,0,1,0,80
60780,25524,2009-04-20,Assembly,"Do pass as amended and be re-referred to the Committee on Revenue 	and Taxation",10,4,0,0,14
60780,25525,2009-05-28,Assembly,"Do pass as amended",12,5,0,0,17
60780,25526,2009-06-03,Assembly,"AB 912 TORRES  Assembly Third Reading",49,28,0,0,77
60780,25527,2009-07-07,Senate,"Do pass, but re-refer to the Committee on Revenue and Taxation",9,2,0,0,11
60780,25528,2009-08-17,Senate,"Do pass",8,4,0,0,12
60780,25529,2009-08-31,Senate,"Assembly 3rd Reading AB912 Torres By Wolk",22,10,0,0,32
60780,25530,2009-09-03,Assembly,"AB 912 TORRES  Concurrence in Senate Amendments",48,25,0,0,73
60782,7452,2009-04-21,Assembly,"Do pass as amended and be re-referred to the Committee on Judiciary",7,0,0,0,7
60782,7453,2009-04-27,Assembly,"Do pass and re-refer to Committee on Appropriations with recommendation:  To Consent Calendar",10,0,0,0,10
60782,7454,2009-05-13,Assembly,"Do pass, to Consent Calendar",16,0,0,0,16
60782,7455,2009-05-21,Assembly,"AB 914 LOGUE  Consent Calendar Second Day  Regular Session",77,0,3,0,80
60782,7456,2009-07-06,Senate,"Do pass as amended, and re-refer to the Committee on Appropriations",7,0,0,0,7
60782,7457,2009-09-04,Senate,"Special Consent #19 AB914 Logue By Aanestad",40,0,0,0,40
60782,7458,2009-09-09,Assembly,"AB 914 LOGUE  Concurrence in Senate Amendments",78,0,1,0,79
60783,7451,2009-04-13,Assembly,"Do pass and be re-referred to the Committee on Natural Resources",4,9,2,0,15
60786,7469,2009-04-14,Assembly,"Do pass as amended",10,0,0,0,10
60786,7470,2009-04-30,Assembly,"AB 918 ADAMS  Assembly Third Reading",75,0,5,0,80
60786,8765,2010-06-16,Senate,"Do pass as amended",4,0,1,0,5
60786,9608,2010-06-28,Senate,"Assembly 3rd Reading AB918 Adams By Price",32,2,5,0,39
60786,10090,2010-07-01,Assembly,"AB 918 ADAMS  Concurrence in Senate Amendments",76,0,3,0,79
60787,917,2009-04-20,Assembly,"Do pass and be re-referred to the Committee on Appropriations.",11,0,0,0,11
60787,918,2009-05-28,Assembly,"Do pass as amended.",17,0,0,0,17
60787,919,2009-06-02,Assembly,"AB 919 NAVA  Assembly Third Reading",75,1,4,0,80
60787,8926,2010-06-16,Senate,"Do pass as amended, and re-refer to the Committee on Judiciary",4,3,4,0,11
60788,24961,2009-04-20,Assembly,"Do pass and be re-referred to the Committee on Natural Resources",11,3,0,0,14
60788,24962,2009-04-27,Assembly,"Do pass and be re-referred to the Committee on Appropriations",6,3,0,0,9
60788,24963,2009-05-28,Assembly,"Do pass",12,5,0,0,17
60788,24964,2009-06-01,Assembly,"AB 920 HUFFMAN  Assembly Third Reading",51,26,0,0,77
60788,24965,2009-07-07,Senate,"Do pass, but re-refer to the Committee on Appropriations",6,4,0,0,10
60788,24966,2009-08-17,Senate,"Placed on Appropriations Suspense file",13,0,0,0,13
60788,24967,2009-08-27,Senate,"Do pass",8,5,0,0,13
60788,24968,2009-09-11,Senate,"Assembly 3rd Reading AB920 Huffman By Hancock",21,18,0,0,39
60788,24969,2009-09-12,Assembly,"AB 920 HUFFMAN  Concurrence in Senate Amendments",54,23,0,0,77
60789,7459,2009-04-28,Assembly,"Do pass and be re-referred to the Committee on Appropriations",5,0,2,0,7
60789,7460,2009-05-20,Assembly,"Do pass as amended",15,0,1,0,16
60789,7461,2009-05-28,Assembly,"AB 921 JONES  Assembly Third Reading",78,0,2,0,80
60789,7462,2009-06-23,Senate,"Do pass, but re-refer to the Committee on Appropriations",5,0,0,0,5
60789,7463,2009-08-17,Senate,"Do pass",12,0,1,0,13
60789,7464,2009-08-31,Senate,"Assembly 3rd Reading AB921 Jones By Runner",35,0,5,0,40
60789,7465,2009-09-02,Assembly,"AB 921 JONES  Concurrence in Senate Amendments",76,0,3,0,79
60791,7471,2009-04-20,Assembly,"Do pass and be re-referred to the Committee on Appropriations",12,0,2,0,14
60793,7466,2009-04-20,Assembly,"Do pass",6,3,0,0,9
60793,7467,2009-05-04,Assembly,"AB 925 SALDANA  Assembly Third Reading",42,34,4,0,80
60793,7468,2009-07-06,Senate,"Do pass",4,2,1,0,7
60794,26358,2009-04-21,Assembly,"Do pass and be re-referred to the Committee on Business and 	Professions",7,0,0,0,7
60794,26359,2009-04-28,Assembly,"Do pass and be re-referred to the Committee on Appropriations",11,0,0,0,11
60794,26360,2009-05-13,Assembly,"Do pass",16,0,0,0,16
60794,26361,2009-05-26,Assembly,"AB 926 RUSKIN  Assembly Third Reading",80,0,0,0,80
60794,26362,2009-06-23,Senate,"Do pass, but re-refer to the Committee on Appropriations Recommend 	Consent",12,0,0,0,12
60794,26363,2009-07-13,Senate,"Do pass",12,0,0,0,12
60794,26364,2009-09-10,Senate,"Special Consent #21 AB926 Ruskin By Price",40,0,0,0,40
60794,26365,2009-09-11,Assembly,"AB 926 Ruskin  Concurrence in Senate Amendments",79,0,0,0,79
60795,24957,2009-04-14,Assembly,"Do pass as amended, to Consent Calendar",10,0,0,0,10
60795,24958,2009-05-04,Assembly,"AB 927 CALDERON  Consent Calendar Second Day",79,0,0,0,79
60795,24959,2009-06-09,Senate,"Do pass and be placed on the Consent Calendar",5,0,0,0,5
60795,24960,2009-06-15,Senate,"Consent Calendar 2nd AB927 Charles Calderon",36,0,0,0,36
60796,7478,2010-01-04,Assembly,"Be referred to Committee on Governmental Organization",10,0,1,0,11
60797,7479,2009-04-13,Assembly,"Do pass and be re-referred to the Committee on Agriculture",9,0,0,0,9
60797,7480,2009-04-29,Assembly,"Do pass and re-refer to Committee on Appropriations with recommendation:  To Consent Calendar",8,0,0,0,8
60797,7481,2009-05-28,Assembly,"Do pass",17,0,0,0,17
60797,7482,2009-06-02,Assembly,"AB 929 BLAKESLEE  Assembly Third Reading",78,0,2,0,80
60797,7483,2009-07-08,Senate,"Do pass, but re-refer to the Committee on Appropriations",4,1,0,0,5
60797,7484,2009-08-17,Senate,"Placed on Appropriations Suspense file",13,0,0,0,13
60798,25970,2009-05-05,Assembly,"Do pass",10,0,0,0,10
60798,25971,2009-05-26,Assembly,"AB 930 SALDANA  Assembly Third Reading",78,0,0,0,78
60798,25972,2009-07-08,Senate,"Do pass and be placed on the Consent Calendar",11,0,0,0,11
60798,25973,2009-07-16,Senate,"Consent Calendar 2nd AB930 Saldana",36,0,0,0,36
60799,26925,2009-05-05,Assembly,"Do pass",19,0,0,0,19
60799,26926,2009-05-14,Assembly,"AB 931 FLETCHER  Assembly Third Reading",74,0,0,0,74
60799,26927,2009-07-08,Senate,"Do pass and be placed on the Consent Calendar",11,0,0,0,11
60799,26928,2009-07-16,Senate,"Consent Calendar 2nd AB931 Fletcher",36,0,0,0,36
60799,26929,2009-08-20,Assembly,"AB 931 FLETCHER  Concurrence in Senate Amendments",77,0,0,0,77
60800,7474,2009-04-15,Assembly,"Do pass as amended and be re-referred to the Committee on Appropriations",10,0,1,0,11
60801,7472,2009-05-06,Assembly,"Do pass",7,3,0,0,10
60801,7473,2009-05-21,Assembly,"AB 933 FONG  Assembly Third Reading",49,30,1,0,80
60801,9251,2010-06-23,Senate,"Do pass, but re-refer to the Committee on Appropriations",4,1,1,0,6
60801,19390,2010-08-02,Senate,"Placed on Appropriations Suspense file",10,0,0,0,10
60801,20017,2010-08-12,Senate,"Do pass as amended",7,4,0,0,11
60801,20788,2010-08-23,Senate,"Assembly 3rd Reading AB933 Fong By Yee",22,12,0,0,34
60801,21004,2010-08-24,Assembly,"AB 933 FONG  Concurrence in Senate Amendments",51,27,0,0,78
60802,7502,2009-04-14,Assembly,"Do pass and be re-referred to the Committee on Appropriations",12,1,0,0,13
60803,7475,2009-04-23,Assembly,"Be referred to Committee on Health",8,0,3,0,11
60803,7476,2009-04-28,Assembly,"Do pass and be re-referred to the Committee on Appropriations",14,1,4,0,19
60805,7477,2009-04-14,Assembly,"Do pass and be re-referred to the Committee on Appropriations",6,0,1,0,7
60806,24943,2009-04-14,Assembly,"Do pass as amended and be re-referred to the Committee on Human 	Services",9,0,0,0,9
60806,24944,2009-04-28,Assembly,"Do pass and be re-referred to the Committee on Appropriations",7,0,0,0,7
60806,24945,2009-05-28,Assembly,"Do pass as amended",13,0,0,0,13
60806,24946,2009-06-02,Assembly,"AB 938 JUD.  Assembly Third Reading  By FEUER",77,0,0,0,77
60806,24947,2009-06-23,Senate,"Do pass, but re-refer to the Committee on Appropriations",5,0,0,0,5
60806,24948,2009-07-13,Senate,"Placed on Appropriations Suspense file",12,0,0,0,12
60806,24949,2009-09-10,Senate,"Assembly 3rd Reading AB938 Committee on JUD. (Feuer) By Liu",36,0,0,0,36
60806,24950,2009-09-11,Assembly,"AB 938 JUD.  Concurrence in Senate Amendments By FEUER",78,0,0,0,78
60807,7485,2010-01-12,Assembly,"Do pass, to Consent Calendar",9,0,0,0,9
60807,7486,2010-01-19,Assembly,"AB 939 JUD.  Consent Calendar Second Day  Regular Session",71,0,7,0,78
60807,10321,2010-06-29,Senate,"Do pass as amended, and re-refer to the Committee on Appropriations",4,0,1,0,5
60807,19901,2010-08-09,Senate,"Do pass",8,0,0,0,8
60807,20657,2010-08-20,Senate,"Assembly 3rd Reading AB939 Committee on JUD. (Feuer)",32,0,0,0,32
60807,20906,2010-08-23,Assembly,"AB 939 JUD.  Concurrence in Senate Amendments By FEUER",75,0,0,0,75
60808,24939,2009-05-05,Assembly,"Do pass",10,0,0,0,10
60808,24940,2009-05-14,Assembly,"AB 940 JUD.  Assembly Third Reading  By FEUER",73,0,0,0,73
60808,24941,2009-06-09,Senate,"Do pass",5,0,0,0,5
60808,24942,2009-06-22,Senate,"Special Consent #9 AB940 Committee on JUD. (Feuer)",40,0,0,0,40
60809,26985,2009-04-14,Assembly,"Do pass as amended, to Consent Calendar",10,0,0,0,10
60809,26986,2009-04-23,Assembly,"AB 941 JUD.  Consent Calendar Second Day  Regular Session",71,0,0,0,71
60809,26987,2009-06-16,Senate,"Do pass, but re-refer to the Committee on Appropriations Recommend 	Consent",5,0,0,0,5
60809,26988,2009-09-09,Senate,"Special Consent #20 AB941 Committee on JUD. (Feuer) By Corbett",40,0,0,0,40
60809,26989,2009-09-11,Assembly,"AB 941 JUD.  Concurrence in Senate Amendments By FEUER",79,0,0,0,79
60810,7487,2009-04-21,Assembly,"Do pass and re-refer to Committee on Appropriations with recommendation:  To Consent Calendar",10,0,0,0,10
60810,7488,2009-05-28,Assembly,"Do pass",17,0,0,0,17
60810,7489,2009-06-01,Assembly,"AB 942 JUD.  Assembly Third Reading  By FEUER",77,2,1,0,80
60810,7490,2009-07-07,Senate,"Do pass as amended, and re-refer to the Committee on Appropriations",5,0,0,0,5
60810,7491,2009-08-17,Senate,"Placed on Appropriations Suspense file",13,0,0,0,13
60811,7492,2009-04-22,Assembly,"Do pass and be re-referred to the Committee on Judiciary",5,2,0,0,7
60811,7493,2009-04-27,Assembly,"Do pass and be re-referred to the Committee on Appropriations",7,3,0,0,10
60811,7494,2009-05-13,Assembly,"Do pass",11,5,0,0,16
60811,7495,2009-05-28,Assembly,"AB 943 MENDOZA  Assembly Third Reading",49,30,1,0,80
60811,7496,2009-06-25,Senate,"Do pass, but re-refer to the Committee on Judiciary",4,2,0,0,6
60811,7497,2009-07-07,Senate,"Do pass as amended, and re-refer to the Committee on Appropriations",3,2,0,0,5
60811,7498,2009-08-24,Senate,"Do pass",8,5,0,0,13
60811,7499,2009-09-03,Senate,"Assembly 3rd Reading AB943 Mendoza By Oropeza",24,14,2,0,40
60811,7500,2009-09-09,Assembly,"AB 943 MENDOZA  Concurrence in Senate Amendments",49,29,1,0,79
60812,7501,2009-04-22,Assembly,"Do pass and re-refer to Committee on Appropriations with recommendation:  To Consent Calendar",6,0,0,0,6
60813,25450,2009-04-15,Assembly,"Do pass and re-refer to Committee on Appropriations with 	recommendation:  To Consent Calendar",8,0,0,0,8
60813,25451,2009-04-29,Assembly,"Do pass",16,0,0,0,16
60813,25452,2009-05-14,Assembly,"AB 945 AGRI.  Assembly Third Reading  By GALGIANI",73,0,0,0,73
60813,25453,2009-07-07,Senate,"Do pass, but re-refer to the Committee on Appropriations",4,0,0,0,4
60813,25454,2009-08-17,Senate,"Do pass",9,0,0,0,9
60813,25455,2009-09-09,Senate,"Assembly 3rd Reading AB945 Committee on AGRI. (Galgiani) By 	Maldonado",38,0,0,0,38
60815,26930,2009-04-21,Assembly,"Do pass and be re-referred to the Committee on Appropriations",7,2,0,0,9
60815,26931,2009-04-29,Assembly,"Do pass",11,5,0,0,16
60815,26932,2009-05-14,Assembly,"AB 947 BROWNLEY  Assembly Third Reading",52,21,0,0,73
60815,26933,2009-06-17,Senate,"Do pass, but re-refer to the Committee on Appropriations",6,2,0,0,8
60815,26934,2009-08-27,Senate,"Assembly 3rd Reading AB947 Brownley By Pavley",26,10,0,0,36
60816,7511,2009-05-06,Assembly,"Do pass",3,5,2,0,10
60816,7512,2009-05-06,Assembly,"Set first hearing.  Failed passage.  Reconsideration granted",10,0,0,0,10
60816,7513,2010-01-06,Assembly,"Do pass",4,7,1,0,12
60817,7503,2009-04-27,Assembly,"Do pass as amended and be re-referred to the Committee on Appropriations",6,5,3,0,14
60817,7504,2009-04-27,Assembly,"Set second hearing.  Failed passage.  Reconsideration granted",14,0,0,0,14
60818,637,2009-04-28,Assembly,"Do pass and be re-referred to the Committee on Appropriations.",17,0,2,0,19
60818,638,2009-05-28,Assembly,"Do pass as amended.",17,0,0,0,17
60818,639,2009-06-02,Assembly,"AB 950 HERNANDEZ  Assembly Third Reading",70,4,6,0,80
60818,10360,2010-06-30,Senate,"Do pass as amended, and re-refer to the Committee on Appropriations",7,1,1,0,9
60818,19431,2010-08-02,Senate,"Placed on Appropriations Suspense file",10,0,0,0,10
60819,26957,2009-04-27,Assembly,"Do pass and be re-referred to the Committee on Appropriations",13,1,0,0,14
60819,26958,2009-05-06,Assembly,"Do pass",16,0,0,0,16
60819,26959,2009-05-14,Assembly,"AB 951 LIEU  Assembly Third Reading",75,0,0,0,75
60819,26960,2009-06-16,Senate,"Do pass, but re-refer to the Committee on Public Safety",11,0,0,0,11
60819,26961,2009-07-07,Senate,"Do pass, but re-refer to the Committee on Appropriations",7,0,0,0,7
60819,26962,2009-09-02,Senate,"Assembly 3rd Reading AB951 Lieu By Liu",36,2,0,0,38
60819,26963,2009-09-08,Assembly,"AB 951 LIEU  Concurrence in Senate Amendments",78,0,0,0,78
60820,24931,2009-05-05,Assembly,"Do pass and be re-referred to the Committee on Judiciary",19,0,0,0,19
60820,24932,2009-05-12,Assembly,"Do pass as amended, to Consent Calendar",10,0,0,0,10
60820,24933,2009-05-28,Assembly,"Do pass, to Consent Calendar",17,0,0,0,17
60820,24934,2009-06-02,Assembly,"AB 952 KREKORIAN  Consent Calendar Second Day  Regular Session",76,0,0,0,76
60820,24935,2009-07-08,Senate,"Do pass, but re-refer to the Committee on Judiciary Recommend 	Consent",11,0,0,0,11
60820,24936,2009-07-14,Senate,"Do pass as amended, but re-refer to the Committee on 	Appropriations Recommend Consent",5,0,0,0,5
60820,24937,2009-08-27,Senate,"Special Consent #16 AB952 Krekorian",38,0,0,0,38
60820,24938,2009-08-31,Assembly,"AB 952 KREKORIAN  Concurrence in Senate Amendments",78,0,0,0,78
60821,7515,2010-01-11,Assembly,"Do pass and be re-referred to the Committee on Appropriations",14,0,0,0,14
60821,7516,2010-01-21,Assembly,"Do pass as amended",17,0,0,0,17
60821,7517,2010-01-27,Assembly,"AB 953 ENG  Assembly Third Reading",73,0,5,0,78
60821,8822,2010-06-15,Senate,"Do pass as amended, and re-refer to the Committee on Appropriations",5,0,0,0,5
60821,19713,2010-08-09,Senate,"Special Consent #30 AB953 Eng By Harman",34,0,0,0,34
60821,20479,2010-08-16,Assembly,"AB 953 ENG  Concurrence in Senate Amendments",74,0,0,0,74
60822,7514,2009-04-22,Assembly,"Do pass as amended and be re-referred to the Committee on Appropriations",7,0,3,0,10
60823,26274,2009-04-21,Assembly,"Do pass as amended and re-refer to Committee on Appropriations 	with recommendation:  To Consent Calendar",7,0,0,0,7
60823,26275,2009-05-13,Assembly,"Do pass, to Consent Calendar",16,0,0,0,16
60823,26276,2009-05-21,Assembly,"AB 955 DE LEON  Consent Calendar Second Day  Regular Session",77,0,0,0,77
60823,26277,2009-07-14,Senate,"Do pass, but re-refer to the Committee on Appropriations",6,0,0,0,6
60823,26278,2009-08-27,Senate,"Special Consent #16 AB955 De Leon",38,0,0,0,38
60823,26279,2009-08-31,Assembly,"AB 955 DE LEON  Concurrence in Senate Amendments",78,0,0,0,78
60825,26945,2009-04-20,Assembly,"Do pass as amended and be re-referred to the Committee on Judiciary",10,1,0,0,11
60825,26946,2009-05-05,Assembly,"Do pass as amended",10,0,0,0,10
60825,26947,2009-05-26,Assembly,"AB 957 GALGIANI  Assembly Third Reading",77,0,0,0,77
60825,26948,2009-06-23,Senate,"Do pass as amended, and re-refer to the Committee on Rules",4,0,0,0,4
60825,26949,2009-09-01,Senate,"Assembly 3rd Reading AB957 Galgiani Urgency Clause",30,4,0,0,34
60825,26950,2009-09-03,Assembly,"AB 957 GALGIANI  Concurrence in Senate Amendments",74,1,0,0,75
60826,7505,2009-04-15,Assembly,"Do pass and be re-referred to the Committee on Water, Parks and Wildlife",5,1,1,0,7
60826,7506,2009-05-13,Assembly,"Do pass",11,3,2,0,16
60826,7507,2009-05-28,Assembly,"AB 958 ENG  Assembly Third Reading",51,28,1,0,80
60826,7508,2009-07-01,Senate,"Do pass as amended, and re-refer to the Committee on Appropriations",3,2,0,0,5
60826,7509,2009-08-31,Senate,"Assembly 3rd Reading AB958 Eng By Kehoe",23,12,5,0,40
60826,7510,2009-09-02,Assembly,"AB 958 ENG  Concurrence in Senate Amendments",49,26,4,0,79
60828,1482,2009-04-14,Assembly,"Do pass and re-refer to Committee on Appropriations with recommendation:  To Consent Calendar",7,0,0,0,7
60828,1483,2009-04-29,Assembly,"Do pass, to Consent Calendar",16,0,0,0,16
60828,1484,2009-05-11,Assembly,"AB 960 PEREZ, V.M.  Consent Calendar Second Day  Regular Session",78,0,2,0,80
60828,1485,2010-04-20,Senate,"Do pass, but re-refer to the Committee on Appropriations",7,0,0,0,7
60828,9234,2010-06-22,Senate,"Do pass, but re-refer to the Committee on Energy, Utilities and Communications",8,0,1,0,9
60829,7521,2009-04-21,Assembly,"Do pass and be re-referred to the Committee on Judiciary",8,0,3,0,11
60829,7522,2009-04-27,Assembly,"Do pass and be re-referred to the Committee on Appropriations",6,2,2,0,10
60830,25081,2009-04-21,Assembly,"Do pass and be re-referred to the Committee on Appropriations",5,2,0,0,7
60830,25082,2009-05-28,Assembly,"Do pass as amended",12,5,0,0,17
60830,25083,2009-06-03,Assembly,"AB 962 DE LEON  Assembly Third Reading",42,31,0,0,73
60830,25084,2009-07-07,Senate,"Do pass, but re-refer to the Committee on Appropriations",4,3,0,0,7
60830,25085,2009-07-23,Senate,"Placed on Appropriations Suspense file",13,0,0,0,13
60830,25086,2009-08-27,Senate,"Do pass",7,5,0,0,12
60830,25087,2009-09-10,Senate,"Assembly 3rd Reading AB962 De Leon By Cedillo",21,18,0,0,39
60830,25088,2009-09-11,Assembly,"AB 962 De Leon  Concurrence in Senate Amendments",43,33,0,0,76
60831,512,2009-04-21,Assembly,"Do pass as amended and be re-referred to the Committee on Appropriations.",18,0,1,0,19
60831,513,2010-01-21,Assembly,"Do pass as amended.",12,5,0,0,17
60831,514,2010-01-27,Assembly,"AB 963 AMMIANO  Assembly Third Reading",45,26,7,0,78
60831,5673,2010-06-09,Senate,"Do pass, but re-refer to the Committee on Human Services",5,0,4,0,9
60831,9515,2010-06-22,Senate,"Do pass as amended, and re-refer to the Committee on Appropriations",3,2,0,0,5
60831,19129,2010-08-02,Senate,"Placed on Appropriations Suspense file",10,0,0,0,10
60832,7518,2009-04-01,Assembly,"Do pass and be re-referred to the Committee on Appropriations",4,2,0,0,6
60832,7519,2009-04-22,Assembly,"Do pass",11,0,6,0,17
60832,7520,2009-05-04,Assembly,"AB 964 P.E., R.& S.S.  Third Reading Urgency  By HERNANDEZ",51,16,13,0,80
60833,7523,2009-04-22,Assembly,"Do pass and be re-referred to the Committee on Appropriations",4,2,0,0,6
60833,7524,2009-05-28,Assembly,"Do pass as amended",12,0,5,0,17
60833,7525,2009-06-03,Assembly,"AB 965 P.E., R.& S.S.  Assembly Third Reading  By HERNANDEZ",49,29,2,0,80
60834,26951,2009-04-22,Assembly,"Do pass and re-refer to Committee on Appropriations with 	recommendation:  To Consent Calendar",6,0,0,0,6
60834,26952,2009-05-06,Assembly,"Do pass, to Consent Calendar",16,0,0,0,16
60834,26953,2009-05-14,Assembly,"AB 966 P.E., R.& S.S.  Consent Calendar Second Day  Regular Session",73,0,0,0,73
60834,26954,2009-06-08,Senate,"Do pass, but re-refer to the Committee on Appropriations Recommend 	Consent",7,0,0,0,7
60834,26955,2009-07-09,Senate,"Special Consent #12 AB966 Committee on P.E.,R.& S.S.(Hernan",34,0,0,0,34
60834,26956,2009-07-13,Assembly,"AB 966 P.E., R.& S.S.  Concurrence in Senate Amendments By HERNANDEZ",76,0,0,0,76
60835,7526,2010-01-07,Assembly,"Be referred to Committee on Judiciary",10,0,1,0,11
60835,7527,2010-01-12,Assembly,"Do pass, to Consent Calendar",9,0,0,0,9
60835,7528,2010-01-19,Assembly,"AB 967 MA  Consent Calendar Second Day  Regular Session",71,0,7,0,78
60835,7529,2010-06-10,Senate,"Do pass as amended",5,0,0,0,5
60835,9628,2010-06-28,Senate,"Special Consent #28 AB967 Ma",32,0,7,0,39
60835,10119,2010-07-01,Assembly,"AB 967 MA  Concurrence in Senate Amendments",76,0,3,0,79
60838,5116,2009-04-22,Assembly,"Do pass as amended and be re-referred to the Committee on Appropriations",9,0,2,0,11
60838,5117,2009-05-28,Assembly,"Do pass as amended",14,3,0,0,17
60838,5118,2009-06-03,Assembly,"AB 970 BLOCK  Assembly Third Reading",75,0,5,0,80
60841,700,2010-01-12,Assembly,"Do pass and be re-referred to the Committee on Appropriations.",9,0,0,0,9
60841,701,2010-01-21,Assembly,"Do pass as amended.",17,0,0,0,17
60841,702,2010-01-27,Assembly,"AB 973 STRICKLAND  Assembly Third Reading",68,0,10,0,78
60841,8738,2010-06-15,Senate,"Do pass",5,0,0,0,5
60841,20554,2010-08-18,Senate,"Assembly 3rd Reading AB973 Audra Strickland By Liu",34,0,0,0,34
60841,20555,2010-08-19,Assembly,"AB 973 STRICKLAND  Concurrence in Senate Amendments",78,0,0,0,78
60842,7540,2009-04-14,Assembly,"Do pass and be re-referred to the Committee on Education",3,7,0,0,10
60843,25800,2009-04-28,Assembly,"Do pass and be re-referred to the Committee on Appropriations",10,2,0,0,12
60843,25801,2009-05-13,Assembly,"Do pass",12,4,0,0,16
60843,25802,2009-05-28,Assembly,"AB 975 FONG  Assembly Third Reading",54,24,0,0,78
60843,25803,2009-07-07,Senate,"Do pass as amended, and re-refer to the Committee on Appropriations",8,3,0,0,11
60843,25804,2009-09-01,Senate,"Assembly 3rd Reading AB975 Fong By Simitian",23,15,0,0,38
60843,25805,2009-09-08,Assembly,"AB 975 FONG  Concurrence in Senate Amendments",57,17,0,0,74
60844,7530,2010-01-13,Assembly,"Do pass as amended and be re-referred to the Committee on Appropriations",6,0,5,0,11
60845,814,2009-04-14,Assembly,"Do pass and be re-referred to the Committee on Health.",4,3,4,0,11
60845,815,2009-04-14,Assembly,"Set first hearing.  Failed passage.  Reconsideration granted.",10,0,1,0,11
60845,816,2009-05-05,Assembly,"Do pass and be re-referred to the Committee on Health.",10,0,1,0,11
60845,817,2010-01-05,Assembly,"Do pass and be re-referred to the Committee on Business and Professions.",17,0,2,0,19
60845,818,2010-01-12,Assembly,"Do pass as amended and be re-referred to the Committee on Appropriations.",11,0,0,0,11
60845,819,2010-01-21,Assembly,"Do pass as amended.",15,0,2,0,17
60845,820,2010-01-27,Assembly,"AB 977 SKINNER  Assembly Third Reading",47,14,17,0,78
60846,821,2010-01-04,Assembly,"Be referred to Committee on Jobs, Economic Development and The Economy.",10,0,1,0,11
60846,822,2010-01-05,Assembly,"Do pass and be re-referred to the Committee on Appropriations to Consent Calendar.",6,0,1,0,7
60846,823,2010-01-21,Assembly,"Do pass as amended.",12,0,5,0,17
60846,824,2010-01-27,Assembly,"AB 978 PEREZ, V.M.  Assembly Third Reading  FORMERLY FILE ITEM3",66,0,12,0,78
60846,9408,2010-06-22,Senate,"Do pass, but re-refer to the Committee on Rules",7,0,4,0,11
60846,10632,2010-07-15,Senate,"Placed on Appropriations Suspense file",8,0,2,0,10
60847,116,2009-04-14,Assembly,"Do pass as amended and be re-referred to the Committee on Appropriations.",7,4,2,0,13
60847,117,2009-05-20,Assembly,"Do pass.",12,0,4,0,16
60847,118,2009-06-02,Assembly,"AB 979 BERRYHILL, T.  Assembly Third Reading",56,12,12,0,80
60847,119,2009-07-06,Senate,"Do pass as amended, and re-refer to the Committee on Appropriations.",8,0,3,0,11
60847,20977,2010-08-23,Senate,"Assembly 3rd Reading AB979 Tom Berryhill By Dutton",29,5,0,0,34
60847,20978,2010-08-24,Assembly,"AB 979 BERRYHILL, T.  Concurrence in Senate Amendments",64,4,0,0,68
60848,7531,2009-04-15,Assembly,"Do pass as amended and be re-referred to the Committee on Appropriations",6,2,3,0,11
60848,7532,2009-04-29,Assembly,"Do pass",10,5,1,0,16
60848,7533,2009-05-21,Assembly,"AB 980 SWANSON  Assembly Third Reading",48,31,1,0,80
60848,7534,2009-07-15,Senate,"Do pass, but re-refer to the Committee on Appropriations",3,1,5,0,9
60848,7535,2009-07-15,Senate,"Set, second hearing.  Failed passage in Committee. Reconsideration granted",8,0,1,0,9
60850,7536,2009-04-22,Assembly,"Do pass as amended and be re-referred to the Committee on Judiciary",10,0,0,0,10
60850,7537,2009-04-27,Assembly,"Do pass as amended and re-refer to Committee on Appropriations with recommendation:  To Consent Calendar",10,0,0,0,10
60850,7538,2009-05-20,Assembly,"Do pass, to Consent Calendar",15,0,1,0,16
60850,7539,2009-05-28,Assembly,"AB 982 TRAN  Consent Calendar Second Day  Regular Session",76,0,4,0,80
60851,537,2009-04-15,Assembly,"Do pass and be re-referred to the Committee on Appropriations.",8,2,1,0,11
60851,538,2009-05-28,Assembly,"Do pass.",12,5,0,0,17
60851,539,2009-06-02,Assembly,"AB 983 SKINNER  Assembly Third Reading",52,26,2,0,80
60851,540,2009-07-15,Senate,"Do pass, but re-refer to the Committee on Appropriations.",6,2,1,0,9
60851,541,2009-08-17,Senate,"Placed on Appropriations Suspense file.",13,0,0,0,13
60852,7549,2010-01-07,Assembly,"Be referred to Committee on Public Safety",10,0,1,0,11
60852,7550,2010-01-12,Assembly,"Do pass as amended and be re-referred to the Committee on Appropriations",5,2,0,0,7
60852,7551,2010-01-21,Assembly,"Do pass",16,0,1,0,17
60852,7552,2010-01-27,Assembly,"AB 984 NAVA  Assembly Third Reading",64,4,10,0,78
60852,10338,2010-06-29,Senate,"Do pass, but re-refer to the Committee on Appropriations",2,5,0,0,7
60853,7541,2009-04-21,Assembly,"Do pass",10,0,0,0,10
60853,7542,2009-05-14,Assembly,"AB 985 DE LA TORRE  Assembly Third Reading",71,0,9,0,80
60853,7543,2009-06-16,Senate,"Do pass, but re-refer to the Committee on Banking, Finance and Insurance",5,0,0,0,5
60853,7544,2009-07-13,Senate,"Placed on Appropriations Suspense file",12,0,1,0,13
60853,7545,2009-08-27,Senate,"Do pass as amended",12,1,0,0,13
60853,7546,2009-09-09,Senate,"Assembly 3rd Reading AB985 De La Torre By Yee",23,2,15,0,40
60853,7547,2009-09-11,Senate,"Assembly 3rd Reading AB985 De La Torre By Yee",24,8,8,0,40
60853,7548,2009-09-12,Assembly,"AB 985  Concurrence in Senate Amendments",50,27,2,0,79
60855,3678,2010-01-07,Assembly,"Be referred to Committee on Local Government",10,0,1,0,11
60855,3679,2010-01-13,Assembly,"Do pass",4,1,2,0,7
60855,3680,2010-01-27,Assembly,"AB 987 MA  Assembly Third Reading",43,29,6,0,78
60855,8759,2010-06-16,Senate,"Do pass",3,1,1,0,5
60855,20816,2010-08-23,Senate,"Assembly 3rd Reading AB987 Ma By Price",21,14,0,0,35
60855,21071,2010-08-25,Assembly,"AB 987 MA  Concurrence in Senate Amendments",51,27,0,0,78
60856,7557,2009-04-28,Assembly,"Do pass and be re-referred to the Committee on Appropriations",6,1,0,0,7
60856,7558,2009-05-13,Assembly,"Do pass as amended",11,5,0,0,16
60856,7559,2009-05-26,Assembly,"AB 988 BROWNLEY  Assembly Third Reading",66,10,4,0,80
60856,7560,2009-07-14,Senate,"Do pass, but re-refer to the Committee on Appropriations",7,0,0,0,7
60856,7561,2009-09-02,Senate,"Assembly 3rd Reading AB988 Brownley By Leno",31,4,5,0,40
60858,7553,2009-04-22,Assembly,"Do pass as amended and be re-referred to the Committee on Appropriations",5,2,0,0,7
60859,26935,2009-05-04,Assembly,"Do pass, to Consent Calendar",9,0,0,0,9
60859,26936,2009-05-11,Assembly,"AB 991 SILVA  Consent Calendar Second Day  Regular Session",78,0,0,0,78
60859,26937,2009-06-17,Senate,"Do pass and be placed on the Consent Calendar",11,0,0,0,11
60859,26938,2009-06-24,Senate,"Consent Calendar 2nd AB991 Silva",40,0,0,0,40
60860,26939,2009-04-28,Assembly,"Do pass and be re-referred to the Committee on Appropriations",9,0,0,0,9
60860,26940,2009-05-13,Assembly,"Do pass",16,0,0,0,16
60860,26941,2009-05-26,Assembly,"AB 992 LIEU  Assembly Third Reading",66,10,0,0,76
60860,26942,2009-06-23,Senate,"Do pass as amended, and re-refer to the Committee on 	Appropriations",4,1,0,0,5
60860,26943,2009-08-27,Senate,"Assembly 3rd Reading AB992 Lieu By Pavley",33,4,0,0,37
60860,26944,2009-08-31,Assembly,"AB 992 LIEU  Concurrence in Senate Amendments",64,6,0,0,70
60863,27018,2009-04-21,Assembly,"Do pass as amended and be re-referred to the Committee on 	Appropriations",18,0,0,0,18
60863,27019,2009-05-20,Assembly,"Do pass",14,0,0,0,14
60863,27020,2009-05-28,Assembly,"AB 995 BLOCK  Assembly Third Reading",78,0,0,0,78
60863,27021,2009-07-15,Senate,"Do pass as amended, and re-refer to the Committee on Appropriations",10,0,0,0,10
60863,27022,2009-08-27,Senate,"Special Consent #16 AB995 Block By Alquist",38,0,0,0,38
60863,27023,2009-09-02,Assembly,"Senate amendments be concurred in",17,0,0,0,17
60863,27024,2009-09-03,Assembly,"AB 995 BLOCK  Concurrence in Senate Amendments",77,0,0,0,77
60864,7554,2009-04-21,Assembly,"Do pass and be re-referred to the Committee on Appropriations",3,7,0,0,10
60864,7555,2009-04-21,Assembly,"Set second hearing.  Failed passage.  Reconsideration granted",10,0,0,0,10
60866,7556,2009-04-21,Assembly,"Do pass and be re-referred to the Committee on Appropriations",14,1,4,0,19
60867,7571,2009-04-28,Assembly,"Do pass and be re-referred to the Committee on Appropriations",5,2,0,0,7
60867,7572,2009-05-13,Assembly,"Do pass",11,5,0,0,16
60867,7573,2009-05-21,Assembly,"AB 999 SKINNER  Assembly Third Reading",45,30,5,0,80
60867,7574,2009-06-23,Senate,"Do pass, but re-refer to the Committee on Appropriations",5,2,0,0,7
60867,7575,2009-07-13,Senate,"Do pass",7,5,1,0,13
60868,7583,2009-04-22,Assembly,"Do pass and be re-referred to the Committee on Judiciary",4,2,1,0,7
60868,7584,2009-04-27,Assembly,"Do pass and be re-referred to the Committee on Appropriations",7,3,0,0,10
60869,7562,2009-04-22,Assembly,"Do pass and be re-referred to the Committee on Judiciary",5,2,0,0,7
60869,7563,2009-04-27,Assembly,"Do pass and be re-referred to the Committee on Appropriations",7,3,0,0,10
60870,7564,2009-04-14,Assembly,"Do pass as amended and be re-referred to the Committee on Appropriations",7,0,0,0,7
60871,23070,2009-04-14,Assembly,"Do pass and be re-referred to the Committee on Appropriations",5,2,0,0,7
60871,23071,2009-04-29,Assembly,"Do pass",11,5,0,0,16
60871,23072,2009-05-14,Assembly,"AB 1003 PEREZ, J.  Assembly Third Reading",46,20,0,0,66
60871,23073,2009-06-25,Senate,"Do pass as amended, and re-refer to the Committee on Appropriations",7,3,0,0,10
60871,23074,2009-09-04,Senate,"Assembly 3rd Reading AB1003 John A. Perez By Alquist",24,15,0,0,39
60871,23075,2009-09-09,Assembly,"AB 1003 PEREZ, J.  Concurrence in Senate Amendments",48,25,0,0,73
60872,1046,2009-04-29,Assembly,"Do pass as amended and be re-referred to the Committee on Appropriations.",4,0,3,0,7
60872,1047,2009-05-20,Assembly,"Do pass, to Consent Calendar.",15,0,1,0,16
60872,1048,2010-01-19,Assembly,"AB 1004 PORTANTINO  Assembly Third Reading",57,6,15,0,78
60872,9766,2010-06-28,Senate,"Do pass as amended, and re-refer to the Committee on Appropriations",7,0,0,0,7
60872,19989,2010-08-12,Senate,"Assembly 3rd Reading AB1004 Portantino By Simitian",34,0,0,0,34
60872,20387,2010-08-17,Assembly,"AB 1004 PORTANTINO  Concurrence in Senate Amendments",72,3,0,0,75
60873,23426,2009-04-28,Assembly,"Do pass as amended and be re-referred to the Committee on 	Appropriations",10,0,0,0,10
60873,23427,2009-05-20,Assembly,"Do pass",11,3,0,0,14
60873,23428,2009-05-28,Assembly,"AB 1005 BLOCK  Assembly Third Reading",50,27,0,0,77
60873,23429,2009-07-06,Senate,"Do pass as amended, and re-refer to the Committee on Appropriations",5,3,0,0,8
60873,23430,2009-07-06,Senate,"Set, first hearing.  Failed passage in Committee.  Reconsideration 	granted",9,0,0,0,9
60873,23431,2009-07-13,Senate,"Do pass as amended, and re-refer to the Committee on Appropriations",6,3,0,0,9
60873,23432,2009-08-17,Senate,"Do pass",8,3,0,0,11
60873,23433,2009-09-01,Senate,"Assembly 3rd Reading AB1005 Block By Negrete McLeod",23,14,0,0,37
60873,23434,2009-09-03,Assembly,"AB 1005 BLOCK  Concurrence in Senate Amendments",50,26,0,0,76
60874,7576,2009-04-14,Assembly,"Do pass and be re-referred to the Committee on Appropriations",9,2,0,0,11
60874,7577,2009-05-28,Assembly,"Do pass as amended",12,4,1,0,17
60874,7578,2009-06-02,Assembly,"AB 1006 BUCHANAN  Assembly Third Reading",62,15,3,0,80
60874,7579,2009-07-08,Senate,"Do pass, but re-refer to the Committee on Appropriations",10,0,3,0,13
60874,7580,2009-08-24,Senate,"Do pass",7,1,5,0,13
60874,7581,2009-09-01,Senate,"Assembly 3rd Reading AB1006 Buchanan By Cox",23,10,7,0,40
60875,7565,2009-04-22,Assembly,"Do pass and be re-referred to the Committee on Appropriations",9,0,2,0,11
60875,7566,2009-05-06,Assembly,"Do pass",15,1,0,0,16
60875,7567,2009-05-18,Assembly,"AB 1007 CARTER  Assembly Third Reading",63,12,5,0,80
60875,7568,2009-07-15,Senate,"Do pass as amended, and re-refer to the Committee on Appropriations",8,0,1,0,9
60875,7569,2009-09-03,Senate,"Assembly 3rd Reading AB1007 Carter By Romero",27,10,3,0,40
60875,7570,2009-09-09,Assembly,"AB 1007 CARTER  Concurrence in Senate Amendments",60,15,4,0,79
60876,1687,2009-04-21,Assembly,"Do pass and be re-referred to the Committee on Appropriations",8,0,1,0,9
60876,1688,2009-05-28,Assembly,"Do pass",12,5,0,0,17
60876,1689,2009-06-01,Assembly,"AB 1008 BLOCK  Assembly Third Reading",54,23,3,0,80
60877,22945,2009-04-21,Assembly,"Do pass as amended and be re-referred to the Committee on 	Appropriations",6,1,0,0,7
60877,22946,2009-05-28,Assembly,"Do pass",12,4,0,0,16
60877,22947,2009-06-01,Assembly,"AB 1009 PEREZ, V.M.  Assembly Third Reading",52,26,0,0,78
60877,22948,2009-07-06,Senate,"Do pass, but re-refer to the Committee on Appropriations",6,3,0,0,9
60877,22949,2009-08-17,Senate,"Placed on Appropriations Suspense file",13,0,0,0,13
60877,22950,2009-10-14,Senate,"Do pass, but re-refer to the Committee on Appropriations",8,0,0,0,8
60877,22951,2009-10-14,Senate,"W/O REF. TO FILE AB1009 V. Manuel Perez Urgency Clause",30,6,0,0,36
60877,22952,2009-10-26,Assembly,"AB 1009 PEREZ, V.M.  Concurrence- Urgency Added",70,2,0,0,72
60879,7592,2009-04-20,Assembly,"Be referred to Committee on Health",10,0,1,0,11
60879,7593,2009-04-28,Assembly,"Do pass and re-refer to Committee on Appropriations with recommendation:  To Consent Calendar",18,0,1,0,19
60879,7594,2009-05-28,Assembly,"Do pass as amended",13,3,1,0,17
60879,7595,2009-06-02,Assembly,"AB 1011 JONES  Assembly Third Reading",77,1,2,0,80
60879,10272,2010-06-30,Senate,"Do pass as amended, and re-refer to the Committee on Appropriations",8,2,1,0,11
60879,19472,2010-08-02,Senate,"Placed on Appropriations Suspense file",10,0,0,0,10
60879,21964,2010-08-30,Senate,"W/O REF. TO FILE AB1011 Jones By Lowenthal",23,14,0,0,37
60879,21965,2010-08-31,Assembly,"Senate amendments be concurred in",7,3,0,0,10
60879,21966,2010-08-31,Assembly,"AB 1011 JONES  Concurrence in Senate Amendments",50,25,0,0,75
60880,7585,2009-04-27,Assembly,"Do pass as amended and be re-referred to the Committee on Appropriations",14,0,1,0,15
60880,7586,2009-05-20,Assembly,"Do pass",15,0,1,0,16
60880,7587,2009-05-28,Assembly,"AB 1012 PEREZ, V.M.  Third Reading Urgency",78,0,2,0,80
60880,7588,2009-07-07,Senate,"Do pass, but re-refer to the Committee on Appropriations",11,0,0,0,11
60880,7589,2009-08-17,Senate,"Do pass",8,0,5,0,13
60880,7590,2009-09-01,Senate,"Assembly 3rd Reading AB1012 V. Manuel Perez Urgency Clause",33,0,7,0,40
60880,7591,2009-09-01,Senate,"Assembly 3rd Reading AB1012 V. Manuel Perez Reconsider",36,0,4,0,40
60880,21087,2010-08-25,Senate,"That the Assembly amendments be concurred in, but first be 	re-referred to the Committee on Appropriations",5,2,0,0,7
60880,21561,2010-08-27,Senate,"From Committee:  Amendments returned to Senate floor for 	consideration",7,3,0,0,10
60880,21879,2010-09-01,Senate,"W/O REF. TO FILE AB1012 V. Manuel Perez By Simitian",20,14,0,0,34
60881,7582,2009-04-14,Assembly,"Do pass and be re-referred to the Committee on Appropriations",7,0,0,0,7
60882,7604,2009-04-27,Assembly,"Do pass as amended and be re-referred to the Committee on Appropriations",12,0,2,0,14
60882,7605,2009-05-20,Assembly,"Do pass",15,0,1,0,16
60882,7606,2009-05-28,Assembly,"AB 1014 GALGIANI  Assembly Third Reading",78,0,2,0,80
60883,25134,2009-04-14,Assembly,"Do pass as amended and re-refer to Committee on Appropriations 	with recommendation:  To Consent Calendar",7,0,0,0,7
60883,25135,2009-05-13,Assembly,"Do pass, to Consent Calendar",16,0,0,0,16
60883,25136,2009-05-28,Assembly,"AB 1015 TORLAKSON  Assembly Third Reading",78,1,0,0,79
60883,25137,2009-07-07,Senate,"Do pass as amended, and re-refer to the Committee on Appropriations",7,0,0,0,7
60883,25138,2009-08-24,Senate,"Special Consent #15 AB1015 Torlakson",39,0,0,0,39
60883,25139,2009-09-09,Senate,"Special Consent #20 AB1015 Torlakson By Padilla",40,0,0,0,40
60883,25140,2009-09-11,Assembly,"AB 1015 TORLAKSON  Concurrence in Senate Amendments",78,0,0,0,78
60885,7596,2009-04-21,Assembly,"Do pass as amended and be re-referred to the Committee on Appropriations",7,0,0,0,7
60885,7597,2009-05-28,Assembly,"Do pass as amended",14,0,3,0,17
60885,7598,2009-06-02,Assembly,"AB 1017 PORTANTINO  Assembly Third Reading",78,0,2,0,80
60885,7599,2009-07-14,Senate,"Do pass as amended, and re-refer to the Committee on Appropriations",7,0,0,0,7
60885,7600,2009-08-17,Senate,"Placed on Appropriations Suspense file",13,0,0,0,13
60885,7601,2009-08-27,Senate,"Do pass",13,0,0,0,13
60885,7602,2009-09-02,Senate,"Assembly 3rd Reading AB1017 Portantino By Alquist",34,0,6,0,40
60885,7603,2009-09-08,Assembly,"AB 1017 PORTANTINO  Concurrence in Senate Amendments",78,0,1,0,79
60887,7609,2009-04-21,Assembly,"Do pass and be re-referred to the Committee on Governmental Organization",3,7,9,0,19
60887,7610,2009-04-21,Assembly,"Set first hearing.  Failed passage.  Reconsideration granted",19,0,0,0,19
60887,7611,2010-01-05,Assembly,"Do pass and be re-referred to the Committee on Governmental Organization",5,8,6,0,19
60888,23769,2009-05-05,Assembly,"Do pass as amended and be re-referred to the Committee on 	Appropriations",19,0,0,0,19
60888,23770,2009-05-28,Assembly,"Do pass as amended",13,0,0,0,13
60888,23771,2009-06-02,Assembly,"AB 1020 EMMERSON  Third Reading Urgency",74,1,0,0,75
60888,23772,2009-07-15,Senate,"Do pass as amended, and re-refer to the Committee on Appropriations",9,0,0,0,9
60888,23773,2009-08-17,Senate,"Do pass",12,0,0,0,12
60888,23774,2009-09-01,Senate,"Assembly 3rd Reading AB1020 Emmerson By Strickland",28,0,0,0,28
60888,23775,2009-09-03,Assembly,"AB 1020 EMMERSON  Concurrence in Senate Amendments",73,2,0,0,75
60890,4262,2009-04-22,Assembly,"Do pass as amended and be re-referred to the Committee on Appropriations",10,0,1,0,11
60890,4263,2009-05-28,Assembly,"Do pass",17,0,0,0,17
60890,4264,2009-06-01,Assembly,"AB 1022 NAVA  Assembly Third Reading",77,0,3,0,80
60890,4265,2009-07-01,Senate,"Do pass as amended, but re-refer to the Committee on Appropriations Recommend Consent",8,0,1,0,9
60890,9380,2010-06-22,Senate,"Do pass as amended, and re-refer to the Committee on Appropriations",7,0,0,0,7
60890,19482,2010-08-02,Senate,"Placed on Appropriations Suspense file",10,0,0,0,10
60890,20141,2010-08-12,Senate,"Do pass",11,0,0,0,11
60890,21009,2010-08-24,Senate,"Assembly 3rd Reading AB1022 Nava By Correa",35,0,0,0,35
60890,21501,2010-08-26,Assembly,"Senate amendments be concurred in",5,0,0,0,5
60890,21570,2010-08-27,Assembly,"AB 1022 NAVA  Concurrence in Senate Amendments",74,0,0,0,74
60891,7607,2009-04-20,Assembly,"Do pass and be re-referred to the Committee on Natural Resources",10,4,1,0,15
60893,23135,2009-04-22,Assembly,"Do pass as amended and be re-referred to the Committee on 	Appropriations",10,0,0,0,10
60893,23136,2009-05-13,Assembly,"Do pass as amended",16,0,0,0,16
60893,23137,2009-05-26,Assembly,"AB 1025 CONWAY  Assembly Third Reading",78,0,0,0,78
60893,23138,2009-07-15,Senate,"Do pass as amended, and re-refer to the Committee on Appropriations",8,0,0,0,8
60893,23139,2009-09-04,Senate,"Special Consent #19 AB1025 Conway By Benoit",40,0,0,0,40
60893,23140,2009-09-09,Assembly,"AB 1025 CONWAY  Concurrence in Senate Amendments",77,0,0,0,77
60896,7608,2009-05-18,Assembly,"Do pass as amended and be re-referred to the Committee on Appropriations",6,3,0,0,9
60897,7618,2010-01-11,Assembly,"Do pass as amended and be re-referred to the Committee on Appropriations",7,0,2,0,9
60898,7613,2009-04-27,Assembly,"Do pass as amended and be re-referred to the Committee on Appropriations",11,2,1,0,14
60898,7614,2009-05-28,Assembly,"Do pass as amended",16,1,0,0,17
60898,7615,2009-06-02,Assembly,"AB 1030 BLUMENFIELD  Assembly Second Reading",76,0,4,0,80
60898,7616,2009-07-07,Senate,"Do pass, but re-refer to the Committee on Energy, Utilities and Communications",9,1,1,0,11
60898,7617,2009-08-17,Senate,"Placed on Appropriations Suspense file",13,0,0,0,13
60899,23498,2009-04-27,Assembly,"Do pass as amended and be re-referred to the Committee on 	Appropriations",13,0,0,0,13
60899,23499,2009-05-28,Assembly,"Do pass as amended",17,0,0,0,17
60899,23500,2009-06-02,Assembly,"AB 1031 BLUMENFIELD  Assembly Third Reading",77,1,0,0,78
60899,23501,2009-07-07,Senate,"Do pass as amended",11,0,0,0,11
60899,23502,2009-09-02,Senate,"Assembly 3rd Reading AB1031 Blumenfield By Strickland",34,0,0,0,34
60899,23503,2009-09-08,Assembly,"AB 1031 BLUMENFIELD  Concurrence in Senate Amendments",79,0,0,0,79
60900,7612,2009-04-29,Assembly,"Do pass as amended and be re-referred to the Committee on Appropriations",7,0,0,0,7
60903,7620,2009-04-20,Assembly,"Do pass and be re-referred to the Committee on Utilities and Commerce",3,6,0,0,9
60903,7621,2009-04-20,Assembly,"Set first hearing.  Failed passage.  Reconsideration granted",9,0,0,0,9
60905,7619,2009-04-21,Assembly,"Do pass and be re-referred to the Committee on Appropriations",16,1,2,0,19
60912,3798,2009-04-21,Assembly,"Do pass and be re-referred to the Committee on Health",4,2,0,0,6
60912,3799,2009-04-28,Assembly,"Do pass as amended and be re-referred to the Committee on Appropriations",13,6,0,0,19
60912,3800,2009-05-28,Assembly,"Do pass",12,5,0,0,17
60912,3801,2009-06-02,Assembly,"AB 1044 JONES  Assembly Third Reading",49,30,1,0,80
60913,23053,2009-04-21,Assembly,"Do pass and re-refer to Committee on Appropriations with 	recommendation:  To Consent Calendar",19,0,0,0,19
60913,23054,2009-05-06,Assembly,"Do pass, to Consent Calendar",16,0,0,0,16
60913,23055,2009-05-14,Assembly,"AB 1045 PEREZ, J.  Consent Calendar Second Day  Regular Session",73,0,0,0,73
60913,23056,2009-06-25,Senate,"Do pass, but re-refer to the Committee on Appropriations",11,0,0,0,11
60913,23057,2009-08-27,Senate,"Special Consent #16 AB1045 John A. Perez",38,0,0,0,38
60914,23064,2009-04-14,Assembly,"Do pass and re-refer to Committee on Appropriations with 	recommendation:  To Consent Calendar",10,0,0,0,10
60914,23065,2009-04-22,Assembly,"Do pass, to Consent Calendar",16,0,0,0,16
60914,23066,2009-05-04,Assembly,"AB 1046 ANDERSON  Consent Calendar Second Day  Regular Session",79,0,0,0,79
60914,23067,2009-06-09,Senate,"Do pass, but re-refer to the Committee on Appropriations Recommend 	Consent",5,0,0,0,5
60914,23068,2009-07-16,Senate,"Special Consent #13 AB1046 Anderson",36,0,0,0,36
60914,23069,2009-08-17,Assembly,"AB 1046 ANDERSON  Concurrence in Senate Amendments",76,0,0,0,76
60915,7622,2009-04-21,Assembly,"Do pass as amended and be re-referred to the Committee on Appropriations",6,1,0,0,7
60916,7623,2009-04-14,Assembly,"Do pass and be re-referred to the Committee on Judiciary",5,0,2,0,7
60916,7624,2009-04-21,Assembly,"Do pass and be re-referred to the Committee on Appropriations",8,2,0,0,10
60916,7625,2009-05-28,Assembly,"Do pass as amended",14,3,0,0,17
60916,7626,2009-06-03,Assembly,"AB 1048 TORRICO  Assembly Third Reading",67,9,4,0,80
60916,7627,2009-07-07,Senate,"Do pass, but re-refer to the Committee on Appropriations",4,1,0,0,5
60916,7628,2009-08-17,Senate,"Do pass",9,3,1,0,13
60916,20718,2010-08-19,Senate,"Assembly 3rd Reading AB1048 Torrico By Cedillo",27,6,0,0,33
60916,20908,2010-08-23,Assembly,"AB 1048 TORRICO  Concurrence in Senate Amendments",76,0,0,0,76
60917,7629,2009-04-20,Assembly,"Do pass and be re-referred to the Committee on Health",9,0,0,0,9
60917,7630,2009-04-28,Assembly,"Do pass and be re-referred to the Committee on Appropriations",19,0,0,0,19
60917,7631,2009-05-28,Assembly,"Do pass as amended",17,0,0,0,17
60917,7632,2009-06-02,Assembly,"AB 1049 TORRICO  Assembly Third Reading",78,0,2,0,80
60917,7633,2009-07-08,Senate,"Do pass, but re-refer to the Committee on Appropriations",6,1,1,0,8
60917,7634,2009-08-17,Senate,"Placed on Appropriations Suspense file",13,0,0,0,13
60917,7635,2009-08-27,Senate,"Do pass as amended",12,1,0,0,13
60917,7636,2009-08-27,Senate,"Reconsideration granted",13,0,0,0,13
60917,7637,2009-08-27,Senate,"Do pass as amended",12,1,0,0,13
60917,7638,2009-09-02,Senate,"Assembly 3rd Reading AB1049 Torrico By Cedillo",28,3,9,0,40
60917,7639,2009-09-08,Assembly,"AB 1049 TORRICO  Concurrence in Senate Amendments",79,0,0,0,79
60918,7640,2009-05-05,Assembly,"Do pass, to Consent Calendar",10,0,0,0,10
60918,7641,2009-05-11,Assembly,"AB 1050 MA  Consent Calendar Second Day  Regular Session",78,0,2,0,80
60918,9880,2010-06-29,Senate,"Do pass, but re-refer to the Committee on Appropriations Recommend Consent",4,0,1,0,5
60918,19447,2010-08-05,Senate,"Consent Calendar 2nd AB1050 Ma",33,0,0,0,33
60918,19667,2010-08-09,Assembly,"AB 1050 MA  Concurrence in Senate Amendments",78,0,0,0,78
60919,25846,2009-04-14,Assembly,"Do pass and be re-referred to the Committee on Appropriations",8,0,0,0,8
60919,25847,2009-04-22,Assembly,"Do pass as amended and be re-referred to the Committee on 	Appropriations",10,0,0,0,10
60919,25848,2009-05-13,Assembly,"Do pass, to Consent Calendar",16,0,0,0,16
60919,25849,2009-05-21,Assembly,"AB 1051 FLETCHER  Consent Calendar Second Day  Regular Session",77,0,0,0,77
60919,25850,2009-06-23,Senate,"Do pass, but re-refer to the Committee on Banking, Finance and 	Insurance",6,0,0,0,6
60919,25851,2009-07-09,Senate,"Do pass, but re-refer to the Committee on Appropriations Recommend 	Consent",11,0,0,0,11
60919,25852,2009-08-27,Senate,"Special Consent #16 AB1051 Fletcher",38,0,0,0,38
60920,22386,2009-04-14,Assembly,"Do pass and be re-referred to the Committee on Appropriations",12,0,0,0,12
60920,22387,2009-05-28,Assembly,"Do pass",17,0,0,0,17
60920,22388,2009-06-01,Assembly,"AB 1052 CABALLERO  Assembly Third Reading",79,0,0,0,79
60920,22389,2009-07-06,Senate,"Do pass as amended, and re-refer to the Committee on Appropriations",9,1,0,0,10
60920,22390,2009-08-24,Senate,"Do pass",11,0,0,0,11
60920,22391,2009-09-01,Senate,"Assembly 3rd Reading AB1052 Caballero By Wolk",33,1,0,0,34
60920,22392,2009-09-03,Assembly,"AB 1052 CABALLERO  Concurrence in Senate Amendments",77,0,0,0,77
60921,23913,2009-04-28,Assembly,"Do pass as amended and be re-referred to the Committee on 	Appropriations",5,1,0,0,6
60921,23914,2009-05-20,Assembly,"Do pass",11,4,0,0,15
60921,23915,2009-06-01,Assembly,"AB 1053 SOLORIO  Assembly Third Reading",49,30,0,0,79
60921,23916,2009-07-07,Senate,"Do pass as amended, and re-refer to the Committee on Appropriations",6,1,0,0,7
60921,23917,2009-08-17,Senate,"Placed on Appropriations Suspense file",13,0,0,0,13
60921,23918,2009-08-27,Senate,"Do pass as amended",8,5,0,0,13
60921,23919,2009-09-10,Senate,"Assembly 3rd Reading AB1053 Solorio By Hancock",24,14,0,0,38
60921,23920,2009-09-11,Assembly,"Senate amendments be concurred in",5,2,0,0,7
60921,23921,2009-09-12,Assembly,"AB 1053 SOLORIO  Concurrence in Senate Amendments",46,29,0,0,75
60922,7642,2009-04-22,Assembly,"Do pass and be re-referred to the Committee on Appropriations",9,1,0,0,10
60922,7643,2010-01-21,Assembly,"Do pass",17,0,0,0,17
60923,7656,2009-04-28,Assembly,"Do pass as amended and be re-referred to the Committee on Appropriations",18,0,1,0,19
60925,7650,2009-04-14,Assembly,"Do pass and be re-referred to the Committee on Appropriations",4,2,1,0,7
60926,7645,2009-04-28,Assembly,"Do pass and be re-referred to the Committee on Appropriations",5,2,0,0,7
60926,7646,2009-05-28,Assembly,"Do pass as amended",12,5,0,0,17
60926,7647,2009-06-03,Assembly,"AB 1058 BEALL  Assembly Third Reading",48,30,2,0,80
60926,7648,2009-06-23,Senate,"Do pass, but re-refer to the Committee on Appropriations",3,2,0,0,5
60926,7649,2009-08-17,Senate,"Placed on Appropriations Suspense file",13,0,0,0,13
60927,22940,2009-05-04,Assembly,"Do pass, to Consent Calendar",9,0,0,2,11
60927,22941,2009-05-11,Assembly,"AB 1059 SILVA  Consent Calendar Second Day  Regular Session",78,0,0,2,80
60927,22942,2009-06-09,Senate,"Do pass and be placed on the Consent Calendar",5,0,0,0,5
60927,22943,2009-08-24,Senate,"Special Consent #15 AB1059 Silva By Harman",39,0,1,0,40
60927,22944,2009-08-27,Assembly,"AB 1059 SILVA  Concurrence in Senate Amendments",76,0,0,3,79
60928,7664,2009-04-30,Assembly,"Do pass and be re-referred to the Committee on Appropriations",11,3,5,0,19
60928,7665,2009-05-13,Assembly,"Do pass",12,4,0,0,16
60928,7666,2009-05-28,Assembly,"AB 1060 DE LA TORRE  Assembly Third Reading",50,27,3,0,80
60928,7667,2009-07-08,Senate,"Do pass, but re-refer to the Committee on Appropriations",6,5,2,0,13
60928,7668,2009-07-08,Senate,"Set, first hearing.  Failed passage in Committee.  Reconsideration granted",11,0,2,0,13
60928,7669,2009-07-14,Senate,"Do pass, but re-refer to the Committee on Appropriations",8,0,5,0,13
60928,7670,2009-08-17,Senate,"Do pass",7,4,2,0,13
60928,21300,2010-08-23,Senate,"Assembly 3rd Reading AB1060 De La Torre By Florez",23,12,0,0,35
60929,26807,2009-04-14,Assembly,"Do pass as amended",12,0,0,0,12
60929,26808,2009-04-20,Assembly,"AB 1061 LIEU  Assembly Third Reading",75,0,0,0,75
60929,26809,2009-06-16,Senate,"Do pass, but re-refer to the Committee on Judiciary",11,0,0,0,11
60929,26810,2009-07-09,Senate,"Special Consent #12 AB1061 Lieu",34,0,0,0,34
60929,26811,2009-08-24,Senate,"Special Consent #15 AB1061 Lieu By Lowenthal",39,0,0,0,39
60929,26812,2009-08-27,Assembly,"AB 1061 LIEU  Concurrence in Senate Amendments",76,0,0,0,76
60930,7644,2010-01-12,Assembly,"Do pass and be re-referred to the Committee on Labor and Employment",3,7,1,0,11
60931,7658,2010-01-12,Assembly,"Do pass and be re-referred to the Committee on Labor and Employment",3,7,1,0,11
60932,7657,2010-01-12,Assembly,"Do pass and be re-referred to the Committee on Labor and Employment",4,7,0,0,11
60934,23382,2009-04-27,Assembly,"Do pass as amended and be re-referred to the Committee on 	Appropriations",7,0,0,0,7
60934,23383,2009-05-20,Assembly,"Do pass",14,0,0,0,14
60934,23384,2009-06-03,Assembly,"AB 1066 MENDOZA  Assembly Third Reading",53,12,0,0,65
60934,23385,2009-07-06,Senate,"Do pass as amended, and re-refer to the Committee on Appropriations",7,2,0,0,9
60934,23386,2009-09-01,Senate,"Assembly 3rd Reading AB1066 Mendoza By Wright",24,8,0,0,32
60934,23387,2009-09-03,Assembly,"AB 1066 MENDOZA  Concurrence in Senate Amendments",57,11,0,0,68
60935,7655,2009-04-28,Assembly,"Do pass as amended and be re-referred to the Committee on Appropriations",5,2,0,0,7
60936,7651,2009-05-05,Assembly,"Do pass",5,2,0,0,7
60936,7652,2009-06-01,Assembly,"AB 1068 SALDANA  Assembly Third Reading",48,29,3,0,80
60936,7653,2009-07-07,Senate,"Do pass",3,2,0,0,5
60936,7654,2009-08-27,Senate,"Assembly 3rd Reading AB1068 Saldana By DeSaulnier",23,15,2,0,40
60937,7671,2009-04-29,Assembly,"Do pass as amended and be re-referred to the Committee on Appropriations",5,3,0,0,8
60937,7672,2009-05-13,Assembly,"Do pass",12,4,0,0,16
60937,7673,2009-05-28,Assembly,"AB 1069 MONNING  Assembly Third Reading",53,27,0,0,80
60937,7674,2009-06-16,Senate,"Do pass, but re-refer to the Committee on Environmental Quality",3,1,1,0,5
60937,7675,2009-06-22,Senate,"Do pass, but re-refer to the Committee on Appropriations",5,2,0,0,7
60937,7676,2009-08-17,Senate,"Placed on Appropriations Suspense file",13,0,0,0,13
60937,7677,2009-08-27,Senate,"Do pass",8,5,0,0,13
60937,7678,2009-09-04,Senate,"Assembly 3rd Reading AB1069 Monning By Hancock",27,13,0,0,40
60938,23412,2009-04-28,Assembly,"Do pass and be re-referred to the Committee on Appropriations",7,2,0,0,9
60938,23413,2009-05-13,Assembly,"Do pass",12,4,0,0,16
60938,23414,2009-05-28,Assembly,"AB 1070 HILL  Assembly Third Reading",48,30,0,0,78
60938,23415,2009-06-29,Senate,"Do pass, but re-refer to the Committee on Judiciary",7,3,0,0,10
60938,23416,2009-07-14,Senate,"Do pass as amended, and re-refer to the Committee on 	Appropriations",3,2,0,0,5
60938,23417,2009-09-04,Senate,"Assembly 3rd Reading AB1070 Hill By Negrete McLeod",25,14,0,0,39
60938,23418,2009-09-09,Assembly,"AB 1070 HILL  Concurrence in Senate Amendments",49,28,0,0,77
60939,26168,2009-04-21,Assembly,"Do pass and be re-referred to the Committee on Appropriations",11,0,0,0,11
60939,26169,2009-05-28,Assembly,"Do pass",17,0,0,0,17
60939,26170,2009-06-01,Assembly,"AB 1071 EMMERSON  Assembly Third Reading",76,0,0,0,76
60939,26171,2009-06-29,Senate,"Do pass, but re-refer to the Committee on Appropriations",9,0,0,0,9
60939,26172,2009-07-06,Senate,"Do pass",10,0,0,0,10
60939,26173,2009-09-04,Senate,"Assembly 3rd Reading AB1071 Emmerson By Wyland",39,0,0,0,39
60939,26174,2009-09-09,Assembly,"Senate amendments be concurred in",10,0,0,0,10
60939,26175,2009-09-10,Assembly,"AB 1071 EMMERSON  Concurrence in Senate Amendments",77,0,0,0,77
60940,23776,2009-04-27,Assembly,"Do pass as amended and be re-referred to the Committee on 	Appropriations",12,1,0,0,13
60940,23777,2009-05-20,Assembly,"Do pass",15,0,0,0,15
60940,23778,2009-05-28,Assembly,"AB 1072 ENG  Third Reading Urgency",78,1,0,0,79
60940,23779,2009-07-07,Senate,"Do pass, but re-refer to the Committee on Appropriations",10,0,0,0,10
60940,23780,2009-08-17,Senate,"Do pass",12,0,0,0,12
60940,23781,2009-08-27,Senate,"Special Consent #16 AB1072 Eng",38,0,0,0,38
60940,23782,2009-08-31,Assembly,"AB 1072 ENG  Concurrence in Senate Amendments",77,0,0,0,77
60942,7660,2009-04-14,Assembly,"Do pass and be re-referred to the Committee on Appropriations",10,0,1,0,11
60942,7661,2009-04-29,Assembly,"Do pass, to Consent Calendar",16,0,0,0,16
60942,7662,2009-05-11,Assembly,"AB 1074 CONWAY  Consent Calendar Second Day  Regular Session",78,0,2,0,80
60942,7663,2009-06-08,Senate,"Do pass, but re-refer to the Committee on Public Safety",7,0,3,0,10
60943,7659,2009-04-20,Assembly,"Do pass as amended and be re-referred to the Committee on Appropriations",7,3,1,0,11
60944,7679,2009-05-12,Assembly,"Do pass and be re-referred to the Committee on Appropriations",19,0,0,0,19
60944,7680,2009-05-28,Assembly,"Do pass as amended",17,0,0,0,17
60944,7681,2009-06-02,Assembly,"AB 1076 JONES  Assembly Third Reading",78,0,2,0,80
60944,7682,2009-07-15,Senate,"Do pass as amended, and re-refer to the Committee on Appropriations",9,1,1,0,11
60946,7683,2009-04-28,Assembly,"Do pass as amended and be re-referred to the Committee on Appropriations",7,0,0,0,7
60946,7684,2009-05-14,Assembly,"AB 1078 FEUER  Assembly Third Reading",74,0,6,0,80
60946,20716,2010-08-18,Senate,"Do pass as amended",8,0,0,0,8
60946,21030,2010-08-24,Senate,"Assembly 3rd Reading AB1078 Feuer Urgency Clause",35,0,0,0,35
60946,21362,2010-08-26,Assembly,"Senate amendments be concurred in",13,0,0,0,13
60946,21590,2010-08-27,Assembly,"AB 1078 FEUER  Concurrence in Senate Amendments",74,0,0,0,74
60947,23146,2009-04-28,Assembly,"Do pass and be re-referred to the Committee on Appropriations",7,0,0,0,7
60947,23147,2009-05-28,Assembly,"Do pass as amended",12,0,0,0,12
60947,23148,2009-06-03,Assembly,"AB 1079 PEREZ, V.M.  Assembly Third Reading",63,12,0,0,75
60947,23149,2009-07-06,Senate,"Do pass, but re-refer to the Committee on Appropriations",6,1,0,0,7
60947,23150,2009-08-17,Senate,"Placed on Appropriations Suspense file",13,0,0,0,13
60947,23151,2009-08-27,Senate,"Do pass as amended",8,5,0,0,13
60947,23152,2009-09-03,Senate,"Assembly 3rd Reading AB1079 V. Manuel Perez By Ducheny",28,8,0,0,36
60947,23153,2009-09-10,Assembly,"AB 1079 PEREZ, V.M.  Concurrence in Senate Amendments",61,16,0,0,77
60948,26853,2009-05-06,Assembly,"Do pass as amended",7,1,0,0,8
60948,26854,2009-05-21,Assembly,"AB 1080 SKINNER  Assembly Third Reading",75,2,0,0,77
60948,26855,2009-07-15,Senate,"Do pass",8,0,0,0,8
60948,26856,2009-08-24,Senate,"Special Consent #15 AB1080 Skinner",39,0,0,0,39
60948,26857,2009-08-27,Assembly,"AB 1080 SKINNER  Concurrence in Senate Amendments",76,0,0,0,76
60949,7701,2009-04-21,Assembly,"Do pass and be re-referred to the Committee on Judiciary",6,0,1,0,7
60949,7702,2009-04-27,Assembly,"Do pass as amended and be re-referred to the Committee on Appropriations",10,0,0,0,10
60951,25700,2009-04-21,Assembly,"Do pass as amended and be re-referred to the Committee on 	Appropriations",17,0,0,0,17
60951,25701,2009-05-20,Assembly,"Do pass as amended",12,0,0,0,12
60951,25702,2009-05-28,Assembly,"AB 1083 PEREZ, J.  Assembly Third Reading",76,0,0,0,76
60951,25703,2009-06-25,Senate,"Do pass, but re-refer to the Committee on Appropriations",10,0,0,0,10
60951,25704,2009-08-17,Senate,"Special Consent #14 AB1083 John A. Perez",35,0,0,0,35
60951,25705,2009-09-03,Assembly,"AB 1083 PEREZ, J.  Concurrence in Senate Amendments",76,0,0,0,76
60952,23504,2009-04-29,Assembly,"Do pass and be re-referred to the Committee on Appropriations",7,0,0,0,7
60952,23505,2009-05-13,Assembly,"Do pass, to Consent Calendar",16,0,0,0,16
60952,23506,2009-05-21,Assembly,"AB 1084 ADAMS  Consent Calendar Second Day  Regular Session",77,0,0,0,77
60952,23507,2009-06-17,Senate,"Do pass, but re-refer to the Committee on Appropriations",5,0,0,0,5
60952,23508,2009-09-03,Senate,"Assembly 3rd Reading AB1084 Adams By Negrete McLeod",36,0,0,0,36
60952,23509,2009-09-09,Assembly,"AB 1084 ADAMS  Concurrence in Senate Amendments",77,0,0,0,77
60953,23625,2009-04-27,Assembly,"Do pass as amended and be re-referred to the Committee on 	Appropriations",9,0,0,0,9
60953,23626,2009-05-20,Assembly,"Do pass, to Consent Calendar",15,0,0,0,15
60953,23627,2009-05-28,Assembly,"AB 1085 MENDOZA  Consent Calendar Second Day  Regular Session",76,0,0,0,76
60953,23628,2009-06-22,Senate,"Do pass, but re-refer to the Committee on Appropriations",7,0,0,0,7
60953,23629,2009-07-13,Senate,"Do pass as amended",10,0,0,0,10
60953,23630,2009-09-02,Senate,"Assembly 3rd Reading AB1085 Mendoza By Dutton",39,0,0,0,39
60953,23631,2009-09-08,Assembly,"AB 1085 MENDOZA  Concurrence in Senate Amendments",78,0,0,0,78
60954,25759,2009-05-12,Assembly,"Do pass as amended and be re-referred to the Committee on 	Appropriations",11,0,0,0,11
60954,25760,2009-06-01,Assembly,"AB 1086 MILLER  Assembly Third Reading",79,0,0,0,79
60954,25761,2009-06-23,Senate,"Do pass, but re-refer to the Committee on Judiciary",12,0,0,0,12
60954,25762,2009-07-07,Senate,"Do pass",5,0,0,0,5
60954,25763,2009-07-16,Senate,"Special Consent #13 AB1086 Miller",36,0,0,0,36
60955,7719,2009-05-18,Assembly,"Do pass and be re-referred to the Committee on Appropriations",6,1,2,0,9
60955,7720,2009-05-28,Assembly,"Do pass as amended",12,5,0,0,17
60955,7721,2009-06-03,Assembly,"AB 1087 MA  Assembly Third Reading",50,28,2,0,80
60955,7722,2009-07-08,Senate,"Do pass, but re-refer to the Committee on Appropriations",5,3,0,0,8
60955,7723,2009-09-01,Senate,"Assembly 3rd Reading AB1087 Ma Reconsider",38,0,2,0,40
60955,7724,2009-09-04,Senate,"Assembly 3rd Reading AB1087 Ma By Wolk",23,16,1,0,40
60955,7725,2009-09-10,Assembly,"Senate amendments be concurred in",6,1,2,0,9
60955,7726,2009-09-11,Assembly,"AB 1087 MA  Concurrence in Senate Amendments",51,27,1,0,79
60956,3597,2010-01-11,Assembly,"Do pass and be re-referred to the Committee on Veterans Affairs",5,0,4,0,9
60956,3598,2010-01-12,Assembly,"Do pass and be re-referred to the Committee on Appropriations to Consent Calendar",8,0,1,0,9
60956,3599,2010-01-21,Assembly,"Do pass as amended",17,0,0,0,17
60956,3600,2010-01-27,Assembly,"AB 1088 FLETCHER  Assembly Third Reading",71,0,7,0,78
60956,3601,2010-04-13,Senate,"Do pass, but re-refer to the Committee on Revenue and Taxation",4,0,1,0,5
60956,9385,2010-06-23,Senate,"Do pass, but re-refer to the Committee on Appropriations",3,0,2,0,5
60956,20545,2010-08-19,Senate,"Assembly 3rd Reading AB1088 Fletcher By Denham",32,1,0,0,33
60956,20859,2010-08-23,Assembly,"AB 1088 FLETCHER  Concurrence in Senate Amendments",77,0,0,0,77
60957,7731,2009-04-21,Assembly,"Committee amendments",3,1,5,0,9
60957,7732,2009-04-21,Assembly,"Do pass as amended and be re-referred to the Committee on Appropriations",9,0,0,0,9
60958,23536,2009-05-05,Assembly,"Do pass as amended",10,0,0,0,10
60958,23537,2009-05-14,Assembly,"AB 1090 MONNING  Assembly Third Reading",71,0,0,0,71
60958,23538,2009-06-09,Senate,"Do pass",4,1,0,0,5
60958,23539,2009-06-22,Senate,"Assembly 3rd Reading AB1090 Monning By Corbett",30,9,0,0,39
60959,7709,2009-04-27,Assembly,"Do pass as amended and be re-referred to the Committee on Appropriations",6,3,0,0,9
60961,23863,2009-05-06,Assembly,"Do pass",10,0,0,0,10
60961,23864,2009-05-28,Assembly,"AB 1093 YAMADA  Assembly Third Reading",80,0,0,0,80
60961,23865,2009-06-25,Senate,"Do pass, but re-refer to the Committee on Judiciary",5,0,0,0,5
60961,23866,2009-08-27,Senate,"Assembly 3rd Reading AB1093 Yamada By Corbett",30,4,0,0,34
60961,23867,2009-08-31,Assembly,"AB 1093 YAMADA  Concurrence in Senate Amendments",77,0,0,0,77
60962,23115,2009-04-28,Assembly,"Do pass",9,0,0,0,9
60962,23116,2009-05-28,Assembly,"AB 1094 CONWAY  Assembly Third Reading",79,0,0,0,79
60962,23117,2009-06-23,Senate,"Do pass as amended",5,0,0,0,5
60962,23118,2009-07-09,Senate,"Special Consent #12 AB1094 Conway",34,0,0,0,34
60962,23119,2009-07-13,Assembly,"AB 1094 CONWAY  Concurrence in Senate Amendments",75,0,0,0,75
60963,7718,2009-05-05,Assembly,"Do pass as amended and be re-referred to the Committee on Appropriations",7,1,1,0,9
60964,7703,2009-04-21,Assembly,"Do pass and re-refer to Committee on Appropriations with recommendation:  To Consent Calendar",7,0,0,0,7
60964,7704,2009-05-28,Assembly,"Do pass as amended",13,0,4,0,17
60964,7705,2009-06-02,Assembly,"AB 1096 GALGIANI  Assembly Third Reading",77,0,3,0,80
60964,7706,2009-07-07,Senate,"Do pass, but re-refer to the Committee on Appropriations Recommend Consent",5,0,0,0,5
60964,7707,2009-08-27,Senate,"Special Consent #16 AB1096 Galgiani",38,0,2,0,40
60964,7708,2009-08-31,Assembly,"AB 1096 GALGIANI  Concurrence in Senate Amendments",78,0,1,0,79
60965,1515,2010-01-07,Assembly,"Be referred to Committee on Transportation",10,0,1,0,11
60965,1516,2010-01-11,Assembly,"Do pass and re-refer to Committee on Appropriations with recommendation:  To Consent Calendar",14,0,0,0,14
60965,1517,2010-01-21,Assembly,"Do pass, to Consent Calendar",17,0,0,0,17
60965,1518,2010-01-27,Assembly,"AB 1097 ENG  Consent Calendar Second Day  Regular Session",68,0,10,0,78
60967,7698,2009-04-29,Assembly,"Do pass and re-refer to Committee on Appropriations with recommendation:  To Consent Calendar",11,0,0,0,11
60967,7699,2009-05-13,Assembly,"Do pass, to Consent Calendar",16,0,0,0,16
60967,7700,2009-05-21,Assembly,"AB 1099 FULLER  Consent Calendar Second Day  Regular Session",77,0,3,0,80
60968,7686,2009-04-28,Assembly,"Do pass as amended and be re-referred to the Committee on Appropriations",7,0,0,0,7
60968,7687,2009-05-20,Assembly,"Do pass, to Consent Calendar",15,0,1,0,16
60968,7688,2009-05-28,Assembly,"AB 1100 DUVALL  Consent Calendar Second Day  Regular Session",76,0,4,0,80
60968,7689,2009-07-08,Senate,"Do pass, but re-refer to the Committee on Environmental Quality",10,1,0,0,11
60968,7690,2009-07-13,Senate,"Do pass, but re-refer to the Committee on Appropriations",3,3,1,0,7
60968,7691,2009-07-13,Senate,"Set, first hearing.  Failed passage in Committee.  Reconsideration granted",4,0,3,0,7
60972,3482,2009-04-27,Assembly,"Do pass, to Consent Calendar",13,0,1,0,14
60972,3483,2009-05-04,Assembly,"AB 1104 MONNING  Consent Calendar Second Day  Regular Session",79,0,1,0,80
60974,7692,2009-04-20,Assembly,"Do pass and be re-referred to the Committee on Natural Resources",10,4,1,0,15
60974,7693,2009-04-27,Assembly,"Do pass as amended and be re-referred to the Committee on Appropriations",6,3,0,0,9
60974,7694,2009-05-28,Assembly,"Do pass",12,5,0,0,17
60974,7695,2009-06-01,Assembly,"AB 1106 FUENTES  Assembly Third Reading",50,26,4,0,80
60974,7696,2009-07-07,Senate,"Do pass as amended, and re-refer to the Committee on Appropriations",6,2,3,0,11
60974,19735,2010-08-10,Senate,"Do pass, but re-refer to the Committee on Appropriations",8,1,0,0,9
60974,20026,2010-08-12,Senate,"Placed on Appropriations Suspense file",11,0,0,0,11
60974,20027,2010-08-12,Senate,"Do pass as amended",8,2,0,0,10
60974,20699,2010-08-20,Senate,"Assembly 3rd Reading AB1106 Fuentes By Padilla",29,3,0,0,32
60974,21460,2010-08-26,Assembly,"AB 1106 FUENTES  Concurrence- Urgency Added",75,2,0,0,77
60975,7685,2010-01-12,Assembly,"Do pass and be re-referred to the Committee on Natural Resources",2,4,1,0,7
60976,86,2009-04-27,Assembly,"Do pass and be re-referred to the Committee on Appropriations.",11,2,2,0,15
60976,87,2009-05-28,Assembly,"Do pass as amended.",12,5,0,0,17
60976,88,2009-06-02,Assembly,"AB 1108 FUENTES  Assembly Third Reading",45,30,5,0,80
60976,89,2009-07-07,Senate,"Do pass as amended, and re-refer to the Committee on Appropriations.",8,3,0,0,11
60976,90,2009-08-17,Senate,"Placed on Appropriations Suspense file.",13,0,0,0,13
60976,20000,2010-08-12,Senate,"Do pass as amended",7,4,0,0,11
60978,25615,2009-05-11,Assembly,"Do pass",12,2,0,0,14
60978,25616,2009-05-21,Assembly,"AB 1110 FUENTES  Assembly Third Reading",64,9,0,0,73
60978,25617,2009-07-07,Senate,"Do pass as amended, and re-refer to the Committee on Appropriations",10,0,0,0,10
60978,25618,2009-08-31,Senate,"Assembly 3rd Reading AB1110 Fuentes By Wright",36,0,0,0,36
60978,25619,2009-09-09,Assembly,"Senate amendments be concurred in",14,0,0,0,14
60978,25620,2009-09-10,Assembly,"AB 1110 FUENTES  Concurrence in Senate Amendments",73,2,0,0,75
60979,7697,2009-04-27,Assembly,"Do pass and be re-referred to the Committee on Appropriations",14,0,1,0,15
60981,26087,2009-04-14,Assembly,"Do pass and be re-referred to the Committee on Appropriations",8,0,0,0,8
60981,26088,2009-04-29,Assembly,"Do pass",14,0,0,0,14
60981,26089,2009-05-18,Assembly,"AB 1113 LOWENTHAL  Assembly Third Reading",71,0,0,0,71
60981,26090,2009-06-22,Senate,"Do pass, but re-refer to the Committee on Appropriations",10,0,0,0,10
60981,26091,2009-07-16,Senate,"Assembly 3rd Reading AB1113 Bonnie Lowenthal By Negrete McLeod",35,0,0,0,35
60983,7744,2009-04-14,Assembly,"Do pass and be re-referred to the Committee on Natural Resources to Consent Calendar",13,0,0,0,13
60983,7745,2009-04-27,Assembly,"Do pass and be re-referred to the Committee on Appropriations",8,0,1,0,9
60983,7746,2009-05-28,Assembly,"Do pass as amended",12,0,5,0,17
60983,7747,2009-06-03,Assembly,"AB 1115 FUENTES  Assembly Third Reading",64,11,5,0,80
60983,7748,2009-07-06,Senate,"Do pass as amended, and re-refer to the Committee on Appropriations",7,2,2,0,11
60983,7749,2009-09-01,Senate,"Assembly 3rd Reading AB1115 Fuentes By Liu",25,11,4,0,40
60983,7750,2009-09-03,Assembly,"AB 1115 FUENTES  Concurrence in Senate Amendments",53,21,5,0,79
60984,23469,2009-04-14,Assembly,"Do pass and be re-referred to the Committee on Health",7,0,0,0,7
60984,23470,2009-05-05,Assembly,"Do pass",19,0,0,0,19
60984,23471,2009-05-18,Assembly,"AB 1116 CARTER  Assembly Third Reading",62,9,0,0,71
60984,23472,2009-06-22,Senate,"Do pass",9,1,0,0,10
60984,23473,2009-09-09,Senate,"Assembly 3rd Reading AB1116 Carter By Aanestad",32,2,0,0,34
60984,23474,2009-09-10,Assembly,"AB 1116 Carter  Concurrence in Senate Amendments",79,0,0,0,79
60985,23486,2009-05-06,Assembly,"Do pass, to Consent Calendar",9,0,0,0,9
60985,23487,2009-05-14,Assembly,"AB 1117 FUENTES  Consent Calendar Second Day  Regular Session",73,0,0,0,73
60985,23488,2009-06-17,Senate,"Do pass as amended",11,0,0,0,11
60985,23489,2009-07-09,Senate,"Special Consent #12 AB1117 Fuentes",34,0,0,0,34
60985,23490,2009-07-16,Assembly,"AB 1117 FUENTES  Concurrence in Senate Amendments",72,0,0,0,72
60987,7765,2009-04-21,Assembly,"Do pass and be re-referred to the Committee on Judiciary",8,0,3,0,11
60987,7766,2009-04-28,Assembly,"Do pass as amended and re-refer to Committee on Appropriations with recommendation:  To Consent Calendar",10,0,0,0,10
60988,7767,2009-04-29,Assembly,"Do pass as amended and re-refer to Committee on Appropriations with recommendation:  To Consent Calendar",11,0,0,0,11
60988,7768,2009-05-20,Assembly,"Do pass, to Consent Calendar",15,0,1,0,16
60988,7769,2009-05-28,Assembly,"AB 1120 NIELLO  Consent Calendar Second Day  Regular Session",76,0,4,0,80
60988,7770,2009-07-08,Senate,"Do pass as amended, but re-refer to the Committee on Appropriations Recommend Consent",7,0,2,0,9
60988,7771,2009-08-17,Senate,"Placed on Appropriations Suspense file",13,0,0,0,13
60988,7772,2009-08-27,Senate,"Do pass",13,0,0,0,13
60988,7773,2009-09-02,Senate,"Assembly 3rd Reading AB1120 Niello By Cox",34,0,6,0,40
60988,7774,2009-09-08,Assembly,"AB 1120 NIELLO  Concurrence in Senate Amendments",79,0,0,0,79
60989,7775,2009-04-21,Assembly,"Do pass as amended and be re-referred to the Committee on Appropriations",5,1,1,0,7
60989,7776,2009-05-28,Assembly,"Do pass",10,6,1,0,17
60989,7777,2009-06-01,Assembly,"AB 1121 DAVIS  Assembly Third Reading",45,30,5,0,80
60989,7778,2009-07-07,Senate,"Do pass as amended, and re-refer to the Committee on Appropriations",3,2,0,0,5
60989,7779,2009-08-17,Senate,"Do pass as amended",7,4,2,0,13
60989,7780,2009-09-03,Senate,"Assembly 3rd Reading AB1121 Davis Reconsider",36,0,4,0,40
60989,7781,2009-09-10,Senate,"Assembly 3rd Reading AB1121 Davis By Hancock",20,19,1,0,40
60990,7782,2009-04-21,Assembly,"Do pass as amended and be re-referred to the Committee on Appropriations",7,3,1,0,11
60990,7783,2009-05-20,Assembly,"Do pass",11,2,3,0,16
60990,7784,2009-05-28,Assembly,"AB 1122 LIEU  Assembly Third Reading",52,19,9,0,80
60990,7785,2009-07-07,Senate,"Do pass, but re-refer to the Committee on Appropriations",5,1,1,0,7
60990,7786,2009-09-01,Senate,"Assembly 3rd Reading AB1122 Lieu By Benoit",21,13,6,0,40
60990,7787,2009-09-08,Assembly,"AB 1122 LIEU  Concurrence in Senate Amendments",57,19,3,0,79
60991,26120,2009-04-28,Assembly,"Do pass and re-refer to Committee on Appropriations with 	recommendation:  To Consent Calendar",10,0,0,0,10
60991,26121,2009-05-13,Assembly,"Do pass, to Consent Calendar",16,0,0,0,16
60991,26122,2009-05-21,Assembly,"AB 1123 DAVIS  Consent Calendar Second Day  Regular Session",77,0,0,0,77
60991,26123,2009-06-22,Senate,"Do pass, but re-refer to the Committee on Appropriations",9,0,0,0,9
60991,26124,2009-07-09,Senate,"Special Consent #12 AB1123 Davis",34,0,0,0,34
60992,7755,2009-04-15,Assembly,"Do pass as amended and be re-referred to the Committee on Appropriations",10,0,1,0,11
60993,7754,2009-04-22,Assembly,"Do pass as amended and be re-referred to the Committee on Appropriations",4,1,1,0,6
60995,7743,2009-04-22,Assembly,"Do pass as amended and be re-referred to the Committee on Appropriations",7,2,2,0,11
60996,7742,2009-04-30,Assembly,"Do pass and be re-referred to the Committee on Appropriations",17,0,2,0,19
60997,25669,2009-05-12,Assembly,"Do pass, to Consent Calendar",7,0,0,0,7
60997,25670,2009-05-21,Assembly,"AB 1129 HAGMAN  Consent Calendar Second Day  Regular Session",77,0,0,0,77
60997,25671,2009-06-16,Senate,"Do pass",6,0,0,0,6
60997,25672,2009-06-24,Senate,"Special Consent #10 AB1129 Hagman",40,0,0,0,40
60997,25673,2009-07-06,Assembly,"AB 1129 HAGMAN  Concurrence in Senate Amendments",78,0,0,0,78
60998,23826,2009-04-29,Assembly,"Do pass",11,0,0,0,11
60998,23827,2009-05-14,Assembly,"AB 1130 SOLORIO  Assembly Third Reading",74,0,0,0,74
60998,23828,2009-07-15,Senate,"Do pass",7,0,0,0,7
60998,23829,2009-09-11,Senate,"Assembly 3rd Reading AB1130 Solorio By Romero",36,0,0,0,36
60998,23830,2009-09-11,Assembly,"AB 1130 SOLORIO  Concurrence in Senate Amendments",75,0,0,0,75
60999,7741,2009-04-28,Assembly,"Do pass and be re-referred to the Committee on Appropriations",5,2,0,0,7
61000,7756,2009-04-20,Assembly,"Do pass as amended and be re-referred to the Committee on Appropriations",12,0,2,0,14
61000,7757,2009-05-20,Assembly,"Do pass",12,2,2,0,16
61000,7758,2009-05-28,Assembly,"AB 1132 JONES  Assembly Third Reading",76,2,2,0,80
61000,7759,2009-07-07,Senate,"Do pass as amended, and re-refer to the Committee on Appropriations",10,0,1,0,11
61000,7760,2009-09-10,Senate,"Special Consent #21 AB1132 Jones By Runner",40,0,0,0,40
61000,7761,2009-09-11,Assembly,"AB 1132 Jones  Concurrence in Senate Amendments",79,0,0,0,79
61001,7733,2009-04-21,Assembly,"Do pass and be re-referred to the Committee on Public Safety",5,2,0,0,7
61001,7734,2009-04-28,Assembly,"Do pass and be re-referred to the Committee on Appropriations",2,3,2,0,7
61001,7735,2009-04-28,Assembly,"Set first hearing.  Failed passage.  Reconsideration granted",7,0,0,0,7
61001,7736,2010-01-12,Assembly,"Do pass and be re-referred to the Committee on Appropriations",2,5,0,0,7
61002,23760,2009-05-05,Assembly,"Do pass, to Consent Calendar",7,0,0,0,7
61002,23761,2009-05-11,Assembly,"AB 1134 MENDOZA  Consent Calendar Second Day  Regular Session",78,0,0,0,78
61002,23762,2009-06-16,Senate,"Do pass and be placed on the Consent Calendar",5,0,0,0,5
61002,23763,2009-08-24,Senate,"Assembly 3rd Reading AB1134 Mendoza By Hancock",40,0,0,0,40
61003,7727,2009-04-20,Assembly,"Do pass and be re-referred to the Committee on Appropriations",8,5,1,0,14
61004,7710,2009-05-06,Assembly,"Do pass",5,0,1,0,6
61004,7711,2009-05-18,Assembly,"AB 1136 FONG  Assembly Third Reading  Amend By FONG  Set #1",50,25,5,0,80
61004,7712,2009-05-28,Assembly,"Do pass",12,5,0,0,17
61004,7713,2009-06-01,Assembly,"AB 1136 FONG  Assembly Third Reading",52,26,2,0,80
61004,7714,2009-06-22,Senate,"Do pass, but re-refer to the Committee on Public Safety",5,2,0,0,7
61004,7715,2009-08-27,Senate,"Assembly 3rd Reading AB1136 Fong By Correa",25,13,2,0,40
61004,7716,2009-08-31,Assembly,"AB 1136 FONG  Concurrence in Senate Amendments",52,26,1,0,79
61008,7762,2009-05-12,Assembly,"Do pass",11,0,0,0,11
61008,7763,2009-05-28,Assembly,"AB 1140 NIELLO  Assembly Third Reading",80,0,0,0,80
61008,19744,2010-08-09,Senate,"Do pass as amended, and re-refer to the Committee on Appropriations",6,1,0,0,7
61010,25554,2009-04-21,Assembly,"Do pass as amended and be re-referred to the Committee on 	Appropriations",13,4,0,0,17
61010,25555,2009-05-13,Assembly,"Do pass",11,5,0,0,16
61010,25556,2009-05-26,Assembly,"AB 1142 PRICE  Assembly Third Reading",47,29,0,0,76
61010,25557,2009-06-25,Senate,"Do pass as amended, and re-refer to the Committee on Appropriations",8,3,0,0,11
61010,25558,2009-08-24,Senate,"Placed on Appropriations Suspense file",13,0,0,0,13
61010,25559,2009-08-27,Senate,"Do pass as amended",8,5,0,0,13
61010,25560,2009-09-08,Senate,"Assembly 3rd Reading AB1142 Price",26,13,0,0,39
61010,25561,2009-09-10,Assembly,"AB 1142  Concurrence in Senate Amendments By HALL",46,30,0,0,76
61011,25300,2009-05-12,Assembly,"Do pass, to Consent Calendar",10,0,0,0,10
61011,25301,2009-05-18,Assembly,"AB 1143 MA  Assembly Third Reading",75,0,0,0,75
61011,25302,2009-06-23,Senate,"Do pass",5,0,0,0,5
61011,25303,2009-08-17,Senate,"Special Consent #14 AB1143 Ma By Corbett",35,0,0,0,35
61011,25304,2009-08-20,Assembly,"AB 1143 MA  Concurrence in Senate Amendments",76,0,0,0,76
61012,7751,2009-04-21,Assembly,"Do pass as amended and be re-referred to the Committee on Appropriations",14,2,3,0,19
61013,23393,2009-04-21,Assembly,"Do pass and be re-referred to the Committee on Appropriations",11,0,0,0,11
61013,23394,2009-05-28,Assembly,"Do pass",16,1,0,0,17
61013,23395,2009-06-02,Assembly,"AB 1145 PRICE  Assembly Third Reading",71,6,0,0,77
61013,23396,2009-07-06,Senate,"Do pass, but re-refer to the Committee on Appropriations",7,1,0,0,8
61013,23397,2009-08-17,Senate,"Do pass",12,0,0,0,12
61013,23398,2009-09-01,Senate,"Assembly 3rd Reading AB1145 Price",33,3,0,0,36
61015,7740,2009-04-14,Assembly,"Do pass as amended and be re-referred to the Committee on Environmental Safety and Toxic Materials",16,0,3,0,19
61017,25373,2009-05-05,Assembly,"Do pass, to Consent Calendar",7,0,0,0,7
61017,25374,2009-05-11,Assembly,"AB 1149 DAVIS  Consent Calendar Second Day  Regular Session",78,0,0,0,78
61017,25375,2009-06-16,Senate,"Do pass and be placed on the Consent Calendar",5,0,0,0,5
61017,25376,2009-06-22,Senate,"Consent Calendar 2nd AB1149 Davis",40,0,0,0,40
61018,7788,2009-04-27,Assembly,"Do pass and be re-referred to the Committee on Appropriations",3,4,2,0,9
61018,7789,2009-04-27,Assembly,"Set first hearing.  Failed passage.  Reconsideration granted",9,0,0,0,9
61020,2468,2009-05-12,Assembly,"Do pass as amended",11,0,0,0,11
61020,2469,2009-05-26,Assembly,"AB 1152 ANDERSON  Assembly Third Reading",75,0,5,0,80
61020,2470,2009-07-13,Senate,"Do pass as amended",2,5,3,0,10
61020,2471,2009-07-13,Senate,"Set, second hearing.  Failed passage in Committee. Reconsideration granted",9,0,1,0,10
61020,2472,2010-04-27,Senate,"Do pass, but re-refer to the Committee on Appropriations",7,0,4,0,11
61020,8971,2010-06-17,Senate,"Assembly 3rd Reading AB1152 Anderson Urgency Clause",33,0,6,0,39
61020,9219,2010-06-23,Assembly,"Senate amendments be concurred in",21,0,1,0,22
61020,9658,2010-06-28,Assembly,"AB 1152 ANDERSON  Concurrence- Urgency Added",78,0,1,0,79
61021,7826,2009-04-28,Assembly,"Do pass and be re-referred to the Committee on Appropriations",7,0,0,0,7
61022,7827,2009-04-15,Assembly,"Amend, and do pass as amended and be re-referred to the Committee on Arts, Entertain, Sports, Tourism, & Internet Media with the recommendation:  To Consent Calendar",10,0,1,0,11
61022,7828,2009-04-28,Assembly,"Do pass",9,0,0,0,9
61022,7829,2009-04-30,Assembly,"AB 1154 STRICKLAND  Assembly Third Reading",75,0,5,0,80
61023,3771,2010-01-12,Assembly,"Do pass and be re-referred to the Committee on Transportation",7,0,0,0,7
61023,3772,2010-01-14,Assembly,"Do pass and re-refer to Committee on Appropriations with recommendation:  To Consent Calendar",9,0,5,0,14
61023,3773,2010-01-21,Assembly,"Do pass as amended, to Consent Calendar",17,0,0,0,17
61023,3774,2010-01-28,Assembly,"AB 1155 STRICKLAND  Consent Calendar Second Day  Regular Session",73,0,5,0,78
61023,3775,2010-05-04,Senate,"Do pass, but re-refer to the Committee on Appropriations",8,0,1,0,9
61023,9975,2010-07-01,Senate,"Special Consent #29 AB1155 Audra Strickland",34,0,5,0,39
61024,7825,2009-04-20,Assembly,"Do pass as amended and be re-referred to the Committee on Appropriations",10,0,1,0,11
61026,7817,2009-04-15,Assembly,"Do pass",5,2,0,0,7
61026,7818,2009-05-11,Assembly,"AB 1158 HAYASHI  Assembly Third Reading",50,27,3,0,80
61026,7819,2009-07-08,Senate,"Do pass",4,1,0,0,5
61026,7820,2009-08-27,Senate,"Assembly 3rd Reading AB1158 Hayashi By Price",22,14,4,0,40
61026,7821,2009-08-31,Assembly,"AB 1158 HAYASHI  Concurrence in Senate Amendments",49,25,5,0,79
61028,26032,2009-04-20,Assembly,"Do pass as amended and be re-referred to the Committee on Judiciary",8,2,0,0,10
61028,26033,2009-04-28,Assembly,"Do pass as amended and be re-referred to the Committee on 	Appropriations",6,2,0,0,8
61028,26034,2009-05-20,Assembly,"Do pass",10,4,0,0,14
61028,26035,2009-06-08,Assembly,"Do pass as amended",8,2,0,0,10
61028,26036,2009-06-18,Assembly,"AB 1160 FONG  Assembly Third Reading",48,20,0,0,68
61028,26037,2009-07-09,Senate,"Do pass, but re-refer to the Committee on Judiciary",7,3,0,0,10
61028,26038,2009-07-14,Senate,"Do pass as amended, and re-refer to the Committee on 	Appropriations",3,2,0,0,5
61028,26039,2009-08-17,Senate,"Do pass",8,4,0,0,12
61028,26040,2009-09-08,Senate,"Assembly 3rd Reading AB1160 Fong By Corbett",26,14,0,0,40
61028,26041,2009-09-10,Assembly,"AB 1160 FONG  Concurrence in Senate Amendments",54,24,0,0,78
61029,7822,2009-04-22,Assembly,"Do pass and be re-referred to the Committee on Appropriations",4,2,0,0,6
61031,22863,2009-04-21,Assembly,"Do pass, to Consent Calendar",10,0,0,0,10
61031,22864,2009-04-27,Assembly,"AB 1163 TRAN  Consent Calendar Second Day  Regular Session",77,0,0,0,77
61031,22865,2009-06-09,Senate,"Do pass and be placed on the Consent Calendar",5,0,0,0,5
61031,22866,2009-06-15,Senate,"Consent Calendar 2nd AB1163 Tran",36,0,0,0,36
61032,25634,2009-04-14,Assembly,"Do pass, to Consent Calendar",10,0,0,0,10
61032,25635,2009-04-20,Assembly,"AB 1164 TRAN  Consent Calendar Second Day  Regular Session",75,0,0,5,80
61032,25636,2009-06-09,Senate,"Do pass and be placed on the Consent Calendar",5,0,0,0,5
61032,25637,2009-06-15,Senate,"Consent Calendar 2nd AB1164 Tran",36,0,4,0,40
61032,25638,2009-06-22,Assembly,"AB 1164 TRAN  Concurrence in Senate Amendments",74,0,0,5,79
61033,23729,2009-04-28,Assembly,"Do pass and be re-referred to the Committee on Appropriations",13,0,0,0,13
61033,23730,2009-05-20,Assembly,"Do pass, to Consent Calendar",15,0,0,0,15
61033,23731,2009-05-28,Assembly,"AB 1165 YAMADA  Consent Calendar Second Day  Regular Session",76,0,0,0,76
61033,23732,2009-06-23,Senate,"Do pass as amended, but re-refer to the Committee on Appropriations 	Recommend Consent",11,0,0,0,11
61033,23733,2009-08-27,Senate,"Special Consent #16 AB1165 Yamada By Wolk",38,0,0,0,38
61033,23734,2009-08-31,Assembly,"AB 1165 YAMADA  Concurrence in Senate Amendments",78,0,0,0,78
61034,22631,2009-04-21,Assembly,"Do pass and be re-referred to the Committee on Appropriations",7,0,0,0,7
61034,22632,2009-05-06,Assembly,"Do pass, to Consent Calendar",15,0,0,0,15
61034,22633,2009-05-14,Assembly,"AB 1166 NIELSEN  Consent Calendar Second Day  Regular Session",73,0,0,0,73
61034,22634,2009-07-07,Senate,"Do pass as amended, and re-refer to the Committee on Appropriations",7,0,0,0,7
61034,22635,2009-08-24,Senate,"Special Consent #15 AB1166 Nielsen",39,0,0,0,39
61034,22636,2009-08-27,Assembly,"AB 1166 NIELSEN  Concurrence in Senate Amendments",76,1,0,0,77
61037,25932,2009-04-14,Assembly,"Do pass as amended and be re-referred to the Committee on Aging and 	Longterm Care",4,2,0,0,6
61037,25933,2009-04-21,Assembly,"Do pass as amended and be re-referred to the Committee on 	Appropriations",4,2,0,0,6
61037,25934,2009-05-13,Assembly,"Do pass",11,4,0,0,15
61037,25935,2009-05-28,Assembly,"AB 1169 RUSKIN  Assembly Third Reading",51,28,0,0,79
61037,25936,2009-06-23,Senate,"Do pass as amended, and re-refer to the Committee on Appropriations",5,0,0,0,5
61037,25937,2009-07-16,Senate,"Assembly 3rd Reading AB1169 Ruskin By Alquist",35,0,0,0,35
61037,25938,2009-08-20,Assembly,"AB 1169 RUSKIN  Concurrence in Senate Amendments",74,0,0,0,74
61038,7764,2009-04-21,Assembly,"Do pass and be re-referred to the Committee on Appropriations",4,0,3,0,7
61040,25867,2009-05-06,Assembly,"Do pass, to Consent Calendar",7,0,0,0,7
61040,25868,2009-05-14,Assembly,"AB 1172 GALGIANI  Consent Calendar Second Day  Regular Session",73,0,0,0,73
61040,25869,2009-07-08,Senate,"Do pass",3,2,0,0,5
61040,25870,2009-08-27,Senate,"Assembly 3rd Reading AB1172 Galgiani By Wolk",25,12,0,0,37
61040,25871,2009-09-08,Assembly,"Senate amendments be concurred in",7,0,0,0,7
61040,25872,2009-09-09,Assembly,"AB 1172 GALGIANI  Concurrence in Senate Amendments",78,0,0,0,78
61041,7806,2009-04-21,Assembly,"Do pass and be re-referred to the Committee on Utilities and Commerce",5,1,1,0,7
61041,7807,2009-04-27,Assembly,"Do pass as amended and be re-referred to the Committee on Appropriations",12,2,1,0,15
61041,7808,2009-05-28,Assembly,"Do pass",12,5,0,0,17
61041,7809,2009-06-02,Assembly,"AB 1173 HUFFMAN  Assembly Third Reading",51,25,4,0,80
61041,7810,2009-07-06,Senate,"Do pass as amended, and re-refer to the Committee on Appropriations",4,2,1,0,7
61041,7811,2009-08-17,Senate,"Do pass",7,5,1,0,13
61041,7812,2009-09-10,Senate,"Assembly 3rd Reading AB1173 Huffman By DeSaulnier",21,17,2,0,40
61041,7813,2009-09-11,Assembly,"AB 1173 Huffman  Concurrence in Senate Amendments",52,27,0,0,79
61042,7805,2009-04-21,Assembly,"Do pass and be re-referred to the Committee on Appropriations",18,0,1,0,19
61043,24002,2009-04-20,Assembly,"Do pass and be re-referred to the Committee on Appropriations",9,2,0,0,11
61043,24003,2009-05-28,Assembly,"Do pass as amended",12,5,0,0,17
61043,24004,2009-06-03,Assembly,"AB 1175 TORLAKSON  Assembly Third Reading",49,29,0,0,78
61043,24005,2009-07-07,Senate,"Do pass, but re-refer to the Committee on Appropriations",5,5,0,0,10
61043,24006,2009-07-07,Senate,"Set, first hearing.  Failed passage in Committee.  Reconsideration 	granted",9,0,0,0,9
61043,24007,2009-07-14,Senate,"Do pass as amended, and re-refer to the Committee on Appropriations",9,2,0,0,11
61043,24008,2009-08-24,Senate,"Placed on Appropriations Suspense file",13,0,0,0,13
61043,24009,2009-08-27,Senate,"Do pass",11,2,0,0,13
61043,24010,2009-09-03,Senate,"Assembly 3rd Reading AB1175 Torlakson By DeSaulnier",30,5,0,0,35
61043,24011,2009-09-09,Assembly,"AB 1175 TORLAKSON  Concurrence in Senate Amendments",77,0,0,0,77
61044,7798,2009-04-29,Assembly,"Do pass",7,0,0,0,7
61044,7799,2009-05-11,Assembly,"AB 1176 AMMIANO  Assembly Third Reading",80,0,0,0,80
61044,7800,2009-06-17,Senate,"Do pass, but re-refer to the Committee on Rules",5,0,0,0,5
61044,7801,2009-08-17,Senate,"Placed on Appropriations Suspense file",13,0,0,0,13
61044,7802,2009-08-27,Senate,"Do pass",12,0,1,0,13
61044,7803,2009-09-04,Senate,"Assembly 3rd Reading AB1176 Ammiano By Leno",40,0,0,0,40
61044,7804,2009-09-10,Assembly,"AB 1176 AMMIANO  Concurrence in Senate Amendments",78,0,2,0,80
61045,7791,2009-04-21,Assembly,"Do pass and be re-referred to the Committee on Human Services",7,4,0,0,11
61045,7792,2009-04-28,Assembly,"Do pass and be re-referred to the Committee on Appropriations",5,2,0,0,7
61045,7793,2009-05-28,Assembly,"Do pass as amended",12,5,0,0,17
61045,7794,2009-06-03,Assembly,"AB 1177 FONG  Assembly Third Reading",49,29,2,0,80
61045,7795,2009-06-23,Senate,"Do pass, but re-refer to the Committee on Transportation and Housing",4,1,0,0,5
61045,7796,2009-07-07,Senate,"Do pass as amended, and re-refer to the Committee on Appropriations",6,4,1,0,11
61045,7797,2009-08-17,Senate,"Placed on Appropriations Suspense file",13,0,0,0,13
61046,3587,2010-01-11,Assembly,"Do pass as amended and be re-referred to the Committee on Appropriations",5,3,1,0,9
61046,3588,2010-01-21,Assembly,"Do pass as amended",12,5,0,0,17
61046,3589,2010-01-27,Assembly,"AB 1178 BLOCK  Assembly Third Reading",39,29,10,0,78
61046,3590,2010-01-28,Assembly,"AB 1178 BLOCK  Motion to Reconsider",44,24,10,0,78
61046,3591,2010-01-28,Assembly,"AB 1178 BLOCK  Assembly Third Reading",42,28,8,0,78
61046,19789,2010-08-11,Senate,"Do pass, but re-refer to the Committee on Appropriations",3,1,0,0,4
61046,20130,2010-08-12,Senate,"Placed on Appropriations Suspense file",11,0,0,0,11
61047,25796,2009-04-22,Assembly,"Do pass as amended",10,0,0,0,10
61047,25797,2009-04-30,Assembly,"AB 1179 JONES  Assembly Third Reading",75,0,0,0,75
61047,25798,2009-06-17,Senate,"Do pass",11,0,0,0,11
61047,25799,2009-06-24,Senate,"Special Consent #10 AB1179 Jones",40,0,0,0,40
61049,27180,2009-04-21,Assembly,"Do pass as amended and be re-referred to the Committee on 	Appropriations",6,1,0,0,7
61049,27181,2009-05-13,Assembly,"Do pass",14,2,0,0,16
61049,27182,2009-05-28,Assembly,"AB 1181 HUBER  Assembly Third Reading",76,1,0,0,77
61049,27183,2009-07-07,Senate,"Do pass, but re-refer to the Committee on Appropriations",4,1,0,0,5
61049,27184,2010-04-15,Senate,"Assembly 3rd Reading AB1181 Huber By Strickland",27,9,0,0,36
61049,27185,2010-04-22,Assembly,"AB 1181 HUBER  Concurrence in Senate Amendments",71,0,0,0,71
61050,25289,2009-04-21,Assembly,"Do pass and re-refer to Committee on Appropriations with 	recommendation:  To Consent Calendar",9,0,0,0,9
61050,25290,2009-05-06,Assembly,"Do pass, to Consent Calendar",16,0,0,0,16
61050,25291,2009-05-14,Assembly,"AB 1182 BROWNLEY  Consent Calendar Second Day  Regular Session",73,0,0,0,73
61050,25292,2009-06-17,Senate,"Do pass, but re-refer to the Committee on Appropriations",8,0,0,0,8
61050,25293,2009-09-09,Senate,"Assembly 3rd Reading AB1182 Brownley By Simitian",37,0,0,0,37
61050,25294,2009-09-11,Assembly,"AB 1182 BROWNLEY  Concurrence in Senate Amendments",78,0,0,0,78
61052,7851,2009-05-11,Assembly,"Do pass, to Consent Calendar",14,0,1,0,15
61052,7852,2009-05-18,Assembly,"AB 1184 ADAMS  Consent Calendar Second Day  Regular Session",77,0,3,0,80
61052,7853,2009-07-07,Senate,"Do pass as amended",11,0,0,0,11
61052,7854,2009-08-24,Senate,"Placed on Appropriations Suspense file",13,0,0,0,13
61053,7844,2009-05-12,Assembly,"Do pass",7,3,0,0,10
61053,7845,2009-05-21,Assembly,"AB 1185 LIEU  Assembly Third Reading",48,30,2,0,80
61053,7846,2009-06-16,Senate,"Do pass",3,2,0,0,5
61053,7847,2009-09-01,Senate,"Assembly 3rd Reading AB1185 Lieu By Padilla",23,14,3,0,40
61054,7861,2009-05-11,Assembly,"Do pass",9,4,1,0,14
61054,7862,2009-06-01,Assembly,"AB 1186 BLUMENFIELD  Assembly Third Reading",57,20,3,0,80
61054,7863,2009-06-22,Senate,"Do pass as amended, and re-refer to the Committee on Transportation and Housing",5,2,0,0,7
61054,7864,2009-07-07,Senate,"Do pass",6,4,1,0,11
61054,7865,2009-09-03,Senate,"Assembly 3rd Reading AB1186 Blumenfield By Lowenthal",22,17,1,0,40
61054,7866,2009-09-09,Assembly,"AB 1186 BLUMENFIELD  Concurrence in Senate Amendments",49,28,2,0,79
61056,23460,2009-04-28,Assembly,"Do pass and re-refer to Committee on Appropriations with 	recommendation:  To Consent Calendar",7,0,0,0,7
61056,23461,2009-05-28,Assembly,"Do pass",17,0,0,0,17
61056,23462,2009-06-01,Assembly,"AB 1188 RUSKIN  Assembly Third Reading",78,0,0,0,78
61056,23463,2009-09-08,Senate,"Do pass, but re-refer to the Committee on Appropriations",5,0,0,0,5
61056,23464,2009-09-11,Senate,"Do pass",10,1,0,0,11
61056,23465,2009-10-14,Senate,"Assembly 3rd Reading AB1188 Ruskin Suspend Joint Rules",38,0,0,0,38
61056,23466,2009-10-14,Senate,"Assembly 3rd Reading AB1188 Ruskin Urgency Clause",35,2,0,0,37
61056,23467,2009-10-26,Assembly,"Senate amendments be concurred in",7,0,0,0,7
61056,23468,2009-10-26,Assembly,"AB 1188 Ruskin  Concurrence- Urgency Added",70,1,0,0,71
61057,7858,2009-04-14,Assembly,"Do pass and be re-referred to the Committee on Transportation",9,3,1,0,13
61057,7859,2009-04-27,Assembly,"Do pass as amended and be re-referred to the Committee on Appropriations",7,5,2,0,14
61057,7860,2009-04-27,Assembly,"Set first hearing.  Failed passage.  Reconsideration granted",14,0,0,0,14
61059,25424,2009-04-30,Assembly,"Do pass and be re-referred to the Committee on Appropriations",16,0,0,0,16
61059,25425,2009-05-18,Assembly,"AB 1191 CONWAY  Assembly Third Reading",77,0,0,0,77
61059,25426,2009-06-23,Senate,"Do pass",12,0,0,0,12
61059,25427,2009-07-09,Senate,"Special Consent #12 AB1191 Conway",34,0,0,0,34
61059,25428,2009-07-13,Assembly,"AB 1191 CONWAY  Concurrence in Senate Amendments",77,0,0,0,77
61063,7856,2009-04-13,Assembly,"Be referred to Committee on Education",9,0,2,0,11
61063,7857,2009-04-29,Assembly,"Do pass and be re-referred to the Committee on Appropriations",8,1,2,0,11
61064,23510,2009-04-21,Assembly,"Do pass and be re-referred to the Committee on Appropriations",8,0,0,0,8
61064,23511,2009-05-06,Assembly,"Do pass",12,4,0,0,16
61064,23512,2009-06-01,Assembly,"AB 1196 BLUMENFIELD  Assembly Third Reading",53,23,0,0,76
61064,23513,2009-07-14,Senate,"Do pass as amended, and re-refer to the Committee on 	Appropriations",3,2,0,0,5
61064,23514,2009-09-08,Senate,"Assembly 3rd Reading AB1196 Blumenfield By Corbett",28,12,0,0,40
61064,23515,2009-09-10,Assembly,"AB 1196 BLUMENFIELD  Concurrence in Senate Amendments",53,24,0,0,77
61065,7855,2009-04-22,Assembly,"Do pass and be re-referred to the Committee on Appropriations",14,0,5,0,19
61066,7831,2009-04-28,Assembly,"Do pass and be re-referred to the Committee on Appropriations",5,2,0,0,7
61066,7832,2009-05-20,Assembly,"Do pass",11,4,1,0,16
61066,7833,2009-05-28,Assembly,"AB 1198 SWANSON  Assembly Third Reading",45,31,4,0,80
61066,7834,2009-06-23,Senate,"Do pass, but re-refer to the Committee on Appropriations",3,2,0,0,5
61066,7835,2009-07-13,Senate,"Placed on Appropriations Suspense file",12,0,1,0,13
61067,3453,2010-01-07,Assembly,"Be referred to Committee on Local Government",10,0,1,0,11
61067,3454,2010-01-07,Assembly,"Be referred to Committee on Appropriations",10,0,1,0,11
61067,3455,2010-01-13,Assembly,"Do pass and be re-referred to the Committee on Appropriations",5,0,2,0,7
61067,3456,2010-01-21,Assembly,"Do pass",12,5,0,0,17
61067,3457,2010-01-27,Assembly,"AB 1199 AMMIANO  Assembly Third Reading",70,2,6,0,78
61067,3458,2010-04-07,Senate,"Do pass, but re-refer to the Committee on Appropriations Recommend Consent",5,0,0,0,5
61067,9696,2010-06-28,Senate,"Placed on Appropriations Suspense file",10,0,1,0,11
61067,20163,2010-08-12,Senate,"Do pass",11,0,0,0,11
61067,21486,2010-08-25,Senate,"Assembly 3rd Reading AB1199 Ammiano By Leno",30,0,0,0,30
61068,22727,2009-05-06,Assembly,"Do pass",10,0,0,0,10
61068,22728,2009-06-01,Assembly,"AB 1200 HAYASHI  Assembly Third Reading",78,0,0,0,78
61068,22729,2009-07-09,Senate,"Do pass as amended",8,1,0,0,9
61068,22730,2009-08-24,Senate,"Assembly 3rd Reading AB1200 Hayashi By Calderon",19,17,0,0,36
61068,22731,2009-08-24,Senate,"Assembly 3rd Reading AB1200 Hayashi Reconsider",39,0,0,0,39
61068,22732,2009-09-04,Senate,"Assembly 3rd Reading AB1200 Hayashi By Calderon",21,17,0,0,38
61068,22733,2009-09-09,Assembly,"AB 1200 HAYASHI  Concurrence in Senate Amendments",42,19,0,0,61
61069,7830,2009-04-21,Assembly,"Do pass as amended and be re-referred to the Committee on Appropriations",12,1,6,0,19
61071,23446,2009-04-30,Assembly,"Do pass and re-refer to Committee on Appropriations with 	recommendation:  To Consent Calendar",16,0,0,0,16
61071,23447,2009-05-13,Assembly,"Do pass",16,0,0,0,16
61071,23448,2009-05-28,Assembly,"AB 1203 MA  Assembly Third Reading",80,0,0,0,80
61071,23449,2009-07-07,Senate,"Do pass, but re-refer to the Committee on Appropriations",10,0,0,0,10
61071,23450,2009-08-24,Senate,"Special Consent #15 AB1203 Ma By Yee",39,0,0,0,39
61072,7838,2009-04-20,Assembly,"Be referred to Committee on Local Government",10,0,1,0,11
61072,7839,2010-01-13,Assembly,"Do pass as amended and be re-referred to the Committee on Appropriations",5,0,2,0,7
61072,7840,2010-01-21,Assembly,"Do pass, to Consent Calendar",17,0,0,0,17
61072,7841,2010-01-27,Assembly,"AB 1204 HUBER  Consent Calendar Second Day  Regular Session",68,0,10,0,78
61072,9059,2010-06-15,Senate,"Do pass, but re-refer to the Committee on Rules",6,1,2,0,9
61072,10241,2010-06-30,Senate,"Do pass, but re-refer to the Committee on Appropriations",4,1,0,0,5
61072,20774,2010-08-20,Senate,"Assembly 3rd Reading AB1204 Huber By Kehoe",26,5,0,0,31
61073,7836,2009-04-20,Assembly,"Do pass and be re-referred to the Committee on Appropriations",4,7,3,0,14
61073,7837,2009-04-20,Assembly,"Set first hearing.  Failed passage.  Reconsideration granted",14,0,0,0,14
61077,25621,2009-05-12,Assembly,"Do pass",7,0,0,0,7
61077,25622,2009-06-03,Assembly,"AB 1209 MA  Assembly Third Reading",78,0,0,0,78
61077,25623,2009-07-14,Senate,"Do pass",7,0,0,0,7
61077,25624,2009-08-24,Senate,"Special Consent #15 AB1209 Ma By Wright",39,0,0,0,39
61077,25625,2009-08-27,Assembly,"AB 1209 MA  Concurrence in Senate Amendments",77,0,0,0,77
61081,7875,2009-04-22,Assembly,"Do pass and be re-referred to the Committee on Appropriations",6,0,1,0,7
61081,7876,2009-05-06,Assembly,"Do pass",11,0,5,0,16
61081,7877,2009-05-14,Assembly,"AB 1213 SKINNER  Assembly Third Reading",63,1,16,0,80
61081,9551,2010-06-23,Senate,"Do pass, but re-refer to the Committee on Appropriations",4,1,1,0,6
61081,21231,2010-08-24,Senate,"Assembly 3rd Reading AB1213 Skinner By Huff",34,0,0,0,34
61082,23481,2009-04-22,Assembly,"Do pass, to Consent Calendar",10,0,0,0,10
61082,23482,2009-05-04,Assembly,"AB 1214 NAVA  Consent Calendar Second Day  Regular Session",79,0,0,0,79
61082,23483,2009-06-17,Senate,"Do pass as amended",11,0,0,0,11
61082,23484,2009-08-24,Senate,"Special Consent #15 AB1214 Nava By Lowenthal",39,0,0,0,39
61082,23485,2009-08-27,Assembly,"AB 1214 NAVA  Concurrence in Senate Amendments",77,0,0,0,77
61083,7878,2009-05-05,Assembly,"Do pass as amended, to Consent Calendar",9,0,0,0,9
61083,7879,2009-05-18,Assembly,"AB 1215 DE LA TORRE  Consent Calendar Second Day  Regular Session",77,0,3,0,80
61083,7880,2009-07-01,Senate,"Do pass and be placed on the Consent Calendar",8,0,1,0,9
61083,10351,2010-06-28,Senate,"Do pass, but re-refer to the Committee on Appropriations",4,2,0,0,6
61083,11018,2010-07-15,Senate,"Placed on Appropriations Suspense file",8,0,2,0,10
61083,20277,2010-08-12,Senate,"Do pass as amended",7,4,0,0,11
61084,23545,2009-04-29,Assembly,"Do pass as amended and re-refer to Committee on Appropriations 	with recommendation:  To Consent Calendar",8,0,0,0,8
61084,23546,2009-05-13,Assembly,"Do pass, to Consent Calendar",16,0,0,0,16
61084,23547,2009-05-21,Assembly,"AB 1216 EVANS  Consent Calendar Second Day  Regular Session",77,0,0,0,77
61084,23548,2009-07-07,Senate,"Do pass as amended, and re-refer to the Committee on 	Appropriations",3,1,0,0,4
61084,23549,2009-08-31,Senate,"Assembly 3rd Reading AB1216 Evans By Maldonado",25,9,0,0,34
61084,23550,2009-09-02,Assembly,"AB 1216 EVANS  Concurrence in Senate Amendments",77,0,0,0,77
61085,23243,2009-04-28,Assembly,"Do pass and be re-referred to the Committee on Appropriations",9,3,0,0,12
61085,23244,2009-05-28,Assembly,"Do pass",12,4,0,0,16
61085,23245,2009-06-01,Assembly,"AB 1217 MONNING  Assembly Third Reading",51,27,0,0,78
61085,23246,2009-06-23,Senate,"Do pass as amended, and re-refer to the Committee on Appropriations",7,4,0,0,11
61085,23247,2009-07-06,Senate,"Placed on Appropriations Suspense file",11,0,0,0,11
61085,23248,2009-08-27,Senate,"Do pass as amended",8,5,0,0,13
61085,23249,2009-09-02,Senate,"Assembly 3rd Reading AB1217 Monning By Simitian",23,12,0,0,35
61085,23250,2009-09-08,Assembly,"AB 1217 MONNING  Concurrence in Senate Amendments",52,26,0,0,78
61086,7896,2009-04-28,Assembly,"Do pass and be re-referred to the Committee on Appropriations",7,6,6,0,19
61086,7897,2009-04-28,Assembly,"Set second hearing.  Failed passage.  Reconsideration granted",19,0,0,0,19
61087,26280,2009-04-20,Assembly,"Do pass as amended",10,1,0,0,11
61087,26281,2009-05-11,Assembly,"AB 1219 EVANS  Assembly Third Reading",56,22,0,0,78
61087,26282,2009-07-07,Senate,"Do pass",8,1,0,0,9
61087,26283,2009-07-16,Senate,"Assembly 3rd Reading AB1219 Evans By Wolk",26,9,0,0,35
61088,7908,2009-04-13,Assembly,"Do pass and be re-referred to the Committee on Appropriations",8,5,1,0,14
61090,7901,2009-04-21,Assembly,"Do pass and be re-referred to the Committee on Judiciary",9,0,0,0,9
61090,7902,2009-04-27,Assembly,"Do pass as amended and re-refer to Committee on Appropriations with recommendation:  To Consent Calendar",10,0,0,0,10
61090,7903,2009-05-20,Assembly,"Do pass, to Consent Calendar",15,0,1,0,16
61090,7904,2009-05-28,Assembly,"AB 1222 LOWENTHAL  Consent Calendar Second Day  Regular Session",76,0,4,0,80
61090,7905,2009-06-23,Senate,"Do pass as amended, and re-refer to the Committee on Appropriations",5,0,0,0,5
61090,7906,2009-08-24,Senate,"Special Consent #15 AB1222 Bonnie Lowenthal",39,0,1,0,40
61090,7907,2009-08-27,Assembly,"AB 1222 LOWENTHAL  Concurrence in Senate Amendments",77,0,2,0,79
61091,7898,2010-01-13,Assembly,"Do pass as amended and be re-referred to the Committee on Appropriations",7,2,2,0,11
61091,7899,2010-01-21,Assembly,"Do pass as amended",12,4,1,0,17
61091,7900,2010-01-27,Assembly,"AB 1223 BLOCK  Assembly Third Reading",44,26,8,0,78
61091,8845,2010-06-16,Senate,"Do pass, but re-refer to the Committee on Appropriations",4,2,3,0,9
61091,8846,2010-06-16,Senate,"Set, first hearing.  Failed passage in Committee.  Reconsideration granted",6,0,3,0,9
61091,9454,2010-06-23,Senate,"Do pass, but re-refer to the Committee on Appropriations",5,2,2,0,9
61091,20809,2010-08-23,Senate,"Assembly 3rd Reading AB1223 Block By Hancock",21,11,0,0,32
61091,20975,2010-08-24,Assembly,"AB 1223 BLOCK  Concurrence in Senate Amendments",50,25,0,0,75
61092,8380,2009-04-27,Assembly,"Do pass and be re-referred to the Committee on Appropriations",5,2,7,0,14
61092,8381,2009-04-27,Assembly,"Set first hearing.  Failed passage.  Reconsideration granted",14,0,0,0,14
61092,8382,2010-01-11,Assembly,"Do pass and re-refer to Committee on Appropriations with recommendation:  To Consent Calendar",14,0,0,0,14
61092,8383,2010-01-21,Assembly,"Do pass, to Consent Calendar",17,0,0,0,17
61092,8384,2010-01-27,Assembly,"AB 1224 ENG  Consent Calendar Second Day  Regular Session",68,0,10,0,78
61092,9070,2010-06-15,Senate,"Do pass, but re-refer to the Committee on Appropriations",8,0,1,0,9
61092,19739,2010-08-09,Senate,"Special Consent #30 AB1224 Eng By Price",34,0,0,0,34
61092,21056,2010-08-23,Assembly,"Senate amendments be concurred in",9,1,0,0,10
61092,21213,2010-08-25,Assembly,"AB 1224 ENG  Concurrence in Senate Amendments",54,22,0,0,76
61093,7887,2010-01-07,Assembly,"Be referred to Committee on Health",10,0,1,0,11
61093,7888,2010-01-12,Assembly,"Do pass and be re-referred to the Committee on Appropriations",14,1,4,0,19
61093,7889,2010-01-21,Assembly,"Do pass as amended",12,5,0,0,17
61093,7890,2010-01-27,Assembly,"AB 1225 DE LA TORRE  Assembly Third Reading",46,22,10,0,78
61093,9426,2010-06-23,Senate,"Do pass, but re-refer to the Committee on Appropriations",6,0,3,0,9
61093,21629,2010-08-26,Senate,"Assembly 3rd Reading AB1225 De La Torre By Negrete McLeod",21,11,0,0,32
61095,23540,2009-05-06,Assembly,"Do pass",7,3,0,0,10
61095,23541,2009-05-18,Assembly,"AB 1227 FEUER  Assembly Third Reading",48,28,0,0,76
61095,23542,2009-06-25,Senate,"Do pass",5,1,0,0,6
61095,23543,2009-09-09,Senate,"Assembly 3rd Reading AB1227 Feuer By DeSaulnier",26,8,0,0,34
61095,23544,2009-09-10,Assembly,"AB 1227 Feuer  Concurrence in Senate Amendments",51,21,0,0,72
61096,7891,2009-05-05,Assembly,"Do pass as amended",5,0,2,0,7
61096,7892,2009-05-18,Assembly,"AB 1228 YAMADA  Assembly Third Reading",48,27,5,0,80
61096,7893,2009-07-07,Senate,"Do pass",3,2,0,0,5
61096,7894,2009-09-01,Senate,"Assembly 3rd Reading AB1228 Yamada By Wolk",21,17,2,0,40
61096,7895,2009-09-08,Assembly,"AB 1228 YAMADA  Concurrence in Senate Amendments",50,28,1,0,79
61097,7867,2010-01-07,Assembly,"Be referred to Committee on Judiciary",10,0,1,0,11
61097,7868,2010-01-12,Assembly,"Do pass and re-refer to Committee on Appropriations with recommendation:  To Consent Calendar",9,0,0,0,9
61097,7869,2010-01-21,Assembly,"Do pass, to Consent Calendar",17,0,0,0,17
61097,7870,2010-01-27,Assembly,"AB 1229 EVANS  Consent Calendar Second Day  Regular Session",68,0,10,0,78
61097,7871,2010-06-10,Senate,"Do pass, but re-refer to the Committee on Appropriations",3,2,0,0,5
61097,20642,2010-08-18,Senate,"Assembly 3rd Reading AB1229 Evans By Liu",22,12,0,0,34
61097,20643,2010-08-19,Assembly,"AB 1229 EVANS  Concurrence in Senate Amendments",78,0,0,0,78
61098,7872,2009-04-21,Assembly,"Do pass and be re-referred to the Committee on Appropriations",9,0,0,0,9
61099,7873,2009-04-15,Assembly,"Do pass as amended and be re-referred to the Committee on Appropriations",8,2,1,0,11
61100,22534,2009-05-13,Assembly,"Do pass",5,2,0,0,7
61100,22535,2009-05-21,Assembly,"AB 1232 HUFFMAN  Assembly Third Reading",48,27,0,0,75
61100,22536,2009-07-08,Senate,"Do pass",3,2,0,0,5
61100,22537,2009-08-27,Senate,"Assembly 3rd Reading AB1232 Huffman By Leno",22,16,0,0,38
61100,22538,2009-08-31,Assembly,"AB 1232 HUFFMAN  Concurrence in Senate Amendments",47,30,0,0,77
61101,23475,2009-05-04,Assembly,"Do pass and be re-referred to the Committee on Judiciary to Consent 	Calendar",9,0,0,2,11
61101,23476,2009-05-12,Assembly,"Do pass, to Consent Calendar",10,0,0,0,10
61101,23477,2009-05-18,Assembly,"AB 1233 SILVA  Consent Calendar Second Day  Regular Session",77,0,0,3,80
61101,23478,2009-07-07,Senate,"Do pass and be placed on the Consent Calendar",5,0,0,0,5
61101,23479,2009-08-24,Senate,"Special Consent #15 AB1233 Silva",39,0,1,0,40
61101,23480,2009-08-27,Assembly,"AB 1233 SILVA  Concurrence in Senate Amendments",77,0,0,2,79
61102,7886,2009-04-27,Assembly,"Do pass as amended and be re-referred to the Committee on Appropriations",6,3,0,0,9
61103,7881,2009-05-13,Assembly,"Do pass as amended",5,0,2,0,7
61103,7882,2009-05-28,Assembly,"Do pass",13,4,0,0,17
61103,7883,2009-06-01,Assembly,"AB 1235 HAYASHI  Assembly Third Reading",51,22,7,0,80
61103,7884,2009-07-15,Senate,"Do pass as amended, and re-refer to the Committee on Appropriations",8,0,3,0,11
61103,7885,2010-03-22,Senate,"Do pass",8,0,1,0,9
61103,20745,2010-08-18,Senate,"Assembly 3rd Reading AB1235 Hayashi By Aanestad",33,0,0,0,33
61103,20746,2010-08-19,Assembly,"AB 1235 HAYASHI  Concurrence in Senate Amendments",74,0,0,0,74
61106,7874,2009-04-29,Assembly,"Do pass as amended and be re-referred to the Committee on Appropriations",8,3,0,0,11
61107,1229,2010-01-12,Assembly,"Do pass and be re-referred to the Committee on Appropriations.",7,0,0,0,7
61107,1230,2010-01-21,Assembly,"Do pass as amended.",12,5,0,0,17
61107,1231,2010-01-27,Assembly,"AB 1239 SOLORIO  Assembly Third Reading",68,2,8,0,78
61107,8815,2010-06-15,Senate,"Do pass, but re-refer to the Committee on Appropriations",7,0,0,0,7
61107,9799,2010-06-28,Senate,"Placed on Appropriations Suspense file",10,0,1,0,11
61107,20178,2010-08-12,Senate,"Do pass",10,1,0,0,11
61107,20911,2010-08-23,Senate,"Assembly 3rd Reading AB1239 Solorio By Huff",30,5,0,0,35
61107,21034,2010-08-24,Assembly,"AB 1239 SOLORIO  Concurrence in Senate Amendments",74,1,0,0,75
61108,24044,2009-04-21,Assembly,"Do pass as amended and be re-referred to the Committee on 	Appropriations",9,0,0,0,9
61108,24045,2009-05-13,Assembly,"Do pass, to Consent Calendar",16,0,0,0,16
61108,24046,2009-05-21,Assembly,"AB 1240 DAVIS  Consent Calendar Second Day  Regular Session",77,0,0,0,77
61108,24047,2009-07-15,Senate,"Do pass as amended, and re-refer to the Committee on Appropriations",8,0,0,0,8
61108,24048,2009-08-27,Senate,"Special Consent #16 AB1240 Davis By Wright",38,0,0,0,38
61108,24049,2009-09-01,Assembly,"AB 1240 DAVIS  Concurrence in Senate Amendments",78,0,0,0,78
61110,7909,2009-04-28,Assembly,"Do pass as amended and be re-referred to the Committee on Appropriations",9,3,1,0,13
61110,7910,2009-05-20,Assembly,"Do pass",12,2,2,0,16
61110,7911,2009-05-28,Assembly,"AB 1242 RUSKIN  Assembly Third Reading",54,25,1,0,80
61110,7912,2009-07-06,Senate,"Do pass, but re-refer to the Committee on Appropriations",7,3,1,0,11
61110,7913,2009-08-17,Senate,"Placed on Appropriations Suspense file",13,0,0,0,13
61110,7914,2009-08-27,Senate,"Do pass as amended",8,5,0,0,13
61110,7915,2009-09-09,Senate,"Assembly 3rd Reading AB1242 Ruskin By Negrete McLeod",23,14,3,0,40
61110,7916,2009-09-10,Assembly,"AB 1242 Ruskin  Concurrence in Senate Amendments",53,24,3,0,80
61111,7917,2009-04-27,Assembly,"Do pass and be re-referred to the Committee on Appropriations",12,0,2,0,14
61111,7918,2009-05-28,Assembly,"Do pass as amended",12,4,1,0,17
61111,7919,2009-06-02,Assembly,"AB 1243 LOWENTHAL  Assembly Third Reading",64,11,5,0,80
61111,7920,2009-07-07,Senate,"Do pass as amended, and re-refer to the Committee on Appropriations",10,0,1,0,11
61111,7921,2009-08-24,Senate,"Placed on Appropriations Suspense file",13,0,0,0,13
61112,7936,2010-01-12,Assembly,"Do pass as amended and be re-referred to the Committee on Appropriations",7,0,0,0,7
61113,23419,2009-04-22,Assembly,"Do pass and be re-referred to the Committee on Judiciary to Consent 	Calendar",16,0,0,0,16
61113,23420,2009-04-27,Assembly,"Do pass and re-refer to Committee on Appropriations with 	recommendation:  To Consent Calendar",10,0,0,0,10
61113,23421,2009-05-13,Assembly,"Do pass, to Consent Calendar",16,0,0,0,16
61113,23422,2009-05-21,Assembly,"AB 1245 MONNING  Consent Calendar Second Day  Regular Session",77,0,0,0,77
61113,23423,2009-06-23,Senate,"Do pass as amended, and re-refer to the Committee on 	Appropriations",5,0,0,0,5
61113,23424,2009-08-27,Senate,"Assembly 3rd Reading AB1245 Monning By Harman",34,3,0,0,37
61113,23425,2009-08-31,Assembly,"AB 1245 MONNING  Concurrence in Senate Amendments",78,0,0,0,78
61114,27083,2009-04-29,Assembly,"Do pass as amended and be re-referred to the Committee on Judiciary",7,0,0,0,7
61114,27084,2009-05-12,Assembly,"Do pass, to Consent Calendar",10,0,0,0,10
61114,27085,2009-05-18,Assembly,"AB 1246 JONES  Consent Calendar Second Day  Regular Session",77,0,0,0,77
61114,27086,2009-07-07,Senate,"Do pass as amended",10,0,0,0,10
61114,27087,2009-08-17,Senate,"Special Consent #14 AB1246 Jones",35,0,0,0,35
61114,27088,2009-08-24,Assembly,"AB 1246 JONES  Concurrence in Senate Amendments",77,0,0,0,77
61117,23491,2009-04-29,Assembly,"Do pass and re-refer to Committee on Appropriations with 	recommendation:  To Consent Calendar",8,0,0,0,8
61117,23492,2009-05-13,Assembly,"Do pass, to Consent Calendar",16,0,0,0,16
61117,23493,2009-05-21,Assembly,"AB 1249 GALGIANI  Consent Calendar Second Day  Regular Session",77,0,0,0,77
61117,23494,2009-07-07,Senate,"Do pass, but re-refer to the Committee on Appropriations",5,0,0,0,5
61117,23495,2009-08-17,Senate,"Do pass",10,0,0,0,10
61117,23496,2009-09-01,Senate,"Assembly 3rd Reading AB1249 Galgiani By Cogdill",32,0,0,0,32
61117,23497,2009-09-03,Assembly,"AB 1249 GALGIANI  Concurrence in Senate Amendments",69,4,0,0,73
61119,7939,2009-04-16,Assembly,"Be referred to Committee on Revenue and Taxation",10,0,1,0,11
61120,7945,2009-04-27,Assembly,"Do pass as amended and be re-referred to the Committee on Appropriations",6,3,0,0,9
61121,7940,2009-04-28,Assembly,"Do pass as amended and be re-referred to the Committee on Appropriations",8,1,4,0,13
61121,7941,2009-05-28,Assembly,"Do pass as amended",16,0,1,0,17
61121,7942,2009-06-02,Assembly,"AB 1253 FULLER  Assembly Third Reading",71,3,6,0,80
61121,7943,2009-07-06,Senate,"Do pass as amended, and re-refer to the Committee on Appropriations",9,0,2,0,11
61121,7944,2009-08-17,Senate,"Placed on Appropriations Suspense file",13,0,0,0,13
61122,3848,2010-01-12,Assembly,"Do pass as amended and be re-referred to the Committee on Appropriations",11,0,1,0,12
61122,3849,2010-01-21,Assembly,"Do pass as amended",17,0,0,0,17
61122,3850,2010-01-27,Assembly,"AB 1254 BERRYHILL, T.  Assembly Third Reading",72,1,5,0,78
61122,10171,2010-06-29,Senate,"Do pass, but re-refer to the Committee on Appropriations Recommend Consent",9,0,0,0,9
61122,20414,2010-08-18,Senate,"Assembly 3rd Reading AB1254 Tom Berryhill By Wolk",34,0,0,0,34
61122,20671,2010-08-20,Assembly,"AB 1254 BERRYHILL, T.  Concurrence in Senate Amendments",76,0,0,0,76
61122,21058,2010-08-24,Assembly,"AB 1254 BERRYHILL, T.  Concurrence in Senate Amendments",76,0,0,0,76
61123,23990,2009-04-15,Assembly,"Do pass and be re-referred to the Committee on Appropriations",8,0,0,0,8
61123,23991,2009-04-29,Assembly,"Do pass",16,0,0,0,16
61123,23992,2009-05-18,Assembly,"AB 1255 BERRYHILL, T.  Assembly Third Reading",76,0,0,0,76
61123,23993,2009-07-07,Senate,"Do pass as amended, and re-refer to the Committee on 	Appropriations",5,0,0,0,5
61123,23994,2009-08-17,Senate,"Do pass",12,0,0,0,12
61123,23995,2009-08-27,Senate,"Special Consent #16 AB1255 Tom Berryhill",38,0,0,0,38
61123,23996,2009-08-31,Assembly,"AB 1255 BERRYHILL, T.  Concurrence in Senate Amendments",74,0,0,0,74
61126,7922,2009-04-15,Assembly,"Do pass and be re-referred to the Committee on Appropriations",10,0,1,0,11
61127,7923,2009-04-21,Assembly,"Do pass and be re-referred to the Committee on Appropriations",4,2,0,0,6
61128,7924,2009-04-28,Assembly,"Do pass",8,2,1,0,11
61128,7925,2009-05-11,Assembly,"AB 1260 HUFFMAN  Assembly Third Reading",62,16,2,0,80
61128,7926,2009-07-06,Senate,"Do pass",9,0,1,0,10
61128,7927,2009-09-10,Senate,"Do pass, but re-refer to the Committee on Appropriations",4,0,1,0,5
61128,19669,2010-08-09,Assembly,"Senate amendments be concurred in",9,3,0,0,12
61128,19670,2010-08-09,Senate,"Do pass as amended",7,1,0,0,8
61128,19671,2010-08-09,Senate,"W/O REF. TO FILE AB1260 Fuller By Huff",26,5,0,0,31
61128,19672,2010-08-09,Assembly,"AB 1260 FULLER  Concurrence in Senate Amendments",45,26,0,0,71
61131,7937,2010-01-12,Assembly,"Do pass as amended and re-refer to Committee on Appropriations with recommendation:  To Consent Calendar",9,0,0,0,9
61131,7938,2010-01-27,Assembly,"AB 1263 STRICKLAND  Consent Calendar Second Day",68,0,10,0,78
61131,8907,2010-06-15,Senate,"Do pass",5,0,0,0,5
61131,10071,2010-07-01,Senate,"Special Consent #29 AB1263 Audra Strickland By Correa",34,0,5,0,39
61131,19355,2010-08-02,Assembly,"AB 1263 STRICKLAND  Concurrence in Senate Amendments",76,0,0,0,76
61133,7928,2009-05-18,Assembly,"Do pass as amended and be re-referred to the Committee on Appropriations",9,0,0,0,9
61133,7929,2009-05-28,Assembly,"Do pass as amended",17,0,0,0,17
61133,7930,2009-06-02,Assembly,"AB 1265 MA  Assembly Third Reading",75,1,4,0,80
61133,7931,2009-07-08,Senate,"Do pass, but re-refer to the Committee on Appropriations Recommend Consent",8,0,0,0,8
61133,19673,2010-08-09,Assembly,"Senate amendments be concurred in",10,3,0,0,13
61133,19674,2010-08-09,Senate,"Do pass",8,1,0,0,9
61133,19675,2010-08-09,Senate,"W/O REF. TO FILE AB1265 Caballero Urgency Clause",27,7,0,0,34
61133,19676,2010-08-09,Assembly,"AB 1265 CABALLERO  Concurrence- Urgency Added",54,22,0,0,76
61134,7934,2009-04-28,Assembly,"Do pass and re-refer to Committee on Appropriations with recommendation:  To Consent Calendar",10,0,1,0,11
61135,7935,2009-04-22,Assembly,"Do pass as amended and be re-referred to the Committee on Appropriations",5,1,0,0,6
61136,7955,2009-04-20,Assembly,"Do pass and be re-referred to the Committee on Judiciary to Consent Calendar",11,0,0,0,11
61136,7956,2009-04-27,Assembly,"Do pass and re-refer to Committee on Appropriations with recommendation:  To Consent Calendar",10,0,0,0,10
61136,7957,2009-05-20,Assembly,"Do pass, to Consent Calendar",15,0,1,0,16
61136,7958,2009-05-28,Assembly,"AB 1268 GAINES  Consent Calendar Second Day  Regular Session",76,0,4,0,80
61136,7959,2009-06-22,Senate,"Do pass, but re-refer to the Committee on Appropriations Recommend Consent",11,0,1,0,12
61136,7960,2009-08-24,Senate,"Special Consent #15 AB1268 Gaines By Runner",39,0,1,0,40
61136,20192,2010-08-12,Senate,"Assembly 3rd Reading AB1268 Gaines By Runner",34,0,0,0,34
61136,20440,2010-08-18,Assembly,"AB 1268 GAINES  Concurrence in Senate Amendments",74,0,0,0,74
61137,23659,2009-04-21,Assembly,"Do pass and be re-referred to the Committee on Appropriations",13,6,0,0,19
61137,23660,2009-05-28,Assembly,"Do pass",12,5,0,0,17
61137,23661,2009-06-02,Assembly,"AB 1269 BROWNLEY  Assembly Third Reading",50,29,0,0,79
61137,23662,2009-07-08,Senate,"Do pass, but re-refer to the Committee on Appropriations",8,3,0,0,11
61137,23663,2009-07-23,Senate,"Placed on Appropriations Suspense file",13,0,0,0,13
61137,23664,2009-08-27,Senate,"Do pass as amended",8,5,0,0,13
61137,23665,2009-09-04,Senate,"Assembly 3rd Reading AB1269 Brownley By Maldonado",26,12,0,0,38
61137,23666,2009-09-09,Assembly,"AB 1269 BROWNLEY  Concurrence in Senate Amendments",49,27,0,0,76
61138,7946,2009-04-21,Assembly,"Do pass and re-refer to Committee on Appropriations with recommendation:  To Consent Calendar",7,0,0,0,7
61138,7947,2009-05-06,Assembly,"Do pass, to Consent Calendar",16,0,0,0,16
61138,7948,2009-05-14,Assembly,"AB 1270 TORRICO  Consent Calendar Second Day  Regular Session",73,0,7,0,80
61138,7949,2009-06-09,Senate,"Do pass, but re-refer to the Committee on Appropriations",7,0,0,0,7
61138,7950,2009-08-17,Senate,"Special Consent #14 AB1270 Torrico By Leno",35,0,5,0,40
61138,7951,2009-09-02,Assembly,"AB 1270 TORRICO  Concurrence in Senate Amendments",77,0,2,0,79
61139,7975,2009-04-21,Assembly,"Do pass as amended and be re-referred to the Committee on Appropriations",5,2,0,0,7
61139,7976,2009-05-13,Assembly,"Do pass",10,5,1,0,16
61139,7977,2009-06-01,Assembly,"AB 1271 KREKORIAN  Assembly Third Reading",50,29,1,0,80
61139,7978,2009-07-07,Senate,"Do pass, but re-refer to the Committee on Appropriations",3,2,0,0,5
61139,7979,2009-08-31,Senate,"Assembly 3rd Reading AB1271 Krekorian By Liu",23,13,4,0,40
61140,1697,2009-05-05,Assembly,"Do pass and be re-referred to the Committee on Transportation to Consent Calendar",19,0,0,0,19
61140,1698,2009-05-11,Assembly,"Do pass as amended, to Consent Calendar",14,0,0,0,14
61140,1699,2009-05-21,Assembly,"AB 1272 HILL  Consent Calendar Second Day",77,0,3,0,80
61140,6549,2010-06-09,Senate,"Do pass as amended, and re-refer to the Committee on Rules",5,0,4,0,9
61142,7996,2009-04-21,Assembly,"Do pass as amended and be re-referred to the Committee on Appropriations",7,0,0,0,7
61142,7997,2009-05-13,Assembly,"Do pass, to Consent Calendar",16,0,0,0,16
61142,7998,2009-05-21,Assembly,"AB 1274 HUBER  Consent Calendar Second Day  Regular Session",77,0,3,0,80
61142,7999,2009-07-07,Senate,"Do pass, but re-refer to the Committee on Appropriations",5,0,0,0,5
61142,8000,2009-08-24,Senate,"Placed on Appropriations Suspense file",13,0,0,0,13
61143,8001,2009-04-21,Assembly,"Do pass and be re-referred to the Committee on Transportation",2,5,0,0,7
61143,8002,2009-04-21,Assembly,"Set first hearing.  Failed passage.  Reconsideration granted",7,0,0,0,7
61143,8003,2010-01-12,Assembly,"Do pass and be re-referred to the Committee on Appropriations",2,5,0,0,7
61144,7985,2009-04-21,Assembly,"Do pass and be re-referred to the Committee on Appropriations",5,2,0,0,7
61144,7986,2009-05-06,Assembly,"Do pass",11,5,0,0,16
61144,7987,2009-05-28,Assembly,"AB 1276 SKINNER  Assembly Third Reading",50,29,1,0,80
61144,7988,2009-06-29,Senate,"Do pass, but re-refer to the Committee on Appropriations",7,2,1,0,10
61144,7989,2009-07-13,Senate,"Do pass",8,4,1,0,13
61144,7990,2009-09-09,Senate,"Assembly 3rd Reading AB1276 Skinner By Hancock",23,13,4,0,40
61148,7971,2009-04-20,Assembly,"Do pass and be re-referred to the Committee on Environmental Safety and Toxic Materials to Consent Calendar",9,0,0,0,9
61148,7972,2009-04-28,Assembly,"Do pass as amended and be re-referred to the Committee on Appropriations",7,0,0,0,7
61148,7973,2009-05-20,Assembly,"Do pass",15,0,1,0,16
61148,7974,2009-05-28,Assembly,"AB 1280 ADAMS  Assembly Third Reading",76,0,4,0,80
61148,10354,2010-06-29,Senate,"Do pass as amended, and re-refer to the Committee on Appropriations",7,0,0,0,7
61148,19421,2010-08-02,Senate,"Placed on Appropriations Suspense file",10,0,0,0,10
61148,20177,2010-08-12,Senate,"Do pass",11,0,0,0,11
61148,20583,2010-08-19,Senate,"Assembly 3rd Reading AB1280 Villines By Huff",31,1,0,0,32
61148,21038,2010-08-24,Assembly,"AB 1280 VILLINES  Concurrence in Senate Amendments",76,0,0,0,76
61149,7961,2009-04-22,Assembly,"Do pass as amended and be re-referred to the Committee on Appropriations",9,0,2,0,11
61149,7962,2009-05-13,Assembly,"Do pass as amended",11,0,5,0,16
61149,7963,2009-05-26,Assembly,"AB 1281 PORTANTINO  Assembly Third Reading",64,9,7,0,80
61149,7964,2009-07-08,Senate,"Do pass as amended, and re-refer to the Committee on Appropriations",8,0,1,0,9
61149,7965,2009-08-31,Senate,"Assembly 3rd Reading AB1281 Portantino By Alquist",33,0,7,0,40
61149,7966,2009-09-02,Assembly,"AB 1281 PORTANTINO  Concurrence in Senate Amendments",61,12,6,0,79
61150,23058,2009-04-22,Assembly,"Do pass and be re-referred to the Committee on Appropriations",15,0,0,0,15
61150,23059,2009-05-06,Assembly,"Do pass, to Consent Calendar",16,0,0,0,16
61150,23060,2009-05-18,Assembly,"AB 1282 HALL  Assembly Third Reading",72,3,0,0,75
61150,23061,2009-07-08,Senate,"Do pass, but re-refer to the Committee on Appropriations",10,0,0,0,10
61150,23062,2009-08-31,Senate,"Assembly 3rd Reading AB1282 Hall Urgency Clause",35,1,0,0,36
61150,23063,2009-09-02,Assembly,"AB 1282 HALL  Concurrence in Senate Amendments",76,2,0,0,78
61152,7954,2009-04-28,Assembly,"Do pass and be re-referred to the Committee on Appropriations",14,2,3,0,19
61154,26631,2009-05-12,Assembly,"Do pass, to Consent Calendar",7,0,0,0,7
61154,26632,2009-05-21,Assembly,"AB 1286 HUBER  Consent Calendar Second Day  Regular Session",77,0,0,0,77
61154,26633,2009-06-16,Senate,"Do pass",6,0,0,0,6
61154,26634,2009-06-24,Senate,"Special Consent #10 AB1286 Huber",40,0,0,0,40
61156,7967,2009-05-06,Assembly,"Do pass",6,1,0,0,7
61156,7968,2009-05-28,Assembly,"AB 1288 FONG  Assembly Third Reading",55,22,3,0,80
61156,7969,2009-06-25,Senate,"Do pass",4,2,0,0,6
61156,7970,2009-08-24,Senate,"Assembly 3rd Reading AB1288 Fong By Ducheny",25,13,2,0,40
61157,7952,2009-04-14,Assembly,"Do pass and be re-referred to the Committee on Public Safety",18,0,1,0,19
61157,7953,2009-04-28,Assembly,"Do pass and re-refer to Committee on Appropriations with recommendation:  To Consent Calendar",7,0,0,0,7
61158,7984,2009-04-22,Assembly,"Do pass and re-refer to Committee on Appropriations with recommendation:  To Consent Calendar",6,0,0,0,6
61159,25179,2009-04-21,Assembly,"Do pass and re-refer to Committee on Appropriations with 	recommendation:  To Consent Calendar",10,0,0,0,10
61159,25180,2009-05-28,Assembly,"Do pass as amended",17,0,0,0,17
61159,25181,2009-06-03,Assembly,"AB 1291 NIELLO  Assembly Third Reading",78,0,0,0,78
61159,25182,2009-07-14,Senate,"Do pass, but re-refer to the Committee on Appropriations",5,0,0,0,5
61159,25183,2009-08-17,Senate,"Placed on Appropriations Suspense file",13,0,0,0,13
61159,25184,2009-08-27,Senate,"Do pass as amended",13,0,0,0,13
61159,25185,2009-09-10,Senate,"Special Consent #21 AB1291 Niello By Cox",40,0,0,0,40
61159,25186,2009-09-11,Assembly,"AB 1291 Niello  Concurrence in Senate Amendments",79,0,0,0,79
61161,23655,2009-05-06,Assembly,"Do pass, to Consent Calendar",5,0,0,0,5
61161,23656,2009-05-14,Assembly,"AB 1293 HALL  Consent Calendar Second Day  Regular Session",73,0,0,0,73
61161,23657,2009-06-17,Senate,"Do pass and be placed on the Consent Calendar",9,0,0,0,9
61161,23658,2009-06-24,Senate,"Consent Calendar 2nd AB1293 Hall",40,0,0,0,40
61163,22659,2009-04-21,Assembly,"Do pass and re-refer to Committee on Appropriations with 	recommendation:  To Consent Calendar",9,0,0,0,9
61163,22660,2009-05-06,Assembly,"Do pass, to Consent Calendar",16,0,0,0,16
61163,22661,2009-05-14,Assembly,"AB 1295 FULLER  Consent Calendar Second Day  Regular Session",73,0,0,0,73
61163,22662,2009-07-15,Senate,"Do pass as amended, and re-refer to the Committee on Appropriations",8,0,0,0,8
61163,22663,2009-08-17,Senate,"Placed on Appropriations Suspense file",13,0,0,0,13
61163,22664,2009-08-27,Senate,"Do pass",13,0,0,0,13
61163,22665,2009-09-04,Senate,"Special Consent #19 AB1295 Fuller",40,0,0,0,40
61163,22666,2009-09-09,Assembly,"AB 1295 FULLER  Concurrence in Senate Amendments",78,0,0,0,78
61168,8043,2009-04-27,Assembly,"Do pass as amended and be re-referred to the Committee on Appropriations",8,0,1,0,9
61168,8044,2009-05-28,Assembly,"Do pass",17,0,0,0,17
61168,8045,2009-06-02,Assembly,"AB 1300 FLETCHER  Assembly Third Reading",77,0,3,0,80
61171,8057,2009-04-28,Assembly,"Do pass and be re-referred to the Committee on Appropriations",17,0,2,0,19
61171,8058,2009-05-28,Assembly,"Do pass as amended",13,4,0,0,17
61171,8059,2009-06-03,Assembly,"AB 1303 HALL  Assembly Third Reading",77,0,3,0,80
61172,8082,2009-05-18,Assembly,"Do pass and be re-referred to the Committee on Appropriations",9,0,0,0,9
61173,8053,2009-04-20,Assembly,"Do pass and be re-referred to the Committee on Utilities and Commerce",6,3,0,0,9
61175,8028,2009-04-28,Assembly,"Do pass as amended and be re-referred to the Committee on Appropriations",15,1,3,0,19
61175,8029,2009-05-20,Assembly,"Do pass",11,1,4,0,16
61175,8030,2009-05-28,Assembly,"AB 1307 BUCHANAN  Assembly Third Reading",60,16,4,0,80
61175,8031,2009-07-15,Senate,"Do pass, but re-refer to the Committee on Appropriations",10,0,1,0,11
61176,8076,2009-04-21,Assembly,"Do pass and be re-referred to the Committee on Appropriations",2,5,0,0,7
61176,8077,2009-04-21,Assembly,"Set first hearing.  Failed passage.  Reconsideration granted",7,0,0,0,7
61178,7991,2009-04-14,Assembly,"Do pass and re-refer to Committee on Appropriations with recommendation:  To Consent Calendar",9,0,2,0,11
61178,7992,2009-05-28,Assembly,"Do pass as amended",17,0,0,0,17
61178,7993,2009-06-02,Assembly,"AB 1310 HERNANDEZ  Assembly Third Reading",78,0,2,0,80
61178,7994,2009-07-06,Senate,"Do pass, but re-refer to the Committee on Appropriations",8,1,1,0,10
61178,7995,2009-08-17,Senate,"Placed on Appropriations Suspense file",13,0,0,0,13
61179,23973,2009-04-28,Assembly,"Do pass and be re-referred to the Committee on Appropriations",11,0,0,0,11
61179,23974,2009-05-13,Assembly,"Do pass, to Consent Calendar",16,0,0,0,16
61179,23975,2009-05-21,Assembly,"AB 1311 DUVALL  Consent Calendar Second Day  Regular Session",77,0,0,0,77
61179,23976,2009-06-23,Senate,"Do pass, but re-refer to the Committee on Rules Recommend Consent",12,0,0,0,12
61179,23977,2009-08-27,Senate,"Special Consent #16 AB1311 Duvall",38,0,0,0,38
61179,23978,2009-08-31,Assembly,"AB 1311 DUVALL  Concurrence in Senate Amendments",78,0,0,0,78
61180,8004,2009-05-05,Assembly,"Do pass as amended, to Consent Calendar",10,0,0,0,10
61180,8005,2009-05-18,Assembly,"AB 1312 SWANSON  Consent Calendar Second Day",77,0,3,0,80
61180,8006,2009-07-14,Senate,"Do pass as amended",4,0,1,0,5
61180,8007,2009-09-02,Senate,"Assembly 3rd Reading AB1312 Swanson By Cedillo",24,9,7,0,40
61180,8008,2009-09-09,Assembly,"AB 1312 SWANSON  Concurrence in Senate Amendments",76,2,1,0,79
61182,8012,2009-04-28,Assembly,"Do pass and be re-referred to the Committee on Appropriations",13,6,0,0,19
61183,8009,2009-04-27,Assembly,"Do pass as amended and be re-referred to the Committee on Appropriations",10,4,1,0,15
61183,8010,2009-05-20,Assembly,"Do pass",11,4,1,0,16
61183,8011,2009-06-02,Assembly,"AB 1315 RUSKIN  Assembly Third Reading",43,27,10,0,80
61183,10143,2010-06-29,Senate,"Do pass as amended, and re-refer to the Committee on Judiciary",10,0,1,0,11
61183,20439,2010-08-18,Senate,"Assembly 3rd Reading AB1315 Fuentes By Padilla",34,0,0,0,34
61183,21070,2010-08-25,Assembly,"Senate amendments be concurred in",10,0,0,0,10
61183,21465,2010-08-26,Assembly,"AB 1315 FUENTES  Concurrence in Senate Amendments",77,0,0,0,77
61184,8021,2009-04-27,Assembly,"Do pass as amended and be re-referred to the Committee on Appropriations",9,5,1,0,15
61184,8022,2009-05-28,Assembly,"Do pass as amended",12,5,0,0,17
61184,8023,2009-06-03,Assembly,"AB 1316 MA  Assembly Third Reading",47,30,3,0,80
61185,22926,2009-04-28,Assembly,"Do pass as amended",11,0,0,0,11
61185,22927,2009-05-18,Assembly,"AB 1317 BLOCK  Assembly Third Reading",48,20,0,0,68
61185,22928,2009-06-25,Senate,"Do pass as amended",8,2,0,0,10
61185,22929,2009-09-02,Senate,"Assembly 3rd Reading AB1317 Block By Alquist",30,3,0,0,33
61185,22930,2009-09-08,Assembly,"AB 1317 BLOCK  Concurrence in Senate Amendments",58,17,0,0,75
61186,26524,2009-05-11,Assembly,"Do pass as amended and be re-referred to the Committee on Utilities 	and Commerce",7,0,0,0,7
61186,26525,2009-05-18,Assembly,"Do pass and be re-referred to the Committee on Appropriations",13,0,0,0,13
61186,26526,2009-07-08,Assembly,"Do pass",15,0,0,0,15
61186,26527,2009-07-13,Assembly,"AB 1318 PEREZ, V.M.  Third Reading Urgency",63,3,0,0,66
61186,26528,2009-08-24,Senate,"Do pass, but re-refer to the Committee on Environmental Quality",6,0,0,0,6
61186,26529,2009-08-26,Senate,"Do pass as amended, and re-refer to the Committee on 	Appropriations",5,2,0,0,7
61186,26530,2009-09-11,Senate,"Assembly 3rd Supp 1 AB1318 V. Manuel Perez By Ducheny",11,8,0,0,19
61186,26531,2009-09-11,Senate,"Assembly 3rd Supp 1 AB1318 V. Manuel Perez By Ducheny",23,6,0,0,29
61186,26532,2009-09-11,Assembly,"AB 1318  Concurrence in Senate Amendments By PEREZ, V.M",65,4,0,0,69
61187,25504,2009-04-22,Assembly,"Do pass and be re-referred to the Committee on Arts, Entertain, 	Sports, Tourism, & Internet Media",5,1,0,0,6
61187,25505,2009-04-28,Assembly,"Do pass and be re-referred to the Committee on Appropriations",7,2,0,0,9
61187,25506,2009-05-13,Assembly,"Do pass",12,4,0,0,16
61187,25507,2009-05-26,Assembly,"AB 1319 KREKORIAN  Assembly Third Reading  Amend By KREKORIAN  Set 	#1",52,23,0,0,75
61187,25508,2009-06-01,Assembly,"AB 1319 KREKORIAN  Assembly Third Reading",58,21,0,0,79
61187,25509,2009-06-23,Senate,"Do pass as amended, and re-refer to the Committee on Rules",4,1,0,0,5
61187,25510,2009-07-08,Senate,"Do pass as amended, and re-refer to the Committee on 	Appropriations",4,1,0,0,5
61187,25511,2009-09-02,Senate,"Assembly 3rd Reading AB1319 Krekorian By Leno",24,10,0,0,34
61187,25512,2009-09-08,Assembly,"AB 1319 KREKORIAN  Concurrence in Senate Amendments",56,21,0,0,77
61188,8024,2009-04-22,Assembly,"Do pass and be re-referred to the Committee on Appropriations",6,1,0,0,7
61188,8025,2009-05-28,Assembly,"Do pass as amended",12,5,0,0,17
61188,8026,2009-06-03,Assembly,"AB 1320 FONG  Assembly Third Reading",50,28,2,0,80
61188,8027,2009-07-08,Senate,"Do pass, but re-refer to the Committee on Appropriations",4,2,0,0,6
61188,19519,2010-08-02,Senate,"Placed on Appropriations Suspense file",10,0,0,0,10
61189,8035,2009-04-27,Assembly,"Do pass as amended and be re-referred to the Committee on Appropriations",6,1,2,0,9
61190,8048,2009-04-21,Assembly,"Do pass and be re-referred to the Committee on Appropriations",7,0,0,0,7
61190,8049,2009-04-29,Assembly,"Do pass, to Consent Calendar",16,0,0,0,16
61190,8050,2009-05-11,Assembly,"AB 1322 HUFFMAN  Consent Calendar Second Day  Regular Session",78,0,2,0,80
61190,8051,2009-07-07,Senate,"Do pass, but re-refer to the Committee on Appropriations",3,2,0,0,5
61190,8052,2009-09-03,Senate,"Assembly 3rd Reading AB1322 Huffman Reconsider",40,0,0,0,40
61191,8032,2009-04-22,Assembly,"Do pass and be re-referred to the Committee on Appropriations",6,1,0,0,7
61192,8036,2009-04-28,Assembly,"Do pass and re-refer to Committee on Appropriations with recommendation:  To Consent Calendar",7,0,0,0,7
61192,8037,2009-05-20,Assembly,"Do pass, to Consent Calendar",15,0,1,0,16
61192,8038,2009-05-28,Assembly,"AB 1324 BASS  Consent Calendar Second Day  Regular Session",76,0,4,0,80
61192,8039,2009-06-23,Senate,"Do pass, but re-refer to the Committee on Appropriations Recommend Consent",5,0,0,0,5
61192,8040,2009-08-17,Senate,"Do pass",9,0,4,0,13
61192,8041,2009-08-27,Senate,"Special Consent #16 AB1324 Bass",38,0,2,0,40
61192,8042,2009-08-31,Assembly,"AB 1324 BASS  Concurrence in Senate Amendments",77,0,2,0,79
61193,25749,2009-04-14,Assembly,"Do pass as amended and be re-referred to the Committee on Judiciary",6,0,0,1,7
61193,25750,2009-04-28,Assembly,"Do pass as amended and be re-referred to the Committee on 	Appropriations",10,0,0,0,10
61193,25751,2009-05-20,Assembly,"Do pass, to Consent Calendar",15,0,0,1,16
61193,25752,2009-05-28,Assembly,"AB 1325 COOK  Consent Calendar Second Day  Regular Session",76,0,0,4,80
61193,25753,2009-06-23,Senate,"Do pass, but re-refer to the Committee on Judiciary Recommend 	Consent",5,0,0,0,5
61193,25754,2009-07-14,Senate,"Do pass, but re-refer to the Committee on Appropriations",5,0,0,0,5
61193,25755,2009-08-24,Senate,"Placed on Appropriations Suspense file",13,0,0,0,13
61193,25756,2009-08-27,Senate,"Do pass",13,0,0,0,13
61193,25757,2009-09-04,Senate,"Assembly 3rd Reading AB1325 Cook By Ducheny",39,0,1,0,40
61193,25758,2009-09-09,Assembly,"AB 1325 COOK  Concurrence in Senate Amendments",78,0,0,1,79
61194,8013,2009-04-21,Assembly,"Do pass and be re-referred to the Committee on Judiciary",5,1,1,0,7
61194,8014,2009-04-28,Assembly,"Do pass and be re-referred to the Committee on Appropriations",7,3,0,0,10
61194,8015,2009-05-13,Assembly,"Do pass",11,5,0,0,16
61194,8016,2009-05-28,Assembly,"AB 1326 HUFFMAN  Assembly Third Reading",51,29,0,0,80
61194,8017,2009-07-07,Senate,"Do pass, but re-refer to the Committee on Elections, Reapportionmnt and Constitutional Amend",3,2,0,0,5
61194,8018,2009-07-15,Senate,"Do pass, but re-refer to the Committee on Appropriations",3,2,0,0,5
61194,8019,2009-09-08,Senate,"Assembly 3rd Reading AB1326 Huffman By Price",25,15,0,0,40
61194,8020,2009-09-10,Assembly,"AB 1326 HUFFMAN  Concurrence in Senate Amendments",50,28,2,0,80
61195,8067,2009-04-27,Assembly,"Do pass and be re-referred to the Committee on Appropriations",7,2,0,0,9
61196,8083,2009-05-13,Assembly,"Do pass as amended",5,1,0,0,6
61196,8084,2009-06-02,Assembly,"AB 1328 SALAS  Assembly Third Reading",48,29,3,0,80
61196,8085,2009-07-07,Senate,"Do pass as amended",6,4,1,0,11
61196,8086,2009-08-31,Senate,"Assembly 3rd Reading AB1328 Salas By Lowenthal",25,11,4,0,40
61196,8087,2009-09-02,Assembly,"AB 1328 SALAS  Concurrence in Senate Amendments",50,26,3,0,79
61197,8108,2009-04-28,Assembly,"Do pass",5,2,0,0,7
61197,8109,2009-06-03,Assembly,"AB 1329 BROWNLEY  Assembly Third Reading",42,32,6,0,80
61197,8110,2009-07-06,Senate,"Do pass",5,2,0,0,7
61198,23868,2009-04-14,Assembly,"Do pass as amended and be re-referred to the Committee on 	Appropriations",8,0,0,0,8
61198,23869,2009-04-29,Assembly,"Do pass as amended and be re-referred to the Committee on 	Appropriations",7,0,0,0,7
61198,23870,2009-05-20,Assembly,"Do pass",15,0,0,0,15
61198,23871,2009-05-28,Assembly,"AB 1330 SALAS  Assembly Third Reading",79,0,0,0,79
61198,23872,2009-06-23,Senate,"Do pass, but re-refer to the Committee on Transportation and 	Housing",6,0,0,0,6
61198,23873,2009-07-07,Senate,"Do pass as amended, but re-refer to the Committee on Appropriations 	Recommend Consent",10,0,0,0,10
61198,23874,2009-08-17,Senate,"Placed on Appropriations Suspense file",13,0,0,0,13
61198,23875,2009-08-27,Senate,"Do pass",13,0,0,0,13
61198,23876,2009-09-09,Senate,"Assembly 3rd Reading AB1330 Salas By Cedillo",30,0,0,0,30
61198,23877,2009-09-10,Assembly,"AB 1330 Salas  Concurrence in Senate Amendments",79,0,0,0,79
61200,8114,2009-05-11,Assembly,"Do pass as amended and be re-referred to the Committee on Appropriations",6,0,3,0,9
61203,547,2009-04-21,Assembly,"Do pass and be re-referred to the Committee on Appropriations.",7,0,0,0,7
61203,548,2009-04-29,Assembly,"Do pass.",11,0,5,0,16
61203,549,2009-05-18,Assembly,"AB 1335 LIEU  Assembly Third Reading",76,0,4,0,80
61203,8779,2010-06-15,Senate,"Do pass, but re-refer to the Committee on Appropriations",4,1,0,0,5
61203,20371,2010-08-11,Senate,"Assembly 3rd Reading AB1335 Lieu By Liu",23,11,0,0,34
61203,20372,2010-08-17,Assembly,"Senate amendments be concurred in",6,0,0,0,6
61203,20428,2010-08-18,Assembly,"AB 1335 LIEU  Concurrence in Senate Amendments",53,21,0,0,74
61204,8090,2009-04-27,Assembly,"Do pass as amended",10,3,1,0,14
61204,8091,2009-05-14,Assembly,"AB 1336 ENG  Assembly Third Reading",44,24,12,0,80
61204,8092,2009-06-16,Senate,"Do pass, but re-refer to the Committee on Judiciary",9,2,0,0,11
61204,8093,2009-07-14,Senate,"Do pass as amended",3,1,1,0,5
61204,8094,2009-09-08,Senate,"Assembly 3rd Reading AB1336 Eng By Florez",21,18,1,0,40
61204,8095,2009-09-10,Assembly,"AB 1336 ENG  Concurrence in Senate Amendments",50,28,2,0,80
61205,23649,2009-04-21,Assembly,"Do pass and be re-referred to the Committee on Appropriations",7,0,0,0,7
61205,23650,2009-04-29,Assembly,"Do pass, to Consent Calendar",16,0,0,0,16
61205,23651,2009-05-11,Assembly,"AB 1337 EVANS  Consent Calendar Second Day  Regular Session",78,0,0,0,78
61205,23652,2009-06-16,Senate,"Do pass, but re-refer to the Committee on Appropriations",5,0,0,0,5
61205,23653,2009-06-29,Senate,"Special Consent #11 AB1337 Evans",40,0,0,0,40
61205,23654,2009-07-06,Assembly,"AB 1337 EVANS  Concurrence in Senate Amendments",78,0,0,0,78
61206,8096,2009-04-21,Assembly,"Do pass as amended and be re-referred to the Committee on Appropriations",6,0,1,0,7
61207,8102,2009-04-15,Assembly,"Do pass and be re-referred to the Committee on Appropriations",7,0,0,0,7
61207,8103,2009-05-28,Assembly,"Do pass",17,0,0,0,17
61207,8104,2009-06-01,Assembly,"AB 1339 PEREZ, V.M.  Assembly Third Reading",78,0,2,0,80
61207,8105,2009-07-08,Senate,"Do pass, but re-refer to the Committee on Appropriations",3,2,0,0,5
61207,8106,2009-08-17,Senate,"Placed on Appropriations Suspense file",13,0,0,0,13
61208,8097,2009-04-21,Assembly,"Do pass and be re-referred to the Committee on Appropriations",7,0,0,0,7
61208,8098,2009-05-20,Assembly,"Do pass",15,0,1,0,16
61208,8099,2009-05-28,Assembly,"AB 1340 LOWENTHAL  Assembly Third Reading",79,0,1,0,80
61208,8100,2009-07-07,Senate,"Do pass as amended, and re-refer to the Committee on Appropriations",5,0,0,0,5
61208,8101,2009-08-24,Senate,"Placed on Appropriations Suspense file",13,0,0,0,13
61209,8054,2009-05-11,Assembly,"Do pass, to Consent Calendar",9,0,0,0,9
61209,8055,2009-05-18,Assembly,"AB 1341 SALDANA  Consent Calendar Second Day  Regular Session",77,0,3,0,80
61209,10358,2010-07-01,Senate,"Do pass as amended",5,0,0,0,5
61209,19892,2010-08-09,Senate,"Placed on Appropriations Suspense file",10,0,0,0,10
61209,20056,2010-08-12,Senate,"Do pass",11,0,0,0,11
61209,20456,2010-08-18,Senate,"Assembly 3rd Reading AB1341 Bonnie Lowenthal By Lowenthal",34,0,0,0,34
61209,21494,2010-08-26,Assembly,"Senate amendments be concurred in",9,0,0,0,9
61209,21567,2010-08-27,Assembly,"AB 1341 LOWENTHAL  Concurrence in Senate Amendments",73,0,0,0,73
61210,8068,2009-04-22,Assembly,"Do pass and be re-referred to the Committee on Revenue and Taxation",5,2,0,0,7
61211,8060,2009-04-27,Assembly,"Do pass as amended and be re-referred to the Committee on Appropriations",7,2,0,0,9
61211,8061,2009-05-28,Assembly,"Do pass",12,5,0,0,17
61211,8062,2009-06-02,Assembly,"AB 1343 HUFFMAN  Assembly Third Reading",48,29,3,0,80
61211,8063,2009-07-06,Senate,"Do pass as amended, and re-refer to the Committee on Appropriations",5,2,0,0,7
61211,8064,2009-08-17,Senate,"Placed on Appropriations Suspense file",13,0,0,0,13
61211,21977,2010-08-31,Senate,"W/O REF. TO FILE AB1343 Huffman By DeSaulnier",21,15,0,0,36
61211,21978,2010-08-31,Assembly,"AB 1343 HUFFMAN  Concurrence in Senate Amendments",47,28,0,0,75
61216,8072,2009-04-27,Assembly,"Do pass and be re-referred to the Committee on Natural Resources",12,0,3,0,15
61216,8073,2009-04-29,Assembly,"Do pass as amended and be re-referred to the Committee on Appropriations",9,0,0,0,9
61216,8074,2009-05-28,Assembly,"Do pass",17,0,0,0,17
61216,8075,2009-06-01,Assembly,"AB 1348 BLAKESLEE  Assembly Third Reading",73,0,7,0,80
61217,314,2009-04-29,Assembly,"Do pass as amended and re-refer to Committee on Appropriations with recommendation:  To Consent Calendar.",11,0,0,0,11
61218,8069,2009-04-27,Assembly,"Do pass and be re-referred to the Committee on Appropriations",8,0,1,0,9
61218,8070,2009-05-06,Assembly,"Do pass, to Consent Calendar",16,0,0,0,16
61218,8071,2009-05-14,Assembly,"AB 1350 BLAKESLEE  Consent Calendar Second Day  Regular Session",73,0,7,0,80
61219,23600,2009-04-13,Assembly,"Do pass and be re-referred to the Committee on Natural Resources to 	Consent Calendar",13,0,0,0,13
61219,23601,2009-04-27,Assembly,"Do pass as amended and be re-referred to the Committee on 	Appropriations",8,0,0,0,8
61219,23602,2009-05-20,Assembly,"Do pass, to Consent Calendar",15,0,0,0,15
61219,23603,2009-05-28,Assembly,"AB 1351 BLAKESLEE  Consent Calendar Second Day  Regular Session",76,0,0,0,76
61219,23604,2009-07-07,Senate,"Do pass, but re-refer to the Committee on Environmental Quality",11,0,0,0,11
61219,23605,2009-07-13,Senate,"Do pass as amended, but re-refer to the Committee on 	Appropriations Recommend Consent",7,0,0,0,7
61219,23606,2009-09-03,Senate,"Assembly 3rd Reading AB1351 Blakeslee By Aanestad",35,0,0,0,35
61219,23607,2009-09-09,Assembly,"AB 1351 BLAKESLEE  Concurrence in Senate Amendments",78,0,0,0,78
61222,8140,2009-05-06,Assembly,"Do pass, to Consent Calendar",5,0,1,0,6
61222,8141,2009-05-14,Assembly,"AB 1354 FONG  Consent Calendar Second Day  Regular Session",73,0,7,0,80
61222,9621,2010-06-28,Senate,"Do pass and be placed on the Consent Calendar",6,0,0,0,6
61222,19508,2010-08-02,Senate,"Consent Calendar 2nd AB1354 Fong",33,0,0,0,33
61222,19803,2010-08-09,Assembly,"AB 1354 FONG  Concurrence in Senate Amendments",78,0,0,0,78
61223,22368,2009-05-06,Assembly,"Do pass, to Consent Calendar",5,0,0,0,5
61223,22369,2009-05-14,Assembly,"AB 1355 FONG  Consent Calendar Second Day  Regular Session",73,0,0,0,73
61223,22370,2009-06-08,Senate,"Do pass and be placed on the Consent Calendar",7,0,0,0,7
61223,22371,2009-06-11,Senate,"Consent Calendar 2nd AB1355 Fong",33,0,0,0,33
61224,8144,2009-04-21,Assembly,"Do pass and be re-referred to the Committee on Transportation",2,5,0,0,7
61224,8145,2009-04-21,Assembly,"Set first hearing.  Failed passage.  Reconsideration granted",7,0,0,0,7
61225,8152,2009-04-20,Assembly,"Do pass, to Consent Calendar",11,0,0,0,11
61225,8153,2009-04-29,Assembly,"Do pass, to Consent Calendar",16,0,0,0,16
61225,8154,2009-05-11,Assembly,"AB 1357 COTO  Consent Calendar Second Day  Regular Session",78,0,2,0,80
61225,8155,2009-06-17,Senate,"Do pass, but re-refer to the Committee on Judiciary Recommend Consent",11,0,1,0,12
61225,8156,2009-07-14,Senate,"Do pass, but re-refer to the Committee on Appropriations",4,0,1,0,5
61225,8157,2009-09-02,Senate,"Assembly 3rd Reading AB1357 Coto By Calderon",33,1,6,0,40
61226,25388,2009-04-27,Assembly,"Do pass as amended and be re-referred to the Committee on 	Appropriations",6,3,0,0,9
61226,25389,2009-05-28,Assembly,"Do pass",9,5,0,0,14
61226,25390,2009-10-26,Assembly,"AB 1358 FEUER  Assembly Third Reading",76,0,0,0,76
61226,25391,2009-11-02,Senate,"W/O REF. TO FILE AB1358 Feuer Urgency Clause",28,2,0,0,30
61227,8151,2009-04-14,Assembly,"Do pass and be re-referred to the Committee on Appropriations",5,2,0,0,7
61228,8148,2009-04-21,Assembly,"Do pass and be re-referred to the Committee on Appropriations",7,0,0,0,7
61228,8149,2009-05-28,Assembly,"Do pass",14,3,0,0,17
61228,8150,2009-06-03,Assembly,"AB 1360 PEREZ, J.  Assembly Third Reading",77,1,2,0,80
61229,23632,2009-04-27,Assembly,"Do pass as amended and be re-referred to the Committee on 	Appropriations",13,0,0,0,13
61229,23633,2009-05-20,Assembly,"Do pass, to Consent Calendar",15,0,0,0,15
61229,23634,2009-05-21,Assembly,"AB 1361 PORTANTINO  Assembly Third Reading",75,0,0,0,75
61229,23635,2009-06-16,Senate,"Do pass as amended, and re-refer to the Committee on Appropriations",11,0,0,0,11
61229,23636,2009-07-06,Senate,"Do pass as amended",11,0,0,0,11
61229,23637,2009-07-16,Senate,"Special Consent #13 AB1361 Portantino Urgency Clause",33,1,0,0,34
61229,23638,2009-07-16,Assembly,"AB 1361 PORTANTINO  Concurrence in Senate Amendments",70,0,0,0,70
61230,8146,2009-04-14,Assembly,"Do pass as amended and be re-referred to the Committee on Appropriations",5,0,2,0,7
61231,23141,2009-04-21,Assembly,"Do pass and be re-referred to the Committee on Appropriations",7,0,0,0,7
61231,23142,2009-05-06,Assembly,"Do pass, to Consent Calendar",16,0,0,0,16
61231,23143,2009-05-18,Assembly,"AB 1363 DAVIS  Assembly Third Reading",77,0,0,0,77
61231,23144,2009-06-16,Senate,"Do pass, but re-refer to the Committee on Appropriations",6,0,0,0,6
61231,23145,2009-09-01,Senate,"Assembly 3rd Reading AB1363 Davis By Cedillo",24,14,0,0,38
61232,26437,2009-05-12,Assembly,"Do pass and be re-referred to the Committee on Appropriations",11,0,0,0,11
61232,26438,2009-05-20,Assembly,"Do pass, to Consent Calendar",15,0,0,0,15
61232,26439,2009-05-28,Assembly,"AB 1364 EVANS  Consent Calendar Second Day  Regular Session",76,0,0,0,76
61232,26440,2009-07-08,Senate,"Do pass, but re-refer to the Committee on Appropriations Recommend 	Consent",11,0,0,0,11
61232,26441,2009-09-02,Senate,"Special Consent #18 AB1364 Evans",39,0,0,0,39
61232,26442,2009-09-08,Assembly,"AB 1364 EVANS  Concurrence in Senate Amendments",78,0,0,0,78
61234,22970,2009-04-28,Assembly,"Do pass and be re-referred to the Committee on Appropriations",11,2,0,0,13
61234,22971,2009-05-13,Assembly,"Do pass",11,4,0,0,15
61234,22972,2009-05-28,Assembly,"AB 1366 FEUER  Assembly Third Reading",60,16,0,0,76
61234,22973,2009-07-06,Senate,"Do pass as amended, and re-refer to the Committee on 	Appropriations",5,2,0,0,7
61234,22974,2009-09-03,Senate,"Assembly 3rd Reading AB1366 Feuer By Lowenthal",24,10,0,0,34
61234,22975,2009-09-09,Assembly,"AB 1366 FEUER  Concurrence in Senate Amendments",56,15,0,0,71
61235,8123,2009-04-21,Assembly,"Do pass as amended and be re-referred to the Committee on Appropriations",5,2,0,0,7
61235,8124,2009-05-20,Assembly,"Do pass",5,10,1,0,16
61236,26005,2009-04-28,Assembly,"Do pass and be re-referred to the Committee on Appropriations",7,0,0,0,7
61236,26006,2009-05-13,Assembly,"Do pass",16,0,0,0,16
61236,26007,2009-05-26,Assembly,"AB 1368 ADAMS  Assembly Third Reading",76,0,0,0,76
61236,26008,2009-06-23,Senate,"Do pass, but re-refer to the Committee on Appropriations",5,0,0,0,5
61236,26009,2009-08-31,Senate,"Assembly 3rd Reading AB1368 Adams By Maldonado",36,0,0,0,36
61237,2068,2009-04-28,Assembly,"Do pass and be re-referred to the Committee on Appropriations",7,0,0,0,7
61237,2069,2009-05-13,Assembly,"Do pass, to Consent Calendar",16,0,0,0,16
61237,2070,2009-05-26,Assembly,"AB 1369 DAVIS  Assembly Third Reading",79,0,1,0,80
61237,2071,2009-07-07,Senate,"Do pass as amended, and re-refer to the Committee on Appropriations",7,0,0,0,7
61237,2072,2009-09-01,Senate,"Assembly 3rd Reading AB1369 Davis By Pavley",27,8,5,0,40
61237,2073,2009-09-01,Senate,"Assembly 3rd Reading AB1369 Davis Reconsider",36,0,4,0,40
61237,2074,2009-09-04,Senate,"Assembly 3rd Reading AB1369 Davis By Pavley",23,8,9,0,40
61237,9950,2010-06-29,Senate,"Do pass as amended, and re-refer to the Committee on Appropriations",5,1,1,0,7
61237,20878,2010-08-23,Senate,"Assembly 3rd Reading AB1369 Davis By Wright",25,9,0,0,34
61237,21020,2010-08-24,Assembly,"AB 1369 DAVIS  Concurrence in Senate Amendments",40,24,0,0,64
61237,21513,2010-08-26,Assembly,"Senate amendments be concurred in",4,0,0,0,4
61237,21576,2010-08-27,Assembly,"AB 1369 DAVIS  Concurrence in Senate Amendments",55,19,0,0,74
61238,8143,2010-01-07,Assembly,"Be referred to Committee on Business and Professions",10,0,1,0,11
61239,8107,2009-04-27,Assembly,"Do pass as amended and be re-referred to the Committee on Natural Resources",11,3,1,0,15
61240,8125,2009-04-28,Assembly,"Do pass as amended and be re-referred to the Committee on Appropriations",13,5,1,0,19
61241,151,2009-04-20,Assembly,"Do pass and be re-referred to the Committee on Appropriations.",6,3,0,0,9
61241,152,2009-05-28,Assembly,"Do pass.",12,5,0,0,17
61241,153,2009-06-03,Assembly,"AB 1373 SKINNER  Assembly Third Reading",48,30,2,0,80
61241,9469,2010-06-22,Senate,"Do pass as amended, and re-refer to the Committee on Appropriations",4,0,1,0,5
61241,19900,2010-08-12,Senate,"Assembly 3rd Reading AB1373 Lieu By Lowenthal",22,9,0,0,31
61241,21497,2010-08-24,Assembly,"Senate amendments be concurred in",9,0,0,0,9
61241,21498,2010-08-25,Assembly,"AB 1373 LIEU  Concurrence in Senate Amendments",62,16,0,0,78
61242,1389,2010-01-13,Assembly,"Do pass as amended, to Consent Calendar",10,0,1,0,11
61242,1390,2010-01-21,Assembly,"AB 1374 BROWNLEY  Consent Calendar Second Day",67,0,11,0,78
61242,1391,2010-05-05,Senate,"Do pass and be placed on the Consent Calendar",7,0,1,0,8
61242,1392,2010-05-13,Senate,"Consent Calendar 2nd AB1374 Brownley",31,0,7,0,38
61242,9081,2010-06-17,Assembly,"AB 1374 BROWNLEY  Concurrence in Senate Amendments",70,0,9,0,79
61243,3810,2009-04-27,Assembly,"Do pass and be re-referred to the Committee on Appropriations",9,4,1,0,14
61243,3811,2010-01-21,Assembly,"Do pass",12,5,0,0,17
61243,3812,2010-01-27,Assembly,"AB 1375 GALGIANI  Assembly Third Reading",42,20,16,0,78
61244,8135,2009-04-28,Assembly,"Do pass and be re-referred to the Committee on Appropriations",5,2,0,0,7
61244,8136,2009-05-28,Assembly,"Do pass",12,5,0,0,17
61244,8137,2009-06-02,Assembly,"AB 1376 BASS  Assembly Third Reading",50,29,1,0,80
61245,8138,2009-04-15,Assembly,"Do pass as amended and be re-referred to the Committee on Appropriations",6,1,4,0,11
61246,8115,2010-01-05,Assembly,"Do pass and be re-referred to the Committee on Veterans Affairs to Consent Calendar",6,0,1,0,7
61246,8116,2010-01-12,Assembly,"Do pass and be re-referred to the Committee on Appropriations",8,0,1,0,9
61246,8117,2010-01-21,Assembly,"Do pass",17,0,0,0,17
61246,8118,2010-01-25,Assembly,"AB 1378 PEREZ, V.M.  Assembly Third Reading",67,0,11,0,78
61246,8119,2010-06-09,Senate,"Do pass, but re-refer to the Committee on Veterans Affairs",4,0,2,0,6
61246,9463,2010-06-22,Senate,"Do pass, but re-refer to the Committee on Appropriations",4,0,1,0,5
61246,19741,2010-08-02,Senate,"Placed on Appropriations Suspense file",10,0,0,0,10
61246,20010,2010-08-12,Senate,"Do pass as amended",11,0,0,0,11
61247,8126,2009-04-20,Assembly,"Do pass as amended and be re-referred to the Committee on Appropriations",8,2,4,0,14
61247,8127,2009-05-14,Assembly,"AB 1379 HILL  Assembly Third Reading",50,18,12,0,80
61247,8128,2009-07-07,Senate,"Do pass as amended",7,3,1,0,11
61247,8129,2009-08-27,Senate,"Assembly 3rd Reading AB1379 Hill By Simitian",25,13,2,0,40
61247,8130,2009-08-31,Assembly,"AB 1379 HILL  Concurrence in Senate Amendments",54,20,5,0,79
61248,8111,2009-04-21,Assembly,"Do pass and be re-referred to the Committee on Appropriations",5,2,0,0,7
61248,8112,2009-05-20,Assembly,"Do pass",11,4,1,0,16
61248,8113,2009-06-02,Assembly,"AB 1380 BASS  Assembly Third Reading",51,28,1,0,80
61249,23283,2009-04-13,Assembly,"Do pass as amended and be re-referred to the Committee on 	Appropriations",9,1,0,0,10
61249,23284,2009-04-29,Assembly,"Do pass",14,2,0,0,16
61249,23285,2009-05-14,Assembly,"AB 1381 PEREZ, J.  Assembly Third Reading",64,3,0,0,67
61249,23286,2009-06-16,Senate,"Do pass, but re-refer to the Committee on Appropriations",9,1,0,0,10
61249,23287,2009-08-24,Senate,"Assembly 3rd Reading AB1381 John A. Perez By Lowenthal",31,2,0,0,33
61251,25438,2009-05-05,Assembly,"Do pass and be re-referred to the Committee on Appropriations",15,0,0,0,15
61251,25439,2009-05-28,Assembly,"Do pass as amended",12,4,0,0,16
61251,25440,2009-06-02,Assembly,"AB 1383 JONES  Third Reading Urgency",71,3,0,0,74
61251,25441,2009-07-08,Senate,"Do pass, but re-refer to the Committee on Appropriations",7,3,0,0,10
61251,25442,2009-07-23,Senate,"Do pass as amended",8,5,0,0,13
61251,25443,2009-09-09,Senate,"Do pass, but re-refer to the Committee on Appropriations",9,1,0,0,10
61251,25444,2009-09-11,Senate,"Do pass",9,2,0,0,11
61251,25445,2009-09-12,Senate,"Assembly 3rd Supp 2 AB1383 Jones Urgency Clause",24,5,0,0,29
61251,25446,2009-09-12,Senate,"Assembly 3rd Supp 2 AB1383 Jones Reconsider",39,0,0,0,39
61251,25447,2009-09-12,Senate,"Assembly 3rd Supp 2 AB1383 Jones Re-Refer",22,12,0,0,34
61251,25448,2009-09-12,Senate,"Assembly 3rd Supp 2 AB1383 Jones By Alquist",24,5,0,0,29
61251,25449,2009-09-12,Assembly,"AB 1383 JONES  Concurrence in Senate Amendments",52,22,0,0,74
61252,8206,2009-04-27,Assembly,"Do pass and be re-referred to the Committee on Appropriations",3,6,0,0,9
61252,8207,2009-04-27,Assembly,"Set first hearing.  Failed passage.  Reconsideration granted",8,1,0,0,9
61252,8208,2009-04-27,Assembly,"Amend, and re-refer to the Committee on Natural Resources",5,1,3,0,9
61253,8209,2009-04-27,Assembly,"Do pass, to Consent Calendar",13,0,1,0,14
61253,8210,2009-05-04,Assembly,"AB 1385 MILLER  Consent Calendar Second Day  Regular Session",79,0,1,0,80
61253,8211,2009-06-16,Senate,"Do pass, but re-refer to the Committee on Public Safety Recommend Consent",11,0,0,0,11
61253,8212,2009-07-14,Senate,"Do pass",7,0,0,0,7
61253,8213,2009-09-04,Senate,"Assembly 3rd Reading AB1385 Miller By Lowenthal",39,0,1,0,40
61253,8214,2009-09-09,Assembly,"AB 1385 MILLER  Concurrence in Senate Amendments",77,0,2,0,79
61254,25565,2009-04-20,Assembly,"Do pass as amended and be re-referred to the Committee on 	Appropriations",11,3,0,0,14
61254,25566,2009-05-28,Assembly,"Do pass",12,4,0,0,16
61254,25567,2009-06-01,Assembly,"AB 1386 HAYASHI  Assembly Third Reading",55,21,0,0,76
61254,25568,2009-07-07,Senate,"Do pass, but re-refer to the Committee on Appropriations",6,3,0,0,9
61254,25569,2009-08-24,Senate,"Placed on Appropriations Suspense file",13,0,0,0,13
61254,25570,2009-08-27,Senate,"Do pass",8,5,0,0,13
61254,25571,2009-09-08,Senate,"Assembly 3rd Reading AB1386 Hayashi By Corbett",25,14,0,0,39
61254,25572,2009-09-10,Assembly,"AB 1386 HAYASHI  Concurrence in Senate Amendments",50,28,0,0,78
61256,26610,2009-05-06,Assembly,"Do pass as amended",7,0,0,0,7
61256,26611,2009-05-14,Assembly,"AB 1388 HERNANDEZ  Assembly Third Reading",75,0,0,0,75
61256,26612,2009-06-17,Senate,"Do pass as amended",5,0,0,0,5
61256,26613,2009-08-24,Senate,"Assembly 3rd Reading AB1388 Hernandez By Ducheny",39,0,0,0,39
61256,26614,2009-08-27,Assembly,"AB 1388 HERNANDEZ  Concurrence in Senate Amendments",77,0,0,0,77
61258,23711,2009-04-22,Assembly,"Do pass and be re-referred to the Committee on Public Safety",8,0,0,0,8
61258,23712,2009-04-28,Assembly,"Do pass as amended and be re-referred to the Committee on 	Appropriations",7,0,0,0,7
61258,23713,2009-05-28,Assembly,"Do pass as amended",13,3,0,0,16
61258,23714,2009-06-02,Assembly,"AB 1390 BLUMENFIELD  Assembly Third Reading",76,1,0,0,77
61258,23715,2009-07-08,Senate,"Do pass, but re-refer to the Committee on Public Safety",9,0,0,0,9
61258,23716,2009-07-14,Senate,"Do pass as amended, and re-refer to the Committee on 	Appropriations",7,0,0,0,7
61258,23717,2009-09-01,Senate,"Assembly 3rd Reading AB1390 Blumenfield By Padilla",35,0,0,0,35
61258,23718,2009-09-03,Assembly,"AB 1390 BLUMENFIELD  Concurrence in Senate Amendments",77,0,0,0,77
61259,8226,2010-01-12,Assembly,"Do pass and be re-referred to the Committee on Appropriations",7,1,3,0,11
61259,8227,2010-01-21,Assembly,"Do pass",12,4,1,0,17
61259,8228,2010-01-27,Assembly,"AB 1391 ENG  Assembly Third Reading",51,17,10,0,78
61260,8215,2009-04-28,Assembly,"Do pass and be re-referred to the Committee on Appropriations",7,0,0,0,7
61261,26345,2009-04-21,Assembly,"Do pass and be re-referred to the Committee on Appropriations",9,0,0,0,9
61261,26346,2009-04-29,Assembly,"Do pass",16,0,0,0,16
61261,26347,2009-05-11,Assembly,"AB 1393 SKINNER  Assembly Third Reading",80,0,0,0,80
61261,26348,2009-06-17,Senate,"Do pass as amended, and re-refer to the Committee on Appropriations",7,0,0,0,7
61261,26349,2009-08-27,Senate,"Assembly 3rd Reading AB1393 Skinner By Leno",32,2,0,0,34
61261,26350,2009-08-31,Assembly,"AB 1393 SKINNER  Concurrence in Senate Amendments",77,0,0,0,77
61262,8216,2009-04-22,Assembly,"Do pass and be re-referred to the Committee on Appropriations",7,0,0,0,7
61262,8217,2009-05-20,Assembly,"Do pass, to Consent Calendar",15,0,1,0,16
61262,8218,2009-05-28,Assembly,"AB 1394 BASS  Consent Calendar Second Day  Regular Session",76,0,4,0,80
61262,8219,2009-06-25,Senate,"Do pass, but re-refer to the Committee on Appropriations",5,1,0,0,6
61262,8220,2009-07-06,Senate,"Do pass as amended",8,3,2,0,13
61262,8221,2009-09-04,Senate,"Assembly 3rd Reading AB1394 Bass By DeSaulnier",26,13,1,0,40
61262,8222,2009-09-09,Assembly,"AB 1394 BASS  Concurrence in Senate Amendments",78,0,1,0,79
61263,8223,2009-04-27,Assembly,"Do pass and re-refer to Committee on Appropriations with recommendation:  To Consent Calendar",9,0,0,0,9
61263,8224,2009-05-13,Assembly,"Do pass, to Consent Calendar",16,0,0,0,16
61263,8225,2009-05-21,Assembly,"AB 1395 TORRICO  Consent Calendar Second Day  Regular Session",77,0,3,0,80
61264,23670,2009-05-05,Assembly,"Do pass, to Consent Calendar",7,0,0,0,7
61264,23671,2009-05-11,Assembly,"AB 1396 TORRES  Consent Calendar Second Day  Regular Session",78,0,0,0,78
61264,23672,2009-06-16,Senate,"Do pass and be placed on the Consent Calendar",5,0,0,0,5
61264,23673,2009-09-04,Senate,"Assembly 3rd Reading AB1396 Torres By Negrete McLeod",40,0,0,0,40
61264,23674,2009-09-09,Assembly,"AB 1396 TORRES  Concurrence in Senate Amendments",78,0,0,0,78
61265,8200,2009-04-28,Assembly,"Do pass and re-refer to Committee on Appropriations with recommendation:  To Consent Calendar",18,0,1,0,19
61265,8201,2009-05-13,Assembly,"Do pass, to Consent Calendar",16,0,0,0,16
61265,8202,2009-06-01,Assembly,"AB 1397 HILL  Assembly Third Reading",79,0,1,0,80
61265,8203,2009-07-08,Senate,"Do pass as amended, and re-refer to the Committee on Appropriations",11,0,0,0,11
61265,8204,2009-09-01,Senate,"Assembly 3rd Reading AB1397 Hill Urgency Clause",31,0,9,0,40
61265,8205,2009-09-03,Assembly,"AB 1397 HILL  Concurrence in Senate Amendments",78,0,1,0,79
61266,25014,2009-04-22,Assembly,"Do pass, to Consent Calendar",10,0,0,0,10
61266,25015,2009-05-04,Assembly,"AB 1398 BLUMENFIELD  Assembly Third Reading",80,0,0,0,80
61266,25016,2009-07-08,Senate,"Do pass as amended",5,2,0,0,7
61266,25017,2009-09-03,Senate,"Assembly 3rd Reading AB1398 Blumenfield By Ashburn",33,3,0,0,36
61266,25018,2009-09-09,Assembly,"AB 1398 BLUMENFIELD  Concurrence in Senate Amendments",77,0,0,0,77
61267,8197,2010-01-04,Assembly,"Be referred to Committee on Local Government",10,0,1,0,11
61267,8198,2010-01-13,Assembly,"Do pass",5,0,2,0,7
61267,8199,2010-01-25,Assembly,"AB 1399 ANDERSON  Assembly Third Reading",66,0,12,0,78
61267,9064,2010-06-16,Senate,"Do pass",3,1,1,0,5
61267,10046,2010-07-01,Senate,"Assembly 3rd Reading AB1399 Anderson By Strickland",29,0,10,0,39
61267,19321,2010-08-02,Assembly,"AB 1399 ANDERSON  Concurrence in Senate Amendments",76,0,0,0,76
61268,8191,2009-04-21,Assembly,"Do pass and be re-referred to the Committee on Appropriations",9,0,0,0,9
61268,8192,2009-04-29,Assembly,"Do pass as amended",11,0,5,0,16
61268,8193,2009-05-21,Assembly,"AB 1400 FONG  Assembly Third Reading",78,0,2,0,80
61268,8194,2009-07-15,Senate,"Do pass, but re-refer to the Committee on Appropriations",8,0,1,0,9
61268,8195,2009-09-01,Senate,"Assembly 3rd Reading AB1400 Fong By Hancock",32,5,3,0,40
61268,8196,2009-09-03,Assembly,"AB 1400 FONG  Concurrence in Senate Amendments",78,0,1,0,79
61269,8170,2009-04-29,Assembly,"Do pass as amended and be re-referred to the Committee on Appropriations",8,0,0,0,8
61269,8171,2009-05-13,Assembly,"Do pass",12,4,0,0,16
61269,8172,2009-05-28,Assembly,"AB 1401 MA  Assembly Third Reading",60,16,4,0,80
61269,8173,2009-07-07,Senate,"Do pass, but re-refer to the Committee on Appropriations",4,1,0,0,5
61269,8174,2009-07-23,Senate,"Do pass as amended",8,5,0,0,13
61269,8175,2009-09-09,Senate,"Assembly 3rd Reading AB1401 Ma By Leno",23,12,5,0,40
61269,8176,2009-09-10,Assembly,"AB 1401 Ma  Concurrence in Senate Amendments",62,14,4,0,80
61270,8142,2009-04-28,Assembly,"Do pass and be re-referred to the Committee on Appropriations",5,1,1,0,7
61271,22859,2009-04-20,Assembly,"Do pass as amended",14,0,0,0,14
61271,22860,2009-05-11,Assembly,"AB 1403 ENG  Assembly Third Reading",79,1,0,0,80
61271,22861,2009-06-23,Senate,"Do pass",9,2,0,0,11
61271,22862,2009-08-24,Senate,"Assembly 3rd Reading AB1403 Eng By Huff",33,7,0,0,40
61272,8158,2009-04-20,Assembly,"Do pass and be re-referred to the Committee on Appropriations",5,3,1,0,9
61272,8159,2009-05-28,Assembly,"Do pass as amended",12,5,0,0,17
61272,8160,2009-06-03,Assembly,"AB 1404 DE LEON  Assembly Third Reading",45,30,5,0,80
61272,8161,2009-07-06,Senate,"Do pass, but re-refer to the Committee on Appropriations",5,2,0,0,7
61272,8162,2009-07-23,Senate,"Placed on Appropriations Suspense file",13,0,0,0,13
61272,8163,2009-08-27,Senate,"Do pass",8,5,0,0,13
61272,8164,2009-09-11,Senate,"Assembly 3rd Reading AB1404 De Leon By Leno",21,19,0,0,40
61272,8165,2009-09-12,Assembly,"AB 1404 DE LEON  Concurrence in Senate Amendments",44,29,6,0,79
61273,8183,2009-04-20,Assembly,"Do pass as amended and be re-referred to the Committee on Appropriations",6,3,0,0,9
61273,8184,2009-05-28,Assembly,"Do pass as amended",12,5,0,0,17
61273,8185,2009-06-03,Assembly,"AB 1405 DE LEON  Assembly Third Reading",45,30,5,0,80
61273,8186,2009-07-07,Senate,"Do pass, but re-refer to the Committee on Environmental Quality",6,5,0,0,11
61273,8187,2009-07-13,Senate,"Do pass as amended, and re-refer to the Committee on Appropriations",5,2,0,0,7
61273,8188,2009-08-17,Senate,"Placed on Appropriations Suspense file",13,0,0,0,13
61273,8189,2009-08-27,Senate,"Do pass as amended",8,5,0,0,13
61273,21453,2010-08-25,Senate,"From Committee:  Amendments returned to Senate floor for 	consideration",5,2,0,0,7
61273,21742,2010-08-30,Senate,"Assembly 3rd Reading AB1405 De Leon By Lowenthal",22,15,0,0,37
61273,21846,2010-08-31,Assembly,"AB 1405 DE LEON  Concurrence in Senate Amendments",49,29,0,0,78
61274,23853,2009-05-06,Assembly,"Do pass as amended",6,0,0,0,6
61274,23854,2009-05-26,Assembly,"AB 1406 EMMERSON  Assembly Third Reading",77,1,0,0,78
61274,23855,2009-06-22,Senate,"Do pass",7,0,0,0,7
61274,23856,2009-08-24,Senate,"Assembly 3rd Reading AB1406 Emmerson By Ashburn",36,0,0,0,36
61275,8190,2009-04-15,Assembly,"Do pass as amended and be re-referred to the Committee on Appropriations",9,0,2,0,11
61276,8166,2009-04-22,Assembly,"Do pass as amended and be re-referred to the Committee on Water, Parks and Wildlife",5,2,0,0,7
61276,8167,2009-04-28,Assembly,"Do pass as amended and be re-referred to the Committee on Appropriations",8,4,1,0,13
61276,8168,2009-05-28,Assembly,"Do pass",10,5,2,0,17
61276,8169,2009-06-02,Assembly,"AB 1408 KREKORIAN  Assembly Third Reading",34,32,14,0,80
61277,8180,2009-05-06,Assembly,"Do pass and be re-referred to the Committee on Transportation",6,1,0,0,7
61277,8181,2009-05-11,Assembly,"Do pass as amended",14,0,0,0,14
61277,8182,2009-06-03,Assembly,"AB 1409 PEREZ, J.  Assembly Third Reading",66,9,5,0,80
61279,8147,2009-05-20,Assembly,"Do pass",12,1,3,0,16
61280,8229,2009-04-30,Assembly,"Do pass as amended and be re-referred to the Committee on Appropriations",6,0,1,0,7
61280,8230,2009-05-20,Assembly,"Do pass",14,0,2,0,16
61281,8246,2009-05-06,Assembly,"Do pass as amended, to Consent Calendar",9,0,1,0,10
61281,8247,2009-05-14,Assembly,"AB 1413 COTO  Consent Calendar Second Day  Regular Session",73,0,7,0,80
61281,21983,2010-08-31,Senate,"W/O REF. TO FILE AB1413 Fuentes and Coto By Cedillo",23,13,0,0,36
61281,21984,2010-08-31,Assembly,"AB 1413 FUENTES  Concurrence in Senate Amendments",47,28,0,0,75
61282,647,2010-01-04,Assembly,"Be referred to Committee on Public Safety.",10,0,1,0,11
61282,648,2010-01-12,Assembly,"Do pass and re-refer to Committee on Appropriations with recommendation:  To Consent Calendar.",7,0,0,0,7
61282,649,2010-01-21,Assembly,"Do pass, to Consent Calendar.",17,0,0,0,17
61282,650,2010-01-27,Assembly,"AB 1414 HILL  Assembly Third Reading",73,0,5,0,78
61282,8732,2010-06-15,Senate,"Do pass",7,0,0,0,7
61282,9619,2010-06-28,Senate,"Special Consent #28 AB1414 Hill",32,0,7,0,39
61282,10109,2010-07-01,Assembly,"AB 1414 HILL  Concurrence in Senate Amendments",77,0,2,0,79
61283,8266,2009-04-21,Assembly,"Do pass and be re-referred to the Committee on Transportation",2,5,0,0,7
61283,8267,2009-04-21,Assembly,"Set first hearing.  Failed passage.  Reconsideration granted",7,0,0,0,7
61284,201,2009-04-14,Assembly,"Do pass and be re-referred to the Committee on Appropriations.",8,0,3,0,11
61284,202,2009-04-29,Assembly,"Do pass, to Consent Calendar.",16,0,0,0,16
61284,203,2009-05-11,Assembly,"AB 1416 GALGIANI  Consent Calendar Second Day  Regular Session",78,0,2,0,80
61284,204,2009-06-08,Senate,"Do pass, but re-refer to the Committee on Appropriations.",4,2,4,0,10
61284,205,2009-06-08,Senate,"Set, first hearing.  Failed passage in Committee.  Reconsideration granted.",7,0,3,0,10
61288,8268,2010-01-05,Assembly,"Do pass and be re-referred to the Committee on Higher Education to Consent Calendar",6,0,1,0,7
61288,8269,2010-01-11,Assembly,"Do pass",8,0,0,0,8
61288,8270,2010-01-19,Assembly,"AB 1420 PEREZ, V.M.  Assembly Third Reading",71,0,7,0,78
61289,8271,2009-04-22,Assembly,"Do pass and be re-referred to the Committee on Appropriations",5,2,0,0,7
61289,8272,2009-05-28,Assembly,"Do pass as amended",12,5,0,0,17
61290,23076,2009-05-13,Assembly,"Do pass",4,1,0,0,5
61290,23077,2009-05-28,Assembly,"AB 1422 BASS  Assembly Third Reading",54,25,0,0,79
61290,23078,2009-06-23,Senate,"Do pass",7,4,0,0,11
61290,23079,2009-08-26,Senate,"Do pass, but re-refer to the Committee on Appropriations",7,0,0,0,7
61290,23080,2009-08-27,Senate,"Do pass",11,1,0,0,12
61290,23081,2009-09-02,Assembly,"Senate amendments be concurred in",6,2,0,0,8
61290,23082,2009-09-02,Assembly,"Be referred to Committee on Revenue and Taxation",12,0,0,0,12
61290,23083,2009-09-02,Senate,"Assembly 3rd Reading AB1422 Bass Urgency Clause",27,8,0,0,35
61290,23084,2009-09-03,Assembly,"Senate amendments be concurred in",10,3,0,0,13
61290,23085,2009-09-03,Assembly,"AB 1422 BASS  Concurrence- Urgency Added",62,5,0,0,67
61291,23933,2009-04-28,Assembly,"Do pass as amended and be re-referred to the Committee on 	Appropriations",12,0,0,0,12
61291,23934,2009-05-20,Assembly,"Do pass",14,0,0,0,14
61291,23935,2009-06-02,Assembly,"AB 1423 BERRYHILL, T.  Assembly Third Reading",73,4,0,0,77
61291,23936,2009-07-06,Senate,"Do pass as amended, and re-refer to the Committee on Appropriations",9,0,0,0,9
61291,23937,2009-08-17,Senate,"Do pass",12,0,0,0,12
61291,23938,2009-09-08,Senate,"Assembly 3rd Reading AB1423 Tom Berryhill By Cogdill",38,0,0,0,38
61291,23939,2009-09-10,Assembly,"AB 1423 BERRYHILL, T.  Concurrence in Senate Amendments",72,2,0,0,74
61292,8255,2009-04-21,Assembly,"Do pass and be re-referred to the Committee on Transportation",2,5,0,0,7
61292,8256,2009-04-21,Assembly,"Set first hearing.  Failed passage.  Reconsideration granted",7,0,0,0,7
61297,8239,2009-04-22,Assembly,"Do pass and be re-referred to the Committee on Appropriations",4,2,0,0,6
61299,581,2010-01-07,Assembly,"Be referred to Committee on Business and Professions.",10,0,1,0,11
61299,582,2010-01-12,Assembly,"Do pass and be re-referred to the Committee on Appropriations.",11,0,0,0,11
61299,583,2010-01-21,Assembly,"Do pass, to Consent Calendar.",17,0,0,0,17
61299,584,2010-01-27,Assembly,"AB 1431 HILL  Consent Calendar Second Day  Regular Session",68,0,10,0,78
61299,585,2010-03-22,Senate,"Do pass as amended, and re-refer to the Committee on Appropriations.",8,0,1,0,9
61299,20375,2010-08-11,Senate,"Assembly 3rd Reading AB1431 Hill By Aanestad",34,0,0,0,34
61299,20376,2010-08-16,Assembly,"AB 1431 HILL  Concurrence in Senate Amendments",74,0,0,0,74
61299,21689,2010-08-30,Senate,"W/O REF. TO FILE AB1431 Hill",37,0,0,0,37
61299,21784,2010-08-31,Assembly,"AB 1431 HILL  Concurrence in Senate Amendments",78,0,0,0,78
61301,644,2010-01-12,Assembly,"Do pass and be re-referred to the Committee on Appropriations to Consent Calendar.",6,0,1,0,7
61301,645,2010-01-21,Assembly,"Do pass, to Consent Calendar.",17,0,0,0,17
61301,646,2010-01-27,Assembly,"AB 1433 ENG  Consent Calendar Second Day  Regular Session",68,0,10,0,78
61301,9198,2010-06-22,Senate,"Do pass as amended, and re-refer to the Committee on Appropriations",5,0,0,0,5
61301,19904,2010-08-12,Senate,"Assembly 3rd Reading AB1433 Eng By Wolk",35,0,0,0,35
61301,20347,2010-08-17,Assembly,"AB 1433 ENG  Concurrence in Senate Amendments",77,0,0,0,77
61302,8257,2009-04-28,Assembly,"Do pass as amended and be re-referred to the Committee on Appropriations",5,2,0,0,7
61303,8258,2009-04-22,Assembly,"Do pass as amended and be re-referred to the Committee on Appropriations",10,0,1,0,11
61303,8259,2009-05-28,Assembly,"Do pass",17,0,0,0,17
61303,8260,2009-06-01,Assembly,"AB 1435 PEREZ, V.M.  Assembly Third Reading",79,0,1,0,80
61303,8261,2009-07-15,Senate,"Do pass, but re-refer to the Committee on Appropriations",8,0,1,0,9
61303,8262,2009-08-17,Senate,"Placed on Appropriations Suspense file",13,0,0,0,13
61303,8263,2009-08-27,Senate,"Do pass",13,0,0,0,13
61303,8264,2009-09-04,Senate,"Special Consent #19 AB1435 V. Manuel Perez By Ducheny",40,0,0,0,40
61304,3160,2010-01-07,Assembly,"Be referred to Committee on Higher Education",10,0,1,0,11
61304,3161,2010-01-11,Assembly,"Do pass and be re-referred to the Committee on Appropriations",8,0,0,0,8
61304,3162,2010-01-21,Assembly,"Do pass",17,0,0,0,17
61304,3163,2010-01-25,Assembly,"AB 1436 Portantino  Assembly Third Reading",67,0,11,0,78
61304,3164,2010-05-05,Senate,"Do pass as amended, but re-refer to the Committee on Appropriations Recommend Consent",7,0,1,0,8
61304,21350,2010-08-23,Senate,"Assembly 3rd Reading AB1436 Portantino By Liu",36,0,0,0,36
61304,21351,2010-08-24,Assembly,"AB 1436 PORTANTINO  Concurrence in Senate Amendments",76,0,0,0,76
61305,4284,2009-04-29,Assembly,"Do pass and be re-referred to the Committee on Appropriations",8,0,0,0,8
61305,4285,2009-05-13,Assembly,"Do pass",10,3,3,0,16
61305,4286,2009-05-26,Assembly,"AB 1437 HUFFMAN  Assembly Third Reading",65,12,3,0,80
61305,4287,2009-06-16,Senate,"Do pass, but re-refer to the Committee on Health",4,1,0,0,5
61305,8956,2010-06-17,Senate,"Assembly 3rd Reading AB1437 Huffman By Florez",23,7,9,0,39
61305,9094,2010-06-21,Assembly,"AB 1437 HUFFMAN  Concurrence in Senate Amendments",65,9,5,0,79
61306,23120,2009-04-21,Assembly,"Do pass and be re-referred to the Committee on Water, Parks and 	Wildlife",7,0,0,0,7
61306,23121,2009-04-28,Assembly,"Do pass as amended and be re-referred to the Committee on 	Appropriations",13,0,0,0,13
61306,23122,2009-05-28,Assembly,"Do pass",17,0,0,0,17
61306,23123,2009-06-01,Assembly,"AB 1438 CONWAY  Assembly Third Reading",79,0,0,0,79
61306,23124,2009-07-06,Senate,"Do pass as amended, and re-refer to the Committee on 	Appropriations",7,0,0,0,7
61306,23125,2009-08-17,Senate,"Placed on Appropriations Suspense file",13,0,0,0,13
61306,23126,2009-08-27,Senate,"Do pass",13,0,0,0,13
61306,23127,2009-09-09,Senate,"Special Consent #20 AB1438 Conway By Aanestad",40,0,0,0,40
61306,23128,2009-09-11,Assembly,"AB 1438 CONWAY  Concurrence in Senate Amendments",79,0,0,0,79
61307,8248,2009-04-28,Assembly,"Do pass and be re-referred to the Committee on Appropriations",5,2,0,0,7
61307,8249,2009-05-13,Assembly,"Do pass",11,0,5,0,16
61307,8250,2009-05-26,Assembly,"AB 1439 SOLORIO  Assembly Third Reading",58,12,10,0,80
61307,8251,2009-07-07,Senate,"Do pass as amended, and re-refer to the Committee on Appropriations",7,0,0,0,7
61307,8252,2009-07-23,Senate,"Do pass as amended",13,0,0,0,13
61307,8253,2009-09-02,Senate,"Special Consent #18 AB1439 Solorio By Benoit",39,0,1,0,40
61307,8254,2009-09-08,Assembly,"AB 1439 SOLORIO  Concurrence in Senate Amendments",79,0,0,0,79
61308,23688,2009-04-21,Assembly,"Do pass and be re-referred to the Committee on Appropriations",7,0,0,0,7
61308,23689,2009-05-06,Assembly,"Do pass",16,0,0,0,16
61308,23690,2009-05-14,Assembly,"AB 1440 SWANSON  Assembly Third Reading",75,0,0,0,75
61308,23691,2009-07-07,Senate,"Do pass, but re-refer to the Committee on Appropriations Recommend 	Consent",5,0,0,0,5
61308,23692,2009-08-17,Senate,"Do pass",8,0,0,0,8
61308,23693,2009-08-27,Senate,"Assembly 3rd Reading AB1440 Swanson",38,0,0,0,38
61308,23694,2009-08-27,Senate,"Assembly 3rd Reading AB1440 Swanson Reconsider",38,0,0,0,38
61308,23695,2009-09-04,Senate,"Assembly 3rd Reading AB1440 Swanson By Wright",39,0,0,0,39
61308,23696,2009-09-09,Assembly,"AB 1440 SWANSON  Concurrence in Senate Amendments",78,0,0,0,78
61309,23997,2009-04-15,Assembly,"Do pass and be re-referred to the Committee on Natural Resources",8,0,0,0,8
61309,23998,2009-05-04,Assembly,"Do pass, to Consent Calendar",9,0,0,0,9
61309,23999,2009-05-11,Assembly,"AB 1441 AGRI.  Consent Calendar Second Day  Regular Session",78,0,0,0,78
61309,24000,2009-06-17,Senate,"Do pass and be placed on the Consent Calendar",5,0,0,0,5
61309,24001,2009-06-24,Senate,"Consent Calendar 2nd AB1441 Committee on AGRI. (Galgiani)",40,0,0,0,40
61310,27042,2009-04-28,Assembly,"Do pass as amended and re-refer to Committee on Appropriations 	with recommendation:  To Consent Calendar",13,0,0,0,13
61310,27043,2009-05-13,Assembly,"Do pass",16,0,0,0,16
61310,27044,2009-05-28,Assembly,"AB 1442 W., P.& W.  Assembly Third Reading  By HUFFMAN",78,0,0,0,78
61310,27045,2009-06-23,Senate,"Do pass as amended, and re-refer to the Committee on Appropriations",10,0,0,0,10
61310,27046,2009-07-13,Senate,"Do pass as amended",12,0,0,0,12
61310,27047,2009-09-01,Senate,"Assembly 3rd Reading AB1442 Committee on W.,P. & W. (Huffman) By 	Pavley",34,0,0,0,34
61310,27048,2009-09-03,Assembly,"AB 1442 W., P.& W.  Concurrence in Senate Amendments By HUFFMAN",76,0,0,0,76
61311,8654,2009-04-14,Assembly,"Do pass and be re-referred to the Committee on Public Safety to Consent Calendar",13,0,0,0,13
61311,8655,2009-04-28,Assembly,"Do pass as amended and re-refer to Committee on Appropriations with recommendation:  To Consent Calendar",7,0,0,0,7
61311,8656,2009-05-20,Assembly,"Do pass, to Consent Calendar",15,0,1,0,16
61311,8657,2009-05-28,Assembly,"AB 1443 W., P.& W.  Consent Calendar Second Day  Regular Session",76,0,4,0,80
61311,10309,2010-06-29,Senate,"Do pass, but re-refer to the Committee on Appropriations",0,3,4,0,7
61312,23639,2009-04-28,Assembly,"Do pass and be re-referred to the Committee on Appropriations",10,0,0,0,10
61312,23640,2009-05-13,Assembly,"Do pass, to Consent Calendar",16,0,0,0,16
61312,23641,2009-05-21,Assembly,"AB 1444 GARRICK  Consent Calendar Second Day  Regular Session",77,0,0,0,77
61312,23642,2009-07-08,Senate,"Do pass, but re-refer to the Committee on Appropriations",11,0,0,0,11
61312,23643,2009-08-27,Senate,"Special Consent #16 AB1444 Garrick",38,0,0,0,38
61313,8273,2009-04-21,Assembly,"Do pass and be re-referred to the Committee on Appropriations",17,0,2,0,19
61313,8274,2009-05-28,Assembly,"Do pass as amended",17,0,0,0,17
61313,8275,2009-06-02,Assembly,"AB 1445 CHESBRO  Assembly Third Reading",78,0,2,0,80
61313,8276,2009-07-08,Senate,"Do pass, but re-refer to the Committee on Appropriations",10,0,1,0,11
61313,20253,2010-08-09,Senate,"Placed on Appropriations Suspense file",10,0,0,0,10
61315,8300,2009-04-22,Assembly,"Do pass and be re-referred to the Committee on Appropriations",10,0,0,0,10
61315,8301,2009-05-06,Assembly,"Do pass, to Consent Calendar",16,0,0,0,16
61315,8302,2009-05-14,Assembly,"AB 1447 PEREZ, J.  Consent Calendar Second Day  Regular Session",73,0,7,0,80
61315,8303,2009-06-17,Senate,"Do pass, but re-refer to the Committee on Governmental Organization",10,0,2,0,12
61315,8304,2009-07-08,Senate,"Do pass, but re-refer to the Committee on Appropriations Recommend Consent",11,0,2,0,13
61315,8305,2009-08-24,Senate,"Special Consent #15 AB1447 John A. Perez By Calderon",39,0,1,0,40
61315,8306,2009-08-31,Assembly,"AB 1447 PEREZ, J.  Concurrence in Senate Amendments",76,0,3,0,79
61316,26802,2009-04-30,Assembly,"Do pass and be re-referred to the Committee on Appropriations",16,0,0,0,16
61316,26803,2009-05-13,Assembly,"Do pass, to Consent Calendar",16,0,0,0,16
61316,26804,2009-05-21,Assembly,"AB 1448 BERRYHILL, T.  Consent Calendar Second Day  Regular Session",77,0,0,0,77
61316,26805,2009-07-08,Senate,"Do pass, but re-refer to the Committee on Appropriations Recommend 	Consent",11,0,0,0,11
61316,26806,2009-08-27,Senate,"Special Consent #16 AB1448 Tom Berryhill",38,0,0,0,38
61317,8289,2009-04-21,Assembly,"Do pass and re-refer to Committee on Appropriations with recommendation:  To Consent Calendar",19,0,0,0,19
61317,8290,2009-05-06,Assembly,"Do pass, to Consent Calendar",16,0,0,0,16
61317,8291,2009-05-14,Assembly,"AB 1449 DE LEON  Consent Calendar Second Day  Regular Session",73,0,7,0,80
61317,8292,2009-07-15,Senate,"Do pass as amended, and re-refer to the Committee on Appropriations",9,0,2,0,11
61317,8293,2009-08-24,Senate,"Placed on Appropriations Suspense file",13,0,0,0,13
61319,3757,2010-01-07,Assembly,"Be referred to Committee on Local Government",10,0,1,0,11
61319,3758,2010-01-13,Assembly,"Do pass",4,1,2,0,7
61319,3759,2010-01-27,Assembly,"AB 1451 AMMIANO  Assembly Third Reading",41,29,8,0,78
61319,3760,2010-04-07,Senate,"Do pass as amended",3,2,0,0,5
61319,20950,2010-08-23,Senate,"Assembly 3rd Reading AB1451 Ammiano By Cedillo",23,13,0,0,36
61319,21230,2010-08-25,Assembly,"AB 1451 AMMIANO  Concurrence in Senate Amendments",47,30,0,0,77
61320,8299,2009-04-27,Assembly,"Do pass and be re-referred to the Committee on Appropriations",6,3,0,0,9
61323,8307,2009-05-05,Assembly,"Do pass as amended",9,0,0,0,9
61323,8308,2009-05-14,Assembly,"AB 1455 HILL  Assembly Third Reading",75,0,5,0,80
61323,8309,2009-06-17,Senate,"Do pass as amended",6,1,2,0,9
61323,9265,2010-06-22,Senate,"Do pass, but re-refer to the Committee on Judiciary",6,1,0,0,7
61325,26095,2009-05-05,Assembly,"Do pass as amended",19,0,0,0,19
61325,26096,2009-05-18,Assembly,"AB 1457 DAVIS  Assembly Third Reading",77,0,0,0,77
61325,26097,2009-07-08,Senate,"Do pass",11,0,0,0,11
61325,26098,2009-08-17,Senate,"Special Consent #14 AB1457 Davis",35,0,0,0,35
61325,26099,2009-08-20,Assembly,"AB 1457 DAVIS  Concurrence in Senate Amendments",78,0,0,0,78
61326,8286,2009-04-21,Assembly,"Do pass and be re-referred to the Committee on Health",7,3,1,0,11
61326,8287,2009-04-28,Assembly,"Do pass as amended and be re-referred to the Committee on Appropriations",10,5,4,0,19
61327,23048,2009-04-29,Assembly,"Do pass",7,0,0,0,7
61327,23049,2009-05-04,Assembly,"AB 1459 DAVIS  Assembly Third Reading",77,0,0,0,77
61327,23050,2009-06-09,Senate,"Do pass as amended, and re-refer to the Committee on Judiciary",10,0,0,0,10
61327,23051,2009-07-16,Senate,"Special Consent #13 AB1459 Davis",36,0,0,0,36
61327,23052,2009-08-17,Assembly,"AB 1459 DAVIS  Concurrence in Senate Amendments",77,0,0,0,77
61329,8277,2009-04-21,Assembly,"Do pass and be re-referred to the Committee on Appropriations",7,3,1,0,11
61330,8278,2009-04-28,Assembly,"Do pass and re-refer to Committee on Appropriations with recommendation:  To Consent Calendar",18,0,1,0,19
61330,8279,2009-05-13,Assembly,"Do pass, to Consent Calendar",16,0,0,0,16
61330,8280,2009-05-21,Assembly,"AB 1462 FEUER  Consent Calendar Second Day  Regular Session",77,0,3,0,80
61330,8281,2009-06-25,Senate,"Do pass, but re-refer to the Committee on Appropriations",11,0,0,0,11
61330,8282,2009-09-03,Senate,"Assembly 3rd Reading AB1462 Feuer By Pavley",36,1,3,0,40
61330,8283,2009-09-09,Assembly,"AB 1462 FEUER  Concurrence in Senate Amendments",77,0,2,0,79
61331,23945,2009-04-29,Assembly,"Do pass as amended",11,0,0,0,11
61331,23946,2009-05-18,Assembly,"AB 1463 SMYTH  Assembly Third Reading",76,0,0,0,76
61331,23947,2009-06-23,Senate,"Do pass, but re-refer to the Committee on Education",6,0,0,0,6
61331,23948,2009-07-08,Senate,"Do pass as amended. To Consent Calendar",7,0,0,0,7
61331,23949,2009-08-17,Senate,"Consent Calendar 2nd AB1463 Smyth",35,0,0,0,35
61331,23950,2009-08-20,Assembly,"AB 1463 SMYTH  Concurrence in Senate Amendments",78,0,0,0,78
61332,26508,2009-04-27,Assembly,"Do pass as amended and be re-referred to the Committee on 	Appropriations",12,0,0,0,12
61332,26509,2009-05-13,Assembly,"Do pass",13,1,0,0,14
61332,26510,2009-05-21,Assembly,"AB 1464 SMYTH  Assembly Third Reading",74,1,0,0,75
61332,26511,2009-06-23,Senate,"Do pass as amended, and re-refer to the Committee on Appropriations",11,0,0,0,11
61332,26512,2009-08-17,Senate,"Special Consent #14 AB1464 Smyth",35,0,0,0,35
61332,26513,2009-08-20,Assembly,"AB 1464 SMYTH  Concurrence in Senate Amendments",77,0,0,0,77
61333,24994,2009-04-28,Assembly,"Do pass and re-refer to Committee on Appropriations with 	recommendation:  To Consent Calendar",13,0,0,0,13
61333,24995,2009-05-13,Assembly,"Do pass, to Consent Calendar",16,0,0,0,16
61333,24996,2009-05-21,Assembly,"AB 1465 HILL  Consent Calendar Second Day  Regular Session",77,0,0,0,77
61333,24997,2009-07-06,Senate,"Do pass, but re-refer to the Committee on Appropriations Recommend 	Consent",10,0,0,0,10
61333,24998,2009-08-24,Senate,"Special Consent #15 AB1465 Hill",39,0,0,0,39
61333,24999,2009-08-27,Assembly,"AB 1465 HILL  Concurrence in Senate Amendments",77,0,0,0,77
61338,25949,2009-04-30,Assembly,"Do pass and be re-referred to the Committee on Appropriations",16,0,0,0,16
61338,25950,2009-05-13,Assembly,"Do pass, to Consent Calendar",16,0,0,0,16
61338,25951,2009-06-01,Assembly,"AB 1470 EVANS  Assembly Third Reading",78,0,0,0,78
61338,25952,2009-07-08,Senate,"Do pass, but re-refer to the Committee on Appropriations",11,0,0,0,11
61338,25953,2009-09-09,Senate,"Special Consent #20 AB1470 Evans By Wright",40,0,0,0,40
61338,25954,2009-09-11,Assembly,"AB 1470 EVANS  Concurrence in Senate Amendments",77,0,0,0,77
61339,23831,2009-04-27,Assembly,"Do pass as amended and re-refer to Committee on Appropriations 	with recommendation:  To Consent Calendar",13,0,0,0,13
61339,23832,2009-05-13,Assembly,"Do pass, to Consent Calendar",16,0,0,0,16
61339,23833,2009-05-21,Assembly,"AB 1471 ENG  Consent Calendar Second Day  Regular Session",77,0,0,0,77
61339,23834,2009-07-07,Senate,"Do pass as amended, but re-refer to the Committee on Appropriations 	Recommend Consent",10,0,0,0,10
61339,23835,2009-08-27,Senate,"Special Consent #16 AB1471 Eng",38,0,0,0,38
61339,23836,2009-08-31,Assembly,"AB 1471 ENG  Concurrence in Senate Amendments",78,0,0,0,78
61342,8284,2009-05-18,Assembly,"Do pass as amended and be re-referred to the Committee on Appropriations",9,0,0,0,9
61343,25656,2009-04-21,Assembly,"Do pass, to Consent Calendar",19,0,0,0,19
61343,25657,2009-05-04,Assembly,"AB 1475 SOLORIO  Consent Calendar Second Day  Regular Session",79,0,0,0,79
61343,25658,2009-06-10,Senate,"Do pass",10,0,0,0,10
61343,25659,2009-08-31,Senate,"Assembly 3rd Reading AB1475 Solorio By Correa",36,0,0,0,36
61344,8285,2009-04-29,Assembly,"Do pass as amended and be re-referred to the Committee on Appropriations",11,0,0,0,11
61345,8311,2009-04-22,Assembly,"Do pass and be re-referred to the Committee on Appropriations",4,1,1,0,6
61350,8313,2009-04-28,Assembly,"Do pass and be re-referred to the Committee on Appropriations",12,0,1,0,13
61354,25694,2009-05-18,Assembly,"Do pass as amended and be re-referred to the Committee on 	Appropriations",8,0,0,0,8
61354,25695,2009-05-28,Assembly,"Do pass, to Consent Calendar",17,0,0,0,17
61354,25696,2009-06-02,Assembly,"AB 1486 FURUTANI  Consent Calendar Second Day  Regular Session",76,0,0,0,76
61354,25697,2009-07-08,Senate,"Do pass as amended, and re-refer to the Committee on Appropriations",7,0,0,0,7
61354,25698,2009-08-27,Senate,"Special Consent #16 AB1486 Furutani",38,0,0,0,38
61354,25699,2009-08-31,Assembly,"AB 1486 FURUTANI  Concurrence in Senate Amendments",77,0,0,0,77
61355,8319,2009-05-12,Assembly,"Do pass",6,1,0,0,7
61355,8320,2009-05-18,Assembly,"AB 1487 HILL  Assembly Third Reading",74,0,6,0,80
61355,8321,2010-06-09,Senate,"Do pass as amended, and re-refer to the Committee on Judiciary",5,0,4,0,9
61355,19881,2010-08-12,Senate,"Assembly 3rd Reading AB1487 Hill Urgency Clause",31,0,0,0,31
61355,21142,2010-08-24,Assembly,"Senate amendments be concurred in",18,0,0,0,18
61355,21336,2010-08-26,Assembly,"AB 1487 HILL  Concurrence- Urgency Added",77,0,0,0,77
61357,23878,2009-04-28,Assembly,"Do pass and re-refer to Committee on Appropriations with 	recommendation:  To Consent Calendar",7,0,0,0,7
61357,23879,2009-05-20,Assembly,"Do pass, to Consent Calendar",15,0,0,0,15
61357,23880,2009-05-28,Assembly,"AB 1489 SMYTH  Consent Calendar Second Day  Regular Session",76,0,0,0,76
61357,23881,2009-07-06,Senate,"Do pass as amended, and re-refer to the Committee on 	Appropriations",7,0,0,0,7
61357,23882,2009-08-27,Senate,"Special Consent #16 AB1489 Smyth",38,0,0,0,38
61357,23883,2009-09-01,Assembly,"AB 1489 SMYTH  Concurrence in Senate Amendments",78,0,0,0,78
61358,23951,2009-04-21,Assembly,"Do pass and re-refer to Committee on Appropriations with 	recommendation:  To Consent Calendar",7,0,0,0,7
61358,23952,2009-04-29,Assembly,"Do pass, to Consent Calendar",16,0,0,0,16
61358,23953,2009-05-11,Assembly,"AB 1490 GALGIANI  Consent Calendar Second Day  Regular Session",78,0,0,0,78
61358,23954,2009-06-16,Senate,"Do pass, but re-refer to the Committee on Appropriations Recommend 	Consent",5,0,0,0,5
61358,23955,2009-06-29,Senate,"Special Consent #11 AB1490 Galgiani",40,0,0,0,40
61359,8315,2010-01-05,Assembly,"Do pass and be re-referred to the Committee on Judiciary",6,0,1,0,7
61359,8316,2010-01-12,Assembly,"Do pass as amended and be re-referred to the Committee on Appropriations",9,0,0,0,9
61362,25008,2009-04-22,Assembly,"Do pass and be re-referred to the Committee on Appropriations",16,0,0,0,16
61362,25009,2009-05-06,Assembly,"Do pass, to Consent Calendar",16,0,0,0,16
61362,25010,2009-05-14,Assembly,"AB 1494 ENG  Consent Calendar Second Day  Regular Session",73,0,0,0,73
61362,25011,2009-06-09,Senate,"Do pass, but re-refer to the Committee on Appropriations",9,0,0,0,9
61362,25012,2009-07-09,Senate,"Special Consent #12 AB1494 Eng",34,0,0,0,34
61362,25013,2009-07-13,Assembly,"AB 1494 ENG  Concurrence in Senate Amendments",77,0,0,0,77
61364,8329,2009-04-21,Assembly,"Do pass and be re-referred to the Committee on Natural Resources",7,1,3,0,11
61364,8330,2009-04-27,Assembly,"Do pass and be re-referred to the Committee on Appropriations",8,1,0,0,9
61366,8331,2009-04-21,Assembly,"Do pass as amended and be re-referred to the Committee on Appropriations",5,1,1,0,7
61367,23963,2009-04-22,Assembly,"Do pass and re-refer to Committee on Appropriations with 	recommendation:  To Consent Calendar",16,0,0,0,16
61367,23964,2009-05-06,Assembly,"Do pass, to Consent Calendar",16,0,0,0,16
61367,23965,2009-05-14,Assembly,"AB 1499 EVANS  Consent Calendar Second Day  Regular Session",73,0,0,0,73
61367,23966,2009-06-09,Senate,"Do pass, but re-refer to the Committee on Appropriations",9,0,0,0,9
61367,23967,2009-06-29,Senate,"Do pass",11,0,0,0,11
61367,23968,2009-07-09,Senate,"Special Consent #12 AB1499 Evans",34,0,0,0,34
61368,4470,2009-04-27,Assembly,"Do pass as amended and be re-referred to the Committee on Appropriations",9,5,0,0,14
61368,4471,2009-05-20,Assembly,"Do pass",10,5,1,0,16
61368,4472,2009-06-02,Assembly,"AB 1500 LIEU  Assembly Third Reading  Amend By LIEU  Set #1",48,29,3,0,80
61368,4473,2009-06-03,Assembly,"AB 1500 LIEU  Assembly Third Reading",46,31,3,0,80
61368,4474,2009-07-07,Senate,"Do pass as amended, and re-refer to the Committee on Appropriations",9,1,1,0,11
61368,9037,2010-06-17,Senate,"Assembly 3rd Reading AB1500 Lieu By Florez",25,8,6,0,39
61368,9125,2010-06-21,Assembly,"AB 1500 LIEU  Concurrence in Senate Amendments",46,27,6,0,79
61369,8328,2009-04-28,Assembly,"Do pass and be re-referred to the Committee on Appropriations",9,0,2,0,11
61370,8324,2010-01-11,Assembly,"Do pass and re-refer to Committee on Appropriations with recommendation:  To Consent Calendar",14,0,0,0,14
61370,8325,2010-01-21,Assembly,"Do pass, to Consent Calendar",17,0,0,0,17
61370,8326,2010-01-27,Assembly,"AB 1502 ENG  Consent Calendar Second Day  Regular Session",68,0,10,0,78
61370,8327,2010-06-10,Senate,"Do pass as amended",5,0,0,0,5
61370,10084,2010-07-01,Senate,"Special Consent #29 AB1502 Eng",34,0,5,0,39
61370,19728,2010-08-10,Assembly,"Senate amendments be concurred in",8,0,0,0,8
61370,20323,2010-08-16,Assembly,"AB 1502 ENG  Concurrence in Senate Amendments",74,0,0,0,74
61371,8340,2009-04-21,Assembly,"Do pass and be re-referred to the Committee on Appropriations",17,0,2,0,19
61371,8341,2009-05-13,Assembly,"Do pass, to Consent Calendar",16,0,0,0,16
61371,8342,2009-05-28,Assembly,"AB 1503 LIEU  Assembly Third Reading",74,0,6,0,80
61371,9464,2010-06-23,Senate,"Do pass as amended, and re-refer to the Committee on Appropriations",6,0,3,0,9
61371,21001,2010-08-24,Senate,"Assembly 3rd Reading AB1503 Lieu By Alquist",23,13,0,0,36
61371,21100,2010-08-25,Assembly,"AB 1503 LIEU  Concurrence in Senate Amendments",76,1,0,0,77
61372,8337,2010-01-11,Assembly,"Do pass and be re-referred to the Committee on Appropriations",6,2,1,0,9
61372,8338,2010-01-21,Assembly,"Do pass",12,5,0,0,17
61372,8339,2010-01-27,Assembly,"AB 1504 SKINNER  Assembly Third Reading",43,28,7,0,78
61372,9142,2010-06-22,Senate,"Do pass, but re-refer to the Committee on Environmental Quality",5,3,1,0,9
61372,9648,2010-06-28,Senate,"Do pass as amended, and re-refer to the Committee on Appropriations",5,2,0,0,7
61372,19212,2010-08-02,Senate,"Placed on Appropriations Suspense file",10,0,0,0,10
61372,20112,2010-08-12,Senate,"Do pass as amended",7,4,0,0,11
61372,21797,2010-08-31,Senate,"Assembly 3rd Reading AB1504 Skinner By Pavley",24,12,0,0,36
61372,21798,2010-08-31,Assembly,"AB 1504 Skinner  Concurrence in Senate Amendments",49,27,0,0,76
61374,8333,2009-07-07,Assembly,"Do pass and be re-referred to the Committee on Appropriations",11,0,0,0,11
61374,8334,2009-08-27,Assembly,"Do pass as amended",17,0,0,0,17
61374,8335,2009-09-02,Assembly,"AB 1506 ANDERSON  Third Reading Urgency",78,0,1,0,79
61374,9561,2010-06-22,Senate,"Do pass, but re-refer to the Committee on Appropriations",9,0,2,0,11
61374,19600,2010-08-02,Senate,"Do pass as amended",9,0,0,0,9
61374,21266,2010-08-23,Senate,"Assembly 3rd Reading AB1506 Anderson Urgency Clause",35,0,0,0,35
61374,21267,2010-08-24,Assembly,"AB 1506 ANDERSON  Concurrence in Senate Amendments",77,0,0,0,77
61375,8351,2009-04-28,Assembly,"Do pass and be re-referred to the Committee on Appropriations",7,0,0,0,7
61375,8352,2009-05-28,Assembly,"Do pass",13,3,1,0,17
61375,8353,2009-06-01,Assembly,"AB 1507 BLOCK  Assembly Third Reading",70,6,4,0,80
61375,8868,2010-06-14,Senate,"Do pass as amended, and re-refer to the Committee on Appropriations",7,0,0,0,7
61375,19464,2010-08-02,Senate,"Do pass",7,3,0,0,10
61375,19797,2010-08-11,Senate,"Assembly 3rd Reading AB1507 Lieu By Liu",24,8,0,0,32
61375,20307,2010-08-16,Assembly,"AB 1507 LIEU  Concurrence in Senate Amendments",54,20,0,0,74
61376,8349,2009-04-29,Assembly,"Do pass as amended and be re-referred to the Committee on Revenue and Taxation",9,1,1,0,11
61376,8350,2009-05-18,Assembly,"Do pass as amended and be re-referred to the Committee on Appropriations",9,0,0,0,9
61378,8343,2009-04-22,Assembly,"Do pass, to Consent Calendar",10,0,1,0,11
61378,8344,2009-05-04,Assembly,"AB 1510 ENG  Consent Calendar Second Day  Regular Session",79,0,1,0,80
61378,8345,2009-07-01,Senate,"Do pass and be placed on the Consent Calendar",8,0,1,0,9
61378,8346,2009-08-17,Senate,"Special Consent #14 AB1510 Eng By Wiggins",35,0,5,0,40
61378,8347,2009-08-20,Assembly,"AB 1510 ENG  Concurrence in Senate Amendments",78,0,1,0,79
61379,8361,2009-04-22,Assembly,"Do pass and be re-referred to the Committee on Public Safety",6,1,4,0,11
61379,8362,2009-04-28,Assembly,"Do pass as amended",5,0,2,0,7
61379,8363,2009-05-14,Assembly,"AB 1511 DE LEON  Assembly Third Reading",62,1,17,0,80
61379,8364,2009-06-17,Senate,"Do pass, but re-refer to the Committee on Public Safety",8,0,1,0,9
61379,8365,2009-07-07,Senate,"Do pass",6,1,0,0,7
61380,8355,2009-04-28,Assembly,"Do pass as amended and be re-referred to the Committee on Appropriations",14,4,1,0,19
61380,8356,2009-05-20,Assembly,"Do pass",11,4,1,0,16
61380,8357,2009-05-28,Assembly,"AB 1512 LIEU  Assembly Third Reading",48,29,3,0,80
61380,8358,2009-07-08,Senate,"Do pass as amended, and re-refer to the Committee on Appropriations",9,0,2,0,11
61380,8359,2009-09-09,Senate,"Assembly 3rd Reading AB1512 Lieu By Liu",24,12,4,0,40
61380,8360,2009-09-10,Assembly,"AB 1512 Lieu  Concurrence in Senate Amendments",49,30,1,0,80
61381,8354,2009-04-20,Assembly,"Do pass as amended and be re-referred to the Committee on Appropriations",6,3,0,0,9
61382,425,2009-04-21,Assembly,"Do pass as amended and be re-referred to the Committee on Appropriations.",6,0,1,0,7
61382,426,2009-05-13,Assembly,"Do pass.",15,1,0,0,16
61382,427,2009-05-21,Assembly,"AB 1514 HAYASHI  Assembly Third Reading",77,0,3,0,80
61382,428,2009-07-07,Senate,"Do pass, but re-refer to the Committee on Appropriations.",3,1,1,0,5
61382,429,2009-09-09,Senate,"Assembly 3rd Reading AB1514 Hayashi Reconsider",40,0,0,0,40
61382,9739,2010-06-28,Senate,"Assembly 3rd Reading AB1514 Hayashi By DeSaulnier",34,0,5,0,39
61382,10008,2010-07-01,Assembly,"AB 1514 HAYASHI  Concurrence in Senate Amendments",75,2,2,0,79
61383,23741,2009-04-27,Assembly,"Do pass as amended and re-refer to Committee on Appropriations 	with recommendation:  To Consent Calendar",13,0,0,0,13
61383,23742,2009-05-20,Assembly,"Do pass, to Consent Calendar",15,0,0,0,15
61383,23743,2009-05-28,Assembly,"AB 1515 ENG  Consent Calendar Second Day  Regular Session",76,0,0,0,76
61383,23744,2009-06-23,Senate,"Do pass as amended, but re-refer to the Committee on Appropriations 	Recommend Consent",11,0,0,0,11
61383,23745,2009-07-16,Senate,"Special Consent #13 AB1515 Eng",36,0,0,0,36
61383,23746,2009-08-20,Assembly,"AB 1515 ENG  Concurrence in Senate Amendments",77,0,0,0,77
61384,25588,2009-05-12,Assembly,"Do pass",5,0,0,0,5
61384,25589,2009-05-26,Assembly,"AB 1516 LIEU  Assembly Third Reading",76,1,0,0,77
61384,25590,2009-07-07,Senate,"Do pass as amended",7,0,0,0,7
61384,25591,2009-08-31,Senate,"Assembly 3rd Reading AB1516 Lieu By Benoit",36,0,0,0,36
61384,25592,2009-09-02,Assembly,"AB 1516 LIEU  Concurrence in Senate Amendments",76,0,0,0,76
61385,8348,2009-04-22,Assembly,"Do pass as amended and re-refer to Committee on Appropriations with recommendation:  To Consent Calendar",10,0,1,0,11
61386,3813,2010-01-12,Assembly,"Do pass as amended and be re-referred to the Committee on Appropriations",11,0,0,0,11
61386,3814,2010-01-21,Assembly,"Do pass as amended",17,0,0,0,17
61386,3815,2010-01-27,Assembly,"AB 1518 ANDERSON  Assembly Third Reading",72,0,6,0,78
61386,3816,2010-04-05,Senate,"Do pass as amended, and re-refer to the Committee on Rules",7,0,2,0,9
61387,8368,2009-04-21,Assembly,"Do pass and be re-referred to the Committee on Appropriations",4,3,0,0,7
61388,8369,2009-04-20,Assembly,"Do pass as amended and be re-referred to the Committee on Appropriations",8,1,0,0,9
61389,8370,2009-04-14,Assembly,"Do pass and be re-referred to the Committee on Insurance",10,6,3,0,19
61389,8371,2009-04-22,Assembly,"Do pass as amended and be re-referred to the Committee on Appropriations",7,3,0,0,10
61389,8372,2009-05-20,Assembly,"Do pass",11,4,1,0,16
61389,8373,2009-05-28,Assembly,"AB 1521 JONES  Assembly Third Reading",48,28,4,0,80
61389,8374,2009-07-08,Senate,"Do pass as amended, and re-refer to the Committee on Appropriations",8,3,0,0,11
61389,8375,2009-08-24,Senate,"Placed on Appropriations Suspense file",13,0,0,0,13
61390,8367,2009-04-16,Assembly,"Be referred to Committee on Transportation",10,0,1,0,11
61391,8379,2009-05-18,Assembly,"Do pass as amended and be re-referred to the Committee on Appropriations",9,0,0,0,9
61392,8376,2010-01-12,Assembly,"Do pass and be re-referred to the Committee on Appropriations",11,0,0,0,11
61392,8377,2010-01-21,Assembly,"Do pass, to Consent Calendar",17,0,0,0,17
61392,8378,2010-01-27,Assembly,"AB 1524 HAYASHI  Consent Calendar Second Day  Regular Session",68,0,10,0,78
61392,9275,2010-06-21,Senate,"Do pass as amended, and re-refer to the Committee on Appropriations",6,1,2,0,9
61392,19585,2010-08-02,Senate,"Do pass",6,0,0,0,6
61392,20548,2010-08-18,Senate,"Assembly 3rd Reading AB1524 Hayashi By Yee",33,0,0,0,33
61392,20549,2010-08-19,Assembly,"AB 1524 HAYASHI  Concurrence in Senate Amendments",77,0,0,0,77
61393,23984,2009-04-21,Assembly,"Do pass and re-refer to Committee on Appropriations with 	recommendation:  To Consent Calendar",7,0,0,0,7
61393,23985,2009-04-29,Assembly,"Do pass, to Consent Calendar",16,0,0,0,16
61393,23986,2009-05-11,Assembly,"AB 1525 BEALL  Consent Calendar Second Day  Regular Session",78,0,0,0,78
61393,23987,2009-07-07,Senate,"Do pass, but re-refer to the Committee on Appropriations Recommend 	Consent",5,0,0,0,5
61393,23988,2009-09-02,Senate,"Assembly 3rd Reading AB1525 Beall",38,0,0,0,38
61393,23989,2009-09-08,Assembly,"AB 1525 BEALL  Concurrence in Senate Amendments",79,0,0,0,79
61395,8385,2009-04-27,Assembly,"Do pass and be re-referred to the Committee on Appropriations",11,0,3,0,14
61395,8386,2009-05-28,Assembly,"Do pass as amended",17,0,0,0,17
61395,8387,2009-06-02,Assembly,"AB 1527 LIEU  Assembly Third Reading",77,0,3,0,80
61395,8388,2009-07-07,Senate,"Do pass as amended, and re-refer to the Committee on Environmental Quality",10,0,1,0,11
61395,8389,2009-07-13,Senate,"Do pass as amended, but re-refer to the Committee on Appropriations Recommend Consent",7,0,0,0,7
61395,8390,2009-08-17,Senate,"Placed on Appropriations Suspense file",13,0,0,0,13
61395,8391,2009-08-27,Senate,"Do pass",13,0,0,0,13
61395,8392,2009-09-02,Senate,"Assembly 3rd Reading AB1527 Lieu By Liu",39,0,1,0,40
61395,8393,2009-09-08,Assembly,"AB 1527 LIEU  Concurrence in Senate Amendments",79,0,0,0,79
61398,1396,2009-04-27,Assembly,"Do pass and be re-referred to the Committee on Appropriations",6,3,0,0,9
61398,1397,2009-05-28,Assembly,"Do pass",12,5,0,0,17
61398,1398,2009-06-01,Assembly,"AB 1530 SKINNER  Assembly Third Reading",47,29,4,0,80
61398,9217,2010-06-23,Senate,"Do pass as amended, and re-refer to the Committee on Appropriations",3,0,2,0,5
61398,21365,2010-08-24,Senate,"Assembly 3rd Reading AB1530 Skinner By Ashburn",30,2,0,0,32
61398,21366,2010-08-26,Assembly,"Senate amendments be concurred in",9,0,0,0,9
61398,21367,2010-08-26,Assembly,"Be referred to Committee on Appropriations",9,0,0,0,9
61398,21684,2010-08-30,Assembly,"AB 1530 SKINNER  Concurrence in Senate Amendments",78,0,0,0,78
61399,8397,2009-04-21,Assembly,"Do pass as amended and be re-referred to the Committee on Appropriations",11,0,0,0,11
61399,8398,2009-05-13,Assembly,"Do pass",16,0,0,0,16
61399,8399,2009-05-21,Assembly,"AB 1531 PORTANTINO  Assembly Third Reading",78,0,2,0,80
61399,8400,2009-07-07,Senate,"Do pass, but re-refer to the Committee on Appropriations Recommend Consent",5,0,0,0,5
61399,9692,2010-06-29,Senate,"Do pass, but re-refer to the Committee on Appropriations",3,1,1,0,5
61399,19506,2010-08-02,Senate,"Placed on Appropriations Suspense file",10,0,0,0,10
61400,1577,2010-01-07,Assembly,"Be referred to Committee on Public Safety",10,0,1,0,11
61400,1578,2010-01-12,Assembly,"Do pass, to Consent Calendar",7,0,0,0,7
61400,1579,2010-01-19,Assembly,"AB 1532 LIEU  Consent Calendar Second Day  Regular Session",71,0,7,0,78
61400,8772,2010-06-15,Senate,"Do pass",7,0,0,0,7
61400,9575,2010-06-28,Senate,"Special Consent #28 AB1532 Lieu",32,0,7,0,39
61400,10032,2010-07-01,Assembly,"AB 1532 LIEU  Concurrence- Urgency Added",77,0,2,0,79
61401,8394,2010-01-06,Assembly,"Do pass and be re-referred to the Committee on Appropriations",4,0,1,0,5
61401,8395,2010-01-21,Assembly,"Do pass",12,0,5,0,17
61401,8396,2010-01-27,Assembly,"AB 1533 LIEU  Assembly Third Reading",45,23,10,0,78
61403,27073,2009-04-28,Assembly,"Do pass and be re-referred to the Committee on Appropriations",9,0,0,0,9
61403,27074,2009-05-20,Assembly,"Do pass",11,2,0,0,13
61403,27075,2009-05-28,Assembly,"AB 1535 JONES  Assembly Third Reading",70,5,0,0,75
61403,27076,2009-07-06,Senate,"Do pass, but re-refer to the Committee on Appropriations",4,3,0,0,7
61403,27077,2009-07-06,Senate,"Set, first hearing.  Failed passage in Committee.  Reconsideration 	granted",9,0,0,0,9
61403,27078,2009-07-13,Senate,"Do pass as amended, and re-refer to the Committee on Appropriations",6,2,0,0,8
61403,27079,2009-08-17,Senate,"Placed on Appropriations Suspense file",13,0,0,0,13
61403,27080,2009-08-27,Senate,"Do pass as amended",12,0,0,0,12
61403,27081,2009-09-09,Senate,"Assembly 3rd Reading AB1535 Jones By Negrete McLeod",27,5,0,0,32
61403,27082,2009-09-10,Assembly,"AB 1535 Jones  Concurrence in Senate Amendments",68,8,0,0,76
61404,1673,2009-04-20,Assembly,"Do pass and be re-referred to the Committee on Natural Resources",15,0,0,0,15
61404,1674,2009-04-27,Assembly,"Do pass as amended and be re-referred to the Committee on Appropriations",6,1,2,0,9
61404,1675,2009-05-20,Assembly,"Do pass",15,0,1,0,16
61404,1676,2009-05-28,Assembly,"AB 1536 BLAKESLEE  Assembly Third Reading",79,0,1,0,80
61406,8404,2009-05-06,Assembly,"Do pass as amended",7,0,4,0,11
61408,23290,2009-04-21,Assembly,"Do pass and be re-referred to the Committee on Environmental Safety 	and Toxic Materials",17,0,0,0,17
61408,23291,2009-04-28,Assembly,"Do pass as amended and be re-referred to the Committee on 	Appropriations",7,0,0,0,7
61408,23292,2009-05-28,Assembly,"Do pass",17,0,0,0,17
61408,23293,2009-06-01,Assembly,"AB 1540 HEALTH  Assembly Third Reading  By JONES",78,0,0,0,78
61408,23294,2009-07-08,Senate,"Do pass, but re-refer to the Committee on Environmental Quality",10,0,0,0,10
61408,23295,2009-07-13,Senate,"Do pass as amended, and re-refer to the Committee on 	Appropriations",6,0,0,0,6
61408,23296,2009-08-24,Senate,"Do pass",13,0,0,0,13
61408,23297,2009-09-09,Senate,"Assembly 3rd Reading AB1540 Committee on HEALTH (Jones) By Pavley",38,0,0,0,38
61408,23298,2009-09-10,Assembly,"AB 1540 HEALTH  Concurrence in Senate Amendments By JONES",79,0,0,0,79
61409,23254,2009-05-12,Assembly,"Do pass and re-refer to Committee on Appropriations with 	recommendation:  To Consent Calendar",19,0,0,0,19
61409,23255,2009-05-20,Assembly,"Do pass",15,0,0,0,15
61409,23256,2009-05-28,Assembly,"AB 1541 HEALTH  Assembly Third Reading  By JONES",79,0,0,0,79
61409,23257,2009-07-15,Senate,"Do pass as amended, and re-refer to the Committee on Appropriations",10,0,0,0,10
61409,23258,2009-09-02,Senate,"Assembly 3rd Reading AB1541 Committee on HEALTH (Jones) By Alquist",34,0,0,0,34
61409,23259,2009-09-08,Assembly,"AB 1541 HEALTH  Concurrence in Senate Amendments By JONES",79,0,0,0,79
61410,2107,2009-05-12,Assembly,"Do pass",19,0,0,0,19
61410,2108,2009-05-14,Assembly,"AB 1542 HEALTH  Assembly Third Reading  By JONES",72,0,8,0,80
61410,10343,2010-06-30,Senate,"Do pass as amended, and re-refer to the Committee on Rules",6,2,1,0,9
61410,19732,2010-08-09,Senate,"Do pass as amended, and re-refer to the Committee on Rules",5,1,0,0,6
61410,20022,2010-08-12,Senate,"Placed on Appropriations Suspense file",11,0,0,0,11
61410,21698,2010-08-30,Senate,"W/O REF. TO FILE AB1542 Jones Urgency Clause",26,10,0,0,36
61410,21699,2010-08-30,Senate,"W/O REF. TO FILE AB1542 Jones Reconsider",37,0,0,0,37
61410,21794,2010-08-31,Senate,"Assembly 3rd Reading AB1542 Jones Urgency Clause",28,9,0,0,37
61410,21795,2010-09-01,Assembly,"AB 1542 JONES  Concurrence- Urgency Added",50,17,0,0,67
61411,22393,2009-05-12,Assembly,"Do pass and be re-referred to the Committee on Appropriations",19,0,0,0,19
61411,22394,2009-05-28,Assembly,"Do pass, to Consent Calendar",17,0,0,0,17
61411,22395,2009-06-02,Assembly,"AB 1543 HEALTH  Consent Calendar Second Day  Regular Session",76,0,0,4,80
61411,22396,2009-06-17,Senate,"Do pass, but re-refer to the Committee on Appropriations",8,0,3,0,11
61411,22397,2009-06-28,Senate,"Assembly 3rd Reading AB1543 Jones Urgency Clause",40,0,0,0,40
61411,22398,2009-06-30,Assembly,"AB 1543 JONES  Concurrence in Senate Amendments",77,0,0,2,79
61412,23041,2009-04-28,Assembly,"Do pass and re-refer to Committee on Appropriations with 	recommendation:  To Consent Calendar",18,0,0,0,18
61412,23042,2009-05-28,Assembly,"Do pass",17,0,0,0,17
61412,23043,2009-06-01,Assembly,"AB 1544 HEALTH  Assembly Third Reading  By JONES",79,0,0,0,79
61412,23044,2009-07-15,Senate,"Do pass as amended, and re-refer to the Committee on Appropriations",10,0,0,0,10
61412,23045,2009-08-17,Senate,"Do pass",12,0,0,0,12
61412,23046,2009-09-09,Senate,"Assembly 3rd Reading AB1544 Jones By Alquist",38,0,0,0,38
61412,23047,2009-09-10,Assembly,"AB 1544 Jones  Concurrence in Senate Amendments",78,0,0,0,78
61413,23969,2009-05-11,Assembly,"Do pass, to Consent Calendar",9,0,0,0,9
61413,23970,2009-05-18,Assembly,"AB 1545 REV.& TAX.  Consent Calendar Second Day  Regular Session",77,0,0,0,77
61413,23971,2009-07-08,Senate,"Do pass and be placed on the Consent Calendar",8,0,0,0,8
61413,23972,2009-07-16,Senate,"Consent Calendar 2nd AB1545 Committee on REV. & TAX. (Caldero",36,0,0,0,36
61414,25547,2009-04-27,Assembly,"Do pass and be re-referred to the Committee on Appropriations",6,2,0,0,8
61414,25548,2009-05-20,Assembly,"Do pass",11,4,0,0,15
61414,25549,2009-05-28,Assembly,"AB 1546 REV.& TAX.  Assembly Third Reading  By CALDERON",50,29,0,0,79
61414,25550,2009-07-08,Senate,"Do pass, but re-refer to the Committee on Appropriations",5,2,0,0,7
61414,25551,2009-08-17,Senate,"Do pass",8,4,0,0,12
61414,25552,2009-09-02,Senate,"Assembly 3rd Reading AB1546 Committee on REV. & TAX. (Caldero By 	Wolk",22,15,0,0,37
61414,25553,2009-09-08,Assembly,"AB 1546 REV.& TAX.  Concurrence in Senate Amendments By CALDERON",48,30,0,0,78
61415,26901,2009-04-27,Assembly,"Do pass and be re-referred to the Committee on Appropriations",6,2,0,0,8
61415,26902,2009-05-20,Assembly,"Do pass",11,4,0,0,15
61415,26903,2009-05-28,Assembly,"AB 1547 REV.& TAX.  Assembly Third Reading  By CALDERON",49,30,0,0,79
61415,26904,2009-07-08,Senate,"Do pass, but re-refer to the Committee on Appropriations",5,2,0,0,7
61415,26905,2009-08-17,Senate,"Do pass",8,4,0,0,12
61415,26906,2009-09-02,Senate,"Assembly 3rd Reading AB1547 Committee on REV. & TAX. (Caldero By 	Wolk",22,16,0,0,38
61415,26907,2009-09-08,Assembly,"AB 1547 REV.& TAX.  Concurrence in Senate Amendments By CALDERON",48,30,0,0,78
61416,8402,2009-05-04,Assembly,"Do pass, to Consent Calendar",9,0,2,0,11
61416,8403,2009-05-11,Assembly,"AB 1548 B.& F.  Consent Calendar Second Day  Regular Session",78,0,2,0,80
61417,22931,2009-04-21,Assembly,"Do pass and be re-referred to the Committee on Banking and Finance 	to Consent Calendar",10,0,0,0,10
61417,22932,2009-05-04,Assembly,"Do pass, to Consent Calendar",9,0,0,0,9
61417,22933,2009-05-11,Assembly,"AB 1549 B.& F.  Consent Calendar Second Day  Regular Session",78,0,0,0,78
61417,22934,2009-06-16,Senate,"Do pass and be placed on the Consent Calendar",5,0,0,0,5
61417,22935,2009-06-22,Senate,"Consent Calendar 2nd AB1549 Committee on B. & F. (Nava)",40,0,0,0,40
61418,23754,2009-04-20,Assembly,"Do pass, to Consent Calendar",11,0,0,0,11
61418,23755,2009-05-06,Assembly,"Do pass, to Consent Calendar",16,0,0,0,16
61418,23756,2009-05-14,Assembly,"AB 1550 B.& F.  Consent Calendar Second Day  Regular Session",73,0,0,0,73
61418,23757,2009-06-17,Senate,"Do pass, but re-refer to the Committee on Appropriations Recommend 	Consent",11,0,0,0,11
61418,23758,2009-06-29,Senate,"Do pass",11,0,0,0,11
61418,23759,2009-07-09,Senate,"Special Consent #12 AB1550 Committee on B. & F. (Nava)",34,0,0,0,34
61419,26990,2009-04-27,Assembly,"Do pass and be re-referred to the Committee on Appropriations",13,0,0,0,13
61419,26991,2009-05-06,Assembly,"Do pass, to Consent Calendar",16,0,0,0,16
61419,26992,2009-05-14,Assembly,"AB 1551 B.& F.  Consent Calendar Second Day  Regular Session",0,0,0,0,0
61419,26993,2009-07-07,Senate,"Do pass as amended, and re-refer to the Committee on Appropriations",11,0,0,0,11
61419,26994,2009-08-27,Senate,"Assembly 3rd Reading AB1551 Committee on U. & C. (Fuentes) Urgency 	Clause",35,0,0,0,35
61419,26995,2009-08-31,Assembly,"AB 1551 U.& C.  Concurrence in Senate Amendments By FUENTES",78,0,0,0,78
61420,8408,2009-04-27,Assembly,"Do pass and be re-referred to the Committee on Appropriations to Consent Calendar",14,0,1,0,15
61420,8409,2009-05-06,Assembly,"Do pass, to Consent Calendar",16,0,0,0,16
61420,8410,2009-05-14,Assembly,"AB 1552 U.& C.  Consent Calendar Second Day  Regular Session",73,0,7,0,80
61420,10365,2010-06-29,Senate,"Do pass as amended, but re-refer to the Committee on Appropriations Recommend Consent",10,0,1,0,11
61421,23956,2009-05-11,Assembly,"Do pass, to Consent Calendar",14,0,0,0,14
61421,23957,2009-05-18,Assembly,"AB 1553 U.& C.  Consent Calendar Second Day  Regular Session",77,0,0,0,77
61421,23958,2009-07-07,Senate,"Do pass as amended, and re-refer to the Committee on Appropriations",10,0,0,0,10
61421,23959,2009-08-17,Senate,"Do pass",9,0,0,0,9
61421,23960,2009-09-02,Senate,"Assembly 3rd Reading AB1553 Fuentes By Padilla",33,0,0,0,33
61421,23961,2009-09-09,Assembly,"Senate amendments be concurred in",15,0,0,0,15
61421,23962,2009-09-10,Assembly,"AB 1553 FUENTES  Concurrence in Senate Amendments",68,6,0,0,74
61422,1707,2009-04-21,Assembly,"Do pass and re-refer to Committee on Appropriations with recommendation:  To Consent Calendar",7,0,0,0,7
61422,1708,2009-05-06,Assembly,"Do pass, to Consent Calendar",16,0,0,0,16
61422,1709,2009-05-14,Assembly,"AB 1554 J., E.D.& E.  Consent Calendar Second Day  Regular Session",73,0,7,0,80
61422,1710,2009-07-07,Senate,"Do pass, but re-refer to the Committee on Appropriations Recommend Consent",10,0,1,0,11
61423,25149,2009-04-21,Assembly,"Do pass, to Consent Calendar",7,0,0,0,7
61423,25150,2009-04-27,Assembly,"AB 1555 J., E.D.& E.  Consent Calendar Second Day  Regular Session",77,0,0,0,77
61423,25151,2009-07-07,Senate,"Do pass",10,0,0,0,10
61423,25152,2009-07-23,Assembly,"Senate amendments be concurred in",15,0,0,0,15
61423,25153,2009-07-24,Senate,"Assembly 2nd Reading AB1555 V. Manuel Perez By Padilla",36,3,0,0,39
61423,25154,2009-07-24,Assembly,"AB 1555 PEREZ, V.M.  Concurrence- Urgency Added",69,4,0,0,73
61424,8406,2010-01-06,Assembly,"Do pass and be re-referred to the Committee on Housing and Community Development",7,0,0,0,7
61424,8407,2010-01-13,Assembly,"Do pass as amended and be re-referred to the Committee on Appropriations",6,0,1,0,7
61425,8405,2009-04-21,Assembly,"Do pass and re-refer to Committee on Appropriations with recommendation:  To Consent Calendar",7,0,0,0,7
61426,8427,2009-04-21,Assembly,"Do pass, to Consent Calendar",7,0,0,0,7
61426,8428,2009-04-27,Assembly,"AB 1558 J., E.D.& E.  Consent Calendar Second Day  Regular Session",77,0,3,0,80
61426,8429,2009-07-06,Senate,"Do pass",9,0,1,0,10
61426,9963,2010-06-28,Senate,"Do pass as amended, and re-refer to the Committee on Appropriations",6,1,2,0,9
61426,19663,2010-08-02,Senate,"Placed on Appropriations Suspense file",10,0,0,0,10
61427,8419,2009-04-22,Assembly,"Do pass and be re-referred to the Committee on Appropriations",7,0,0,0,7
61427,8420,2009-05-28,Assembly,"Do pass as amended",12,0,5,0,17
61427,8421,2009-06-02,Assembly,"AB 1559 L.& E.  Assembly Third Reading  By SWANSON",74,0,6,0,80
61427,8422,2009-07-08,Senate,"Do pass, but re-refer to the Committee on Appropriations",5,1,0,0,6
61427,8423,2009-08-17,Senate,"Placed on Appropriations Suspense file",13,0,0,0,13
61427,8424,2009-08-27,Senate,"Do pass as amended",12,1,0,0,13
61427,8425,2009-09-03,Senate,"Assembly 3rd Reading AB1559 Committee on L. & E. (Monning) By Ducheny",32,6,2,0,40
61427,8426,2009-09-09,Assembly,"AB 1559 L.& E.  Concurrence in Senate Amendments By MONNING",78,0,1,0,79
61428,8418,2009-04-22,Assembly,"Do pass and be re-referred to the Committee on Appropriations",6,1,0,0,7
61429,8411,2009-04-22,Assembly,"Do pass and be re-referred to the Committee on Appropriations",5,2,0,0,7
61429,8412,2009-05-28,Assembly,"Do pass",12,5,0,0,17
61429,8413,2009-06-01,Assembly,"AB 1561 L.& E.  Assembly Third Reading  By SWANSON",49,30,1,0,80
61429,8414,2009-07-08,Senate,"Do pass, but re-refer to the Committee on Appropriations",5,1,0,0,6
61429,8415,2009-08-17,Senate,"Do pass",9,3,1,0,13
61429,8416,2009-09-01,Senate,"Assembly 3rd Reading AB1561 Committee on L. & E. (Monning) By Leno",25,13,2,0,40
61429,8417,2009-09-03,Assembly,"AB 1561 L.& E.  Concurrence in Senate Amendments By SWANSON",49,29,1,0,79
61430,8440,2009-04-22,Assembly,"Do pass and be re-referred to the Committee on Appropriations",5,2,0,0,7
61430,8441,2009-05-06,Assembly,"Do pass",11,5,0,0,16
61430,8442,2009-05-18,Assembly,"AB 1562 L.& E.  Assembly Third Reading  By SWANSON",47,30,3,0,80
61430,8443,2009-07-08,Senate,"Do pass, but re-refer to the Committee on Appropriations",4,2,0,0,6
61430,8444,2009-09-02,Senate,"Assembly 3rd Reading AB1562 Committee on L. & E. (Monning) By Padilla",24,15,1,0,40
61431,8434,2009-04-22,Assembly,"Do pass and be re-referred to the Committee on Appropriations",5,2,0,0,7
61431,8435,2009-05-06,Assembly,"Do pass",11,5,0,0,16
61431,8436,2009-05-18,Assembly,"AB 1563 L.& E.  Assembly Third Reading  By SWANSON",48,29,3,0,80
61431,8437,2009-07-08,Senate,"Do pass, but re-refer to the Committee on Appropriations",4,2,0,0,6
61431,8438,2009-09-01,Senate,"Assembly 3rd Reading AB1563 Committee on L. & E. (Monning) By Padilla",23,15,2,0,40
61431,8439,2009-09-08,Assembly,"AB 1563 L.& E.  Concurrence in Senate Amendments By MONNING",51,28,0,0,79
61433,8430,2009-05-06,Assembly,"Do pass, to Consent Calendar",9,0,1,0,10
61433,8431,2009-05-14,Assembly,"AB 1565 INS.  Consent Calendar Second Day  Regular Session",73,0,7,0,80
61434,23581,2009-04-20,Assembly,"Do pass, to Consent Calendar",11,0,0,0,11
61434,23582,2009-04-27,Assembly,"AB 1566 B.& F.  Consent Calendar Second Day  By NAVA",77,0,0,0,77
61434,23583,2009-06-17,Senate,"Do pass and be placed on the Consent Calendar",11,0,0,0,11
61434,23584,2009-06-24,Senate,"Consent Calendar 2nd AB1566 Committee on B. & F. (Nava)",40,0,0,0,40
61435,8464,2009-04-28,Assembly,"Do pass and be re-referred to the Committee on Labor and Employment to Consent Calendar",9,0,0,0,9
61435,8465,2009-04-30,Assembly,"Do pass and re-refer to Committee on Appropriations with recommendation:  To Consent Calendar",4,0,3,0,7
61435,8466,2009-05-13,Assembly,"Do pass, to Consent Calendar",16,0,0,0,16
61435,8467,2009-05-21,Assembly,"AB 1567 V. A.  Consent Calendar Second Day  Regular Session",77,0,3,0,80
61435,8468,2009-06-23,Senate,"Do pass, but re-refer to the Committee on Labor and Industrial Relations",6,0,1,0,7
61435,8469,2009-07-08,Senate,"Do pass, but re-refer to the Committee on Appropriations Recommend Consent",6,0,0,0,6
61435,8470,2009-08-27,Senate,"Special Consent #16 AB1567 Committee on V. A. (Salas)",38,0,2,0,40
61436,26588,2009-04-28,Assembly,"Do pass and re-refer to Committee on Appropriations with 	recommendation:  To Consent Calendar",18,0,0,0,18
61436,26589,2009-05-28,Assembly,"Do pass",17,0,0,0,17
61436,26590,2009-06-02,Assembly,"AB 1568 V. A.  Assembly Third Reading  By SALAS",79,0,0,0,79
61436,26591,2009-06-23,Senate,"Do pass, but re-refer to the Committee on Health",6,0,0,0,6
61436,26592,2009-07-15,Senate,"Do pass, but re-refer to the Committee on Appropriations",10,0,0,0,10
61436,26593,2009-08-17,Senate,"Placed on Appropriations Suspense file",13,0,0,0,13
61436,26594,2009-09-11,Assembly,"AB 1568 Salas  Concurrence in Senate Amendments",79,0,0,0,79
61436,26595,2009-09-11,Senate,"W/O REF. TO FILE AB1568 Salas By Kehoe",36,0,0,0,36
61437,3392,2009-05-05,Assembly,"Do pass and be re-referred to the Committee on Veterans Affairs to Consent Calendar",9,0,0,0,9
61437,3393,2009-05-12,Assembly,"Do pass, to Consent Calendar",8,0,1,0,9
61437,3394,2009-05-21,Assembly,"AB 1569 V. A.  Consent Calendar Second Day  Regular Session",77,0,3,0,80
61437,3395,2009-06-23,Senate,"Do pass, but re-refer to the Committee on Education",6,0,1,0,7
61438,1927,2009-04-28,Assembly,"Do pass and be re-referred to the Committee on Appropriations",5,1,3,0,9
61438,1928,2009-05-13,Assembly,"Do pass",10,0,6,0,16
61438,1929,2009-06-03,Assembly,"AB 1570 V. A.  Assembly Third Reading  By SALAS",77,1,2,0,80
61438,1930,2009-06-23,Senate,"Do pass, but re-refer to the Committee on Appropriations",6,0,1,0,7
61438,1931,2009-07-13,Senate,"Placed on Appropriations Suspense file",12,0,1,0,13
61438,1932,2009-08-27,Senate,"Do pass as amended",13,0,0,0,13
61438,10129,2010-07-01,Senate,"Do pass as amended, and re-refer to the Committee on Appropriations",8,0,1,0,9
61438,19224,2010-08-02,Senate,"Do pass",9,0,0,0,9
61438,20049,2010-08-11,Senate,"Assembly 3rd Reading AB1570 Salas By Corbett",34,0,0,0,34
61438,21254,2010-08-24,Assembly,"Senate amendments be concurred in",9,0,0,0,9
61438,21255,2010-08-25,Assembly,"AB 1570 SALAS  Concurrence in Senate Amendments",78,0,0,0,78
61439,23837,2009-04-21,Assembly,"Do pass and be re-referred to the Committee on Veterans Affairs",14,2,0,0,16
61439,23838,2009-04-28,Assembly,"Do pass and be re-referred to the Committee on Appropriations",8,1,0,0,9
61439,23839,2009-05-20,Assembly,"Do pass",15,0,0,0,15
61439,23840,2009-06-02,Assembly,"AB 1571 V. A.  Assembly Third Reading  By SALAS",73,2,0,0,75
61439,23841,2009-06-23,Senate,"Do pass, but re-refer to the Committee on Rules",6,0,0,0,6
61439,23842,2009-07-15,Senate,"Do pass as amended, and re-refer to the Committee on Appropriations",10,0,0,0,10
61439,23843,2009-08-17,Senate,"Placed on Appropriations Suspense file",13,0,0,0,13
61439,23844,2009-08-27,Senate,"Do pass as amended",13,0,0,0,13
61439,23845,2009-09-09,Senate,"Assembly 3rd Reading AB1571 Committee on V. A. (Salas) By Alquist",31,0,0,0,31
61439,23846,2009-09-11,Assembly,"AB 1571 V. A.  Concurrence in Senate Amendments By SALAS",79,0,0,0,79
61440,25500,2009-05-05,Assembly,"Do pass, to Consent Calendar",7,0,0,0,7
61440,25501,2009-05-11,Assembly,"AB 1572 E.& R.  Consent Calendar Second Day  Regular Session",78,0,0,0,78
61440,25502,2009-06-16,Senate,"Do pass and be placed on the Consent Calendar",5,0,0,0,5
61440,25503,2009-09-04,Senate,"Special Consent #19 AB1572 Committee on E. & R. (Fong)",40,0,0,0,40
61441,25726,2009-04-21,Assembly,"Do pass and re-refer to Committee on Appropriations with 	recommendation:  To Consent Calendar",7,0,0,0,7
61441,25727,2009-04-29,Assembly,"Do pass, to Consent Calendar",16,0,0,0,16
61441,25728,2009-05-11,Assembly,"AB 1573 E.& R.  Consent Calendar Second Day  Regular Session",78,0,0,0,78
61441,25729,2009-06-16,Senate,"Do pass, but re-refer to the Committee on Appropriations Recommend 	Consent",5,0,0,0,5
61441,25730,2009-09-04,Senate,"Special Consent #19 AB1573 Committee on E. & R. (Fong)",40,0,0,0,40
61442,23200,2009-04-21,Assembly,"Do pass and re-refer to Committee on Appropriations with 	recommendation:  To Consent Calendar",7,0,0,0,7
61442,23201,2009-04-29,Assembly,"Do pass, to Consent Calendar",16,0,0,0,16
61442,23202,2009-05-11,Assembly,"AB 1574 E.& R.  Consent Calendar Second Day  Regular Session",78,0,0,0,78
61442,23203,2009-06-16,Senate,"Do pass, but re-refer to the Committee on Appropriations Recommend 	Consent",5,0,0,0,5
61442,23204,2009-09-02,Senate,"Special Consent #18 AB1574 Committee on E. & R. (Fong) By Hancock",39,0,0,0,39
61442,23205,2009-09-08,Assembly,"AB 1574 E.& R.  Concurrence in Senate Amendments By FONG",78,0,0,0,78
61443,25170,2009-04-30,Assembly,"Do pass and be re-referred to the Committee on Appropriations",16,0,0,0,16
61443,25171,2009-05-13,Assembly,"Do pass",16,0,0,0,16
61443,25172,2009-05-26,Assembly,"AB 1575 G.O.  Assembly Third Reading  By PRICE",72,2,0,0,74
61443,25173,2009-07-08,Senate,"Do pass, but re-refer to the Committee on Appropriations",11,0,0,0,11
61443,25174,2009-09-10,Senate,"Assembly 3rd Reading AB1575 Committee on G.O. (Price) By Price",24,8,0,0,32
61443,25175,2009-09-10,Senate,"Assembly 3rd Reading AB1575 Committee on G.O. (Price) Reconsider",40,0,0,0,40
61443,25176,2009-10-14,Senate,"Assembly 3rd Reading AB1575 Committee on G.O. (Price) By Price",34,2,0,0,36
61443,25177,2009-10-26,Assembly,"Senate amendments be concurred in",14,0,0,0,14
61443,25178,2009-10-26,Assembly,"AB 1575 G.O.  Concurrence in Senate Amendments By COTO",73,0,0,0,73
61444,8462,2009-05-06,Assembly,"Do pass, to Consent Calendar",16,0,3,0,19
61444,8463,2009-05-14,Assembly,"AB 1576 G.O.  Consent Calendar Second Day  Regular Session",73,0,7,0,80
61445,8454,2009-04-30,Assembly,"Do pass and re-refer to Committee on Appropriations with recommendation:  To Consent Calendar",16,0,3,0,19
61445,8455,2009-05-13,Assembly,"Do pass, to Consent Calendar",16,0,0,0,16
61445,8456,2009-05-21,Assembly,"AB 1577 G.O.  Consent Calendar Second Day  Regular Session",77,0,3,0,80
61445,8457,2009-07-08,Senate,"Do pass, but re-refer to the Committee on Appropriations Recommend Consent",11,0,2,0,13
61445,8458,2009-08-24,Senate,"Do pass",13,0,0,0,13
61445,8459,2009-09-03,Senate,"Assembly 3rd Reading AB1577 Coto By Price",35,0,5,0,40
61445,8460,2009-09-09,Assembly,"Senate amendments be concurred in",15,0,4,0,19
61445,8461,2009-09-10,Assembly,"AB 1577 COTO  Concurrence in Senate Amendments",78,0,2,0,80
61446,25248,2009-05-06,Assembly,"Do pass, to Consent Calendar",16,0,0,0,16
61446,25249,2009-05-14,Assembly,"AB 1578 G.O.  Consent Calendar Second Day  Regular Session",73,0,0,0,73
61446,25250,2009-07-08,Senate,"Do pass and be placed on the Consent Calendar",11,0,0,0,11
61446,25251,2009-08-27,Senate,"Special Consent #16 AB1578 Committee on G.O. (Price)",38,0,0,0,38
61446,25252,2009-09-02,Assembly,"AB 1578 G.O.  Concurrence in Senate Amendments By PRICE",77,0,0,0,77
61447,8481,2009-04-30,Assembly,"Do pass and re-refer to Committee on Appropriations with recommendation:  To Consent Calendar",16,0,3,0,19
61447,8482,2009-05-13,Assembly,"Do pass",11,0,5,0,16
61447,8483,2009-05-26,Assembly,"AB 1579 G.O.  Assembly Third Reading  By PRICE",76,1,3,0,80
61447,8484,2009-07-08,Senate,"Do pass, but re-refer to the Committee on Appropriations Recommend Consent",11,0,2,0,13
61448,8445,2009-04-27,Assembly,"Do pass and re-refer to Committee on Appropriations with recommendation:  To Consent Calendar",8,0,1,0,9
61448,8446,2009-05-20,Assembly,"Do pass, to Consent Calendar",15,0,1,0,16
61448,8447,2009-05-28,Assembly,"AB 1580 REV.& TAX.  Consent Calendar Second Day  Regular Session",76,0,4,0,80
61448,8448,2009-08-24,Senate,"Do pass, but re-refer to the Committee on Appropriations",5,2,1,0,8
61448,8449,2009-08-27,Senate,"Do pass as amended",8,5,0,0,13
61448,8450,2009-09-04,Senate,"Assembly 3rd Reading AB1580 Charles Calderon By Wolk",22,17,1,0,40
61448,8451,2009-09-09,Assembly,"Senate amendments be concurred in",6,2,1,0,9
61448,8452,2009-09-09,Assembly,"Senate amendments be concurred in",10,5,1,0,16
61448,8453,2009-09-10,Assembly,"AB 1580 CALDERON  Concurrence in Senate Amendments",44,30,6,0,80
61449,8478,2009-05-04,Assembly,"Do pass, to Consent Calendar",9,0,0,0,9
61449,8479,2009-05-11,Assembly,"AB 1581 NAT. RES.  Consent Calendar Second Day  Regular Session",78,0,2,0,80
61449,9618,2010-06-28,Senate,"Do pass, but re-refer to the Committee on Appropriations",6,1,0,0,7
61449,21424,2010-08-25,Senate,"From Committee:  Amendments returned to Senate floor for 	consideration",4,2,0,0,6
61450,25651,2009-05-13,Assembly,"Do pass, to Consent Calendar",7,0,0,0,7
61450,25652,2009-05-21,Assembly,"AB 1582 L. GOV.  Consent Calendar Second Day  Regular Session",77,0,0,0,77
61450,25653,2009-06-17,Senate,"Do pass and be placed on the Consent Calendar",5,0,0,0,5
61450,25654,2009-06-24,Senate,"Consent Calendar 2nd AB1582 Committee on L. GOV. (Caballero)",40,0,0,0,40
61450,25655,2009-07-06,Assembly,"AB 1582 L. GOV.  Concurrence in Senate Amendments By CABALLERO",77,0,0,0,77
61452,23129,2009-07-01,Assembly,"Do pass and be re-referred to the Committee on Appropriations",6,0,0,0,6
61452,23130,2009-07-08,Assembly,"Do pass, to Consent Calendar",15,0,0,0,15
61452,23131,2009-07-16,Assembly,"AB 1584 P.E., R.& S.S.  Consent Calendar Second Day  By HERNANDEZ",72,0,0,0,72
61452,23132,2009-08-24,Senate,"Do pass, but re-refer to the Committee on Appropriations",7,0,0,0,7
61452,23133,2009-09-03,Senate,"Assembly 3rd Reading AB1584 Hernandez Urgency Clause",38,0,0,0,38
61452,23134,2009-09-11,Assembly,"AB 1584 HERNANDEZ  Concurrence in Senate Amendments",79,0,0,0,79
61453,22785,2009-08-24,Assembly,"Do pass and be re-referred to the Committee on Appropriations",10,0,0,0,10
61453,22786,2009-08-27,Assembly,"Do pass",17,0,0,0,17
61453,22787,2009-09-02,Assembly,"AB 1585A& A.R.  Third Reading Urgency  By DE LA TORRE",77,0,0,2,79
61453,22788,2010-01-12,Senate,"Do pass, but re-refer to the Committee on Appropriations",9,0,2,0,11
61453,22789,2010-02-11,Senate,"Assembly 3rd Reading AB1585 Committee on ACC. & ADM. REV. (De",35,0,4,0,39
61453,22790,2010-02-16,Assembly,"AB 1585A& A.R.  Concurrence in Senate Amendments By DE LA TORRE",72,0,0,7,79
61454,8489,2010-01-12,Assembly,"Do pass",7,0,0,0,7
61454,8490,2010-01-25,Assembly,"AB 1586 SWANSON  Assembly Third Reading",67,0,11,0,78
61454,8735,2010-06-15,Senate,"Do pass",7,0,0,0,7
61454,9620,2010-06-28,Senate,"Special Consent #28 AB1586 Swanson By Hancock",32,0,7,0,39
61454,10113,2010-07-01,Assembly,"AB 1586 SWANSON  Concurrence in Senate Amendments",79,0,0,0,79
61457,8487,2010-01-12,Assembly,"Do pass and be re-referred to the Committee on Judiciary",4,0,3,0,7
61457,8488,2010-01-14,Assembly,"Do pass and be re-referred to the Committee on Appropriations",6,0,3,0,9
61458,8493,2010-01-12,Assembly,"Do pass and be re-referred to the Committee on Budget",11,0,0,0,11
61458,8494,2010-01-21,Assembly,"Do pass as amended",16,0,1,0,17
61460,741,2010-04-07,Assembly,"Do pass and be re-referred to the Committee on Appropriations.",4,1,1,0,6
61460,742,2010-05-28,Assembly,"Do pass.",12,0,5,0,17
61460,743,2010-06-02,Assembly,"AB 1592 NAVA  Assembly Third Reading",49,24,6,0,79
61460,19369,2010-08-03,Senate,"Do pass as amended, and re-refer to the Committee on 	Appropriations",6,0,0,0,6
61460,19737,2010-08-09,Senate,"Do pass",8,0,0,0,8
61460,20678,2010-08-18,Senate,"Assembly 3rd Reading AB1592 Buchanan Urgency Clause",31,1,0,0,32
61460,20679,2010-08-19,Assembly,"Senate amendments be concurred in",5,1,0,0,6
61460,20680,2010-08-19,Assembly,"AB 1592 BUCHANAN  Concurrence- Urgency Added",73,4,0,0,77
61461,2599,2010-03-23,Assembly,"Do pass and be re-referred to the Committee on Appropriations",18,0,1,0,19
61461,2600,2010-05-28,Assembly,"Do pass as amended",17,0,0,0,17
61461,2601,2010-06-02,Assembly,"AB 1593 YAMADA  Assembly Third Reading",75,0,4,0,79
61461,8890,2010-06-16,Senate,"Do pass, but re-refer to the Committee on Veterans Affairs",8,0,1,0,9
61461,9277,2010-06-22,Senate,"Do pass, but re-refer to the Committee on Appropriations",4,0,1,0,5
61461,10943,2010-07-15,Senate,"Placed on Appropriations Suspense file",8,0,2,0,10
61461,20037,2010-08-12,Senate,"Do pass",11,0,0,0,11
61461,20615,2010-08-19,Senate,"Assembly 3rd Reading AB1593 Yamada By Alquist",35,0,0,0,35
61461,20946,2010-08-23,Assembly,"AB 1593 YAMADA  Concurrence in Senate Amendments",77,0,0,0,77
61463,5321,2010-04-20,Assembly,"Do pass as amended and be re-referred to the Committee on Appropriations",11,5,3,0,19
61464,4041,2010-03-16,Assembly,"Do pass as amended and be re-referred to the Committee on Appropriations",9,0,0,0,9
61464,4042,2010-04-08,Assembly,"AB 1596 HAYASHI  Assembly Third Reading",74,0,5,0,79
61464,9338,2010-06-22,Senate,"Do pass, but re-refer to the Committee on Public Safety",4,0,1,0,5
61464,20472,2010-08-18,Senate,"Special Consent #31 AB1596 Hayashi By Hancock",34,0,0,0,34
61464,20565,2010-08-19,Assembly,"AB 1596 HAYASHI  Concurrence in Senate Amendments",78,0,0,0,78
61465,3823,2010-04-07,Assembly,"Do pass as amended and be re-referred to the Committee on Appropriations",11,0,1,0,12
61465,3824,2010-04-28,Assembly,"Do pass",13,2,2,0,17
61465,3825,2010-05-13,Assembly,"AB 1597 JONES  Assembly Third Reading",74,3,2,0,79
61465,9789,2010-06-30,Senate,"Do pass, but re-refer to the Committee on Appropriations",10,0,1,0,11
61465,19297,2010-08-02,Senate,"Do pass",9,0,0,0,9
61465,20020,2010-08-11,Senate,"Assembly 3rd Reading AB1597 Jones By Denham",31,2,0,0,33
61466,8310,2010-04-12,Assembly,"Do pass and be re-referred to the Committee on Appropriations",4,10,8,0,22
61467,994,2010-04-06,Assembly,"Do pass as amended and be re-referred to the Committee on Appropriations.",19,0,0,0,19
61468,3112,2010-04-06,Assembly,"Do pass and be re-referred to the Committee on Appropriations",13,6,0,0,19
61468,3113,2010-05-28,Assembly,"Do pass",12,5,0,0,17
61468,3114,2010-06-01,Assembly,"AB 1600 BEALL  Assembly Third Reading",50,27,2,0,79
61468,9549,2010-06-23,Senate,"Do pass, but re-refer to the Committee on Appropriations",6,0,3,0,9
61468,10603,2010-07-15,Senate,"Do pass",6,2,2,0,10
61468,21125,2010-08-25,Senate,"Assembly 3rd Reading AB1600 Beall By Ashburn",21,9,0,0,30
61468,21509,2010-08-26,Assembly,"AB 1600 BEALL  Concurrence in Senate Amendments",50,28,0,0,78
61469,2700,2010-03-23,Assembly,"Do pass and be re-referred to the Committee on Appropriations",5,0,2,0,7
61469,2701,2010-05-28,Assembly,"Do pass as amended",12,0,5,0,17
61469,2702,2010-06-02,Assembly,"AB 1601 HILL  Assembly Third Reading",74,0,5,0,79
61469,10232,2010-06-29,Senate,"Do pass as amended, and re-refer to the Committee on Appropriations",7,0,0,0,7
61469,19184,2010-08-02,Senate,"Placed on Appropriations Suspense file",10,0,0,0,10
61469,20247,2010-08-12,Senate,"Do pass as amended",11,0,0,0,11
61469,20537,2010-08-19,Senate,"Assembly 3rd Reading AB1601 Hill By Leno",32,1,0,0,33
61469,20847,2010-08-23,Assembly,"AB 1601 HILL  Concurrence in Senate Amendments",77,0,0,0,77
61470,852,2010-04-20,Assembly,"Do pass and be re-referred to the Committee on Appropriations.",12,5,2,0,19
61470,853,2010-05-28,Assembly,"Do pass.",12,5,0,0,17
61470,854,2010-06-01,Assembly,"AB 1602 PEREZ, J.  Assembly Third Reading",49,26,4,0,79
61470,10340,2010-06-30,Senate,"Do pass, but re-refer to the Committee on Appropriations",6,2,1,0,9
61470,19536,2010-08-02,Senate,"Placed on Appropriations Suspense file",10,0,0,0,10
61470,20147,2010-08-12,Senate,"Do pass as amended",7,4,0,0,11
61470,20967,2010-08-24,Senate,"Assembly 3rd Reading AB1602 John A. Perez By Alquist",21,13,0,0,34
61470,21139,2010-08-25,Assembly,"AB 1602 PEREZ, J.  Concurrence in Senate Amendments",51,27,0,0,78
61473,5470,2010-04-21,Assembly,"Do pass as amended and be re-referred to the Committee on Appropriations",9,0,0,0,9
61474,4678,2010-04-20,Assembly,"Do pass as amended and be re-referred to the Committee on Appropriations",12,5,2,0,19
61475,3371,2010-03-16,Assembly,"Do pass and be re-referred to the Committee on Appropriations",2,3,1,0,6
61475,3372,2010-03-16,Assembly,"Set second hearing.  Failed passage.  Reconsideration granted",6,0,0,0,6
61475,3373,2010-04-20,Assembly,"Do pass and be re-referred to the Committee on Appropriations",3,4,0,0,7
61477,21937,2010-08-31,Assembly,"AB 1609 BLUMENFIELD  Assembly Third Reading",50,28,0,0,78
61478,1677,2010-04-15,Assembly,"Do pass as amended",14,0,13,0,27
61478,1678,2010-04-22,Assembly,"AB 1610 BUDGET  Assembly Third Reading  By BLUMENFIELD",45,7,27,0,79
61478,22222,2010-10-07,Senate,"Assembly 3rd Reading AB1610 Committee on BUDGET (Blumenfield) 	Urgency Clause",28,6,0,0,34
61478,22223,2010-10-07,Assembly,"AB 1610 BUDGET  Concurrence- Urgency Added  By BLUMENFIELD",56,14,0,0,70
61479,1486,2010-04-15,Assembly,"Do pass as amended",14,0,13,0,27
61479,1487,2010-04-22,Assembly,"AB 1611 BUDGET  Assembly Third Reading  By BLUMENFIELD",45,7,27,0,79
61479,22215,2010-10-08,Senate,"Assembly 3rd Reading AB1611 Committee on BUDGET (Blumenfield) 	Urgency Clause",25,11,0,0,36
61480,3069,2010-04-15,Assembly,"Do pass as amended",14,0,13,0,27
61480,3070,2010-04-22,Assembly,"AB 1612 BUDGET  Assembly Third Reading  By BLUMENFIELD",45,7,27,0,79
61480,22208,2010-10-07,Senate,"Assembly 2nd Reading AB1612 Committee on BUDGET (Blumenfield) By 	Ducheny",27,8,0,0,35
61480,22209,2010-10-08,Assembly,"AB 1612 BUDGET  Concurrence- Urgency Added  By BLUMENFIELD",54,17,0,0,71
61481,1511,2010-04-15,Assembly,"Do pass as amended",14,0,13,0,27
61481,1512,2010-04-22,Assembly,"AB 1613 BUDGET  Assembly Third Reading  By BLUMENFIELD",45,7,27,0,79
61481,22217,2010-10-07,Senate,"Assembly 2nd Reading AB1613 Committee on BUDGET (Evans) Lay on Table",21,11,0,0,32
61481,22218,2010-10-07,Senate,"Assembly 2nd Reading AB1613 Committee on BUDGET (Evans) Lay on Table",22,11,0,0,33
61481,22219,2010-10-08,Senate,"Assembly 2nd Reading AB1613 Committee on BUDGET (Evans)",26,7,0,0,33
61482,1830,2010-04-15,Assembly,"Do pass as amended",14,0,13,0,27
61482,1831,2010-04-22,Assembly,"AB 1614 BUDGET  Assembly Third Reading  By BLUMENFIELD",45,7,27,0,79
61482,22227,2010-10-07,Senate,"Do pass",7,3,0,0,10
61482,22228,2010-10-08,Senate,"Assembly 3rd Reading AB1614 Committee on BUDGET (Blumenfield) 	Urgency Clause",20,14,0,0,34
61483,1916,2010-04-15,Assembly,"Do pass as amended",14,0,13,0,27
61483,1917,2010-04-22,Assembly,"AB 1615 BUDGET  Assembly Third Reading  By BLUMENFIELD",45,7,27,0,79
61484,1761,2010-04-15,Assembly,"Do pass as amended",14,0,13,0,27
61484,1762,2010-04-22,Assembly,"AB 1616 BUDGET  Assembly Third Reading  By BLUMENFIELD",45,7,27,0,79
61485,1649,2010-04-15,Assembly,"Do pass as amended",14,0,13,0,27
61485,1650,2010-04-22,Assembly,"AB 1617 BUDGET  Assembly Third Reading  By BLUMENFIELD",45,7,27,0,79
61486,504,2010-04-15,Assembly,"Do pass as amended.",14,0,13,0,27
61486,505,2010-04-22,Assembly,"AB 1618 BUDGET  Assembly Third Reading  By BLUMENFIELD",45,7,27,0,79
61486,22206,2010-10-08,Senate,"Assembly 2nd Reading AB1618 Committee on BUDGET (Blumenfield) 	Urgency Clause",26,10,0,0,36
61487,959,2010-04-15,Assembly,"Do pass as amended.",14,0,13,0,27
61487,960,2010-04-22,Assembly,"AB 1619 BUDGET  Assembly Third Reading  By BLUMENFIELD",45,7,27,0,79
61487,22211,2010-10-07,Senate,"Assembly 3rd Reading AB1619 Committee on BUDGET (Blumenfield) 	Urgency Clause",28,4,0,0,32
61487,22212,2010-10-07,Assembly,"AB 1619 BUDGET  Concurrence- Urgency Added  By BLUMENFIELD",67,7,0,0,74
61488,1340,2010-04-15,Assembly,"Do pass as amended.",14,0,13,0,27
61488,1341,2010-04-22,Assembly,"AB 1620 BUDGET  Assembly Third Reading  By BLUMENFIELD",45,7,27,0,79
61488,22213,2010-10-07,Senate,"Assembly 2nd Reading AB1620 Committee on BUDGET (Blumenfield) 	Urgency Clause",33,3,0,0,36
61488,22214,2010-10-07,Assembly,"AB 1620 BUDGET  Concurrence- Urgency Added  By BLUMENFIELD",56,18,0,0,74
61489,1513,2010-04-15,Assembly,"Do pass as amended",14,0,13,0,27
61489,1514,2010-04-22,Assembly,"AB 1621 BUDGET  Assembly Third Reading  By BLUMENFIELD",45,7,27,0,79
61489,22220,2010-10-07,Senate,"Assembly 2nd Reading AB1621 Committee on BUDGET (Blumenfield) 	Urgency Clause",32,3,0,0,35
61489,22221,2010-10-07,Assembly,"AB 1621 BUDGET  Concurrence- Urgency Added  By BLUMENFIELD",57,18,0,0,75
61490,2833,2010-04-15,Assembly,"Do pass as amended",14,0,13,0,27
61490,2834,2010-04-22,Assembly,"AB 1622 BUDGET  Assembly Third Reading  By BLUMENFIELD",45,7,27,0,79
61491,2341,2010-04-15,Assembly,"Do pass as amended",14,0,13,0,27
61491,2342,2010-04-22,Assembly,"AB 1623 BUDGET  Assembly Third Reading  By BLUMENFIELD",45,7,27,0,79
61492,2711,2010-04-15,Assembly,"Do pass as amended",14,0,13,0,27
61492,2712,2010-04-22,Assembly,"AB 1624 BUDGET  Assembly Third Reading  By BLUMENFIELD",45,7,27,0,79
61492,22201,2010-10-07,Senate,"Assembly 2nd Reading AB1624 Committee on BUDGET (Blumenfield) 	Urgency Clause",34,1,0,0,35
61492,22202,2010-10-07,Assembly,"AB 1624 BUDGET  Concurrence- Urgency Added  By BLUMENFIELD",64,11,0,0,75
61493,1714,2010-04-15,Assembly,"Do pass as amended",14,0,13,0,27
61493,1715,2010-04-22,Assembly,"AB 1625 BUDGET  Assembly Third Reading  By BLUMENFIELD",45,7,27,0,79
61493,22224,2010-10-07,Senate,"Do pass, but re-refer to the Committee on Appropriations",6,0,0,0,6
61493,22225,2010-10-07,Senate,"Assembly 3rd Reading AB1625 John A. Perez Urgency Clause",32,0,0,0,32
61493,22226,2010-10-07,Assembly,"AB 1625 PEREZ, J.  Concurrence- Urgency Added  By TORRICO",66,5,0,0,71
61494,2756,2010-04-15,Assembly,"Do pass as amended",14,0,13,0,27
61494,2757,2010-04-22,Assembly,"AB 1626 BUDGET  Assembly Third Reading  By BLUMENFIELD",45,7,27,0,79
61495,2667,2010-04-15,Assembly,"Do pass as amended",14,0,13,0,27
61495,2668,2010-04-22,Assembly,"AB 1627 BUDGET  Assembly Third Reading  By BLUMENFIELD",45,7,27,0,79
61496,2288,2010-04-15,Assembly,"Do pass as amended",14,0,13,0,27
61496,2289,2010-04-22,Assembly,"AB 1628 BUDGET  Assembly Third Reading  By BLUMENFIELD",45,7,27,0,79
61496,27393,2010-10-07,Senate,"Assembly 2nd Reading AB1628 Committee on BUDGET (Blumenfield) 	Urgency Clause",32,3,0,0,35
61496,27394,2010-10-07,Assembly,"AB 1628 BUDGET  Concurrence- Urgency Added  By BLUMENFIELD",71,3,0,0,74
61497,2713,2010-04-15,Assembly,"Do pass as amended",14,0,13,0,27
61497,2714,2010-04-22,Assembly,"AB 1629 BUDGET  Assembly Third Reading  By BLUMENFIELD",45,7,27,0,79
61497,27395,2010-10-07,Senate,"Assembly 2nd Reading AB1629 Committee on BUDGET (Blumenfield) 	Urgency Clause",34,2,0,0,36
61497,27396,2010-10-07,Assembly,"AB 1629 BUDGET  Concurrence- Urgency Added  By BLUMENFIELD",73,0,0,0,73
61498,3038,2010-04-15,Assembly,"Do pass as amended",14,0,13,0,27
61498,3039,2010-04-22,Assembly,"AB 1630 BUDGET  Assembly Third Reading  By BLUMENFIELD",45,7,27,0,79
61499,2582,2010-04-15,Assembly,"Do pass as amended",14,0,13,0,27
61499,2583,2010-04-22,Assembly,"AB 1631 BUDGET  Assembly Third Reading  By BLUMENFIELD",45,7,27,0,79
61499,22200,2010-10-08,Senate,"Assembly 3rd Reading AB1631 Garrick Urgency Clause",24,10,0,0,34
61500,2580,2010-04-15,Assembly,"Do pass as amended",14,0,13,0,27
61500,2581,2010-04-22,Assembly,"AB 1632 BUDGET  Assembly Third Reading  By BLUMENFIELD",45,7,27,0,79
61500,22198,2010-10-07,Senate,"Assembly 2nd Reading AB1632 Committee on BUDGET (Blumenfield) 	Urgency Clause",36,0,0,0,36
61500,22199,2010-10-07,Assembly,"AB 1632 BUDGET  Concurrence- Urgency Added  By BLUMENFIELD",68,5,0,0,73
61501,2918,2010-04-15,Assembly,"Do pass as amended",14,0,13,0,27
61501,2919,2010-04-22,Assembly,"AB 1633 BUDGET  Assembly Third Reading  By BLUMENFIELD",45,7,27,0,79
61501,21815,2010-09-01,Senate,"Assembly 3rd Reading AB1633 Garrick Urgency Clause",12,24,0,0,36
61502,2105,2010-04-15,Assembly,"Do pass as amended",14,0,13,0,27
61502,2106,2010-04-22,Assembly,"AB 1634 BUDGET  Assembly Third Reading  By BLUMENFIELD",45,7,27,0,79
61503,2920,2010-04-15,Assembly,"Do pass as amended",14,0,13,0,27
61503,2921,2010-04-22,Assembly,"AB 1635 BUDGET  Assembly Third Reading  By BLUMENFIELD",45,7,27,0,79
61504,2619,2010-04-15,Assembly,"Do pass as amended",14,0,13,0,27
61504,2620,2010-04-22,Assembly,"AB 1636 BUDGET  Assembly Third Reading  By BLUMENFIELD",45,7,27,0,79
61504,21842,2010-09-01,Senate,"W/O REF. TO FILE AB1636 Blumenfield Urgency Clause",21,14,0,0,35
61505,689,2010-04-15,Assembly,"Do pass as amended.",14,0,13,0,27
61505,690,2010-04-22,Assembly,"AB 1637 BUDGET  Assembly Third Reading  By BLUMENFIELD",45,7,27,0,79
61507,23,2010-04-08,Assembly,"Be referred to Committee on Judiciary.",11,0,0,0,11
61507,24,2010-04-19,Assembly,"Do pass and be re-referred to the Committee on Judiciary.",7,5,0,0,12
61507,25,2010-04-22,Assembly,"Do pass and be re-referred to the Committee on Appropriations.",7,3,0,0,10
61507,26,2010-05-28,Assembly,"Do pass as amended.",12,5,0,0,17
61507,27,2010-06-03,Assembly,"AB 1639 NAVA  Assembly Third Reading",38,31,10,0,79
61507,28,2010-06-03,Assembly,"AB 1639 NAVA  Assembly Third Reading  Motion to Reconsider  By CALDERON",42,24,13,0,79
61508,668,2010-03-23,Assembly,"Do pass and be re-referred to the Committee on Appropriations.",15,0,4,0,19
61508,669,2010-05-28,Assembly,"Do pass as amended.",12,5,0,0,17
61508,670,2010-06-02,Assembly,"AB 1640 EVANS  Assembly Third Reading",61,13,5,0,79
61508,10287,2010-06-30,Senate,"Do pass, but re-refer to the Committee on Appropriations",8,0,1,0,9
61508,19326,2010-08-02,Senate,"Placed on Appropriations Suspense file",10,0,0,0,10
61508,20108,2010-08-12,Senate,"Do pass as amended",11,0,0,0,11
61508,21523,2010-08-25,Senate,"Assembly 3rd Reading AB1640 Evans By Kehoe",34,0,0,0,34
61508,21524,2010-08-26,Assembly,"AB 1640 EVANS  Concurrence in Senate Amendments",76,0,0,0,76
61509,4386,2010-04-12,Assembly,"Be referred to Committee on Housing and Community Development",10,0,1,0,11
61509,4387,2010-05-05,Assembly,"Do pass as amended",6,3,0,0,9
61509,4388,2010-05-13,Assembly,"AB 1641 HALL  Assembly Third Reading",46,26,7,0,79
61509,9396,2010-06-22,Senate,"Do pass as amended, and re-refer to the Committee on Rules",5,2,2,0,9
61509,9805,2010-06-30,Senate,"Do pass as amended",3,2,0,0,5
61509,20601,2010-08-18,Senate,"Assembly 3rd Reading AB1641 Hall By Wright",21,13,0,0,34
61509,20602,2010-08-19,Assembly,"AB 1641 HALL  Concurrence in Senate Amendments",48,29,0,0,77
61510,4679,2010-04-13,Assembly,"Do pass and be re-referred to the Committee on Appropriations",4,0,2,0,6
61511,4670,2010-04-12,Assembly,"Do pass and re-refer to Committee on Appropriations with recommendation:  To Consent Calendar",20,0,2,0,22
61511,4671,2010-04-21,Assembly,"Do pass",17,0,0,0,17
61511,4672,2010-04-26,Assembly,"AB 1643 SMYTH  Third Reading Urgency",69,0,10,0,79
61511,4673,2010-06-09,Senate,"Do pass and be placed on the Consent Calendar",6,0,5,0,11
61511,8996,2010-06-17,Senate,"Consent Calendar 2nd AB1643 Smyth",33,0,6,0,39
61511,9355,2010-06-24,Senate,"Assembly 3rd Reading AB1643 Smyth Urgency Clause",31,0,8,0,39
61511,9601,2010-06-28,Assembly,"AB 1643 SMYTH  Concurrence in Senate Amendments",75,0,4,0,79
61512,951,2010-03-23,Assembly,"Amend, and do pass as amended and be re-referred to the Committee on Veterans Affairs with the recommendation:  To Consent Calendar.",10,0,0,0,10
61512,952,2010-04-13,Assembly,"Do pass.",9,0,0,0,9
61512,953,2010-04-22,Assembly,"AB 1644 NIELSEN  Assembly Third Reading",75,0,4,0,79
61512,9211,2010-06-22,Senate,"Do pass, but re-refer to the Committee on Judiciary",4,0,1,0,5
61512,9822,2010-06-29,Senate,"Do pass as amended. To Consent Calendar",4,0,1,0,5
61512,19428,2010-08-05,Senate,"Consent Calendar 2nd AB1644 Nielsen",33,0,0,0,33
61512,19615,2010-08-09,Assembly,"AB 1644 NIELSEN  Concurrence in Senate Amendments",78,0,0,0,78
61513,140,2010-04-19,Assembly,"Do pass as amended.",19,0,8,0,27
61513,141,2010-04-22,Assembly,"AB 1645 NESTANDE  Assembly Third Reading",73,0,6,0,79
61514,5367,2010-03-24,Assembly,"Do pass and be re-referred to the Committee on Appropriations",6,2,1,0,9
61515,746,2010-04-06,Assembly,"Do pass as amended and be re-referred to the Committee on Judiciary.",9,0,2,0,11
61515,747,2010-04-13,Assembly,"Do pass as amended and be re-referred to the Committee on Appropriations.",8,0,2,0,10
61515,748,2010-05-28,Assembly,"Do pass as amended.",12,0,5,0,17
61515,749,2010-06-02,Assembly,"AB 1647 HAYASHI  Assembly Third Reading",59,17,3,0,79
61515,9232,2010-06-21,Senate,"Do pass, but re-refer to the Committee on Education",6,0,3,0,9
61515,20484,2010-08-12,Senate,"Assembly 3rd Reading AB1647 Hayashi By Lowenthal",27,5,0,0,32
61515,20485,2010-08-17,Assembly,"AB 1647 HAYASHI  Concurrence in Senate Amendments",56,20,0,0,76
61516,4559,2010-04-19,Assembly,"Do pass and be re-referred to the Committee on Appropriations",13,0,1,0,14
61516,4560,2010-04-28,Assembly,"Do pass as amended, to Consent Calendar",15,0,2,0,17
61516,4561,2010-05-06,Assembly,"AB 1648 JEFFRIES  Consent Calendar Second Day  Regular Session",74,0,5,0,79
61516,10056,2010-06-29,Senate,"Do pass as amended, and re-refer to the Committee on Appropriations",8,0,1,0,9
61516,21137,2010-08-25,Senate,"Assembly 3rd Reading AB1648 Jeffries By Emmerson",31,0,0,0,31
61516,21325,2010-08-26,Assembly,"AB 1648 JEFFRIES  Concurrence in Senate Amendments",75,0,0,0,75
61517,592,2010-04-12,Assembly,"Do pass and re-refer to Committee on Appropriations with recommendation:  To Consent Calendar.",20,0,2,0,22
61517,593,2010-04-21,Assembly,"Do pass.",17,0,0,0,17
61517,594,2010-05-03,Assembly,"AB 1649 CHESBRO  Assembly Third Reading",77,0,2,0,79
61517,5685,2010-06-09,Senate,"Do pass, but re-refer to the Committee on Appropriations Recommend Consent",6,0,5,0,11
61517,19156,2010-08-02,Senate,"Consent Calendar 2nd AB1649 Chesbro",33,0,0,0,33
61518,1635,2010-02-16,Assembly,"Do pass as amended and be re-referred to the Committee on Business and Professions",9,0,0,0,9
61518,1636,2010-04-20,Assembly,"Do pass and be re-referred to the Committee on Appropriations",11,0,0,0,11
61518,1637,2010-05-28,Assembly,"Do pass",17,0,0,0,17
61518,1638,2010-06-01,Assembly,"AB 1650 FEUER  Assembly Third Reading",74,0,5,0,79
61518,10236,2010-06-29,Senate,"Do pass as amended, and re-refer to the Committee on Appropriations",7,0,4,0,11
61518,19401,2010-08-02,Senate,"Placed on Appropriations Suspense file",10,0,0,0,10
61518,20043,2010-08-12,Senate,"Do pass, but re-refer to the Committee on Rules",11,0,0,0,11
61518,21836,2010-08-31,Senate,"W/O REF. TO FILE AB1650 Feuer By Leno",29,3,0,0,32
61518,21837,2010-08-31,Assembly,"AB 1650 Feuer  Concurrence in Senate Amendments",76,0,0,0,76
61519,264,2010-04-21,Assembly,"Do pass and be re-referred to the Committee on Appropriations.",4,1,1,0,6
61519,265,2010-05-28,Assembly,"Do pass as amended.",12,5,0,0,17
61519,266,2010-06-02,Assembly,"AB 1651 DE LA TORRE  Assembly Third Reading",51,22,6,0,79
61519,9626,2010-06-28,Senate,"Do pass, but re-refer to the Committee on Appropriations",4,2,0,0,6
61519,10888,2010-07-15,Senate,"Placed on Appropriations Suspense file",8,0,2,0,10
61519,20282,2010-08-12,Senate,"Do pass",7,4,0,0,11
61519,20917,2010-08-23,Senate,"Assembly 3rd Reading AB1651 De La Torre By Leno",23,12,0,0,35
61520,2425,2010-03-11,Assembly,"Be referred to Committee on Health",10,0,1,0,11
61520,2426,2010-03-23,Assembly,"Do pass and be re-referred to the Committee on Judiciary",12,7,0,0,19
61520,2427,2010-04-20,Assembly,"Do pass",7,3,0,0,10
61520,2428,2010-06-01,Assembly,"AB 1652 JONES  Assembly Third Reading",44,30,5,0,79
61520,10243,2010-06-30,Senate,"Do pass as amended",6,2,1,0,9
61520,21338,2010-08-23,Senate,"Assembly 3rd Reading AB1652 Jones By Yee",24,12,0,0,36
61520,21339,2010-08-25,Assembly,"AB 1652 JONES  Concurrence in Senate Amendments",52,25,0,0,77
61521,2981,2010-04-06,Assembly,"Do pass and be re-referred to the Committee on Appropriations",16,1,2,0,19
61521,2982,2010-05-28,Assembly,"Do pass",12,5,0,0,17
61521,2983,2010-06-01,Assembly,"AB 1653 JONES  Third Reading Urgency",63,14,2,0,79
61521,10079,2010-06-30,Senate,"Do pass as amended, and re-refer to the Committee on Appropriations",6,2,1,0,9
61521,19842,2010-08-09,Senate,"Placed on Appropriations Suspense file",10,0,0,0,10
61521,20025,2010-08-12,Senate,"Do pass as amended",10,1,0,0,11
61521,21605,2010-08-27,Senate,"Assembly 3rd Reading AB1653 Jones By Alquist",31,2,0,0,33
61521,21716,2010-08-30,Assembly,"Senate amendments be concurred in",16,0,0,0,16
61521,21717,2010-08-30,Assembly,"AB 1653 Jones  Concurrence in Senate Amendments",77,0,0,0,77
61523,5295,2010-03-23,Assembly,"Do pass and be re-referred to the Committee on Judiciary",6,0,0,0,6
61523,5296,2010-04-06,Assembly,"Do pass and be re-referred to the Committee on Appropriations",9,0,1,0,10
61524,4529,2010-03-16,Assembly,"Do pass as amended",9,0,0,0,9
61524,4530,2010-04-05,Assembly,"AB 1656 MA  Assembly Third Reading",59,11,9,0,79
61524,8823,2010-06-15,Senate,"Do pass",3,2,0,0,5
61524,19857,2010-08-11,Senate,"Assembly 3rd Reading AB1656 Ma By DeSaulnier",22,11,0,0,33
61526,4235,2010-05-05,Assembly,"Do pass, to Consent Calendar",6,0,0,0,6
61526,4236,2010-05-13,Assembly,"AB 1658 LIEU  Consent Calendar Second Day  Regular Session",76,0,3,0,79
61526,8721,2010-06-14,Senate,"Do pass",6,0,0,0,6
61526,9647,2010-06-28,Senate,"Assembly 3rd Reading AB1658 Lieu By Correa",34,0,5,0,39
61527,296,2010-04-06,Assembly,"Do pass as amended and be re-referred to the Committee on Appropriations.",11,0,0,0,11
61527,297,2010-05-28,Assembly,"Do pass.",17,0,0,0,17
61527,298,2010-06-03,Assembly,"AB 1659 HUBER  Assembly Third Reading",73,3,3,0,79
61527,9183,2010-06-21,Senate,"Do pass, but re-refer to the Committee on Rules",6,0,3,0,9
61527,19478,2010-08-02,Senate,"Placed on Appropriations Suspense file",10,0,0,0,10
61527,20125,2010-08-12,Senate,"Do pass",11,0,0,0,11
61527,20825,2010-08-23,Senate,"Assembly 3rd Reading AB1659 Huber By DeSaulnier",34,0,0,0,34
61527,20992,2010-08-24,Assembly,"AB 1659 HUBER  Concurrence in Senate Amendments",76,0,0,0,76
61528,5157,2010-03-22,Assembly,"Do pass, to Consent Calendar",13,0,1,0,14
61528,5158,2010-04-05,Assembly,"AB 1660 SALAS  Consent Calendar Second Day",76,0,3,0,79
61528,8906,2010-06-15,Senate,"Do pass and be placed on the Consent Calendar",8,0,1,0,9
61528,9541,2010-06-24,Senate,"Consent Calendar 2nd AB1660 Salas",31,0,8,0,39
61529,8554,2010-04-20,Assembly,"Do pass and be re-referred to the Committee on Appropriations",3,4,0,0,7
61530,361,2010-04-14,Assembly,"Do pass and be re-referred to the Committee on Revenue and Taxation.",8,0,1,0,9
61530,362,2010-04-19,Assembly,"Do pass and be re-referred to the Committee on Appropriations.",9,0,0,0,9
61530,363,2010-05-28,Assembly,"Do pass.",17,0,0,0,17
61530,364,2010-06-01,Assembly,"AB 1662 PORTANTINO  Third Reading Urgency",77,0,2,0,79
61530,9501,2010-06-23,Senate,"Do pass, but re-refer to the Committee on Appropriations",3,0,2,0,5
61530,10546,2010-07-15,Senate,"Placed on Appropriations Suspense file",8,0,2,0,10
61530,20272,2010-08-12,Senate,"Do pass as amended",11,0,0,0,11
61530,21173,2010-08-25,Senate,"Assembly 3rd Reading AB1662 Portantino Reconsider",34,0,0,0,34
61530,21790,2010-08-31,Senate,"W/O REF. TO FILE AB1662 Portantino Urgency Clause",28,0,0,0,28
61530,21791,2010-08-31,Assembly,"AB 1662 PORTANTINO  Concurrence in Senate Amendments",74,0,0,0,74
61530,22028,2010-08-25,Senate,"Assembly 3rd Reading AB1662 Portantino Urgency Clause",25,9,0,0,34
61531,8497,2010-03-23,Assembly,"Do pass",2,4,1,0,7
61531,8498,2010-03-23,Assembly,"Set third hearing.  Failed passage.  Reconsideration granted",7,0,0,0,7
61532,1278,2010-04-08,Assembly,"Be referred to Committee on Local Government.",11,0,0,0,11
61533,3249,2010-04-21,Assembly,"Do pass and be re-referred to the Committee on Appropriations",4,1,1,0,6
61533,3250,2010-05-28,Assembly,"Do pass as amended",12,5,0,0,17
61533,3251,2010-06-03,Assembly,"AB 1665 SWANSON  Assembly Third Reading",49,28,2,0,79
61533,9662,2010-06-28,Senate,"Do pass, but re-refer to the Committee on Appropriations",1,3,2,0,6
61533,9663,2010-06-28,Senate,"Set, first hearing.  Failed passage in Committee.  Reconsideration granted",6,0,0,0,6
61534,4526,2010-03-11,Assembly,"Be referred to Committee on Local Government",10,0,1,0,11
61534,4527,2010-05-05,Assembly,"Do pass",9,0,0,0,9
61534,4528,2010-05-13,Assembly,"AB 1666 SWANSON  Assembly Third Reading",76,0,3,0,79
61534,8766,2010-06-16,Senate,"Do pass",4,0,1,0,5
61534,9649,2010-06-28,Senate,"Special Consent #28 AB1666 Swanson",32,0,7,0,39
61534,9982,2010-07-01,Assembly,"AB 1666 SWANSON  Concurrence in Senate Amendments",77,0,2,0,79
61535,1519,2010-03-11,Assembly,"Be referred to Committee on Public Employees, Retirement and Social Security",10,0,1,0,11
61535,1520,2010-05-05,Assembly,"Do pass as amended, to Consent Calendar",6,0,0,0,6
61535,1521,2010-05-20,Assembly,"AB 1667 SWANSON  Consent Calendar Second Day  Regular Session",72,0,7,0,79
61535,9939,2010-06-28,Senate,"Do pass",6,0,0,0,6
61535,10085,2010-07-01,Senate,"Special Consent #29 AB1667 Swanson",34,0,5,0,39
61536,5344,2010-03-16,Assembly,"Amend, and do pass as amended and be re-referred to the Committee on Local Government with the recommendation:  To Consent Calendar",7,0,0,0,7
61536,5345,2010-04-07,Assembly,"Do pass, to Consent Calendar",9,0,0,0,9
61536,5346,2010-04-15,Assembly,"AB 1668 KNIGHT  Consent Calendar Second Day  Regular Session",70,0,9,0,79
61536,5347,2010-05-05,Senate,"Do pass as amended",5,0,0,0,5
61536,9056,2010-06-17,Senate,"Assembly 3rd Reading AB1668 Knight By Runner",29,0,10,0,39
61536,9106,2010-06-21,Assembly,"AB 1668 KNIGHT  Concurrence in Senate Amendments",75,0,4,0,79
61537,8500,2010-03-22,Assembly,"Do pass and be re-referred to the Committee on Appropriations",3,6,0,0,9
61538,1080,2010-03-22,Assembly,"Do pass as amended and re-refer to Committee on Appropriations with recommendation:  To Consent Calendar.",14,0,0,0,14
61538,1081,2010-05-28,Assembly,"Do pass.",17,0,0,0,17
61538,1082,2010-06-01,Assembly,"AB 1670 BEALL  Assembly Third Reading",77,0,2,0,79
61538,9998,2010-06-29,Senate,"Do pass as amended, and re-refer to the Committee on Appropriations",8,0,1,0,9
61538,19466,2010-08-02,Senate,"Placed on Appropriations Suspense file",10,0,0,0,10
61538,20089,2010-08-12,Senate,"Do pass",11,0,0,0,11
61538,20497,2010-08-18,Senate,"Assembly 3rd Reading AB1670 Beall By Alquist",34,0,0,0,34
61538,20595,2010-08-19,Assembly,"AB 1670 BEALL  Concurrence in Senate Amendments",78,0,0,0,78
61539,3243,2010-04-21,Assembly,"Do pass and be re-referred to the Committee on Appropriations",5,2,2,0,9
61539,3244,2010-05-12,Assembly,"Do pass as amended",16,0,1,0,17
61539,3245,2010-05-20,Assembly,"AB 1671 JEFFRIES  Assembly Third Reading",68,0,11,0,79
61539,10176,2010-06-30,Senate,"Do pass, but re-refer to the Committee on Appropriations",4,0,1,0,5
61539,19681,2010-08-09,Senate,"Special Consent #30 AB1671 Jeffries",34,0,0,0,34
61540,8499,2010-03-22,Assembly,"Do pass and be re-referred to the Committee on Elections and Redistricting",3,6,0,0,9
61541,841,2010-03-24,Assembly,"Do pass as amended and be re-referred to the Committee on Appropriations.",6,2,1,0,9
61542,1990,2010-04-13,Assembly,"Do pass as amended and be re-referred to the Committee on Appropriations",9,0,0,0,9
61542,1991,2010-05-05,Assembly,"Do pass",16,0,1,0,17
61542,1992,2010-05-13,Assembly,"AB 1674 SALDANA  Assembly Third Reading",68,4,7,0,79
61542,8700,2010-06-14,Senate,"Do pass as amended, and re-refer to the Committee on Appropriations",7,0,0,0,7
61542,21028,2010-08-23,Senate,"Assembly 3rd Reading AB1674 Saldana By Lowenthal",32,3,0,0,35
61542,21151,2010-08-25,Assembly,"AB 1674 SALDANA  Concurrence in Senate Amendments",66,8,0,0,74
61543,369,2010-03-16,Assembly,"Do pass and be re-referred to the Committee on Appropriations.",5,0,1,0,6
61543,370,2010-04-14,Assembly,"Do pass as amended, to Consent Calendar.",15,0,2,0,17
61543,371,2010-04-22,Assembly,"AB 1675 HAGMAN  Consent Calendar Second Day  Regular Session",74,0,5,0,79
61543,9205,2010-06-22,Senate,"Do pass, but re-refer to the Committee on Appropriations",7,0,0,0,7
61543,19889,2010-08-12,Senate,"Assembly 3rd Reading AB1675 Hagman By Leno",35,0,0,0,35
61543,20341,2010-08-17,Assembly,"AB 1675 HAGMAN  Concurrence in Senate Amendments",76,0,0,0,76
61544,1111,2010-04-20,Assembly,"Do pass as amended and be re-referred to the Committee on Appropriations.",7,0,0,0,7
61544,1112,2010-05-28,Assembly,"Do pass as amended.",17,0,0,0,17
61544,1113,2010-06-03,Assembly,"AB 1676 FUENTES  Assembly Third Reading",72,2,5,0,79
61544,9743,2010-06-29,Senate,"Do pass, but re-refer to the Committee on Rules",4,0,1,0,5
61544,19925,2010-08-12,Senate,"Do pass, but re-refer to the Committee on Appropriations",4,0,0,0,4
61544,21789,2010-08-31,Senate,"W/O REF. TO FILE AB1676 Fuentes Urgency Clause",28,5,0,0,33
61544,22216,2010-10-08,Assembly,"AB 1676 FUENTES  Concurrence- Urgency Added",42,12,0,0,54
61545,1420,2010-04-13,Assembly,"Do pass, to Consent Calendar",13,0,0,0,13
61545,1421,2010-04-22,Assembly,"AB 1677 CABALLERO  Consent Calendar Second Day  Regular Session",74,0,5,0,79
61545,4428,2010-06-09,Senate,"Do pass as amended. To Consent Calendar",7,0,2,0,9
61545,8940,2010-06-17,Senate,"Consent Calendar 2nd AB1677 Caballero",33,0,6,0,39
61545,9095,2010-06-21,Assembly,"AB 1677 CABALLERO  Concurrence in Senate Amendments",75,0,4,0,79
61546,4741,2010-04-20,Assembly,"Do pass and be re-referred to the Committee on Appropriations",4,2,1,0,7
61547,3511,2010-05-03,Assembly,"Do pass",14,0,1,0,15
61547,3512,2010-05-06,Assembly,"AB 1679 TORRES  Assembly Third Reading",73,0,6,0,79
61547,19403,2010-08-04,Senate,"Do pass",4,0,0,0,4
61547,20423,2010-08-18,Senate,"Special Consent #31 AB1679 Torres",34,0,0,0,34
61547,20685,2010-08-20,Assembly,"AB 1679 TORRES  Concurrence in Senate Amendments",76,0,0,0,76
61548,2262,2010-03-16,Assembly,"Do pass as amended",6,3,0,0,9
61548,2263,2010-04-29,Assembly,"AB 1680 SALDANA  Assembly Third Reading",44,27,8,0,79
61548,10223,2010-06-29,Senate,"Do pass as amended",3,1,1,0,5
61548,20994,2010-08-24,Senate,"Assembly 3rd Reading AB1680 Saldana By Leno",23,13,0,0,36
61548,21086,2010-08-25,Assembly,"AB 1680 SALDANA  Concurrence in Senate Amendments",50,27,0,0,77
61549,5262,2010-03-16,Assembly,"Do pass",5,0,2,0,7
61549,5263,2010-04-05,Assembly,"AB 1681 YAMADA  Assembly Third Reading",49,25,5,0,79
61549,8913,2010-06-15,Senate,"Do pass",3,2,0,0,5
61549,21945,2010-08-30,Senate,"Assembly 3rd Reading AB1681 Yamada By Hancock",21,16,0,0,37
61549,21946,2010-08-31,Assembly,"AB 1681 YAMADA  Concurrence in Senate Amendments",51,24,0,0,75
61550,2058,2010-04-21,Assembly,"Do pass and be re-referred to the Committee on Public Safety",20,0,2,0,22
61550,2059,2010-04-22,Assembly,"Do pass",2,5,0,0,7
61550,2060,2010-04-22,Assembly,"Set first hearing.  Failed passage.  Reconsideration granted",7,0,0,0,7
61550,2061,2010-05-04,Assembly,"Do pass",2,5,0,0,7
61551,1014,2010-04-07,Assembly,"Do pass and re-refer to Committee on Appropriations with recommendation:  To Consent Calendar.",8,0,1,0,9
61551,1015,2010-05-28,Assembly,"Do pass as amended.",12,0,5,0,17
61551,1016,2010-06-02,Assembly,"AB 1683 TORRES  Assembly Third Reading",75,0,4,0,79
61551,10266,2010-06-30,Senate,"Do pass as amended, but re-refer to the Committee on Appropriations Recommend Consent",8,0,1,0,9
61551,19454,2010-08-05,Senate,"Consent Calendar 2nd AB1683 Torres",33,0,0,0,33
61551,20677,2010-08-20,Assembly,"AB 1683 TORRES  Concurrence in Senate Amendments",75,0,0,0,75
61552,4773,2010-03-16,Assembly,"Do pass, to Consent Calendar",9,0,0,0,9
61552,4774,2010-03-22,Assembly,"AB 1684 JEFFRIES  Consent Calendar Second Day",73,0,6,0,79
61552,8861,2010-06-15,Senate,"Do pass and be placed on the Consent Calendar",5,0,0,0,5
61552,9553,2010-06-24,Senate,"Consent Calendar 2nd AB1684 Jeffries",31,0,8,0,39
61555,4960,2010-05-10,Assembly,"Do pass and be re-referred to the Committee on Appropriations",9,0,0,0,9
61556,8501,2010-03-02,Assembly,"Do pass and be re-referred to the Committee on Appropriations",2,3,1,0,6
61556,8502,2010-03-02,Assembly,"Set first hearing.  Failed passage.  Reconsideration granted",6,0,0,0,6
61557,8672,2010-04-06,Assembly,"Do pass and re-refer to Committee on Appropriations with recommendation:  To Consent Calendar",7,0,0,0,7
61557,8673,2010-04-14,Assembly,"Do pass, to Consent Calendar",15,0,2,0,17
61557,8674,2010-04-22,Assembly,"AB 1689 TORRES  Consent Calendar Second Day  Regular Session",74,0,5,0,79
61557,9734,2010-06-29,Senate,"Do pass, but re-refer to the Committee on Appropriations Recommend Consent",4,0,1,0,5
61557,19461,2010-08-05,Senate,"Consent Calendar 2nd AB1689 Torres",33,0,0,0,33
61557,19697,2010-08-09,Assembly,"AB 1689 TORRES  Concurrence in Senate Amendments",78,0,0,0,78
61558,3048,2010-04-14,Assembly,"Do pass and be re-referred to the Committee on Revenue and Taxation",8,0,1,0,9
61558,3049,2010-05-10,Assembly,"Do pass and be re-referred to the Committee on Appropriations",9,0,0,0,9
61558,3050,2010-05-19,Assembly,"Do pass",16,0,1,0,17
61558,3051,2010-05-24,Assembly,"AB 1690 CHESBRO  Third Reading Urgency",70,0,9,0,79
61558,9488,2010-06-23,Senate,"Do pass, but re-refer to the Committee on Appropriations",3,0,2,0,5
61558,10679,2010-07-15,Senate,"Placed on Appropriations Suspense file",8,0,2,0,10
61558,20286,2010-08-12,Senate,"Do pass",11,0,0,0,11
61558,20780,2010-08-19,Senate,"Assembly 3rd Reading AB1690 Chesbro Reconsider",35,0,0,0,35
61558,20934,2010-08-23,Senate,"Assembly 3rd Reading AB1690 Chesbro Urgency Clause",33,0,0,0,33
61558,21049,2010-08-24,Assembly,"AB 1690 CHESBRO  Concurrence in Senate Amendments",75,0,0,0,75
61559,4923,2010-03-16,Assembly,"Do pass as amended",7,1,0,0,8
61559,4924,2010-04-05,Assembly,"AB 1691 AMMIANO  Assembly Third Reading",48,28,3,0,79
61559,9473,2010-06-23,Senate,"Do pass as amended",5,2,2,0,9
61560,8314,2010-04-12,Assembly,"Do pass and be re-referred to the Committee on Appropriations",3,6,0,0,9
61561,4841,2010-03-23,Assembly,"Do pass and re-refer to Committee on Appropriations with recommendation:  To Consent Calendar",11,0,0,0,11
61561,4842,2010-04-14,Assembly,"Do pass, to Consent Calendar",15,0,2,0,17
61561,4843,2010-04-22,Assembly,"AB 1693 MA  Consent Calendar Second Day  Regular Session",74,0,5,0,79
61561,8864,2010-06-15,Senate,"Do pass, but re-refer to the Committee on Appropriations Recommend Consent",8,0,1,0,9
61561,19132,2010-08-02,Senate,"Consent Calendar 2nd AB1693 Ma",33,0,0,0,33
61562,8603,2010-03-23,Assembly,"Do pass as amended and be re-referred to the Committee on Governmental Organization",5,8,6,0,19
61562,8604,2010-03-23,Assembly,"Set first hearing.  Failed passage.  Reconsideration granted",19,0,0,0,19
61563,2090,2010-03-02,Assembly,"Do pass, to Consent Calendar",6,0,0,0,6
61563,2091,2010-03-15,Assembly,"AB 1695 BEALL  Consent Calendar Second Day",69,0,10,0,79
61563,8793,2010-06-15,Senate,"Do pass",7,0,0,0,7
61563,19664,2010-08-09,Senate,"Special Consent #30 AB1695 Beall By Alquist",34,0,0,0,34
61563,19863,2010-08-12,Assembly,"AB 1695 BEALL  Concurrence in Senate Amendments",78,0,0,0,78
61564,3615,2010-05-05,Assembly,"Do pass as amended",11,0,1,0,12
61564,3616,2010-05-13,Assembly,"AB 1696 BERRYHILL, B.  Assembly Third Reading",75,0,4,0,79
61564,9420,2010-06-23,Senate,"Do pass",3,0,3,0,6
61564,9884,2010-06-30,Senate,"Reconsideration granted",4,0,2,0,6
61564,9885,2010-06-30,Senate,"Do pass",4,0,2,0,6
61564,19807,2010-08-11,Senate,"Assembly 3rd Reading AB1696 Bill Berryhill By DeSaulnier",27,3,0,0,30
61565,1118,2010-04-20,Assembly,"Do pass and be re-referred to the Committee on Appropriations.",8,0,2,0,10
61565,1119,2010-05-28,Assembly,"Do pass as amended.",12,5,0,0,17
61565,1120,2010-06-02,Assembly,"AB 1697 HALL  Assembly Third Reading",56,18,5,0,79
61567,2855,2010-04-07,Assembly,"Do pass and be re-referred to the Committee on Appropriations",4,1,1,0,6
61567,2856,2010-05-28,Assembly,"Do pass",12,5,0,0,17
61567,2857,2010-06-03,Assembly,"AB 1699 HERNANDEZ  Third Reading Urgency",54,19,6,0,79
61567,9478,2010-06-23,Senate,"Do pass, but re-refer to the Committee on Appropriations",4,1,1,0,6
61567,10666,2010-07-15,Senate,"Do pass",6,1,3,0,10
61567,20180,2010-08-12,Senate,"Assembly 3rd Reading AB1699 Hernandez Lay on Table",19,13,0,0,32
61567,21975,2010-08-31,Senate,"W/O REF. TO FILE AB1699 Hernandez Urgency Clause",23,10,0,0,33
61569,5130,2010-03-23,Assembly,"Do pass",14,4,1,0,19
61569,5131,2010-04-05,Assembly,"AB 1701 CHESBRO  Assembly Third Reading",49,27,3,0,79
61569,9348,2010-06-23,Senate,"Do pass as amended",6,1,2,0,9
61569,21209,2010-08-25,Senate,"Assembly 3rd Reading AB1701 Chesbro By Alquist",22,13,0,0,35
61569,21412,2010-08-26,Assembly,"AB 1701 CHESBRO  Concurrence in Senate Amendments",52,23,0,0,75
61570,3202,2010-04-08,Assembly,"Be referred to Committee on Higher Education",11,0,0,0,11
61570,3203,2010-04-20,Assembly,"Do pass and be re-referred to the Committee on Appropriations",8,0,1,0,9
61570,3204,2010-05-28,Assembly,"Do pass as amended",17,0,0,0,17
61570,3205,2010-06-02,Assembly,"AB 1702 SWANSON  Assembly Third Reading",75,0,4,0,79
61570,10302,2010-06-30,Senate,"Do pass, but re-refer to the Committee on Appropriations",8,0,1,0,9
61570,19240,2010-08-02,Senate,"Placed on Appropriations Suspense file",10,0,0,0,10
61571,4316,2010-03-16,Assembly,"Do pass as amended and be re-referred to the Committee on Appropriations",8,0,0,0,8
61571,4317,2010-04-14,Assembly,"Do pass, to Consent Calendar",15,0,2,0,17
61571,4318,2010-04-22,Assembly,"AB 1703 KNIGHT  Consent Calendar Second Day  Regular Session",74,0,5,0,79
61571,8799,2010-06-16,Senate,"Do pass as amended, and re-refer to the Committee on Appropriations",6,0,3,0,9
61571,10713,2010-07-15,Senate,"Placed on Appropriations Suspense file",8,0,2,0,10
61572,7980,2010-03-22,Assembly,"Do pass and be re-referred to the Committee on Appropriations",3,6,0,0,9
61572,7981,2010-03-22,Assembly,"Set first hearing.  Failed passage.  Reconsideration granted",9,0,0,0,9
61572,7982,2010-04-19,Assembly,"Do pass and be re-referred to the Committee on Appropriations",3,6,0,0,9
61574,1152,2010-03-16,Assembly,"Do pass.",4,2,0,0,6
61574,1153,2010-04-22,Assembly,"AB 1706 AMMIANO  Assembly Third Reading",38,30,11,0,79
61574,1154,2010-06-01,Assembly,"AB 1706 AMMIANO  Motion to Reconsider",46,26,7,0,79
61574,1155,2010-06-01,Assembly,"AB 1706 AMMIANO  Assembly Third Reading",44,28,7,0,79
61574,10039,2010-06-29,Senate,"Do pass",5,1,1,0,7
61576,3817,2010-04-07,Assembly,"Do pass, to Consent Calendar",12,0,0,0,12
61576,3818,2010-04-15,Assembly,"AB 1708 VILLINES  Consent Calendar Second Day",70,0,9,0,79
61576,9003,2010-06-16,Senate,"Do pass and be placed on the Consent Calendar",9,0,2,0,11
61576,20660,2010-08-18,Senate,"Assembly 3rd Reading AB1708 Villines By Cogdill",34,0,0,0,34
61576,20661,2010-08-19,Assembly,"AB 1708 VILLINES  Concurrence in Senate Amendments",77,0,0,0,77
61577,1809,2010-04-14,Assembly,"Do pass as amended and be re-referred to the Committee on Appropriations",8,0,0,0,8
61577,1810,2010-05-12,Assembly,"Do pass, to Consent Calendar",16,0,1,0,17
61577,1811,2010-05-20,Assembly,"AB 1709 CONWAY  Consent Calendar Second Day  Regular Session",72,0,7,0,79
61577,8785,2010-06-15,Senate,"Do pass, but re-refer to the Committee on Appropriations Recommend Consent",5,0,0,0,5
61577,20670,2010-08-20,Senate,"Assembly 3rd Reading AB1709 Conway By Emmerson",32,0,0,0,32
61577,20949,2010-08-23,Assembly,"AB 1709 CONWAY  Concurrence in Senate Amendments",76,0,0,0,76
61580,4456,2010-04-21,Assembly,"Do pass and be re-referred to the Committee on Appropriations",5,1,0,0,6
61580,4457,2010-05-05,Assembly,"Do pass",12,5,0,0,17
61580,4458,2010-05-13,Assembly,"AB 1712 FURUTANI  Assembly Third Reading",49,24,6,0,79
61580,9404,2010-06-23,Senate,"Do pass as amended, and re-refer to the Committee on Appropriations",5,2,2,0,9
61580,19947,2010-08-12,Senate,"Assembly 3rd Reading AB1712 Furutani By Negrete McLeod",22,12,0,0,34
61580,20364,2010-08-17,Assembly,"AB 1712 FURUTANI  Concurrence in Senate Amendments",51,26,0,0,77
61581,4870,2010-03-16,Assembly,"Do pass as amended and be re-referred to the Committee on Appropriations",8,0,0,0,8
61581,4871,2010-04-14,Assembly,"Do pass, to Consent Calendar",15,0,2,0,17
61581,4872,2010-04-22,Assembly,"AB 1713 FURUTANI  Consent Calendar Second Day  Regular Session",74,0,5,0,79
61581,8872,2010-06-16,Senate,"Do pass as amended, but re-refer to the Committee on Appropriations Recommend Consent",6,0,3,0,9
61581,19406,2010-08-05,Senate,"Consent Calendar 2nd AB1713 Furutani",33,0,0,0,33
61581,20196,2010-08-12,Assembly,"AB 1713 FURUTANI  Concurrence in Senate Amendments",78,0,0,0,78
61582,2088,2010-05-28,Assembly,"Do pass",17,0,0,0,17
61582,2089,2010-06-01,Assembly,"AB 1714 FUENTES  Third Reading Urgency",76,1,2,0,79
61582,9609,2010-06-28,Senate,"Do pass as amended",8,1,2,0,11
61582,10086,2010-07-01,Senate,"Assembly 2nd Reading AB1714 Fuentes Urgency Clause",30,1,8,0,39
61582,10087,2010-07-01,Assembly,"AB 1714 FUENTES  Concurrence in Senate Amendments",74,2,3,0,79
61583,805,2010-05-19,Assembly,"Do pass.",16,0,1,0,17
61583,806,2010-05-24,Assembly,"AB 1715 FUENTES  Third Reading Urgency",70,0,9,0,79
61583,9866,2010-06-28,Senate,"Do pass as amended",9,1,1,0,11
61583,20766,2010-08-18,Senate,"Assembly 3rd Reading AB1715 Fuentes Urgency Clause",27,5,0,0,32
61583,20767,2010-08-20,Assembly,"AB 1715 FUENTES  Concurrence in Senate Amendments",74,0,0,0,74
61584,3639,2010-05-05,Assembly,"Do pass",8,1,0,0,9
61584,3640,2010-05-13,Assembly,"AB 1716 TORLAKSON  Assembly Third Reading",74,1,4,0,79
61585,5155,2010-04-06,Assembly,"Do pass, to Consent Calendar",7,0,0,0,7
61585,5156,2010-04-12,Assembly,"AB 1717 DE LEON  Consent Calendar Second Day  Regular Session",71,0,8,0,79
61585,8905,2010-06-15,Senate,"Do pass and be placed on the Consent Calendar",5,0,0,0,5
61585,9539,2010-06-24,Senate,"Consent Calendar 2nd AB1717 De Leon",31,0,8,0,39
61585,9593,2010-06-28,Assembly,"AB 1717 DE LEON  Concurrence in Senate Amendments",76,0,3,0,79
61586,2376,2010-04-20,Assembly,"Do pass as amended and be re-referred to the Committee on Appropriations",7,1,2,0,10
61586,2377,2010-05-28,Assembly,"Do pass as amended",17,0,0,0,17
61586,2378,2010-06-02,Assembly,"AB 1718 BLUMENFIELD  Assembly Third Reading",76,0,3,0,79
61586,9531,2010-06-23,Senate,"Do pass, but re-refer to the Committee on Banking, Finance and Insurance",3,0,2,0,5
61586,9825,2010-06-30,Senate,"Do pass as amended, and re-refer to the Committee on Appropriations",10,0,1,0,11
61586,21186,2010-08-25,Senate,"Be re-referred to the Committee on Banking, Finance and Insurance 	pursuant to Senate Rule 29.10",3,2,0,0,5
61586,21389,2010-08-26,Senate,"From Committee:  Amendments returned to Senate floor for 	consideration",6,2,0,0,8
61586,21803,2010-08-31,Senate,"W/O REF. TO FILE AB1718 Blumenfield By Lowenthal",21,13,0,0,34
61586,21804,2010-08-31,Assembly,"AB 1718 Blumenfield  Concurrence in Senate Amendments",51,25,0,0,76
61588,3027,2010-04-05,Assembly,"Do pass and be re-referred to the Committee on Judiciary",11,0,1,0,12
61588,3028,2010-04-13,Assembly,"Do pass and be re-referred to the Committee on Appropriations",10,0,0,0,10
61588,3029,2010-04-21,Assembly,"Do pass, to Consent Calendar",17,0,0,0,17
61588,3030,2010-04-29,Assembly,"AB 1720 GALGIANI  Consent Calendar Second Day  Regular Session",74,0,5,0,79
61588,8835,2010-06-16,Senate,"Do pass as amended, and re-refer to the Committee on Judiciary",4,1,6,0,11
61589,7790,2010-04-06,Assembly,"Do pass and be re-referred to the Committee on Agriculture",5,2,2,0,9
61590,8540,2010-04-13,Assembly,"Do pass and be re-referred to the Committee on Judiciary",11,0,0,0,11
61590,8541,2010-04-20,Assembly,"Do pass and re-refer to Committee on Appropriations with recommendation:  To Consent Calendar",10,0,0,0,10
61591,5304,2010-04-13,Assembly,"Do pass",10,0,0,0,10
61591,5305,2010-04-22,Assembly,"AB 1723 LIEU  Assembly Third Reading",73,0,6,0,79
61591,9949,2010-06-29,Senate,"Do pass as amended",6,1,0,0,7
61591,19770,2010-08-11,Senate,"Assembly 3rd Reading AB1723 Lieu By Emmerson",31,0,0,0,31
61591,20327,2010-08-16,Assembly,"AB 1723 LIEU  Concurrence in Senate Amendments",74,0,0,0,74
61592,4075,2010-04-21,Assembly,"Do pass and re-refer to Committee on Appropriations with recommendation:  To Consent Calendar",9,0,0,0,9
61592,4076,2010-05-05,Assembly,"Do pass",17,0,0,0,17
61592,4077,2010-05-13,Assembly,"AB 1724 CHESBRO  Third Reading Urgency",75,0,4,0,79
61592,9017,2010-06-16,Senate,"Do pass, but re-refer to the Committee on Appropriations",6,0,3,0,9
61592,9644,2010-06-28,Senate,"Placed on Appropriations Suspense file",10,0,1,0,11
61593,3414,2010-04-08,Assembly,"Be referred to Committee on Public Safety",11,0,0,0,11
61594,3831,2010-05-05,Assembly,"Do pass",9,0,0,0,9
61594,3832,2010-05-10,Assembly,"AB 1726 SWANSON  Assembly Third Reading",62,3,14,0,79
61594,10178,2010-06-29,Senate,"Do pass",5,0,4,0,9
61594,19809,2010-08-11,Senate,"Assembly 3rd Reading AB1726 Swanson By Ashburn",28,2,0,0,30
61594,20311,2010-08-16,Assembly,"AB 1726 SWANSON  Concurrence in Senate Amendments",71,1,0,0,72
61596,3421,2010-04-27,Assembly,"Do pass",2,5,2,0,9
61596,3422,2010-04-27,Assembly,"Set first hearing.  Failed passage.  Reconsideration granted",9,0,0,0,9
61597,1738,2010-04-07,Assembly,"Do pass and be re-referred to the Committee on Veterans Affairs to Consent Calendar",5,0,1,0,6
61597,1739,2010-04-13,Assembly,"Do pass and be re-referred to the Committee on Appropriations",9,0,0,0,9
61597,1740,2010-04-28,Assembly,"Do pass, to Consent Calendar",15,0,2,0,17
61597,1741,2010-05-06,Assembly,"AB 1729 YAMADA  Consent Calendar Second Day  Regular Session",74,0,5,0,79
61597,8688,2010-06-14,Senate,"Do pass, but re-refer to the Committee on Veterans Affairs",6,0,0,0,6
61597,9360,2010-06-22,Senate,"Do pass, but re-refer to the Committee on Appropriations",4,0,1,0,5
61597,19611,2010-08-09,Senate,"Special Consent #30 AB1729 Yamada",34,0,0,0,34
61597,19944,2010-08-12,Assembly,"AB 1729 YAMADA  Concurrence in Senate Amendments",77,0,0,0,77
61598,4793,2010-03-23,Assembly,"Do pass, to Consent Calendar",10,0,0,0,10
61598,4794,2010-04-05,Assembly,"AB 1730 EMMERSON  Consent Calendar Second Day  Regular Session",76,0,3,0,79
61598,8862,2010-06-15,Senate,"Do pass",5,0,0,0,5
61598,9646,2010-06-28,Senate,"Special Consent #28 AB1730 Emmerson",32,0,7,0,39
61599,3561,2010-05-04,Assembly,"Do pass as amended",10,0,0,0,10
61599,3562,2010-05-13,Assembly,"AB 1731 TRAN  Assembly Third Reading",72,1,6,0,79
61599,10311,2010-06-29,Senate,"Do pass as amended",1,3,1,0,5
61600,2298,2010-04-07,Assembly,"Do pass and be re-referred to the Committee on Appropriations to Consent Calendar",9,0,0,0,9
61600,2299,2010-04-28,Assembly,"Do pass, to Consent Calendar",15,0,2,0,17
61600,2300,2010-05-06,Assembly,"AB 1732 HALL  Consent Calendar Second Day  Regular Session",74,0,5,0,79
61600,9991,2010-06-29,Senate,"Do pass, but re-refer to the Committee on Appropriations Recommend Consent",9,0,0,0,9
61600,19658,2010-08-09,Senate,"Consent Calendar 2nd AB1732 Hall",34,0,0,0,34
61601,5489,2010-03-23,Assembly,"Do pass and be re-referred to the Committee on Business and Professions",18,0,1,0,19
61601,5490,2010-04-13,Assembly,"Do pass and re-refer to Committee on Appropriations with recommendation:  To Consent Calendar",11,0,0,0,11
61604,2593,2010-03-23,Assembly,"Do pass and re-refer to Committee on Appropriations with recommendation:  To Consent Calendar",11,0,0,0,11
61604,2594,2010-04-14,Assembly,"Do pass, to Consent Calendar",15,0,2,0,17
61604,2595,2010-05-06,Assembly,"AB 1736 MA  Assembly Third Reading",69,3,7,0,79
61604,8693,2010-06-14,Senate,"Do pass, but re-refer to the Committee on Appropriations",6,1,2,0,9
61604,20916,2010-08-23,Senate,"Assembly 3rd Reading AB1736 Ma By Padilla",35,0,0,0,35
61604,21178,2010-08-25,Assembly,"AB 1736 MA  Concurrence in Senate Amendments",74,4,0,0,78
61605,964,2010-03-23,Assembly,"Do pass and be re-referred to the Committee on Appropriations.",7,3,1,0,11
61606,865,2010-03-16,Assembly,"Do pass as amended and re-refer to Committee on Appropriations with recommendation:  To Consent Calendar.",9,0,0,0,9
61606,866,2010-04-14,Assembly,"Do pass, to Consent Calendar.",15,0,2,0,17
61606,867,2010-04-22,Assembly,"AB 1738 TRAN  Consent Calendar Second Day  Regular Session",74,0,5,0,79
61606,8720,2010-06-15,Senate,"Do pass, but re-refer to the Committee on Appropriations",7,0,0,0,7
61606,9600,2010-06-28,Senate,"Do pass",10,0,1,0,11
61606,19771,2010-08-11,Senate,"Assembly 3rd Reading AB1738 Tran By Harman",33,0,0,0,33
61606,20290,2010-08-16,Assembly,"AB 1738 TRAN  Concurrence in Senate Amendments",75,0,0,0,75
61608,8503,2008-12-08,Assembly,"AB2 EVANS  Assembly Third Reading  First Extraordinary Session",74,1,5,0,80
61608,8504,2008-12-18,Assembly,"AB2 EVANS  Concurrence in Senate Amendments Appeal the Decision  of the Chair  By DE VORE  First Extraordinary Session",28,48,4,0,80
61608,8505,2008-12-18,Assembly,"AB2 EVANS  Concurrence in Senate Amendments  First Extraordinary Session",47,27,6,0,80
61608,8506,2008-12-18,Senate,"Assembly 3rd Reading AB2 Evans Ducheny",23,15,1,0,39
61609,8513,2008-12-08,Assembly,"AB3 EVANS  Assembly Third Reading  First Extraordinary Session",74,1,5,0,80
61609,8514,2008-12-18,Senate,"Assembly 3rd Reading AB3 Evans Ducheny",36,1,2,0,39
61609,8515,2008-12-18,Assembly,"AB3 EVANS  Concurrence in Senate Amendments  First Extraordinary Session",60,12,8,0,80
61610,8525,2008-12-08,Assembly,"AB4 EVANS  Assembly Third Reading  First Extraordinary Session",74,1,5,0,80
61610,8526,2008-12-18,Assembly,"AB4 EVANS  Concurrence in Senate Amendments  First Extraordinary Session",48,24,8,0,80
61610,8527,2008-12-18,Senate,"Assembly 3rd Reading AB4 Evans",29,8,2,0,39
61611,8507,2008-12-08,Assembly,"AB5 EVANS  Assembly Third Reading  First Extraordinary Session",74,1,5,0,80
61611,8508,2008-12-18,Senate,"Assembly 3rd Reading AB5 Evans Ducheny",27,10,2,0,39
61611,8509,2008-12-18,Assembly,"AB5 EVANS  Concurrence in Senate Amendments  First Extraordinary Session",59,13,8,0,80
61612,8510,2008-12-08,Assembly,"AB6 EVANS  Assembly Third Reading  First Extraordinary Session",74,1,5,0,80
61612,8511,2008-12-18,Assembly,"AB6 EVANS  Concurrence in Senate Amendments  First Extraordinary Session",48,26,6,0,80
61612,8512,2008-12-18,Senate,"Assembly 3rd Reading AB6 Evans",30,8,1,0,39
61613,8528,2008-12-08,Assembly,"AB7 EVANS  Assembly Third Reading  First Extraordinary Session",74,1,5,0,80
61613,8529,2008-12-18,Senate,"Assembly 3rd Reading AB7 Evans Amend By Ducheny",33,0,6,0,39
61613,8530,2008-12-18,Senate,"Assembly 3rd Reading AB7 Evans Suspend Senate Rules",30,6,3,0,39
61613,8531,2008-12-18,Senate,"Assembly 3rd Reading AB7 Evans Urgency Clause",37,0,2,0,39
61613,8532,2008-12-18,Assembly,"AB7 EVANS  Concurrence- Urgency Added  First Extraordinary Session",57,17,6,0,80
61614,8520,2008-12-08,Assembly,"AB8 EVANS  Assembly Third Reading  First Extraordinary Session",74,1,5,0,80
61614,8521,2008-12-18,Senate,"Assembly 3rd Reading AB8 Budget Committee Ducheny",23,15,1,0,39
61614,8522,2008-12-18,Assembly,"AB8 BUDGET  Concurrence in Senate Amendments By EVANS  First Extraordinary Session",47,27,6,0,80
61615,8519,2008-12-08,Assembly,"AB9 EVANS  Assembly Third Reading  First Extraordinary Session",74,1,5,0,80
61616,8516,2008-12-08,Assembly,"AB 10 EVANS  Assembly Third Reading  First Extraordinary Session",74,1,5,0,80
61616,8517,2008-12-18,Senate,"Assembly 3rd Reading AB10 Evans Urgency Clause",33,4,2,0,39
61616,8518,2008-12-18,Assembly,"AB 10 BUDGET  Concurrence- Urgency Added  By EVANS  First Extraordinary Session",66,7,7,0,80
61617,8538,2008-12-08,Assembly,"AB 11 EVANS  Assembly Third Reading  First Extraordinary Session",74,1,5,0,80
61618,8534,2008-12-08,Assembly,"AB 12 EVANS  Assembly Third Reading  First Extraordinary Session",74,1,5,0,80
61618,8535,2008-12-18,Senate,"Assembly 3rd Reading AB12 Evans Ducheny",23,14,2,0,39
61618,8536,2008-12-18,Assembly,"AB 12 EVANS  Concurrence in Senate Amendments  First Extraordinary Session",47,28,5,0,80
61619,8537,2008-12-08,Assembly,"AB 13 EVANS  Assembly Third Reading  First Extraordinary Session",74,1,5,0,80
61623,8533,2009-02-14,Assembly,"AB3 GALGIANI  Assembly Third Reading  Second Extraordinary Session",62,10,8,0,80
61624,8539,2009-02-14,Assembly,"AB4 NIELLO  Assembly Third Reading  Second Extraordinary Session",43,29,8,0,80
61625,22480,2009-02-14,Assembly,"AB5 GAINES  Assembly Third Reading  Second Extraordinary Session",46,29,0,0,75
61625,22481,2009-02-15,Senate,"W/O REF. TO FILE AB5 Gaines",29,6,0,0,35
61625,22482,2009-02-19,Senate,"Assembly 3rd Supp 1 AB5 Gaines Benoit",33,2,0,0,35
61627,23251,2009-02-14,Assembly,"AB7 LIEU  Assembly Third Reading  Second Extraordinary Session",48,27,0,0,75
61627,23252,2009-02-15,Senate,"W/O REF. TO FILE AB7 Lieu",23,15,0,0,38
61627,23253,2009-02-19,Senate,"Assembly 3rd Supp 1 AB7 Lieu By Corbett",23,15,0,0,38
61628,22488,2009-02-14,Assembly,"AB8 NESTANDE  Assembly Third Reading  Second Extraordinary Session",48,28,0,0,76
61628,22489,2009-02-15,Senate,"W/O REF. TO FILE AB8 Evans",24,11,0,0,35
61628,22490,2009-02-19,Senate,"Assembly 3rd Supp 1 AB8 Nestande By Cogdill",26,10,0,0,36
61629,8547,2009-01-12,Assembly,"AB1 EVANS  Assembly Third Reading  Third Extraordinary Session",48,0,32,0,80
61629,8548,2009-02-14,Senate,"Do pass as amended",23,13,3,0,39
61629,8549,2009-02-15,Senate,"Assembly 3rd Reading AB1 Evans",25,13,1,0,39
61630,8550,2009-01-12,Assembly,"AB2 EVANS  Assembly Third Reading  Third Extraordinary Session",48,0,32,0,80
61630,8551,2009-02-14,Senate,"Do pass as amended",23,13,3,0,39
61630,8552,2009-06-29,Senate,"Do pass",23,14,3,0,40
61630,8553,2009-06-29,Senate,"Assembly 3rd Reading AB2 Evans",22,17,1,0,40
61631,25988,2009-01-12,Assembly,"AB3 EVANS  Assembly Third Reading  Third Extraordinary Session",48,0,0,0,48
61631,25989,2009-02-14,Senate,"Do pass as amended",23,13,0,0,36
61631,25990,2009-02-19,Senate,"Assembly 3rd Reading AB3 Evans On Call",23,12,0,0,35
61631,25991,2009-02-19,Senate,"Assembly 3rd Reading AB3 Evans Reconsider",23,6,0,0,29
61631,25992,2009-02-19,Senate,"Assembly 3rd Reading AB3 Evans",27,12,0,0,39
61631,25993,2009-02-19,Assembly,"AB3 EVANS  Concurrence- Urgency Added  Third Extraordinary Session",54,26,0,0,80
61632,8543,2009-01-12,Assembly,"AB4 EVANS  Assembly Third Reading  Third Extraordinary Session",48,0,32,0,80
61632,8544,2009-02-14,Senate,"Do pass as amended",23,13,3,0,39
61632,8545,2009-06-29,Senate,"Do pass",23,14,3,0,40
61632,8546,2009-06-29,Senate,"Assembly 3rd Reading AB4 Evans",23,15,2,0,40
61633,26335,2009-01-12,Assembly,"AB5 EVANS  Assembly Third Reading  Third Extraordinary Session",48,0,0,0,48
61633,26336,2009-02-14,Senate,"Do pass as amended",23,13,0,0,36
61633,26337,2009-02-14,Senate,"Assembly 3rd Reading AB5 Evans",27,6,0,0,33
61633,26338,2009-02-14,Assembly,"AB5 EVANS  Concurrence- Urgency Added  Third Extraordinary Session",67,12,0,0,79
61634,8565,2009-01-12,Assembly,"AB6 EVANS  Assembly Third Reading  Third Extraordinary Session",48,0,32,0,80
61634,8566,2009-02-14,Senate,"Do pass as amended",23,13,3,0,39
61635,25217,2009-01-12,Assembly,"AB7 EVANS  Assembly Third Reading  Third Extraordinary Session",48,0,0,0,48
61635,25218,2009-02-14,Senate,"Do pass as amended",23,13,0,0,36
61635,25219,2009-02-15,Senate,"Assembly 3rd Reading AB7 Evans",24,14,0,0,38
61635,25220,2009-07-01,Senate,"Assembly 3rd Reading AB7 Evans Urgency Clause",35,0,0,0,35
61635,25221,2009-07-01,Assembly,"AB7 EVANS  Concurrence- Urgency Added  Third Extraordinary Session",73,0,0,0,73
61636,8562,2009-01-12,Assembly,"AB8 EVANS  Assembly Third Reading  Third Extraordinary Session",48,0,32,0,80
61636,8563,2009-02-15,Senate,"Do pass as amended",22,13,4,0,39
61636,8564,2009-02-15,Senate,"Assembly 3rd Reading AB8 Evans",19,13,7,0,39
61637,8559,2009-01-12,Assembly,"AB9 EVANS  Assembly Third Reading  Third Extraordinary Session",48,0,32,0,80
61637,8560,2009-02-14,Senate,"Do pass as amended",24,11,4,0,39
61637,8561,2009-02-14,Senate,"Assembly 3rd Reading AB9 Evans",38,0,1,0,39
61638,8555,2009-01-12,Assembly,"AB 10 EVANS  Assembly Third Reading  Third Extraordinary Session",48,0,32,0,80
61638,8556,2009-02-14,Senate,"Do pass as amended",23,13,3,0,39
61638,8557,2009-06-30,Senate,"Assembly 3rd Reading AB10 Evans By Ducheny",22,15,3,0,40
61638,8558,2009-07-01,Assembly,"AB 10 EVANS  Concurrence in Senate Amendments  Third Extraordinary Session",46,28,5,0,79
61639,22814,2009-01-12,Assembly,"AB 11 EVANS  Assembly Third Reading  Third Extraordinary Session",48,0,0,0,48
61639,22815,2009-02-14,Senate,"Do pass as amended",23,13,0,0,36
61639,22816,2009-02-14,Senate,"Assembly 3rd Reading AB11 Evans",36,1,0,0,37
61639,22817,2009-02-14,Assembly,"AB 11 EVANS  Concurrence- Urgency Added  Third Extraordinary Session",75,5,0,0,80
61640,25543,2009-01-12,Assembly,"AB 12 EVANS  Assembly Third Reading  Third Extraordinary Session",48,0,0,0,48
61640,25544,2009-02-14,Senate,"Do pass as amended",23,13,0,0,36
61640,25545,2009-02-14,Senate,"Assembly 3rd Reading AB12 Evans",30,8,0,0,38
61640,25546,2009-02-14,Assembly,"AB 12 EVANS  Concurrence- Urgency Added  Third Extraordinary Session",70,8,0,0,78
61641,22476,2009-01-12,Assembly,"AB 13 EVANS  Assembly Third Reading  Third Extraordinary Session",48,0,0,0,48
61641,22477,2009-02-14,Senate,"Do pass as amended",23,13,0,0,36
61641,22478,2009-02-14,Senate,"Assembly 3rd Reading AB13 Evans",36,3,0,0,39
61641,22479,2009-02-14,Assembly,"AB 13 EVANS  Concurrence- Urgency Added  Third Extraordinary Session",71,8,0,0,79
61642,8572,2009-01-12,Assembly,"AB 14 EVANS  Assembly Third Reading  Third Extraordinary Session",48,0,32,0,80
61642,8573,2009-02-14,Senate,"Do pass as amended",23,13,3,0,39
61642,8574,2009-08-20,Senate,"Do pass",22,16,2,0,40
61642,8575,2009-08-20,Senate,"Assembly 3rd Reading AB14 Arambula By Ducheny",21,19,0,0,40
61642,8576,2009-08-20,Senate,"Assembly 3rd Reading AB14 Evans Lay on Table",24,15,1,0,40
61642,8577,2009-08-20,Senate,"Assembly 3rd Reading AB14 Evans Set 1 Lay on Table",24,15,1,0,40
61642,8578,2009-08-20,Senate,"Assembly 3rd Reading AB14 Evans Set 2 Lay on Table",24,15,1,0,40
61642,8579,2009-08-20,Senate,"Assembly 3rd Reading AB14 Evans Set 4 Lay on Table",23,15,2,0,40
61642,8580,2009-08-20,Senate,"Assembly 3rd Reading AB14 Evans Set 5 Lay on Table",24,15,1,0,40
61642,8581,2009-08-20,Senate,"Assembly 3rd Reading AB14 Evans Set 6 Lay on Table",23,15,2,0,40
61642,8582,2009-08-20,Senate,"Assembly 3rd Reading AB14 Evans Set 7 Lay on Table",23,15,2,0,40
61642,8583,2009-08-20,Senate,"Assembly 3rd Reading AB14 Evans Lay on Table",15,24,1,0,40
61643,22805,2009-01-12,Assembly,"AB 15 EVANS  Assembly Third Reading  Third Extraordinary Session",48,0,0,0,48
61643,22806,2009-02-14,Senate,"Do pass as amended",23,13,0,0,36
61643,22807,2009-02-14,Senate,"Assembly 3rd Reading AB15 Evans",26,7,0,0,33
61643,22808,2009-02-14,Assembly,"AB 15 KREKORIAN  Concurrence in Senate Amendments  Third 	Extraordinary Session",63,8,0,0,71
61644,25873,2009-01-12,Assembly,"AB 16 EVANS  Assembly Third Reading  Third Extraordinary Session",48,0,0,0,48
61644,25874,2009-02-19,Senate,"Assembly 3rd Reading AB16 Evans",27,11,0,0,38
61644,25875,2009-02-19,Assembly,"AB 16 EVANS  Concurrence- Urgency Added  Third Extraordinary Session",63,11,0,0,74
61645,25985,2009-01-12,Assembly,"AB 17 EVANS  Assembly Third Reading  Third Extraordinary Session",48,0,0,0,48
61645,25986,2009-02-19,Senate,"Assembly 3rd Reading AB17 Evans",37,0,0,0,37
61645,25987,2009-02-19,Assembly,"AB 17 EVANS  Concurrence- Urgency Added  Third Extraordinary Session",75,3,0,0,78
61646,27100,2009-01-12,Assembly,"AB 18 EVANS  Assembly Third Reading  Third Extraordinary Session",48,0,0,0,48
61646,27101,2009-02-26,Senate,"Assembly 3rd Reading AB18 Evans By Ducheny",34,0,0,0,34
61646,27102,2009-02-26,Assembly,"AB 18 EVANS  Concurrence- Urgency Added  Third Extraordinary Session",71,0,0,0,71
61647,8569,2009-01-12,Assembly,"AB 19 EVANS  Assembly Third Reading  Third Extraordinary Session",48,0,32,0,80
61647,8570,2009-06-30,Senate,"Assembly 3rd Reading AB19 Evans By Ducheny",24,14,2,0,40
61647,8571,2009-07-01,Assembly,"AB 19 EVANS  Concurrence in Senate Amendments  Third Extraordinary Session",44,30,5,0,79
61648,23930,2009-01-12,Assembly,"AB 20 EVANS  Assembly Third Reading  Third Extraordinary Session",48,0,0,0,48
61648,23931,2009-03-23,Senate,"Assembly 3rd Reading AB20 Bass Urgency Clause",36,0,0,0,36
61648,23932,2009-03-26,Assembly,"AB 20 BASS  Concurrence in Senate Amendments  Third Extraordinary 	Session",72,0,0,0,72
61651,26674,2009-03-04,Assembly,"Do pass as amended and be re-referred to the Committee on 	Appropriations",8,2,0,0,10
61651,26675,2009-03-11,Assembly,"Do pass",11,4,0,0,15
61651,26676,2009-03-16,Assembly,"AB 23 COTO  Third Reading Urgency  Amend By BLAKESLEE  Set #1  Lay 	on the Table  Third Extraordinary Session",49,23,0,0,72
61651,26677,2009-03-16,Assembly,"AB 23 COTO  Third Reading Urgency  Third Extraordinary Session",52,10,0,0,62
61651,26678,2009-03-16,Assembly,"AB 23 COTO  Third Reading Urgency  Amend By COTO  Set #1  Third 	Extraordinary Session",54,12,0,0,66
61651,26679,2009-03-16,Assembly,"AB 23 COTO  Third Reading Urgency  Third Extraordinary Session",53,9,0,0,62
61651,26680,2009-03-23,Assembly,"AB 23 COTO  Third Reading Urgency  Third Extraordinary Session",77,0,0,0,77
61651,26681,2009-03-25,Senate,"Do pass",5,0,0,0,5
61651,26682,2009-03-26,Senate,"Do pass",12,0,0,0,12
61651,26683,2009-03-26,Senate,"W/O REF. TO FILE AB23 Coto (Desaulnier) Lay on Table",22,15,0,0,37
61651,26684,2009-03-26,Senate,"W/O REF. TO FILE AB23 Coto Urgency Clause",38,0,0,0,38
61657,22910,2009-03-23,Assembly,"Do pass",10,0,0,0,10
61657,22911,2009-03-23,Assembly,"AB 29 COTO  Assembly Third Reading  Third Extraordinary Session",78,0,0,0,78
61657,22912,2009-03-25,Senate,"Do pass as amended, and re-refer to the Committee on 	Appropriations",4,0,0,0,4
61657,22913,2009-03-26,Senate,"Do pass",8,4,0,0,12
61657,22914,2009-03-26,Senate,"W/O REF. TO FILE AB29 Coto By Ducheny",31,7,0,0,38
61657,22915,2009-03-26,Assembly,"AB 29 COTO  Concurrence in Senate Amendments  Third Extraordinary 	Session",60,6,0,0,66
61661,8594,2009-08-31,Assembly,"Do pass and be re-referred to the Committee on Natural Resources",8,1,6,0,15
61661,8595,2009-09-03,Assembly,"Do pass and be re-referred to the Committee on Appropriations",6,0,3,0,9
61661,8596,2009-09-10,Assembly,"Do pass as amended",15,1,0,0,16
61661,8597,2009-09-11,Assembly,"AB 33 VILLINES  Assembly Third Reading  Third Extraordinary Session",58,12,9,0,79
61663,8586,2009-06-17,Assembly,"Do pass as amended and be re-referred to the Committee on Appropriations",9,0,2,0,11
61663,8587,2009-06-25,Assembly,"Do pass",16,0,0,0,16
61663,8588,2009-06-25,Assembly,"AB 35 HAGMAN  Third Reading Urgency  Third Extraordinary Session",77,0,2,0,79
61663,8589,2009-06-29,Senate,"Do pass, but re-refer to the Committee on Appropriations",7,0,2,0,9
61663,8590,2009-07-13,Senate,"Placed on Appropriations Suspense file",7,5,1,0,13
61665,23684,2009-06-28,Assembly,"AB 37 EVANS  Assembly Third Reading  Amend By EVANS  Set #1  Third 	Extraordinary Session",47,28,0,0,75
61665,23685,2009-06-28,Assembly,"AB 37 EVANS  Assembly Third Reading  Third Extraordinary Session",47,28,0,0,75
61665,23686,2009-09-11,Senate,"Assembly 3rd Reading AB37 Evans By Ducheny",26,2,0,0,28
61665,23687,2009-09-12,Assembly,"AB 37 EVANS  Concurrence in Senate Amendments  Third Extraordinary 	Session",53,19,0,0,72
61667,8605,2009-06-28,Assembly,"AB 39 EVANS  Assembly Third Reading  Amend By EVANS  Set #1  Third Extraordinary Session",47,28,4,0,79
61667,8606,2009-06-28,Assembly,"AB 39 EVANS  Assembly Third Reading  Third Extraordinary Session",44,31,4,0,79
61668,8601,2009-06-28,Assembly,"AB 40 EVANS  Assembly Third Reading  Amend By EVANS  Set #1  Third Extraordinary Session",47,28,4,0,79
61668,8602,2009-06-28,Assembly,"AB 40 EVANS  Assembly Third Reading  Third Extraordinary Session",45,31,3,0,79
61669,8598,2009-06-28,Assembly,"AB 41 EVANS  Assembly Third Reading  Amend By EVANS  Set #1  Third Extraordinary Session",47,28,4,0,79
61669,8599,2009-06-28,Assembly,"AB 41 EVANS  Assembly Third Reading  Third Extraordinary Session",46,30,3,0,79
61669,8600,2009-06-30,Senate,"Assembly 3rd Reading AB41 Evans By Ducheny",24,14,2,0,40
61670,8611,2009-06-28,Assembly,"AB 42 EVANS  Assembly Third Reading  Amend By EVANS  Set #1  Third Extraordinary Session",47,28,4,0,79
61670,8612,2009-06-28,Assembly,"AB 42 EVANS  Assembly Third Reading  Third Extraordinary Session",42,30,7,0,79
61670,8613,2009-06-30,Senate,"Assembly 3rd Reading AB42 Evans By Ducheny",21,15,4,0,40
61671,8608,2009-06-28,Assembly,"AB 43 EVANS  Assembly Third Reading  Amend By EVANS  Set #1  Third Extraordinary Session",47,28,4,0,79
61671,8609,2009-06-28,Assembly,"AB 43 EVANS  Assembly Third Reading  Third Extraordinary Session",47,28,4,0,79
61671,8610,2009-06-30,Senate,"Assembly 3rd Reading AB43 Evans",22,15,3,0,40
61672,8621,2009-06-28,Assembly,"AB 44 EVANS  Assembly Third Reading  Amend By EVANS  Set #1  Third Extraordinary Session",47,28,4,0,79
61672,8622,2009-06-28,Assembly,"AB 44 EVANS  Assembly Third Reading  Third Extraordinary Session",47,28,4,0,79
61672,8623,2009-06-30,Senate,"Assembly 3rd Reading AB44 Evans",22,15,3,0,40
61673,8591,2009-06-28,Assembly,"AB 45 EVANS  Assembly Third Reading  Amend By EVANS  Set #1  Third Extraordinary Session",47,28,4,0,79
61673,8592,2009-06-28,Assembly,"AB 45 EVANS  Assembly Third Reading  Third Extraordinary Session",48,28,3,0,79
61673,8593,2009-06-30,Senate,"Assembly 3rd Reading AB45 Evans By Ducheny",22,14,4,0,40
61674,8625,2009-06-28,Assembly,"AB 46 EVANS  Assembly Third Reading  Amend By EVANS  Set #1  Third Extraordinary Session",47,28,4,0,79
61674,8626,2009-06-28,Assembly,"AB 46 EVANS  Assembly Third Reading  Third Extraordinary Session",45,28,6,0,79
61674,8627,2009-06-30,Senate,"Assembly 3rd Reading AB46 Evans By Ducheny",22,14,4,0,40
61675,8614,2009-07-02,Assembly,"AB 47 EVANS  Assembly Third Reading  Third Extraordinary Session",47,2,29,0,78
61676,8629,2009-07-02,Assembly,"AB 48 EVANS  Assembly Third Reading  Third Extraordinary Session",47,2,29,0,78
61677,8615,2009-07-02,Assembly,"AB 49 EVANS  Assembly Third Reading  Third Extraordinary Session",47,2,29,0,78
61678,8616,2009-07-02,Assembly,"AB 50 EVANS  Assembly Third Reading  Third Extraordinary Session",47,2,29,0,78
61679,8632,2009-07-02,Assembly,"AB 51 EVANS  Assembly Third Reading  Third Extraordinary Session",47,2,29,0,78
61680,8633,2009-07-02,Assembly,"AB 52 EVANS  Assembly Third Reading  Third Extraordinary Session",47,2,29,0,78
61681,8624,2009-07-02,Assembly,"AB 53 EVANS  Assembly Third Reading  Third Extraordinary Session",47,2,29,0,78
61682,8639,2009-07-02,Assembly,"AB 54 EVANS  Assembly Third Reading  Third Extraordinary Session",47,2,29,0,78
61683,8634,2009-07-02,Assembly,"AB 55 EVANS  Assembly Third Reading  Third Extraordinary Session",47,2,29,0,78
61684,22899,2009-07-02,Assembly,"AB 56 EVANS  Assembly Third Reading",47,2,0,0,49
61684,22900,2009-10-14,Senate,"Assembly 3rd Reading AB56 Evans Suspend Joint Rules",38,0,0,0,38
61684,22901,2009-10-14,Senate,"Assembly 3rd Reading AB56 Evans By Ducheny",23,13,0,0,36
61684,22902,2009-10-26,Assembly,"AB 56 EVANS  Concurrence in Senate Amendments  Third Extraordinary 	Session",51,22,0,0,73
61685,8628,2009-07-09,Assembly,"AB 57 EVANS  Assembly Third Reading  Third Extraordinary Session",48,2,29,0,79
61686,8636,2009-07-09,Assembly,"AB 58 EVANS  Assembly Third Reading  Third Extraordinary Session",48,2,29,0,79
61687,8637,2009-07-09,Assembly,"AB 59 EVANS  Assembly Third Reading  Third Extraordinary Session",48,2,29,0,79
61688,8630,2009-07-09,Assembly,"AB 60 EVANS  Assembly Third Reading  Third Extraordinary Session",48,2,29,0,79
61689,8631,2009-07-09,Assembly,"AB 61 EVANS  Assembly Third Reading  Third Extraordinary Session",48,2,29,0,79
61690,8638,2009-07-09,Assembly,"AB 62 EVANS  Assembly Third Reading  Third Extraordinary Session",48,2,29,0,79
61691,8645,2009-07-09,Assembly,"AB 63 EVANS  Assembly Third Reading  Third Extraordinary Session",48,2,29,0,79
61692,8635,2009-07-09,Assembly,"AB 64 EVANS  Assembly Third Reading  Third Extraordinary Session",48,2,29,0,79
61693,8643,2009-07-09,Assembly,"AB 65 EVANS  Assembly Third Reading  Third Extraordinary Session",48,2,29,0,79
61694,8644,2009-07-09,Assembly,"AB 66 EVANS  Assembly Third Reading  Third Extraordinary Session",48,2,29,0,79
61695,8642,2009-07-09,Assembly,"AB 67 EVANS  Assembly Third Reading  Third Extraordinary Session",48,2,29,0,79
61696,8648,2009-07-09,Assembly,"AB 68 EVANS  Assembly Third Reading  Third Extraordinary Session",48,2,29,0,79
61697,8649,2009-07-09,Assembly,"AB 69 EVANS  Assembly Third Reading  Third Extraordinary Session",48,2,29,0,79
61698,8640,2009-07-09,Assembly,"AB 70 EVANS  Assembly Third Reading  Third Extraordinary Session",48,2,29,0,79
61699,8650,2009-07-09,Assembly,"AB 71 EVANS  Assembly Third Reading  Third Extraordinary Session",48,2,29,0,79
61700,8647,2009-07-09,Assembly,"AB 72 EVANS  Assembly Third Reading  Third Extraordinary Session",48,2,29,0,79
61701,8646,2009-07-09,Assembly,"AB 73 EVANS  Assembly Third Reading  Third Extraordinary Session",48,2,29,0,79
61702,8641,2009-07-09,Assembly,"AB 74 EVANS  Assembly Third Reading  Third Extraordinary Session",48,2,29,0,79
61703,8651,2009-07-09,Assembly,"AB 75 EVANS  Assembly Third Reading  Third Extraordinary Session",48,2,29,0,79
61704,8658,2009-07-09,Assembly,"AB 76 EVANS  Assembly Third Reading  Third Extraordinary Session",48,2,29,0,79
61709,26636,2009-09-09,Assembly,"Do pass and be re-referred to the Committee on Appropriations",7,0,0,0,7
61709,26637,2009-09-10,Assembly,"AB 81 HALL  Assembly Third Reading  Amend By FLETCHER  Set #1 	Motion to  Lay on the Table  By TORRICO  Third Extraordinary Session",36,25,0,0,61
61709,26638,2009-09-10,Assembly,"AB 81 HALL  Assembly Third Reading  Third Extraordinary Session",54,18,0,0,72
61709,26639,2009-10-14,Senate,"W/O REF. TO FILE AB81 Hall Suspend Joint Rules",28,7,0,0,35
61709,26640,2009-10-14,Senate,"W/O REF. TO FILE AB81 Hall Set 1",22,14,0,0,36
61709,26641,2009-10-14,Senate,"W/O REF. TO FILE AB81 Hall Lay on Table",21,13,0,0,34
61709,26642,2009-10-14,Senate,"W/O REF. TO FILE AB81 Hall Re-Refer",13,20,0,0,33
61709,26643,2009-10-14,Senate,"W/O REF. TO FILE AB81 Hall By Price",21,14,0,0,35
61714,22259,2009-07-09,Assembly,"AB1 EVANS  Assembly Third Reading  Fourth Extraordinary Session",47,2,0,0,49
61714,22260,2009-07-23,Senate,"Assembly 3rd Reading AB1 Evans Lay on Table",22,15,0,0,37
61714,22261,2009-07-23,Senate,"Assembly 3rd Reading AB1 Evans Urgency Clause",27,13,0,0,40
61714,22262,2009-07-23,Assembly,"AB1 EVANS  Concurrence- Urgency Added  Fourth Extraordinary Session",56,23,0,0,79
61715,26410,2009-07-09,Assembly,"AB2 EVANS  Assembly Third Reading  Fourth Extraordinary Session",47,2,0,0,49
61715,26411,2009-07-24,Senate,"Assembly 3rd Reading AB2 Evans Urgency Clause",29,6,0,0,35
61715,26412,2009-07-24,Assembly,"AB2 EVANS  Concurrence- Urgency Added  Fourth Extraordinary Session",55,18,0,0,73
61716,23222,2009-07-09,Assembly,"AB3 EVANS  Assembly Third Reading  Fourth Extraordinary Session",47,2,0,0,49
61716,23223,2009-07-24,Senate,"Assembly 3rd Reading AB3 Evans Urgency Clause",27,13,0,0,40
61716,23224,2009-07-24,Assembly,"AB3 EVANS  Concurrence- Urgency Added  Fourth Extraordinary Session",56,20,0,0,76
61717,22839,2009-07-09,Assembly,"AB4 EVANS  Assembly Third Reading  Fourth Extraordinary Session",47,2,0,0,49
61717,22840,2009-07-24,Senate,"Assembly 3rd Reading AB4 Evans By Ducheny",35,5,0,0,40
61717,22841,2009-07-24,Assembly,"AB4 EVANS  Concurrence- Urgency Added  Fourth Extraordinary Session",73,3,0,0,76
61718,22255,2009-07-09,Assembly,"AB5 EVANS  Assembly Third Reading  Fourth Extraordinary Session",47,2,0,0,49
61718,22256,2009-07-23,Senate,"Assembly 3rd Reading AB5 Evans Lay on Table",24,15,0,0,39
61718,22257,2009-07-23,Senate,"Assembly 3rd Reading AB5 Evans Urgency Clause",29,11,0,0,40
61718,22258,2009-07-23,Assembly,"AB5 EVANS  Concurrence- Urgency Added  Fourth Extraordinary Session",57,20,0,0,77
61719,27125,2009-07-09,Assembly,"AB6 EVANS  Assembly Third Reading  Fourth Extraordinary Session",47,2,0,0,49
61719,27126,2009-07-23,Senate,"Assembly 3rd Reading AB6 Evans",39,0,0,0,39
61719,27127,2009-07-23,Assembly,"AB6 EVANS  Concurrence- Urgency Added  Fourth Extraordinary Session",76,2,0,0,78
61720,27137,2009-07-09,Assembly,"AB7 EVANS  Assembly Third Reading  Fourth Extraordinary Session",47,2,0,0,49
61720,27138,2009-07-23,Senate,"Assembly 3rd Reading AB7 Evans By Hollingsworth",25,15,0,0,40
61720,27139,2009-07-24,Assembly,"AB7 EVANS  Concurrence in Senate Amendments  Fourth Extraordinary 	Session",46,30,0,0,76
61721,22252,2009-07-09,Assembly,"AB8 EVANS  Assembly Third Reading  Fourth Extraordinary Session",47,2,0,0,49
61721,22253,2009-07-24,Senate,"Assembly 3rd Reading AB8 Evans By Ashburn",21,18,0,0,39
61721,22254,2009-07-24,Assembly,"AB8 EVANS  Concurrence in Senate Amendments  Fourth Extraordinary 	Session",47,25,0,0,72
61722,26865,2009-07-09,Assembly,"AB9 EVANS  Assembly Third Reading  Fourth Extraordinary Session",47,2,0,0,49
61722,26866,2009-07-23,Senate,"Assembly 3rd Reading AB9 Evans Urgency Clause",28,10,0,0,38
61722,26867,2009-07-23,Assembly,"AB9 EVANS  Concurrence- Urgency Added  Fourth Extraordinary Session",62,15,0,0,77
61723,25660,2009-07-09,Assembly,"AB 10 EVANS  Assembly Third Reading  Fourth Extraordinary Session",47,2,0,0,49
61723,25661,2009-07-23,Senate,"Assembly 3rd Reading AB10 Evans Urgency Clause",27,12,0,0,39
61723,25662,2009-07-24,Assembly,"AB 10 BUDGET  Concurrence- Urgency Added  By EVANS  Fourth 	Extraordinary Session",54,25,0,0,79
61724,27122,2009-07-09,Assembly,"AB 11 EVANS  Assembly Third Reading  Fourth Extraordinary Session",47,2,0,0,49
61724,27123,2009-07-23,Senate,"Assembly 3rd Reading AB11 Evans Urgency Clause",31,7,0,0,38
61724,27124,2009-07-23,Assembly,"AB 11 EVANS  Concurrence- Urgency Added  Fourth Extraordinary 	Session",68,10,0,0,78
61725,26092,2009-07-09,Assembly,"AB 12 EVANS  Assembly Third Reading  Fourth Extraordinary Session",47,2,0,0,49
61725,26093,2009-07-23,Senate,"Assembly 3rd Reading AB12 Evans Urgency Clause",27,12,0,0,39
61725,26094,2009-07-24,Assembly,"AB 12 EVANS  Concurrence- Urgency Added  Fourth Extraordinary 	Session",54,24,0,0,78
61726,8660,2009-07-09,Assembly,"AB 13 EVANS  Assembly Third Reading  Fourth Extraordinary Session",47,2,30,0,79
61726,8661,2009-07-23,Senate,"Assembly 3rd Reading AB13 Evans Urgency Clause",30,7,3,0,40
61727,22759,2009-07-09,Assembly,"AB 14 EVANS  Assembly Third Reading  Fourth Extraordinary Session",47,2,0,0,49
61727,22760,2009-07-24,Senate,"Assembly 3rd Reading AB14 Evans Urgency Clause",27,13,0,0,40
61727,22761,2009-07-24,Assembly,"AB 14 BUDGET  Concurrence- Urgency Added  By EVANS  Fourth 	Extraordinary Session",54,25,0,0,79
61728,23922,2009-07-09,Assembly,"AB 15 EVANS  Assembly Third Reading  Fourth Extraordinary Session",47,2,0,0,49
61728,23923,2009-07-24,Senate,"Assembly 3rd Reading AB15 Evans Urgency Clause",28,9,0,0,37
61728,23924,2009-07-24,Assembly,"AB 15 GAINES  Concurrence- Urgency Added  Fourth Extraordinary 	Session",59,14,0,0,73
61729,8652,2009-07-09,Assembly,"AB 16 EVANS  Assembly Third Reading  Fourth Extraordinary Session",47,2,30,0,79
61729,8653,2009-07-23,Senate,"Assembly 3rd Reading AB16 Evans Urgency Clause",32,7,1,0,40
61730,22249,2009-07-09,Assembly,"AB 17 EVANS  Assembly Third Reading  Fourth Extraordinary Session",47,2,0,0,49
61730,22250,2009-07-23,Senate,"Assembly 3rd Reading AB17 Evans",22,16,0,0,38
61730,22251,2009-07-23,Assembly,"AB 17 BUDGET  Concurrence in Senate Amendments By EVANS  Fourth 	Extraordinary Session",46,33,0,0,79
61731,22246,2009-07-09,Assembly,"AB 18 EVANS  Assembly Third Reading  Fourth Extraordinary Session",47,2,0,0,49
61731,22247,2009-07-23,Senate,"Assembly 3rd Reading AB18 Evans",23,16,0,0,39
61731,22248,2009-07-23,Assembly,"AB 18 BUDGET  Concurrence in Senate Amendments By EVANS  Fourth 	Extraordinary Session",47,32,0,0,79
61732,22243,2009-07-09,Assembly,"AB 19 EVANS  Assembly Third Reading  Fourth Extraordinary Session",47,2,0,0,49
61732,22244,2009-07-24,Senate,"Assembly 3rd Reading AB19 Evans By Walters",25,15,0,0,40
61732,22245,2009-07-24,Assembly,"AB 19 EVANS  Concurrence in Senate Amendments  Fourth Extraordinary 	Session",42,33,0,0,75
61733,25829,2009-07-09,Assembly,"AB 20 EVANS  Assembly Third Reading  Fourth Extraordinary Session",47,2,0,0,49
61733,25830,2009-07-23,Senate,"Assembly 3rd Reading AB20 Evans",39,0,0,0,39
61733,25831,2009-07-23,Assembly,"AB 20 EVANS  Concurrence in Senate Amendments  Fourth Extraordinary 	Session",78,0,0,0,78
61734,26766,2009-07-09,Assembly,"AB 21 EVANS  Assembly Third Reading  Fourth Extraordinary Session",47,2,0,0,49
61734,26767,2009-07-23,Senate,"Assembly 3rd Reading AB21 Evans",38,0,0,0,38
61734,26768,2009-07-23,Assembly,"AB 21 EVANS  Concurrence- Urgency Added  Fourth Extraordinary 	Session",76,2,0,0,78
61735,25461,2009-07-09,Assembly,"AB 22 EVANS  Assembly Third Reading  Fourth Extraordinary Session",47,2,0,0,49
61735,25462,2009-07-23,Senate,"Assembly 3rd Reading AB22 Evans Urgency Clause",37,0,0,0,37
61735,25463,2009-07-23,Assembly,"AB 22 EVANS  Concurrence- Urgency Added  Fourth Extraordinary 	Session",76,3,0,0,79
61736,8667,2009-07-09,Assembly,"AB 23 EVANS  Assembly Third Reading  Fourth Extraordinary Session",47,2,30,0,79
61736,8668,2009-07-24,Senate,"Assembly 3rd Reading AB23 DeVore By Hollingsworth",21,18,1,0,40
61737,8665,2009-07-09,Assembly,"AB 24 EVANS  Assembly Third Reading  Fourth Extraordinary Session",47,2,30,0,79
61737,8666,2009-07-24,Senate,"Assembly 3rd Reading AB24 Evans Urgency Clause",31,5,4,0,40
61738,23719,2009-07-09,Assembly,"AB 25 EVANS  Assembly Third Reading  Fourth Extraordinary Session",47,2,0,0,49
61738,23720,2009-07-23,Senate,"Assembly 3rd Reading AB25 Evans",39,0,0,0,39
61738,23721,2009-07-23,Assembly,"AB 25 EVANS  Concurrence- Urgency Added  Fourth Extraordinary 	Session",67,11,0,0,78
61739,25611,2009-07-09,Assembly,"AB 26 EVANS  Assembly Third Reading  Fourth Extraordinary Session",47,2,0,0,49
61739,25612,2009-07-24,Senate,"Assembly 3rd Reading AB26 Evans Urgency Clause",23,15,0,0,38
61739,25613,2009-07-24,Senate,"Assembly 3rd Reading AB26 Evans By Lowenthal",21,17,0,0,38
61739,25614,2009-07-24,Assembly,"AB 26 EVANS  Concurrence in Senate Amendments  Fourth Extraordinary 	Session",41,31,0,0,72
61740,8663,2009-07-09,Assembly,"AB 27 EVANS  Assembly Third Reading  Fourth Extraordinary Session",47,2,30,0,79
61740,8664,2009-07-24,Senate,"Assembly 3rd Reading AB27 Evans Urgency Clause",27,13,0,0,40
61741,8662,2009-07-09,Assembly,"AB 28 EVANS  Assembly Third Reading  Fourth Extraordinary Session",47,2,30,0,79
61742,8669,2009-07-09,Assembly,"AB 29 EVANS  Assembly Third Reading  Fourth Extraordinary Session",47,2,30,0,79
61743,8670,2009-07-09,Assembly,"AB 30 EVANS  Assembly Third Reading  Fourth Extraordinary Session",47,2,30,0,79
61743,8671,2009-07-24,Senate,"Assembly 3rd Reading AB30 Evans By Steinberg",21,19,0,0,40
61757,8677,2009-12-09,Assembly,"Do pass and be re-referred to the Committee on Appropriations",10,6,1,0,17
61757,8678,2009-12-10,Assembly,"Do pass as amended",12,4,1,0,17
61757,8679,2009-12-10,Assembly,"AB8 BROWNLEY  Assembly Third Reading  Fifth Extraordinary Session",48,25,6,0,79
61775,25239,2010-02-04,Assembly,"AB1 BUDGET  Assembly Third Reading  By EVANS  Eighth Extraordinary 	Session",46,0,0,0,46
61775,25240,2010-02-18,Senate,"Assembly 3rd Reading AB1 Committee on BUDGET (Evans) By Ducheny",38,0,0,0,38
61775,25241,2010-02-22,Assembly,"AB1 BUDGET  Concurrence in Senate Amendments By EVANS  Eighth 	Extraordinary Session",49,6,0,0,55
61776,132,2010-02-04,Assembly,"AB2 BUDGET  Assembly Third Reading  By EVANS  Eighth Extraordinary Session",46,0,33,0,79
61776,133,2010-02-18,Senate,"Assembly 3rd Reading AB2 Committee on BUDGET (Evans) By Ducheny",23,15,1,0,39
61776,134,2010-02-22,Assembly,"AB2 BUDGET  Concurrence in Senate Amendments By EVANS  Eighth Extraordinary Session",44,20,15,0,79
61777,23379,2010-02-04,Assembly,"AB3 BUDGET  Assembly Third Reading  By EVANS  Eighth Extraordinary 	Session",46,0,0,0,46
61777,23380,2010-02-18,Senate,"Assembly 3rd Reading AB3 Committee on BUDGET (Evans) By Ducheny",24,14,0,0,38
61777,23381,2010-02-22,Assembly,"AB3 BUDGET  Concurrence in Senate Amendments By EVANS  Eighth 	Extraordinary Session",45,17,0,0,62
61778,129,2010-02-04,Assembly,"AB4 BUDGET  Assembly Third Reading  By EVANS  Eighth Extraordinary Session",46,0,33,0,79
61778,130,2010-02-18,Senate,"Assembly 3rd Reading AB4 Committee on BUDGET (Evans) By Ducheny",30,8,1,0,39
61778,131,2010-02-22,Assembly,"AB4 BUDGET  Concurrence in Senate Amendments By EVANS  Eighth Extraordinary Session",25,25,29,0,79
61779,23375,2010-02-04,Assembly,"AB5 BUDGET  Assembly Third Reading  By EVANS  Eighth Extraordinary 	Session",46,0,0,0,46
61779,23376,2010-02-22,Senate,"Assembly 3rd Reading AB5 Committee on BUDGET (Evans) Urgency Clause",37,2,0,0,39
61779,23377,2010-02-24,Assembly,"Senate amendments be concurred in",19,3,0,0,22
61779,23378,2010-02-25,Assembly,"AB5 BUDGET  Concurrence in Senate Amendments By EVANS  Eighth 	Extraordinary Session",55,15,0,0,70
61780,25832,2010-02-04,Assembly,"AB6 BUDGET  Assembly Third Reading  By EVANS  Eighth Extraordinary 	Session",46,0,0,0,46
61780,25833,2010-03-04,Senate,"Assembly 3rd Reading AB6 Committee on BUDGET (Evans) By Ducheny",22,10,0,0,32
61780,25834,2010-03-04,Assembly,"AB6 BUDGET  Concurrence in Senate Amendments By EVANS  Eighth 	Extraordinary Session",41,32,0,0,73
61781,26519,2010-02-04,Assembly,"AB7 BUDGET  Assembly Third Reading  By EVANS  Eighth Extraordinary 	Session",46,0,0,0,46
61781,26520,2010-02-18,Senate,"Assembly 3rd Reading AB7 Committee on BUDGET (Evans) Urgency Clause",31,6,0,0,37
61781,26521,2010-02-22,Assembly,"AB7 BUDGET  Concurrence- Urgency Added  By EVANS  Eighth 	Extraordinary Session",48,1,0,0,49
61781,26522,2010-02-24,Assembly,"Senate amendments be concurred in",24,0,0,0,24
61781,26523,2010-02-25,Assembly,"AB7 BUDGET  Concurrence- Urgency Added  By EVANS  Eighth 	Extraordinary Session",69,0,0,0,69
61782,55,2010-02-04,Assembly,"AB8 BUDGET  Assembly Third Reading  By EVANS  Eighth Extraordinary Session",46,0,33,0,79
61782,56,2010-02-18,Senate,"Assembly 3rd Reading AB8 Committee on BUDGET (Evans) By Ducheny",23,15,1,0,39
61783,26763,2010-02-04,Assembly,"AB9 BUDGET  Assembly Third Reading  By EVANS  Eighth Extraordinary 	Session",46,0,0,0,46
61783,26764,2010-03-04,Senate,"Assembly 3rd Reading AB9 Committee on BUDGET (Evans) By Ducheny",21,10,0,0,31
61783,26765,2010-03-04,Assembly,"AB9 BUDGET  Concurrence in Senate Amendments By EVANS  Eighth 	Extraordinary Session",44,30,0,0,74
61784,23675,2010-02-04,Assembly,"AB 10 BUDGET  Assembly Third Reading  By EVANS  Eighth 	Extraordinary Session",46,0,0,0,46
61784,23676,2010-02-18,Senate,"Assembly 3rd Reading AB10 Committee on BUDGET (Evans) By Ducheny",32,6,0,0,38
61784,23677,2010-02-22,Assembly,"AB 10 BUDGET  Concurrence in Senate Amendments By EVANS  Eighth 	Extraordinary Session",48,12,0,0,60
61785,23390,2010-02-04,Assembly,"AB 11 BUDGET  Assembly Third Reading  By EVANS  Eighth 	Extraordinary Session",46,0,0,0,46
61785,23391,2010-02-22,Senate,"Assembly 3rd Reading AB11 Committee on BUDGET (Evans) By Ducheny",39,0,0,0,39
61785,23392,2010-02-22,Assembly,"AB 11 BUDGET  Concurrence in Senate Amendments By EVANS  Eighth 	Extraordinary Session",49,1,0,0,50
61786,22989,2010-02-04,Assembly,"AB 12 BUDGET  Assembly Third Reading  By EVANS  Eighth 	Extraordinary Session",46,0,0,0,46
61786,22990,2010-02-22,Senate,"Assembly 3rd Reading AB12 Committee on BUDGET (Evans) By Ducheny",39,0,0,0,39
61786,22991,2010-02-22,Assembly,"AB 12 BUDGET  Concurrence in Senate Amendments By EVANS  Eighth 	Extraordinary Session",49,1,0,0,50
61787,210,2010-02-04,Assembly,"AB 13 BUDGET  Assembly Third Reading  By EVANS  Eighth Extraordinary Session",46,0,33,0,79
61788,27051,2010-02-04,Assembly,"AB 14 BUDGET  Assembly Third Reading  By EVANS  Eighth 	Extraordinary Session",46,0,0,0,46
61788,27052,2010-03-04,Senate,"Assembly 3rd Reading AB14 Committee on BUDGET (Evans) By Ducheny",31,0,0,0,31
61788,27053,2010-03-04,Assembly,"AB 14 BUDGET  Concurrence- Urgency Added  By EVANS  Eighth 	Extraordinary Session",63,7,0,0,70
61789,171,2010-02-04,Assembly,"AB 15 BUDGET  Assembly Third Reading  By EVANS  Eighth Extraordinary Session",46,0,33,0,79
61790,127,2010-02-04,Assembly,"AB 16 BUDGET  Assembly Third Reading  By EVANS  Eighth Extraordinary Session",46,0,33,0,79
61791,128,2010-02-04,Assembly,"AB 17 BUDGET  Assembly Third Reading  By EVANS  Eighth Extraordinary Session",46,0,33,0,79
61792,170,2010-02-04,Assembly,"AB 18 BUDGET  Assembly Third Reading  By EVANS  Eighth Extraordinary Session",46,0,33,0,79
61793,169,2010-02-04,Assembly,"AB 19 BUDGET  Assembly Third Reading  By EVANS  Eighth Extraordinary Session",46,0,33,0,79
61794,168,2010-02-04,Assembly,"AB 20 BUDGET  Assembly Third Reading  By EVANS  Eighth Extraordinary Session",46,0,33,0,79
61811,340,2009-06-23,Assembly,"Be adopted and be re-referred to the Committee on Appropriations.",5,2,0,0,7
61811,341,2009-08-27,Assembly,"Be adopted.",11,5,1,0,17
61812,464,2009-06-23,Assembly,"Be adopted and be re-referred to the Committee on Appropriations.",7,0,0,0,7
61812,465,2009-08-27,Assembly,"Be adopted.",17,0,0,0,17
61813,27391,2010-10-07,Assembly,"ACA4 GATTO  Assembly Third Reading",65,8,0,0,73
61813,27392,2010-10-08,Senate,"W/O REF. TO FILE ACA4 Gatto and Niello",29,7,0,0,36
61814,414,2009-07-07,Assembly,"Be adopted as amended and be re-referred to the Committee on Appropriations.",6,0,1,0,7
61814,415,2009-08-27,Assembly,"Be adopted.",12,4,1,0,17
61815,416,2009-06-15,Assembly,"Be adopted and be re-referred to the Committee on Appropriations.",6,3,0,0,9
61815,417,2009-08-27,Assembly,"Be adopted.",12,5,0,0,17
61818,461,2009-05-06,Assembly,"Be adopted and be re-referred to the Committee on Revenue and Taxation.",5,2,0,0,7
61818,462,2009-06-22,Assembly,"Do pass as amended and be re-referred to the Committee on Appropriations.",6,3,0,0,9
61818,463,2009-08-27,Assembly,"Be adopted.",12,5,0,0,17
61819,7842,2009-05-11,Assembly,"Be adopted and be re-referred to the Committee on Appropriations",5,3,1,0,9
61819,7843,2009-05-28,Assembly,"Be adopted",12,5,0,0,17
61820,460,2010-04-13,Assembly,"Be adopted and be re-referred to the Committee on Appropriations.",4,7,2,0,13
61822,507,2009-06-23,Assembly,"Be adopted as amended and be re-referred to the Committee on Appropriations.",5,2,0,0,7
61822,508,2009-08-27,Assembly,"Be adopted as amended.",12,5,0,0,17
61822,509,2010-06-01,Assembly,"ACA 13 HERNANDEZ  Assembly Third Reading  Amend By HERNANDEZ  Set #1",48,27,4,0,79
61824,502,2009-05-06,Assembly,"Be adopted and be re-referred to the Committee on Appropriations.",5,2,0,0,7
61824,503,2009-05-28,Assembly,"Be adopted.",12,5,0,0,17
61826,546,2009-05-05,Assembly,"Be adopted and be re-referred to the Committee on Appropriations.",8,1,0,0,9
61829,544,2009-06-23,Assembly,"Be adopted and be re-referred to the Committee on Appropriations.",2,5,0,0,7
61829,545,2009-06-23,Assembly,"Set first hearing.  Failed passage.  Reconsideration granted.",7,0,0,0,7
61830,586,2009-07-15,Assembly,"Be adopted as amended and be re-referred to the Committee on Appropriations.",4,0,3,0,7
61830,587,2009-08-27,Assembly,"Be adopted.",12,5,0,0,17
61832,622,2009-07-07,Assembly,"Be adopted and be re-referred to the Committee on Judiciary.",6,1,2,0,9
61841,22359,2009-02-14,Assembly,"ACA1 NIELLO  Assembly Third Reading  Third Extraordinary Session",74,6,0,0,80
61841,22360,2009-02-15,Senate,"W/O REF. TO FILE ACA1 Niello",32,4,0,0,36
61841,22361,2009-02-15,Senate,"W/O REF. TO FILE ACA1 Niello",18,16,0,0,34
61841,22362,2009-02-19,Senate,"W/O REF. TO FILE ACA1 Niello",30,8,0,0,38
61842,23527,2009-02-14,Assembly,"ACA2 BASS  Assembly Third Reading  Third Extraordinary Session",68,11,0,0,79
61842,23528,2009-02-15,Senate,"W/O REF. TO FILE ACA2 Bass",29,10,0,0,39
61842,23529,2009-02-19,Senate,"Assembly 3rd Reading ACA2 Bass",28,10,0,0,38
61847,26072,2009-03-03,Assembly,"Be adopted and be re-referred to the Committee on Appropriations",9,0,0,0,9
61847,26073,2009-05-06,Assembly,"Be adopted, to Consent Calendar",16,0,0,0,16
61847,26074,2009-05-14,Assembly,"ACR2 HALL  Consent Calendar Second Day  Regular Session",73,0,0,0,73
61847,26075,2009-06-17,Senate,"Be adopted, but re-refer to the Committee on Appropriations",9,0,0,0,9
61847,26076,2009-07-09,Senate,"Special Consent #12 ACR2 Hall",34,0,0,0,34
61848,25939,2009-03-09,Assembly,"From committee:  Be adopted.  To third reading",8,0,0,0,8
61848,25940,2009-09-03,Senate,"Assembly 3rd Reading ACR3 Mendoza By Cedillo",32,0,0,0,32
61850,24991,2009-02-23,Assembly,"From committee:  Be adopted.  To third reading",9,0,0,0,9
61850,24992,2009-03-12,Senate,"W/O REF. TO FILE ACR5 Torlakson",33,0,0,0,33
61850,24993,2009-03-16,Assembly,"ACR5 TORLAKSON  Concurrence in Senate Amendments",73,0,0,0,73
61851,724,2009-03-02,Assembly,"Be adopted, as amended, to Consent Calendar.",8,0,3,0,11
61851,725,2009-03-16,Assembly,"ACR6 BLAKESLEE  Assembly Third Reading  Re-refer to Committee  By TORRICO",46,30,4,0,80
61852,25397,2009-01-15,Assembly,"ACR7 SWANSON  Assembly Third Reading",78,0,0,0,78
61852,25398,2009-06-26,Senate,"Special Consent Cal ACR7 Swanson",36,0,0,0,36
61853,23904,2009-03-23,Assembly,"Be adopted, to Consent Calendar",9,0,0,0,9
61853,23905,2009-03-26,Assembly,"ACR8 TORLAKSON  Consent Calendar Second Day",71,0,0,0,71
61853,23906,2009-04-13,Senate,"W/O REF. TO FILE ACR8 Torlakson",36,0,0,0,36
61854,25044,2009-03-23,Senate,"W/O REF. TO FILE ACR9 Hayashi",37,0,0,0,37
61856,26228,2009-03-26,Senate,"Assembly 3rd Reading ACR11 Fong Yee",38,0,0,0,38
61857,22920,2009-03-23,Assembly,"Be adopted as amended, and re-refer to Committee on Appropriations. 	with the recommendation:  To Consent Calendar",14,0,0,0,14
61857,22921,2009-04-22,Assembly,"Be adopted, to Consent Calendar",16,0,0,0,16
61857,22922,2009-05-04,Assembly,"ACR 12 BLAKESLEE  Consent Calendar Second Day  Regular Session",79,0,0,0,79
61857,22923,2009-06-16,Senate,"Be adopted, but re-refer to the Committee on Appropriations 	Recommend Consent",11,0,0,0,11
61857,22924,2009-07-09,Senate,"Special Consent #12 ACR12 Blakeslee",34,0,0,0,34
61857,22925,2009-08-17,Assembly,"ACR 12 BLAKESLEE  Concurrence in Senate Amendments",77,0,0,0,77
61859,758,2009-04-20,Assembly,"Be adopted and be re-referred to the Committee on Appropriations.",3,6,0,0,9
61859,759,2009-04-20,Assembly,"In committee:  Refused adoption. Reconsideration granted.",9,0,0,0,9
61859,760,2009-04-27,Assembly,"Be adopted and be re-referred to the Committee on Appropriations.",3,6,0,0,9
61860,23311,2009-03-23,Assembly,"Be adopted as amended, and re-refer to Committee on Appropriations. 	with the recommendation:  To Consent Calendar",14,0,0,0,14
61860,23312,2009-04-22,Assembly,"Be adopted, to Consent Calendar",16,0,0,0,16
61860,23313,2009-05-04,Assembly,"ACR 15 FURUTANI  Consent Calendar Second Day  Regular Session",79,0,0,0,79
61860,23314,2009-06-09,Senate,"Be adopted, but re-refer to the Committee on Appropriations 	Recommend Consent",11,0,0,0,11
61860,23315,2009-06-29,Senate,"Special Consent #11 ACR15 Furutani",40,0,0,0,40
61862,22745,2009-03-16,Assembly,"Be adopted, to Consent Calendar",11,0,0,0,11
61862,22746,2009-03-23,Assembly,"ACR 17 SALDANA  Consent Calendar Second Day",77,0,0,0,77
61862,22747,2009-04-13,Senate,"W/O REF. TO FILE ACR17 Saldana",36,0,0,0,36
61863,24976,2009-03-23,Assembly,"From committee:  Be adopted.  To third reading",9,0,0,0,9
61863,24977,2009-04-16,Senate,"W/O REF. TO FILE ACR18 Chesbro",37,0,0,0,37
61864,25305,2009-02-26,Assembly,"Be adopted as amended",9,0,0,0,9
61864,25306,2009-02-26,Assembly,"Be adopted as amended",9,0,0,0,9
61864,25307,2009-03-26,Senate,"W/O REF. TO FILE ACR19 Smyth",38,0,0,0,38
61865,27012,2009-04-13,Assembly,"Be adopted as amended, and re-refer to Committee on Appropriations. 	with the recommendation:  To Consent Calendar",10,0,0,0,10
61865,27013,2009-04-29,Assembly,"Be adopted, as amended, to Consent Calendar",16,0,0,0,16
61865,27014,2009-05-11,Assembly,"ACR 20 BERRYHILL, B.  Consent Calendar Second Day  Regular Session",78,0,0,0,78
61865,27015,2009-06-09,Senate,"Be adopted as amended, but re-refer to the Committee on 	Appropriations Recommend Consent",11,0,0,0,11
61865,27016,2009-07-09,Senate,"Special Consent #12 ACR20 Bill Berryhill",34,0,0,0,34
61865,27017,2009-07-13,Assembly,"ACR 20 BERRYHILL, B.  Concurrence in Senate Amendments",77,0,0,0,77
61866,26731,2009-02-14,Assembly,"From committee:  Be adopted.  To third reading",8,0,0,0,8
61866,26732,2009-02-14,Assembly,"From committee:  Be adopted.  To third reading",8,0,0,0,8
61866,26733,2009-03-26,Senate,"W/O REF. TO FILE ACR21 Yamada",38,0,0,0,38
61867,24974,2009-02-26,Assembly,"From committee:  Be adopted.  To third reading",9,0,0,0,9
61867,24975,2009-03-26,Senate,"W/O REF. TO FILE ACR22 Mendoza",38,0,0,0,38
61868,22427,2009-02-14,Assembly,"From committee:  Be adopted.  To third reading",8,0,0,0,8
61868,22428,2009-02-26,Assembly,"ACR 23 SWANSON  Assembly Third Reading",76,0,0,0,76
61868,22429,2009-06-26,Senate,"Special Consent Cal ACR23 Swanson",36,0,0,0,36
61869,22680,2009-04-13,Assembly,"Be adopted, and re-refer to Committee on Appropriations with 	recommendation:  To Consent Calendar",10,0,0,0,10
61869,22681,2009-04-22,Assembly,"Be adopted, to Consent Calendar",16,0,0,0,16
61869,22682,2009-05-04,Assembly,"ACR 24 CARTER  Consent Calendar Second Day  Regular Session",79,0,0,0,79
61869,22683,2009-06-09,Senate,"Be adopted, but re-refer to the Committee on Appropriations 	Recommend Consent",11,0,0,0,11
61869,22684,2009-06-29,Senate,"Special Consent #11 ACR24 Carter",40,0,0,0,40
61869,22685,2009-07-06,Assembly,"ACR 24 CARTER  Concurrence in Senate Amendments",78,0,0,0,78
61870,22405,2009-03-23,Assembly,"Be adopted, to Consent Calendar",9,0,0,0,9
61870,22406,2009-03-26,Assembly,"ACR 25 MILLER  Consent Calendar Second Day  Regular Session",71,0,0,0,71
61870,22407,2009-04-13,Senate,"W/O REF. TO FILE ACR25 Miller",36,0,0,0,36
61871,23288,2009-03-17,Assembly,"From committee:  Be adopted.  To third reading",8,0,0,0,8
61871,23289,2009-06-01,Senate,"Assembly 3rd Reading ACR26 Davis Maldonado",38,0,0,0,38
61872,23558,2009-04-30,Assembly,"Be adopted, to Consent Calendar",10,0,0,0,10
61872,23559,2009-05-11,Assembly,"ACR 27 DAVIS  Consent Calendar Second Day  Regular Session",78,0,0,0,78
61872,23560,2009-05-21,Senate,"W/O REF. TO FILE ACR27 Davis",36,0,0,0,36
61873,25994,2009-03-24,Assembly,"Be adopted as amended and be re-referred to the Committee on 	Appropriations",19,0,0,0,19
61873,25995,2009-05-28,Assembly,"Be adopted as amended",17,0,0,0,17
61873,25996,2009-06-26,Senate,"Special Consent Cal ACR28 Ma",36,0,0,0,36
61874,25687,2009-03-24,Assembly,"Be adopted and be re-referred to the Committee on Appropriations",17,0,0,0,17
61874,25688,2009-04-01,Assembly,"Be adopted, to Consent Calendar",16,0,0,0,16
61874,25689,2009-04-13,Assembly,"ACR 29 JONES  Consent Calendar Second Day  Regular Session",78,0,0,0,78
61874,25690,2009-06-10,Senate,"Be adopted as amended, and re-refer to the Committee on 	Appropriations",9,1,0,0,10
61874,25691,2009-06-29,Senate,"Do pass as amended",11,0,0,0,11
61874,25692,2009-08-27,Senate,"Assembly 3rd Reading ACR29 Jones By Calderon",34,1,0,0,35
61874,25693,2009-08-31,Assembly,"ACR 29 JONES  Concurrence in Senate Amendments",76,0,0,0,76
61875,26443,2009-03-23,Assembly,"Be adopted, and re-refer to Committee on Appropriations with 	recommendation:  To Consent Calendar",14,0,0,0,14
61875,26444,2009-04-01,Assembly,"Be adopted, to Consent Calendar",16,0,0,0,16
61875,26445,2009-04-13,Assembly,"ACR 30 MENDOZA  Consent Calendar Second Day  Regular Session",78,0,0,0,78
61875,26446,2009-05-12,Senate,"Be adopted as amended, but re-refer to the Committee on 	Appropriations Recommend Consent",11,0,0,0,11
61875,26447,2009-06-02,Senate,"Special Consent #7 ACR30 Mendoza",39,0,0,0,39
61875,26448,2009-06-03,Assembly,"ACR 30 MENDOZA  Concurrence in Senate Amendments",76,0,0,0,76
61876,3423,2009-05-05,Assembly,"Be adopted and be re-referred to the Committee on Appropriations",7,1,1,0,9
61876,3424,2010-02-04,Assembly,"From committee:  Be adopted.  To third reading",11,0,0,0,11
61876,21084,2010-08-24,Senate,"Assembly 3rd Reading ACR31 Ruskin By Simitian",36,0,0,0,36
61878,25738,2009-03-23,Assembly,"Be adopted, and re-refer to Committee on Appropriations with 	recommendation:  To Consent Calendar",14,0,0,0,14
61878,25739,2009-04-01,Assembly,"Be adopted, to Consent Calendar",16,0,0,0,16
61878,25740,2009-07-07,Senate,"Be adopted, but re-refer to the Committee on Appropriations 	Recommend Consent",10,0,0,0,10
61878,25741,2009-08-24,Senate,"Special Consent #15 ACR33 Jeffries",39,0,0,0,39
61879,23435,2009-03-23,Assembly,"Be adopted, and re-refer to Committee on Appropriations with 	recommendation:  To Consent Calendar",14,0,0,0,14
61879,23436,2009-04-01,Assembly,"Be adopted, to Consent Calendar",16,0,0,0,16
61879,23437,2009-04-13,Assembly,"ACR 34 FURUTANI  Consent Calendar Second Day  Regular Session",78,0,0,0,78
61879,23438,2009-05-12,Senate,"Be adopted as amended, but re-refer to the Committee on 	Appropriations Recommend Consent",11,0,0,0,11
61879,23439,2009-06-02,Senate,"Special Consent #7 ACR34 Furutani",39,0,0,0,39
61879,23440,2009-06-03,Assembly,"ACR 34 FURUTANI  Concurrence in Senate Amendments",77,0,0,0,77
61880,23160,2009-03-31,Assembly,"From committee:  Be adopted.  To third reading",11,0,0,0,11
61880,23161,2009-05-06,Senate,"W/O REF. TO FILE ACR35 Blakeslee",35,0,0,0,35
61881,26920,2009-04-13,Assembly,"Be adopted, and re-refer to Committee on Appropriations with 	recommendation:  To Consent Calendar",10,0,0,0,10
61881,26921,2009-04-22,Assembly,"Be adopted, to Consent Calendar",16,0,0,0,16
61881,26922,2009-05-04,Assembly,"ACR 36 CONWAY  Consent Calendar Second Day  Regular Session",79,0,0,0,79
61881,26923,2009-06-09,Senate,"Be adopted, but re-refer to the Committee on Appropriations 	Recommend Consent",11,0,0,0,11
61881,26924,2009-06-29,Senate,"Special Consent #11 ACR36 Conway",40,0,0,0,40
61882,25581,2009-04-02,Assembly,"From committee:  Be adopted.  To third reading",10,0,0,0,10
61882,25582,2009-05-26,Senate,"Assembly 3rd Reading ACR37 Torres Ducheny",39,0,0,0,39
61883,23192,2009-04-02,Assembly,"From committee:  Be adopted.  To third reading",10,0,0,0,10
61883,23193,2009-05-14,Senate,"W/O REF. TO FILE ACR38 Duvall",38,0,0,0,38
61884,25522,2009-04-23,Assembly,"From committee:  Be adopted.  To third reading",8,0,0,0,8
61884,25523,2009-05-14,Senate,"W/O REF. TO FILE ACR39 Caballero",38,0,0,0,38
61885,26601,2009-04-16,Assembly,"Be adopted, to Consent Calendar",10,0,0,0,10
61885,26602,2009-04-23,Assembly,"ACR 40 CONWAY  Consent Calendar Second Day",71,0,0,0,71
61885,26603,2009-05-14,Senate,"W/O REF. TO FILE ACR40 Conway",38,0,0,0,38
61886,22306,2009-03-31,Assembly,"Be adopted, to Consent Calendar",11,0,0,0,11
61886,22307,2009-04-02,Assembly,"ACR 41 MILLER  Consent Calendar Second Day  Regular Session",75,0,0,0,75
61886,22308,2009-04-16,Senate,"W/O REF. TO FILE ACR41 Miller",37,0,0,0,37
61887,23551,2009-06-23,Assembly,"Be adopted, to Consent Calendar",9,0,0,0,9
61887,23552,2009-07-09,Senate,"W/O REF. TO FILE ACR42 Fong",34,0,0,0,34
61888,22997,2009-05-14,Assembly,"From committee:  Be adopted.  To third reading",9,0,0,0,9
61888,22998,2009-06-26,Senate,"Special Consent Cal ACR43 Duvall",36,0,0,0,36
61888,22999,2009-07-06,Assembly,"ACR 43 DUVALL  Concurrence in Senate Amendments",77,0,0,0,77
61889,25024,2009-03-16,Assembly,"Be adopted as amended",8,0,0,0,8
61889,25025,2009-03-26,Senate,"W/O REF. TO FILE ACR44 Fuentes By Padilla",34,2,0,0,36
61890,25472,2009-04-16,Assembly,"From committee:  Be adopted.  To third reading",10,0,0,0,10
61890,25473,2009-05-14,Senate,"W/O REF. TO FILE ACR45 Ruskin",38,0,0,0,38
61891,8120,2010-04-08,Assembly,"Be referred to Committee on Judiciary",11,0,0,0,11
61891,8121,2010-04-13,Assembly,"From committee:  Be adopted.  To third reading",7,0,3,0,10
61891,8122,2010-04-15,Assembly,"ACR 46 SALDANA  Assembly Third Reading",48,4,27,0,79
61892,24970,2009-04-23,Assembly,"From committee:  Be adopted.  To third reading",8,0,0,0,8
61892,24971,2009-05-14,Senate,"W/O REF. TO FILE ACR47 Mendoza",38,0,0,0,38
61893,23355,2009-04-13,Assembly,"Be adopted, and re-refer to Committee on Appropriations with 	recommendation:  To Consent Calendar",10,0,0,0,10
61893,23356,2009-04-22,Assembly,"Be adopted, to Consent Calendar",16,0,0,0,16
61893,23357,2009-05-04,Assembly,"ACR 48 GILMORE  Consent Calendar Second Day  Regular Session",79,0,0,0,79
61893,23358,2009-06-09,Senate,"Be adopted, but re-refer to the Committee on Appropriations 	Recommend Consent",11,0,0,0,11
61893,23359,2009-06-29,Senate,"Special Consent #11 ACR48 Gilmore",40,0,0,0,40
61894,22237,2009-05-12,Assembly,"Be adopted, as amended, to Consent Calendar",10,0,0,0,10
61894,22238,2009-05-28,Assembly,"Be adopted, to Consent Calendar",17,0,0,0,17
61894,22239,2009-06-02,Assembly,"ACR 49 EVANS  Consent Calendar Second Day  Regular Session",76,0,0,0,76
61894,22240,2009-07-07,Senate,"Be adopted, but re-refer to the Committee on Appropriations 	Recommend Consent",5,0,0,0,5
61894,22241,2009-08-31,Senate,"Special Consent #17 ACR49 Evans By Corbett",36,0,0,0,36
61894,22242,2009-09-02,Assembly,"ACR 49 EVANS  Concurrence in Senate Amendments",76,1,0,0,77
61895,26776,2009-04-23,Assembly,"Be adopted as amended",8,0,0,0,8
61895,26777,2009-04-23,Assembly,"Be adopted as amended",8,0,0,0,8
61895,26778,2009-05-28,Senate,"W/O REF. TO FILE ACR50 Skinner",34,0,0,0,34
61897,26065,2009-05-04,Assembly,"From committee:  Be adopted.  To third reading",10,0,0,0,10
61897,26066,2009-06-22,Senate,"Assembly 3rd Reading ACR52 Solorio DeSaulnier",38,0,0,0,38
61898,24978,2009-04-23,Assembly,"From committee:  Be adopted.  To third reading",8,0,0,0,8
61898,24979,2009-05-14,Senate,"W/O REF. TO FILE ACR53 Price",38,0,0,0,38
61899,23086,2009-04-15,Assembly,"Be adopted",8,2,0,0,10
61899,23087,2009-05-11,Assembly,"ACR 54 BROWNLEY  Assembly Third Reading",49,29,0,0,78
61899,23088,2009-07-08,Senate,"Be adopted as amended",6,3,0,0,9
61899,23089,2009-08-31,Senate,"Assembly 3rd Reading ACR54 Brownley By Romero",21,13,0,0,34
61899,23090,2009-09-02,Assembly,"ACR 54 BROWNLEY  Concurrence in Senate Amendments",47,29,0,0,76
61900,794,2009-05-05,Assembly,"Be adopted as amended and be re-referred to the Committee on Appropriations.",7,0,2,0,9
61900,795,2009-05-28,Assembly,"From committee:  Be adopted.  To third reading.",12,5,0,0,17
61900,796,2009-06-01,Assembly,"ACR 55 TORLAKSON  Assembly Third Reading",49,28,3,0,80
61900,797,2009-07-08,Senate,"Be adopted, but re-refer to the Committee on Appropriations.",6,3,0,0,9
61900,798,2009-08-17,Senate,"Placed on Appropriations Suspense file.",13,0,0,0,13
61901,799,2009-04-16,Assembly,"From committee:  Be adopted.  To third reading.",10,0,1,0,11
61902,24972,2009-04-20,Assembly,"From committee:  Be adopted.  To third reading",10,0,0,0,10
61902,24973,2009-05-14,Senate,"W/O REF. TO FILE ACR57 Eng",38,0,0,0,38
61903,25022,2009-04-30,Assembly,"Be adopted, to Consent Calendar",10,0,0,0,10
61903,25023,2009-05-14,Senate,"W/O REF. TO FILE ACR58 Nestande",38,0,0,0,38
61904,25019,2009-04-23,Assembly,"Be adopted as amended",8,0,0,0,8
61904,25020,2009-04-23,Assembly,"Be adopted as amended",8,0,0,0,8
61904,25021,2009-05-14,Senate,"W/O REF. TO FILE ACR59 Nielsen",38,0,0,0,38
61905,22499,2009-04-27,Assembly,"Be adopted, and re-refer to Committee on Appropriations with 	recommendation:  To Consent Calendar",13,0,0,0,13
61905,22500,2009-05-06,Assembly,"Be adopted, to Consent Calendar",16,0,0,0,16
61905,22501,2009-05-14,Assembly,"ACR 60 GILMORE  Consent Calendar Second Day  Regular Session",73,0,0,0,73
61905,22502,2009-06-09,Senate,"Be adopted as amended, but re-refer to the Committee on 	Appropriations Recommend Consent",11,0,0,0,11
61905,22503,2009-06-29,Senate,"Special Consent #11 ACR60 Gilmore",40,0,0,0,40
61905,22504,2009-07-06,Assembly,"ACR 60 GILMORE  Concurrence in Senate Amendments",76,0,0,0,76
61906,23441,2009-05-11,Assembly,"Be adopted, and re-refer to Committee on Appropriations with 	recommendation:  To Consent Calendar",14,0,0,0,14
61906,23442,2009-05-20,Assembly,"Be adopted, to Consent Calendar",15,0,0,0,15
61906,23443,2009-05-28,Assembly,"ACR 61 VILLINES  Consent Calendar Second Day  Regular Session",76,0,0,0,76
61906,23444,2009-07-07,Senate,"Be adopted, but re-refer to the Committee on Appropriations 	Recommend Consent",10,0,0,0,10
61906,23445,2009-08-24,Senate,"Special Consent #15 ACR61 Villines",39,0,0,0,39
61907,22992,2009-05-05,Assembly,"Be adopted, to Consent Calendar",19,0,0,0,19
61907,22993,2009-05-20,Assembly,"Be adopted, to Consent Calendar",15,0,0,0,15
61907,22994,2009-05-28,Assembly,"ACR 62 GALGIANI  Consent Calendar Second Day  Regular Session",76,0,0,0,76
61907,22995,2009-07-08,Senate,"Do pass, but re-refer to the Committee on Appropriations Recommend 	Consent",11,0,0,0,11
61907,22996,2009-08-24,Senate,"Special Consent #15 ACR62 Galgiani",39,0,0,0,39
61908,837,2009-04-23,Assembly,"Be adopted, to Consent Calendar.",8,0,3,0,11
61908,838,2009-05-04,Assembly,"ACR 63 BASS  Consent Calendar Second Day  Regular Session",79,0,1,0,80
61909,23225,2009-05-14,Assembly,"Be adopted as amended",9,0,0,0,9
61909,23226,2009-06-08,Senate,"W/O REF. TO FILE ACR64 Ma",31,0,0,0,31
61910,27103,2009-05-04,Assembly,"Be adopted, as amended, to Consent Calendar",10,0,0,0,10
61910,27104,2009-05-11,Assembly,"ACR 65 RUSKIN  Consent Calendar Second Day  Regular Session",78,0,0,0,78
61910,27105,2009-09-08,Senate,"W/O REF. TO FILE ACR65 Ruskin",23,10,0,0,33
61910,27106,2009-09-10,Assembly,"ACR 65 RUSKIN  Concurrence in Senate Amendments",78,0,0,0,78
61911,25277,2009-05-14,Assembly,"From committee:  Be adopted.  To third reading",9,0,0,0,9
61911,25278,2009-06-11,Senate,"W/O REF. TO FILE ACR66 V. Manuel Perez",33,0,0,0,33
61912,554,2010-05-03,Assembly,"Be adopted as amended.",7,0,4,0,11
61913,22591,2009-05-18,Assembly,"From committee:  Be adopted.  To third reading",10,0,0,0,10
61913,22592,2009-09-01,Senate,"Assembly 3rd Reading ACR68 Davis By Cedillo",29,1,0,0,30
61915,26644,2009-05-11,Assembly,"From committee:  Be adopted.  To third reading",11,0,0,0,11
61915,26645,2009-05-28,Senate,"W/O REF. TO FILE ACR70 Ma",34,0,0,0,34
61916,26449,2009-06-22,Assembly,"Be adopted, and re-refer to Committee on Appropriations with 	recommendation:  To Consent Calendar",13,0,0,0,13
61916,26450,2009-07-01,Assembly,"Be adopted, to Consent Calendar",15,0,0,0,15
61916,26451,2009-07-09,Assembly,"ACR 71 NIELSEN  Consent Calendar Second Day",74,0,0,0,74
61916,26452,2009-09-09,Senate,"Special Consent #20 ACR71 Nielsen",40,0,0,0,40
61916,26453,2009-09-11,Assembly,"ACR 71 NIELSEN  Concurrence in Senate Amendments",77,0,0,0,77
61917,23260,2009-06-22,Assembly,"Be adopted, to Consent Calendar",10,0,0,0,10
61917,23261,2009-06-24,Assembly,"ACR 72 HUFFMAN  Consent Calendar Second Day",72,0,0,0,72
61917,23262,2009-07-09,Senate,"W/O REF. TO FILE ACR72 Huffman",34,0,0,0,34
61918,23211,2009-05-21,Assembly,"From committee:  Be adopted.  To third reading",9,0,0,0,9
61918,23212,2009-06-08,Senate,"W/O REF. TO FILE ACR73 Portantino",31,0,0,0,31
61919,1925,2010-02-18,Assembly,"Be referred to Committee on Health",10,0,1,0,11
61919,1926,2010-03-23,Assembly,"From committee:  Be adopted.  To third reading",18,0,1,0,19
61919,9085,2010-06-16,Senate,"Be adopted",8,0,1,0,9
61919,20796,2010-08-23,Senate,"Assembly 3rd Reading ACR74 Portantino By Alquist",36,0,0,0,36
61920,22976,2009-06-30,Assembly,"Be adopted, as amended, to Consent Calendar",16,0,0,0,16
61920,22977,2009-09-10,Senate,"W/O REF. TO FILE ACR75 V. Manuel Perez",40,0,0,0,40
61921,22983,2009-08-18,Assembly,"Be adopted as amended",8,0,0,0,8
61921,22984,2009-09-10,Senate,"W/O REF. TO FILE ACR76 Eng",40,0,0,0,40
61922,26237,2009-07-07,Assembly,"Do pass as amended and be re-referred to the Committee on 	Appropriations",7,0,0,0,7
61922,26238,2009-08-27,Assembly,"From committee:  Be adopted.  To third reading",17,0,0,0,17
61922,26239,2009-09-10,Senate,"W/O REF. TO FILE ACR77 Swanson",40,0,0,0,40
61923,23269,2009-06-22,Assembly,"Be adopted, and re-refer to Committee on Appropriations with 	recommendation:  To Consent Calendar",13,0,0,0,13
61923,23270,2009-07-01,Assembly,"Be adopted, to Consent Calendar",15,0,0,0,15
61923,23271,2009-07-09,Assembly,"ACR 78 BUCHANAN  Consent Calendar Second Day  Regular Session",74,0,0,0,74
61923,23272,2009-09-09,Senate,"Special Consent #20 ACR78 Buchanan",40,0,0,0,40
61924,22936,2009-06-22,Assembly,"Be adopted, as amended, to Consent Calendar",13,0,0,0,13
61924,22937,2009-07-08,Assembly,"Be adopted, to Consent Calendar",15,0,0,0,15
61924,22938,2009-07-13,Assembly,"ACR 79 HAYASHI  Consent Calendar Second Day",74,0,0,0,74
61924,22939,2009-09-09,Senate,"Special Consent #20 ACR79 Hayashi",40,0,0,0,40
61925,26132,2009-06-30,Assembly,"From committee:  Be adopted.  To third reading",5,0,0,0,5
61925,26133,2009-09-04,Senate,"Assembly 3rd Reading ACR80 Hill By Simitian",24,12,0,0,36
61926,25315,2009-06-22,Assembly,"From committee:  Be adopted.  To third reading",10,0,0,0,10
61926,25316,2009-07-09,Senate,"W/O REF. TO FILE ACR81 Torrico",34,0,0,0,34
61927,27156,2009-07-01,Assembly,"Be adopted as amended",7,1,0,0,8
61927,27157,2010-03-24,Senate,"Do pass as amended",6,1,0,0,7
61927,27158,2010-04-08,Senate,"Assembly 3rd Reading ACR82 Hall By Kehoe",22,7,0,0,29
61927,27159,2010-04-15,Assembly,"ACR 82 HALL  Concurrence in Senate Amendments",46,11,0,0,57
61930,26240,2009-09-02,Senate,"Assembly 3rd Reading ACR85 Torrico By Corbett",30,1,0,0,31
61931,25562,2009-08-24,Assembly,"Be adopted, to Consent Calendar",9,0,0,0,9
61931,25563,2009-08-27,Assembly,"ACR 86 HUFFMAN  Consent Calendar Second Day",74,0,0,0,74
61931,25564,2009-09-10,Senate,"Assembly 3rd Reading ACR86 Huffman",34,0,0,0,34
61933,871,2009-08-26,Assembly,"From committee:  Be adopted.  To third reading.",9,0,2,0,11
61933,9093,2010-06-16,Senate,"Be adopted, but re-refer to the Committee on Rules Recommend Consent",6,0,3,0,9
61933,10331,2010-07-01,Senate,"Assembly 3rd Reading ACR88 Torlakson By Emmerson",32,0,7,0,39
61934,25513,2009-08-26,Assembly,"Be adopted, as amended, to Consent Calendar",10,0,0,0,10
61934,25514,2009-09-11,Senate,"W/O REF. TO FILE ACR89 Galgiani By Yee",22,0,0,0,22
61935,25102,2009-08-24,Assembly,"Be adopted, to Consent Calendar",9,0,0,0,9
61935,25103,2009-09-09,Senate,"Assembly 3rd Reading ACR90 Beall By Liu",39,0,0,0,39
61936,872,2009-08-27,Assembly,"Be adopted, to Consent Calendar.",10,0,1,0,11
61938,23388,2009-09-03,Assembly,"From committee:  Be adopted.  To third reading",9,0,0,0,9
61938,23389,2009-09-10,Senate,"W/O REF. TO FILE ACR93 Torres",40,0,0,0,40
61939,26199,2009-09-11,Senate,"W/O REF. TO FILE ACR94 Charles Calderon",40,0,0,0,40
61940,26608,2009-09-10,Assembly,"From committee:  Be adopted.  To third reading",10,0,0,0,10
61940,26609,2009-09-11,Senate,"W/O REF. TO FILE ACR95 Torrico By Cedillo",40,0,0,0,40
61941,24042,2010-01-07,Assembly,"From committee:  Be adopted.  To third reading",10,0,0,0,10
61941,24043,2010-02-04,Senate,"ASSEMBLY 3RD READING ACR96 HAYASHI BY YEE",32,0,0,0,32
61942,8695,2010-06-10,Assembly,"Be adopted, to Consent Calendar",11,0,0,0,11
61942,9071,2010-06-17,Assembly,"ACR 97 ENG  Consent Calendar Second Day",72,0,7,0,79
61942,21958,2010-08-30,Senate,"Assembly 3rd Reading ACR97 Eng By Price",33,0,0,0,33
61943,915,2010-01-07,Assembly,"From committee:  Be adopted.  To third reading.",10,0,1,0,11
61944,8694,2010-06-10,Assembly,"Be adopted, to Consent Calendar",11,0,0,0,11
61944,9069,2010-06-17,Assembly,"ACR 99 BUCHANAN  Consent Calendar Second Day  Regular Session",72,0,7,0,79
61944,19386,2010-08-02,Senate,"W/O REF. TO FILE ACR99 Buchanan",33,0,0,0,33
61945,22783,2010-02-04,Assembly,"From committee:  Be adopted.  To third reading",11,0,0,0,11
61945,22784,2010-02-22,Senate,"Assembly 3rd Reading ACR100 Jones By Correa",36,0,0,0,36
61946,5467,2010-04-08,Assembly,"From committee:  Be adopted.  To third reading",11,0,0,0,11
61946,5468,2010-04-08,Assembly,"From committee:  Be adopted.  To third reading",11,0,0,0,11
61946,5469,2010-05-28,Senate,"Assembly 3rd Reading ACR101 Furutani By Negrete McLeod",29,0,9,0,38
61947,5433,2010-03-22,Assembly,"Be adopted, and re-refer to Committee on Appropriations with recommendation:  To Consent Calendar",13,0,1,0,14
61947,5434,2010-04-14,Assembly,"Be adopted, to Consent Calendar",15,0,2,0,17
61947,5435,2010-04-19,Assembly,"ACR 102 COTO  Consent Calendar Second Day",73,0,6,0,79
61947,8930,2010-06-15,Senate,"Be adopted, but re-refer to the Committee on Appropriations",6,1,2,0,9
61947,20337,2010-08-11,Senate,"Assembly 3rd Reading ACR102 Coto By Alquist",32,1,0,0,33
61947,20338,2010-08-16,Assembly,"ACR 102 COTO  Concurrence in Senate Amendments",74,0,0,0,74
61948,4698,2010-03-22,Assembly,"Be adopted, and re-refer to Committee on Appropriations with recommendation:  To Consent Calendar",13,0,1,0,14
61948,4699,2010-04-21,Assembly,"Be adopted, to Consent Calendar",16,0,1,0,17
61948,4700,2010-04-26,Assembly,"ACR 103 PEREZ, J.  Consent Calendar Second Day  Regular Session",71,0,8,0,79
61948,8844,2010-06-15,Senate,"Be adopted as amended, and re-refer to the Committee on Appropriations",6,1,2,0,9
61948,20415,2010-08-18,Senate,"Assembly 3rd Reading ACR103 John A. Perez By Cedillo",29,0,0,0,29
61948,20948,2010-08-23,Assembly,"ACR 103 PEREZ, J.  Concurrence in Senate Amendments",76,0,0,0,76
61949,956,2010-01-19,Assembly,"From committee:  Be adopted.  To third reading.",10,0,1,0,11
61950,27144,2010-03-23,Assembly,"Be adopted, to Consent Calendar",18,0,0,0,18
61950,27145,2010-04-05,Assembly,"ACR 105 NAVA  Consent Calendar Second Day  Regular Session",76,0,0,0,76
61950,27146,2010-04-15,Senate,"W/O REF. TO FILE ACR105 Nava",35,0,0,0,35
61950,27147,2010-04-22,Assembly,"ACR 105 NAVA  Concurrence in Senate Amendments",73,0,0,0,73
61951,4590,2010-03-22,Assembly,"Be adopted, and re-refer to Committee on Appropriations with recommendation:  To Consent Calendar",13,0,1,0,14
61951,4591,2010-04-14,Assembly,"Be adopted, to Consent Calendar",15,0,2,0,17
61951,4592,2010-04-19,Assembly,"ACR 106 CABALLERO  Consent Calendar Second Day  Regular Session",73,0,6,0,79
61951,4593,2010-05-04,Senate,"Be adopted as amended, but re-refer to the Committee on Appropriations Recommend Consent",8,0,1,0,9
61951,4594,2010-05-27,Senate,"Consent Calendar 2nd ACR106 Caballero",33,0,5,0,38
61951,8751,2010-06-14,Assembly,"ACR 106 CABALLERO  Concurrence in Senate Amendments",70,0,9,0,79
61952,955,2010-03-04,Assembly,"From committee:  Be adopted.  To third reading.",8,0,3,0,11
61952,19087,2010-08-02,Senate,"W/O REF. TO FILE ACR107 Torres",33,0,0,0,33
61953,954,2010-02-11,Assembly,"From committee:  Be adopted.  To third reading.",9,0,2,0,11
61954,27307,2010-03-22,Assembly,"Be adopted, and re-refer to Committee on Appropriations with 	recommendation:  To Consent Calendar",13,0,0,0,13
61954,27308,2010-04-14,Assembly,"Be adopted, to Consent Calendar",15,0,0,0,15
61954,27309,2010-04-19,Assembly,"ACR 109 NESTANDE  Consent Calendar Second Day  Regular Session",73,0,0,0,73
61954,27310,2010-05-04,Senate,"Be adopted, but re-refer to the Committee on Appropriations 	Recommend Consent",8,0,0,0,8
61954,27311,2010-05-27,Senate,"Consent Calendar 2nd ACR109 Nestande",33,0,0,0,33
61954,27312,2010-05-28,Assembly,"ACR 109 NESTANDE  Concurrence in Senate Amendments",59,0,0,0,59
61955,4558,2010-04-27,Assembly,"From committee:  Be adopted.  To third reading",4,1,1,0,6
61955,20476,2010-08-18,Senate,"Assembly 3rd Reading ACR110 Conway By Liu",26,4,0,0,30
61956,5096,2010-04-15,Assembly,"Be adopted, to Consent Calendar",9,0,2,0,11
61956,5097,2010-04-22,Assembly,"ACR 111 BUCHANAN  Consent Calendar Second Day  Regular Session",74,0,5,0,79
61956,19400,2010-08-02,Senate,"W/O REF. TO FILE ACR111 Buchanan",33,0,0,0,33
61957,916,2010-02-18,Assembly,"From committee:  Be adopted.  To third reading.",10,0,1,0,11
61958,4237,2010-03-22,Assembly,"Be adopted as amended, and re-refer to Committee on Appropriations. with the recommendation:  To Consent Calendar",13,0,1,0,14
61958,4238,2010-04-14,Assembly,"Be adopted, to Consent Calendar",15,0,2,0,17
61958,4239,2010-04-19,Assembly,"ACR 113 CABALLERO  Consent Calendar Second Day  Regular Session",73,0,6,0,79
61958,4240,2010-05-04,Senate,"Be adopted as amended, but re-refer to the Committee on Appropriations Recommend Consent",8,0,1,0,9
61958,19504,2010-08-02,Senate,"Consent Calendar 2nd ACR113 Caballero",33,0,0,0,33
61958,19801,2010-08-09,Assembly,"ACR 113 CABALLERO  Concurrence in Senate Amendments",75,0,0,0,75
61959,993,2010-02-18,Assembly,"From committee:  Be adopted.  To third reading.",10,0,1,0,11
61960,27195,2010-03-18,Assembly,"From committee:  Be adopted.  To third reading",10,0,0,0,10
61960,27196,2010-04-26,Senate,"Assembly 3rd Reading ACR115 Emmerson By Dutton",35,0,0,0,35
61961,2015,2010-04-22,Assembly,"From committee:  Be adopted.  To third reading",8,0,3,0,11
61961,19725,2010-08-05,Senate,"W/O REF. TO FILE ACR116 Hill",33,0,0,0,33
61962,1024,2010-02-18,Assembly,"Be adopted as amended.",10,0,1,0,11
61962,20036,2010-08-11,Senate,"Assembly 3rd Reading ACR117 Hill By Corbett",33,0,0,0,33
61963,22383,2009-05-06,Assembly,"Be adopted, as amended, to Consent Calendar",9,0,0,0,9
61963,22384,2009-05-14,Assembly,"AJR1 BLAKESLEE  Consent Calendar Second Day  Regular Session",73,0,0,0,73
61963,22385,2009-06-26,Senate,"Special Consent Cal AJR1 Blakeslee",36,0,0,0,36
61964,25399,2009-04-22,Assembly,"From committee:  Be adopted.  To third reading",5,1,0,0,6
61964,25400,2009-05-04,Assembly,"AJR2 CABALLERO  Assembly Third Reading",77,0,0,0,77
61964,25401,2009-06-09,Senate,"Be adopted",5,0,0,0,5
61964,25402,2009-06-11,Senate,"Assembly 3rd Reading AJR2 Caballero Maldonado",33,0,0,0,33
61965,1832,2009-04-13,Assembly,"Be adopted",6,3,0,0,9
61965,1833,2009-04-20,Assembly,"AJR3 NAVA  Assembly Third Reading",43,25,12,0,80
61965,1834,2009-07-06,Senate,"Be adopted",7,3,1,0,11
61965,9188,2010-06-22,Senate,"Be adopted, but re-refer to the Committee on Environmental Quality",5,3,1,0,9
61965,9638,2010-06-28,Senate,"Be adopted",5,2,0,0,7
61966,957,2009-02-02,Assembly,"From committee:  Be adopted.  To third reading.",7,3,1,0,11
61966,958,2009-02-02,Assembly,"AJR4 BASS  Assembly Third Reading",46,27,7,0,80
61968,22867,2009-03-31,Assembly,"From committee:  Be adopted.  To third reading",6,0,0,0,6
61968,22868,2009-04-02,Assembly,"AJR6 BEALL  Assembly Third Reading",52,12,0,0,64
61968,22869,2009-08-24,Senate,"Assembly 3rd Reading AJR6 Beall By Liu",27,11,0,0,38
61970,25357,2009-04-14,Assembly,"Be adopted as amended",11,1,0,0,12
61970,25358,2009-04-20,Assembly,"AJR8 MONNING  Assembly Third Reading",63,3,0,0,66
61970,25359,2009-06-09,Senate,"Do pass",6,3,0,0,9
61970,25360,2009-08-27,Senate,"Assembly 3rd Reading AJR8 Monning By Maldonado",26,11,0,0,37
61970,25361,2009-08-31,Assembly,"AJR8 MONNING  Concurrence in Senate Amendments",62,4,0,0,66
61971,25383,2009-03-31,Assembly,"Be adopted as amended",19,0,0,0,19
61971,25384,2009-04-20,Assembly,"AJR9 PEREZ, J.  Assembly Third Reading",76,0,0,0,76
61971,25385,2009-05-20,Senate,"Be adopted",8,0,0,0,8
61971,25386,2009-06-15,Senate,"Assembly 3rd Reading AJR9 John A. Perez",35,0,0,0,35
61971,25387,2009-06-22,Assembly,"AJR9 PEREZ, J.  Concurrence in Senate Amendments",77,0,0,0,77
61972,25774,2009-05-06,Assembly,"Be adopted",6,0,0,0,6
61972,25775,2009-05-18,Assembly,"AJR 10 TORLAKSON  Assembly Third Reading",62,13,0,0,75
61972,25776,2009-06-22,Senate,"Be adopted",5,0,0,0,5
61972,25777,2009-09-01,Senate,"Assembly 3rd Reading AJR10 Torlakson By Yee",26,8,0,0,34
61972,25778,2009-09-08,Assembly,"AJR 10 TORLAKSON  Concurrence in Senate Amendments",64,13,0,0,77
61973,23280,2009-04-16,Assembly,"From committee:  Be adopted.  To third reading",7,0,0,0,7
61973,23281,2009-04-20,Assembly,"AJR 11 FURUTANI  Assembly Third Reading",47,1,0,0,48
61973,23282,2009-06-11,Senate,"Assembly 3rd Reading AJR11 Furutani Oropeza",23,0,0,0,23
61974,990,2009-06-08,Assembly,"Be referred to Committee on Revenue and Taxation.",8,0,3,0,11
61974,991,2009-06-15,Assembly,"From committee:  Be adopted.  To third reading.",6,3,0,0,9
61974,992,2009-07-13,Assembly,"AJR 12 BLOCK  Assembly Third Reading",49,27,3,0,79
61974,9605,2010-06-23,Senate,"Be adopted",3,0,2,0,5
61974,20443,2010-08-12,Senate,"Assembly 3rd Reading AJR12 Block By Wolk",21,14,0,0,35
61975,4952,2009-08-18,Assembly,"Be adopted as amended",7,3,0,0,10
61975,4953,2009-09-08,Assembly,"AJR 13 AMMIANO  Assembly Third Reading",46,29,4,0,79
61975,4954,2010-06-09,Senate,"Be adopted",5,0,4,0,9
61975,21303,2010-08-25,Senate,"Assembly 3rd Reading AJR13 Ammiano By DeSaulnier",22,8,0,0,30
61976,23348,2009-04-20,Assembly,"Be adopted as amended",9,0,0,0,9
61976,23349,2009-04-23,Assembly,"AJR 14 KREKORIAN  Assembly Third Reading",74,0,0,0,74
61976,23350,2009-09-08,Senate,"W/O REF. TO FILE AJR14 Krekorian",40,0,0,0,40
61977,4914,2009-08-18,Assembly,"Be adopted as amended",7,3,0,0,10
61977,4915,2009-09-08,Assembly,"AJR 15 DE LEON  Assembly Third Reading",45,29,5,0,79
61977,8878,2010-06-10,Senate,"Be adopted as amended",3,2,0,0,5
61977,9861,2010-06-28,Senate,"Assembly 3rd Reading AJR15 De Leon By Leno",23,12,4,0,39
61977,9993,2010-07-01,Assembly,"AJR 15 DE LEON  Concurrence in Senate Amendments",48,25,6,0,79
61978,1346,2009-06-23,Assembly,"Be adopted, as amended, to Consent Calendar.",10,0,0,0,10
61978,1347,2009-07-06,Assembly,"AJR 16 EVANS  Consent Calendar Second Day",78,0,1,0,79
61978,8763,2010-06-15,Senate,"Be adopted and be placed on the Consent Calendar",5,0,0,0,5
61978,9554,2010-06-24,Senate,"Consent Calendar 2nd AJR16 Evans",31,0,8,0,39
61978,9656,2010-06-28,Assembly,"AJR 16 EVANS  Concurrence in Senate Amendments",75,1,3,0,79
61979,23213,2009-06-23,Assembly,"From committee:  Be adopted.  To third reading",19,0,0,0,19
61979,23214,2009-06-25,Assembly,"AJR 17 SWANSON  Assembly Third Reading",72,2,0,0,74
61979,23215,2009-08-26,Senate,"Be adopted",9,0,0,0,9
61979,23216,2009-09-02,Senate,"Assembly 3rd Reading AJR17 Swanson By Alquist",26,1,0,0,27
61980,8066,2010-06-10,Assembly,"Be referred to Committee on Judiciary",7,4,0,0,11
61981,3985,2009-08-18,Assembly,"Be adopted as amended",7,3,0,0,10
61981,3986,2009-08-31,Assembly,"AJR 19 BROWNLEY  Assembly Third Reading",47,29,3,0,79
61981,9013,2010-06-15,Senate,"Be adopted",3,2,0,0,5
61981,20928,2010-08-23,Senate,"Assembly 3rd Reading AJR19 Brownley By Leno",22,12,0,0,34
61985,1059,2010-01-11,Assembly,"Be adopted as amended.",7,2,2,0,11
61986,1140,2010-01-12,Assembly,"Do pass as amended.",6,0,1,0,7
61986,1141,2010-01-27,Assembly,"AJR 24 LOWENTHAL  Assembly Third Reading",62,6,10,0,78
61987,4927,2010-02-16,Assembly,"Be adopted as amended",9,0,0,0,9
61987,4928,2010-05-24,Assembly,"AJR 25 FURUTANI  Assembly Third Reading",70,0,9,0,79
61987,20552,2010-08-18,Senate,"Assembly 3rd Reading AJR25 Furutani By Yee",34,0,0,0,34
61988,1060,2010-01-11,Assembly,"Be adopted as amended.",6,2,1,0,9
61988,1061,2010-01-25,Assembly,"AJR 26 CHESBRO  Assembly Third Reading",41,19,18,0,78
61988,8697,2010-06-09,Senate,"Do pass, but re-refer to the Committee on Environmental Quality",5,2,2,0,9
61988,8698,2010-06-14,Senate,"Be adopted",4,2,1,0,7
61988,20863,2010-08-18,Senate,"Assembly 3rd Reading AJR26 Chesbro By Pavley",22,12,0,0,34
61989,8401,2010-04-20,Assembly,"Be adopted as amended",4,2,0,0,6
61989,9562,2010-06-21,Assembly,"AJR 27 TORRICO  Assembly Third Reading",47,27,5,0,79
61989,19826,2010-08-09,Senate,"Do pass",5,2,0,0,7
61989,21307,2010-08-24,Senate,"Assembly 3rd Reading AJR27 Torrico By Negrete McLeod",22,14,0,0,36
61989,21502,2010-08-26,Assembly,"AJR 27 TORRICO  Concurrence in Senate Amendments",48,27,0,0,75
61991,123,2010-04-12,Assembly,"Be adopted as amended.",8,0,1,0,9
61991,124,2010-04-22,Assembly,"AJR 29 FEUER  Assembly Third Reading",61,8,10,0,79
61991,9475,2010-06-23,Senate,"Be adopted as amended",3,0,2,0,5
61991,10091,2010-07-01,Senate,"Assembly 3rd Reading AJR29 Feuer By Ashburn",24,11,4,0,39
61991,19886,2010-08-09,Assembly,"AJR 29 FEUER  Concurrence in Senate Amendments",60,11,0,0,71
61992,4021,2010-03-22,Assembly,"Be adopted, to Consent Calendar",9,0,0,0,9
61992,4022,2010-03-25,Assembly,"AJR 30 SALAS  Consent Calendar Second Day",70,0,9,0,79
61993,3904,2010-03-24,Assembly,"Be adopted, as amended, to Consent Calendar",9,0,0,0,9
61993,3905,2010-04-08,Assembly,"AJR 31 BUCHANAN  Consent Calendar Second Day  Regular Session",71,0,8,0,79
61993,9738,2010-06-24,Senate,"W/O REF. TO FILE AJR31 Buchanan",31,0,8,0,39
61997,1138,2009-03-03,Assembly,"From committee:  Be adopted.  To third reading.",9,0,0,0,9
61997,1139,2009-03-12,Assembly,"HR 4 PORTANTINO  Assembly Third Reading",47,21,12,0,80
61998,1136,2009-02-17,Assembly,"From committee:  Be adopted.  To third reading.",7,3,0,0,10
61998,1137,2009-03-02,Assembly,"HR5 AMMIANO  Assembly Third Reading",45,27,8,0,80
61999,1134,2009-02-05,Assembly,"From committee:  Be adopted.  To third reading.",11,0,0,0,11
61999,1135,2009-02-05,Assembly,"HR6 GARRICK  Assembly Third Reading",75,0,5,0,80
62000,1215,2009-02-26,Assembly,"From committee:  Be adopted.  To third reading.",9,0,2,0,11
62002,1178,2009-03-02,Assembly,"From committee:  Be adopted.  To third reading.",8,0,3,0,11
62002,1179,2009-03-09,Assembly,"HR9 PRICE  Assembly Third Reading",78,0,2,0,80
62003,1180,2009-04-14,Assembly,"From committee:  Be adopted.  To third reading.",7,0,0,0,7
62004,1218,2009-04-14,Assembly,"From committee:  Be adopted.  To third reading.",7,0,0,0,7
62006,1181,2009-05-04,Assembly,"From committee:  Be adopted.  To third reading.",10,0,1,0,11
62007,1182,2009-08-20,Assembly,"From committee:  Be adopted.  To third reading.",10,0,1,0,11
62007,1183,2009-08-24,Assembly,"HR 14 RUSKIN  Assembly Third Reading",76,0,3,0,79
62008,1249,2009-05-11,Assembly,"From committee:  Be adopted.  To third reading.",11,0,0,0,11
62009,1250,2009-06-16,Assembly,"Be adopted as amended.",5,1,1,0,7
62009,1251,2009-06-25,Assembly,"HR 16 NAVA  Assembly Third Reading",53,13,13,0,79
62010,1216,2009-06-08,Assembly,"From committee:  Be adopted.  To third reading.",6,1,4,0,11
62010,1217,2009-06-22,Assembly,"HR 17 PEREZ, J.  Assembly Third Reading",47,11,21,0,79
62012,1284,2009-06-30,Assembly,"From committee:  Be adopted.  To third reading.",7,0,4,0,11
62012,1285,2009-07-02,Assembly,"HR 19 COOK  Assembly Third Reading",77,0,2,0,79
62013,1282,2009-09-10,Assembly,"From committee:  Be adopted.  To third reading.",6,4,1,0,11
62013,1283,2009-09-12,Assembly,"HR 20 ENG  Assembly Third Reading",51,26,2,0,79
62015,1248,2010-02-01,Assembly,"From committee:  Be adopted.  To third reading.",10,0,1,0,11
62017,24984,2009-04-21,Senate,"Do pass, but re-refer to the Committee on Appropriations",5,0,0,0,5
62017,24985,2009-05-04,Senate,"Placed on Appropriations Suspense file",11,0,0,0,11
62017,24986,2009-05-28,Senate,"Do pass",12,0,0,0,12
62017,24987,2009-06-01,Senate,"Senate 3rd Reading SB2 Wiggins",36,0,0,0,36
62017,24988,2009-06-17,Assembly,"Do pass and be re-referred to the Committee on Appropriations",7,0,0,0,7
62017,24989,2009-08-27,Assembly,"Do pass",16,0,0,0,16
62017,24990,2009-09-02,Assembly,"SB2 Wiggins  Senate Third Reading  By CHESBRO",75,0,0,0,75
62018,1329,2009-04-29,Senate,"Do pass, but re-refer to the Committee on Appropriations.",4,2,0,0,6
62018,1330,2009-05-18,Senate,"Placed on Appropriations Suspense file.",13,0,0,0,13
62019,8231,2009-03-24,Senate,"Do pass, but re-refer to the Committee on Appropriations",7,3,1,0,11
62019,8232,2009-05-14,Senate,"Senate 3rd Reading SB4 Oropeza",21,14,4,0,39
62019,8233,2009-07-01,Assembly,"Do pass and be re-referred to the Committee on Water, Parks and Wildlife",10,7,2,0,19
62019,8234,2009-07-07,Assembly,"Do pass as amended and be re-referred to the Committee on Appropriations",7,4,2,0,13
62019,8235,2009-08-19,Assembly,"Do pass",11,6,0,0,17
62019,8236,2010-03-18,Assembly,"SB4 Oropeza  Senate Third Reading  By BROWNLEY",37,24,18,0,79
62019,8237,2010-03-22,Assembly,"SB4 Oropeza  Senate Third Reading  By BROWNLEY",42,27,10,0,79
62019,8238,2010-04-15,Senate,"Unfinished Business SB4 Oropeza",21,13,5,0,39
62020,1290,2009-04-21,Senate,"Do pass as amended, and re-refer to the Committee on Appropriations.",7,0,0,0,7
62020,1291,2009-05-18,Senate,"Special Consent #5 SB5 Maldonado",36,0,3,0,39
62020,1292,2009-06-16,Assembly,"Do pass and re-refer to Committee on Appropriations with recommendation:  To Consent Calendar.",7,0,0,0,7
62020,1293,2009-07-01,Assembly,"Do pass.",15,0,1,0,16
62020,21096,2010-08-25,Assembly,"Do pass as amended",6,1,0,0,7
62020,21648,2010-08-30,Assembly,"SB5 Hollingsworth  Third Reading Urgency  By FLETCHER",71,1,0,0,72
62020,21649,2010-08-30,Senate,"W/O REF. TO FILE SB5 Hollingsworth Urgency Clause",33,1,0,0,34
62021,22357,2009-02-19,Senate,"W/O REF. TO FILE SB6 Maldonado",27,11,0,0,38
62021,22358,2009-02-19,Assembly,"SB6 Maldonado  Senate Third Reading  By CALDERON",46,22,0,0,68
62022,1286,2009-04-27,Senate,"Do pass as amended, and re-refer to the Committee on Appropriations.",11,0,0,0,11
62022,1287,2009-06-03,Senate,"Senate 3rd Reading SB7 Wiggins",34,0,5,0,39
62022,1288,2009-07-06,Assembly,"Do pass as amended and be re-referred to the Committee on Appropriations.",10,3,2,0,15
62022,1289,2009-08-19,Assembly,"Do pass.",12,4,1,0,17
62022,20708,2010-08-20,Assembly,"SB7 Wiggins  Senate Third Reading  Amend By BRADFORD  Set #1",48,27,0,0,75
62025,1374,2009-04-14,Senate,"Do pass, but re-refer to the Committee on Revenue and Taxation",6,4,1,0,11
62025,1375,2009-04-22,Senate,"Do pass, but re-refer to the Committee on Appropriations",5,3,0,0,8
62025,1376,2009-05-04,Senate,"Placed on Appropriations Suspense file",11,0,2,0,13
62025,1377,2009-05-28,Senate,"Do pass as amended",7,5,1,0,13
62025,1378,2009-06-02,Senate,"Senate 3rd Reading SB10 Leno",21,16,2,0,39
62025,1379,2009-06-29,Assembly,"Do pass and be re-referred to the Committee on Revenue and Taxation",9,5,0,0,14
62025,1380,2009-07-06,Assembly,"Do pass as amended and be re-referred to the Committee on Appropriations",6,2,1,0,9
62025,1381,2010-03-22,Assembly,"SB 10 Leno  Senate Third Reading  By TORLAKSON",35,29,15,0,79
62026,27069,2009-04-20,Senate,"Do pass",7,0,0,0,7
62026,27070,2009-05-06,Senate,"Senate 3rd Reading SB11 Negrete McLeod",31,3,0,0,34
62026,27071,2009-07-08,Assembly,"Do pass",5,0,0,0,5
62026,27072,2009-08-20,Assembly,"SB 11 Negrete McLeod  Senate Third Reading  By EMMERSON",65,9,0,0,74
62027,1331,2009-04-14,Senate,"Do pass, but re-refer to the Committee on Local Government.",7,3,1,0,11
62027,1332,2009-04-29,Senate,"Do pass as amended, and re-refer to the Committee on Appropriations.",3,2,0,0,5
62027,1333,2009-05-18,Senate,"Placed on Appropriations Suspense file.",13,0,0,0,13
62027,1334,2009-05-28,Senate,"Do pass as amended.",7,5,1,0,13
62027,1335,2009-06-03,Senate,"Senate 3rd Reading SB12 Simitian",26,9,4,0,39
62027,1336,2009-07-09,Assembly,"SB 12 Pavley  Senate Third Reading  By HUFFMAN  Amend By HUFFMAN Set #1",41,25,13,0,79
62027,1337,2009-07-13,Assembly,"SB 12 Simitian  Senate Third Reading",47,20,12,0,79
62027,1338,2009-07-16,Senate,"Unfinished Business SB12 Simitian",0,36,4,0,40
62029,1425,2009-03-03,Senate,"Do pass, but re-refer to the Committee on Rules",6,3,2,0,11
62029,1426,2009-03-16,Senate,"Placed on Appropriations Suspense file",10,0,3,0,13
62029,1427,2009-03-23,Senate,"Do pass as amended",7,5,1,0,13
62029,1428,2009-03-31,Senate,"Senate 3rd Reading SB14 Simitian",21,16,2,0,39
62029,1429,2009-07-06,Assembly,"Do pass and be re-referred to the Committee on Natural Resources",10,5,0,0,15
62029,1430,2009-07-08,Assembly,"Do pass as amended and be re-referred to the Committee on Appropriations",5,3,1,0,9
62029,1431,2009-08-27,Assembly,"Do pass",12,5,0,0,17
62029,1432,2009-09-04,Assembly,"SB 14 Simitian  Senate Third Reading  Amend By FUENTES  Set #1",43,28,8,0,79
62029,1433,2009-09-09,Assembly,"Do pass as amended",10,5,0,0,15
62029,1434,2009-09-12,Senate,"W/O REF. TO FILE SB14 Simitian Concurrence",22,13,5,0,40
62029,1435,2009-09-12,Assembly,"SB 14 Simitian  Senate Third Reading  By KREKORIAN",49,28,2,0,79
62030,1423,2009-03-18,Senate,"Do pass as amended, and re-refer to the Committee on Appropriations",8,0,1,0,9
62030,1424,2009-04-20,Senate,"Placed on Appropriations Suspense file",11,0,2,0,13
62031,1382,2009-02-04,Senate,"Do pass as amended, and re-refer to the Committee on Appropriations",5,1,1,0,7
62031,1383,2009-04-27,Senate,"Placed on Appropriations Suspense file",13,0,0,0,13
62032,25257,2009-04-27,Senate,"Do pass as amended, and re-refer to the Committee on Appropriations",10,0,0,0,10
62032,25258,2009-05-26,Senate,"Do pass",8,0,0,0,8
62032,25259,2009-06-01,Senate,"Senate 3rd Reading SB17 Padilla",38,0,0,0,38
62032,25260,2009-06-22,Assembly,"Do pass and be re-referred to the Committee on Appropriations",14,0,0,0,14
62032,25261,2009-08-27,Assembly,"Do pass",17,0,0,0,17
62032,25262,2009-09-01,Assembly,"SB 17 Padilla  Senate Third Reading  By FUENTES",77,0,0,0,77
62032,25263,2009-09-04,Senate,"Unfinished Business SB17 Padilla",37,0,0,0,37
62033,23611,2009-04-28,Senate,"Do pass as amended",7,0,0,0,7
62033,23612,2009-05-14,Senate,"Special Consent #4 SB18 Oropeza",38,0,0,0,38
62033,23613,2009-06-23,Assembly,"Do pass",7,0,0,0,7
62033,23614,2009-07-13,Assembly,"SB 18 Oropeza  Senate Third Reading",77,0,0,0,77
62034,22953,2009-04-22,Senate,"Do pass as amended, and re-refer to the Committee on Appropriations",9,0,0,0,9
62034,22954,2009-05-26,Senate,"Senate 3rd Reading SB19 Simitian",35,2,0,0,37
62034,22955,2009-07-01,Assembly,"Do pass",7,2,0,0,9
62034,22956,2009-09-03,Assembly,"Do pass and be re-referred to the Committee on Appropriations",8,0,0,0,8
62034,22957,2009-09-04,Assembly,"Do pass as amended",10,0,0,0,10
62034,22958,2009-09-11,Senate,"Unfinished Supp 1 SB19 Simitian",31,7,0,0,38
62034,22959,2009-09-11,Assembly,"SB 19 Simitian  Senate Third Reading  By BROWNLEY",53,20,0,0,73
62035,1470,2009-02-24,Senate,"Do pass as amended, and re-refer to the Committee on Appropriations",3,2,0,0,5
62035,1471,2009-04-27,Senate,"Senate 3rd Reading SB20 Simitian",26,9,4,0,39
62035,1472,2009-06-30,Assembly,"Do pass as amended and be re-referred to the Committee on Appropriations",7,3,0,0,10
62035,1473,2009-08-19,Assembly,"Do pass as amended",12,1,4,0,17
62035,1474,2009-09-01,Assembly,"SB 20 Simitian  Senate Third Reading  By FEUER",56,13,10,0,79
62035,1475,2009-09-04,Senate,"Unfinished Business SB20 Simitian",31,7,2,0,40
62036,1476,2009-03-24,Senate,"Do pass as amended, and re-refer to the Committee on Appropriations",8,2,1,0,11
62036,1477,2009-04-20,Senate,"Placed on Appropriations Suspense file",11,0,2,0,13
62036,1478,2010-01-21,Senate,"Do pass as amended",6,3,2,0,11
62036,1479,2010-01-28,Senate,"SENATE 3RD READING SB21 SIMITIAN",23,10,6,0,39
62036,8727,2010-06-15,Assembly,"Do pass and be re-referred to the Committee on Appropriations",8,3,1,0,12
62036,10152,2010-06-30,Assembly,"Do pass",12,5,0,0,17
62036,20820,2010-08-23,Assembly,"SB 21 Simitian  Senate Third Reading  By HUFFMAN",51,25,0,0,76
62036,21072,2010-08-25,Senate,"Unfinished Business SB21 Simitian",22,11,0,0,33
62037,1480,2010-01-04,Senate,"Do pass, but re-refer to the Committee on Appropriations",5,1,1,0,7
62037,1481,2010-01-25,Senate,"SENATE 3RD READING SB22 SIMITIAN",22,14,3,0,39
62037,10370,2010-06-29,Assembly,"Do pass and be re-referred to the Committee on Appropriations",6,3,0,0,9
62038,22769,2009-04-28,Senate,"Do pass as amended, and re-refer to the Committee on Appropriations",10,0,0,0,10
62038,22770,2009-06-02,Senate,"Senate 3rd Reading SB23 Padilla",36,0,0,0,36
62038,22771,2009-07-08,Assembly,"Do pass as amended and be re-referred to the Committee on 	Appropriations",6,0,0,0,6
62038,22772,2009-08-19,Assembly,"Do pass",16,0,0,0,16
62038,22773,2009-09-01,Assembly,"SB 23 Padilla  Senate Third Reading  By FUENTES",66,6,0,0,72
62038,22774,2009-09-04,Senate,"Unfinished Business SB23 Padilla",38,0,0,0,38
62039,25492,2009-04-21,Senate,"Do pass, but re-refer to the Committee on Appropriations",7,0,0,0,7
62039,25493,2009-05-11,Senate,"Special Consent #3 SB24 Oropeza",36,0,0,0,36
62039,25494,2009-06-16,Assembly,"Do pass and re-refer to Committee on Appropriations with 	recommendation:  To Consent Calendar",7,0,0,0,7
62039,25495,2009-07-01,Assembly,"Do pass, to Consent Calendar",15,0,0,0,15
62039,25496,2009-07-09,Assembly,"SB 24 Oropeza  Consent Calendar Second Day  Regular Session",74,0,0,0,74
62039,25497,2009-08-17,Senate,"Special Consent #14 SB24 Oropeza",35,0,0,0,35
62039,25498,2009-09-08,Assembly,"SB 24 Oropeza  Senate Third Reading  By BERRYHILL, B",79,0,0,0,79
62039,25499,2009-09-10,Senate,"Unfinished Business SB24 Oropeza",33,1,0,0,34
62040,1436,2009-04-27,Senate,"Do pass as amended, and re-refer to the Committee on Appropriations",5,2,0,0,7
62040,1437,2009-05-26,Senate,"Placed on Appropriations Suspense file",13,0,0,0,13
62040,1438,2009-05-28,Senate,"Do pass as amended",7,5,1,0,13
62040,1439,2009-06-02,Senate,"Senate 3rd Reading SB25 Padilla",21,18,0,0,39
62041,1561,2009-04-13,Senate,"Do pass as amended, and re-refer to the Committee on Environmental Quality",8,1,1,0,10
62041,1562,2009-04-20,Senate,"Do pass, but re-refer to the Committee on Appropriations",7,0,0,0,7
62041,1563,2009-05-04,Senate,"Placed on Appropriations Suspense file",11,0,2,0,13
62041,1564,2010-01-28,Senate,"SENATE 3RD READING SB26 SIMITIAN",24,10,5,0,39
62042,23790,2009-03-04,Senate,"Do pass",5,0,0,0,5
62042,23791,2009-03-12,Senate,"Senate 3rd Reading SB27 Hancock",33,0,0,0,33
62042,23792,2009-05-13,Assembly,"Do pass",6,0,0,0,6
62042,23793,2009-05-28,Assembly,"SB 27 Hancock  Third Reading Urgency  By BUCHANAN",78,1,0,0,79
62043,1510,2010-01-12,Senate,"Do pass, but re-refer to the Committee on Appropriations",2,5,0,0,7
62046,1544,2009-04-20,Senate,"Do pass, but re-refer to the Committee on Energy, Utilities and Communications",5,2,0,0,7
62046,1545,2009-04-27,Senate,"Do pass as amended, and re-refer to the Committee on Appropriations",6,3,2,0,11
62046,1546,2009-05-26,Senate,"Do pass",8,5,0,0,13
62046,1547,2009-06-03,Senate,"Senate 3rd Reading SB31 Pavley Reconsider",39,0,0,0,39
62046,9105,2009-06-03,Senate,"Senate 3rd Reading SB31 Pavley",16,19,4,0,39
62047,22563,2009-04-21,Senate,"Do pass as amended, and re-refer to the Committee on Appropriations",10,0,0,0,10
62047,22564,2009-05-18,Senate,"Placed on Appropriations Suspense file",13,0,0,0,13
62047,22565,2009-05-28,Senate,"Do pass as amended",11,0,0,0,11
62047,22566,2009-06-03,Senate,"Senate 3rd Reading SB32 Negrete McLeod",34,0,0,0,34
62047,22567,2009-07-06,Assembly,"Do pass and be re-referred to the Committee on Natural Resources",10,4,0,0,14
62047,22568,2009-07-08,Assembly,"Do pass as amended and be re-referred to the Committee on 	Appropriations",7,1,0,0,8
62047,22569,2009-08-27,Assembly,"Do pass as amended",13,3,0,0,16
62047,22570,2009-09-11,Senate,"Unfinished Supp 1 SB32 Negrete McLeod",37,0,0,0,37
62047,22571,2009-09-11,Assembly,"SB 32 Negrete McLeod  Senate Third Reading  By FUENTES",62,16,0,0,78
62048,22593,2009-04-20,Senate,"Do pass, but re-refer to the Committee on Appropriations",9,0,0,0,9
62048,22594,2009-05-11,Senate,"Senate 3rd Reading SB33 Correa",36,0,0,0,36
62048,22595,2009-06-16,Assembly,"Do pass and be re-referred to the Committee on Appropriations",11,0,0,0,11
62048,22596,2009-07-01,Assembly,"Do pass, to Consent Calendar",15,0,0,0,15
62048,22597,2009-07-09,Assembly,"SB 33 Correa  Consent Calendar Second Day  Regular Session",74,0,0,0,74
62048,22598,2009-07-16,Senate,"Unfinished Business SB33 Correa Concurrence",35,0,0,0,35
62049,1548,2009-03-31,Senate,"Do pass, but re-refer to the Committee on Public Safety",3,2,0,0,5
62049,1549,2009-04-21,Senate,"Do pass, but re-refer to the Committee on Appropriations",5,2,0,0,7
62049,1550,2009-05-14,Senate,"Senate 3rd Reading SB34 Corbett",22,14,3,0,39
62049,1551,2009-07-07,Assembly,"Do pass and be re-referred to the Committee on Appropriations",4,2,1,0,7
62049,1552,2009-08-19,Assembly,"Do pass",12,5,0,0,17
62049,1553,2009-09-02,Assembly,"SB 34 Corbett  Senate Third Reading  By FONG",43,29,7,0,79
62050,1554,2009-04-28,Senate,"Do pass as amended, and re-refer to the Committee on Appropriations",8,2,2,0,12
62050,1555,2009-05-18,Senate,"Placed on Appropriations Suspense file",13,0,0,0,13
62051,23816,2009-04-01,Senate,"Do pass, but re-refer to the Committee on Business, Professions and 	Economic Development",9,0,0,0,9
62051,23817,2009-04-13,Senate,"Do pass as amended, and re-refer to the Committee on Appropriations",7,1,0,0,8
62051,23818,2009-04-27,Senate,"Placed on Appropriations Suspense file",13,0,0,0,13
62051,23819,2009-05-28,Senate,"Do pass",12,0,0,0,12
62051,23820,2009-06-01,Senate,"Senate 3rd Reading SB36 Calderon",36,1,0,0,37
62051,23821,2009-06-29,Assembly,"Do pass and be re-referred to the Committee on Business and 	Professions",10,1,0,0,11
62051,23822,2009-07-07,Assembly,"Do pass and be re-referred to the Committee on Appropriations",11,0,0,0,11
62051,23823,2009-08-27,Assembly,"Do pass as amended",15,0,0,0,15
62051,23824,2009-09-02,Assembly,"SB 36 Calderon  Third Reading Urgency  By NIELLO",72,3,0,0,75
62051,23825,2009-09-08,Senate,"Unfinished Business SB36 Calderon",39,1,0,0,40
62052,25909,2009-04-20,Senate,"Do pass, but re-refer to the Committee on Appropriations",7,0,0,0,7
62052,25910,2009-05-11,Senate,"Senate 3rd Reading SB37 Strickland",36,0,0,0,36
62052,25911,2009-07-08,Assembly,"Do pass and be re-referred to the Committee on Appropriations",6,0,0,0,6
62052,25912,2009-08-19,Assembly,"Do pass, to Consent Calendar",17,0,0,0,17
62052,25913,2009-08-27,Assembly,"SB 37 Strickland  Consent Calendar Second Day  Regular Session",74,0,0,0,74
62052,25914,2009-09-02,Senate,"Unfinished Business SB37 Strickland",35,0,0,0,35
62053,1556,2009-04-21,Senate,"Do pass, but re-refer to the Committee on Appropriations",5,0,2,0,7
62053,1557,2009-05-11,Senate,"Placed on Appropriations Suspense file",13,0,0,0,13
62053,1558,2009-05-28,Senate,"Do pass as amended",8,3,2,0,13
62053,1559,2009-06-01,Senate,"Senate 3rd Reading SB38 Alquist",25,9,5,0,39
62053,1560,2009-06-23,Assembly,"Do pass and be re-referred to the Committee on Appropriations",7,0,0,0,7
62054,22324,2009-05-05,Senate,"Do pass as amended",5,0,0,0,5
62054,22325,2009-05-18,Senate,"Special Consent #5 SB39 Benoit",36,0,0,0,36
62054,22326,2009-06-23,Assembly,"Do pass as amended, to Consent Calendar",10,0,0,0,10
62054,22327,2009-07-01,Assembly,"SB 39 Benoit  Consent Calendar Second Day",76,0,0,0,76
62054,22328,2009-07-16,Senate,"Special Consent #13 SB39 Benoit",36,0,0,0,36
62055,22505,2009-03-24,Senate,"Do pass as amended",5,0,0,0,5
62055,22506,2009-04-20,Senate,"Senate 3rd Reading SB40 Correa",33,0,0,0,33
62055,22507,2009-06-23,Assembly,"Do pass, to Consent Calendar",10,0,0,0,10
62055,22508,2009-08-20,Assembly,"SB 40 Correa  Senate Third Reading  By DUVALL",78,0,0,0,78
62055,22509,2009-08-31,Senate,"Special Consent #17 SB40 Correa",36,0,0,0,36
62056,1598,2009-04-28,Senate,"Do pass, but re-refer to the Committee on Appropriations",5,2,0,0,7
62056,1599,2009-05-11,Senate,"Placed on Appropriations Suspense file",13,0,0,0,13
62056,1600,2009-05-28,Senate,"Do pass as amended",7,5,1,0,13
62056,1601,2009-06-01,Senate,"Senate 3rd Reading SB41 Lowenthal",21,14,4,0,39
62056,1602,2009-06-30,Assembly,"Do pass and be re-referred to the Committee on Appropriations",4,2,1,0,7
62056,1603,2009-08-19,Assembly,"Do pass",12,5,0,0,17
62056,1604,2009-09-08,Assembly,"SB 41 Lowenthal  Senate Third Reading  By MA",48,30,1,0,79
62056,1605,2009-09-10,Senate,"Unfinished Business SB41 Lowenthal Concurrence",23,14,3,0,40
62057,1606,2009-03-24,Senate,"Do pass, but re-refer to the Committee on Energy, Utilities and Communications",6,3,2,0,11
62058,23273,2009-04-20,Senate,"Do pass, but re-refer to the Committee on Judiciary",8,1,0,0,9
62058,23274,2009-06-01,Senate,"Senate 3rd Reading SB43 Alquist",37,2,0,0,39
62058,23275,2009-07-06,Assembly,"Be referred to Committee on Local Government",6,3,0,0,9
62058,23276,2009-07-08,Assembly,"Do pass as amended",5,2,0,0,7
62058,23277,2009-09-03,Assembly,"SB 43 Alquist  Senate Third Reading  By TORRICO",56,14,0,0,70
62058,23278,2009-09-09,Senate,"From committee:  That the Assembly Amendments be concurred in",5,0,0,0,5
62058,23279,2009-09-10,Senate,"Unfinished Supp 1 SB43 Alquist Concurrence",34,4,0,0,38
62059,1607,2009-04-27,Senate,"Do pass, but re-refer to the Committee on Appropriations",2,5,0,0,7
62059,1608,2009-04-27,Senate,"Set, first hearing.  Failed passage in Committee.  Reconsideration granted",6,0,1,0,7
62060,1609,2009-03-25,Senate,"Do pass, but re-refer to the Committee on Appropriations",4,0,2,0,6
62060,1610,2009-05-06,Senate,"Senate 3rd Reading SB45 Padilla",21,11,7,0,39
62060,1611,2009-07-08,Assembly,"Do pass and be re-referred to the Committee on Appropriations",5,2,0,0,7
62060,1612,2009-08-19,Assembly,"Do pass",12,5,0,0,17
62060,1613,2009-09-01,Assembly,"SB 45 Padilla  Senate Third Reading  By MONNING",47,28,4,0,79
62060,1614,2009-09-09,Senate,"Unfinished Business SB45 Padilla",23,15,2,0,40
62061,1681,2010-01-12,Senate,"Do pass, but re-refer to the Committee on Appropriations",2,5,0,0,7
62063,25769,2009-05-06,Senate,"Do pass as amended",8,0,0,0,8
62063,25770,2009-06-01,Senate,"Senate 3rd Reading SB48 Alquist",32,5,0,0,37
62063,25771,2009-07-07,Assembly,"Do pass",9,0,0,0,9
62063,25772,2009-07-13,Assembly,"SB 48 Alquist  Senate Third Reading  By BLOCK",66,10,0,0,76
62063,25773,2009-08-24,Senate,"Unfinished Business SB48 Alquist Concurrence",24,11,0,0,35
62065,1594,2009-04-21,Senate,"Do pass as amended, and re-refer to the Committee on Appropriations",7,0,0,0,7
62065,1595,2009-05-11,Senate,"Placed on Appropriations Suspense file",13,0,0,0,13
62065,1596,2009-05-28,Senate,"Do pass as amended",12,0,1,0,13
62065,1597,2009-06-03,Senate,"Special Consent #8 SB50 Corbett",39,0,0,0,39
62066,1723,2009-03-24,Senate,"Do pass, but re-refer to the Committee on Environmental Quality",10,0,1,0,11
62066,1724,2009-04-27,Senate,"Do pass as amended, and re-refer to the Committee on Appropriations",7,0,0,0,7
62066,1725,2009-05-18,Senate,"Placed on Appropriations Suspense file",13,0,0,0,13
62066,1726,2009-05-28,Senate,"Do pass as amended",10,2,1,0,13
62066,1727,2009-06-03,Senate,"Senate 3rd Reading SB51 Ducheny",37,0,2,0,39
62066,9109,2010-06-17,Assembly,"Be referred to Committee on Water, Parks and Wildlife",9,0,2,0,11
62066,9798,2010-06-29,Assembly,"Do pass as amended and be re-referred to the Committee on Appropriations",10,3,0,0,13
62066,19948,2010-08-12,Assembly,"Do pass",12,5,0,0,17
62066,21902,2010-08-31,Assembly,"SB 51 Ducheny  Senate Third Reading  By SALAS",51,25,0,0,76
62066,21903,2010-08-31,Senate,"W/O REF. TO FILE SB51 Ducheny Concurrence",26,4,0,0,30
62067,22493,2009-04-28,Senate,"Do pass, but re-refer to the Committee on Appropriations Recommend 	Consent",12,0,0,0,12
62067,22494,2009-05-26,Senate,"Special Consent #6 SB52 Correa",39,0,0,0,39
62067,22495,2009-06-23,Assembly,"Do pass and re-refer to Committee on Appropriations with 	recommendation:  To Consent Calendar",7,0,0,0,7
62067,22496,2009-07-01,Assembly,"Do pass, to Consent Calendar",15,0,0,0,15
62067,22497,2009-07-09,Assembly,"SB 52 Correa  Consent Calendar Second Day  Regular Session",74,0,0,0,74
62067,22498,2009-08-17,Senate,"Special Consent #14 SB52 Correa",35,0,0,0,35
62068,25429,2009-03-24,Senate,"Do pass, but re-refer to the Committee on Appropriations",5,0,0,0,5
62068,25430,2009-04-16,Senate,"Senate 3rd Reading SB53 DeSaulnier",36,0,0,0,36
62068,25431,2009-06-23,Assembly,"Do pass and re-refer to Committee on Appropriations with 	recommendation:  To Consent Calendar",10,0,0,0,10
62068,25432,2009-07-01,Assembly,"Do pass, to Consent Calendar",15,0,0,0,15
62068,25433,2009-07-09,Assembly,"SB 53 DeSaulnier  Consent Calendar Second Day  Regular Session",74,0,0,0,74
62069,25141,2009-04-01,Senate,"Do pass, but re-refer to the Committee on Judiciary",8,3,0,0,11
62069,25142,2009-04-14,Senate,"Do pass, but re-refer to the Committee on Appropriations",3,2,0,0,5
62069,25143,2009-05-14,Senate,"Senate 3rd Reading SB54 Leno",24,14,0,0,38
62069,25144,2009-06-23,Assembly,"Do pass and be re-referred to the Committee on Judiciary",13,5,0,0,18
62069,25145,2009-07-09,Assembly,"Do pass as amended",7,3,0,0,10
62069,25146,2009-09-03,Assembly,"SB 54 Leno  Senate Third Reading  By FEUER",47,29,0,0,76
62069,25147,2009-09-08,Senate,"From committee:  That the Assembly Amendments be concurred in",3,2,0,0,5
62069,25148,2009-09-09,Senate,"Unfinished Business SB54 Leno",23,14,0,0,37
62070,25367,2009-04-20,Senate,"Do pass as amended, and re-refer to the Committee on Appropriations",5,2,0,0,7
62070,25368,2009-05-28,Senate,"Senate 3rd Reading SB55 Corbett",29,4,0,0,33
62070,25369,2009-07-06,Assembly,"Do pass and be re-referred to the Committee on Appropriations",9,0,0,0,9
62070,25370,2009-08-19,Assembly,"Do pass, to Consent Calendar",17,0,0,0,17
62070,25371,2010-01-04,Assembly,"SB 55 Corbett  Third Reading Urgency  By FEUER",59,0,0,0,59
62070,25372,2010-01-06,Senate,"UNFINISHED BUSINESS SB55 CORBETT URGENCY CLAUSE",32,0,0,0,32
62071,1719,2009-04-22,Senate,"Do pass as amended, and re-refer to the Committee on Appropriations",7,4,0,0,11
62071,1720,2009-05-18,Senate,"Placed on Appropriations Suspense file",13,0,0,0,13
62071,1721,2010-01-21,Senate,"Do pass",6,3,2,0,11
62071,1722,2010-01-28,Senate,"SENATE 3RD READING SB56 ALQUIST",21,12,6,0,39
62071,8784,2010-06-15,Assembly,"Do pass and be re-referred to the Committee on Appropriations",12,4,3,0,19
62071,20382,2010-08-12,Assembly,"Do pass as amended",12,5,0,0,17
62071,20839,2010-08-23,Assembly,"SB 56 Alquist  Senate Third Reading  By MONNING",50,26,0,0,76
62071,21097,2010-08-25,Senate,"Unfinished Business SB56 Alquist",22,10,0,0,32
62072,1716,2009-04-22,Senate,"Do pass, but re-refer to the Committee on Appropriations",2,5,4,0,11
62072,1717,2009-04-22,Senate,"Set, first hearing.  Failed passage in Committee.  Reconsideration granted",7,0,4,0,11
62072,1718,2009-04-29,Senate,"Do pass, but re-refer to the Committee on Appropriations",2,6,3,0,11
62073,1679,2009-04-27,Senate,"Do pass, but re-refer to the Committee on Judiciary",7,0,3,0,10
62073,1680,2009-05-11,Senate,"Placed on Appropriations Suspense file",7,4,2,0,13
62074,1771,2009-04-28,Senate,"Do pass",3,4,0,0,7
62074,1772,2009-04-28,Senate,"Set, second hearing.  Failed passage in Committee. Reconsideration granted",7,0,0,0,7
62074,1773,2010-01-12,Senate,"Do pass",3,4,0,0,7
62075,1774,2009-04-14,Senate,"Do pass, but re-refer to the Committee on Appropriations",6,4,1,0,11
62075,1775,2009-04-27,Senate,"Placed on Appropriations Suspense file",13,0,0,0,13
62075,1776,2009-05-28,Senate,"Do pass as amended",7,5,1,0,13
62075,1777,2009-06-01,Senate,"Senate 3rd Reading SB60 Cedillo",24,15,0,0,39
62076,1778,2009-04-16,Senate,"Senate 3rd Reading SB61 Committee on B. & F.R. (Ducheny)",22,14,3,0,39
62076,1779,2009-05-21,Assembly,"SB 61 B.& F. R.  Senate Third Reading",52,3,25,0,80
62076,1780,2009-05-21,Senate,"W/O REF. TO FILE SB61 Committee on B. & F.R. (Ducheny) Concurrence",0,36,3,0,39
62077,1728,2009-04-16,Senate,"Senate 3rd Reading SB62 Committee on B. & F.R. (Ducheny)",22,14,3,0,39
62077,1729,2009-06-24,Assembly,"SB 62 B.& F. R.  Third Reading Urgency  WITHOUT REFERENCE TO FILE",48,30,1,0,79
62077,1730,2009-09-12,Assembly,"SB 62 Simitian  Senate Third Reading  By KREKORIAN",50,23,6,0,79
62077,1731,2009-09-12,Senate,"W/O REF. TO FILE SB62 Simitian",23,14,3,0,40
62078,23667,2009-04-16,Senate,"Senate 3rd Reading SB63 Committee on B. & F.R. (Ducheny)",22,14,0,0,36
62078,23668,2009-07-24,Senate,"W/O REF. TO FILE SB63 Strickland Concurrence",22,15,0,0,37
62078,23669,2009-07-24,Assembly,"SB 63 Strickland  Senate Third Reading",54,20,0,0,74
62079,1763,2009-04-16,Senate,"Senate 3rd Reading SB64 Committee on B. & F.R. (Ducheny)",22,14,3,0,39
62079,1764,2009-06-25,Assembly,"SB 64 B.& F. R.  Third Reading Urgency  By EVANS",68,0,11,0,79
62079,1765,2009-06-25,Senate,"W/O REF. TO FILE SB64 Committee on B. & F.R. (Ducheny) Concurrence",21,14,5,0,40
62079,1766,2009-06-25,Senate,"W/O REF. TO FILE SB64 Committee on B. & F.R. (Ducheny) Reconsider",34,0,6,0,40
62079,1767,2009-06-29,Senate,"Unfinished Business SB64 Committee on B. & F.R. (Ducheny) Concurrence",21,15,4,0,40
62079,1768,2009-06-29,Senate,"Unfinished Business SB64 Committee on B. & F.R. (Ducheny) Suspend Senate Rules",23,13,4,0,40
62079,1769,2009-06-29,Senate,"Unfinished Business SB64 Committee on B. & F.R. (Ducheny) Reconsider",23,13,4,0,40
62079,1770,2009-06-30,Senate,"Unfinished Business SB64 Committee on B. & F.R. (Ducheny) Concurrence",25,14,1,0,40
62080,23644,2009-04-16,Senate,"Senate 3rd Reading SB65 Committee on B. & F.R. (Ducheny)",22,14,0,0,36
62080,23645,2009-09-11,Assembly,"SB 65 B.& F. R.  Third Reading Urgency  By EVANS",64,10,0,0,74
62080,23646,2009-09-12,Senate,"Unfinished Supp 1 SB65 Committee on B. & F.R. (Ducheny) Urgency 	Clause",26,1,0,0,27
62080,23647,2009-09-12,Senate,"Unfinished Supp 1 SB65 Committee on B. & F.R. (Ducheny) Reconsider",39,0,0,0,39
62080,23648,2009-10-14,Senate,"Unfinished Business SB65 Committee on B. & F.R. (Ducheny) Urgency 	Clause",38,0,0,0,38
62081,22232,2009-04-16,Senate,"Senate 3rd Reading SB66 Committee on B. & F.R. (Ducheny)",22,14,0,0,36
62081,22233,2009-09-11,Assembly,"SB 66 Price  Third Reading Urgency  By PEREZ, V.M",77,1,0,0,78
62081,22234,2009-09-12,Senate,"Unfinished Supp 1 SB66 Price Urgency Clause",26,0,0,0,26
62081,22235,2009-09-12,Senate,"Unfinished Supp 1 SB66 Price Reconsider",39,0,0,0,39
62081,22236,2009-10-14,Senate,"Unfinished Business SB66 Price Urgency Clause",37,0,0,0,37
62082,25187,2009-04-16,Senate,"Senate 3rd Reading SB67 Committee on B. & F.R. (Ducheny)",22,14,0,0,36
62082,25188,2009-09-11,Assembly,"SB 67 B.& F. R.  Third Reading Urgency",62,12,0,0,74
62082,25189,2009-09-12,Senate,"Unfinished Supp 1 SB67 Committee on B. & F.R. (Ducheny) Urgency 	Clause",26,1,0,0,27
62082,25190,2009-09-12,Senate,"Unfinished Supp 1 SB67 Committee on B. & F.R. (Ducheny) Reconsider",39,0,0,0,39
62082,25191,2009-10-14,Senate,"Unfinished Business SB67 Committee on B. & F.R. (Ducheny) Urgency 	Clause",37,0,0,0,37
62083,22302,2009-04-16,Senate,"Senate 3rd Reading SB68 Committee on B. & F.R. (Ducheny)",22,14,0,0,36
62083,22303,2009-09-11,Assembly,"Do pass as amended",8,4,0,0,12
62083,22304,2009-11-02,Assembly,"SB 68 B.& F. R.  Third Reading Urgency  By EVANS",56,12,0,0,68
62083,22305,2009-11-03,Senate,"Unfinished Business SB68 Committee on B. & F.R. (Ducheny) Urgency 	Clause",30,5,0,0,35
62084,1827,2009-04-16,Senate,"Senate 3rd Reading SB69 Committee on B. & F.R. (Ducheny)",22,14,3,0,39
62084,1828,2009-11-02,Assembly,"SB 69 B.& F. R.  Third Reading Urgency  By EVANS",68,0,11,0,79
62084,1829,2009-11-04,Senate,"Unfinished Business SB69 Committee on B. & F.R. (Ducheny) Urgency Clause",23,12,5,0,40
62085,25354,2009-04-16,Senate,"Senate 3rd Reading SB70 Committee on B. & F.R. (Ducheny)",22,14,0,0,36
62085,25355,2010-03-22,Assembly,"SB 70 B.& F. R.  Senate Third Reading  By BLUMENFIELD",70,2,0,0,72
62085,25356,2010-03-22,Senate,"W/O REF. TO FILE SB70 Committee on B. & F.R. (Ducheny)",25,10,0,0,35
62086,26162,2009-04-16,Senate,"Senate 3rd Reading SB71 Committee on B. & F.R. (Ducheny)",22,14,0,0,36
62086,26163,2010-03-22,Assembly,"Do pass",16,0,0,0,16
62086,26164,2010-03-22,Assembly,"SB 71 B.& F. R.  Third Reading Urgency  By BLUMENFIELD",74,0,0,0,74
62086,26165,2010-03-22,Senate,"W/O REF. TO FILE SB71 Committee on B. & F.R. Urgency Clause",36,0,0,0,36
62087,22607,2009-04-16,Senate,"Senate 3rd Reading SB72 Committee on B. & F.R. (Ducheny)",22,14,0,0,36
62087,22608,2009-09-08,Assembly,"SB 72 B.& F. R.  Senate Third Reading  By EVANS",63,9,0,0,72
62087,22609,2009-09-10,Senate,"Unfinished Business SB72 Committee on B. & F.R. (Ducheny) 	Concurrence",21,14,0,0,35
62088,23334,2009-04-16,Senate,"Senate 3rd Reading SB73 Committee on B. & F.R. (Ducheny)",22,14,0,0,36
62088,23335,2009-09-08,Assembly,"SB 73 B.& F. R.  Senate Third Reading  By EVANS",51,22,0,0,73
62088,23336,2009-09-10,Senate,"Unfinished Business SB73 Committee on B. & F.R. (Ducheny) 	Concurrence",22,15,0,0,37
62089,1819,2009-04-16,Senate,"Senate 3rd Reading SB74 Committee on B. & F.R. (Ducheny)",22,14,3,0,39
62089,1820,2009-06-25,Senate,"W/O REF. TO FILE SB74 Committee on B. & F.R. (Ducheny) Concurrence",24,14,2,0,40
62089,1821,2009-06-25,Senate,"W/O REF. TO FILE SB74 Committee on B. & F.R. (Ducheny) Reconsider",34,0,6,0,40
62089,1822,2009-06-25,Assembly,"SB 74 B.& F. R.  Third Reading Urgency  By EVANS",73,2,4,0,79
62089,1823,2009-06-29,Senate,"Unfinished Business SB74 Committee on B. & F.R. (Ducheny) Urgency Clause",23,14,3,0,40
62089,1824,2009-06-29,Senate,"Unfinished Business SB74 Committee on B. & F.R. (Ducheny) Reconsider",23,13,4,0,40
62089,1825,2009-06-29,Senate,"Unfinished Business SB74 Committee on B. & F.R. (Ducheny) Suspend Senate Rules",23,13,4,0,40
62089,1826,2009-06-30,Senate,"Unfinished Business SB74 Committee on B. & F.R. (Ducheny) Concurrence",25,14,1,0,40
62090,22599,2009-04-16,Senate,"Senate 3rd Reading SB75 Committee on B. & F.R. (Ducheny)",22,14,0,0,36
62090,22600,2009-09-08,Assembly,"SB 75 B.& F. R.  Senate Third Reading  By EVANS",58,14,0,0,72
62090,22601,2009-09-10,Senate,"Unfinished Business SB75 Committee on B. & F.R. (Ducheny)",33,4,0,0,37
62091,1818,2009-04-16,Senate,"Senate 3rd Reading SB76 Committee on B. & F.R. (Ducheny)",22,14,3,0,39
62091,20957,2010-08-23,Assembly,"SB 76 PUB. S.  Third Reading Urgency  By HUBER",75,1,0,0,76
62091,21243,2010-08-25,Senate,"Unfinished Business SB76 Committee on Pub. S. (Leno) Urgency Clause",32,0,0,0,32
62092,27160,2009-04-16,Senate,"Senate 3rd Reading SB77 Committee on B. & F.R. (Ducheny)",22,14,0,0,36
62092,27161,2010-03-22,Assembly,"SB 77 B.& F. R.  Senate Third Reading  By SKINNER  Amend By SKINNER 	Set #1",44,22,0,0,66
62092,27162,2010-04-07,Assembly,"Do pass",10,3,0,0,13
62092,27163,2010-04-08,Assembly,"SB 77 Pavley  Third Reading Urgency  By SKINNER",60,10,0,0,70
62092,27164,2010-04-08,Senate,"W/O REF. TO FILE SB77 Pavley Urgency Clause",33,0,0,0,33
62093,4452,2009-04-16,Senate,"Senate 3rd Reading SB78 Committee on B. & F.R. (Ducheny)",22,14,3,0,39
62094,4616,2009-04-16,Senate,"Senate 3rd Reading SB79 Committee on B. & F.R. (Ducheny)",22,14,3,0,39
62095,1871,2009-04-16,Senate,"Senate 3rd Reading SB80 Committee on B. & F.R. (Ducheny)",22,14,3,0,39
62095,1872,2009-06-25,Senate,"W/O REF. TO FILE SB80 Committee on B. & F.R. (Ducheny) Concurrence",23,14,3,0,40
62095,1873,2009-06-25,Senate,"W/O REF. TO FILE SB80 Committee on B. & F.R. (Ducheny) Reconsider",34,0,6,0,40
62095,1874,2009-06-25,Assembly,"SB 80 B.& F. R.  Third Reading Urgency  By EVANS",58,3,18,0,79
62095,1875,2009-06-29,Senate,"Unfinished Business SB80 Committee on B. & F.R. (Ducheny) Suspend Senate Rules",23,13,4,0,40
62095,1876,2009-06-30,Senate,"Unfinished Business SB80 Committee on B. & F.R. (Ducheny) Concurrence",25,14,1,0,40
62095,9114,2009-06-29,Senate,"Unfinished Business SB80 Committee on B. & F.R. (Ducheny) Urgency Clause",24,14,2,0,40
62095,9115,2009-06-29,Senate,"Unfinished Business SB80 Committee on B. & F.R. (Ducheny) Reconsider",23,13,4,0,40
62096,1877,2009-04-16,Senate,"Senate 3rd Reading SB81 Committee on B. & F.R. (Ducheny)",22,14,3,0,39
62096,1878,2009-09-11,Assembly,"SB 81 Alquist  Third Reading Urgency  By LIEU",77,0,2,0,79
62096,1879,2009-09-12,Senate,"Unfinished Supp 1 SB81 Alquist Reconsider",39,0,1,0,40
62096,1880,2009-10-14,Senate,"Unfinished Business SB81 Alquist Urgency Clause",38,0,2,0,40
62096,9116,2009-09-12,Senate,"Unfinished Supp 1 SB81 Alquist Concurrence",26,0,14,0,40
62097,8296,2009-04-16,Senate,"Senate 3rd Reading SB82 Committee on B. & F.R. (Ducheny)",22,14,3,0,39
62097,8297,2009-09-04,Assembly,"SB 82 B.& F. R.  Senate Third Reading  Amend By TORRICO  Set #1",43,28,8,0,79
62097,8298,2010-04-12,Assembly,"Be referred to Committee on Higher Education",10,0,1,0,11
62097,9264,2010-06-22,Assembly,"Do pass",9,0,0,0,9
62097,20567,2010-08-19,Assembly,"SB 82 Hancock  Senate Third Reading  By CHESBRO",73,4,0,0,77
62097,21353,2010-08-26,Senate,"From committee:  That the Assembly Amendments be concurred in",7,0,0,0,7
62097,21586,2010-08-27,Senate,"Unfinished Business SB82 Hancock",32,3,0,0,35
62098,22298,2009-04-16,Senate,"Senate 3rd Reading SB83 Committee on B. & F.R. (Ducheny)",22,14,0,0,36
62098,22299,2009-09-04,Assembly,"SB 83 B.& F. R.  Senate Third Reading  Amend By TORRICO  Set #1",43,28,0,0,71
62098,22300,2009-09-09,Assembly,"SB 83 Hancock  Senate Third Reading  By ENG",46,31,0,0,77
62098,22301,2009-09-10,Senate,"Unfinished Supp 1 SB83 Hancock Concurrence",23,17,0,0,40
62099,1881,2009-04-16,Senate,"Senate 3rd Reading SB84 Committee on B. & F.R. (Ducheny)",22,14,3,0,39
62099,1882,2009-09-04,Assembly,"SB 84 B.& F. R.  Senate Third Reading  Amend By TORRICO  Set #1",43,28,8,0,79
62099,1883,2009-09-10,Assembly,"Do pass as amended",11,5,0,0,16
62099,1884,2009-09-11,Assembly,"SB 84 Steinberg  Senate Third Reading  By TORLAKSON",54,22,3,0,79
62099,1885,2009-09-11,Senate,"Unfinished Supp 2 SB84 Steinberg Concurrence",25,11,4,0,40
62100,25903,2009-04-16,Senate,"Senate 3rd Reading SB85 Committee on B. & F.R. (Ducheny)",22,14,0,0,36
62100,25904,2009-09-10,Assembly,"Do pass as amended",15,0,0,0,15
62100,25905,2009-09-11,Assembly,"SB 85 Cogdill  Senate Third Reading  By HAYASHI",77,1,0,0,78
62100,25906,2010-01-27,Assembly,"SB 85 Cogdill  Senate Third Reading  By YAMADA",71,0,0,0,71
62100,25907,2010-02-10,Senate,"From committee:  That the Assembly Amendments be concurred in",5,0,0,0,5
62100,25908,2010-02-11,Senate,"Unfinished Business SB85 Cogdill",35,0,0,0,35
62101,1815,2009-04-16,Senate,"Senate 3rd Reading SB86 Committee on B. & F.R. (Ducheny)",22,14,3,0,39
62101,1816,2009-09-08,Assembly,"SB 86 Yee  Senate Third Reading  By PORTANTINO",77,1,1,0,79
62101,1817,2009-09-10,Senate,"Unfinished Business SB86 Yee Concurrence",32,5,3,0,40
62102,4081,2009-04-16,Senate,"Senate 3rd Reading SB87 Committee on B. & F.R. (Ducheny)",22,14,3,0,39
62103,4288,2009-04-16,Senate,"Senate 3rd Reading SB88 Committee on B. & F.R. (Ducheny)",22,14,3,0,39
62103,4289,2009-09-04,Assembly,"SB 88 B.& F. R.  Senate Third Reading  Amend By TORRICO  Set #1",43,28,8,0,79
62103,4290,2009-09-08,Assembly,"SB 88 DeSaulnier  Senate Third Reading  By TORRICO",47,28,4,0,79
62103,4291,2010-05-06,Assembly,"Be referred to Committee on Transportation",10,0,1,0,11
62103,8914,2010-06-14,Assembly,"Do pass as amended and be re-referred to the Committee on Appropriations",12,0,2,0,14
62103,19571,2010-08-04,Assembly,"Do pass",17,0,0,0,17
62103,20412,2010-08-16,Assembly,"SB 88 DeSaulnier  Senate Third Reading",72,0,0,0,72
62103,20413,2010-08-18,Senate,"From committee:  That the Assembly Amendments be concurred in",7,1,0,0,8
62103,20614,2010-08-19,Senate,"Unfinished Business SB88 DeSaulnier",34,1,0,0,35
62104,22295,2009-04-16,Senate,"Senate 3rd Reading SB89 Committee on B. & F.R. (Ducheny)",22,14,0,0,36
62104,22296,2009-12-10,Assembly,"SB 89 B.& F. R.  Third Reading Urgency  By CHESBRO",69,0,0,0,69
62104,22297,2009-12-17,Senate,"Unfinished Business SB89 Committee on B. & F.R. (Ducheny) Urgency 	Clause",30,3,0,0,33
62105,23399,2009-04-16,Senate,"Senate 3rd Reading SB90 Committee on B. & F.R. (Ducheny)",22,14,0,0,36
62105,23400,2009-07-15,Assembly,"Do pass as amended",11,0,0,0,11
62105,23401,2009-07-24,Senate,"W/O REF. TO FILE SB90 Ducheny Urgency Clause",29,3,0,0,32
62105,23402,2009-07-24,Assembly,"SB 90 B.& F. R.  Senate Third Reading  By EVANS",56,22,0,0,78
62106,23299,2009-04-22,Senate,"Do pass, but re-refer to the Committee on Appropriations",7,1,0,0,8
62106,23300,2009-05-04,Senate,"Do pass",9,1,0,0,10
62106,23301,2009-05-11,Senate,"Senate 3rd Reading SB91 Correa",31,2,0,0,33
62106,23302,2009-06-15,Assembly,"Do pass and be re-referred to the Committee on Appropriations",9,0,0,0,9
62106,23303,2009-07-01,Assembly,"Do pass as amended",15,0,0,0,15
62106,23304,2009-07-13,Assembly,"SB 91 Correa  Senate Third Reading  By DUVALL",75,0,0,0,75
62106,23305,2009-07-16,Senate,"Unfinished Business SB91 Correa Concurrence",31,2,0,0,33
62107,1923,2009-04-29,Senate,"Do pass, but re-refer to the Committee on Appropriations",1,6,4,0,11
62107,1924,2009-04-29,Senate,"Set, first hearing.  Failed passage in Committee.  Reconsideration granted",7,0,4,0,11
62108,23206,2009-03-04,Senate,"Do pass as amended",5,0,0,0,5
62108,23207,2009-05-21,Senate,"Senate 3rd Reading SB93 Kehoe",34,0,0,0,34
62108,23208,2009-07-08,Assembly,"Do pass as amended",7,0,0,0,7
62108,23209,2009-09-02,Assembly,"SB 93 Kehoe  Senate Third Reading  By BLOCK",77,0,0,0,77
62108,23210,2009-09-08,Senate,"Unfinished Business SB93 Kehoe",39,0,0,0,39
62109,26646,2009-04-01,Senate,"Do pass, but re-refer to the Committee on Rules",7,2,0,0,9
62109,26647,2009-04-21,Senate,"Do pass as amended, and re-refer to the Committee on 	Appropriations",3,2,0,0,5
62109,26648,2009-05-21,Senate,"Senate 3rd Reading SB94 Calderon",21,14,0,0,35
62109,26649,2009-07-06,Assembly,"Do pass and be re-referred to the Committee on Judiciary",9,1,0,0,10
62109,26650,2009-07-09,Assembly,"Do pass as amended and be re-referred to the Committee on 	Appropriations",8,2,0,0,10
62109,26651,2009-08-19,Assembly,"Do pass",13,3,0,0,16
62109,26652,2009-09-02,Assembly,"SB 94 Calderon  Third Reading Urgency  By LIEU",62,10,0,0,72
62109,26653,2009-09-08,Senate,"Unfinished Business SB94 Calderon Urgency Clause",36,4,0,0,40
62110,22960,2009-03-31,Senate,"Do pass as amended, and re-refer to the Committee on 	Appropriations",3,2,0,0,5
62110,22961,2009-05-11,Senate,"Placed on Appropriations Suspense file",13,0,0,0,13
62110,22962,2009-05-28,Senate,"Do pass as amended",7,5,0,0,12
62110,22963,2009-06-02,Senate,"Senate 3rd Reading SB95 Corbett",18,19,0,0,37
62110,22964,2009-06-02,Senate,"Senate 3rd Reading SB95 Corbett Reconsider",39,0,0,0,39
62110,22965,2009-06-03,Senate,"Senate 3rd Reading SB95 Corbett",21,17,0,0,38
62110,22966,2009-06-30,Assembly,"Do pass as amended and be re-referred to the Committee on 	Appropriations",10,0,0,0,10
62110,22967,2009-07-15,Assembly,"Do pass",11,3,0,0,14
62110,22968,2009-08-20,Assembly,"SB 95 Corbett  Senate Third Reading  By TORRICO",46,23,0,0,69
62110,22969,2009-09-02,Senate,"Unfinished Business SB95 Corbett",21,10,0,0,31
62113,23808,2009-04-15,Senate,"Do pass as amended, and re-refer to the Committee on 	Appropriations",10,0,0,0,10
62113,23809,2009-05-04,Senate,"Placed on Appropriations Suspense file",11,0,0,0,11
62113,23810,2009-05-28,Senate,"Do pass as amended",12,0,0,0,12
62113,23811,2009-06-02,Senate,"Senate 3rd Reading SB98 Calderon",37,1,0,0,38
62113,23812,2009-06-25,Assembly,"Do pass as amended and be re-referred to the Committee on 	Appropriations",10,0,0,0,10
62113,23813,2009-08-27,Assembly,"Do pass",16,0,0,0,16
62113,23814,2009-09-02,Assembly,"SB 98 Calderon  Senate Third Reading  By COTO",72,1,0,0,73
62113,23815,2009-09-08,Senate,"Unfinished Business SB98 Calderon",40,0,0,0,40
62114,26183,2009-03-04,Senate,"Do pass, but re-refer to the Committee on Appropriations Recommend 	Consent",5,0,0,0,5
62114,26184,2009-05-26,Senate,"Special Consent #6 SB99 Committee on L.Gov (Negrete McLeo",39,0,0,0,39
62114,26185,2009-07-01,Assembly,"Do pass and be re-referred to the Committee on Appropriations to 	Consent Calendar",7,0,0,0,7
62114,26186,2009-08-27,Assembly,"Do pass as amended",17,0,0,0,17
62114,26187,2009-09-08,Assembly,"SB 99 L. GOV.  Senate Third Reading  By SILVA",78,0,0,0,78
62114,26188,2009-09-10,Senate,"Unfinished Business SB99 Committee on L.Gov (Wiggins) Concurrence",37,0,0,0,37
62115,1969,2009-04-01,Senate,"Do pass as amended, and re-refer to the Committee on Appropriations",6,0,3,0,9
62115,1970,2009-04-27,Senate,"Placed on Appropriations Suspense file",13,0,0,0,13
62116,23577,2009-03-04,Senate,"Do pass and be placed on the Consent Calendar",5,0,0,0,5
62116,23578,2009-03-12,Senate,"Consent Calendar 2nd SB101 Committee on L.Gov (Negrete McLeo",33,0,0,0,33
62116,23579,2009-04-15,Assembly,"Do pass, to Consent Calendar",7,0,0,0,7
62116,23580,2009-04-23,Assembly,"SB 101 L. GOV.  Consent Calendar Second Day  Regular Session",71,0,0,0,71
62117,26189,2009-03-04,Senate,"Do pass and be placed on the Consent Calendar",5,0,0,0,5
62117,26190,2009-03-12,Senate,"Consent Calendar 2nd SB102 Committee on L.Gov (Negrete McLeo",33,0,0,0,33
62117,26191,2009-04-15,Assembly,"Do pass, to Consent Calendar",7,0,0,0,7
62117,26192,2009-08-20,Assembly,"SB 102 L. GOV.  Senate Third Reading  By CABALLERO",76,0,0,0,76
62118,26573,2009-03-04,Senate,"Do pass and be placed on the Consent Calendar",5,0,0,0,5
62118,26574,2009-03-12,Senate,"Consent Calendar 2nd SB103 Committee on L.Gov (Negrete McLeo",33,0,0,0,33
62118,26575,2009-04-15,Assembly,"Do pass, to Consent Calendar",7,0,0,0,7
62118,26576,2009-08-20,Assembly,"SB 103 L. GOV.  Senate Third Reading  By CABALLERO",75,0,0,0,75
62119,22411,2009-04-27,Senate,"Do pass as amended, and re-refer to the Committee on 	Appropriations",5,2,0,0,7
62119,22412,2009-06-01,Senate,"Senate 3rd Reading SB104 Oropeza",21,17,0,0,38
62119,22413,2009-07-06,Assembly,"Do pass and be re-referred to the Committee on Appropriations",6,3,0,0,9
62119,22414,2009-07-15,Assembly,"Do pass",11,5,0,0,16
62119,22415,2009-09-08,Assembly,"SB 104 Oropeza  Senate Third Reading  By SKINNER",44,34,0,0,78
62119,22416,2009-09-10,Senate,"Unfinished Business SB104 Oropeza",22,17,0,0,39
62120,1971,2009-05-05,Senate,"Do pass",5,0,0,0,5
62120,1972,2009-05-14,Senate,"Special Consent #4 SB105 Harman",38,0,1,0,39
62120,10120,2010-06-29,Assembly,"Do pass as amended",10,0,0,0,10
62120,20328,2010-08-16,Assembly,"SB 105 Harman  Senate Third Reading  By SILVA",74,0,0,0,74
62120,20639,2010-08-19,Senate,"Unfinished Business SB105 Harman",35,0,0,0,35
62121,1918,2009-03-04,Senate,"Do pass and be placed on the Consent Calendar",5,0,0,0,5
62121,1919,2009-03-12,Senate,"Consent Calendar 2nd SB106 Committee on L.Gov (Negrete McLeo",33,0,6,0,39
62121,1920,2009-06-17,Assembly,"Do pass as amended and re-refer to Committee on Appropriations with recommendation:  To Consent Calendar",10,0,1,0,11
62122,1921,2009-06-10,Senate,"Do pass as amended, and re-refer to the Committee on Appropriations",7,0,1,0,8
62122,1922,2009-06-29,Senate,"Placed on Appropriations Suspense file",13,0,0,0,13
62123,2037,2009-04-28,Senate,"Do pass, but re-refer to the Committee on Appropriations",5,0,0,0,5
62123,2038,2009-05-26,Senate,"Do pass as amended",12,0,1,0,13
62123,2039,2009-06-03,Senate,"Senate 3rd Reading SB108 Walters",37,0,2,0,39
62124,2040,2009-04-13,Senate,"Do pass, but re-refer to the Committee on Judiciary",7,2,1,0,10
62124,2041,2009-04-21,Senate,"Do pass as amended, and re-refer to the Committee on Appropriations",4,1,0,0,5
62124,2042,2009-05-14,Senate,"Senate 3rd Reading SB109 Calderon",24,13,2,0,39
62124,2043,2009-06-16,Assembly,"Do pass and be re-referred to the Committee on Judiciary",7,2,2,0,11
62124,2044,2009-06-23,Assembly,"Do pass and be re-referred to the Committee on Appropriations",7,3,0,0,10
62124,2045,2009-07-08,Assembly,"Do pass",12,3,1,0,16
62124,2046,2009-08-20,Assembly,"SB 109 Calderon  Senate Third Reading  By FEUER",50,27,2,0,79
62124,2047,2009-08-27,Senate,"Unfinished Business SB109 Calderon",25,12,3,0,40
62125,1963,2009-04-28,Senate,"Do pass as amended, and re-refer to the Committee on Appropriations",6,0,1,0,7
62125,1964,2009-05-18,Senate,"Placed on Appropriations Suspense file",13,0,0,0,13
62125,1965,2010-01-21,Senate,"Do pass as amended",6,2,3,0,11
62125,1966,2010-01-28,Senate,"SENATE 3RD READING SB110 LIU",31,1,7,0,39
62125,9117,2010-06-15,Assembly,"Do pass as amended and be re-referred to the Committee on Human Services",7,0,0,0,7
62125,9751,2010-06-29,Assembly,"Do pass and be re-referred to the Committee on Appropriations",6,0,0,0,6
62125,19376,2010-08-04,Assembly,"Do pass, to Consent Calendar",17,0,0,0,17
62125,19978,2010-08-12,Assembly,"SB 110 Liu  Consent Calendar Second Day  Regular Session",78,0,0,0,78
62125,20739,2010-08-19,Senate,"Unfinished Business SB110 Liu",35,0,0,0,35
62126,27128,2009-03-31,Senate,"Do pass",3,2,0,0,5
62126,27129,2009-04-20,Senate,"Senate 3rd Reading SB111 Correa",23,13,0,0,36
62126,27130,2009-06-17,Assembly,"Do pass",4,2,0,0,6
62126,27131,2009-09-08,Assembly,"SB 111 Correa  Senate Third Reading  By TORRES",77,0,0,0,77
62126,27132,2009-09-10,Senate,"Unfinished Business SB111 Correa Concurrence",33,4,0,0,37
62127,22870,2009-03-23,Senate,"Do pass as amended, and re-refer to the Committee on Appropriations",10,0,0,0,10
62127,22871,2009-04-20,Senate,"Do pass",11,0,0,0,11
62127,22872,2009-04-23,Senate,"Special Consent #1 SB112 Oropeza",37,0,0,0,37
62127,22873,2009-06-30,Assembly,"Do pass and be re-referred to the Committee on Appropriations",10,0,0,0,10
62127,22874,2009-07-08,Assembly,"Do pass",15,0,0,0,15
62127,22875,2009-08-31,Assembly,"SB 112 Oropeza  Third Reading Urgency  By EMMERSON",74,0,0,0,74
62127,22876,2009-09-04,Senate,"Unfinished Business SB112 Oropeza",36,0,0,0,36
62128,26176,2009-04-15,Senate,"Do pass, but re-refer to the Committee on Appropriations Recommend 	Consent",5,0,0,0,5
62128,26177,2009-05-06,Senate,"Special Consent #2 SB113 Committee on L.Gov (Negrete McLeo",35,0,4,0,39
62128,26178,2009-07-01,Assembly,"Do pass and be re-referred to the Committee on Appropriations to 	Consent Calendar",7,0,0,0,7
62128,26179,2009-07-15,Assembly,"Do pass, to Consent Calendar",16,0,0,0,16
62128,26180,2009-08-17,Assembly,"SB 113 L. GOV.  Consent Calendar Second Day",76,0,0,3,79
62128,26181,2009-08-24,Senate,"Special Consent #15 SB113 Committee on L.Gov (Wiggins)",39,0,1,0,40
62128,26182,2009-09-09,Senate,"Special Consent #20 SB113 Committee on L.Gov (Wiggins)",40,0,0,0,40
62129,1967,2009-04-01,Senate,"Do pass, but re-refer to the Committee on Appropriations",10,1,0,0,11
62129,1968,2009-04-20,Senate,"Placed on Appropriations Suspense file",11,0,2,0,13
62130,2051,2009-03-31,Senate,"Do pass, but re-refer to the Committee on Appropriations",3,2,0,0,5
62130,2052,2009-05-06,Senate,"Senate 3rd Reading SB115 Lowenthal",21,11,7,0,39
62130,2053,2009-06-23,Assembly,"Do pass and be re-referred to the Committee on Appropriations",7,3,0,0,10
62130,2054,2009-07-08,Assembly,"Do pass",10,5,1,0,16
62130,2055,2009-08-20,Assembly,"SB 115 Lowenthal  Senate Third Reading  By FEUER",48,25,6,0,79
62131,23794,2009-04-15,Senate,"Do pass as amended, and re-refer to the Committee on 	Appropriations",10,0,0,0,10
62131,23795,2009-05-11,Senate,"Do pass",13,0,0,0,13
62131,23796,2009-05-18,Senate,"Special Consent #5 SB116 Calderon",36,0,0,0,36
62131,23797,2009-06-08,Assembly,"Do pass and be re-referred to the Committee on Appropriations",10,0,0,0,10
62131,23798,2009-06-11,Assembly,"Do pass, to Consent Calendar",14,0,0,0,14
62131,23799,2009-06-18,Assembly,"SB 116 Calderon  Third Reading Urgency  By NAVA",44,18,0,0,62
62131,23800,2009-07-24,Assembly,"SB 116 Calderon  Third Reading Urgency  By NAVA",57,16,0,0,73
62132,27060,2009-04-01,Senate,"Do pass, but re-refer to the Committee on Appropriations",10,1,0,0,11
62132,27061,2009-04-20,Senate,"Placed on Appropriations Suspense file",11,0,0,0,11
62132,27062,2009-05-28,Senate,"Do pass as amended",10,1,0,0,11
62132,27063,2009-06-03,Senate,"Senate 3rd Reading SB117 Corbett",33,6,0,0,39
62132,27064,2009-06-30,Assembly,"Do pass and be re-referred to the Committee on Aging and Longterm 	Care",15,4,0,0,19
62132,27065,2009-07-07,Assembly,"Do pass and be re-referred to the Committee on Appropriations",5,0,0,0,5
62132,27066,2009-08-27,Assembly,"Do pass as amended",12,5,0,0,17
62132,27067,2009-09-08,Assembly,"SB 117 Corbett  Senate Third Reading  By CHESBRO",51,26,0,0,77
62132,27068,2009-09-10,Senate,"Unfinished Business SB117 Corbett",28,8,0,0,36
62133,22671,2009-04-28,Senate,"Do pass, but re-refer to the Committee on Appropriations",5,0,0,0,5
62133,22672,2009-05-18,Senate,"Placed on Appropriations Suspense file",13,0,0,0,13
62133,22673,2009-05-28,Senate,"Do pass as amended",12,0,0,0,12
62133,22674,2009-06-03,Senate,"Senate 3rd Reading SB118 Liu",38,0,0,0,38
62133,22675,2009-06-30,Assembly,"Do pass and be re-referred to the Committee on Appropriations",7,0,0,0,7
62133,22676,2009-08-27,Assembly,"Do pass as amended",17,0,0,0,17
62133,22677,2009-09-02,Assembly,"SB 118 Liu  Senate Third Reading  By BEALL",75,0,0,0,75
62133,22678,2009-09-08,Assembly,"SB 118 Liu  Senate Third Reading  By BEALL",79,0,0,0,79
62133,22679,2009-09-10,Senate,"Unfinished Business SB118 Liu Concurrence",35,0,0,0,35
62134,27133,2009-05-05,Senate,"Do pass as amended. To Consent Calendar",5,0,0,0,5
62134,27134,2009-05-14,Senate,"Consent Calendar 2nd SB119 Wyland",38,0,0,0,38
62134,27135,2009-06-25,Assembly,"Do pass, to Consent Calendar",10,0,0,0,10
62134,27136,2009-07-01,Assembly,"SB 119 Wyland  Consent Calendar Second Day  Regular Session",76,0,0,0,76
62135,23783,2009-03-31,Senate,"Do pass, but re-refer to the Committee on Appropriations",3,2,0,0,5
62135,23784,2009-04-23,Senate,"Senate 3rd Reading SB120 Lowenthal",23,14,0,0,37
62135,23785,2009-06-23,Assembly,"Do pass and be re-referred to the Committee on Utilities and 	Commerce",7,3,0,0,10
62135,23786,2009-07-06,Assembly,"Do pass and be re-referred to the Committee on Appropriations",10,4,0,0,14
62135,23787,2009-08-19,Assembly,"Do pass as amended",12,5,0,0,17
62135,23788,2009-09-01,Assembly,"SB 120 Lowenthal  Senate Third Reading  By TORRICO",47,29,0,0,76
62135,23789,2009-09-04,Senate,"Unfinished Business SB120 Lowenthal",24,13,0,0,37
62136,23184,2009-03-31,Senate,"Do pass as amended, and re-refer to the Committee on Appropriations",7,0,0,0,7
62136,23185,2009-05-06,Senate,"Senate 3rd Reading SB121 Denham",35,0,0,0,35
62136,23186,2009-06-16,Assembly,"Do pass, to Consent Calendar",7,0,0,0,7
62136,23187,2009-06-22,Assembly,"SB 121 Denham  Consent Calendar Second Day  Regular Session",74,0,0,0,74
62136,23188,2009-06-29,Senate,"Special Consent #11 SB121 Denham",40,0,0,0,40
62137,2049,2009-04-28,Senate,"Do pass, but re-refer to the Committee on Appropriations",7,4,0,0,11
62137,2050,2009-05-11,Senate,"Placed on Appropriations Suspense file",13,0,0,0,13
62138,22602,2009-03-18,Senate,"Do pass as amended, and re-refer to the Committee on Appropriations",6,0,0,0,6
62138,22603,2009-04-23,Senate,"Special Consent #1 SB123 Liu",37,0,0,0,37
62138,22604,2009-06-17,Assembly,"Do pass and re-refer to Committee on Appropriations with 	recommendation:  To Consent Calendar",10,0,0,0,10
62138,22605,2009-07-01,Assembly,"Do pass, to Consent Calendar",15,0,0,0,15
62138,22606,2009-07-09,Assembly,"SB 123 Liu  Consent Calendar Second Day  Regular Session",74,0,0,0,74
62139,22621,2009-05-12,Senate,"Do pass",7,4,0,0,11
62139,22622,2009-05-26,Senate,"Senate 3rd Reading SB124 Oropeza",26,13,0,0,39
62139,22623,2009-06-29,Assembly,"Do pass",9,5,0,0,14
62139,22624,2009-08-31,Assembly,"SB 124 Oropeza  Senate Third Reading  By BLUMENFIELD",48,28,0,0,76
62139,22625,2009-09-04,Senate,"Unfinished Business SB124 Oropeza",24,13,0,0,37
62140,1999,2009-04-21,Senate,"Do pass, but re-refer to the Committee on Appropriations",3,4,0,0,7
62140,2000,2009-04-21,Senate,"Set, first hearing.  Failed passage in Committee.  Reconsideration granted",7,0,0,0,7
62141,22436,2009-04-14,Senate,"Do pass as amended, but re-refer to the Committee on 	Appropriations Recommend Consent",13,0,0,0,13
62141,22437,2009-05-26,Senate,"Senate 3rd Reading SB126 Cedillo Urgency Clause",38,1,0,0,39
62141,22438,2009-07-08,Assembly,"Do pass and be re-referred to the Committee on Appropriations",18,0,0,0,18
62141,22439,2009-08-19,Assembly,"Do pass as amended",17,0,0,0,17
62141,22440,2009-09-02,Assembly,"SB 126 Cedillo  Third Reading Urgency  By COTO",75,1,0,0,76
62141,22441,2009-09-08,Senate,"Unfinished Business SB126 Cedillo",38,1,0,0,39
62142,2001,2009-05-12,Senate,"Do pass as amended",3,2,0,0,5
62142,2002,2009-06-02,Senate,"Senate 3rd Reading SB127 Calderon",23,15,1,0,39
62142,6603,2010-06-10,Assembly,"Be referred to Committee on Judiciary",11,0,0,0,11
62142,10164,2010-06-29,Assembly,"Do pass, to Consent Calendar",10,0,0,0,10
62142,21282,2010-08-25,Assembly,"Do pass as amended",9,0,0,0,9
62142,21751,2010-08-30,Assembly,"SB 127 Calderon  Senate Third Reading  By CALDERON  FORMERLY FILE 	ITEM1",76,0,0,0,76
62142,21857,2010-08-31,Senate,"From committee:  That the Assembly Amendments be concurred in",4,1,0,0,5
62142,21858,2010-08-31,Senate,"W/O REF. TO FILE SB127 Calderon Concurrence",31,2,0,0,33
62143,2142,2009-04-27,Senate,"Do pass, but re-refer to the Committee on Appropriations",5,2,0,0,7
62143,2143,2009-05-04,Senate,"Placed on Appropriations Suspense file",11,0,2,0,13
62144,2099,2009-07-15,Senate,"Do pass as amended, and re-refer to the Committee on Appropriations",8,0,1,0,9
62144,2100,2009-08-17,Senate,"Placed on Appropriations Suspense file",13,0,0,0,13
62145,25742,2009-04-29,Senate,"Do pass as amended, and re-refer to the Committee on Appropriations",9,0,0,0,9
62145,25743,2009-05-11,Senate,"Placed on Appropriations Suspense file",13,0,0,0,13
62145,25744,2009-05-28,Senate,"Do pass",10,0,0,0,10
62145,25745,2009-06-01,Senate,"Senate 3rd Reading SB130 Denham Urgency Clause",30,3,0,0,33
62145,25746,2009-06-24,Assembly,"Do pass and be re-referred to the Committee on Appropriations",10,1,0,0,11
62145,25747,2009-07-01,Assembly,"Do pass",13,0,0,0,13
62145,25748,2009-07-09,Assembly,"SB 130 Denham  Third Reading Urgency  By CABALLERO",67,5,0,0,72
62146,23591,2009-04-28,Senate,"Do pass as amended. To Consent Calendar",12,0,0,0,12
62146,23592,2009-05-06,Senate,"Consent Calendar 2nd SB131 Wiggins",35,0,0,0,35
62146,23593,2009-07-01,Assembly,"Do pass, to Consent Calendar",17,0,0,0,17
62146,23594,2009-09-04,Assembly,"SB 131 Wiggins  Senate Third Reading  By SALAS  Amend By MA  Set #1",43,28,0,0,71
62146,23595,2009-09-09,Assembly,"Do pass as amended",15,0,0,0,15
62146,23596,2009-09-11,Assembly,"SB 131 Wiggins  Third Reading Urgency  By MA",73,1,0,0,74
62146,23597,2009-09-12,Senate,"W/O REF. TO FILE SB131 Wiggins Urgency Clause",23,0,0,0,23
62146,23598,2009-09-12,Senate,"W/O REF. TO FILE SB131 Wiggins Reconsider",39,0,0,0,39
62146,23599,2009-10-14,Senate,"Unfinished Business SB131 Wiggins Urgency Clause",37,0,0,0,37
62147,25057,2009-03-23,Senate,"Do pass, but re-refer to the Committee on Appropriations",10,0,0,0,10
62147,25058,2009-04-20,Senate,"Do pass as amended",10,0,0,0,10
62147,25059,2009-05-21,Senate,"Senate 3rd Reading SB132 Denham Urgency Clause",34,0,0,0,34
62147,25060,2009-06-30,Assembly,"Do pass as amended and be re-referred to the Committee on 	Appropriations",10,0,0,0,10
62147,25061,2009-08-27,Assembly,"Do pass as amended",16,0,0,0,16
62147,25062,2009-09-08,Assembly,"SB 132 Denham  Third Reading Urgency  By CHESBRO",71,7,0,0,78
62147,25063,2009-10-14,Senate,"Unfinished Business SB132 Denham",37,1,0,0,38
62148,27116,2009-03-24,Senate,"Do pass, but re-refer to the Committee on Environmental Quality",10,0,0,0,10
62148,27117,2009-04-27,Senate,"Do pass as amended, and re-refer to the Committee on 	Appropriations",7,0,0,0,7
62148,27118,2009-05-26,Senate,"Special Consent #6 SB133 Corbett",39,0,0,0,39
62148,27119,2009-06-30,Assembly,"Do pass and re-refer to Committee on Appropriations with 	recommendation:  To Consent Calendar",11,0,0,0,11
62148,27120,2009-07-08,Assembly,"Do pass, to Consent Calendar",15,0,0,0,15
62148,27121,2009-08-27,Assembly,"SB 133 Corbett  Consent Calendar Second Day  Regular Session",74,0,0,0,74
62149,2101,2010-01-12,Senate,"Do pass, but re-refer to the Committee on Appropriations",7,0,0,0,7
62149,2102,2010-01-19,Senate,"Placed on Appropriations Suspense file",8,0,3,0,11
62150,26734,2009-04-21,Senate,"Do pass, but re-refer to the Committee on Public Safety",4,1,0,0,5
62150,26735,2009-04-28,Senate,"Do pass as amended, and re-refer to the Committee on Appropriations",5,2,0,0,7
62150,26736,2009-05-26,Senate,"Senate 3rd Reading SB135 Florez",27,12,0,0,39
62150,26737,2009-06-23,Assembly,"Do pass as amended and be re-referred to the Committee on 	Agriculture",4,1,0,0,5
62150,26738,2009-07-01,Assembly,"Do pass as amended and be re-referred to the Committee on 	Appropriations",6,1,0,0,7
62150,26739,2009-08-19,Assembly,"Do pass",13,2,0,0,15
62150,26740,2009-09-03,Assembly,"SB 135 Florez  Senate Third Reading  By NAVA",58,15,0,0,73
62150,26741,2009-09-08,Senate,"Unfinished Business SB135 Florez",26,12,0,0,38
62151,23194,2009-04-28,Senate,"Do pass, but re-refer to the Committee on Appropriations",10,0,0,0,10
62151,23195,2009-05-18,Senate,"Special Consent #5 SB136 Huff",36,0,0,0,36
62151,23196,2009-07-07,Assembly,"Do pass and be re-referred to the Committee on Appropriations",10,0,0,0,10
62151,23197,2009-08-19,Assembly,"Do pass",17,0,0,0,17
62151,23198,2009-09-01,Assembly,"SB 136 Huff  Senate Third Reading  By JEFFRIES",77,0,0,0,77
62151,23199,2009-09-04,Senate,"Unfinished Business SB136 Huff",39,0,0,0,39
62152,2103,2009-04-22,Senate,"Do pass as amended, and re-refer to the Committee on Appropriations",7,0,1,0,8
62152,2104,2009-05-04,Senate,"Placed on Appropriations Suspense file",11,0,2,0,13
62153,2132,2009-04-22,Senate,"Do pass as amended, and re-refer to the Committee on Appropriations",5,2,1,0,8
62153,2133,2009-05-26,Senate,"Senate 3rd Reading SB138 Liu Reconsider",39,0,0,0,39
62153,2134,2009-06-02,Senate,"Senate 3rd Reading SB138 Liu",22,17,0,0,39
62153,2135,2009-07-06,Assembly,"Do pass as amended and be re-referred to the Committee on Appropriations",6,2,1,0,9
62153,9118,2009-05-26,Senate,"Senate 3rd Reading SB138 Liu",19,19,1,0,39
62155,23231,2009-04-21,Senate,"Do pass as amended, and re-refer to the Committee on 	Appropriations",4,1,0,0,5
62155,23232,2009-05-11,Senate,"Do pass as amended",12,0,0,0,12
62155,23233,2009-05-18,Senate,"Senate 3rd Reading SB140 Corbett Urgency Clause",29,5,0,0,34
62155,23234,2009-06-17,Assembly,"Do pass and be re-referred to the Committee on Appropriations",7,0,0,0,7
62155,23235,2009-08-27,Assembly,"Do pass as amended",16,0,0,0,16
62155,23236,2009-09-08,Assembly,"SB 140 Corbett  Third Reading Urgency  By CONWAY",74,3,0,0,77
62155,23237,2009-09-10,Senate,"Unfinished Business SB140 Corbett Concurrence",24,6,0,0,30
62155,23238,2009-09-10,Senate,"Unfinished Business SB140 Corbett Reconsider",40,0,0,0,40
62155,23239,2009-10-14,Senate,"Unfinished Business SB140 Corbett",32,2,0,0,34
62156,2183,2009-04-28,Senate,"Do pass as amended, and re-refer to the Committee on Appropriations",5,0,0,0,5
62156,2184,2009-05-28,Senate,"Senate 3rd Reading SB141 Maldonado",29,1,9,0,39
62156,2185,2009-06-30,Assembly,"Do pass as amended and be re-referred to the Committee on Appropriations",7,0,0,0,7
62157,2139,2009-04-28,Senate,"Do pass as amended, and re-refer to the Committee on Appropriations",5,0,0,0,5
62157,2140,2009-06-01,Senate,"Senate 3rd Reading SB142 Maldonado",32,1,6,0,39
62157,2141,2009-06-30,Assembly,"Do pass as amended and be re-referred to the Committee on Appropriations",6,0,1,0,7
62158,22734,2009-04-20,Senate,"Do pass, but re-refer to the Committee on Judiciary",7,0,0,0,7
62158,22735,2009-04-20,Senate,MOTIONDCD148**,7,0,0,0,7
62158,22736,2009-04-20,Senate,"Do pass as amended, and re-refer to the Committee on Judiciary",7,0,0,0,7
62158,22737,2009-04-28,Senate,"Do pass, but re-refer to the Committee on Appropriations",5,0,0,0,5
62158,22738,2009-05-18,Senate,"Do pass",10,0,0,0,10
62158,22739,2009-05-26,Senate,"Special Consent #6 SB143 Cedillo",39,0,0,0,39
62158,22740,2009-06-16,Assembly,"Do pass and be re-referred to the Committee on Judiciary to Consent 	Calendar",7,0,0,0,7
62158,22741,2009-06-23,Assembly,"Do pass and re-refer to Committee on Appropriations with 	recommendation:  To Consent Calendar",10,0,0,0,10
62158,22742,2009-08-19,Assembly,"Do pass, to Consent Calendar",17,0,0,0,17
62158,22743,2009-08-27,Assembly,"SB 143 Cedillo  Consent Calendar Second Day  Regular Session",74,0,0,0,74
62158,22744,2009-09-02,Senate,"Special Consent #18 SB143 Cedillo",39,0,0,0,39
62159,2178,2009-03-24,Senate,"Do pass, but re-refer to the Committee on Environmental Quality",7,3,1,0,11
62159,2179,2009-04-27,Senate,"Do pass, but re-refer to the Committee on Appropriations",5,2,0,0,7
62159,2180,2009-05-04,Senate,"Placed on Appropriations Suspense file",11,0,2,0,13
62159,2181,2009-05-28,Senate,"Do pass as amended",7,5,1,0,13
62159,2182,2009-06-03,Senate,"Senate 3rd Reading SB144 Pavley",21,17,1,0,39
62160,2218,2009-03-25,Senate,"Do pass as amended, and re-refer to the Committee on Judiciary",4,1,1,0,6
62160,2219,2009-06-01,Senate,"Senate 3rd Reading SB145 DeSaulnier",23,15,1,0,39
62160,2220,2009-07-08,Assembly,"Do pass",7,3,0,0,10
62160,20973,2010-08-23,Assembly,"SB 145 DeSaulnier  Senate Third Reading  By SOLORIO",47,27,0,0,74
62160,21458,2010-08-26,Senate,"Unfinished Business SB145 DeSaulnier",22,14,0,0,36
62161,2174,2009-03-31,Senate,"Do pass, but re-refer to the Committee on Appropriations Recommend Consent",11,0,0,0,11
62161,2175,2009-04-20,Senate,"Placed on Appropriations Suspense file",11,0,2,0,13
62162,23703,2009-04-15,Senate,"Do pass as amended, and re-refer to the Committee on Appropriations",7,0,0,0,7
62162,23704,2009-05-26,Senate,"Placed on Appropriations Suspense file",13,0,0,0,13
62162,23705,2009-05-28,Senate,"Do pass",12,0,0,0,12
62162,23706,2009-06-02,Senate,"Senate 3rd Reading SB147 DeSaulnier",39,0,0,0,39
62162,23707,2009-07-07,Assembly,"Do pass and be re-referred to the Committee on Appropriations",9,0,0,0,9
62162,23708,2009-08-27,Assembly,"Do pass",15,0,0,0,15
62162,23709,2009-09-02,Assembly,"SB 147 DeSaulnier  Senate Third Reading  By PORTANTINO",76,1,0,0,77
62162,23710,2009-09-08,Senate,"Unfinished Business SB147 DeSaulnier",40,0,0,0,40
62163,23697,2009-04-01,Senate,"Do pass as amended, and re-refer to the Committee on Appropriations",10,1,0,0,11
62163,23698,2009-06-01,Senate,"Senate 3rd Reading SB148 Oropeza",34,2,0,0,36
62163,23699,2009-06-30,Assembly,"Do pass as amended and be re-referred to the Committee on 	Appropriations",17,0,0,0,17
62163,23700,2009-08-19,Assembly,"Do pass, to Consent Calendar",17,0,0,0,17
62163,23701,2009-08-27,Assembly,"SB 148 Oropeza  Consent Calendar Second Day  Regular Session",74,0,0,0,74
62163,23702,2009-09-04,Senate,"Unfinished Business SB148 Oropeza",33,3,0,0,36
62164,23979,2009-05-26,Senate,"Do pass as amended",12,0,0,0,12
62164,23980,2009-06-01,Senate,"Senate 3rd Reading SB149 Kehoe Urgency Clause",39,0,0,0,39
62164,23981,2009-08-19,Assembly,"Do pass",17,0,0,0,17
62164,23982,2009-09-01,Assembly,"SB 149 Kehoe  Third Reading Urgency  By DE LEON",77,0,0,0,77
62164,23983,2009-09-04,Senate,"Unfinished Business SB149 Kehoe Urgency Clause",37,1,0,0,38
62165,23108,2009-04-14,Senate,"Do pass as amended, and re-refer to the Committee on Appropriations",7,0,0,0,7
62165,23109,2009-04-27,Senate,"Placed on Appropriations Suspense file",13,0,0,0,13
62165,23110,2009-05-28,Senate,"Do pass",12,0,0,0,12
62165,23111,2009-06-03,Senate,"Special Consent #8 SB150 Wright",39,0,0,0,39
62165,23112,2009-06-23,Assembly,"Do pass and re-refer to Committee on Appropriations with 	recommendation:  To Consent Calendar",7,0,0,0,7
62165,23113,2009-08-27,Assembly,"Do pass",17,0,0,0,17
62165,23114,2009-09-03,Assembly,"SB 150 Wright  Senate Third Reading  By LIEU",76,0,0,0,76
62166,2172,2009-04-21,Senate,"Do pass, but re-refer to the Committee on Appropriations",7,0,0,0,7
62166,2173,2009-05-04,Senate,"Placed on Appropriations Suspense file",11,0,2,0,13
62167,2255,2009-04-01,Senate,"Do pass as amended, and re-refer to the Committee on Appropriations",11,0,0,0,11
62167,2256,2009-04-27,Senate,"Do pass",12,0,1,0,13
62167,2257,2009-05-06,Senate,"Senate 3rd Reading SB152 Cox",34,0,5,0,39
62169,2221,2009-04-14,Senate,"Do pass as amended, and re-refer to the Committee on Appropriations",6,0,1,0,7
62169,2222,2009-05-26,Senate,"Special Consent #6 SB154 Benoit",39,0,0,0,39
62169,2223,2009-06-23,Assembly,"Do pass as amended and be re-referred to the Committee on Appropriations",7,0,0,0,7
62170,2176,2009-03-18,Senate,"Do pass as amended, and re-refer to the Committee on Appropriations",8,0,1,0,9
62170,2177,2009-05-04,Senate,"Placed on Appropriations Suspense file",11,0,2,0,13
62171,2290,2009-05-06,Senate,"Do pass, but re-refer to the Committee on Judiciary Recommend Consent",11,0,1,0,12
62171,2291,2009-05-12,Senate,"Do pass as amended",5,0,0,0,5
62171,2292,2009-05-21,Senate,"Senate 3rd Reading SB156 Wright",35,0,4,0,39
62171,2293,2009-06-25,Assembly,"Do pass and be re-referred to the Committee on Judiciary",10,0,0,0,10
62171,2294,2009-07-09,Assembly,"Do pass",10,0,0,0,10
62171,2295,2009-08-20,Assembly,"SB 156 Wright  Senate Third Reading  By SOLORIO",77,0,2,0,79
62171,20427,2010-08-16,Assembly,"SB 156 Wright  Senate Third Reading  By SOLORIO",74,0,0,0,74
62171,20635,2010-08-19,Senate,"Unfinished Business SB156 Wright",34,0,0,0,34
62173,2249,2009-04-22,Senate,"Do pass, but re-refer to the Committee on Rules",8,3,0,0,11
62173,2250,2009-05-11,Senate,"Senate 3rd Reading SB158 Wiggins",23,13,3,0,39
62173,2251,2009-06-09,Assembly,"Do pass as amended and be re-referred to the Committee on Appropriations",13,5,1,0,19
62173,2252,2009-08-27,Assembly,"Do pass as amended",12,5,0,0,17
62173,2253,2009-09-02,Assembly,"SB 158 Wiggins  Senate Third Reading  By EVANS",49,24,6,0,79
62173,2254,2009-09-08,Senate,"Unfinished Business SB158 Wiggins",25,14,1,0,40
62174,22702,2009-03-31,Senate,"Do pass as amended, and re-refer to the Committee on Appropriations",9,2,0,0,11
62174,22703,2009-04-20,Senate,"Do pass",10,0,0,0,10
62174,22704,2009-04-23,Senate,"Senate 3rd Reading SB159 Simitian",33,2,0,0,35
62174,22705,2009-06-22,Assembly,"Do pass and be re-referred to the Committee on Appropriations",13,0,0,0,13
62174,22706,2009-07-01,Assembly,"Do pass",15,0,0,0,15
62174,22707,2009-07-16,Assembly,"SB 159 Simitian  Senate Third Reading  By DE LEON",72,0,0,0,72
62175,2258,2009-03-18,Senate,"Do pass, but re-refer to the Committee on Appropriations",5,3,1,0,9
62175,2259,2009-04-20,Senate,"Placed on Appropriations Suspense file",11,0,2,0,13
62176,2343,2009-04-29,Senate,"Do pass, but re-refer to the Committee on Rules",11,0,0,0,11
62176,2344,2009-05-26,Senate,"Do pass",10,0,3,0,13
62176,2345,2009-06-01,Senate,"Senate 3rd Reading SB161 Wright",36,0,3,0,39
62176,2346,2009-07-07,Assembly,"Do pass and be re-referred to the Committee on Appropriations",13,6,0,0,19
62176,2347,2009-08-27,Assembly,"Do pass as amended",12,5,0,0,17
62176,2348,2009-09-08,Assembly,"SB 161 Wright  Senate Third Reading  By HALL",51,23,5,0,79
62176,2349,2009-09-10,Senate,"Unfinished Business SB161 Wright Concurrence",31,3,6,0,40
62180,2401,2009-04-28,Senate,"Do pass, but re-refer to the Committee on Appropriations",9,1,1,0,11
62180,2402,2009-06-02,Senate,"Senate 3rd Reading SB165 Lowenthal",38,0,1,0,39
62180,10147,2010-06-28,Assembly,"Do pass and re-refer to Committee on Appropriations with recommendation:  To Consent Calendar",14,0,0,0,14
62180,19575,2010-08-04,Assembly,"Do pass, to Consent Calendar",17,0,0,0,17
62181,2333,2009-03-31,Senate,"Do pass, but re-refer to the Committee on Public Safety",11,0,0,0,11
62181,2334,2009-04-23,Senate,"Special Consent #1 SB166 Runner",37,0,2,0,39
62181,2335,2009-06-17,Assembly,"Do pass and re-refer to Committee on Appropriations with recommendation:  To Consent Calendar",6,0,0,0,6
62181,2336,2009-07-01,Assembly,"Do pass, to Consent Calendar",15,0,1,0,16
62181,2337,2009-07-09,Assembly,"SB 166 Runner  Consent Calendar Second Day  Regular Session",74,0,5,0,79
62181,2338,2009-08-17,Senate,"Special Consent #14 SB166 Runner",35,0,5,0,40
62182,23451,2009-04-20,Senate,"Do pass as amended, and re-refer to the Committee on Appropriations",6,1,0,0,7
62182,23452,2009-05-14,Senate,"Senate 3rd Reading SB167 Ducheny",25,9,0,0,34
62182,23453,2009-06-22,Assembly,"Do pass and be re-referred to the Committee on Appropriations",7,2,0,0,9
62182,23454,2009-08-27,Assembly,"Do pass",12,5,0,0,17
62182,23455,2009-09-09,Assembly,"SB 167 Ducheny  Senate Third Reading  By SALAS",48,28,0,0,76
62184,25207,2009-04-14,Senate,"Do pass",7,0,0,0,7
62184,25208,2009-04-20,Senate,"Senate 3rd Reading SB169 Benoit",37,0,0,0,37
62184,25209,2009-06-16,Assembly,"Do pass",7,0,0,0,7
62184,25210,2009-07-16,Assembly,"SB 169 Benoit  Senate Third Reading  By GILMORE",71,0,0,0,71
62184,25211,2009-08-24,Senate,"Special Consent #15 SB169 Benoit",39,0,0,0,39
62186,26868,2009-03-23,Senate,"Do pass and be placed on the Consent Calendar",10,0,0,0,10
62186,26869,2009-03-31,Senate,"Consent Calendar 2nd SB171 Pavley",39,0,0,0,39
62186,26870,2009-06-16,Assembly,"Do pass as amended, to Consent Calendar",11,0,0,0,11
62186,26871,2009-06-24,Assembly,"SB 171 Pavley  Consent Calendar Second Day  Regular Session",72,0,0,0,72
62186,26872,2009-07-16,Senate,"Special Consent #13 SB171 Pavley",36,0,0,0,36
62187,2379,2009-04-21,Senate,"Do pass, but re-refer to the Committee on Appropriations",3,2,0,0,5
62187,2380,2009-05-21,Senate,"Senate 3rd Reading SB172 Florez",21,15,3,0,39
62187,2381,2009-07-07,Assembly,"Do pass as amended and be re-referred to the Committee on Appropriations",4,2,1,0,7
62187,2382,2009-08-19,Assembly,"Do pass",12,5,0,0,17
62187,2383,2009-09-01,Assembly,"SB 172 Florez  Senate Third Reading  By MA",48,29,2,0,79
62187,2384,2009-09-04,Senate,"Unfinished Business SB172 Florez",24,14,2,0,40
62188,2389,2009-04-21,Senate,"Do pass, but re-refer to the Committee on Rules",3,1,1,0,5
62188,2390,2009-04-29,Senate,"Do pass as amended, and re-refer to the Committee on Appropriations",7,3,1,0,11
62188,2391,2009-05-26,Senate,"Placed on Appropriations Suspense file",13,0,0,0,13
62188,2392,2009-05-28,Senate,"Do pass as amended",7,5,1,0,13
62188,2393,2009-06-03,Senate,"Senate 3rd Reading SB173 Florez",26,12,1,0,39
62188,2394,2009-06-23,Assembly,"Do pass and be re-referred to the Committee on Agriculture",14,1,4,0,19
62188,2395,2009-07-01,Assembly,"Do pass as amended and be re-referred to the Committee on Appropriations",5,2,1,0,8
62188,2396,2009-08-19,Assembly,"Do pass",13,4,0,0,17
62188,2397,2009-09-01,Assembly,"SB 173 Florez  Senate Third Reading  By MA",50,27,2,0,79
62188,2398,2009-09-04,Senate,"Unfinished Business SB173 Florez",26,9,5,0,40
62189,22748,2009-04-28,Senate,"Do pass as amended, and re-refer to the Committee on Appropriations",7,0,0,0,7
62189,22749,2009-05-26,Senate,"Special Consent #6 SB174 Strickland",39,0,0,0,39
62189,22750,2009-06-23,Assembly,"Do pass and re-refer to Committee on Appropriations with 	recommendation:  To Consent Calendar",7,0,0,0,7
62189,22751,2009-07-01,Assembly,"Do pass, to Consent Calendar",15,0,0,0,15
62189,22752,2009-07-09,Assembly,"SB 174 Strickland  Consent Calendar Second Day  Regular Session",74,0,0,0,74
62190,25861,2009-04-28,Senate,"Do pass, but re-refer to the Committee on Appropriations",7,0,0,0,7
62190,25862,2009-05-26,Senate,"Special Consent #6 SB175 Aanestad",39,0,0,0,39
62190,25863,2009-06-23,Assembly,"Do pass as amended and re-refer to Committee on Appropriations 	with recommendation:  To Consent Calendar",7,0,0,0,7
62190,25864,2009-08-19,Assembly,"Do pass as amended, to Consent Calendar",17,0,0,0,17
62190,25865,2009-08-27,Assembly,"SB 175 Aanestad  Consent Calendar Second Day  Regular Session",74,0,0,0,74
62190,25866,2009-09-02,Senate,"Special Consent #18 SB175 Aanestad",39,0,0,0,39
62191,26291,2009-05-05,Senate,"Do pass as amended",10,0,0,0,10
62191,26292,2009-05-18,Senate,"Special Consent #5 SB176 Simitian",36,0,0,0,36
62191,26293,2009-06-22,Assembly,"Do pass, to Consent Calendar",14,0,0,0,14
62191,26294,2009-06-30,Assembly,"SB 176 Simitian  Consent Calendar Second Day  Regular Session",77,0,0,0,77
62192,2399,2009-03-31,Senate,"Do pass, but re-refer to the Committee on Appropriations",7,4,0,0,11
62192,2400,2009-04-23,Senate,"Senate 3rd Reading SB177 Lowenthal",25,11,3,0,39
62193,22610,2009-04-28,Senate,"Do pass, but re-refer to the Committee on Appropriations",12,0,0,0,12
62193,22611,2009-05-11,Senate,"Placed on Appropriations Suspense file",13,0,0,0,13
62193,22612,2009-05-28,Senate,"Do pass",12,0,0,0,12
62193,22613,2009-06-03,Senate,"Special Consent #8 SB178 Aanestad",39,0,0,0,39
62193,22614,2009-07-07,Assembly,"Do pass and re-refer to Committee on Appropriations with 	recommendation:  To Consent Calendar",11,0,0,0,11
62193,22615,2009-08-19,Assembly,"Do pass, to Consent Calendar",17,0,0,0,17
62193,22616,2009-09-02,Assembly,"SB 178 Aanestad  Senate Third Reading  By NIELSEN",75,0,0,0,75
62193,22617,2009-09-08,Senate,"Unfinished Business SB178 Aanestad",40,0,0,0,40
62194,3215,2009-03-31,Senate,"Do pass as amended",5,0,0,0,5
62194,3216,2009-04-16,Senate,"Senate 3rd Reading SB179 Runner",32,2,5,0,39
62194,8972,2010-06-15,Assembly,"Do pass",10,0,0,0,10
62194,9099,2010-06-21,Assembly,"SB 179 Runner  Senate Third Reading  By KNIGHT",75,0,4,0,79
62194,9419,2010-06-24,Senate,"Unfinished Business SB179 Runner",29,0,10,0,39
62197,2339,2009-04-29,Senate,"Do pass, but re-refer to the Committee on Appropriations",6,1,2,0,9
62197,2340,2009-05-18,Senate,"Senate 3rd Reading SB182 Ashburn",26,5,8,0,39
62198,27233,2009-04-21,Senate,"Do pass, but re-refer to the Committee on Judiciary",8,3,0,0,11
62198,27234,2009-04-28,Senate,"Do pass as amended, and re-refer to the Committee on 	Appropriations",4,1,0,0,5
62198,27235,2009-05-28,Senate,"Senate 3rd Reading SB183 Lowenthal",21,12,0,0,33
62198,27236,2009-06-17,Assembly,"Do pass as amended and be re-referred to the Committee on Judiciary",6,0,0,0,6
62198,27237,2009-06-30,Assembly,"Do pass and be re-referred to the Committee on Appropriations",7,3,0,0,10
62198,27238,2009-07-15,Assembly,"Do pass",13,3,0,0,16
62198,27239,2009-09-09,Assembly,"SB 183 Lowenthal  Senate Third Reading  By TORRES",54,21,0,0,75
62198,27240,2010-04-12,Assembly,"SB 183 Lowenthal  Senate Third Reading  By CONWAY",47,20,0,0,67
62198,27241,2010-04-26,Senate,"Unfinished Business SB183 Lowenthal",23,9,0,0,32
62201,22906,2009-03-25,Senate,"Do pass",5,0,0,0,5
62201,22907,2009-04-27,Senate,"Senate 3rd Reading SB186 DeSaulnier",29,10,0,0,39
62201,22908,2009-07-08,Assembly,"Do pass",9,1,0,0,10
62201,22909,2009-09-03,Assembly,"SB 186 DeSaulnier  Senate Third Reading  By SOLORIO",69,2,0,0,71
62202,2449,2009-04-29,Senate,"Do pass, but re-refer to the Committee on Appropriations",2,4,0,0,6
62202,2450,2009-05-13,Senate,"Reconsideration granted",5,0,1,0,6
62203,22583,2009-04-29,Senate,"Do pass, but re-refer to the Committee on Judiciary",9,0,0,0,9
62203,22584,2009-05-12,Senate,"Do pass as amended",5,0,0,0,5
62203,22585,2009-06-03,Senate,"Special Consent #8 SB188 Runner",39,0,0,0,39
62203,22586,2009-06-30,Assembly,"Amend, and do pass as amended and be re-referred to the Committee 	on Education with the recommendation:  To Consent Calendar",10,0,0,0,10
62203,22587,2009-08-19,Assembly,"Do pass, to Consent Calendar",17,0,0,0,17
62203,22588,2009-09-10,Assembly,"Do pass as amended, to Consent Calendar",10,0,0,0,10
62203,22589,2009-09-11,Assembly,"SB 188 Runner  Senate Third Reading  By KNIGHT",78,0,0,0,78
62203,22590,2009-09-11,Senate,"Unfinished Supp 2 SB188 Runner",40,0,0,0,40
62204,2485,2010-01-12,Senate,"Do pass as amended, and re-refer to the Committee on Appropriations",5,0,0,0,5
62204,2486,2010-01-25,Senate,"SENATE 3RD READING SB189 LOWENTHAL",35,0,4,0,39
62204,9002,2010-06-15,Assembly,"Do pass and re-refer to Committee on Appropriations with recommendation:  To Consent Calendar",10,0,0,0,10
62204,19648,2010-08-04,Assembly,"Do pass, to Consent Calendar",17,0,0,0,17
62204,20380,2010-08-17,Assembly,"SB 189 Lowenthal  Senate Third Reading  By FEUER",75,0,0,0,75
62204,21421,2010-08-25,Senate,"Unfinished Business SB189 Lowenthal",35,0,0,0,35
62205,2540,2009-04-29,Senate,"Do pass as amended, and re-refer to the Committee on Appropriations",11,0,0,0,11
62205,2541,2009-05-26,Senate,"Do pass",8,1,4,0,13
62205,2542,2009-06-01,Senate,"Senate 3rd Reading SB190 Wright",36,1,2,0,39
62205,2543,2009-07-07,Assembly,"Do pass and be re-referred to the Committee on Appropriations",12,4,3,0,19
62205,2544,2009-08-19,Assembly,"Do pass",12,5,0,0,17
62206,22686,2009-04-22,Senate,"Do pass, but re-refer to the Committee on Appropriations",8,0,0,0,8
62206,22687,2009-05-11,Senate,"Special Consent #3 SB191 Wright",36,0,0,0,36
62206,22688,2009-07-08,Assembly,"Do pass as amended and re-refer to Committee on Appropriations 	with recommendation:  To Consent Calendar",11,0,0,0,11
62206,22689,2009-08-19,Assembly,"Do pass, to Consent Calendar",17,0,0,0,17
62206,22690,2009-08-27,Assembly,"SB 191 Wright  Consent Calendar Second Day  Regular Session",74,0,0,0,74
62206,22691,2009-09-02,Senate,"Special Consent #18 SB191 Wright",39,0,0,0,39
62207,2502,2009-04-14,Senate,"Do pass and be placed on the Consent Calendar",13,0,0,0,13
62207,2503,2009-04-20,Senate,"Consent Calendar 2nd SB192 Negrete",37,0,2,0,39
62207,2504,2009-07-01,Assembly,"Do pass, to Consent Calendar",17,0,2,0,19
62207,20996,2010-08-20,Assembly,"SB 192 Negrete McLeod  Senate Third Reading  Amend By BROWNLEY  Set 	#1",49,26,0,0,75
62208,2439,2009-04-29,Senate,"Do pass as amended, and re-refer to the Committee on Appropriations",9,0,0,0,9
62208,2440,2009-05-18,Senate,"Placed on Appropriations Suspense file",13,0,0,0,13
62208,2441,2009-05-28,Senate,"Do pass as amended",12,0,1,0,13
62208,2442,2009-06-03,Senate,"Special Consent #8 SB193 Lowenthal",39,0,0,0,39
62208,2443,2009-07-08,Assembly,"Do pass as amended and re-refer to Committee on Appropriations with recommendation:  To Consent Calendar",11,0,0,0,11
62208,2444,2009-08-27,Assembly,"Do pass",17,0,0,0,17
62208,2445,2009-09-01,Assembly,"SB 193 Lowenthal  Third Reading Urgency  By LOWENTHAL",78,0,1,0,79
62208,2446,2009-09-09,Senate,"Special Consent #20 SB193 Lowenthal Reconsider",40,0,0,0,40
62208,2447,2009-09-11,Assembly,"SB 193 Lowenthal  Senate Third Reading  By LOWENTHAL",78,0,1,0,79
62208,2448,2009-09-11,Senate,"Unfinished Supp 2 SB193 Lowenthal",40,0,0,0,40
62208,9121,2009-09-09,Senate,"Special Consent #20 SB193 Lowenthal",25,1,14,0,40
62209,2577,2009-04-29,Senate,"Do pass as amended, and re-refer to the Committee on Rules",3,2,0,0,5
62209,2578,2009-05-26,Senate,"Placed on Appropriations Suspense file",13,0,0,0,13
62209,2579,2010-01-28,Senate,"SENATE 3RD READING SB194 FLOREZ",23,14,2,0,39
62209,9839,2010-06-30,Assembly,"Do pass as amended",7,2,0,0,9
62209,21624,2010-08-26,Assembly,"SB 194 Florez  Senate Third Reading  By ARAMBULA",43,31,0,0,74
62209,21749,2010-08-30,Senate,"Unfinished Business SB194 Florez",22,14,0,0,36
62210,2490,2009-04-15,Senate,"Do pass, but re-refer to the Committee on Judiciary",5,1,3,0,9
62210,2491,2009-04-28,Senate,"Do pass as amended, and re-refer to the Committee on Appropriations",3,2,0,0,5
62210,2492,2009-05-26,Senate,"Placed on Appropriations Suspense file",13,0,0,0,13
62211,2493,2009-04-01,Senate,"Do pass as amended, and re-refer to the Committee on Appropriations",7,4,0,0,11
62211,2494,2009-05-21,Senate,"Senate 3rd Reading SB196 Corbett",21,13,5,0,39
62211,2495,2009-06-30,Assembly,"Do pass and be re-referred to the Committee on Appropriations",9,5,5,0,19
62211,2496,2009-06-30,Assembly,"Set second hearing.  Failed passage.  Reconsideration granted",19,0,0,0,19
62211,2497,2009-07-07,Assembly,"Do pass as amended and be re-referred to the Committee on Appropriations",14,5,0,0,19
62211,2498,2009-08-19,Assembly,"Do pass",12,5,0,0,17
62211,2499,2009-09-01,Assembly,"SB 196 Corbett  Senate Third Reading  By HUFFMAN",49,27,3,0,79
62211,2500,2009-09-08,Senate,"From committee:  That the Assembly Amendments be concurred in",7,3,1,0,11
62211,2501,2009-09-09,Senate,"Unfinished Business SB196 Corbett",22,16,2,0,40
62212,25212,2009-04-14,Senate,"Do pass as amended",7,0,0,0,7
62212,25213,2009-05-06,Senate,"Senate 3rd Reading SB197 Pavley",35,0,0,0,35
62212,25214,2009-06-30,Assembly,"Do pass as amended",7,0,0,0,7
62212,25215,2009-09-02,Assembly,"SB 197 Pavley  Senate Third Reading  By ARAMBULA",78,0,0,0,78
62212,25216,2009-09-08,Senate,"Unfinished Business SB197 Pavley",40,0,0,0,40
62213,22855,2009-05-06,Senate,"Do pass",4,0,0,0,4
62213,22856,2009-05-14,Senate,"Special Consent #4 SB198 Cogdill",38,0,0,0,38
62213,22857,2009-06-17,Assembly,"Do pass, to Consent Calendar",7,0,0,0,7
62213,22858,2009-07-13,Assembly,"SB 198 Cogdill  Senate Third Reading  By BERRYHILL, T",77,0,0,0,77
62214,2536,2009-04-15,Senate,"Do pass as amended, and re-refer to the Committee on Appropriations",6,1,2,0,9
62214,2537,2009-05-04,Senate,"Placed on Appropriations Suspense file",11,0,2,0,13
62215,23217,2009-04-14,Senate,"Do pass as amended",13,0,0,0,13
62215,23218,2009-04-20,Senate,"Senate 3rd Reading SB200 Correa",37,0,0,0,37
62215,23219,2009-07-01,Assembly,"Do pass as amended",17,0,0,0,17
62215,23220,2009-07-13,Assembly,"SB 200 Correa  Senate Third Reading  By HARKEY",77,0,0,0,77
62215,23221,2009-07-16,Senate,"Unfinished Business SB200 Correa Concurrence",35,0,0,0,35
62216,2621,2009-05-12,Senate,"Do pass as amended",7,4,0,0,11
62216,2622,2009-05-26,Senate,"Senate 3rd Reading SB201 Oropeza",22,14,3,0,39
62216,2623,2009-06-29,Assembly,"Do pass",9,5,0,0,14
62216,2624,2009-09-04,Assembly,"SB 201 Oropeza  Senate Third Reading  By FURUTANI  Amend By FURUTANI  Set #1",43,28,8,0,79
62216,2625,2009-09-08,Assembly,"SB 201 Oropeza  Senate Third Reading  By FURUTANI",49,28,2,0,79
62216,2626,2009-09-10,Senate,"Unfinished Business SB201 Oropeza",21,16,3,0,40
62217,216,2009-04-27,Senate,"Do pass, but re-refer to the Committee on Appropriations.",10,0,0,0,10
62217,217,2009-05-11,Senate,"Do pass as amended.",13,0,0,0,13
62217,218,2009-05-18,Senate,"Senate 3rd Reading SB202 Harman",33,0,6,0,39
62217,219,2009-06-30,Assembly,"Do pass as amended and be re-referred to the Committee on Appropriations.",10,0,0,0,10
62217,220,2009-08-27,Assembly,"Do pass.",16,1,0,0,17
62217,221,2010-05-28,Assembly,"Be referred to Committee on Judiciary.",9,0,2,0,11
62217,9186,2010-06-22,Assembly,"Do pass, to Consent Calendar",10,0,0,0,10
62217,20326,2010-08-16,Assembly,"SB 202 Harman  Senate Third Reading  By TRAN",74,0,0,0,74
62217,20794,2010-08-23,Senate,"From committee:  That the Assembly Amendments be concurred in",4,0,0,0,4
62217,21448,2010-08-26,Senate,"Special Consent #32 SB202 Harman",34,0,0,0,34
62218,2538,2010-01-12,Senate,"Do pass as amended, and re-refer to the Committee on Appropriations",7,0,0,0,7
62218,2539,2010-01-25,Senate,"SENATE 3RD READING SB203 HARMAN",36,0,3,0,39
62218,9191,2010-06-22,Assembly,"Do pass as amended and be re-referred to the Committee on Appropriations",6,0,1,0,7
62219,26138,2009-04-15,Senate,"Do pass as amended, and re-refer to the Committee on 	Appropriations",11,0,0,0,11
62219,26139,2009-04-27,Senate,"Do pass",12,0,0,0,12
62219,26140,2009-05-06,Senate,"Senate 3rd Reading SB204 Benoit",33,1,0,0,34
62219,26141,2009-06-29,Assembly,"Do pass and be re-referred to the Committee on Appropriations",10,1,0,0,11
62219,26142,2009-07-15,Assembly,"Do pass",16,0,0,0,16
62219,26143,2009-09-03,Assembly,"SB 204 Benoit  Senate Third Reading  By HAGMAN",72,1,0,0,73
62219,26144,2009-09-09,Senate,"Unfinished Business SB204 Benoit",38,0,0,0,38
62220,25922,2009-03-31,Senate,"Do pass as amended, and re-refer to the Committee on Appropriations",7,4,0,0,11
62220,25923,2009-04-27,Senate,"Do pass",8,4,0,0,12
62220,25924,2009-06-01,Senate,"Senate 3rd Reading SB205 Hancock",21,17,0,0,38
62220,25925,2009-06-29,Assembly,"Do pass and be re-referred to the Committee on Local Government",9,5,0,0,14
62220,25926,2009-07-08,Assembly,"Do pass as amended and be re-referred to the Committee on 	Appropriations",5,2,0,0,7
62220,25927,2010-01-21,Assembly,"Do pass as amended",17,0,0,0,17
62220,25928,2010-02-16,Assembly,"SB 205 Hancock  Third Reading Urgency  By BROWNLEY",72,0,0,0,72
62220,25929,2010-03-11,Assembly,"SB 205 Hancock  Third Reading Urgency  By BROWNLEY",73,0,0,0,73
62220,25930,2010-03-15,Senate,"From committee:  That the Assembly Amendments be concurred in",10,0,0,0,10
62220,25931,2010-03-22,Senate,"Unfinished Business SB205 Hancock Urgency Clause",37,0,0,0,37
62223,2669,2009-04-22,Senate,"Do pass, but re-refer to the Committee on Appropriations",11,0,0,0,11
62223,2670,2009-05-14,Senate,"Senate 3rd Reading SB208 Steinberg Urgency Clause",38,0,1,0,39
62223,10161,2010-06-29,Assembly,"Do pass and be re-referred to the Committee on Appropriations",13,0,6,0,19
62223,20210,2010-08-12,Assembly,"Do pass",12,0,0,0,12
62223,22204,2010-10-07,Assembly,"SB 208 Steinberg  Third Reading Urgency  By MONNING",71,0,0,0,71
62223,22205,2010-10-07,Senate,"W/O REF. TO FILE SB208 Steinberg Urgency Clause",35,0,0,0,35
62224,22529,2009-03-31,Senate,"Do pass and be placed on the Consent Calendar",5,0,0,0,5
62224,22530,2009-04-13,Senate,"Consent Calendar 2nd SB209 Corbett",36,0,0,0,36
62224,22531,2009-06-23,Assembly,"Do pass as amended, to Consent Calendar",10,0,0,0,10
62224,22532,2009-07-09,Assembly,"SB 209 Corbett  Consent Calendar Second Day  Regular Session",74,0,0,0,74
62224,22533,2009-08-17,Senate,"Special Consent #14 SB209 Corbett",35,0,0,0,35
62226,2574,2009-04-01,Senate,"Do pass as amended",4,1,0,0,5
62226,2575,2009-04-16,Senate,"Senate 3rd Reading SB211 Simitian",31,4,4,0,39
62226,2576,2009-07-08,Assembly,"Do pass",5,2,0,0,7
62226,9361,2010-06-24,Assembly,"SB 211 Simitian  Senate Third Reading  By FONG  Amend By FONG  Set #1",50,25,4,0,79
62226,10359,2010-07-01,Assembly,"Do pass and be re-referred to the Committee on Appropriations",6,0,1,0,7
62226,20254,2010-08-12,Assembly,"Do pass",17,0,0,0,17
62226,20344,2010-08-17,Assembly,"SB 211 Simitian  Senate Third Reading  By FONG",76,0,0,0,76
62226,20656,2010-08-20,Senate,"From committee:  That the Assembly Amendments be concurred in",4,0,0,0,4
62226,21159,2010-08-25,Senate,"Unfinished Business SB211 Simitian",34,0,0,0,34
62227,2655,2009-04-22,Senate,"Do pass, but re-refer to the Committee on Health",5,2,2,0,9
62227,2656,2009-04-29,Senate,"Do pass as amended, and re-refer to the Committee on Appropriations",11,0,0,0,11
62227,2657,2009-06-03,Senate,"Senate 3rd Reading SB212 Florez",31,7,1,0,39
62227,2658,2009-07-08,Assembly,"Do pass and be re-referred to the Committee on Appropriations",8,1,2,0,11
62227,2659,2009-08-19,Assembly,"Do pass",13,4,0,0,17
62227,2660,2009-09-03,Assembly,"SB 212 Florez  Senate Third Reading  By SOLORIO",54,20,5,0,79
62228,2715,2009-05-12,Senate,"Do pass as amended, and re-refer to the Committee on Appropriations",6,1,5,0,12
62228,2716,2009-05-12,Senate,"Set, first hearing.  Failed passage in Committee.  Reconsideration granted",7,0,5,0,12
62228,2717,2009-05-14,Senate,"Do pass as amended, and re-refer to the Committee on Appropriations",7,2,3,0,12
62228,2718,2009-05-26,Senate,"Placed on Appropriations Suspense file",13,0,0,0,13
62228,2719,2009-05-28,Senate,"Do pass as amended",8,0,5,0,13
62228,2720,2009-06-03,Senate,"Senate 3rd Reading SB213 Florez",32,3,4,0,39
62228,2721,2009-07-08,Assembly,"Do pass and be re-referred to the Committee on Appropriations",18,0,1,0,19
62228,2722,2009-08-27,Assembly,"Do pass",17,0,0,0,17
62228,2723,2009-09-08,Assembly,"SB 213 Florez  Senate Third Reading  By HALL",73,0,6,0,79
62228,2724,2009-09-10,Senate,"Unfinished Business SB213 Florez Concurrence",31,3,6,0,40
62230,22753,2009-04-01,Senate,"Do pass, but re-refer to the Committee on Appropriations",3,2,0,0,5
62230,22754,2009-04-23,Senate,"Senate 3rd Reading SB215 Wiggins",21,14,0,0,35
62230,22755,2009-06-17,Assembly,"Do pass as amended and be re-referred to the Committee on 	Appropriations",5,2,0,0,7
62230,22756,2009-07-01,Assembly,"Do pass",10,5,0,0,15
62230,22757,2009-08-17,Assembly,"SB 215 Wiggins  Senate Third Reading  By SKINNER",50,26,0,0,76
62230,22758,2009-08-24,Senate,"Unfinished Business SB215 Wiggins Concurrence",24,12,0,0,36
62231,2617,2009-04-22,Senate,"Do pass, but re-refer to the Committee on Appropriations",8,0,1,0,9
62231,2618,2009-05-04,Senate,"Placed on Appropriations Suspense file",11,0,2,0,13
62232,2766,2009-04-29,Senate,"Do pass as amended, and re-refer to the Committee on Appropriations",7,2,0,0,9
62232,2767,2009-05-26,Senate,"Senate 3rd Reading SB217 Yee",35,3,1,0,39
62232,2768,2009-07-07,Assembly,"Do pass and be re-referred to the Committee on Appropriations",8,0,1,0,9
62233,2759,2009-05-12,Senate,"Do pass as amended",4,1,0,0,5
62233,2760,2009-06-03,Senate,"Senate 3rd Reading SB218 Yee",35,1,3,0,39
62233,2761,2009-07-07,Assembly,"Do pass and be re-referred to the Committee on Governmental Organization",8,0,1,0,9
62233,2762,2009-07-08,Assembly,"Do pass as amended and be re-referred to the Committee on Appropriations",18,0,1,0,19
62233,2763,2009-08-19,Assembly,"Do pass as amended",16,0,1,0,17
62233,2764,2009-09-03,Assembly,"SB 218 Yee  Senate Third Reading  By NIELSEN",76,0,3,0,79
62233,2765,2009-09-08,Senate,"Unfinished Business SB218 Yee",33,1,6,0,40
62234,2661,2009-05-05,Senate,"Do pass",3,0,2,0,5
62234,2662,2009-05-18,Senate,"Senate 3rd Reading SB219 Yee Reconsider",36,0,3,0,39
62234,2663,2009-05-26,Senate,"Senate 3rd Reading SB219 Yee",23,14,2,0,39
62234,2664,2009-06-23,Assembly,"Do pass as amended",8,2,0,0,10
62234,2665,2009-07-13,Assembly,"SB 219 Yee  Senate Third Reading  By YAMADA",50,24,5,0,79
62234,2666,2009-08-24,Senate,"Unfinished Business SB219 Yee",22,14,4,0,40
62234,9122,2009-05-18,Senate,"Senate 3rd Reading SB219 Yee",19,15,5,0,39
62235,1569,2009-04-21,Senate,"Do pass, but re-refer to the Committee on Appropriations",3,2,0,0,5
62235,1570,2009-05-11,Senate,"Senate 3rd Reading SB220 Yee",21,15,3,0,39
62235,1571,2009-06-23,Assembly,"Do pass as amended and be re-referred to the Committee on Appropriations",7,2,1,0,10
62235,1572,2009-07-15,Assembly,"Do pass as amended",11,5,0,0,16
62235,1573,2010-03-11,Assembly,"SB 220 Yee  Senate Third Reading  Amend By JONES  Set #1",47,24,8,0,79
62235,1574,2010-05-06,Assembly,"Be referred to Committee on Health",10,0,1,0,11
62235,9299,2010-06-22,Assembly,"Do pass as amended and be re-referred to the Committee on Appropriations",14,5,0,0,19
62235,19879,2010-08-12,Assembly,"Do pass as amended",12,5,0,0,17
62235,20674,2010-08-20,Assembly,"SB 220 Yee  Senate Third Reading  Amend By FUENTES  Set #1",48,27,0,0,75
62235,21232,2010-08-25,Assembly,"Do pass",12,2,0,0,14
62235,21728,2010-08-30,Assembly,"SB 220 Yee  Senate Third Reading  By FUENTES",54,24,0,0,78
62235,21824,2010-08-31,Senate,"From committee:  That the Assembly Amendments be concurred in",5,3,0,0,8
62235,21825,2010-08-31,Senate,"W/O REF. TO FILE SB220 Yee Concurrence",22,13,0,0,35
62236,22809,2009-04-01,Senate,"Do pass, but re-refer to the Committee on Appropriations",11,0,0,0,11
62236,22810,2009-04-23,Senate,"Special Consent #1 SB221 Walters",37,0,0,0,37
62236,22811,2009-06-09,Assembly,"Do pass and re-refer to Committee on Appropriations with 	recommendation:  To Consent Calendar",18,0,0,0,18
62236,22812,2009-07-01,Assembly,"Do pass, to Consent Calendar",15,0,0,0,15
62236,22813,2009-07-09,Assembly,"SB 221 Walters  Consent Calendar Second Day  Regular Session",74,0,0,0,74
62238,2795,2009-04-29,Senate,"Do pass as amended, but re-refer to the Committee on Appropriations Recommend Consent",9,0,0,0,9
62238,2796,2009-05-26,Senate,"Special Consent #6 SB223 Wyland",39,0,0,0,39
62238,2797,2009-07-08,Assembly,"Do pass as amended and be re-referred to the Committee on Appropriations",11,0,0,0,11
62239,23154,2009-03-31,Senate,"Do pass, but re-refer to the Committee on Appropriations Recommend 	Consent",11,0,0,0,11
62239,23155,2009-04-23,Senate,"Special Consent #1 SB224 Correa",37,0,0,0,37
62239,23156,2009-06-17,Assembly,"Do pass and be re-referred to the Committee on Appropriations",6,0,0,0,6
62239,23157,2009-07-01,Assembly,"Do pass as amended, to Consent Calendar",15,0,0,0,15
62239,23158,2009-07-09,Assembly,"SB 224 Correa  Consent Calendar Second Day  Regular Session",74,0,0,0,74
62239,23159,2009-08-17,Senate,"Special Consent #14 SB224 Correa",35,0,0,0,35
62241,25717,2009-04-21,Senate,"Do pass",7,0,0,0,7
62241,25718,2009-04-23,Senate,"Special Consent #1 SB226 Alquist",37,0,0,0,37
62241,25719,2009-06-16,Assembly,"Do pass as amended, to Consent Calendar",7,0,0,0,7
62241,25720,2009-06-30,Assembly,"SB 226 Alquist  Consent Calendar Second Day  By MA",77,0,0,0,77
62241,25721,2009-07-16,Senate,"Special Consent #13 SB226 Alquist",36,0,0,0,36
62242,2706,2009-04-22,Senate,"Do pass, but re-refer to the Committee on Appropriations",10,1,0,0,11
62242,2707,2009-05-04,Senate,"Placed on Appropriations Suspense file",11,0,2,0,13
62242,2708,2009-05-28,Senate,"Do pass as amended",8,3,2,0,13
62242,2709,2009-06-03,Senate,"Senate 3rd Reading SB227 Alquist",23,15,1,0,39
62242,2710,2009-06-30,Assembly,"Do pass as amended and be re-referred to the Committee on Appropriations",13,6,0,0,19
62242,8770,2010-06-15,Assembly,"Do pass and be re-referred to the Committee on Appropriations",18,0,1,0,19
62242,8982,2010-06-17,Assembly,"Do pass as amended",14,0,3,0,17
62242,9112,2010-06-21,Assembly,"SB 227 Alquist  Third Reading Urgency  By VILLINES",76,0,3,0,79
62242,9435,2010-06-23,Senate,"From committee:  That the Assembly Amendments be concurred in",6,0,3,0,9
62242,9585,2010-06-28,Senate,"Unfinished Business SB227 Alquist Urgency Clause",28,8,3,0,39
62243,2842,2009-05-04,Senate,"Do pass as amended",5,2,0,0,7
62243,2843,2009-05-26,Senate,"Placed on Appropriations Suspense file",13,0,0,0,13
62243,2844,2010-01-21,Senate,"Do pass as amended",6,3,2,0,11
62243,2845,2010-01-28,Senate,"SENATE 3RD READING SB228 DESAULNIER",24,10,5,0,39
62243,9868,2010-06-28,Assembly,"Do pass and be re-referred to the Committee on Appropriations",7,1,1,0,9
62243,19578,2010-08-04,Assembly,"Do pass as amended",12,4,0,0,16
62243,20828,2010-08-23,Assembly,"SB 228 DeSaulnier  Senate Third Reading  By SKINNER",55,21,0,0,76
62243,21477,2010-08-26,Senate,"Unfinished Business SB228 DeSaulnier",23,13,0,0,36
62244,2835,2009-04-14,Senate,"Do pass, but re-refer to the Committee on Appropriations",7,3,1,0,11
62244,2836,2009-05-11,Senate,"Placed on Appropriations Suspense file",13,0,0,0,13
62244,2837,2009-05-28,Senate,"Do pass as amended",7,5,1,0,13
62244,2838,2009-06-03,Senate,"Senate 3rd Reading SB229 Pavley",22,15,2,0,39
62244,2839,2009-07-09,Assembly,"SB 229 Pavley  Senate Third Reading  By HUFFMAN  Amend By HUFFMAN Set #1",43,26,10,0,79
62244,2840,2009-07-13,Assembly,"SB 229 Pavley  Senate Third Reading  By HUFFMAN",46,24,9,0,79
62244,2841,2009-07-16,Senate,"Unfinished Business SB229 Pavley Concurrence",0,36,4,0,40
62245,26232,2009-04-20,Senate,"Do pass, but re-refer to the Committee on Appropriations Recommend 	Consent",7,0,0,0,7
62245,26233,2009-05-11,Senate,"Special Consent #3 SB230 Cogdill",36,0,0,0,36
62245,26234,2009-06-22,Assembly,"Do pass and re-refer to Committee on Appropriations with 	recommendation:  To Consent Calendar",9,0,0,0,9
62245,26235,2009-07-01,Assembly,"Do pass, to Consent Calendar",15,0,0,0,15
62245,26236,2009-07-09,Assembly,"SB 230 Cogdill  Consent Calendar Second Day  Regular Session",74,0,0,0,74
62246,2753,2009-04-27,Senate,"Do pass, but re-refer to the Committee on Appropriations",5,2,0,0,7
62246,2754,2009-05-11,Senate,"Do pass",7,3,3,0,13
62246,2755,2009-05-26,Senate,"Senate 3rd Reading SB231 Lowenthal",22,17,0,0,39
62246,10029,2010-06-29,Assembly,"Do pass and be re-referred to the Committee on Appropriations",6,3,0,0,9
62246,20110,2010-08-12,Assembly,"Do pass",12,5,0,0,17
62249,2872,2009-04-29,Senate,"Do pass as amended, and re-refer to the Committee on Appropriations",8,0,1,0,9
62249,2873,2009-06-03,Senate,"Senate 3rd Reading SB234 Wyland",35,0,4,0,39
62249,2874,2009-07-08,Assembly,"Do pass as amended and be re-referred to the Committee on Appropriations",10,0,1,0,11
62252,26054,2009-04-13,Senate,"Do pass, but re-refer to the Committee on Appropriations",8,1,0,0,9
62252,26055,2009-04-27,Senate,"Do pass",8,0,0,0,8
62252,26056,2009-05-06,Senate,"Senate 3rd Reading SB237 Calderon",35,0,0,0,35
62252,26057,2009-06-16,Assembly,"Do pass as amended and be re-referred to the Committee on 	Appropriations",9,0,0,0,9
62252,26058,2009-07-08,Assembly,"Do pass",13,0,0,0,13
62252,26059,2009-08-20,Assembly,"SB 237 Calderon  Senate Third Reading  By HAYASHI",63,9,0,0,72
62252,26060,2009-08-27,Senate,"Unfinished Business SB237 Calderon",34,3,0,0,37
62254,22718,2009-04-28,Senate,"Do pass as amended, and re-refer to the Committee on Appropriations",7,0,0,0,7
62254,22719,2009-05-26,Senate,"Special Consent #6 SB239 Pavley",39,0,0,0,39
62254,22720,2009-06-23,Assembly,"Do pass and be re-referred to the Committee on Appropriations",7,0,0,0,7
62254,22721,2009-07-08,Assembly,"Do pass, to Consent Calendar",15,0,0,0,15
62254,22722,2009-08-17,Assembly,"SB 239 Pavley  Senate Third Reading  By LIEU",76,0,0,0,76
62255,22775,2009-04-14,Senate,"Do pass, but re-refer to the Committee on Appropriations",8,2,0,0,10
62255,22776,2009-04-27,Senate,"Do pass",9,0,0,0,9
62255,22777,2009-05-14,Senate,"Senate 3rd Reading SB240 Wright",30,2,0,0,32
62255,22778,2009-06-29,Assembly,"Do pass and be re-referred to the Committee on Appropriations",14,0,0,0,14
62255,22779,2009-07-08,Assembly,"Do pass",15,0,0,0,15
62255,22780,2009-09-11,Senate,"From committee:  That the Assembly Amendments be concurred in",8,1,0,0,9
62255,22781,2009-09-11,Assembly,"SB 240 Wright  Senate Third Reading  By DE LEON",78,1,0,0,79
62255,22782,2009-09-11,Senate,"Unfinished Supp 1 SB240 Wright Concurrence",34,2,0,0,36
62256,23004,2009-04-22,Senate,"Do pass, but re-refer to the Committee on Appropriations",11,0,0,0,11
62256,23005,2009-05-11,Senate,"Special Consent #3 SB241 Runner",36,0,0,0,36
62256,23006,2009-07-07,Assembly,"Do pass and re-refer to Committee on Appropriations with 	recommendation:  To Consent Calendar",18,0,0,0,18
62256,23007,2009-08-19,Assembly,"Do pass, to Consent Calendar",17,0,0,0,17
62256,23008,2009-08-27,Assembly,"SB 241 Runner  Consent Calendar Second Day  Regular Session",74,0,0,0,74
62256,23009,2009-09-02,Senate,"Special Consent #18 SB241 Runner",39,0,0,0,39
62257,2922,2009-03-31,Senate,"Do pass",3,2,0,0,5
62257,2923,2009-04-16,Senate,"Senate 3rd Reading SB242 Yee",21,15,3,0,39
62257,2924,2009-06-30,Assembly,"Do pass as amended",7,2,1,0,10
62257,2925,2009-08-20,Assembly,"SB 242 Yee  Senate Third Reading  By HAYASHI",48,27,4,0,79
62257,2926,2009-09-02,Senate,"Unfinished Business SB242 Yee",21,12,7,0,40
62259,2999,2009-04-22,Senate,"Do pass as amended, and re-refer to the Committee on Appropriations",6,1,2,0,9
62259,3000,2009-05-18,Senate,"Placed on Appropriations Suspense file",13,0,0,0,13
62259,3001,2009-05-28,Senate,"Do pass as amended",7,5,1,0,13
62259,3002,2009-06-03,Senate,"Senate 3rd Reading SB244 Wright",28,11,0,0,39
62259,3003,2009-06-30,Assembly,"Do pass as amended and be re-referred to the Committee on Appropriations",5,0,2,0,7
62259,3004,2010-05-20,Assembly,"Be referred to Committee on Human Services",11,0,0,0,11
62259,8966,2010-06-15,Assembly,"Do pass and be re-referred to the Committee on Education",5,0,1,0,6
62262,26241,2009-04-29,Senate,"Do pass as amended",9,0,0,0,9
62262,26242,2009-05-11,Senate,"Senate 3rd Reading SB247 Alquist",36,0,0,0,36
62262,26243,2009-07-08,Assembly,"Do pass as amended",11,0,0,0,11
62262,26244,2009-08-17,Assembly,"SB 247 Alquist  Senate Third Reading  By TORLAKSON",75,0,0,0,75
62262,26245,2009-08-24,Senate,"Special Consent #15 SB247 Alquist",39,0,0,0,39
62263,2964,2009-04-22,Senate,"Do pass as amended, and re-refer to the Committee on Appropriations",8,1,0,0,9
62263,2965,2009-05-11,Senate,"Placed on Appropriations Suspense file",13,0,0,0,13
62263,2966,2009-05-28,Senate,"Do pass as amended",8,4,1,0,13
62263,2967,2009-06-01,Senate,"Senate 3rd Reading SB248 Oropeza",25,12,2,0,39
62263,2968,2009-07-01,Assembly,"Do pass and be re-referred to the Committee on Higher Education",7,3,1,0,11
62263,2969,2009-07-07,Assembly,"Do pass and be re-referred to the Committee on Appropriations",7,1,1,0,9
62263,2970,2009-08-27,Assembly,"Do pass as amended",12,5,0,0,17
62263,2971,2009-09-03,Assembly,"SB 248 Oropeza  Senate Third Reading  By PORTANTINO",54,21,4,0,79
62263,2972,2009-09-08,Senate,"Unfinished Business SB248 Oropeza",25,12,3,0,40
62264,23735,2009-04-15,Senate,"Do pass as amended",10,0,0,0,10
62264,23736,2009-05-18,Senate,"Special Consent #5 SB249 Cox",36,0,0,0,36
62264,23737,2009-06-30,Assembly,"Do pass and re-refer to Committee on Appropriations with 	recommendation:  To Consent Calendar",16,0,0,0,16
62264,23738,2009-07-08,Assembly,"Do pass, to Consent Calendar",15,0,0,0,15
62264,23739,2009-09-02,Assembly,"SB 249 Cox  Senate Third Reading  By TORLAKSON",78,0,0,0,78
62264,23740,2009-09-09,Senate,"Special Consent #20 SB249 Cox",40,0,0,0,40
62265,2909,2009-04-15,Senate,"Do pass as amended, and re-refer to the Committee on Appropriations",3,1,1,0,5
62265,2910,2009-05-11,Senate,"Placed on Appropriations Suspense file",13,0,0,0,13
62265,2911,2009-05-28,Senate,"Do pass as amended",7,5,1,0,13
62265,2912,2009-06-01,Senate,"Senate 3rd Reading SB250 Florez",16,15,8,0,39
62265,2913,2009-06-01,Senate,"Senate 3rd Reading SB250 Florez Reconsider",35,0,4,0,39
62265,2914,2009-06-02,Senate,"Senate 3rd Reading SB250 Florez",21,16,2,0,39
62265,2915,2009-06-30,Assembly,"Do pass and be re-referred to the Committee on Appropriations",6,4,0,0,10
62265,2916,2009-08-27,Assembly,"Do pass as amended",9,5,3,0,17
62265,2917,2009-09-08,Assembly,"SB 250 Florez  Senate Third Reading  By BLUMENFIELD",28,42,9,0,79
62265,21622,2010-08-26,Assembly,"SB 250 Florez  Senate Third Reading  By BLUMENFIELD",34,40,0,0,74
62265,21813,2010-08-31,Assembly,"SB 250 Florez  Motion to Reconsider  By BLUMENFIELD",42,27,0,0,69
62265,21814,2010-08-31,Assembly,"SB 250 Florez  Senate Third Reading  By BLUMENFIELD",28,40,0,0,68
62266,26253,2009-04-14,Senate,"Do pass and be placed on the Consent Calendar",10,0,0,0,10
62266,26254,2009-04-23,Senate,"Consent Calendar 2nd SB251 Committee on T.& H. (Lowenthal)",37,0,0,0,37
62266,26255,2009-07-08,Assembly,"Do pass, to Consent Calendar",6,0,0,0,6
62266,26256,2009-07-16,Assembly,"SB 251 T.& H.  Consent Calendar Second Day  Regular Session",72,0,0,0,72
62266,26257,2009-09-08,Assembly,"SB 251 T.& H.  Senate Third Reading  By TORRES",78,0,0,0,78
62266,26258,2009-09-10,Senate,"Unfinished Business SB251 Committee on T.&H. (Lowenthal) Concurrence",38,0,0,0,38
62267,2953,2009-04-01,Senate,"Do pass, but re-refer to the Committee on Rules",8,0,1,0,9
62267,2954,2009-04-27,Senate,"Placed on Appropriations Suspense file",13,0,0,0,13
62268,761,2009-04-22,Senate,"Do pass as amended. To Consent Calendar.",7,0,2,0,9
62268,762,2009-05-06,Senate,"Consent Calendar 2nd SB253 Wyland",35,0,4,0,39
62268,763,2009-07-08,Assembly,"Do pass as amended, to Consent Calendar.",11,0,0,0,11
62269,23940,2009-04-28,Senate,"Do pass, but re-refer to the Committee on Judiciary",10,1,0,0,11
62269,23941,2009-05-12,Senate,"Do pass as amended",4,1,0,0,5
62269,23942,2009-05-26,Senate,"Senate 3rd Reading SB254 Wiggins",30,8,0,0,38
62269,23943,2009-07-01,Assembly,"Do pass",17,0,0,0,17
62269,23944,2009-07-13,Assembly,"SB 254 Wiggins  Senate Third Reading  By CHESBRO",77,0,0,0,77
62271,22375,2009-04-28,Senate,"Do pass, but re-refer to the Committee on Appropriations",11,0,0,0,11
62271,22376,2009-05-11,Senate,"Placed on Appropriations Suspense file",13,0,0,0,13
62271,22377,2009-05-28,Senate,"Do pass",12,0,0,0,12
62271,22378,2009-06-03,Senate,"Special Consent #8 SB256 Aanestad",39,0,0,0,39
62271,22379,2009-07-07,Assembly,"Do pass and re-refer to Committee on Appropriations with 	recommendation:  To Consent Calendar",11,0,0,0,11
62271,22380,2009-08-19,Assembly,"Do pass, to Consent Calendar",17,0,0,0,17
62271,22381,2009-08-27,Assembly,"SB 256 Aanestad  Consent Calendar Second Day  Regular Session",74,0,0,0,74
62271,22382,2009-09-02,Senate,"Special Consent #18 SB256 Aanestad",39,0,0,0,39
62272,2958,2009-04-14,Senate,"Do pass, but re-refer to the Committee on Appropriations",9,3,1,0,13
62272,2959,2009-04-27,Senate,"Do pass as amended",8,4,1,0,13
62272,2960,2009-05-11,Senate,"Senate 3rd Reading SB257 Pavley",22,12,5,0,39
62272,2961,2009-06-09,Assembly,"Do pass and be re-referred to the Committee on Appropriations",16,1,2,0,19
62272,2962,2009-07-01,Assembly,"Do pass",12,3,1,0,16
62272,2963,2009-08-20,Assembly,"SB 257 Pavley  Senate Third Reading  By DE LEON",55,15,9,0,79
62273,2955,2009-04-27,Senate,"Do pass, but re-refer to the Committee on Appropriations",7,3,0,0,10
62273,2956,2009-05-11,Senate,"Do pass as amended",8,4,1,0,13
62273,2957,2009-06-01,Senate,"Senate 3rd Reading SB258 Oropeza",23,15,1,0,39
62273,9668,2010-06-29,Assembly,"Do pass and be re-referred to the Committee on Appropriations",7,3,1,0,11
62275,23925,2009-04-13,Senate,"Do pass, but re-refer to the Committee on Appropriations",6,3,0,0,9
62275,23926,2009-04-23,Senate,"Senate 3rd Reading SB260 Wiggins",21,15,0,0,36
62275,23927,2009-06-16,Assembly,"Do pass and be re-referred to the Committee on Appropriations",7,4,0,0,11
62275,23928,2009-08-27,Assembly,"Do pass",12,5,0,0,17
62275,23929,2009-09-02,Assembly,"SB 260 Wiggins  Senate Third Reading  By EVANS",43,33,0,0,76
62276,3071,2009-04-28,Senate,"Do pass as amended, and re-refer to the Committee on Appropriations",11,0,0,0,11
62276,3072,2009-05-18,Senate,"Placed on Appropriations Suspense file",13,0,0,0,13
62276,3073,2009-05-28,Senate,"Do pass as amended",12,0,1,0,13
62276,3074,2009-06-03,Senate,"Special Consent #8 SB261 Dutton",39,0,0,0,39
62276,3075,2009-07-07,Assembly,"Do pass as amended and be re-referred to the Committee on Appropriations",9,0,4,0,13
62277,2990,2009-05-12,Senate,"Do pass as amended",7,3,1,0,11
62277,2991,2009-05-26,Senate,"Senate 3rd Reading SB262 Lowenthal",21,18,0,0,39
62277,2992,2009-07-06,Assembly,"Do pass as amended",8,0,1,0,9
62277,2993,2009-08-24,Assembly,"SB 262 Lowenthal  Senate Third Reading  By CHESBRO",49,27,3,0,79
62277,2994,2009-09-04,Senate,"Unfinished Business SB262 Lowenthal",23,15,2,0,40
62278,22466,2009-05-06,Senate,"Do pass",4,0,0,0,4
62278,22467,2009-05-11,Senate,"Senate 3rd Reading SB263 Strickland",36,0,0,0,36
62278,22468,2009-06-17,Assembly,"Do pass",7,0,0,0,7
62278,22469,2009-06-25,Assembly,"SB 263 Strickland  Senate Third Reading  By STRICKLAND",72,0,0,0,72
62280,3067,2009-04-28,Senate,"Do pass as amended, and re-refer to the Committee on Appropriations",2,4,1,0,7
62280,3068,2009-04-28,Senate,"Set, second hearing.  Failed passage in Committee. Reconsideration granted",6,0,1,0,7
62281,3036,2009-04-29,Senate,"Do pass as amended, and re-refer to the Committee on Appropriations",7,0,2,0,9
62281,3037,2009-05-18,Senate,"Placed on Appropriations Suspense file",13,0,0,0,13
62283,3031,2009-04-29,Senate,"Do pass as amended, and re-refer to the Committee on Appropriations",7,4,0,0,11
62283,3032,2009-06-01,Senate,"Senate 3rd Reading SB268 Harman Reconsider",34,0,5,0,39
62283,3033,2009-06-03,Senate,"Senate 3rd Reading SB268 Harman",23,15,1,0,39
62283,3034,2009-07-07,Assembly,"Do pass and be re-referred to the Committee on Appropriations",2,11,6,0,19
62283,3035,2009-07-07,Assembly,"Set first hearing.  Failed passage.  Reconsideration granted",19,0,0,0,19
62283,6927,2010-06-10,Assembly,"Be referred to Committee on Public Safety",11,0,0,0,11
62283,8910,2009-06-01,Senate,"Senate 3rd Reading SB268 Harman",16,16,7,0,39
62285,3103,2009-04-29,Senate,"Do pass as amended, and re-refer to the Committee on Appropriations",9,0,2,0,11
62285,3104,2009-05-18,Senate,"Placed on Appropriations Suspense file",13,0,0,0,13
62285,3105,2010-01-13,Senate,"Do pass, but re-refer to the Committee on Appropriations Recommend Consent",7,0,2,0,9
62285,3106,2010-01-25,Senate,"SENATE 3RD READING SB270 ALQUIST",33,0,6,0,39
62285,9891,2010-06-29,Assembly,"Do pass as amended and re-refer to Committee on Appropriations with recommendation:  To Consent Calendar",19,0,0,0,19
62285,20164,2010-08-12,Assembly,"Do pass",17,0,0,0,17
62285,20625,2010-08-19,Assembly,"SB 270 Alquist  Third Reading Urgency  By MONNING",79,0,0,0,79
62285,21457,2010-08-26,Senate,"Special Consent #32 SB270 Alquist",34,0,0,0,34
62286,3107,2009-04-29,Senate,"Do pass as amended, and re-refer to the Committee on Appropriations",7,0,2,0,9
62286,3108,2009-05-18,Senate,"Placed on Appropriations Suspense file",13,0,0,0,13
62287,3062,2009-04-22,Senate,"Do pass",6,1,2,0,9
62287,3063,2009-04-27,Senate,"Senate 3rd Reading SB272 Wiggins",25,12,2,0,39
62287,3064,2009-06-17,Assembly,"Do pass as amended",6,3,2,0,11
62287,3065,2009-08-17,Assembly,"SB 272 Wiggins  Senate Third Reading  By TORLAKSON",50,26,3,0,79
62287,3066,2009-08-24,Senate,"Unfinished Business SB272 Wiggins",23,13,4,0,40
62288,23019,2009-04-29,Senate,"Do pass as amended, and re-refer to the Committee on Appropriations",11,0,0,0,11
62288,23020,2009-05-28,Senate,"Senate 3rd Reading SB273 Corbett",34,0,0,0,34
62288,23021,2009-06-30,Assembly,"Do pass as amended and re-refer to Committee on Appropriations 	with recommendation:  To Consent Calendar",16,0,0,0,16
62288,23022,2009-08-19,Assembly,"Do pass, to Consent Calendar",17,0,0,0,17
62288,23023,2009-08-27,Assembly,"SB 273 Corbett  Consent Calendar Second Day  Regular Session",74,0,0,0,74
62288,23024,2009-09-02,Senate,"Special Consent #18 SB273 Corbett",39,0,0,0,39
62289,3128,2009-05-13,Senate,"Do pass, but re-refer to the Committee on Appropriations",3,4,1,0,8
62289,3129,2009-05-13,Senate,"Set, first hearing.  Failed passage in Committee.  Reconsideration granted",7,0,1,0,8
62290,3130,2009-04-20,Senate,"Do pass, but re-refer to the Committee on Appropriations",2,5,3,0,10
62290,3131,2010-01-11,Senate,"Do pass, but re-refer to the Committee on Appropriations",2,0,8,0,10
62292,3101,2009-04-29,Senate,"Do pass, but re-refer to the Committee on Appropriations",4,1,0,0,5
62292,3102,2009-05-18,Senate,"Placed on Appropriations Suspense file",13,0,0,0,13
62294,3155,2009-04-15,Senate,"Do pass as amended",4,1,0,0,5
62294,3156,2009-04-27,Senate,"Senate 3rd Reading SB279 Hancock",26,13,0,0,39
62294,3157,2009-07-01,Assembly,"Do pass as amended",5,2,0,0,7
62294,3158,2009-09-01,Assembly,"SB 279 Hancock  Senate Third Reading  By SILVA",58,19,2,0,79
62294,3159,2009-09-09,Senate,"Unfinished Business SB279 Hancock",25,8,7,0,40
62295,5741,2009-04-27,Senate,"Do pass, but re-refer to the Committee on Appropriations",5,2,0,0,7
62295,5742,2009-05-18,Senate,"Placed on Appropriations Suspense file",13,0,0,0,13
62297,5759,2009-04-21,Senate,"Do pass as amended",3,1,3,0,7
62297,5760,2009-04-21,Senate,"Set, first hearing.  Failed passage in Committee.  Reconsideration granted",5,0,2,0,7
62297,5761,2009-04-28,Senate,"Do pass as amended",4,2,1,0,7
62297,5762,2009-05-14,Senate,"Senate 3rd Reading SB282 Wright",21,14,4,0,39
62297,9706,2010-06-29,Assembly,"Do pass as amended and be re-referred to the Committee on Appropriations",7,0,0,0,7
62297,19375,2010-08-04,Assembly,"Do pass, to Consent Calendar",17,0,0,0,17
62298,23173,2009-04-14,Senate,"Do pass, but re-refer to the Committee on Rules",8,1,0,0,9
62298,23174,2009-04-27,Senate,"Do pass as amended, and re-refer to the Committee on 	Appropriations",7,0,0,0,7
62298,23175,2009-06-02,Senate,"Senate 3rd Reading SB283 DeSaulnier Urgency Clause",35,1,0,0,36
62298,23176,2009-06-16,Assembly,"Do pass and be re-referred to the Committee on Appropriations",10,0,0,0,10
62298,23177,2009-07-01,Assembly,"Do pass, to Consent Calendar",15,0,0,0,15
62298,23178,2009-08-17,Assembly,"SB 283 DeSaulnier  Third Reading Urgency  By HUFFMAN",74,0,0,0,74
62300,26067,2009-04-21,Senate,"Do pass as amended",5,0,0,0,5
62300,26068,2009-04-23,Senate,"Special Consent #1 SB285 Wright",37,0,0,0,37
62300,26069,2009-06-23,Assembly,"Do pass as amended, to Consent Calendar",10,0,0,0,10
62300,26070,2009-08-20,Assembly,"SB 285 Wright  Senate Third Reading  By LIEU",78,0,0,0,78
62300,26071,2009-08-31,Senate,"Special Consent #17 SB285 Wright",36,0,0,0,36
62301,26964,2009-04-14,Senate,"Do pass, but re-refer to the Committee on Appropriations Recommend 	Consent",10,0,0,0,10
62301,26965,2009-04-27,Senate,"Do pass",10,0,0,0,10
62301,26966,2009-05-06,Senate,"Special Consent #2 SB286 Aanestad",35,0,0,0,35
62301,26967,2009-06-16,Assembly,"Do pass and be re-referred to the Committee on Appropriations",11,0,0,0,11
62301,26968,2009-07-01,Assembly,"Do pass",14,0,0,0,14
62301,26969,2009-08-31,Assembly,"SB 286 Aanestad  Senate Third Reading  By NIELSEN",75,0,0,0,75
62301,26970,2009-09-02,Senate,"Unfinished Business SB286 Aanestad",36,0,0,0,36
62303,5777,2009-03-31,Senate,"Do pass, but re-refer to the Committee on Appropriations",5,0,0,0,5
62303,5778,2009-05-06,Senate,"Special Consent #2 SB288 Yee",35,0,4,0,39
62303,5779,2009-06-23,Assembly,"Do pass and be re-referred to the Committee on Appropriations",7,0,0,0,7
62303,5780,2009-07-01,Assembly,"Do pass",15,0,1,0,16
62303,5781,2009-08-17,Assembly,"SB 288 Yee  Senate Third Reading  By FONG",76,0,3,0,79
62303,5782,2009-08-24,Senate,"Special Consent #15 SB288 Yee",39,0,1,0,40
62304,5783,2009-04-15,Senate,"Do pass as amended, and re-refer to the Committee on Appropriations",11,0,0,0,11
62304,5784,2009-05-11,Senate,"Special Consent #3 SB289 Ducheny",36,0,3,0,39
62304,5785,2009-07-07,Assembly,"Do pass and be re-referred to the Committee on Appropriations",18,0,1,0,19
62304,5786,2009-08-19,Assembly,"Do pass, to Consent Calendar",17,0,0,0,17
62304,21080,2010-08-25,Assembly,"Do pass",14,1,0,0,15
62304,21559,2010-08-27,Assembly,"SB 289 Ducheny  Senate Third Reading  By FLETCHER",67,3,0,0,70
62304,21765,2010-08-30,Senate,"Unfinished Business SB289 Ducheny",33,2,0,0,35
62305,22559,2009-03-31,Senate,"Do pass",3,2,0,0,5
62305,22560,2009-04-20,Senate,"Senate 3rd Reading SB290 Leno",21,15,0,0,36
62305,22561,2009-06-23,Assembly,"Do pass",6,3,0,0,9
62305,22562,2009-09-03,Assembly,"SB 290 Leno  Senate Third Reading  By TORRICO",44,30,0,0,74
62306,23895,2009-04-01,Senate,"Do pass and be placed on the Consent Calendar",9,0,0,0,9
62306,23896,2009-04-16,Senate,"Consent Calendar 2nd SB291 Committee on B.,F.& I. (Machado)",37,0,0,0,37
62306,23897,2009-07-08,Assembly,"Do pass as amended and be re-referred to the Committee on 	Appropriations",10,0,0,0,10
62306,23898,2009-08-19,Assembly,"Do pass as amended, to Consent Calendar",17,0,0,0,17
62306,23899,2009-08-27,Assembly,"SB 291 Calderon  Consent Calendar Second Day  Regular Session",74,0,0,0,74
62306,23900,2009-09-09,Senate,"Unfinished Business SB291 Calderon Urgency Clause",22,1,0,0,23
62306,23901,2009-09-09,Senate,"Unfinished Business SB291 Calderon Reconsider",40,0,0,0,40
62306,23902,2009-09-11,Assembly,"SB 291 Calderon  Senate Third Reading  By SOLORIO",78,0,0,0,78
62306,23903,2009-09-11,Senate,"Unfinished Business SB291 Calderon Concurrence",32,0,0,0,32
62307,5790,2009-04-21,Senate,"Do pass as amended, and re-refer to the Committee on Appropriations",5,2,0,0,7
62307,5791,2009-05-26,Senate,"Placed on Appropriations Suspense file",13,0,0,0,13
62309,5792,2009-04-13,Senate,"Do pass, but re-refer to the Committee on Appropriations",6,1,3,0,10
62309,5793,2009-05-11,Senate,"Senate 3rd Reading SB294 Negrete McLeod",25,11,3,0,39
62309,5794,2009-06-30,Assembly,"Do pass as amended and be re-referred to the Committee on Appropriations",10,0,0,0,10
62309,5795,2009-07-15,Assembly,"Do pass, to Consent Calendar",16,0,0,0,16
62309,5796,2009-09-04,Assembly,"SB 294 Negrete McLeod  Senate Third Reading  Amend By ENG  Set #1",43,28,8,0,79
62309,9150,2010-06-22,Assembly,"Do pass and be re-referred to the Committee on Appropriations",11,0,0,0,11
62309,19584,2010-08-04,Assembly,"Do pass",16,0,0,0,16
62309,20438,2010-08-18,Assembly,"SB 294 Negrete McLeod  Senate Third Reading  By HAYASHI",72,2,0,0,74
62309,20521,2010-08-19,Senate,"Unfinished Business SB294 Negrete McLeod",33,0,0,0,33
62310,5788,2009-05-20,Senate,"Do pass as amended, and re-refer to the Committee on Appropriations",3,4,0,0,7
62310,5789,2009-05-20,Senate,"Set, second hearing.  Failed passage in Committee. Reconsideration granted",5,0,2,0,7
62311,23857,2009-04-22,Senate,"Do pass, but re-refer to the Committee on Appropriations",10,1,0,0,11
62311,23858,2009-05-14,Senate,"Senate 3rd Reading SB296 Lowenthal",25,12,0,0,37
62311,23859,2009-07-07,Assembly,"Do pass as amended and be re-referred to the Committee on 	Appropriations",18,0,0,0,18
62311,23860,2009-08-19,Assembly,"Do pass, to Consent Calendar",17,0,0,0,17
62311,23861,2009-08-27,Assembly,"SB 296 Lowenthal  Consent Calendar Second Day  Regular Session",74,0,0,0,74
62311,23862,2009-09-02,Senate,"Unfinished Business SB296 Lowenthal",26,9,0,0,35
62315,25110,2009-04-28,Senate,"Do pass as amended, and re-refer to the Committee on 	Appropriations",11,1,0,0,12
62315,25111,2009-05-18,Senate,"Do pass",9,4,0,0,13
62315,25112,2009-05-28,Senate,"Senate 3rd Reading SB300 Yee",21,12,0,0,33
62315,25113,2009-07-06,Assembly,"Do pass as amended and be re-referred to the Committee on 	Appropriations",9,3,0,0,12
62315,25114,2009-07-15,Assembly,"Do pass",11,5,0,0,16
62315,25115,2009-08-20,Assembly,"SB 300 Yee  Senate Third Reading  By TORLAKSON  Amend By TORLAKSON 	Set #1",50,28,0,0,78
62315,25116,2009-09-01,Assembly,"SB 300 Yee  Senate Third Reading  By TORLAKSON",61,14,0,0,75
62315,25117,2009-09-08,Senate,"Unfinished Business SB300 Yee",27,13,0,0,40
62318,5763,2009-04-01,Senate,"Do pass as amended, and re-refer to the Committee on Judiciary",8,3,0,0,11
62318,5764,2009-04-28,Senate,"Do pass, but re-refer to the Committee on Appropriations",3,2,0,0,5
62318,5765,2009-05-18,Senate,"Placed on Appropriations Suspense file",13,0,0,0,13
62318,5766,2009-05-28,Senate,"Do pass",7,5,1,0,13
62318,5767,2009-06-02,Senate,"Senate 3rd Reading SB303 Alquist",25,13,1,0,39
62318,5768,2009-06-23,Assembly,"Do pass and be re-referred to the Committee on Judiciary",13,3,3,0,19
62318,5769,2009-06-30,Assembly,"Do pass as amended and be re-referred to the Committee on Appropriations",7,3,0,0,10
62318,5770,2009-08-19,Assembly,"Do pass",12,5,0,0,17
62318,5771,2009-09-02,Assembly,"SB 303 Alquist  Senate Third Reading  By HALL  Amend By GAINES  Set #2  Motion to  Lay on the Table  By TORRICO",48,28,3,0,79
62318,5772,2009-09-02,Assembly,"SB 303 Alquist  Senate Third Reading  By HALL  Amend By LOGUE  Set #3  Motion to  Lay on the Table  By TORRICO",48,28,3,0,79
62318,5773,2009-09-02,Assembly,"SB 303 Alquist  Senate Third Reading  By HALL  Amend By ANDERSON Set #4  Motion to  Lay on the Table  By KREKORIAN",47,28,4,0,79
62318,5774,2009-09-02,Assembly,"SB 303 Alquist  Senate Third Reading  By HALL  Amend By KNIGHT  Set #5  Motion to  Lay on the Table  By TORRICO",48,28,3,0,79
62318,5775,2009-09-08,Assembly,"SB 303 Alquist  Senate Third Reading  By HALL",50,26,3,0,79
62318,5776,2009-09-10,Senate,"Unfinished Business SB303 Alquist Concurrence",22,13,5,0,40
62320,5746,2009-04-29,Senate,"Do pass as amended, and re-refer to the Committee on Appropriations",7,2,0,0,9
62320,5747,2009-05-21,Senate,"Senate 3rd Reading SB305 Corbett",22,10,7,0,39
62320,5748,2009-07-01,Assembly,"Do pass and be re-referred to the Committee on Appropriations",8,0,3,0,11
62320,5749,2009-07-15,Assembly,"Do pass",11,5,0,0,16
62320,5750,2009-08-20,Assembly,"SB 305 Corbett  Senate Third Reading  By BUCHANAN",50,25,4,0,79
62321,23801,2009-04-01,Senate,"Do pass, but re-refer to the Committee on Judiciary",9,0,0,0,9
62321,23802,2009-04-14,Senate,"Do pass as amended. To Consent Calendar",5,0,0,0,5
62321,23803,2009-04-23,Senate,"Consent Calendar 2nd SB306 Calderon",37,0,0,0,37
62321,23804,2009-06-29,Assembly,"Do pass and be re-referred to the Committee on Judiciary to Consent 	Calendar",11,0,0,0,11
62321,23805,2009-06-30,Assembly,"Do pass, to Consent Calendar",10,0,0,0,10
62321,23806,2009-07-06,Assembly,"SB 306 Calderon  Consent Calendar Second Day  Regular Session",78,0,0,0,78
62321,23807,2009-07-16,Senate,"Special Consent #13 SB306 Calderon",36,0,0,0,36
62322,5756,2009-06-17,Senate,"Do pass and be placed on the Consent Calendar",9,0,0,0,9
62322,5757,2009-06-24,Senate,"Consent Calendar 2nd SB307 Alquist",40,0,0,0,40
62322,5758,2009-08-19,Assembly,"Do pass and be re-referred to the Committee on Appropriations",9,0,2,0,11
62323,22652,2009-03-31,Senate,"Do pass, but re-refer to the Committee on Appropriations Recommend 	Consent",5,0,0,0,5
62323,22653,2009-04-23,Senate,"Special Consent #1 SB308 Harman",37,0,0,0,37
62323,22654,2009-06-23,Assembly,"Do pass and be re-referred to the Committee on Business and 	Professions to Consent Calendar",10,0,0,0,10
62323,22655,2009-06-30,Assembly,"Do pass and be re-referred to the Committee on Appropriations",10,0,0,0,10
62323,22656,2009-07-15,Assembly,"Do pass, to Consent Calendar",16,0,0,0,16
62323,22657,2009-08-17,Assembly,"SB 308 Harman  Consent Calendar Second Day  Regular Session",76,0,0,0,76
62323,22658,2009-08-24,Senate,"Special Consent #15 SB308 Harman",39,0,0,0,39
62324,5737,2009-04-28,Senate,"Do pass, but re-refer to the Committee on Appropriations",7,3,1,0,11
62324,5738,2009-05-18,Senate,"Senate 3rd Reading SB309 Ducheny",25,6,8,0,39
62324,5739,2009-06-22,Assembly,"Do pass and be re-referred to the Committee on Appropriations",7,2,0,0,9
62324,5740,2009-07-01,Assembly,"Do pass",14,1,1,0,16
62324,21085,2010-08-25,Assembly,"SB 309 Ducheny  Senate Third Reading  By CABALLERO",68,9,0,0,77
62325,23165,2009-04-27,Senate,"Do pass as amended, and re-refer to the Committee on 	Appropriations",5,2,0,0,7
62325,23166,2009-05-26,Senate,"Do pass as amended",8,5,0,0,13
62325,23167,2009-06-02,Senate,"Senate 3rd Reading SB310 Ducheny",22,14,0,0,36
62325,23168,2009-06-30,Assembly,"Do pass and be re-referred to the Committee on Water, Parks and 	Wildlife",5,0,0,0,5
62325,23169,2009-07-07,Assembly,"Do pass as amended and be re-referred to the Committee on 	Appropriations",8,4,0,0,12
62325,23170,2009-08-27,Assembly,"Do pass as amended",12,5,0,0,17
62325,23171,2009-09-03,Assembly,"SB 310 Ducheny  Senate Third Reading  By FUENTES",42,28,0,0,70
62325,23172,2009-09-08,Senate,"Unfinished Business SB310 Ducheny",24,13,0,0,37
62326,5735,2009-04-22,Senate,"Do pass as amended, and re-refer to the Committee on Appropriations",11,0,0,0,11
62326,5736,2009-05-11,Senate,"Placed on Appropriations Suspense file",13,0,0,0,13
62327,22417,2009-04-15,Senate,"Do pass, but re-refer to the Committee on Appropriations",5,0,0,0,5
62327,22418,2009-04-27,Senate,"Do pass as amended",10,0,0,0,10
62327,22419,2009-05-06,Senate,"Special Consent #2 SB312 Romero",35,0,0,0,35
62327,22420,2009-07-01,Assembly,"Do pass as amended and re-refer to Committee on Appropriations 	with recommendation:  To Consent Calendar",10,0,0,0,10
62327,22421,2009-08-19,Assembly,"Do pass, to Consent Calendar",17,0,0,0,17
62327,22422,2009-08-27,Assembly,"SB 312 Romero  Consent Calendar Second Day  Regular Session",74,0,0,0,74
62327,22423,2009-09-02,Senate,"Special Consent #18 SB312 Romero",39,0,0,0,39
62328,26266,2009-04-29,Senate,"Do pass, but re-refer to the Committee on Appropriations",6,0,0,0,6
62328,26267,2009-05-26,Senate,"Special Consent #6 SB313 DeSaulnier",39,0,0,0,39
62328,26268,2009-07-08,Assembly,"Do pass and be re-referred to the Committee on Appropriations",10,0,0,0,10
62328,26269,2009-08-19,Assembly,"Do pass as amended, to Consent Calendar",17,0,0,0,17
62328,26270,2009-09-08,Assembly,"SB 313 DeSaulnier  Senate Third Reading  By NIELLO",78,1,0,0,79
62328,26271,2009-09-12,Senate,"Unfinished Business SB313 DeSaulnier Concurrence",25,0,0,0,25
62328,26272,2009-09-12,Senate,"Unfinished Business SB313 DeSaulnier Reconsider",39,0,0,0,39
62328,26273,2009-10-14,Senate,"Unfinished Business SB313 DeSaulnier",35,0,0,0,35
62329,25125,2009-04-28,Senate,"Do pass, but re-refer to the Committee on Appropriations",7,0,0,0,7
62329,25126,2009-05-11,Senate,"Placed on Appropriations Suspense file",13,0,0,0,13
62329,25127,2009-05-28,Senate,"Do pass as amended",12,0,0,0,12
62329,25128,2009-06-03,Senate,"Senate 3rd Reading SB314 Calderon",38,0,0,0,38
62329,25129,2009-06-30,Assembly,"Do pass and be re-referred to the Committee on Appropriations",7,0,0,0,7
62329,25130,2009-07-08,Assembly,"Do pass, to Consent Calendar",15,0,0,0,15
62329,25131,2009-08-20,Assembly,"SB 314 Calderon  Senate Third Reading  By SOLORIO",79,0,0,0,79
62330,5722,2009-04-01,Senate,"Do pass",7,1,1,0,9
62330,5723,2009-04-13,Senate,"Senate 3rd Reading SB315 Liu",24,11,4,0,39
62330,5724,2009-06-17,Assembly,"Do pass",6,3,2,0,11
62330,5725,2009-07-16,Assembly,"SB 315 Liu  Senate Third Reading  By FEUER",49,22,8,0,79
62330,5726,2009-09-02,Senate,"Unfinished Business SB315 Liu",23,10,7,0,40
62331,5730,2009-04-01,Senate,"Do pass, but re-refer to the Committee on Appropriations",6,4,1,0,11
62331,5731,2009-04-20,Senate,"Placed on Appropriations Suspense file",11,0,2,0,13
62331,5732,2009-05-28,Senate,"Do pass as amended",7,5,1,0,13
62331,5733,2009-06-03,Senate,"Senate 3rd Reading SB316 Alquist Reconsider",39,0,0,0,39
62331,5734,2010-01-28,Senate,"SENATE 3RD READING SB316 ALQUIST",23,15,1,0,39
62331,8974,2009-06-03,Senate,"Senate 3rd Reading SB316 Alquist",17,20,2,0,39
62332,5743,2009-04-27,Senate,"Do pass",5,2,0,0,7
62332,5744,2009-05-14,Senate,"Senate 3rd Reading SB317 Simitian",22,15,2,0,39
62332,5745,2009-06-16,Assembly,"Do pass as amended",5,2,0,0,7
62333,23722,2009-04-21,Senate,"Do pass, but re-refer to the Committee on Appropriations",2,3,0,0,5
62333,23723,2009-04-21,Senate,"Set, first hearing.  Failed passage in Committee.  Reconsideration 	granted",7,0,0,0,7
62333,23724,2009-04-28,Senate,"Do pass as amended, and re-refer to the Committee on Appropriations",6,0,0,0,6
62333,23725,2009-05-26,Senate,"Do pass as amended",13,0,0,0,13
62333,23726,2009-06-01,Senate,"Senate 3rd Reading SB318 Calderon",36,2,0,0,38
62333,23727,2009-06-30,Assembly,"Do pass",7,0,0,0,7
62333,23728,2009-08-24,Assembly,"SB 318 Calderon  Senate Third Reading  By MA",77,0,0,0,77
62334,25198,2009-04-21,Senate,"Do pass as amended. To Consent Calendar",5,0,0,0,5
62334,25199,2009-04-27,Senate,"Consent Calendar 2nd SB319 Harman",39,0,0,0,39
62334,25200,2009-06-23,Assembly,"Do pass, to Consent Calendar",10,0,0,0,10
62334,25201,2009-06-30,Assembly,"SB 319 Harman  Consent Calendar Second Day  Regular Session",77,0,0,0,77
62335,25482,2009-04-28,Senate,"Do pass",5,0,0,0,5
62335,25483,2009-05-14,Senate,"Senate 3rd Reading SB320 Corbett",38,0,0,0,38
62335,25484,2009-06-23,Assembly,"Do pass",10,0,0,0,10
62335,25485,2009-08-17,Assembly,"SB 320 Corbett  Senate Third Reading  By EVANS",75,0,0,0,75
62335,25486,2009-08-24,Senate,"Special Consent #15 SB320 Corbett",39,0,0,0,39
62336,25118,2009-04-29,Senate,"Do pass, but re-refer to the Committee on Appropriations",5,0,0,0,5
62336,25119,2009-05-26,Senate,"Special Consent #6 SB321 Benoit",39,0,0,0,39
62336,25120,2009-07-01,Assembly,"Do pass and be re-referred to the Committee on Elections and 	Redistricting",7,0,0,0,7
62336,25121,2009-07-07,Assembly,"Do pass and be re-referred to the Committee on Appropriations",7,0,0,0,7
62336,25122,2009-08-19,Assembly,"Do pass, to Consent Calendar",17,0,0,0,17
62336,25123,2009-08-27,Assembly,"SB 321 Benoit  Consent Calendar Second Day  Regular Session",74,0,0,0,74
62336,25124,2009-09-02,Senate,"Special Consent #18 SB321 Benoit",39,0,0,0,39
62338,5751,2009-04-22,Senate,"Do pass, but re-refer to the Committee on Appropriations",5,2,1,0,8
62338,5752,2009-05-04,Senate,"Placed on Appropriations Suspense file",11,0,2,0,13
62338,5753,2009-05-28,Senate,"Do pass as amended",7,5,1,0,13
62338,5754,2009-06-03,Senate,"Senate 3rd Reading SB323 Oropeza",23,14,2,0,39
62338,5755,2009-07-06,Assembly,"Do pass as amended and be re-referred to the Committee on Appropriations",6,3,0,0,9
62339,23764,2009-04-14,Senate,"Do pass",7,0,0,0,7
62339,23765,2009-04-20,Senate,"Senate 3rd Reading SB324 Cedillo",37,0,0,0,37
62339,23766,2009-06-16,Assembly,"Do pass",6,0,0,0,6
62339,23767,2009-06-25,Assembly,"SB 324 Cedillo  Senate Third Reading  By FURUTANI",76,1,0,0,77
62339,23768,2009-09-11,Senate,"Unfinished Business SB324 Cedillo",35,0,0,0,35
62340,22459,2009-04-21,Senate,"Do pass, but re-refer to the Committee on Appropriations",7,0,0,0,7
62340,22460,2009-05-11,Senate,"Do pass",8,0,0,0,8
62340,22461,2009-05-18,Senate,"Special Consent #5 SB325 Alquist",36,0,0,0,36
62340,22462,2009-06-16,Assembly,"Do pass and re-refer to Committee on Appropriations with 	recommendation:  To Consent Calendar",7,0,0,0,7
62340,22463,2009-07-01,Assembly,"Do pass",15,0,0,0,15
62340,22464,2009-07-13,Assembly,"SB 325 Alquist  Senate Third Reading  By NIELSEN",77,0,0,0,77
62340,22465,2009-08-17,Senate,"Special Consent #14 SB325 Alquist",35,0,0,0,35
62341,5727,2009-04-28,Senate,"Do pass, but re-refer to the Committee on Appropriations",10,0,1,0,11
62341,5728,2009-05-26,Senate,"Do pass",13,0,0,0,13
62341,5729,2009-06-01,Senate,"Senate 3rd Reading SB326 Strickland",36,0,3,0,39
62342,25279,2009-04-20,Senate,"Do pass",11,0,0,0,11
62342,25280,2009-04-23,Senate,"Senate 3rd Reading SB327 Kehoe Urgency Clause",34,0,0,0,34
62342,25281,2009-07-01,Assembly,"Do pass",15,0,0,0,15
62342,25282,2009-07-13,Assembly,"SB 327 Kehoe  Third Reading Urgency  By DE LEON",76,0,0,0,76
62345,744,2010-01-12,Senate,"Do pass.",5,0,0,0,5
62345,745,2010-01-28,Senate,"SENATE 3RD READING SB330 YEE",37,1,1,0,39
62345,8915,2010-06-16,Assembly,"Do pass and be re-referred to the Committee on Higher Education",19,0,3,0,22
62345,9214,2010-06-22,Assembly,"Do pass",6,0,3,0,9
62345,20481,2010-08-16,Assembly,"SB 330 Yee  Senate Third Reading  By PORTANTINO",71,0,0,0,71
62345,20572,2010-08-19,Senate,"Unfinished Business SB330 Yee",22,10,0,0,32
62346,5717,2009-04-22,Senate,"Do pass as amended, and re-refer to the Committee on Appropriations",8,1,0,0,9
62346,5718,2009-05-11,Senate,"Placed on Appropriations Suspense file",13,0,0,0,13
62346,5719,2009-05-28,Senate,"Do pass as amended",7,4,2,0,13
62346,5720,2009-06-01,Senate,"Senate 3rd Reading SB331 Romero",25,13,1,0,39
62346,8970,2010-06-16,Assembly,"Do pass as amended and be re-referred to the Committee on Appropriations",5,2,2,0,9
62346,20123,2010-08-12,Assembly,"Do pass as amended",12,5,0,0,17
62346,20566,2010-08-19,Assembly,"SB 331 Romero  Senate Third Reading",76,1,0,0,77
62346,21340,2010-08-26,Senate,"Unfinished Business SB331 Romero",35,0,0,0,35
62348,5709,2009-04-27,Senate,"Do pass as amended, and re-refer to the Committee on Appropriations",5,2,0,0,7
62348,5710,2009-05-18,Senate,"Placed on Appropriations Suspense file",13,0,0,0,13
62349,22543,2009-04-15,Senate,"Do pass as amended, and re-refer to the Committee on Appropriations",5,0,0,0,5
62349,22544,2009-05-04,Senate,"Placed on Appropriations Suspense file",11,0,0,0,11
62349,22545,2009-05-28,Senate,"Do pass",7,5,0,0,12
62349,22546,2009-06-02,Senate,"Senate 3rd Reading SB334 Ducheny",24,12,0,0,36
62349,22547,2009-07-08,Assembly,"Do pass as amended and be re-referred to the Committee on 	Appropriations",8,3,0,0,11
62349,22548,2009-08-27,Assembly,"Do pass",12,5,0,0,17
62349,22549,2009-09-02,Assembly,"SB 334 Ducheny  Senate Third Reading  By COTO",48,26,0,0,74
62349,22550,2009-09-08,Senate,"Unfinished Business SB334 Ducheny",26,14,0,0,40
62352,26077,2009-04-29,Senate,"Do pass as amended, and re-refer to the Committee on Appropriations",9,0,0,0,9
62352,26078,2009-05-26,Senate,"Special Consent #6 SB337 Alquist",39,0,0,0,39
62352,26079,2009-06-30,Assembly,"Do pass as amended and be re-referred to the Committee on 	Appropriations",19,0,0,0,19
62352,26080,2009-08-19,Assembly,"Do pass, to Consent Calendar",17,0,0,0,17
62352,26081,2009-08-27,Assembly,"SB 337 Alquist  Consent Calendar Second Day  Regular Session",74,0,0,0,74
62352,26082,2009-09-09,Assembly,"Do pass",15,0,0,0,15
62352,26083,2009-09-09,Assembly,"Do pass and be re-referred to the Committee on Appropriations",19,0,0,0,19
62352,26084,2009-09-10,Senate,"From committee:  That the Assembly Amendments be concurred in",8,3,0,0,11
62352,26085,2009-09-11,Senate,"Unfinished Supp 1 SB337 Alquist",25,8,0,0,33
62352,26086,2009-09-11,Assembly,"SB 337 Alquist  Senate Third Reading  By BEALL",75,3,0,0,78
62353,5715,2009-04-27,Senate,"Do pass, but re-refer to the Committee on Appropriations",10,0,1,0,11
62353,5716,2009-05-18,Senate,"Placed on Appropriations Suspense file",13,0,0,0,13
62355,22288,2009-04-14,Senate,"Do pass as amended",5,0,0,0,5
62355,22289,2009-04-23,Senate,"Special Consent #1 SB340 Yee",37,0,0,0,37
62355,22290,2009-06-30,Assembly,"Amend, and do pass as amended and be re-referred to the Committee 	on Business and Professions with the recommendation:  To Consent 	Calendar",10,0,0,0,10
62355,22291,2009-07-07,Assembly,"Do pass",11,0,0,0,11
62355,22292,2009-07-13,Assembly,"SB 340 Yee  Senate Third Reading  By TORLAKSON",77,0,0,0,77
62355,22293,2009-08-24,Assembly,"SB 340 Yee  Senate Third Reading  By TORLAKSON",77,0,0,0,77
62355,22294,2009-08-31,Senate,"Special Consent #17 SB340 Yee",36,0,0,0,36
62356,5711,2009-04-15,Senate,"Do pass as amended, and re-refer to the Committee on Revenue and Taxation",5,4,2,0,11
62356,5712,2009-04-15,Senate,"Set, first hearing.  Failed passage in Committee.  Reconsideration granted",11,0,0,0,11
62356,5713,2009-04-29,Senate,"Do pass as amended, and re-refer to the Committee on Revenue and Taxation",6,3,2,0,11
62356,5714,2009-05-26,Senate,"Placed on Appropriations Suspense file",13,0,0,0,13
62360,22442,2009-04-27,Senate,"Do pass",7,0,0,0,7
62360,22443,2009-05-11,Senate,"Senate 3rd Reading SB345 Negrete McLeod",36,0,0,0,36
62360,22444,2009-07-08,Assembly,"Do pass",6,0,0,0,6
62360,22445,2009-08-17,Assembly,"SB 345 Negrete McLeod  Senate Third Reading  By EMMERSON",74,1,0,0,75
62360,22446,2009-08-24,Senate,"Special Consent #15 SB345 Negrete McLeod",39,0,0,0,39
62361,5706,2009-04-20,Senate,"Do pass as amended, and re-refer to the Committee on Appropriations",5,2,0,0,7
62361,5707,2009-05-26,Senate,"Do pass",8,5,0,0,13
62361,5708,2009-06-03,Senate,"Senate 3rd Reading SB346 Kehoe",22,16,1,0,39
62361,8842,2010-06-15,Assembly,"Do pass as amended and be re-referred to the Committee on Appropriations",6,3,0,0,9
62361,20235,2010-08-12,Assembly,"Do pass",12,5,0,0,17
62361,21667,2010-08-30,Assembly,"SB 346 Kehoe  Senate Third Reading  By FLETCHER",70,3,0,0,73
62361,21887,2010-08-31,Senate,"Unfinished Business SB346 Kehoe",31,6,0,0,37
62363,25456,2009-05-12,Senate,"Do pass as amended",5,0,0,0,5
62363,25457,2009-06-03,Senate,"Senate 3rd Reading SB348 Cogdill Urgency Clause",37,0,0,0,37
62363,25458,2009-06-30,Assembly,"Do pass as amended",10,0,0,0,10
62363,25459,2009-08-17,Assembly,"SB 348 Cogdill  Third Reading Urgency  By CALDERON",71,0,0,0,71
62363,25460,2009-08-20,Senate,"Unfinished Business SB348 Cogdill Urgency Clause",38,0,0,0,38
62365,5676,2009-04-15,Senate,"Do pass, but re-refer to the Committee on Rules",10,0,2,0,12
62365,5677,2009-05-14,Senate,"Senate 3rd Reading SB350 Yee",37,0,2,0,39
62367,26100,2009-04-14,Senate,"Do pass, but re-refer to the Committee on Public Safety",5,0,0,0,5
62367,26101,2009-04-28,Senate,"Do pass as amended, and re-refer to the Committee on Appropriations",7,0,0,0,7
62367,26102,2009-05-26,Senate,"Do pass as amended",13,0,0,0,13
62367,26103,2009-06-02,Senate,"Special Consent #7 SB352 Dutton",39,0,0,0,39
62367,26104,2009-06-23,Assembly,"Do pass and be re-referred to the Committee on Human Services to 	Consent Calendar",7,0,0,0,7
62367,26105,2009-06-30,Assembly,"Do pass and re-refer to Committee on Appropriations with 	recommendation:  To Consent Calendar",7,0,0,0,7
62367,26106,2009-07-08,Assembly,"Do pass, to Consent Calendar",15,0,0,0,15
62367,26107,2009-07-16,Assembly,"SB 352 Dutton  Consent Calendar Second Day  Regular Session",72,0,0,0,72
62371,5689,2009-04-27,Senate,"Do pass, but re-refer to the Committee on Appropriations",6,2,2,0,10
62371,5690,2009-05-18,Senate,"Placed on Appropriations Suspense file",13,0,0,0,13
62371,5691,2010-01-25,Senate,"SENATE 3RD READING SB356 WRIGHT",34,2,3,0,39
62372,23561,2009-04-14,Senate,"Do pass, but re-refer to the Committee on Appropriations",13,0,0,0,13
62372,23562,2009-05-06,Senate,"Special Consent #2 SB357 Ducheny",35,0,0,0,35
62372,23563,2009-07-01,Assembly,"Do pass and be re-referred to the Committee on Appropriations",17,0,0,0,17
62372,23564,2009-08-27,Assembly,"Do pass",17,0,0,0,17
62372,23565,2009-09-08,Assembly,"SB 357 Ducheny  Senate Third Reading  By COTO",76,2,0,0,78
62373,5666,2009-04-13,Senate,"Do pass, but re-refer to the Committee on Appropriations",8,1,1,0,10
62373,5667,2009-04-27,Senate,"Placed on Appropriations Suspense file",13,0,0,0,13
62374,25583,2009-05-12,Senate,"Do pass",5,0,0,0,5
62374,25584,2009-05-18,Senate,"Special Consent #5 SB359 Romero",36,0,0,0,36
62374,25585,2009-07-01,Assembly,"Do pass, to Consent Calendar",17,0,0,0,17
62374,25586,2009-08-24,Assembly,"SB 359 Romero  Senate Third Reading  By COTO",77,0,0,0,77
62374,25587,2009-08-31,Senate,"Special Consent #17 SB359 Romero",36,0,0,0,36
62375,5687,2009-04-15,Senate,"Do pass as amended, and re-refer to the Committee on Appropriations",7,4,0,0,11
62375,5688,2009-05-11,Senate,"Placed on Appropriations Suspense file",13,0,0,0,13
62376,22551,2009-04-14,Senate,"Do pass, but re-refer to the Committee on Education",7,0,0,0,7
62376,22552,2009-04-29,Senate,"Do pass as amended, and re-refer to the Committee on Appropriations",9,0,0,0,9
62376,22553,2009-05-26,Senate,"Special Consent #6 SB361 Runner",39,0,0,0,39
62376,22554,2009-06-23,Assembly,"Do pass and be re-referred to the Committee on Veterans Affairs to 	Consent Calendar",9,0,0,0,9
62376,22555,2009-06-30,Assembly,"Do pass and be re-referred to the Committee on Appropriations",9,0,0,0,9
62376,22556,2009-08-19,Assembly,"Do pass, to Consent Calendar",17,0,0,0,17
62376,22557,2009-08-27,Assembly,"SB 361 Runner  Consent Calendar Second Day  Regular Session",74,0,0,0,74
62376,22558,2009-09-02,Senate,"Special Consent #18 SB361 Runner",39,0,0,0,39
62377,5657,2009-04-21,Senate,"Do pass, but re-refer to the Committee on Appropriations",3,2,0,0,5
62377,5658,2009-05-26,Senate,"Placed on Appropriations Suspense file",13,0,0,0,13
62377,5659,2009-05-28,Senate,"Do pass as amended",7,5,1,0,13
62377,5660,2009-06-02,Senate,"Senate 3rd Reading SB362 Florez",24,12,3,0,39
62377,5661,2009-07-01,Assembly,"Do pass as amended and be re-referred to the Committee on Appropriations",3,4,1,0,8
62377,5662,2009-07-01,Assembly,"Set first hearing.  Failed passage.  Reconsideration granted",8,0,0,0,8
62377,5663,2010-05-28,Assembly,"Be referred to Committee on Health",9,0,2,0,11
62377,8953,2010-06-10,Assembly,"Be referred to Committee on Agriculture",11,0,0,0,11
62378,5701,2009-04-27,Senate,"Do pass as amended, and re-refer to the Committee on Appropriations",7,0,4,0,11
62378,5702,2009-05-26,Senate,"Placed on Appropriations Suspense file",13,0,0,0,13
62378,5703,2009-05-28,Senate,"Do pass as amended",7,5,1,0,13
62378,5704,2009-06-03,Senate,"Senate 3rd Reading SB363 Hancock",25,13,1,0,39
62378,5705,2009-07-06,Assembly,"Do pass as amended and be re-referred to the Committee on Appropriations",10,5,0,0,15
62379,2197,2009-04-29,Senate,"Do pass as amended, and re-refer to the Committee on Appropriations",7,4,0,0,11
62379,2198,2009-05-21,Senate,"Senate 3rd Reading SB364 Florez",21,15,3,0,39
62379,2199,2009-07-07,Assembly,"Do pass as amended and be re-referred to the Committee on Appropriations",10,7,2,0,19
62379,2200,2009-08-27,Assembly,"Do pass as amended",9,7,1,0,17
62379,2201,2009-09-02,Assembly,"SB 364 Florez  Senate Third Reading  By MA",25,38,16,0,79
62379,2202,2010-04-22,Assembly,"SB 364 Florez  Senate Third Reading  Amend By MA  Set #1",45,28,6,0,79
62379,2203,2010-05-28,Assembly,"Be referred to Committee on Health",9,0,2,0,11
62379,10329,2010-07-01,Assembly,"Do pass",10,3,5,0,18
62380,5629,2009-04-15,Senate,"Do pass, but re-refer to the Committee on Rules",6,3,0,0,9
62380,5630,2009-05-11,Senate,"Placed on Appropriations Suspense file",13,0,0,0,13
62380,5631,2009-05-28,Senate,"Do pass",7,5,1,0,13
62380,5632,2009-06-02,Senate,"Senate 3rd Reading SB365 Ducheny",22,14,3,0,39
62380,5633,2009-07-08,Assembly,"Do pass as amended and be re-referred to the Committee on Appropriations",8,1,2,0,11
62382,25331,2009-05-05,Senate,"Do pass and be placed on the Consent Calendar",5,0,0,0,5
62382,25332,2009-05-14,Senate,"Consent Calendar 2nd SB367 Harman",38,0,0,0,38
62382,25333,2009-07-09,Assembly,"Do pass as amended, to Consent Calendar",10,0,0,0,10
62382,25334,2009-09-02,Assembly,"SB 367 Negrete McLeod  Third Reading Urgency  By TRAN",78,0,0,0,78
62382,25335,2009-09-08,Senate,"From committee:  That the Assembly Amendments be concurred in",5,0,0,0,5
62382,25336,2009-09-09,Senate,"Unfinished Business SB367 Negrete McLeod Urgency Clause",23,0,0,0,23
62382,25337,2009-09-09,Senate,"Unfinished Business SB367 Negrete McLeod Reconsider",40,0,0,0,40
62382,25338,2009-10-14,Senate,"Unfinished Business SB367 Negrete McLeod Urgency Clause",35,0,0,0,35
62384,26417,2009-04-14,Senate,"Do pass, but re-refer to the Committee on Appropriations",7,0,0,0,7
62384,26418,2009-05-04,Senate,"Do pass",9,0,0,0,9
62384,26419,2009-05-11,Senate,"Special Consent #3 SB369 Maldonado",36,0,0,0,36
62384,26420,2009-06-16,Assembly,"Do pass and be re-referred to the Committee on Appropriations",8,0,0,0,8
62384,26421,2009-07-01,Assembly,"Do pass, to Consent Calendar",15,0,0,0,15
62384,26422,2009-07-09,Assembly,"SB 369 Maldonado  Consent Calendar Second Day  Regular Session",74,0,0,0,74
62385,5692,2009-04-21,Senate,"Do pass, but re-refer to the Committee on Rules",2,3,0,0,5
62385,5693,2009-04-21,Senate,"Set, first hearing.  Failed passage in Committee.  Reconsideration granted",5,0,0,0,5
62387,5694,2009-04-28,Senate,"Do pass as amended, and re-refer to the Committee on Appropriations",7,4,0,0,11
62387,5695,2009-06-02,Senate,"Senate 3rd Reading SB372 Kehoe",21,16,2,0,39
62387,5696,2009-06-30,Assembly,"Do pass and be re-referred to the Committee on Appropriations",8,3,2,0,13
62387,5697,2009-07-15,Assembly,"Do pass",10,5,1,0,16
62387,5698,2009-09-04,Assembly,"SB 372 Kehoe  Senate Third Reading  By SALAS  Amend By SALAS  Set #1",43,28,8,0,79
62387,5699,2009-09-11,Senate,"Unfinished Supp 1 SB372 Kehoe",21,16,3,0,40
62387,5700,2009-09-11,Assembly,"SB 372 Kehoe  Senate Third Reading  By SALAS",43,33,3,0,79
62389,5678,2009-04-13,Senate,"Do pass, but re-refer to the Committee on Rules",7,2,1,0,10
62389,5679,2009-04-23,Senate,"Senate 3rd Reading SB374 Calderon",22,13,4,0,39
62389,5680,2009-06-30,Assembly,"Do pass and be re-referred to the Committee on Appropriations",6,3,1,0,10
62390,5590,2009-04-01,Senate,"Do pass as amended, and re-refer to the Committee on Appropriations",7,0,2,0,9
62390,5591,2009-04-27,Senate,"Placed on Appropriations Suspense file",13,0,0,0,13
62391,5681,2009-04-21,Senate,"Do pass as amended, and re-refer to the Committee on Appropriations",9,2,0,0,11
62391,5682,2009-05-18,Senate,"Placed on Appropriations Suspense file",13,0,0,0,13
62391,5683,2010-01-21,Senate,"Do pass as amended",6,3,2,0,11
62391,5684,2010-01-28,Senate,"SENATE 3RD READING SB376 SIMITIAN",25,9,5,0,39
62391,8959,2010-06-14,Assembly,"Do pass and be re-referred to the Committee on Natural Resources",9,3,3,0,15
62391,9850,2010-06-28,Assembly,"Do pass as amended and be re-referred to the Committee on Appropriations",6,3,0,0,9
62392,5578,2009-04-14,Senate,"Do pass, but re-refer to the Committee on Appropriations",5,0,0,0,5
62392,5579,2009-04-27,Senate,"Placed on Appropriations Suspense file",13,0,0,0,13
62393,5674,2009-04-15,Senate,"Do pass as amended, and re-refer to the Committee on Appropriations",7,0,2,0,9
62393,5675,2009-05-04,Senate,"Placed on Appropriations Suspense file",11,0,2,0,13
62394,5588,2009-04-28,Senate,"Do pass, but re-refer to the Committee on Appropriations",4,0,0,0,4
62394,5589,2009-05-11,Senate,"Placed on Appropriations Suspense file",13,0,0,0,13
62396,5571,2009-04-22,Senate,"Do pass",6,3,0,0,9
62396,5572,2009-05-21,Senate,"Senate 3rd Reading SB381 Wright",32,2,5,0,39
62396,5573,2009-07-08,Assembly,"Do pass and be re-referred to the Committee on Appropriations",6,3,2,0,11
62397,5668,2009-04-21,Senate,"Do pass, but re-refer to the Committee on Environmental Quality",4,1,0,0,5
62397,5669,2009-05-04,Senate,"Do pass as amended",5,2,0,0,7
62397,5670,2009-05-14,Senate,"Senate 3rd Reading SB382 Florez",23,14,2,0,39
62397,5671,2009-07-06,Assembly,"Do pass",5,3,1,0,9
62397,5672,2009-09-02,Assembly,"SB 382 Florez  Senate Third Reading  By ARAMBULA",47,30,2,0,79
62398,5562,2009-04-14,Senate,"Do pass as amended, and re-refer to the Committee on Appropriations",3,1,1,0,5
62398,5563,2009-04-27,Senate,"Placed on Appropriations Suspense file",13,0,0,0,13
62399,5664,2009-04-28,Senate,"Do pass, but re-refer to the Committee on Appropriations",2,3,0,0,5
62399,5665,2009-04-28,Senate,"Set, first hearing.  Failed passage in Committee.  Reconsideration granted",5,0,0,0,5
62401,5653,2009-04-29,Senate,"Do pass as amended, and re-refer to the Committee on Appropriations",9,0,0,0,9
62401,5654,2009-05-18,Senate,"Placed on Appropriations Suspense file",13,0,0,0,13
62402,5557,2009-04-21,Senate,"Do pass, but re-refer to the Committee on Appropriations",3,1,1,0,5
62402,5558,2009-05-14,Senate,"Senate 3rd Reading SB387 Hancock",25,12,2,0,39
62402,5559,2009-06-23,Assembly,"Do pass and be re-referred to the Committee on Appropriations",5,2,0,0,7
62402,5560,2009-07-01,Assembly,"Do pass",11,4,1,0,16
62402,5561,2009-07-13,Assembly,"SB 387 Hancock  Senate Third Reading  By HARKEY",51,23,5,0,79
62403,5647,2009-05-06,Senate,"Do pass, but re-refer to the Committee on Judiciary",9,0,0,0,9
62403,5648,2009-05-14,Senate,"Senate 3rd Reading SB388 Calderon",31,5,3,0,39
62403,5649,2009-07-07,Assembly,"Do pass as amended and be re-referred to the Committee on Appropriations",6,1,2,0,9
62403,5650,2009-09-04,Assembly,"SB 388 Calderon  Senate Third Reading  Amend By FURUTANI  Set #1",43,28,8,0,79
62403,5651,2009-09-11,Assembly,"Do pass as amended",9,2,4,0,15
62403,5652,2009-09-12,Assembly,"SB 388 Calderon  Senate Third Reading  By CALDERON",44,16,19,0,79
62404,5541,2009-04-20,Senate,"Do pass, but re-refer to the Committee on Public Safety",9,0,1,0,10
62404,5542,2009-04-28,Senate,"Do pass as amended, and re-refer to the Committee on Appropriations",7,0,0,0,7
62404,5543,2009-05-18,Senate,"Placed on Appropriations Suspense file",13,0,0,0,13
62404,5544,2009-05-28,Senate,"Do pass as amended",12,0,1,0,13
62404,5545,2009-06-03,Senate,"Senate 3rd Reading SB389 Negrete McLeod",37,1,1,0,39
62404,5546,2009-06-30,Assembly,"Do pass and be re-referred to the Committee on Public Safety",6,0,4,0,10
62404,5547,2009-07-07,Assembly,"Do pass and be re-referred to the Committee on Appropriations",2,4,1,0,7
62404,5548,2009-07-07,Assembly,"Set first hearing.  Failed passage.  Reconsideration granted",7,0,0,0,7
62405,8131,2009-04-20,Senate,"Do pass as amended, and re-refer to the Committee on Appropriations",7,0,0,0,7
62405,8132,2009-05-11,Senate,"Placed on Appropriations Suspense file",13,0,0,0,13
62405,8133,2010-01-21,Senate,"Do pass as amended",9,0,2,0,11
62405,8134,2010-01-28,Senate,"SENATE 3RD READING SB390 KEHOE",35,0,4,0,39
62405,9558,2010-06-21,Assembly,"Do pass and be re-referred to the Committee on Appropriations",7,0,2,0,9
62405,20322,2010-08-12,Assembly,"Do pass",17,0,0,0,17
62405,20790,2010-08-23,Assembly,"SB 390 Kehoe  Senate Third Reading  By CHESBRO",77,0,0,0,77
62405,21259,2010-08-25,Senate,"Unfinished Business SB390 Kehoe",35,0,0,0,35
62406,25674,2009-04-21,Senate,"Do pass as amended, and re-refer to the Committee on Environmental 	Quality",7,4,0,0,11
62406,25675,2009-04-27,Senate,"Do pass as amended, and re-refer to the Committee on 	Appropriations",5,2,0,0,7
62406,25676,2009-05-18,Senate,"Do pass",8,5,0,0,13
62406,25677,2009-06-01,Senate,"Senate 3rd Reading SB391 Liu",23,15,0,0,38
62406,25678,2009-06-29,Assembly,"Do pass and be re-referred to the Committee on Appropriations",9,5,0,0,14
62406,25679,2009-08-27,Assembly,"Do pass",12,5,0,0,17
62406,25680,2009-09-03,Assembly,"SB 391 Liu  Senate Third Reading  By TORLAKSON",48,28,0,0,76
62407,5529,2009-04-13,Senate,"Do pass as amended, and re-refer to the Committee on Judiciary",8,0,2,0,10
62407,5530,2009-04-28,Senate,"Do pass, but re-refer to the Committee on Appropriations",5,0,0,0,5
62407,5531,2009-05-11,Senate,"Do pass",13,0,0,0,13
62407,5532,2009-05-18,Senate,"Special Consent #5 SB392 Florez",36,0,3,0,39
62407,5533,2009-06-16,Assembly,"Do pass and be re-referred to the Committee on Judiciary",10,0,1,0,11
62407,8936,2010-06-15,Assembly,"Do pass as amended and be re-referred to the Committee on Appropriations",10,0,0,0,10
62407,19683,2010-08-04,Assembly,"Do pass",17,0,0,0,17
62407,21600,2010-08-26,Assembly,"SB 392 Florez  Senate Third Reading  By FUENTES",75,0,0,0,75
62407,21704,2010-08-30,Senate,"Unfinished Business SB392 Florez",37,0,0,0,37
62408,5655,2009-05-12,Senate,"Do pass as amended, and re-refer to the Committee on Appropriations",2,3,0,0,5
62408,5656,2009-05-12,Senate,"Set, second hearing.  Failed passage in Committee. Reconsideration granted",5,0,0,0,5
62411,5634,2009-04-29,Senate,"Do pass, but re-refer to the Committee on Appropriations",11,0,1,0,12
62411,5635,2009-05-18,Senate,"Special Consent #5 SB396 Calderon",36,0,3,0,39
62411,5636,2009-07-08,Assembly,"Do pass as amended and be re-referred to the Committee on Appropriations",10,0,0,0,10
62411,5637,2009-08-19,Assembly,"Do pass",16,0,1,0,17
62411,5638,2009-09-03,Assembly,"SB 396 Calderon  Senate Third Reading  By CALDERON",66,5,8,0,79
62411,5639,2009-09-08,Senate,"Unfinished Business SB396 Calderon",34,4,2,0,40
62412,5615,2009-04-29,Senate,"Do pass as amended, and re-refer to the Committee on Appropriations",9,2,1,0,12
62412,5616,2009-06-01,Senate,"Senate 3rd Reading SB397 Calderon",32,3,4,0,39
62412,5617,2009-07-08,Assembly,"Do pass as amended and be re-referred to the Committee on Appropriations",9,0,1,0,10
62412,5618,2009-08-19,Assembly,"Do pass, to Consent Calendar",17,0,0,0,17
62412,5619,2009-09-08,Assembly,"SB 397 Calderon  Senate Third Reading  By TORRICO",77,0,2,0,79
62412,5620,2009-09-10,Senate,"Unfinished Business SB397 Calderon Concurrence",33,1,6,0,40
62413,22695,2009-04-21,Senate,"Do pass as amended, and re-refer to the Committee on Appropriations",8,2,0,0,10
62413,22696,2009-05-11,Senate,"Placed on Appropriations Suspense file",13,0,0,0,13
62413,22697,2009-05-28,Senate,"Do pass",7,5,0,0,12
62413,22698,2009-06-01,Senate,"Senate 3rd Reading SB398 Correa",27,10,0,0,37
62413,22699,2009-07-08,Assembly,"Do pass as amended",4,2,0,0,6
62413,22700,2009-08-24,Assembly,"SB 398 Correa  Senate Third Reading  By TORRICO",49,24,0,0,73
62413,22701,2009-09-04,Senate,"Unfinished Business SB398 Correa",27,12,0,0,39
62414,5640,2009-04-14,Senate,"Do pass, but re-refer to the Committee on Appropriations",5,2,0,0,7
62414,5641,2009-05-18,Senate,"Placed on Appropriations Suspense file",13,0,0,0,13
62414,5642,2009-05-28,Senate,"Do pass as amended",7,5,1,0,13
62414,5643,2009-06-02,Senate,"Senate 3rd Reading SB399 Yee",23,15,1,0,39
62414,5644,2009-06-30,Assembly,"Do pass and be re-referred to the Committee on Appropriations",3,4,0,0,7
62414,5645,2009-06-30,Assembly,"Set second hearing.  Failed passage.  Reconsideration granted",7,0,0,0,7
62414,5646,2010-01-12,Assembly,"Do pass and be re-referred to the Committee on Appropriations",4,2,1,0,7
62414,10058,2010-06-30,Assembly,"Do pass",9,6,2,0,17
62414,20494,2010-08-16,Assembly,"SB 399 Yee  Senate Third Reading  By FUENTES  Amend By FUENTES  Set 	#1",34,30,0,0,64
62414,20658,2010-08-20,Assembly,"SB 399 Yee  Senate Third Reading  By FUENTES  Amend By FUENTES  Set 	#1",48,27,0,0,75
62414,21039,2010-08-24,Assembly,"SB 399 Yee  Senate Third Reading  By FUENTES",34,38,0,0,72
62414,21702,2010-08-30,Assembly,"SB 399 Yee  Motion to Reconsider  By FUENTES",44,28,0,0,72
62414,21703,2010-08-30,Assembly,"SB 399 Yee  Senate Third Reading  By FUENTES",33,38,0,0,71
62415,5621,2009-04-21,Senate,"Do pass as amended, and re-refer to the Committee on Environmental Quality",6,4,1,0,11
62415,5622,2009-06-03,Senate,"Senate 3rd Reading SB400 Corbett",23,15,1,0,39
62415,5623,2009-07-08,Assembly,"Do pass and be re-referred to the Committee on Appropriations",18,0,1,0,19
62415,5624,2009-08-19,Assembly,"Do pass",17,0,0,0,17
62415,5625,2009-09-02,Assembly,"SB 400 Corbett  Senate Third Reading  By FONG  Amend By FONG  Set #1",51,24,4,0,79
62415,5626,2009-09-08,Assembly,"SB 400 Corbett  Senate Third Reading  By FONG",50,29,0,0,79
62415,5627,2009-09-10,Senate,"From committee:  That the Assembly Amendments be concurred in",9,2,0,0,11
62415,5628,2009-09-11,Senate,"W/O REF. TO FILE SB400 Corbett",24,14,2,0,40
62416,27169,2009-04-22,Senate,"Do pass as amended, and re-refer to the Committee on Appropriations",5,2,0,0,7
62416,27170,2009-05-11,Senate,"Placed on Appropriations Suspense file",13,0,0,0,13
62416,27171,2009-05-28,Senate,"Do pass as amended",7,5,0,0,12
62416,27172,2009-06-02,Senate,"Senate 3rd Reading SB401 Wolk",22,15,0,0,37
62416,27173,2009-07-06,Assembly,"Do pass as amended and be re-referred to the Committee on 	Appropriations",6,2,0,0,8
62416,27174,2009-08-27,Assembly,"Do pass as amended",12,5,0,0,17
62416,27175,2010-04-05,Assembly,"SB 401 Wolk  Senate Third Reading  By CALDERON  Amend By CALDERON 	Set #1",45,27,0,0,72
62416,27176,2010-04-06,Assembly,"Do pass and be re-referred to the Committee on Appropriations",5,3,0,0,8
62416,27177,2010-04-07,Assembly,"Do pass",9,4,0,0,13
62416,27178,2010-04-08,Assembly,"SB 401 Wolk  Senate Third Reading  By PORTANTINO",47,24,0,0,71
62416,27179,2010-04-08,Senate,"W/O REF. TO FILE SB401 Wolk Concurrence",24,9,0,0,33
62417,5603,2009-04-22,Senate,"Do pass as amended, and re-refer to the Committee on Rules",5,2,1,0,8
62417,5604,2009-05-18,Senate,"Placed on Appropriations Suspense file",13,0,0,0,13
62417,5605,2009-05-28,Senate,"Do pass",7,5,1,0,13
62417,5606,2009-06-01,Senate,"Senate 3rd Reading SB402 Wolk",23,16,0,0,39
62417,5607,2009-07-06,Assembly,"Do pass and be re-referred to the Committee on Appropriations",6,2,1,0,9
62417,5608,2009-08-27,Assembly,"Do pass",12,5,0,0,17
62417,5609,2009-09-11,Assembly,"Do pass as amended",8,0,1,0,9
62417,5610,2009-09-11,Assembly,"SB 402 Wolk  Senate Third Reading  Amendment",51,24,4,0,79
62417,5611,2009-09-11,Assembly,"SB 402 Wolk  Senate Third Reading  By SKINNER",58,16,5,0,79
62417,5612,2009-09-11,Senate,"Unfinished Supp 2 SB402 Wolk",22,14,4,0,40
62419,5613,2009-05-13,Senate,"Do pass as amended",5,0,1,0,6
62419,5614,2009-05-21,Senate,"Senate 3rd Reading SB404 Benoit",32,0,7,0,39
62421,5592,2009-04-15,Senate,"Do pass, but re-refer to the Committee on Rules",3,2,0,0,5
62421,5593,2009-04-28,Senate,"Do pass as amended, and re-refer to the Committee on Appropriations",6,4,1,0,11
62421,5594,2009-05-26,Senate,"Placed on Appropriations Suspense file",13,0,0,0,13
62421,5595,2009-05-28,Senate,"Do pass as amended",7,5,1,0,13
62421,5596,2009-06-02,Senate,"Senate 3rd Reading SB406 DeSaulnier",21,16,2,0,39
62421,5597,2009-07-01,Assembly,"Do pass and be re-referred to the Committee on Transportation",5,2,0,0,7
62421,5598,2009-07-06,Assembly,"Do pass as amended and be re-referred to the Committee on Appropriations",8,6,0,0,14
62421,5599,2009-08-27,Assembly,"Do pass as amended",12,5,0,0,17
62421,5600,2009-09-04,Assembly,"SB 406 DeSaulnier  Senate Third Reading  Amend By TORLAKSON  Set #1",43,28,8,0,79
62421,5601,2009-09-11,Senate,"Unfinished Supp 1 SB406 DeSaulnier Concurrence",21,17,2,0,40
62421,5602,2009-09-11,Assembly,"SB 406 DeSaulnier  Senate Third Reading  By TORLAKSON",47,31,1,0,79
62422,25626,2009-04-21,Senate,"Do pass, but re-refer to the Committee on Rules",7,3,0,0,10
62422,25627,2009-05-12,Senate,"Do pass as amended",3,1,0,0,4
62422,25628,2009-06-03,Senate,"Senate 3rd Reading SB407 Padilla",22,15,0,0,37
62422,25629,2009-06-30,Assembly,"Do pass as amended and be re-referred to the Committee on Housing 	and Community Development",7,3,0,0,10
62422,25630,2009-07-08,Assembly,"Do pass and be re-referred to the Committee on Appropriations",4,2,0,0,6
62422,25631,2009-08-27,Assembly,"Do pass as amended",12,5,0,0,17
62422,25632,2009-09-11,Senate,"Unfinished Supp 1 SB407 Padilla",25,15,0,0,40
62422,25633,2009-09-11,Assembly,"SB 407 Padilla  Senate Third Reading  By HUFFMAN",45,29,0,0,74
62423,27281,2010-01-19,Senate,"Do pass, but re-refer to the Committee on Appropriations",4,0,0,0,4
62423,27282,2010-01-21,Senate,"Placed on Appropriations Suspense file",9,0,0,0,9
62423,27283,2010-01-21,Senate,"Do pass as amended",9,0,0,0,9
62423,27284,2010-01-28,Senate,"SENATE 3RD READING SB408 PADILLA",35,0,0,0,35
62423,27285,2010-04-22,Assembly,"Do pass and re-refer to Committee on Appropriations with 	recommendation:  To Consent Calendar",7,0,0,0,7
62423,27286,2010-05-05,Assembly,"Do pass, to Consent Calendar",17,0,0,0,17
62423,27287,2010-05-17,Assembly,"SB 408 Padilla  Third Reading Urgency  By PEREZ, V.M",73,0,0,0,73
62424,5574,2009-06-09,Senate,"Do pass, but re-refer to the Committee on Appropriations",10,0,1,0,11
62424,5575,2009-07-23,Senate,"Placed on Appropriations Suspense file",13,0,0,0,13
62424,5576,2009-08-27,Senate,"Do pass",13,0,0,0,13
62424,5577,2010-01-28,Senate,"SENATE 3RD READING SB409 DUCHENY",32,0,7,0,39
62424,9844,2010-06-28,Assembly,"Do pass as amended and be re-referred to the Committee on Appropriations",11,0,3,0,14
62425,5580,2009-04-29,Senate,"Do pass, but re-refer to the Committee on Appropriations",5,1,0,0,6
62425,5581,2009-05-18,Senate,"Placed on Appropriations Suspense file",13,0,0,0,13
62425,5582,2009-05-28,Senate,"Do pass",7,5,1,0,13
62425,5583,2009-06-02,Senate,"Senate 3rd Reading SB410 Ducheny",23,11,5,0,39
62425,5584,2009-07-08,Assembly,"Do pass and be re-referred to the Committee on Appropriations",6,1,0,0,7
62425,5585,2009-08-27,Assembly,"Do pass",12,5,0,0,17
62425,5586,2009-09-08,Assembly,"SB 410 Ducheny  Senate Third Reading  By MONNING",57,22,0,0,79
62425,5587,2009-09-10,Senate,"Unfinished Business SB410 Ducheny Concurrence",26,14,0,0,40
62427,25955,2009-04-21,Senate,"Do pass, but re-refer to the Committee on Appropriations",10,1,0,0,11
62427,25956,2009-05-04,Senate,"Placed on Appropriations Suspense file",11,0,0,0,11
62427,25957,2009-05-28,Senate,"Do pass as amended",11,0,0,0,11
62427,25958,2009-06-01,Senate,"Senate 3rd Reading SB412 Kehoe",37,0,0,0,37
62427,25959,2009-06-29,Assembly,"Do pass and be re-referred to the Committee on Natural Resources",13,0,0,0,13
62427,25960,2009-07-06,Assembly,"Do pass as amended and be re-referred to the Committee on 	Appropriations",9,0,0,0,9
62427,25961,2009-08-19,Assembly,"Do pass",15,0,0,0,15
62427,25962,2009-09-03,Assembly,"SB 412 Kehoe  Senate Third Reading  By SKINNER",71,3,0,0,74
62427,25963,2009-09-08,Senate,"Unfinished Business SB412 Kehoe",36,0,0,0,36
62428,5556,2009-04-27,Senate,"Do pass as amended, and re-refer to the Committee on Appropriations",5,2,0,0,7
62429,998,2010-01-11,Senate,"Do pass as amended.",4,2,0,0,6
62429,999,2010-01-25,Senate,"SENATE 3RD READING SB414 CORREA",23,13,3,0,39
62429,9563,2010-06-23,Assembly,"Do pass",5,1,0,0,6
62429,19855,2010-08-09,Assembly,"SB 414 Correa  Senate Third Reading  By BERRYHILL, T",53,20,0,0,73
62429,20775,2010-08-19,Senate,"Unfinished Business SB414 Correa",23,11,0,0,34
62430,5534,2009-04-28,Senate,"Do pass, but re-refer to the Committee on Appropriations",7,4,1,0,12
62430,5535,2009-06-01,Senate,"Senate 3rd Reading SB415 Oropeza",23,16,0,0,39
62430,5536,2009-07-01,Assembly,"Do pass and be re-referred to the Committee on Appropriations",8,6,5,0,19
62430,5537,2009-07-01,Assembly,"Set first hearing.  Failed passage.  Reconsideration granted",17,0,2,0,19
62430,5538,2009-07-08,Assembly,"Do pass and be re-referred to the Committee on Appropriations",10,8,1,0,19
62430,5539,2009-08-19,Assembly,"Do pass",10,7,0,0,17
62430,5540,2009-09-08,Assembly,"SB 415 Oropeza  Senate Third Reading  By TORLAKSON",43,30,6,0,79
62431,5549,2009-04-21,Senate,"Do pass as amended, and re-refer to the Committee on Education",3,1,1,0,5
62431,5550,2009-04-29,Senate,"Do pass as amended, and re-refer to the Committee on Appropriations",5,2,2,0,9
62431,5551,2009-05-26,Senate,"Placed on Appropriations Suspense file",13,0,0,0,13
62431,5552,2009-05-28,Senate,"Do pass as amended",7,5,1,0,13
62431,5553,2009-06-03,Senate,"Senate 3rd Reading SB416 Florez",15,20,4,0,39
62431,5554,2009-06-03,Senate,"Senate 3rd Reading SB416 Florez Reconsider",39,0,0,0,39
62431,5555,2010-01-28,Senate,"SENATE 3RD READING SB416 FLOREZ",16,17,6,0,39
62433,23015,2009-04-14,Senate,"Do pass",7,0,0,0,7
62433,23016,2009-04-20,Senate,"Senate 3rd Reading SB418 Committee on V.A. (Wyland)",37,0,0,0,37
62433,23017,2009-06-30,Assembly,"Do pass, to Consent Calendar",9,0,0,0,9
62433,23018,2009-07-09,Assembly,"SB 418 V. A.  Consent Calendar Second Day  Regular Session",74,0,0,0,74
62434,22641,2009-04-14,Senate,"Do pass",7,0,0,0,7
62434,22642,2009-04-20,Senate,"Senate 3rd Reading SB419 Committee on V.A. (Wyland)",37,0,0,0,37
62434,22643,2009-06-16,Assembly,"Do pass",8,0,0,0,8
62434,22644,2009-08-24,Assembly,"SB 419 V. A.  Senate Third Reading",76,0,0,0,76
62434,22645,2009-08-31,Senate,"Special Consent #17 SB419 Committee on V.A. (Denham)",36,0,0,0,36
62439,22470,2009-04-14,Senate,"Do pass, but re-refer to the Committee on Appropriations",10,0,0,0,10
62439,22471,2009-05-06,Senate,"Special Consent #2 SB424 Padilla",35,0,0,0,35
62439,22472,2009-05-21,Assembly,"Do pass and be re-referred to the Committee on Appropriations",9,0,0,0,9
62439,22473,2009-06-11,Assembly,"Do pass as amended, to Consent Calendar",14,0,0,0,14
62439,22474,2009-06-18,Assembly,"SB 424 Padilla  Consent Calendar Second Day",72,0,0,0,72
62439,22475,2009-06-22,Senate,"Unfinished Business SB424 Padilla Concurrence",38,0,0,0,38
62440,5564,2009-04-28,Senate,"Do pass as amended, and re-refer to the Committee on Environmental Quality",8,1,2,0,11
62440,5565,2009-04-28,Senate,"Reconsideration granted",9,0,2,0,11
62440,5566,2009-04-28,Senate,"Do pass as amended, and re-refer to the Committee on Environmental Quality",8,1,2,0,11
62440,5567,2009-07-08,Senate,"Do pass, but re-refer to the Committee on Appropriations",7,0,1,0,8
62440,5568,2009-07-23,Senate,"Placed on Appropriations Suspense file",13,0,0,0,13
62441,5569,2009-04-15,Senate,"Do pass as amended, and re-refer to the Committee on Appropriations",6,3,0,0,9
62441,5570,2009-05-26,Senate,"Placed on Appropriations Suspense file",13,0,0,0,13
62442,3898,2009-04-13,Senate,"Do pass, but re-refer to the Committee on Judiciary",5,3,2,0,10
62442,3899,2009-04-13,Senate,"Set, first hearing.  Failed passage in Committee.  Reconsideration granted",9,0,1,0,10
62442,3900,2009-04-20,Senate,"Do pass, but re-refer to the Committee on Judiciary",7,2,1,0,10
62442,3901,2009-06-03,Senate,"Senate 3rd Reading SB427 Negrete McLeod",25,10,4,0,39
62442,9569,2010-06-22,Assembly,"Do pass and be re-referred to the Committee on Appropriations",7,3,1,0,11
62442,19665,2010-08-04,Assembly,"Do pass as amended",12,5,0,0,17
62442,21929,2010-08-30,Assembly,"SB 427 Negrete McLeod  Senate Third Reading  By HAYASHI",67,8,0,0,75
62442,21930,2010-08-30,Senate,"W/O REF. TO FILE SB427 Negrete McLeod Concurrence",23,11,0,0,34
62443,25089,2009-04-14,Senate,"Do pass",10,1,0,0,11
62443,25090,2009-04-16,Senate,"Senate 3rd Reading SB428 Kehoe",30,4,0,0,34
62443,25091,2009-06-22,Assembly,"Do pass",9,0,0,0,9
62443,25092,2009-07-09,Assembly,"SB 428 Kehoe  Senate Third Reading  By FLETCHER",75,0,0,0,75
62445,22579,2009-05-06,Senate,"Do pass as amended, and re-refer to the Committee on Appropriations",4,0,0,0,4
62445,22580,2009-05-18,Senate,"Senate 3rd Reading SB430 Dutton",33,0,0,0,33
62445,22581,2009-06-17,Assembly,"Do pass",7,0,0,0,7
62445,22582,2009-06-25,Assembly,"SB 430 Dutton  Senate Third Reading  By ADAMS",69,0,0,0,69
62446,23263,2009-04-28,Senate,"Do pass",7,0,0,0,7
62446,23264,2009-05-11,Senate,"Special Consent #3 SB431 Benoit",36,0,0,0,36
62446,23265,2009-06-16,Assembly,"Do pass and re-refer to Committee on Appropriations with 	recommendation:  To Consent Calendar",7,0,0,0,7
62446,23266,2009-07-01,Assembly,"Do pass, to Consent Calendar",15,0,0,0,15
62446,23267,2009-07-09,Assembly,"SB 431 Benoit  Consent Calendar Second Day  Regular Session",74,0,0,0,74
62446,23268,2009-08-17,Senate,"Special Consent #14 SB431 Benoit",35,0,0,0,35
62447,25283,2009-04-28,Senate,"Do pass as amended, and re-refer to the Committee on Appropriations",7,0,0,0,7
62447,25284,2009-05-18,Senate,"Do pass as amended",11,0,0,0,11
62447,25285,2009-05-28,Senate,"Senate 3rd Reading SB432 Runner",32,0,0,0,32
62447,25286,2009-06-23,Assembly,"Do pass and re-refer to Committee on Appropriations with 	recommendation:  To Consent Calendar",7,0,0,0,7
62447,25287,2009-07-01,Assembly,"Do pass, to Consent Calendar",15,0,0,0,15
62447,25288,2009-07-09,Assembly,"SB 432 Runner  Consent Calendar Second Day  Regular Session",74,0,0,0,74
62449,5526,2009-04-14,Senate,"Do pass, but re-refer to the Committee on Appropriations",7,0,0,0,7
62449,5527,2009-05-06,Senate,"Special Consent #2 SB434 Benoit",35,0,4,0,39
62449,5528,2009-06-16,Assembly,"Do pass as amended and be re-referred to the Committee on Appropriations",6,0,1,0,7
62450,5521,2009-04-14,Senate,"Do pass, but re-refer to the Committee on Appropriations",7,3,1,0,11
62450,5522,2009-04-27,Senate,"Placed on Appropriations Suspense file",13,0,0,0,13
62450,5523,2009-05-28,Senate,"Do pass as amended",7,5,1,0,13
62450,5524,2009-06-01,Senate,"Senate 3rd Reading SB435 Pavley",22,17,0,0,39
62450,10031,2010-06-28,Assembly,"Do pass as amended and be re-referred to the Committee on Appropriations",8,4,2,0,14
62450,19746,2010-08-04,Assembly,"Do pass as amended",11,5,0,0,16
62450,20538,2010-08-18,Assembly,"SB 435 Pavley  Senate Third Reading  By HILL",43,31,0,0,74
62450,20850,2010-08-23,Senate,"From committee:  That the Assembly Amendments be concurred in",6,2,0,0,8
62450,21916,2010-08-30,Senate,"Unfinished Business SB435 Pavley",21,16,0,0,37
62452,5525,2010-01-13,Senate,"Do pass as amended",1,7,3,0,11
62453,5512,2009-04-29,Senate,"Do pass as amended, and re-refer to the Committee on Appropriations",9,2,0,0,11
62453,5513,2009-05-18,Senate,"Placed on Appropriations Suspense file",13,0,0,0,13
62453,5514,2010-01-12,Senate,"Do pass as amended, and re-refer to the Committee on Appropriations",5,0,0,0,5
62453,5515,2010-01-25,Senate,"SENATE 3RD READING SB438 YEE",31,0,8,0,39
62453,8934,2010-06-15,Assembly,"Do pass and be re-referred to the Committee on Appropriations",10,0,0,0,10
62453,9813,2010-06-30,Assembly,"Do pass",13,4,0,0,17
62453,19526,2010-08-02,Assembly,"SB 438 Yee  Senate Third Reading  By EVANS",52,19,0,0,71
62455,5501,2010-01-12,Senate,"Do pass, but re-refer to the Committee on Appropriations",2,5,0,0,7
62456,5516,2009-04-28,Senate,"Do pass, but re-refer to the Committee on Appropriations",7,0,0,0,7
62456,5517,2009-05-18,Senate,"Placed on Appropriations Suspense file",13,0,0,0,13
62456,5518,2009-05-28,Senate,"Do pass as amended",8,4,1,0,13
62456,5519,2009-06-02,Senate,"Senate 3rd Reading SB441 Ducheny",34,4,1,0,39
62456,5520,2009-06-30,Assembly,"Do pass and be re-referred to the Committee on Appropriations",7,0,0,0,7
62457,5502,2009-04-22,Senate,"Do pass as amended, and re-refer to the Committee on Appropriations",11,0,0,0,11
62457,5503,2009-05-11,Senate,"Placed on Appropriations Suspense file",13,0,0,0,13
62457,5504,2010-01-21,Senate,"Do pass as amended",9,0,2,0,11
62457,5505,2010-01-28,Senate,"SENATE 3RD READING SB442 DUCHENY",35,0,4,0,39
62457,9996,2010-06-29,Assembly,"Do pass as amended and be re-referred to the Committee on Appropriations",19,0,0,0,19
62457,19316,2010-08-04,Assembly,"Do pass, to Consent Calendar",17,0,0,0,17
62457,20304,2010-08-16,Assembly,"SB 442 Ducheny  Senate Third Reading  By CHESBRO",74,0,0,0,74
62457,20576,2010-08-19,Senate,"From committee:  That the Assembly Amendments be concurred in",7,0,0,0,7
62457,21364,2010-08-26,Senate,"Special Consent #32 SB442 Ducheny",34,0,0,0,34
62458,5506,2009-04-27,Senate,"Do pass as amended, and re-refer to the Committee on Appropriations",5,2,0,0,7
62458,5507,2009-05-26,Senate,"Placed on Appropriations Suspense file",13,0,0,0,13
62462,23091,2009-04-14,Senate,"Do pass as amended, and re-refer to the Committee on Appropriations",7,0,0,0,7
62462,23092,2009-05-11,Senate,"Do pass",12,0,0,0,12
62462,23093,2009-05-18,Senate,"Senate 3rd Reading SB447 Yee",33,1,0,0,34
62462,23094,2009-06-16,Assembly,"Do pass and re-refer to Committee on Appropriations with 	recommendation:  To Consent Calendar",7,0,0,0,7
62462,23095,2009-07-01,Assembly,"Do pass",15,0,0,0,15
62462,23096,2009-07-13,Assembly,"SB 447 Yee  Senate Third Reading  By TORRICO",76,0,0,0,76
62463,24830,2009-04-14,Senate,"Do pass, but re-refer to the Committee on Appropriations",10,0,0,0,10
62463,24831,2009-04-27,Senate,"Do pass",12,0,0,0,12
62463,24832,2009-05-06,Senate,"Special Consent #2 SB448 Pavley",35,0,0,0,35
62463,24833,2009-06-16,Assembly,"Do pass and be re-referred to the Committee on Appropriations",12,0,0,0,12
62463,24834,2009-07-15,Assembly,"Do pass",16,0,0,0,16
62463,24835,2009-09-01,Assembly,"SB 448 Pavley  Senate Third Reading  By YAMADA",77,0,0,0,77
62463,24836,2009-09-08,Senate,"Unfinished Business SB448 Pavley",40,0,0,0,40
62464,22351,2009-04-14,Senate,"Do pass, but re-refer to the Committee on Appropriations",7,0,0,0,7
62464,22352,2009-05-14,Senate,"Senate 3rd Reading SB449 Padilla",38,0,0,0,38
62464,22353,2009-06-16,Assembly,"Do pass as amended and be re-referred to the Committee on 	Appropriations",6,0,0,0,6
62464,22354,2009-08-19,Assembly,"Do pass as amended, to Consent Calendar",17,0,0,0,17
62464,22355,2009-08-27,Assembly,"SB 449 Padilla  Consent Calendar Second Day  Regular Session",74,0,0,0,74
62464,22356,2009-09-02,Senate,"Special Consent #18 SB449 Padilla",39,0,0,0,39
62465,5473,2009-03-31,Senate,"Do pass, but re-refer to the Committee on Appropriations",11,0,0,0,11
62465,5474,2009-04-23,Senate,"Special Consent #1 SB450 Lowenthal",37,0,2,0,39
62465,5475,2009-07-08,Assembly,"Do pass and re-refer to Committee on Appropriations with recommendation:  To Consent Calendar",6,0,0,0,6
62465,5476,2009-08-19,Assembly,"Do pass, to Consent Calendar",17,0,0,0,17
62465,5477,2009-09-09,Assembly,"Do pass and be re-referred to the Committee on Utilities and Commerce",9,0,0,0,9
62465,5478,2009-09-11,Assembly,"Do pass as amended",14,0,1,0,15
62465,10374,2010-06-30,Assembly,"Do pass and re-refer to Committee on Appropriations with recommendation:  To Consent Calendar",9,0,0,0,9
62465,19998,2010-08-12,Assembly,"Do pass",17,0,0,0,17
62468,5484,2009-04-29,Senate,"Do pass, but re-refer to the Committee on Appropriations",10,1,0,0,11
62468,5485,2009-05-11,Senate,"Placed on Appropriations Suspense file",13,0,0,0,13
62469,4437,2010-01-12,Senate,"Do pass, but re-refer to the Committee on Appropriations",8,0,1,0,9
62469,4438,2010-01-19,Senate,"Do pass",8,0,3,0,11
62469,4439,2010-01-25,Senate,"SENATE 3RD READING SB454 LOWENTHAL",34,0,5,0,39
62469,9033,2010-06-16,Assembly,"Do pass and be re-referred to the Committee on Housing and Community Development",9,0,0,0,9
62469,10283,2010-06-30,Assembly,"Do pass and be re-referred to the Committee on Appropriations",8,0,1,0,9
62469,19762,2010-08-04,Assembly,"Do pass",17,0,0,0,17
62469,20483,2010-08-16,Assembly,"SB 454 Lowenthal  Senate Third Reading  By TORRES",65,9,0,0,74
62469,20574,2010-08-19,Senate,"Unfinished Business SB454 Lowenthal",33,1,0,0,34
62470,5479,2009-04-21,Senate,"Do pass, but re-refer to the Committee on Appropriations",10,1,0,0,11
62470,5480,2009-05-26,Senate,"Do pass",9,4,0,0,13
62470,5481,2009-06-02,Senate,"Senate 3rd Reading SB455 Lowenthal",32,5,2,0,39
62470,5482,2009-06-29,Assembly,"Do pass and be re-referred to the Committee on Appropriations",10,4,0,0,14
62470,5483,2009-07-15,Assembly,"Do pass",11,5,0,0,16
62470,21713,2010-08-30,Assembly,"SB 455 Lowenthal  Senate Third Reading  By LOWENTHAL",72,5,0,0,77
62470,21714,2010-08-30,Senate,"W/O REF. TO FILE SB455 Lowenthal Concurrence",25,12,0,0,37
62472,5462,2009-04-14,Senate,"Do pass, but re-refer to the Committee on Local Government",7,3,1,0,11
62472,5463,2009-04-29,Senate,"Do pass as amended, and re-refer to the Committee on Appropriations",3,2,0,0,5
62472,5464,2009-05-18,Senate,"Placed on Appropriations Suspense file",13,0,0,0,13
62472,5465,2009-05-28,Senate,"Do pass as amended",7,5,1,0,13
62472,5466,2009-06-03,Senate,"Senate 3rd Reading SB457 Wolk",23,14,2,0,39
62473,5455,2009-04-14,Senate,"Do pass, but re-refer to the Committee on Appropriations",7,3,1,0,11
62473,5456,2009-05-11,Senate,"Placed on Appropriations Suspense file",13,0,0,0,13
62473,5457,2009-05-28,Senate,"Do pass as amended",7,5,1,0,13
62473,5458,2009-06-03,Senate,"Senate 3rd Reading SB458 Wolk",24,10,5,0,39
62473,5459,2009-07-09,Assembly,"SB 458 Pavley  Senate Third Reading  By HUFFMAN  Amend By HUFFMAN Set #1",42,27,10,0,79
62473,5460,2009-07-13,Assembly,"SB 458 Wolk  Senate Third Reading  By HUFFMAN",45,23,11,0,79
62473,5461,2009-07-16,Senate,"Unfinished Business SB458 Wolk",0,36,4,0,40
62474,5445,2009-04-14,Senate,"Do pass as amended, and re-refer to the Committee on Judiciary",8,1,2,0,11
62474,5446,2009-04-28,Senate,"Do pass as amended, and re-refer to the Committee on Appropriations",4,0,1,0,5
62474,5447,2009-06-01,Senate,"Senate 3rd Reading SB459 Wolk",35,2,2,0,39
62474,5448,2009-06-30,Assembly,"Do pass and be re-referred to the Committee on Natural Resources",10,0,0,0,10
62474,5449,2009-07-06,Assembly,"Do pass as amended and be re-referred to the Committee on Appropriations",8,0,1,0,9
62474,5450,2009-08-19,Assembly,"Do pass, to Consent Calendar",17,0,0,0,17
62474,5451,2009-08-27,Assembly,"SB 459 Wolk  Consent Calendar Second Day  Regular Session",74,0,5,0,79
62474,5452,2009-09-02,Senate,"Unfinished Business SB459 Wolk",30,1,9,0,40
62475,5437,2009-04-28,Senate,"Do pass as amended, and re-refer to the Committee on Appropriations",11,0,0,0,11
62475,5438,2009-05-18,Senate,"Placed on Appropriations Suspense file",13,0,0,0,13
62478,5436,2009-04-21,Senate,"Do pass as amended, and re-refer to the Committee on Revenue and Taxation",10,0,1,0,11
62480,5416,2010-01-05,Senate,"Do pass, but re-refer to the Committee on Appropriations",2,3,0,0,5
62482,988,2009-04-14,Senate,"Do pass, but re-refer to the Committee on Appropriations.",12,0,1,0,13
62482,989,2009-04-27,Senate,"Placed on Appropriations Suspense file.",13,0,0,0,13
62484,23516,2009-04-14,Senate,"Do pass as amended, and re-refer to the Committee on Appropriations",7,0,0,0,7
62484,23517,2009-05-11,Senate,"Special Consent #3 SB469 Aanestad",36,0,0,0,36
62484,23518,2009-06-16,Assembly,"Do pass and be re-referred to the Committee on Appropriations",8,0,0,0,8
62484,23519,2009-07-01,Assembly,"Do pass, to Consent Calendar",15,0,0,0,15
62484,23520,2009-07-09,Assembly,"SB 469 Aanestad  Consent Calendar Second Day  Regular Session",74,0,0,0,74
62484,23521,2009-08-17,Senate,"Special Consent #14 SB469 Aanestad",35,0,0,0,35
62485,22796,2009-04-20,Senate,"Do pass as amended, and re-refer to the Committee on Appropriations",8,0,0,0,8
62485,22797,2009-05-14,Senate,"Senate 3rd Reading SB470 Corbett",37,1,0,0,38
62485,22798,2009-06-23,Assembly,"Do pass and be re-referred to the Committee on Business and 	Professions",19,0,0,0,19
62485,22799,2009-06-30,Assembly,"Do pass and be re-referred to the Committee on Appropriations",10,0,0,0,10
62485,22800,2009-07-08,Assembly,"Do pass, to Consent Calendar",15,0,0,0,15
62485,22801,2009-08-27,Assembly,"SB 470 Corbett  Consent Calendar Second Day  Regular Session",74,0,0,0,74
62486,26996,2009-04-29,Senate,"Do pass as amended, and re-refer to the Committee on Appropriations",7,1,0,0,8
62486,26997,2009-05-18,Senate,"Placed on Appropriations Suspense file",13,0,0,0,13
62486,26998,2009-05-28,Senate,"Do pass as amended",7,5,0,0,12
62486,26999,2009-06-01,Senate,"Senate 3rd Reading SB471 Romero",24,14,0,0,38
62486,27000,2009-07-08,Assembly,"Do pass as amended and be re-referred to the Committee on 	Appropriations",7,2,0,0,9
62486,27001,2009-08-27,Assembly,"Do pass as amended",12,5,0,0,17
62486,27002,2009-09-08,Assembly,"SB 471 Romero  Senate Third Reading  By HILL",52,26,0,0,78
62486,27003,2009-09-10,Senate,"Unfinished Business SB471 Romero",23,13,0,0,36
62489,5417,2009-07-07,Senate,"Do pass as amended, and re-refer to the Committee on Appropriations",9,0,2,0,11
62489,5418,2009-08-27,Senate,"Senate 3rd Reading SB474 Ducheny Urgency Clause",38,0,2,0,40
62489,9697,2010-06-28,Assembly,"Do pass as amended and be re-referred to the Committee on Appropriations",10,1,3,0,14
62489,19361,2010-08-04,Assembly,"Do pass",15,0,0,0,15
62489,20503,2010-08-16,Assembly,"SB 474 Ducheny  Third Reading Urgency  By JEFFRIES",75,0,0,0,75
62489,20605,2010-08-19,Senate,"Unfinished Business SB474 Ducheny Urgency Clause",35,0,0,0,35
62490,26583,2009-04-20,Senate,"Do pass, but re-refer to the Committee on Appropriations",9,0,0,0,9
62490,26584,2009-05-14,Senate,"Senate 3rd Reading SB475 Padilla",36,0,0,0,36
62490,26585,2009-06-16,Assembly,"Do pass and be re-referred to the Committee on Appropriations",11,0,0,0,11
62490,26586,2009-07-01,Assembly,"Do pass",14,0,0,0,14
62490,26587,2009-07-13,Assembly,"SB 475 Padilla  Senate Third Reading  By NAVA",69,6,0,0,75
62491,5414,2009-04-27,Senate,"Do pass as amended",6,0,1,0,7
62491,5415,2009-05-11,Senate,"Special Consent #3 SB476 Correa",36,0,3,0,39
62492,4937,2009-04-21,Senate,"Do pass, but re-refer to the Committee on Appropriations",7,3,1,0,11
62492,4938,2009-05-14,Senate,"Senate 3rd Reading SB477 Florez",23,13,3,0,39
62492,4939,2009-07-08,Assembly,"Do pass as amended and be re-referred to the Committee on Appropriations",4,2,0,0,6
62492,4940,2010-05-06,Assembly,"Be referred to Committee on Labor and Employment",10,0,1,0,11
62492,9285,2010-06-23,Assembly,"Do pass and be re-referred to the Committee on Appropriations",4,1,1,0,6
62493,26212,2009-05-13,Senate,"Do pass and be placed on the Consent Calendar",5,0,0,0,5
62493,26213,2009-05-21,Senate,"Consent Calendar 2nd SB478 Wolk",36,0,0,0,36
62493,26214,2009-07-08,Assembly,"Do pass as amended",7,0,0,0,7
62493,26215,2009-08-19,Assembly,"Do pass, to Consent Calendar",17,0,0,0,17
62493,26216,2009-08-27,Assembly,"SB 478 Wolk  Consent Calendar Second Day  Regular Session",74,0,0,0,74
62493,26217,2009-09-02,Senate,"Special Consent #18 SB478 Wolk",39,0,0,0,39
62496,23847,2009-04-28,Senate,"Do pass, but re-refer to the Committee on Appropriations",11,0,0,0,11
62496,23848,2009-05-18,Senate,"Special Consent #5 SB481 Cox",36,0,0,0,36
62496,23849,2009-06-16,Assembly,"Do pass as amended and be re-referred to the Committee on 	Appropriations",12,0,0,0,12
62496,23850,2009-07-01,Assembly,"Do pass, to Consent Calendar",15,0,0,0,15
62496,23851,2009-08-17,Assembly,"SB 481 Cox  Senate Third Reading  By NIELLO",74,0,0,0,74
62496,23852,2009-08-20,Senate,"Unfinished Business SB481 Cox Concurrence",38,0,0,0,38
62497,5406,2009-04-27,Senate,"Do pass, but re-refer to the Committee on Rules",7,1,2,0,10
62498,5390,2009-05-12,Senate,"Do pass and be placed on the Consent Calendar",5,0,0,0,5
62498,5391,2009-05-21,Senate,"Consent Calendar 2nd SB483 Corbett",36,0,3,0,39
62498,5392,2009-06-30,Assembly,"Do pass as amended, to Consent Calendar",10,0,0,0,10
62498,5393,2009-09-10,Assembly,"Do pass as amended and be re-referred to the Committee on Revenue and Taxation",10,0,1,0,11
62499,5384,2009-04-28,Senate,"Do pass as amended, and re-refer to the Committee on Appropriations",6,1,0,0,7
62499,5385,2009-05-26,Senate,"Placed on Appropriations Suspense file",13,0,0,0,13
62499,5386,2009-05-28,Senate,"Do pass",7,5,1,0,13
62499,5387,2009-06-02,Senate,"Senate 3rd Reading SB484 Wright",22,10,7,0,39
62499,5388,2009-06-30,Assembly,"Do pass as amended and be re-referred to the Committee on Appropriations",3,2,2,0,7
62499,5389,2009-06-30,Assembly,"Set second hearing.  Failed passage.  Reconsideration granted",7,0,0,0,7
62501,26615,2009-04-27,Senate,"Do pass, but re-refer to the Committee on Appropriations",7,0,0,0,7
62501,26616,2009-05-14,Senate,"Senate 3rd Reading SB486 Simitian",32,4,0,0,36
62501,26617,2009-06-16,Assembly,"Do pass and be re-referred to the Committee on Appropriations",6,0,0,0,6
62501,26618,2009-08-27,Assembly,"Do pass as amended",13,4,0,0,17
62501,26619,2009-09-02,Assembly,"SB 486 Simitian  Senate Third Reading  By CHESBRO",46,22,0,0,68
62501,26620,2009-09-08,Senate,"Unfinished Business SB486 Simitian",23,16,0,0,39
62503,24951,2009-04-27,Senate,"Do pass as amended, and re-refer to the Committee on Appropriations",11,0,0,0,11
62503,24952,2009-06-01,Senate,"Senate 3rd Reading SB488 Pavley",34,3,0,0,37
62503,24953,2009-07-06,Assembly,"Do pass as amended and be re-referred to the Committee on 	Appropriations",13,0,0,0,13
62503,24954,2009-08-27,Assembly,"Do pass as amended",15,1,0,0,16
62503,24955,2009-09-02,Assembly,"SB 488 Pavley  Senate Third Reading  By FUENTES",68,6,0,0,74
62503,24956,2009-09-08,Senate,"Unfinished Business SB488 Pavley",34,4,0,0,38
62505,25295,2009-03-31,Senate,"Do pass, but re-refer to the Committee on Appropriations",7,0,0,0,7
62505,25296,2009-04-23,Senate,"Special Consent #1 SB490 Maldonado",37,0,0,0,37
62505,25297,2009-06-16,Assembly,"Do pass, to Consent Calendar",7,0,0,0,7
62505,25298,2009-06-22,Assembly,"SB 490 Maldonado  Consent Calendar Second Day  Regular Session",74,0,0,0,74
62505,25299,2009-06-29,Senate,"Special Consent #11 SB490 Maldonado",40,0,0,0,40
62507,22399,2009-04-14,Senate,"Do pass as amended, and re-refer to the Committee on Appropriations",7,0,0,0,7
62507,22400,2009-05-14,Senate,"Senate 3rd Reading SB492 Maldonado",37,0,0,0,37
62507,22401,2009-06-16,Assembly,"Do pass and be re-referred to the Committee on Appropriations",4,1,0,0,5
62507,22402,2009-07-08,Assembly,"Do pass as amended",14,1,0,0,15
62507,22403,2009-09-02,Assembly,"SB 492 Maldonado  Senate Third Reading  By MA",78,0,0,0,78
62507,22404,2009-09-08,Senate,"Unfinished Business SB492 Maldonado",38,1,0,0,39
62511,5362,2009-04-27,Senate,"Do pass, but re-refer to the Committee on Public Safety",7,1,2,0,10
62511,5363,2009-04-28,Senate,"Do pass, but re-refer to the Committee on Appropriations",2,3,2,0,7
62511,5364,2009-04-28,Senate,"Set, first hearing.  Failed passage in Committee.  Reconsideration granted",5,0,2,0,7
62512,5359,2009-04-01,Senate,"Do pass, but re-refer to the Committee on Environmental Quality",5,1,3,0,9
62512,5360,2009-04-27,Senate,"Do pass as amended, and re-refer to the Committee on Appropriations",5,2,0,0,7
62512,5361,2009-05-18,Senate,"Placed on Appropriations Suspense file",13,0,0,0,13
62514,23025,2009-04-15,Senate,"Do pass, but re-refer to the Committee on Appropriations",11,0,0,0,11
62514,23026,2009-05-06,Senate,"Special Consent #2 SB499 Ducheny",35,0,0,0,35
62514,23027,2009-06-09,Assembly,"Do pass and be re-referred to the Committee on Appropriations",17,0,0,0,17
62514,23028,2009-08-27,Assembly,"Do pass",17,0,0,0,17
62514,23029,2009-09-09,Assembly,"Do pass and be re-referred to the Committee on Appropriations",17,0,0,0,17
62514,23030,2009-09-09,Assembly,"Do pass",15,0,0,0,15
62514,23031,2009-09-10,Senate,"From committee:  That the Assembly Amendments be concurred in",9,1,0,0,10
62514,23032,2009-09-11,Senate,"Unfinished Supp 1 SB499 Ducheny Concurrence",31,1,0,0,32
62514,23033,2009-09-11,Assembly,"SB 499 Ducheny  Senate Third Reading",72,3,0,0,75
62516,5368,2009-04-28,Senate,"Do pass, but re-refer to the Committee on Appropriations",10,0,1,0,11
62516,5369,2009-05-18,Senate,"Special Consent #5 SB501 Correa",36,0,3,0,39
62516,5370,2009-06-17,Assembly,"Do pass and be re-referred to the Committee on Appropriations",7,0,0,0,7
62516,5371,2009-07-01,Assembly,"Do pass, to Consent Calendar",15,0,1,0,16
62516,20452,2010-08-18,Assembly,"Do pass",6,0,0,0,6
62516,21843,2010-08-31,Assembly,"SB 501 Correa  Senate Third Reading  By DE LA TORRE",75,0,0,0,75
62518,5355,2009-04-28,Senate,"Do pass, but re-refer to the Committee on Appropriations",8,4,0,0,12
62518,5356,2009-05-11,Senate,"Placed on Appropriations Suspense file",13,0,0,0,13
62518,5357,2010-01-21,Senate,"Do pass",8,1,2,0,11
62518,5358,2010-01-28,Senate,"SENATE 3RD READING SB503 KEHOE",37,0,2,0,39
62518,8922,2010-06-15,Assembly,"Do pass and be re-referred to the Committee on Appropriations",11,0,0,0,11
62518,20416,2010-08-12,Assembly,"Do pass",17,0,0,0,17
62518,20620,2010-08-19,Assembly,"SB 503 Kehoe  Senate Third Reading  By SALAS",77,0,0,0,77
62518,21238,2010-08-25,Senate,"Unfinished Business SB503 Kehoe",35,0,0,0,35
62520,5332,2009-04-15,Senate,"Do pass as amended, and re-refer to the Committee on Environmental Quality",3,2,0,0,5
62520,5333,2009-04-27,Senate,"Do pass, but re-refer to the Committee on Appropriations",5,2,0,0,7
62520,5334,2009-05-11,Senate,"Placed on Appropriations Suspense file",13,0,0,0,13
62520,5335,2009-05-28,Senate,"Do pass as amended",7,5,1,0,13
62520,5336,2009-06-03,Senate,"Senate 3rd Reading SB505 Kehoe",24,15,0,0,39
62520,5337,2009-07-01,Assembly,"Do pass and be re-referred to the Committee on Natural Resources",5,0,2,0,7
62520,5338,2009-07-06,Assembly,"Do pass as amended and be re-referred to the Committee on Appropriations",6,1,2,0,9
62520,5339,2009-08-27,Assembly,"Do pass",12,5,0,0,17
62520,5340,2009-09-01,Assembly,"SB 505 Kehoe  Senate Third Reading  By DE LA TORRE",55,18,6,0,79
62520,5341,2009-09-08,Senate,"Unfinished Business SB505 Kehoe",25,14,1,0,40
62522,5311,2009-05-20,Senate,"Do pass, but re-refer to the Committee on Appropriations",3,3,1,0,7
62522,5312,2009-05-20,Senate,"Set, first hearing.  Failed passage in Committee.  Reconsideration granted",5,0,2,0,7
62524,26663,2009-04-29,Senate,"Do pass and be placed on the Consent Calendar",9,0,0,0,9
62524,26664,2009-05-06,Senate,"Consent Calendar 2nd SB509 Committee on Ed. (Scott)",35,0,0,0,35
62524,26665,2009-07-01,Assembly,"Do pass as amended and re-refer to Committee on Appropriations 	with recommendation:  To Consent Calendar",10,0,0,0,10
62524,26666,2009-08-19,Assembly,"Do pass, to Consent Calendar",17,0,0,0,17
62524,26667,2009-08-27,Assembly,"SB 509 E.D.  Consent Calendar Second Day  Regular Session",74,0,0,0,74
62524,26668,2009-09-02,Senate,"Special Consent #18 SB509 Committee on Ed. (Romero)",39,0,0,0,39
62525,22626,2009-04-28,Senate,"Do pass as amended",3,2,0,0,5
62525,22627,2009-05-14,Senate,"Senate 3rd Reading SB510 Corbett",24,13,0,0,37
62525,22628,2009-06-30,Assembly,"Do pass as amended",10,0,0,0,10
62525,22629,2009-08-24,Assembly,"SB 510 Corbett  Senate Third Reading  By TRAN",74,0,0,0,74
62525,22630,2009-09-09,Senate,"Unfinished Business SB510 Corbett",24,10,0,0,34
62526,26971,2009-04-29,Senate,"Do pass, but re-refer to the Committee on Appropriations Recommend 	Consent",9,0,0,0,9
62526,26972,2009-05-18,Senate,"Special Consent #5 SB511 Committee on Ed. (Scott)",36,0,0,0,36
62526,26973,2009-06-23,Assembly,"Do pass and be re-referred to the Committee on Education to Consent 	Calendar",9,0,0,0,9
62526,26974,2009-07-08,Assembly,"Do pass and re-refer to Committee on Appropriations with 	recommendation:  To Consent Calendar",11,0,0,0,11
62526,26975,2009-08-19,Assembly,"Do pass as amended",12,0,0,0,12
62526,26976,2009-09-02,Assembly,"SB 511 E.D.  Senate Third Reading  By PORTANTINO",74,1,0,0,75
62526,26977,2009-09-09,Senate,"Special Consent #20 SB511 Committee on Ed. (Romero)",40,0,0,0,40
62527,23010,2009-04-29,Senate,"Do pass as amended. To Consent Calendar",9,0,0,0,9
62527,23011,2009-05-14,Senate,"Consent Calendar 2nd SB512 Committee on Ed. (Scott)",38,0,0,0,38
62527,23012,2009-06-17,Assembly,"Do pass, to Consent Calendar",10,0,0,0,10
62527,23013,2009-06-24,Assembly,"SB 512 E.D.  Consent Calendar Second Day  Regular Session",72,0,0,0,72
62527,23014,2009-07-09,Senate,"Special Consent #12 SB512 Committee on Ed. (Romero)",34,0,0,0,34
62530,5327,2009-04-22,Senate,"Do pass, but re-refer to the Committee on Business, Professions and Economic Development",8,0,1,0,9
62530,5328,2009-05-11,Senate,"Do pass",9,1,0,0,10
62530,5329,2009-05-14,Senate,"Senate 3rd Reading SB515 Hancock",28,9,2,0,39
62530,5330,2009-06-17,Assembly,"Do pass as amended",9,0,2,0,11
62530,5331,2009-07-13,Assembly,"SB 515 Hancock  Senate Third Reading",64,13,2,0,79
62530,21212,2010-08-25,Assembly,"SB 515 Hancock  Senate Third Reading  By FURUTANI",58,19,0,0,77
62530,21416,2010-08-26,Senate,"Unfinished Business SB515 Hancock",31,6,0,0,37
62531,5306,2009-04-22,Senate,"Do pass as amended, and re-refer to the Committee on Appropriations",5,2,1,0,8
62531,5307,2009-05-18,Senate,"Placed on Appropriations Suspense file",13,0,0,0,13
62531,5308,2009-05-28,Senate,"Do pass as amended",7,5,1,0,13
62531,5309,2009-06-01,Senate,"Senate 3rd Reading SB516 DeSaulnier",24,14,1,0,39
62531,5310,2009-06-30,Assembly,"Do pass and be re-referred to the Committee on Revenue and Taxation",4,2,1,0,7
62531,9927,2010-06-28,Assembly,"Do pass as amended and be re-referred to the Committee on Appropriations",7,1,1,0,9
62531,19783,2010-08-04,Assembly,"Do pass",12,5,0,0,17
62531,21064,2010-08-23,Assembly,"SB 516 DeSaulnier  Senate Third Reading  By AMMIANO",55,18,0,0,73
62531,21436,2010-08-26,Senate,"Unfinished Business SB516 DeSaulnier",23,13,0,0,36
62532,22877,2009-05-12,Senate,"Do pass as amended, and re-refer to the Committee on 	Appropriations",8,1,0,0,9
62532,22878,2009-06-01,Senate,"Senate 3rd Reading SB517 Florez Urgency Clause",36,2,0,0,38
62532,22879,2009-07-08,Assembly,"Do pass and be re-referred to the Committee on Appropriations",18,0,0,0,18
62532,22880,2009-08-27,Assembly,"Do pass as amended",17,0,0,0,17
62532,22881,2009-09-08,Assembly,"SB 517 Florez  Third Reading Urgency  By COTO",76,0,0,0,76
62532,22882,2009-09-10,Senate,"Unfinished Business SB517 Florez Concurrence",24,2,0,0,26
62532,22883,2009-09-10,Senate,"Unfinished Business SB517 Florez Reconsider",40,0,0,0,40
62532,22884,2009-10-14,Senate,"Unfinished Business SB517 Florez",36,0,0,0,36
62533,4988,2009-04-21,Senate,"Do pass, but re-refer to the Committee on Education",6,4,1,0,11
62533,4989,2009-04-29,Senate,"Do pass as amended, and re-refer to the Committee on Appropriations",5,3,1,0,9
62533,4990,2009-05-26,Senate,"Placed on Appropriations Suspense file",13,0,0,0,13
62533,4991,2009-05-28,Senate,"Do pass as amended",7,5,1,0,13
62533,4992,2009-06-03,Senate,"Senate 3rd Reading SB518 Lowenthal",19,18,2,0,39
62533,4993,2009-06-03,Senate,"Senate 3rd Reading SB518 Lowenthal Reconsider",39,0,0,0,39
62533,4994,2010-01-28,Senate,"SENATE 3RD READING SB518 LOWENTHAL",21,12,6,0,39
62533,4995,2010-05-28,Assembly,"Be referred to Committee on Environmental Safety and Toxic Materials",9,0,2,0,11
62533,8866,2010-06-15,Assembly,"Do pass as amended and be re-referred to the Committee on Appropriations",9,0,0,0,9
62533,9803,2010-06-30,Assembly,"Do pass, to Consent Calendar",17,0,0,0,17
62533,19952,2010-08-05,Assembly,"SB 518 Lowenthal  Consent Calendar Second Day  Regular Session",71,0,0,0,71
62533,19953,2010-08-10,Senate,"From committee:  That the Assembly Amendments be concurred in",9,0,0,0,9
62533,19954,2010-08-11,Senate,"Unfinished Business SB518 Lowenthal",32,0,0,0,32
62534,22342,2009-05-04,Senate,"Placed on Appropriations Suspense file",11,0,0,0,11
62534,22343,2009-05-28,Senate,"Do pass",11,0,0,0,11
62534,22344,2009-06-01,Senate,"Senate 3rd Reading SB519 Ashburn",36,0,0,0,36
62534,22345,2009-07-08,Assembly,"Do pass and be re-referred to the Committee on Appropriations",6,0,0,0,6
62534,22346,2009-08-27,Assembly,"Do pass",17,0,0,0,17
62534,22347,2009-09-03,Assembly,"Do pass",5,0,0,0,5
62534,22348,2009-09-09,Assembly,"SB 519 Ashburn  Senate Third Reading  By HERNANDEZ",73,2,0,0,75
62534,22349,2009-09-10,Senate,"From committee:  That the Assembly Amendments be concurred in",7,0,0,0,7
62534,22350,2009-09-11,Senate,"Unfinished Business SB519 Ashburn Concurrence",38,0,0,0,38
62535,5313,2009-05-06,Senate,"Do pass as amended",8,1,0,0,9
62535,5314,2009-05-14,Senate,"Senate 3rd Reading SB520 Pavley",24,13,2,0,39
62535,5315,2009-06-24,Assembly,"Do pass as amended",7,3,1,0,11
62535,5316,2009-07-16,Assembly,"SB 520 Pavley  Senate Third Reading  By BROWNLEY",44,26,9,0,79
62535,5317,2009-08-24,Assembly,"SB 520 Pavley  Senate Third Reading  By BROWNLEY",45,29,5,0,79
62535,5318,2009-09-04,Senate,"Unfinished Business SB520 Pavley",26,13,1,0,40
62536,5319,2009-04-22,Senate,"Do pass, but re-refer to the Committee on Appropriations",7,0,2,0,9
62536,5320,2009-05-11,Senate,"Placed on Appropriations Suspense file",13,0,0,0,13
62539,5267,2009-04-27,Senate,"Do pass as amended, and re-refer to the Committee on Appropriations",7,0,0,0,7
62539,5268,2009-06-02,Senate,"Special Consent #7 SB524 Correa",39,0,0,0,39
62539,5269,2009-06-30,Assembly,"Do pass as amended and be re-referred to the Committee on Appropriations",5,1,1,0,7
62539,5270,2009-08-27,Assembly,"Do pass",17,0,0,0,17
62539,27374,2010-10-08,Assembly,"SB 524 Cogdill  Third Reading Urgency  By GILMORE",65,4,0,0,69
62539,27375,2010-10-08,Senate,"W/O REF. TO FILE SB524 Cogdill Urgency Clause",28,2,0,0,30
62540,5297,2010-01-12,Senate,"Do pass, but re-refer to the Committee on Appropriations",7,0,0,0,7
62540,5298,2010-01-25,Senate,"SENATE 3RD READING SB525 PADILLA",36,0,3,0,39
62540,8916,2010-06-15,Assembly,"Do pass and be re-referred to the Committee on Appropriations",5,0,2,0,7
62540,9931,2010-06-30,Assembly,"Do pass as amended, to Consent Calendar",17,0,0,0,17
62540,19413,2010-08-05,Assembly,"SB 525 Padilla  Consent Calendar Second Day  Regular Session",71,0,0,0,71
62540,19630,2010-08-09,Senate,"Unfinished Business SB525 Padilla",34,0,0,0,34
62541,5299,2009-04-28,Senate,"Do pass, but re-refer to the Committee on Appropriations",10,0,1,0,11
62541,5300,2009-05-11,Senate,"Placed on Appropriations Suspense file",13,0,0,0,13
62542,26413,2009-05-12,Senate,"Do pass",9,2,0,0,11
62542,26414,2009-05-18,Senate,"Senate 3rd Reading SB527 Kehoe",33,1,0,0,34
62542,26415,2009-06-22,Assembly,"Do pass",14,0,0,0,14
62542,26416,2009-08-31,Assembly,"SB 527 Kehoe  Senate Third Reading  By GARRICK",77,0,0,0,77
62545,5289,2009-05-06,Senate,"Do pass, but re-refer to the Committee on Appropriations",4,0,1,0,5
62545,5290,2009-05-14,Senate,"Senate 3rd Reading SB530 Dutton",36,1,2,0,39
62545,9938,2010-06-30,Assembly,"Do pass, to Consent Calendar",9,0,0,0,9
62545,19559,2010-08-05,Assembly,"SB 530 Dutton  Consent Calendar Second Day  Regular Session",71,0,0,0,71
62546,5253,2009-04-27,Senate,"Do pass as amended, and re-refer to the Committee on Revenue and Taxation",5,2,0,0,7
62546,5254,2009-05-18,Senate,"Do pass",8,3,2,0,13
62546,5255,2009-06-01,Senate,"Senate 3rd Reading SB531 DeSaulnier",23,15,1,0,39
62547,23369,2009-04-28,Senate,"Do pass, but re-refer to the Committee on Appropriations Recommend 	Consent",10,0,0,0,10
62547,23370,2009-05-18,Senate,"Special Consent #5 SB532 Cogdill",36,0,0,0,36
62547,23371,2009-06-29,Assembly,"Do pass and re-refer to Committee on Appropriations with 	recommendation:  To Consent Calendar",13,0,0,0,13
62547,23372,2009-07-08,Assembly,"Do pass, to Consent Calendar",15,0,0,0,15
62547,23373,2009-08-24,Assembly,"SB 532 Cogdill  Senate Third Reading  By BROWNLEY",76,0,0,0,76
62547,23374,2009-08-31,Senate,"Special Consent #17 SB532 Cogdill",36,0,0,0,36
62549,5277,2009-05-13,Senate,"Do pass as amended, and re-refer to the Committee on Appropriations",6,0,2,0,8
62549,5278,2009-05-26,Senate,"Placed on Appropriations Suspense file",13,0,0,0,13
62550,104,2009-04-28,Senate,"Do pass as amended, and re-refer to the Committee on Appropriations.",7,0,4,0,11
62550,105,2009-05-21,Senate,"Senate 3rd Reading SB535 Yee",29,5,5,0,39
62550,106,2009-06-29,Assembly,"Do pass as amended and be re-referred to the Committee on Appropriations.",9,2,3,0,14
62550,107,2009-08-19,Assembly,"Do pass.",15,0,2,0,17
62550,9576,2010-06-28,Assembly,"SB 535 Yee  Senate Third Reading  By ENG",65,8,6,0,79
62550,19829,2010-08-10,Senate,"From committee:  That the Assembly Amendments be concurred in",8,0,0,0,8
62550,19830,2010-08-11,Senate,"Unfinished Business SB535 Yee",29,3,0,0,32
62553,26134,2009-04-20,Senate,"Do pass",7,0,0,0,7
62553,26135,2009-04-23,Senate,"Special Consent #1 SB538 Committee on P.E. & R. (Wiggens)",37,0,0,0,37
62553,26136,2009-07-08,Assembly,"Do pass, to Consent Calendar",6,0,0,0,6
62553,26137,2009-09-10,Assembly,"SB 538 P.E.& R.  Senate Third Reading  By HERNANDEZ",78,0,0,0,78
62554,5245,2009-04-28,Senate,"Do pass as amended, and re-refer to the Committee on Appropriations",7,4,0,0,11
62554,5246,2009-05-26,Senate,"Placed on Appropriations Suspense file",13,0,0,0,13
62554,5247,2009-05-28,Senate,"Do pass",7,5,1,0,13
62554,5248,2009-06-01,Senate,"Senate 3rd Reading SB539 Wiggins",27,12,0,0,39
62554,5249,2009-06-30,Assembly,"Do pass and be re-referred to the Committee on Appropriations",9,2,2,0,13
62556,5222,2009-03-31,Senate,"Do pass, but re-refer to the Committee on Appropriations",3,2,0,0,5
62556,5223,2009-05-14,Senate,"Senate 3rd Reading SB541 Pavley",22,15,2,0,39
62556,5224,2009-07-07,Assembly,"Do pass as amended and be re-referred to the Committee on Appropriations",4,2,1,0,7
62556,5225,2009-08-19,Assembly,"Do pass as amended",12,5,0,0,17
62556,5226,2009-09-09,Assembly,"SB 541 Pavley  Senate Third Reading  By PEREZ, J",50,29,0,0,79
62556,5227,2009-09-10,Senate,"Unfinished Supp 1 SB541 Pavley",26,14,0,0,40
62557,5228,2009-04-21,Senate,"Do pass as amended, and re-refer to the Committee on Appropriations",10,1,0,0,11
62557,5229,2009-05-18,Senate,"Placed on Appropriations Suspense file",13,0,0,0,13
62557,5230,2009-05-28,Senate,"Do pass as amended",8,4,1,0,13
62557,5231,2009-06-03,Senate,"Senate 3rd Reading SB542 Wiggins",30,8,1,0,39
62557,5232,2009-07-06,Assembly,"Do pass and be re-referred to the Committee on Appropriations",9,5,1,0,15
62558,5237,2009-05-05,Senate,"Do pass as amended",3,0,2,0,5
62558,5238,2009-05-28,Senate,"Do pass as amended",7,3,3,0,13
62558,5239,2009-06-03,Senate,"Senate 3rd Reading SB543 Leno",22,12,5,0,39
62558,5240,2009-06-30,Assembly,"Do pass as amended",7,3,0,0,10
62558,20666,2010-08-20,Assembly,"SB 543 Leno  Remove from Inactive File  Amend By MA  Set #1",48,26,0,0,74
62558,21938,2010-08-30,Assembly,"SB 543 Leno  Senate Third Reading  By MA",49,28,0,0,77
62558,21939,2010-08-30,Senate,"W/O REF. TO FILE SB543 Leno Concurrence",23,14,0,0,37
62559,23316,2009-05-12,Senate,"Do pass and be placed on the Consent Calendar",5,0,0,0,5
62559,23317,2009-05-21,Senate,"Consent Calendar 2nd SB544 Committee on Jud. (Corbett)",36,0,0,0,36
62559,23318,2009-06-23,Assembly,"Do pass as amended, to Consent Calendar",10,0,0,0,10
62559,23319,2009-07-01,Assembly,"SB 544 JUD.  Consent Calendar Second Day  Regular Session",76,0,0,0,76
62559,23320,2009-07-16,Senate,"Special Consent #13 SB544 Committee on Jud. (Corbett)",36,0,0,0,36
62560,5195,2009-04-28,Senate,"Do pass, but re-refer to the Committee on Appropriations",9,0,2,0,11
62560,5196,2009-05-11,Senate,"Do pass",13,0,0,0,13
62560,5197,2009-05-26,Senate,"Senate 3rd Reading SB545 Cedillo",38,0,1,0,39
62560,5198,2009-07-06,Assembly,"Do pass and be re-referred to the Committee on Appropriations",10,0,4,0,14
62560,5199,2009-08-27,Assembly,"Do pass",13,4,0,0,17
62560,5200,2009-09-04,Assembly,"SB 545 Cedillo  Senate Third Reading  Amend By ENG  Set #1",43,28,8,0,79
62560,5201,2009-09-09,Assembly,"SB 545 Cedillo  Senate Third Reading  By ENG",37,14,28,0,79
62560,5202,2009-09-11,Assembly,"SB 545 Cedillo  Motion to Reconsider  By ENG",58,6,15,0,79
62560,5203,2009-09-11,Assembly,"SB 545 Cedillo  Senate Third Reading  By ENG",57,8,14,0,79
62560,5204,2009-09-11,Senate,"Unfinished Supp 2 SB545 Cedillo Concurrence",34,2,4,0,40
62561,24052,2009-04-27,Senate,"Do pass, but re-refer to the Committee on Appropriations",5,2,0,0,7
62561,24053,2009-05-11,Senate,"Do pass",8,3,0,0,11
62561,24054,2009-05-26,Senate,"Senate 3rd Reading SB546 Lowenthal",23,15,0,0,38
62561,24055,2009-07-06,Assembly,"Do pass as amended and be re-referred to the Committee on 	Appropriations",7,1,0,0,8
62561,24056,2009-08-27,Assembly,"Do pass as amended",12,5,0,0,17
62561,24057,2009-09-11,Senate,"Unfinished Supp 1 SB546 Lowenthal Concurrence",21,15,0,0,36
62561,24058,2009-09-11,Assembly,"SB 546 Lowenthal  Senate Third Reading  By HUFFMAN",51,27,0,0,78
62563,25162,2009-04-14,Senate,"Do pass, but re-refer to the Committee on Appropriations",7,0,0,0,7
62563,25163,2009-04-27,Senate,"Placed on Appropriations Suspense file",13,0,0,0,13
62563,25164,2009-05-28,Senate,"Do pass",12,0,0,0,12
62563,25165,2009-06-03,Senate,"Special Consent #8 SB548 Huff",39,0,0,0,39
62563,25166,2009-07-07,Assembly,"Do pass as amended and be re-referred to the Committee on 	Appropriations",7,0,0,0,7
62563,25167,2009-08-19,Assembly,"Do pass, to Consent Calendar",17,0,0,0,17
62563,25168,2009-08-27,Assembly,"SB 548 Huff  Consent Calendar Second Day  Regular Session",74,0,0,0,74
62563,25169,2009-09-02,Senate,"Special Consent #18 SB548 Huff",39,0,0,0,39
62564,5205,2009-04-20,Senate,"Do pass, but re-refer to the Committee on Appropriations",8,1,1,0,10
62564,5206,2009-04-27,Senate,"Do pass as amended",8,2,3,0,13
62564,5207,2009-05-14,Senate,"Senate 3rd Reading SB549 Correa",23,11,5,0,39
62564,5208,2009-06-16,Assembly,"Do pass and be re-referred to the Committee on Appropriations",7,2,2,0,11
62564,5209,2009-07-01,Assembly,"Do pass",10,5,1,0,16
62564,5210,2009-08-31,Assembly,"SB 549 Correa  Senate Third Reading  By SOLORIO",48,27,4,0,79
62564,5211,2009-09-02,Senate,"Unfinished Business SB549 Correa",21,12,7,0,40
62565,5398,2009-05-11,Senate,"Do pass as amended",8,2,0,0,10
62565,5399,2009-06-03,Senate,"Senate 3rd Reading SB550 Florez",26,11,2,0,39
62565,5400,2009-07-07,Assembly,"Do pass as amended",7,4,0,0,11
62565,5401,2009-08-31,Assembly,"SB 550 Florez  Senate Third Reading  By HAYASHI  Amend By HAYASHI Set #1",46,28,5,0,79
62565,5402,2009-09-02,Assembly,"SB 550 Florez  Senate Third Reading  By HAYASHI",31,35,13,0,79
62565,5403,2010-04-08,Assembly,"SB 550 Florez  Senate Third Reading  Amend By HAYASHI  Set #1",46,25,8,0,79
62565,5404,2010-05-28,Assembly,"Be referred to Committee on Natural Resources",9,0,2,0,11
62565,9758,2010-06-28,Assembly,"Do pass as amended and be re-referred to the Committee on Appropriations",6,2,1,0,9
62565,20068,2010-08-12,Assembly,"Do pass as amended",12,0,0,0,12
62565,21211,2010-08-25,Assembly,"SB 550 Florez  Senate Third Reading  By HILL",76,0,0,0,76
62565,21721,2010-08-30,Senate,"From committee:  That the Assembly Amendments be concurred in",6,0,0,0,6
62565,21722,2010-08-30,Senate,"W/O REF. TO FILE SB550 Florez Concurrence",37,0,0,0,37
62567,5170,2009-04-29,Senate,"Do pass, but re-refer to the Committee on Appropriations",7,1,1,0,9
62567,5171,2009-05-21,Senate,"Senate 3rd Reading SB552 Padilla",26,7,6,0,39
62567,5172,2009-07-08,Assembly,"Do pass as amended and be re-referred to the Committee on Appropriations",9,1,1,0,11
62568,5144,2009-04-28,Senate,"Do pass, but re-refer to the Committee on Appropriations",11,0,1,0,12
62568,5145,2009-05-11,Senate,"Placed on Appropriations Suspense file",13,0,0,0,13
62570,5149,2009-04-21,Senate,"Do pass as amended, and re-refer to the Committee on Appropriations",3,2,0,0,5
62570,5150,2009-06-02,Senate,"Senate 3rd Reading SB555 Kehoe",22,14,3,0,39
62570,5151,2009-06-30,Assembly,"Do pass and be re-referred to the Committee on Appropriations",7,3,0,0,10
62570,5152,2009-08-19,Assembly,"Do pass",12,4,1,0,17
62570,5153,2009-09-08,Assembly,"SB 555 Kehoe  Senate Third Reading  By CHESBRO",50,25,4,0,79
62570,5154,2009-09-10,Senate,"Unfinished Supp 1 SB555 Kehoe Concurrence",27,11,2,0,40
62571,26311,2009-03-31,Senate,"Do pass, but re-refer to the Committee on Appropriations Recommend 	Consent",5,0,0,0,5
62571,26312,2009-04-23,Senate,"Special Consent #1 SB556 Committee on Jud. (Corbett)",37,0,0,0,37
62571,26313,2009-06-23,Assembly,"Do pass as amended and be re-referred to the Committee on 	Appropriations",9,0,0,0,9
62571,26314,2009-07-15,Assembly,"Do pass",16,0,0,0,16
62571,26315,2009-09-03,Assembly,"SB 556 JUD.  Senate Third Reading  By FEUER",70,1,0,0,71
62571,26316,2009-09-08,Senate,"Unfinished Business SB556 Committee on Jud. (Corbett)",40,0,0,0,40
62572,5124,2009-04-28,Senate,"Do pass as amended, and re-refer to the Committee on Appropriations",7,0,0,0,7
62572,5125,2009-05-26,Senate,"Special Consent #6 SB557 Yee",39,0,0,0,39
62572,5126,2009-06-23,Assembly,"Do pass as amended and be re-referred to the Committee on Appropriations",7,0,0,0,7
62572,5127,2009-07-15,Assembly,"Do pass",16,0,0,0,16
62572,5128,2009-09-01,Assembly,"SB 557 Yee  Senate Third Reading  By LIEU",77,1,1,0,79
62572,5129,2009-09-08,Senate,"Unfinished Business SB557 Yee",40,0,0,0,40
62577,5120,2009-04-21,Senate,"Do pass, but re-refer to the Committee on Appropriations Recommend Consent",5,0,0,0,5
62577,5121,2009-05-11,Senate,"Special Consent #3 SB562 Florez",36,0,3,0,39
62579,5122,2009-04-28,Senate,"Do pass as amended, and re-refer to the Committee on Appropriations",6,0,1,0,7
62579,5123,2009-05-26,Senate,"Placed on Appropriations Suspense file",13,0,0,0,13
62580,2801,2009-04-14,Senate,"Do pass, but re-refer to the Committee on Environmental Quality",7,3,1,0,11
62580,2802,2009-04-27,Senate,"Do pass as amended, and re-refer to the Committee on Appropriations",5,2,0,0,7
62580,2803,2009-05-18,Senate,"Placed on Appropriations Suspense file",13,0,0,0,13
62580,2804,2009-05-28,Senate,"Do pass as amended",7,5,1,0,13
62580,2805,2009-06-03,Senate,"Senate 3rd Reading SB565 Pavley",21,13,5,0,39
62580,10123,2010-06-29,Assembly,"Do pass as amended and be re-referred to the Committee on Appropriations",7,6,0,0,13
62580,20115,2010-08-12,Assembly,"Do pass as amended",9,6,0,0,15
62585,4998,2009-04-14,Senate,"Do pass, but re-refer to the Committee on Appropriations",8,0,3,0,11
62586,22708,2009-04-14,Senate,"Do pass, but re-refer to the Committee on Appropriations Recommend 	Consent",10,0,0,0,10
62586,22709,2009-05-06,Senate,"Special Consent #2 SB571 Maldonado",35,0,0,0,35
62586,22710,2009-06-22,Assembly,"Do pass as amended and be re-referred to the Committee on 	Appropriations",9,0,0,0,9
62586,22711,2009-07-08,Assembly,"Do pass, to Consent Calendar",15,0,0,0,15
62586,22712,2009-07-16,Assembly,"SB 571 Maldonado  Consent Calendar Second Day  Regular Session",72,0,0,0,72
62586,22713,2009-08-24,Senate,"Special Consent #15 SB571 Maldonado",39,0,0,0,39
62587,26404,2009-04-14,Senate,"Do pass as amended, and re-refer to the Committee on Education",9,4,0,0,13
62587,26405,2009-05-06,Senate,"Do pass",7,2,0,0,9
62587,26406,2009-05-14,Senate,"Senate 3rd Reading SB572 Leno",24,14,0,0,38
62587,26407,2009-06-17,Assembly,"Do pass as amended",6,3,0,0,9
62587,26408,2009-09-03,Assembly,"SB 572 Leno  Senate Third Reading  By AMMIANO",46,28,0,0,74
62587,26409,2009-09-08,Senate,"Unfinished Business SB572 Leno",23,14,0,0,37
62589,5068,2009-04-15,Senate,"Do pass as amended, and re-refer to the Committee on Public Safety",9,0,0,0,9
62589,5069,2009-05-04,Senate,"Placed on Appropriations Suspense file",11,0,2,0,13
62590,22885,2009-04-28,Senate,"Do pass as amended, and re-refer to the Committee on Appropriations",6,3,0,0,9
62590,22886,2009-06-03,Senate,"Senate 3rd Reading SB575 Steinberg",23,15,0,0,38
62590,22887,2009-07-08,Assembly,"Do pass as amended and be re-referred to the Committee on 	Appropriations",4,2,0,0,6
62590,22888,2009-08-19,Assembly,"Do pass",12,5,0,0,17
62590,22889,2009-09-01,Assembly,"SB 575 Steinberg  Senate Third Reading  By SALAS",51,25,0,0,76
62590,22890,2009-09-08,Senate,"Unfinished Business SB575 Steinberg",27,13,0,0,40
62593,4941,2009-04-28,Senate,"Do pass, but re-refer to the Committee on Appropriations",5,0,0,0,5
62593,4942,2009-05-26,Senate,"Do pass",13,0,0,0,13
62593,4943,2009-06-02,Senate,"Special Consent #7 SB578 Wright",39,0,0,0,39
62593,4944,2009-06-23,Assembly,"Do pass as amended and re-refer to Committee on Appropriations with recommendation:  To Consent Calendar",10,0,0,0,10
62594,4412,2009-08-26,Senate,"Do pass as amended, and re-refer to the Committee on Appropriations",7,0,0,0,7
62594,4413,2009-09-02,Senate,"W/O REF. TO FILE SB579 Lowenthal Urgency Clause",31,0,9,0,40
62594,9227,2010-06-21,Assembly,"Do pass and re-refer to Committee on Appropriations with recommendation:  To Consent Calendar",7,0,2,0,9
62594,19582,2010-08-04,Assembly,"Do pass, to Consent Calendar",17,0,0,0,17
62594,20918,2010-08-23,Assembly,"SB 579 Lowenthal  Senate Third Reading  By HUFFMAN",76,1,0,0,77
62594,21385,2010-08-25,Senate,"From committee:  That the Assembly Amendments be concurred in",5,0,0,0,5
62594,21598,2010-08-27,Senate,"Unfinished Business SB579 Lowenthal",33,2,0,0,35
62595,5059,2010-01-12,Senate,"Do pass as amended, and re-refer to the Committee on Appropriations",5,0,0,0,5
62595,5060,2010-01-25,Senate,"SENATE 3RD READING SB580 WRIGHT",36,0,3,0,39
62595,8873,2010-06-15,Assembly,"Do pass, to Consent Calendar",10,0,0,0,10
62595,9096,2010-06-21,Assembly,"SB 580 Wright  Consent Calendar Second Day",75,0,4,0,79
62595,9660,2010-06-28,Senate,"Special Consent #28 SB580 Wright",32,0,7,0,39
62596,25348,2009-05-05,Senate,"Do pass as amended",7,3,0,0,10
62596,25349,2009-05-26,Senate,"Senate 3rd Reading SB581 Leno",25,14,0,0,39
62596,25350,2009-06-22,Assembly,"Do pass as amended and be re-referred to the Committee on Natural 	Resources",13,0,0,0,13
62596,25351,2009-07-06,Assembly,"Do pass",9,0,0,0,9
62596,25352,2009-09-01,Assembly,"SB 581 Leno  Senate Third Reading  By BERRYHILL, T",74,1,0,0,75
62596,25353,2009-09-08,Senate,"Unfinished Business SB581 Leno",30,9,0,0,39
62597,5039,2009-04-21,Senate,"Do pass, but re-refer to the Committee on Appropriations",2,2,1,0,5
62597,5040,2009-04-21,Senate,"Set, first hearing.  Failed passage in Committee.  Reconsideration granted",5,0,0,0,5
62598,25820,2009-04-28,Senate,"Do pass as amended, and re-refer to the Committee on Appropriations",7,0,0,0,7
62598,25821,2009-06-03,Senate,"Special Consent #8 SB583 Hollingsworth",39,0,0,0,39
62598,25822,2009-06-23,Assembly,"Do pass and re-refer to Committee on Appropriations with 	recommendation:  To Consent Calendar",7,0,0,0,7
62598,25823,2009-07-01,Assembly,"Do pass, to Consent Calendar",15,0,0,0,15
62598,25824,2009-07-09,Assembly,"SB 583 Hollingsworth  Consent Calendar Second Day  Regular Session",74,0,0,0,74
62600,5041,2009-04-14,Senate,"Do pass, but re-refer to the Committee on Appropriations",4,2,1,0,7
62600,5042,2009-04-27,Senate,"Placed on Appropriations Suspense file",13,0,0,0,13
62600,5043,2009-05-28,Senate,"Do pass as amended",7,5,1,0,13
62600,5044,2009-06-03,Senate,"Senate 3rd Reading SB585 Leno",21,18,0,0,39
62600,5045,2009-06-30,Assembly,"Do pass and be re-referred to the Committee on Appropriations",4,3,0,0,7
62600,5046,2009-07-15,Assembly,"Do pass",10,6,0,0,16
62600,5047,2009-09-04,Assembly,"SB 585 Leno  Senate Third Reading  By HILL  Amend By ANDERSON  Set #2",28,41,10,0,79
62600,5048,2009-09-09,Assembly,"SB 585 Leno  Senate Third Reading  By HILL",45,33,1,0,79
62600,5049,2009-09-10,Senate,"Unfinished Supp 1 SB585 Leno Concurrence",21,18,1,0,40
62601,4905,2009-04-14,Senate,"Do pass, but re-refer to the Committee on Environmental Quality",11,1,1,0,13
62601,4906,2009-05-26,Senate,"Do pass",13,0,0,0,13
62601,4907,2009-06-03,Senate,"Senate 3rd Reading SB586 Yee Urgency Clause",35,0,4,0,39
62601,4908,2009-07-07,Assembly,"Do pass and be re-referred to the Committee on Appropriations",11,0,0,0,11
62601,4909,2009-08-19,Assembly,"Do pass as amended",17,0,0,0,17
62601,4910,2009-09-04,Assembly,"SB 586 Yee  Third Reading Urgency  Amend By HILL  Set #1",43,28,8,0,79
62601,9281,2010-06-21,Assembly,"Be referred to Committee on Public Safety",11,0,0,0,11
62601,10078,2010-06-29,Assembly,"Do pass as amended and be re-referred to the Committee on Appropriations",7,0,0,0,7
62603,22832,2009-03-31,Senate,"Do pass, but re-refer to the Committee on Appropriations",7,0,0,0,7
62603,22833,2009-04-20,Senate,"Placed on Appropriations Suspense file",11,0,0,0,11
62603,22834,2009-05-28,Senate,"Do pass",12,0,0,0,12
62603,22835,2009-06-03,Senate,"Special Consent #8 SB588 Committee on Pub. S. (Romero)",39,0,0,0,39
62603,22836,2009-06-30,Assembly,"Do pass and re-refer to Committee on Appropriations with 	recommendation:  To Consent Calendar",7,0,0,0,7
62603,22837,2009-08-27,Assembly,"Do pass",17,0,0,0,17
62603,22838,2009-09-03,Assembly,"SB 588 PUB. S.  Senate Third Reading  By CONWAY",71,0,0,0,71
62604,5023,2009-04-28,Senate,"Do pass, but re-refer to the Committee on Appropriations",11,0,0,0,11
62604,5024,2009-05-18,Senate,"Senate 3rd Reading SB589 Harman",34,0,5,0,39
62604,5025,2009-06-16,Assembly,"Do pass and be re-referred to the Committee on Appropriations",12,0,1,0,13
62604,5026,2009-07-01,Assembly,"Do pass, to Consent Calendar",15,0,1,0,16
62604,5027,2009-07-16,Assembly,"SB 589 Harman  Senate Third Reading  By FULLER",73,0,6,0,79
62604,5028,2009-08-24,Senate,"Unfinished Business SB589 Harman Concurrence",35,1,4,0,40
62607,22447,2009-04-29,Senate,"Do pass as amended, and re-refer to the Committee on Appropriations",9,0,0,0,9
62607,22448,2009-05-26,Senate,"Placed on Appropriations Suspense file",13,0,0,0,13
62607,22449,2009-06-29,Senate,"Do pass",10,0,0,0,10
62607,22450,2009-07-09,Senate,"Special Consent #12 SB592 Romero",34,0,0,0,34
62607,22451,2009-08-19,Assembly,"Do pass and be re-referred to the Committee on Appropriations",10,0,0,0,10
62607,22452,2009-08-27,Assembly,"Do pass, to Consent Calendar",17,0,0,0,17
62607,22453,2009-09-02,Assembly,"SB 592 Romero  Consent Calendar Second Day",76,0,0,0,76
62607,22454,2009-09-08,Senate,"Unfinished Business SB592 Romero",37,0,0,0,37
62610,5001,2009-04-14,Senate,"Do pass as amended, and re-refer to the Committee on Transportation and Housing",5,1,1,0,7
62610,5002,2009-04-28,Senate,"Do pass as amended, and re-refer to the Committee on Appropriations",6,3,2,0,11
62610,5003,2009-05-18,Senate,"Placed on Appropriations Suspense file",13,0,0,0,13
62612,22818,2009-04-14,Senate,"Do pass, but re-refer to the Committee on Judiciary",3,0,0,0,3
62612,22819,2009-04-27,Senate,"Placed on Appropriations Suspense file",13,0,0,0,13
62612,22820,2009-05-28,Senate,"Do pass",8,0,0,0,8
62612,22821,2009-06-01,Senate,"Senate 3rd Reading SB597 Liu",36,1,0,0,37
62612,22822,2009-06-30,Assembly,"Do pass and be re-referred to the Committee on Appropriations",7,0,0,0,7
62612,22823,2009-08-27,Assembly,"Do pass as amended",17,0,0,0,17
62612,22824,2009-09-08,Assembly,"SB 597 Liu  Senate Third Reading  By ADAMS",78,0,0,0,78
62612,22825,2009-09-10,Senate,"Unfinished Business SB597 Liu Concurrence",33,1,0,0,34
62613,23099,2009-04-28,Senate,"Do pass as amended, and re-refer to the Committee on Appropriations",7,0,0,0,7
62613,23100,2009-05-18,Senate,"Placed on Appropriations Suspense file",13,0,0,0,13
62613,23101,2009-05-28,Senate,"Do pass",12,0,0,0,12
62613,23102,2009-06-03,Senate,"Special Consent #8 SB598 Huff",39,0,0,0,39
62613,23103,2009-06-30,Assembly,"Do pass and be re-referred to the Committee on Transportation",7,0,0,0,7
62613,23104,2009-07-06,Assembly,"Do pass and be re-referred to the Committee on Appropriations",12,0,0,0,12
62613,23105,2009-08-27,Assembly,"Do pass as amended",17,0,0,0,17
62613,23106,2009-09-08,Assembly,"SB 598 Huff  Senate Third Reading  By BUCHANAN",78,0,0,0,78
62613,23107,2009-09-10,Senate,"Unfinished Business SB598 Huff",39,0,0,0,39
62614,26711,2009-04-27,Senate,"Do pass as amended, and re-refer to the Committee on 	Appropriations",10,0,0,0,10
62614,26712,2009-05-18,Senate,"Placed on Appropriations Suspense file",13,0,0,0,13
62614,26713,2009-05-28,Senate,"Do pass",12,0,0,0,12
62614,26714,2009-06-03,Senate,"Special Consent #8 SB599 Negrete McLeod",39,0,0,0,39
62614,26715,2009-06-30,Assembly,"Do pass and be re-referred to the Committee on Higher Education",10,0,0,0,10
62614,26716,2009-07-07,Assembly,"Do pass as amended and re-refer to Committee on Appropriations 	with recommendation:  To Consent Calendar",9,0,0,0,9
62614,26717,2009-08-27,Assembly,"Do pass as amended",17,0,0,0,17
62614,26718,2009-09-02,Assembly,"SB 599 Negrete McLeod  Third Reading Urgency  By PORTANTINO  Amend 	By PORTANTINO  Set #1",51,22,0,0,73
62614,26719,2009-09-08,Assembly,"SB 599 Negrete McLeod  Third Reading Urgency  By PORTANTINO",79,0,0,0,79
62614,26720,2009-09-12,Senate,"Unfinished Business SB599 Negrete McLeod Concurrence",26,1,0,0,27
62614,26721,2009-09-12,Senate,"Unfinished Business SB599 Negrete McLeod Reconsider",39,0,0,0,39
62614,26722,2009-10-14,Senate,"Unfinished Business SB599 Negrete McLeod",37,0,0,0,37
62615,4982,2009-06-17,Senate,"Do pass, but re-refer to the Committee on Revenue and Taxation",6,3,2,0,11
62615,4983,2009-08-26,Senate,"Do pass, but re-refer to the Committee on Appropriations",5,3,0,0,8
62615,4984,2009-08-27,Senate,"Placed on Appropriations Suspense file",13,0,0,0,13
62615,4985,2009-08-27,Senate,"Do pass, but re-refer to the Committee on Rules",8,5,0,0,13
62616,4874,2009-04-22,Senate,"Do pass as amended, and re-refer to the Committee on Appropriations",5,3,0,0,8
62616,4875,2009-05-11,Senate,"Placed on Appropriations Suspense file",13,0,0,0,13
62617,4975,2009-04-15,Senate,"Do pass as amended, and re-refer to the Committee on Revenue and Taxation",7,3,1,0,11
62617,4976,2009-04-22,Senate,"Do pass as amended, and re-refer to the Committee on Appropriations",5,3,0,0,8
62617,4977,2009-05-11,Senate,"Placed on Appropriations Suspense file",13,0,0,0,13
62617,4978,2009-05-28,Senate,"Do pass as amended",7,5,1,0,13
62617,4979,2009-06-03,Senate,"Senate 3rd Reading SB602 Padilla",23,13,3,0,39
62617,4980,2009-09-10,Assembly,"Be referred to Committee on Health",10,0,1,0,11
62617,4981,2010-03-23,Assembly,"Do pass as amended and be re-referred to the Committee on Appropriations",17,0,2,0,19
62617,10170,2010-06-30,Assembly,"Do pass",17,0,0,0,17
62617,20450,2010-08-16,Assembly,"SB 602 Padilla  Third Reading Urgency  By CALDERON",74,1,0,0,75
62617,21535,2010-08-27,Senate,"Unfinished Business SB602 Padilla Urgency Clause",30,1,0,0,31
62618,4962,2009-04-22,Senate,"Do pass as amended, and re-refer to the Committee on Appropriations",5,3,0,0,8
62618,4963,2009-05-11,Senate,"Placed on Appropriations Suspense file",13,0,0,0,13
62618,4964,2009-05-28,Senate,"Do pass as amended",7,5,1,0,13
62618,4965,2009-06-03,Senate,"Senate 3rd Reading SB603 Padilla",21,16,2,0,39
62620,22524,2009-04-27,Senate,"Do pass as amended, and re-refer to the Committee on 	Appropriations",7,0,0,0,7
62620,22525,2009-05-26,Senate,"Special Consent #6 SB605 Ashburn",39,0,0,0,39
62620,22526,2009-07-06,Assembly,"Do pass and re-refer to Committee on Appropriations with 	recommendation:  To Consent Calendar",9,0,0,0,9
62620,22527,2009-07-15,Assembly,"Do pass, to Consent Calendar",16,0,0,0,16
62620,22528,2009-08-17,Assembly,"SB 605 Ashburn  Consent Calendar Second Day  Regular Session",76,0,0,0,76
62621,23034,2009-04-13,Senate,"Do pass, but re-refer to the Committee on Appropriations",8,1,0,0,9
62621,23035,2009-04-27,Senate,"Do pass",11,0,0,0,11
62621,23036,2009-05-11,Senate,"Senate 3rd Reading SB606 Ducheny",34,1,0,0,35
62621,23037,2009-07-07,Assembly,"Do pass and be re-referred to the Committee on Appropriations",11,0,0,0,11
62621,23038,2009-08-19,Assembly,"Do pass",16,0,0,0,16
62621,23039,2009-09-02,Assembly,"SB 606 Ducheny  Senate Third Reading  By FLETCHER",71,4,0,0,75
62621,23040,2009-09-11,Senate,"Unfinished Supp 1 SB606 Ducheny",24,1,0,0,25
62622,25317,2009-04-14,Senate,"Do pass as amended, and re-refer to the Committee on Appropriations",10,0,0,0,10
62622,25318,2009-05-11,Senate,"Special Consent #3 SB607 Ducheny",36,0,0,0,36
62622,25319,2009-06-22,Assembly,"Do pass and re-refer to Committee on Appropriations with 	recommendation:  To Consent Calendar",13,0,0,0,13
62622,25320,2009-07-01,Assembly,"Do pass, to Consent Calendar",15,0,0,0,15
62622,25321,2009-07-09,Assembly,"SB 607 Ducheny  Consent Calendar Second Day  Regular Session",74,0,0,0,74
62623,4955,2009-03-31,Senate,"Do pass, but re-refer to the Committee on Appropriations Recommend Consent",11,0,0,0,11
62623,4956,2009-04-23,Senate,"Special Consent #1 SB608 Ducheny",37,0,2,0,39
62623,4957,2009-07-08,Assembly,"Do pass and re-refer to Committee on Appropriations with recommendation:  To Consent Calendar",6,0,0,0,6
62623,4958,2009-08-19,Assembly,"Do pass",17,0,0,0,17
62623,21224,2010-08-25,Assembly,"Do pass",14,1,0,0,15
62623,21727,2010-08-30,Assembly,"SB 608 Alquist  Senate Third Reading  By RUSKIN",72,1,0,0,73
62623,21822,2010-08-31,Senate,"From committee:  That the Assembly Amendments be concurred in",8,0,0,0,8
62623,21823,2010-08-31,Senate,"W/O REF. TO FILE SB608 Alquist Concurrence",31,0,0,0,31
62624,22539,2009-04-28,Senate,"Do pass as amended",7,0,0,0,7
62624,22540,2009-05-14,Senate,"Senate 3rd Reading SB609 Hollingsworth",22,11,0,0,33
62624,22541,2009-06-16,Assembly,"Do pass",9,2,0,0,11
62624,22542,2009-06-18,Assembly,"SB 609 Hollingsworth  Senate Third Reading  By HUFFMAN",45,16,0,0,61
62626,4949,2009-04-14,Senate,"Do pass as amended, and re-refer to the Committee on Education",7,0,0,0,7
62626,4950,2009-04-29,Senate,"Do pass as amended, and re-refer to the Committee on Appropriations",9,0,0,0,9
62626,4951,2009-05-18,Senate,"Placed on Appropriations Suspense file",13,0,0,0,13
62628,4552,2010-01-06,Senate,"Do pass as amended",3,0,2,0,5
62628,4553,2010-01-25,Senate,"SENATE 3RD READING SB613 HARMAN",36,0,3,0,39
62628,4554,2010-04-07,Assembly,"Do pass and be re-referred to the Committee on Appropriations to Consent Calendar",9,0,0,0,9
62628,9809,2010-06-30,Assembly,"Do pass, to Consent Calendar",17,0,0,0,17
62628,20355,2010-08-17,Assembly,"SB 613 Harman  Senate Third Reading  By SOLORIO",77,0,0,0,77
62629,24059,2009-04-20,Senate,"Do pass",7,0,0,0,7
62629,24060,2009-04-23,Senate,"Special Consent #1 SB614 Simitian",37,0,0,0,37
62629,24061,2009-06-16,Assembly,"Do pass and be re-referred to the Committee on Appropriations",7,0,0,0,7
62629,24062,2009-07-01,Assembly,"Do pass, to Consent Calendar",15,0,0,0,15
62629,24063,2009-09-04,Assembly,"SB 614 Simitian  Senate Third Reading  By CHESBRO  Amend By CHESBRO 	Set #1",43,28,0,0,71
62629,24064,2009-09-08,Assembly,"SB 614 Simitian  Senate Third Reading  By CHESBRO",77,0,0,0,77
62629,24065,2009-09-10,Senate,"Unfinished Business SB614 Simitian Concurrence",39,0,0,0,39
62632,4855,2009-05-05,Senate,"Do pass as amended",2,3,0,0,5
62632,4856,2009-05-05,Senate,"Reconsideration granted",3,0,2,0,5
62634,22572,2009-04-28,Senate,"Do pass, but re-refer to the Committee on Judiciary Recommend 	Consent",11,0,0,0,11
62634,22573,2009-05-18,Senate,"Placed on Appropriations Suspense file",13,0,0,0,13
62634,22574,2009-05-28,Senate,"Do pass",12,0,0,0,12
62634,22575,2009-06-03,Senate,"Special Consent #8 SB619 Strickland",39,0,0,0,39
62634,22576,2009-06-30,Assembly,"Do pass and re-refer to Committee on Appropriations with 	recommendation:  To Consent Calendar",11,0,0,0,11
62634,22577,2009-08-27,Assembly,"Do pass",17,0,0,0,17
62634,22578,2009-09-02,Assembly,"SB 619 Strickland  Senate Third Reading  By NAVA",77,0,0,0,77
62635,24012,2009-04-13,Senate,"Do pass, but re-refer to the Committee on Appropriations",8,1,0,0,9
62635,24013,2009-04-23,Senate,"Senate 3rd Reading SB620 Wiggins",32,2,0,0,34
62635,24014,2009-06-16,Assembly,"Do pass as amended and be re-referred to the Committee on 	Appropriations",9,2,0,0,11
62635,24015,2009-07-08,Assembly,"Do pass",10,5,0,0,15
62635,24016,2009-08-31,Assembly,"SB 620 Wiggins  Senate Third Reading  By HAYASHI",53,22,0,0,75
62635,24017,2009-09-02,Senate,"Unfinished Business SB620 Wiggins",31,3,0,0,34
62636,4911,2009-04-29,Senate,"Do pass as amended, and re-refer to the Committee on Appropriations",8,1,0,0,9
62636,4912,2009-05-26,Senate,"Placed on Appropriations Suspense file",13,0,0,0,13
62637,4847,2009-06-10,Senate,"Do pass, but re-refer to the Committee on Appropriations",7,0,1,0,8
62638,5100,2009-04-27,Senate,"Do pass as amended, and re-refer to the Committee on Appropriations",4,1,2,0,7
62638,5101,2009-05-21,Senate,"Senate 3rd Reading SB623 Ashburn",22,5,12,0,39
62638,8139,2010-06-10,Assembly,"Be referred to Committee on Local Government",11,0,0,0,11
62638,10323,2010-06-30,Assembly,"Do pass",5,2,2,0,9
62638,20501,2010-08-16,Assembly,"SB 623 Ashburn  Senate Third Reading  By COTO",61,7,0,0,68
62638,20667,2010-08-20,Senate,"From committee:  That the Assembly Amendments be concurred in",1,3,0,0,4
62639,1252,2009-04-27,Senate,"Do pass, but re-refer to the Committee on Appropriations.",7,0,0,0,7
62639,1253,2009-05-18,Senate,"Special Consent #5 SB624 Romero",36,0,3,0,39
62639,9564,2010-06-21,Assembly,"Do pass as amended",7,0,2,0,9
62640,4898,2009-04-28,Senate,"Do pass as amended, and re-refer to the Committee on Appropriations",7,0,0,0,7
62640,4899,2009-06-02,Senate,"Special Consent #7 SB625 Wright",39,0,0,0,39
62641,26423,2009-04-21,Senate,"Do pass, but re-refer to the Committee on Transportation and 	Housing",11,0,0,0,11
62641,26424,2009-04-28,Senate,"Do pass, but re-refer to the Committee on Appropriations",9,1,0,0,10
62641,26425,2009-05-18,Senate,"Do pass as amended",11,0,0,0,11
62641,26426,2009-06-01,Senate,"Senate 3rd Reading SB626 Kehoe",30,1,0,0,31
62641,26427,2009-06-29,Assembly,"Do pass as amended and be re-referred to the Committee on 	Appropriations",10,2,0,0,12
62641,26428,2009-08-19,Assembly,"Do pass",15,1,0,0,16
62641,26429,2009-09-02,Assembly,"SB 626 Kehoe  Senate Third Reading  By MILLER",58,17,0,0,75
62641,26430,2009-09-08,Senate,"Unfinished Business SB626 Kehoe",33,6,0,0,39
62642,25779,2009-04-27,Senate,"Do pass as amended, and re-refer to the Committee on Appropriations",10,0,0,0,10
62642,25780,2009-05-26,Senate,"Special Consent #6 SB627 Calderon",39,0,0,0,39
62642,25781,2009-06-30,Assembly,"Do pass as amended and be re-referred to the Committee on 	Appropriations",10,0,0,0,10
62642,25782,2009-07-15,Assembly,"Do pass as amended, to Consent Calendar",16,0,0,0,16
62642,25783,2009-08-24,Assembly,"SB 627 Calderon  Consent Calendar Second Day  By ANDERSON",76,0,0,0,76
62642,25784,2009-08-31,Senate,"Special Consent #17 SB627 Calderon",36,0,0,0,36
62643,4895,2009-04-27,Senate,"Do pass, but re-refer to the Committee on Appropriations",2,4,1,0,7
62643,4896,2009-04-27,Senate,"Set, first hearing.  Failed passage in Committee.  Reconsideration granted",5,0,2,0,7
62643,4897,2010-01-11,Senate,"Do pass, but re-refer to the Committee on Appropriations",2,4,0,0,6
62644,4837,2009-04-14,Senate,"Do pass as amended",4,1,0,0,5
62644,4838,2009-06-01,Senate,"Senate 3rd Reading SB629 Liu",31,6,2,0,39
62644,4839,2009-06-30,Assembly,"Do pass",6,3,1,0,10
62644,4840,2009-08-20,Assembly,"SB 629 Liu  Senate Third Reading  By EMMERSON",52,22,5,0,79
62645,25474,2009-04-15,Senate,"Do pass, but re-refer to the Committee on Appropriations",10,0,0,0,10
62645,25475,2009-05-04,Senate,"Placed on Appropriations Suspense file",11,0,0,0,11
62645,25476,2009-05-28,Senate,"Do pass as amended",12,0,0,0,12
62645,25477,2009-06-03,Senate,"Senate 3rd Reading SB630 Steinberg",34,0,0,0,34
62645,25478,2009-06-30,Assembly,"Do pass and be re-referred to the Committee on Appropriations",13,0,0,0,13
62645,25479,2009-08-27,Assembly,"Do pass as amended",12,5,0,0,17
62645,25480,2009-09-09,Assembly,"SB 630 Steinberg  Senate Third Reading  By ADAMS",58,10,0,0,68
62645,25481,2009-09-11,Senate,"Unfinished Business SB630 Steinberg",35,0,0,0,35
62646,4893,2009-04-21,Senate,"Do pass, but re-refer to the Committee on Public Safety",2,3,0,0,5
62646,4894,2009-04-21,Senate,"Set, first hearing.  Failed passage in Committee.  Reconsideration granted",5,0,0,0,5
62647,4806,2009-03-31,Senate,"Do pass, but re-refer to the Committee on Environmental Quality",10,1,0,0,11
62647,4807,2009-04-27,Senate,"Do pass as amended, and re-refer to the Committee on Appropriations",7,0,0,0,7
62647,4808,2009-05-21,Senate,"Senate 3rd Reading SB632 Lowenthal",30,4,5,0,39
62647,4809,2009-06-22,Assembly,"Do pass and be re-referred to the Committee on Appropriations",12,1,1,0,14
62647,4810,2009-07-08,Assembly,"Do pass",11,3,2,0,16
62647,20495,2010-08-18,Assembly,"SB 632 Lowenthal  Senate Third Reading  Amend By LOWENTHAL  Set #1",47,22,0,0,69
62647,21872,2010-08-31,Assembly,"Amend, and re-refer to the Committee on Rules",7,1,0,0,8
62648,25264,2009-04-20,Senate,"Do pass, but re-refer to the Committee on Appropriations",9,0,0,0,9
62648,25265,2009-05-06,Senate,"Do pass and be placed on the Consent Calendar",11,0,0,0,11
62648,25266,2009-05-14,Senate,"Consent Calendar 2nd SB633 Wright",38,0,0,0,38
62648,25267,2009-06-29,Assembly,"Do pass, to Consent Calendar",11,0,0,0,11
62648,25268,2009-07-06,Assembly,"SB 633 Wright  Consent Calendar Second Day  Regular Session",78,0,0,0,78
62649,25593,2009-04-20,Senate,"Do pass, but re-refer to the Committee on Appropriations",7,0,0,0,7
62649,25594,2009-05-11,Senate,"Special Consent #3 SB634 Committee on P.E. & R. (Wiggens)",36,0,0,0,36
62649,25595,2009-07-08,Assembly,"Do pass and re-refer to Committee on Appropriations with 	recommendation:  To Consent Calendar",6,0,0,0,6
62649,25596,2009-08-19,Assembly,"Do pass, to Consent Calendar",17,0,0,0,17
62649,25597,2009-08-27,Assembly,"SB 634 P.E.& R.  Consent Calendar Second Day  Regular Session",74,0,0,0,74
62649,25598,2009-09-02,Senate,"Special Consent #18 SB634 Committee on P.E. & R. (Correa)",39,0,0,0,39
62650,26114,2009-04-29,Senate,"Do pass, but re-refer to the Committee on Judiciary",3,2,0,0,5
62650,26115,2009-05-05,Senate,"Do pass as amended",3,1,0,0,4
62650,26116,2009-05-26,Senate,"Senate 3rd Reading SB635 Wiggins",22,17,0,0,39
62650,26117,2009-06-30,Assembly,"Do pass",7,3,0,0,10
62650,26118,2009-07-13,Assembly,"SB 635 Wiggins  Senate Third Reading  By HAYASHI",50,27,0,0,77
62650,26119,2009-09-08,Senate,"Unfinished Business SB635 Wiggins",23,17,0,0,40
62651,25835,2009-04-29,Senate,"Do pass as amended, and re-refer to the Committee on Rules",5,0,0,0,5
62651,25836,2009-05-14,Senate,"Special Consent #4 SB636 Ashburn",38,0,0,0,38
62651,25837,2009-06-17,Assembly,"Do pass and be re-referred to the Committee on Revenue and Taxation 	to Consent Calendar",7,0,0,0,7
62651,25838,2009-08-20,Assembly,"SB 636 Ashburn  Senate Third Reading  By LOGUE",75,0,0,0,75
62653,4892,2009-04-20,Senate,"Do pass, but re-refer to the Committee on Rules",8,1,1,0,10
62654,4795,2009-04-28,Senate,"Do pass as amended, and re-refer to the Committee on Appropriations",9,1,2,0,12
62654,4796,2009-05-18,Senate,"Placed on Appropriations Suspense file",13,0,0,0,13
62655,22483,2009-05-06,Senate,"Do pass",9,0,0,0,9
62655,22484,2009-05-14,Senate,"Senate 3rd Reading SB640 Hancock",38,0,0,0,38
62655,22485,2009-06-17,Assembly,"Do pass as amended, to Consent Calendar",10,0,0,0,10
62655,22486,2009-06-30,Assembly,"SB 640 Hancock  Consent Calendar Second Day  Regular Session",77,0,0,0,77
62655,22487,2009-07-16,Senate,"Special Consent #13 SB640 Hancock",36,0,0,0,36
62656,4769,2009-05-12,Senate,"Do pass as amended",5,0,0,0,5
62656,4770,2009-05-26,Senate,"Special Consent #6 SB641 Corbett",39,0,0,0,39
62656,4771,2009-06-23,Assembly,"Do pass",10,0,0,0,10
62656,4772,2009-08-31,Assembly,"SB 641 Corbett  Senate Third Reading  By FEUER",75,1,3,0,79
62657,4877,2009-04-28,Senate,"Do pass as amended, and re-refer to the Committee on Appropriations",12,0,0,0,12
62657,4878,2009-05-18,Senate,"Placed on Appropriations Suspense file",13,0,0,0,13
62658,4863,2009-04-14,Senate,"Do pass, but re-refer to the Committee on Governmental Organization",7,0,0,0,7
62658,4864,2009-04-28,Senate,"Do pass, but re-refer to the Committee on Appropriations Recommend Consent",12,0,0,0,12
62658,4865,2009-05-11,Senate,"Placed on Appropriations Suspense file",13,0,0,0,13
62659,23403,2009-04-14,Senate,"Do pass, but re-refer to the Committee on Appropriations",7,0,0,0,7
62659,23404,2009-04-27,Senate,"Do pass, but re-refer to the Committee on Appropriations",7,0,0,0,7
62659,23405,2009-05-18,Senate,"Special Consent #5 SB644 Denham",36,0,0,0,36
62659,23406,2009-06-30,Assembly,"Do pass and be re-referred to the Committee on Public Employees, 	Retirement and Social Security",9,0,0,0,9
62659,23407,2009-07-08,Assembly,"Do pass and re-refer to Committee on Appropriations with 	recommendation:  To Consent Calendar",6,0,0,0,6
62659,23408,2009-08-19,Assembly,"Do pass, to Consent Calendar",17,0,0,0,17
62659,23409,2009-08-27,Assembly,"SB 644 Denham  Consent Calendar Second Day  Regular Session",74,0,0,0,74
62660,4749,2009-04-22,Senate,"Do pass as amended. To Consent Calendar",7,0,2,0,9
62660,4750,2009-05-06,Senate,"Consent Calendar 2nd SB645 Denham",35,0,4,0,39
62660,4751,2009-06-23,Assembly,"Do pass, to Consent Calendar",9,0,0,0,9
62660,4752,2009-06-30,Assembly,"SB 645 Denham  Consent Calendar Second Day  Regular Session",77,0,2,0,79
62661,4866,2009-04-14,Senate,"Do pass, but re-refer to the Committee on Education",7,0,0,0,7
62661,4867,2009-04-29,Senate,"Do pass as amended, and re-refer to the Committee on Appropriations",7,0,2,0,9
62661,4868,2009-05-18,Senate,"Placed on Appropriations Suspense file",13,0,0,0,13
62662,4753,2009-04-14,Senate,"Do pass, but re-refer to the Committee on Appropriations",7,0,0,0,7
62664,23179,2009-04-28,Senate,"Do pass as amended, and re-refer to the Committee on Appropriations",10,0,0,0,10
62664,23180,2009-05-26,Senate,"Special Consent #6 SB649 Ashburn",39,0,0,0,39
62664,23181,2009-06-22,Assembly,"Do pass and re-refer to Committee on Appropriations with 	recommendation:  To Consent Calendar",13,0,0,0,13
62664,23182,2009-07-01,Assembly,"Do pass, to Consent Calendar",15,0,0,0,15
62664,23183,2009-07-09,Assembly,"SB 649 Ashburn  Consent Calendar Second Day  Regular Session",74,0,0,0,74
62665,4857,2010-01-12,Senate,"Do pass as amended",3,2,0,0,5
62665,4858,2010-01-28,Senate,"SENATE 3RD READING SB650 YEE",23,15,1,0,39
62665,8836,2010-06-15,Assembly,"Do pass",7,3,0,0,10
62665,9521,2010-06-24,Assembly,"SB 650 Yee  Senate Third Reading  By YAMADA",49,26,4,0,79
62665,9637,2010-06-28,Senate,"Unfinished Business SB650 Yee",21,14,4,0,39
62666,26303,2009-04-29,Senate,"Do pass as amended, and re-refer to the Committee on Appropriations",9,0,0,0,9
62666,26304,2009-05-18,Senate,"Placed on Appropriations Suspense file",13,0,0,0,13
62666,26305,2009-05-28,Senate,"Do pass as amended",12,0,0,0,12
62666,26306,2009-06-03,Senate,"Senate 3rd Reading SB651 Romero",37,1,0,0,38
62666,26307,2009-07-08,Assembly,"Do pass as amended and be re-referred to the Committee on 	Appropriations",10,0,0,0,10
62666,26308,2009-08-27,Assembly,"Do pass",17,0,0,0,17
62666,26309,2009-09-03,Assembly,"SB 651 Romero  Senate Third Reading  By HUBER",76,0,0,0,76
62666,26310,2009-09-08,Senate,"Unfinished Business SB651 Romero",38,1,0,0,39
62667,4729,2009-05-06,Senate,"Do pass",4,0,1,0,5
62668,4844,2009-04-28,Senate,"Do pass as amended, and re-refer to the Committee on Appropriations",5,0,0,0,5
62668,4845,2009-05-26,Senate,"Do pass as amended",13,0,0,0,13
62668,4846,2009-06-02,Senate,"Special Consent #7 SB653 Correa",39,0,0,0,39
62668,8954,2010-06-17,Assembly,"Be referred to Committee on Public Employees, Retirement and Social Security",9,0,2,0,11
62669,5424,2009-04-14,Senate,"Do pass, but re-refer to the Committee on Appropriations",4,1,0,0,5
62669,5425,2009-04-27,Senate,"Placed on Appropriations Suspense file",13,0,0,0,13
62669,5426,2010-01-21,Senate,"Do pass",6,3,2,0,11
62669,5427,2010-01-28,Senate,"SENATE 3RD READING SB654 LENO",23,12,4,0,39
62669,5428,2010-05-11,Assembly,"Do pass and be re-referred to the Committee on Appropriations",6,0,0,0,6
62669,20120,2010-08-12,Assembly,"Do pass",17,0,0,0,17
62669,21272,2010-08-23,Assembly,"SB 654 Leno  Senate Third Reading  By PORTANTINO",76,0,0,0,76
62670,4848,2009-04-21,Senate,"Do pass as amended, and re-refer to the Committee on Appropriations",9,2,0,0,11
62670,4849,2009-06-03,Senate,"Senate 3rd Reading SB655 Padilla",25,11,3,0,39
62670,4850,2009-07-06,Assembly,"Do pass and be re-referred to the Committee on Appropriations",15,0,0,0,15
62670,4851,2009-08-19,Assembly,"Do pass, to Consent Calendar",17,0,0,0,17
62671,4822,2009-04-27,Senate,"Do pass, but re-refer to the Committee on Appropriations",5,2,0,0,7
62671,4823,2009-05-11,Senate,"Do pass",11,0,2,0,13
62671,4824,2009-05-26,Senate,"Senate 3rd Reading SB656 DeSaulnier",30,8,1,0,39
62671,4825,2009-07-08,Assembly,"Do pass and be re-referred to the Committee on Appropriations",6,0,0,0,6
62671,4826,2009-08-19,Assembly,"Do pass, to Consent Calendar",17,0,0,0,17
62671,4827,2009-09-02,Assembly,"SB 656 DeSaulnier  Senate Third Reading  By HERNANDEZ",76,0,3,0,79
62671,4828,2009-09-08,Senate,"Unfinished Business SB656 DeSaulnier",33,7,0,0,40
62672,4711,2009-04-21,Senate,"Do pass, but re-refer to the Committee on Appropriations",3,2,0,0,5
62672,4712,2009-05-04,Senate,"Placed on Appropriations Suspense file",11,0,2,0,13
62672,4713,2010-01-28,Senate,"SENATE 3RD READING SB657 STEINBERG",24,13,2,0,39
62672,9683,2010-06-29,Assembly,"Do pass as amended",7,2,1,0,10
62672,21503,2010-08-26,Assembly,"SB 657 Steinberg  Senate Third Reading  By FEUER",44,24,0,0,68
62672,21661,2010-08-30,Senate,"Unfinished Business SB657 Steinberg",22,14,0,0,36
62675,4829,2009-05-06,Senate,"Do pass, but re-refer to the Committee on Judiciary",8,3,1,0,12
62675,4830,2009-05-12,Senate,"Do pass as amended",3,2,0,0,5
62675,4831,2009-06-01,Senate,"Senate 3rd Reading SB660 Wolk",23,15,1,0,39
62675,4832,2009-07-06,Assembly,"Do pass as amended and be re-referred to the Committee on Judiciary",6,3,2,0,11
62675,4833,2009-07-09,Assembly,"Do pass as amended",7,3,0,0,10
62675,4834,2009-09-09,Assembly,"SB 660 Wolk  Senate Third Reading  By NAVA",49,29,1,0,79
62675,9368,2010-06-24,Assembly,"SB 660 Wolk  Senate Third Reading  By FEUER  Amend By FEUER  Set #1",48,25,6,0,79
62675,9610,2010-06-28,Assembly,"Be referred to Committee on Banking and Finance",11,0,0,0,11
62675,10093,2010-07-01,Assembly,"Do pass",1,5,6,0,12
62677,4346,2009-04-28,Senate,"Do pass, but re-refer to the Committee on Appropriations",11,0,1,0,12
62677,4347,2009-05-11,Senate,"Do pass as amended",12,0,1,0,13
62677,4348,2009-05-18,Senate,"Senate 3rd Reading SB662 Yee",34,0,5,0,39
62677,4349,2009-07-08,Assembly,"Do pass and be re-referred to the Committee on Appropriations",17,0,2,0,19
62677,4350,2010-05-13,Assembly,"Be referred to Committee on Judiciary",9,0,2,0,11
62677,8730,2010-06-15,Assembly,"Do pass as amended",7,3,0,0,10
62677,9603,2010-06-28,Assembly,"SB 662 Yee  Senate Third Reading  By SALAS",49,27,3,0,79
62677,19866,2010-08-09,Senate,"From committee:  That the Assembly Amendments be concurred in",3,1,0,0,4
62677,21575,2010-08-26,Senate,"Unfinished Business SB662 Yee",21,14,0,0,35
62683,22667,2009-04-28,Senate,"Do pass as amended, and re-refer to the Committee on Appropriations",7,0,0,0,7
62683,22668,2009-05-18,Senate,"Senate 3rd Reading SB668 Hollingsworth",36,0,0,0,36
62683,22669,2009-06-30,Assembly,"Do pass, to Consent Calendar",7,0,0,0,7
62683,22670,2009-07-09,Assembly,"SB 668 Hollingsworth  Consent Calendar Second Day  Regular Session",74,0,0,0,74
62684,25327,2009-04-28,Senate,"Do pass as amended",7,0,0,0,7
62684,25328,2009-05-14,Senate,"Senate 3rd Reading SB669 Hollingsworth",38,0,0,0,38
62684,25329,2009-06-30,Assembly,"Do pass",7,0,0,0,7
62684,25330,2009-07-13,Assembly,"SB 669 Hollingsworth  Senate Third Reading  By ARAMBULA",77,0,0,0,77
62685,26200,2009-04-28,Senate,"Do pass, but re-refer to the Committee on Appropriations",8,3,0,0,11
62685,26201,2009-05-26,Senate,"Senate 3rd Reading SB670 Wiggins Urgency Clause",31,8,0,0,39
62685,26202,2009-06-16,Assembly,"Do pass and be re-referred to the Committee on Appropriations",11,0,0,0,11
62685,26203,2009-07-01,Assembly,"Do pass",12,0,0,0,12
62685,26204,2009-07-09,Assembly,"SB 670 Wiggins  Third Reading Urgency  By HUFFMAN",63,11,0,0,74
62685,26205,2009-07-13,Senate,"Unfinished Business SB670 Wiggins Concurrence",28,7,0,0,35
62686,25064,2009-04-15,Senate,"Do pass as amended, and re-refer to the Committee on 	Appropriations",5,0,0,0,5
62686,25065,2009-05-14,Senate,"Special Consent #4 SB671 Runner",38,0,0,0,38
62686,25066,2009-06-17,Assembly,"Do pass and be re-referred to the Committee on Natural Resources to 	Consent Calendar",7,0,0,0,7
62686,25067,2009-07-06,Assembly,"Do pass and re-refer to Committee on Appropriations with 	recommendation:  To Consent Calendar",9,0,0,0,9
62686,25068,2009-07-15,Assembly,"Do pass, to Consent Calendar",16,0,0,0,16
62686,25069,2009-08-17,Assembly,"SB 671 Runner  Consent Calendar Second Day  Regular Session",76,0,0,0,76
62688,22714,2009-05-06,Senate,"Do pass as amended",4,0,0,0,4
62688,22715,2009-05-14,Senate,"Special Consent #4 SB673 Cox",38,0,0,0,38
62688,22716,2009-06-17,Assembly,"Do pass, to Consent Calendar",7,0,0,0,7
62688,22717,2009-06-24,Assembly,"SB 673 Cox  Consent Calendar Second Day  Regular Session",72,0,0,0,72
62689,4642,2009-04-20,Senate,"Do pass, but re-refer to the Committee on Appropriations",8,0,2,0,10
62689,4643,2009-05-04,Senate,"Placed on Appropriations Suspense file",11,0,2,0,13
62689,4644,2009-05-28,Senate,"Do pass as amended",12,0,1,0,13
62689,4645,2009-06-03,Senate,"Senate 3rd Reading SB674 Negrete McLeod",31,2,6,0,39
62689,4646,2009-06-30,Assembly,"Do pass and be re-referred to the Committee on Health",10,0,0,0,10
62689,4647,2009-07-07,Assembly,"Do pass and be re-referred to the Committee on Appropriations",18,0,1,0,19
62689,4648,2009-08-19,Assembly,"Do pass",17,0,0,0,17
62689,4649,2009-09-02,Assembly,"SB 674 Negrete McLeod  Senate Third Reading  By DE LA TORRE",78,0,1,0,79
62689,4650,2009-09-08,Senate,"Unfinished Business SB674 Negrete McLeod",38,1,1,0,40
62690,4744,2009-04-01,Senate,"Do pass as amended, and re-refer to the Committee on Rules",7,0,2,0,9
62690,4745,2009-04-27,Senate,"Do pass, but re-refer to the Committee on Appropriations",8,1,1,0,10
62690,4746,2009-05-11,Senate,"Placed on Appropriations Suspense file",13,0,0,0,13
62690,4747,2010-01-21,Senate,"Do pass",6,3,2,0,11
62690,4748,2010-01-28,Senate,"SENATE 3RD READING SB675 STEINBERG",26,9,4,0,39
62690,8943,2010-06-16,Assembly,"Do pass and be re-referred to the Committee on Natural Resources",7,1,1,0,9
62690,9755,2010-06-28,Assembly,"Do pass and be re-referred to the Committee on Appropriations",6,3,0,0,9
62690,20186,2010-08-12,Assembly,"Do pass as amended",12,5,0,0,17
62690,21552,2010-08-27,Assembly,"Do pass as amended",6,1,0,0,7
62690,21867,2010-08-31,Assembly,"SB 675 Steinberg  Senate Third Reading  By HAYASHI",51,25,0,0,76
62690,21868,2010-08-31,Senate,"W/O REF. TO FILE SB675 Steinberg Concurrence",21,14,0,0,35
62691,26259,2009-04-21,Senate,"Do pass, but re-refer to the Committee on Rules",5,2,0,0,7
62691,26260,2009-05-06,Senate,"Do pass as amended",3,1,0,0,4
62691,26261,2009-06-01,Senate,"Senate 3rd Reading SB676 Wolk",22,15,0,0,37
62691,26262,2009-07-01,Assembly,"Do pass and be re-referred to the Committee on Public Safety",5,2,0,0,7
62691,26263,2009-07-07,Assembly,"Do pass as amended",5,0,0,0,5
62691,26264,2009-09-08,Assembly,"SB 676 Wolk  Senate Third Reading  By HALL",49,29,0,0,78
62691,26265,2009-09-10,Senate,"Unfinished Business SB676 Wolk Concurrence",21,16,0,0,37
62692,4754,2009-04-29,Senate,"Do pass, but re-refer to the Committee on Appropriations",4,2,0,0,6
62692,4755,2009-05-26,Senate,"Placed on Appropriations Suspense file",13,0,0,0,13
62692,4756,2010-01-12,Senate,"Do pass, but re-refer to the Committee on Appropriations",7,0,0,0,7
62692,4757,2010-01-25,Senate,"SENATE 3RD READING SB677 YEE",36,0,3,0,39
62692,8858,2010-06-15,Assembly,"Do pass and be re-referred to the Committee on Appropriations",7,0,0,0,7
62692,9829,2010-06-30,Assembly,"Do pass, to Consent Calendar",17,0,0,0,17
62692,19607,2010-08-09,Assembly,"SB 677 Yee  Senate Third Reading  By STRICKLAND",77,0,0,0,77
62692,19817,2010-08-11,Senate,"Unfinished Business SB677 Yee",29,0,0,0,29
62693,23321,2009-04-28,Senate,"Do pass, but re-refer to the Committee on Appropriations",7,0,0,0,7
62693,23322,2009-05-11,Senate,"Do pass",9,0,0,0,9
62693,23323,2009-05-18,Senate,"Senate 3rd Reading SB678 Leno",33,0,0,0,33
62693,23324,2009-06-16,Assembly,"Do pass as amended and be re-referred to the Committee on 	Appropriations",7,0,0,0,7
62693,23325,2009-08-27,Assembly,"Do pass as amended",16,0,0,0,16
62693,23326,2009-09-11,Assembly,"SB 678 Leno  Third Reading Urgency  By HAGMAN",79,0,0,0,79
62693,23327,2009-09-12,Assembly,"SB 678 Leno  Senate Third Reading  By HAGMAN",77,0,0,0,77
62693,23328,2009-09-12,Senate,"W/O REF. TO FILE SB678 Leno Concurrence",38,0,0,0,38
62694,4651,2009-04-28,Senate,"Do pass as amended, and re-refer to the Committee on Appropriations",7,4,0,0,11
62694,4652,2009-06-01,Senate,"Senate 3rd Reading SB679 Wolk",22,15,2,0,39
62694,4653,2009-06-30,Assembly,"Do pass as amended and be re-referred to the Committee on Appropriations",8,3,2,0,13
62694,4654,2009-08-27,Assembly,"Do pass as amended",12,5,0,0,17
62694,4655,2009-09-03,Assembly,"SB 679 Wolk  Senate Third Reading  By CABALLERO",39,31,9,0,79
62694,4656,2009-09-08,Assembly,"SB 679 Wolk  Motion to Reconsider  By CABALLERO",44,29,6,0,79
62694,4657,2009-09-08,Assembly,"SB 679 Wolk  Senate Third Reading  By CABALLERO",43,32,4,0,79
62694,4658,2009-09-10,Senate,"Unfinished Business SB679 Wolk Concurrence",24,15,1,0,40
62695,23566,2009-04-15,Senate,"Do pass",9,0,0,0,9
62695,23567,2009-04-20,Senate,"Senate 3rd Reading SB680 Romero Urgency Clause",37,0,0,0,37
62695,23568,2009-06-17,Assembly,"Do pass as amended and be re-referred to the Committee on 	Appropriations",6,1,0,0,7
62695,23569,2009-06-30,Assembly,"Do pass",5,11,0,0,16
62695,23570,2009-06-30,Assembly,"Set first hearing.  Failed passage.  Reconsideration granted",16,0,0,0,16
62695,23571,2009-07-15,Assembly,"Do pass as amended",9,3,0,0,12
62695,23572,2009-09-03,Assembly,"SB 680 Romero  Senate Third Reading  By TORRICO",46,15,0,0,61
62695,23573,2009-09-08,Senate,"Unfinished Business SB680 Romero",38,0,0,0,38
62696,4724,2009-04-28,Senate,"Do pass, but re-refer to the Committee on Appropriations",6,4,1,0,11
62696,4725,2009-05-11,Senate,"Placed on Appropriations Suspense file",13,0,0,0,13
62696,4726,2009-05-28,Senate,"Do pass as amended",7,5,1,0,13
62696,4727,2009-06-03,Senate,"Senate 3rd Reading SB681 Pavley Reconsider",39,0,0,0,39
62696,8852,2009-06-03,Senate,"Senate 3rd Reading SB681 Pavley",19,19,1,0,39
62697,276,2009-04-22,Senate,"Do pass as amended.",9,0,0,0,9
62697,277,2009-05-06,Senate,"Special Consent #2 SB682 Padilla",35,0,4,0,39
62697,278,2009-06-17,Assembly,"Do pass as amended and be re-referred to the Committee on Appropriations.",10,0,1,0,11
62698,4610,2009-04-01,Senate,"Do pass, but re-refer to the Committee on Appropriations",9,0,1,0,10
62698,4611,2009-05-21,Senate,"Senate 3rd Reading SB683 Calderon",33,0,6,0,39
62699,4730,2009-04-01,Senate,"Do pass, but re-refer to the Committee on Appropriations",5,0,0,0,5
62699,4731,2009-04-20,Senate,"Placed on Appropriations Suspense file",11,0,2,0,13
62699,4732,2009-05-28,Senate,"Do pass",12,0,1,0,13
62699,4733,2009-06-03,Senate,"Special Consent #8 SB684 Cogdill",39,0,0,0,39
62699,4734,2009-07-08,Assembly,"Do pass and be re-referred to the Committee on Appropriations",7,0,0,0,7
62700,4708,2009-04-28,Senate,"Do pass as amended, and re-refer to the Committee on Appropriations",5,5,2,0,12
62700,4709,2009-04-28,Senate,"Set, first hearing.  Failed passage in Committee.  Reconsideration granted",10,0,2,0,12
62701,4599,2009-04-20,Senate,"Do pass and be placed on the Consent Calendar",7,0,0,0,7
62701,4600,2009-04-27,Senate,"Senate 3rd Reading SB686 DeSaulnier",36,0,3,0,39
62702,4693,2009-04-29,Senate,"Do pass as amended, and re-refer to the Committee on Appropriations",9,0,2,0,11
62702,4694,2009-05-18,Senate,"Placed on Appropriations Suspense file",13,0,0,0,13
62703,4595,2009-04-29,Senate,"Do pass, but re-refer to the Committee on Appropriations",8,0,1,0,9
62703,4596,2009-05-11,Senate,"Placed on Appropriations Suspense file",13,0,0,0,13
62704,4714,2009-04-28,Senate,"Do pass, but re-refer to the Committee on Appropriations",2,4,1,0,7
62704,4715,2009-04-28,Senate,"Set, first hearing.  Failed passage in Committee.  Reconsideration granted",6,0,1,0,7
62705,4710,2009-04-21,Senate,"Do pass, but re-refer to the Committee on Judiciary",6,4,1,0,11
62706,4569,2009-04-27,Senate,"Do pass, but re-refer to the Committee on Appropriations",7,0,3,0,10
62706,4570,2009-05-18,Senate,"Placed on Appropriations Suspense file",13,0,0,0,13
62706,4571,2009-05-28,Senate,"Do pass as amended",12,0,1,0,13
62706,4572,2009-06-03,Senate,"W/O REF. TO FILE SB691 Yee",37,0,2,0,39
62706,4573,2009-07-07,Assembly,"Do pass and be re-referred to the Committee on Appropriations",11,0,0,0,11
62706,4574,2009-07-15,Assembly,"Do pass, to Consent Calendar",16,0,0,0,16
62706,21895,2010-08-31,Assembly,"Do pass",4,5,0,0,9
62708,22723,2009-04-14,Senate,"Do pass",13,0,0,0,13
62708,22724,2009-04-16,Senate,"Senate 3rd Reading SB693 Harman",34,0,0,0,34
62708,22725,2009-07-01,Assembly,"Do pass, to Consent Calendar",17,0,0,0,17
62708,22726,2009-07-09,Assembly,"SB 693 Harman  Consent Calendar Second Day  Regular Session",74,0,0,0,74
62709,4123,2010-01-06,Senate,"Do pass as amended, and re-refer to the Committee on Appropriations",3,0,2,0,5
62709,4124,2010-01-25,Senate,"SENATE 3RD READING SB694 CORREA",36,0,3,0,39
62709,9020,2010-06-16,Assembly,"Do pass and be re-referred to the Committee on Business, Professions and Consumer Protection",9,0,0,0,9
62709,9143,2010-06-22,Assembly,"Do pass",11,0,0,0,11
62709,20384,2010-08-16,Assembly,"SB 694 Correa  Senate Third Reading  By BERRYHILL, B",74,0,0,0,74
62709,20539,2010-08-19,Senate,"Unfinished Business SB694 Correa",35,0,0,0,35
62710,25045,2009-04-21,Senate,"Do pass as amended, and re-refer to the Committee on Appropriations",11,0,0,0,11
62710,25046,2009-05-18,Senate,"Placed on Appropriations Suspense file",13,0,0,0,13
62710,25047,2009-05-28,Senate,"Do pass as amended",11,0,0,0,11
62710,25048,2009-06-01,Senate,"Senate 3rd Reading SB695 Kehoe Urgency Clause",37,0,0,0,37
62710,25049,2009-06-29,Assembly,"Do pass and be re-referred to the Committee on Appropriations",14,0,0,0,14
62710,25050,2009-08-19,Assembly,"Do pass",16,0,0,0,16
62710,25051,2009-09-01,Assembly,"SB 695 Kehoe  Third Reading Urgency  By FUENTES",76,1,0,0,77
62710,25052,2009-09-08,Senate,"Unfinished Business SB695 Kehoe",39,0,0,0,39
62711,4695,2009-06-16,Senate,"Do pass as amended, and re-refer to the Committee on Environmental Quality",6,3,2,0,11
62711,4696,2009-08-26,Senate,"Do pass as amended, and re-refer to the Committee on Appropriations",7,0,0,0,7
62711,4697,2009-09-02,Senate,"W/O REF. TO FILE SB696 Wright Urgency Clause",31,2,7,0,40
62713,4536,2009-04-29,Senate,"Do pass, but re-refer to the Committee on Appropriations",8,1,0,0,9
62713,4537,2009-05-11,Senate,"Placed on Appropriations Suspense file",13,0,0,0,13
62715,4507,2009-04-20,Senate,"Do pass as amended, and re-refer to the Committee on Appropriations",7,2,1,0,10
62715,4508,2009-05-14,Senate,"Senate 3rd Reading SB700 Negrete McLeod Reconsider",38,0,1,0,39
62715,4509,2009-06-03,Senate,"Senate 3rd Reading SB700 Negrete McLeod Reconsider",39,0,0,0,39
62715,4510,2010-01-28,Senate,"SENATE 3RD READING SB700 NEGRETE MCLEOD",35,0,4,0,39
62715,4511,2010-03-23,Assembly,"Do pass and be re-referred to the Committee on Appropriations",11,0,0,0,11
62715,8818,2009-05-14,Senate,"Senate 3rd Reading SB700 Negrete McLeod",19,15,5,0,39
62715,8819,2009-06-03,Senate,"Senate 3rd Reading SB700 Negrete McLeod",17,16,6,0,39
62715,19363,2010-08-04,Assembly,"Do pass, to Consent Calendar",17,0,0,0,17
62715,20854,2010-08-23,Assembly,"SB 700 Negrete McLeod  Senate Third Reading  By RUSKIN",76,0,0,0,76
62715,21106,2010-08-25,Senate,"Unfinished Business SB700 Negrete McLeod",35,0,0,0,35
62716,4683,2009-04-29,Senate,"Do pass as amended, and re-refer to the Committee on Appropriations",5,2,2,0,9
62716,4684,2009-05-18,Senate,"Placed on Appropriations Suspense file",13,0,0,0,13
62717,22826,2009-04-28,Senate,"Do pass as amended, and re-refer to the Committee on Appropriations",5,0,0,0,5
62717,22827,2009-05-21,Senate,"Senate 3rd Reading SB702 DeSaulnier",29,4,0,0,33
62717,22828,2009-06-30,Assembly,"Do pass and be re-referred to the Committee on Appropriations",7,0,0,0,7
62717,22829,2009-08-27,Assembly,"Do pass as amended",14,3,0,0,17
62717,22830,2009-09-09,Assembly,"SB 702 DeSaulnier  Senate Third Reading  By FUENTES",61,16,0,0,77
62717,22831,2009-09-10,Senate,"Unfinished Supp 1 SB702 DeSaulnier",23,5,0,0,28
62719,4484,2009-04-27,Senate,"Placed on Appropriations Suspense file",13,0,0,0,13
62720,4629,2009-04-28,Senate,"Do pass, but re-refer to the Committee on Appropriations",3,2,0,0,5
62720,4630,2009-05-26,Senate,"Placed on Appropriations Suspense file",13,0,0,0,13
62722,4660,2009-04-29,Senate,"Do pass, but re-refer to the Committee on Appropriations",7,2,2,0,11
62722,4661,2009-05-11,Senate,"Placed on Appropriations Suspense file",13,0,0,0,13
62727,4614,2009-04-27,Senate,"Do pass as amended, and re-refer to the Committee on Rules",10,0,1,0,11
62727,4615,2009-05-18,Senate,"Placed on Appropriations Suspense file",13,0,0,0,13
62730,4597,2009-05-06,Senate,"Do pass",4,0,1,0,5
62730,4598,2009-06-03,Senate,"Senate 3rd Reading SB715 Wolk",34,3,2,0,39
62731,26206,2009-05-12,Senate,"Do pass as amended",6,3,0,0,9
62731,26207,2009-05-26,Senate,"Senate 3rd Reading SB716 Wolk",24,14,0,0,38
62731,26208,2009-07-06,Assembly,"Do pass as amended",8,5,0,0,13
62731,26209,2009-08-31,Assembly,"SB 716 Wolk  Senate Third Reading  By NAVA  Amend By NAVA  Set #1",47,28,0,0,75
62731,26210,2009-09-08,Assembly,"SB 716 Wolk  Senate Third Reading  By NAVA",48,29,0,0,77
62731,26211,2009-09-10,Senate,"Unfinished Business SB716 Wolk Concurrence",22,13,0,0,35
62732,23618,2009-04-14,Senate,"Do pass as amended, and re-refer to the Committee on Appropriations",10,0,0,0,10
62732,23619,2009-05-26,Senate,"Special Consent #6 SB717 Runner",39,0,0,0,39
62732,23620,2009-06-16,Assembly,"Amend, and do pass as amended and be re-referred to the Committee 	on Public Safety with the recommendation:  To Consent Calendar",12,0,0,0,12
62732,23621,2009-06-30,Assembly,"Do pass as amended and re-refer to Committee on Appropriations 	with recommendation:  To Consent Calendar",7,0,0,0,7
62732,23622,2009-08-19,Assembly,"Do pass, to Consent Calendar",17,0,0,0,17
62732,23623,2009-08-27,Assembly,"SB 717 Runner  Consent Calendar Second Day  Regular Session",74,0,0,0,74
62732,23624,2009-09-02,Senate,"Special Consent #18 SB717 Runner",39,0,0,0,39
62733,4410,2009-04-14,Senate,"Do pass, but re-refer to the Committee on Appropriations",3,1,1,0,5
62733,4411,2009-04-27,Senate,"Placed on Appropriations Suspense file",13,0,0,0,13
62734,4567,2009-04-14,Senate,"Do pass, but re-refer to the Committee on Rules",11,0,2,0,13
62734,4568,2009-04-27,Senate,"Placed on Appropriations Suspense file",13,0,0,0,13
62736,4376,2009-04-20,Senate,"Do pass as amended, and re-refer to the Committee on Appropriations",5,2,0,0,7
62736,4377,2009-05-04,Senate,"Placed on Appropriations Suspense file",11,0,2,0,13
62737,4575,2009-04-20,Senate,"Do pass as amended, and re-refer to the Committee on Judiciary",6,1,0,0,7
62737,4576,2009-05-05,Senate,"Do pass",3,0,2,0,5
62737,4577,2009-05-14,Senate,"Senate 3rd Reading SB722 Steinberg",21,15,3,0,39
62737,4578,2009-06-22,Assembly,"Do pass as amended and be re-referred to the Committee on Judiciary",5,3,1,0,9
62737,4579,2009-06-30,Assembly,"Do pass",7,3,0,0,10
62737,4580,2010-03-04,Assembly,"SB 722 Steinberg  Senate Third Reading  By SKINNER  Amend By SKINNER  Set #1",44,26,9,0,79
62737,9244,2010-06-17,Assembly,"Be referred to Committee on Utilities and Commerce",9,0,2,0,11
62737,9437,2010-06-24,Assembly,"Do pass and be re-referred to the Committee on Natural Resources",9,2,4,0,15
62737,9784,2010-06-30,Assembly,"Do pass as amended and be re-referred to the Committee on Appropriations",5,3,1,0,9
62737,19930,2010-08-12,Assembly,"Do pass as amended",12,5,0,0,17
62737,21833,2010-08-31,Assembly,"Amend, and re-refer to the Committee on Rules",7,2,0,0,9
62737,21834,2010-08-31,Assembly,"SB 722 Simitian  Senate Third Reading  By SKINNER  Motion to  Move 	Previous Question  By CALDERON",47,26,0,0,73
62737,21835,2010-08-31,Assembly,"SB 722 Simitian  Senate Third Reading  By SKINNER",46,26,0,0,72
62738,4368,2009-05-04,Senate,"Do pass, but re-refer to the Committee on Appropriations",5,2,0,0,7
62738,4369,2009-05-18,Senate,"Placed on Appropriations Suspense file",13,0,0,0,13
62738,4370,2009-05-28,Senate,"Do pass",7,5,1,0,13
62738,4371,2009-06-01,Senate,"Senate 3rd Reading SB723 DeSaulnier",22,17,0,0,39
62739,4531,2009-04-28,Senate,"Do pass, but re-refer to the Committee on Appropriations",3,2,2,0,7
62739,4532,2009-04-28,Senate,"Set, second hearing.  Failed passage in Committee. Reconsideration granted",5,0,2,0,7
62740,4533,2009-04-01,Senate,"Do pass as amended, and re-refer to the Committee on Business, Professions and Economic Development",6,0,3,0,9
62740,4534,2009-04-27,Senate,"Do pass, but re-refer to the Committee on Appropriations",8,2,0,0,10
62740,4535,2009-05-11,Senate,"Placed on Appropriations Suspense file",13,0,0,0,13
62741,3878,2009-04-27,Senate,"Do pass, but re-refer to the Committee on Health",6,2,2,0,10
62741,3879,2009-04-29,Senate,"Do pass as amended, and re-refer to the Committee on Appropriations",10,0,1,0,11
62741,3880,2009-05-26,Senate,"Do pass",11,1,1,0,13
62741,3881,2009-06-01,Senate,"Senate 3rd Reading SB726 Ashburn",36,3,0,0,39
62741,3882,2009-07-07,Assembly,"Do pass and be re-referred to the Committee on Health",10,0,1,0,11
62741,3883,2009-07-09,Assembly,"Do pass as amended and be re-referred to the Committee on Appropriations",14,1,4,0,19
62741,3884,2009-08-27,Assembly,"Do pass",15,1,1,0,17
62741,9004,2010-06-17,Assembly,"SB 726 Ashburn  Senate Third Reading  By SWANSON",38,26,15,0,79
62741,9887,2010-06-28,Assembly,"SB 726 Ashburn  Assembly Third Reading  By SWANSON",43,24,12,0,79
62741,21429,2010-08-25,Senate,"Do pass",3,4,0,0,7
62742,4512,2009-04-22,Senate,"Do pass as amended, and re-refer to the Committee on Appropriations",11,0,0,0,11
62742,4513,2009-05-11,Senate,"Placed on Appropriations Suspense file",13,0,0,0,13
62743,22762,2009-05-04,Senate,"Do pass, but re-refer to the Committee on Judiciary",5,2,0,0,7
62743,22763,2009-05-14,Senate,"Do pass",6,3,0,0,9
62743,22764,2009-05-26,Senate,"Senate 3rd Reading SB728 Lowenthal",21,16,0,0,37
62743,22765,2009-06-29,Assembly,"Do pass",8,5,0,0,13
62743,22766,2009-08-20,Assembly,"SB 728 Lowenthal  Senate Third Reading  By BLUMENFIELD  Amend By 	BLUMENFIELD  Set #1",48,29,0,0,77
62743,22767,2009-08-24,Assembly,"SB 728 Lowenthal  Senate Third Reading  By BLUMENFIELD",45,29,0,0,74
62743,22768,2009-09-04,Senate,"Unfinished Business SB728 Lowenthal",22,18,0,0,40
62745,4514,2009-05-04,Senate,"Do pass as amended",5,2,0,0,7
62745,4515,2009-05-26,Senate,"Do pass",8,5,0,0,13
62745,4516,2009-06-02,Senate,"Senate 3rd Reading SB730 Wiggins",21,18,0,0,39
62745,9236,2010-06-17,Assembly,"Be referred to Committee on Utilities and Commerce",9,0,2,0,11
62745,9810,2010-06-28,Assembly,"Do pass as amended and be re-referred to the Committee on Appropriations",15,0,0,0,15
62745,20217,2010-08-12,Assembly,"Do pass as amended",17,0,0,0,17
62745,20463,2010-08-18,Assembly,"SB 730 Wiggins  Senate Third Reading  By HUFFMAN",65,5,0,0,70
62745,20713,2010-08-20,Senate,"From committee:  That the Assembly Amendments be concurred in",9,0,0,0,9
62745,21120,2010-08-25,Senate,"Unfinished Business SB730 Wiggins",28,0,0,0,28
62747,4272,2009-04-22,Senate,"Do pass, but re-refer to the Committee on Appropriations",11,0,0,0,11
62747,4273,2009-05-04,Senate,"Placed on Appropriations Suspense file",11,0,2,0,13
62747,4274,2010-01-13,Senate,"Do pass, but re-refer to the Committee on Appropriations",7,0,2,0,9
62747,4275,2010-01-25,Senate,"SENATE 3RD READING SB732 ALQUIST",36,0,3,0,39
62748,4490,2009-04-28,Senate,"Do pass, but re-refer to the Committee on Appropriations",7,0,0,0,7
62748,4491,2009-05-18,Senate,"Placed on Appropriations Suspense file",13,0,0,0,13
62748,4492,2010-01-21,Senate,"Do pass as amended",9,0,2,0,11
62748,4493,2010-01-28,Senate,"SENATE 3RD READING SB733 LENO",32,2,5,0,39
62748,8820,2010-06-15,Assembly,"Do pass and be re-referred to the Committee on Appropriations",7,0,0,0,7
62748,20309,2010-08-12,Assembly,"Do pass as amended",12,5,0,0,17
62748,21516,2010-08-25,Assembly,"SB 733 Leno  Senate Third Reading  By HAGMAN",73,1,0,0,74
62748,21517,2010-08-26,Senate,"Unfinished Business SB733 Leno",35,1,0,0,36
62749,23585,2009-04-28,Senate,"Do pass, but re-refer to the Committee on Appropriations Recommend 	Consent",10,0,0,0,10
62749,23586,2009-05-18,Senate,"Special Consent #5 SB734 Lowenthal",36,0,0,0,36
62749,23587,2009-06-29,Assembly,"Do pass and re-refer to Committee on Appropriations with 	recommendation:  To Consent Calendar",13,0,0,0,13
62749,23588,2009-07-08,Assembly,"Do pass, to Consent Calendar",15,0,0,0,15
62749,23589,2009-09-01,Assembly,"SB 734 Lowenthal  Senate Third Reading  By ENG",78,0,0,0,78
62749,23590,2009-09-08,Senate,"Unfinished Business SB734 Lowenthal",40,0,0,0,40
62752,4453,2009-04-15,Senate,"Do pass as amended, and re-refer to the Committee on Appropriations",5,0,0,0,5
62752,4454,2009-05-04,Senate,"Placed on Appropriations Suspense file",11,0,2,0,13
62753,4232,2009-04-14,Senate,"Do pass, but re-refer to the Committee on Education",5,2,0,0,7
62753,4233,2009-04-29,Senate,"Do pass as amended, and re-refer to the Committee on Appropriations",8,1,0,0,9
62753,4234,2009-05-18,Senate,"Placed on Appropriations Suspense file",13,0,0,0,13
62754,23306,2009-04-21,Senate,"Do pass as amended, and re-refer to the Committee on 	Appropriations",5,0,0,0,5
62754,23307,2009-06-02,Senate,"Senate 3rd Reading SB739 Strickland Urgency Clause",31,0,0,0,31
62754,23308,2009-07-07,Assembly,"Do pass and be re-referred to the Committee on Appropriations",7,0,0,0,7
62754,23309,2009-08-19,Assembly,"Do pass, to Consent Calendar",17,0,0,0,17
62754,23310,2009-08-27,Assembly,"SB 739 Strickland  Consent Calendar Second Day  Regular Session",74,0,0,0,74
62755,25223,2009-03-31,Senate,"Do pass, but re-refer to the Committee on Appropriations Recommend 	Consent",5,0,0,0,5
62755,25224,2009-04-23,Senate,"Special Consent #1 SB740 Cedillo",37,0,0,0,37
62755,25225,2009-06-23,Assembly,"Do pass and re-refer to Committee on Appropriations with 	recommendation:  To Consent Calendar",7,0,0,0,7
62755,25226,2009-07-01,Assembly,"Do pass, to Consent Calendar",15,0,0,0,15
62755,25227,2009-09-03,Assembly,"SB 740 Cedillo  Senate Third Reading  By MENDOZA",73,0,0,0,73
62756,26698,2009-04-20,Senate,"Do pass, but re-refer to the Committee on Public Safety",8,1,0,0,9
62756,26699,2009-05-04,Senate,"Do pass",10,0,0,0,10
62756,26700,2009-05-14,Senate,"Senate 3rd Reading SB741 Maldonado",34,3,0,0,37
62756,26701,2009-06-30,Assembly,"Do pass and be re-referred to the Committee on Appropriations",10,0,0,0,10
62756,26702,2009-07-15,Assembly,"Do pass",12,1,0,0,13
62756,26703,2009-08-20,Assembly,"SB 741 Maldonado  Senate Third Reading  By HAYASHI",65,5,0,0,70
62756,26704,2009-09-02,Senate,"Unfinished Business SB741 Maldonado",29,3,0,0,32
62757,4447,2009-04-29,Senate,"Do pass as amended, and re-refer to the Committee on Appropriations",8,0,1,0,9
62757,4448,2009-05-18,Senate,"Placed on Appropriations Suspense file",13,0,0,0,13
62757,4449,2009-05-28,Senate,"Do pass as amended",12,0,1,0,13
62757,4450,2009-06-03,Senate,"Senate 3rd Reading SB742 Romero",35,2,2,0,39
62757,4451,2009-07-08,Assembly,"Do pass and be re-referred to the Committee on Appropriations",7,1,3,0,11
62758,26246,2009-04-01,Senate,"Do pass, but re-refer to the Committee on Judiciary",11,0,0,0,11
62758,26247,2009-04-21,Senate,"Do pass",5,0,0,0,5
62758,26248,2009-04-23,Senate,"Special Consent #1 SB743 Committee on Health (Kuehl)",37,0,0,0,37
62758,26249,2009-06-09,Assembly,"Do pass and be re-referred to the Committee on Judiciary to Consent 	Calendar",18,0,0,0,18
62758,26250,2009-06-23,Assembly,"Do pass, to Consent Calendar",10,0,0,0,10
62758,26251,2009-06-30,Assembly,"SB 743 HEALTH  Consent Calendar Second Day  Regular Session",77,0,0,0,77
62758,26252,2009-08-17,Senate,"Special Consent #14 SB743 Committee on Health (Alquist)",35,0,0,0,35
62759,26779,2009-04-15,Senate,"Do pass as amended, and re-refer to the Committee on Business, 	Professions and Economic Development",11,0,0,0,11
62759,26780,2009-04-27,Senate,"Do pass, but re-refer to the Committee on Appropriations",6,1,0,0,7
62759,26781,2009-05-26,Senate,"Do pass",13,0,0,0,13
62759,26782,2009-06-01,Senate,"Senate 3rd Reading SB744 Strickland Urgency Clause",39,0,0,0,39
62759,26783,2009-06-30,Assembly,"Do pass and be re-referred to the Committee on Health",8,0,0,0,8
62759,26784,2009-07-07,Assembly,"Do pass as amended and be re-referred to the Committee on 	Appropriations",16,0,0,0,16
62759,26785,2009-08-27,Assembly,"Do pass",16,0,0,0,16
62759,26786,2009-09-02,Assembly,"SB 744 Strickland  Third Reading Urgency  By EMMERSON",70,3,0,0,73
62759,26787,2009-09-08,Senate,"Unfinished Business SB744 Strickland",39,0,0,0,39
62762,4429,2009-04-29,Senate,"Do pass, but re-refer to the Committee on Appropriations",9,0,0,0,9
62762,4430,2009-05-18,Senate,"Placed on Appropriations Suspense file",13,0,0,0,13
62762,4431,2009-05-28,Senate,"Do pass as amended",12,0,1,0,13
62762,4432,2009-06-03,Senate,"Special Consent #8 SB747 Romero",39,0,0,0,39
62762,4433,2009-07-01,Assembly,"Do pass and be re-referred to the Committee on Higher Education",10,0,1,0,11
62762,4434,2009-07-07,Assembly,"Do pass as amended and re-refer to Committee on Appropriations with recommendation:  To Consent Calendar",9,0,0,0,9
62763,25269,2009-04-14,Senate,"Do pass, but re-refer to the Committee on Judiciary",7,0,0,0,7
62763,25270,2009-04-21,Senate,"Do pass as amended, and re-refer to the Committee on 	Appropriations",5,0,0,0,5
62763,25271,2009-05-26,Senate,"Special Consent #6 SB748 Leno",39,0,0,0,39
62763,25272,2009-06-23,Assembly,"Do pass and be re-referred to the Committee on Judiciary to Consent 	Calendar",7,0,0,0,7
62763,25273,2009-06-30,Assembly,"Do pass and re-refer to Committee on Appropriations with 	recommendation:  To Consent Calendar",10,0,0,0,10
62763,25274,2009-07-15,Assembly,"Do pass as amended, to Consent Calendar",16,0,0,0,16
62763,25275,2009-08-24,Assembly,"SB 748 Leno  Consent Calendar Second Day  Regular Session",76,0,0,0,76
62763,25276,2009-08-31,Senate,"Special Consent #17 SB748 Leno",36,0,0,0,36
62766,22849,2009-04-15,Senate,"Do pass as amended, and re-refer to the Committee on Appropriations",7,0,0,0,7
62766,22850,2009-05-18,Senate,"Special Consent #5 SB751 Romero",36,0,0,0,36
62766,22851,2009-06-17,Assembly,"Do pass as amended and re-refer to Committee on Appropriations 	with recommendation:  To Consent Calendar",10,0,0,0,10
62766,22852,2009-08-19,Assembly,"Do pass, to Consent Calendar",17,0,0,0,17
62766,22853,2009-08-27,Assembly,"SB 751 Romero  Consent Calendar Second Day  Regular Session",74,0,0,0,74
62766,22854,2009-09-02,Senate,"Special Consent #18 SB751 Romero",39,0,0,0,39
62767,27089,2009-04-27,Senate,"Do pass, but re-refer to the Committee on Appropriations",7,0,0,0,7
62767,27090,2009-05-18,Senate,"Placed on Appropriations Suspense file",13,0,0,0,13
62767,27091,2009-05-28,Senate,"Do pass as amended",12,0,0,0,12
62767,27092,2009-06-03,Senate,"Special Consent #8 SB752 Wiggins",39,0,0,0,39
62767,27093,2009-07-08,Assembly,"Do pass as amended and be re-referred to the Committee on 	Appropriations",6,0,0,0,6
62767,27094,2009-09-01,Assembly,"SB 752 Correa  Third Reading Urgency  By SILVA",78,0,0,0,78
62767,27095,2009-09-04,Senate,"From committee:  That the Assembly Amendments be concurred in",7,0,0,0,7
62767,27096,2009-09-08,Senate,"Unfinished Business SB752 Correa Urgency Clause",40,0,0,0,40
62770,4378,2009-04-14,Senate,"Do pass, but re-refer to the Committee on Judiciary",12,0,1,0,13
62770,4379,2009-04-28,Senate,"Do pass as amended, and re-refer to the Committee on Appropriations",5,0,0,0,5
62770,4380,2009-05-18,Senate,"Placed on Appropriations Suspense file",13,0,0,0,13
62771,4181,2009-04-28,Senate,"Do pass, but re-refer to the Committee on Appropriations",6,0,1,0,7
62771,4182,2009-05-11,Senate,"Placed on Appropriations Suspense file",13,0,0,0,13
62772,24923,2009-04-20,Senate,"Do pass, but re-refer to the Committee on Judiciary",5,2,0,0,7
62772,24924,2009-04-28,Senate,"Do pass as amended, and re-refer to the Committee on 	Appropriations",4,1,0,0,5
62772,24925,2009-05-18,Senate,"Senate 3rd Reading SB757 Pavley",21,13,0,0,34
62772,24926,2009-06-16,Assembly,"Do pass as amended and be re-referred to the Committee on Judiciary",5,1,0,0,6
62772,24927,2009-06-30,Assembly,"Do pass and be re-referred to the Committee on Appropriations",7,3,0,0,10
62772,24928,2009-08-27,Assembly,"Do pass",12,5,0,0,17
62772,24929,2009-09-02,Assembly,"SB 757 Pavley  Senate Third Reading  By CHESBRO",48,28,0,0,76
62772,24930,2009-09-08,Senate,"Unfinished Business SB757 Pavley",23,13,0,0,36
62774,4178,2009-04-22,Senate,"Do pass, but re-refer to the Committee on Environmental Quality",9,2,0,0,11
62774,4179,2009-04-27,Senate,"Do pass as amended, and re-refer to the Committee on Appropriations",5,2,0,0,7
62774,4180,2009-05-18,Senate,"Placed on Appropriations Suspense file",13,0,0,0,13
62775,26431,2009-04-28,Senate,"Do pass, but re-refer to the Committee on Appropriations",10,0,0,0,10
62775,26432,2009-05-11,Senate,"Do pass",11,0,0,0,11
62775,26433,2009-05-18,Senate,"Special Consent #5 SB760 Aanestad",36,0,0,0,36
62775,26434,2009-06-16,Assembly,"Do pass and re-refer to Committee on Appropriations with 	recommendation:  To Consent Calendar",11,0,0,0,11
62775,26435,2009-07-01,Assembly,"Do pass, to Consent Calendar",15,0,0,0,15
62775,26436,2009-07-09,Assembly,"SB 760 Aanestad  Consent Calendar Second Day  Regular Session",74,0,0,0,74
62776,4372,2009-04-29,Senate,"Do pass as amended, and re-refer to the Committee on Appropriations",11,0,0,0,11
62776,4373,2009-05-26,Senate,"Special Consent #6 SB761 Aanestad",39,0,0,0,39
62776,4374,2009-07-07,Assembly,"Do pass and be re-referred to the Committee on Appropriations",8,4,7,0,19
62776,4375,2009-07-07,Assembly,"Set first hearing.  Failed passage.  Reconsideration granted",19,0,0,0,19
62777,22309,2009-04-27,Senate,"Do pass as amended",7,3,0,0,10
62777,22310,2009-05-14,Senate,"Senate 3rd Reading SB762 Aanestad",31,6,0,0,37
62777,22311,2009-06-16,Assembly,"Do pass",9,0,0,0,9
62777,22312,2009-06-25,Assembly,"SB 762 Aanestad  Senate Third Reading  By ENG",59,6,0,0,65
62779,4149,2009-04-29,Senate,"Do pass, but re-refer to the Committee on Appropriations",5,0,1,0,6
62779,4150,2009-05-18,Senate,"Placed on Appropriations Suspense file",13,0,0,0,13
62780,26108,2009-05-13,Senate,"Do pass, but re-refer to the Committee on Appropriations",8,0,0,0,8
62780,26109,2009-06-02,Senate,"Special Consent #7 SB765 Dutton",39,0,0,0,39
62780,26110,2009-07-06,Assembly,"Do pass and re-refer to Committee on Appropriations with 	recommendation:  To Consent Calendar",8,0,0,0,8
62780,26111,2009-08-27,Assembly,"Do pass as amended",17,0,0,0,17
62780,26112,2009-09-02,Assembly,"SB 765 Dutton  Senate Third Reading  By SALAS",76,0,0,0,76
62780,26113,2009-09-09,Senate,"Special Consent #20 SB765 Dutton",40,0,0,0,40
62781,23747,2009-04-28,Senate,"Do pass, but re-refer to the Committee on Appropriations",11,0,0,0,11
62781,23748,2009-05-11,Senate,"Do pass",13,0,0,0,13
62781,23749,2009-05-18,Senate,"Special Consent #5 SB766 Negrete McLeod",36,0,0,0,36
62781,23750,2009-07-08,Assembly,"Do pass and re-refer to Committee on Appropriations with 	recommendation:  To Consent Calendar",17,0,0,0,17
62781,23751,2009-08-27,Assembly,"Do pass as amended",17,0,0,0,17
62781,23752,2009-09-02,Assembly,"SB 766 Negrete McLeod  Senate Third Reading  By TORRES",74,0,0,0,74
62781,23753,2009-09-08,Senate,"Unfinished Business SB766 Negrete McLeod",40,0,0,0,40
62784,4329,2009-04-22,Senate,"Do pass, but re-refer to the Committee on Appropriations",11,0,0,0,11
62784,4330,2009-06-01,Senate,"Senate 3rd Reading SB769 Alquist",36,0,3,0,39
62784,4331,2009-07-07,Assembly,"Do pass as amended and be re-referred to the Committee on Appropriations",18,0,1,0,19
62784,4332,2009-08-27,Assembly,"Do pass as amended",17,0,0,0,17
62784,4333,2009-09-08,Assembly,"SB 769 Alquist  Senate Third Reading  By FONG",78,0,1,0,79
62784,4334,2009-09-11,Assembly,"SB 769 Alquist  Third Reading Urgency  By FONG",77,0,2,0,79
62784,4335,2009-09-12,Senate,"Unfinished Supp 1 SB769 Alquist Reconsider",39,0,1,0,40
62784,8875,2009-09-12,Senate,"Unfinished Supp 1 SB769 Alquist Urgency Clause",26,1,13,0,40
62784,9640,2010-06-28,Assembly,"SB 769 Alquist  Third Reading Urgency  By MONNING",75,0,4,0,79
62784,20626,2010-08-19,Assembly,"SB 769 Alquist  Third Reading Urgency  By MONNING",76,0,0,0,76
62784,21250,2010-08-25,Senate,"From committee:  That the Assembly Amendments be concurred in",8,0,0,0,8
62784,21434,2010-08-26,Senate,"Unfinished Business SB769 Alquist Urgency Clause",37,0,0,0,37
62786,4125,2010-01-13,Senate,"Do pass, but re-refer to the Committee on Appropriations",6,1,2,0,9
62786,4126,2010-01-19,Senate,"Placed on Appropriations Suspense file",8,0,3,0,11
62786,4127,2010-01-21,Senate,"Do pass as amended",6,3,2,0,11
62786,4128,2010-01-28,Senate,"SENATE 3RD READING SB771 ALQUIST",24,10,5,0,39
62786,10098,2010-06-29,Assembly,"Do pass as amended and be re-referred to the Committee on Appropriations",15,4,0,0,19
62787,4322,2009-04-27,Senate,"Do pass as amended, and re-refer to the Committee on Appropriations",6,2,2,0,10
62787,4323,2009-05-18,Senate,"Do pass",8,3,2,0,13
62787,4324,2009-06-03,Senate,"Senate 3rd Reading SB772 Leno",23,14,2,0,39
62787,4325,2009-06-30,Assembly,"Do pass and be re-referred to the Committee on Business and Professions",4,2,1,0,7
62787,4326,2009-07-07,Assembly,"Do pass as amended and be re-referred to the Committee on Appropriations",7,2,2,0,11
62787,4327,2009-08-19,Assembly,"Do pass",6,5,6,0,17
62787,4328,2009-08-19,Assembly,"Set first hearing.  Failed passage.  Reconsideration granted",17,0,0,0,17
62788,4136,2009-05-13,Senate,"Do pass as amended",4,1,1,0,6
62788,4137,2009-05-26,Senate,"Placed on Appropriations Suspense file",13,0,0,0,13
62789,4276,2009-04-21,Senate,"Do pass, but re-refer to the Committee on Human Services",7,0,0,0,7
62789,4277,2009-04-28,Senate,"Do pass, but re-refer to the Committee on Appropriations",3,0,2,0,5
62789,4278,2009-05-11,Senate,"Placed on Appropriations Suspense file",13,0,0,0,13
62789,4279,2009-05-28,Senate,"Do pass as amended",12,0,1,0,13
62789,4280,2009-06-03,Senate,"Senate 3rd Reading SB774 Ashburn",39,0,0,0,39
62789,4281,2009-06-30,Assembly,"Do pass as amended and be re-referred to the Committee on Public Safety",4,1,2,0,7
62789,4282,2009-07-07,Assembly,"Do pass as amended and be re-referred to the Committee on Appropriations",7,0,0,0,7
62793,4102,2009-04-28,Senate,"Do pass, but re-refer to the Committee on Appropriations",9,1,1,0,11
62793,4103,2009-05-21,Senate,"Senate 3rd Reading SB778 Wiggins",30,4,5,0,39
62793,4104,2009-06-16,Assembly,"Do pass and be re-referred to the Committee on Appropriations",11,0,2,0,13
62793,4105,2009-07-01,Assembly,"Do pass",14,1,1,0,16
62796,26284,2009-04-21,Senate,"Do pass as amended, and re-refer to the Committee on 	Appropriations",5,0,0,0,5
62796,26285,2009-05-18,Senate,"Special Consent #5 SB781 Leno",36,0,0,0,36
62796,26286,2009-06-23,Assembly,"Do pass and be re-referred to the Committee on Human Services",10,0,0,0,10
62796,26287,2009-06-30,Assembly,"Do pass and be re-referred to the Committee on Appropriations",6,0,0,0,6
62796,26288,2009-08-19,Assembly,"Do pass, to Consent Calendar",17,0,0,0,17
62796,26289,2009-08-27,Assembly,"SB 781 Leno  Consent Calendar Second Day  Regular Session",74,0,0,0,74
62796,26290,2009-09-02,Senate,"Special Consent #18 SB781 Leno",39,0,0,0,39
62797,4013,2009-05-05,Senate,"Do pass as amended",3,0,2,0,5
62797,4014,2009-05-28,Senate,"Senate 3rd Reading SB782 Yee Reconsider",34,0,5,0,39
62797,4015,2009-06-01,Senate,"Senate 3rd Reading SB782 Yee",21,18,0,0,39
62797,8717,2010-06-15,Assembly,"Do pass as amended and be re-referred to the Committee on Appropriations",7,2,1,0,10
62797,8918,2009-05-28,Senate,"Senate 3rd Reading SB782 Yee",19,15,5,0,39
62797,19638,2010-08-04,Assembly,"Do pass",10,2,0,0,12
62797,20403,2010-08-17,Assembly,"SB 782 Yee  Senate Third Reading  By NAVA",70,5,0,0,75
62797,21507,2010-08-26,Senate,"Unfinished Business SB782 Yee",22,15,0,0,37
62798,22842,2009-04-28,Senate,"Do pass as amended, and re-refer to the Committee on Appropriations",10,0,0,0,10
62798,22843,2009-05-26,Senate,"Do pass as amended",12,1,0,0,13
62798,22844,2009-06-01,Senate,"Senate 3rd Reading SB783 Ashburn",38,0,0,0,38
62798,22845,2009-06-29,Assembly,"Do pass as amended and be re-referred to the Committee on 	Appropriations",12,0,0,0,12
62798,22846,2009-07-15,Assembly,"Do pass, to Consent Calendar",16,0,0,0,16
62798,22847,2009-08-17,Assembly,"SB 783 Ashburn  Consent Calendar Second Day  Regular Session",76,0,0,0,76
62798,22848,2009-08-24,Senate,"Special Consent #15 SB783 Ashburn",39,0,0,0,39
62801,23000,2009-05-12,Senate,"Do pass as amended",5,0,0,0,5
62801,23001,2009-05-28,Senate,"Senate 3rd Reading SB786 Yee",34,0,0,0,34
62801,23002,2009-06-23,Assembly,"Do pass",9,1,0,0,10
62801,23003,2009-07-13,Assembly,"SB 786 Yee  Senate Third Reading  By EVANS",66,2,0,0,68
62803,23341,2009-04-27,Senate,"Do pass, but re-refer to the Committee on Public Safety",10,0,0,0,10
62803,23342,2009-06-03,Senate,"Senate 3rd Reading SB788 Wyland",36,1,0,0,37
62803,23343,2009-07-07,Assembly,"Do pass and be re-referred to the Committee on Appropriations",11,0,0,0,11
62803,23344,2009-08-27,Assembly,"Do pass",16,0,0,0,16
62803,23345,2009-09-03,Assembly,"SB 788 Wyland  Senate Third Reading  By CALDERON  Amend By CALDERON 	Set #1",52,21,0,0,73
62803,23346,2009-09-08,Assembly,"SB 788 Wyland  Senate Third Reading  By CALDERON",70,5,0,0,75
62803,23347,2009-09-10,Senate,"Unfinished Business SB788 Wyland Concurrence",26,1,0,0,27
62804,4202,2009-04-01,Senate,"Do pass as amended, and re-refer to the Committee on Appropriations",4,2,0,0,6
62804,4203,2009-04-20,Senate,"Motion to place on APPROPRIATIONS suspense file refused",3,7,3,0,13
62804,4204,2009-04-20,Senate,"Do pass",7,3,3,0,13
62804,4205,2009-04-23,Senate,"Senate 3rd Reading SB789 Steinberg",23,14,2,0,39
62804,4206,2009-05-06,Assembly,"Do pass and be re-referred to the Committee on Appropriations",5,2,0,0,7
62804,4207,2009-07-01,Assembly,"Do pass",10,5,1,0,16
62804,4208,2009-08-27,Assembly,"SB 789 Steinberg  Senate Third Reading  By MENDOZA",47,29,3,0,79
62805,23907,2009-04-27,Senate,"Do pass as amended, and re-refer to the Committee on 	Appropriations",5,2,0,0,7
62805,23908,2009-05-28,Senate,"Senate 3rd Reading SB790 Pavley",21,12,0,0,33
62805,23909,2009-06-30,Assembly,"Do pass as amended and be re-referred to the Committee on 	Appropriations",5,2,0,0,7
62805,23910,2009-08-27,Assembly,"Do pass",12,5,0,0,17
62805,23911,2009-09-03,Assembly,"SB 790 Pavley  Senate Third Reading  By MONNING",48,27,0,0,75
62805,23912,2009-09-08,Senate,"Unfinished Business SB790 Pavley",28,12,0,0,40
62806,4068,2009-04-28,Senate,"Do pass, but re-refer to the Committee on Appropriations",5,0,0,0,5
62806,4069,2009-06-02,Senate,"Senate 3rd Reading SB791 Yee Urgency Clause",36,1,2,0,39
62806,4070,2009-06-30,Assembly,"Do pass",5,0,2,0,7
62806,4071,2009-07-16,Assembly,"SB 791 Yee  Third Reading Urgency  By COOK",63,5,11,0,79
62807,23678,2009-04-28,Senate,"Do pass as amended, and re-refer to the Committee on Appropriations",10,0,0,0,10
62807,23679,2009-06-02,Senate,"Senate 3rd Reading SB792 Leno",34,2,0,0,36
62807,23680,2009-07-08,Assembly,"Do pass as amended and be re-referred to the Committee on 	Appropriations",4,0,0,0,4
62807,23681,2009-08-19,Assembly,"Do pass as amended",9,2,0,0,11
62807,23682,2009-09-09,Assembly,"SB 792 Leno  Senate Third Reading  By MA",69,1,0,0,70
62807,23683,2009-09-10,Senate,"Unfinished Supp 1 SB792 Leno",38,1,0,0,39
62812,4061,2009-04-20,Senate,"Do pass, but re-refer to the Committee on Health",5,2,0,0,7
62812,4062,2009-04-29,Senate,"Do pass",6,2,3,0,11
62812,4063,2009-06-02,Senate,"Senate 3rd Reading SB797 Pavley",21,16,2,0,39
62812,4064,2009-06-30,Assembly,"Do pass and be re-referred to the Committee on Health",5,2,0,0,7
62812,4065,2009-07-07,Assembly,"Do pass as amended",10,6,3,0,19
62812,4066,2009-09-09,Assembly,"SB 797 Pavley  Senate Third Reading  By PEREZ, J",35,32,12,0,79
62812,9635,2010-06-28,Assembly,"SB 797 Pavley  Senate Third Reading  By BRADFORD",37,29,13,0,79
62812,10125,2010-07-01,Assembly,"SB 797 Pavley  Motion to Reconsider  By BRADFORD",48,27,4,0,79
62812,10126,2010-07-01,Assembly,"SB 797 Pavley  Senate Third Reading  By BRADFORD",43,31,5,0,79
62812,21431,2010-08-25,Senate,"Unfinished Business SB797 Pavley Reconsider",34,0,0,0,34
62812,21832,2010-08-31,Senate,"Unfinished Business SB797 Pavley",19,18,0,0,37
62813,3,2009-04-22,Senate,"Do pass as amended, and re-refer to the Committee on Appropriations.",9,0,0,0,9
62813,4,2009-05-11,Senate,"Placed on Appropriations Suspense file.",13,0,0,0,13
62813,5,2010-01-21,Senate,"Do pass.",6,3,2,0,11
62813,6,2010-01-28,Senate,"SENATE 3RD READING SB798 DESAULNIER",31,6,2,0,39
62813,8941,2010-06-16,Assembly,"Do pass as amended and be re-referred to the Committee on Appropriations",7,0,2,0,9
62813,19869,2010-08-12,Assembly,"Do pass as amended",12,5,0,0,17
62813,20833,2010-08-23,Assembly,"SB 798 DeSaulnier  Senate Third Reading  By TORLAKSON",50,22,0,0,72
62813,21422,2010-08-26,Senate,"Unfinished Business SB798 DeSaulnier",29,6,0,0,35
62815,4037,2009-04-15,Senate,"Do pass",4,5,0,0,9
62815,4038,2009-04-15,Senate,"Set, first hearing.  Failed passage in Committee.  Reconsideration granted",9,0,0,0,9
62817,4167,2009-04-14,Senate,"Do pass, but re-refer to the Committee on Appropriations",12,1,0,0,13
62817,4168,2009-04-27,Senate,"Do pass",12,0,1,0,13
62817,4169,2009-05-06,Senate,"Senate 3rd Reading SB802 Leno",35,0,4,0,39
62817,4170,2009-07-07,Assembly,"Do pass and be re-referred to the Committee on Appropriations",11,0,0,0,11
62817,4171,2009-08-19,Assembly,"Do pass",17,0,0,0,17
62817,4172,2009-09-04,Assembly,"SB 802 Leno  Senate Third Reading  By FUENTES  Amend By FUENTES Set #1",40,29,10,0,79
62817,4173,2009-09-09,Assembly,"SB 802 Leno  Senate Third Reading  By FUENTES",75,1,3,0,79
62817,4174,2009-09-10,Senate,"Unfinished Supp 1 SB802 Leno",39,0,1,0,40
62819,23227,2009-05-05,Senate,"Do pass",3,0,0,0,3
62819,23228,2009-06-02,Senate,"Senate 3rd Reading SB804 Leno",28,6,0,0,34
62819,23229,2009-07-08,Assembly,"Do pass, to Consent Calendar",6,0,0,0,6
62819,23230,2009-07-16,Assembly,"SB 804 Leno  Consent Calendar Second Day  Regular Session",72,0,0,0,72
62820,4151,2009-04-21,Senate,"Do pass, but re-refer to the Committee on Appropriations",9,1,1,0,11
62820,4152,2009-05-04,Senate,"Placed on Appropriations Suspense file",11,0,2,0,13
62821,4764,2009-04-21,Senate,"Do pass as amended, and re-refer to the Committee on Appropriations",8,3,0,0,11
62821,4765,2009-05-18,Senate,"Placed on Appropriations Suspense file",13,0,0,0,13
62821,4766,2010-01-12,Senate,"Do pass and be placed on the Consent Calendar",9,0,2,0,11
62821,4767,2010-01-19,Senate,"CONSENT CALENDAR 2ND SB806 WIGGINS",31,0,8,0,39
62821,10149,2010-06-30,Assembly,"Do pass and re-refer to Committee on Appropriations with recommendation:  To Consent Calendar",18,0,4,0,22
62821,19689,2010-08-04,Assembly,"Do pass, to Consent Calendar",17,0,0,0,17
62821,21068,2010-08-23,Assembly,"SB 806 Wiggins  Senate Third Reading  By CHESBRO",77,0,0,0,77
62821,21279,2010-08-25,Senate,"Unfinished Business SB806 Wiggins",35,0,0,0,35
62823,27300,2010-01-12,Senate,"Do pass as amended, and re-refer to the Committee on Appropriations",9,0,0,0,9
62823,27301,2010-01-19,Senate,"Placed on Appropriations Suspense file",8,0,0,0,8
62823,27302,2010-01-21,Senate,"Do pass as amended",9,0,0,0,9
62823,27303,2010-01-28,Senate,"SENATE 3RD READING SB808 WOLK",35,0,0,0,35
62823,27304,2010-04-27,Assembly,"Do pass and re-refer to Committee on Appropriations with 	recommendation:  To Consent Calendar",11,0,0,0,11
62823,27305,2010-05-19,Assembly,"Do pass",16,0,0,0,16
62823,27306,2010-05-24,Assembly,"SB 808 Wolk  Third Reading Urgency  By NIELSEN",71,0,0,0,71
62824,23360,2009-05-13,Senate,"Do pass, but re-refer to the Committee on Appropriations",7,0,0,0,7
62824,23361,2009-06-02,Senate,"Special Consent #7 SB809 Committee on V.A. (Wyland)",39,0,0,0,39
62824,23362,2009-07-06,Assembly,"Do pass as amended and be re-referred to the Committee on 	Appropriations",8,0,0,0,8
62824,23363,2009-08-19,Assembly,"Do pass, to Consent Calendar",17,0,0,0,17
62824,23364,2009-09-02,Assembly,"SB 809 V. A.  Senate Third Reading  By MA",77,0,0,0,77
62824,23365,2009-09-08,Senate,"Unfinished Business SB809 Committee on V.A. (Denham)",40,0,0,0,40
62825,4027,2009-04-15,Senate,"Do pass as amended, and re-refer to the Committee on Appropriations",7,4,0,0,11
62825,4028,2009-05-04,Senate,"Placed on Appropriations Suspense file",11,0,2,0,13
62825,4029,2010-01-21,Senate,"Do pass",6,3,2,0,11
62825,4030,2010-01-28,Senate,"SENATE 3RD READING SB810 LENO",22,14,3,0,39
62825,10204,2010-06-29,Assembly,"Do pass and be re-referred to the Committee on Appropriations",13,6,0,0,19
62825,20083,2010-08-12,Assembly,"Do pass",12,5,0,0,17
62825,20690,2010-08-20,Assembly,"SB 810 Leno  Senate Third Reading  Amend By HAGMAN  Set #1  Motion 	to  Lay on the Table  By CALDERON",45,26,0,0,71
62826,4138,2009-04-14,Senate,"Do pass as amended, and re-refer to the Committee on Appropriations",7,3,1,0,11
62826,4139,2009-06-01,Senate,"Senate 3rd Reading SB811 DeSaulnier",24,13,2,0,39
62826,4140,2009-07-06,Assembly,"Do pass and be re-referred to the Committee on Appropriations",9,4,1,0,14
62826,4141,2009-07-15,Assembly,"Do pass",12,4,0,0,16
62826,4142,2009-09-08,Assembly,"SB 811 DeSaulnier  Senate Third Reading  By PEREZ, J",51,28,0,0,79
62827,4003,2009-04-28,Senate,"Do pass as amended, but re-refer to the Committee on Appropriations Recommend Consent",10,0,1,0,11
62827,4004,2009-05-18,Senate,"Placed on Appropriations Suspense file",13,0,0,0,13
62827,4005,2010-01-21,Senate,"Do pass",9,0,2,0,11
62827,4006,2010-01-28,Senate,"SENATE 3RD READING SB812 ASHBURN",36,0,3,0,39
62827,9062,2010-06-16,Assembly,"Do pass and be re-referred to the Committee on Housing and Community Development",9,0,0,0,9
62827,9832,2010-06-30,Assembly,"Do pass and be re-referred to the Committee on Appropriations",8,0,1,0,9
62827,20116,2010-08-12,Assembly,"Do pass as amended",17,0,0,0,17
62827,20879,2010-08-23,Assembly,"SB 812 Ashburn  Senate Third Reading  By BEALL",74,0,0,0,74
62827,21130,2010-08-25,Senate,"Unfinished Business SB812 Ashburn",35,0,0,0,35
62828,4129,2009-05-06,Senate,"Do pass as amended",4,0,1,0,5
62828,4130,2009-05-14,Senate,"Senate 3rd Reading SB813 Kehoe",36,0,3,0,39
62828,4131,2009-07-08,Assembly,"Do pass as amended and be re-referred to the Committee on Appropriations",4,2,0,0,6
62828,4132,2009-08-27,Assembly,"Do pass as amended",12,5,0,0,17
62828,4133,2009-09-11,Senate,"From committee:  That the Assembly Amendments be concurred in",7,2,2,0,11
62828,4134,2009-09-11,Assembly,"SB 813 Kehoe  Senate Third Reading  By TORRES",51,28,0,0,79
62828,4135,2009-09-12,Senate,"Unfinished Supp 1 SB813 Kehoe Concurrence",25,13,2,0,40
62830,4016,2009-04-29,Senate,"Do pass as amended, and re-refer to the Committee on Appropriations",8,0,1,0,9
62830,4017,2009-05-18,Senate,"Placed on Appropriations Suspense file",13,0,0,0,13
62830,4018,2009-05-28,Senate,"Do pass as amended",12,0,1,0,13
62830,4019,2009-06-03,Senate,"Senate 3rd Reading SB815 Cogdill",35,0,4,0,39
62830,4020,2009-06-30,Assembly,"Do pass and be re-referred to the Committee on Higher Education",8,0,1,0,9
62831,22282,2009-04-22,Senate,"Do pass as amended, and re-refer to the Committee on Appropriations",7,1,0,0,8
62831,22283,2009-05-18,Senate,"Senate 3rd Reading SB816 Ducheny",32,2,0,0,34
62831,22284,2009-06-22,Assembly,"Do pass as amended and be re-referred to the Committee on 	Appropriations",6,3,0,0,9
62831,22285,2009-07-08,Assembly,"Do pass",10,5,0,0,15
62831,22286,2009-09-09,Assembly,"SB 816 Ducheny  Senate Third Reading  By CALDERON",49,27,0,0,76
62831,22287,2009-09-10,Senate,"Unfinished Supp 1 SB816 Ducheny Concurrence",28,11,0,0,39
62832,4106,2009-04-21,Senate,"Do pass and be placed on the Consent Calendar",5,0,0,0,5
62832,4107,2009-04-27,Senate,"Consent Calendar 2nd SB817 Committee on E.R.& C.A. (Calderon)",39,0,0,0,39
62832,4108,2009-06-23,Assembly,"Do pass as amended, to Consent Calendar",7,0,0,0,7
62832,20776,2010-08-20,Assembly,"SB 817 E.R.& C.A.  Senate Third Reading  By BUCHANAN  Amend By 	SKINNER  Set #1",49,26,0,0,75
62833,22276,2009-04-14,Senate,"Do pass, but re-refer to the Committee on Appropriations",7,0,0,0,7
62833,22277,2009-05-06,Senate,"Special Consent #2 SB818 Committee on V.A. (Wyland)",35,0,0,0,35
62833,22278,2009-06-16,Assembly,"Do pass and be re-referred to the Committee on Appropriations",8,0,0,0,8
62833,22279,2009-07-01,Assembly,"Do pass, to Consent Calendar",15,0,0,0,15
62833,22280,2009-07-09,Assembly,"SB 818 V. A.  Consent Calendar Second Day  Regular Session",74,0,0,0,74
62833,22281,2009-08-17,Senate,"Special Consent #14 SB818 Committee on V.A. (Denham)",35,0,0,0,35
62834,22510,2009-04-27,Senate,"Do pass, but re-refer to the Committee on Appropriations",10,0,0,0,10
62834,22511,2009-06-03,Senate,"Senate 3rd Reading SB819 Committee on B.P.& E.D. (Ridley-Th Urgency 	Clause)",38,0,1,0,39
62834,22512,2009-06-30,Assembly,"Do pass and be re-referred to the Committee on Appropriations",10,0,0,0,10
62834,22513,2009-07-15,Assembly,"Do pass",15,0,0,1,16
62834,22514,2009-09-09,Assembly,"Do pass as amended",10,0,0,0,10
62834,22515,2009-09-11,Assembly,"SB 819 Yee  Third Reading Urgency  By HAYASHI",79,0,0,0,79
62834,22516,2009-09-12,Assembly,"SB 819 Yee  Third Reading Urgency  By HAYASHI",72,0,0,7,79
62834,22517,2009-09-12,Senate,"W/O REF. TO FILE SB819 Yee",35,0,5,0,40
62835,3987,2009-04-27,Senate,"Do pass, but re-refer to the Committee on Appropriations",10,0,0,0,10
62835,3988,2009-05-18,Senate,"Special Consent #5 SB820 Committee on B.P.& E.D. (Ridley-Th",36,0,3,0,39
62835,3989,2009-07-07,Assembly,"Do pass and be re-referred to the Committee on Appropriations",11,0,0,0,11
62835,3990,2009-08-19,Assembly,"Do pass",13,1,3,0,17
62835,3991,2009-09-09,Assembly,"SB 820 Negrete McLeod  Senate Third Reading  By RUSKIN",73,0,6,0,79
62835,3992,2009-09-10,Senate,"Unfinished Supp 1 SB820 Negrete McLeod Concurrence",40,0,0,0,40
62836,22270,2009-04-27,Senate,"Do pass as amended, and re-refer to the Committee on 	Appropriations",10,0,0,0,10
62836,22271,2009-05-26,Senate,"Special Consent #6 SB821 Committee on B.P.& E.D. (Ridley-Th",39,0,0,0,39
62836,22272,2009-07-07,Assembly,"Do pass and be re-referred to the Committee on Appropriations",11,0,0,0,11
62836,22273,2009-08-19,Assembly,"Do pass, to Consent Calendar",17,0,0,0,17
62836,22274,2009-08-27,Assembly,"SB 821 B. P.& E.D.  Consent Calendar Second Day  Regular Session",74,0,0,5,79
62836,22275,2009-09-02,Senate,"Special Consent #18 SB821 Committee on B.P.&E.D. (Negrete M",39,0,1,0,40
62837,26042,2009-04-22,Senate,"Do pass, but re-refer to the Committee on Appropriations Recommend 	Consent",8,0,0,0,8
62837,26043,2009-05-11,Senate,"Special Consent #3 SB822 Committee on Rev. & Tax. (Oropeza",36,0,0,0,36
62837,26044,2009-06-15,Assembly,"Do pass as amended and re-refer to Committee on Appropriations 	with recommendation:  To Consent Calendar",9,0,0,0,9
62837,26045,2009-07-01,Assembly,"Do pass and be re-referred to the Committee on Appropriations to 	Consent Calendar",7,0,0,0,7
62837,26046,2009-07-15,Assembly,"Do pass, to Consent Calendar",16,0,0,0,16
62837,26047,2009-09-02,Assembly,"SB 822 REV.& TAX.  Senate Third Reading  By CALDERON",78,0,0,0,78
62837,26048,2009-09-09,Senate,"Unfinished Business SB822 Committee on Rev. & Tax. (Wolk)",39,0,0,0,39
62838,25945,2009-04-22,Senate,"Do pass and be placed on the Consent Calendar",8,0,0,0,8
62838,25946,2009-05-06,Senate,"Consent Calendar 2nd SB823 Committee on Rev. & Tax. (Oropeza",35,0,0,0,35
62838,25947,2009-06-15,Assembly,"Do pass, to Consent Calendar",9,0,0,0,9
62838,25948,2009-06-22,Assembly,"SB 823 REV.& TAX.  Consent Calendar Second Day",74,0,0,0,74
62839,25392,2009-04-22,Senate,"Do pass, but re-refer to the Committee on Appropriations Recommend 	Consent",8,0,0,0,8
62839,25393,2009-05-11,Senate,"Special Consent #3 SB824 Committee on Rev. & Tax. (Oropeza",36,0,0,0,36
62839,25394,2009-06-15,Assembly,"Do pass and re-refer to Committee on Appropriations with 	recommendation:  To Consent Calendar",9,0,0,0,9
62839,25395,2009-07-01,Assembly,"Do pass, to Consent Calendar",15,0,0,0,15
62839,25396,2009-07-09,Assembly,"SB 824 REV.& TAX.  Consent Calendar Second Day  Regular Session",74,0,0,0,74
62840,23351,2009-05-12,Senate,"Do pass and be placed on the Consent Calendar",10,0,0,0,10
62840,23352,2009-05-18,Senate,"Consent Calendar 2nd SB825 Committee on G.O. (Florez)",36,0,0,0,36
62840,23353,2009-07-08,Assembly,"Do pass, to Consent Calendar",17,0,0,0,17
62840,23354,2009-07-16,Assembly,"SB 825 G.O.  Consent Calendar Second Day  Regular Session",72,0,0,0,72
62841,25880,2009-04-28,Senate,"Do pass, but re-refer to the Committee on Appropriations Recommend 	Consent",12,0,0,0,12
62841,25881,2009-05-26,Senate,"Do pass",12,0,0,0,12
62841,25882,2009-06-02,Senate,"Special Consent #7 SB826 Committee on G.O. (Florez)",39,0,0,0,39
62841,25883,2009-06-29,Assembly,"Do pass and be re-referred to the Committee on Appropriations",11,0,0,0,11
62841,25884,2009-07-08,Assembly,"Do pass, to Consent Calendar",15,0,0,0,15
62841,25885,2009-09-01,Assembly,"SB 826 G.O.  Senate Third Reading  By EVANS",76,2,0,0,78
62842,22263,2009-05-12,Senate,"Do pass and be placed on the Consent Calendar",10,0,0,0,10
62842,22264,2009-05-18,Senate,"Consent Calendar 2nd SB827 Committee on G.O. (Florez)",36,0,0,0,36
62842,22265,2009-07-08,Assembly,"Do pass, to Consent Calendar",17,0,0,0,17
62842,22266,2009-09-09,Assembly,"Do pass and be re-referred to the Committee on Utilities and 	Commerce",9,0,0,0,9
62842,22267,2009-09-11,Assembly,"Do pass as amended",9,2,0,0,11
62842,22268,2009-09-12,Assembly,"SB 827 Wright  Senate Third Reading",45,21,0,0,66
62842,22269,2009-09-12,Senate,"W/O REF. TO FILE SB827 Wright Concurrence",27,9,0,0,36
62843,4098,2009-04-28,Senate,"Do pass, but re-refer to the Committee on Appropriations Recommend Consent",12,0,0,0,12
62843,4099,2009-05-18,Senate,"Special Consent #5 SB828 Committee on G.O. (Florez)",36,0,3,0,39
62843,4100,2009-07-08,Assembly,"Do pass and re-refer to Committee on Appropriations with recommendation:  To Consent Calendar",17,0,2,0,19
62843,4101,2009-08-19,Assembly,"Do pass, to Consent Calendar",17,0,0,0,17
62844,26023,2009-04-28,Senate,"Do pass as amended, but re-refer to the Committee on 	Appropriations Recommend Consent",12,0,0,0,12
62844,26024,2009-05-26,Senate,"Special Consent #6 SB829 Committee on G.O. (Florez)",39,0,0,0,39
62844,26025,2009-07-08,Assembly,"Do pass and re-refer to Committee on Appropriations with 	recommendation:  To Consent Calendar",17,0,0,0,17
62844,26026,2009-08-19,Assembly,"Do pass, to Consent Calendar",17,0,0,0,17
62844,26027,2009-09-11,Senate,"Unfinished Supp 1 SB829 Committee on G.O. (Wright)",36,0,0,0,36
62844,26028,2009-09-11,Assembly,"SB 829 G.O.  Senate Third Reading  By BLOCK",79,0,0,0,79
62845,5375,2009-04-28,Senate,"Do pass, but re-refer to the Committee on Appropriations Recommend Consent",12,0,0,0,12
62845,5376,2009-05-18,Senate,"Special Consent #5 SB830 Committee on G.O. (Florez)",36,0,3,0,39
62845,5377,2009-07-08,Assembly,"Do pass and re-refer to Committee on Appropriations with recommendation:  To Consent Calendar",17,0,2,0,19
62845,5378,2010-05-28,Assembly,"Be referred to Committee on Public Safety",9,0,2,0,11
62845,8876,2010-06-15,Assembly,"Do pass and re-refer to Committee on Appropriations with recommendation:  To Consent Calendar",7,0,0,0,7
62845,20070,2010-08-12,Assembly,"Do pass",17,0,0,0,17
62845,21355,2010-08-23,Assembly,"SB 830 Wright  Senate Third Reading  By CALDERON",76,0,0,0,76
62845,21356,2010-08-26,Senate,"From committee:  That the Assembly Amendments be concurred in",7,0,0,0,7
62845,21589,2010-08-27,Senate,"Unfinished Business SB830 Wright",35,0,0,0,35
62846,23329,2009-04-28,Senate,"Do pass, but re-refer to the Committee on Appropriations Recommend 	Consent",12,0,0,0,12
62846,23330,2009-05-18,Senate,"Special Consent #5 SB831 Committee on G.O. (Florez)",36,0,0,0,36
62846,23331,2009-07-08,Assembly,"Do pass and re-refer to Committee on Appropriations with 	recommendation:  To Consent Calendar",17,0,0,0,17
62846,23332,2009-08-19,Assembly,"Do pass, to Consent Calendar",17,0,0,0,17
62846,23333,2009-08-27,Assembly,"SB 831 G.O.  Consent Calendar Second Day  Regular Session",74,0,0,0,74
62847,22333,2009-05-04,Senate,"Do pass, but re-refer to the Committee on Appropriations Recommend 	Consent",7,0,0,0,7
62847,22334,2009-05-26,Senate,"Special Consent #6 SB832 Committee on E.Q. (Simitian)",39,0,0,0,39
62847,22335,2009-07-06,Assembly,"Do pass and be re-referred to the Committee on Appropriations",9,0,0,0,9
62847,22336,2009-07-15,Assembly,"Do pass and be re-referred to the Committee on Revenue and Taxation",15,0,0,0,15
62847,22337,2009-08-24,Assembly,"Do pass as amended",9,0,0,0,9
62847,22338,2009-09-11,Assembly,"SB 832 E.Q.  Third Reading Urgency  By SKINNER",76,1,0,0,77
62847,22339,2009-09-12,Senate,"Unfinished Supp 1 SB832 Committee on E.Q. (Simitian)",25,3,0,0,28
62847,22340,2009-09-12,Senate,"Unfinished Supp 1 SB832 Committee on E.Q. (Simitian) Reconsider",39,0,0,0,39
62847,22341,2009-10-14,Senate,"Unfinished Business SB832 Committee on E.Q. (Simitian)",37,0,0,0,37
62848,25464,2009-04-23,Senate,"W/O REF. TO FILE SB833 Committee on N.R. & W. (Steinberg Invoke 	Constitution",36,0,0,0,36
62848,25465,2009-04-28,Senate,"Do pass, but re-refer to the Committee on Appropriations",10,0,0,0,10
62848,25466,2009-05-18,Senate,"Special Consent #5 SB833 Committee on N.R. & W. (Steinberg",36,0,0,0,36
62848,25467,2009-06-22,Assembly,"Do pass as amended and be re-referred to the Committee on Local 	Government",9,0,0,0,9
62848,25468,2009-07-08,Assembly,"Do pass and be re-referred to the Committee on Appropriations to 	Consent Calendar",7,0,0,0,7
62848,25469,2009-08-19,Assembly,"Do pass, to Consent Calendar",17,0,0,0,17
62848,25470,2009-09-08,Assembly,"SB 833 N.R.& W.  Senate Third Reading  By SKINNER",78,0,0,0,78
62848,25471,2009-09-10,Senate,"Unfinished Business SB833 Committee on N.R. & W. (Pavley)",39,0,0,0,39
62849,3322,2010-04-20,Senate,"Do pass, but re-refer to the Committee on Appropriations",7,0,0,0,7
62849,3323,2010-05-03,Senate,"Placed on Appropriations Suspense file",10,0,1,0,11
62849,3324,2010-05-27,Senate,"Do pass as amended",10,0,1,0,11
62849,3325,2010-06-03,Senate,"Special Consent #27 SB834 Florez",36,0,2,0,38
62849,10111,2010-06-29,Assembly,"Do pass and re-refer to Committee on Appropriations with recommendation:  To Consent Calendar",7,0,0,0,7
62849,20205,2010-08-12,Assembly,"Do pass",17,0,0,0,17
62849,21206,2010-08-23,Assembly,"SB 834 Florez  Senate Third Reading  By AMMIANO",77,0,0,0,77
62850,3844,2010-04-13,Senate,"Do pass, but re-refer to the Committee on Rules",5,5,1,0,11
62850,3845,2010-04-22,Senate,"Reconsideration granted",6,0,5,0,11
62850,3846,2010-04-22,Senate,"Do pass, but re-refer to the Committee on Rules",7,1,3,0,11
62850,3847,2010-05-10,Senate,"Placed on Appropriations Suspense file",9,0,2,0,11
62851,4109,2010-03-24,Senate,"Do pass as amended, and re-refer to the Committee on Appropriations",7,2,0,0,9
62851,4110,2010-04-26,Senate,"Placed on Appropriations Suspense file",9,0,2,0,11
62852,1352,2010-04-13,Senate,"Do pass as amended, and re-refer to the Committee on Energy, Utilities and Communications.",3,1,1,0,5
62852,1353,2010-04-20,Senate,"Do pass as amended, and re-refer to the Committee on Appropriations.",8,2,1,0,11
62852,1354,2010-05-17,Senate,"Placed on Appropriations Suspense file.",10,0,1,0,11
62852,1355,2010-05-27,Senate,"Do pass as amended.",7,3,1,0,11
62852,1356,2010-06-02,Senate,"Senate 3rd Reading SB837 Florez",21,11,6,0,38
62852,10074,2010-06-28,Assembly,"Do pass as amended and be re-referred to the Committee on Appropriations",14,1,0,0,15
62852,19353,2010-08-04,Assembly,"Do pass",16,0,0,0,16
62852,20760,2010-08-20,Assembly,"SB 837 Florez  Senate Third Reading  By ARAMBULA  Amend By ARAMBULA 	Set #1",49,26,0,0,75
62853,27293,2010-03-24,Senate,"Do pass as amended, and re-refer to the Committee on Appropriations",9,0,0,0,9
62853,27294,2010-04-12,Senate,"Do pass",10,0,0,0,10
62853,27295,2010-04-15,Senate,"Senate 3rd Reading SB838 Strickland Urgency Clause",35,0,0,0,35
62853,27296,2010-05-04,Assembly,"Do pass and be re-referred to the Committee on Appropriations",19,0,0,0,19
62853,27297,2010-05-12,Assembly,"Do pass, to Consent Calendar",16,0,0,0,16
62853,27298,2010-05-20,Assembly,"SB 838 Strickland  Consent Calendar Second Day  Regular Session",72,0,0,0,72
62853,27299,2010-05-24,Senate,"Unfinished Business SB838 Strickland",30,0,0,0,30
62854,4603,2010-03-23,Senate,"Do pass, but re-refer to the Committee on Appropriations",7,0,0,0,7
62854,4604,2010-04-15,Senate,"Senate 3rd Reading SB839 Runner",36,0,3,0,39
62854,9242,2010-06-22,Assembly,"Do pass and re-refer to Committee on Appropriations with recommendation:  To Consent Calendar",6,0,1,0,7
62854,19680,2010-08-04,Assembly,"Do pass",17,0,0,0,17
62854,20451,2010-08-16,Assembly,"SB 839 Runner  Senate Third Reading  By GILMORE",75,0,0,0,75
62854,20533,2010-08-19,Senate,"Unfinished Business SB839 Runner",34,0,0,0,34
62855,2194,2010-03-23,Senate,"Do pass as amended, and re-refer to the Committee on Appropriations",7,0,0,0,7
62855,2195,2010-05-03,Senate,"Senate 3rd Reading SB840 Yee",29,0,9,0,38
62855,8945,2010-06-15,Assembly,"Do pass as amended and be re-referred to the Committee on Appropriations",5,0,2,0,7
62856,27191,2010-03-03,Senate,"Do pass and be placed on the Consent Calendar",4,0,0,0,4
62856,27192,2010-03-11,Senate,"Consent Calendar 2nd SB841 Committee on L.Gov (Wiggins)",31,0,0,0,31
62856,27193,2010-04-07,Assembly,"Do pass, to Consent Calendar",9,0,0,0,9
62856,27194,2010-04-15,Assembly,"SB 841 L. GOV.  Consent Calendar Second Day  Regular Session",70,0,0,0,70
62857,7728,2010-03-03,Senate,"Do pass and be placed on the Consent Calendar",4,0,1,0,5
62857,7729,2010-03-11,Senate,"Consent Calendar 2nd SB842 Committee on L.Gov (Wiggins)",31,0,8,0,39
62857,7730,2010-04-07,Assembly,"Do pass, to Consent Calendar",9,0,0,0,9
62857,19645,2010-08-09,Assembly,"SB 842 L. GOV.  Senate Third Reading  By SMYTH",78,0,0,0,78
62858,7737,2010-03-03,Senate,"Do pass and be placed on the Consent Calendar",4,0,1,0,5
62858,7738,2010-03-11,Senate,"Consent Calendar 2nd SB843 Committee on L.Gov (Wiggins)",31,0,8,0,39
62858,7739,2010-04-07,Assembly,"Do pass, to Consent Calendar",9,0,0,0,9
62858,19647,2010-08-09,Assembly,"SB 843 L. GOV.  Senate Third Reading  By SMYTH",76,0,0,0,76
62861,5243,2010-04-22,Senate,"Senate 3rd Reading SB846 Committee on B. & F.R. (Ducheny)",24,5,10,0,39
62861,19164,2010-08-03,Assembly,"Do pass and be re-referred to the Committee on Appropriations",4,1,0,0,5
62861,19368,2010-08-04,Assembly,"Do pass",14,3,0,0,17
62861,19970,2010-08-12,Assembly,"SB 846 Correa  Third Reading Urgency  By BUCHANAN",75,4,0,0,79
62861,20436,2010-08-18,Senate,"From committee:  That the Assembly Amendments be concurred in",5,0,0,0,5
62861,20520,2010-08-19,Senate,"Unfinished Business SB846 Correa Urgency Clause",31,1,0,0,32
62862,5221,2010-04-22,Senate,"Senate 3rd Reading SB847 Committee on B. & F.R. (Ducheny)",24,5,10,0,39
62862,20830,2010-08-20,Assembly,"SB 847 B.& F. R.  Senate Third Reading  By TORLAKSON  Amend By 	TORLAKSON  Set #1",49,26,0,0,75
62862,21083,2010-08-25,Assembly,"Do pass as amended",9,0,0,0,9
62862,21766,2010-08-30,Assembly,"Do pass as amended",13,0,0,0,13
62862,21767,2010-08-30,Assembly,"SB 847 Steinberg  Senate Second Reading  By TORLAKSON",77,1,0,0,78
62862,21828,2010-08-31,Senate,"From committee:  That the Assembly Amendments be concurred in",7,4,0,0,11
62862,21829,2010-09-01,Senate,"W/O REF. TO FILE SB847 Steinberg Urgency Clause",28,3,0,0,31
62863,5099,2010-04-22,Senate,"Senate 3rd Reading SB848 Committee on B. & F.R. (Ducheny)",24,5,10,0,39
62863,27365,2010-10-08,Assembly,"SB 848 Hollingsworth  Third Reading Urgency  By BLUMENFIELD",11,34,0,0,45
62864,987,2010-04-22,Senate,"Senate 3rd Reading SB849 Committee on B. & F.R. (Ducheny)",24,5,10,0,39
62864,19354,2010-08-04,Assembly,"Do pass as amended",16,0,0,0,16
62864,20291,2010-08-16,Assembly,"SB 849 Ducheny  Third Reading Urgency  By BLUMENFIELD",71,0,0,0,71
62864,21104,2010-08-25,Senate,"Unfinished Business SB849 Ducheny Urgency Clause",31,0,0,0,31
62865,4455,2010-04-22,Senate,"Senate 3rd Reading SB850 Committee on B. & F.R. (Ducheny)",24,5,10,0,39
62866,5075,2010-04-22,Senate,"Senate 3rd Reading SB851 Committee on B. & F.R. (Ducheny)",24,5,10,0,39
62866,27354,2010-10-08,Assembly,"SB 851 B.& F. R.  Third Reading Urgency  By BLUMENFIELD",54,19,0,0,73
62866,27355,2010-10-08,Senate,"W/O REF. TO FILE SB851 Committee on B. & F.R. (Ducheny) Urgency 	Clause",27,8,0,0,35
62867,4792,2010-04-22,Senate,"Senate 3rd Reading SB852 Committee on B. & F.R. (Ducheny)",24,5,10,0,39
62868,4776,2010-04-22,Senate,"Senate 3rd Reading SB853 Committee on B. & F.R. (Ducheny)",24,5,10,0,39
62868,27336,2010-10-08,Assembly,"SB 853 B.& F. R.  Senate Third Reading  Amend By GAINES  Set #2 	Motion to  Lay on the Table  By CALDERON",46,26,0,0,72
62868,27337,2010-10-08,Assembly,"SB 853 B.& F. R.  Senate Third Reading  Amend By LOGUE  Set #3 	Motion to  Lay on the Table  By CALDERON",48,26,0,0,74
62868,27338,2010-10-08,Assembly,"SB 853 B.& F. R.  Senate Third Reading  Amend By KNIGHT  Set #4 	Motion to  Lay on the Table  By CALDERON",47,26,0,0,73
62868,27339,2010-10-08,Assembly,"SB 853  Third Reading Urgency  By BLUMENFIELD",58,15,0,0,73
62868,27340,2010-10-08,Senate,"W/O REF. TO FILE SB853 Committee on B. & F.R. (Ducheny) Urgency 	Clause",27,7,0,0,34
62869,5119,2010-04-22,Senate,"Senate 3rd Reading SB854 Committee on B. & F.R. (Ducheny)",24,5,10,0,39
62869,27369,2010-10-07,Assembly,"SB 854 B.& F. R.  Third Reading Urgency  By BLUMENFIELD",63,10,0,0,73
62869,27370,2010-10-08,Senate,"W/O REF. TO FILE SB854 Committee on B. & F.R. (Ducheny) Urgency 	Clause",12,18,0,0,30
62870,4728,2010-04-22,Senate,"Senate 3rd Reading SB855 Committee on B. & F.R. (Ducheny)",24,5,10,0,39
62870,27331,2010-10-07,Assembly,"SB 855 B.& F. R.  Third Reading Urgency  By BLUMENFIELD",54,21,0,0,75
62870,27332,2010-10-07,Senate,"W/O REF. TO FILE SB855 Committee on B. & F.R. (Ducheny) Urgency 	Clause",27,4,0,0,31
62871,5089,2010-04-22,Senate,"Senate 3rd Reading SB856 Committee on B. & F.R. (Ducheny)",24,5,10,0,39
62871,27361,2010-10-07,Assembly,"SB 856 B.& F. R.  Third Reading Urgency  By BLUMENFIELD  Formerly 	Item 19",41,24,0,0,65
62871,27362,2010-10-07,Assembly,"SB 856 B.& F. R.  Third Reading Urgency  By BLUMENFIELD",61,8,0,0,69
62871,27363,2010-10-07,Senate,"W/O REF. TO FILE SB856 Committee on B. & F.R. (Ducheny) Urgency 	Clause",31,2,0,0,33
62872,5098,2010-04-22,Senate,"Senate 3rd Reading SB857 Committee on B. & F.R. (Ducheny)",24,5,10,0,39
62872,27357,2010-10-07,Assembly,"SB 857 B.& F. R.  Third Reading Urgency  By BLUMENFIELD  Formerly 	Item 20",56,18,0,0,74
62872,27358,2010-10-08,Senate,"W/O REF. TO FILE SB857 Committee on B. & F.R. (Ducheny) Urgency 	Clause",27,9,0,0,36
62873,5111,2010-04-22,Senate,"Senate 3rd Reading SB858 Committee on B. & F.R. (Ducheny)",24,5,10,0,39
62873,27367,2010-10-07,Assembly,"SB 858 B.& F. R.  Third Reading Urgency  By BLUMENFIELD",60,13,0,0,73
62873,27368,2010-10-08,Senate,"W/O REF. TO FILE SB858 Committee on B. & F.R. (Ducheny) Urgency 	Clause",27,7,0,0,34
62874,4783,2010-04-22,Senate,"Senate 3rd Reading SB859 Committee on B. & F.R. (Ducheny)",24,5,10,0,39
62875,4900,2010-04-22,Senate,"Senate 3rd Reading SB860 Committee on B. & F.R. (Ducheny)",24,5,10,0,39
62876,5067,2010-04-22,Senate,"Senate 3rd Reading SB861 Committee on B. & F.R. (Ducheny)",24,5,10,0,39
62877,5279,2010-04-22,Senate,"Senate 3rd Reading SB862 Committee on B. & F.R. (Ducheny)",24,5,10,0,39
62878,4913,2010-04-22,Senate,"Senate 3rd Reading SB863 Committee on B. & F.R. (Ducheny)",24,5,10,0,39
62878,27345,2010-10-08,Assembly,"SB 863 B.& F. R.  Third Reading Urgency  By BLUMENFIELD  Formerly 	item 26",58,8,0,0,66
62878,27346,2010-10-08,Senate,"W/O REF. TO FILE SB863 Committee on B. & F.R. (Ducheny) Urgency 	Clause",28,5,0,0,33
62879,5088,2010-04-22,Senate,"Senate 3rd Reading SB864 Committee on B. & F.R. (Ducheny)",24,5,10,0,39
62880,5090,2010-04-22,Senate,"Senate 3rd Reading SB865 Committee on B. & F.R. (Ducheny)",24,5,10,0,39
62881,4566,2010-04-22,Senate,"Senate 3rd Reading SB866 Committee on B. & F.R. (Ducheny)",24,5,10,0,39
62881,22229,2010-10-07,Assembly,"SB 866 B.& F. R.  Third Reading Urgency  By BLUMENFIELD",57,18,0,0,75
62881,22230,2010-10-07,Assembly,"SB 866 B.& F. R.  Third Reading Urgency  Amend By BLUMENFIELD  Set 	#1",43,25,0,0,68
62881,22231,2010-10-08,Senate,"W/O REF. TO FILE SB866 Committee on B. & F.R. (Ducheny) Urgency 	Clause",29,4,0,0,33
62882,5020,2010-04-22,Senate,"Senate 3rd Reading SB867 Committee on B. & F.R. (Ducheny)",24,5,10,0,39
62882,27350,2010-10-07,Assembly,"SB 867 Hollingsworth  Third Reading Urgency  By BLUMENFIELD",67,5,0,0,72
62882,27351,2010-10-07,Senate,"W/O REF. TO FILE SB867 Hollingsworth Urgency Clause",35,0,0,0,35
62883,4974,2010-04-22,Senate,"Senate 3rd Reading SB868 Committee on B. & F.R. (Ducheny)",24,5,10,0,39
62884,4201,2010-04-22,Senate,"Senate 3rd Reading SB869 Committee on B. & F.R. (Ducheny)",24,5,10,0,39
62885,4775,2010-04-22,Senate,"Senate 3rd Reading SB870 Committee on B. & F.R. (Ducheny)",24,5,10,0,39
62885,27334,2010-10-07,Assembly,"SB 870 Ducheny  Third Reading Urgency  By BLUMENFIELD",57,13,0,0,70
62885,27335,2010-10-08,Senate,"W/O REF. TO FILE SB870 Committee on B. & F.R. (Ducheny) Urgency 	Clause",27,9,0,0,36
62886,4966,2010-04-22,Senate,"Senate 3rd Reading SB871 Committee on B. & F.R. (Ducheny)",24,5,10,0,39
62886,27347,2010-10-08,Assembly,"SB 871 Hollingsworth  Third Reading Urgency  By GARRICK",14,14,0,0,28
62887,4283,2010-04-22,Senate,,0,0,10,0,10
62888,5143,2010-04-22,Senate,"Senate 3rd Reading SB873 Committee on B. & F.R. (Ducheny)",24,5,10,0,39
62888,21985,2010-08-31,Assembly,"SB 873 Hollingsworth  Third Reading Urgency  By NIELSEN",25,50,0,0,75
62892,4972,2010-05-04,Senate,"Do pass and be placed on the Consent Calendar",4,0,1,0,5
62892,4973,2010-05-13,Senate,"Consent Calendar 2nd SB877 Harman",31,0,7,0,38
62892,10095,2010-06-29,Assembly,"Do pass as amended, to Consent Calendar",10,0,0,0,10
62892,20852,2010-08-23,Assembly,"SB 877 Harman  Senate Third Reading  By TRAN",76,0,0,0,76
62892,21500,2010-08-26,Senate,"Unfinished Business SB877 Harman",37,0,0,0,37
62893,1307,2010-05-04,Senate,"Do pass as amended.",4,0,1,0,5
62893,1308,2010-06-01,Senate,"Senate 3rd Reading SB878 Liu",25,7,6,0,38
62893,9050,2010-06-16,Assembly,"Do pass",7,2,0,0,9
62893,9389,2010-06-24,Assembly,"SB 878 Liu  Senate Third Reading  By DAVIS",54,18,7,0,79
62893,9625,2010-06-28,Senate,"Unfinished Business SB878 Liu",28,5,6,0,39
62894,2750,2010-04-19,Senate,"Do pass as amended, and re-refer to the Committee on Appropriations",3,2,0,0,5
62894,2751,2010-05-10,Senate,"Do pass",6,3,2,0,11
62894,2752,2010-06-01,Senate,"Senate 3rd Reading SB879 Cox",24,8,6,0,38
62894,9066,2010-06-16,Assembly,"Do pass and be re-referred to the Committee on Appropriations",6,3,0,0,9
62894,20075,2010-08-12,Assembly,"Do pass as amended",17,0,0,0,17
62894,20421,2010-08-18,Assembly,"SB 879  Senate Third Reading",62,6,0,0,68
62894,21522,2010-08-25,Senate,"Unfinished Business SB879 Cox",30,0,0,0,30
62895,1961,2010-04-14,Senate,"Do pass as amended, and re-refer to the Committee on Appropriations",6,2,1,0,9
62895,1962,2010-06-01,Senate,"Senate 3rd Reading SB880 Yee",21,13,4,0,38
62895,9405,2010-06-22,Assembly,"Do pass and be re-referred to the Committee on Judiciary",14,4,1,0,19
62895,9729,2010-06-29,Assembly,"Do pass as amended and be re-referred to the Committee on Appropriations",7,2,1,0,10
62895,19315,2010-08-04,Assembly,"Do pass",12,5,0,0,17
62895,20755,2010-08-19,Assembly,"SB 880 Yee  Senate Third Reading  By JONES",51,25,0,0,76
62895,21229,2010-08-25,Senate,"Unfinished Business SB880 Yee",23,11,0,0,34
62897,705,2010-04-19,Senate,"Do pass, but re-refer to the Committee on Appropriations.",5,2,2,0,9
62897,706,2010-05-05,Senate,"Do pass as amended, and re-refer to the Committee on Appropriations.",9,0,0,0,9
62897,707,2010-05-28,Senate,"Senate 3rd Reading SB882 Corbett Urgency Clause",28,0,10,0,38
62897,9270,2010-06-23,Assembly,"Do pass and be re-referred to the Committee on Appropriations",21,0,1,0,22
62897,19709,2010-08-04,Assembly,"Do pass, to Consent Calendar",17,0,0,0,17
62897,19917,2010-08-12,Assembly,"SB 882 Corbett  Consent Calendar Second Day  Regular Session",78,0,0,0,78
62897,20759,2010-08-19,Senate,"Unfinished Business SB882 Corbett Urgency Clause",35,0,0,0,35
62899,10151,2010-07-01,Senate,"Do pass as amended, and re-refer to the Committee on Appropriations",5,0,0,0,5
62899,19620,2010-08-09,Senate,"Senate 3rd Reading SB884 Ashburn Urgency Clause",33,0,0,0,33
62900,2988,2010-03-23,Senate,"Do pass",3,2,0,0,5
62900,2989,2010-06-03,Senate,"Senate 3rd Reading SB885 Corbett",21,12,5,0,38
62900,10155,2010-06-29,Assembly,"Do pass as amended",6,4,1,0,11
62900,20861,2010-08-23,Assembly,"SB 885 Corbett  Senate Third Reading  By ENG",50,26,0,0,76
62900,21117,2010-08-25,Senate,"Unfinished Business SB885 Corbett",25,8,0,0,33
62901,651,2010-03-23,Senate,"Do pass, but re-refer to the Committee on Appropriations.",4,0,1,0,5
62901,652,2010-04-22,Senate,"Senate 3rd Reading SB886 Florez",28,1,10,0,39
62901,9030,2010-06-15,Assembly,"Do pass as amended and be re-referred to the Committee on Appropriations",4,1,1,0,6
62902,5010,2010-04-13,Senate,"Do pass, but re-refer to the Committee on Appropriations",4,5,2,0,11
62902,5011,2010-04-22,Senate,"Reconsideration granted",6,0,5,0,11
62902,5012,2010-04-22,Senate,"Do pass, but re-refer to the Committee on Appropriations",4,3,4,0,11
62903,1232,2010-04-21,Senate,"Do pass as amended, and re-refer to the Committee on Appropriations.",5,0,4,0,9
62903,1233,2010-05-24,Senate,"Senate 3rd Reading SB888 Yee",32,0,6,0,38
62903,8758,2010-06-15,Assembly,"Do pass as amended and be re-referred to the Committee on Appropriations",18,0,1,0,19
62903,19550,2010-08-04,Assembly,"Do pass, to Consent Calendar",17,0,0,0,17
62903,19959,2010-08-12,Assembly,"SB 888 Yee  Consent Calendar Second Day  Regular Session",78,0,0,0,78
62903,20727,2010-08-19,Senate,"Unfinished Business SB888 Yee",35,0,0,0,35
62904,5212,2010-03-23,Senate,"Do pass, but re-refer to the Committee on Appropriations",7,1,1,0,9
62904,5213,2010-05-03,Senate,"Do pass",8,0,3,0,11
62904,5214,2010-05-10,Senate,"Senate 3rd Reading SB889 Aanestad Urgency Clause",28,1,9,0,38
62904,8746,2010-06-15,Assembly,"Do pass and be re-referred to the Committee on Appropriations",4,6,2,0,12
62905,3287,2010-04-21,Senate,"Do pass as amended, and re-refer to the Committee on Appropriations",5,0,4,0,9
62905,3288,2010-05-24,Senate,"Placed on Appropriations Suspense file",10,0,1,0,11
62905,3289,2010-05-27,Senate,"Do pass",7,2,2,0,11
62905,3290,2010-06-01,Senate,"Senate 3rd Reading SB890 Alquist",23,11,4,0,38
62905,10010,2010-06-29,Assembly,"Do pass as amended and be re-referred to the Committee on Appropriations",13,6,0,0,19
62905,20162,2010-08-12,Assembly,"Do pass as amended",12,5,0,0,17
62905,21352,2010-08-26,Assembly,"Do pass",12,4,0,0,16
62905,21682,2010-08-30,Assembly,"SB 890 Alquist  Senate Third Reading  By MONNING",51,27,0,0,78
62905,21820,2010-08-31,Senate,"From committee:  That the Assembly Amendments be concurred in",6,2,0,0,8
62905,21821,2010-08-31,Senate,"W/O REF. TO FILE SB890 Alquist Concurrence",22,11,0,0,33
62906,3617,2010-04-13,Senate,"Do pass, but re-refer to the Committee on Appropriations",3,1,1,0,5
62906,3618,2010-05-24,Senate,"Placed on Appropriations Suspense file",10,0,1,0,11
62907,2698,2010-04-20,Senate,"Do pass as amended, and re-refer to the Committee on Appropriations",5,0,2,0,7
62907,2699,2010-05-17,Senate,"Special Consent #24 SB892 Alquist",33,0,5,0,38
62907,8814,2010-06-15,Assembly,"Do pass and be re-referred to the Committee on Public Safety",5,0,1,0,6
62907,10162,2010-06-29,Assembly,"Do pass and be re-referred to the Committee on Appropriations",7,0,0,0,7
62909,2778,2010-04-19,Senate,"Do pass, but re-refer to the Committee on Appropriations Recommend Consent",5,0,0,0,5
62909,2779,2010-05-10,Senate,"Consent Calendar 2nd SB894 Committee on L.Gov (Wiggins)",30,0,8,0,38
62909,10202,2010-06-30,Assembly,"Do pass and be re-referred to the Committee on Appropriations to Consent Calendar",9,0,0,0,9
62909,19345,2010-08-04,Assembly,"Do pass, to Consent Calendar",17,0,0,0,17
62909,19981,2010-08-12,Assembly,"SB 894 L. GOV.  Consent Calendar Second Day  Regular Session",78,0,0,0,78
62909,20742,2010-08-19,Senate,"Unfinished Business SB894 Committee on L.Gov (Kehoe)",35,0,0,0,35
62910,2350,2010-04-13,Senate,"Do pass, but re-refer to the Committee on Appropriations",7,0,0,0,7
62910,2351,2010-05-03,Senate,"Special Consent #22 SB895 Huff",34,0,4,0,38
62910,8947,2010-06-15,Assembly,"Do pass and re-refer to Committee on Appropriations with recommendation:  To Consent Calendar",7,0,0,0,7
62910,8948,2010-06-17,Assembly,"Do pass",14,0,3,0,17
62910,9087,2010-06-21,Assembly,"SB 895 Huff  Third Reading Urgency  By CONWAY",76,0,3,0,79
62913,1055,2010-03-24,Senate,"Do pass, but re-refer to the Committee on Appropriations Recommend Consent.",7,0,2,0,9
62913,1056,2010-05-10,Senate,"Placed on Appropriations Suspense file.",9,0,2,0,11
62914,286,2010-04-27,Senate,"Do pass.",7,0,4,0,11
62914,287,2010-04-29,Senate,"Senate 3rd Reading SB899 Denham",34,0,4,0,38
62914,8898,2010-06-16,Assembly,"Do pass",21,0,1,0,22
62914,20142,2010-08-12,Assembly,"SB 899 Denham  Third Reading Urgency  By ANDERSON",76,0,0,0,76
62914,20762,2010-08-19,Senate,"Unfinished Business SB899 Denham Urgency Clause",35,0,0,0,35
62915,1407,2010-04-21,Senate,"Do pass, but re-refer to the Committee on Appropriations",5,0,4,0,9
62915,1408,2010-05-17,Senate,"Placed on Appropriations Suspense file",10,0,1,0,11
62915,1409,2010-05-27,Senate,"Do pass",7,2,2,0,11
62915,1410,2010-06-01,Senate,"Senate 3rd Reading SB900 Alquist",21,12,5,0,38
62915,10312,2010-06-29,Assembly,"Do pass and be re-referred to the Committee on Appropriations",13,6,0,0,19
62915,20236,2010-08-12,Assembly,"Do pass as amended",12,5,0,0,17
62915,20522,2010-08-19,Assembly,"SB 900 Alquist  Senate Third Reading  By MONNING  Amend By MONNING 	Set #1",50,26,0,0,76
62915,20655,2010-08-20,Assembly,"SB 900 Alquist  Senate Third Reading  By MONNING",49,25,0,0,74
62915,20969,2010-08-24,Senate,"Unfinished Business SB900 Alquist",22,13,0,0,35
62917,4935,2010-04-07,Senate,"Do pass",5,0,0,0,5
62917,4936,2010-04-22,Senate,"Senate 3rd Reading SB902 Ashburn",31,0,8,0,39
62917,9284,2010-06-16,Assembly,"Do pass, to Consent Calendar",9,0,0,0,9
62917,9381,2010-06-24,Assembly,"SB 902 Ashburn  Consent Calendar Second Day  Regular Session",73,0,6,0,79
62918,1006,2010-04-19,Senate,"Do pass, but re-refer to the Committee on Appropriations.",4,2,0,0,6
62918,1007,2010-05-10,Senate,"Senate 3rd Reading SB903 Wright",21,10,7,0,38
62918,9466,2010-06-23,Assembly,"Do pass and be re-referred to the Committee on Appropriations",5,0,1,0,6
62918,19388,2010-08-04,Assembly,"Do pass",12,5,0,0,17
62918,20478,2010-08-16,Assembly,"SB 903 Wright  Senate Third Reading",51,23,0,0,74
62918,20569,2010-08-19,Senate,"Unfinished Business SB903 Wright",24,11,0,0,35
62919,2727,2010-03-23,Senate,"Do pass as amended, and re-refer to the Committee on Appropriations",9,0,0,0,9
62919,2728,2010-04-26,Senate,"Do pass",9,0,2,0,11
62919,2729,2010-05-03,Senate,"Special Consent #22 SB904 Hollingsworth",34,0,4,0,38
62919,8960,2010-06-15,Assembly,"Do pass as amended and be re-referred to the Committee on Appropriations",5,6,1,0,12
62919,8961,2010-06-15,Assembly,"Set first hearing.  Failed passage.  Reconsideration granted",11,0,1,0,12
62919,9854,2010-06-29,Assembly,"Do pass and be re-referred to the Committee on Appropriations",6,6,1,0,13
62921,154,2010-03-23,Senate,"Do pass.",3,2,0,0,5
62921,155,2010-05-27,Senate,"Senate 3rd Reading SB906 Leno",23,11,4,0,38
62921,9201,2010-06-22,Assembly,"Do pass as amended",6,3,1,0,10
62921,20693,2010-08-19,Assembly,"SB 906 Leno  Senate Third Reading  By ARAMBULA",51,26,0,0,77
62921,21270,2010-08-25,Senate,"Unfinished Business SB906 Leno",23,11,0,0,34
62922,3720,2010-03-23,Senate,"Do pass as amended, and re-refer to the Committee on Appropriations",7,2,2,0,11
62922,3721,2010-04-26,Senate,"Placed on Appropriations Suspense file",9,0,2,0,11
62924,403,2010-05-04,Senate,"Do pass as amended.",4,0,1,0,5
62924,404,2010-05-28,Senate,"Senate 3rd Reading SB909 Wright",22,7,9,0,38
62924,10016,2010-06-29,Assembly,"Do pass as amended",7,0,3,0,10
62924,20445,2010-08-16,Assembly,"SB 909 Wright  Senate Third Reading  By RUSKIN",73,1,0,0,74
62924,20530,2010-08-19,Senate,"Unfinished Business SB909 Wright",24,10,0,0,34
62925,2306,2010-05-24,Senate,"Do pass",10,0,1,0,11
62925,2307,2010-05-28,Senate,"Senate 3rd Reading SB910 Kehoe Urgency Clause",28,2,8,0,38
62925,19352,2010-08-04,Assembly,"Do pass",16,0,0,0,16
62925,20492,2010-08-16,Assembly,"SB 910 Kehoe  Third Reading Urgency  By FUENTES",74,0,0,0,74
62925,20587,2010-08-19,Senate,"Unfinished Business SB910 Kehoe Urgency Clause",34,1,0,0,35
62926,1751,2010-04-26,Senate,"Do pass",8,1,2,0,11
62926,1752,2010-04-29,Senate,"Senate 3rd Reading SB911 Kehoe Urgency Clause",29,4,5,0,38
62926,1753,2010-05-28,Assembly,"Do pass",17,0,0,0,17
62926,1754,2010-06-02,Assembly,"SB 911 Kehoe  Third Reading Urgency  By FUENTES",76,0,3,0,79
62932,8322,2010-04-21,Senate,"Do pass, but re-refer to the Committee on Appropriations",2,2,5,0,9
62932,8323,2010-04-21,Senate,"Set, second hearing.  Failed passage in Committee. Reconsideration granted",8,0,1,0,9
62933,932,2010-03-24,Senate,"Do pass, but re-refer to the Committee on Environmental Quality.",6,3,0,0,9
62933,933,2010-04-19,Senate,"Do pass as amended, and re-refer to the Committee on Appropriations.",6,0,1,0,7
62933,934,2010-05-10,Senate,"Placed on Appropriations Suspense file.",9,0,2,0,11
62933,935,2010-05-27,Senate,"Do pass as amended.",7,3,1,0,11
62933,936,2010-06-02,Senate,"Senate 3rd Reading SB918 Pavley",24,12,2,0,38
62933,8840,2010-06-15,Assembly,"Do pass and be re-referred to the Committee on Water, Parks and Wildlife",7,0,2,0,9
62933,10195,2010-06-29,Assembly,"Do pass and be re-referred to the Committee on Appropriations",10,2,1,0,13
62933,20155,2010-08-12,Assembly,"Do pass as amended",12,5,0,0,17
62933,21228,2010-08-25,Assembly,"SB 918 Pavley  Senate Third Reading  By DE LA TORRE",54,21,0,0,75
62933,21426,2010-08-26,Senate,"Unfinished Business SB918 Pavley",25,12,0,0,37
62934,9072,2010-06-14,Senate,"Do pass, but re-refer to the Committee on Appropriations",1,4,1,0,6
62934,9073,2010-06-14,Senate,"Set, second hearing.  Failed passage in Committee. Reconsideration granted",5,0,1,0,6
62935,640,2010-04-20,Senate,"Do pass as amended, and re-refer to the Committee on Appropriations.",6,4,1,0,11
62935,641,2010-05-24,Senate,"Do pass as amended.",6,4,1,0,11
62935,642,2010-06-03,Senate,"Senate 3rd Reading SB920 Yee",12,18,8,0,38
62935,643,2010-06-03,Senate,"Senate 3rd Reading SB920 Yee Reconsider",36,0,2,0,38
62943,2192,2010-04-05,Senate,"Do pass",4,1,2,0,7
62943,2193,2010-04-08,Senate,"Senate 3rd Reading SB928 Simitian",21,12,6,0,39
62943,10231,2010-06-29,Assembly,"Do pass as amended and be re-referred to the Committee on Appropriations",5,3,1,0,9
62944,1385,2010-04-19,Senate,"Do pass as amended",4,0,3,0,7
62944,1386,2010-04-26,Senate,"Senate 3rd Reading SB929 Pavley",26,10,3,0,39
62944,10368,2010-06-29,Assembly,"Do pass as amended",6,1,2,0,9
62944,19955,2010-08-12,Assembly,"Do pass as amended",12,5,0,0,17
62944,20527,2010-08-19,Assembly,"SB 929 Pavley  Senate Third Reading  By BROWNLEY",52,24,0,0,76
62944,21079,2010-08-25,Senate,"Unfinished Business SB929 Pavley",23,11,0,0,34
62945,855,2010-04-14,Senate,"Do pass as amended, and re-refer to the Committee on Appropriations.",6,2,1,0,9
62945,856,2010-05-17,Senate,"Placed on Appropriations Suspense file.",10,0,1,0,11
62945,857,2010-05-27,Senate,"Do pass as amended.",7,3,1,0,11
62945,858,2010-06-02,Senate,"Senate 3rd Reading SB930 Ducheny",23,13,2,0,38
62945,10105,2010-06-30,Assembly,"Do pass as amended and be re-referred to the Committee on Appropriations",6,1,2,0,9
62945,20176,2010-08-12,Assembly,"Do pass as amended",12,5,0,0,17
62945,20802,2010-08-23,Assembly,"SB 930 Ducheny  Senate Third Reading  By COTO",48,26,0,0,74
62945,21273,2010-08-25,Senate,"Unfinished Business SB930 Ducheny",23,11,0,0,34
62946,1913,2010-04-07,Senate,"Do pass, but re-refer to the Committee on Judiciary Recommend Consent",11,0,0,0,11
62946,1914,2010-05-04,Senate,"Do pass",4,0,1,0,5
62946,1915,2010-05-10,Senate,"Senate 3rd Reading SB931 Ducheny",31,0,7,0,38
62946,9302,2010-06-21,Assembly,"Do pass and be re-referred to the Committee on Judiciary",11,0,1,0,12
62946,10128,2010-06-29,Assembly,"Do pass",10,0,0,0,10
62946,20308,2010-08-16,Assembly,"SB 931 Ducheny  Senate Third Reading  By SALAS",73,0,0,0,73
62946,20588,2010-08-19,Senate,"Unfinished Business SB931 Ducheny",35,0,0,0,35
62948,3148,2010-04-27,Senate,"Do pass as amended",3,1,1,0,5
62948,3149,2010-06-03,Senate,"Senate 3rd Reading SB933 Oropeza",22,9,7,0,38
62948,9919,2010-06-29,Assembly,"Do pass",7,1,2,0,10
62948,20406,2010-08-12,Assembly,"SB 933 Oropeza  Senate Third Reading  By MA  Amend By TRAN  Set #1 	Motion to  Lay on the Table  By CALDERON",46,27,0,0,73
62948,20407,2010-08-12,Assembly,"SB 933 Oropeza  Senate Third Reading  By MA  Amend By ADAMS  Set #2 	Motion to  Lay on the Table  By CALDERON",42,34,0,0,76
62948,20408,2010-08-12,Assembly,"SB 933 Oropeza  Senate Third Reading  By MA",45,24,0,0,69
62953,1973,2010-04-13,Senate,"Do pass, but re-refer to the Committee on Appropriations",6,0,1,0,7
62953,1974,2010-05-03,Senate,"Special Consent #22 SB938 Huff",34,0,4,0,38
62953,8757,2010-06-14,Assembly,"Do pass and re-refer to Committee on Appropriations with recommendation:  To Consent Calendar",12,0,2,0,14
62953,20339,2010-08-12,Assembly,"Do pass as amended",17,0,0,0,17
62953,20470,2010-08-18,Assembly,"SB 938 Huff  Senate Third Reading  By MILLER",75,0,0,0,75
62953,21335,2010-08-26,Senate,"Special Consent #32 SB938 Huff",34,0,0,0,34
62957,3906,2010-04-13,Senate,"Do pass, but re-refer to the Committee on Appropriations",7,1,3,0,11
62957,3907,2010-04-26,Senate,"Placed on Appropriations Suspense file",9,0,2,0,11
62959,4545,2010-03-24,Senate,"Do pass",7,0,2,0,9
62959,4546,2010-04-08,Senate,"Senate 3rd Reading SB944 Runner",34,0,5,0,39
62959,9049,2010-06-16,Assembly,"Do pass as amended",5,1,3,0,9
62959,9577,2010-06-28,Assembly,"SB 944 Runner  Senate Third Reading  By STRICKLAND",66,0,13,0,79
62959,10041,2010-07-01,Senate,"Unfinished Business SB944 Runner",32,0,7,0,39
62960,136,2010-04-13,Senate,"Do pass, but re-refer to the Committee on Public Safety.",4,0,1,0,5
62960,137,2010-04-20,Senate,"Do pass, but re-refer to the Committee on Appropriations.",7,0,0,0,7
62960,138,2010-05-03,Senate,"Do pass.",9,0,2,0,11
62960,139,2010-05-10,Senate,"Special Consent #23 SB945 Liu",30,0,8,0,38
62960,8895,2010-06-15,Assembly,"Do pass and be re-referred to the Committee on Appropriations",5,0,1,0,6
62960,9892,2010-06-30,Assembly,"Do pass",15,1,1,0,17
62960,21396,2010-08-26,Assembly,"SB 945 Liu  Senate Third Reading  By JONES",72,2,0,0,74
62960,21604,2010-08-27,Senate,"Unfinished Business SB945 Liu",34,0,0,0,34
62962,3519,2010-04-13,Senate,"Do pass, but re-refer to the Committee on Appropriations",4,0,1,0,5
62962,3520,2010-05-03,Senate,"Special Consent #22 SB947 Wiggins",34,0,4,0,38
62962,9538,2010-06-24,Assembly,"Be referred to Committee on Utilities and Commerce",6,4,1,0,11
62962,9667,2010-06-28,Assembly,"Do pass as amended and be re-referred to the Committee on Appropriations",3,7,5,0,15
62964,3115,2010-05-04,Senate,"Do pass as amended",8,0,1,0,9
62964,3116,2010-05-28,Senate,"Senate 3rd Reading SB949 Oropeza",28,0,10,0,38
62964,9856,2010-06-28,Assembly,"Do pass as amended",11,0,3,0,14
62964,21473,2010-08-26,Assembly,"SB 949 Oropeza  Senate Third Reading  By BLOCK",69,0,0,0,69
62964,21557,2010-08-27,Senate,"Unfinished Business SB949 Oropeza",33,0,0,0,33
62965,5282,2010-04-13,Senate,"Do pass, but re-refer to the Committee on Judiciary",4,0,1,0,5
62965,5283,2010-04-20,Senate,"Do pass, but re-refer to the Committee on Appropriations Recommend Consent",4,0,1,0,5
62965,5284,2010-05-10,Senate,"Consent Calendar 2nd SB950 Wiggins",30,0,8,0,38
62965,8860,2010-06-15,Assembly,"Do pass and be re-referred to the Committee on Judiciary to Consent Calendar",9,0,0,0,9
62965,9138,2010-06-22,Assembly,"Do pass as amended and re-refer to Committee on Appropriations with recommendation:  To Consent Calendar",10,0,0,0,10
62965,19594,2010-08-04,Assembly,"Do pass, to Consent Calendar",17,0,0,0,17
62965,19902,2010-08-12,Assembly,"SB 950 Wiggins  Consent Calendar Second Day  Regular Session",78,0,0,0,78
62965,20757,2010-08-19,Senate,"Unfinished Business SB950 Wiggins",35,0,0,0,35
62966,721,2010-03-23,Senate,"Do pass, but re-refer to the Committee on Appropriations.",7,1,1,0,9
62966,722,2010-04-26,Senate,"Do pass.",8,1,2,0,11
62966,723,2010-04-29,Senate,"Senate 3rd Reading SB951 Correa",24,8,6,0,38
62966,9816,2010-06-30,Assembly,"Do pass as amended and be re-referred to the Committee on Appropriations",9,0,0,0,9
62966,19919,2010-08-12,Assembly,"Do pass",17,0,0,0,17
62966,21262,2010-08-23,Assembly,"SB 951 Correa  Senate Third Reading  By TORRES",76,0,0,0,76
62966,21263,2010-08-25,Senate,"Unfinished Business SB951 Correa",24,7,0,0,31
62968,807,2010-04-05,Senate,"Do pass, but re-refer to the Committee on Judiciary.",7,0,2,0,9
62968,808,2010-05-04,Senate,"Do pass as amended.",4,0,1,0,5
62968,809,2010-05-24,Senate,"Senate 3rd Reading SB953 Walters",32,0,6,0,38
62968,8741,2010-06-15,Assembly,"Do pass and be re-referred to the Committee on Judiciary",11,0,0,0,11
62968,9365,2010-06-22,Assembly,"Do pass, to Consent Calendar",10,0,0,0,10
62968,9606,2010-06-28,Assembly,"SB 953 Walters  Consent Calendar Second Day",73,0,6,0,79
62970,757,2010-04-21,Senate,"Do pass as amended.",5,4,0,0,9
62971,3309,2010-03-10,Senate,"Do pass as amended, and re-refer to the Committee on Education",4,1,1,0,6
62971,3310,2010-04-14,Senate,"Do pass as amended, and re-refer to the Committee on Appropriations",5,2,2,0,9
62971,3311,2010-05-03,Senate,"Placed on Appropriations Suspense file",10,0,1,0,11
62971,3312,2010-05-27,Senate,"Do pass as amended",7,3,1,0,11
62971,3313,2010-06-02,Senate,"Senate 3rd Reading SB956 Romero",21,13,4,0,38
62972,195,2010-03-24,Senate,"Do pass as amended, and re-refer to the Committee on Appropriations.",6,0,3,0,9
62972,196,2010-04-26,Senate,"Do pass as amended.",8,1,2,0,11
62972,197,2010-05-27,Senate,"Senate 3rd Reading SB957 Price",26,3,9,0,38
62972,9354,2010-06-22,Assembly,"Do pass as amended and be re-referred to the Committee on Appropriations",9,0,0,0,9
62972,19572,2010-08-04,Assembly,"Do pass, to Consent Calendar",17,0,0,0,17
62972,19984,2010-08-12,Assembly,"SB 957 Price  Consent Calendar Second Day  Regular Session",78,0,0,0,78
62972,21601,2010-08-26,Senate,"Unfinished Business SB957 Price",32,0,0,0,32
62973,4435,2010-03-23,Senate,"Do pass as amended, but re-refer to the Committee on Appropriations Recommend Consent",8,0,1,0,9
62973,4436,2010-04-15,Senate,"Consent Calendar 2nd SB958 Lowenthal",35,0,4,0,39
62973,8812,2010-06-16,Assembly,"Do pass and be re-referred to the Committee on Appropriations",9,0,0,0,9
62973,10225,2010-06-30,Assembly,"Do pass, to Consent Calendar",17,0,0,0,17
62974,2566,2010-04-07,Senate,"Do pass as amended, and re-refer to the Committee on Environmental Quality",5,0,0,0,5
62974,2567,2010-04-19,Senate,"Do pass as amended, and re-refer to the Committee on Appropriations",7,0,0,0,7
62974,2568,2010-05-03,Senate,"Placed on Appropriations Suspense file",10,0,1,0,11
62974,2569,2010-05-27,Senate,"Do pass as amended",7,3,1,0,11
62974,2570,2010-06-02,Senate,"Senate 3rd Reading SB959 Ducheny Urgency Clause",31,3,4,0,38
62974,9592,2010-06-28,Assembly,"Do pass and be re-referred to the Committee on Natural Resources",9,0,0,0,9
62974,9669,2010-06-28,Assembly,"Do pass and be re-referred to the Committee on Appropriations",8,0,1,0,9
62974,20157,2010-08-12,Assembly,"Do pass as amended",17,0,0,0,17
62974,20616,2010-08-19,Assembly,"SB 959 Ducheny  Third Reading Urgency  By CABALLERO",77,1,0,0,78
62974,21223,2010-08-25,Senate,"Unfinished Business SB959 Ducheny Urgency Clause",30,4,0,0,34
62975,7849,2010-04-05,Senate,"Do pass, but re-refer to the Committee on Appropriations",2,4,1,0,7
62975,7850,2010-04-05,Senate,"Set, first hearing.  Failed passage in Committee.  Reconsideration granted",6,0,1,0,7
62976,3271,2010-04-21,Senate,"Do pass as amended, and re-refer to the Committee on Appropriations",5,0,4,0,9
62976,3272,2010-05-24,Senate,"Senate 3rd Reading SB961 Wright",26,6,6,0,38
62976,9289,2010-06-22,Assembly,"Do pass and be re-referred to the Committee on Appropriations",13,6,0,0,19
62976,20242,2010-08-12,Assembly,"Do pass",12,5,0,0,17
62976,21264,2010-08-23,Assembly,"SB 961 Wright  Senate Third Reading  By LOWENTHAL",54,20,0,0,74
62976,21265,2010-08-25,Senate,"Unfinished Business SB961 Wright",29,5,0,0,34
62977,1062,2010-03-23,Senate,"Do pass, but re-refer to the Committee on Judiciary.",7,0,0,0,7
62977,1063,2010-04-13,Senate,"Do pass as amended, but re-refer to the Committee on Appropriations Recommend Consent.",4,0,1,0,5
62977,1064,2010-05-03,Senate,"Do pass.",9,0,2,0,11
62977,1065,2010-05-10,Senate,"Special Consent #23 SB962 Liu",30,0,8,0,38
62977,8929,2010-06-15,Assembly,"Do pass and be re-referred to the Committee on Judiciary",7,0,0,0,7
62977,9170,2010-06-22,Assembly,"Do pass and re-refer to Committee on Appropriations with recommendation:  To Consent Calendar",10,0,0,0,10
62977,19619,2010-08-04,Assembly,"Do pass, to Consent Calendar",17,0,0,0,17
62977,19946,2010-08-12,Assembly,"SB 962 Liu  Consent Calendar Second Day  Regular Session",78,0,0,0,78
62977,20724,2010-08-19,Senate,"Unfinished Business SB962 Liu",35,0,0,0,35
62979,712,2010-04-20,Senate,"Do pass as amended, and re-refer to the Committee on Education.",6,2,1,0,9
62979,713,2010-04-26,Senate,"Placed on Appropriations Suspense file.",9,0,2,0,11
62979,714,2010-05-27,Senate,"Do pass.",7,2,2,0,11
62979,715,2010-06-01,Senate,"Senate 3rd Reading SB964 Alquist",23,11,4,0,38
62979,9920,2010-06-28,Assembly,"Do pass as amended and be re-referred to the Committee on Appropriations",9,5,0,0,14
62979,20087,2010-08-12,Assembly,"Do pass",12,5,0,0,17
62979,21175,2010-08-25,Assembly,"SB 964 Alquist  Senate Third Reading  By GALGIANI",53,24,0,0,77
62979,21382,2010-08-26,Senate,"Unfinished Business SB964 Alquist",23,14,0,0,37
62980,1301,2010-04-13,Senate,"Do pass, but re-refer to the Committee on Appropriations.",8,0,1,0,9
62980,1302,2010-04-26,Senate,"Do pass.",8,1,2,0,11
62980,1303,2010-04-29,Senate,"Senate 3rd Reading SB965 DeSaulnier",26,8,4,0,38
62980,9838,2010-06-28,Assembly,"Do pass and be re-referred to the Committee on Appropriations",14,0,0,0,14
62980,19573,2010-08-04,Assembly,"Do pass",13,3,0,0,16
62980,21415,2010-08-26,Assembly,"SB 965 DeSaulnier  Senate Third Reading  By GALGIANI",61,13,0,0,74
62980,21812,2010-08-31,Senate,"W/O REF. TO FILE SB965 DeSaulnier",24,11,0,0,35
62981,3576,2010-04-21,Senate,"Do pass, but re-refer to the Committee on Appropriations",5,0,4,0,9
62981,3577,2010-05-10,Senate,"Placed on Appropriations Suspense file",9,0,2,0,11
62982,1034,2010-04-13,Senate,"Do pass, but re-refer to the Committee on Appropriations.",7,0,4,0,11
62982,1035,2010-04-26,Senate,"Placed on Appropriations Suspense file.",9,0,2,0,11
62982,1036,2010-05-27,Senate,"Do pass as amended.",7,3,1,0,11
62982,1037,2010-06-02,Senate,"Senate 3rd Reading SB967 Correa",23,13,2,0,38
62982,10116,2010-06-29,Assembly,"Do pass and be re-referred to the Committee on Appropriations",7,4,0,0,11
62982,20216,2010-08-12,Assembly,"Do pass as amended",12,5,0,0,17
62982,21952,2010-08-30,Assembly,"SB 967 Correa  Senate Third Reading  By CABALLERO",51,26,0,0,77
62982,21953,2010-08-31,Senate,"Unfinished Business SB967 Correa",23,14,0,0,37
62983,1156,2010-03-24,Senate,"Do pass, but re-refer to the Committee on Appropriations.",4,2,0,0,6
62983,1157,2010-04-26,Senate,"Placed on Appropriations Suspense file.",9,0,2,0,11
62983,1158,2010-05-27,Senate,"Do pass.",7,3,1,0,11
62983,1159,2010-06-01,Senate,"Senate 3rd Reading SB968 Negrete McLeod",22,11,5,0,38
62983,9470,2010-06-23,Assembly,"Do pass and be re-referred to the Committee on Appropriations",8,4,0,0,12
62984,159,2010-04-21,Senate,"Do pass as amended, and re-refer to the Committee on Appropriations.",8,0,1,0,9
62984,160,2010-05-03,Senate,"Placed on Appropriations Suspense file.",10,0,1,0,11
62984,161,2010-05-27,Senate,"Do pass as amended.",9,0,2,0,11
62984,162,2010-06-02,Senate,"Senate 3rd Reading SB969 Liu",26,7,5,0,38
62984,9874,2010-06-30,Assembly,"Do pass and be re-referred to the Committee on Appropriations",6,1,2,0,9
62984,20153,2010-08-12,Assembly,"Do pass as amended",12,5,0,0,17
62985,2473,2010-04-06,Senate,"Do pass, but re-refer to the Committee on Appropriations",3,2,0,0,5
62985,2474,2010-04-26,Senate,"Placed on Appropriations Suspense file",9,0,2,0,11
62985,2475,2010-05-27,Senate,"Do pass as amended",7,3,1,0,11
62985,2476,2010-06-02,Senate,"Senate 3rd Reading SB970 Corbett",22,13,3,0,38
62985,9309,2010-06-22,Assembly,"Do pass as amended and be re-referred to the Committee on Appropriations",5,2,0,0,7
62985,19558,2010-08-04,Assembly,"Do pass",11,5,0,0,16
62985,20772,2010-08-20,Assembly,"SB 970 Corbett  Senate Third Reading  By FONG  Amend By FONG  Set #1",49,26,0,0,75
62985,20853,2010-08-23,Assembly,"SB 970 Corbett  Senate Third Reading  By FONG",48,28,0,0,76
62985,21108,2010-08-25,Senate,"Unfinished Business SB970 Corbett",23,11,0,0,34
62986,3979,2008-12-08,Senate,"W/O REF. TO FILE SB1 Ducheny Invoke Constitution",33,1,5,0,39
62986,3980,2008-12-08,Senate,"W/O REF. TO FILE SB1 Ducheny",33,1,5,0,39
62986,3981,2008-12-16,Assembly,"SB1 Ducheny  Senate Third Reading  By EVANS  First Extraordinary Session",1,27,52,0,80
62987,3969,2008-12-08,Senate,"W/O REF. TO FILE SB2 Ducheny",33,1,5,0,39
62988,3955,2008-12-08,Senate,"W/O REF. TO FILE SB3 Ducheny",33,1,5,0,39
62988,3956,2008-12-18,Assembly,"SB3 Ducheny  Senate Third Reading  By BASS  First Extraordinary Session",47,27,6,0,80
62988,3957,2008-12-18,Senate,"W/O REF. TO FILE SB3 Ducheny Concurrence",21,16,2,0,39
62989,3982,2008-12-08,Senate,"W/O REF. TO FILE SB4 Ducheny",33,1,5,0,39
62989,3983,2008-12-18,Assembly,"SB4 Ducheny  Senate Third Reading  By EVANS  First Extraordinary Session",53,20,7,0,80
62989,3984,2008-12-18,Senate,"W/O REF. TO FILE SB4 Ducheny Concurrence",35,2,2,0,39
62990,3966,2008-12-08,Senate,"W/O REF. TO FILE SB5 Ducheny",33,1,5,0,39
62990,3967,2008-12-18,Assembly,"SB5 Ducheny  Senate Third Reading  By EVANS  First Extraordinary Session",48,23,9,0,80
62990,3968,2008-12-18,Senate,"W/O REF. TO FILE SB5 Ducheny",33,5,1,0,39
62991,3941,2008-12-08,Senate,"W/O REF. TO FILE SB6 Ducheny",33,1,5,0,39
62991,3942,2008-12-18,Assembly,"SB6 Ducheny  Senate Third Reading  By EVANS  First Extraordinary Session",50,26,4,0,80
62991,3943,2008-12-18,Senate,"W/O REF. TO FILE SB6 Ducheny Concurrence",23,15,1,0,39
62992,3970,2008-12-08,Senate,"W/O REF. TO FILE SB7 Ducheny",33,1,5,0,39
62992,3971,2008-12-18,Assembly,"SB7 Ducheny  Senate Third Reading  By EVANS  First Extraordinary Session",47,27,6,0,80
62992,3972,2008-12-18,Senate,"W/O REF. TO FILE SB7 Ducheny Concurrence",21,16,2,0,39
62993,3940,2008-12-08,Senate,"W/O REF. TO FILE SB8 Ducheny",33,1,5,0,39
62994,3951,2008-12-08,Senate,"W/O REF. TO FILE SB9 Ducheny",33,1,5,0,39
62994,3952,2008-12-18,Assembly,"SB9 Ducheny  Senate Third Reading  By EVANS  Appeal the Decision of the Chair  By DE VORE  First Extraordinary Session",27,50,3,0,80
62994,3953,2008-12-18,Assembly,"SB9 Ducheny  Senate Third Reading  By EVANS  First Extraordinary Session",47,27,6,0,80
62994,3954,2008-12-18,Senate,"W/O REF. TO FILE SB9 Ducheny Concurrence",23,14,2,0,39
62995,3939,2008-12-08,Senate,"W/O REF. TO FILE SB10 Ducheny",33,1,5,0,39
62996,3925,2008-12-08,Senate,"W/O REF. TO FILE SB11 Ducheny",33,1,5,0,39
62996,3926,2008-12-18,Assembly,"SB 11 Ducheny  Senate Third Reading  By EVANS  Appeal the Decision of the Chair  By DE VORE  First Extraordinary Session",27,49,4,0,80
62996,3927,2008-12-18,Assembly,"SB 11 Ducheny  Senate Third Reading  By EVANS  First Extraordinary Session",47,27,6,0,80
62996,3928,2008-12-18,Senate,"W/O REF. TO FILE SB11 Ducheny Concurrence",21,15,3,0,39
62997,3949,2008-12-08,Senate,"W/O REF. TO FILE SB12 Ducheny",33,1,5,0,39
62997,3950,2008-12-16,Assembly,"SB 12 Ducheny  Third Reading Urgency  By EVANS  First Extraordinary Session",0,26,54,0,80
63002,22318,2009-02-14,Senate,"Do pass as amended",22,13,0,0,35
63002,22319,2009-02-14,Senate,"Senate 3rd Reading SB3 Ducheny",36,1,0,0,37
63002,22320,2009-02-14,Assembly,"SB3 Florez  Senate Third Reading  Second Extraordinary Session",62,10,0,0,72
63003,22618,2009-02-14,Senate,"Do pass as amended",22,13,0,0,35
63003,22619,2009-02-14,Senate,"Senate 3rd Reading SB4 Ducheny",30,4,0,0,34
63003,22620,2009-02-14,Assembly,"SB4 Cogdill  Senate Third Reading  Second Extraordinary Session",43,29,0,0,72
63004,3929,2009-02-14,Senate,"Do pass as amended",22,13,4,0,39
63004,3930,2009-02-15,Senate,"Senate 3rd Reading SB5 Ducheny",34,2,3,0,39
63006,27097,2009-02-14,Senate,"Do pass as amended",22,13,0,0,35
63006,27098,2009-02-14,Senate,"Senate 3rd Reading SB7 Ducheny",24,15,0,0,39
63006,27099,2009-02-14,Assembly,"SB7 Corbett  Senate Third Reading  Second Extraordinary Session",48,27,0,0,75
63007,3914,2009-02-14,Senate,"Do pass as amended",22,13,4,0,39
63007,3915,2009-02-15,Senate,"Senate 3rd Reading SB8 Ducheny",18,19,2,0,39
63008,22430,2009-02-14,Senate,"Do pass as amended",22,13,0,0,35
63008,22431,2009-02-14,Senate,"Senate 3rd Reading SB9 Ducheny",33,4,0,0,37
63008,22432,2009-02-15,Assembly,"SB9 Padilla  Senate Third Reading  By ENG  Second Extraordinary 	Session",71,6,0,0,77
63009,22372,2009-02-14,Senate,"Do pass as amended",22,13,0,0,35
63009,22373,2009-02-14,Senate,"Senate 3rd Reading SB10 Ducheny",37,1,0,0,38
63009,22374,2009-02-15,Assembly,"SB 10 Oropeza  Senate Third Reading  By EVANS  Second Extraordinary 	Session",67,8,0,0,75
63010,22692,2009-02-14,Senate,"Do pass as amended",22,13,0,0,35
63010,22693,2009-02-14,Senate,"Senate 3rd Reading SB11 Ducheny",32,6,0,0,38
63010,22694,2009-02-15,Assembly,"SB 11 Steinberg  Senate Third Reading  By LIEU  Second 	Extraordinary Session",69,3,0,0,72
63011,22521,2009-02-14,Senate,"Do pass as amended",22,13,0,0,35
63011,22522,2009-02-14,Senate,"Senate 3rd Reading SB12 Ducheny",35,3,0,0,38
63011,22523,2009-02-19,Assembly,"SB 12 Steinberg  Senate Third Reading  By JONES  Second 	Extraordinary Session",73,4,0,0,77
63014,22518,2009-02-15,Senate,"Senate 3rd Reading SB15 Ducheny",37,1,0,0,38
63014,22519,2009-02-15,Assembly,"SB 15 Ashburn  Senate Third Reading  By HUBER  Second Extraordinary 	Session",27,3,0,0,30
63014,22520,2009-02-19,Assembly,"SB 15 Ashburn  Senate Third Reading  By HUBER  Second Extraordinary 	Session",62,11,0,0,73
63015,26166,2009-02-19,Senate,"Senate 3rd Supp 1 SB16 Ducheny",34,2,0,0,36
63015,26167,2009-02-19,Assembly,"SB 16 Ashburn  Senate Third Reading  By GALGIANI  Second 	Extraordinary Session",63,4,0,0,67
63016,3910,2009-01-12,Senate,"Senate 3rd Reading SB1 Ducheny",29,1,9,0,39
63016,3911,2009-02-15,Assembly,"SB1 Ducheny  Third Reading Urgency  By EVANS  Third Extraordinary Session",58,21,1,0,80
63016,3912,2009-02-15,Senate,"W/O REF. TO FILE SB1 Ducheny",24,13,2,0,39
63016,3913,2009-02-19,Senate,"Unfinished Business SB1 Ducheny Concurrence",27,12,0,0,39
63017,3867,2009-01-12,Senate,"Senate 3rd Reading SB2 Ducheny",29,1,9,0,39
63017,3868,2009-02-14,Assembly,"SB2 Ducheny  Third Reading Urgency  Third Extraordinary Session",65,15,0,0,80
63017,3869,2009-02-15,Senate,"Unfinished Supp 1 SB2 Ducheny Reconsider",39,0,0,0,39
63017,3870,2009-02-19,Senate,"Unfinished Business SB2 Ducheny Concurrence",31,8,0,0,39
63017,9164,2009-02-15,Senate,"Unfinished Supp 1 SB2 Ducheny",30,8,1,0,39
63018,3895,2009-01-12,Senate,"Senate 3rd Reading SB3 Ducheny",29,1,9,0,39
63018,3896,2009-03-16,Assembly,"SB3 DeSaulnier  Senate Third Reading  Third Extraordinary Session",53,11,16,0,80
63019,22313,2009-01-12,Senate,"Senate 3rd Reading SB4 Ducheny",29,1,0,0,30
63019,22314,2009-02-14,Assembly,"SB4 Ducheny  Third Reading Urgency  Third Extraordinary Session",72,5,0,0,77
63019,22315,2009-02-15,Senate,"Unfinished Supp 1 SB4 Ducheny",27,8,0,0,35
63019,22316,2009-02-15,Senate,"Unfinished Supp 1 SB4 Ducheny Reconsider",39,0,0,0,39
63019,22317,2009-02-19,Senate,"Unfinished Business SB4 Ducheny Concurrence",27,11,0,0,38
63020,3893,2009-01-12,Senate,"Senate 3rd Reading SB5 Ducheny",29,1,9,0,39
63020,3894,2009-02-14,Assembly,"SB5 Ducheny  Third Reading Urgency  Third Extraordinary Session",67,12,1,0,80
63021,22637,2009-01-12,Senate,"Senate 3rd Reading SB6 Ducheny",29,1,0,0,30
63021,22638,2009-02-14,Assembly,"SB6 Ducheny  Third Reading Urgency  Third Extraordinary Session",68,11,0,0,79
63021,22639,2009-02-15,Senate,"Unfinished Supp 1 SB6 Ducheny",29,7,0,0,36
63021,22640,2009-02-19,Senate,"Unfinished Business SB6 Ducheny Concurrence",28,10,0,0,38
63022,26061,2009-01-12,Senate,"Senate 3rd Reading SB7 Steinberg",29,1,0,0,30
63022,26062,2009-02-14,Assembly,"SB7 Ducheny  Third Reading Urgency  Third Extraordinary Session",65,12,0,0,77
63022,26063,2009-02-15,Senate,"W/O REF. TO FILE SB7 Concurrance Ducheny",20,13,0,0,33
63022,26064,2009-02-19,Senate,"Unfinished Business SB7 Ducheny Concurrence",27,12,0,0,39
63023,22455,2009-01-12,Senate,"Senate 3rd Reading SB8 Ducheny",29,1,0,0,30
63023,22456,2009-02-15,Assembly,"SB8 Ducheny  Third Reading Urgency  By EVANS  Third Extraordinary 	Session",54,21,0,0,75
63023,22457,2009-02-15,Senate,"W/O REF. TO FILE SB8 Concurrance Ducheny",19,13,0,0,32
63023,22458,2009-02-19,Senate,"Unfinished Business SB8 Ducheny Concurrence",27,11,0,0,38
63024,3871,2009-01-12,Senate,"Senate 3rd Reading SB9 Ducheny",29,1,9,0,39
63024,3872,2009-02-14,Assembly,"SB9 Ducheny  Third Reading Urgency  Amend By GARRICK  Set #2 Motion to  Lay on the Table  By TORRICO  Third Extraordinary Session",51,29,0,0,80
63024,3873,2009-02-14,Assembly,"SB9 Ducheny  Third Reading Urgency  Amend By GARRICK  Set #3 Motion to  Lay on the Table  By KREKORIAN  Third Extraordinary Session",51,28,1,0,80
63024,3874,2009-02-14,Assembly,"SB9 Ducheny  Third Reading Urgency  By EVANS  Third Extraordinary Session",72,5,3,0,80
63024,3875,2009-02-15,Senate,"W/O REF. TO FILE SB9 Ducheny",37,0,2,0,39
63025,22363,2009-01-12,Senate,"Senate 3rd Reading SB10 Ducheny",29,1,0,0,30
63025,22364,2009-02-14,Assembly,"SB 10 Ducheny  Third Reading Urgency  Third Extraordinary Session",76,4,0,0,80
63025,22365,2009-02-15,Senate,"Unfinished Supp 1 SB10 Ducheny",36,2,0,0,38
63025,22366,2009-02-15,Senate,"Unfinished Supp 1 SB10 Ducheny Reconsider",39,0,0,0,39
63025,22367,2009-02-19,Senate,"Unfinished Business SB10 Ducheny Concurrence",36,2,0,0,38
63026,3889,2009-01-12,Senate,"Senate 3rd Reading SB11 Ducheny",29,1,9,0,39
63026,3890,2009-02-14,Assembly,"SB 11 Ducheny  Third Reading Urgency  By EVANS  Third Extraordinary Session",75,5,0,0,80
63027,3891,2009-01-12,Senate,"Senate 3rd Reading SB12 Ducheny",29,1,9,0,39
63027,3892,2009-02-14,Assembly,"SB 12 Ducheny  Third Reading Urgency  By EVANS  Third Extraordinary Session",70,8,2,0,80
63028,26327,2009-01-12,Senate,"Senate 3rd Reading SB13 Ducheny",29,1,0,0,30
63028,26328,2009-02-14,Assembly,"SB 13 Ducheny  Third Reading Urgency  By EVANS  Third Extraordinary 	Session",71,8,0,0,79
63028,26329,2009-09-10,Assembly,"Do pass and be re-referred to the Committee on Appropriations",7,0,0,0,7
63028,26330,2009-09-11,Assembly,"SB 13 Yee  Third Reading Urgency  By SMYTH  Third Extraordinary 	Session",74,4,0,0,78
63028,26331,2009-09-12,Assembly,"SB 13 Yee  Third Reading Urgency  By EVANS  Third Extraordinary 	Session",76,0,0,0,76
63028,26332,2009-09-12,Senate,"W/O REF. TO FILE SB13 Alquist Urgency Clause",24,0,0,0,24
63028,26333,2009-09-12,Senate,"W/O REF. TO FILE SB13 Alquist Reconsider",39,0,0,0,39
63028,26334,2009-10-14,Senate,"Unfinished Business SB13 Alquist Urgency Clause",38,0,0,0,38
63029,22329,2009-01-12,Senate,"Senate 3rd Reading SB14 Ducheny",29,1,0,0,30
63029,22330,2009-02-14,Assembly,"SB 14 Ducheny  Third Reading Urgency  Third Extraordinary Session",79,1,0,0,80
63029,22331,2009-02-15,Senate,"Unfinished Supp 1 SB14 Ducheny",30,8,0,0,38
63029,22332,2009-02-19,Senate,"Unfinished Business SB14 Ducheny Concurrence",32,6,0,0,38
63030,25709,2009-01-12,Senate,"Senate 3rd Reading SB15 Ducheny",29,1,0,0,30
63030,25710,2009-02-14,Assembly,"SB 15 Calderon  Senate Third Reading  Third Extraordinary Session",63,8,0,0,71
63030,25711,2009-02-15,Senate,"Unfinished Supp 1 SB15 Concurrance Ducheny",28,9,0,0,37
63030,25712,2009-02-19,Senate,"Unfinished Business SB15 Calderon Concurrence",30,7,0,0,37
63031,3840,2009-01-12,Senate,"Senate 3rd Reading SB16 Ducheny",29,1,9,0,39
63031,3841,2009-06-28,Assembly,"SB 16 Ducheny  Senate Third Reading  By EVANS  Amend By EVANS  Set #1  Third Extraordinary Session",47,28,4,0,79
63031,3842,2009-06-28,Assembly,"SB 16 Ducheny  Senate Third Reading  By EVANS  Third Extraordinary Session",46,29,4,0,79
63031,3843,2009-06-29,Senate,"W/O REF. TO FILE SB16 Ducheny Concurrence",22,17,1,0,40
63032,3860,2009-01-12,Senate,"Senate 3rd Reading SB17 Ducheny",29,1,9,0,39
63032,3861,2009-06-28,Assembly,"SB 17 Ducheny  Senate Third Reading  By EVANS  Amend By EVANS  Set #1  Third Extraordinary Session",47,28,4,0,79
63032,3862,2009-06-28,Assembly,"SB 17 Ducheny  Senate Third Reading  By EVANS  Third Extraordinary Session",42,31,6,0,79
63032,3863,2009-06-29,Senate,"W/O REF. TO FILE SB17 Ducheny Concurrence",24,16,0,0,40
63033,25339,2009-01-12,Senate,"Senate 3rd Reading SB18 Ducheny",29,1,0,0,30
63033,25340,2009-08-31,Assembly,"SB 18 Ducheny  Senate Third Reading  Amend By ARAMBULA  Set #1 	Third Extraordinary Session",42,30,0,0,72
63033,25341,2009-08-31,Assembly,"SB 18 Ducheny  Senate Third Reading  By ARAMBULA  Third 	Extraordinary Session",41,37,0,0,78
63033,25342,2009-09-11,Senate,"Unfinished Business SB18 Ducheny Concurrence",21,16,0,0,37
63034,22321,2009-01-12,Senate,"Senate 3rd Reading SB19 Ducheny",29,1,0,0,30
63034,22322,2009-02-19,Assembly,"SB 19 Ducheny  Third Reading Urgency  By EVANS  Third Extraordinary 	Session",58,12,0,0,70
63034,22323,2009-02-19,Senate,"W/O REF. TO FILE SB19 Ducheny",31,4,0,0,35
63035,3864,2009-01-12,Senate,"Senate 3rd Reading SB20 Ducheny",29,1,9,0,39
63035,3865,2009-02-19,Assembly,"SB 20 Maldonado  Third Reading Urgency  By EVANS  Third Extraordinary Session",57,4,19,0,80
63035,3866,2009-02-19,Senate,"W/O REF. TO FILE SB20 Maldonado",27,9,3,0,39
63039,25132,2009-03-23,Senate,"Senate 3rd Reading SB24 Alquist Urgency Clause",35,0,0,0,35
63039,25133,2009-03-26,Assembly,"SB 24 Alquist  Third Reading Urgency  By JONES  Third Extraordinary 	Session",67,1,0,0,68
63042,27010,2009-03-23,Senate,"W/O REF. TO FILE SB27 Negrete McLeod Urgency Clause",36,0,0,0,36
63042,27011,2009-03-26,Assembly,"SB 27 Negrete McLeod  Senate Third Reading  By CARTER  Third 	Extraordinary Session",73,0,0,0,73
63044,3838,2009-06-29,Senate,"Do pass",23,14,3,0,40
63044,3839,2009-06-29,Senate,"Senate 3rd Reading SB29 Ducheny",23,15,2,0,40
63045,3827,2009-06-29,Senate,"Do pass",23,14,3,0,40
63045,3828,2009-06-29,Senate,"Senate 3rd Reading SB30 Ducheny",23,14,3,0,40
63046,3829,2009-06-29,Senate,"Do pass",23,14,3,0,40
63046,3830,2009-06-29,Senate,"Senate 3rd Reading SB31 Ducheny",23,16,1,0,40
63052,3789,2009-09-11,Senate,"Senate 3rd Reading SB37 Ducheny Reconsider",40,0,0,0,40
63052,3790,2009-10-14,Senate,"Senate 3rd Reading SB37 Ashburn Suspend Joint Rules",38,0,2,0,40
63052,3791,2009-10-14,Senate,"Senate 3rd Reading SB37 Ashburn",35,1,4,0,40
63052,9159,2009-09-11,Senate,"Senate 3rd Reading SB37 Ducheny",18,1,21,0,40
63055,3794,2009-07-06,Senate,"Senate 3rd Reading SB40 Ducheny",23,13,4,0,40
63056,3793,2009-07-06,Senate,"Senate 3rd Reading SB41 Ducheny",23,13,4,0,40
63057,3792,2009-07-06,Senate,"Senate 3rd Reading SB42 Ducheny",23,13,4,0,40
63058,3755,2009-07-06,Senate,"Senate 3rd Reading SB43 Ducheny",23,13,4,0,40
63059,3756,2009-07-06,Senate,"Senate 3rd Reading SB44 Ducheny",23,13,4,0,40
63060,3770,2009-07-06,Senate,"Senate 3rd Reading SB45 Ducheny",23,13,4,0,40
63061,3741,2009-07-06,Senate,"Senate 3rd Reading SB46 Ducheny",23,13,4,0,40
63062,3753,2009-07-06,Senate,"Senate 3rd Reading SB47 Ducheny",23,13,4,0,40
63063,3754,2009-07-06,Senate,"Senate 3rd Reading SB48 Ducheny",23,13,4,0,40
63064,3732,2009-07-06,Senate,"Senate 3rd Reading SB49 Ducheny",23,13,4,0,40
63065,3739,2009-07-06,Senate,"Senate 3rd Reading SB50 Ducheny",23,13,4,0,40
63066,3740,2009-07-06,Senate,"Senate 3rd Reading SB51 Ducheny",23,13,4,0,40
63067,3730,2009-07-06,Senate,"Senate 3rd Reading SB52 Ducheny",23,13,4,0,40
63068,3731,2009-07-06,Senate,"Senate 3rd Reading SB53 Ducheny",23,13,4,0,40
63069,3716,2009-07-06,Senate,"Senate 3rd Reading SB54 Ducheny",23,13,4,0,40
63074,3694,2009-07-09,Senate,"Senate 3rd Reading SB1 Ducheny",23,12,5,0,40
63075,3695,2009-07-09,Senate,"Senate 3rd Reading SB2 Ducheny",23,12,5,0,40
63076,3712,2009-07-09,Senate,"Senate 3rd Reading SB3 Ducheny",23,12,5,0,40
63077,3713,2009-07-09,Senate,"Senate 3rd Reading SB4 Ducheny",23,12,5,0,40
63078,3690,2009-07-09,Senate,"Senate 3rd Reading SB5 Ducheny",23,12,5,0,40
63079,3692,2009-07-09,Senate,"Senate 3rd Reading SB6 Ducheny",23,12,5,0,40
63080,3693,2009-07-09,Senate,"Senate 3rd Reading SB7 Ducheny",23,12,5,0,40
63081,3685,2009-07-09,Senate,"Senate 3rd Reading SB8 Ducheny",23,12,5,0,40
63082,3691,2009-07-09,Senate,"Senate 3rd Reading SB9 Ducheny",23,12,5,0,40
63083,3676,2009-07-09,Senate,"Senate 3rd Reading SB10 Ducheny",23,12,5,0,40
63084,3689,2009-07-09,Senate,"Senate 3rd Reading SB11 Ducheny",23,12,5,0,40
63085,3687,2009-07-09,Senate,"Senate 3rd Reading SB12 Ducheny",23,12,5,0,40
63085,3688,2009-07-24,Assembly,"SB 12 Ducheny  Third Reading Urgency  By EVANS  Fourth Extraordinary Session",54,24,1,0,79
63086,26754,2009-07-09,Senate,"Senate 3rd Reading SB13 Ducheny",23,12,0,0,35
63086,26755,2009-07-23,Assembly,"SB 13 Ducheny  Third Reading Urgency  By EVANS  Fourth 	Extraordinary Session",56,21,0,0,77
63086,26756,2009-07-24,Senate,"W/O REF. TO FILE SB13 Ducheny Urgency Clause",29,8,0,0,37
63087,3674,2009-07-09,Senate,"Senate 3rd Reading SB14 Ducheny",23,12,5,0,40
63088,3673,2009-07-09,Senate,"Senate 3rd Reading SB15 Ducheny",23,12,5,0,40
63089,23574,2009-07-09,Senate,"Senate 3rd Reading SB16 Ducheny",23,12,0,0,35
63089,23575,2009-07-23,Assembly,"SB 16 Ducheny  Third Reading Urgency  By EVANS  Fourth 	Extraordinary Session",55,22,0,0,77
63089,23576,2009-07-24,Senate,"W/O REF. TO FILE SB16 Ducheny Urgency Clause",33,6,0,0,39
63090,3672,2009-07-09,Senate,"Senate 3rd Reading SB17 Ducheny",23,12,5,0,40
63091,3641,2009-07-09,Senate,"Senate 3rd Reading SB18 Ducheny",23,12,5,0,40
63092,3642,2009-07-09,Senate,"Senate 3rd Reading SB19 Ducheny",23,12,5,0,40
63093,3654,2009-07-09,Senate,"Senate 3rd Reading SB20 Ducheny",23,12,5,0,40
63094,3628,2009-07-09,Senate,"Senate 3rd Reading SB21 Ducheny",23,12,5,0,40
63095,3629,2009-07-09,Senate,"Senate 3rd Reading SB22 Ducheny",23,12,5,0,40
63096,3619,2009-07-09,Senate,"Senate 3rd Reading SB23 Ducheny",23,12,5,0,40
63097,3620,2009-07-09,Senate,"Senate 3rd Reading SB24 Ducheny",23,12,5,0,40
63098,3627,2009-07-09,Senate,"Senate 3rd Reading SB25 Ducheny",23,12,5,0,40
63099,3609,2009-07-09,Senate,"Senate 3rd Reading SB26 Ducheny",23,12,5,0,40
63100,3610,2009-07-09,Senate,"Senate 3rd Reading SB27 Ducheny",23,12,5,0,40
63101,3611,2009-07-09,Senate,"Senate 3rd Reading SB28 Ducheny",23,12,5,0,40
63102,3602,2009-07-09,Senate,"Senate 3rd Reading SB29 Ducheny",23,12,5,0,40
63103,3603,2009-07-09,Senate,"Senate 3rd Reading SB30 Ducheny",23,12,5,0,40
63106,27031,2009-11-02,Senate,"Do pass, but re-refer to the Committee on Appropriations",5,0,0,0,5
63106,27032,2009-11-03,Senate,"Do pass as amended",7,3,0,0,10
63106,27033,2009-11-03,Senate,"W/O REF. TO FILE SB1 Romero",21,12,0,0,33
63106,27034,2009-12-09,Assembly,"Do pass and be re-referred to the Committee on Appropriations",6,5,0,0,11
63106,27035,2009-12-09,Assembly,"Set first hearing.  Failed passage.  Reconsideration granted",15,0,0,0,15
63106,27036,2010-01-05,Assembly,"Do pass as amended",12,4,0,0,16
63106,27037,2010-01-05,Assembly,"Do pass and be re-referred to the Committee on Appropriations",11,2,0,0,13
63106,27038,2010-01-05,Assembly,"SB1 Steinberg  Senate Third Reading  By BROWNLEY  Fifth 	Extraordinary Session",45,17,0,0,62
63106,27039,2010-01-06,Senate,"From committee:  That the Assembly Amendments be concurred in",9,2,0,0,11
63106,27040,2010-01-06,Senate,"From committee:  That the Assembly Amendments be concurred in",6,0,0,0,6
63106,27041,2010-01-06,Senate,"W/O REF. TO FILE SB1 STEINBERG",27,7,0,0,34
63107,26295,2009-11-02,Senate,"Do pass, but re-refer to the Committee on Appropriations",5,0,0,0,5
63107,26296,2009-11-03,Senate,"Do pass as amended",9,0,0,0,9
63107,26297,2009-11-03,Senate,"W/O REF. TO FILE SB2 Simitian Invoke Constitution",34,0,0,0,34
63107,26298,2009-11-03,Senate,"W/O REF. TO FILE SB2 Simitian",35,0,0,0,35
63107,26299,2009-12-09,Assembly,"Do pass and be re-referred to the Committee on Appropriations",13,1,0,0,14
63107,26300,2009-12-10,Assembly,"Do pass as amended",14,2,0,0,16
63107,26301,2009-12-10,Assembly,"SB2 Simitian  Senate Third Reading  By BROWNLEY  Fifth 	Extraordinary Session",69,0,0,0,69
63107,26302,2009-12-17,Senate,"Unfinished Business SB2 Simitian",28,0,0,0,28
63109,26795,2009-12-17,Senate,"Do pass, but re-refer to the Committee on Appropriations",7,0,0,0,7
63109,26796,2009-12-17,Senate,"W/O REF. TO FILE SB4 Romero",21,7,0,0,28
63109,26797,2010-01-05,Assembly,"Do pass",11,4,0,0,15
63109,26798,2010-01-05,Assembly,"Do pass and be re-referred to the Committee on Appropriations",11,4,0,0,15
63109,26799,2010-01-05,Assembly,"SB4 Romero  Senate Third Reading  By ARAMBULA  Fifth Extraordinary 	Session",41,27,0,0,68
63109,26800,2010-01-06,Senate,"From committee:  That the Assembly Amendments be concurred in",6,1,0,0,7
63109,26801,2010-01-06,Senate,"W/O REF. TO FILE SB4 ROMERO",23,11,0,0,34
63112,23530,2009-11-02,Senate,"Do pass as amended",25,4,11,0,40
63112,23531,2009-11-02,Senate,"Senate 3rd Reading SB1 Simitian Suspend Senate Rules",23,11,6,0,40
63112,23532,2009-11-02,Senate,"Senate 3rd Reading SB1 Simitian",29,5,6,0,40
63112,23533,2009-11-03,Assembly,"SB1 Simitian  Senate Third Reading  Amend By HUBER  Set #1  Motion 	to  Lay on the Table  By TORRICO  Seventh Extraordinary Session",40,16,0,23,79
63112,23534,2009-11-03,Assembly,"SB1 Simitian  Senate Third Reading  By HUFFMAN  Seventh 	Extraordinary Session",46,29,0,4,79
63112,23535,2009-11-04,Senate,"W/O REF. TO FILE SB1 Simitian Concurrence",27,7,6,0,40
63113,25537,2009-11-02,Senate,"Do pass as amended",29,7,0,0,36
63113,25538,2009-11-02,Senate,"Senate Third SB2 Cogdill Suspend Senate Rules",23,4,0,0,27
63113,25539,2009-11-02,Senate,"Senate Third SB2 Cogdill Urgency Clause",28,8,0,0,36
63113,25540,2009-11-04,Assembly,"SB2 Cogdill  Third Reading Urgency  By CABALLERO  Seventh 	Extraordinary Session",2,18,0,0,20
63113,25541,2009-11-04,Assembly,"SB2 Cogdill  Third Reading Urgency  By CABALLERO  Seventh 	Extraordinary Session",55,20,0,0,75
63113,25542,2009-11-04,Senate,"W/O REF. TO FILE SB2 Cogdill Concurrence",27,8,0,0,35
63116,3582,2009-11-02,Senate,"Do pass as amended",18,16,6,0,40
63116,3583,2009-11-02,Senate,"Set, first hearing.  Failed passage in Committee.  Reconsideration granted",21,0,19,0,40
63117,22646,2009-11-02,Senate,"Do pass as amended",30,3,0,0,33
63117,22647,2009-11-03,Senate,"Senate 3rd Reading SB6 Steinberg",21,13,0,0,34
63117,22648,2009-11-03,Assembly,"SB6 Steinberg  Senate Third Reading  By HUFFMAN  Seventh 	Extraordinary Session",44,29,0,0,73
63117,22649,2009-11-03,Senate,"Senate Third SB6 Steinberg",19,16,0,0,35
63117,22650,2009-11-03,Senate,"Senate Third SB6 Steinberg Reconsider",21,0,0,0,21
63117,22651,2009-11-04,Senate,"W/O REF. TO FILE SB6 Steinberg Concurrence",22,13,0,0,35
63118,25681,2009-11-02,Senate,"Do pass as amended",21,13,0,0,34
63118,25682,2009-11-02,Senate,"Senate Third SB7 Ducheny Amendments",25,8,0,0,33
63118,25683,2009-11-02,Senate,"Senate Third SB7 Ducheny Suspend Senate Rules",22,10,0,0,32
63118,25684,2009-11-02,Senate,"Senate Third SB7 Steinberg",21,13,0,0,34
63118,25685,2009-11-03,Assembly,"SB7 Steinberg  Senate Third Reading  By FEUER  Seventh 	Extraordinary Session",49,19,0,0,68
63118,25686,2009-11-04,Senate,"W/O REF. TO FILE SB7 Steinberg",21,13,0,0,34
63119,22791,2009-11-02,Senate,"Do pass as amended",21,14,0,0,35
63119,22792,2009-11-02,Senate,"Senate Third SB8 Steinberg Suspend Senate Rules",22,11,0,0,33
63119,22793,2009-11-02,Senate,"Senate Third SB8 Steinberg",21,12,0,0,33
63119,22794,2009-11-04,Assembly,"SB8 Steinberg  Senate Third Reading  By DE LEON  Seventh 	Extraordinary Session",49,20,0,0,69
63119,22795,2009-11-04,Senate,"W/O REF. TO FILE SB8 Steinberg",23,3,0,0,26
63121,3575,2010-02-04,Senate,"SENATE 3RD READING SB1 COMMITTEE ON B. & F.R. (DUCHENY)",21,0,18,0,39
63122,3574,2010-02-04,Senate,"SENATE 3RD READING SB2 COMMITTEE ON B. & F.R. (DUCHENY)",21,0,18,0,39
63123,3572,2010-02-04,Senate,"SENATE 3RD READING SB3 COMMITTEE ON B. & F.R. (DUCHENY)",21,0,18,0,39
63123,3573,2010-02-22,Assembly,"SB3 B.& F. R.  Senate Third Reading  Amend By EVANS  Set #1  Eighth Extraordinary Session",46,27,6,0,79
63124,22916,2010-02-04,Senate,"SENATE 3RD READING SB4 COMMITTEE ON B. & F.R. (DUCHENY)",21,0,0,0,21
63124,22917,2010-02-24,Assembly,"Do pass as amended",15,3,0,0,18
63124,22918,2010-02-25,Assembly,"SB4 B.& F. R.  Senate Third Reading  By EVANS  FORMERLY FILE ITEM1 	Eighth Extraordinary Session",54,13,0,0,67
63124,22919,2010-03-01,Senate,"Unfinished Business SB4 Committee on B. & F.R. (Ducheny)",29,2,0,0,31
63125,3570,2010-02-04,Senate,"SENATE 3RD READING SB5 COMMITTEE ON B. & F.R. (DUCHENY)",21,0,18,0,39
63125,3571,2010-02-22,Assembly,"SB5 B.& F. R.  Senate Third Reading  Amend By EVANS  Set #1  Eighth Extraordinary Session",45,22,12,0,79
63126,3550,2010-02-04,Senate,"SENATE 3RD READING SB6 COMMITTEE ON B. & F.R. (DUCHENY)",21,0,18,0,39
63126,3551,2010-02-22,Assembly,"SB6 B.& F. R.  Senate Third Reading  Amend By EVANS  Set #1  Eighth Extraordinary Session",41,24,14,0,79
63126,3552,2010-02-22,Assembly,"SB6 B.& F. R.  Senate Third Reading  By EVANS  Eighth Extraordinary Session",43,24,12,0,79
63127,3553,2010-02-04,Senate,"SENATE 3RD READING SB7 COMMITTEE ON B. & F.R. (DUCHENY)",21,0,18,0,39
63127,3554,2010-02-22,Assembly,"SB7 B.& F. R.  Senate Third Reading  Amend By EVANS  Set #1  Eighth Extraordinary Session",45,22,12,0,79
63128,3555,2010-02-04,Senate,"SENATE 3RD READING SB8 COMMITTEE ON B. & F.R. (DUCHENY)",21,0,18,0,39
63128,3556,2010-02-22,Assembly,"SB8 B.& F. R.  Senate Third Reading  Amend By EVANS  Set #1  Eighth Extraordinary Session",45,22,12,0,79
63129,3531,2010-02-04,Senate,"SENATE 3RD READING SB9 COMMITTEE ON B. & F.R. (DUCHENY)",21,0,18,0,39
63130,3546,2010-02-04,Senate,"SENATE 3RD READING SB10 COMMITTEE ON B. & F.R. (DUCHENY)",21,0,18,0,39
63130,3547,2010-02-22,Assembly,"SB 10 B.& F. R.  Senate Third Reading  Amend By EVANS  Set #1 Eighth Extraordinary Session",45,22,12,0,79
63131,3548,2010-02-04,Senate,"SENATE 3RD READING SB11 COMMITTEE ON B. & F.R. (DUCHENY)",21,0,18,0,39
63131,3549,2010-02-22,Assembly,"SB 11 B.& F. R.  Senate Third Reading  Amend By EVANS  Set #1 Eighth Extraordinary Session",45,22,12,0,79
63132,3530,2010-02-04,Senate,"SENATE 3RD READING SB12 COMMITTEE ON B. & F.R. (DUCHENY)",21,0,18,0,39
63133,3536,2010-02-04,Senate,"SENATE 3RD READING SB13 COMMITTEE ON B. & F.R. (DUCHENY)",21,0,18,0,39
63133,3537,2010-02-22,Assembly,"SB 13 B.& F. R.  Senate Third Reading  Amend By EVANS  Set #1 Eighth Extraordinary Session",45,22,12,0,79
63134,3535,2010-02-04,Senate,"SENATE 3RD READING SB14 COMMITTEE ON B. & F.R. (DUCHENY)",21,0,18,0,39
63135,3534,2010-02-04,Senate,"SENATE 3RD READING SB15 COMMITTEE ON B. & F.R. (DUCHENY)",21,0,18,0,39
63136,3525,2010-02-04,Senate,"SENATE 3RD READING SB16 COMMITTEE ON B. & F.R. (DUCHENY)",21,0,18,0,39
63137,3528,2010-02-04,Senate,"SENATE 3RD READING SB17 COMMITTEE ON B. & F.R. (DUCHENY)",21,0,18,0,39
63138,3529,2010-02-04,Senate,"SENATE 3RD READING SB18 COMMITTEE ON B. & F.R. (DUCHENY)",21,0,18,0,39
63139,3527,2010-02-04,Senate,"SENATE 3RD READING SB19 COMMITTEE ON B. & F.R. (DUCHENY)",21,0,18,0,39
63140,3526,2010-02-04,Senate,"SENATE 3RD READING SB20 COMMITTEE ON B. & F.R. (DUCHENY)",21,0,18,0,39
63142,3501,2010-02-16,Senate,"Do pass as amended, and re-refer to the Committee on Rules",9,0,2,0,11
63146,3475,2010-02-16,Senate,"Do pass, but re-refer to the Committee on Appropriations",9,0,2,0,11
63146,3476,2010-02-22,Senate,"Do pass as amended",8,0,3,0,11
63146,3477,2010-02-25,Senate,"Senate 3rd Reading SB26 Pavley",32,0,7,0,39
63146,3478,2010-03-09,Assembly,"Do pass and be re-referred to the Committee on Natural Resources",6,1,0,0,7
63146,3479,2010-03-10,Assembly,"Do pass as amended",11,3,3,0,17
63147,3484,2010-02-10,Senate,"Do pass, but re-refer to the Committee on Appropriations",8,0,1,0,9
63147,3485,2010-02-16,Senate,"Senate 3rd Reading SB27 Lowenthal",32,0,7,0,39
63148,3486,2010-02-10,Senate,"Do pass, but re-refer to the Committee on Appropriations",6,0,3,0,9
63148,3487,2010-02-12,Senate,"Do pass",6,1,4,0,11
63149,3466,2010-02-16,Senate,"Do pass, but re-refer to the Committee on Appropriations",5,0,1,0,6
63149,3467,2010-02-17,Senate,"Do pass",7,1,3,0,11
63149,3468,2010-02-18,Senate,"Senate 3rd Reading SB29 Steinberg",30,6,3,0,39
63149,3469,2010-02-22,Assembly,"Do pass",11,3,3,0,17
63149,3470,2010-03-08,Senate,"W/O REF. TO FILE SB29 Steinberg Concurrence",27,7,5,0,39
63149,3471,2010-03-08,Assembly,"SB 29 Steinberg  Senate Third Reading  By DE LA TORRE  Eighth Extraordinary Session",70,7,0,0,77
63150,3472,2010-02-25,Senate,"Do pass, but re-refer to the Committee on Appropriations",5,2,2,0,9
63150,3473,2010-03-01,Senate,"Do pass",7,3,1,0,11
63150,3474,2010-03-04,Senate,"Senate 3rd Reading SB30 Oropeza",23,8,8,0,39
63151,3450,2010-02-16,Senate,"Do pass, but re-refer to the Committee on Appropriations",9,0,2,0,11
63151,3451,2010-02-17,Senate,"Do pass",8,0,3,0,11
63151,3452,2010-02-18,Senate,"Senate 3rd Reading SB31 Cedillo",35,0,4,0,39
63152,1241,2010-02-11,Senate,"Do pass, but re-refer to the Committee on Appropriations.",3,2,0,0,5
63152,1242,2010-02-12,Senate,"Do pass.",6,1,4,0,11
63152,1243,2010-02-18,Senate,"Senate 3rd Reading SB32 Wolk",21,14,4,0,39
63152,1244,2010-02-24,Assembly,"Do pass and be re-referred to the Committee on Appropriations.",6,1,2,0,9
63152,1245,2010-02-25,Assembly,"Do pass.",10,5,2,0,17
63152,1246,2010-03-08,Assembly,"SB 32 Wolk  Senate Third Reading  By CALDERON  Eighth Extraordinary Session",47,29,0,0,76
63152,1247,2010-03-11,Senate,"Unfinished Business SB32 Wolk",21,15,3,0,39
63154,26154,2010-02-16,Senate,"Do pass, but re-refer to the Committee on Appropriations",6,0,0,0,6
63154,26155,2010-02-18,Senate,"Do pass as amended",9,1,0,0,10
63154,26156,2010-02-22,Senate,"Do pass",10,0,0,0,10
63154,26157,2010-02-22,Senate,"W/O REF. TO FILE SB34 Padilla",33,0,0,0,33
63154,26158,2010-03-09,Assembly,"Do pass and be re-referred to the Committee on Appropriations",10,1,0,0,11
63154,26159,2010-03-10,Assembly,"Do pass as amended",15,0,0,0,15
63154,26160,2010-03-11,Assembly,"SB 34 Padilla  Third Reading Urgency  By BLUMENFIELD  FORMERLY FILE 	ITEM1  Eighth Extraordinary Session",71,3,0,0,74
63154,26161,2010-03-11,Senate,"W/O REF. TO FILE SB34 Padilla Urgency Clause",32,0,0,0,32
63161,27049,2009-02-19,Senate,"W/O REF. TO FILE SCA4 Maldonado",27,12,0,0,39
63161,27050,2009-02-19,Assembly,"SCA4 Maldonado  Senate Third Reading  By CALDERON",54,20,0,0,74
63162,3443,2009-08-25,Senate,"Do pass, but re-refer to the Committee on Appropriations",3,2,0,0,5
63162,3444,2009-08-27,Senate,"Placed on Appropriations Suspense file",13,0,0,0,13
63162,3445,2009-08-27,Senate,"Do pass",8,5,0,0,13
63163,3447,2009-05-13,Senate,"Be adopted, but re-refer to the Committee on Elections, Reapportionmnt and Constitutional Amend",5,3,0,0,8
63163,3448,2009-06-11,Senate,"Be adopted",3,1,1,0,5
63165,22491,2009-02-19,Senate,"W/O REF. TO FILE SCA8 Maldonado",39,0,0,0,39
63165,22492,2009-02-19,Assembly,"SCA8 Maldonado  Senate Third Reading  By NIELLO",80,0,0,0,80
63167,3440,2009-06-16,Senate,"Be adopted, but re-refer to the Committee on Appropriations",3,2,0,0,5
63167,3441,2009-06-29,Senate,"Placed on Appropriations Suspense file",13,0,0,0,13
63167,3442,2009-08-27,Senate,"Do pass",8,5,0,0,13
63168,3434,2009-05-13,Senate,"Be adopted, but re-refer to the Committee on Elections, Reapportionmnt and Constitutional Amend",3,5,0,0,8
63168,3435,2009-05-13,Senate,"Set, first hearing.  Failed passage in Committee.  Reconsideration granted",8,0,0,0,8
63169,3436,2009-05-13,Senate,"Be adopted, but re-refer to the Committee on Elections, Reapportionmnt and Constitutional Amend",5,2,1,0,8
63169,3437,2009-06-11,Senate,"Be adopted",3,1,1,0,5
63170,3438,2009-05-13,Senate,"Be adopted, but re-refer to the Committee on Elections, Reapportionmnt and Constitutional Amend",6,0,2,0,8
63171,3427,2009-06-16,Senate,"Be adopted as amended, and re-refer to the Committee on Appropriations",3,1,1,0,5
63171,3428,2009-07-06,Senate,"Placed on Appropriations Suspense file",11,0,2,0,13
63171,3429,2009-08-27,Senate,"Do pass",8,5,0,0,13
63173,3431,2009-07-07,Senate,"Be adopted, but re-refer to the Committee on Appropriations",3,2,0,0,5
63173,3432,2009-07-23,Senate,"Placed on Appropriations Suspense file",13,0,0,0,13
63173,3433,2009-08-27,Senate,"Do pass",8,5,0,0,13
63175,3425,2009-05-20,Senate,"Do pass, but re-refer to the Committee on Elections, Reapportionmnt and Constitutional Amend",3,2,0,0,5
63175,3426,2009-06-16,Senate,"Be adopted",3,2,0,0,5
63176,4549,2009-07-07,Senate,"Be adopted, but re-refer to the Committee on Appropriations",3,2,0,0,5
63176,4550,2009-07-23,Senate,"Placed on Appropriations Suspense file",13,0,0,0,13
63176,4551,2009-08-27,Senate,"Do pass",8,5,0,0,13
63183,8491,2010-04-21,Senate,"Do pass",2,2,5,0,9
63183,8492,2010-04-21,Senate,"Set, second hearing.  Failed passage in Committee. Reconsideration granted",8,0,1,0,9
63190,22894,2008-12-01,Senate,"W/O REF. TO FILE SCR1 Oropeza",39,0,0,0,39
63190,22895,2009-04-23,Assembly,"Be adopted, as amended, to Consent Calendar",8,0,0,3,11
63190,22896,2009-04-23,Assembly,"Be adopted, as amended, to Consent Calendar",8,0,0,3,11
63190,22897,2009-05-04,Assembly,"SCR1 Oropeza  Consent Calendar Second Day  Regular Session",79,0,0,1,80
63190,22898,2009-05-11,Senate,"Unfinished Business SCR1 Oropeza Concurrence",31,0,8,0,39
63191,24050,2008-12-01,Assembly,"SCR2 Steinberg  Senate Third Reading",80,0,0,0,80
63191,24051,2008-12-01,Senate,"W/O REF. TO FILE SCR2 Steinberg",39,0,0,0,39
63193,23890,2009-03-31,Senate,"Be adopted, but re-refer to the Committee on Appropriations 	Recommend Consent",11,0,0,0,11
63193,23891,2009-04-23,Senate,"Special Consent #1 SCR4 DeSaulnier",37,0,0,0,37
63193,23892,2009-05-11,Assembly,"Be adopted, and re-refer to Committee on Appropriations with 	recommendation:  To Consent Calendar",14,0,0,0,14
63193,23893,2009-07-01,Assembly,"Be adopted, to Consent Calendar",15,0,0,0,15
63193,23894,2009-07-09,Assembly,"SCR4 DeSaulnier  Consent Calendar Second Day  Regular Session",74,0,0,0,74
63194,23522,2009-03-31,Senate,"Be adopted, but re-refer to the Committee on Appropriations 	Recommend Consent",11,0,0,0,11
63194,23523,2009-04-23,Senate,"Special Consent #1 SCR5 Runner",37,0,0,0,37
63194,23524,2009-05-11,Assembly,"Be adopted, and re-refer to Committee on Appropriations with 	recommendation:  To Consent Calendar",14,0,0,0,14
63194,23525,2009-07-01,Assembly,"Be adopted, to Consent Calendar",15,0,0,0,15
63194,23526,2009-07-09,Assembly,"SCR5 Runner  Consent Calendar Second Day  Regular Session",74,0,0,0,74
63195,3418,2009-03-02,Senate,"Senate 3rd Reading SCR6 Alquist",32,0,7,0,39
63196,22433,2009-01-29,Senate,"W/O REF. TO FILE SCR7 Denham",35,0,0,0,35
63196,22434,2009-02-14,Assembly,"Be adopted, to Consent Calendar",8,0,0,0,8
63196,22435,2009-02-23,Assembly,"SCR7 Denham  Consent Calendar Second Day",74,0,0,0,74
63198,23553,2009-03-31,Senate,"Be adopted, but re-refer to the Committee on Appropriations 	Recommend Consent",11,0,0,0,11
63198,23554,2009-04-23,Senate,"Special Consent #1 SCR9 Wiggins",37,0,0,0,37
63198,23555,2009-05-11,Assembly,"Be adopted, and re-refer to Committee on Appropriations with 	recommendation:  To Consent Calendar",14,0,0,0,14
63198,23556,2009-07-01,Assembly,"Be adopted, to Consent Calendar",15,0,0,0,15
63198,23557,2009-07-09,Assembly,"SCR9 Wiggins  Consent Calendar Second Day  Regular Session",74,0,0,0,74
63199,22903,2009-03-23,Senate,"W/O REF. TO FILE SCR10 Liu",37,0,0,0,37
63199,22904,2009-05-21,Assembly,"Be adopted, to Consent Calendar",9,0,0,0,9
63199,22905,2009-05-28,Assembly,"SCR 10 Liu  Consent Calendar Second Day  Regular Session",76,0,0,0,76
63201,22978,2009-03-31,Senate,"Be adopted as amended, but re-refer to the Committee on 	Appropriations Recommend Consent",11,0,0,0,11
63201,22979,2009-04-23,Senate,"Special Consent #1 SCR12 Dutton",37,0,0,0,37
63201,22980,2009-05-11,Assembly,"Be adopted, and re-refer to Committee on Appropriations with 	recommendation:  To Consent Calendar",14,0,0,0,14
63201,22981,2009-07-01,Assembly,"Be adopted, to Consent Calendar",15,0,0,0,15
63201,22982,2009-07-09,Assembly,"SCR 12 Dutton  Consent Calendar Second Day  Regular Session",74,0,0,0,74
63202,23456,2009-05-14,Senate,"Senate 3rd Reading SCR13 Steinberg",37,1,0,0,38
63202,23457,2009-08-31,Assembly,"Be adopted as amended",7,2,0,0,9
63202,23458,2009-09-02,Assembly,"SCR 13 Steinberg  Senate Third Reading  By MA",51,23,0,0,74
63202,23459,2009-09-08,Senate,"Unfinished Business SCR13 Steinberg",33,6,0,0,39
63203,25098,2009-06-08,Senate,"W/O REF. TO FILE SCR14 Aanestad",31,0,0,0,31
63203,25099,2009-06-30,Assembly,"Be adopted, to Consent Calendar",7,0,0,0,7
63203,25100,2009-07-08,Assembly,"Be adopted, to Consent Calendar",15,0,0,0,15
63203,25101,2009-07-13,Assembly,"SCR 14 Aanestad  Consent Calendar Second Day  Regular Session",74,0,0,0,74
63204,23410,2009-02-26,Senate,"W/O REF. TO FILE SCR15 Wiggins",21,8,0,0,29
63204,23411,2009-03-16,Assembly,"From committee:  Be adopted.  To third reading",9,2,0,0,11
63205,24980,2009-03-12,Senate,"Senate 3rd Reading SCR16 Runner",33,0,0,0,33
63205,24981,2009-03-31,Assembly,"From committee:  Be adopted.  To third reading",11,0,0,0,11
63205,24982,2009-04-02,Assembly,"SCR 16 Runner  Senate Third Reading  By BERRYHILL, T",75,0,0,0,75
63205,24983,2009-04-20,Senate,"Unfinished Business SCR16 Runner",35,0,0,0,35
63206,22408,2009-03-16,Senate,"Senate 3rd Reading SCR17 Corbett",34,0,0,0,34
63206,22409,2009-05-21,Assembly,"Be adopted, to Consent Calendar",9,0,0,0,9
63206,22410,2009-05-28,Assembly,"SCR 17 Corbett  Consent Calendar Second Day  Regular Session",76,0,0,0,76
63207,23615,2009-03-23,Senate,"W/O REF. TO FILE SCR18 Alquist",37,0,0,0,37
63207,23616,2009-04-30,Assembly,"Be adopted, to Consent Calendar",10,0,0,0,10
63207,23617,2009-05-11,Assembly,"SCR 18 Alquist  Consent Calendar Second Day  Regular Session",78,0,0,0,78
63208,23608,2009-03-23,Senate,"W/O REF. TO FILE SCR19 Steinberg",37,0,0,0,37
63208,23609,2009-04-30,Assembly,"Be adopted, to Consent Calendar",10,0,0,0,10
63208,23610,2009-05-11,Assembly,"SCR 19 Steinberg  Consent Calendar Second Day  Regular Session",78,0,0,0,78
63209,25039,2009-05-05,Senate,"Do pass as amended, and re-refer to the Committee on 	Appropriations",4,0,0,0,4
63209,25040,2009-06-01,Senate,"Senate 3rd Reading SCR20 Liu",32,0,0,0,32
63209,25041,2009-06-30,Assembly,"Be adopted, and re-refer to Committee on Appropriations with 	recommendation:  To Consent Calendar",10,0,0,0,10
63209,25042,2009-08-19,Assembly,"Be adopted, to Consent Calendar",17,0,0,0,17
63209,25043,2009-08-27,Assembly,"SCR 20 Liu  Consent Calendar Second Day  Regular Session",74,0,0,0,74
63210,25487,2009-03-11,Senate,"Be adopted",4,0,0,0,4
63210,25488,2009-03-16,Senate,"Senate 3rd Reading SCR21 Kehoe",34,0,0,0,34
63210,25489,2009-04-30,Assembly,"Be adopted, to Consent Calendar",10,0,0,0,10
63210,25490,2009-05-14,Assembly,"SCR 21 Kehoe  Senate Third Reading  By NAVA",74,0,0,0,74
63210,25491,2009-05-26,Senate,"Special Consent #6 SCR21 Kehoe",39,0,0,0,39
63211,25253,2009-03-12,Senate,"W/O REF. TO FILE SCR22 Steinberg",33,0,0,0,33
63211,25254,2009-04-16,Assembly,"Be adopted, to Consent Calendar",10,0,0,0,10
63211,25255,2009-04-23,Assembly,"SCR 22 Steinberg  Consent Calendar Second Day  Regular Session",71,0,0,0,71
63211,25256,2009-05-06,Senate,"Special Consent #2 SCR22 Steinberg",35,0,0,0,35
63212,22985,2009-03-23,Senate,"W/O REF. TO FILE SCR23 Steinberg",35,0,0,0,35
63212,22986,2009-05-11,Assembly,"Be adopted, to Consent Calendar",11,0,0,0,11
63212,22987,2009-05-14,Assembly,"SCR 23 Steinberg  Consent Calendar Second Day  Regular Session",73,0,0,0,73
63212,22988,2009-05-26,Senate,"Special Consent #6 SCR23 Steinberg",39,0,0,0,39
63213,22424,2009-05-14,Senate,"W/O REF. TO FILE SCR24 Ashburn",38,0,0,0,38
63213,22425,2009-06-30,Assembly,"Be adopted, to Consent Calendar",7,0,0,0,7
63213,22426,2009-07-02,Assembly,"SCR 24 Ashburn  Consent Calendar Second Day",77,0,0,0,77
63214,3417,2009-03-26,Senate,"W/O REF. TO FILE SCR25 Lowenthal",38,0,1,0,39
63215,25706,2009-04-16,Senate,"W/O REF. TO FILE SCR26 Correa",37,0,0,0,37
63215,25707,2009-05-04,Assembly,"From committee:  Be adopted.  To third reading",10,0,0,0,10
63215,25708,2009-05-06,Senate,"W/O REF. TO FILE SCR26 Correa Concurrence",33,0,0,0,33
63216,23162,2009-03-26,Senate,"W/O REF. TO FILE SCR27 Wolk",38,0,0,0,38
63216,23163,2009-05-14,Assembly,"Be adopted, to Consent Calendar",9,0,0,0,9
63216,23164,2009-05-21,Assembly,"SCR 27 Wolk  Consent Calendar Second Day  Regular Session",77,0,0,0,77
63217,26029,2009-04-23,Senate,"W/O REF. TO FILE SCR28 Correa",37,0,0,0,37
63217,26030,2009-05-18,Assembly,"Be adopted, to Consent Calendar",10,0,0,0,10
63217,26031,2009-05-21,Assembly,"SCR 28 Correa  Consent Calendar Second Day  Regular Session",77,0,0,0,77
63218,27165,2009-04-20,Senate,"Senate 3rd Reading SCR29 Correa",37,0,0,0,37
63218,27166,2010-04-12,Assembly,"Be adopted, to Consent Calendar",10,0,0,0,10
63218,27167,2010-04-15,Assembly,"SCR 29 Correa  Consent Calendar Second Day  Regular Session",70,0,0,0,70
63218,27168,2010-04-19,Senate,"Unfinished Business SCR29 Correa",31,0,0,0,31
63219,26669,2009-05-12,Senate,"Be adopted as amended, but re-refer to the Committee on 	Appropriations Recommend Consent",11,0,0,0,11
63219,26670,2009-06-02,Senate,"Special Consent #7 SCR30 Simitian",39,0,0,0,39
63219,26671,2009-06-29,Assembly,"Be adopted, and re-refer to Committee on Appropriations with 	recommendation:  To Consent Calendar",13,0,0,0,13
63219,26672,2009-07-08,Assembly,"Be adopted, to Consent Calendar",15,0,0,0,15
63219,26673,2009-07-13,Assembly,"SCR 30 Simitian  Consent Calendar Second Day  Regular Session",74,0,0,0,74
63220,26229,2009-05-14,Senate,"W/O REF. TO FILE SCR31 Runner",38,0,0,0,38
63220,26230,2009-06-08,Assembly,"Be adopted, to Consent Calendar",8,0,0,0,8
63220,26231,2009-06-15,Assembly,"SCR 31 Runner  Consent Calendar Second Day",72,0,0,0,72
63221,23097,2009-05-06,Senate,"W/O REF. TO FILE SCR32 Strickland",35,0,0,0,35
63221,23098,2009-05-18,Assembly,"From committee:  Be adopted.  To third reading",10,0,0,0,10
63222,26555,2009-04-23,Senate,"W/O REF. TO FILE SCR33 Calderon",37,0,0,0,37
63222,26556,2009-05-11,Assembly,"From committee:  Be adopted.  To third reading",11,0,0,0,11
63222,26557,2009-05-21,Assembly,"SCR 33 Calderon  Consent Calendar Second Day  Regular Session",77,0,0,0,77
63223,25941,2009-06-10,Senate,"Do pass, but re-refer to the Committee on Appropriations",7,0,0,0,7
63223,25942,2009-08-24,Senate,"Senate 3rd Reading SCR34 Ducheny Concurrence",34,0,0,0,34
63223,25943,2009-08-31,Assembly,"Be adopted as amended",8,0,0,0,8
63223,25944,2009-09-08,Senate,"Unfinished Business SCR34 Ducheny",35,0,0,0,35
63224,3408,2009-05-18,Senate,"Senate 3rd Reading SCR35 Steinberg",36,0,3,0,39
63225,22891,2009-05-18,Senate,"Senate 3rd Reading SCR36 Alquist",33,0,0,0,33
63225,22892,2009-06-30,Assembly,"From committee:  Be adopted.  To third reading",18,0,0,0,18
63225,22893,2009-08-20,Assembly,"SCR 36 Alquist  Senate Third Reading  By FLETCHER",77,0,0,0,77
63226,8949,2010-06-15,Senate,"Be adopted, but re-refer to the Committee on Appropriations Recommend Consent",8,0,1,0,9
63226,19103,2010-08-02,Senate,"Consent Calendar 2nd SCR37 Wiggins",33,0,0,0,33
63226,19644,2010-08-09,Assembly,"Be adopted, and re-refer to Committee on Appropriations with 	recommendation:  To Consent Calendar",12,0,0,0,12
63226,19977,2010-08-12,Assembly,"Be adopted, to Consent Calendar",17,0,0,0,17
63226,20377,2010-08-17,Assembly,"SCR 37 Wiggins  Consent Calendar Second Day  Regular Session",76,0,0,0,76
63228,23189,2009-05-14,Senate,"W/O REF. TO FILE SCR39 Steinberg",38,0,0,0,38
63228,23190,2009-06-08,Assembly,"Be adopted, to Consent Calendar",8,0,0,0,8
63228,23191,2009-06-24,Senate,"Special Consent #10 SCR39 Steinberg",40,0,0,0,40
63229,2927,2009-06-23,Senate,"Be adopted",5,0,2,0,7
63229,2928,2009-08-24,Senate,"Senate 3rd Reading SCR40 Yee Concurrence",22,12,6,0,40
63229,9124,2010-06-15,Assembly,"Be adopted as amended",4,2,1,0,7
63229,9664,2010-06-28,Assembly,"SCR 40 Yee  Senate Third Reading  By AMMIANO",45,27,7,0,79
63229,10019,2010-07-01,Senate,"Unfinished Business SCR40 Yee",22,12,5,0,39
63230,23240,2009-05-18,Senate,"Senate 3rd Reading SCR41 Yee",36,0,0,0,36
63230,23241,2009-06-18,Assembly,"Be adopted, to Consent Calendar",11,0,0,0,11
63230,23242,2009-06-24,Assembly,"SCR 41 Yee  Consent Calendar Second Day  Regular Session",72,0,0,0,72
63231,3410,2009-05-21,Senate,"Senate 3rd Reading SCR42 Negrete McLeod",29,0,10,0,39
63232,25434,2009-05-14,Senate,"W/O REF. TO FILE SCR43 Huff",38,0,0,0,38
63232,25435,2009-06-30,Assembly,"Be adopted, to Consent Calendar",7,0,0,0,7
63232,25436,2009-07-02,Assembly,"SCR 43 Huff  Consent Calendar Second Day  Regular Session",77,0,0,0,77
63232,25437,2009-07-16,Senate,"Special Consent #13 SCR43 Huff",36,0,0,0,36
63233,3411,2009-07-01,Senate,"Be adopted as amended, and re-refer to the Committee on Appropriations",7,0,2,0,9
63233,3412,2009-07-23,Senate,"Do pass as amended",9,3,1,0,13
63233,3413,2009-09-02,Senate,"Senate 3rd Reading SCR44 Corbett",24,10,6,0,40
63234,23366,2009-05-14,Senate,"W/O REF. TO FILE SCR45 Benoit",38,0,0,0,38
63234,23367,2009-06-08,Assembly,"Be adopted, to Consent Calendar",8,0,0,0,8
63234,23368,2009-06-15,Assembly,"SCR 45 Benoit  Consent Calendar Second Day  Regular Session",72,0,0,0,72
63235,3407,2009-05-14,Senate,"W/O REF. TO FILE SCR46 Harman",38,0,1,0,39
63236,3409,2009-08-24,Senate,"Senate 3rd Reading SCR47 DeSaulnier Concurrence",24,11,5,0,40
63236,9135,2010-06-16,Assembly,"From committee:  Be adopted.  To third reading",6,2,1,0,9
63236,9757,2010-06-28,Assembly,"SCR 47 DeSaulnier  Senate Third Reading  By TORLAKSON",49,20,10,0,79
63236,19610,2010-08-09,Senate,"Unfinished Business SCR47 DeSaulnier",22,11,0,0,33
63237,26604,2009-07-09,Senate,"Special Consent #12 SCR48 Yee",34,0,0,0,34
63237,26605,2009-08-24,Assembly,"Be adopted, to Consent Calendar",9,0,0,0,9
63237,26606,2009-08-27,Assembly,"SCR 48 Yee  Consent Calendar Second Day  Regular Session",74,0,0,0,74
63237,26607,2009-09-09,Senate,"Unfinished Business SCR48 Yee",39,0,0,0,39
63238,3402,2009-09-10,Senate,"Senate 3rd Reading SCR49 DeSaulnier",26,13,1,0,40
63239,3403,2009-07-14,Senate,"Be adopted, but re-refer to the Committee on Appropriations Recommend Consent",11,0,0,0,11
63239,3404,2009-08-27,Senate,"Special Consent #16 SCR50 Cox",38,0,2,0,40
63239,8781,2010-06-07,Assembly,"Be adopted, and re-refer to Committee on Appropriations with recommendation:  To Consent Calendar",11,0,3,0,14
63239,10246,2010-06-30,Assembly,"Be adopted, to Consent Calendar",16,0,1,0,17
63239,19088,2010-08-02,Assembly,"SCR 50  Consent Calendar Second Day  Regular Session",76,0,0,0,76
63240,3405,2009-08-24,Senate,"Senate 3rd Reading SCR51 Corbett",39,0,1,0,40
63241,3406,2009-08-27,Senate,"Senate 3rd Reading SCR52 Lowenthal",37,0,3,0,40
63242,23337,2009-07-24,Senate,"W/O REF. TO FILE SCR53 Corbett",38,0,0,0,38
63242,23338,2009-08-25,Assembly,"Be adopted as amended",7,0,0,0,7
63242,23339,2009-09-02,Assembly,"SCR 53 Corbett  Senate Third Reading  By TORRICO",74,2,0,0,76
63242,23340,2009-09-08,Senate,"Unfinished Business SCR53 Corbett",37,1,0,0,38
63243,5422,2010-04-06,Senate,"Be adopted as amended, but re-refer to the Committee on Appropriations Recommend Consent",8,0,1,0,9
63243,5423,2010-05-10,Senate,"Consent Calendar 2nd SCR54 Cogdill",30,0,8,0,38
63243,8734,2010-06-07,Assembly,"Be adopted, and re-refer to Committee on Appropriations with recommendation:  To Consent Calendar",11,0,3,0,14
63243,10067,2010-06-30,Assembly,"Be adopted, to Consent Calendar",16,0,1,0,17
63243,19235,2010-08-02,Assembly,"SCR 54 Cogdill  Consent Calendar Second Day  Regular Session",76,0,0,0,76
63243,19629,2010-08-09,Senate,"Special Consent #30 SCR54 Cogdill",34,0,0,0,34
63244,26635,2009-09-08,Senate,"W/O REF. TO FILE SCR55 Wolk",34,5,0,0,39
63246,25222,2009-09-11,Senate,"W/O REF. TO FILE SCR57 Calderon",22,0,0,0,22
63247,3400,2009-09-10,Senate,"W/O REF. TO FILE SCR58 Cedillo",26,9,5,0,40
63247,9133,2010-06-15,Assembly,"From committee:  Be adopted.  To third reading",7,2,1,0,10
63247,9134,2010-06-21,Assembly,"SCR 58 Cedillo  Senate Third Reading  By COTO",48,20,11,0,79
63248,3401,2009-09-11,Senate,"Senate 3rd Reading SCR59 Cedillo",23,12,5,0,40
63250,3399,2010-01-19,Senate,"SENATE 3RD READING SCR61 PRICE",30,0,9,0,39
63252,27225,2010-03-22,Senate,"Do pass",9,0,0,0,9
63252,27226,2010-04-08,Senate,"Senate 3rd Reading SCR63 Yee",34,0,0,0,34
63252,27227,2010-05-04,Assembly,"Be adopted, to Consent Calendar",11,0,0,0,11
63252,27228,2010-05-06,Assembly,"SCR 63 Yee  Consent Calendar Second Day  Regular Session",74,0,0,0,74
63253,24039,2010-01-28,Senate,"W/O REF. TO FILE SCR64 ROMERO",37,0,0,0,37
63253,24040,2010-02-01,Assembly,"From committee:  Be adopted.  To third reading",10,0,0,0,10
63253,24041,2010-02-18,Senate,"Unfinished Business SCR64 Romero",35,0,0,0,35
63255,27222,2010-03-25,Senate,"Senate 3rd Reading SCR66 Steinberg",33,0,0,0,33
63255,27223,2010-04-29,Assembly,"Be adopted, to Consent Calendar",10,0,0,0,10
63255,27224,2010-05-06,Assembly,"SCR 66 Steinberg  Consent Calendar Second Day  Regular Session",74,0,0,0,74
63256,10355,2010-07-01,Senate,"Senate 3rd Reading SCR67 Walters",35,0,4,0,39
63256,20274,2010-08-12,Assembly,"Be adopted, to Consent Calendar",9,0,0,0,9
63256,20359,2010-08-17,Assembly,"SCR 67 Walters  Consent Calendar Second Day  Regular Session",76,0,0,0,76
63258,26788,2009-04-22,Senate,"Be adopted",5,3,0,0,8
63258,26789,2009-05-18,Senate,"Senate 3rd Reading SJR1 Ducheny",19,16,0,0,35
63258,26790,2009-05-18,Senate,"Senate 3rd Reading SJR1 Ducheny Reconsider",36,0,0,0,36
63258,26791,2009-06-03,Senate,"Senate 3rd Reading SJR1 Ducheny",22,16,0,0,38
63258,26792,2009-07-06,Assembly,"Be adopted as amended",6,3,0,0,9
63258,26793,2009-08-24,Assembly,"SJR1 Ducheny  Senate Third Reading  By MA",44,31,0,0,75
63258,26794,2009-09-04,Senate,"Unfinished Business SJR1 Ducheny",24,15,0,0,39
63259,3396,2009-04-01,Senate,"Be adopted, but re-refer to the Committee on Appropriations Recommend Consent",8,0,1,0,9
63259,3397,2009-04-23,Senate,"Senate 3rd Reading SJR2 Liu",35,0,4,0,39
63259,3398,2009-06-23,Assembly,"Be adopted and be re-referred to the Committee on Appropriations",9,0,0,0,9
63261,25981,2009-04-23,Senate,"W/O REF. TO FILE SJR4 Correa",32,1,0,0,33
63261,25982,2009-07-07,Assembly,"From committee:  Be adopted.  To third reading",5,0,0,0,5
63261,25983,2009-08-17,Assembly,"SJR4 Correa  Senate Third Reading  By LOWENTHAL",73,0,0,0,73
63261,25984,2009-08-24,Senate,"Unfinished Business SJR4 Correa Concurrence",32,1,0,0,33
63262,23884,2009-06-08,Senate,"W/O REF. TO FILE SJR5 Wiggins Reconsider",31,0,0,0,31
63262,23885,2009-06-08,Senate,"W/O REF. TO FILE SJR5 Wiggins",20,10,0,0,30
63262,23886,2009-06-22,Senate,"Senate 3rd Reading SJR5 Wiggins",23,12,0,0,35
63262,23887,2009-07-08,Assembly,"Be adopted as amended",5,3,0,0,8
63262,23888,2009-08-20,Assembly,"SJR5 Wiggins  Senate Third Reading  By EVANS",50,26,0,0,76
63262,23889,2009-09-02,Senate,"Unfinished Business SJR5 Wiggins",23,13,0,0,36
63263,25839,2009-05-11,Senate,"Special Consent #3 SJR6 Lowenthal",36,0,0,0,36
63263,25840,2009-06-22,Assembly,"From committee:  Be adopted.  To third reading",14,0,0,0,14
63263,25841,2009-06-25,Assembly,"SJR6 Lowenthal  Senate Third Reading  By NIELLO",70,2,0,0,72
63264,25403,2009-05-21,Senate,"Senate 3rd Reading SJR7 Lowenthal",36,0,0,0,36
63264,25404,2009-06-23,Assembly,"From committee:  Be adopted.  To third reading",19,0,0,0,19
63264,25405,2009-07-09,Assembly,"SJR7 Lowenthal  Senate Third Reading  By TORLAKSON",67,2,0,0,69
63264,25406,2009-08-17,Senate,"Special Consent #14 SJR7 Lowenthal",35,0,0,0,35
63265,3391,2009-07-16,Senate,"Senate 3rd Reading SJR8 Corbett",22,13,5,0,40
63266,27262,2009-06-23,Senate,"Do pass",4,1,0,0,5
63266,27263,2009-08-24,Senate,"Senate 3rd Reading SJR9 Kehoe Concurrence",23,13,0,0,36
63266,27264,2010-01-12,Assembly,"From committee:  Be adopted.  To third reading",6,3,0,0,9
63266,27265,2010-04-29,Assembly,"SJR9 Kehoe  Senate Third Reading  By SALAS  Amend By SALAS  Set #1",45,27,0,0,72
63266,27266,2010-05-13,Assembly,"SJR9 Kehoe  Senate Third Reading  By SALAS",51,21,0,0,72
63266,27267,2010-05-27,Senate,"Unfinished Business SJR9 Kehoe",24,7,0,0,31
63267,22802,2009-06-26,Senate,"Special Consent Cal SJR10 Committee on V.A. (Denham)",36,0,0,0,36
63267,22803,2009-08-27,Assembly,"Be adopted, to Consent Calendar",8,0,0,0,8
63267,22804,2009-09-09,Assembly,"SJR 10 V. A.  Consent Calendar Second Day",73,0,0,0,73
63268,3382,2009-07-07,Senate,"Be adopted",2,4,1,0,7
63269,3383,2009-07-07,Senate,"Be adopted as amended",6,0,1,0,7
63269,3384,2009-08-17,Senate,"Special Consent #14 SJR12 Benoit",35,0,5,0,40
63270,3376,2009-07-08,Senate,"Be adopted and be placed on the Consent Calendar",11,0,0,0,11
63270,3377,2009-07-16,Senate,"Consent Calendar 2nd SJR13 Oropeza",36,0,4,0,40
63270,9127,2010-06-15,Assembly,"Be adopted, to Consent Calendar",18,0,1,0,19
63270,9128,2010-06-21,Assembly,"SJR 13 Oropeza  Consent Calendar Second Day  Regular Session",75,0,4,0,79
63271,3378,2009-07-15,Senate,"Be adopted",7,3,1,0,11
63271,3379,2009-08-24,Senate,"Senate 3rd Reading SJR14 Leno",23,15,2,0,40
63271,9126,2010-06-15,Assembly,"From committee:  Be adopted.  To third reading",10,5,4,0,19
63271,21755,2010-08-30,Assembly,"SJR 14 Leno  Senate Third Reading  By AMMIANO",37,29,0,0,66
63272,3380,2009-07-15,Senate,"Be adopted as amended. To Consent Calendar",10,0,1,0,11
63272,3381,2009-08-20,Senate,"Consent Calendar 2nd SJR15 Alquist",40,0,0,0,40
63272,9129,2010-06-15,Assembly,"Be adopted, to Consent Calendar",18,0,1,0,19
63272,9130,2010-06-21,Assembly,"SJR 15 Alquist  Consent Calendar Second Day  Regular Session",75,0,4,0,79
63273,3374,2009-07-09,Senate,"W/O REF. TO FILE SJR16 Denham",34,0,6,0,40
63274,27152,2009-08-26,Senate,"Be adopted",5,2,0,0,7
63274,27153,2009-09-09,Senate,"Senate 3rd Reading SJR17 Leno",23,13,0,0,36
63274,27154,2010-04-12,Assembly,"Be adopted",6,3,0,0,9
63274,27155,2010-04-22,Assembly,"SJR 17 Leno  Senate Third Reading  By MONNING",46,21,0,0,67
63275,27257,2010-03-23,Senate,"Do pass as amended",5,3,0,0,8
63275,27258,2010-04-08,Senate,"Senate 3rd Reading SJR18 Simitian",23,11,0,0,34
63275,27259,2010-04-27,Assembly,"From committee:  Be adopted.  To third reading",8,3,0,0,11
63275,27260,2010-05-17,Assembly,"SJR 18 Simitian  Senate Third Reading  By HUFFMAN",48,23,0,0,71
63275,27261,2010-05-27,Senate,"Unfinished Business SJR18 Simitian",22,9,0,0,31
63276,3375,2009-09-10,Senate,"W/O REF. TO FILE SJR19 Cedillo",23,14,3,0,40
63277,2363,2010-05-12,Senate,"Do pass and be placed on the Consent Calendar",4,0,1,0,5
63277,2364,2010-05-24,Senate,"Consent Calendar 2nd SJR20 Alquist",32,0,6,0,38
63277,9969,2010-06-28,Assembly,"Be adopted, to Consent Calendar",9,0,0,0,9
63277,9970,2010-07-01,Assembly,"SJR 20 Alquist  Consent Calendar Second Day  Regular Session",76,0,3,0,79
63278,4067,2010-02-25,Senate,"Senate 3rd Reading SJR21 Wright",36,0,3,0,39
63278,9181,2010-06-15,Assembly,"From committee:  Be adopted.  To third reading",9,0,0,0,9
63278,9182,2010-06-21,Assembly,"SJR 21 Wright  Senate Third Reading  By BRADFORD",74,0,5,0,79
63278,9386,2010-06-24,Senate,"Unfinished Business SJR21 Wright",29,0,10,0,39
63354,3681,2010-05-05,Assembly,"Do pass, to Consent Calendar",6,0,0,0,6
63354,3682,2010-05-13,Assembly,"AB 1739 LIEU  Consent Calendar Second Day  Regular Session",76,0,3,0,79
63354,8699,2010-06-14,Senate,"Do pass",6,0,0,0,6
63354,9641,2010-06-28,Senate,"Assembly 3rd Reading AB1739 Lieu By Correa",34,0,5,0,39
63355,2677,2010-03-22,Assembly,"Do pass and be re-referred to the Committee on Appropriations",7,4,3,0,14
63355,2678,2010-03-22,Assembly,"Set first hearing.  Failed passage.  Reconsideration granted",14,0,0,0,14
63355,2679,2010-04-05,Assembly,"Do pass and be re-referred to the Committee on Appropriations",8,4,2,0,14
63355,2680,2010-04-21,Assembly,"Do pass as amended",11,6,0,0,17
63355,2681,2010-05-03,Assembly,"AB 1740 JEFFRIES  Assembly Third Reading",44,22,13,0,79
63355,9090,2010-06-15,Senate,"Do pass, but re-refer to the Committee on Appropriations",3,5,1,0,9
63355,9091,2010-06-15,Senate,"Set, first hearing.  Failed passage in Committee.  Reconsideration granted",8,0,1,0,9
63355,10363,2010-06-15,Senate,"Set, first hearing.  Failed passage in Committee.  Reconsideration granted",8,0,1,0,9
63356,4143,2010-04-07,Assembly,"Do pass as amended and be re-referred to the Committee on Appropriations",6,2,1,0,9
63356,4144,2010-05-05,Assembly,"Do pass",12,5,0,0,17
63356,4145,2010-05-13,Assembly,"AB 1741 COTO  Assembly Third Reading",49,27,3,0,79
63356,9344,2010-06-23,Senate,"Do pass as amended, and re-refer to the Committee on Appropriations",5,0,4,0,9
63357,4051,2010-03-11,Assembly,"Be referred to Committee on Education",10,0,1,0,11
63357,4052,2010-05-05,Assembly,"Do pass, to Consent Calendar",9,0,0,0,9
63357,4053,2010-05-13,Assembly,"AB 1742 COTO  Consent Calendar Second Day  Regular Session",76,0,3,0,79
63357,9305,2010-06-23,Senate,"Do pass and be placed on the Consent Calendar",6,0,3,0,9
63357,10342,2010-07-01,Senate,"Consent Calendar 2nd AB1742 Coto",34,0,5,0,39
63357,19549,2010-08-02,Assembly,"AB 1742 COTO  Concurrence in Senate Amendments",77,0,0,0,77
63358,2984,2010-04-07,Assembly,"Do pass and be re-referred to the Committee on Elections and Redistricting",4,1,1,0,6
63358,2985,2010-04-20,Assembly,"Do pass and be re-referred to the Committee on Appropriations",7,0,0,0,7
63358,2986,2010-05-28,Assembly,"Do pass",11,5,1,0,17
63358,2987,2010-06-02,Assembly,"AB 1743 HERNANDEZ  Assembly Third Reading",56,8,15,0,79
63358,9296,2010-06-23,Senate,"Do pass, but re-refer to the Committee on Elections, Reapportionmnt and Constitutional Amend",4,1,1,0,6
63358,9725,2010-06-29,Senate,"Do pass, but re-refer to the Committee on Appropriations",4,0,1,0,5
63358,19666,2010-08-02,Senate,"Do pass as amended",8,0,0,0,8
63358,21754,2010-08-30,Senate,"Assembly 3rd Reading AB1743 Hernandez By Correa",29,7,0,0,36
63358,21864,2010-08-31,Assembly,"AB 1743 Hernandez  Concurrence in Senate Amendments",64,13,0,0,77
63359,663,2010-04-21,Assembly,"Do pass and be re-referred to the Committee on Appropriations.",4,2,0,0,6
63360,1342,2010-04-13,Assembly,"Do pass.",7,3,0,0,10
63360,1343,2010-05-03,Assembly,"AB 1745 AMMIANO  Assembly Third Reading",46,29,4,0,79
63360,8736,2010-06-15,Senate,"Do pass",3,2,0,0,5
63360,21308,2010-08-23,Senate,"Assembly 3rd Reading AB1745 Ammiano By Yee",21,15,0,0,36
63360,21309,2010-08-24,Assembly,"AB 1745 AMMIANO  Concurrence in Senate Amendments",49,28,0,0,77
63361,306,2010-03-23,Assembly,"Do pass and re-refer to Committee on Appropriations with recommendation:  To Consent Calendar.",11,0,0,0,11
63361,307,2010-04-14,Assembly,"Do pass, to Consent Calendar.",15,0,2,0,17
63361,308,2010-04-22,Assembly,"AB 1746 EMMERSON  Consent Calendar Second Day  Regular Session",74,0,5,0,79
63361,8713,2010-06-14,Senate,"Do pass as amended, and re-refer to the Committee on Appropriations",7,0,2,0,9
63361,19718,2010-08-09,Senate,"Special Consent #30 AB1746 Emmerson",34,0,0,0,34
63361,20487,2010-08-17,Assembly,"AB 1746  Concurrence in Senate Amendments By COOK",77,0,0,0,77
63362,2858,2010-04-05,Assembly,"Do pass and be re-referred to the Committee on Appropriations",13,1,0,0,14
63362,2859,2010-04-21,Assembly,"Do pass",15,1,1,0,17
63362,2860,2010-05-20,Assembly,"AB 1747 GALGIANI  Assembly Third Reading",66,0,13,0,79
63363,3584,2010-04-21,Assembly,"Do pass and be re-referred to the Committee on Appropriations",21,0,1,0,22
63363,3585,2010-05-05,Assembly,"Do pass, to Consent Calendar",17,0,0,0,17
63363,3586,2010-05-17,Assembly,"AB 1748 HILL  Assembly Third Reading",72,0,7,0,79
63363,6477,2010-06-09,Senate,"Do pass and be placed on the Consent Calendar",6,0,5,0,11
63363,9416,2010-06-24,Senate,"Assembly 3rd Reading AB1748 Hill By Yee",31,0,8,0,39
63363,9659,2010-06-28,Assembly,"AB 1748 HILL  Concurrence in Senate Amendments",77,0,2,0,79
63364,186,2010-04-20,Assembly,"Do pass as amended and be re-referred to the Committee on Appropriations.",10,0,0,0,10
63364,187,2010-05-12,Assembly,"Do pass.",16,0,1,0,17
63364,188,2010-05-24,Assembly,"AB 1749 LOWENTHAL  Assembly Third Reading",70,0,9,0,79
63364,10200,2010-06-29,Senate,"Do pass, but re-refer to the Committee on Appropriations Recommend Consent",4,0,1,0,5
63364,19473,2010-08-05,Senate,"Consent Calendar 2nd AB1749 Bonnie Lowenthal",33,0,0,0,33
63366,1981,2010-04-20,Assembly,"Do pass and be re-referred to the Committee on Appropriations",4,3,0,0,7
63366,1982,2010-05-05,Assembly,"Do pass",12,4,1,0,17
63366,1983,2010-06-03,Assembly,"AB 1751 AMMIANO  Assembly Third Reading",27,37,15,0,79
63368,322,2010-04-21,Assembly,"Do pass and re-refer to Committee on Appropriations with recommendation:  To Consent Calendar.",21,0,1,0,22
63368,323,2010-05-12,Assembly,"Do pass.",15,0,2,0,17
63368,324,2010-05-20,Assembly,"AB 1753 HALL  Assembly Third Reading",71,0,8,0,79
63368,9367,2010-06-22,Senate,"Do pass, but re-refer to the Committee on Appropriations",7,0,0,0,7
63368,19606,2010-08-09,Senate,"Special Consent #30 AB1753 Hall",34,0,0,0,34
63370,1587,2010-04-28,Assembly,"Do pass as amended",7,1,1,0,9
63370,1588,2010-05-06,Assembly,"AB 1755 SWANSON  Assembly Third Reading",55,18,6,0,79
63370,10177,2010-06-30,Senate,"Do pass as amended",4,1,0,0,5
63370,20955,2010-08-24,Senate,"Assembly 3rd Reading AB1755 Swanson By DeSaulnier",25,10,0,0,35
63370,21239,2010-08-25,Assembly,"AB 1755 SWANSON  Concurrence in Senate Amendments",54,23,0,0,77
63371,189,2010-04-13,Assembly,"Do pass and be re-referred to the Committee on Appropriations.",4,1,1,0,6
63371,190,2010-04-28,Assembly,"Do pass.",10,5,2,0,17
63371,191,2010-05-13,Assembly,"AB 1756 SWANSON  Assembly Third Reading",44,31,4,0,79
63371,9492,2010-06-22,Senate,"Do pass, but re-refer to the Committee on Appropriations",3,2,0,0,5
63371,19693,2010-08-02,Senate,"Placed on Appropriations Suspense file",10,0,0,0,10
63372,1865,2010-03-23,Assembly,"Do pass as amended and be re-referred to the Committee on Appropriations",7,0,2,0,9
63372,1866,2010-05-28,Assembly,"Do pass as amended",17,0,0,0,17
63372,1867,2010-06-02,Assembly,"AB 1757 MONNING  Assembly Third Reading",76,0,3,0,79
63372,9495,2010-06-22,Senate,"Do pass, but re-refer to the Committee on Appropriations",4,0,1,0,5
63372,19435,2010-08-02,Senate,"Placed on Appropriations Suspense file",10,0,0,0,10
63372,20237,2010-08-12,Senate,"Do pass",11,0,0,0,11
63372,20524,2010-08-19,Senate,"Assembly 3rd Reading AB1757 Monning By Denham",34,0,0,0,34
63372,20822,2010-08-23,Assembly,"AB 1757 MONNING  Concurrence in Senate Amendments",76,0,0,0,76
63373,893,2010-03-23,Assembly,"Do pass as amended and re-refer to Committee on Appropriations with recommendation:  To Consent Calendar.",6,0,0,0,6
63373,894,2010-04-14,Assembly,"Do pass, to Consent Calendar.",15,0,2,0,17
63373,895,2010-04-22,Assembly,"AB 1758 AMMIANO  Consent Calendar Second Day  Regular Session",74,0,5,0,79
63373,9291,2010-06-22,Senate,"Do pass as amended, and re-refer to the Committee on Appropriations",5,0,0,0,5
63373,19213,2010-08-02,Senate,"Do pass",9,0,0,0,9
63373,20547,2010-08-19,Senate,"Assembly 3rd Reading AB1758 Ammiano By Liu",35,0,0,0,35
63373,20862,2010-08-23,Assembly,"AB 1758 AMMIANO  Concurrence in Senate Amendments",76,0,0,0,76
63374,3604,2010-04-13,Assembly,"Do pass as amended",12,6,1,0,19
63374,3605,2010-05-06,Assembly,"AB 1759 BLUMENFIELD  Assembly Third Reading",44,28,7,0,79
63374,10357,2010-06-30,Senate,"Do pass as amended",6,2,1,0,9
63374,19990,2010-08-09,Senate,"Do pass",7,2,0,0,9
63374,20829,2010-08-23,Senate,"Assembly 3rd Reading AB1759 Blumenfield By Cedillo",22,14,0,0,36
63374,21082,2010-08-25,Assembly,"AB 1759 BLUMENFIELD  Concurrence in Senate Amendments",50,26,0,0,76
63375,2590,2010-04-12,Assembly,"Do pass as amended and be re-referred to the Committee on Appropriations",10,0,4,0,14
63375,2591,2010-04-28,Assembly,"Do pass, to Consent Calendar",15,0,2,0,17
63375,2592,2010-05-06,Assembly,"AB 1760 BLUMENFIELD  Consent Calendar Second Day  Regular Session",74,0,5,0,79
63375,9349,2010-06-22,Senate,"Do pass as amended, and re-refer to the Committee on Appropriations",7,0,2,0,9
63375,19469,2010-08-02,Senate,"Placed on Appropriations Suspense file",10,0,0,0,10
63375,20105,2010-08-12,Senate,"Do pass",11,0,0,0,11
63375,20629,2010-08-19,Senate,"Assembly 3rd Reading AB1760 Blumenfield By Huff",33,0,0,0,33
63375,20787,2010-08-23,Assembly,"AB 1760 BLUMENFIELD  Concurrence in Senate Amendments",75,0,0,0,75
63376,5134,2010-03-16,Assembly,"Do pass and be re-referred to the Committee on Appropriations",8,0,0,0,8
63377,4631,2010-03-23,Assembly,"Do pass",10,0,1,0,11
63377,4632,2010-04-08,Assembly,"AB 1762 HAYASHI  Assembly Third Reading",73,0,6,0,79
63377,9041,2010-06-16,Senate,"Do pass, but re-refer to the Committee on Rules Recommend Consent",9,0,2,0,11
63377,9634,2010-06-28,Senate,"Special Consent #28 AB1762 Hayashi",32,0,7,0,39
63377,10124,2010-07-01,Assembly,"AB 1762 HAYASHI  Concurrence in Senate Amendments",79,0,0,0,79
63378,787,2010-04-13,Assembly,"Do pass and be re-referred to the Committee on Appropriations.",4,0,2,0,6
63378,788,2010-05-28,Assembly,"Do pass.",12,5,0,0,17
63378,789,2010-06-03,Assembly,"AB 1763 LIEU  Third Reading Urgency",54,22,3,0,79
63378,9204,2010-06-22,Senate,"Do pass, but re-refer to the Committee on Public Safety",4,0,1,0,5
63378,10297,2010-06-29,Senate,"Do pass as amended, and re-refer to the Committee on Appropriations",5,1,1,0,7
63378,19457,2010-08-02,Senate,"Placed on Appropriations Suspense file",10,0,0,0,10
63378,20076,2010-08-12,Senate,"Do pass as amended",7,4,0,0,11
63379,5022,2010-04-07,Assembly,"Do pass and be re-referred to the Committee on Appropriations",4,1,1,0,6
63380,968,2010-04-07,Assembly,"Do pass and be re-referred to the Committee on Appropriations.",4,0,2,0,6
63380,969,2010-05-28,Assembly,"Do pass.",12,5,0,0,17
63380,970,2010-06-01,Assembly,"AB 1765 SOLORIO  Assembly Third Reading",55,14,10,0,79
63380,9588,2010-06-28,Senate,"Do pass, but re-refer to the Committee on Appropriations",4,2,0,0,6
63380,10922,2010-07-15,Senate,"Placed on Appropriations Suspense file",8,0,2,0,10
63380,20150,2010-08-12,Senate,"Do pass",7,4,0,0,11
63380,21468,2010-08-24,Senate,"Assembly 3rd Reading AB1765 Solorio By DeSaulnier",25,9,0,0,34
63381,1041,2010-04-14,Assembly,"Amend, and re-refer to the Committee on Local Government.",8,0,1,0,9
63381,1042,2010-04-21,Assembly,"Do pass and be re-referred to the Committee on Revenue and Taxation.",6,3,0,0,9
63381,1043,2010-05-10,Assembly,"Do pass and be re-referred to the Committee on Appropriations.",9,0,0,0,9
63381,1044,2010-05-19,Assembly,"Do pass.",16,0,1,0,17
63381,1045,2010-05-24,Assembly,"AB 1766 GAINES  Third Reading Urgency",71,0,8,0,79
63381,9415,2010-06-23,Senate,"Do pass, but re-refer to the Committee on Appropriations",3,0,2,0,5
63381,10652,2010-07-15,Senate,"Placed on Appropriations Suspense file",8,0,2,0,10
63381,20279,2010-08-12,Senate,"Do pass as amended",11,0,0,0,11
63381,21587,2010-08-27,Senate,"Assembly 3rd Reading AB1766 Gaines By Aanestad",35,0,0,0,35
63381,21675,2010-08-30,Assembly,"AB 1766 Gaines  Concurrence in Senate Amendments",76,0,0,0,76
63382,731,2010-03-23,Assembly,"Do pass and be re-referred to the Committee on Appropriations.",10,0,1,0,11
63382,732,2010-04-14,Assembly,"Do pass.",16,0,1,0,17
63382,733,2010-04-22,Assembly,"AB 1767 HILL  Assembly Third Reading",71,0,8,0,79
63382,8851,2010-06-14,Senate,"Do pass, but re-refer to the Committee on Appropriations",7,0,2,0,9
63382,20313,2010-08-12,Senate,"Assembly 3rd Reading AB1767 Hill By Negrete McLeod",34,0,0,0,34
63382,20361,2010-08-17,Assembly,"AB 1767 HILL  Concurrence in Senate Amendments",71,5,0,0,76
63383,1028,2010-03-16,Assembly,"Do pass and be re-referred to the Committee on Appropriations.",6,0,0,0,6
63384,1142,2010-04-06,Assembly,"Do pass as amended and re-refer to Committee on Appropriations with recommendation:  To Consent Calendar.",7,0,0,0,7
63385,2066,2010-04-27,Assembly,"Do pass as amended",7,3,0,0,10
63385,2067,2010-05-06,Assembly,"AB 1770 GALGIANI  Assembly Third Reading",46,26,7,0,79
63385,8761,2010-06-16,Senate,"Do pass, but re-refer to the Committee on Judiciary",3,1,1,0,5
63385,9988,2010-06-29,Senate,"Do pass",3,1,1,0,5
63385,20764,2010-08-20,Senate,"Assembly 3rd Reading AB1770 Galgiani By Corbett",21,10,0,0,31
63385,20824,2010-08-23,Assembly,"AB 1770 GALGIANI  Concurrence in Senate Amendments",47,27,0,0,74
63386,4761,2010-04-20,Assembly,"Do pass and be re-referred to the Committee on Public Safety",6,0,0,0,6
63386,4762,2010-04-22,Assembly,"Do pass as amended and be re-referred to the Committee on Appropriations",4,0,3,0,7
63387,2614,2010-04-05,Assembly,"Do pass as amended and be re-referred to the Committee on Appropriations",14,0,0,0,14
63387,2615,2010-05-28,Assembly,"Do pass",17,0,0,0,17
63387,2616,2010-06-01,Assembly,"AB 1772 MENDOZA  Assembly Third Reading",75,0,4,0,79
63387,9262,2010-06-22,Senate,"Do pass, but re-refer to the Committee on Appropriations",6,0,3,0,9
63387,19705,2010-08-02,Senate,"Placed on Appropriations Suspense file",10,0,0,0,10
63388,1025,2010-04-12,Assembly,"Do pass and re-refer to Committee on Appropriations with recommendation:  To Consent Calendar.",20,0,2,0,22
63388,1026,2010-04-21,Assembly,"Do pass, to Consent Calendar.",17,0,0,0,17
63388,1027,2010-04-29,Assembly,"AB 1773 MENDOZA  Consent Calendar Second Day  Regular Session",74,0,5,0,79
63388,9571,2010-06-22,Senate,"Do pass, but re-refer to the Committee on Appropriations Recommend Consent",9,0,2,0,11
63388,19567,2010-08-05,Senate,"Consent Calendar 2nd AB1773 Mendoza",33,0,0,0,33
63389,1238,2010-03-23,Assembly,"Do pass as amended and re-refer to Committee on Appropriations with recommendation:  To Consent Calendar.",12,0,0,0,12
63389,1239,2010-05-28,Assembly,"Do pass as amended.",17,0,0,0,17
63389,1240,2010-06-02,Assembly,"AB 1774 SALDANA  Assembly Third Reading",76,0,3,0,79
63390,271,2010-05-05,Assembly,"Do pass as amended.",8,0,1,0,9
63390,272,2010-05-20,Assembly,"AB 1775 FURUTANI  Assembly Third Reading",69,0,10,0,79
63390,9782,2010-06-30,Senate,"Do pass, but re-refer to the Committee on Rules Recommend Consent",8,0,1,0,9
63390,19631,2010-08-09,Senate,"Special Consent #30 AB1775 Furutani",34,0,0,0,34
63390,21201,2010-08-24,Assembly,"AB 1775 FURUTANI  Concurrence in Senate Amendments",73,0,0,0,73
63392,769,2010-04-06,Assembly,"Do pass and be re-referred to the Committee on Revenue and Taxation.",6,1,1,0,8
63392,770,2010-04-19,Assembly,"Do pass and be re-referred to the Committee on Appropriations.",6,3,0,0,9
63393,784,2010-04-06,Assembly,"Do pass and be re-referred to the Committee on Appropriations.",5,0,3,0,8
63393,785,2010-05-19,Assembly,"Do pass.",11,5,1,0,17
63393,786,2010-05-24,Assembly,"AB 1778 LIEU  Assembly Third Reading",47,19,13,0,79
63393,10138,2010-06-29,Senate,"Do pass, but re-refer to the Committee on Appropriations",7,1,3,0,11
63393,19660,2010-08-02,Senate,"Placed on Appropriations Suspense file",10,0,0,0,10
63393,20287,2010-08-12,Senate,"Do pass",7,4,0,0,11
63393,20801,2010-08-23,Senate,"Assembly 3rd Reading AB1778 Lieu By Lowenthal",24,12,0,0,36
63396,4360,2010-03-22,Assembly,"Do pass as amended and be re-referred to the Committee on Appropriations",13,0,1,0,14
63396,4361,2010-04-14,Assembly,"Do pass, to Consent Calendar",15,0,2,0,17
63396,4362,2010-04-22,Assembly,"AB 1781 VILLINES  Consent Calendar Second Day  Regular Session",74,0,5,0,79
63396,8806,2010-06-15,Senate,"Do pass, but re-refer to the Committee on Appropriations",7,1,1,0,9
63396,20471,2010-08-18,Senate,"Assembly 3rd Reading AB1781 Villines By Cogdill",31,0,0,0,31
63396,20564,2010-08-19,Assembly,"AB 1781 VILLINES  Concurrence in Senate Amendments",74,0,0,0,74
63398,4622,2010-03-23,Assembly,"Do pass and be re-referred to the Committee on Appropriations",18,0,1,0,19
63398,4623,2010-04-14,Assembly,"Do pass, to Consent Calendar",15,0,2,0,17
63398,4624,2010-04-22,Assembly,"AB 1783 HAYASHI  Consent Calendar Second Day  Regular Session",74,0,5,0,79
63398,8838,2010-06-16,Senate,"Do pass, but re-refer to the Committee on Appropriations Recommend Consent",8,0,1,0,9
63398,19237,2010-08-02,Senate,"Consent Calendar 2nd AB1783 Hayashi",33,0,0,0,33
63398,19813,2010-08-09,Assembly,"AB 1783 HAYASHI  Concurrence in Senate Amendments",78,0,0,0,78
63399,4209,2010-03-22,Assembly,"Amend, and do pass as amended and be re-referred to the Committee on Local Government with the recommendation:  To Consent Calendar",14,0,0,0,14
63399,4210,2010-04-14,Assembly,"Do pass, to Consent Calendar",8,0,1,0,9
63399,4211,2010-04-22,Assembly,,0,0,0,0,0
63399,8780,2010-06-15,Senate,"Do pass and be placed on the Consent Calendar",8,0,1,0,9
63399,9552,2010-06-24,Senate,"Consent Calendar 2nd AB1784 Fong",31,0,8,0,39
63400,1066,2010-04-20,Assembly,"Do pass as amended and be re-referred to the Committee on Appropriations.",11,6,2,0,19
63402,4971,2010-04-20,Assembly,"Do pass and be re-referred to the Committee on Appropriations",11,0,0,0,11
63403,555,2010-03-23,Assembly,"Do pass and re-refer to Committee on Appropriations with recommendation:  To Consent Calendar.",12,0,0,0,12
63403,556,2010-05-28,Assembly,"Do pass.",17,0,0,0,17
63403,557,2010-06-01,Assembly,"AB 1788 YAMADA  Assembly Third Reading",77,0,2,0,79
63403,10038,2010-06-29,Senate,"Do pass as amended, and re-refer to the Committee on Appropriations",9,0,0,0,9
63403,19468,2010-08-02,Senate,"Placed on Appropriations Suspense file",10,0,0,0,10
63403,20095,2010-08-12,Senate,"Do pass",11,0,0,0,11
63403,20608,2010-08-19,Senate,"Assembly 3rd Reading AB1788 Yamada By Wolk",35,0,0,0,35
63403,20940,2010-08-23,Assembly,"AB 1788 YAMADA  Concurrence in Senate Amendments",76,0,0,0,76
63406,4524,2010-04-21,Assembly,"Do pass",7,2,0,0,9
63406,4525,2010-04-29,Assembly,"AB 1791 MONNING  Assembly Third Reading",50,15,14,0,79
63406,8762,2010-06-16,Senate,"Do pass as amended",3,1,1,0,5
63406,20288,2010-08-11,Senate,"Assembly 3rd Reading AB1791 Monning Reconsider",33,0,0,0,33
63406,21491,2010-08-24,Senate,"Assembly 3rd Reading AB1791 Monning By Kehoe",21,15,0,0,36
63406,21492,2010-08-25,Assembly,"AB 1791 MONNING  Concurrence in Senate Amendments",59,17,0,0,76
63407,2688,2010-04-21,Assembly,"Do pass and re-refer to Committee on Appropriations with recommendation:  To Consent Calendar",21,0,1,0,22
63407,2689,2010-05-05,Assembly,"Do pass, to Consent Calendar",17,0,0,0,17
63407,2690,2010-05-13,Assembly,"AB 1792 SILVA  Consent Calendar Second Day  Regular Session",76,0,3,0,79
63407,10004,2010-06-29,Senate,"Do pass, but re-refer to the Committee on Appropriations Recommend Consent",8,0,3,0,11
63407,19430,2010-08-05,Senate,"Consent Calendar 2nd AB1792 Silva",33,0,0,0,33
63407,19650,2010-08-09,Assembly,"AB 1792 SILVA  Concurrence in Senate Amendments",76,0,0,0,76
63408,5013,2010-03-11,Assembly,"Be referred to Committee on Housing and Community Development",10,0,1,0,11
63408,5014,2010-04-14,Assembly,"Do pass as amended",7,0,2,0,9
63408,5015,2010-04-22,Assembly,"AB 1793 SALDANA  Assembly Third Reading",69,1,9,0,79
63408,8887,2010-06-15,Senate,"Do pass",5,3,1,0,9
63408,20453,2010-08-18,Senate,"Assembly 3rd Reading AB1793 Saldana By Ducheny",22,10,0,0,32
63410,273,2010-03-24,Assembly,"Do pass and be re-referred to the Committee on Appropriations.",8,0,0,0,8
63410,274,2010-04-14,Assembly,"Do pass, to Consent Calendar.",15,0,2,0,17
63410,275,2010-04-22,Assembly,"AB 1795 AGRI.  Consent Calendar Second Day  Regular Session",74,0,5,0,79
63410,8711,2010-06-15,Senate,"Do pass, but re-refer to the Committee on Appropriations",5,0,0,0,5
63410,19662,2010-08-09,Senate,"Special Consent #30 AB1795 Committee on AGRI. (Galgiani)",34,0,0,0,34
63410,19862,2010-08-12,Assembly,"AB 1795 AGRI.  Concurrence in Senate Amendments By GALGIANI",76,1,0,0,77
63412,1221,2010-03-23,Assembly,"Do pass and be re-referred to the Committee on Appropriations.",4,3,5,0,12
63412,1222,2010-03-23,Assembly,"Set first hearing.  Failed passage.  Reconsideration granted.",12,0,0,0,12
63412,1223,2010-04-13,Assembly,"Do pass and be re-referred to the Committee on Appropriations.",7,5,1,0,13
63413,3563,2010-04-21,Assembly,"Do pass and re-refer to Committee on Appropriations with recommendation:  To Consent Calendar",21,0,1,0,22
63413,3564,2010-05-05,Assembly,"Do pass, to Consent Calendar",17,0,0,0,17
63413,3565,2010-05-13,Assembly,"AB 1798 EVANS  Consent Calendar Second Day  Regular Session",76,0,3,0,79
63413,9326,2010-06-22,Senate,"Do pass, but re-refer to the Committee on Appropriations Recommend Consent",9,0,2,0,11
63413,19444,2010-08-05,Senate,"Consent Calendar 2nd AB1798 Evans",33,0,0,0,33
63413,20874,2010-08-23,Senate,"Assembly 3rd Reading AB1798 Evans By Padilla",36,0,0,0,36
63413,21511,2010-08-26,Assembly,"Senate amendments be concurred in",18,0,0,0,18
63413,21574,2010-08-27,Assembly,"AB 1798 EVANS  Concurrence in Senate Amendments",74,0,0,0,74
63414,3559,2010-05-04,Assembly,"Do pass",5,2,0,0,7
63414,3560,2010-05-13,Assembly,"AB 1799 FONG  Assembly Third Reading",49,27,3,0,79
63414,9772,2010-06-29,Senate,"Do pass",3,1,1,0,5
63414,20263,2010-08-11,Senate,"Assembly 3rd Reading AB1799 Fong By Hancock",19,15,0,0,34
63414,20264,2010-08-11,Senate,"Assembly 3rd Reading AB1799 Fong Reconsider",33,0,0,0,33
63414,21940,2010-08-30,Senate,"Assembly 3rd Reading AB1799 Fong By Hancock",21,16,0,0,37
63415,4916,2010-03-23,Assembly,"Do pass and be re-referred to the Committee on Appropriations",5,0,2,0,7
63415,4917,2010-04-14,Assembly,"Do pass as amended, to Consent Calendar",15,0,2,0,17
63415,4918,2010-04-22,Assembly,"AB 1800 MA  Consent Calendar Second Day  Regular Session",73,1,5,0,79
63415,10317,2010-06-29,Senate,"Do pass as amended, and re-refer to the Committee on Appropriations",7,0,0,0,7
63415,20506,2010-08-18,Senate,"Assembly 3rd Reading AB1800 Ma By Cogdill",33,0,0,0,33
63415,20617,2010-08-19,Assembly,"AB 1800 MA  Concurrence in Senate Amendments",74,1,0,0,75
63417,836,2010-04-20,Assembly,"Do pass and be re-referred to the Committee on Appropriations.",4,3,4,0,11
63418,834,2010-04-14,Assembly,"Do pass and be re-referred to the Committee on Judiciary.",1,4,4,0,9
63418,835,2010-04-14,Assembly,"Set first hearing.  Failed passage.  Reconsideration granted.",9,0,0,0,9
63419,5439,2010-04-21,Assembly,"Do pass as amended and be re-referred to the Committee on Appropriations",11,1,0,0,12
63422,4959,2010-03-16,Assembly,"Do pass and be re-referred to the Committee on Appropriations",8,0,0,0,8
63423,4763,2010-04-13,Assembly,"Do pass as amended and be re-referred to the Committee on Appropriations",6,0,0,0,6
63424,1567,2010-03-23,Assembly,"Do pass as amended",11,0,0,0,11
63424,1568,2010-04-29,Assembly,"AB 1809 SMYTH  Assembly Third Reading",73,0,6,0,79
63424,9747,2010-06-28,Senate,"Do pass",7,0,2,0,9
63424,20029,2010-08-12,Senate,"Assembly 3rd Reading AB1809 Smyth By Strickland",34,0,0,0,34
63424,21046,2010-08-23,Assembly,"AB 1809 SMYTH  Concurrence in Senate Amendments",75,0,0,0,75
63425,1096,2010-04-13,Assembly,"Do pass and be re-referred to the Committee on Appropriations.",4,2,1,0,7
63425,1097,2010-05-28,Assembly,"Do pass as amended.",12,5,0,0,17
63425,1098,2010-06-03,Assembly,"AB 1810 FEUER  Assembly Third Reading",42,29,8,0,79
63425,9853,2010-06-29,Senate,"Do pass, but re-refer to the Committee on Appropriations",4,2,1,0,7
63425,19173,2010-08-02,Senate,"Placed on Appropriations Suspense file",10,0,0,0,10
63425,19991,2010-08-12,Senate,"Do pass",7,4,0,0,11
63425,21695,2010-08-30,Senate,"Assembly 3rd Reading AB1810 Feuer Reconsider",37,0,0,0,37
63425,22025,2010-08-30,Senate,"Assembly 3rd Reading AB1810 Feuer By DeSaulnier",18,18,0,0,36
63426,3369,2010-03-23,Assembly,"Do pass",4,3,0,0,7
63426,3370,2010-06-03,Assembly,"AB 1811 AMMIANO  Assembly Third Reading",33,36,10,0,79
63428,3488,2010-04-06,Assembly,"Do pass as amended and re-refer to Committee on Appropriations with recommendation:  To Consent Calendar",7,0,0,0,7
63428,3489,2010-04-28,Assembly,"Do pass, to Consent Calendar",15,0,2,0,17
63428,3490,2010-05-06,Assembly,"AB 1813 LIEU  Consent Calendar Second Day  Regular Session",74,0,5,0,79
63428,9322,2010-06-22,Senate,"Do pass, but re-refer to the Committee on Appropriations",7,0,0,0,7
63428,19655,2010-08-09,Senate,"Special Consent #30 AB1813 Lieu",34,0,0,0,34
63429,995,2010-04-06,Assembly,"Do pass as amended and re-refer to Committee on Appropriations with recommendation:  To Consent Calendar.",9,0,1,0,10
63429,996,2010-04-21,Assembly,"Do pass, to Consent Calendar.",17,0,0,0,17
63429,997,2010-04-29,Assembly,"AB 1814 BUCHANAN  Consent Calendar Second Day  Regular Session",74,0,5,0,79
63429,5787,2010-06-10,Senate,"Do pass, but re-refer to the Committee on Appropriations Recommend Consent",5,0,0,0,5
63429,19080,2010-08-02,Senate,"Consent Calendar 2nd AB1814 Buchanan",33,0,0,0,33
63430,896,2010-04-19,Assembly,"Do pass as amended and be re-referred to the Committee on Appropriations.",10,1,3,0,14
63430,897,2010-05-28,Assembly,"Do pass as amended.",17,0,0,0,17
63430,898,2010-06-02,Assembly,"AB 1815 EMMERSON  Assembly Third Reading",74,1,4,0,79
63432,1507,2010-04-20,Assembly,"Do pass as amended and be re-referred to the Committee on Appropriations",18,0,1,0,19
63432,1508,2010-05-12,Assembly,"Do pass",16,0,1,0,17
63432,1509,2010-05-20,Assembly,"AB 1817 ARAMBULA  Assembly Third Reading",70,0,9,0,79
63432,9441,2010-06-22,Senate,"Do pass, but re-refer to the Committee on Appropriations",7,0,0,0,7
63432,19596,2010-08-02,Senate,"Do pass",10,0,0,0,10
63432,20594,2010-08-19,Senate,"Assembly 3rd Reading AB1817 Arambula By Leno",35,0,0,0,35
63433,5373,2010-03-22,Assembly,"Do pass as amended and be re-referred to the Committee on Water, Parks and Wildlife",6,3,0,0,9
63433,5374,2010-04-13,Assembly,"Do pass as amended and be re-referred to the Committee on Appropriations",9,1,3,0,13
63435,222,2010-03-23,Assembly,"Do pass and be re-referred to the Committee on Appropriations.",9,0,2,0,11
63436,1758,2010-04-21,Assembly,"Do pass and be re-referred to the Committee on Appropriations",4,2,0,0,6
63436,1759,2010-05-05,Assembly,"Do pass",12,5,0,0,17
63436,1760,2010-06-01,Assembly,"AB 1821 MA  Assembly Third Reading",50,25,4,0,79
63436,8705,2010-06-14,Senate,"Do pass as amended, and re-refer to the Committee on Appropriations",4,2,0,0,6
63436,11027,2010-07-15,Senate,"Placed on Appropriations Suspense file",8,0,2,0,10
63436,20276,2010-08-12,Senate,"Do pass",7,4,0,0,11
63436,20586,2010-08-19,Senate,"Assembly 3rd Reading AB1821 Ma By Liu",22,12,0,0,34
63436,20922,2010-08-23,Assembly,"AB 1821 MA  Concurrence in Senate Amendments",51,24,0,0,75
63437,907,2010-04-20,Assembly,"Do pass and be re-referred to the Committee on Appropriations.",8,3,0,0,11
63437,908,2010-05-28,Assembly,"Do pass as amended.",12,0,5,0,17
63437,909,2010-06-02,Assembly,"AB 1822 SWANSON  Assembly Third Reading",59,14,6,0,79
63437,9690,2010-06-28,Senate,"Do pass, but re-refer to the Committee on Rules",5,1,3,0,9
63437,21569,2010-08-27,Senate,"Assembly 3rd Reading AB1822 Swanson Reconsider",34,0,0,0,34
63437,21666,2010-08-30,Senate,"Assembly 3rd Reading AB1822 Swanson By Wright",22,14,0,0,36
63437,21801,2010-08-31,Assembly,"AB 1822 SWANSON  Concurrence in Senate Amendments",64,9,0,0,73
63437,22031,2010-08-27,Senate,"Assembly 3rd Reading AB1822 Swanson By Wright",19,11,0,0,30
63439,2270,2010-04-13,Assembly,"Do pass as amended and be re-referred to the Committee on Appropriations",9,0,0,0,9
63439,2271,2010-05-05,Assembly,"Do pass as amended",14,3,0,0,17
63439,2272,2010-05-13,Assembly,"AB 1824 MONNING  Assembly Third Reading",73,0,6,0,79
63439,8702,2010-06-14,Senate,"Do pass, but re-refer to the Committee on Appropriations",6,0,1,0,7
63439,9941,2010-06-28,Senate,"Do pass",10,0,1,0,11
63439,19498,2010-08-02,Senate,"Assembly 3rd Reading AB1824 Monning By Strickland",30,3,0,0,33
63440,1074,2010-04-20,Assembly,"Do pass and be re-referred to the Committee on Appropriations.",12,6,1,0,19
63440,1075,2010-05-28,Assembly,"Do pass.",12,5,0,0,17
63440,1076,2010-06-02,Assembly,"AB 1825 DE LA TORRE  Assembly Third Reading",48,25,6,0,79
63440,9543,2010-06-23,Senate,"Do pass, but re-refer to the Committee on Appropriations",6,0,3,0,9
63440,10698,2010-07-15,Senate,"Placed on Appropriations Suspense file",8,0,2,0,10
63440,20126,2010-08-12,Senate,"Do pass",7,4,0,0,11
63440,21075,2010-08-25,Senate,"Assembly 3rd Reading AB1825 De La Torre By Alquist",22,11,0,0,33
63440,21472,2010-08-26,Assembly,"AB 1825 DE LA TORRE  Concurrence in Senate Amendments",52,22,0,0,74
63441,886,2010-04-20,Assembly,"Do pass and be re-referred to the Committee on Appropriations.",11,6,2,0,19
63441,887,2010-05-28,Assembly,"Do pass as amended.",12,0,5,0,17
63441,888,2010-06-02,Assembly,"AB 1826 HUFFMAN  Assembly Third Reading",45,26,8,0,79
63441,10247,2010-06-30,Senate,"Do pass, but re-refer to the Committee on Appropriations",5,2,2,0,9
63441,19543,2010-08-02,Senate,"Placed on Appropriations Suspense file",10,0,0,0,10
63442,3172,2010-03-24,Assembly,"Do pass as amended and be re-referred to the Committee on Appropriations",11,1,0,0,12
63442,3173,2010-05-28,Assembly,"Do pass as amended",12,0,5,0,17
63442,3174,2010-06-03,Assembly,"AB 1827 ARAMBULA  Assembly Third Reading",57,16,6,0,79
63442,9502,2010-06-23,Senate,"Do pass, but re-refer to the Committee on Appropriations",4,1,1,0,6
63442,10559,2010-07-15,Senate,"Placed on Appropriations Suspense file",8,0,2,0,10
63443,5380,2010-03-16,Assembly,"Do pass and be re-referred to the Committee on Appropriations",6,0,0,0,6
63444,1092,2010-03-16,Assembly,"Do pass and re-refer to Committee on Appropriations with recommendation:  To Consent Calendar.",6,0,0,0,6
63444,1093,2010-04-13,Assembly,"Do pass and be re-referred to the Committee on Appropriations.",9,0,0,0,9
63444,1094,2010-04-21,Assembly,"Do pass, to Consent Calendar.",17,0,0,0,17
63444,1095,2010-04-29,Assembly,"AB 1829 COOK  Consent Calendar Second Day  Regular Session",74,0,5,0,79
63444,8724,2010-06-15,Senate,"Do pass, but re-refer to the Committee on Veterans Affairs",7,0,0,0,7
63444,9221,2010-06-22,Senate,"Do pass as amended, and re-refer to the Committee on Appropriations",4,0,1,0,5
63444,19154,2010-08-02,Senate,"Do pass",8,1,0,0,9
63444,20553,2010-08-19,Senate,"Assembly 3rd Reading AB1829 Cook By Denham",32,1,0,0,33
63444,20793,2010-08-23,Assembly,"AB 1829 COOK  Concurrence in Senate Amendments",76,0,0,0,76
63445,3085,2010-04-05,Assembly,"Do pass as amended and be re-referred to the Committee on Appropriations",12,2,0,0,14
63445,3086,2010-04-21,Assembly,"Do pass",12,4,1,0,17
63445,3087,2010-06-03,Assembly,"AB 1830 JONES  Assembly Third Reading",53,22,4,0,79
63445,9962,2010-06-29,Senate,"Do pass, but re-refer to the Committee on Appropriations",6,2,1,0,9
63445,19169,2010-08-02,Senate,"Placed on Appropriations Suspense file",10,0,0,0,10
63445,20209,2010-08-12,Senate,"Do pass",7,4,0,0,11
63445,21387,2010-08-24,Senate,"Assembly 3rd Reading AB1830 Jones By Kehoe",23,12,0,0,35
63445,21388,2010-08-25,Assembly,"AB 1830 JONES  Concurrence in Senate Amendments",51,26,0,0,77
63446,686,2010-04-21,Assembly,"Do pass as amended and be re-referred to the Committee on Appropriations.",6,3,0,0,9
63447,4925,2010-03-16,Assembly,"Do pass",5,1,1,0,7
63447,4926,2010-04-05,Assembly,"AB 1832 SALDANA  Assembly Third Reading",48,29,2,0,79
63447,8880,2010-06-15,Senate,"Do pass",3,2,0,0,5
63447,21092,2010-08-24,Senate,"Assembly 3rd Reading AB1832 Saldana By Liu",21,15,0,0,36
63452,3350,2010-02-18,Assembly,"From committee:  Be adopted.  To third reading",10,0,1,0,11
63453,8584,2010-04-13,Assembly,"From committee:  Be adopted.  To third reading",3,7,0,0,10
63454,3351,2010-02-25,Assembly,"From committee:  Be adopted.  To third reading",10,0,1,0,11
63454,20175,2010-08-12,Senate,"Assembly 3rd Reading ACR120 Mendoza By Price",35,0,0,0,35
63455,8178,2010-04-08,Assembly,"Be adopted, to Consent Calendar",11,0,0,0,11
63455,8179,2010-04-08,Assembly,"From committee:  Be adopted.  To third reading",11,0,0,0,11
63455,19782,2010-08-11,Senate,"Assembly 3rd Reading ACR121 Conway By Correa",32,0,0,0,32
63456,8585,2010-04-27,Assembly,"From committee:  Be adopted.  To third reading",7,2,0,0,9
63457,3293,2010-03-11,Assembly,"Be adopted, to Consent Calendar",10,0,1,0,11
63457,3294,2010-03-18,Assembly,"HR 24 GALGIANI  Consent Calendar Second Day",64,0,15,0,79
63458,3295,2010-02-25,Assembly,"From committee:  Be adopted.  To third reading",10,0,1,0,11
63459,2365,2010-04-14,Senate,"Do pass, but re-refer to the Committee on Business, Professions and Economic Development",9,0,0,0,9
63459,2366,2010-04-19,Senate,"Do pass as amended, and re-refer to the Committee on Appropriations",8,0,1,0,9
63459,2367,2010-06-02,Senate,"Senate 3rd Reading SB971 Pavley",34,0,4,0,38
63459,9418,2010-06-22,Assembly,"Do pass and be re-referred to the Committee on Business, Professions and Consumer Protection",19,0,0,0,19
63459,9678,2010-06-29,Assembly,"Do pass and be re-referred to the Committee on Appropriations",11,0,0,0,11
63459,19335,2010-08-04,Assembly,"Do pass as amended, to Consent Calendar",17,0,0,0,17
63459,20312,2010-08-16,Assembly,"SB 971 Pavley  Senate Third Reading  By MONNING",75,0,0,0,75
63459,21074,2010-08-25,Senate,"Unfinished Business SB971 Pavley",35,0,0,0,35
63460,1130,2010-05-04,Senate,"Do pass as amended.",4,0,1,0,5
63460,1131,2010-06-01,Senate,"Senate 3rd Reading SB972 Wolk",30,3,5,0,38
63460,9705,2010-06-29,Assembly,"Do pass as amended",9,1,0,0,10
63460,21110,2010-08-25,Assembly,"Do pass",9,0,0,0,9
63460,21693,2010-08-30,Assembly,"SB 972 Wolk  Senate Third Reading  By JONES",77,0,0,0,77
63460,21694,2010-08-30,Senate,"W/O REF. TO FILE SB972 Wolk Concurrence",37,0,0,0,37
63461,4032,2010-03-23,Senate,"Do pass, but re-refer to the Committee on Appropriations",7,0,0,0,7
63461,4033,2010-04-26,Senate,"Placed on Appropriations Suspense file",9,0,2,0,11
63462,2233,2010-04-21,Senate,"Do pass, but re-refer to the Committee on Revenue and Taxation",8,0,1,0,9
63462,2234,2010-05-12,Senate,"Do pass as amended, and re-refer to the Committee on Appropriations",3,1,1,0,5
63462,2235,2010-05-24,Senate,"Placed on Appropriations Suspense file",10,0,1,0,11
63462,2236,2010-05-27,Senate,"Do pass",7,3,1,0,11
63462,2237,2010-06-03,Senate,"Senate 3rd Reading SB974 Steinberg",21,16,1,0,38
63464,3612,2010-04-19,Senate,"Do pass, but re-refer to the Committee on Appropriations",2,4,1,0,7
63465,5271,2010-04-19,Senate,"Do pass and be placed on the Consent Calendar",5,0,0,0,5
63465,5272,2010-04-26,Senate,"Consent Calendar 2nd SB977 Hollingsworth",35,0,4,0,39
63465,8854,2010-06-16,Assembly,"Do pass and be re-referred to the Committee on Local Government",9,0,0,0,9
63465,9971,2010-06-30,Assembly,"Do pass, to Consent Calendar",9,0,0,0,9
63465,19532,2010-08-05,Assembly,"SB 977 Hollingsworth  Consent Calendar Second Day  Regular Session",71,0,0,0,71
63465,20717,2010-08-19,Senate,"Unfinished Business SB977 Hollingsworth",30,0,0,0,30
63468,4440,2010-04-19,Senate,"Do pass, but re-refer to the Committee on Appropriations",8,0,1,0,9
63468,4441,2010-05-10,Senate,"Placed on Appropriations Suspense file",9,0,2,0,11
63470,12793,2010-07-15,Senate,"Do pass as amended, and re-refer to the Committee on Appropriations",4,0,1,0,5
63470,19759,2010-08-09,Senate,"Do pass",8,1,0,0,9
63470,19802,2010-08-11,Senate,"Senate 2nd Reading SB982 Hollingsworth Urgency Clause",29,1,0,0,30
63472,10326,2010-06-29,Senate,"Do pass as amended",4,0,1,0,5
63472,10327,2010-06-29,Senate,"Reconsideration granted",3,0,2,0,5
63472,10328,2010-06-29,Senate,"Do pass as amended",3,1,1,0,5
63476,4564,2010-04-27,Senate,"Do pass as amended, and re-refer to the Committee on Rules",7,0,4,0,11
63476,4565,2010-05-17,Senate,"Placed on Appropriations Suspense file",10,0,1,0,11
63477,4078,2010-05-03,Senate,"Do pass as amended, and re-refer to the Committee on Judiciary",6,0,0,0,6
63477,10213,2010-06-29,Senate,"Do pass",4,0,1,0,5
63477,19373,2010-08-02,Senate,"Senate 3rd Reading SB989 Hollingsworth Urgency Clause",30,0,0,0,30
63479,2826,2010-04-13,Senate,"Do pass, but re-refer to the Committee on Appropriations",6,3,0,0,9
63479,2827,2010-04-26,Senate,"Placed on Appropriations Suspense file",9,0,2,0,11
63479,2828,2010-05-27,Senate,"Do pass",7,3,1,0,11
63479,2829,2010-06-02,Senate,"Senate 3rd Reading SB991 Wolk",21,14,3,0,38
63479,10281,2010-06-29,Assembly,"Do pass as amended and be re-referred to the Committee on Appropriations",8,4,1,0,13
63479,20151,2010-08-12,Assembly,"Do pass as amended",12,5,0,0,17
63479,20649,2010-08-20,Assembly,"SB 991 Wolk  Senate Third Reading  By HUBER  Amend By HUBER  Set #1",49,26,0,0,75
63479,20884,2010-08-23,Assembly,"SB 991 Wolk  Senate Third Reading  By HUBER",50,26,0,0,76
63479,21133,2010-08-25,Senate,"Unfinished Business SB991 Wolk",22,12,0,0,34
63481,2214,2010-03-23,Senate,"Do pass, but re-refer to the Committee on Appropriations Recommend Consent",8,0,1,0,9
63481,2215,2010-04-26,Senate,"Placed on Appropriations Suspense file",9,0,2,0,11
63481,2216,2010-05-27,Senate,"Do pass",10,0,1,0,11
63481,2217,2010-06-02,Senate,"Special Consent #26 SB993 Huff",35,0,3,0,38
63481,9228,2010-06-21,Assembly,"Do pass and re-refer to Committee on Appropriations with recommendation:  To Consent Calendar",14,0,0,0,14
63481,20114,2010-08-12,Assembly,"Do pass",17,0,0,0,17
63481,20869,2010-08-23,Assembly,"SB 993 Huff  Senate Third Reading  By ADAMS",77,0,0,0,77
63481,21126,2010-08-25,Senate,"Unfinished Business SB993 Huff",35,0,0,0,35
63482,3580,2010-04-20,Senate,"Do pass, but re-refer to the Committee on Appropriations",5,0,0,0,5
63482,3581,2010-05-03,Senate,"Placed on Appropriations Suspense file",10,0,1,0,11
63484,4009,2010-04-14,Senate,"Do pass, but re-refer to the Committee on Appropriations",5,0,0,0,5
63484,4010,2010-05-17,Senate,"Placed on Appropriations Suspense file",10,0,1,0,11
63486,3698,2010-04-14,Senate,"Do pass as amended, and re-refer to the Committee on Appropriations",6,3,0,0,9
63486,3699,2010-05-03,Senate,"Placed on Appropriations Suspense file",10,0,1,0,11
63487,3291,2010-05-03,Senate,"Do pass",8,0,1,0,9
63487,3292,2010-05-17,Senate,"Special Consent #24 SB999 Walters",33,0,5,0,38
63487,10179,2010-06-29,Assembly,"Do pass, to Consent Calendar",11,0,0,0,11
63487,19810,2010-08-05,Assembly,"SB 999 Walters  Consent Calendar Second Day",71,0,0,0,71
63490,4876,2010-04-13,Senate,"Do pass",4,0,1,0,5
63491,1685,2010-04-13,Senate,"Do pass",4,0,1,0,5
63491,1686,2010-05-03,Senate,"Special Consent #22 SB1003 Wiggins",34,0,4,0,38
63491,8939,2010-06-15,Assembly,"Do pass",9,0,0,0,9
63492,839,2010-03-23,Senate,"Do pass, but re-refer to the Committee on Appropriations.",8,0,1,0,9
63492,840,2010-05-03,Senate,"Special Consent #22 SB1004 Huff",34,0,4,0,38
63492,8714,2010-06-07,Assembly,"Do pass and be re-referred to the Committee on Appropriations",11,0,3,0,14
63492,10314,2010-06-30,Assembly,"Do pass",17,0,0,0,17
63492,20517,2010-08-17,Assembly,"SB 1004 Huff  Senate Third Reading  By SMYTH",76,0,0,0,76
63492,20800,2010-08-23,Senate,"From committee:  That the Assembly Amendments be concurred in",4,0,0,0,4
63492,21449,2010-08-26,Senate,"Special Consent #32 SB1004 Huff",34,0,0,0,34
63493,535,2010-04-19,Senate,"Do pass, but re-refer to the Committee on Appropriations.",3,2,0,0,5
63493,536,2010-06-01,Senate,"Senate 3rd Reading SB1005 Cox",23,6,9,0,38
63493,9053,2010-06-16,Assembly,"Do pass as amended and be re-referred to the Committee on Appropriations",5,2,2,0,9
63493,19515,2010-08-04,Assembly,"Do pass",6,5,0,0,11
63494,3279,2010-04-13,Senate,"Do pass, but re-refer to the Committee on Environmental Quality",6,3,0,0,9
63494,3280,2010-04-19,Senate,"Do pass as amended, and re-refer to the Committee on Appropriations",4,2,1,0,7
63494,3281,2010-05-10,Senate,"Placed on Appropriations Suspense file",9,0,2,0,11
63494,3282,2010-05-27,Senate,"Do pass as amended",7,3,1,0,11
63494,3283,2010-06-02,Senate,"Senate 3rd Reading SB1006 Pavley",22,14,2,0,38
63494,9778,2010-06-28,Assembly,"Do pass and be re-referred to the Committee on Appropriations",5,3,1,0,9
63494,9779,2010-06-28,Assembly,"Do pass and be re-referred to the Committee on Natural Resources",6,3,0,0,9
63494,20251,2010-08-12,Assembly,"Do pass",12,5,0,0,17
63494,20903,2010-08-23,Assembly,"SB 1006 Pavley  Senate Third Reading  By CHESBRO",50,27,0,0,77
63494,21158,2010-08-25,Senate,"Unfinished Business SB1006 Pavley",23,11,0,0,34
63495,2231,2010-04-06,Senate,"Do pass, but re-refer to the Committee on Appropriations Recommend Consent",5,0,0,0,5
63495,2232,2010-04-22,Senate,"Consent Calendar 2nd SB1007 Hancock",33,0,6,0,39
63495,9449,2010-06-22,Assembly,"Do pass as amended and re-refer to Committee on Appropriations with recommendation:  To Consent Calendar",7,0,0,0,7
63495,19344,2010-08-04,Assembly,"Do pass",16,1,0,0,17
63495,20410,2010-08-16,Assembly,"SB 1007 Hancock  Senate Third Reading  By HERNANDEZ",73,1,0,0,74
63495,20603,2010-08-19,Senate,"Unfinished Business SB1007 Hancock",35,0,0,0,35
63496,2947,2010-04-05,Senate,"Do pass, but re-refer to the Committee on Judiciary",7,0,2,0,9
63496,2948,2010-04-20,Senate,"Do pass as amended, and re-refer to the Committee on Appropriations",4,0,1,0,5
63496,2949,2010-05-17,Senate,"Special Consent #24 SB1008 Padilla",33,0,5,0,38
63496,9154,2010-06-22,Assembly,"Do pass and be re-referred to the Committee on Judiciary",11,0,0,0,11
63496,10000,2010-06-29,Assembly,"Do pass as amended and re-refer to Committee on Appropriations with recommendation:  To Consent Calendar",10,0,0,0,10
63496,20165,2010-08-12,Assembly,"Do pass",17,0,0,0,17
63496,20784,2010-08-23,Assembly,"SB 1008 Padilla  Third Reading Urgency  By SMYTH",76,0,0,0,76
63496,21249,2010-08-25,Senate,"Unfinished Business SB1008 Padilla Urgency Clause",35,0,0,0,35
63498,7752,2010-04-05,Senate,"Do pass, but re-refer to the Committee on Judiciary",2,4,1,0,7
63498,7753,2010-04-05,Senate,"Set, first hearing.  Failed passage in Committee.  Reconsideration granted",6,0,1,0,7
63510,800,2010-04-13,Senate,"Do pass as amended.",7,0,0,0,7
63510,801,2010-04-26,Senate,"Senate 3rd Reading SB1011 Calderon",36,0,3,0,39
63510,10026,2010-06-29,Assembly,"Do pass",7,0,0,0,7
63510,21227,2010-08-20,Assembly,"SB 1011 Calderon  Senate Third Reading  Amend By PORTANTINO  Set #1",49,26,0,0,75
63517,4480,2010-04-20,Senate,"Do pass, but re-refer to the Committee on Appropriations",7,0,0,0,7
63517,4481,2010-05-03,Senate,"Placed on Appropriations Suspense file",10,0,1,0,11
63518,2879,2010-04-07,Senate,"Do pass, but re-refer to the Committee on Appropriations Recommend Consent",5,0,0,0,5
63518,2880,2010-04-26,Senate,"Do pass as amended",9,0,2,0,11
63518,2881,2010-05-03,Senate,"Senate 3rd Reading SB1019 Correa",31,0,7,0,38
63518,8963,2010-06-16,Assembly,"Do pass and be re-referred to the Committee on Appropriations to Consent Calendar",9,0,0,0,9
63518,10214,2010-06-30,Assembly,"Do pass, to Consent Calendar",17,0,0,0,17
63518,19899,2010-08-05,Assembly,"SB 1019 Correa  Consent Calendar Second Day  Regular Session",71,0,0,0,71
63519,1090,2010-05-27,Senate,"Do pass.",10,0,5,0,15
63519,1091,2010-06-02,Senate,"Senate 3rd Reading SB1020 Wolk",36,0,2,0,38
63521,2806,2010-04-13,Senate,"Do pass, but re-refer to the Committee on Appropriations",9,0,2,0,11
63521,2807,2010-05-03,Senate,"Special Consent #22 SB1022 Strickland",34,0,4,0,38
63521,9314,2010-06-23,Assembly,"Do pass and re-refer to Committee on Appropriations with recommendation:  To Consent Calendar",21,0,1,0,22
63521,19750,2010-08-04,Assembly,"Do pass, to Consent Calendar",17,0,0,0,17
63521,19873,2010-08-12,Assembly,"SB 1022 Strickland  Consent Calendar Second Day  Regular Session",78,0,0,0,78
63522,5322,2010-05-05,Senate,"Do pass",5,0,0,0,5
63522,5323,2010-05-10,Senate,"Senate 3rd Reading SB1023 Wiggins",31,0,7,0,38
63522,9055,2010-06-16,Assembly,"Do pass",9,0,0,0,9
63522,9425,2010-06-24,Assembly,"SB 1023 Wiggins  Senate Third Reading  By EVANS",74,0,5,0,79
63524,4292,2010-04-20,Senate,"Do pass, but re-refer to the Committee on Appropriations",2,5,0,0,7
63529,3387,2010-02-24,Senate,"Do pass, but re-refer to the Committee on Appropriations",2,5,2,0,9
63531,4609,2010-04-20,Senate,"Be adopted",2,5,0,0,7
63532,5291,2010-06-09,Senate,"Be adopted, but re-refer to the Committee on Elections, Reapportionmnt and Constitutional Amend",2,3,6,0,11
63532,5292,2010-06-09,Senate,"Set, first hearing.  Failed passage in Committee.  Reconsideration granted",6,0,5,0,11
63533,4835,2010-03-23,Senate,"Be adopted, but re-refer to the Committee on Appropriations Recommend Consent",8,0,1,0,9
63533,4836,2010-04-22,Senate,"Consent Calendar 2nd SCR69 Runner",33,0,6,0,39
63533,8863,2010-06-07,Assembly,"Be adopted, and re-refer to Committee on Appropriations with recommendation:  To Consent Calendar",11,0,3,0,14
63533,10180,2010-06-30,Assembly,"Be adopted, to Consent Calendar",16,0,1,0,17
63533,19120,2010-08-02,Assembly,"SCR 69 Runner  Consent Calendar Second Day  Regular Session",76,0,0,0,76
63534,27229,2010-04-08,Senate,"W/O REF. TO FILE SCR70 Hancock",32,0,0,0,32
63534,27230,2010-04-29,Assembly,"Be adopted, to Consent Calendar",10,0,0,0,10
63534,27231,2010-05-06,Assembly,"SCR 70 Hancock  Consent Calendar Second Day  Regular Session",74,0,0,0,74
63534,27232,2010-05-10,Senate,"Unfinished Business SCR70 Hancock",31,0,0,0,31
63535,3416,2010-02-16,Senate,"W/O REF. TO FILE SCR71 Price",33,0,6,0,39
63536,8080,2010-03-16,Senate,"Be adopted",3,1,1,0,5
63536,8081,2010-04-15,Senate,"Senate 3rd Reading SJR22 Florez",27,7,5,0,39
63536,10361,2010-06-30,Assembly,"Be adopted as amended",7,1,0,0,8
63536,20409,2010-08-16,Assembly,"SJR 22 Florez  Senate Third Reading  By NAVA",55,16,0,0,71
63536,21306,2010-08-25,Senate,"Unfinished Business SJR22 Florez",27,7,0,0,34
63554,383,2010-04-06,Assembly,"Do pass and be re-referred to the Committee on Natural Resources.",4,7,0,0,11
63554,384,2010-04-06,Assembly,"Set second hearing.  Failed passage.  Reconsideration granted.",11,0,0,0,11
63555,3333,2010-04-13,Assembly,"Do pass and be re-referred to the Committee on Appropriations",13,0,0,0,13
63555,3334,2010-05-28,Assembly,"Do pass as amended",17,0,0,0,17
63555,3335,2010-06-02,Assembly,"AB 1834 SOLORIO  Assembly Third Reading",74,0,5,0,79
63555,9136,2010-06-22,Senate,"Do pass, but re-refer to the Committee on Environmental Quality",6,1,2,0,9
63555,9642,2010-06-28,Senate,"Do pass as amended, and re-refer to the Committee on Appropriations",7,0,0,0,7
63555,19492,2010-08-02,Senate,"Placed on Appropriations Suspense file",10,0,0,0,10
63555,20222,2010-08-12,Senate,"Do pass as amended",9,2,0,0,11
63555,20692,2010-08-20,Senate,"Assembly 3rd Reading AB1834 Solorio By Pavley",30,1,0,0,31
63555,20803,2010-08-23,Assembly,"AB 1834 SOLORIO  Concurrence in Senate Amendments",76,0,0,0,76
63558,4717,2010-04-21,Assembly,"Do pass as amended and be re-referred to the Committee on Appropriations",10,2,0,0,12
63558,4718,2010-05-28,Assembly,"AB 1837 GAINES  Assembly Third Reading",58,1,20,0,79
63558,9994,2010-06-30,Senate,"Do pass",10,0,1,0,11
63558,20646,2010-08-18,Senate,"Assembly 3rd Reading AB1837 Gaines By Cogdill",32,0,0,0,32
63558,20647,2010-08-19,Assembly,"AB 1837 GAINES  Concurrence in Senate Amendments",74,1,0,0,75
63559,3993,2010-04-20,Assembly,"Do pass and re-refer to Committee on Appropriations with recommendation:  To Consent Calendar",10,0,0,0,10
63559,3994,2010-04-28,Assembly,"Do pass, to Consent Calendar",15,0,2,0,17
63559,3995,2010-05-06,Assembly,"AB 1838 BERRYHILL, B.  Consent Calendar Second Day  Regular Session",74,0,5,0,79
63559,9819,2010-06-29,Senate,"Do pass as amended, and re-refer to the Committee on Appropriations",4,0,1,0,5
63559,19897,2010-08-12,Senate,"Assembly 3rd Reading AB1838 Bill Berryhill By Wolk",35,0,0,0,35
63559,20369,2010-08-17,Assembly,"AB 1838 BERRYHILL, B.  Concurrence in Senate Amendments",76,0,0,0,76
63560,8240,2010-04-07,Assembly,"Do pass as amended and be re-referred to the Committee on Revenue and Taxation",5,2,2,0,9
63562,5280,2010-03-24,Assembly,"Do pass as amended, to Consent Calendar",9,0,0,0,9
63562,5281,2010-04-12,Assembly,"AB 1841 BUCHANAN  Consent Calendar Second Day",71,0,8,0,79
63562,8855,2010-06-16,Senate,"Do pass, but re-refer to the Committee on Judiciary Recommend Consent",6,0,3,0,9
63562,9455,2010-06-22,Senate,"Do pass and be placed on the Consent Calendar",4,0,1,0,5
63562,20173,2010-08-11,Senate,"Assembly 3rd Reading AB1841 Buchanan By Liu",34,0,0,0,34
63562,20325,2010-08-16,Assembly,"AB 1841 BUCHANAN  Concurrence in Senate Amendments",75,0,0,0,75
63565,980,2010-04-20,Assembly,"Do pass as amended and be re-referred to the Committee on Appropriations.",5,0,2,0,7
63565,981,2010-05-28,Assembly,"Do pass.",13,0,4,0,17
63565,982,2010-06-03,Assembly,"AB 1844 FLETCHER  Assembly Third Reading",71,0,8,0,79
63565,9776,2010-06-29,Senate,"Do pass as amended, and re-refer to the Committee on Appropriations",7,0,0,0,7
63565,19749,2010-08-09,Senate,"Placed on Appropriations Suspense file",10,0,0,0,10
63565,20028,2010-08-12,Senate,"Do pass as amended",11,0,0,0,11
63565,20954,2010-08-24,Senate,"Assembly 3rd Reading AB1844 Fletcher Urgency Clause",36,0,0,0,36
63565,21690,2010-08-30,Assembly,"AB 1844 FLETCHER  Concurrence- Urgency Added",74,0,0,0,74
63567,240,2010-04-12,Assembly,"Do pass as amended and be re-referred to the Committee on Appropriations.",9,0,0,0,9
63567,241,2010-04-28,Assembly,"Do pass, to Consent Calendar.",15,0,2,0,17
63567,242,2010-05-06,Assembly,"AB 1846 PEREZ, V.M.  Consent Calendar Second Day  Regular Session",74,0,5,0,79
63567,8710,2010-06-14,Senate,"Do pass as amended, but re-refer to the Committee on Appropriations Recommend Consent",7,0,0,0,7
63567,19516,2010-08-05,Senate,"Consent Calendar 2nd AB1846 V. Manuel Perez",33,0,0,0,33
63567,19678,2010-08-09,Assembly,"AB 1846 PEREZ, V.M.  Concurrence in Senate Amendments",77,0,0,0,77
63568,3963,2010-04-13,Assembly,"Do pass as amended and be re-referred to the Committee on Public Safety",10,0,0,0,10
63568,3964,2010-05-04,Assembly,"Do pass as amended",7,0,0,0,7
63568,3965,2010-05-13,Assembly,"AB 1847 FURUTANI  Assembly Third Reading",74,1,4,0,79
63568,9791,2010-06-29,Senate,"Do pass",4,1,2,0,7
63568,21191,2010-08-23,Senate,"Assembly 3rd Reading AB1847 Furutani By Cedillo",32,0,0,0,32
63568,21192,2010-08-25,Assembly,"AB 1847 FURUTANI  Concurrence in Senate Amendments",77,0,0,0,77
63569,5016,2010-03-23,Assembly,"Do pass and re-refer to Committee on Appropriations with recommendation:  To Consent Calendar",7,0,0,0,7
63569,5017,2010-04-14,Assembly,"Do pass, to Consent Calendar",15,0,2,0,17
63569,5018,2010-04-22,Assembly,"AB 1848 GARRICK  Consent Calendar Second Day  Regular Session",74,0,5,0,79
63569,8889,2010-06-15,Senate,"Do pass, but re-refer to the Committee on Appropriations",7,0,0,0,7
63569,10020,2010-07-01,Senate,"Special Consent #29 AB1848 Garrick",34,0,5,0,39
63570,3802,2010-04-14,Assembly,"Do pass and be re-referred to the Committee on Education",2,4,3,0,9
63570,3803,2010-04-14,Assembly,"Set first hearing.  Failed passage.  Reconsideration granted",7,0,2,0,9
63571,4945,2010-04-20,Assembly,"Do pass as amended and be re-referred to the Committee on Appropriations",7,0,0,0,7
63573,4784,2010-03-23,Assembly,"Do pass and be re-referred to the Committee on Appropriations",4,0,2,0,6
63574,39,2010-03-23,Assembly,"Do pass and be re-referred to the Committee on Appropriations.",7,4,0,0,11
63574,40,2010-05-28,Assembly,"Do pass as amended.",12,5,0,0,17
63574,41,2010-06-02,Assembly,"AB 1853 HUFFMAN  Assembly Third Reading",47,25,7,0,79
63574,10033,2010-06-29,Senate,"Do pass, but re-refer to the Committee on Appropriations",7,1,3,0,11
63574,19147,2010-08-02,Senate,"Placed on Appropriations Suspense file",10,0,0,0,10
63574,21976,2010-08-31,Senate,"W/O REF. TO FILE AB1853 De La Torre",13,10,0,0,23
63575,1629,2010-05-05,Assembly,"Do pass as amended",6,2,1,0,9
63575,1630,2010-06-01,Assembly,"AB 1854 AMMIANO  Assembly Third Reading",48,27,4,0,79
63575,9500,2010-06-23,Senate,"Do pass as amended",5,2,2,0,9
63575,20894,2010-08-18,Senate,"Assembly 3rd Reading AB1854 Ammiano By Romero",21,11,0,0,32
63575,20895,2010-08-20,Assembly,"AB 1854 AMMIANO  Concurrence in Senate Amendments",48,27,0,0,75
63576,4555,2010-04-12,Assembly,"Do pass as amended and re-refer to Committee on Appropriations with recommendation:  To Consent Calendar",13,0,1,0,14
63576,4556,2010-05-05,Assembly,"Do pass, to Consent Calendar",17,0,0,0,17
63576,4557,2010-05-13,Assembly,"AB 1855 YAMADA  Consent Calendar Second Day  Regular Session",76,0,3,0,79
63576,9040,2010-06-15,Senate,"Do pass, but re-refer to the Committee on Appropriations Recommend Consent",8,0,1,0,9
63576,19148,2010-08-02,Senate,"Consent Calendar 2nd AB1855 Yamada",33,0,0,0,33
63576,19806,2010-08-09,Assembly,"AB 1855 YAMADA  Concurrence in Senate Amendments",78,0,0,0,78
63577,4252,2010-04-21,Assembly,"Do pass and re-refer to Committee on Appropriations with recommendation:  To Consent Calendar",6,0,0,0,6
63577,4253,2010-05-05,Assembly,"Do pass, to Consent Calendar",17,0,0,0,17
63577,4254,2010-05-17,Assembly,"AB 1856 FONG  Consent Calendar Second Day  Regular Session",73,0,6,0,79
63577,8919,2010-06-14,Senate,"Do pass, but re-refer to the Committee on Appropriations Recommend Consent",5,0,1,0,6
63577,9932,2010-06-28,Senate,"Do pass",10,0,1,0,11
63577,10082,2010-07-01,Senate,"Special Consent #29 AB1856 Fong",34,0,5,0,39
63577,19865,2010-08-09,Assembly,"AB 1856 FONG  Concurrence in Senate Amendments",78,0,0,0,78
63578,102,2010-05-05,Assembly,"Do pass.",19,0,3,0,22
63578,103,2010-05-13,Assembly,"AB 1857 COOK  Assembly Third Reading",73,0,6,0,79
63579,1393,2010-04-06,Assembly,"Do pass as amended and be re-referred to the Committee on Appropriations",11,5,3,0,19
63579,1394,2010-05-05,Assembly,"Do pass",12,5,0,0,17
63579,1395,2010-05-13,Assembly,"AB 1858 BLUMENFIELD  Assembly Third Reading",44,29,6,0,79
63579,9460,2010-06-23,Senate,"Do pass as amended, and re-refer to the Committee on Appropriations",4,1,4,0,9
63579,9461,2010-06-23,Senate,"Set, second hearing.  Failed passage in Committee. Reconsideration granted",6,0,3,0,9
63579,10252,2010-06-30,Senate,"Do pass as amended, and re-refer to the Committee on Appropriations",5,3,1,0,9
63579,19160,2010-08-02,Senate,"Placed on Appropriations Suspense file",10,0,0,0,10
63579,20185,2010-08-12,Senate,"Do pass as amended",7,4,0,0,11
63579,20931,2010-08-23,Senate,"Assembly 3rd Reading AB1858 Blumenfield By Yee",21,13,0,0,34
63579,20932,2010-08-23,Senate,"Assembly 3rd Reading AB1858 Blumenfield Reconsider",36,0,0,0,36
63579,21047,2010-08-24,Senate,"Assembly 3rd Reading AB1858 Blumenfield By Yee",21,15,0,0,36
63579,21399,2010-08-26,Assembly,"AB 1858 BLUMENFIELD  Concurrence in Senate Amendments",47,28,0,0,75
63580,3826,2010-04-21,Assembly,"Do pass and be re-referred to the Committee on Appropriations",0,4,5,0,9
63581,1933,2010-04-12,Assembly,"Do pass and re-refer to Committee on Appropriations with recommendation:  To Consent Calendar",20,0,2,0,22
63581,1934,2010-04-21,Assembly,"Do pass",17,0,0,0,17
63581,1935,2010-05-03,Assembly,"AB 1860 BERRYHILL, T.  Assembly Third Reading",74,0,5,0,79
63581,9192,2010-06-22,Senate,"Do pass, but re-refer to the Committee on Appropriations Recommend Consent",9,0,2,0,11
63581,19424,2010-08-05,Senate,"Consent Calendar 2nd AB1860 Tom Berryhill",33,0,0,0,33
63581,20239,2010-08-12,Assembly,"AB 1860 BERRYHILL, T.  Concurrence- Urgency Added",76,0,0,0,76
63583,4112,2010-04-21,Assembly,"Do pass and be re-referred to the Committee on Appropriations",4,2,0,0,6
63583,4113,2010-05-05,Assembly,"Do pass",12,5,0,0,17
63583,4114,2010-05-13,Assembly,"AB 1862 ENG  Assembly Third Reading",50,25,4,0,79
63583,8709,2010-06-14,Senate,"Do pass, but re-refer to the Committee on Appropriations",4,2,0,0,6
63583,9842,2010-06-28,Senate,"Do pass",7,3,1,0,11
63583,20910,2010-08-20,Senate,"Assembly 3rd Reading AB1862 Eng By Corbett",23,8,0,0,31
63584,4403,2010-03-23,Assembly,"Do pass and re-refer to Committee on Appropriations with recommendation:  To Consent Calendar",18,0,1,0,19
63584,4404,2010-04-14,Assembly,"Do pass, to Consent Calendar",15,0,2,0,17
63584,4405,2010-04-22,Assembly,"AB 1863 GAINES  Consent Calendar Second Day  Regular Session",74,0,5,0,79
63584,4406,2010-06-09,Senate,"Do pass, but re-refer to the Committee on Environmental Quality",5,0,4,0,9
63584,9597,2010-06-28,Senate,"Do pass, but re-refer to the Committee on Appropriations Recommend Consent",7,0,0,0,7
63584,19586,2010-08-05,Senate,"Consent Calendar 2nd AB1863 Gaines",33,0,0,0,33
63585,5070,2010-03-23,Assembly,"Do pass as amended and be re-referred to the Committee on Appropriations",17,1,1,0,19
63586,1850,2010-04-14,Assembly,"Do pass and be re-referred to the Committee on Appropriations",9,0,0,0,9
63586,1851,2010-05-28,Assembly,"Do pass",17,0,0,0,17
63586,1852,2010-06-02,Assembly,"AB 1865 STRICKLAND  Assembly Third Reading  By ARAMBULA",75,0,4,0,79
63586,9254,2010-06-22,Senate,"Do pass, but re-refer to the Committee on Appropriations Recommend Consent",6,0,3,0,9
63586,19479,2010-08-05,Senate,"Consent Calendar 2nd AB1865 Audra Strickland",33,0,0,0,33
63586,19717,2010-08-09,Assembly,"AB 1865 STRICKLAND  Concurrence in Senate Amendments",77,0,0,0,77
63587,279,2010-03-23,Assembly,"Do pass and be re-referred to the Committee on Appropriations.",2,3,1,0,6
63588,1732,2010-04-21,Assembly,"Do pass and be re-referred to the Committee on Housing and Community Development",6,2,1,0,9
63588,1733,2010-04-28,Assembly,"Do pass, to Consent Calendar",9,0,0,0,9
63588,1734,2010-05-06,Assembly,"AB 1867 HARKEY  Consent Calendar Second Day",74,0,5,0,79
63588,10191,2010-06-29,Senate,"Do pass as amended",8,0,1,0,9
63588,19710,2010-08-09,Senate,"Special Consent #30 AB1867 Harkey",34,0,0,0,34
63588,19920,2010-08-12,Assembly,"AB 1867 HARKEY  Concurrence in Senate Amendments",78,0,0,0,78
63589,3169,2010-04-07,Assembly,"Do pass as amended and be re-referred to the Committee on Appropriations",8,4,0,0,12
63589,3170,2010-05-28,Assembly,"Do pass",12,5,0,0,17
63589,3171,2010-06-01,Assembly,"AB 1868 JONES  Assembly Third Reading",48,28,3,0,79
63589,9976,2010-06-30,Senate,"Do pass as amended, and re-refer to the Committee on Appropriations",10,0,1,0,11
63589,19448,2010-08-02,Senate,"Do pass as amended",6,3,0,0,9
63589,21301,2010-08-23,Senate,"Assembly 3rd Reading AB1868 Jones By Calderon",23,12,0,0,35
63589,21302,2010-08-25,Assembly,"AB 1868 JONES  Concurrence in Senate Amendments",64,11,0,0,75
63592,1993,2010-05-05,Assembly,"Do pass as amended",7,2,3,0,12
63592,1994,2010-06-03,Assembly,"AB 1871 JONES  Assembly Third Reading",75,0,4,0,79
63592,10294,2010-06-30,Senate,"Do pass",10,0,1,0,11
63592,21152,2010-08-25,Senate,"Assembly 3rd Reading AB1871 Jones By Pavley",35,0,0,0,35
63592,21358,2010-08-26,Assembly,"AB 1871 JONES  Concurrence in Senate Amendments",74,0,0,0,74
63593,27313,2010-03-22,Assembly,"Be adopted, and re-refer to Committee on Appropriations with 	recommendation:  To Consent Calendar",13,0,0,0,13
63593,27314,2010-04-14,Assembly,"Be adopted, to Consent Calendar",15,0,0,0,15
63593,27315,2010-04-19,Assembly,"ACR 122 LOGUE  Consent Calendar Second Day  Regular Session",73,0,0,0,73
63593,27316,2010-05-04,Senate,"Be adopted, but re-refer to the Committee on Appropriations 	Recommend Consent",8,0,0,0,8
63593,27317,2010-05-27,Senate,"Consent Calendar 2nd ACR122 Logue",33,0,0,0,33
63594,8312,2010-03-25,Assembly,"From committee:  Be adopted.  To third reading",10,0,1,0,11
63594,10364,2010-07-01,Senate,"W/O REF. TO FILE ACR123 Chesbro",34,0,5,0,39
63597,4719,2010-04-14,Senate,"Do pass, but re-refer to the Committee on Appropriations",5,0,0,0,5
63597,4720,2010-05-10,Senate,"Special Consent #23 SB1028 Correa",30,0,8,0,38
63597,9923,2010-06-28,Assembly,"Amend, and do pass as amended and be re-referred to the Committee on Appropriations with the recommendation:  To Consent Calendar",9,0,0,0,9
63597,19554,2010-08-04,Assembly,"Do pass, to Consent Calendar",17,0,0,0,17
63597,19963,2010-08-12,Assembly,"SB 1028 Correa  Consent Calendar Second Day  Regular Session",78,0,0,0,78
63597,20729,2010-08-19,Senate,"Unfinished Business SB1028 Correa",35,0,0,0,35
63598,4883,2010-03-24,Senate,"Do pass as amended, and re-refer to the Committee on Business, Professions and Economic Development",6,3,0,0,9
63598,4884,2010-04-22,Senate,"Do pass, but re-refer to the Committee on Appropriations",5,1,3,0,9
63598,4885,2010-05-28,Senate,"Senate 3rd Reading SB1029 Yee",21,6,11,0,38
63598,4886,2010-05-28,Senate,"Senate 3rd Reading SB1029 Yee Reconsider",30,0,8,0,38
63598,4887,2010-05-28,Senate,"Senate 3rd Reading SB1029 Yee",21,8,9,0,38
63598,9491,2010-06-22,Assembly,"Do pass and be re-referred to the Committee on Business, Professions and Consumer Protection",12,6,1,0,19
63598,9674,2010-06-29,Assembly,"Do pass and be re-referred to the Committee on Appropriations",6,2,3,0,11
63598,19768,2010-08-04,Assembly,"Do pass",12,5,0,0,17
63598,21546,2010-08-26,Assembly,"SB 1029 Yee  Senate Third Reading  By CHESBRO",48,23,0,0,71
63598,21860,2010-08-31,Senate,"W/O REF. TO FILE SB1029 Yee Concurrence",21,16,0,0,37
63600,375,2010-04-19,Senate,"Do pass, but re-refer to the Committee on Appropriations.",7,0,2,0,9
63600,376,2010-05-24,Senate,"Placed on Appropriations Suspense file.",10,0,1,0,11
63600,377,2010-05-27,Senate,"Do pass as amended.",10,0,1,0,11
63600,378,2010-06-02,Senate,"Special Consent #26 SB1031 Corbett",35,0,3,0,38
63601,2018,2010-04-13,Senate,"Do pass, but re-refer to the Committee on Appropriations",7,0,0,0,7
63601,2019,2010-05-03,Senate,"Placed on Appropriations Suspense file",10,0,1,0,11
63601,2020,2010-05-27,Senate,"Do pass",10,0,1,0,11
63601,2021,2010-06-02,Senate,"Special Consent #26 SB1032 Wright",35,0,3,0,38
63601,9212,2010-06-22,Assembly,"Do pass and be re-referred to the Committee on Appropriations",6,0,1,0,7
63601,20219,2010-08-12,Assembly,"Do pass",12,5,0,0,17
63601,20551,2010-08-19,Assembly,"SB 1032 Wright  Senate Third Reading  By HALL",78,0,0,0,78
63602,184,2010-04-19,Senate,"Do pass as amended, and re-refer to the Committee on Appropriations.",5,1,1,0,7
63602,185,2010-05-24,Senate,"Senate 3rd Reading SB1033 Wright",32,1,5,0,38
63603,1185,2010-03-23,Senate,"Do pass, but re-refer to the Committee on Public Safety.",6,3,0,0,9
63603,1186,2010-04-20,Senate,"Do pass, but re-refer to the Committee on Appropriations.",7,0,0,0,7
63603,1187,2010-05-10,Senate,"Senate 3rd Reading SB1034 Ducheny",31,0,7,0,38
63603,9295,2010-06-22,Assembly,"Do pass and re-refer to Committee on Appropriations with recommendation:  To Consent Calendar",6,0,1,0,7
63603,19322,2010-08-04,Assembly,"Do pass, to Consent Calendar",17,0,0,0,17
63603,19909,2010-08-12,Assembly,"SB 1034 Ducheny  Consent Calendar Second Day  Regular Session",78,0,0,0,78
63603,20758,2010-08-19,Senate,"Unfinished Business SB1034 Ducheny",35,0,0,0,35
63604,57,2010-04-07,Senate,"Do pass, but re-refer to the Committee on Judiciary.",4,1,0,0,5
63604,58,2010-04-13,Senate,"Do pass as amended, and re-refer to the Committee on Appropriations.",3,1,1,0,5
63604,59,2010-05-10,Senate,"Do pass.",7,1,3,0,11
63604,60,2010-05-28,Senate,"Senate 3rd Reading SB1035 Hancock",22,6,10,0,38
63604,9051,2010-06-16,Assembly,"Do pass and be re-referred to the Committee on Judiciary",6,3,0,0,9
63604,9753,2010-06-29,Assembly,"Do pass and be re-referred to the Committee on Appropriations",7,3,0,0,10
63604,19597,2010-08-04,Assembly,"Do pass",12,5,0,0,17
63604,21115,2010-08-23,Assembly,"SB 1035 Hancock  Senate Third Reading  By SKINNER",49,27,0,0,76
63604,21116,2010-08-25,Senate,"Unfinished Business SB1035 Hancock",22,11,0,0,33
63605,1693,2010-04-14,Senate,"Do pass as amended, and re-refer to the Committee on Appropriations",4,1,0,0,5
63605,1694,2010-05-13,Senate,"Senate 3rd Reading SB1036 Cedillo",20,11,7,0,38
63605,1695,2010-05-13,Senate,"Senate 3rd Reading SB1036 Cedillo Reconsider",31,0,7,0,38
63605,1696,2010-05-28,Senate,"Senate 3rd Reading SB1036 Cedillo",23,7,8,0,38
63605,9945,2010-06-28,Assembly,"Do pass",0,6,3,0,9
63605,9946,2010-06-28,Assembly,"Set first hearing.  Failed passage.  Reconsideration granted",9,0,0,0,9
63606,3976,2010-04-13,Senate,"Do pass, but re-refer to the Committee on Appropriations",2,3,2,0,7
63607,728,2010-05-04,Senate,"Do pass and be placed on the Consent Calendar.",4,0,1,0,5
63607,729,2010-05-13,Senate,"Consent Calendar 2nd SB1038 Harman",31,0,7,0,38
63607,8921,2010-06-15,Assembly,"Do pass, to Consent Calendar",10,0,0,0,10
63607,9123,2010-06-21,Assembly,"SB 1038 Harman  Consent Calendar Second Day  Regular Session",75,0,4,0,79
63608,4785,2010-05-05,Senate,"Do pass",5,0,0,0,5
63608,4786,2010-05-10,Senate,"Senate 3rd Reading SB1039 Ducheny",31,0,7,0,38
63609,1615,2010-04-06,Senate,"Do pass as amended, and re-refer to the Committee on Appropriations",10,0,1,0,11
63609,1616,2010-04-26,Senate,"Do pass as amended",9,0,2,0,11
63609,1617,2010-05-03,Senate,"Senate 3rd Reading SB1040 Padilla Urgency Clause",33,0,5,0,38
63609,8743,2010-06-14,Assembly,"Do pass as amended and be re-referred to the Committee on Appropriations",9,3,3,0,15
63609,20402,2010-08-12,Assembly,"Do pass as amended",12,5,0,0,17
63609,20584,2010-08-19,Assembly,"SB 1040 Padilla  Third Reading Urgency  By FUENTES",61,16,0,0,77
63609,21183,2010-08-25,Senate,"Unfinished Business SB1040 Padilla Urgency Clause",35,0,0,0,35
63609,21184,2010-08-25,Senate,"Unfinished Business SB1040 Padilla Reconsider",35,0,0,0,35
63609,21185,2010-08-25,Senate,"Unfinished Business SB1040 Padilla Urgency Clause",32,1,0,0,33
63610,2276,2010-05-04,Senate,"Do pass as amended",4,0,1,0,5
63610,2277,2010-05-17,Senate,"Special Consent #24 SB1041 Harman",33,0,5,0,38
63610,9439,2010-06-22,Assembly,"Do pass, to Consent Calendar",10,0,0,0,10
63610,9591,2010-06-28,Assembly,"SB 1041 Harman  Consent Calendar Second Day  Regular Session",73,0,6,0,79
63611,1294,2010-03-17,Senate,"Do pass and be placed on the Consent Calendar.",4,0,1,0,5
63611,1295,2010-03-25,Senate,"Consent Calendar 2nd SB1042 Walters",33,0,6,0,39
63611,9080,2010-06-16,Assembly,"Do pass, to Consent Calendar",9,0,0,0,9
63611,9382,2010-06-24,Assembly,"SB 1042 Walters  Consent Calendar Second Day  Regular Session",73,0,6,0,79
63612,6109,2010-05-03,Senate,"Do pass",1,4,4,0,9
63612,6110,2010-05-03,Senate,"Reconsideration granted",8,0,1,0,9
63627,27425,2010-02-24,Senate,"Do pass, but re-refer to the Committee on Transportation and 	Housing",1,3,0,0,4
63631,3385,2010-02-25,Senate,"Do pass as amended, and re-refer to the Committee on Appropriations",2,6,1,0,9
63631,3386,2010-02-25,Senate,"Set, first hearing.  Failed passage in Committee.  Reconsideration granted",8,0,1,0,9
63634,2976,2010-03-25,Senate,"Senate 3rd Reading SCR73 DeSaulnier",33,0,6,0,39
63634,2977,2010-05-20,Assembly,"From committee:  Be adopted.  To third reading",9,0,2,0,11
63634,9578,2010-06-28,Senate,"Special Consent #28 SCR73 DeSaulnier",32,0,7,0,39
69511,1995,2010-03-23,Assembly,"Do pass as amended and be re-referred to the Committee on Appropriations",19,0,0,0,19
69511,1996,2010-05-28,Assembly,"Do pass",17,0,0,0,17
69511,1997,2010-06-01,Assembly,"AB 1872 GALGIANI  Assembly Third Reading",77,0,2,0,79
69511,9533,2010-06-23,Senate,"Do pass as amended, and re-refer to the Committee on Appropriations",6,0,3,0,9
69511,19491,2010-08-02,Senate,"Placed on Appropriations Suspense file",10,0,0,0,10
69512,3178,2010-04-19,Assembly,"Do pass as amended and be re-referred to the Committee on Appropriations",6,3,0,0,9
69512,3179,2010-05-28,Assembly,"Do pass as amended",12,0,5,0,17
69512,3180,2010-06-02,Assembly,"AB 1873 HUFFMAN  Assembly Third Reading",52,24,3,0,79
69512,10224,2010-06-29,Senate,"Do pass, but re-refer to the Committee on Appropriations",8,0,3,0,11
69512,20591,2010-08-18,Senate,"Assembly 3rd Reading AB1873 Huffman By Pavley",24,10,0,0,34
69512,20659,2010-08-20,Assembly,"AB 1873 HUFFMAN  Concurrence in Senate Amendments",53,21,0,0,74
69513,5409,2010-03-24,Assembly,"Do pass as amended and re-refer to Committee on Appropriations with recommendation:  To Consent Calendar",9,0,0,0,9
69513,5410,2010-04-14,Assembly,"Do pass, to Consent Calendar",15,0,2,0,17
69513,5411,2010-04-22,Assembly,"AB 1874 EVANS  Consent Calendar Second Day  Regular Session",74,0,5,0,79
69513,8927,2010-06-16,Senate,"Do pass, but re-refer to the Committee on Appropriations Recommend Consent",6,0,3,0,9
69513,19100,2010-08-02,Senate,"Consent Calendar 2nd AB1874 Evans",33,0,0,0,33
69515,790,2010-04-21,Assembly,"Do pass as amended.",6,3,0,0,9
69515,791,2010-05-13,Assembly,"AB 1876 TORLAKSON  Assembly Third Reading",51,24,4,0,79
69515,9202,2010-06-23,Senate,"Do pass",5,2,2,0,9
69515,10035,2010-07-01,Senate,"Assembly 3rd Reading AB1876 Torlakson By Liu",24,10,5,0,39
69517,4869,2010-04-20,Assembly,"Do pass and be re-referred to the Committee on Appropriations",7,4,0,0,11
69518,571,2010-04-19,Assembly,"Do pass and be re-referred to the Committee on Appropriations.",14,0,1,0,15
69518,572,2010-05-28,Assembly,"Do pass.",12,5,0,0,17
69518,573,2010-06-01,Assembly,"AB 1879 BEALL  Assembly Third Reading",67,8,4,0,79
69518,10254,2010-06-29,Senate,"Do pass, but re-refer to the Committee on Appropriations Recommend Consent",10,0,1,0,11
69518,19714,2010-08-09,Senate,"Consent Calendar 2nd AB1879 Beall",34,0,0,0,34
69518,19924,2010-08-12,Assembly,"AB 1879 BEALL  Concurrence in Senate Amendments",67,8,0,0,75
69520,4085,2010-05-05,Assembly,"Do pass",4,2,0,0,6
69520,4086,2010-05-13,Assembly,"AB 1881 MONNING  Assembly Third Reading",48,27,4,0,79
69520,7108,2010-06-09,Senate,"Do pass",4,0,2,0,6
69520,21103,2010-08-24,Senate,"Assembly 3rd Reading AB1881 Monning By DeSaulnier",21,15,0,0,36
69522,5412,2010-03-23,Assembly,"Do pass as amended",7,3,0,0,10
69522,5413,2010-05-03,Assembly,"AB 1883 EVANS  Assembly Third Reading",45,30,4,0,79
69524,2264,2010-04-06,Assembly,"Do pass and be re-referred to the Committee on Appropriations",5,2,0,0,7
69524,2265,2010-04-21,Assembly,"Do pass",12,5,0,0,17
69524,2266,2010-04-29,Assembly,"AB 1885 HILL  Assembly Third Reading",53,15,11,0,79
69524,9594,2010-06-22,Senate,"Do pass as amended, and re-refer to the Committee on Appropriations",5,2,0,0,7
69524,20980,2010-08-24,Senate,"Assembly 3rd Reading AB1885 Hill By Yee",29,6,0,0,35
69524,21284,2010-08-25,Assembly,"AB 1885 HILL  Concurrence in Senate Amendments",68,9,0,0,77
69525,5276,2010-03-23,Assembly,"Do pass and be re-referred to the Committee on Appropriations",9,2,1,0,12
69526,2653,2010-04-20,Assembly,"Do pass as amended and be re-referred to the Committee on Appropriations",17,0,2,0,19
69526,2654,2010-05-28,Assembly,"Do pass as amended",17,0,0,0,17
69526,8692,2010-06-14,Assembly,"AB 1887 VILLINES  Third Reading Urgency",72,0,7,0,79
69526,8903,2010-06-16,Senate,"Do pass, but re-refer to the Committee on Appropriations",6,2,1,0,9
69526,8989,2010-06-17,Senate,"Do pass",7,1,3,0,11
69526,9828,2010-06-28,Senate,"Assembly 3rd Reading AB1887 Villines Urgency Clause",27,8,4,0,39
69527,2146,2010-04-19,Assembly,"Do pass and be re-referred to the Committee on Appropriations",13,0,1,0,14
69527,2147,2010-04-28,Assembly,"Do pass, to Consent Calendar",15,0,2,0,17
69527,2148,2010-05-06,Assembly,"AB 1888 MA  Consent Calendar Second Day  Regular Session",74,0,5,0,79
69527,9315,2010-06-22,Senate,"Do pass, but re-refer to the Committee on Appropriations Recommend Consent",9,0,2,0,11
69527,19434,2010-08-05,Senate,"Consent Calendar 2nd AB1888 Ma",33,0,0,0,33
69527,20080,2010-08-12,Assembly,"AB 1888 MA  Concurrence in Senate Amendments",78,0,0,0,78
69528,674,2010-04-06,Assembly,"Do pass and be re-referred to the Committee on Appropriations.",6,3,0,0,9
69528,675,2010-05-28,Assembly,"Do pass.",12,5,0,0,17
69528,676,2010-06-01,Assembly,"AB 1889 PORTANTINO  Assembly Third Reading",50,24,5,0,79
69528,10051,2010-06-28,Senate,"Do pass, but re-refer to the Committee on Education",6,1,2,0,9
69528,19325,2010-08-02,Senate,"Placed on Appropriations Suspense file",10,0,0,0,10
69528,20097,2010-08-12,Senate,"Do pass as amended",7,4,0,0,11
69528,21357,2010-08-24,Senate,"Assembly 3rd Reading AB1889 Portantino By Calderon",23,13,0,0,36
69528,21778,2010-08-31,Assembly,"AB 1889 PORTANTINO  Concurrence in Senate Amendments",62,15,0,0,77
69529,1296,2010-04-06,Assembly,"Do pass and re-refer to Committee on Appropriations with recommendation:  To Consent Calendar.",9,0,0,0,9
69529,1297,2010-04-21,Assembly,"Do pass, to Consent Calendar.",17,0,0,0,17
69529,1298,2010-04-29,Assembly,"AB 1890 HIGHER ED.  Consent Calendar Second Day  Regular Session",74,0,5,0,79
69529,9079,2010-06-16,Senate,"Do pass as amended, but re-refer to the Committee on Appropriations Recommend Consent",6,0,3,0,9
69529,19626,2010-08-05,Senate,"Consent Calendar 2nd AB1890 Committee on HIGHER ED. (Portanti",33,0,0,0,33
69529,19627,2010-08-09,Assembly,"AB 1890 HIGHER ED.  Concurrence in Senate Amendments By BLOCK",77,0,0,0,77
69530,3996,2010-04-06,Assembly,"Do pass and be re-referred to the Committee on Agriculture to Consent Calendar",9,0,0,0,9
69530,3997,2010-04-14,Assembly,"Do pass and re-refer to Committee on Appropriations with recommendation:  To Consent Calendar",8,0,0,0,8
69530,3998,2010-04-28,Assembly,"Do pass, to Consent Calendar",15,0,2,0,17
69530,3999,2010-05-06,Assembly,"AB 1891 HIGHER ED.  Consent Calendar Second Day  Regular Session",74,0,5,0,79
69530,9014,2010-06-16,Senate,"Do pass, but re-refer to the Committee on Appropriations Recommend Consent",6,0,3,0,9
69530,19595,2010-08-05,Senate,"Consent Calendar 2nd AB1891 Committee on HIGHER ED. (Portanti",33,0,0,0,33
69530,19704,2010-08-09,Assembly,"AB 1891 HIGHER ED.  Concurrence in Senate Amendments By BLOCK",76,0,0,0,76
69533,8675,2010-04-06,Assembly,"Do pass as amended, to Consent Calendar",9,0,1,0,10
69533,8676,2010-04-22,Assembly,"AB 1894 MONNING  Assembly Third Reading",73,0,6,0,79
69533,9210,2010-06-22,Senate,"Do pass and be placed on the Consent Calendar",4,0,1,0,5
69533,10348,2010-07-01,Senate,"Consent Calendar 2nd AB1894 Monning",34,0,5,0,39
69533,19306,2010-08-02,Assembly,"AB 1894 MONNING  Concurrence in Senate Amendments",74,0,0,0,74
69534,2016,2010-05-04,Assembly,"Do pass",9,0,0,0,9
69534,2017,2010-05-24,Assembly,"AB 1895 RUSKIN  Assembly Third Reading",70,0,9,0,79
69535,1121,2010-04-12,Assembly,"Do pass as amended and be re-referred to the Committee on Appropriations.",20,0,2,0,22
69535,1122,2010-05-28,Assembly,"Do pass as amended.",12,0,5,0,17
69535,1123,2010-06-02,Assembly,"AB 1896 JEFFRIES  Assembly Third Reading",75,0,4,0,79
69535,10291,2010-06-29,Senate,"Do pass, but re-refer to the Committee on Appropriations Recommend Consent",8,0,3,0,11
69535,19471,2010-08-05,Senate,"Consent Calendar 2nd AB1896 Jeffries",33,0,0,0,33
69536,61,2010-04-21,Assembly,"Do pass as amended and be re-referred to the Committee on Appropriations.",8,4,0,0,12
69538,3223,2010-03-23,Assembly,"Do pass and be re-referred to the Committee on Appropriations",7,3,1,0,11
69538,3224,2010-05-28,Assembly,"Do pass as amended",12,0,5,0,17
69538,3225,2010-06-03,Assembly,"AB 1899 ENG  Assembly Third Reading",49,27,3,0,79
69538,10154,2010-06-29,Senate,"Do pass, but re-refer to the Committee on Appropriations",7,1,3,0,11
69538,19688,2010-08-02,Senate,"Placed on Appropriations Suspense file",10,0,0,0,10
69538,20042,2010-08-12,Senate,"Do pass",7,4,0,0,11
69538,20795,2010-08-23,Senate,"Assembly 3rd Reading AB1899 Eng By Yee",23,12,0,0,35
69538,21532,2010-08-27,Assembly,"AB 1899 ENG  Concurrence in Senate Amendments",53,24,0,0,77
69539,1755,2010-04-06,Assembly,"Do pass and be re-referred to the Committee on Appropriations",5,0,2,0,7
69539,1756,2010-05-12,Assembly,"Do pass as amended",11,0,6,0,17
69539,1757,2010-05-20,Assembly,"AB 1900 SKINNER  Assembly Third Reading",70,0,9,0,79
69539,9944,2010-06-29,Senate,"Do pass, but re-refer to the Committee on Appropriations",7,0,0,0,7
69539,19486,2010-08-02,Senate,"Do pass as amended",9,0,0,0,9
69539,20920,2010-08-23,Senate,"Assembly 3rd Reading AB1900 Skinner By Liu",35,0,0,0,35
69539,21040,2010-08-24,Assembly,"AB 1900 SKINNER  Concurrence in Senate Amendments",74,0,0,0,74
69540,1219,2010-04-20,Assembly,"Do pass and be re-referred to the Committee on Appropriations.",9,0,0,0,9
69540,1220,2010-05-28,Assembly,"AB 1901 RUSKIN  Assembly Third Reading",63,0,16,0,79
69540,10290,2010-06-30,Senate,"Do pass as amended. To Consent Calendar",8,0,1,0,9
69540,19423,2010-08-05,Senate,"Consent Calendar 2nd AB1901 Ruskin",33,0,0,0,33
69540,19637,2010-08-09,Assembly,"AB 1901 RUSKIN  Concurrence in Senate Amendments",77,0,0,0,77
69541,3908,2010-05-05,Assembly,"Do pass",6,0,0,0,6
69541,3909,2010-05-10,Assembly,"AB 1902 PORTANTINO  Assembly Third Reading",72,0,7,0,79
69541,9570,2010-06-23,Senate,"Do pass",5,0,1,0,6
69541,10003,2010-07-01,Senate,"Special Consent #29 AB1902 Portantino",34,0,5,0,39
69542,4853,2010-04-07,Assembly,"Do pass and be re-referred to the Committee on Appropriations",6,0,0,0,6
69543,1384,2010-04-20,Assembly,"Do pass and be re-referred to the Committee on Appropriations",4,12,3,0,19
69544,2633,2010-03-23,Assembly,"Do pass and be re-referred to the Committee on Appropriations",6,0,0,0,6
69544,2634,2010-04-14,Assembly,"Do pass, to Consent Calendar",15,0,2,0,17
69544,2635,2010-04-22,Assembly,"AB 1905 COOK  Consent Calendar Second Day  Regular Session",74,0,5,0,79
69544,6111,2010-06-10,Senate,"Do pass, but re-refer to the Committee on Appropriations Recommend Consent",3,0,1,0,4
69544,20761,2010-08-20,Senate,"Assembly 3rd Reading AB1905 Cook By Emmerson",32,0,0,0,32
69544,20814,2010-08-23,Assembly,"AB 1905 COOK  Concurrence in Senate Amendments",76,0,0,0,76
69545,4738,2010-03-23,Assembly,"Do pass as amended and be re-referred to the Committee on Appropriations",7,0,0,0,7
69545,4739,2010-04-21,Assembly,"Do pass",17,0,0,0,17
69545,4740,2010-04-26,Assembly,"AB 1906 COOK  Assembly Third Reading",69,1,9,0,79
69545,8856,2010-06-15,Senate,"Do pass, but re-refer to the Committee on Appropriations",5,0,0,0,5
69545,9580,2010-06-28,Senate,"Do pass",9,1,1,0,11
69545,9979,2010-07-01,Senate,"Assembly 3rd Reading AB1906 Cook By Dutton",33,0,6,0,39
69547,3806,2010-04-05,Assembly,"Do pass and be re-referred to the Committee on Veterans Affairs",14,0,0,0,14
69547,3807,2010-04-13,Assembly,"Do pass and be re-referred to the Committee on Appropriations",9,0,0,0,9
69547,3808,2010-05-05,Assembly,"Do pass, to Consent Calendar",17,0,0,0,17
69547,3809,2010-05-13,Assembly,"AB 1908 COOK  Consent Calendar Second Day  Regular Session",76,0,3,0,79
69547,9333,2010-06-22,Senate,"Do pass, but re-refer to the Committee on Transportation and Housing",4,0,1,0,5
69547,10310,2010-06-29,Senate,"Do pass, but re-refer to the Committee on Appropriations Recommend Consent",8,0,1,0,9
69547,19425,2010-08-05,Senate,"Consent Calendar 2nd AB1908 Cook",33,0,0,0,33
69549,4888,2010-03-24,Assembly,"Do pass and be re-referred to the Committee on Appropriations",8,0,0,0,8
69549,4889,2010-04-14,Assembly,"Do pass, to Consent Calendar",15,0,2,0,17
69549,4890,2010-04-22,Assembly,"AB 1910 AGRI.  Consent Calendar Second Day  Regular Session",74,0,5,0,79
69549,8789,2010-06-15,Senate,"Do pass, but re-refer to the Committee on Appropriations Recommend Consent",5,0,0,0,5
69549,19223,2010-08-02,Senate,"Consent Calendar 2nd AB1910 Committee on AGRI. (Galgiani)",33,0,0,0,33
69549,19788,2010-08-09,Assembly,"AB 1910 AGRI.  Concurrence in Senate Amendments By GALGIANI",78,0,0,0,78
69550,1299,2010-04-13,Assembly,"Do pass.",11,0,0,0,11
69550,1300,2010-04-26,Assembly,"AB 1911 GARRICK  Assembly Third Reading",68,0,11,0,79
69550,5835,2010-06-09,Senate,"Do pass, but re-refer to the Committee on Rules Recommend Consent",6,0,5,0,11
69550,9477,2010-06-23,Senate,"Do pass as amended",4,0,1,0,5
69550,9573,2010-06-28,Senate,"Assembly 3rd Reading AB1911 Garrick Urgency Clause",32,0,7,0,39
69550,10025,2010-07-01,Assembly,"AB 1911 GARRICK  Concurrence- Urgency Added",73,0,6,0,79
69551,1399,2010-04-14,Assembly,"Do pass and be re-referred to the Committee on Judiciary",7,0,1,0,8
69551,1400,2010-04-20,Assembly,"Do pass and be re-referred to the Committee on Appropriations",8,2,0,0,10
69551,1401,2010-05-28,Assembly,"Do pass",12,5,0,0,17
69551,1402,2010-06-01,Assembly,"AB 1912 EVANS  Assembly Third Reading",61,15,3,0,79
69551,8737,2010-06-15,Senate,"Do pass, but re-refer to the Committee on Appropriations",4,1,0,0,5
69551,9806,2010-06-28,Senate,"Do pass as amended",9,1,1,0,11
69551,19884,2010-08-11,Senate,"Assembly 3rd Reading AB1912 Evans By Hancock",26,8,0,0,34
69551,20298,2010-08-16,Assembly,"AB 1912 EVANS  Concurrence in Senate Amendments",57,16,0,0,73
69552,1226,2010-04-21,Assembly,"Do pass as amended and be re-referred to the Committee on Appropriations.",4,2,0,0,6
69552,1227,2010-05-12,Assembly,"Do pass.",11,5,1,0,17
69552,1228,2010-05-20,Assembly,"AB 1913 DAVIS  Assembly Third Reading",44,25,10,0,79
69553,1803,2010-04-13,Assembly,"Do pass and be re-referred to the Committee on Appropriations",4,1,1,0,6
69553,1804,2010-04-28,Assembly,"Do pass",10,5,2,0,17
69553,1805,2010-05-06,Assembly,"AB 1914 DAVIS  Assembly Third Reading",45,28,6,0,79
69553,9527,2010-06-22,Senate,"Do pass, but re-refer to the Committee on Appropriations",3,2,0,0,5
69553,19163,2010-08-02,Senate,"Placed on Appropriations Suspense file",10,0,0,0,10
69553,20189,2010-08-12,Senate,"Do pass as amended",7,4,0,0,11
69553,20929,2010-08-23,Senate,"Assembly 3rd Reading AB1914 Davis By Liu",23,13,0,0,36
69553,21190,2010-08-25,Assembly,"AB 1914 DAVIS  Concurrence in Senate Amendments",51,27,0,0,78
69554,5441,2010-04-12,Assembly,"Be referred to Committee on Revenue and Taxation",10,0,1,0,11
69555,8523,2010-04-13,Assembly,"Do pass and be re-referred to the Committee on Business, Professions and Consumer Protection",13,5,1,0,19
69555,8524,2010-04-20,Assembly,"Do pass and be re-referred to the Committee on Appropriations",1,5,5,0,11
69557,1108,2010-04-20,Assembly,"Do pass and be re-referred to the Committee on Appropriations.",4,2,0,0,6
69557,1109,2010-05-12,Assembly,"Do pass.",11,5,1,0,17
69557,1110,2010-05-20,Assembly,"AB 1918 DAVIS  Assembly Third Reading",45,26,8,0,79
69557,8754,2010-06-15,Senate,"Do pass, but re-refer to the Committee on Veterans Affairs",7,2,2,0,11
69557,9403,2010-06-22,Senate,"Do pass as amended, and re-refer to the Committee on Appropriations",3,0,2,0,5
69557,20871,2010-08-23,Senate,"Assembly 3rd Reading AB1918 Davis By Cedillo",22,11,0,0,33
69557,21123,2010-08-25,Assembly,"AB 1918 DAVIS  Concurrence in Senate Amendments",51,27,0,0,78
69558,2555,2010-04-14,Assembly,"Do pass",6,2,1,0,9
69558,2556,2010-04-26,Assembly,"AB 1919 DAVIS  Assembly Third Reading",40,32,7,0,79
69558,2557,2010-06-01,Assembly,"AB 1919 DAVIS  Motion to Reconsider",45,28,6,0,79
69558,2558,2010-06-01,Assembly,"AB 1919 DAVIS  Assembly Third Reading",43,33,3,0,79
69558,9840,2010-06-30,Senate,"Do pass as amended",5,0,0,0,5
69559,5021,2010-04-13,Assembly,"Do pass as amended and be re-referred to the Committee on Appropriations",4,1,1,0,6
69560,3958,2010-05-04,Assembly,"Do pass",7,0,0,0,7
69560,3959,2010-05-10,Assembly,"AB 1921 DAVIS  Assembly Third Reading",69,1,9,0,79
69560,9010,2010-06-15,Senate,"Do pass and be placed on the Consent Calendar",5,0,0,0,5
69560,9550,2010-06-24,Senate,"Consent Calendar 2nd AB1921 Davis",31,0,8,0,39
69561,3252,2010-04-07,Assembly,"Do pass as amended and be re-referred to the Committee on Business, Professions and Consumer Protection",6,2,1,0,9
69561,3253,2010-04-20,Assembly,"Do pass and be re-referred to the Committee on Appropriations",7,3,1,0,11
69561,3254,2010-05-28,Assembly,"Do pass as amended",12,5,0,0,17
69561,3255,2010-06-02,Assembly,"AB 1922 DAVIS  Assembly Third Reading",48,26,5,0,79
69561,9286,2010-06-23,Senate,"Do pass as amended, and re-refer to the Committee on Appropriations",5,2,2,0,9
69561,19588,2010-08-02,Senate,"Placed on Appropriations Suspense file",10,0,0,0,10
69562,1653,2010-05-03,Assembly,"Do pass",9,2,4,0,15
69562,1654,2010-05-06,Assembly,"AB 1923 EVANS  Assembly Third Reading",46,25,8,0,79
69562,8938,2010-06-15,Senate,"Do pass",6,3,2,0,11
69562,21067,2010-08-20,Senate,"Assembly 3rd Reading AB1923 Evans Reconsider",32,0,0,0,32
69562,21955,2010-08-30,Senate,"Assembly 3rd Reading AB1923 Evans By Kehoe",21,15,0,0,36
69564,2571,2010-04-13,Assembly,"Do pass as amended and be re-referred to the Committee on Appropriations",7,0,0,0,7
69564,2572,2010-05-28,Assembly,"Do pass as amended",17,0,0,0,17
69564,2573,2010-06-02,Assembly,"AB 1925 SALAS  Assembly Third Reading",76,0,3,0,79
69564,9207,2010-06-22,Senate,"Do pass, but re-refer to the Committee on Public Safety",4,0,1,0,5
69564,10274,2010-06-29,Senate,"Do pass as amended, and re-refer to the Committee on Appropriations",7,0,0,0,7
69564,19922,2010-08-11,Senate,"Assembly 3rd Reading AB1925 Salas By Correa",34,0,0,0,34
69564,20310,2010-08-16,Assembly,"AB 1925 SALAS  Concurrence in Senate Amendments",75,0,0,0,75
69565,8685,2010-03-23,Assembly,"Do pass as amended and be re-referred to the Committee on Appropriations",10,0,0,0,10
69565,8686,2010-04-14,Assembly,"Do pass, to Consent Calendar",15,0,2,0,17
69565,8687,2010-04-22,Assembly,"AB 1926 EVANS  Consent Calendar Second Day  Regular Session",74,0,5,0,79
69565,10367,2010-06-29,Senate,"Do pass, but re-refer to the Committee on Appropriations Recommend Consent",4,0,1,0,5
69565,19500,2010-08-05,Senate,"Consent Calendar 2nd AB1926 Evans",33,0,0,0,33
69571,4674,2010-03-22,Assembly,"Be adopted, and re-refer to Committee on Appropriations with recommendation:  To Consent Calendar",13,0,1,0,14
69571,4675,2010-04-14,Assembly,"Be adopted, to Consent Calendar",15,0,2,0,17
69571,4676,2010-04-19,Assembly,"ACR 124 BASS  Consent Calendar Second Day  Regular Session",73,0,6,0,79
69571,8767,2010-06-15,Senate,"Do pass, but re-refer to the Committee on Appropriations",6,1,2,0,9
69571,20343,2010-08-12,Senate,"Assembly 3rd Reading ACR124 Bass By Price",34,0,0,0,34
69571,20480,2010-08-18,Assembly,"ACR 124 BASS  Concurrence in Senate Amendments",73,0,0,0,73
69572,1651,2010-05-04,Assembly,"Be adopted, to Consent Calendar",19,0,0,0,19
69572,1652,2010-05-10,Assembly,"ACR 125 VILLINES  Consent Calendar Second Day  Regular Session",71,0,8,0,79
69572,21316,2010-08-23,Senate,"Assembly 3rd Reading ACR125 Villines By Emmerson",32,0,0,0,32
69573,5082,2010-04-12,Assembly,"Be adopted, and re-refer to Committee on Appropriations with recommendation:  To Consent Calendar",13,0,1,0,14
69573,5083,2010-04-21,Assembly,"Be adopted, to Consent Calendar",16,0,1,0,17
69573,5084,2010-04-26,Assembly,"ACR 126 DAVIS  Consent Calendar Second Day  Regular Session",71,0,8,0,79
69573,19812,2010-08-10,Senate,"Be adopted, but re-refer to the Committee on Appropriations 	Recommend Consent",9,0,0,0,9
69573,20662,2010-08-20,Senate,"Consent Calendar 2nd ACR126 Davis",32,0,0,0,32
69573,21045,2010-08-24,Assembly,"ACR 126 DAVIS  Concurrence in Senate Amendments",75,0,0,0,75
69574,4319,2010-03-22,Assembly,"Be adopted, and re-refer to Committee on Appropriations with recommendation:  To Consent Calendar",13,0,1,0,14
69574,4320,2010-04-14,Assembly,"Be adopted, to Consent Calendar",15,0,2,0,17
69574,4321,2010-04-19,Assembly,"ACR 127 ADAMS  Consent Calendar Second Day  Regular Session",73,0,6,0,79
69574,9148,2010-06-15,Senate,"Be adopted as amended, and re-refer to the Committee on Appropriations",6,1,2,0,9
69574,19971,2010-08-12,Senate,"Assembly 3rd Reading ACR127 Adams By Runner",35,0,0,0,35
69574,20329,2010-08-16,Assembly,"ACR 127 ADAMS  Concurrence in Senate Amendments",74,0,0,0,74
69575,595,2010-03-23,Assembly,"Be adopted as amended.",7,1,2,0,10
69575,596,2010-04-08,Assembly,"AJR 32 MONNING  Assembly Third Reading",54,5,20,0,79
69575,5686,2010-06-10,Senate,"Be adopted",3,2,0,0,5
69575,9602,2010-06-28,Senate,"Assembly 3rd Reading AJR32 Monning By Corbett",22,11,6,0,39
69575,10081,2010-07-01,Assembly,"AJR 32 MONNING  Concurrence in Senate Amendments",51,15,13,0,79
69576,3420,2010-03-23,Senate,"Do pass, but re-refer to the Committee on Appropriations Recommend Consent",9,0,2,0,11
69577,623,2010-04-21,Senate,"Do pass and be placed on the Consent Calendar.",8,0,1,0,9
69577,624,2010-04-29,Senate,"Consent Calendar 2nd SB1045 Alquist",33,0,5,0,38
69578,4797,2010-03-24,Senate,"Do pass, but re-refer to the Committee on Judiciary Recommend Consent",7,0,2,0,9
69578,4798,2010-04-20,Senate,"Do pass, but re-refer to the Committee on Appropriations",4,0,1,0,5
69578,4799,2010-05-03,Senate,"Do pass",10,0,1,0,11
69578,4800,2010-05-10,Senate,"Special Consent #23 SB1046 Cogdill",30,0,8,0,38
69578,9444,2010-06-22,Assembly,"Do pass and be re-referred to the Committee on Judiciary",9,0,0,0,9
69578,9684,2010-06-29,Assembly,"Do pass and be re-referred to the Committee on Appropriations",10,0,0,0,10
69578,19616,2010-08-04,Assembly,"Do pass, to Consent Calendar",17,0,0,0,17
69578,19942,2010-08-12,Assembly,"SB 1046 Cogdill  Consent Calendar Second Day  Regular Session",78,0,0,0,78
69579,1372,2010-05-04,Senate,"Do pass as amended. To Consent Calendar",4,0,1,0,5
69579,1373,2010-05-17,Senate,"Consent Calendar 2nd SB1047 Correa",33,0,5,0,38
69579,9852,2010-06-30,Assembly,"Do pass, to Consent Calendar",8,0,1,0,9
69579,19411,2010-08-05,Assembly,"SB 1047 Correa  Consent Calendar Second Day  Regular Session",71,0,0,0,71
69581,1978,2010-04-20,Senate,"Do pass, but re-refer to the Committee on Appropriations",4,3,0,0,7
69581,1979,2010-04-20,Senate,"Do pass, but re-refer to the Committee on Appropriations",4,3,0,0,7
69581,1980,2010-05-24,Senate,"Senate 3rd Reading SB1049 Harman",28,3,7,0,38
69581,9448,2010-06-22,Assembly,"Do pass and be re-referred to the Committee on Appropriations",6,0,1,0,7
69581,10217,2010-06-30,Assembly,"Do pass, to Consent Calendar",17,0,0,0,17
69581,19906,2010-08-05,Assembly,"SB 1049 Harman  Consent Calendar Second Day  Regular Session",71,0,0,0,71
69582,3776,2010-04-05,Senate,"Do pass as amended, and re-refer to the Committee on Appropriations",7,0,2,0,9
69582,3777,2010-05-03,Senate,"Senate 3rd Reading SB1050 Yee",30,0,8,0,38
69582,9001,2010-06-15,Assembly,"Do pass and be re-referred to the Committee on Appropriations",11,0,0,0,11
69582,9943,2010-06-30,Assembly,"Do pass",17,0,0,0,17
69582,19381,2010-08-02,Assembly,"SB 1050 Yee  Senate Third Reading  By HAYASHI",76,0,0,0,76
69583,4257,2010-04-14,Senate,"Do pass, but re-refer to the Committee on Health",5,1,3,0,9
69583,4258,2010-04-21,Senate,"Do pass as amended, and re-refer to the Committee on Rules",1,1,7,0,9
69583,4259,2010-04-21,Senate,"Set, first hearing.  Failed passage in Committee.  Reconsideration granted",5,0,4,0,9
69583,4260,2010-05-05,Senate,"Do pass, but re-refer to the Committee on Rules",6,3,0,0,9
69583,4261,2010-05-24,Senate,"Placed on Appropriations Suspense file",10,0,1,0,11
69584,4220,2010-04-05,Senate,"Do pass as amended, and re-refer to the Committee on Appropriations",4,2,1,0,7
69584,4221,2010-04-26,Senate,"Placed on Appropriations Suspense file",9,0,2,0,11
69587,458,2010-04-13,Senate,"Do pass as amended, and re-refer to the Committee on Appropriations.",7,0,0,0,7
69587,459,2010-05-10,Senate,"Senate 3rd Reading SB1055 Ashburn",31,0,7,0,38
69587,9681,2010-06-29,Assembly,"Do pass as amended and be re-referred to the Committee on Appropriations",7,0,0,0,7
69587,19343,2010-08-04,Assembly,"Do pass, to Consent Calendar",17,0,0,0,17
69587,19903,2010-08-12,Assembly,"SB 1055 Ashburn  Consent Calendar Second Day  Regular Session",78,0,0,0,78
69587,20550,2010-08-19,Senate,"Unfinished Business SB1055 Ashburn",35,0,0,0,35
69589,442,2010-04-13,Senate,"Do pass as amended, and re-refer to the Committee on Rules.",4,0,1,0,5
69589,443,2010-06-03,Senate,"Special Consent #27 SB1057 Denham",36,0,2,0,38
69589,9179,2010-06-22,Assembly,"Do pass and be re-referred to the Committee on Appropriations",11,0,0,0,11
69589,19636,2010-08-04,Assembly,"Do pass, to Consent Calendar",17,0,0,0,17
69589,19962,2010-08-12,Assembly,"SB 1057 Denham  Consent Calendar Second Day  Regular Session",78,0,0,0,78
69590,4735,2010-03-23,Senate,"Do pass, but re-refer to the Committee on Appropriations Recommend Consent",9,0,0,0,9
69590,4736,2010-04-22,Senate,"Consent Calendar 2nd SB1058 Harman",33,0,6,0,39
69590,8857,2010-06-15,Assembly,"Do pass as amended and re-refer to Committee on Appropriations with recommendation:  To Consent Calendar",11,0,1,0,12
69590,19507,2010-08-04,Assembly,"Do pass as amended",17,0,0,0,17
69590,20577,2010-08-19,Assembly,"SB 1058 Harman  Senate Third Reading  By CHESBRO",79,0,0,0,79
69590,21370,2010-08-26,Senate,"Special Consent #32 SB1058 Harman",34,0,0,0,34
69591,599,2010-04-21,Senate,"Do pass, but re-refer to the Committee on Appropriations.",8,0,1,0,9
69591,600,2010-05-24,Senate,"Do pass as amended.",10,0,1,0,11
69591,601,2010-06-01,Senate,"Senate 3rd Reading SB1059 Liu",33,0,5,0,38
69591,10345,2010-06-30,Assembly,"Do pass as amended and be re-referred to the Committee on Appropriations",7,2,0,0,9
69591,19387,2010-08-04,Assembly,"Do pass",14,3,0,0,17
69591,20429,2010-08-16,Assembly,"SB 1059 Liu  Senate Third Reading  By TORLAKSON",64,8,0,0,72
69591,20636,2010-08-19,Senate,"Unfinished Business SB1059 Liu",34,0,0,0,34
69592,6103,2010-04-06,Senate,"Do pass, but re-refer to the Committee on Appropriations",2,4,1,0,7
69593,64,2010-03-23,Senate,"Do pass as amended, and re-refer to the Committee on Appropriations.",6,2,1,0,9
69593,65,2010-04-26,Senate,"Placed on Appropriations Suspense file.",9,0,2,0,11
69593,66,2010-05-27,Senate,"Do pass.",7,3,1,0,11
69593,67,2010-06-01,Senate,"Senate 3rd Reading SB1061 Hancock",23,11,4,0,38
69593,9187,2010-06-21,Assembly,"Do pass and be re-referred to the Committee on Appropriations",8,4,2,0,14
69594,1631,2010-04-20,Senate,"Do pass as amended, and re-refer to the Committee on Appropriations",7,0,0,0,7
69594,1632,2010-05-24,Senate,"Placed on Appropriations Suspense file",10,0,1,0,11
69594,1633,2010-05-27,Senate,"Do pass",10,0,1,0,11
69594,1634,2010-06-02,Senate,"Special Consent #26 SB1062 Strickland",35,0,3,0,38
69594,9665,2010-06-29,Assembly,"Do pass and re-refer to Committee on Appropriations with recommendation:  To Consent Calendar",7,0,0,0,7
69594,19760,2010-08-04,Assembly,"Do pass, to Consent Calendar",17,0,0,0,17
69594,19912,2010-08-12,Assembly,"SB 1062 Strickland  Consent Calendar Second Day  Regular Session",78,0,0,0,78
69595,3664,2010-04-14,Senate,"Do pass as amended, and re-refer to the Committee on Appropriations",9,0,0,0,9
69595,3665,2010-05-03,Senate,"Placed on Appropriations Suspense file",10,0,1,0,11
69596,1083,2010-04-14,Senate,"Do pass as amended, and re-refer to the Committee on Appropriations.",6,0,3,0,9
69596,1084,2010-05-10,Senate,"Placed on Appropriations Suspense file.",9,0,2,0,11
69596,1085,2010-05-27,Senate,"Do pass.",10,0,1,0,11
69596,1086,2010-06-03,Senate,"Senate 3rd Reading SB1064 Alquist",33,0,5,0,38
69596,10130,2010-06-29,Assembly,"Do pass and re-refer to Committee on Appropriations with recommendation:  To Consent Calendar",19,0,0,0,19
69596,20258,2010-08-12,Assembly,"Do pass",17,0,0,0,17
69596,20352,2010-08-17,Assembly,"SB 1064 Alquist  Senate Third Reading  By PORTANTINO",76,0,0,0,76
69596,21505,2010-08-25,Senate,"Unfinished Business SB1064 Alquist",35,0,0,0,35
69599,3430,2010-02-24,Senate,"Do pass, but re-refer to the Committee on Appropriations",2,5,2,0,9
69600,3439,2010-02-24,Senate,"Do pass, but re-refer to the Committee on Appropriations",1,4,1,0,6
69603,3446,2010-02-25,Senate,"Do pass",1,3,1,0,5
69604,3449,2010-02-24,Senate,"Do pass, but re-refer to the Committee on Appropriations",1,4,1,0,6
70210,499,2010-04-14,Assembly,"Do pass as amended and be re-referred to the Committee on Judiciary.",9,0,0,0,9
70210,500,2010-04-27,Assembly,"Do pass.",9,0,1,0,10
70210,501,2010-04-29,Assembly,"AB 1927 KNIGHT  Assembly Third Reading",73,0,6,0,79
70210,8792,2010-06-15,Senate,"Do pass, but re-refer to the Committee on Judiciary",8,0,1,0,9
70210,9792,2010-06-29,Senate,"Do pass",4,0,1,0,5
70210,20069,2010-08-11,Senate,"Assembly 3rd Reading AB1927 Knight By Harman",34,0,0,0,34
70210,20314,2010-08-16,Assembly,"AB 1927 KNIGHT  Concurrence in Senate Amendments",75,0,0,0,75
70211,1975,2010-04-05,Assembly,"Do pass as amended and re-refer to Committee on Appropriations with recommendation:  To Consent Calendar",14,0,0,0,14
70211,1976,2010-04-21,Assembly,"Do pass, to Consent Calendar",17,0,0,0,17
70211,1977,2010-04-29,Assembly,"AB 1928 TORLAKSON  Consent Calendar Second Day  Regular Session",74,0,5,0,79
70211,9582,2010-06-22,Senate,"Do pass, but re-refer to the Committee on Appropriations",7,0,0,0,7
70211,20528,2010-08-18,Senate,"Assembly 3rd Reading AB1928 Torlakson By Emmerson",34,0,0,0,34
70212,5136,2010-03-23,Assembly,"Do pass and be re-referred to the Committee on Judiciary to Consent Calendar",12,0,0,0,12
70212,5137,2010-04-06,Assembly,"Do pass and re-refer to Committee on Appropriations with recommendation:  To Consent Calendar",9,0,1,0,10
70212,5138,2010-04-14,Assembly,"Do pass, to Consent Calendar",15,0,2,0,17
70212,5139,2010-04-22,Assembly,"AB 1929 HALL  Consent Calendar Second Day  Regular Session",74,0,5,0,79
70212,10107,2010-06-29,Senate,"Do pass, but re-refer to the Committee on Appropriations Recommend Consent",9,0,0,0,9
70212,19562,2010-08-05,Senate,"Consent Calendar 2nd AB1929 Hall",33,0,0,0,33
70213,2608,2010-04-27,Assembly,"Do pass as amended",9,0,0,0,9
70213,2609,2010-05-28,Assembly,"Do pass",17,0,0,0,17
70213,2610,2010-06-02,Assembly,"AB 1930 DE LA TORRE  Assembly Third Reading",76,0,3,0,79
70213,9693,2010-06-28,Senate,"Do pass as amended, and re-refer to the Committee on Appropriations",7,0,0,0,7
70213,19139,2010-08-02,Senate,"Do pass",10,0,0,0,10
70213,20014,2010-08-12,Senate,"Assembly 3rd Reading AB1930 De La Torre By Lowenthal",32,1,0,0,33
70213,20365,2010-08-17,Assembly,"AB 1930 DE LA TORRE  Concurrence in Senate Amendments",77,0,0,0,77
70214,2477,2010-04-13,Assembly,"Do pass and re-refer to Committee on Appropriations with recommendation:  To Consent Calendar",19,0,0,0,19
70214,2478,2010-05-28,Assembly,"Do pass as amended",17,0,0,0,17
70214,2479,2010-06-02,Assembly,"AB 1931 TORRICO  Assembly Third Reading",75,1,3,0,79
70214,10347,2010-06-30,Senate,"Do pass, but re-refer to the Committee on Appropriations",8,0,1,0,9
70214,19296,2010-08-02,Senate,"Placed on Appropriations Suspense file",10,0,0,0,10
70214,20265,2010-08-12,Senate,"Do pass as amended",11,0,0,0,11
70214,20650,2010-08-20,Senate,"Assembly 3rd Reading AB1931 Torrico By Corbett",32,0,0,0,32
70214,20885,2010-08-23,Assembly,"AB 1931 TORRICO  Concurrence in Senate Amendments",76,0,0,0,76
70215,3262,2010-04-20,Assembly,"Do pass and be re-referred to the Committee on Appropriations",15,0,4,0,19
70215,3263,2010-05-19,Assembly,"Do pass",12,0,5,0,17
70215,3264,2010-06-01,Assembly,"AB 1932 HERNANDEZ  Assembly Third Reading",69,5,5,0,79
70215,9468,2010-06-23,Senate,"Do pass, but re-refer to the Committee on Appropriations",6,0,3,0,9
70215,10643,2010-07-15,Senate,"Placed on Appropriations Suspense file",8,0,2,0,10
70216,3521,2010-03-24,Assembly,"Do pass as amended and be re-referred to the Committee on Human Services",9,0,0,0,9
70216,3522,2010-04-13,Assembly,"Do pass and be re-referred to the Committee on Appropriations",6,0,0,0,6
70216,3523,2010-04-28,Assembly,"Do pass, to Consent Calendar",15,0,2,0,17
70216,3524,2010-05-06,Assembly,"AB 1933 BROWNLEY  Consent Calendar Second Day  Regular Session",74,0,5,0,79
70216,9484,2010-06-23,Senate,"Do pass, but re-refer to the Committee on Appropriations",7,0,2,0,9
70216,10507,2010-07-15,Senate,"Placed on Appropriations Suspense file",8,0,2,0,10
70216,20281,2010-08-12,Senate,"Do pass as amended",11,0,0,0,11
70216,21036,2010-08-24,Senate,"Assembly 3rd Reading AB1933 Brownley By Liu",35,0,0,0,35
70216,21174,2010-08-25,Assembly,"AB 1933 BROWNLEY  Concurrence in Senate Amendments",77,0,0,0,77
70217,2273,2010-04-20,Assembly,"Do pass as amended and be re-referred to the Committee on Appropriations",5,2,0,0,7
70217,2274,2010-05-12,Assembly,"Do pass",11,5,1,0,17
70217,2275,2010-06-01,Assembly,"AB 1934 SALDANA  Assembly Third Reading",46,30,3,0,79
70217,9229,2010-06-22,Senate,"Do pass, but re-refer to the Committee on Appropriations",4,3,0,0,7
70217,21947,2010-08-30,Senate,"Assembly 3rd Reading AB1934 Saldana By DeSaulnier",20,16,0,0,36
70217,21948,2010-08-30,Senate,"Assembly 3rd Reading AB1934 Saldana Reconsider",37,0,0,0,37
70217,21949,2010-08-31,Senate,"Assembly 3rd Reading AB1934 Saldana By DeSaulnier",21,16,0,0,37
70217,21950,2010-08-31,Assembly,"AB 1934 SALDANA  Concurrence in Senate Amendments Motion to 	Re-refer to Committee  By JEFFRIES",29,39,0,0,68
70217,21951,2010-08-31,Assembly,"AB 1934 SALDANA  Concurrence in Senate Amendments Motion to 	Suspend the Rules  By CALDERON",53,11,0,0,64
70218,4704,2010-05-10,Assembly,"Do pass and be re-referred to the Committee on Appropriations",6,3,0,0,9
70219,1107,2010-05-10,Assembly,"Do pass and be re-referred to the Committee on Appropriations.",6,3,0,0,9
70220,5350,2010-05-04,Assembly,"Do pass",11,0,0,0,11
70220,5351,2010-05-06,Assembly,"AB 1937 FLETCHER  Assembly Third Reading",72,1,6,0,79
70220,8870,2010-06-14,Senate,"Do pass, but re-refer to the Committee on Education",7,0,2,0,9
70220,10251,2010-06-30,Senate,"Do pass and be placed on the Consent Calendar",8,0,1,0,9
70220,19545,2010-08-02,Senate,"Consent Calendar 2nd AB1937 Fletcher",33,0,0,0,33
70220,19805,2010-08-09,Assembly,"AB 1937 FLETCHER  Concurrence- Urgency Added",77,0,0,0,77
70225,3696,2010-04-19,Assembly,"Do pass as amended",13,0,1,0,14
70225,3697,2010-05-17,Assembly,"AB 1942 FLETCHER  Assembly Third Reading",69,1,9,0,79
70225,9948,2010-06-29,Senate,"Do pass as amended",8,0,1,0,9
70225,21359,2010-08-26,Senate,"Assembly 3rd Reading AB1942 Fletcher By Huff",29,4,0,0,33
70225,21679,2010-08-30,Assembly,"AB 1942 Fletcher  Concurrence in Senate Amendments",71,5,0,0,76
70227,1537,2010-04-05,Assembly,"Do pass and be re-referred to the Committee on Veterans Affairs to Consent Calendar",14,0,0,0,14
70227,1538,2010-04-13,Assembly,"Do pass and be re-referred to the Committee on Appropriations",9,0,0,0,9
70227,1539,2010-05-12,Assembly,"Do pass, to Consent Calendar",16,0,1,0,17
70227,1540,2010-05-20,Assembly,"AB 1944 FLETCHER  Consent Calendar Second Day  Regular Session",72,0,7,0,79
70227,9467,2010-06-22,Senate,"Do pass, but re-refer to the Committee on Appropriations",4,0,1,0,5
70227,9837,2010-06-29,Senate,"Do pass as amended, but re-refer to the Committee on Appropriations Recommend Consent",8,0,1,0,9
70227,19533,2010-08-05,Senate,"Consent Calendar 2nd AB1944 Fletcher",33,0,0,0,33
70227,20197,2010-08-12,Assembly,"AB 1944 FLETCHER  Concurrence in Senate Amendments",77,0,0,0,77
70230,3506,2010-04-05,Assembly,"Do pass",8,6,1,0,15
70230,3507,2010-06-02,Assembly,"AB 1947 FONG  Assembly Third Reading",50,24,5,0,79
70230,9764,2010-06-29,Senate,"Do pass",6,2,3,0,11
70230,21410,2010-08-23,Senate,"Assembly 3rd Reading AB1947 Fong By Leno",24,12,0,0,36
70230,21411,2010-08-24,Assembly,"AB 1947 FONG  Concurrence in Senate Amendments",51,23,0,0,74
70232,8432,2010-04-13,Assembly,"Do pass and be re-referred to the Committee on Appropriations",4,5,2,0,11
70232,8433,2010-04-13,Assembly,"Set first hearing.  Failed passage.  Reconsideration granted",11,0,0,0,11
70233,2950,2010-04-21,Assembly,"Do pass as amended and be re-referred to the Committee on Appropriations",5,4,0,0,9
70233,2951,2010-05-28,Assembly,"Do pass",12,5,0,0,17
70233,2952,2010-06-03,Assembly,"AB 1950 BROWNLEY  Assembly Third Reading",49,27,3,0,79
70235,2371,2010-04-12,Assembly,"Do pass and be re-referred to the Committee on Appropriations",13,0,1,0,14
70235,2372,2010-04-21,Assembly,"Do pass, to Consent Calendar",17,0,0,0,17
70235,2373,2010-04-29,Assembly,"AB 1952 NIELLO  Consent Calendar Second Day  Regular Session",74,0,5,0,79
70235,10027,2010-06-29,Senate,"Do pass as amended, and re-refer to the Committee on Appropriations",9,0,0,0,9
70235,19659,2010-08-09,Senate,"Assembly 3rd Reading AB1952 Niello By Wolk",31,3,0,0,34
70235,19861,2010-08-12,Assembly,"AB 1952 NIELLO  Concurrence in Senate Amendments",78,0,0,0,78
70237,4186,2010-04-05,Assembly,"Do pass and be re-referred to the Committee on Natural Resources",14,0,1,0,15
70237,4187,2010-04-19,Assembly,"Do pass and be re-referred to the Committee on Appropriations",9,0,0,0,9
70237,4188,2010-05-05,Assembly,"Do pass, to Consent Calendar",17,0,0,0,17
70237,4189,2010-05-13,Assembly,"AB 1954 SKINNER  Consent Calendar Second Day  Regular Session",76,0,3,0,79
70237,10322,2010-06-29,Senate,"Do pass as amended, and re-refer to the Committee on Appropriations",9,0,2,0,11
70237,19453,2010-08-02,Senate,"Do pass as amended",9,0,0,0,9
70237,20981,2010-08-24,Senate,"Assembly 3rd Reading AB1954 Skinner By Strickland",35,0,0,0,35
70237,21549,2010-08-27,Assembly,"AB 1954 SKINNER  Concurrence in Senate Amendments",75,0,0,0,75
70238,15,2010-04-21,Assembly,"Do pass.",8,0,1,0,9
70238,16,2010-04-29,Assembly,"AB 1955 DE LA TORRE  Assembly Third Reading",72,0,7,0,79
70238,9767,2010-06-30,Senate,"Do pass",1,3,1,0,5
70238,19877,2010-08-12,Senate,"Reconsideration granted",3,0,0,0,3
70238,19878,2010-08-12,Senate,"Do pass, but re-refer to the Committee on Appropriations",3,1,0,0,4
70238,21554,2010-08-27,Senate,"Motion to place on APPROPRIATIONS suspense file refused",4,7,0,0,11
70238,21555,2010-08-27,Senate,"Do pass",7,4,0,0,11
70238,21777,2010-08-31,Senate,"W/O REF. TO FILE AB1955 De La Torre Reconsider",37,0,0,0,37
70238,22029,2010-08-31,Senate,"W/O REF. TO FILE AB1955 De La Torre Urgency Clause",15,19,0,0,34
70239,3238,2010-03-23,Assembly,"Do pass as amended and be re-referred to the Committee on Appropriations",12,0,0,0,12
70239,3239,2010-04-14,Assembly,"Do pass",14,0,3,0,17
70239,3240,2010-04-22,Assembly,"AB 1956 MONNING  Assembly Third Reading",72,0,7,0,79
70239,6190,2010-06-09,Senate,"Do pass, but re-refer to the Committee on Appropriations",7,0,2,0,9
70239,19956,2010-08-12,Senate,"Assembly 3rd Reading AB1956 Monning By Wolk",22,11,0,0,33
70239,20368,2010-08-17,Assembly,"AB 1956 MONNING  Concurrence in Senate Amendments",53,22,0,0,75
70239,20962,2010-08-24,Senate,"Assembly 3rd Reading AB1956 Monning By Wolk",22,9,0,0,31
70239,21257,2010-08-25,Assembly,"AB 1956 MONNING  Concurrence in Senate Amendments",76,0,0,0,76
70240,5074,2010-04-06,Assembly,"Do pass and be re-referred to the Committee on Appropriations",6,2,3,0,11
70243,3125,2010-03-24,Assembly,"Do pass and be re-referred to the Committee on Appropriations",8,0,0,0,8
70243,3126,2010-05-28,Assembly,"Do pass as amended",17,0,0,0,17
70243,3127,2010-06-03,Assembly,"AB 1960 MA  Assembly Third Reading",76,0,3,0,79
70244,730,2010-03-23,Assembly,"Do pass and re-refer to Committee on Appropriations with recommendation:  To Consent Calendar.",7,0,0,0,7
70245,3737,2010-05-05,Assembly,"Do pass, to Consent Calendar",9,0,0,0,9
70245,3738,2010-05-13,Assembly,"AB 1962 CHESBRO  Consent Calendar Second Day  Regular Session",76,0,3,0,79
70245,9025,2010-06-16,Senate,"Do pass and be placed on the Consent Calendar",4,0,1,0,5
70245,9536,2010-06-24,Senate,"Consent Calendar 2nd AB1962 Chesbro",31,0,8,0,39
70245,10353,2010-07-01,Assembly,"AB 1962 CHESBRO  Concurrence in Senate Amendments",77,0,2,0,79
70246,3326,2010-04-06,Assembly,"Do pass and be re-referred to the Committee on Health",5,1,3,0,9
70246,3327,2010-04-20,Assembly,"Do pass as amended and be re-referred to the Committee on Appropriations",12,5,2,0,19
70246,3328,2010-05-12,Assembly,"Do pass",11,5,1,0,17
70246,3329,2010-06-01,Assembly,"AB 1963 NAVA  Assembly Third Reading",50,27,2,0,79
70246,9797,2010-06-28,Senate,"Do pass, but re-refer to the Committee on Rules",5,2,0,0,7
70246,10127,2010-06-30,Senate,"Do pass as amended, and re-refer to the Committee on Appropriations",6,2,1,0,9
70246,19463,2010-08-02,Senate,"Do pass as amended",6,3,0,0,9
70246,21312,2010-08-23,Senate,"Assembly 3rd Reading AB1963 Nava By Yee",22,14,0,0,36
70246,21313,2010-08-24,Assembly,"AB 1963 NAVA  Concurrence in Senate Amendments",51,26,0,0,77
70247,246,2010-04-14,Assembly,"Do pass and be re-referred to the Committee on Appropriations.",8,0,1,0,9
70247,247,2010-05-19,Assembly,"Do pass.",16,0,1,0,17
70247,248,2010-05-24,Assembly,"AB 1964 TORRES  Assembly Third Reading",68,1,10,0,79
70247,9777,2010-06-29,Senate,"Do pass, but re-refer to the Committee on Appropriations",9,0,0,0,9
70247,19144,2010-08-02,Senate,"Do pass",8,0,0,0,8
70248,3643,2010-04-21,Assembly,"Do pass and be re-referred to the Committee on Local Government to Consent Calendar",7,0,1,0,8
70248,3644,2010-05-05,Assembly,"Do pass, to Consent Calendar",9,0,0,0,9
70248,3645,2010-05-13,Assembly,"AB 1965 YAMADA  Consent Calendar Second Day  Regular Session",76,0,3,0,79
70248,8995,2010-06-16,Senate,"Do pass and be placed on the Consent Calendar",4,0,1,0,5
70248,9542,2010-06-24,Senate,"Consent Calendar 2nd AB1965 Yamada",31,0,8,0,39
70249,922,2010-04-06,Assembly,"Do pass and be re-referred to the Committee on Appropriations.",19,0,0,0,19
70250,5472,2010-04-21,Assembly,"Do pass as amended and be re-referred to the Committee on Appropriations",8,1,0,0,9
70251,2586,2010-04-20,Assembly,"Do pass and be re-referred to the Committee on Appropriations",4,2,1,0,7
70251,2587,2010-05-05,Assembly,"Do pass",6,5,6,0,17
70251,2588,2010-05-05,Assembly,"Set first hearing.  Failed passage.  Reconsideration granted",17,0,0,0,17
70251,2589,2010-05-19,Assembly,"Do pass",6,5,6,0,17
70252,5076,2010-04-07,Assembly,"Do pass",9,0,0,0,9
70252,5077,2010-04-15,Assembly,"AB 1969 JEFFRIES  Assembly Third Reading",69,0,10,0,79
70252,5078,2010-06-09,Senate,"Do pass and be placed on the Consent Calendar",3,0,2,0,5
70252,9047,2010-06-17,Senate,"Consent Calendar 2nd AB1969 Jeffries",33,0,6,0,39
70253,5135,2010-04-13,Assembly,"Do pass and be re-referred to the Committee on Appropriations",4,1,1,0,6
70254,173,2010-04-06,Assembly,"Do pass and be re-referred to the Committee on Judiciary.",9,0,0,0,9
70254,174,2010-04-13,Assembly,"Do pass and re-refer to Committee on Appropriations with recommendation:  To Consent Calendar.",10,0,0,0,10
70254,175,2010-04-21,Assembly,"Do pass, to Consent Calendar.",17,0,0,0,17
70254,176,2010-04-29,Assembly,"AB 1971 LOWENTHAL  Consent Calendar Second Day  Regular Session",74,0,5,0,79
70254,8542,2010-06-10,Senate,"Do pass as amended, but re-refer to the Committee on Appropriations Recommend Consent",5,0,0,0,5
70254,19170,2010-08-02,Senate,"Consent Calendar 2nd AB1971 Bonnie Lowenthal",33,0,0,0,33
70254,19831,2010-08-09,Assembly,"AB 1971 LOWENTHAL  Concurrence in Senate Amendments",78,0,0,0,78
70256,1745,2010-05-10,Assembly,"Do pass as amended and be re-referred to the Committee on Appropriations",9,0,0,0,9
70256,1746,2010-05-28,Assembly,"Do pass as amended",17,0,0,0,17
70256,1747,2010-06-02,Assembly,"AB 1973 SWANSON  Assembly Third Reading",70,4,5,0,79
70256,10061,2010-07-01,Senate,"Do pass, but re-refer to the Committee on Appropriations",5,0,0,0,5
70256,19342,2010-08-02,Senate,"Placed on Appropriations Suspense file",10,0,0,0,10
70258,1984,2010-04-13,Assembly,"Do pass",13,0,0,0,13
70258,1985,2010-05-28,Assembly,"Do pass as amended",12,2,3,0,17
70258,1986,2010-06-03,Assembly,"AB 1975 FONG  Assembly Third Reading",59,13,7,0,79
70258,9671,2010-06-29,Senate,"Do pass, but re-refer to the Committee on Rules",6,3,0,0,9
70258,19875,2010-08-09,Senate,"Placed on Appropriations Suspense file",10,0,0,0,10
70259,8485,2010-04-13,Assembly,"Do pass and be re-referred to the Committee on Judiciary",6,8,5,0,19
70259,8486,2010-04-13,Assembly,"Set first hearing.  Failed passage.  Reconsideration granted",19,0,0,0,19
70260,339,2010-04-21,Assembly,"Do pass and be re-referred to the Committee on Appropriations.",2,4,1,0,7
70261,2758,2010-04-13,Assembly,"Do pass and be re-referred to the Committee on Appropriations",3,6,0,0,9
70263,2013,2010-05-04,Assembly,"Do pass",10,0,1,0,11
70263,2014,2010-05-06,Assembly,"AB 1980 HAYASHI  Assembly Third Reading",73,0,6,0,79
70263,9166,2010-06-21,Senate,"Do pass as amended, and re-refer to the Committee on Appropriations",6,0,3,0,9
70263,19864,2010-08-12,Senate,"Assembly 3rd Reading AB1980 Hayashi By Negrete McLeod",35,0,0,0,35
70263,20968,2010-08-24,Assembly,"Senate amendments be concurred in",9,0,0,0,9
70263,21140,2010-08-25,Assembly,"AB 1980 HAYASHI  Concurrence in Senate Amendments",78,0,0,0,78
70264,1800,2010-04-19,Assembly,"Do pass as amended and be re-referred to the Committee on Appropriations",9,0,0,0,9
70264,1801,2010-05-28,Assembly,"Do pass as amended",12,5,0,0,17
70264,1802,2010-06-02,Assembly,"AB 1981 HILL  Assembly Third Reading",63,9,7,0,79
70265,1363,2010-05-05,Assembly,"Do pass as amended.",5,4,0,0,9
70265,1364,2010-05-20,Assembly,"AB 1982 AMMIANO  Assembly Third Reading  Amend By AMMIANO  Set #1",45,26,8,0,79
70265,1365,2010-06-01,Assembly,"AB 1982 AMMIANO  Assembly Third Reading",48,28,3,0,79
70265,10131,2010-06-30,Senate,"Do pass",3,4,2,0,9
70266,2186,2010-04-19,Assembly,"Do pass and be re-referred to the Committee on Appropriations",9,0,0,0,9
70266,2187,2010-04-28,Assembly,"Do pass as amended",14,0,3,0,17
70266,2188,2010-05-06,Assembly,"AB 1983 TORRICO  Assembly Third Reading",71,1,7,0,79
70266,9306,2010-06-23,Senate,"Do pass, but re-refer to the Committee on Appropriations",3,0,2,0,5
70266,21917,2010-08-30,Senate,"Assembly 3rd Reading AB1983 Torrico By Cedillo",31,0,0,0,31
70268,3206,2010-04-13,Assembly,"Do pass and be re-referred to the Committee on Appropriations",15,2,2,0,19
70268,3207,2010-05-28,Assembly,"Do pass",12,5,0,0,17
70268,3208,2010-06-01,Assembly,"AB 1985 GALGIANI  Assembly Third Reading",52,22,5,0,79
70268,9763,2010-06-29,Senate,"Do pass as amended, and re-refer to the Committee on Appropriations",5,0,2,0,7
70268,19470,2010-08-02,Senate,"Do pass",10,0,0,0,10
70268,20598,2010-08-19,Senate,"Assembly 3rd Reading AB1985 Galgiani By Leno",34,0,0,0,34
70268,20936,2010-08-23,Assembly,"AB 1985 GALGIANI  Concurrence in Senate Amendments",71,2,0,0,73
70269,5394,2010-03-23,Assembly,"Do pass, to Consent Calendar",10,0,0,0,10
70269,5395,2010-04-05,Assembly,"AB 1986 SILVA  Consent Calendar Second Day  Regular Session",76,0,3,0,79
70269,8924,2010-06-10,Senate,"Do pass as amended. To Consent Calendar",5,0,0,0,5
70269,9504,2010-06-24,Senate,"Consent Calendar 2nd AB1986 Silva",31,0,8,0,39
70269,9613,2010-06-28,Assembly,"AB 1986 SILVA  Concurrence in Senate Amendments",78,0,1,0,79
70270,91,2010-04-21,Assembly,"Do pass and be re-referred to the Committee on Appropriations.",6,0,0,0,6
70270,92,2010-05-12,Assembly,"Do pass.",15,0,2,0,17
70270,93,2010-06-03,Assembly,"AB 1987 MA  Assembly Third Reading",75,0,4,0,79
70270,9257,2010-06-23,Senate,"Do pass, but re-refer to the Committee on Appropriations",5,0,1,0,6
70270,19135,2010-08-02,Senate,"Placed on Appropriations Suspense file",10,0,0,0,10
70270,20008,2010-08-12,Senate,"Do pass as amended",11,0,0,0,11
70270,21655,2010-08-30,Senate,"W/O REF. TO FILE AB1987 Ma",28,1,0,0,29
70270,21783,2010-08-31,Assembly,"AB 1987 Ma  Concurrence in Senate Amendments",77,0,0,0,77
70271,2782,2010-03-24,Assembly,"Do pass as amended and re-refer to Committee on Appropriations with recommendation:  To Consent Calendar",9,0,0,0,9
70271,2783,2010-05-28,Assembly,"Do pass as amended",17,0,0,0,17
70271,2784,2010-06-02,Assembly,"AB 1988 HAGMAN  Third Reading Urgency",76,0,3,0,79
70271,10244,2010-06-30,Senate,"Do pass as amended, and re-refer to the Committee on Appropriations",8,0,1,0,9
70271,19208,2010-08-02,Senate,"Placed on Appropriations Suspense file",10,0,0,0,10
70272,5471,2010-04-07,Assembly,"Do pass as amended and be re-referred to the Committee on Appropriations",6,2,1,0,9
70274,588,2010-04-21,Assembly,"Do pass and be re-referred to the Committee on Appropriations.",4,3,2,0,9
70274,27424,2010-04-21,Assembly,"Do pass and be re-referred to the Committee on Appropriations",4,3,0,0,7
70275,4414,2010-04-21,Assembly,"Do pass and re-refer to Committee on Appropriations with recommendation:  To Consent Calendar",21,0,1,0,22
70275,4415,2010-05-05,Assembly,"Do pass, to Consent Calendar",17,0,0,0,17
70275,4416,2010-05-13,Assembly,"AB 1992 PORTANTINO  Consent Calendar Second Day  Regular Session",76,0,3,0,79
70275,4417,2010-06-09,Senate,"Do pass, but re-refer to the Committee on Appropriations",6,0,5,0,11
70275,10100,2010-07-01,Senate,"Special Consent #29 AB1992 Portantino",34,0,5,0,39
70276,1114,2010-04-13,Assembly,"Do pass and be re-referred to the Committee on Judiciary.",11,0,0,0,11
70276,1115,2010-04-20,Assembly,"Do pass as amended and be re-referred to the Committee on Appropriations.",9,0,1,0,10
70276,1116,2010-05-19,Assembly,"Do pass as amended.",16,0,1,0,17
70276,1117,2010-06-02,Assembly,"AB 1993 STRICKLAND  Assembly Third Reading  By LOWENTHAL",75,0,4,0,79
70277,5038,2010-04-21,Assembly,"Do pass and be re-referred to the Committee on Appropriations",8,4,0,0,12
70278,1618,2010-03-23,Assembly,"Do pass as amended and be re-referred to the Committee on Appropriations",12,0,0,0,12
70278,1619,2010-04-14,Assembly,"Do pass",16,0,1,0,17
70278,1620,2010-04-29,Assembly,"AB 1995 GAINES  Assembly Third Reading",74,0,5,0,79
70278,5911,2010-06-09,Senate,"Do pass as amended, but re-refer to the Committee on Appropriations Recommend Consent",7,0,2,0,9
70278,9811,2010-06-28,Senate,"Do pass",10,0,1,0,11
70278,9959,2010-07-01,Senate,"Special Consent #29 AB1995 Gaines",34,0,5,0,39
70278,19529,2010-08-02,Assembly,"AB 1995 GAINES  Concurrence in Senate Amendments",76,0,0,0,76
70279,400,2010-04-13,Assembly,"Do pass as amended and be re-referred to the Committee on Appropriations.",11,0,0,0,11
70279,401,2010-04-28,Assembly,"Do pass.",12,1,4,0,17
70279,402,2010-05-06,Assembly,"AB 1996 HILL  Assembly Third Reading",64,8,7,0,79
70279,8715,2010-06-14,Senate,"Do pass, but re-refer to the Committee on Appropriations",4,3,2,0,9
70279,8716,2010-06-14,Senate,"Set, first hearing.  Failed passage in Committee.  Reconsideration granted",7,0,2,0,9
70279,9818,2010-06-28,Senate,"Do pass, but re-refer to the Committee on Appropriations",5,2,2,0,9
70279,10904,2010-07-15,Senate,"Do pass",7,1,2,0,10
70279,19790,2010-08-11,Senate,"Assembly 3rd Reading AB1996 Hill By Emmerson",22,11,0,0,33
70279,20301,2010-08-16,Assembly,"AB 1996 HILL  Concurrence in Senate Amendments",55,17,0,0,72
70280,2226,2010-05-04,Assembly,"Do pass",8,0,1,0,9
70280,2227,2010-05-10,Assembly,"AB 1997 PORTANTINO  Assembly Third Reading",71,0,8,0,79
70280,9457,2010-06-23,Senate,"Do pass as amended, and re-refer to the Committee on Appropriations",7,0,2,0,9
70280,19695,2010-08-02,Senate,"Placed on Appropriations Suspense file",10,0,0,0,10
70280,20289,2010-08-12,Senate,"Do pass",10,0,0,0,10
70280,20870,2010-08-23,Senate,"Assembly 3rd Reading AB1997 Portantino By Hancock",36,0,0,0,36
70280,21016,2010-08-24,Assembly,"AB 1997 PORTANTINO  Concurrence in Senate Amendments",76,0,0,0,76
70281,3343,2010-04-12,Assembly,"Do pass as amended and be re-referred to the Committee on Appropriations",6,3,0,0,9
70281,3344,2010-05-28,Assembly,"Do pass as amended",11,5,1,0,17
70281,3345,2010-06-02,Assembly,"AB 1998 BROWNLEY  Assembly Third Reading",42,27,10,0,79
70281,9590,2010-06-28,Senate,"Do pass as amended, and re-refer to the Committee on Appropriations",5,2,0,0,7
70281,19467,2010-08-02,Senate,"Placed on Appropriations Suspense file",10,0,0,0,10
70281,20093,2010-08-12,Senate,"Be re-referred to the Committee on Rules",11,0,0,0,11
70281,21861,2010-08-31,Senate,"Do pass",7,3,0,0,10
70281,21862,2010-08-31,Senate,"Assembly 3rd Reading AB1998 Brownley Re-Refer",14,20,0,0,34
70281,21863,2010-08-31,Senate,"Assembly 3rd Reading AB1998 Brownley By Cedillo",14,21,0,0,35
70282,3231,2010-03-23,Assembly,"Do pass",7,0,0,0,7
70282,3232,2010-04-05,Assembly,"AB 1999 PORTANTINO  Assembly Third Reading",74,3,2,0,79
70282,9016,2010-06-15,Senate,"Do pass",7,0,0,0,7
70282,20507,2010-08-18,Senate,"Assembly 3rd Reading AB1999 Portantino By Calderon",31,0,0,0,31
70282,20618,2010-08-19,Assembly,"AB 1999 PORTANTINO  Concurrence in Senate Amendments",74,2,0,0,76
70283,3055,2010-04-14,Assembly,"Do pass and be re-referred to the Committee on Appropriations",7,0,1,0,8
70283,3056,2010-04-28,Assembly,"Do pass, to Consent Calendar",15,0,2,0,17
70283,3057,2010-05-06,Assembly,"AB 2000 HAGMAN  Consent Calendar Second Day  Regular Session",74,0,5,0,79
70283,10307,2010-06-30,Senate,"Do pass as amended, and re-refer to the Committee on Appropriations",8,0,1,0,9
70283,19490,2010-08-02,Senate,"Placed on Appropriations Suspense file",10,0,0,0,10
70283,21599,2010-08-27,Senate,"Do pass as amended",4,7,0,0,11
70284,3212,2010-04-13,Assembly,"Do pass and re-refer to Committee on Appropriations with recommendation:  To Consent Calendar",11,0,0,0,11
70284,3213,2010-04-28,Assembly,"Do pass as amended, to Consent Calendar",15,0,2,0,17
70284,3214,2010-05-06,Assembly,"AB 2001 HARKEY  Consent Calendar Second Day  Regular Session",74,0,5,0,79
70284,8968,2010-06-15,Senate,"Do pass, but re-refer to the Committee on Rules Recommend Consent",8,0,1,0,9
70284,19412,2010-08-05,Senate,"Consent Calendar 2nd AB2001 Harkey",33,0,0,0,33
70284,20211,2010-08-12,Assembly,"AB 2001 HARKEY  Concurrence in Senate Amendments",77,0,0,0,77
70285,5499,2010-04-07,Assembly,"Do pass, to Consent Calendar",12,0,0,0,12
70285,5500,2010-04-15,Assembly,"AB 2002 HUFFMAN  Consent Calendar Second Day  Regular Session",70,0,9,0,79
70285,8932,2010-06-16,Senate,"Do pass and be placed on the Consent Calendar",9,0,2,0,11
70285,9343,2010-06-24,Senate,"Consent Calendar 2nd AB2002 Huffman",31,0,8,0,39
70287,253,2010-04-13,Assembly,"Do pass as amended and be re-referred to the Committee on Appropriations.",4,1,1,0,6
70289,3419,2010-03-23,Assembly,"Do pass as amended and be re-referred to the Committee on Appropriations",7,2,1,0,10
70290,3463,2010-04-20,Assembly,"Do pass and be re-referred to the Committee on Appropriations",7,0,0,0,7
70290,3464,2010-04-28,Assembly,"Do pass",14,1,2,0,17
70290,3465,2010-05-06,Assembly,"AB 2007 ADAMS  Assembly Third Reading",74,0,5,0,79
70290,8983,2010-06-15,Senate,"Do pass, but re-refer to the Committee on Appropriations",5,0,0,0,5
70290,9823,2010-06-28,Senate,"Placed on Appropriations Suspense file",10,0,1,0,11
70290,20194,2010-08-12,Senate,"Do pass",11,0,0,0,11
70290,20750,2010-08-18,Senate,"Assembly 3rd Reading AB2007 Adams By Price",34,0,0,0,34
70290,20751,2010-08-19,Assembly,"AB 2007 ADAMS  Concurrence in Senate Amendments",77,0,0,0,77
70291,2429,2010-04-21,Assembly,"Do pass and be re-referred to the Committee on Appropriations",5,1,0,0,6
70291,2430,2010-05-28,Assembly,"Do pass as amended",12,5,0,0,17
70291,2431,2010-06-02,Assembly,"AB 2008 ARAMBULA  Assembly Third Reading",55,21,3,0,79
70291,9197,2010-06-23,Senate,"Do pass, but re-refer to the Committee on Appropriations",4,1,1,0,6
70291,10623,2010-07-15,Senate,"Do pass",7,1,2,0,10
70291,21057,2010-08-23,Senate,"Assembly 3rd Reading AB2008 Arambula By Correa",28,8,0,0,36
70292,4612,2010-03-23,Assembly,"Do pass, to Consent Calendar",7,0,0,0,7
70292,4613,2010-04-08,Assembly,"AB 2009 LOGUE  Consent Calendar Second Day",71,0,8,0,79
70292,10159,2010-06-29,Senate,"Do pass",7,0,0,0,7
70292,19628,2010-08-09,Senate,"Special Consent #30 AB2009 Logue",34,0,0,0,34
70292,19957,2010-08-12,Assembly,"AB 2009 LOGUE  Concurrence in Senate Amendments",78,0,0,0,78
70294,2738,2010-03-23,Assembly,"Do pass and be re-referred to the Committee on Appropriations",7,0,0,0,7
70294,2739,2010-04-14,Assembly,"Do pass as amended, to Consent Calendar",15,0,2,0,17
70294,2740,2010-04-22,Assembly,"AB 2011 ARAMBULA  Consent Calendar Second Day  Regular Session",74,0,5,0,79
70294,8813,2010-06-15,Senate,"Do pass, but re-refer to the Committee on Appropriations",7,0,0,0,7
70294,9795,2010-06-28,Senate,"Do pass as amended",10,0,1,0,11
70294,10121,2010-07-01,Senate,"Special Consent #29 AB2011 Arambula",34,0,5,0,39
70294,19389,2010-08-02,Assembly,"AB 2011 ARAMBULA  Concurrence in Senate Amendments",76,0,0,0,76
70295,448,2010-04-20,Assembly,"Do pass as amended and re-refer to Committee on Appropriations with recommendation:  To Consent Calendar.",7,0,0,0,7
70295,449,2010-05-19,Assembly,"Do pass.",11,4,2,0,17
70295,450,2010-05-24,Assembly,"AB 2012 LIEU  Assembly Third Reading",60,10,9,0,79
70295,9383,2010-06-22,Senate,"Do pass, but re-refer to the Committee on Appropriations",6,1,0,0,7
70295,20145,2010-08-12,Senate,"Assembly 3rd Reading AB2012 Lieu By Leno",28,6,0,0,34
70295,20353,2010-08-17,Assembly,"AB 2012 LIEU  Concurrence in Senate Amendments",63,12,0,0,75
70296,4882,2010-04-21,Assembly,"Do pass as amended and be re-referred to the Committee on Appropriations",6,1,2,0,9
70297,5396,2010-05-03,Assembly,"Do pass and be re-referred to the Committee on Revenue and Taxation",7,0,2,0,9
70297,5397,2010-05-10,Assembly,"Do pass as amended and be re-referred to the Committee on Appropriations",9,0,0,0,9
70299,515,2010-04-05,Assembly,"Do pass and be re-referred to the Committee on Judiciary.",12,0,0,0,12
70299,516,2010-04-27,Assembly,"Do pass, to Consent Calendar.",10,0,0,0,10
70299,517,2010-05-03,Assembly,"AB 2016 TORRES  Consent Calendar Second Day",75,0,4,0,79
70299,8911,2010-06-15,Senate,"Do pass as amended",5,0,0,0,5
70299,9652,2010-06-28,Senate,"Special Consent #28 AB2016 Torres",32,0,7,0,39
70299,19520,2010-08-02,Assembly,"AB 2016 TORRES  Concurrence in Senate Amendments",77,0,0,0,77
70300,750,2010-03-23,Assembly,"Do pass and be re-referred to the Committee on Revenue and Taxation.",4,0,2,0,6
70300,751,2010-04-19,Assembly,"Do pass as amended and be re-referred to the Committee on Appropriations.",9,0,0,0,9
70300,752,2010-05-28,Assembly,"Do pass as amended.",16,1,0,0,17
70300,753,2010-06-02,Assembly,"AB 2017 HALL  Assembly Third Reading",71,0,8,0,79
70300,10007,2010-07-01,Senate,"Do pass, but re-refer to the Committee on Appropriations",4,1,0,0,5
70300,21234,2010-08-23,Senate,"Assembly 3rd Reading AB2017 Hall By Lowenthal",30,2,0,0,32
70300,21235,2010-08-24,Assembly,"AB 2017 HALL  Concurrence in Senate Amendments",73,0,0,0,73
70301,1304,2010-04-13,Assembly,"Do pass and be re-referred to the Committee on Appropriations.",4,0,2,0,6
70301,1305,2010-05-19,Assembly,"Do pass.",13,0,4,0,17
70301,1306,2010-05-24,Assembly,"AB 2018 SKINNER  Assembly Third Reading",62,1,16,0,79
70301,9436,2010-06-22,Senate,"Do pass, but re-refer to the Committee on Appropriations",4,0,1,0,5
70301,19216,2010-08-02,Senate,"Do pass",8,0,0,0,8
70301,21327,2010-08-24,Senate,"Assembly 3rd Reading AB2018 Skinner By Emmerson",35,0,0,0,35
70301,21579,2010-08-27,Assembly,"AB 2018 SKINNER  Concurrence in Senate Amendments",67,6,0,0,73
70302,1357,2010-04-07,Assembly,"Do pass as amended and be re-referred to the Committee on Appropriations.",7,0,2,0,9
70302,1358,2010-05-28,Assembly,"Do pass.",12,5,0,0,17
70302,1359,2010-06-01,Assembly,"AB 2019 TORLAKSON  Assembly Third Reading",54,21,4,0,79
70303,5453,2010-03-23,Assembly,"Do pass as amended",10,0,0,0,10
70303,5454,2010-04-15,Assembly,"AB 2020 FLETCHER  Assembly Third Reading",72,0,7,0,79
70303,8888,2010-06-15,Senate,"Do pass",5,0,0,0,5
70303,20058,2010-08-11,Senate,"Assembly 3rd Reading AB2020 Fletcher By Liu",33,0,0,0,33
70303,20299,2010-08-16,Assembly,"AB 2020 FLETCHER  Concurrence in Senate Amendments",75,0,0,0,75
70304,4160,2010-04-12,Assembly,"Do pass and be re-referred to the Committee on Higher Education to Consent Calendar",20,0,2,0,22
70304,4161,2010-04-20,Assembly,"Do pass and re-refer to Committee on Appropriations with recommendation:  To Consent Calendar",9,0,0,0,9
70304,4162,2010-05-05,Assembly,"Do pass",17,0,0,0,17
70304,4163,2010-05-17,Assembly,"AB 2021 FLETCHER  Assembly Third Reading",71,0,8,0,79
70304,9359,2010-06-22,Senate,"Do pass, but re-refer to the Committee on Appropriations Recommend Consent",9,0,2,0,11
70304,19756,2010-08-09,Senate,"Consent Calendar 2nd AB2021 Fletcher",34,0,0,0,34
70304,20462,2010-08-16,Assembly,"AB 2021 FLETCHER  Concurrence in Senate Amendments",75,0,0,0,75
70305,527,2010-05-05,Assembly,"Do pass as amended.",12,0,0,0,12
70305,528,2010-05-20,Assembly,"AB 2022 GAINES  Assembly Third Reading",72,0,7,0,79
70305,9830,2010-06-30,Senate,"Do pass and be placed on the Consent Calendar",10,0,1,0,11
70305,20722,2010-08-20,Senate,"Assembly 3rd Reading AB2022 Gaines By Runner",31,0,0,0,31
70306,4517,2010-04-20,Assembly,"Do pass as amended and be re-referred to the Committee on Appropriations",7,0,0,0,7
70306,4518,2010-05-05,Assembly,"Do pass, to Consent Calendar",17,0,0,0,17
70306,4519,2010-05-13,Assembly,"AB 2023 SALDANA  Consent Calendar Second Day  Regular Session",76,0,3,0,79
70306,8745,2010-06-15,Senate,"Do pass, but re-refer to the Committee on Appropriations",5,0,0,0,5
70306,9459,2010-06-15,Senate,"Do pass, but re-refer to the Committee on Appropriations",5,0,0,0,5
70306,9995,2010-07-01,Senate,"Special Consent #29 AB2023 Saldana",34,0,5,0,39
70308,4778,2010-05-04,Assembly,"Do pass as amended and be re-referred to the Committee on Appropriations",12,5,2,0,19
70309,4293,2010-04-20,Assembly,"Do pass and be re-referred to the Committee on Judiciary",7,1,1,0,9
70309,4294,2010-05-04,Assembly,"Do pass as amended",7,2,1,0,10
70309,4295,2010-05-13,Assembly,"AB 2026 ARAMBULA  Assembly Third Reading",47,27,5,0,79
70309,9384,2010-06-23,Senate,"Do pass",5,2,2,0,9
70309,9622,2010-06-28,Senate,"Assembly 3rd Reading AB2026 Arambula",22,11,6,0,39
70310,2031,2010-04-21,Assembly,"Do pass as amended and re-refer to Committee on Appropriations with recommendation:  To Consent Calendar",9,0,0,0,9
70310,2032,2010-05-28,Assembly,"Do pass as amended",17,0,0,0,17
70310,2033,2010-06-02,Assembly,"AB 2027 BLUMENFIELD  Assembly Third Reading",76,0,3,0,79
70310,10141,2010-06-30,Senate,"Do pass as amended, and re-refer to the Committee on Appropriations",8,0,1,0,9
70310,19432,2010-08-02,Senate,"Placed on Appropriations Suspense file",10,0,0,0,10
70311,1522,2010-03-23,Assembly,"Do pass and be re-referred to the Committee on Judiciary",17,0,2,0,19
70311,1523,2010-04-06,Assembly,"Do pass as amended and be re-referred to the Committee on Appropriations",9,0,1,0,10
70311,1524,2010-04-28,Assembly,"Do pass, to Consent Calendar",15,0,2,0,17
70311,1525,2010-05-06,Assembly,"AB 2028 HERNANDEZ  Consent Calendar Second Day  Regular Session",74,0,5,0,79
70311,8771,2010-06-15,Senate,"Do pass as amended, and re-refer to the Committee on Appropriations",5,0,0,0,5
70311,19883,2010-08-12,Senate,"Assembly 3rd Reading AB2028 Hernandez By Leno",32,0,0,0,32
70311,20400,2010-08-17,Assembly,"AB 2028 HERNANDEZ  Concurrence in Senate Amendments",76,0,0,0,76
70312,2831,2010-04-14,Assembly,"Do pass and be re-referred to the Committee on Appropriations",4,2,3,0,9
70312,2832,2010-04-14,Assembly,"Set first hearing.  Failed passage.  Reconsideration granted",9,0,0,0,9
70313,349,2010-04-07,Assembly,"Do pass as amended and be re-referred to the Committee on Appropriations.",6,5,1,0,12
70313,350,2010-04-07,Assembly,"Set first hearing.  Failed passage.  Reconsideration granted.",12,0,0,0,12
70313,351,2010-04-21,Assembly,"Do pass and be re-referred to the Committee on Appropriations.",7,5,0,0,12
70314,3931,2010-04-13,Assembly,"Do pass and re-refer to Committee on Appropriations with recommendation:  To Consent Calendar",11,0,0,0,11
70314,3932,2010-04-28,Assembly,"Do pass, to Consent Calendar",15,0,2,0,17
70314,3933,2010-05-06,Assembly,"AB 2031 EVANS  Consent Calendar Second Day  Regular Session",74,0,5,0,79
70314,10166,2010-06-29,Senate,"Do pass, but re-refer to the Committee on Appropriations Recommend Consent",8,0,3,0,11
70314,19436,2010-08-05,Senate,"Consent Calendar 2nd AB2031 Evans",33,0,0,0,33
70314,20805,2010-08-23,Senate,"Assembly 3rd Reading AB2031 Evans By Yee",36,0,0,0,36
70314,20972,2010-08-24,Assembly,"AB 2031 EVANS  Concurrence in Senate Amendments",76,0,0,0,76
70315,1580,2010-04-06,Assembly,"Do pass and be re-referred to the Committee on Labor and Employment",5,2,1,0,8
70315,1581,2010-04-21,Assembly,"Do pass and be re-referred to the Committee on Appropriations",6,1,0,0,7
70315,1582,2010-05-28,Assembly,"Do pass as amended",12,5,0,0,17
70315,1583,2010-06-02,Assembly,"AB 2032 DAVIS  Assembly Third Reading",50,23,6,0,79
70315,9471,2010-06-23,Senate,"Do pass, but re-refer to the Committee on Appropriations",4,1,1,0,6
70315,10653,2010-07-15,Senate,"Do pass",6,2,2,0,10
70315,19798,2010-08-11,Senate,"Assembly 3rd Reading AB2032 Davis By DeSaulnier",21,13,0,0,34
70316,3091,2010-04-14,Assembly,"Do pass and be re-referred to the Committee on Appropriations",8,0,1,0,9
70316,3092,2010-05-12,Assembly,"Do pass",16,0,1,0,17
70316,3093,2010-05-24,Assembly,"AB 2033 TORRES  Assembly Third Reading",70,0,9,0,79
70316,9155,2010-06-22,Senate,"Do pass as amended, and re-refer to the Committee on Appropriations",7,0,2,0,9
70316,19838,2010-08-09,Senate,"Placed on Appropriations Suspense file",10,0,0,0,10
70317,1442,2010-03-24,Assembly,"Do pass as amended and be re-referred to the Committee on Appropriations",7,1,1,0,9
70317,1443,2010-04-21,Assembly,"Do pass as amended",16,1,0,0,17
70317,1444,2010-04-29,Assembly,"AB 2034 KNIGHT  Assembly Third Reading",64,3,12,0,79
70317,9353,2010-06-23,Senate,"Do pass, but re-refer to the Committee on Rules",0,3,6,0,9
70318,4929,2010-03-23,Assembly,"Do pass",19,0,0,0,19
70318,4930,2010-04-08,Assembly,"AB 2035 COTO  Assembly Third Reading",73,0,6,0,79
70319,3142,2010-04-20,Assembly,"Do pass as amended and be re-referred to the Committee on Appropriations",9,0,1,0,10
70319,3143,2010-05-12,Assembly,"Do pass, to Consent Calendar",16,0,1,0,17
70319,3144,2010-05-20,Assembly,"AB 2036 BERRYHILL, B.  Consent Calendar Second Day  Regular Session",72,0,7,0,79
70319,19742,2010-08-10,Senate,"Do pass, but re-refer to the Committee on Appropriations",8,0,0,0,8
70319,20045,2010-08-12,Senate,"Do pass as amended",11,0,0,0,11
70319,20987,2010-08-24,Senate,"Assembly 3rd Reading AB2036 Bill Berryhill Urgency Clause",36,0,0,0,36
70319,20988,2010-08-24,Senate,"Assembly 3rd Reading AB2036 Bill Berryhill Reconsider",35,0,0,0,35
70319,21762,2010-08-30,Assembly,"Senate amendments be concurred in",9,0,0,0,9
70319,21763,2010-08-30,Senate,"Assembly 2nd Reading AB2036 Bill Berryhill By Wyland",32,0,0,0,32
70319,21869,2010-08-31,Assembly,"AB 2036 BERRYHILL, B.  Concurrence in Senate Amendments",78,0,0,0,78
70320,2062,2010-04-05,Assembly,"Do pass and be re-referred to the Committee on Natural Resources",10,4,1,0,15
70320,2063,2010-04-19,Assembly,"Do pass and be re-referred to the Committee on Appropriations",6,3,0,0,9
70320,2064,2010-04-28,Assembly,"Do pass",10,5,2,0,17
70320,2065,2010-05-10,Assembly,"AB 2037 PEREZ, V.M.  Assembly Third Reading",44,26,9,0,79
70320,8942,2010-06-15,Senate,"Do pass, but re-refer to the Committee on Environmental Quality",7,2,2,0,11
70320,9824,2010-06-28,Senate,"Do pass as amended, and re-refer to the Committee on Appropriations",5,2,0,0,7
70320,20511,2010-08-18,Senate,"Assembly 3rd Reading AB2037 V. Manuel Perez By Pavley",21,13,0,0,34
70320,20630,2010-08-19,Assembly,"AB 2037 PEREZ, V.M.  Concurrence in Senate Amendments",49,27,0,0,76
70321,7,2010-04-13,Assembly,"Do pass and be re-referred to the Committee on Revenue and Taxation.",7,4,0,0,11
70321,8,2010-04-19,Assembly,"Do pass as amended and be re-referred to the Committee on Appropriations.",6,3,0,0,9
70322,319,2010-03-23,Assembly,"Do pass and re-refer to Committee on Appropriations with recommendation:  To Consent Calendar.",6,0,0,0,6
70322,320,2010-04-14,Assembly,"Do pass, to Consent Calendar.",15,0,2,0,17
70322,321,2010-04-22,Assembly,"AB 2039 LOGUE  Consent Calendar Second Day  Regular Session",74,0,5,0,79
70322,8568,2010-06-10,Senate,"Do pass, but re-refer to the Committee on Appropriations",3,0,1,0,4
70322,10052,2010-07-01,Senate,"Special Consent #29 AB2039 Logue",34,0,5,0,39
70322,19327,2010-08-02,Assembly,"AB 2039 LOGUE  Concurrence in Senate Amendments",76,0,0,0,76
70323,1326,2010-04-07,Assembly,"Do pass and re-refer to Committee on Appropriations with recommendation:  To Consent Calendar.",8,0,1,0,9
70323,1327,2010-05-28,Assembly,"Do pass.",17,0,0,0,17
70323,1328,2010-06-02,Assembly,"AB 2040 BROWNLEY  Assembly Third Reading",76,0,3,0,79
70323,9860,2010-06-30,Senate,"Do pass, but re-refer to the Committee on Appropriations Recommend Consent",8,0,1,0,9
70323,19409,2010-08-05,Senate,"Consent Calendar 2nd AB2040 Brownley",33,0,0,0,33
70325,4090,2010-04-13,Assembly,"Do pass as amended and be re-referred to the Committee on Appropriations",13,6,0,0,19
70325,4091,2010-05-05,Assembly,"Do pass",12,5,0,0,17
70325,4092,2010-05-13,Assembly,"AB 2042 FEUER  Assembly Third Reading",48,27,4,0,79
70325,9499,2010-06-23,Senate,"Do pass as amended, and re-refer to the Committee on Appropriations",6,0,3,0,9
70325,21181,2010-08-23,Senate,"Assembly 3rd Reading AB2042 Feuer By Leno",22,13,0,0,35
70325,21182,2010-08-25,Assembly,"AB 2042 FEUER  Concurrence in Senate Amendments",50,26,0,0,76
70326,419,2010-04-28,Assembly,"Do pass as amended and be re-referred to the Committee on Local Government.",7,2,0,0,9
70326,420,2010-05-05,Assembly,"Do pass and be re-referred to the Committee on Appropriations.",6,3,0,0,9
70330,2646,2010-04-06,Assembly,"Do pass and be re-referred to the Committee on Judiciary",6,3,0,0,9
70330,2647,2010-04-20,Assembly,"Do pass as amended and be re-referred to the Committee on Appropriations",7,3,0,0,10
70330,2648,2010-05-28,Assembly,"Do pass",12,5,0,0,17
70330,2649,2010-06-03,Assembly,"AB 2047 HERNANDEZ  Assembly Third Reading",48,28,3,0,79
70330,10005,2010-06-30,Senate,"Do pass, but re-refer to the Committee on Appropriations",6,2,1,0,9
70330,19724,2010-08-02,Senate,"Placed on Appropriations Suspense file",10,0,0,0,10
70330,20296,2010-08-12,Senate,"Do pass",7,4,0,0,11
70330,20865,2010-08-23,Senate,"Assembly 3rd Reading AB2047 Hernandez By Simitian",23,13,0,0,36
70331,389,2010-04-07,Assembly,"Do pass and re-refer to Committee on Appropriations with recommendation:  To Consent Calendar.",8,0,1,0,9
70331,390,2010-04-21,Assembly,"Do pass, to Consent Calendar.",17,0,0,0,17
70331,391,2010-04-29,Assembly,"AB 2048 TORLAKSON  Consent Calendar Second Day  Regular Session",74,0,5,0,79
70331,8904,2010-06-16,Senate,"Do pass, but re-refer to the Committee on Appropriations Recommend Consent",6,0,3,0,9
70331,20944,2010-08-23,Senate,"Assembly 3rd Reading AB2048 Torlakson By Huff",36,0,0,0,36
70331,21059,2010-08-24,Assembly,"AB 2048 TORLAKSON  Concurrence in Senate Amendments",75,0,0,0,75
70332,2846,2010-03-24,Assembly,"Be adopted, to Consent Calendar",9,0,0,0,9
70332,2847,2010-04-08,Assembly,"ACR 128 EMMERSON  Consent Calendar Second Day  Regular Session",71,0,8,0,79
70332,9645,2010-06-28,Senate,"Special Consent #28 ACR128 Emmerson",32,0,7,0,39
70333,5219,2010-04-12,Assembly,"Be adopted as amended",13,0,1,0,14
70333,5220,2010-04-22,Assembly,"AJR 33 FULLER  Assembly Third Reading",73,0,6,0,79
70335,82,2010-04-14,Senate,"Do pass, but re-refer to the Committee on Appropriations.",5,0,0,0,5
70335,83,2010-05-03,Senate,"Placed on Appropriations Suspense file.",10,0,1,0,11
70335,84,2010-05-27,Senate,"Do pass.",10,0,1,0,11
70335,85,2010-06-02,Senate,"Special Consent #26 SB1065 Walters",35,0,3,0,38
70335,10036,2010-06-28,Assembly,"Do pass and re-refer to Committee on Appropriations with recommendation:  To Consent Calendar",9,0,0,0,9
70335,20135,2010-08-12,Assembly,"Do pass",17,0,0,0,17
70335,20348,2010-08-17,Assembly,"SB 1065 Walters  Senate Third Reading",76,0,0,0,76
70336,19,2010-04-06,Senate,"Do pass, but re-refer to the Committee on Appropriations.",7,0,0,0,7
70336,20,2010-04-26,Senate,"Placed on Appropriations Suspense file.",9,0,2,0,11
70336,21,2010-05-27,Senate,"Do pass.",10,0,1,0,11
70336,22,2010-06-02,Senate,"Special Consent #26 SB1066 Oropeza",35,0,3,0,38
70336,9724,2010-06-29,Assembly,"Do pass and re-refer to Committee on Appropriations with recommendation:  To Consent Calendar",7,0,0,0,7
70336,20067,2010-08-12,Assembly,"Do pass as amended",12,0,0,0,12
70336,21328,2010-08-23,Assembly,"SB 1066 Oropeza  Senate Third Reading  By AMMIANO",74,0,0,0,74
70336,21329,2010-08-25,Senate,"Unfinished Business SB1066 Oropeza",35,0,0,0,35
70337,3314,2010-04-06,Senate,"Do pass as amended, and re-refer to the Committee on Appropriations",7,0,0,0,7
70337,3315,2010-04-26,Senate,"Placed on Appropriations Suspense file",9,0,2,0,11
70337,3316,2010-05-27,Senate,"Do pass",10,0,1,0,11
70337,3317,2010-06-02,Senate,"Special Consent #26 SB1067 Oropeza",35,0,3,0,38
70337,9720,2010-06-29,Assembly,"Do pass and re-refer to Committee on Appropriations with recommendation:  To Consent Calendar",7,0,0,0,7
70337,19657,2010-08-04,Assembly,"Do pass, to Consent Calendar",17,0,0,0,17
70337,19988,2010-08-12,Assembly,"SB 1067 Oropeza  Consent Calendar Second Day  Regular Session",78,0,0,0,78
70337,21462,2010-08-26,Senate,"Special Consent #32 SB1067 Oropeza",34,0,0,0,34
70339,343,2010-04-12,Senate,"Do pass, but re-refer to the Committee on Judiciary.",8,0,1,0,9
70339,344,2010-04-20,Senate,"Do pass, but re-refer to the Committee on Appropriations.",4,0,1,0,5
70339,345,2010-05-10,Senate,"Senate 3rd Reading SB1069 Pavley",30,0,8,0,38
70339,8902,2010-06-15,Assembly,"Do pass and be re-referred to the Committee on Judiciary",11,0,0,0,11
70339,9421,2010-06-22,Assembly,"Do pass and re-refer to Committee on Appropriations with recommendation:  To Consent Calendar",10,0,0,0,10
70339,19577,2010-08-04,Assembly,"Do pass, to Consent Calendar",17,0,0,0,17
70339,20457,2010-08-18,Assembly,"SB 1069 Pavley  Senate Third Reading  By FLETCHER",75,0,0,0,75
70339,21499,2010-08-26,Senate,"Special Consent #32 SB1069 Pavley",34,0,0,0,34
70340,5109,2010-05-05,Senate,"Do pass and be placed on the Consent Calendar",5,0,0,0,5
70340,5110,2010-05-13,Senate,"Consent Calendar 2nd SB1070 Cogdill",31,0,7,0,38
70340,10062,2010-06-30,Assembly,"Do pass, to Consent Calendar",9,0,0,0,9
70340,19404,2010-08-05,Assembly,"SB 1070 Cogdill  Consent Calendar Second Day  Regular Session",71,0,0,0,71
70341,1858,2010-05-05,Senate,"Do pass as amended, and re-refer to the Committee on Revenue and Taxation",4,5,0,0,9
70341,1859,2010-05-05,Senate,"Set, first hearing.  Failed passage in Committee.  Reconsideration granted",9,0,0,0,9
70342,2769,2010-04-27,Senate,"Do pass and be placed on the Consent Calendar",7,0,4,0,11
70342,2770,2010-05-03,Senate,"Consent Calendar 2nd SB1072 Calderon",34,0,4,0,38
70342,10262,2010-06-30,Assembly,"Do pass as amended",18,0,4,0,22
70342,19929,2010-08-12,Assembly,"Do pass as amended",17,0,0,0,17
70342,20698,2010-08-20,Assembly,"SB 1072 Calderon  Senate Third Reading  Amend By TORRICO  Set #1",49,26,0,0,75
70342,21898,2010-08-30,Assembly,"Do pass as amended",12,0,0,0,12
70342,21899,2010-08-30,Assembly,"SB 1072 Calderon  Senate Third Reading  By MA",56,10,0,0,66
70342,21900,2010-08-31,Senate,"From committee:  That the Assembly Amendments be concurred in",10,0,0,0,10
70342,21901,2010-08-31,Senate,"W/O REF. TO FILE SB1072 Calderon",23,6,0,0,29
70345,2890,2010-04-13,Senate,"Do pass, but re-refer to the Committee on Education",4,0,1,0,5
70345,2891,2010-04-21,Senate,"Do pass as amended, and re-refer to the Committee on Appropriations",8,0,1,0,9
70345,2892,2010-05-17,Senate,"Do pass",7,0,4,0,11
70345,2893,2010-05-24,Senate,"Senate 3rd Reading SB1075 Correa",33,0,5,0,38
70345,8828,2010-06-15,Assembly,"Do pass and be re-referred to the Committee on Higher Education to Consent Calendar",9,0,0,0,9
70345,9514,2010-06-22,Assembly,"Do pass as amended and be re-referred to the Committee on Appropriations",9,0,0,0,9
70345,19348,2010-08-04,Assembly,"Do pass, to Consent Calendar",17,0,0,0,17
70345,19985,2010-08-12,Assembly,"SB 1075 Correa  Consent Calendar Second Day  Regular Session",78,0,0,0,78
70345,20743,2010-08-19,Senate,"Unfinished Business SB1075 Correa",35,0,0,0,35
70346,2245,2010-04-14,Senate,"Do pass, but re-refer to the Committee on Appropriations",3,1,1,0,5
70346,2246,2010-05-27,Senate,"Senate 3rd Reading SB1076 Price",22,7,9,0,38
70346,9966,2010-06-28,Assembly,"Do pass as amended and be re-referred to the Committee on Appropriations",8,1,0,0,9
70346,19392,2010-08-04,Assembly,"Do pass",16,0,0,0,16
70346,20444,2010-08-17,Assembly,"SB 1076 Price  Senate Third Reading  By PORTANTINO",68,5,0,0,73
70346,21423,2010-08-25,Senate,"Unfinished Business SB1076 Price",24,8,0,0,32
70348,8659,2010-04-06,Senate,"Do pass as amended, and re-refer to the Committee on Appropriations",2,5,0,0,7
70349,214,2010-04-13,Senate,"Do pass, but re-refer to the Committee on Appropriations.",9,0,2,0,11
70349,215,2010-05-10,Senate,"Special Consent #23 SB1079 Walters",30,0,8,0,38
70349,8896,2010-06-15,Assembly,"Do pass and be re-referred to the Committee on Appropriations",11,0,0,0,11
70349,9901,2010-06-30,Assembly,"Do pass as amended",17,0,0,0,17
70349,20331,2010-08-16,Assembly,"SB 1079 Walters  Senate Third Reading  By CONWAY",75,0,0,0,75
70349,21437,2010-08-26,Senate,"Special Consent #32 SB1079 Walters",34,0,0,0,34
70350,4903,2010-04-06,Senate,"Do pass",7,0,0,0,7
70350,4904,2010-04-15,Senate,"Senate 3rd Reading SB1080 Committee on Pub. S. (Leno)",31,0,8,0,39
70350,9280,2010-06-22,Assembly,"Do pass",6,0,1,0,7
70350,19329,2010-08-02,Assembly,"SB 1080 PUB. S.  Senate Third Reading  By AMMIANO",73,0,0,0,73
70350,21520,2010-08-26,Assembly,"SB 1080 PUB. S.  Senate Third Reading  By AMMIANO",73,0,0,0,73
70350,21591,2010-08-27,Senate,"Unfinished Business SB1080 Committee on Pub. S. (Leno)",26,0,0,0,26
70353,4407,2010-04-21,Senate,"Do pass as amended, and re-refer to the Committee on Appropriations",5,0,4,0,9
70353,4408,2010-05-17,Senate,"Placed on Appropriations Suspense file",10,0,1,0,11
70354,2903,2010-03-22,Senate,"Do pass as amended, and re-refer to the Committee on Rules",6,3,0,0,9
70354,2904,2010-05-17,Senate,"Placed on Appropriations Suspense file",10,0,1,0,11
70354,2905,2010-05-27,Senate,"Do pass as amended",7,3,1,0,11
70354,2906,2010-06-02,Senate,"Senate 3rd Reading SB1084 Liu",22,13,3,0,38
70354,9271,2010-06-22,Assembly,"Do pass and be re-referred to the Committee on Human Services",4,2,0,0,6
70354,9688,2010-06-29,Assembly,"Do pass as amended and be re-referred to the Committee on Appropriations",4,2,0,0,6
70355,444,2010-04-20,Senate,"Do pass as amended, and re-refer to the Committee on Appropriations.",4,0,1,0,5
70355,445,2010-05-10,Senate,"Placed on Appropriations Suspense file.",9,0,2,0,11
70355,446,2010-05-27,Senate,"Do pass as amended.",10,0,1,0,11
70355,447,2010-06-02,Senate,"Special Consent #26 SB1085 Runner",35,0,3,0,38
70355,9897,2010-06-30,Assembly,"Do pass and be re-referred to the Committee on Appropriations",8,0,0,0,8
70355,19309,2010-08-04,Assembly,"Do pass, to Consent Calendar",17,0,0,0,17
70355,19941,2010-08-12,Assembly,"SB 1085 Runner  Consent Calendar Second Day  Regular Session",78,0,0,0,78
70355,20721,2010-08-19,Senate,"Unfinished Business SB1085 Runner",34,0,0,0,34
70357,3606,2010-04-20,Senate,"Do pass as amended",7,0,0,0,7
70357,3607,2010-04-20,Senate,"Do pass as amended",7,0,0,0,7
70357,3608,2010-05-03,Senate,"Special Consent #22 SB1087 Alquist",34,0,4,0,38
70357,8992,2010-06-15,Assembly,"Do pass",7,0,0,0,7
70357,9636,2010-06-28,Assembly,"SB 1087 Alquist  Senate Third Reading  By AMMIANO",78,0,1,0,79
70358,3181,2010-04-21,Senate,"Do pass, but re-refer to the Committee on Appropriations",5,0,4,0,9
70358,3182,2010-05-17,Senate,"Placed on Appropriations Suspense file",10,0,1,0,11
70358,3183,2010-05-27,Senate,"Do pass as amended",7,3,1,0,11
70358,3184,2010-06-02,Senate,"Senate 3rd Reading SB1088 Price",21,13,4,0,38
70358,10237,2010-06-29,Assembly,"Do pass and be re-referred to the Committee on Appropriations",13,6,0,0,19
70358,20084,2010-08-12,Assembly,"Do pass",12,5,0,0,17
70358,20804,2010-08-23,Assembly,"SB 1088 Price  Senate Third Reading  By MONNING",50,27,0,0,77
70358,21274,2010-08-25,Senate,"Unfinished Business SB1088 Price",23,11,0,0,34
70360,5510,2010-03-23,Senate,"Do pass as amended. To Consent Calendar",9,0,2,0,11
70360,5511,2010-04-08,Senate,"Consent Calendar 2nd SB1090 Cedillo",32,0,7,0,39
70360,8893,2010-06-16,Assembly,"Do pass",21,0,1,0,22
70360,20769,2010-08-18,Assembly,"SB 1090 Cedillo  Senate Third Reading  By COTO",73,0,0,0,73
70360,20770,2010-08-19,Senate,"Unfinished Business SB1090 Cedillo",32,0,0,0,32
70361,1846,2010-04-21,Senate,"Do pass as amended, and re-refer to the Committee on Appropriations",5,0,4,0,9
70361,1847,2010-05-10,Senate,"Placed on Appropriations Suspense file",9,0,2,0,11
70361,1848,2010-05-27,Senate,"Do pass",10,0,1,0,11
70361,1849,2010-06-02,Senate,"Special Consent #26 SB1091 Hancock",35,0,3,0,38
70361,10203,2010-06-29,Assembly,"Do pass and be re-referred to the Committee on Appropriations",17,0,2,0,19
70361,20074,2010-08-12,Assembly,"Do pass",17,0,0,0,17
70361,20953,2010-08-23,Assembly,"SB 1091 Hancock  Senate Third Reading  By MONNING",77,0,0,0,77
70361,21428,2010-08-26,Senate,"Unfinished Business SB1091 Hancock",37,0,0,0,37
70363,2596,2010-04-13,Senate,"Do pass as amended, and re-refer to the Committee on Appropriations",5,3,1,0,9
70363,2597,2010-05-10,Senate,"Do pass",6,2,3,0,11
70363,2598,2010-06-01,Senate,"Senate 3rd Reading SB1093 Wiggins",21,11,6,0,38
70363,9762,2010-06-29,Assembly,"Do pass as amended and be re-referred to the Committee on Appropriations",9,4,0,0,13
70363,20121,2010-08-12,Assembly,"Do pass",12,5,0,0,17
70363,20651,2010-08-20,Assembly,"SB 1093 Wiggins  Senate Third Reading  By HUFFMAN  Amend By HUFFMAN 	Set #1",49,26,0,0,75
70363,20886,2010-08-23,Assembly,"SB 1093 Wiggins  Senate Third Reading  By HUFFMAN",49,26,0,0,75
70363,21581,2010-08-27,Senate,"From committee:  That the Assembly Amendments be concurred in",6,3,0,0,9
70363,21892,2010-08-31,Senate,"Unfinished Business SB1093 Wiggins Reconsider",37,0,0,0,37
70363,22024,2010-08-31,Senate,"Unfinished Business SB1093 Wiggins",14,7,0,0,21
70366,8033,2010-03-23,Senate,"Do pass and be placed on the Consent Calendar",9,0,2,0,11
70366,8034,2010-04-05,Senate,"Consent Calendar 2nd SB1096 Wiggins",32,0,7,0,39
70366,8877,2010-06-16,Assembly,"Do pass, to Consent Calendar",20,0,2,0,22
70366,20184,2010-08-12,Assembly,"SB 1096 Wiggins  Consent Calendar Second Day  Regular Session",78,0,0,0,78
70367,656,2010-04-20,Senate,"Do pass as amended, and re-refer to the Committee on Appropriations.",8,2,1,0,11
70367,657,2010-05-17,Senate,"Placed on Appropriations Suspense file.",10,0,1,0,11
70368,941,2010-04-05,Senate,"Do pass, but re-refer to the Committee on Judiciary.",5,2,2,0,9
70368,942,2010-04-13,Senate,"Do pass as amended, and re-refer to the Committee on Appropriations.",3,1,1,0,5
70368,943,2010-05-03,Senate,"Placed on Appropriations Suspense file.",10,0,1,0,11
70368,944,2010-05-27,Senate,"Do pass.",7,3,1,0,11
70368,945,2010-06-01,Senate,"Senate 3rd Reading SB1098 Corbett",23,12,3,0,38
70368,9206,2010-06-22,Assembly,"Do pass and be re-referred to the Committee on Judiciary",7,1,1,0,9
70368,10172,2010-06-29,Assembly,"Do pass and be re-referred to the Committee on Appropriations",8,2,0,0,10
70368,20109,2010-08-12,Assembly,"Do pass",12,5,0,0,17
70368,21220,2010-08-23,Assembly,"SB 1098 Corbett  Senate Third Reading  By TORLAKSON",51,23,0,0,74
70368,21221,2010-08-25,Senate,"Unfinished Business SB1098 Corbett",23,10,0,0,33
70369,3973,2010-04-13,Senate,"Do pass, but re-refer to the Committee on Education",3,1,1,0,5
70369,3974,2010-04-21,Senate,"Do pass, but re-refer to the Committee on Appropriations",8,0,1,0,9
70369,3975,2010-05-10,Senate,"Placed on Appropriations Suspense file",9,0,2,0,11
70370,2416,2010-04-05,Senate,"Do pass, but re-refer to the Committee on Appropriations",4,2,1,0,7
70370,2417,2010-05-03,Senate,"Do pass",6,3,2,0,11
70370,2418,2010-06-03,Senate,"Senate 3rd Reading SB1100 Corbett",23,10,5,0,38
70370,9865,2010-06-29,Assembly,"Do pass and be re-referred to the Committee on Appropriations",6,3,0,0,9
70371,1224,2010-04-13,Senate,"Do pass, but re-refer to the Committee on Appropriations Recommend Consent.",10,0,1,0,11
70371,1225,2010-04-29,Senate,"Consent Calendar 2nd SB1101 Wiggins",33,0,5,0,38
70371,9078,2010-06-16,Assembly,"Do pass and re-refer to Committee on Appropriations with recommendation:  To Consent Calendar",20,0,2,0,22
70371,10301,2010-06-30,Assembly,"Do pass, to Consent Calendar",17,0,0,0,17
70371,19854,2010-08-05,Assembly,"SB 1101 Wiggins  Consent Calendar Second Day  Regular Session",71,0,0,0,71
70372,249,2010-04-20,Senate,"Do pass as amended.",3,2,0,0,5
70373,4023,2010-03-23,Senate,"Do pass as amended, and re-refer to the Committee on Appropriations",7,1,1,0,9
70373,4024,2010-04-26,Senate,"Placed on Appropriations Suspense file",9,0,2,0,11
70374,3718,2010-04-21,Senate,"Do pass as amended, and re-refer to the Committee on Appropriations",5,0,4,0,9
70374,3719,2010-05-10,Senate,"Placed on Appropriations Suspense file",9,0,2,0,11
70376,920,2010-03-22,Senate,"Do pass as amended, and re-refer to the Committee on Appropriations.",5,2,2,0,9
70376,921,2010-04-22,Senate,"Senate 3rd Reading SB1106 Yee",25,6,8,0,39
70376,9443,2010-06-22,Assembly,"Do pass and be re-referred to the Committee on Business, Professions and Consumer Protection",11,6,2,0,19
70376,9676,2010-06-29,Assembly,"Do pass and be re-referred to the Committee on Appropriations",6,4,1,0,11
70376,19772,2010-08-04,Assembly,"Do pass",12,5,0,0,17
70377,1209,2010-04-06,Senate,"Do pass as amended, and re-refer to the Committee on Environmental Quality.",3,1,1,0,5
70377,1210,2010-04-19,Senate,"Do pass, but re-refer to the Committee on Appropriations.",4,2,1,0,7
70377,1211,2010-05-03,Senate,"Do pass.",7,3,1,0,11
70377,1212,2010-06-01,Senate,"Senate 3rd Reading SB1107 Kehoe",22,13,3,0,38
70377,8764,2010-06-15,Assembly,"Do pass and be re-referred to the Committee on Agriculture",6,3,0,0,9
70378,1947,2010-04-13,Senate,"Do pass, but re-refer to the Committee on Appropriations",8,0,3,0,11
70378,1948,2010-04-26,Senate,"Placed on Appropriations Suspense file",9,0,2,0,11
70378,1949,2010-05-27,Senate,"Do pass as amended",9,1,1,0,11
70378,1950,2010-06-02,Senate,"Senate 3rd Reading SB1108 Price",33,3,2,0,38
70378,9199,2010-06-22,Assembly,"Do pass and be re-referred to the Committee on Business, Professions and Consumer Protection",6,0,0,0,6
70378,9731,2010-06-29,Assembly,"Do pass and be re-referred to the Committee on Appropriations",7,4,0,0,11
70379,2130,2010-04-14,Senate,"Do pass, but re-refer to the Committee on Appropriations",2,6,1,0,9
70379,2131,2010-04-14,Senate,"Set, first hearing.  Failed passage in Committee.  Reconsideration granted",8,0,1,0,9
70381,879,2010-04-22,Senate,"Do pass, but re-refer to the Committee on Judiciary.",1,1,7,0,9
70382,4059,2010-04-19,Senate,"Do pass as amended, and re-refer to the Committee on Rules",3,2,0,0,5
70382,4060,2010-05-17,Senate,"Placed on Appropriations Suspense file",10,0,1,0,11
70383,29,2010-04-14,Senate,"Do pass, but re-refer to the Committee on Rules.",3,2,0,0,5
70383,30,2010-04-20,Senate,"Do pass as amended, and re-refer to the Committee on Appropriations.",3,1,1,0,5
70383,31,2010-05-17,Senate,"Placed on Appropriations Suspense file.",10,0,1,0,11
70383,32,2010-05-27,Senate,"Do pass.",7,3,1,0,11
70383,33,2010-06-03,Senate,"Senate 3rd Reading SB1113 Wolk",15,20,3,0,38
70383,34,2010-06-03,Senate,"Senate 3rd Reading SB1113 Wolk Reconsider",36,0,2,0,38
70385,4617,2010-04-06,Senate,"Do pass",7,0,0,0,7
70385,4618,2010-04-15,Senate,"Senate 3rd Reading SB1115 Committee on Pub. S. (Leno)",31,0,8,0,39
70385,9255,2010-06-22,Assembly,"Do pass",6,0,1,0,7
70385,19396,2010-08-02,Assembly,"SB 1115 PUB. S.  Senate Third Reading",76,0,0,0,76
70386,4701,2010-03-24,Senate,"Do pass as amended, and re-refer to the Committee on Public Safety",7,0,2,0,9
70386,4702,2010-05-10,Senate,"Do pass as amended",9,0,2,0,11
70386,4703,2010-05-28,Senate,"Senate 3rd Reading SB1116 Huff Urgency Clause",28,0,10,0,38
70386,9973,2010-06-30,Assembly,"Do pass as amended and be re-referred to the Committee on Appropriations",8,0,1,0,9
70386,20139,2010-08-12,Assembly,"Do pass as amended",17,0,0,0,17
70386,21179,2010-08-25,Assembly,"SB 1116 Huff  Third Reading Urgency  By BROWNLEY",75,0,0,0,75
70386,21384,2010-08-26,Senate,"Unfinished Business SB1116 Huff Urgency Clause",37,0,0,0,37
70387,8680,2010-04-20,Senate,"Do pass, but re-refer to the Committee on Appropriations",1,3,1,0,5
70387,8681,2010-04-20,Senate,"Set, first hearing.  Failed passage in Committee.  Reconsideration granted",4,0,1,0,5
70388,4156,2010-04-20,Senate,"Do pass as amended, and re-refer to the Committee on Appropriations",5,0,0,0,5
70388,9691,2010-06-28,Senate,"Senate 3rd Reading SB1118 Ashburn Urgency Clause",29,3,7,0,39
70389,634,2010-04-14,Senate,"Do pass, but re-refer to the Committee on Business, Professions and Economic Development.",9,0,0,0,9
70389,635,2010-04-19,Senate,"Do pass as amended, and re-refer to the Committee on Appropriations.",7,0,2,0,9
70389,636,2010-05-10,Senate,"Senate 3rd Reading SB1119 Wright",30,0,8,0,38
70389,9532,2010-06-22,Assembly,"Do pass and be re-referred to the Committee on Business, Professions and Consumer Protection",19,0,0,0,19
70389,9728,2010-06-29,Assembly,"Do pass and be re-referred to the Committee on Appropriations",6,2,3,0,11
70389,19328,2010-08-04,Assembly,"Do pass",16,0,0,0,16
70389,21663,2010-08-30,Assembly,"SB 1119 Wright  Senate Third Reading  By ARAMBULA",51,10,0,0,61
70389,21664,2010-08-30,Senate,"W/O REF. TO FILE SB1119 Wright Concurrence",33,4,0,0,37
70390,8078,2010-04-05,Senate,"Do pass, but re-refer to the Committee on Appropriations",2,4,1,0,7
70390,8079,2010-04-05,Senate,"Set, first hearing.  Failed passage in Committee.  Reconsideration granted",6,0,1,0,7
70391,27268,2010-04-19,Senate,"Senate 3rd Reading SCR74 Correa",33,0,0,0,33
70391,27269,2010-05-06,Assembly,"Be adopted, to Consent Calendar",10,0,0,0,10
70391,27270,2010-05-06,Assembly,"Be adopted, as amended, to Consent Calendar",10,0,0,0,10
70391,27271,2010-05-13,Assembly,"SCR 74 Correa  Consent Calendar Second Day  Regular Session",76,0,0,0,76
70391,27272,2010-05-17,Senate,"Unfinished Business SCR74 Correa",33,0,0,0,33
70392,5252,2010-04-26,Senate,"Senate 3rd Reading SCR75 Hollingsworth",34,0,5,0,39
70392,9324,2010-06-21,Assembly,"From committee:  Be adopted.  To third reading",7,0,2,0,9
70392,10160,2010-07-01,Assembly,"SCR 75 Hollingsworth  Senate Third Reading  By ANDERSON",74,0,5,0,79
70633,902,2010-04-13,Assembly,"Do pass as amended and be re-referred to the Committee on Appropriations.",8,4,1,0,13
70633,903,2010-05-28,Assembly,"Do pass as amended.",12,5,0,0,17
70633,904,2010-06-02,Assembly,"AB 2049 ARAMBULA  Assembly Third Reading",38,31,10,0,79
70633,905,2010-06-03,Assembly,"AB 2049 ARAMBULA  Motion to Reconsider",45,26,8,0,79
70633,906,2010-06-03,Assembly,"AB 2049 ARAMBULA  Assembly Third Reading",35,33,11,0,79
70635,3960,2010-04-21,Assembly,"Do pass and re-refer to Committee on Appropriations with recommendation:  To Consent Calendar",21,0,1,0,22
70635,3961,2010-05-05,Assembly,"Do pass, to Consent Calendar",17,0,0,0,17
70635,3962,2010-05-13,Assembly,"AB 2051 TRAN  Consent Calendar Second Day  Regular Session",76,0,3,0,79
70635,9335,2010-06-22,Senate,"Do pass, but re-refer to the Committee on Appropriations",8,0,3,0,11
70635,19587,2010-08-02,Senate,"Placed on Appropriations Suspense file",10,0,0,0,10
70636,4072,2010-04-20,Assembly,"Do pass and re-refer to Committee on Appropriations with recommendation:  To Consent Calendar",11,0,0,0,11
70636,4073,2010-05-05,Assembly,"Do pass",12,5,0,0,17
70636,4074,2010-05-13,Assembly,"AB 2052 HAYASHI  Assembly Third Reading",56,20,3,0,79
70637,831,2010-04-06,Assembly,"Do pass.",2,4,1,0,7
70637,832,2010-04-06,Assembly,"Set second hearing.  Failed passage.  Reconsideration granted.",7,0,0,0,7
70637,833,2010-04-20,Assembly,"Do pass.",2,4,1,0,7
70638,315,2010-03-23,Assembly,"Do pass and be re-referred to the Committee on Appropriations.",6,0,1,0,7
70639,299,2010-04-21,Assembly,"Do pass and be re-referred to the Committee on Appropriations.",8,4,0,0,12
70639,300,2010-05-28,Assembly,"Do pass.",12,5,0,0,17
70639,301,2010-06-02,Assembly,"AB 2055 DE LA TORRE  Assembly Third Reading",48,26,5,0,79
70639,9485,2010-06-23,Senate,"Do pass, but re-refer to the Committee on Appropriations",4,1,1,0,6
70639,19394,2010-08-02,Senate,"Do pass",8,1,0,0,9
70639,21320,2010-08-23,Senate,"Assembly 3rd Reading AB2055 De La Torre By Kehoe",23,12,0,0,35
70639,21321,2010-08-24,Assembly,"AB 2055 DE LA TORRE  Concurrence in Senate Amendments",53,24,0,0,77
70640,2505,2010-05-04,Assembly,"Do pass",2,4,1,0,7
70640,2506,2010-05-04,Assembly,"Set first hearing.  Failed passage.  Reconsideration granted",7,0,0,0,7
70641,3352,2010-03-23,Assembly,"Do pass and be re-referred to the Committee on Appropriations",2,4,1,0,7
70641,3353,2010-03-23,Assembly,"Set first hearing.  Failed passage.  Reconsideration granted",7,0,0,0,7
70641,3354,2010-04-20,Assembly,"Do pass and be re-referred to the Committee on Appropriations",3,4,0,0,7
70642,3330,2010-03-24,Assembly,"Do pass as amended and be re-referred to the Committee on Appropriations",8,4,0,0,12
70642,3331,2010-05-28,Assembly,"Do pass as amended",12,5,0,0,17
70642,3332,2010-06-03,Assembly,"AB 2058 BLOCK  Assembly Third Reading",58,19,2,0,79
70642,9294,2010-06-23,Senate,"Do pass, but re-refer to the Committee on Appropriations",4,1,1,0,6
70642,10602,2010-07-15,Senate,"Placed on Appropriations Suspense file",8,0,2,0,10
70642,20159,2010-08-12,Senate,"Do pass",7,4,0,0,11
70642,20652,2010-08-20,Senate,"Assembly 3rd Reading AB2058 Block By Negrete McLeod",24,8,0,0,32
70642,21363,2010-08-26,Assembly,"AB 2058 BLOCK  Concurrence in Senate Amendments",61,16,0,0,77
70643,4339,2010-04-13,Assembly,"Do pass as amended",7,3,0,0,10
70643,4340,2010-05-13,Assembly,"AB 2059 CALDERON  Assembly Third Reading",48,28,3,0,79
70643,9226,2010-06-22,Senate,"Do pass as amended",4,0,1,0,5
70643,21640,2010-08-26,Senate,"From Committee:  Amendments returned with further amendements to 	Senate floor for consideration",4,0,0,0,4
70643,21806,2010-08-31,Senate,"Assembly 3rd Reading AB2059 Charles Calderon By Calderon",24,12,0,0,36
70643,21807,2010-08-31,Assembly,"AB 2059 CALDERON  Concurrence in Senate Amendments",48,26,0,0,74
70644,2285,2010-05-10,Assembly,"Do pass as amended and be re-referred to the Committee on Appropriations",9,0,0,0,9
70644,2286,2010-05-28,Assembly,"Do pass",17,0,0,0,17
70644,2287,2010-06-01,Assembly,"AB 2060 CALDERON  Assembly Third Reading",77,0,2,0,79
70644,10303,2010-07-01,Senate,"Do pass as amended, and re-refer to the Committee on Appropriations",4,1,0,0,5
70644,19485,2010-08-02,Senate,"Placed on Appropriations Suspense file",10,0,0,0,10
70644,20182,2010-08-12,Senate,"Do pass as amended",11,0,0,0,11
70644,21188,2010-08-25,Senate,"Assembly 3rd Reading AB2060 Charles Calderon By Padilla",26,0,0,0,26
70644,21391,2010-08-26,Assembly,"AB 2060 CALDERON  Concurrence in Senate Amendments",77,0,0,0,77
70645,4721,2010-04-19,Assembly,"Do pass and be re-referred to the Committee on Appropriations",13,2,0,0,15
70647,3188,2010-03-23,Assembly,"Do pass and re-refer to Committee on Appropriations with recommendation:  To Consent Calendar",12,0,0,0,12
70647,3189,2010-04-14,Assembly,"Do pass, to Consent Calendar",15,0,2,0,17
70647,3190,2010-04-22,Assembly,"AB 2063 HUFFMAN  Consent Calendar Second Day  Regular Session",74,0,5,0,79
70647,6182,2010-06-09,Senate,"Do pass as amended, and re-refer to the Committee on Governmental Organization",5,2,2,0,9
70647,9218,2010-06-22,Senate,"Do pass, but re-refer to the Committee on Appropriations",7,0,4,0,11
70647,10719,2010-07-15,Senate,"Placed on Appropriations Suspense file",8,0,2,0,10
70647,20228,2010-08-12,Senate,"Do pass as amended",7,4,0,0,11
70647,20519,2010-08-19,Senate,"Assembly 3rd Reading AB2063 Huffman By Harman",23,11,0,0,34
70647,20806,2010-08-23,Assembly,"AB 2063 HUFFMAN  Concurrence in Senate Amendments",61,14,0,0,75
70648,1987,2010-05-05,Assembly,"Do pass as amended and be re-referred to the Committee on Appropriations",8,1,0,0,9
70648,1988,2010-05-28,Assembly,"Do pass",12,5,0,0,17
70648,1989,2010-06-01,Assembly,"AB 2064 PEREZ, J.  Third Reading Urgency",60,16,3,0,79
70648,10208,2010-06-29,Senate,"Do pass as amended, and re-refer to the Committee on Appropriations",6,2,1,0,9
70648,19358,2010-08-02,Senate,"Placed on Appropriations Suspense file",10,0,0,0,10
70648,20156,2010-08-12,Senate,"Do pass",7,4,0,0,11
70649,4779,2010-04-28,Assembly,"Do pass as amended and be re-referred to the Committee on Local Government",8,0,1,0,9
70649,4780,2010-05-05,Assembly,"Do pass and be re-referred to the Committee on Appropriations",9,0,0,0,9
70650,3677,2010-04-13,Assembly,"Do pass as amended and be re-referred to the Committee on Insurance",7,2,1,0,10
70651,5496,2010-04-05,Assembly,"Do pass",14,0,0,0,14
70651,5497,2010-04-12,Assembly,"AB 2067 LOWENTHAL  Assembly Third Reading",73,0,6,0,79
70651,8760,2010-06-15,Senate,"Do pass as amended",8,0,1,0,9
70651,10315,2010-07-01,Senate,"Special Consent #29 AB2067 Bonnie Lowenthal",34,0,5,0,39
70651,19366,2010-08-02,Assembly,"AB 2067 LOWENTHAL  Concurrence in Senate Amendments",75,0,0,0,75
70652,346,2010-03-23,Assembly,"Do pass and be re-referred to the Committee on Appropriations.",4,0,3,0,7
70652,347,2010-04-14,Assembly,"Do pass as amended.",10,5,2,0,17
70652,348,2010-05-03,Assembly,"AB 2068 HILL  Assembly Third Reading",45,29,5,0,79
70652,8901,2010-06-15,Senate,"Do pass, but re-refer to the Committee on Appropriations",5,2,0,0,7
70652,20571,2010-08-19,Senate,"Assembly 3rd Reading AB2068 Hill By Ducheny",23,10,0,0,33
70652,20904,2010-08-23,Assembly,"AB 2068 HILL  Concurrence in Senate Amendments",45,29,0,0,74
70653,802,2010-04-21,Assembly,"Do pass as amended and be re-referred to the Committee on Appropriations.",9,0,0,0,9
70656,1445,2010-04-20,Assembly,"Do pass as amended",10,4,5,0,19
70656,1446,2010-04-29,Assembly,"AB 2072 MENDOZA  Assembly Third Reading",57,7,15,0,79
70656,9506,2010-06-23,Senate,"Do pass as amended",5,1,3,0,9
70656,19916,2010-08-09,Senate,"Placed on Appropriations Suspense file",10,0,0,0,10
70656,19992,2010-08-12,Senate,"Do pass as amended",10,1,0,0,11
70656,21018,2010-08-24,Senate,"Assembly 3rd Reading AB2072 Mendoza By Alquist",23,11,0,0,34
70656,21573,2010-08-27,Assembly,"AB 2072 MENDOZA  Concurrence in Senate Amendments",72,2,0,0,74
70657,3686,2010-03-23,Assembly,"Do pass and be re-referred to the Committee on Appropriations",19,0,0,0,19
70659,4183,2010-04-06,Assembly,"Do pass and be re-referred to the Committee on Appropriations",11,0,0,0,11
70659,4184,2010-04-14,Assembly,"Do pass, to Consent Calendar",15,0,2,0,17
70659,4185,2010-04-22,Assembly,"AB 2075 HIGHER ED.  Consent Calendar Second Day  Regular Session",74,0,5,0,79
70659,8776,2010-06-16,Senate,"Do pass, but re-refer to the Committee on Appropriations Recommend Consent",6,0,3,0,9
70659,19200,2010-08-02,Senate,"Consent Calendar 2nd AB2075 Committee on HIGHER ED. (Portanti",33,0,0,0,33
70660,4459,2010-04-13,Assembly,"Do pass and be re-referred to the Committee on Appropriations",11,0,0,0,11
70660,4460,2010-04-28,Assembly,"Do pass",14,1,2,0,17
70660,4461,2010-05-13,Assembly,"AB 2076 SALAS  Assembly Third Reading",71,5,3,0,79
70660,9100,2010-06-21,Senate,"Do pass as amended, and re-refer to the Committee on Appropriations",5,1,3,0,9
70660,21202,2010-08-25,Senate,"Assembly 3rd Reading AB2076 Salas By Ducheny",26,8,0,0,34
70660,21608,2010-08-27,Assembly,"AB 2076 SALAS  Concurrence in Senate Amendments",56,17,0,0,73
70661,1279,2010-04-20,Assembly,"Do pass as amended and be re-referred to the Committee on Appropriations.",9,1,1,0,11
70661,1280,2010-05-05,Assembly,"Do pass as amended.",16,0,1,0,17
70661,1281,2010-05-13,Assembly,"AB 2077 SOLORIO  Assembly Third Reading",68,5,6,0,79
70661,8689,2010-06-14,Senate,"Do pass as amended, and re-refer to the Committee on Appropriations",4,2,3,0,9
70661,8690,2010-06-14,Senate,"Set, first hearing.  Failed passage in Committee.  Reconsideration granted",7,0,2,0,9
70661,9713,2010-06-28,Senate,"Do pass, but re-refer to the Committee on Appropriations",7,0,2,0,9
70661,19729,2010-08-09,Senate,"Placed on Appropriations Suspense file",10,0,0,0,10
70661,20034,2010-08-12,Senate,"Do pass",11,0,0,0,11
70661,20960,2010-08-24,Senate,"Assembly 3rd Reading AB2077 Solorio By Emmerson",35,0,0,0,35
70661,21531,2010-08-27,Assembly,"AB 2077 SOLORIO  Concurrence in Senate Amendments",75,0,0,0,75
70662,1787,2010-04-19,Assembly,"Do pass as amended and be re-referred to the Committee on Appropriations",6,3,0,0,9
70662,1788,2010-05-06,Assembly,"AB 2078 CALDERON  Assembly Third Reading",46,28,5,0,79
70662,10336,2010-07-01,Senate,"Do pass, but re-refer to the Committee on Appropriations",3,2,0,0,5
70662,19527,2010-08-02,Senate,"Do pass",6,3,0,0,9
70663,2529,2010-04-06,Assembly,"Do pass as amended and be re-referred to the Committee on Arts, Entertain, Sports, Tourism, & Internet Media",9,0,0,0,9
70663,2530,2010-04-20,Assembly,"Do pass and be re-referred to the Committee on Appropriations",6,1,1,0,8
70663,2531,2010-05-28,Assembly,"Do pass as amended",12,5,0,0,17
70663,2532,2010-06-02,Assembly,"AB 2079 TORLAKSON  Assembly Third Reading",58,17,4,0,79
70663,10211,2010-06-30,Senate,"Do pass as amended, and re-refer to the Committee on Appropriations",5,2,2,0,9
70663,19488,2010-08-02,Senate,"Placed on Appropriations Suspense file",10,0,0,0,10
70663,20193,2010-08-12,Senate,"Do pass as amended",6,5,0,0,11
70663,21311,2010-08-24,Senate,"Assembly 3rd Reading AB2079 Torlakson By Strickland",24,11,0,0,35
70663,21506,2010-08-26,Assembly,"AB 2079 TORLAKSON  Concurrence in Senate Amendments",56,19,0,0,75
70664,3594,2010-04-14,Assembly,"Do pass and be re-referred to the Committee on Appropriations",6,2,1,0,9
70664,3595,2010-04-28,Assembly,"Do pass",10,5,2,0,17
70664,3596,2010-05-06,Assembly,"AB 2080 HERNANDEZ  Assembly Third Reading",47,27,5,0,79
70664,10228,2010-06-30,Senate,"Do pass, but re-refer to the Committee on Appropriations",3,2,0,0,5
70664,19876,2010-08-11,Senate,"Assembly 3rd Reading AB2080 Hernandez By DeSaulnier",22,12,0,0,34
70665,1490,2010-04-21,Assembly,"Do pass, to Consent Calendar",9,0,0,0,9
70665,1491,2010-04-29,Assembly,"AB 2081 ED.  Consent Calendar Second Day  Regular Session",74,0,5,0,79
70665,9038,2010-06-16,Senate,"Do pass and be placed on the Consent Calendar",6,0,3,0,9
70665,9548,2010-06-24,Senate,"Consent Calendar 2nd AB2081 Committee on ED. (Brownley)",31,0,8,0,39
70665,9624,2010-06-28,Assembly,"AB 2081 ED.  Concurrence in Senate Amendments By BROWNLEY",78,0,1,0,79
70666,2169,2010-04-21,Assembly,"Do pass and re-refer to Committee on Appropriations with recommendation:  To Consent Calendar",9,0,0,0,9
70666,2170,2010-05-28,Assembly,"Do pass as amended",17,0,0,0,17
70666,2171,2010-06-02,Assembly,"AB 2082 ED.  Assembly Third Reading  By BROWNLEY",75,0,4,0,79
70667,4198,2010-04-07,Assembly,"Do pass as amended and re-refer to Committee on Appropriations with recommendation:  To Consent Calendar",8,0,1,0,9
70667,4199,2010-05-05,Assembly,"Do pass, to Consent Calendar",17,0,0,0,17
70667,4200,2010-05-13,Assembly,"AB 2083 ED.  Consent Calendar Second Day  Regular Session",76,0,3,0,79
70667,9364,2010-06-23,Senate,"Do pass, but re-refer to the Committee on Appropriations Recommend Consent",6,0,3,0,9
70667,19410,2010-08-05,Senate,"Consent Calendar 2nd AB2083 Committee on ED. (Brownley)",33,0,0,0,33
70668,3233,2010-04-13,Assembly,"Do pass as amended and be re-referred to the Committee on Appropriations",4,2,0,0,6
70668,3234,2010-05-19,Assembly,"Do pass",11,5,1,0,17
70668,3235,2010-05-24,Assembly,"AB 2084 BROWNLEY  Assembly Third Reading",44,26,9,0,79
70668,9391,2010-06-23,Senate,"Do pass, but re-refer to the Committee on Appropriations",6,1,2,0,9
70668,10597,2010-07-15,Senate,"Placed on Appropriations Suspense file",8,0,2,0,10
70668,20100,2010-08-12,Senate,"Do pass as amended",7,4,0,0,11
70668,21372,2010-08-24,Senate,"Assembly 3rd Reading AB2084 Brownley Reconsider",35,0,0,0,35
70668,21686,2010-08-30,Senate,"Assembly 3rd Reading AB2084 Brownley By Alquist",22,15,0,0,37
70668,21782,2010-08-31,Assembly,"AB 2084 BROWNLEY  Concurrence in Senate Amendments",50,27,0,0,77
70668,22026,2010-08-24,Senate,"Assembly 3rd Reading AB2084 Brownley By Alquist",19,15,0,0,34
70670,1049,2010-04-20,Assembly,"Do pass as amended and be re-referred to the Committee on Appropriations.",9,0,0,0,9
70670,1050,2010-05-12,Assembly,"Do pass.",16,0,1,0,17
70670,1051,2010-05-24,Assembly,"AB 2086 COTO  Assembly Third Reading",70,1,8,0,79
70670,9517,2010-06-23,Senate,"Do pass as amended, and re-refer to the Committee on Appropriations",7,0,2,0,9
70670,20925,2010-08-23,Senate,"Assembly 3rd Reading AB2086 Coto By Alquist",36,0,0,0,36
70670,21043,2010-08-24,Assembly,"AB 2086 COTO  Concurrence in Senate Amendments",75,0,0,0,75
70671,1263,2010-04-13,Assembly,"Do pass as amended and be re-referred to the Committee on Appropriations.",9,0,0,0,9
70671,1264,2010-05-28,Assembly,"Do pass.",12,5,0,0,17
70671,1265,2010-06-01,Assembly,"AB 2087 TORRES  Assembly Third Reading",74,0,5,0,79
70671,9476,2010-06-22,Senate,"Do pass, but re-refer to the Committee on Appropriations",4,0,1,0,5
70671,10497,2010-07-15,Senate,"Placed on Appropriations Suspense file",8,0,2,0,10
70671,20275,2010-08-12,Senate,"Do pass",11,0,0,0,11
70671,20915,2010-08-23,Senate,"Assembly 3rd Reading AB2087 Torres By Denham",36,0,0,0,36
70672,4079,2010-05-04,Assembly,"Do pass, to Consent Calendar",7,0,0,0,7
70672,4080,2010-05-13,Assembly,"AB 2088 ADAMS  Consent Calendar Second Day  Regular Session",76,0,3,0,79
70672,9018,2010-06-15,Senate,"Do pass",5,0,0,0,5
70672,21627,2010-08-26,Senate,"Assembly 3rd Reading AB2088 Adams By Liu",37,0,0,0,37
70673,2900,2010-04-21,Assembly,"Do pass as amended and re-refer to Committee on Appropriations with recommendation:  To Consent Calendar",9,0,0,0,9
70673,2901,2010-05-28,Assembly,"Do pass",17,0,0,0,17
70673,2902,2010-06-02,Assembly,"AB 2089 COTO  Assembly Third Reading",76,0,3,0,79
70673,10330,2010-06-30,Senate,"Do pass, but re-refer to the Committee on Appropriations Recommend Consent",8,0,1,0,9
70673,19510,2010-08-02,Senate,"Placed on Appropriations Suspense file",10,0,0,0,10
70673,20172,2010-08-12,Senate,"Do pass",11,0,0,0,11
70673,20581,2010-08-19,Senate,"Assembly 3rd Reading AB2089 Coto By Cedillo",35,0,0,0,35
70673,20907,2010-08-23,Assembly,"AB 2089 COTO  Concurrence in Senate Amendments",77,0,0,0,77
70675,3778,2010-05-05,Assembly,"Do pass, to Consent Calendar",19,0,3,0,22
70675,3779,2010-05-13,Assembly,"AB 2091 CONWAY  Consent Calendar Second Day  Regular Session",76,0,3,0,79
70675,9272,2010-06-22,Senate,"Do pass as amended",4,0,1,0,5
70675,19580,2010-08-02,Senate,"Assembly 3rd Reading AB2091 Conway By Ashburn",34,0,0,0,34
70675,19845,2010-08-09,Assembly,"AB 2091 CONWAY  Concurrence in Senate Amendments",78,0,0,0,78
70676,1204,2010-04-13,Assembly,"Do pass as amended and be re-referred to the Committee on Appropriations.",8,3,2,0,13
70676,1205,2010-05-12,Assembly,"Do pass.",11,5,1,0,17
70676,1206,2010-06-02,Assembly,"AB 2092 HUFFMAN  Assembly Third Reading",47,26,6,0,79
70676,9428,2010-06-22,Senate,"Do pass as amended, and re-refer to the Committee on Appropriations",5,3,1,0,9
70676,20065,2010-08-12,Senate,"Do pass as amended",7,3,0,0,10
70676,21558,2010-08-25,Senate,"Assembly 3rd Reading AB2092 Huffman Reconsider",34,0,0,0,34
70676,21873,2010-08-31,Senate,"Assembly 3rd Reading AB2092 Huffman By Pavley",16,21,0,0,37
70676,22022,2010-08-25,Senate,"Assembly 3rd Reading AB2092 Huffman By Pavley",20,14,0,0,34
70677,1309,2010-04-06,Assembly,"Do pass and be re-referred to the Committee on Appropriations.",15,0,4,0,19
70677,1310,2010-05-28,Assembly,"Do pass as amended.",13,4,0,0,17
70677,1311,2010-06-02,Assembly,"AB 2093 PEREZ, V.M.  Assembly Third Reading",73,1,5,0,79
70677,10258,2010-06-30,Senate,"Do pass as amended, and re-refer to the Committee on Appropriations",7,1,1,0,9
70677,19180,2010-08-02,Senate,"Do pass as amended",7,1,0,0,8
70677,21048,2010-08-24,Senate,"Assembly 3rd Reading AB2093 V. Manuel Perez By Emmerson",24,9,0,0,33
70677,21193,2010-08-25,Assembly,"AB 2093 PEREZ, V.M.  Concurrence in Senate Amendments",74,2,0,0,76
70679,252,2010-04-21,Assembly,"Do pass as amended and re-refer to Committee on Appropriations with recommendation:  To Consent Calendar.",9,0,0,0,9
70681,2025,2010-04-19,Assembly,"Do pass and re-refer to Committee on Appropriations with recommendation:  To Consent Calendar",13,0,1,0,14
70681,2026,2010-05-28,Assembly,"Do pass as amended",17,0,0,0,17
70681,2027,2010-06-02,Assembly,"AB 2097 MILLER  Assembly Third Reading",76,0,3,0,79
70681,10142,2010-06-29,Senate,"Do pass, but re-refer to the Committee on Appropriations",9,0,0,0,9
70681,19653,2010-08-02,Senate,"Placed on Appropriations Suspense file",10,0,0,0,10
70682,4409,2010-04-19,Assembly,"Amend, and re-refer to the Committee on Transportation",12,0,2,0,14
70682,9793,2010-06-28,Assembly,"Do pass",12,0,2,0,14
70682,21563,2010-08-27,Assembly,"AB 2098 MILLER  Third Reading Urgency",73,0,0,0,73
70682,21646,2010-08-30,Senate,"Do pass",11,0,0,0,11
70682,21647,2010-08-30,Senate,"W/O REF. TO FILE AB2098 Miller Urgency Clause",37,0,0,0,37
70683,1106,2010-04-19,Assembly,"Do pass and be re-referred to the Committee on Appropriations.",11,0,3,0,14
70685,3633,2010-04-06,Assembly,"Do pass and be re-referred to the Committee on Judiciary",6,0,1,0,7
70685,3634,2010-04-13,Assembly,"Do pass as amended and re-refer to Committee on Appropriations with recommendation:  To Consent Calendar",10,0,0,0,10
70685,3635,2010-04-28,Assembly,"Do pass, to Consent Calendar",15,0,2,0,17
70685,3636,2010-05-06,Assembly,"AB 2101 FONG  Consent Calendar Second Day  Regular Session",74,0,5,0,79
70685,8739,2010-06-15,Senate,"Do pass, but re-refer to the Committee on Judiciary Recommend Consent",5,0,0,0,5
70685,10318,2010-06-29,Senate,"Do pass",7,0,0,0,7
70685,19643,2010-08-09,Senate,"Special Consent #30 AB2101 Fong",34,0,0,0,34
70685,19973,2010-08-12,Assembly,"AB 2101 FONG  Concurrence in Senate Amendments",78,0,0,0,78
70686,3083,2010-05-04,Assembly,"Do pass",7,0,0,0,7
70686,3084,2010-05-20,Assembly,"AB 2102 LIEU  Assembly Third Reading",69,0,10,0,79
70687,1659,2010-04-28,Assembly,"Do pass",9,0,0,0,9
70687,1660,2010-05-06,Assembly,"AB 2103 HILL  Assembly Third Reading",74,0,5,0,79
70687,6512,2010-06-09,Senate,"Do pass and be placed on the Consent Calendar",3,0,2,0,5
70687,20252,2010-08-11,Senate,"Assembly 3rd Reading AB2103 Hill By DeSaulnier",31,0,0,0,31
70687,20305,2010-08-16,Assembly,"AB 2103 HILL  Concurrence in Senate Amendments",75,0,0,0,75
70688,2775,2010-04-20,Assembly,"Do pass and be re-referred to the Committee on Appropriations",7,4,0,0,11
70688,2776,2010-05-28,Assembly,"Do pass as amended",11,6,0,0,17
70688,2777,2010-06-02,Assembly,"AB 2104 HAYASHI  Assembly Third Reading",44,29,6,0,79
70688,9237,2010-06-21,Senate,"Do pass as amended, and re-refer to the Committee on Appropriations",0,3,6,0,9
70688,9238,2010-06-21,Senate,"Set, first hearing.  Failed passage in Committee.  Reconsideration granted",7,0,2,0,9
70688,9750,2010-06-28,Senate,"Do pass, but re-refer to the Committee on Appropriations",7,0,2,0,9
70688,20534,2010-08-18,Senate,"Assembly 3rd Reading AB2104 Hayashi By Yee",33,0,0,0,33
70688,20535,2010-08-19,Assembly,"AB 2104 HAYASHI  Concurrence in Senate Amendments",77,0,0,0,77
70694,529,2010-05-04,Assembly,"Do pass as amended.",13,6,0,0,19
70694,530,2010-05-19,Assembly,"Do pass.",11,5,1,0,17
70694,531,2010-06-02,Assembly,"AB 2110 DE LA TORRE  Assembly Third Reading",47,27,5,0,79
70694,10188,2010-06-30,Senate,"Do pass, but re-refer to the Committee on Appropriations",5,2,2,0,9
70695,1256,2010-04-06,Assembly,"Do pass as amended and be re-referred to the Committee on Insurance.",11,0,0,0,11
70695,1257,2010-04-21,Assembly,"Do pass as amended and re-refer to Committee on Appropriations with recommendation:  To Consent Calendar.",12,0,0,0,12
70695,1258,2010-05-19,Assembly,"Do pass, to Consent Calendar.",16,0,1,0,17
70695,1259,2010-05-28,Assembly,"AB 2111 SMYTH  Consent Calendar Second Day",63,0,16,0,79
70695,9231,2010-06-21,Senate,"Do pass, but re-refer to the Committee on Judiciary",6,0,3,0,9
70695,9965,2010-06-29,Senate,"Do pass, but re-refer to the Committee on Appropriations",4,0,1,0,5
70695,20683,2010-08-20,Senate,"Assembly 3rd Reading AB2111 Smyth By Emmerson",31,0,0,0,31
70695,20792,2010-08-23,Assembly,"AB 2111 SMYTH  Concurrence in Senate Amendments",76,0,0,0,76
70698,2085,2010-04-06,Assembly,"Do pass and be re-referred to the Committee on Appropriations",4,1,1,0,6
70698,2086,2010-04-21,Assembly,"Do pass as amended",12,5,0,0,17
70698,2087,2010-05-03,Assembly,"AB 2114 BEALL  Assembly Third Reading",51,20,8,0,79
70698,9303,2010-06-22,Senate,"Do pass as amended, and re-refer to the Committee on Appropriations",4,0,1,0,5
70698,19243,2010-08-02,Senate,"Placed on Appropriations Suspense file",10,0,0,0,10
70699,94,2010-04-06,Assembly,"Do pass and be re-referred to the Committee on Appropriations.",2,4,1,0,7
70699,95,2010-04-06,Assembly,"Set second hearing.  Failed passage.  Reconsideration granted.",7,0,0,0,7
70700,3669,2010-04-20,Assembly,"Do pass and re-refer to Committee on Appropriations with recommendation:  To Consent Calendar",10,0,0,0,10
70700,3670,2010-04-28,Assembly,"Do pass, to Consent Calendar",15,0,2,0,17
70700,3671,2010-05-06,Assembly,"AB 2116 EVANS  Consent Calendar Second Day  Regular Session",74,0,5,0,79
70700,6585,2010-06-10,Senate,"Do pass, but re-refer to the Committee on Appropriations Recommend Consent",5,0,0,0,5
70700,19604,2010-08-05,Senate,"Consent Calendar 2nd AB2116 Evans",33,0,0,0,33
70700,19720,2010-08-09,Assembly,"AB 2116 EVANS  Concurrence in Senate Amendments",77,0,0,0,77
70701,3733,2010-03-23,Assembly,"Do pass and be re-referred to the Committee on Appropriations",3,7,0,0,10
70701,3734,2010-03-23,Assembly,"Set first hearing.  Failed passage.  Reconsideration granted",10,0,0,0,10
70702,4468,2010-04-05,Assembly,"Do pass, to Consent Calendar",14,0,0,0,14
70702,4469,2010-04-12,Assembly,"AB 2118 HERNANDEZ  Consent Calendar Second Day  Regular Session",71,0,8,0,79
70702,9967,2010-06-29,Senate,"Do pass as amended",1,3,1,0,5
70702,9968,2010-06-29,Senate,"Set, first hearing.  Failed passage in Committee.  Reconsideration granted",4,0,1,0,5
70703,4365,2010-03-23,Assembly,"Do pass, to Consent Calendar",10,0,0,0,10
70703,4366,2010-04-05,Assembly,"AB 2119 TRAN  Consent Calendar Second Day  Regular Session",76,0,3,0,79
70703,8808,2010-06-10,Senate,"Do pass and be placed on the Consent Calendar",5,0,0,0,5
70703,9000,2010-06-17,Senate,"Consent Calendar 2nd AB2119 Tran",33,0,6,0,39
70704,687,2010-04-28,Assembly,"Do pass as amended.",9,0,0,0,9
70704,688,2010-05-24,Assembly,"AB 2120 SILVA  Assembly Third Reading",68,0,11,0,79
70704,8712,2010-06-15,Senate,"Do pass as amended. To Consent Calendar",5,0,0,0,5
70704,9402,2010-06-24,Senate,"Consent Calendar 2nd AB2120 Silva",31,0,8,0,39
70704,10030,2010-07-01,Assembly,"AB 2120 SILVA  Concurrence in Senate Amendments",76,0,3,0,79
70705,3284,2010-04-19,Assembly,"Do pass as amended and be re-referred to the Committee on Appropriations",13,0,1,0,14
70705,3285,2010-05-28,Assembly,"Do pass as amended",17,0,0,0,17
70705,3286,2010-06-02,Assembly,"AB 2121 HARKEY  Assembly Third Reading",76,0,3,0,79
70706,560,2010-04-14,Assembly,"Do pass and be re-referred to the Committee on Environmental Safety and Toxic Materials.",8,0,0,0,8
70706,561,2010-04-20,Assembly,"Do pass and re-refer to Committee on Appropriations with recommendation:  To Consent Calendar.",8,0,1,0,9
70706,562,2010-05-28,Assembly,"Do pass.",17,0,0,0,17
70706,563,2010-06-01,Assembly,"AB 2122 MENDOZA  Assembly Third Reading",75,0,4,0,79
70706,8782,2010-06-15,Senate,"Do pass, but re-refer to the Committee on Environmental Quality Recommend Consent",5,0,0,0,5
70706,9904,2010-06-28,Senate,"Do pass, but re-refer to the Committee on Appropriations Recommend Consent",7,0,0,0,7
70706,10991,2010-07-15,Senate,"Placed on Appropriations Suspense file",8,0,2,0,10
70706,20273,2010-08-12,Senate,"Do pass as amended",11,0,0,0,11
70706,20912,2010-08-23,Senate,"Assembly 3rd Reading AB2122 Mendoza By Simitian",36,0,0,0,36
70706,21035,2010-08-24,Assembly,"AB 2122 MENDOZA  Concurrence in Senate Amendments",78,0,0,0,78
70709,198,2010-04-12,Assembly,"Do pass as amended and be re-referred to the Committee on Appropriations.",6,3,0,0,9
70709,199,2010-05-28,Assembly,"Do pass.",12,5,0,0,17
70709,200,2010-06-02,Assembly,"AB 2125 RUSKIN  Assembly Third Reading",51,24,4,0,79
70709,10182,2010-06-29,Senate,"Do pass as amended, and re-refer to the Committee on Appropriations",6,3,0,0,9
70709,19450,2010-08-02,Senate,"Placed on Appropriations Suspense file",10,0,0,0,10
70709,20270,2010-08-12,Senate,"Do pass as amended",7,4,0,0,11
70709,20905,2010-08-23,Senate,"Assembly 3rd Reading AB2125 Ruskin By Lowenthal",22,11,0,0,33
70709,21031,2010-08-24,Assembly,"AB 2125 RUSKIN  Concurrence in Senate Amendments",53,25,0,0,78
70710,4737,2010-05-10,Assembly,"Do pass as amended and be re-referred to the Committee on Appropriations",9,0,0,0,9
70712,4025,2010-05-04,Assembly,"Do pass",11,0,0,0,11
70712,4026,2010-05-06,Assembly,"AB 2128 GAINES  Assembly Third Reading",73,0,6,0,79
70712,9754,2010-06-28,Senate,"Do pass as amended",5,2,2,0,9
70712,20823,2010-08-23,Senate,"Assembly 3rd Reading AB2128 Gaines By Calderon",30,3,0,0,33
70712,20990,2010-08-24,Assembly,"AB 2128 GAINES  Concurrence in Senate Amendments",78,0,0,0,78
70713,2095,2010-03-23,Assembly,"Do pass and re-refer to Committee on Appropriations with recommendation:  To Consent Calendar",6,0,0,0,6
70713,2096,2010-04-14,Assembly,"Do pass, to Consent Calendar",15,0,2,0,17
70713,2097,2010-04-22,Assembly,"AB 2129 BASS  Consent Calendar Second Day  Regular Session",74,0,5,0,79
70713,9330,2010-06-22,Senate,"Do pass, but re-refer to the Committee on Appropriations",4,1,0,0,5
70713,19209,2010-08-02,Senate,"Placed on Appropriations Suspense file",10,0,0,0,10
70713,20090,2010-08-12,Senate,"Do pass",7,4,0,0,11
70713,20499,2010-08-18,Senate,"Assembly 3rd Reading AB2129 Bass By Liu",26,7,0,0,33
70713,20596,2010-08-19,Assembly,"AB 2129 BASS  Concurrence in Senate Amendments",76,0,0,0,76
70714,3185,2010-04-06,Assembly,"Do pass and be re-referred to the Committee on Appropriations",11,0,0,0,11
70714,3186,2010-05-28,Assembly,"Do pass",17,0,0,0,17
70714,3187,2010-06-03,Assembly,"AB 2130 HUBER  Assembly Third Reading",74,3,2,0,79
70714,10112,2010-06-28,Senate,"Do pass, but re-refer to the Committee on Rules",7,0,2,0,9
70714,20945,2010-08-23,Senate,"Assembly 3rd Reading AB2130 Huber By DeSaulnier",36,0,0,0,36
70714,21060,2010-08-24,Assembly,"AB 2130 HUBER  Concurrence in Senate Amendments",75,1,0,0,76
70716,3175,2010-04-19,Assembly,"Do pass as amended and be re-referred to the Committee on Appropriations",13,0,2,0,15
70716,3176,2010-05-28,Assembly,"Do pass as amended",11,5,1,0,17
70716,3177,2010-06-02,Assembly,"AB 2132 CARTER  Assembly Third Reading",66,8,5,0,79
70716,10300,2010-06-29,Senate,"Do pass, but re-refer to the Committee on Appropriations",8,1,2,0,11
70716,10604,2010-07-15,Senate,"Placed on Appropriations Suspense file",8,0,2,0,10
70717,394,2010-04-21,Assembly,"Do pass and be re-referred to the Committee on Appropriations.",8,0,1,0,9
70717,395,2010-05-19,Assembly,"Do pass.",16,0,1,0,17
70717,396,2010-05-24,Assembly,"AB 2133 NIELLO  Assembly Third Reading",69,1,9,0,79
70717,9821,2010-06-30,Senate,"Do pass, but re-refer to the Committee on Appropriations",4,0,1,0,5
70717,21225,2010-08-24,Senate,"Assembly 3rd Reading AB2133 Niello By Liu",32,3,0,0,35
70717,21226,2010-08-25,Assembly,"AB 2133 NIELLO  Concurrence in Senate Amendments",74,0,0,0,74
70718,3491,2010-04-12,Assembly,"Do pass as amended and be re-referred to the Committee on Appropriations",20,0,2,0,22
70718,3492,2010-04-28,Assembly,"Do pass, to Consent Calendar",15,0,2,0,17
70718,3493,2010-05-06,Assembly,"AB 2134 CHESBRO  Consent Calendar Second Day  Regular Session",74,0,5,0,79
70718,6382,2010-06-09,Senate,"Do pass, but re-refer to the Committee on Appropriations Recommend Consent",6,0,5,0,11
70718,19077,2010-08-02,Senate,"Consent Calendar 2nd AB2134 Chesbro",33,0,0,0,33
70720,861,2010-05-05,Assembly,"Do pass as amended and be re-referred to the Committee on Revenue and Taxation.",8,0,1,0,9
70720,862,2010-05-10,Assembly,"Do pass and be re-referred to the Committee on Appropriations.",9,0,0,0,9
70720,863,2010-05-19,Assembly,"Do pass.",16,0,1,0,17
70720,864,2010-05-24,Assembly,"AB 2136 PEREZ, V.M.  Third Reading Urgency",69,0,10,0,79
70720,9510,2010-06-23,Senate,"Do pass, but re-refer to the Committee on Appropriations",3,0,2,0,5
70720,10571,2010-07-15,Senate,"Placed on Appropriations Suspense file",8,0,2,0,10
70720,20283,2010-08-12,Senate,"Do pass as amended",11,0,0,0,11
70720,21037,2010-08-24,Senate,"Assembly 3rd Reading AB2136 V. Manuel Perez Urgency Clause",34,0,0,0,34
70720,21386,2010-08-26,Assembly,"Senate amendments be concurred in",7,0,0,0,7
70720,21597,2010-08-27,Assembly,"AB 2136 PEREZ, V.M.  Concurrence in Senate Amendments",75,0,0,0,75
70721,792,2010-04-28,Assembly,"Do pass as amended.",5,2,1,0,8
70721,793,2010-05-10,Assembly,"AB 2137 CHESBRO  Assembly Third Reading",47,19,13,0,79
70721,8719,2010-06-15,Senate,"Do pass, but re-refer to the Committee on Environmental Quality",4,1,0,0,5
70721,9596,2010-06-28,Senate,"Do pass",7,0,0,0,7
70722,5035,2010-04-12,Assembly,"Do pass as amended and be re-referred to the Committee on Appropriations",6,3,0,0,9
70723,772,2010-04-13,Assembly,"Do pass and be re-referred to the Committee on Natural Resources.",6,3,0,0,9
70723,773,2010-04-19,Assembly,"Do pass and be re-referred to the Committee on Appropriations.",6,3,0,0,9
70723,774,2010-05-28,Assembly,"Do pass as amended.",12,5,0,0,17
70723,775,2010-06-03,Assembly,"AB 2139 CHESBRO  Assembly Third Reading",30,31,18,0,79
70727,3024,2010-04-13,Assembly,"Do pass as amended and be re-referred to the Committee on Appropriations",7,0,2,0,9
70727,3025,2010-05-28,Assembly,"Do pass as amended",17,0,0,0,17
70727,3026,2010-06-03,Assembly,"AB 2143 GILMORE  Assembly Third Reading",75,1,3,0,79
70728,2454,2010-04-12,Assembly,"Do pass as amended and be re-referred to the Committee on Appropriations",13,0,1,0,14
70728,2455,2010-04-28,Assembly,"Do pass, to Consent Calendar",15,0,2,0,17
70728,2456,2010-05-06,Assembly,"AB 2144 GILMORE  Consent Calendar Second Day  Regular Session",74,0,5,0,79
70728,10255,2010-06-29,Senate,"Do pass, but re-refer to the Committee on Appropriations Recommend Consent",8,0,1,0,9
70728,19407,2010-08-05,Senate,"Consent Calendar 2nd AB2144 Gilmore",33,0,0,0,33
70728,19622,2010-08-09,Assembly,"AB 2144 GILMORE  Concurrence in Senate Amendments",77,0,0,0,77
70729,868,2010-04-13,Assembly,"Do pass and be re-referred to the Committee on Appropriations.",9,0,1,0,10
70729,869,2010-05-28,Assembly,"Do pass as amended.",17,0,0,0,17
70729,870,2010-06-02,Assembly,"AB 2145 AMMIANO  Assembly Third Reading",74,1,4,0,79
70729,9209,2010-06-22,Senate,"Do pass as amended",4,0,1,0,5
70729,20422,2010-08-18,Senate,"Assembly 3rd Reading AB2145 Ammiano By Price",34,0,0,0,34
70729,20645,2010-08-20,Assembly,"AB 2145 AMMIANO  Concurrence in Senate Amendments",75,0,0,0,75
70731,2403,2010-04-12,Assembly,"Do pass as amended and be re-referred to the Committee on Appropriations",11,1,2,0,14
70731,2404,2010-04-28,Assembly,"Do pass as amended",12,2,3,0,17
70731,2405,2010-05-06,Assembly,"AB 2147 PEREZ, V.M.  Assembly Third Reading",58,16,5,0,79
70731,10135,2010-06-29,Senate,"Do pass as amended, and re-refer to the Committee on Appropriations",7,1,1,0,9
70731,21198,2010-08-25,Senate,"Assembly 3rd Reading AB2147 V. Manuel Perez By Wolk",25,10,0,0,35
70731,21408,2010-08-26,Assembly,"AB 2147 PEREZ, V.M.  Concurrence in Senate Amendments",53,20,0,0,73
70732,771,2010-05-10,Assembly,"Do pass as amended and be re-referred to the Committee on Appropriations.",9,0,0,0,9
70733,2224,2010-05-05,Assembly,"Do pass",6,0,0,0,6
70733,2225,2010-05-10,Assembly,"AB 2149 FURUTANI  Assembly Third Reading",69,1,9,0,79
70735,254,2010-04-21,Assembly,"Do pass and be re-referred to the Committee on Appropriations.",12,0,0,0,12
70735,255,2010-05-12,Assembly,"Do pass, to Consent Calendar.",16,0,1,0,17
70735,256,2010-05-20,Assembly,"AB 2151 TORRES  Consent Calendar Second Day  Regular Session",72,0,7,0,79
70735,9908,2010-06-30,Senate,"Do pass as amended, and re-refer to the Committee on Appropriations",9,1,1,0,11
70735,19846,2010-08-09,Senate,"Placed on Appropriations Suspense file",10,0,0,0,10
70735,20035,2010-08-12,Senate,"Do pass",10,1,0,0,11
70735,20599,2010-08-19,Senate,"Assembly 3rd Reading AB2151 Torres Reconsider",35,0,0,0,35
70735,21050,2010-08-24,Senate,"Assembly 3rd Reading AB2151 Torres By Correa",31,0,0,0,31
70735,21407,2010-08-26,Assembly,"Senate amendments be concurred in",11,0,0,0,11
70735,21607,2010-08-27,Assembly,"AB 2151 TORRES  Concurrence in Senate Amendments",74,0,0,0,74
70736,3750,2010-04-06,Assembly,"Do pass",2,4,1,0,7
70736,3751,2010-04-06,Assembly,"Set second hearing.  Failed passage.  Reconsideration granted",7,0,0,0,7
70736,3752,2010-04-20,Assembly,"Do pass as amended and be re-referred to the Committee on Appropriations",3,4,0,0,7
70737,5004,2010-04-13,Assembly,"Do pass and be re-referred to the Committee on Appropriations",18,1,0,0,19
70737,5005,2010-04-21,Assembly,"Do pass",17,0,0,0,17
70737,5006,2010-04-26,Assembly,"AB 2153 LIEU  Assembly Third Reading",68,2,9,0,79
70737,8886,2010-06-16,Senate,"Do pass, but re-refer to the Committee on Appropriations",7,1,1,0,9
70737,9752,2010-06-28,Senate,"Do pass",7,3,1,0,11
70738,5407,2010-04-06,Assembly,"Do pass",5,2,0,0,7
70738,5408,2010-04-08,Assembly,"AB 2154 SOLORIO  Assembly Third Reading",49,19,11,0,79
70738,8928,2010-06-15,Senate,"Do pass",3,2,0,0,5
70738,21959,2010-08-26,Senate,"Assembly 3rd Reading AB2154 Solorio By Hancock",21,13,0,0,34
70740,3299,2010-04-13,Assembly,"Do pass and be re-referred to the Committee on Elections and Redistricting",9,0,0,0,9
70740,3300,2010-04-20,Assembly,"Do pass and re-refer to Committee on Appropriations with recommendation:  To Consent Calendar",7,0,0,0,7
70740,3301,2010-04-28,Assembly,"Do pass, to Consent Calendar",15,0,2,0,17
70740,3302,2010-05-06,Assembly,"AB 2156 EVANS  Consent Calendar Second Day  Regular Session",74,0,5,0,79
70740,9208,2010-06-22,Senate,"Do pass, but re-refer to the Committee on Appropriations",4,0,1,0,5
70740,19784,2010-08-09,Senate,"Assembly 3rd Reading AB2156 Evans By Denham",33,0,0,0,33
70740,19880,2010-08-12,Assembly,"AB 2156 EVANS  Concurrence in Senate Amendments",78,0,0,0,78
70741,468,2010-03-23,Assembly,"Do pass as amended and re-refer to Committee on Appropriations with recommendation:  To Consent Calendar.",7,0,0,0,7
70741,469,2010-05-19,Assembly,"Do pass, to Consent Calendar.",16,0,1,0,17
70741,470,2010-05-28,Assembly,"AB 2157 LOGUE  Consent Calendar Second Day  Regular Session",63,0,16,0,79
70741,10009,2010-06-29,Senate,"Do pass",2,4,1,0,7
70742,405,2010-05-03,Assembly,"Do pass and be re-referred to the Committee on Appropriations.",11,0,1,0,12
70742,406,2010-06-01,Assembly,"AB 2158 HAGMAN  Assembly Third Reading",77,0,2,0,79
70742,9509,2010-06-22,Senate,"Do pass and be placed on the Consent Calendar",4,0,1,0,5
70742,10334,2010-07-01,Senate,"Consent Calendar 2nd AB2158 Hagman",34,0,5,0,39
70743,5301,2010-04-06,Assembly,"Do pass as amended and be re-referred to the Committee on Appropriations",9,0,0,0,9
70744,4931,2010-03-24,Assembly,"Do pass as amended and re-refer to Committee on Appropriations with recommendation:  To Consent Calendar",9,0,0,0,9
70744,4932,2010-04-14,Assembly,"Do pass, to Consent Calendar",15,0,2,0,17
70744,4933,2010-04-22,Assembly,"AB 2160 BASS  Consent Calendar Second Day  Regular Session",74,0,5,0,79
70744,8879,2010-06-16,Senate,"Do pass, but re-refer to the Committee on Appropriations Recommend Consent",6,0,3,0,9
70744,19203,2010-08-02,Senate,"Consent Calendar 2nd AB2160 Bass",33,0,0,0,33
70745,804,2010-04-07,Assembly,"Do pass as amended and be re-referred to the Committee on Appropriations.",8,0,1,0,9
70747,3145,2010-04-19,Assembly,"Do pass as amended and be re-referred to the Committee on Appropriations",9,0,0,0,9
70747,3146,2010-05-12,Assembly,"Do pass as amended, to Consent Calendar",15,0,2,0,17
70747,3147,2010-05-20,Assembly,"AB 2163 MENDOZA  Third Reading Urgency",57,7,15,0,79
70747,9961,2010-06-29,Senate,"Do pass, but re-refer to the Committee on Appropriations",6,0,3,0,9
70747,20513,2010-08-18,Senate,"Assembly 3rd Reading AB2163 Mendoza Urgency Clause",32,1,0,0,33
70748,2820,2010-05-04,Assembly,"Do pass",5,0,2,0,7
70748,2821,2010-05-20,Assembly,"AB 2164 NORBY  Assembly Third Reading",60,2,17,0,79
70749,506,2010-04-19,Assembly,"Do pass and be re-referred to the Committee on Appropriations.",3,5,1,0,9
70750,4919,2010-04-14,Assembly,"Do pass",8,0,1,0,9
70750,4920,2010-04-22,Assembly,"AB 2166 CHESBRO  Assembly Third Reading",68,1,10,0,79
70750,9769,2010-06-30,Senate,"Do pass as amended",5,0,0,0,5
70750,20464,2010-08-18,Senate,"Assembly 3rd Reading AB2166 Chesbro By Aanestad",32,0,0,0,32
70750,20546,2010-08-19,Assembly,"AB 2166 CHESBRO  Concurrence in Senate Amendments",72,4,0,0,76
70751,4164,2010-04-13,Assembly,"Do pass as amended and be re-referred to the Committee on Appropriations",11,0,0,0,11
70751,4165,2010-05-05,Assembly,"Do pass",17,0,0,0,17
70751,4166,2010-05-17,Assembly,"AB 2167 NAVA  Assembly Third Reading",68,1,10,0,79
70751,9770,2010-06-28,Senate,"Do pass, but re-refer to the Committee on Appropriations",6,1,2,0,9
70751,9771,2010-06-28,Senate,"Do pass, but re-refer to the Committee on Appropriations",6,1,2,0,9
70751,20502,2010-08-18,Senate,"Assembly 3rd Reading AB2167 Nava By Negrete McLeod",32,2,0,0,34
70751,20606,2010-08-19,Assembly,"AB 2167 NAVA  Concurrence in Senate Amendments",73,2,0,0,75
70754,5365,2010-04-20,Assembly,"Do pass as amended and be re-referred to the Committee on Appropriations",12,6,1,0,19
70755,4902,2010-04-19,Assembly,"Do pass as amended and be re-referred to the Committee on Appropriations",6,3,0,0,9
70756,5405,2010-04-21,Assembly,"Do pass and be re-referred to the Committee on Appropriations",6,2,1,0,9
70757,1938,2010-04-13,Assembly,"Do pass and be re-referred to the Committee on Appropriations",15,2,2,0,19
70757,1939,2010-05-28,Assembly,"Do pass as amended",17,0,0,0,17
70757,1940,2010-06-02,Assembly,"AB 2173 BEALL  Assembly Third Reading",65,8,6,0,79
70757,9498,2010-06-23,Senate,"Do pass, but re-refer to the Committee on Public Safety",5,0,4,0,9
70757,9935,2010-06-29,Senate,"Do pass as amended, and re-refer to the Committee on Appropriations",7,0,0,0,7
70757,19433,2010-08-02,Senate,"Placed on Appropriations Suspense file",10,0,0,0,10
70757,20227,2010-08-12,Senate,"Do pass as amended",8,3,0,0,11
70757,20974,2010-08-24,Senate,"Assembly 3rd Reading AB2173 Beall By Emmerson",23,7,0,0,30
70757,21281,2010-08-25,Assembly,"AB 2173 BEALL  Concurrence in Senate Amendments",65,10,0,0,75
70760,4768,2010-04-20,Assembly,"Do pass as amended and be re-referred to the Committee on Appropriations",5,3,1,0,9
70761,2408,2010-04-12,Assembly,"Do pass as amended and be re-referred to the Committee on Appropriations",8,0,1,0,9
70761,2409,2010-04-28,Assembly,"Do pass as amended, to Consent Calendar",15,0,2,0,17
70761,2410,2010-05-06,Assembly,"AB 2177 BEALL  Consent Calendar Second Day  Regular Session",74,0,5,0,79
70761,6108,2010-06-09,Senate,"Do pass, but re-refer to the Committee on Appropriations",3,0,2,0,5
70761,10096,2010-07-01,Senate,"Special Consent #29 AB2177 Beall",34,0,5,0,39
70761,19374,2010-08-02,Assembly,"AB 2177 BEALL  Concurrence in Senate Amendments",76,0,0,0,76
70762,1172,2010-04-07,Assembly,"Do pass as amended and re-refer to Committee on Appropriations with recommendation:  To Consent Calendar.",8,0,1,0,9
70762,1173,2010-05-28,Assembly,"Do pass as amended.",17,0,0,0,17
70762,1174,2010-06-02,Assembly,"AB 2178 TORLAKSON  Assembly Third Reading",76,0,3,0,79
70762,9863,2010-06-30,Senate,"Do pass, but re-refer to the Committee on Appropriations Recommend Consent",8,0,1,0,9
70762,19177,2010-08-02,Senate,"Do pass",10,0,0,0,10
70762,20811,2010-08-23,Senate,"Assembly 3rd Reading AB2178 Torlakson By Simitian",35,1,0,0,36
70762,20964,2010-08-24,Assembly,"AB 2178 TORLAKSON  Concurrence in Senate Amendments",77,0,0,0,77
70763,4398,2010-04-12,Assembly,"Do pass and be re-referred to the Committee on Local Government to Consent Calendar",9,0,0,0,9
70763,4399,2010-04-21,Assembly,"Do pass and be re-referred to the Committee on Appropriations to Consent Calendar",8,0,1,0,9
70763,4400,2010-05-05,Assembly,"Do pass, to Consent Calendar",17,0,0,0,17
70763,4401,2010-05-13,Assembly,"AB 2179 MONNING  Consent Calendar Second Day  Regular Session",76,0,3,0,79
70763,4402,2010-06-09,Senate,"Do pass, but re-refer to the Committee on Appropriations",7,0,2,0,9
70763,20391,2010-08-12,Senate,"Assembly 3rd Reading AB2179 Monning By Lowenthal",33,0,0,0,33
70765,4269,2010-04-20,Assembly,"Do pass and be re-referred to the Committee on Appropriations",9,2,0,0,11
70765,4270,2010-05-05,Assembly,"Do pass as amended",14,0,3,0,17
70765,4271,2010-05-17,Assembly,"AB 2181 HAGMAN  Assembly Third Reading",61,3,15,0,79
70765,9379,2010-06-22,Senate,"Do pass, but re-refer to the Committee on Appropriations",7,0,4,0,11
70765,19915,2010-08-11,Senate,"Assembly 3rd Reading AB2181 Hagman By Harman",29,3,0,0,32
70766,558,2010-04-28,Assembly,"Do pass.",8,1,0,0,9
70766,559,2010-05-06,Assembly,"AB 2182 HUFFMAN  Assembly Third Reading",65,6,8,0,79
70766,10146,2010-06-30,Senate,"Do pass as amended",4,1,0,0,5
70766,21168,2010-08-24,Senate,"Assembly 3rd Reading AB2182 Huffman By Liu",22,10,0,0,32
70766,21169,2010-08-25,Assembly,"AB 2182 HUFFMAN  Concurrence in Senate Amendments",61,16,0,0,77
70768,4424,2010-05-05,Assembly,"Do pass",9,0,0,0,9
70768,4425,2010-05-13,Assembly,"AB 2184 ARAMBULA  Assembly Third Reading",76,0,3,0,79
70768,9034,2010-06-16,Senate,"Do pass and be placed on the Consent Calendar",4,0,1,0,5
70768,9544,2010-06-24,Senate,"Consent Calendar 2nd AB2184 Arambula",31,0,8,0,39
70770,1234,2010-04-13,Assembly,"Do pass and be re-referred to the Committee on Appropriations.",5,0,2,0,7
70770,1235,2010-05-05,Assembly,"Do pass.",12,5,0,0,17
70771,3543,2010-04-07,Assembly,"Do pass and be re-referred to the Committee on Appropriations",4,2,0,0,6
70771,3544,2010-04-21,Assembly,"Do pass",12,5,0,0,17
70771,3545,2010-05-06,Assembly,"AB 2187 ARAMBULA  Assembly Third Reading",42,28,9,0,79
70771,9327,2010-06-23,Senate,"Do pass, but re-refer to the Committee on Appropriations",4,1,1,0,6
70771,21069,2010-08-24,Senate,"Assembly 3rd Reading AB2187 Arambula By DeSaulnier",21,14,0,0,35
70771,21283,2010-08-25,Assembly,"AB 2187 ARAMBULA  Concurrence in Senate Amendments",47,27,0,0,74
70772,3336,2010-04-07,Assembly,"Do pass as amended and be re-referred to the Committee on Appropriations",9,2,1,0,12
70772,3337,2010-05-28,Assembly,"Do pass as amended",12,5,0,0,17
70772,3338,2010-06-02,Assembly,"AB 2188 BRADFORD  Assembly Third Reading",55,17,7,0,79
70772,9261,2010-06-23,Senate,"Do pass, but re-refer to the Committee on Appropriations",5,0,1,0,6
70772,21044,2010-08-24,Senate,"Assembly 3rd Reading AB2188 Bradford Urgency Clause",35,0,0,0,35
70772,21398,2010-08-26,Assembly,"AB 2188 BRADFORD  Concurrence- Urgency Added",75,0,0,0,75
70774,1145,2010-04-06,Assembly,"Do pass as amended and re-refer to Committee on Appropriations with recommendation:  To Consent Calendar.",9,0,1,0,10
70774,1146,2010-04-21,Assembly,"Do pass, to Consent Calendar.",17,0,0,0,17
70774,1147,2010-04-29,Assembly,"AB 2190 BLOCK  Consent Calendar Second Day  Regular Session",74,0,5,0,79
70775,3835,2010-04-06,Assembly,"Do pass and be re-referred to the Committee on Appropriations",10,0,1,0,11
70775,3836,2010-04-21,Assembly,"Do pass, to Consent Calendar",17,0,0,0,17
70775,3837,2010-04-29,Assembly,"AB 2191 EMMERSON  Consent Calendar Second Day  Regular Session",74,0,5,0,79
70775,8704,2010-06-14,Senate,"Do pass as amended, and re-refer to the Committee on Appropriations",7,0,2,0,9
70775,19537,2010-08-02,Senate,"Do pass",10,0,0,0,10
70775,20691,2010-08-20,Senate,"Assembly 3rd Reading AB2191 Emmerson By Emmerson",31,0,0,0,31
70775,20797,2010-08-23,Assembly,"AB 2191  Concurrence in Senate Amendments By HAYASHI",76,0,0,0,76
70777,2602,2010-04-21,Assembly,"Do pass and be re-referred to the Committee on Appropriations",21,0,1,0,22
70777,2603,2010-05-28,Assembly,"Do pass",12,5,0,0,17
70777,2604,2010-06-01,Assembly,"AB 2193 HALL  Assembly Third Reading",72,3,4,0,79
70777,10260,2010-06-29,Senate,"Do pass, but re-refer to the Committee on Appropriations",7,1,3,0,11
70777,19722,2010-08-02,Senate,"Placed on Appropriations Suspense file",10,0,0,0,10
70777,20295,2010-08-12,Senate,"Do pass",11,0,0,0,11
70777,20872,2010-08-23,Senate,"Assembly 3rd Reading AB2193 Hall By Florez",33,1,0,0,34
70779,4120,2010-04-19,Assembly,"Do pass as amended and be re-referred to the Committee on Appropriations",9,0,0,0,9
70779,4121,2010-05-05,Assembly,"Do pass, to Consent Calendar",17,0,0,0,17
70779,4122,2010-05-13,Assembly,"AB 2195 SILVA  Consent Calendar Second Day  Regular Session",76,0,3,0,79
70779,9345,2010-06-23,Senate,"Do pass, but re-refer to the Committee on Appropriations Recommend Consent",3,0,2,0,5
70779,19456,2010-08-05,Senate,"Consent Calendar 2nd AB2195 Silva",33,0,0,0,33
70780,3897,2010-04-20,Assembly,"Do pass and be re-referred to the Committee on Appropriations",3,3,0,0,6
70781,4873,2010-04-21,Assembly,"Do pass and be re-referred to the Committee on Appropriations",21,1,0,0,22
70782,5261,2010-04-21,Assembly,"Do pass and be re-referred to the Committee on Appropriations",22,0,0,0,22
70783,4497,2010-04-06,Assembly,"Do pass and be re-referred to the Committee on Appropriations",4,0,3,0,7
70783,4498,2010-04-21,Assembly,"Do pass",17,0,0,0,17
70783,4499,2010-04-26,Assembly,"AB 2199 LOWENTHAL  Assembly Third Reading",70,1,8,0,79
70783,9413,2010-06-23,Senate,"Do pass, but re-refer to the Committee on Appropriations",7,0,2,0,9
70783,10651,2010-07-15,Senate,"Placed on Appropriations Suspense file",8,0,2,0,10
70783,20278,2010-08-12,Senate,"Do pass as amended",11,0,0,0,11
70783,20896,2010-08-23,Senate,"Assembly 3rd Reading AB2199 Bonnie Lowenthal By Ashburn",36,0,0,0,36
70783,21148,2010-08-25,Assembly,"AB 2199 LOWENTHAL  Concurrence in Senate Amendments",75,1,0,0,76
70784,4859,2010-04-06,Assembly,"Do pass and be re-referred to the Committee on Appropriations",7,0,0,0,7
70785,3857,2010-04-21,Assembly,"Do pass and be re-referred to the Committee on Appropriations",22,0,0,0,22
70785,3858,2010-05-05,Assembly,"Do pass",17,0,0,0,17
70785,3859,2010-05-13,Assembly,"AB 2201 COTO  Assembly Third Reading",74,0,5,0,79
70785,9787,2010-06-29,Senate,"Do pass, but re-refer to the Committee on Appropriations Recommend Consent",8,0,3,0,11
70785,20644,2010-08-18,Senate,"Assembly 3rd Reading AB2201 Coto By Price",34,0,0,0,34
70786,2553,2010-04-27,Assembly,"Do pass as amended",9,0,0,0,9
70786,2554,2010-05-10,Assembly,"AB 2202 PEREZ, V.M.  Assembly Third Reading",69,1,9,0,79
70786,8691,2010-06-14,Senate,"Do pass, but re-refer to the Committee on Natural Resources and Water",6,0,1,0,7
70786,9633,2010-06-28,Senate,"Do pass",7,2,2,0,11
70786,21757,2010-08-30,Senate,"W/O REF. TO FILE AB2202 V. Manuel Perez",27,10,0,0,37
70786,21866,2010-08-31,Assembly,"AB 2202 PEREZ, V.M.  Concurrence in Senate Amendments",69,4,0,0,73
70787,5352,2010-04-06,Assembly,"Do pass as amended and be re-referred to the Committee on Appropriations",9,0,0,0,9
70787,5353,2010-04-21,Assembly,"Do pass, to Consent Calendar",17,0,0,0,17
70787,5354,2010-04-29,Assembly,"AB 2203 SOLORIO  Consent Calendar Second Day  Regular Session",74,0,5,0,79
70787,10024,2010-06-30,Senate,"Do pass, but re-refer to the Committee on Appropriations Recommend Consent",8,0,1,0,9
70787,19792,2010-08-11,Senate,"Assembly 3rd Reading AB2203 Solorio By Correa",33,0,0,0,33
70787,20306,2010-08-16,Assembly,"AB 2203 SOLORIO  Concurrence in Senate Amendments",74,0,0,0,74
70788,3944,2010-03-23,Assembly,"Do pass and be re-referred to the Committee on Appropriations",4,2,0,0,6
70788,3945,2010-04-14,Assembly,"Do pass",11,5,1,0,17
70788,3946,2010-04-22,Assembly,"AB 2204 BEALL  Assembly Third Reading",45,27,7,0,79
70788,9336,2010-06-22,Senate,"Do pass, but re-refer to the Committee on Appropriations",3,2,0,0,5
70788,10508,2010-07-15,Senate,"Placed on Appropriations Suspense file",8,0,2,0,10
70790,662,2010-04-13,Assembly,"Do pass and be re-referred to the Committee on Appropriations.",5,0,1,0,6
70791,3742,2010-04-19,Assembly,"Do pass and be re-referred to the Committee on Appropriations",10,4,1,0,15
70791,3743,2010-05-05,Assembly,"Do pass",12,5,0,0,17
70791,3744,2010-05-13,Assembly,"AB 2207 FONG  Assembly Third Reading",48,28,3,0,79
70791,10075,2010-06-29,Senate,"Do pass, but re-refer to the Committee on Appropriations",5,4,2,0,11
70792,5429,2010-04-20,Assembly,"Do pass as amended and be re-referred to the Committee on Appropriations",7,0,0,0,7
70794,1682,2010-04-13,Assembly,"Do pass and re-refer to Committee on Appropriations with recommendation:  To Consent Calendar",7,0,0,0,7
70794,1683,2010-04-28,Assembly,"Do pass, to Consent Calendar",15,0,2,0,17
70794,1684,2010-05-06,Assembly,"AB 2210 FUENTES  Consent Calendar Second Day  Regular Session",74,0,5,0,79
70794,10122,2010-06-29,Senate,"Do pass as amended, and re-refer to the Committee on Appropriations",7,0,0,0,7
70794,19487,2010-08-02,Senate,"Do pass",8,0,0,0,8
70794,20496,2010-08-18,Senate,"Special Consent #31 AB2210 Fuentes",34,0,0,0,34
70794,20664,2010-08-20,Assembly,"AB 2210 FUENTES  Concurrence in Senate Amendments",77,0,0,0,77
70795,2640,2010-04-07,Assembly,"Do pass as amended and re-refer to Committee on Appropriations with recommendation:  To Consent Calendar",8,0,1,0,9
70795,2641,2010-05-28,Assembly,"Do pass",17,0,0,0,17
70795,2642,2010-06-01,Assembly,"AB 2211 FUENTES  Third Reading Urgency",77,0,2,0,79
70795,10279,2010-06-30,Senate,"Do pass as amended, and re-refer to the Committee on Appropriations",7,0,2,0,9
70795,19481,2010-08-02,Senate,"Placed on Appropriations Suspense file",10,0,0,0,10
70795,20140,2010-08-12,Senate,"Do pass as amended",11,0,0,0,11
70795,20857,2010-08-23,Senate,"Assembly 3rd Reading AB2211 Fuentes Urgency Clause",35,0,0,0,35
70795,21918,2010-08-31,Assembly,"AB 2211 Fuentes  Concurrence in Senate Amendments",77,0,0,0,77
70796,1843,2010-04-13,Assembly,"Do pass and be re-referred to the Committee on Appropriations",7,0,0,0,7
70796,1844,2010-04-28,Assembly,"Do pass, to Consent Calendar",15,0,2,0,17
70796,1845,2010-05-06,Assembly,"AB 2212 FUENTES  Consent Calendar Second Day  Regular Session",74,0,5,0,79
70796,9196,2010-06-22,Senate,"Do pass, but re-refer to the Committee on Appropriations",7,0,0,0,7
70796,19766,2010-08-11,Senate,"Assembly 3rd Reading AB2212 Fuentes By DeSaulnier",33,0,0,0,33
70796,20379,2010-08-17,Assembly,"AB 2212 FUENTES  Concurrence in Senate Amendments",76,0,0,0,76
70797,776,2010-04-19,Assembly,"Do pass as amended and be re-referred to the Committee on Appropriations.",12,0,3,0,15
70797,777,2010-05-12,Assembly,"Do pass, to Consent Calendar.",16,0,1,0,17
70797,778,2010-05-20,Assembly,"AB 2213 FUENTES  Consent Calendar Second Day  Regular Session",72,0,7,0,79
70797,8740,2010-06-15,Senate,"Do pass as amended, and re-refer to the Committee on Appropriations",8,0,3,0,11
70797,19668,2010-08-02,Senate,"Do pass",8,0,0,0,8
70797,20779,2010-08-20,Senate,"Assembly 3rd Reading AB2213 Fuentes By Padilla",28,0,0,0,28
70797,20927,2010-08-23,Assembly,"AB 2213 FUENTES  Concurrence in Senate Amendments",76,0,0,0,76
70798,2166,2010-04-19,Assembly,"Do pass as amended and be re-referred to the Committee on Appropriations",6,3,0,0,9
70798,2167,2010-05-28,Assembly,"Do pass",12,5,0,0,17
70798,2168,2010-06-01,Assembly,"AB 2214 FUENTES  Assembly Third Reading",51,26,2,0,79
70798,19757,2010-08-10,Senate,"Do pass, but re-refer to the Committee on Appropriations",6,3,0,0,9
70798,20061,2010-08-12,Senate,"Placed on Appropriations Suspense file",11,0,0,0,11
70798,20062,2010-08-12,Senate,"Do pass",7,4,0,0,11
70799,2460,2010-04-21,Assembly,"Do pass as amended and be re-referred to the Committee on Appropriations",21,0,1,0,22
70799,2461,2010-05-28,Assembly,"Do pass as amended",17,0,0,0,17
70799,2462,2010-06-02,Assembly,"AB 2215 FUENTES  Assembly Third Reading",73,0,6,0,79
70799,9833,2010-06-29,Senate,"Do pass, but re-refer to the Committee on Appropriations Recommend Consent",8,0,3,0,11
70799,19679,2010-08-02,Senate,"Do pass as amended",9,0,0,0,9
70799,20687,2010-08-18,Senate,"Assembly 3rd Reading AB2215 Fuentes By Price",32,0,0,0,32
70799,20688,2010-08-19,Assembly,"AB 2215 FUENTES  Concurrence in Senate Amendments",76,0,0,0,76
70800,779,2010-04-06,Assembly,"Do pass and be re-referred to the Committee on Judiciary.",11,0,0,0,11
70800,780,2010-05-04,Assembly,"Do pass as amended.",10,0,0,0,10
70800,781,2010-05-20,Assembly,"AB 2216 FUENTES  Assembly Third Reading",71,0,8,0,79
70800,10256,2010-06-29,Senate,"Do pass, but re-refer to the Committee on Rules",3,1,1,0,5
70800,19226,2010-08-02,Senate,"Do pass",7,0,0,0,7
70800,21343,2010-08-25,Senate,"Assembly 3rd Reading AB2216 Fuentes Reconsider",35,0,0,0,35
70800,21344,2010-08-25,Senate,"Assembly 3rd Reading AB2216 Fuentes By Padilla",32,0,0,0,32
70800,21773,2010-08-31,Senate,"Assembly 3rd Reading AB2216 Fuentes By Padilla",17,9,0,0,26
70801,4581,2010-04-06,Assembly,"Do pass and be re-referred to the Committee on Appropriations",9,0,1,0,10
70801,4582,2010-04-14,Assembly,"Do pass, to Consent Calendar",15,0,2,0,17
70801,4583,2010-04-26,Assembly,"AB 2217 FUENTES  Assembly Third Reading",71,0,8,0,79
70801,9815,2010-06-29,Senate,"Do pass, but re-refer to the Committee on Appropriations",7,0,0,0,7
70801,20004,2010-08-12,Senate,"Assembly 3rd Reading AB2217 Fuentes By Padilla",32,0,0,0,32
70801,20358,2010-08-17,Assembly,"AB 2217 FUENTES  Concurrence in Senate Amendments",76,0,0,0,76
70802,2357,2010-04-20,Assembly,"Do pass and be re-referred to the Committee on Appropriations",7,0,0,0,7
70802,2358,2010-05-05,Assembly,"Do pass",12,5,0,0,17
70802,2359,2010-05-20,Assembly,"AB 2218 FUENTES  Assembly Third Reading",62,5,12,0,79
70802,9131,2010-06-22,Senate,"Do pass, but re-refer to the Committee on Appropriations",6,0,1,0,7
70802,9132,2010-06-22,Senate,"Do pass, but re-refer to the Committee on Appropriations",6,0,1,0,7
70802,19945,2010-08-12,Senate,"Assembly 3rd Reading AB2218 Fuentes By Leno",25,8,0,0,33
70802,20362,2010-08-17,Assembly,"AB 2218 FUENTES  Concurrence in Senate Amendments",64,7,0,0,71
70804,5132,2010-04-21,Assembly,"Do pass and be re-referred to the Committee on Appropriations",20,1,1,0,22
70805,3306,2010-04-20,Assembly,"Do pass as amended and be re-referred to the Committee on Appropriations",18,0,1,0,19
70805,3307,2010-05-12,Assembly,"Do pass",16,0,1,0,17
70805,3308,2010-05-20,Assembly,"AB 2221 BEALL  Assembly Third Reading",69,0,10,0,79
70805,9547,2010-06-23,Senate,"Do pass as amended, and re-refer to the Committee on Appropriations",6,0,3,0,9
70805,19773,2010-08-09,Senate,"Placed on Appropriations Suspense file",10,0,0,0,10
70806,5147,2010-04-20,Assembly,"Do pass and be re-referred to the Committee on Appropriations",7,0,0,0,7
70807,971,2010-04-13,Assembly,"Do pass as amended and be re-referred to the Committee on Appropriations.",8,4,1,0,13
70807,972,2010-05-28,Assembly,"Do pass as amended.",12,5,0,0,17
70807,973,2010-06-03,Assembly,"AB 2223 NAVA  Assembly Third Reading",47,29,3,0,79
70807,9222,2010-06-22,Senate,"Do pass as amended, and re-refer to the Committee on Appropriations",4,3,2,0,9
70807,9223,2010-06-22,Senate,"Set, first hearing.  Failed passage in Committee.  Reconsideration granted",7,0,2,0,9
70807,9744,2010-06-29,Senate,"Do pass, but re-refer to the Committee on Appropriations",3,4,2,0,9
70808,1266,2010-04-13,Assembly,"Do pass and re-refer to Committee on Appropriations with recommendation:  To Consent Calendar.",9,0,0,0,9
70808,1267,2010-04-28,Assembly,"Do pass, to Consent Calendar.",15,0,2,0,17
70808,1268,2010-05-06,Assembly,"AB 2224 RUSKIN  Consent Calendar Second Day  Regular Session",74,0,5,0,79
70813,737,2010-04-13,Assembly,"Do pass and be re-referred to the Committee on Human Services.",7,0,0,0,7
70813,738,2010-04-27,Assembly,"Do pass as amended.",6,0,0,0,6
70813,739,2010-05-19,Assembly,"Do pass, to Consent Calendar.",16,0,1,0,17
70813,740,2010-06-02,Assembly,"AB 2229 BROWNLEY  Assembly Third Reading",76,0,3,0,79
70813,9215,2010-06-22,Senate,"Do pass, but re-refer to the Committee on Public Safety",5,0,0,0,5
70813,10282,2010-06-29,Senate,"Do pass as amended, and re-refer to the Committee on Appropriations",7,0,0,0,7
70813,20697,2010-08-20,Senate,"Assembly 3rd Reading AB2229 Brownley By Pavley",32,0,0,0,32
70813,20807,2010-08-23,Assembly,"AB 2229 BROWNLEY  Concurrence in Senate Amendments",76,0,0,0,76
70814,949,2010-04-19,Assembly,"Do pass as amended and be re-referred to the Committee on Appropriations.",6,3,0,0,9
70814,950,2010-05-28,Assembly,"Do pass.",12,5,0,0,17
70817,1318,2010-04-20,Assembly,"Do pass and re-refer to Committee on Appropriations with recommendation:  To Consent Calendar.",7,0,0,0,7
70817,1319,2010-05-28,Assembly,"Do pass as amended.",17,0,0,0,17
70817,1320,2010-06-02,Assembly,"AB 2233 NIELSEN  Assembly Third Reading",74,1,4,0,79
70817,9992,2010-06-29,Senate,"Do pass, but re-refer to the Committee on Appropriations",1,5,1,0,7
70818,5419,2010-04-06,Assembly,"Do pass and be re-referred to the Committee on Appropriations",19,0,0,0,19
70822,42,2010-04-21,Assembly,"Do pass and be re-referred to the Committee on Appropriations.",16,1,5,0,22
70822,43,2010-05-12,Assembly,"Do pass.",11,5,1,0,17
70822,44,2010-05-24,Assembly,"AB 2238 COTO  Assembly Third Reading",45,20,14,0,79
70823,3795,2010-04-13,Assembly,"Do pass and be re-referred to the Committee on Appropriations",3,4,0,0,7
70823,3796,2010-04-13,Assembly,"Set second hearing.  Failed passage.  Reconsideration granted",7,0,0,0,7
70823,3797,2010-04-20,Assembly,"Do pass and be re-referred to the Committee on Appropriations",3,4,0,0,7
70824,2674,2010-04-14,Assembly,"Do pass and be re-referred to the Committee on Appropriations",8,0,0,0,8
70824,2675,2010-04-28,Assembly,"Do pass as amended",12,1,4,0,17
70824,2676,2010-05-06,Assembly,"AB 2240 MA  Assembly Third Reading",58,11,10,0,79
70824,8958,2010-06-15,Senate,"Do pass as amended, and re-refer to the Committee on Appropriations",3,1,1,0,5
70824,19525,2010-08-02,Senate,"Do pass",8,0,0,0,8
70824,20050,2010-08-11,Senate,"Assembly 3rd Reading AB2240 Ma By Emmerson",25,6,0,0,31
70824,20292,2010-08-16,Assembly,"AB 2240 MA  Concurrence in Senate Amendments",65,7,0,0,72
70825,5094,2010-05-05,Assembly,"Do pass as amended",13,2,7,0,22
70825,5095,2010-05-28,Assembly,"AB 2241 COTO  Assembly Third Reading",43,14,22,0,79
70827,4586,2010-03-23,Assembly,"Do pass, to Consent Calendar",10,0,0,0,10
70827,4587,2010-04-05,Assembly,"AB 2243 SMYTH  Consent Calendar Second Day  Regular Session",76,0,3,0,79
70827,8832,2010-06-15,Senate,"Do pass as amended. To Consent Calendar",5,0,0,0,5
70827,9340,2010-06-24,Senate,"Consent Calendar 2nd AB2243 Smyth",31,0,8,0,39
70827,9586,2010-06-28,Assembly,"AB 2243 SMYTH  Concurrence in Senate Amendments",79,0,0,0,79
70828,946,2010-04-20,Assembly,"Do pass as amended and be re-referred to the Committee on Appropriations.",11,6,2,0,19
70828,947,2010-05-28,Assembly,"Do pass.",12,5,0,0,17
70828,948,2010-06-01,Assembly,"AB 2244 FEUER  Assembly Third Reading",50,25,4,0,79
70828,9458,2010-06-23,Senate,"Do pass as amended, and re-refer to the Committee on Appropriations",6,1,2,0,9
70828,19547,2010-08-02,Senate,"Placed on Appropriations Suspense file",10,0,0,0,10
70828,20167,2010-08-12,Senate,"Do pass",7,4,0,0,11
70828,21162,2010-08-25,Senate,"Assembly 3rd Reading AB2244 Feuer By Alquist",22,11,0,0,33
70828,21373,2010-08-26,Assembly,"AB 2244 FEUER  Concurrence in Senate Amendments",50,25,0,0,75
70829,3922,2010-04-19,Assembly,"Do pass as amended and be re-referred to the Committee on Appropriations",8,4,2,0,14
70829,3923,2010-05-05,Assembly,"Do pass",12,5,0,0,17
70829,3924,2010-05-13,Assembly,"AB 2245 HILL  Assembly Third Reading",48,26,5,0,79
70829,9007,2010-06-15,Senate,"Do pass, but re-refer to the Committee on Appropriations",5,3,1,0,9
70829,21011,2010-08-23,Senate,"Assembly 3rd Reading AB2245 Hill By Hancock",25,11,0,0,36
70830,5348,2010-04-20,Assembly,"Do pass as amended and be re-referred to the Committee on Appropriations",7,0,0,0,7
70832,2798,2010-04-13,Assembly,"Do pass and re-refer to Committee on Appropriations with recommendation:  To Consent Calendar",19,0,0,0,19
70832,2799,2010-04-21,Assembly,"Do pass, to Consent Calendar",17,0,0,0,17
70832,2800,2010-04-29,Assembly,"AB 2248 HERNANDEZ  Consent Calendar Second Day  Regular Session",74,0,5,0,79
70832,10356,2010-06-30,Senate,"Do pass as amended, but re-refer to the Committee on Appropriations Recommend Consent",8,0,1,0,9
70832,19408,2010-08-05,Senate,"Consent Calendar 2nd AB2248 Hernandez",33,0,0,0,33
70832,20592,2010-08-19,Senate,"Assembly 3rd Reading AB2248 Hernandez By Leno",34,0,0,0,34
70832,20930,2010-08-23,Assembly,"AB 2248 HERNANDEZ  Concurrence in Senate Amendments",77,0,0,0,77
70833,4637,2010-04-20,Assembly,"Do pass as amended and re-refer to Committee on Appropriations with recommendation:  To Consent Calendar",6,0,0,0,6
70833,4638,2010-05-19,Assembly,"Do pass, to Consent Calendar",16,0,1,0,17
70833,4639,2010-05-28,Assembly,"AB 2249 RUSKIN  Consent Calendar Second Day  Regular Session",63,0,16,0,79
70833,9274,2010-06-22,Senate,"Do pass, but re-refer to the Committee on Rules",4,0,1,0,5
70833,19623,2010-08-09,Senate,"Special Consent #30 AB2249 Ruskin",34,0,0,0,34
70833,19949,2010-08-12,Assembly,"AB 2249 RUSKIN  Concurrence in Senate Amendments",78,0,0,0,78
70836,510,2010-04-21,Assembly,"Do pass and be re-referred to the Committee on Appropriations.",6,3,0,0,9
70837,2869,2010-04-07,Assembly,"Do pass and be re-referred to the Committee on Appropriations",11,1,0,0,12
70837,2870,2010-05-28,Assembly,"Do pass as amended",12,5,0,0,17
70837,2871,2010-06-02,Assembly,"AB 2253 COTO  Assembly Third Reading",68,4,7,0,79
70837,9253,2010-06-23,Senate,"Do pass, but re-refer to the Committee on Appropriations",4,1,1,0,6
70837,19397,2010-08-02,Senate,"Placed on Appropriations Suspense file",10,0,0,0,10
70837,20079,2010-08-12,Senate,"Do pass",7,4,0,0,11
70837,20488,2010-08-18,Senate,"Assembly 3rd Reading AB2253 Coto By Price",25,9,0,0,34
70840,3256,2010-04-20,Assembly,"Do pass and be re-referred to the Committee on Appropriations",6,3,2,0,11
70840,3257,2010-05-12,Assembly,"Do pass",11,5,1,0,17
70840,3258,2010-06-03,Assembly,"AB 2256 HUFFMAN  Assembly Third Reading",46,27,6,0,79
70840,9176,2010-06-21,Senate,"Do pass, but re-refer to the Committee on Environmental Quality",3,3,3,0,9
70840,9177,2010-06-21,Senate,"Set, first hearing.  Failed passage in Committee.  Reconsideration granted",7,0,2,0,9
70840,10181,2010-06-28,Senate,"Do pass, but re-refer to the Committee on Environmental Quality",5,2,2,0,9
70842,1366,2010-04-20,Assembly,"Do pass and be re-referred to the Committee on Appropriations.",4,3,0,0,7
70842,1367,2010-05-28,Assembly,"Do pass as amended.",12,5,0,0,17
70844,4421,2010-04-21,Assembly,"Do pass and re-refer to Committee on Appropriations with recommendation:  To Consent Calendar",6,0,0,0,6
70844,4422,2010-05-05,Assembly,"Do pass, to Consent Calendar",17,0,0,0,17
70844,4423,2010-05-13,Assembly,"AB 2260 P.E., R.& S.S.  Consent Calendar Second Day  Regular Session",76,0,3,0,79
70844,8708,2010-06-14,Senate,"Do pass, but re-refer to the Committee on Appropriations Recommend Consent",6,0,0,0,6
70844,19068,2010-08-02,Senate,"Consent Calendar 2nd AB2260 Committee on P.E.,R.& S.S.(Hernan",33,0,0,0,33
70844,19642,2010-08-09,Assembly,"AB 2260 P.E., R.& S.S.  Concurrence in Senate Amendments By TORRICO",77,0,0,0,77
70846,3362,2010-04-06,Assembly,"Do pass and be re-referred to the Committee on Appropriations",6,0,1,0,7
70846,3363,2010-05-28,Assembly,"Do pass as amended",12,0,5,0,17
70846,3364,2010-06-02,Assembly,"AB 2262 BASS  Assembly Third Reading",73,1,5,0,79
70846,9141,2010-06-22,Senate,"Do pass, but re-refer to the Committee on Appropriations",7,0,0,0,7
70846,19153,2010-08-02,Senate,"Placed on Appropriations Suspense file",10,0,0,0,10
70847,899,2010-04-13,Assembly,"Do pass and be re-referred to the Committee on Appropriations.",7,0,0,0,7
70847,900,2010-05-28,Assembly,"Do pass.",17,0,0,0,17
70847,901,2010-06-01,Assembly,"AB 2263 YAMADA  Assembly Third Reading",77,0,2,0,79
70847,9290,2010-06-22,Senate,"Do pass, but re-refer to the Committee on Appropriations",7,0,0,0,7
70847,10826,2010-07-15,Senate,"Placed on Appropriations Suspense file",8,0,2,0,10
70847,20268,2010-08-12,Senate,"Do pass",11,0,0,0,11
70847,21144,2010-08-25,Senate,"Assembly 3rd Reading AB2263 Yamada By Wright",35,0,0,0,35
70847,21342,2010-08-26,Assembly,"AB 2263 YAMADA  Concurrence in Senate Amendments",76,0,0,0,76
70848,2360,2010-04-20,Assembly,"Do pass and be re-referred to the Committee on Appropriations",5,2,0,0,7
70848,2361,2010-05-28,Assembly,"Do pass as amended",12,5,0,0,17
70848,2362,2010-06-02,Assembly,"AB 2264 DE LEON  Assembly Third Reading",49,25,5,0,79
70848,9857,2010-06-29,Senate,"Do pass, but re-refer to the Committee on Appropriations",5,1,1,0,7
70848,20542,2010-08-18,Senate,"Assembly 3rd Reading AB2264 De Leon By Liu",21,13,0,0,34
70848,20711,2010-08-20,Assembly,"AB 2264 DE LEON  Concurrence in Senate Amendments",50,24,0,0,74
70849,418,2010-04-07,Assembly,"Do pass as amended and be re-referred to the Committee on Appropriations.",6,0,3,0,9
70850,4482,2010-04-07,Assembly,"Do pass as amended, to Consent Calendar",8,0,1,0,9
70850,4483,2010-05-17,Assembly,"AB 2266 BRADFORD  Assembly Third Reading",71,0,8,0,79
70850,9409,2010-06-23,Senate,"Do pass as amended",7,0,2,0,9
70850,19291,2010-08-02,Senate,"Placed on Appropriations Suspense file",10,0,0,0,10
70852,5162,2010-04-13,Assembly,"Do pass as amended",18,0,1,0,19
70852,5163,2010-04-26,Assembly,"AB 2268 CHESBRO  Assembly Third Reading",71,0,8,0,79
70852,5164,2010-06-09,Senate,"Do pass",5,0,4,0,9
70852,9655,2010-06-28,Senate,"Special Consent #28 AB2268 Chesbro",32,0,7,0,39
70853,5366,2010-04-07,Assembly,"Do pass as amended and be re-referred to the Committee on Appropriations",10,1,1,0,12
70854,5064,2010-03-24,Assembly,"Do pass and be re-referred to the Committee on Appropriations",8,0,0,0,8
70854,5065,2010-04-14,Assembly,"Do pass, to Consent Calendar",15,0,2,0,17
70854,5066,2010-04-22,Assembly,"AB 2270 AGRI.  Consent Calendar Second Day  Regular Session",74,0,5,0,79
70854,8892,2010-06-15,Senate,"Do pass, but re-refer to the Committee on Appropriations Recommend Consent",5,0,0,0,5
70854,19119,2010-08-02,Senate,"Consent Calendar 2nd AB2270 Committee on AGRI. (Galgiani)",33,0,0,0,33
70855,5241,2010-03-23,Assembly,"Do pass, to Consent Calendar",10,0,0,0,10
70855,5242,2010-04-05,Assembly,"AB 2271 SILVA  Consent Calendar Second Day  Regular Session",76,0,3,0,79
70855,8909,2010-06-10,Senate,"Do pass as amended. To Consent Calendar",5,0,0,0,5
70855,9490,2010-06-24,Senate,"Consent Calendar 2nd AB2271 Silva",31,0,8,0,39
70855,9595,2010-06-28,Assembly,"AB 2271 SILVA  Concurrence in Senate Amendments",75,0,4,0,79
70856,5236,2010-04-21,Assembly,"Do pass as amended and be re-referred to the Committee on Appropriations",6,3,0,0,9
70857,5146,2010-04-21,Assembly,"Do pass as amended and be re-referred to the Committee on Appropriations",6,3,0,0,9
70858,2785,2010-04-13,Assembly,"Do pass and be re-referred to the Committee on Appropriations",4,1,1,0,6
70858,2786,2010-04-28,Assembly,"Do pass",10,5,2,0,17
70858,2787,2010-05-06,Assembly,"AB 2274 BEALL  Assembly Third Reading",48,26,5,0,79
70858,9312,2010-06-22,Senate,"Do pass, but re-refer to the Committee on Appropriations",3,2,0,0,5
70858,19849,2010-08-11,Senate,"Assembly 3rd Reading AB2274 Beall By Liu",22,12,0,0,34
70858,19850,2010-08-11,Senate,"Assembly 3rd Reading AB2274 Beall Reconsider",33,0,0,0,33
70858,21732,2010-08-30,Senate,"Assembly 3rd Reading AB2274 Beall By Liu",24,13,0,0,37
70859,2851,2010-05-04,Assembly,"Do pass, to Consent Calendar",11,0,0,0,11
70859,2852,2010-05-10,Assembly,"AB 2275 HAYASHI  Consent Calendar Second Day  Regular Session",71,0,8,0,79
70859,10132,2010-06-30,Senate,"Do pass as amended, and re-refer to the Committee on Appropriations",8,0,1,0,9
70859,19776,2010-08-09,Senate,"Placed on Appropriations Suspense file",10,0,0,0,10
70859,20046,2010-08-12,Senate,"Do pass as amended",9,0,0,0,9
70859,20525,2010-08-18,Senate,"Assembly 3rd Reading AB2275 Hayashi By Aanestad",33,0,0,0,33
70859,21076,2010-08-24,Assembly,"Senate amendments be concurred in",18,0,0,0,18
70859,21471,2010-08-26,Assembly,"AB 2275 HAYASHI  Concurrence in Senate Amendments",76,0,0,0,76
70860,4852,2010-04-06,Assembly,"Do pass and re-refer to Committee on Appropriations with recommendation:  To Consent Calendar",7,0,0,0,7
70861,1077,2010-03-23,Assembly,"Do pass and re-refer to Committee on Appropriations with recommendation:  To Consent Calendar.",12,0,0,0,12
70861,1078,2010-04-14,Assembly,"Do pass, to Consent Calendar.",15,0,2,0,17
70861,1079,2010-04-22,Assembly,"AB 2277 FLETCHER  Consent Calendar Second Day  Regular Session",74,0,5,0,79
70861,10187,2010-06-29,Senate,"Do pass as amended, but re-refer to the Committee on Appropriations Recommend Consent",9,0,0,0,9
70861,19462,2010-08-05,Senate,"Consent Calendar 2nd AB2277 Fletcher",33,0,0,0,33
70861,20144,2010-08-12,Assembly,"AB 2277 FLETCHER  Concurrence in Senate Amendments",78,0,0,0,78
70863,3657,2010-04-13,Assembly,"Do pass and be re-referred to the Committee on Appropriations",7,4,0,0,11
70863,3658,2010-04-28,Assembly,"Do pass",10,5,2,0,17
70863,3659,2010-05-06,Assembly,"AB 2279 EVANS  Assembly Third Reading",51,24,4,0,79
70863,9432,2010-06-22,Senate,"Do pass as amended, and re-refer to the Committee on Appropriations",8,1,2,0,11
70863,19211,2010-08-02,Senate,"Do pass as amended",7,3,0,0,10
70863,19910,2010-08-12,Senate,"Assembly 3rd Reading AB2279 Evans By Wolk",22,12,0,0,34
70863,20350,2010-08-17,Assembly,"AB 2279 EVANS  Concurrence in Senate Amendments",51,25,0,0,76
70867,3303,2010-04-13,Assembly,"Do pass and be re-referred to the Committee on Appropriations",10,0,1,0,11
70867,3304,2010-04-28,Assembly,"Do pass",15,0,2,0,17
70867,3305,2010-05-06,Assembly,"AB 2283 MILLER  Assembly Third Reading",75,0,4,0,79
70868,5140,2010-03-23,Assembly,"Do pass and re-refer to Committee on Appropriations with recommendation:  To Consent Calendar",10,0,0,0,10
70868,5141,2010-04-14,Assembly,"Do pass, to Consent Calendar",15,0,2,0,17
70868,5142,2010-04-22,Assembly,"AB 2284 EVANS  Consent Calendar Second Day  Regular Session",74,0,5,0,79
70868,9926,2010-06-29,Senate,"Do pass as amended, and re-refer to the Committee on Appropriations",4,0,1,0,5
70868,20714,2010-08-20,Senate,"Assembly 3rd Reading AB2284 Evans By Corbett",31,0,0,0,31
70868,20890,2010-08-23,Assembly,"AB 2284 EVANS  Concurrence in Senate Amendments",77,0,0,0,77
70871,2514,2010-04-20,Assembly,"Do pass as amended and be re-referred to the Committee on Appropriations",6,0,0,0,6
70871,2515,2010-05-28,Assembly,"Do pass as amended",12,0,5,0,17
70871,2516,2010-06-02,Assembly,"AB 2287 MONNING  Assembly Third Reading",50,25,4,0,79
70871,10207,2010-06-30,Senate,"Do pass as amended, and re-refer to the Committee on Appropriations",7,1,1,0,9
70871,19168,2010-08-02,Senate,"Placed on Appropriations Suspense file",10,0,0,0,10
70872,7823,2010-04-19,Assembly,"Do pass as amended and be re-referred to the Committee on Appropriations",5,6,1,0,12
70872,7824,2010-04-19,Assembly,"Set first hearing.  Failed passage.  Reconsideration granted",12,0,0,0,12
70873,434,2010-04-19,Assembly,"Do pass as amended and be re-referred to the Committee on Appropriations.",8,3,3,0,14
70873,435,2010-05-28,Assembly,"Do pass as amended.",12,5,0,0,17
70873,436,2010-06-02,Assembly,"AB 2289 ENG  Assembly Third Reading",48,27,4,0,79
70873,9162,2010-06-21,Senate,"Do pass, but re-refer to the Committee on Transportation and Housing",4,2,3,0,9
70873,9163,2010-06-21,Senate,"Set, first hearing.  Failed passage in Committee.  Reconsideration granted",7,0,2,0,9
70873,9682,2010-06-28,Senate,"Do pass, but re-refer to the Committee on Transportation and Housing",5,2,2,0,9
70873,19837,2010-08-09,Senate,"Do pass",6,1,0,0,7
70873,21127,2010-08-25,Senate,"Assembly 3rd Reading AB2289 Eng By Lowenthal",22,11,0,0,33
70873,21508,2010-08-26,Assembly,"AB 2289 ENG  Concurrence in Senate Amendments",49,25,0,0,74
70874,1192,2010-04-13,Assembly,"Do pass and re-refer to Committee on Appropriations with recommendation:  To Consent Calendar.",7,0,0,0,7
70874,1193,2010-05-28,Assembly,"Do pass as amended.",17,0,0,0,17
70874,1194,2010-06-02,Assembly,"AB 2290 BRADFORD  Assembly Third Reading",74,0,5,0,79
70874,9279,2010-06-22,Senate,"Do pass, but re-refer to the Committee on Appropriations",7,0,0,0,7
70874,19621,2010-08-02,Senate,"Do pass",8,0,0,0,8
70874,20060,2010-08-11,Senate,"Assembly 3rd Reading AB2290 Bradford By Huff",33,0,0,0,33
70876,4987,2010-03-23,Assembly,"Do pass and be re-referred to the Committee on Appropriations",19,0,0,0,19
70877,1621,2010-04-14,Assembly,"Do pass as amended and be re-referred to the Committee on Appropriations",8,0,1,0,9
70877,1622,2010-05-28,Assembly,"Do pass as amended",17,0,0,0,17
70877,1623,2010-06-02,Assembly,"AB 2293 TORRES  Third Reading Urgency",75,0,4,0,79
70877,9960,2010-06-29,Senate,"Do pass, but re-refer to the Committee on Appropriations",9,0,0,0,9
70877,19827,2010-08-09,Senate,"Placed on Appropriations Suspense file",10,0,0,0,10
70877,20013,2010-08-12,Senate,"Do pass as amended",11,0,0,0,11
70877,21518,2010-08-24,Senate,"Assembly 3rd Reading AB2293 Torres Urgency Clause",36,0,0,0,36
70877,21519,2010-08-26,Assembly,"AB 2293 TORRES  Concurrence in Senate Amendments",77,0,0,0,77
70878,2548,2010-04-19,Assembly,"Do pass as amended",11,0,3,0,14
70878,2549,2010-05-03,Assembly,"AB 2294 BLOCK  Assembly Third Reading",73,1,5,0,79
70878,9139,2010-06-22,Senate,"Do pass as amended",6,0,3,0,9
70878,20817,2010-08-23,Senate,"Assembly 3rd Reading AB2294 Block By Kehoe",27,6,0,0,33
70878,20986,2010-08-24,Assembly,"AB 2294 BLOCK  Concurrence in Senate Amendments",72,4,0,0,76
70879,156,2010-04-20,Assembly,"Do pass and re-refer to Committee on Appropriations with recommendation:  To Consent Calendar.",7,0,0,0,7
70879,157,2010-05-28,Assembly,"Do pass as amended.",12,0,5,0,17
70879,158,2010-06-02,Assembly,"AB 2295 DE LA TORRE  Assembly Third Reading",76,0,3,0,79
70879,10045,2010-06-29,Senate,"Do pass as amended, and re-refer to the Committee on Appropriations",7,0,0,0,7
70879,19484,2010-08-02,Senate,"Placed on Appropriations Suspense file",10,0,0,0,10
70879,20181,2010-08-12,Senate,"Do pass as amended",11,0,0,0,11
70879,20493,2010-08-18,Senate,"Assembly 3rd Reading AB2295 De La Torre",34,0,0,0,34
70879,20589,2010-08-19,Assembly,"AB 2295 DE LA TORRE  Concurrence in Senate Amendments",78,0,0,0,78
70880,929,2010-04-19,Assembly,"Do pass as amended and be re-referred to the Committee on Appropriations.",9,3,3,0,15
70880,930,2010-05-12,Assembly,"Do pass.",11,4,2,0,17
70880,931,2010-05-20,Assembly,"AB 2296 SALDANA  Assembly Third Reading",44,23,12,0,79
70881,211,2010-04-06,Assembly,"Do pass as amended and be re-referred to the Committee on Appropriations.",9,0,0,0,9
70881,212,2010-04-21,Assembly,"Do pass.",16,1,0,0,17
70881,213,2010-05-03,Assembly,"AB 2297 BROWNLEY  Assembly Third Reading",68,8,3,0,79
70881,9481,2010-06-23,Senate,"Do pass as amended, and re-refer to the Committee on Appropriations",7,0,2,0,9
70881,20509,2010-08-18,Senate,"Assembly 3rd Reading AB2297 Brownley By Pavley",30,1,0,0,31
70881,20623,2010-08-19,Assembly,"AB 2297 BROWNLEY  Concurrence in Senate Amendments",78,0,0,0,78
70882,1797,2010-04-07,Assembly,"Do pass as amended and be re-referred to the Committee on Appropriations",6,0,3,0,9
70882,1798,2010-05-28,Assembly,"Do pass as amended",12,5,0,0,17
70882,1799,2010-06-02,Assembly,"AB 2298 TORLAKSON  Assembly Third Reading",53,20,6,0,79
70882,10250,2010-06-30,Senate,"Do pass, but re-refer to the Committee on Appropriations",6,2,1,0,9
70882,19711,2010-08-02,Senate,"Placed on Appropriations Suspense file",10,0,0,0,10
70883,5181,2010-04-19,Assembly,"Do pass as amended and be re-referred to the Committee on Appropriations",9,0,0,0,9
70884,2848,2010-04-13,Assembly,"Do pass and re-refer to Committee on Appropriations with recommendation:  To Consent Calendar",11,0,0,0,11
70884,2849,2010-04-28,Assembly,"Do pass as amended, to Consent Calendar",15,0,2,0,17
70884,2850,2010-05-06,Assembly,"AB 2300 EMMERSON  Consent Calendar Second Day  Regular Session",74,0,5,0,79
70884,9555,2010-06-23,Senate,"Do pass as amended, and re-refer to the Committee on Appropriations",7,0,2,0,9
70884,19493,2010-08-02,Senate,"Do pass as amended",10,0,0,0,10
70884,20672,2010-08-20,Senate,"Assembly 3rd Reading AB2300 Emmerson By Emmerson",31,0,0,0,31
70884,20951,2010-08-23,Assembly,"AB 2300  Concurrence in Senate Amendments By HAYASHI",77,0,0,0,77
70885,653,2010-04-19,Assembly,"Do pass as amended and be re-referred to the Committee on Appropriations.",9,0,0,0,9
70885,654,2010-05-28,Assembly,"Do pass as amended.",17,0,0,0,17
70885,655,2010-06-02,Assembly,"AB 2301 LOGUE  Assembly Third Reading",68,4,7,0,79
70886,9445,2010-06-22,Assembly,"Be adopted as amended and be re-referred to the Committee on Appropriations",6,0,4,0,10
70886,19799,2010-08-04,Assembly,"From committee:  Be adopted.  To third reading",12,1,0,0,13
70886,19800,2010-08-09,Assembly,"ACR 129 MONNING  Assembly Third Reading",52,11,0,0,63
70886,21643,2010-08-27,Senate,"Assembly 3rd Reading ACR129 Monning By Hancock",22,11,0,0,33
70887,5173,2010-04-05,Assembly,"Be adopted, and re-refer to Committee on Appropriations with recommendation:  To Consent Calendar",13,0,1,0,14
70887,5174,2010-04-14,Assembly,"Be adopted, to Consent Calendar",15,0,2,0,17
70887,5175,2010-04-19,Assembly,"ACR 130 DE LA TORRE  Consent Calendar Second Day  Regular Session",73,0,6,0,79
70887,9316,2010-06-22,Senate,"Be adopted as amended, and re-refer to the Committee on Appropriations",5,1,3,0,9
70887,20516,2010-08-18,Senate,"Assembly 3rd Reading ACR130 De La Torre By Calderon",33,0,0,0,33
70887,20637,2010-08-19,Assembly,"ACR 130 DE LA TORRE  Concurrence in Senate Amendments",77,0,0,0,77
70888,27318,2010-03-22,Assembly,"Be adopted, and re-refer to Committee on Appropriations with 	recommendation:  To Consent Calendar",13,0,0,0,13
70888,27319,2010-04-14,Assembly,"Be adopted, to Consent Calendar",15,0,0,0,15
70888,27320,2010-04-19,Assembly,"ACR 131 ANDERSON  Consent Calendar Second Day  Regular Session",73,0,0,0,73
70888,27321,2010-05-04,Senate,"Be adopted, but re-refer to the Committee on Appropriations 	Recommend Consent",8,0,0,0,8
70888,27322,2010-05-27,Senate,"Consent Calendar 2nd ACR131 Anderson",33,0,0,0,33
70889,5343,2010-04-19,Assembly,"Be adopted as amended",12,0,2,0,14
70889,10023,2010-06-29,Senate,"Be adopted as amended",9,0,0,0,9
70889,19654,2010-08-09,Senate,"Special Consent #30 ACR132 Nielsen",34,0,0,0,34
70890,698,2010-05-03,Senate,"Do pass.",4,2,0,0,6
70890,699,2010-06-03,Senate,"Senate 3rd Reading SB1121 Florez",23,12,3,0,38
70890,9220,2010-06-23,Assembly,"Do pass",4,1,1,0,6
70890,10001,2010-07-01,Assembly,"SB 1121 Florez  Senate Third Reading  By MONNING",47,28,4,0,79
70891,2725,2010-04-14,Senate,"Do pass, but re-refer to the Committee on Appropriations Recommend Consent",8,0,1,0,9
70891,2726,2010-04-29,Senate,"Consent Calendar 2nd SB1122 Wright",33,0,5,0,38
70891,8955,2010-06-15,Assembly,"Do pass and be re-referred to the Committee on Higher Education",11,0,0,0,11
70891,9395,2010-06-22,Assembly,"Do pass and be re-referred to the Committee on Appropriations",9,0,0,0,9
70891,19738,2010-08-04,Assembly,"Do pass, to Consent Calendar",17,0,0,0,17
70891,19975,2010-08-12,Assembly,"SB 1122 Wright  Consent Calendar Second Day  Regular Session",78,0,0,0,78
70892,4543,2010-04-19,Senate,"Do pass, but re-refer to the Committee on Appropriations",8,0,1,0,9
70892,4544,2010-05-03,Senate,"Placed on Appropriations Suspense file",10,0,1,0,11
70893,615,2010-04-13,Senate,"Do pass, but re-refer to the Committee on Appropriations.",7,0,2,0,9
70893,616,2010-05-28,Senate,"Senate 3rd Reading SB1124 Negrete McLeod",22,6,10,0,38
70893,617,2010-05-28,Senate,"Senate 3rd Reading SB1124 Negrete McLeod Reconsider",22,2,14,0,38
70893,618,2010-06-03,Senate,"Senate 3rd Reading SB1124 Negrete McLeod",28,7,3,0,38
70893,9928,2010-06-29,Assembly,"Do pass and be re-referred to the Committee on Appropriations",13,0,0,0,13
70893,19787,2010-08-04,Assembly,"Do pass",17,0,0,0,17
70893,20881,2010-08-23,Assembly,"SB 1124 Negrete McLeod  Senate Third Reading  By CARTER",75,0,0,0,75
70893,21132,2010-08-25,Senate,"Unfinished Business SB1124 Negrete McLeod",33,0,0,0,33
70894,352,2010-04-13,Senate,"Do pass as amended, and re-refer to the Committee on Appropriations.",8,0,3,0,11
70894,353,2010-05-03,Senate,"Do pass.",10,0,1,0,11
70894,354,2010-06-02,Senate,"Senate 3rd Reading SB1125 Florez",33,2,3,0,38
70894,9916,2010-06-30,Assembly,"Do pass as amended and be re-referred to the Committee on Appropriations",18,0,4,0,22
70894,20224,2010-08-12,Assembly,"Do pass as amended",17,0,0,0,17
70894,20866,2010-08-23,Assembly,"SB 1125 Florez  Senate Third Reading  By HALL",68,1,0,0,69
70894,21121,2010-08-25,Senate,"Unfinished Business SB1125 Florez",31,2,0,0,33
70895,3855,2010-03-24,Senate,"Do pass as amended, and re-refer to the Committee on Appropriations",6,0,3,0,9
70895,3856,2010-04-26,Senate,"Placed on Appropriations Suspense file",9,0,2,0,11
70896,1132,2010-04-13,Senate,"Do pass as amended, and re-refer to the Committee on Appropriations.",4,0,1,0,5
70896,1133,2010-06-01,Senate,"Special Consent #25 SB1127 Oropeza",35,0,3,0,38
70896,9846,2010-06-29,Assembly,"Do pass as amended and be re-referred to the Committee on Appropriations",8,0,1,0,9
70896,19347,2010-08-04,Assembly,"Do pass, to Consent Calendar",17,0,0,0,17
70896,19914,2010-08-12,Assembly,"SB 1127 Oropeza  Consent Calendar Second Day  Regular Session",78,0,0,0,78
70896,21346,2010-08-26,Senate,"Special Consent #32 SB1127 Oropeza",34,0,0,0,34
70897,5487,2010-04-13,Senate,"Do pass",8,0,1,0,9
70897,5488,2010-04-22,Senate,"Senate 3rd Reading SB1128 DeSaulnier",33,0,6,0,39
70897,9902,2010-06-30,Assembly,"Do pass, to Consent Calendar",8,0,1,0,9
70897,20418,2010-08-16,Assembly,"SB 1128 DeSaulnier  Senate Third Reading  By BUCHANAN",75,0,0,0,75
70897,20628,2010-08-19,Senate,"Unfinished Business SB1128 DeSaulnier",27,0,0,0,27
70898,4193,2010-04-13,Senate,"Do pass, but re-refer to the Committee on Health",3,1,1,0,5
70898,4194,2010-05-10,Senate,"Placed on Appropriations Suspense file",9,0,2,0,11
70899,910,2010-04-13,Senate,"Do pass, but re-refer to the Committee on Appropriations.",7,2,2,0,11
70899,911,2010-05-17,Senate,"Do pass.",5,4,2,0,11
70899,912,2010-05-17,Senate,"Set, final hearing.  Failed passage in Committee.  Reconsideration granted.",10,0,1,0,11
70899,913,2010-05-24,Senate,"Do pass as amended.",7,3,1,0,11
70899,914,2010-06-02,Senate,"Senate 3rd Reading SB1130 Aanestad",26,8,4,0,38
70899,9703,2010-06-29,Assembly,"Do pass as amended and be re-referred to the Committee on Appropriations",6,0,1,0,7
70900,825,2010-04-13,Senate,"Do pass, but re-refer to the Committee on Appropriations.",7,1,3,0,11
70900,826,2010-04-26,Senate,"Do pass as amended.",7,2,2,0,11
70900,827,2010-05-27,Senate,"Senate 3rd Reading SB1131 Calderon",24,7,7,0,38
70900,9412,2010-06-22,Assembly,"Do pass",5,3,1,0,9
70900,21029,2010-08-20,Assembly,"SB 1131 Calderon  Senate Third Reading  Amend By MA  Set #1",49,26,0,0,75
70905,1466,2010-04-14,Senate,"Do pass as amended, but re-refer to the Committee on Appropriations Recommend Consent",8,0,1,0,9
70905,1467,2010-05-10,Senate,"Placed on Appropriations Suspense file",9,0,2,0,11
70905,1468,2010-05-27,Senate,"Do pass as amended",10,0,1,0,11
70905,1469,2010-06-03,Senate,"Special Consent #27 SB1136 Cox",36,0,2,0,38
70905,10034,2010-06-30,Assembly,"Do pass as amended and re-refer to Committee on Appropriations with recommendation:  To Consent Calendar",9,0,0,0,9
70906,3046,2010-04-07,Senate,"Do pass and be placed on the Consent Calendar",11,0,0,0,11
70906,3047,2010-04-15,Senate,"Consent Calendar 2nd SB1137 Committee on B.,F.& I. (Calderon)",35,0,4,0,39
70906,9156,2010-06-21,Assembly,"Do pass and be re-referred to the Committee on Appropriations to Consent Calendar",12,0,0,0,12
70906,10205,2010-06-30,Assembly,"Do pass, to Consent Calendar",17,0,0,0,17
70906,20508,2010-08-17,Assembly,"SB 1137 B.,F.& I.  Senate Third Reading  By ENG",76,1,0,0,77
70906,21371,2010-08-26,Senate,"Special Consent #32 SB1137 Committee on B.,F.& I. (Calderon)",34,0,0,0,34
70907,4967,2010-04-06,Senate,"Do pass, but re-refer to the Committee on Environmental Quality",4,0,1,0,5
70907,4968,2010-04-19,Senate,"Do pass as amended, and re-refer to the Committee on Appropriations",6,0,1,0,7
70907,4969,2010-05-10,Senate,"Do pass",8,0,3,0,11
70907,4970,2010-05-13,Senate,"Senate 3rd Reading SB1138 Cedillo",28,0,10,0,38
70907,9045,2010-06-16,Assembly,"Do pass as amended and re-refer to Committee on Appropriations with recommendation:  To Consent Calendar",8,0,0,0,8
70908,4607,2010-04-12,Senate,"Do pass",6,0,0,0,6
70908,4608,2010-04-15,Senate,"Senate 3rd Reading SB1139 Correa",35,0,4,0,39
70908,9252,2010-06-23,Assembly,"Do pass, to Consent Calendar",6,0,0,0,6
70908,19896,2010-08-12,Assembly,"Do pass",12,5,0,0,17
70908,20575,2010-08-19,Assembly,"SB 1139 Correa  Senate Third Reading  By TORRICO",52,24,0,0,76
70908,21156,2010-08-25,Senate,"Unfinished Business SB1139 Correa",23,9,0,0,32
70909,3365,2010-04-06,Senate,"Do pass, but re-refer to the Committee on Appropriations",3,2,0,0,5
70909,3366,2010-05-03,Senate,"Placed on Appropriations Suspense file",10,0,1,0,11
70909,3367,2010-05-27,Senate,"Do pass as amended",7,3,1,0,11
70909,3368,2010-06-02,Senate,"Senate 3rd Reading SB1140 Yee",22,12,4,0,38
70909,9144,2010-06-22,Assembly,"Do pass as amended and be re-referred to the Committee on Appropriations",5,2,0,0,7
70910,231,2010-04-07,Senate,"Do pass, but re-refer to the Committee on Appropriations.",4,1,0,0,5
70910,232,2010-05-03,Senate,"Placed on Appropriations Suspense file.",10,0,1,0,11
70910,233,2010-05-27,Senate,"Do pass as amended.",6,4,1,0,11
70910,234,2010-06-02,Senate,"Senate 3rd Reading SB1141 Negrete McLeod",25,10,3,0,38
70910,9987,2010-06-30,Assembly,"Do pass and be re-referred to the Committee on Appropriations",5,3,1,0,9
70910,20195,2010-08-12,Assembly,"Do pass as amended",12,5,0,0,17
70910,21943,2010-08-30,Assembly,"SB 1141 Negrete McLeod  Senate Third Reading  By MENDOZA",50,25,0,0,75
70910,21944,2010-08-30,Senate,"W/O REF. TO FILE SB1141 Negrete McLeod Concurrence",21,13,0,0,34
70911,74,2010-04-19,Senate,"Do pass, but re-refer to the Committee on Appropriations.",4,1,0,0,5
70911,75,2010-05-10,Senate,"Do pass.",8,0,3,0,11
70911,76,2010-06-01,Senate,"Senate 3rd Reading SB1142 Wiggins",23,11,4,0,38
70911,9153,2010-06-21,Assembly,"Do pass and be re-referred to the Committee on Agriculture",7,0,2,0,9
70911,9999,2010-06-30,Assembly,"Do pass as amended and be re-referred to the Committee on Appropriations",8,0,0,0,8
70911,20229,2010-08-12,Assembly,"Do pass",17,0,0,0,17
70911,20877,2010-08-23,Assembly,"SB 1142 Wiggins  Senate Third Reading  By YAMADA",76,1,0,0,77
70911,21514,2010-08-26,Senate,"Unfinished Business SB1142 Wiggins",23,14,0,0,37
70912,355,2010-04-21,Senate,"Do pass, but re-refer to the Committee on Appropriations.",7,0,2,0,9
70912,356,2010-05-24,Senate,"Placed on Appropriations Suspense file.",10,0,1,0,11
70912,357,2010-05-27,Senate,"Do pass as amended.",8,0,3,0,11
70912,358,2010-06-02,Senate,"Senate 3rd Reading SB1143 Liu",19,8,11,0,38
70912,359,2010-06-02,Senate,"Senate 3rd Reading SB1143 Liu Reconsider",35,0,3,0,38
70912,360,2010-06-03,Senate,"Senate 3rd Reading SB1143 Liu",22,10,6,0,38
70912,9250,2010-06-22,Assembly,"Do pass and be re-referred to the Committee on Appropriations",5,3,1,0,9
70912,20166,2010-08-12,Assembly,"Do pass as amended",17,0,0,0,17
70912,20570,2010-08-19,Assembly,"SB 1143 Liu  Senate Third Reading  By BLOCK",57,14,0,0,71
70912,21150,2010-08-25,Senate,"Unfinished Business SB1143 Liu",23,7,0,0,30
70915,112,2010-04-07,Senate,"Do pass, but re-refer to the Committee on Judiciary.",9,0,2,0,11
70915,113,2010-04-20,Senate,"Do pass as amended, and re-refer to the Committee on Appropriations.",4,0,1,0,5
70915,114,2010-05-10,Senate,"Do pass.",9,0,2,0,11
70915,115,2010-06-02,Senate,"Senate 3rd Reading SB1146 Florez",36,0,2,0,38
70915,9145,2010-06-21,Assembly,"Do pass as amended and be re-referred to the Committee on Judiciary",12,0,0,0,12
70915,9741,2010-06-29,Assembly,"Do pass as amended and be re-referred to the Committee on Appropriations",10,0,0,0,10
70915,20161,2010-08-12,Assembly,"Do pass as amended",17,0,0,0,17
70915,21240,2010-08-25,Assembly,"SB 1146 Florez  Senate Third Reading  By ENG",75,1,0,0,76
70915,21430,2010-08-26,Senate,"Unfinished Business SB1146 Florez",37,0,0,0,37
70916,3700,2010-04-13,Senate,"Do pass, but re-refer to the Committee on Rules",5,0,2,0,7
70916,3701,2010-05-27,Senate,"Placed on Appropriations Suspense file",10,0,1,0,11
70917,4381,2010-04-14,Senate,"Do pass, but re-refer to the Committee on Appropriations",8,0,1,0,9
70917,4382,2010-04-26,Senate,"Placed on Appropriations Suspense file",9,0,2,0,11
70918,2355,2010-03-23,Senate,"Do pass as amended",3,2,0,0,5
70918,2356,2010-04-22,Senate,"Senate 3rd Reading SB1149 Corbett",21,9,9,0,39
70918,9673,2010-06-29,Assembly,"Do pass",7,2,1,0,10
70918,21105,2010-08-25,Assembly,"SB 1149 Corbett  Senate Third Reading  By FEUER",51,26,0,0,77
70918,21495,2010-08-26,Senate,"Unfinished Business SB1149 Corbett",22,14,0,0,36
70919,108,2010-04-05,Senate,"Do pass, but re-refer to the Committee on Rules.",6,1,2,0,9
70919,109,2010-04-26,Senate,"Placed on Appropriations Suspense file.",9,0,2,0,11
70919,110,2010-05-27,Senate,"Do pass.",10,0,1,0,11
70919,111,2010-06-01,Senate,"Senate 3rd Reading SB1150 Negrete McLeod",31,1,6,0,38
70919,9152,2010-06-22,Assembly,"Do pass and be re-referred to the Committee on Health",11,0,0,0,11
70919,9990,2010-06-29,Assembly,"Do pass and be re-referred to the Committee on Appropriations",19,0,0,0,19
70922,4541,2010-04-20,Senate,"Do pass as amended, and re-refer to the Committee on Appropriations",8,2,1,0,11
70922,4542,2010-05-10,Senate,"Placed on Appropriations Suspense file",9,0,2,0,11
70923,810,2010-04-20,Senate,"Do pass as amended, and re-refer to the Committee on Appropriations.",10,0,1,0,11
70923,811,2010-05-10,Senate,"Placed on Appropriations Suspense file.",9,0,2,0,11
70923,812,2010-05-27,Senate,"Do pass.",10,0,1,0,11
70923,813,2010-06-01,Senate,"Senate 3rd Reading SB1154 Cedillo",35,0,3,0,38
70923,9871,2010-06-28,Assembly,"Do pass as amended and be re-referred to the Committee on Appropriations",13,2,0,0,15
70923,20154,2010-08-12,Assembly,"Do pass as amended",12,5,0,0,17
70923,21931,2010-08-30,Assembly,"SB 1154 Cedillo  Senate Third Reading  By HALL",55,23,0,0,78
70923,21932,2010-08-31,Senate,"Unfinished Business SB1154 Cedillo",36,0,0,0,36
70924,1886,2010-04-07,Senate,"Do pass as amended, and re-refer to the Committee on Business, Professions and Economic Development",11,0,0,0,11
70924,1887,2010-04-26,Senate,"Do pass",9,0,2,0,11
70924,1888,2010-05-03,Senate,"Special Consent #22 SB1155 Dutton",34,0,4,0,38
70924,9300,2010-06-21,Assembly,"Do pass and be re-referred to the Committee on Appropriations to Consent Calendar",12,0,0,0,12
70924,19357,2010-08-04,Assembly,"Do pass, to Consent Calendar",17,0,0,0,17
70924,19951,2010-08-12,Assembly,"SB 1155 Dutton  Consent Calendar Second Day  Regular Session",78,0,0,0,78
70924,20725,2010-08-19,Senate,"Unfinished Business SB1155 Dutton",35,0,0,0,35
70925,9140,2010-06-22,Senate,"Do pass, but re-refer to the Committee on Appropriations",7,0,2,0,9
70925,10986,2010-07-15,Senate,"Do pass",7,0,3,0,10
70925,19844,2010-08-11,Senate,"Senate 3rd Reading SB1156 Cedillo Urgency Clause",33,0,0,0,33
70926,3137,2010-04-14,Senate,"Do pass, but re-refer to the Committee on Rules",6,2,1,0,9
70926,3138,2010-04-22,Senate,"Do pass as amended, and re-refer to the Committee on Appropriations",5,0,2,0,7
70926,3139,2010-05-17,Senate,"Placed on Appropriations Suspense file",10,0,1,0,11
70926,3140,2010-05-27,Senate,"Do pass as amended",7,3,1,0,11
70926,3141,2010-06-02,Senate,"Senate 3rd Reading SB1157 DeSaulnier",21,12,5,0,38
70926,10198,2010-06-29,Assembly,"Do pass as amended and be re-referred to the Committee on Appropriations",6,3,0,0,9
70926,20106,2010-08-12,Assembly,"Do pass as amended",12,5,0,0,17
70926,20849,2010-08-23,Assembly,"SB 1157 DeSaulnier  Senate Third Reading  By MONNING",47,27,0,0,74
70926,21489,2010-08-26,Senate,"Unfinished Business SB1157 DeSaulnier",22,14,0,0,36
70929,302,2010-04-13,Senate,"Do pass, but re-refer to the Committee on Appropriations.",7,1,3,0,11
70929,303,2010-05-03,Senate,"Placed on Appropriations Suspense file.",10,0,1,0,11
70929,304,2010-05-27,Senate,"Do pass as amended.",10,0,1,0,11
70929,305,2010-06-03,Senate,"Senate 3rd Reading SB1160 Dutton",30,1,7,0,38
70930,659,2010-04-14,Senate,"Do pass as amended, and re-refer to the Committee on Appropriations.",7,0,2,0,9
70930,660,2010-05-03,Senate,"Do pass.",9,0,2,0,11
70930,661,2010-05-10,Senate,"Special Consent #23 SB1161 Lowenthal",30,0,8,0,38
70930,10372,2010-06-30,Assembly,"Do pass and re-refer to Committee on Appropriations with recommendation:  To Consent Calendar",9,0,0,0,9
70932,3358,2010-04-21,Senate,"Do pass as amended, and re-refer to the Committee on Appropriations",5,0,4,0,9
70932,3359,2010-05-17,Senate,"Placed on Appropriations Suspense file",10,0,1,0,11
70932,3360,2010-05-27,Senate,"Do pass",7,3,1,0,11
70932,3361,2010-06-03,Senate,"Senate 3rd Reading SB1163 Leno",23,12,3,0,38
70932,10261,2010-06-29,Assembly,"Do pass and be re-referred to the Committee on Appropriations",13,5,1,0,19
70932,20212,2010-08-12,Assembly,"Do pass as amended",12,5,0,0,17
70932,21451,2010-08-26,Assembly,"Do pass",15,1,0,0,16
70932,21740,2010-08-30,Assembly,"SB 1163 Leno  Senate Third Reading  By DE LA TORRE",56,21,0,0,77
70932,21844,2010-08-31,Senate,"From committee:  That the Assembly Amendments be concurred in",6,2,0,0,8
70932,21845,2010-08-31,Senate,"W/O REF. TO FILE SB1163 Leno",21,15,0,0,36
70935,4255,2010-03-23,Senate,"Do pass, but re-refer to the Committee on Appropriations",4,1,0,0,5
70935,4256,2010-04-15,Senate,"Senate 3rd Reading SB1166 Simitian",31,5,3,0,39
70935,8797,2010-06-15,Assembly,"Do pass as amended and be re-referred to the Committee on Appropriations",7,3,0,0,10
70935,19570,2010-08-04,Assembly,"Do pass",12,5,0,0,17
70935,20411,2010-08-16,Assembly,"SB 1166 Simitian  Senate Third Reading  By FEUER",50,25,0,0,75
70935,20613,2010-08-19,Senate,"Unfinished Business SB1166 Simitian",31,4,0,0,35
70936,3078,2010-04-13,Senate,"Do pass, but re-refer to the Committee on Appropriations",7,0,4,0,11
70936,3079,2010-05-03,Senate,"Special Consent #22 SB1167 Cogdill",34,0,4,0,38
70936,8969,2010-06-15,Assembly,"Do pass and be re-referred to the Committee on Appropriations",11,0,0,0,11
70936,9869,2010-06-30,Assembly,"Do pass",17,0,0,0,17
70936,20771,2010-08-16,Assembly,"SB 1167 Cogdill  Senate Third Reading  By VILLINES",75,0,0,0,75
70937,145,2010-04-20,Senate,"Do pass as amended, and re-refer to the Committee on Appropriations.",7,0,0,0,7
70937,146,2010-05-10,Senate,"Do pass.",7,2,2,0,11
70937,147,2010-05-13,Senate,"Senate 3rd Reading SB1168 Cedillo Reconsider",31,0,7,0,38
70937,148,2010-06-01,Senate,"Senate 3rd Reading SB1168 Cedillo",24,9,5,0,38
70937,8881,2010-05-13,Senate,"Senate 3rd Reading SB1168 Cedillo",18,11,9,0,38
70937,9722,2010-06-29,Assembly,"Do pass and be re-referred to the Committee on Appropriations",1,1,5,0,7
70938,2308,2010-04-14,Senate,"Do pass as amended, and re-refer to the Committee on Appropriations",7,2,0,0,9
70938,2309,2010-05-10,Senate,"Placed on Appropriations Suspense file",9,0,2,0,11
70938,2310,2010-05-27,Senate,"Do pass as amended",7,3,1,0,11
70938,2311,2010-06-01,Senate,"Senate 3rd Reading SB1169 Lowenthal",24,11,3,0,38
70938,8795,2010-06-15,Assembly,"Do pass and be re-referred to the Committee on Appropriations",12,5,2,0,19
70938,10108,2010-06-30,Assembly,"Do pass",12,5,0,0,17
70938,20889,2010-08-23,Assembly,"SB 1169 Lowenthal  Senate Third Reading  By FULLER",74,1,0,0,75
70938,21582,2010-08-27,Senate,"From committee:  That the Assembly Amendments be concurred in",9,0,0,0,9
70938,21671,2010-08-30,Senate,"Unfinished Business SB1169 Lowenthal",35,0,0,0,35
70940,8177,2010-03-22,Senate,"Do pass as amended, and re-refer to the Committee on Rules",6,2,1,0,9
70941,5234,2010-04-19,Senate,"Do pass, but re-refer to the Committee on Appropriations",7,1,1,0,9
70941,5235,2010-05-28,Senate,"Senate 3rd Reading SB1172 Negrete McLeod",27,0,11,0,38
70941,10047,2010-06-29,Assembly,"Do pass and be re-referred to the Committee on Appropriations",11,0,0,0,11
70941,19764,2010-08-04,Assembly,"Do pass",17,0,0,0,17
70941,20386,2010-08-16,Assembly,"SB 1172 Negrete McLeod  Senate Third Reading  By ENG",74,0,0,0,74
70941,20543,2010-08-19,Senate,"Unfinished Business SB1172 Negrete McLeod",34,0,0,0,34
70942,2125,2010-03-23,Senate,"Do pass as amended, and re-refer to the Committee on Environmental Quality",5,3,1,0,9
70942,2126,2010-04-19,Senate,"Do pass, but re-refer to the Committee on Appropriations",4,2,1,0,7
70942,2127,2010-05-03,Senate,"Do pass",6,3,2,0,11
70942,2128,2010-05-27,Senate,"Senate 3rd Reading SB1173 Wolk",22,11,5,0,38
70942,8748,2010-06-15,Assembly,"Do pass and be re-referred to the Committee on Environmental Safety and Toxic Materials",7,4,1,0,12
70942,10011,2010-06-29,Assembly,"Do pass and be re-referred to the Committee on Appropriations",6,3,0,0,9
70942,20124,2010-08-12,Assembly,"Do pass",12,5,0,0,17
70942,20563,2010-08-19,Assembly,"SB 1173 Wolk  Senate Third Reading  By BUCHANAN",50,28,0,0,78
70942,21136,2010-08-25,Senate,"Unfinished Business SB1173 Wolk",22,11,0,0,33
70943,2159,2010-04-19,Senate,"Do pass, but re-refer to the Committee on Appropriations",3,2,0,0,5
70943,2160,2010-05-10,Senate,"Do pass",6,3,2,0,11
70943,2161,2010-06-02,Senate,"Senate 3rd Reading SB1174 Wolk",22,14,2,0,38
70943,9896,2010-06-30,Assembly,"Do pass and be re-referred to the Committee on Appropriations",6,3,0,0,9
70945,552,2010-04-06,Senate,"Do pass, but re-refer to the Committee on Appropriations Recommend Consent.",4,0,1,0,5
70945,553,2010-04-26,Senate,"Senate 3rd Reading SB1176 Aanestad",36,0,3,0,39
70945,9328,2010-06-16,Assembly,"Do pass as amended and re-refer to Committee on Appropriations with recommendation:  To Consent Calendar",8,0,0,0,8
70945,20510,2010-08-16,Assembly,"SB 1176 Aanestad  Senate Third Reading  By BERRYHILL, T",75,0,0,0,75
70945,21375,2010-08-26,Senate,"Special Consent #32 SB1176 Aanestad",34,0,0,0,34
70946,309,2010-04-13,Senate,"Do pass, but re-refer to the Committee on Food and Agriculture.",5,3,1,0,9
70946,310,2010-04-20,Senate,"Do pass, but re-refer to the Committee on Appropriations.",3,1,1,0,5
70946,311,2010-05-03,Senate,"Placed on Appropriations Suspense file.",10,0,1,0,11
70946,312,2010-05-27,Senate,"Do pass as amended.",7,3,1,0,11
70946,313,2010-06-02,Senate,"Senate 3rd Reading SB1177 Kehoe",21,13,4,0,38
70946,9921,2010-06-28,Assembly,"Do pass and be re-referred to the Committee on Agriculture",6,3,0,0,9
70947,1175,2010-03-23,Senate,"Do pass.",3,1,1,0,5
70947,1176,2010-05-28,Senate,"Senate 3rd Reading SB1178 Corbett Reconsider",28,0,10,0,38
70947,1177,2010-06-03,Senate,"W/O REF. TO FILE SB1178 Corbett",30,4,4,0,38
70947,8810,2010-05-28,Senate,"Senate 3rd Reading SB1178 Corbett",19,5,14,0,38
70947,9712,2010-06-29,Assembly,"Do pass",8,2,0,0,10
70947,20568,2010-08-19,Assembly,"SB 1178 Corbett  Senate Third Reading  By FEUER",60,17,0,0,77
70948,1002,2010-04-13,Senate,"Do pass as amended, and re-refer to the Committee on Appropriations.",6,3,0,0,9
70948,1003,2010-04-26,Senate,"Placed on Appropriations Suspense file.",9,0,2,0,11
70948,1004,2010-05-27,Senate,"Do pass as amended.",10,0,1,0,11
70948,1005,2010-06-02,Senate,"Senate 3rd Reading SB1179 Hollingsworth",28,6,4,0,38
70948,9847,2010-06-29,Assembly,"Do pass as amended and be re-referred to the Committee on Appropriations",12,0,1,0,13
70948,20133,2010-08-12,Assembly,"Do pass",17,0,0,0,17
70948,20345,2010-08-17,Assembly,"SB 1179 Hollingsworth  Senate Third Reading",72,3,0,0,75
70948,20580,2010-08-19,Senate,"Unfinished Business SB1179 Hollingsworth",24,7,0,0,31
70950,2810,2010-04-20,Senate,"Do pass as amended, and re-refer to the Committee on Appropriations",4,0,1,0,5
70950,2811,2010-05-17,Senate,"Placed on Appropriations Suspense file",10,0,1,0,11
70950,2812,2010-05-27,Senate,"Do pass",10,0,1,0,11
70950,2813,2010-06-02,Senate,"Special Consent #26 SB1181 Cedillo",35,0,3,0,38
70950,8787,2010-06-15,Assembly,"Do pass as amended and re-refer to Committee on Appropriations with recommendation:  To Consent Calendar",10,0,0,0,10
70950,20169,2010-08-12,Assembly,"Do pass",17,0,0,0,17
70950,21153,2010-08-23,Assembly,"SB 1181 Cedillo  Senate Third Reading  By EVANS",77,0,0,0,77
70950,21154,2010-08-25,Senate,"Unfinished Business SB1181 Cedillo",35,0,0,0,35
70955,3885,2010-04-21,Senate,"Do pass, but re-refer to the Committee on Appropriations",5,0,4,0,9
70955,3886,2010-05-17,Senate,"Placed on Appropriations Suspense file",10,0,1,0,11
70956,2735,2010-04-27,Senate,"Do pass, but re-refer to the Committee on Health",4,0,1,0,5
70956,2736,2010-05-05,Senate,"Do pass",9,0,0,0,9
70956,2737,2010-05-17,Senate,"Special Consent #24 SB1187 Strickland",33,0,5,0,38
70956,8816,2010-06-15,Assembly,"Do pass and be re-referred to the Committee on Judiciary to Consent Calendar",18,0,1,0,19
70956,9169,2010-06-22,Assembly,"Do pass, to Consent Calendar",10,0,0,0,10
70956,9614,2010-06-28,Assembly,"SB 1187 Strickland  Consent Calendar Second Day  Regular Session",73,0,6,0,79
70957,3152,2010-04-07,Senate,"Do pass, but re-refer to the Committee on Judiciary",9,1,1,0,11
70957,3153,2010-05-04,Senate,"Do pass as amended. To Consent Calendar",4,0,1,0,5
70957,3154,2010-05-17,Senate,"Consent Calendar 2nd SB1188 Wright",33,0,5,0,38
70957,8848,2010-06-15,Assembly,"Do pass as amended, to Consent Calendar",10,0,0,0,10
70957,19083,2010-08-02,Assembly,"SB 1188 Wright  Consent Calendar Second Day  Regular Session",76,0,0,0,76
70957,19708,2010-08-09,Senate,"Special Consent #30 SB1188 Wright",34,0,0,0,34
70959,550,2010-04-06,Senate,"Do pass.",7,0,0,0,7
70959,551,2010-04-08,Senate,"Senate 3rd Reading SB1190 Cedillo",32,0,7,0,39
70959,9075,2010-06-15,Assembly,"Do pass, to Consent Calendar",7,0,0,0,7
70959,9119,2010-06-21,Assembly,"SB 1190 Cedillo  Consent Calendar Second Day  Regular Session",75,0,4,0,79
70959,9598,2010-06-28,Senate,"Special Consent #28 SB1190 Cedillo",32,0,7,0,39
70960,471,2010-04-14,Senate,"Do pass as amended.",8,0,1,0,9
70960,472,2010-05-10,Senate,"Senate 3rd Reading SB1191 Wiggins",27,0,11,0,38
70960,9068,2010-06-16,Assembly,"Do pass as amended, to Consent Calendar",8,0,1,0,9
70960,10332,2010-07-01,Assembly,"SB 1191 Wiggins  Consent Calendar Second Day  Regular Session",76,0,3,0,79
70960,19715,2010-08-09,Senate,"Special Consent #30 SB1191 Wiggins",34,0,0,0,34
70961,3197,2010-05-04,Senate,"Do pass, but re-refer to the Committee on Local Government",4,0,1,0,5
70961,3198,2010-05-05,Senate,"Do pass as amended, and re-refer to the Committee on Appropriations",5,0,0,0,5
70961,3199,2010-05-24,Senate,"Placed on Appropriations Suspense file",10,0,1,0,11
70961,3200,2010-05-27,Senate,"Do pass as amended",7,2,2,0,11
70961,3201,2010-06-03,Senate,"Senate 3rd Reading SB1192 Oropeza",32,1,5,0,38
70961,9977,2010-06-29,Assembly,"Do pass as amended and be re-referred to the Committee on Appropriations",7,2,1,0,10
70961,19391,2010-08-04,Assembly,"Do pass as amended",12,5,0,0,17
70961,21155,2010-08-25,Assembly,"Do pass as amended",6,1,0,0,7
70961,21683,2010-08-30,Assembly,"SB 1192 Oropeza  Senate Third Reading  By FEUER",49,27,0,0,76
70961,21781,2010-08-31,Senate,"Unfinished Business SB1192 Oropeza",21,15,0,0,36
70962,1348,2010-04-14,Senate,"Do pass as amended, and re-refer to the Committee on Appropriations.",5,2,2,0,9
70962,1349,2010-05-03,Senate,"Placed on Appropriations Suspense file.",10,0,1,0,11
70962,1350,2010-05-27,Senate,"Do pass as amended.",7,3,1,0,11
70962,1351,2010-06-03,Senate,"Senate 3rd Reading SB1193 Lowenthal Urgency Clause",27,4,7,0,38
70962,10259,2010-06-30,Assembly,"Do pass as amended and be re-referred to the Committee on Appropriations",7,1,1,0,9
70962,20215,2010-08-12,Assembly,"Do pass as amended",12,5,0,0,17
70963,3717,2010-04-19,Senate,"Do pass",2,4,1,0,7
70965,2584,2010-04-13,Senate,"Do pass, but re-refer to the Committee on Appropriations",4,0,1,0,5
70965,2585,2010-05-03,Senate,"Senate 3rd Reading SB1196 Negrete McLeod",33,0,5,0,38
70967,235,2010-04-20,Senate,"Do pass as amended, and re-refer to the Committee on Appropriations.",6,4,1,0,11
70967,236,2010-05-10,Senate,"Do pass.",5,4,2,0,11
70967,237,2010-05-10,Senate,"Set, first hearing.  Failed passage in Committee.  Reconsideration granted.",9,0,2,0,11
70967,238,2010-05-17,Senate,"Do pass.",6,4,1,0,11
70967,239,2010-06-01,Senate,"Senate 3rd Reading SB1198 Huff",24,9,5,0,38
70967,9161,2010-06-21,Assembly,"Do pass and be re-referred to the Committee on Natural Resources",12,1,2,0,15
70967,10037,2010-06-28,Assembly,"Do pass as amended and be re-referred to the Committee on Appropriations",7,0,2,0,9
70967,19755,2010-08-04,Assembly,"Do pass",17,0,0,0,17
70967,20459,2010-08-18,Assembly,"SB 1198 Huff  Senate Third Reading  By FUENTES",69,3,0,0,72
70967,21547,2010-08-25,Senate,"Unfinished Business SB1198 Huff",25,10,0,0,35
70969,2323,2010-04-21,Senate,"Do pass as amended, and re-refer to the Committee on Appropriations",5,0,4,0,9
70969,2324,2010-05-17,Senate,"Placed on Appropriations Suspense file",10,0,1,0,11
70969,2325,2010-05-27,Senate,"Do pass as amended",7,3,1,0,11
70969,2326,2010-06-03,Senate,"Senate 3rd Reading SB1200 Leno",22,10,6,0,38
70969,9529,2010-06-22,Assembly,"Do pass and be re-referred to the Committee on Appropriations",13,5,1,0,19
70970,1143,2010-04-13,Senate,"Do pass as amended, and re-refer to the Committee on Appropriations.",7,0,0,0,7
70970,1144,2010-05-10,Senate,"Special Consent #23 SB1201 DeSaulnier",30,0,8,0,38
70970,9175,2010-06-22,Assembly,"Do pass and re-refer to Committee on Appropriations with recommendation:  To Consent Calendar",6,0,1,0,7
70970,10226,2010-06-30,Assembly,"Do pass, to Consent Calendar",17,0,0,0,17
70970,20475,2010-08-17,Assembly,"SB 1201 DeSaulnier  Senate Third Reading  By FLETCHER",75,0,0,0,75
70970,21147,2010-08-25,Assembly,"SB 1201 DeSaulnier  Senate Third Reading  By FLETCHER",78,0,0,0,78
70970,21347,2010-08-26,Senate,"From committee:  That the Assembly Amendments be concurred in",7,0,0,0,7
70970,21585,2010-08-27,Senate,"Unfinished Business SB1201 DeSaulnier",35,0,0,0,35
70971,3018,2010-04-20,Senate,"Do pass, but re-refer to the Committee on Appropriations",3,2,0,0,5
70971,3019,2010-05-03,Senate,"Placed on Appropriations Suspense file",10,0,1,0,11
70971,3020,2010-05-27,Senate,"Do pass",7,3,1,0,11
70971,3021,2010-06-02,Senate,"Senate 3rd Reading SB1202 DeSaulnier",21,14,3,0,38
70971,9276,2010-06-22,Assembly,"Do pass as amended and be re-referred to the Committee on Appropriations",6,1,0,0,7
70971,19583,2010-08-04,Assembly,"Do pass",12,5,0,0,17
70971,20734,2010-08-19,Assembly,"SB 1202 DeSaulnier  Senate Third Reading  By ADAMS",52,26,0,0,78
70971,21077,2010-08-25,Senate,"Unfinished Business SB1202 DeSaulnier",21,11,0,0,32
70972,1316,2010-04-06,Senate,"Do pass.",3,2,0,0,5
70972,1317,2010-05-28,Senate,"Senate 3rd Reading SB1203 DeSaulnier",22,5,11,0,38
70972,9434,2010-06-22,Assembly,"Do pass",5,2,0,0,7
70972,20765,2010-08-20,Assembly,"SB 1203 DeSaulnier  Senate Third Reading  Amend By HERNANDEZ  Set #1",49,26,0,0,75
70973,365,2010-04-20,Senate,"Do pass as amended, and re-refer to the Committee on Appropriations.",7,0,0,0,7
70973,366,2010-04-20,Senate,"Do pass as amended, and re-refer to the Committee on Appropriations.",7,0,0,0,7
70973,367,2010-05-10,Senate,"Do pass.",9,0,2,0,11
70973,368,2010-05-13,Senate,"Senate 3rd Reading SB1204 Runner",24,0,14,0,38
70973,9378,2010-06-22,Assembly,"Do pass and be re-referred to the Committee on Appropriations",4,3,0,0,7
70974,937,2010-04-07,Senate,"Do pass as amended, and re-refer to the Committee on Appropriations.",3,2,0,0,5
70974,938,2010-05-03,Senate,"Placed on Appropriations Suspense file.",10,0,1,0,11
70974,939,2010-05-27,Senate,"Do pass as amended.",7,3,1,0,11
70974,940,2010-06-02,Senate,"Senate 3rd Reading SB1205 Corbett",22,14,2,0,38
70974,10239,2010-06-30,Assembly,"Do pass and be re-referred to the Committee on Appropriations",6,3,0,0,9
70974,20191,2010-08-12,Assembly,"Do pass as amended",12,5,0,0,17
70974,20523,2010-08-19,Assembly,"SB 1205 Corbett  Senate Third Reading  By SKINNER",52,27,0,0,79
70974,21073,2010-08-25,Senate,"Unfinished Business SB1205 Corbett",24,9,0,0,33
70976,1163,2010-04-07,Senate,"Do pass, but re-refer to the Committee on Environmental Quality.",3,2,0,0,5
70976,1164,2010-04-19,Senate,"Do pass, but re-refer to the Committee on Appropriations.",5,1,1,0,7
70976,1165,2010-05-03,Senate,"Placed on Appropriations Suspense file.",10,0,1,0,11
70976,1166,2010-05-27,Senate,"Do pass.",7,3,1,0,11
70976,1167,2010-06-01,Senate,"Senate 3rd Reading SB1207 Kehoe",23,11,4,0,38
70976,9048,2010-06-16,Assembly,"Do pass and be re-referred to the Committee on Natural Resources",7,1,1,0,9
70976,9740,2010-06-28,Assembly,"Do pass and be re-referred to the Committee on Appropriations",7,0,2,0,9
70976,20099,2010-08-12,Assembly,"Do pass",12,5,0,0,17
70976,21089,2010-08-25,Assembly,"SB 1207 Kehoe  Senate Third Reading  By DE LA TORRE",56,20,0,0,76
70976,21482,2010-08-26,Senate,"Unfinished Business SB1207 Kehoe",23,13,0,0,36
70978,3765,2010-04-19,Senate,"Do pass, but re-refer to the Committee on Appropriations",2,2,2,0,6
70978,3766,2010-04-19,Senate,"Set, second hearing.  Failed passage in Committee. Reconsideration granted",6,0,0,0,6
70980,5165,2010-04-19,Senate,"Do pass, but re-refer to the Committee on Appropriations Recommend Consent",6,0,0,0,6
70980,5166,2010-05-10,Senate,"Consent Calendar 2nd SB1211 Romero",30,0,8,0,38
70980,9245,2010-06-23,Assembly,"Do pass as amended and re-refer to Committee on Appropriations with recommendation:  To Consent Calendar",12,0,0,0,12
70980,19565,2010-08-04,Assembly,"Do pass, to Consent Calendar",17,0,0,0,17
70980,19979,2010-08-12,Assembly,"SB 1211 Romero  Consent Calendar Second Day  Regular Session",78,0,0,0,78
70980,20740,2010-08-19,Senate,"Unfinished Business SB1211 Romero",33,1,0,0,34
70981,597,2010-04-19,Senate,"Do pass as amended.",4,2,1,0,7
70981,598,2010-06-03,Senate,"Senate 3rd Reading SB1212 Leno Reconsider",36,0,2,0,38
70981,9028,2010-06-03,Senate,"Senate 3rd Reading SB1212 Leno",16,14,8,0,38
70982,3887,2010-03-24,Senate,"Do pass as amended, and re-refer to the Committee on Appropriations",4,2,0,0,6
70982,3888,2010-05-03,Senate,"Placed on Appropriations Suspense file",10,0,1,0,11
70983,1911,2010-03-23,Senate,"Do pass, but re-refer to the Committee on Appropriations",4,0,1,0,5
70983,1912,2010-06-01,Senate,"Senate 3rd Reading SB1214 Wolk",33,0,5,0,38
70983,9878,2010-06-29,Assembly,"Do pass as amended and be re-referred to the Committee on Appropriations",6,0,0,0,6
70983,20160,2010-08-12,Assembly,"Do pass as amended",17,0,0,0,17
70983,21651,2010-08-30,Assembly,"SB 1214 Wolk  Senate Third Reading  By PORTANTINO",78,0,0,0,78
70983,21652,2010-08-30,Senate,"W/O REF. TO FILE SB1214 Wolk Concurrence",37,0,0,0,37
70984,1254,2010-04-20,Senate,"Do pass, but re-refer to the Committee on Appropriations.",7,1,1,0,9
70984,1255,2010-05-28,Senate,"Senate 3rd Reading SB1215 Price",28,2,8,0,38
70984,10057,2010-06-28,Assembly,"Do pass and be re-referred to the Committee on Appropriations",7,2,5,0,14
70985,4341,2010-04-06,Senate,"Do pass, but re-refer to the Committee on Appropriations",8,0,1,0,9
70985,4342,2010-04-28,Senate,"Do pass as amended, and re-refer to the Committee on Appropriations",4,0,1,0,5
70985,4343,2010-05-24,Senate,"Placed on Appropriations Suspense file",10,0,1,0,11
70986,4706,2010-04-12,Senate,"Do pass, but re-refer to the Committee on Appropriations Recommend Consent",6,0,0,0,6
70986,4707,2010-04-29,Senate,"Consent Calendar 2nd SB1217 Committee on P.E. & R. (Correa)",33,0,5,0,38
70986,9433,2010-06-23,Assembly,"Do pass and re-refer to Committee on Appropriations with recommendation:  To Consent Calendar",6,0,0,0,6
70986,10316,2010-06-30,Assembly,"Do pass, to Consent Calendar",17,0,0,0,17
70986,19885,2010-08-05,Assembly,"SB 1217 P.E.& R.  Consent Calendar Second Day  Regular Session",71,0,0,0,71
70989,5293,2010-05-04,Senate,"Do pass",8,0,1,0,9
70989,5294,2010-05-10,Senate,"Senate 3rd Reading SB1220 Wolk Urgency Clause",31,0,7,0,38
70989,9390,2010-06-21,Assembly,"Do pass as amended",13,0,1,0,14
70989,19564,2010-08-04,Assembly,"Do pass, to Consent Calendar",17,0,0,0,17
70989,19976,2010-08-12,Assembly,"SB 1220 Wolk  Consent Calendar Second Day  Regular Session",78,0,0,0,78
70989,20735,2010-08-19,Senate,"Unfinished Business SB1220 Wolk Urgency Clause",35,0,0,0,35
70990,4722,2010-03-23,Senate,"Do pass as amended. To Consent Calendar",5,0,0,0,5
70990,4723,2010-04-08,Senate,"Consent Calendar 2nd SB1221 Calderon",32,0,7,0,39
70990,9267,2010-06-21,Assembly,"Do pass and be re-referred to the Committee on Judiciary",11,0,1,0,12
70990,10048,2010-06-29,Assembly,"Do pass, to Consent Calendar",10,0,0,0,10
70990,19451,2010-08-05,Assembly,"SB 1221 Calderon  Consent Calendar Second Day  Regular Session",71,0,0,0,71
70991,3058,2010-04-27,Senate,"Do pass as amended",3,1,1,0,5
70991,3059,2010-05-17,Senate,"Senate 3rd Reading SB1222 Wolk",18,13,7,0,38
70991,3060,2010-05-17,Senate,"Senate 3rd Reading SB1222 Wolk Reconsider",25,0,13,0,38
70991,3061,2010-06-01,Senate,"Senate 3rd Reading SB1222 Wolk",21,14,3,0,38
70991,8718,2010-06-15,Assembly,"Do pass",7,3,0,0,10
70991,20395,2010-08-16,Assembly,"SB 1222 Wolk  Senate Third Reading  By EVANS",45,27,0,0,72
70992,4222,2010-04-07,Senate,"Do pass, but re-refer to the Committee on Judiciary",9,0,2,0,11
70992,4223,2010-04-13,Senate,"Do pass, but re-refer to the Committee on Appropriations Recommend Consent",4,0,1,0,5
70992,4224,2010-04-29,Senate,"Consent Calendar 2nd SB1223 Calderon",33,0,5,0,38
70992,9375,2010-06-21,Assembly,"Do pass and be re-referred to the Committee on Judiciary",11,0,1,0,12
70992,10076,2010-06-29,Assembly,"Do pass and be re-referred to the Committee on Appropriations",10,0,0,0,10
70992,19603,2010-08-04,Assembly,"Do pass, to Consent Calendar",17,0,0,0,17
70992,19931,2010-08-12,Assembly,"SB 1223 Calderon  Consent Calendar Second Day  Regular Session",78,0,0,0,78
70992,20719,2010-08-19,Senate,"Unfinished Business SB1223 Calderon",35,0,0,0,35
70993,605,2010-05-03,Senate,"Do pass as amended.",6,1,0,0,7
70993,606,2010-05-24,Senate,"Senate 3rd Reading SB1224 Wright",29,2,7,0,38
70993,9393,2010-06-21,Assembly,"Do pass",6,0,3,0,9
70993,20349,2010-08-17,Assembly,"SB 1224 Wright  Senate Third Reading  By HALL",74,0,0,0,74
70994,4344,2010-04-14,Senate,"Do pass, but re-refer to the Committee on Appropriations",6,2,1,0,9
70994,4345,2010-05-03,Senate,"Placed on Appropriations Suspense file",10,0,1,0,11
71133,680,2010-04-20,Assembly,"Do pass as amended and be re-referred to the Committee on Appropriations.",9,0,0,0,9
71133,681,2010-05-28,Assembly,"Do pass.",12,5,0,0,17
71133,682,2010-06-01,Assembly,"AB 2302 FONG  Assembly Third Reading",75,2,2,0,79
71133,10285,2010-06-30,Senate,"Do pass as amended, and re-refer to the Committee on Appropriations",7,0,2,0,9
71133,19323,2010-08-02,Senate,"Placed on Appropriations Suspense file",10,0,0,0,10
71133,20096,2010-08-12,Senate,"Do pass as amended",8,2,0,0,10
71133,21094,2010-08-25,Senate,"Assembly 3rd Reading AB2302 Fong By Alquist",29,0,0,0,29
71133,21345,2010-08-26,Assembly,"AB 2302 FONG  Concurrence in Senate Amendments",75,0,0,0,75
71134,4367,2010-04-12,Assembly,"Do pass and be re-referred to the Committee on Appropriations",0,5,9,0,14
71135,1463,2010-04-27,Assembly,"Do pass and be re-referred to the Committee on Local Government",7,3,2,0,12
71135,1464,2010-05-05,Assembly,"Do pass",6,3,0,0,9
71135,1465,2010-06-02,Assembly,"AB 2304 HUFFMAN  Assembly Third Reading",49,27,3,0,79
71135,9446,2010-06-22,Senate,"Do pass, but re-refer to the Committee on Appropriations",5,3,1,0,9
71135,21253,2010-08-25,Senate,"Assembly 3rd Reading AB2304 Huffman By Wolk",22,12,0,0,34
71135,21733,2010-08-30,Assembly,"AB 2304 HUFFMAN  Concurrence in Senate Amendments",48,28,0,0,76
71136,4395,2010-04-20,Assembly,"Do pass as amended and be re-referred to the Committee on Appropriations",7,2,2,0,11
71136,4396,2010-05-05,Assembly,"Do pass",17,0,0,0,17
71136,4397,2010-05-13,Assembly,"AB 2305 KNIGHT  Assembly Third Reading",62,11,6,0,79
71136,9097,2010-06-21,Senate,"Do pass, but re-refer to the Committee on Labor and Industrial Relations",5,1,3,0,9
71136,9398,2010-06-23,Senate,"Do pass as amended, and re-refer to the Committee on Appropriations",5,0,1,0,6
71136,20712,2010-08-20,Senate,"Assembly 3rd Reading AB2305 Knight By Runner",31,0,0,0,31
71136,20856,2010-08-23,Assembly,"AB 2305 KNIGHT  Concurrence in Senate Amendments",71,2,0,0,73
71138,5007,2010-04-21,Assembly,"Do pass as amended and re-refer to Committee on Appropriations with recommendation:  To Consent Calendar",9,0,0,0,9
71138,5008,2010-05-19,Assembly,"Do pass, to Consent Calendar",16,0,1,0,17
71138,5009,2010-05-28,Assembly,"AB 2307 CARTER  Consent Calendar Second Day  Regular Session",63,0,16,0,79
71138,10194,2010-06-30,Senate,"Do pass as amended, but re-refer to the Committee on Appropriations Recommend Consent",8,0,1,0,9
71138,19774,2010-08-09,Senate,"Placed on Appropriations Suspense file",10,0,0,0,10
71139,8567,2010-03-25,Assembly,"Be referred to Committee on Judiciary",6,4,1,0,11
71140,3763,2010-04-27,Assembly,"Do pass as amended",8,0,1,0,9
71140,3764,2010-05-10,Assembly,"AB 2309 FLETCHER  Assembly Third Reading",71,0,8,0,79
71140,9566,2010-06-22,Senate,"Do pass and be placed on the Consent Calendar",4,0,1,0,5
71140,9985,2010-07-01,Senate,"Assembly 3rd Reading AB2309 Fletcher By Ducheny",35,0,4,0,39
71140,9986,2010-07-01,Senate,"Assembly 3rd Reading AB2309 Fletcher Reconsider",34,0,5,0,39
71140,19853,2010-08-11,Senate,"Assembly 3rd Reading AB2309 Fletcher By Ducheny",34,0,0,0,34
71142,1029,2010-04-12,Assembly,"Do pass as amended and be re-referred to the Committee on Appropriations.",9,0,0,0,9
71144,1052,2010-04-19,Assembly,"Do pass as amended and be re-referred to the Committee on Appropriations.",8,0,1,0,9
71144,1053,2010-05-28,Assembly,"Do pass.",12,5,0,0,17
71144,1054,2010-06-03,Assembly,"AB 2313 BUCHANAN  Assembly Third Reading",65,6,8,0,79
71145,4418,2010-04-19,Assembly,"Do pass, to Consent Calendar",9,0,0,0,9
71145,4419,2010-04-26,Assembly,"AB 2314 BLOCK  Consent Calendar Second Day  Regular Session",71,0,8,0,79
71145,4420,2010-06-09,Senate,"Do pass and be placed on the Consent Calendar",3,0,2,0,5
71145,10002,2010-07-01,Senate,"Assembly 3rd Reading AB2314 Block By Wolk",35,0,4,0,39
71145,19556,2010-08-02,Assembly,"AB 2314 BLOCK  Concurrence in Senate Amendments",76,0,0,0,76
71148,4393,2010-04-14,Assembly,"Do pass",6,2,1,0,9
71148,4394,2010-05-17,Assembly,"AB 2317 SALDANA  Assembly Third Reading",47,24,8,0,79
71148,9032,2010-06-16,Senate,"Do pass",3,1,1,0,5
71148,20490,2010-08-18,Senate,"Assembly 3rd Reading AB2317 Saldana Reconsider",34,0,0,0,34
71148,21170,2010-08-25,Senate,"Assembly 3rd Reading AB2317 Saldana By Kehoe",21,14,0,0,35
71148,21596,2010-08-27,Assembly,"AB 2317 SALDANA  Concurrence in Senate Amendments",52,25,0,0,77
71150,317,2010-04-13,Assembly,"Do pass as amended and be re-referred to the Committee on Appropriations.",7,0,0,0,7
71151,1853,2010-04-21,Assembly,"Do pass as amended and be re-referred to the Committee on Appropriations",5,4,0,0,9
71151,1854,2010-05-28,Assembly,"Do pass as amended",12,5,0,0,17
71151,1855,2010-06-03,Assembly,"AB 2320 SWANSON  Assembly Third Reading",48,29,2,0,79
71151,9882,2010-06-30,Senate,"Do pass as amended, and re-refer to the Committee on Appropriations",2,3,4,0,9
71153,267,2010-04-27,Assembly,"Amend, and re-refer to the Committee on Human Services.",6,0,0,0,6
71153,268,2010-05-11,Assembly,"Do pass and be re-referred to the Committee on Appropriations.",6,0,0,0,6
71153,269,2010-05-19,Assembly,"Do pass, to Consent Calendar.",16,0,1,0,17
71153,270,2010-06-01,Assembly,"AB 2322 FEUER  Third Reading Urgency",77,0,2,0,79
71153,10018,2010-06-30,Senate,"Do pass as amended, and re-refer to the Committee on Appropriations",5,0,0,0,5
71153,19828,2010-08-09,Senate,"Do pass",8,0,0,0,8
71153,20938,2010-08-23,Senate,"Assembly 3rd Reading AB2322 Feuer Urgency Clause",36,0,0,0,36
71153,21054,2010-08-24,Assembly,"AB 2322 FEUER  Concurrence in Senate Amendments",77,0,0,0,77
71154,803,2010-04-07,Assembly,"Do pass as amended and be re-referred to the Committee on Appropriations.",5,0,4,0,9
71155,4462,2010-04-13,Assembly,"Do pass and be re-referred to the Committee on Appropriations",6,0,1,0,7
71155,4463,2010-04-28,Assembly,"Do pass as amended",14,0,3,0,17
71155,4464,2010-05-13,Assembly,"AB 2324 PEREZ, J.  Assembly Third Reading",77,0,2,0,79
71155,9233,2010-06-22,Senate,"Do pass, but re-refer to the Committee on Appropriations",6,0,1,0,7
71155,21280,2010-08-25,Senate,"Assembly 3rd Reading AB2324 John A. Perez By Leno",32,0,0,0,32
71155,21543,2010-08-27,Assembly,"AB 2324 PEREZ, J.  Concurrence in Senate Amendments",75,0,0,0,75
71156,2238,2010-04-19,Assembly,"Do pass as amended and be re-referred to the Committee on Appropriations",9,2,1,0,12
71156,2239,2010-05-12,Assembly,"Do pass",11,5,1,0,17
71156,2240,2010-05-20,Assembly,"AB 2325 LIEU  Assembly Third Reading",46,24,9,0,79
71156,9451,2010-06-22,Senate,"Do pass, but re-refer to the Committee on Appropriations",3,1,1,0,5
71156,20518,2010-08-18,Senate,"Assembly 3rd Reading AB2325 Lieu By Calderon",22,12,0,0,34
71157,2550,2010-04-06,Assembly,"Do pass and be re-referred to the Committee on Appropriations",7,0,0,0,7
71157,2551,2010-05-28,Assembly,"Do pass as amended",12,5,0,0,17
71157,2552,2010-06-02,Assembly,"AB 2326 BASS  Assembly Third Reading",54,20,5,0,79
71157,9147,2010-06-22,Senate,"Do pass as amended, and re-refer to the Committee on Appropriations",6,0,1,0,7
71157,19220,2010-08-02,Senate,"Placed on Appropriations Suspense file",10,0,0,0,10
71157,20118,2010-08-12,Senate,"Do pass",7,4,0,0,11
71157,21271,2010-08-25,Senate,"Assembly 3rd Reading AB2326 Bass By Leno",24,6,0,0,30
71157,21537,2010-08-27,Assembly,"AB 2326 BASS  Concurrence in Senate Amendments",55,20,0,0,75
71158,873,2010-04-07,Assembly,"Do pass as amended and be re-referred to the Committee on Housing and Community Development.",11,0,1,0,12
71158,874,2010-04-14,Assembly,"Do pass as amended and be re-referred to the Committee on Appropriations.",7,0,2,0,9
71158,875,2010-05-19,Assembly,"Do pass as amended, to Consent Calendar.",16,0,1,0,17
71158,876,2010-05-28,Assembly,"AB 2327 HARKEY  Consent Calendar Second Day  Regular Session",63,0,16,0,79
71158,9888,2010-06-30,Senate,"Do pass, but re-refer to the Committee on Appropriations Recommend Consent",10,0,1,0,11
71158,19476,2010-08-05,Senate,"Consent Calendar 2nd AB2327 Harkey",33,0,0,0,33
71158,20171,2010-08-12,Assembly,"AB 2327 HARKEY  Concurrence in Senate Amendments",78,0,0,0,78
71159,3122,2010-04-12,Assembly,"Do pass as amended and be re-referred to the Committee on Appropriations",7,2,0,0,9
71159,3123,2010-04-28,Assembly,"Do pass",14,1,2,0,17
71159,3124,2010-05-10,Assembly,"AB 2328 NIELLO  Assembly Third Reading",58,9,12,0,79
71159,8706,2010-06-14,Senate,"Do pass as amended, and re-refer to the Committee on Appropriations",5,1,1,0,7
71159,19551,2010-08-02,Senate,"Do pass",4,5,0,0,9
71159,19552,2010-08-02,Senate,"Set, first hearing.  Failed passage in Committee.  Reconsideration 	granted",10,0,0,0,10
71159,20266,2010-08-09,Senate,"Do pass",3,5,0,0,8
71160,372,2010-04-19,Assembly,"Do pass as amended and be re-referred to the Committee on Appropriations.",6,3,0,0,9
71160,373,2010-05-28,Assembly,"Do pass.",12,5,0,0,17
71160,374,2010-06-02,Assembly,"AB 2329 RUSKIN  Assembly Third Reading",49,27,3,0,79
71160,9876,2010-06-28,Senate,"Do pass as amended, and re-refer to the Committee on Appropriations",5,2,0,0,7
71160,19128,2010-08-02,Senate,"Placed on Appropriations Suspense file",10,0,0,0,10
71160,21830,2010-08-31,Senate,"W/O REF. TO FILE AB2329 Ruskin By Lowenthal",17,16,0,0,33
71161,1148,2010-04-20,Assembly,"Do pass and be re-referred to the Committee on Judiciary.",7,0,0,0,7
71162,1008,2010-04-07,Assembly,"Do pass and be re-referred to the Committee on Appropriations.",9,0,0,0,9
71162,1009,2010-04-21,Assembly,"Do pass, to Consent Calendar.",17,0,0,0,17
71162,1010,2010-04-29,Assembly,"AB 2331 SKINNER  Consent Calendar Second Day  Regular Session",74,0,5,0,79
71162,9414,2010-06-22,Senate,"Do pass as amended",4,0,1,0,5
71162,19686,2010-08-09,Senate,"Special Consent #30 AB2331 Skinner",34,0,0,0,34
71162,21131,2010-08-24,Senate,"Assembly 3rd Reading AB2331 Skinner By Leno",34,0,0,0,34
71162,21578,2010-08-27,Assembly,"AB 2331 SKINNER  Concurrence in Senate Amendments",77,0,0,0,77
71163,4302,2010-04-06,Assembly,"Do pass and be re-referred to the Committee on Appropriations",7,2,2,0,11
71163,4303,2010-04-21,Assembly,"Do pass",12,5,0,0,17
71163,4304,2010-06-02,Assembly,"AB 2332 ENG  Assembly Third Reading",48,28,3,0,79
71163,9184,2010-06-21,Senate,"Do pass, but re-refer to the Committee on Appropriations",4,1,4,0,9
71163,9185,2010-06-21,Senate,"Set, first hearing.  Failed passage in Committee.  Reconsideration granted",7,0,2,0,9
71163,10190,2010-06-28,Senate,"Do pass, but re-refer to the Committee on Appropriations",5,2,2,0,9
71163,21290,2010-08-23,Senate,"Assembly 3rd Reading AB2332 Eng By Negrete McLeod",22,14,0,0,36
71164,620,2010-04-06,Assembly,"Do pass.",2,4,1,0,7
71164,621,2010-04-06,Assembly,"Set first hearing.  Failed passage.  Reconsideration granted.",7,0,0,0,7
71166,2894,2010-04-21,Assembly,"Do pass as amended and re-refer to Committee on Appropriations with recommendation:  To Consent Calendar",9,0,0,0,9
71166,2895,2010-05-28,Assembly,"Do pass",17,0,0,0,17
71166,2896,2010-06-02,Assembly,"AB 2335 BROWNLEY  Assembly Third Reading",76,0,3,0,79
71167,1260,2010-04-13,Assembly,"Do pass as amended and be re-referred to the Committee on Appropriations.",10,1,2,0,13
71167,1261,2010-05-05,Assembly,"Do pass.",16,0,1,0,17
71167,1262,2010-05-20,Assembly,"AB 2336 FULLER  Assembly Third Reading",64,5,10,0,79
71168,1269,2010-04-21,Assembly,"Do pass as amended and be re-referred to the Committee on Appropriations.",4,2,0,0,6
71168,1270,2010-05-28,Assembly,"Do pass as amended.",12,5,0,0,17
71168,1271,2010-06-02,Assembly,"AB 2337 AMMIANO  Assembly Third Reading",43,30,6,0,79
71168,9631,2010-06-28,Senate,"Do pass, but re-refer to the Committee on Appropriations",1,4,1,0,6
71168,9632,2010-06-28,Senate,"Set, first hearing.  Failed passage in Committee.  Reconsideration granted",6,0,0,0,6
71169,225,2010-04-19,Assembly,"Do pass and re-refer to Committee on Appropriations with recommendation:  To Consent Calendar.",13,0,1,0,14
71169,226,2010-05-28,Assembly,"Do pass as amended.",17,0,0,0,17
71169,227,2010-06-02,Assembly,"AB 2338 CONWAY  Assembly Third Reading",76,0,3,0,79
71169,9146,2010-06-22,Senate,"Do pass, but re-refer to the Committee on Appropriations Recommend Consent",6,0,3,0,9
71169,19130,2010-08-02,Senate,"Do pass",9,0,0,0,9
71169,20448,2010-08-18,Senate,"Special Consent #31 AB2338 Conway By Ashburn",34,0,0,0,34
71170,223,2010-04-13,Assembly,"Do pass, to Consent Calendar.",7,0,0,0,7
71170,224,2010-04-22,Assembly,"AB 2339 SMYTH  Consent Calendar Second Day",74,0,5,0,79
71170,9023,2010-06-15,Senate,"Do pass",7,0,0,0,7
71170,9661,2010-06-28,Senate,"Special Consent #28 AB2339 Smyth",32,0,7,0,39
71171,1501,2010-04-21,Assembly,"Do pass and be re-referred to the Committee on Appropriations",4,2,1,0,7
71171,1502,2010-05-12,Assembly,"Do pass",11,5,1,0,17
71171,1503,2010-06-01,Assembly,"AB 2340 MONNING  Assembly Third Reading",47,28,4,0,79
71171,9496,2010-06-23,Senate,"Do pass, but re-refer to the Committee on Appropriations",4,1,1,0,6
71171,19419,2010-08-02,Senate,"Do pass",7,3,0,0,10
71171,20777,2010-08-20,Senate,"Assembly 3rd Reading AB2340 Monning By Corbett",22,10,0,0,32
71171,20913,2010-08-23,Assembly,"AB 2340 MONNING  Concurrence in Senate Amendments",47,28,0,0,75
71173,2314,2010-04-13,Assembly,"Do pass as amended and be re-referred to the Committee on Appropriations",4,0,2,0,6
71173,2315,2010-05-28,Assembly,"Do pass as amended",12,5,0,0,17
71173,2316,2010-06-02,Assembly,"AB 2342 EVANS  Assembly Third Reading",54,20,5,0,79
71173,9519,2010-06-22,Senate,"Do pass, but re-refer to the Committee on Appropriations",3,2,0,0,5
71173,20434,2010-08-18,Senate,"Assembly 3rd Reading AB2342 Evans By Liu",21,12,0,0,33
71173,20641,2010-08-19,Assembly,"AB 2342 EVANS  Concurrence in Senate Amendments",55,23,0,0,78
71175,4228,2010-04-06,Assembly,"Do pass and be re-referred to the Committee on Business and Professions to Consent Calendar",9,0,0,0,9
71175,4229,2010-04-20,Assembly,"Do pass and be re-referred to the Committee on Appropriations",11,0,0,0,11
71175,4230,2010-05-05,Assembly,"Do pass, to Consent Calendar",17,0,0,0,17
71175,4231,2010-05-13,Assembly,"AB 2344 NIELSEN  Consent Calendar Second Day  Regular Session",76,0,3,0,79
71175,9677,2010-06-28,Senate,"Do pass, but re-refer to the Committee on Appropriations",7,0,2,0,9
71175,19605,2010-08-09,Senate,"Special Consent #30 AB2344 Nielsen",34,0,0,0,34
71176,182,2010-05-04,Assembly,"Do pass.",13,0,6,0,19
71176,183,2010-06-02,Assembly,"AB 2345 DE LA TORRE  Assembly Third Reading",52,11,16,0,79
71176,10175,2010-06-30,Senate,"Do pass as amended, and re-refer to the Committee on Appropriations",6,2,1,0,9
71176,19202,2010-08-02,Senate,"Placed on Appropriations Suspense file",10,0,0,0,10
71176,20072,2010-08-12,Senate,"Do pass as amended",7,4,0,0,11
71176,20899,2010-08-23,Senate,"Assembly 3rd Reading AB2345 De La Torre By Florez",22,14,0,0,36
71176,21023,2010-08-24,Assembly,"AB 2345 DE LA TORRE  Concurrence in Senate Amendments",50,26,0,0,76
71178,3194,2010-04-27,Assembly,"Do pass and be re-referred to the Committee on Banking and Finance",7,2,1,0,10
71178,3195,2010-05-03,Assembly,"Do pass as amended",8,1,3,0,12
71178,3196,2010-06-01,Assembly,"AB 2347 FEUER  Assembly Third Reading",50,25,4,0,79
71178,8802,2010-06-16,Senate,"Do pass, but re-refer to the Committee on Judiciary",7,0,4,0,11
71178,10275,2010-06-29,Senate,"Do pass as amended",3,1,1,0,5
71178,20937,2010-08-23,Senate,"Assembly 3rd Reading AB2347 Feuer By Padilla",22,14,0,0,36
71178,21053,2010-08-24,Assembly,"AB 2347 FEUER  Concurrence in Senate Amendments",51,27,0,0,78
71180,3296,2010-04-07,Assembly,"Do pass and be re-referred to the Committee on Appropriations",6,0,0,0,6
71180,3297,2010-04-21,Assembly,"Do pass",16,1,0,0,17
71180,3298,2010-04-26,Assembly,"AB 2349 FONG  Assembly Third Reading",68,2,9,0,79
71180,9474,2010-06-23,Senate,"Do pass, but re-refer to the Committee on Appropriations",4,1,1,0,6
71180,10655,2010-07-15,Senate,"Placed on Appropriations Suspense file",8,0,2,0,10
71181,4999,2010-04-06,Assembly,"Do pass as amended",7,0,0,0,7
71181,5000,2010-04-15,Assembly,"AB 2350 HILL  Assembly Third Reading",72,0,7,0,79
71181,8796,2010-06-15,Senate,"Do pass",7,0,0,0,7
71181,9604,2010-06-28,Senate,"Special Consent #28 AB2350 Hill",32,0,7,0,39
71182,3666,2010-04-12,Assembly,"Do pass as amended and be re-referred to the Committee on Appropriations",7,2,0,0,9
71182,3667,2010-04-28,Assembly,"Do pass",11,3,3,0,17
71182,3668,2010-05-06,Assembly,"AB 2351 CHESBRO  Assembly Third Reading",55,18,6,0,79
71182,6586,2010-06-09,Senate,"Do pass, but re-refer to the Committee on Appropriations",5,1,3,0,9
71182,9918,2010-06-28,Senate,"Do pass",8,0,3,0,11
71182,21098,2010-08-20,Senate,"Assembly 3rd Reading AB2351 Chesbro By Kehoe",22,9,0,0,31
71183,49,2010-04-20,Assembly,"Do pass and be re-referred to the Committee on Appropriations.",17,0,2,0,19
71183,50,2010-05-28,Assembly,"Do pass.",12,5,0,0,17
71183,51,2010-06-01,Assembly,"AB 2352 PEREZ, J.  Assembly Third Reading",62,12,5,0,79
71183,9377,2010-06-23,Senate,"Do pass as amended, and re-refer to the Committee on Appropriations",6,0,3,0,9
71183,19191,2010-08-02,Senate,"Placed on Appropriations Suspense file",10,0,0,0,10
71183,19999,2010-08-12,Senate,"Do pass",7,4,0,0,11
71183,20970,2010-08-24,Senate,"Assembly 3rd Reading AB2352 John A. Perez By Emmerson",31,4,0,0,35
71183,21723,2010-08-30,Assembly,"AB 2352 PEREZ, J.  Concurrence in Senate Amendments",66,11,0,0,77
71184,589,2010-04-19,Assembly,"Do pass as amended and be re-referred to the Committee on Appropriations.",9,0,0,0,9
71185,1899,2010-04-20,Assembly,"Do pass and be re-referred to the Committee on Appropriations",11,5,3,0,19
71185,1900,2010-05-28,Assembly,"Do pass as amended",12,5,0,0,17
71185,1901,2010-06-03,Assembly,"AB 2354 PEREZ, V.M.  Assembly Third Reading",50,26,3,0,79
71185,10209,2010-06-30,Senate,"Do pass, but re-refer to the Committee on Appropriations",6,2,1,0,9
71185,19362,2010-08-02,Senate,"Placed on Appropriations Suspense file",10,0,0,0,10
71186,206,2010-04-20,Assembly,"Do pass and be re-referred to the Committee on Appropriations.",3,6,2,0,11
71186,207,2010-04-20,Assembly,"Set second hearing.  Failed passage.  Reconsideration granted.",11,0,0,0,11
71188,3508,2010-04-20,Assembly,"Do pass and be re-referred to the Committee on Appropriations",7,0,0,0,7
71188,3509,2010-04-28,Assembly,"Do pass",13,1,3,0,17
71188,3510,2010-05-06,Assembly,"AB 2357 SALDANA  Assembly Third Reading",66,5,8,0,79
71188,8984,2010-06-15,Senate,"Do pass, but re-refer to the Committee on Appropriations",4,1,0,0,5
71188,19268,2010-08-02,Senate,"Assembly 3rd Reading AB2357 Saldana By Hancock",23,9,0,0,32
71188,19269,2010-08-02,Senate,"Assembly 3rd Reading AB2357 Saldana Reconsider",33,0,0,0,33
71189,2744,2010-04-13,Assembly,"Do pass and be re-referred to the Committee on Appropriations",5,2,0,0,7
71189,2745,2010-04-28,Assembly,"Do pass",10,5,2,0,17
71189,2746,2010-05-06,Assembly,"AB 2358 DE LEON  Assembly Third Reading",43,30,6,0,79
71189,8821,2010-06-15,Senate,"Do pass as amended, and re-refer to the Committee on Appropriations",5,2,0,0,7
71189,20876,2010-08-23,Senate,"From Committee:  Amendments returned to Senate floor for 	consideration",4,2,0,0,6
71189,21888,2010-08-31,Senate,"W/O REF. TO FILE AB2358 De Leon By DeSaulnier",20,17,0,0,37
71191,5148,2010-04-19,Assembly,"Do pass and be re-referred to the Committee on Appropriations",9,0,0,0,9
71192,3876,2010-04-13,Assembly,"Do pass",11,0,0,0,11
71192,3877,2010-05-10,Assembly,"AB 2361 RUSKIN  Assembly Third Reading",67,3,9,0,79
71192,9749,2010-06-28,Senate,"Do pass",5,1,3,0,9
71192,21062,2010-08-18,Senate,"Assembly 3rd Reading AB2361 Ruskin By Yee",24,5,0,0,29
71193,2327,2010-05-10,Assembly,"Do pass as amended and be re-referred to the Committee on Appropriations",9,0,0,0,9
71193,2328,2010-05-28,Assembly,"Do pass",17,0,0,0,17
71193,2329,2010-06-02,Assembly,"AB 2362 SKINNER  Assembly Third Reading",76,0,3,0,79
71193,10299,2010-06-30,Senate,"Do pass as amended",4,0,1,0,5
71193,19719,2010-08-09,Senate,"Special Consent #30 AB2362 Skinner By Hancock",34,0,0,0,34
71193,21463,2010-08-25,Assembly,"Senate amendments be concurred in",5,3,0,0,8
71193,21464,2010-08-26,Assembly,"AB 2362 SKINNER  Concurrence in Senate Amendments",55,23,0,0,78
71194,5061,2010-04-07,Assembly,"Do pass and be re-referred to the Committee on Appropriations",5,3,1,0,9
71194,5062,2010-04-14,Assembly,"Do pass",11,5,1,0,17
71194,5063,2010-04-22,Assembly,"AB 2363 MENDOZA  Assembly Third Reading",43,31,5,0,79
71194,10072,2010-06-30,Senate,"Do pass, but re-refer to the Committee on Appropriations",2,6,1,0,9
71195,5085,2010-03-24,Assembly,"Do pass and be re-referred to the Committee on Appropriations",12,0,0,0,12
71195,5086,2010-04-14,Assembly,"Do pass, to Consent Calendar",15,0,2,0,17
71195,5087,2010-04-22,Assembly,"AB 2364 NAVA  Consent Calendar Second Day  Regular Session",74,0,5,0,79
71195,9528,2010-06-23,Senate,"Do pass, but re-refer to the Committee on Appropriations",4,1,1,0,6
71195,19378,2010-08-02,Senate,"Do pass",6,3,0,0,9
71195,21113,2010-08-23,Senate,"Assembly 3rd Reading AB2364 Nava By DeSaulnier",25,10,0,0,35
71195,21114,2010-08-24,Assembly,"AB 2364 NAVA  Concurrence in Senate Amendments",78,0,0,0,78
71196,3702,2010-04-27,Assembly,"Do pass and be re-referred to the Committee on Judiciary to Consent Calendar",8,0,1,0,9
71196,3703,2010-05-04,Assembly,"Do pass, to Consent Calendar",10,0,0,0,10
71196,3704,2010-05-10,Assembly,"AB 2365 LIEU  Consent Calendar Second Day",71,0,8,0,79
71196,9565,2010-06-22,Senate,"Do pass, but re-refer to the Committee on Judiciary",4,0,1,0,5
71196,10278,2010-06-29,Senate,"Do pass as amended",4,0,1,0,5
71196,19613,2010-08-09,Senate,"Special Consent #30 AB2365 Lieu By Denham",34,0,0,0,34
71196,19940,2010-08-12,Assembly,"AB 2365 LIEU  Concurrence in Senate Amendments",78,0,0,0,78
71197,3094,2010-04-21,Assembly,"Do pass as amended and be re-referred to the Committee on Appropriations",6,3,0,0,9
71197,3095,2010-05-28,Assembly,"Do pass",12,5,0,0,17
71197,3096,2010-06-03,Assembly,"AB 2366 BROWNLEY  Assembly Third Reading",51,26,2,0,79
71197,9875,2010-06-30,Senate,"Do pass, but re-refer to the Committee on Appropriations",7,1,1,0,9
71197,19188,2010-08-02,Senate,"Placed on Appropriations Suspense file",10,0,0,0,10
71198,3786,2010-04-21,Assembly,"Do pass and re-refer to Committee on Appropriations with recommendation:  To Consent Calendar",12,0,0,0,12
71198,3787,2010-05-05,Assembly,"Do pass, to Consent Calendar",17,0,0,0,17
71198,3788,2010-05-13,Assembly,"AB 2367 CALDERON  Consent Calendar Second Day  Regular Session",76,0,3,0,79
71198,9873,2010-06-30,Senate,"Do pass, but re-refer to the Committee on Appropriations Recommend Consent",10,0,1,0,11
71199,3540,2010-04-06,Assembly,"Do pass and be re-referred to the Committee on Appropriations",4,3,0,0,7
71199,3541,2010-05-05,Assembly,"Do pass",2,5,10,0,17
71199,3542,2010-05-05,Assembly,"Set third hearing.  Failed passage.  Reconsideration granted",17,0,0,0,17
71200,5091,2010-04-06,Assembly,"Do pass and re-refer to Committee on Appropriations with recommendation:  To Consent Calendar",7,0,0,0,7
71200,5092,2010-04-14,Assembly,"Do pass, to Consent Calendar",15,0,2,0,17
71200,5093,2010-04-22,Assembly,"AB 2369 BLOCK  Consent Calendar Second Day  Regular Session",74,0,5,0,79
71200,9910,2010-06-29,Senate,"Do pass, but re-refer to the Committee on Appropriations Recommend Consent",4,0,1,0,5
71200,19201,2010-08-02,Senate,"Do pass",9,0,0,0,9
71200,20437,2010-08-18,Senate,"Special Consent #31 AB2369 Block By Correa",34,0,0,0,34
71201,1936,2010-05-05,Assembly,"Do pass as amended",6,3,0,0,9
71201,1937,2010-06-01,Assembly,"AB 2370 HERNANDEZ  Assembly Third Reading",45,29,5,0,79
71201,9523,2010-06-23,Senate,"Do pass",4,3,2,0,9
71201,9524,2010-06-23,Senate,"Set, first hearing.  Failed passage in Committee.  Reconsideration granted",4,1,4,0,9
71201,9525,2010-06-23,Senate,"Reconsideration refused",4,1,4,0,9
71202,4195,2010-04-20,Assembly,"Do pass as amended and be re-referred to the Committee on Appropriations",7,0,0,0,7
71202,4196,2010-05-05,Assembly,"Do pass, to Consent Calendar",17,0,0,0,17
71202,4197,2010-05-13,Assembly,"AB 2371 ANDERSON  Consent Calendar Second Day  Regular Session",76,0,3,0,79
71202,9820,2010-06-29,Senate,"Do pass, but re-refer to the Committee on Appropriations Recommend Consent",4,0,1,0,5
71202,19414,2010-08-05,Senate,"Consent Calendar 2nd AB2371 Anderson",33,0,0,0,33
71203,2605,2010-04-20,Assembly,"Do pass and be re-referred to the Committee on Appropriations",5,2,0,0,7
71203,2606,2010-05-05,Assembly,"Do pass",11,4,2,0,17
71203,2607,2010-06-01,Assembly,"AB 2372 AMMIANO  Assembly Third Reading",44,30,5,0,79
71203,10264,2010-06-29,Senate,"Do pass, but re-refer to the Committee on Appropriations",5,1,1,0,7
71203,21242,2010-08-24,Senate,"Assembly 3rd Reading AB2372 Ammiano By Leno",22,14,0,0,36
71205,1589,2010-04-13,Assembly,"Do pass and be re-referred to the Committee on Appropriations",5,0,1,0,6
71205,1590,2010-05-28,Assembly,"Do pass",17,0,0,0,17
71205,1591,2010-06-01,Assembly,"AB 2374 NESTANDE  Assembly Third Reading",74,1,4,0,79
71205,9494,2010-06-22,Senate,"Do pass, but re-refer to the Committee on Appropriations",4,0,1,0,5
71205,10916,2010-07-15,Senate,"Placed on Appropriations Suspense file",8,0,2,0,10
71206,4115,2010-04-19,Assembly,"Do pass as amended and be re-referred to the Committee on Appropriations",9,0,0,0,9
71206,4116,2010-05-05,Assembly,"Do pass, to Consent Calendar",17,0,0,0,17
71206,4117,2010-05-13,Assembly,"AB 2375 KNIGHT  Consent Calendar Second Day  Regular Session",76,0,3,0,79
71206,9346,2010-06-23,Senate,"Do pass, but re-refer to the Committee on Appropriations",0,3,2,0,5
71206,9347,2010-06-23,Senate,"Set, first hearing.  Failed passage in Committee.  Reconsideration granted",3,0,2,0,5
71206,10199,2010-07-01,Senate,"Do pass, but re-refer to the Committee on Appropriations",2,3,0,0,5
71207,1668,2010-04-13,Assembly,"Do pass and be re-referred to the Committee on Appropriations",9,2,2,0,13
71207,1669,2010-05-28,Assembly,"Do pass as amended",12,5,0,0,17
71207,1670,2010-06-02,Assembly,"AB 2376 HUFFMAN  Assembly Third Reading",48,27,4,0,79
71207,9745,2010-06-29,Senate,"Do pass as amended, and re-refer to the Committee on Appropriations",6,3,0,0,9
71207,19474,2010-08-02,Senate,"Placed on Appropriations Suspense file",10,0,0,0,10
71207,21979,2010-08-31,Senate,"W/O REF. TO FILE AB2376 Huffman Concurrence",21,15,0,0,36
71207,21980,2010-08-31,Assembly,"AB 2376 HUFFMAN  Concurrence in Senate Amendments",47,26,0,0,73
71209,4241,2010-05-03,Assembly,"Do pass as amended",8,2,5,0,15
71209,4242,2010-05-13,Assembly,"AB 2378 TRAN  Assembly Third Reading",69,0,10,0,79
71209,8722,2010-06-15,Senate,"Do pass",7,2,2,0,11
71210,2368,2010-04-13,Assembly,"Do pass and be re-referred to the Committee on Appropriations",9,0,0,0,9
71210,2369,2010-04-21,Assembly,"Do pass, to Consent Calendar",17,0,0,0,17
71210,2370,2010-04-29,Assembly,"AB 2379 FEUER  Consent Calendar Second Day  Regular Session",74,0,5,0,79
71210,8703,2010-06-14,Senate,"Do pass, but re-refer to the Committee on Appropriations",6,0,1,0,7
71210,21973,2010-08-27,Senate,"Assembly 3rd Reading AB2379 Feuer By Simitian",35,0,0,0,35
71211,1017,2010-04-13,Assembly,"Do pass, to Consent Calendar.",7,0,0,0,7
71211,1018,2010-04-22,Assembly,"AB 2380 LOWENTHAL  Consent Calendar Second Day  Regular Session",74,0,5,0,79
71211,8752,2010-06-15,Senate,"Do pass as amended",7,0,0,0,7
71211,9650,2010-06-28,Senate,"Special Consent #28 AB2380 Bonnie Lowenthal By Liu",32,0,7,0,39
71211,9981,2010-07-01,Assembly,"AB 2380 LOWENTHAL  Concurrence in Senate Amendments",77,0,2,0,79
71213,3623,2010-04-06,Assembly,"Do pass as amended and be re-referred to the Committee on Business and Professions",9,0,0,0,9
71213,3624,2010-04-20,Assembly,"Do pass and be re-referred to the Committee on Appropriations",11,0,0,0,11
71213,3625,2010-05-05,Assembly,"Do pass",16,0,1,0,17
71213,3626,2010-05-13,Assembly,"AB 2382 BLUMENFIELD  Assembly Third Reading",75,1,3,0,79
71213,9329,2010-06-23,Senate,"Do pass, but re-refer to the Committee on Appropriations",6,0,3,0,9
71213,19446,2010-08-02,Senate,"Do pass",9,1,0,0,10
71213,20015,2010-08-12,Senate,"Assembly 3rd Reading AB2382 Blumenfield By Padilla",35,0,0,0,35
71213,20370,2010-08-17,Assembly,"AB 2382 BLUMENFIELD  Concurrence in Senate Amendments",72,4,0,0,76
71215,8056,2010-04-06,Assembly,"Do pass and be re-referred to the Committee on Appropriations",2,2,3,0,7
71216,1321,2010-04-20,Assembly,"Do pass as amended and be re-referred to the Committee on Appropriations.",9,0,0,0,9
71216,1322,2010-05-28,Assembly,"Do pass as amended.",12,5,0,0,17
71216,1323,2010-06-03,Assembly,"AB 2385 PEREZ, J.  Assembly Third Reading  By BUCHANAN",62,13,4,0,79
71216,10227,2010-06-30,Senate,"Do pass as amended, and re-refer to the Committee on Appropriations",7,1,1,0,9
71216,19166,2010-08-02,Senate,"Placed on Appropriations Suspense file",10,0,0,0,10
71216,20198,2010-08-12,Senate,"Do pass as amended",10,1,0,0,11
71216,21304,2010-08-23,Senate,"Assembly 3rd Reading AB2385 John A. Perez By Padilla",30,3,0,0,33
71216,21305,2010-08-25,Assembly,"AB 2385 PEREZ, J.  Concurrence in Senate Amendments",69,7,0,0,76
71217,5112,2010-05-04,Assembly,"Do pass as amended",18,0,1,0,19
71217,5113,2010-05-13,Assembly,"AB 2386 GILMORE  Assembly Third Reading",75,0,4,0,79
71217,8824,2010-06-14,Senate,"Do pass, but re-refer to the Committee on Appropriations",7,0,2,0,9
71217,9955,2010-07-01,Senate,"Special Consent #29 AB2386 Gilmore",34,0,5,0,39
71217,19522,2010-08-02,Assembly,"AB 2386 GILMORE  Concurrence in Senate Amendments",77,0,0,0,77
71219,5486,2010-04-13,Assembly,"Do pass as amended and re-refer to Committee on Appropriations with recommendation:  To Consent Calendar",9,0,0,0,9
71220,962,2010-05-04,Assembly,"Do pass.",17,0,2,0,19
71220,963,2010-05-28,Assembly,"AB 2389 GAINES  Assembly Third Reading",61,0,18,0,79
71220,9497,2010-06-23,Senate,"Do pass as amended",5,1,3,0,9
71220,21935,2010-08-30,Senate,"Assembly 3rd Reading AB2389 Gaines By Alquist",29,6,0,0,35
71220,21936,2010-08-31,Assembly,"Senate amendments not be concurred in",2,4,0,0,6
71221,1704,2010-05-04,Assembly,"Do pass and be re-referred to the Committee on Appropriations",7,3,1,0,11
71221,1705,2010-05-19,Assembly,"Do pass",11,5,1,0,17
71221,1706,2010-06-01,Assembly,"AB 2390 BUCHANAN  Assembly Third Reading",51,18,10,0,79
71221,9189,2010-06-21,Senate,"Do pass, but re-refer to the Committee on Governmental Organization",5,1,3,0,9
71221,10245,2010-06-29,Senate,"Do pass, but re-refer to the Committee on Appropriations",7,1,3,0,11
71221,19221,2010-08-02,Senate,"Placed on Appropriations Suspense file",10,0,0,0,10
71223,8332,2010-04-20,Assembly,"Do pass and be re-referred to the Committee on Appropriations",3,3,1,0,7
71224,2517,2010-04-20,Assembly,"Do pass as amended and be re-referred to the Committee on Business, Professions and Consumer Protection",6,3,0,0,9
71224,2518,2010-05-04,Assembly,"Do pass",7,4,0,0,11
71224,2519,2010-06-01,Assembly,"AB 2393 AMMIANO  Assembly Third Reading",49,27,3,0,79
71224,9675,2010-06-28,Senate,"Do pass",5,2,2,0,9
71224,21919,2010-08-30,Senate,"Assembly 3rd Reading AB2393 Ammiano By Florez",21,16,0,0,37
71224,21920,2010-08-31,Assembly,"AB 2393 AMMIANO  Concurrence in Senate Amendments",50,27,0,0,77
71225,1711,2010-04-20,Assembly,"Do pass as amended and re-refer to Committee on Appropriations with recommendation:  To Consent Calendar",10,0,0,0,10
71225,1712,2010-05-12,Assembly,"Do pass, to Consent Calendar",16,0,1,0,17
71225,1713,2010-05-20,Assembly,"AB 2394 BROWNLEY  Consent Calendar Second Day  Regular Session",72,0,7,0,79
71225,9311,2010-06-22,Senate,"Do pass, but re-refer to the Committee on Appropriations Recommend Consent",4,0,1,0,5
71225,19131,2010-08-02,Senate,"Do pass",8,0,0,0,8
71225,20420,2010-08-18,Senate,"Special Consent #31 AB2394 Brownley",34,0,0,0,34
71225,20627,2010-08-19,Assembly,"AB 2394 BROWNLEY  Concurrence in Senate Amendments",78,0,0,0,78
71227,1067,2010-04-07,Assembly,"Do pass as amended and be re-referred to the Committee on Governmental Organization.",12,0,0,0,12
71227,1068,2010-04-21,Assembly,"Do pass and be re-referred to the Committee on Appropriations.",21,0,1,0,22
71227,1069,2010-05-19,Assembly,"Do pass.",16,0,1,0,17
71227,1070,2010-05-28,Assembly,"AB 2396 SOLORIO  Assembly Third Reading",59,0,20,0,79
71227,8801,2010-06-16,Senate,"Do pass as amended, and re-refer to the Committee on Judiciary",9,0,2,0,11
71227,19548,2010-08-02,Senate,"Placed on Appropriations Suspense file",10,0,0,0,10
71228,3722,2010-05-05,Assembly,"Do pass",9,2,1,0,12
71228,3723,2010-05-13,Assembly,"AB 2397 SOLORIO  Assembly Third Reading",50,17,12,0,79
71228,9331,2010-06-23,Senate,"Do pass",4,1,1,0,6
71228,20536,2010-08-19,Senate,"Assembly 3rd Reading AB2397 Solorio By Calderon",21,10,0,0,31
71228,20843,2010-08-23,Assembly,"AB 2397 SOLORIO  Concurrence in Senate Amendments",50,13,0,0,63
71229,2533,2010-04-19,Assembly,"Do pass and be re-referred to the Committee on Appropriations",6,3,0,0,9
71229,2534,2010-05-28,Assembly,"Do pass as amended",12,5,0,0,17
71229,2535,2010-06-02,Assembly,"AB 2398 PEREZ, J.  Assembly Third Reading",49,27,3,0,79
71229,9572,2010-06-28,Senate,"Do pass, but re-refer to the Committee on Appropriations",5,2,0,0,7
71229,19459,2010-08-02,Senate,"Placed on Appropriations Suspense file",10,0,0,0,10
71229,20078,2010-08-12,Senate,"Do pass as amended",7,4,0,0,11
71229,21786,2010-08-31,Senate,"Assembly 3rd Reading AB2398 John A. Perez",23,12,0,0,35
71229,21787,2010-08-31,Assembly,"AB 2398 PEREZ, J.  Concurrence in Senate Amendments",49,27,0,0,76
71232,2208,2010-04-20,Assembly,"Do pass and be re-referred to the Committee on Appropriations",6,3,0,0,9
71232,2209,2010-05-28,Assembly,"Do pass as amended",12,5,0,0,17
71232,2210,2010-06-02,Assembly,"AB 2401 BLOCK  Assembly Third Reading",50,25,4,0,79
71233,2028,2010-04-20,Assembly,"Do pass and be re-referred to the Committee on Appropriations",6,1,2,0,9
71233,2029,2010-05-28,Assembly,"Do pass as amended",12,5,0,0,17
71233,2030,2010-06-02,Assembly,"AB 2402 BLOCK  Assembly Third Reading",50,26,3,0,79
71233,9781,2010-06-30,Senate,"Do pass, but re-refer to the Committee on Appropriations",8,0,1,0,9
71233,19503,2010-08-02,Senate,"Placed on Appropriations Suspense file",10,0,0,0,10
71233,20149,2010-08-12,Senate,"Do pass",11,0,0,0,11
71233,20468,2010-08-18,Senate,"Assembly 3rd Reading AB2402 Block By Liu",28,1,0,0,29
71233,20556,2010-08-19,Assembly,"AB 2402 BLOCK  Concurrence in Senate Amendments",68,6,0,0,74
71234,1184,2010-05-04,Assembly,"Do pass and re-refer to Committee on Appropriations with recommendation:  To Consent Calendar.",11,0,0,0,11
71235,671,2010-04-21,Assembly,"Do pass as amended and be re-referred to the Committee on Appropriations.",12,0,0,0,12
71235,672,2010-05-12,Assembly,"Do pass, to Consent Calendar.",16,0,1,0,17
71235,673,2010-05-20,Assembly,"AB 2404 HILL  Consent Calendar Second Day  Regular Session",72,0,7,0,79
71235,9855,2010-06-30,Senate,"Do pass as amended, and re-refer to the Committee on Appropriations",6,3,2,0,11
71235,20826,2010-08-23,Senate,"Assembly 3rd Reading AB2404 Hill By Calderon",26,10,0,0,36
71235,20993,2010-08-24,Assembly,"AB 2404 HILL  Concurrence in Senate Amendments",75,1,0,0,76
71237,4494,2010-05-05,Assembly,"Do pass",9,0,0,0,9
71237,4495,2010-05-13,Assembly,"AB 2406 BLAKESLEE  Assembly Third Reading",74,0,5,0,79
71237,9883,2010-06-29,Senate,"Do pass",9,0,0,0,9
71237,19811,2010-08-09,Senate,"Special Consent #30 AB2406 Blakeslee By Huff",34,0,0,0,34
71239,4353,2010-04-20,Assembly,"Do pass and re-refer to Committee on Appropriations with recommendation:  To Consent Calendar",11,0,0,0,11
71239,4354,2010-05-05,Assembly,"Do pass as amended, to Consent Calendar",17,0,0,0,17
71239,4355,2010-05-17,Assembly,"AB 2408 SMYTH  Consent Calendar Second Day",73,0,6,0,79
71239,9350,2010-06-22,Senate,"Do pass as amended, and re-refer to the Committee on Appropriations",8,0,3,0,11
71239,20612,2010-08-19,Senate,"Assembly 3rd Reading AB2408 Smyth By Ducheny",35,0,0,0,35
71239,20942,2010-08-23,Assembly,"AB 2408 SMYTH  Concurrence in Senate Amendments",75,0,0,0,75
71240,4811,2010-04-13,Assembly,"Do pass, to Consent Calendar",13,0,0,0,13
71240,4812,2010-04-22,Assembly,"AB 2409 NESTANDE  Consent Calendar Second Day  Regular Session",74,0,5,0,79
71240,4813,2010-06-09,Senate,"Do pass as amended. To Consent Calendar",7,0,2,0,9
71240,8951,2010-06-17,Senate,"Consent Calendar 2nd AB2409 Nestande",33,0,6,0,39
71240,9092,2010-06-21,Assembly,"AB 2409 NESTANDE  Concurrence in Senate Amendments",76,0,3,0,79
71241,5106,2010-04-13,Assembly,"Do pass as amended",7,0,0,0,7
71241,5107,2010-04-26,Assembly,"AB 2410 FULLER  Assembly Third Reading",71,0,8,0,79
71241,9915,2010-06-29,Senate,"Do pass as amended",7,0,0,0,7
71241,19609,2010-08-09,Senate,"Special Consent #30 AB2410 Fuller",34,0,0,0,34
71241,19938,2010-08-12,Assembly,"AB 2410 FULLER  Concurrence in Senate Amendments",77,0,0,0,77
71242,1806,2010-04-07,Assembly,"Do pass as amended and be re-referred to the Committee on Appropriations",8,2,2,0,12
71242,1807,2010-05-28,Assembly,"Do pass",12,5,0,0,17
71242,1808,2010-06-01,Assembly,"AB 2411 JONES  Assembly Third Reading",52,22,5,0,79
71242,10192,2010-06-30,Senate,"Do pass, but re-refer to the Committee on Appropriations",8,2,1,0,11
71242,19320,2010-08-02,Senate,"Do pass",8,1,0,0,9
71242,21314,2010-08-23,Senate,"Assembly 3rd Reading AB2411 Jones By Wyland",27,9,0,0,36
71242,21315,2010-08-24,Assembly,"AB 2411 JONES  Concurrence in Senate Amendments",49,26,0,0,75
71243,4442,2010-05-05,Assembly,"Do pass as amended",5,0,4,0,9
71243,4443,2010-05-17,Assembly,"AB 2412 TRAN  Assembly Third Reading",65,0,14,0,79
71244,280,2010-04-20,Assembly,"Do pass.",2,4,1,0,7
71245,1447,2010-04-21,Assembly,"Do pass and re-refer to Committee on Appropriations with recommendation:  To Consent Calendar",21,0,1,0,22
71245,1448,2010-05-28,Assembly,"Do pass",17,0,0,0,17
71245,1449,2010-06-01,Assembly,"AB 2414 PEREZ, J.  Assembly Third Reading",74,1,4,0,79
71245,10021,2010-06-29,Senate,"Do pass, but re-refer to the Committee on Appropriations Recommend Consent",8,0,3,0,11
71245,19736,2010-08-02,Senate,"Placed on Appropriations Suspense file",10,0,0,0,10
71245,19997,2010-08-12,Senate,"Do pass as amended",11,0,0,0,11
71245,21926,2010-08-31,Senate,"W/O REF. TO FILE AB2414 John A. Perez",28,0,0,0,28
71245,21927,2010-08-31,Assembly,"AB 2414 PEREZ, J.  Concurrence in Senate Amendments",63,2,0,0,65
71247,5250,2010-04-06,Assembly,"Do pass, to Consent Calendar",9,0,1,0,10
71247,5251,2010-04-12,Assembly,"AB 2416 COOK  Consent Calendar Second Day  Regular Session",71,0,8,0,79
71247,8912,2010-06-10,Senate,"Do pass as amended",5,0,0,0,5
71247,19779,2010-08-11,Senate,"Assembly 3rd Reading AB2416 Cook By Ducheny",34,0,0,0,34
71247,19868,2010-08-12,Assembly,"AB 2416 COOK  Concurrence in Senate Amendments",78,0,0,0,78
71248,4039,2010-05-04,Assembly,"Do pass, to Consent Calendar",10,0,0,0,10
71248,4040,2010-05-10,Assembly,"AB 2417 COOK  Consent Calendar Second Day  Regular Session",71,0,8,0,79
71248,10325,2010-06-29,Senate,"Do pass as amended. To Consent Calendar",4,0,1,0,5
71248,19815,2010-08-11,Senate,"Assembly 3rd Reading AB2417 Cook By Emmerson",32,0,0,0,32
71248,19928,2010-08-12,Assembly,"AB 2417 COOK  Concurrence in Senate Amendments",78,0,0,0,78
71249,3008,2010-04-27,Assembly,"Do pass as amended",6,0,0,0,6
71249,3009,2010-04-27,Assembly,"Do pass and be re-referred to the Committee on Human Services",10,0,0,0,10
71249,3010,2010-05-06,Assembly,"AB 2418 COOK  Assembly Third Reading",74,0,5,0,79
71249,6133,2010-06-10,Senate,"Do pass",3,0,1,0,4
71249,19781,2010-08-11,Senate,"Assembly 3rd Reading AB2418 Cook By Emmerson",33,0,0,0,33
71249,19872,2010-08-12,Assembly,"AB 2418 COOK  Concurrence in Senate Amendments",78,0,0,0,78
71250,3040,2010-04-13,Assembly,"Do pass and be re-referred to the Committee on Appropriations",11,0,0,0,11
71250,3041,2010-04-28,Assembly,"Do pass",15,0,2,0,17
71250,3042,2010-05-10,Assembly,"AB 2419 COOK  Assembly Third Reading",70,0,9,0,79
71250,8696,2010-06-14,Senate,"Do pass, but re-refer to the Committee on Appropriations",7,0,2,0,9
71250,19624,2010-08-09,Senate,"Special Consent #30 AB2419 Cook By Negrete McLeod",34,0,0,0,34
71250,19950,2010-08-12,Assembly,"AB 2419 COOK  Concurrence in Senate Amendments",78,0,0,0,78
71253,4659,2010-04-13,Assembly,"Do pass as amended and be re-referred to the Committee on Appropriations",6,5,2,0,13
71255,8366,2010-04-21,Assembly,"Do pass and be re-referred to the Committee on Appropriations",2,5,0,0,7
71256,3132,2010-04-14,Assembly,"Do pass and be re-referred to the Committee on Local Government",3,4,2,0,9
71256,3133,2010-04-14,Assembly,"Set first hearing.  Failed passage.  Reconsideration granted",9,0,0,0,9
71257,3821,2010-05-04,Assembly,"Do pass as amended, to Consent Calendar",10,0,0,0,10
71257,3822,2010-05-13,Assembly,"AB 2426 BRADFORD  Consent Calendar Second Day  Regular Session",76,0,3,0,79
71257,9332,2010-06-22,Senate,"Do pass as amended",3,1,1,0,5
71257,10106,2010-07-01,Senate,"Assembly 3rd Reading AB2426 Bradford By Liu",26,9,4,0,39
71257,19379,2010-08-02,Assembly,"AB 2426 BRADFORD  Concurrence in Senate Amendments",77,0,0,0,77
71258,2875,2010-04-27,Assembly,"Do pass as amended",5,5,2,0,12
71258,2876,2010-04-27,Assembly,"Set second hearing.  Failed passage.  Reconsideration granted",11,0,1,0,12
71261,1592,2010-04-13,Assembly,"Do pass and be re-referred to the Committee on Appropriations",4,0,2,0,6
71261,1593,2010-05-05,Assembly,"Do pass",12,5,0,0,17
71263,1889,2010-04-06,Assembly,"Do pass as amended",18,0,1,0,19
71263,1890,2010-05-03,Assembly,"AB 2432 PEREZ, J.  Assembly Third Reading",76,0,3,0,79
71263,10044,2010-06-30,Senate,"Do pass, but re-refer to the Committee on Appropriations Recommend Consent",8,0,1,0,9
71263,19365,2010-08-02,Senate,"Do pass",10,0,0,0,10
71263,20893,2010-08-23,Senate,"Assembly 3rd Reading AB2432 John A. Perez By Alquist",36,0,0,0,36
71263,21146,2010-08-25,Assembly,"AB 2432 PEREZ, J.  Concurrence in Senate Amendments",78,0,0,0,78
71264,3936,2010-04-21,Assembly,"Do pass and re-refer to Committee on Appropriations with recommendation:  To Consent Calendar",12,0,0,0,12
71264,3937,2010-04-28,Assembly,"Do pass, to Consent Calendar",15,0,2,0,17
71264,3938,2010-05-06,Assembly,"AB 2433 RUSKIN  Consent Calendar Second Day  Regular Session",74,0,5,0,79
71264,6901,2010-06-09,Senate,"Do pass, but re-refer to the Committee on Appropriations Recommend Consent",4,0,2,0,6
71264,19078,2010-08-02,Senate,"Consent Calendar 2nd AB2433 Ruskin",33,0,0,0,33
71265,4677,2010-04-21,Assembly,"Do pass as amended and be re-referred to the Committee on Appropriations",6,3,0,0,9
71266,1748,2010-04-06,Assembly,"Do pass and be re-referred to the Committee on Appropriations",11,0,0,0,11
71266,1749,2010-04-21,Assembly,"Do pass as amended",17,0,0,0,17
71266,1750,2010-05-03,Assembly,"AB 2435 LOWENTHAL  Assembly Third Reading",70,2,7,0,79
71266,8783,2010-06-14,Senate,"Do pass as amended, and re-refer to the Committee on Appropriations",5,2,2,0,9
71266,20732,2010-08-20,Senate,"Assembly 3rd Reading AB2435 Bonnie Lowenthal By Negrete McLeod",26,6,0,0,32
71266,20813,2010-08-23,Assembly,"AB 2435 LOWENTHAL  Concurrence in Senate Amendments",70,3,0,0,73
71268,889,2010-04-12,Assembly,"Be referred to Committee on Jobs, Economic Development and The Economy.",10,0,1,0,11
71268,890,2010-04-20,Assembly,"Do pass as amended and be re-referred to the Committee on Appropriations.",6,0,0,0,6
71268,891,2010-05-28,Assembly,"Do pass as amended.",17,0,0,0,17
71268,892,2010-06-02,Assembly,"AB 2437 PEREZ, V.M.  Assembly Third Reading",74,0,5,0,79
71268,9710,2010-06-28,Senate,"Do pass, but re-refer to the Committee on Appropriations",6,1,2,0,9
71268,19835,2010-08-09,Senate,"Placed on Appropriations Suspense file",10,0,0,0,10
71268,20018,2010-08-12,Senate,"Do pass",7,4,0,0,11
71268,21317,2010-08-24,Senate,"Assembly 3rd Reading AB2437 V. Manuel Perez By DeSaulnier",23,11,0,0,34
71268,21971,2010-08-31,Assembly,"AB 2437 PEREZ, V.M.  Concurrence in Senate Amendments",67,10,0,0,77
71269,629,2010-05-04,Assembly,"Do pass and be re-referred to the Committee on Appropriations.",9,2,0,0,11
71271,1422,2010-04-20,Assembly,"Do pass and be re-referred to the Committee on Appropriations",6,11,2,0,19
71272,5133,2010-04-19,Assembly,"Do pass as amended and be re-referred to the Committee on Appropriations",14,1,0,0,15
71274,4521,2010-04-20,Assembly,"Do pass and be re-referred to the Committee on Appropriations",4,2,0,0,6
71274,4522,2010-05-05,Assembly,"Do pass as amended",12,5,0,0,17
71274,4523,2010-05-17,Assembly,"AB 2443 PEREZ, V.M.  Assembly Third Reading",47,25,7,0,79
71274,9685,2010-06-28,Senate,"Do pass, but re-refer to the Committee on Appropriations",6,1,2,0,9
71274,19933,2010-08-12,Senate,"Assembly 3rd Reading AB2443 V. Manuel Perez By Negrete McLeod",22,13,0,0,35
71274,20720,2010-08-20,Assembly,"AB 2443 PEREZ, V.M.  Concurrence in Senate Amendments",51,24,0,0,75
71275,4218,2010-05-05,Assembly,"Do pass as amended",9,0,0,0,9
71275,4219,2010-05-13,Assembly,"AB 2444 FURUTANI  Assembly Third Reading",75,0,4,0,79
71275,9373,2010-06-23,Senate,"Do pass",6,0,3,0,9
71275,20868,2010-08-23,Senate,"Assembly 3rd Reading AB2444 Furutani By Lowenthal",36,0,0,0,36
71275,21012,2010-08-24,Assembly,"AB 2444 FURUTANI  Concurrence in Senate Amendments",76,0,0,0,76
71276,342,2010-04-21,Assembly,"Do pass and be re-referred to the Committee on Appropriations.",6,3,0,0,9
71277,71,2010-04-07,Assembly,"Do pass as amended and be re-referred to the Committee on Appropriations.",8,0,1,0,9
71277,72,2010-05-28,Assembly,"Do pass as amended.",17,0,0,0,17
71277,73,2010-06-02,Assembly,"AB 2446 FURUTANI  Assembly Third Reading",76,0,3,0,79
71277,10022,2010-06-30,Senate,"Do pass as amended, and re-refer to the Committee on Appropriations",5,1,3,0,9
71277,19149,2010-08-02,Senate,"Placed on Appropriations Suspense file",10,0,0,0,10
71277,21922,2010-08-31,Senate,"W/O REF. TO FILE AB2446 Furutani By Hancock",34,0,0,0,34
71277,21923,2010-08-31,Assembly,"AB 2446 FURUTANI  Concurrence in Senate Amendments",76,0,0,0,76
71278,961,2010-04-20,Assembly,"Do pass as amended and be re-referred to the Committee on Appropriations.",6,3,0,0,9
71279,4625,2010-05-04,Assembly,"Do pass as amended and be re-referred to the Committee on Appropriations",9,0,0,0,9
71279,4626,2010-05-19,Assembly,"Do pass as amended",16,0,1,0,17
71279,4627,2010-05-28,Assembly,"AB 2448 FURUTANI  Assembly Third Reading",63,0,16,0,79
71279,10295,2010-06-30,Senate,"Do pass as amended",8,0,1,0,9
71279,20700,2010-08-19,Senate,"Assembly 3rd Reading AB2448 Furutani",31,4,0,0,35
71279,20983,2010-08-24,Assembly,"AB 2448 FURUTANI  Concurrence in Senate Amendments",75,0,0,0,75
71284,2694,2010-04-12,Assembly,"Do pass and be re-referred to the Committee on Judiciary",9,0,0,0,9
71284,2695,2010-04-20,Assembly,"Do pass and re-refer to Committee on Appropriations with recommendation:  To Consent Calendar",10,0,0,0,10
71284,2696,2010-05-28,Assembly,"Do pass",17,0,0,0,17
71284,2697,2010-06-02,Assembly,"AB 2453 TRAN  Assembly Third Reading",76,0,3,0,79
71284,9230,2010-06-22,Senate,"Do pass, but re-refer to the Committee on Judiciary Recommend Consent",8,0,1,0,9
71284,9964,2010-06-29,Senate,"Do pass as amended, and re-refer to the Committee on Appropriations",4,0,1,0,5
71284,19480,2010-08-02,Senate,"Placed on Appropriations Suspense file",10,0,0,0,10
71284,20132,2010-08-12,Senate,"Do pass as amended",11,0,0,0,11
71284,20531,2010-08-19,Senate,"Assembly 3rd Reading AB2453 Tran By Harman",35,0,0,0,35
71284,20836,2010-08-23,Assembly,"AB 2453 TRAN  Concurrence in Senate Amendments",76,0,0,0,76
71285,4685,2010-04-21,Assembly,"Do pass as amended and be re-referred to the Committee on Appropriations",5,4,0,0,9
71286,5104,2010-03-23,Assembly,"Do pass, to Consent Calendar",7,0,2,0,9
71286,5105,2010-04-08,Assembly,"AB 2455 NAVA  Consent Calendar Second Day  Regular Session",71,0,8,0,79
71286,9301,2010-06-22,Senate,"Do pass and be placed on the Consent Calendar",4,0,1,0,5
71286,10341,2010-07-01,Senate,"Consent Calendar 2nd AB2455 Nava",34,0,5,0,39
71287,2611,2010-04-13,Assembly,"Do pass as amended and be re-referred to the Committee on Appropriations",17,2,0,0,19
71287,2612,2010-05-28,Assembly,"Do pass as amended",12,5,0,0,17
71287,2613,2010-06-02,Assembly,"AB 2456 TORRICO  Assembly Third Reading",53,19,7,0,79
71287,10296,2010-06-30,Senate,"Do pass as amended, and re-refer to the Committee on Appropriations",5,3,1,0,9
71287,19489,2010-08-02,Senate,"Placed on Appropriations Suspense file",10,0,0,0,10
71287,20001,2010-08-12,Senate,"Do pass",7,4,0,0,11
71287,21143,2010-08-25,Senate,"Assembly 3rd Reading AB2456 Torrico By Cedillo",22,12,0,0,34
71287,21337,2010-08-26,Assembly,"AB 2456 TORRICO  Concurrence in Senate Amendments",52,19,0,0,71
71288,683,2010-04-19,Assembly,"Do pass and be re-referred to the Committee on Appropriations.",11,0,1,0,12
71288,684,2010-05-28,Assembly,"Do pass as amended.",12,5,0,0,17
71288,685,2010-06-02,Assembly,"AB 2457 SALAS  Assembly Third Reading",71,3,5,0,79
71288,10219,2010-06-30,Senate,"Do pass as amended, and re-refer to the Committee on Appropriations",8,2,1,0,11
71288,19494,2010-08-02,Senate,"Do pass",8,1,0,0,9
71288,20778,2010-08-20,Senate,"Assembly 3rd Reading AB2457 Salas By Kehoe",25,5,0,0,30
71288,20919,2010-08-23,Assembly,"AB 2457 SALAS  Concurrence in Senate Amendments",61,14,0,0,75
71289,79,2010-04-12,Assembly,"Do pass and re-refer to Committee on Appropriations with recommendation:  To Consent Calendar.",8,0,1,0,9
71289,80,2010-05-12,Assembly,"Do pass.",16,0,1,0,17
71289,81,2010-05-20,Assembly,"AB 2458 SALDANA  Assembly Third Reading",72,0,7,0,79
71289,9530,2010-06-23,Senate,"Do pass as amended, and re-refer to the Committee on Appropriations",3,0,2,0,5
71289,20604,2010-08-19,Senate,"Assembly 3rd Reading AB2458 Saldana By Wolk",33,0,0,0,33
71289,20935,2010-08-23,Assembly,"AB 2458 SALDANA  Concurrence in Senate Amendments",76,0,0,0,76
71290,5103,2010-04-13,Assembly,"Do pass and be re-referred to the Committee on Appropriations",7,0,0,0,7
71291,334,2010-04-20,Assembly,"Do pass as amended and be re-referred to the Committee on Appropriations.",4,3,0,0,7
71291,335,2010-06-01,Assembly,"AB 2460 AMMIANO  Assembly Third Reading",45,28,6,0,79
71291,10144,2010-06-29,Senate,"Do pass",5,2,0,0,7
71291,21276,2010-08-25,Senate,"Assembly 3rd Reading AB2460 Ammiano By DeSaulnier",21,13,0,0,34
71291,21539,2010-08-27,Assembly,"AB 2460 AMMIANO  Concurrence in Senate Amendments",47,29,0,0,76
71292,3916,2010-04-19,Assembly,"Do pass, to Consent Calendar",13,0,1,0,14
71292,3917,2010-04-26,Assembly,"AB 2461 EMMERSON  Consent Calendar Second Day",71,0,8,0,79
71292,9008,2010-06-15,Senate,"Do pass as amended, and re-refer to the Committee on Rules",7,0,2,0,9
71292,20425,2010-08-18,Senate,"Assembly 3rd Reading AB2461 Emmerson By Emmerson",33,0,0,0,33
71292,20682,2010-08-20,Assembly,"AB 2461  Concurrence in Senate Amendments By COOK",76,0,0,0,76
71294,1011,2010-04-13,Assembly,"Do pass and be re-referred to the Committee on Appropriations.",6,0,0,0,6
71294,1012,2010-05-28,Assembly,"Do pass as amended.",12,5,0,0,17
71294,1013,2010-06-02,Assembly,"AB 2463 BROWNLEY  Assembly Third Reading",50,24,5,0,79
71294,10265,2010-06-30,Senate,"Do pass as amended, and re-refer to the Committee on Appropriations",6,2,1,0,9
71294,19982,2010-08-09,Senate,"Placed on Appropriations Suspense file",10,0,0,0,10
71295,1000,2010-04-19,Assembly,"Do pass.",12,1,1,0,14
71295,1001,2010-04-29,Assembly,"AB 2464 HUFFMAN  Assembly Third Reading",64,8,7,0,79
71295,8805,2010-06-15,Senate,"Do pass as amended",7,1,1,0,9
71295,20200,2010-08-12,Senate,"Assembly 3rd Reading AB2464 Huffman By Lowenthal",26,3,0,0,29
71295,20381,2010-08-17,Assembly,"AB 2464 HUFFMAN  Concurrence in Senate Amendments",60,16,0,0,76
71296,172,2010-04-06,Assembly,"Do pass as amended and be re-referred to the Committee on Appropriations.",11,0,0,0,11
71297,5440,2010-04-20,Assembly,"Do pass and be re-referred to the Committee on Appropriations",9,1,1,0,11
71298,2630,2010-05-04,Assembly,"Do pass",7,0,0,0,7
71298,2631,2010-05-10,Assembly,"AB 2467 MONNING  Assembly Third Reading",71,0,8,0,79
71298,9922,2010-06-29,Senate,"Do pass",3,1,1,0,5
71298,19777,2010-08-11,Senate,"Assembly 3rd Reading AB2467 Monning By Liu",23,10,0,0,33
71298,20336,2010-08-16,Assembly,"AB 2467 MONNING  Concurrence in Senate Amendments",75,0,0,0,75
71299,4619,2010-04-07,Assembly,"Do pass and be re-referred to the Committee on Appropriations",5,0,1,0,6
71299,4620,2010-04-21,Assembly,"Do pass",16,1,0,0,17
71299,4621,2010-04-26,Assembly,"AB 2468 DE LEON  Assembly Third Reading",63,7,9,0,79
71299,9256,2010-06-23,Senate,"Do pass, but re-refer to the Committee on Appropriations",4,1,1,0,6
71299,10610,2010-07-15,Senate,"Do pass",7,1,2,0,10
71299,19832,2010-08-11,Senate,"Assembly 3rd Reading AB2468 De Leon By Pavley",21,6,0,0,27
71300,177,2010-04-12,Assembly,"Do pass as amended and be re-referred to the Committee on Judiciary.",9,0,0,0,9
71300,178,2010-04-20,Assembly,"Do pass as amended and be re-referred to the Committee on Appropriations.",6,2,2,0,10
71301,2685,2010-03-23,Assembly,"Do pass and be re-referred to the Committee on Appropriations",13,5,1,0,19
71301,2686,2010-05-28,Assembly,"Do pass",12,5,0,0,17
71301,2687,2010-06-02,Assembly,"AB 2470 DE LA TORRE  Assembly Third Reading",46,27,6,0,79
71301,9479,2010-06-23,Senate,"Do pass, but re-refer to the Committee on Judiciary",5,0,4,0,9
71301,9893,2010-06-29,Senate,"Do pass, but re-refer to the Committee on Appropriations",3,1,1,0,5
71301,19136,2010-08-02,Senate,"Placed on Appropriations Suspense file",10,0,0,0,10
71301,20019,2010-08-12,Senate,"Do pass as amended",7,4,0,0,11
71301,21705,2010-08-30,Senate,"W/O REF. TO FILE AB2470 De La Torre By Padilla",24,10,0,0,34
71301,21802,2010-08-31,Assembly,"AB 2470 DE LA TORRE  Concurrence in Senate Amendments",59,18,0,0,77
71302,4048,2010-04-19,Assembly,"Do pass and be re-referred to the Committee on Appropriations",13,0,1,0,14
71302,4049,2010-05-05,Assembly,"Do pass",13,0,4,0,17
71302,4050,2010-05-13,Assembly,"AB 2471 PEREZ, J.  Assembly Third Reading",77,0,2,0,79
71302,9339,2010-06-22,Senate,"Do pass, but re-refer to the Committee on Appropriations",6,1,0,0,7
71302,20529,2010-08-18,Senate,"Assembly 3rd Reading AB2471 John A. Perez By Correa",33,1,0,0,34
71304,5217,2010-04-06,Assembly,"Do pass and be re-referred to the Committee on Appropriations",7,4,0,0,11
71305,3022,2010-04-27,Assembly,"Do pass",6,0,0,0,6
71305,3023,2010-05-06,Assembly,"AB 2474 BEALL  Assembly Third Reading",74,0,5,0,79
71305,6134,2010-06-10,Senate,"Do pass and be placed on the Consent Calendar",3,0,1,0,4
71305,8998,2010-06-17,Senate,"Consent Calendar 2nd AB2474 Beall",33,0,6,0,39
71306,4635,2010-05-04,Assembly,"Do pass as amended and be re-referred to the Committee on Appropriations",8,1,1,0,10
71307,5498,2010-04-20,Assembly,"Do pass and be re-referred to the Committee on Appropriations",6,0,0,0,6
71308,336,2010-04-06,Assembly,"Do pass and be re-referred to the Committee on Appropriations.",15,0,4,0,19
71308,337,2010-05-28,Assembly,"Do pass.",12,5,0,0,17
71308,338,2010-06-01,Assembly,"AB 2477 JONES  Assembly Third Reading",57,16,6,0,79
71309,5258,2010-04-06,Assembly,"Do pass and be re-referred to the Committee on Appropriations",6,0,1,0,7
71309,5259,2010-04-21,Assembly,"Do pass",16,1,0,0,17
71309,5260,2010-04-26,Assembly,"AB 2478 MENDOZA  Assembly Third Reading",68,2,9,0,79
71309,9431,2010-06-22,Senate,"Do pass as amended, and re-refer to the Committee on Appropriations",6,1,0,0,7
71309,20768,2010-08-19,Senate,"Assembly 3rd Reading AB2478 Mendoza By Cedillo",23,10,0,0,33
71309,20841,2010-08-23,Assembly,"AB 2478 MENDOZA  Concurrence in Senate Amendments",72,2,0,0,74
71310,859,2010-05-04,Assembly,"Do pass as amended.",7,1,2,0,10
71310,860,2010-06-03,Assembly,"AB 2479 BASS  Assembly Third Reading",56,16,7,0,79
71310,10212,2010-06-29,Senate,"Do pass",3,1,1,0,5
71310,21360,2010-08-24,Senate,"From Committee:  Amendments returned to Senate floor for 	consideration",5,2,0,0,7
71310,21592,2010-08-27,Senate,"Assembly 3rd Reading AB2479 Bass By Price",21,13,0,0,34
71310,21680,2010-08-30,Assembly,"Senate amendments be concurred in",7,3,0,0,10
71310,21779,2010-08-31,Assembly,"AB 2479 BASS  Concurrence in Senate Amendments",54,21,0,0,75
71313,4383,2010-04-20,Assembly,"Do pass and be re-referred to the Committee on Appropriations",6,3,0,0,9
71313,4384,2010-04-28,Assembly,"Do pass",10,5,2,0,17
71313,4385,2010-05-13,Assembly,"AB 2482 FURUTANI  Assembly Third Reading",50,25,4,0,79
71314,2861,2010-04-07,Assembly,"Do pass and be re-referred to the Committee on Water, Parks and Wildlife",6,3,0,0,9
71314,2862,2010-04-13,Assembly,"Do pass and be re-referred to the Committee on Appropriations",9,3,1,0,13
71314,2863,2010-05-28,Assembly,"Do pass",12,5,0,0,17
71314,2864,2010-06-03,Assembly,"AB 2483 COTO  Assembly Third Reading",49,28,2,0,79
71314,9700,2010-06-29,Senate,"Do pass, but re-refer to the Committee on Local Government",5,3,1,0,9
71314,9788,2010-06-30,Senate,"Do pass as amended, and re-refer to the Committee on Appropriations",3,2,0,0,5
71316,602,2010-05-04,Assembly,"Do pass and be re-referred to the Committee on Appropriations.",7,3,0,0,10
71316,603,2010-05-19,Assembly,"Do pass.",11,5,1,0,17
71316,604,2010-05-24,Assembly,"AB 2485 FEUER  Assembly Third Reading",44,27,8,0,79
71316,9933,2010-06-29,Senate,"Do pass",3,1,1,0,5
71316,21968,2010-08-26,Senate,"Assembly 3rd Reading AB2485 Feuer By Corbett",22,12,0,0,34
71316,21969,2010-08-30,Assembly,"AB 2485 Feuer  Concurrence in Senate Amendments",51,27,0,0,78
71317,4584,2010-03-23,Assembly,"Do pass as amended",10,0,0,0,10
71317,4585,2010-04-22,Assembly,"AB 2486 FEUER  Assembly Third Reading",73,0,6,0,79
71317,9288,2010-06-22,Senate,"Do pass as amended",4,0,1,0,5
71317,10049,2010-07-01,Senate,"Assembly 3rd Reading AB2486 Feuer By Harman",35,0,4,0,39
71317,19330,2010-08-02,Assembly,"AB 2486 FEUER  Concurrence in Senate Amendments",72,1,0,0,73
71318,3461,2010-04-27,Assembly,"Do pass as amended",10,0,0,0,10
71318,3462,2010-05-06,Assembly,"AB 2487 FEUER  Assembly Third Reading",71,0,8,0,79
71318,9929,2010-06-29,Senate,"Do pass as amended",4,0,1,0,5
71318,19635,2010-08-09,Senate,"Special Consent #30 AB2487 Feuer",34,0,0,0,34
71318,19960,2010-08-12,Assembly,"AB 2487 FEUER  Concurrence in Senate Amendments",78,0,0,0,78
71319,3459,2010-04-28,Assembly,"Do pass, to Consent Calendar",9,0,0,0,9
71319,3460,2010-05-06,Assembly,"AB 2488 RUSKIN  Consent Calendar Second Day  Regular Session",74,0,5,0,79
71319,8981,2010-06-16,Senate,"Do pass and be placed on the Consent Calendar",4,0,1,0,5
71319,9535,2010-06-24,Senate,"Consent Calendar 2nd AB2488 Ruskin",31,0,8,0,39
71321,3355,2010-04-21,Assembly,"Do pass as amended and be re-referred to the Committee on Appropriations",8,4,0,0,12
71321,3356,2010-05-12,Assembly,"Do pass",11,5,1,0,17
71321,3357,2010-05-24,Assembly,"AB 2490 JONES  Assembly Third Reading",41,28,10,0,79
71321,8869,2010-06-16,Senate,"Do pass, but re-refer to the Committee on Judiciary",7,2,2,0,11
71321,10242,2010-06-29,Senate,"Do pass, but re-refer to the Committee on Appropriations",3,1,1,0,5
71321,21896,2010-08-30,Senate,"Assembly 3rd Reading AB2490 Jones By Price",23,13,0,0,36
71321,21897,2010-08-31,Assembly,"AB 2490 JONES  Concurrence in Senate Amendments",49,27,0,0,76
71323,5379,2010-05-10,Assembly,"Do pass as amended and be re-referred to the Committee on Appropriations",6,3,0,0,9
71323,9061,2010-06-17,Assembly,"Do pass",9,4,4,0,17
71324,4640,2010-04-06,Assembly,"Do pass as amended and be re-referred to the Committee on Appropriations",9,0,1,0,10
71324,4641,2010-04-26,Assembly,"AB 2493 FULLER  Assembly Third Reading",73,0,6,0,79
71324,8839,2010-06-10,Senate,"Do pass",5,0,0,0,5
71324,9599,2010-06-28,Senate,"Special Consent #28 AB2493 Fuller",32,0,7,0,39
71325,2419,2010-04-13,Assembly,"Do pass and be re-referred to the Committee on Appropriations",7,1,3,0,11
71325,2420,2010-05-05,Assembly,"Do pass",12,5,0,0,17
71325,2421,2010-05-28,Assembly,"AB 2494 BLUMENFIELD  Assembly Third Reading  Amend By BLUMENFIELD Set #1",42,20,17,0,79
71325,2422,2010-06-01,Assembly,"AB 2494 BLUMENFIELD  Assembly Third Reading",50,27,2,0,79
71325,10229,2010-06-29,Senate,"Do pass, but re-refer to the Committee on Appropriations",7,1,3,0,11
71325,19641,2010-08-02,Senate,"Placed on Appropriations Suspense file",10,0,0,0,10
71325,20284,2010-08-12,Senate,"Do pass",7,4,0,0,11
71325,20622,2010-08-19,Senate,"Assembly 3rd Reading AB2494 Blumenfield By Ducheny",23,11,0,0,34
71327,611,2010-04-12,Assembly,"Do pass and be re-referred to the Committee on Judiciary.",17,1,4,0,22
71327,612,2010-04-20,Assembly,"Do pass and be re-referred to the Committee on Appropriations.",8,1,1,0,10
71327,613,2010-05-19,Assembly,"Do pass as amended.",14,2,1,0,17
71327,614,2010-06-01,Assembly,"AB 2496 NAVA  Assembly Third Reading",58,16,5,0,79
71327,8874,2010-06-16,Senate,"Do pass, but re-refer to the Committee on Revenue and Taxation",6,2,1,0,9
71327,9247,2010-06-23,Senate,"Do pass, but re-refer to the Committee on Appropriations",3,0,2,0,5
71327,20791,2010-08-23,Senate,"Assembly 3rd Reading AB2496 Nava By Alquist",23,10,0,0,33
71327,20965,2010-08-24,Assembly,"AB 2496 NAVA  Concurrence in Senate Amendments",54,22,0,0,76
71329,3578,2010-05-03,Assembly,"Do pass",11,0,4,0,15
71329,3579,2010-05-06,Assembly,"AB 2498 SKINNER  Assembly Third Reading",55,6,18,0,79
71330,490,2010-04-12,Assembly,"Do pass and be re-referred to the Committee on Appropriations.",12,0,2,0,14
71330,491,2010-05-28,Assembly,"Do pass.",17,0,0,0,17
71330,492,2010-06-01,Assembly,"AB 2499 PORTANTINO  Assembly Third Reading",64,10,5,0,79
71330,10165,2010-06-29,Senate,"Do pass as amended, and re-refer to the Committee on Appropriations",9,0,0,0,9
71330,19743,2010-08-09,Senate,"Do pass",10,0,0,0,10
71330,20702,2010-08-18,Senate,"Assembly 3rd Reading AB2499 Portantino By Lowenthal",22,8,0,0,30
71330,20703,2010-08-20,Assembly,"AB 2499 PORTANTINO  Concurrence in Senate Amendments",64,8,0,0,72
71331,4946,2010-05-04,Assembly,"Do pass and re-refer to Committee on Appropriations with recommendation:  To Consent Calendar",11,0,0,0,11
71331,4947,2010-05-19,Assembly,"Do pass as amended",16,0,1,0,17
71331,4948,2010-05-28,Assembly,"AB 2500 HAGMAN  Assembly Third Reading",62,0,17,0,79
71331,10088,2010-06-28,Senate,"Do pass, but re-refer to the Committee on Appropriations",7,0,2,0,9
71331,19640,2010-08-09,Senate,"Special Consent #30 AB2500 Hagman",34,0,0,0,34
71331,20405,2010-08-16,Assembly,"AB 2500 HAGMAN  Concurrence in Senate Amendments",74,0,0,0,74
71333,619,2010-04-28,Assembly,"Do pass and be re-referred to the Committee on Judiciary.",6,3,0,0,9
71334,1742,2010-04-13,Assembly,"Do pass as amended and be re-referred to the Committee on Appropriations",11,0,2,0,13
71334,1743,2010-05-28,Assembly,"Do pass as amended",17,0,0,0,17
71334,1744,2010-06-02,Assembly,"AB 2503 PEREZ, J.  Assembly Third Reading",73,0,6,0,79
71334,9907,2010-06-29,Senate,"Do pass as amended, and re-refer to the Committee on Rules",9,0,0,0,9
71334,20259,2010-08-12,Senate,"Do pass as amended",10,1,0,0,11
71334,21180,2010-08-25,Senate,"Assembly 3rd Reading AB2503 John A. Perez By Kehoe",31,1,0,0,32
71334,21796,2010-08-31,Assembly,"AB 2503 PEREZ, J.  Concurrence in Senate Amendments",68,2,0,0,70
71335,8607,2010-04-13,Assembly,"Do pass and be re-referred to the Committee on Public Safety",2,4,0,0,6
71336,2260,2010-04-20,Assembly,"Do pass, to Consent Calendar",7,0,0,0,7
71336,2261,2010-04-29,Assembly,"AB 2505 STRICKLAND  Consent Calendar Second Day",74,0,5,0,79
71336,9086,2010-06-15,Senate,"Do pass",7,0,0,0,7
71336,9627,2010-06-28,Senate,"Special Consent #28 AB2505 Audra Strickland",32,0,7,0,39
71338,8336,2010-04-12,Assembly,"Be referred to Committee on Water, Parks and Wildlife",10,0,1,0,11
71339,977,2010-04-28,Assembly,"Do pass as amended and be re-referred to the Committee on Local Government.",9,0,0,0,9
71339,978,2010-05-05,Assembly,"Do pass.",9,0,0,0,9
71339,979,2010-05-20,Assembly,"AB 2508 CABALLERO  Assembly Third Reading",72,0,7,0,79
71339,9886,2010-06-29,Senate,"Do pass as amended",9,0,0,0,9
71339,19887,2010-08-09,Senate,"Placed on Appropriations Suspense file",10,0,0,0,10
71339,20055,2010-08-12,Senate,"Do pass",11,0,0,0,11
71339,20845,2010-08-23,Senate,"Assembly 3rd Reading AB2508 Caballero By DeSaulnier",36,0,0,0,36
71339,21002,2010-08-24,Assembly,"AB 2508 CABALLERO  Concurrence in Senate Amendments",77,0,0,0,77
71340,4351,2010-05-05,Assembly,"Do pass",6,3,0,0,9
71340,4352,2010-05-13,Assembly,"AB 2509 HAYASHI  Assembly Third Reading",49,27,3,0,79
71340,8798,2010-06-16,Senate,"Do pass",3,1,1,0,5
71341,380,2010-04-21,Assembly,"Do pass as amended and be re-referred to the Committee on Appropriations.",6,0,0,0,6
71341,381,2010-05-12,Assembly,"Do pass, to Consent Calendar.",16,0,1,0,17
71341,382,2010-05-24,Assembly,"AB 2510 FLETCHER  Assembly Third Reading",71,0,8,0,79
71341,9268,2010-06-23,Senate,"Do pass, but re-refer to the Committee on Appropriations Recommend Consent",5,0,1,0,6
71341,19142,2010-08-02,Senate,"Do pass",9,0,0,0,9
71341,20458,2010-08-18,Senate,"Special Consent #31 AB2510 Fletcher",34,0,0,0,34
71343,3415,2010-04-20,Assembly,"Do pass as amended and be re-referred to the Committee on Appropriations",18,0,1,0,19
71345,1414,2010-04-19,Assembly,"Do pass and be re-referred to the Committee on Natural Resources",7,6,2,0,15
71345,1415,2010-04-22,Assembly,"Do pass as amended and be re-referred to the Committee on Appropriations",6,3,0,0,9
71345,1416,2010-04-22,Assembly,"Reconsideration granted",14,0,1,0,15
71345,1417,2010-04-22,Assembly,"Do pass and be re-referred to the Committee on Natural Resources",8,6,1,0,15
71345,1418,2010-05-28,Assembly,"Do pass as amended",12,5,0,0,17
71345,1419,2010-06-03,Assembly,"AB 2514 SKINNER  Assembly Third Reading",41,28,10,0,79
71345,9800,2010-06-29,Senate,"Do pass as amended, and re-refer to the Committee on Appropriations",8,2,1,0,11
71345,19182,2010-08-02,Senate,"Placed on Appropriations Suspense file",10,0,0,0,10
71345,20240,2010-08-12,Senate,"Do pass as amended",7,4,0,0,11
71345,20991,2010-08-24,Senate,"Assembly 3rd Reading AB2514 Skinner By Kehoe",22,13,0,0,35
71345,21553,2010-08-27,Assembly,"AB 2514 SKINNER  Concurrence in Senate Amendments",48,27,0,0,75
71346,1272,2010-04-27,Assembly,"Do pass as amended.",9,0,0,0,9
71346,1273,2010-05-19,Assembly,"Do pass, to Consent Calendar.",16,0,1,0,17
71346,1274,2010-06-01,Assembly,"AB 2515 PEREZ, V.M.  Assembly Third Reading",77,0,2,0,79
71346,9616,2010-06-28,Senate,"Do pass as amended, and re-refer to the Committee on Appropriations",7,0,0,0,7
71346,19350,2010-08-02,Senate,"Placed on Appropriations Suspense file",10,0,0,0,10
71346,20137,2010-08-12,Senate,"Do pass",11,0,0,0,11
71346,20838,2010-08-23,Senate,"Assembly 3rd Reading AB2515 V. Manuel Perez By Aanestad",36,0,0,0,36
71346,20998,2010-08-24,Assembly,"AB 2515 PEREZ, V.M.  Concurrence- Urgency Added",77,0,0,0,77
71347,4705,2010-05-04,Assembly,"Do pass and be re-referred to the Committee on Appropriations",8,1,1,0,10
71349,5102,2010-04-20,Assembly,"Do pass and be re-referred to the Committee on Appropriations",6,0,0,0,6
71352,1124,2010-04-20,Assembly,"Do pass as amended and be re-referred to the Committee on Appropriations.",10,0,0,0,10
71352,1125,2010-05-28,Assembly,"Do pass as amended.",12,5,0,0,17
71352,1126,2010-06-02,Assembly,"AB 2521 TORRICO  Assembly Third Reading",72,0,7,0,79
71353,5244,2010-04-20,Assembly,"Do pass as amended and be re-referred to the Committee on Appropriations",5,2,1,0,8
71354,2978,2010-04-21,Assembly,"Do pass and be re-referred to the Committee on Appropriations",7,0,0,0,7
71354,2979,2010-05-05,Assembly,"Do pass, to Consent Calendar",17,0,0,0,17
71354,2980,2010-05-20,Assembly,"AB 2523 ENG  Assembly Third Reading",72,0,7,0,79
71354,9259,2010-06-23,Senate,"Do pass, but re-refer to the Committee on Appropriations",4,1,1,0,6
71355,4212,2010-04-20,Assembly,"Do pass as amended and be re-referred to the Committee on Appropriations",6,1,0,0,7
71355,4213,2010-05-05,Assembly,"Do pass",12,5,0,0,17
71355,4214,2010-05-13,Assembly,"AB 2524 EVANS  Assembly Third Reading",50,26,3,0,79
71355,9872,2010-06-29,Senate,"Do pass, but re-refer to the Committee on Appropriations",3,1,1,0,5
71355,19727,2010-08-02,Senate,"Placed on Appropriations Suspense file",10,0,0,0,10
71359,1201,2010-05-03,Assembly,"Do pass as amended and be re-referred to the Committee on Appropriations.",9,0,0,0,9
71359,1202,2010-05-28,Assembly,"Do pass.",17,0,0,0,17
71359,1203,2010-06-01,Assembly,"AB 2528 KNIGHT  Assembly Third Reading",75,0,4,0,79
71360,1944,2010-04-20,Assembly,"Do pass and be re-referred to the Committee on Appropriations",8,2,1,0,11
71360,1945,2010-05-28,Assembly,"Do pass as amended",17,0,0,0,17
71360,1946,2010-06-03,Assembly,"AB 2529 FUENTES  Assembly Third Reading",44,18,17,0,79
71361,2229,2010-04-28,Assembly,"Do pass, to Consent Calendar",9,0,0,0,9
71361,2230,2010-05-06,Assembly,"AB 2530 NIELSEN  Consent Calendar Second Day  Regular Session",74,0,5,0,79
71361,8946,2010-06-16,Senate,"Do pass and be placed on the Consent Calendar",4,0,1,0,5
71361,21008,2010-08-24,Senate,"From Committee:  Amendments returned to Senate floor for 	consideration",4,0,0,0,4
71361,21656,2010-08-30,Assembly,"Senate amendments be concurred in",9,0,0,0,9
71361,21657,2010-08-30,Senate,"Assembly 3rd Reading AB2530 Nielsen By Price",37,0,0,0,37
71361,21884,2010-08-31,Assembly,"AB 2530 NIELSEN  Concurrence in Senate Amendments",78,0,0,0,78
71362,1452,2010-04-28,Assembly,"Do pass as amended and be re-referred to the Committee on Local Government",5,0,4,0,9
71362,1453,2010-05-05,Assembly,"Do pass and be re-referred to the Committee on Appropriations",7,0,2,0,9
71362,1454,2010-05-28,Assembly,"Do pass",12,5,0,0,17
71362,1455,2010-06-02,Assembly,"AB 2531 FUENTES  Assembly Third Reading",49,25,5,0,79
71362,10263,2010-06-30,Senate,"Do pass as amended",3,2,0,0,5
71362,20016,2010-08-12,Senate,"Assembly 3rd Reading AB2531 Fuentes By Padilla",22,13,0,0,35
71362,21584,2010-08-27,Assembly,"AB 2531 FUENTES  Concurrence in Senate Amendments",50,26,0,0,76
71363,1073,2010-05-04,Assembly,"Do pass.",10,0,1,0,11
71364,4087,2010-04-06,Assembly,"Do pass and be re-referred to the Committee on Appropriations",19,0,0,0,19
71364,4088,2010-04-21,Assembly,"Do pass, to Consent Calendar",17,0,0,0,17
71364,4089,2010-05-13,Assembly,"AB 2533 FUENTES  Assembly Third Reading",77,0,2,0,79
71364,10249,2010-06-30,Senate,"Do pass, but re-refer to the Committee on Appropriations Recommend Consent",8,0,1,0,9
71366,2457,2010-04-21,Assembly,"Do pass and re-refer to Committee on Appropriations with recommendation:  To Consent Calendar",12,0,0,0,12
71366,2458,2010-04-28,Assembly,"Do pass as amended, to Consent Calendar",14,0,3,0,17
71366,2459,2010-05-06,Assembly,"AB 2535 BLAKESLEE  Consent Calendar Second Day  Regular Session",74,0,5,0,79
71366,10006,2010-06-30,Senate,"Do pass, but re-refer to the Committee on Appropriations Recommend Consent",10,0,1,0,11
71367,568,2010-04-14,Assembly,"Do pass and be re-referred to the Committee on Appropriations.",8,0,1,0,9
71367,569,2010-05-28,Assembly,"Do pass as amended.",17,0,0,0,17
71367,570,2010-06-03,Assembly,"AB 2536 CARTER  Assembly Third Reading",77,0,2,0,79
71367,9193,2010-06-22,Senate,"Do pass, but re-refer to the Committee on Appropriations",6,0,3,0,9
71367,11083,2010-07-15,Senate,"Do pass",8,0,2,0,10
71367,21215,2010-08-24,Senate,"Assembly 3rd Reading AB2536 Carter By Lowenthal",34,0,0,0,34
71367,21216,2010-08-25,Assembly,"AB 2536 CARTER  Concurrence in Senate Amendments",76,0,0,0,76
71368,4225,2010-04-13,Assembly,"Do pass as amended and re-refer to Committee on Appropriations with recommendation:  To Consent Calendar",11,0,0,0,11
71368,4226,2010-05-05,Assembly,"Do pass",17,0,0,0,17
71368,4227,2010-05-13,Assembly,"AB 2537 SILVA  Assembly Third Reading",77,0,2,0,79
71368,7252,2010-06-09,Senate,"Do pass, but re-refer to the Committee on Appropriations",6,0,5,0,11
71368,19399,2010-08-02,Senate,"Placed on Appropriations Suspense file",10,0,0,0,10
71369,4860,2010-04-21,Assembly,"Do pass as amended and re-refer to Committee on Appropriations with recommendation:  To Consent Calendar",12,0,0,0,12
71369,4861,2010-05-19,Assembly,"Do pass, to Consent Calendar",16,0,1,0,17
71369,4862,2010-05-28,Assembly,"AB 2538 NIELLO  Consent Calendar Second Day  Regular Session",63,0,16,0,79
71369,9483,2010-06-23,Senate,"Do pass as amended, and re-refer to the Committee on Appropriations",5,0,1,0,6
71369,19617,2010-08-09,Senate,"Special Consent #30 AB2538 Niello",34,0,0,0,34
71369,19943,2010-08-12,Assembly,"AB 2538 NIELLO  Concurrence in Senate Amendments",78,0,0,0,78
71371,3745,2010-04-20,Assembly,"Do pass and be re-referred to the Committee on Appropriations",16,0,3,0,19
71371,3746,2010-05-05,Assembly,"Do pass, to Consent Calendar",17,0,0,0,17
71371,3747,2010-05-13,Assembly,"AB 2540 DE LA TORRE  Consent Calendar Second Day  Regular Session",76,0,3,0,79
71371,9556,2010-06-23,Senate,"Do pass as amended, and re-refer to the Committee on Appropriations",6,0,3,0,9
71371,19415,2010-08-02,Senate,"Do pass",8,1,0,0,9
71371,21295,2010-08-24,Senate,"Assembly 3rd Reading AB2540 De La Torre By Romero",26,8,0,0,34
71371,21481,2010-08-26,Assembly,"AB 2540 DE LA TORRE  Concurrence in Senate Amendments",61,16,0,0,77
71372,1812,2010-04-20,Assembly,"Do pass and be re-referred to the Committee on Appropriations",18,0,1,0,19
71372,1813,2010-05-12,Assembly,"Do pass, to Consent Calendar",16,0,1,0,17
71372,1814,2010-05-20,Assembly,"AB 2541 PORTANTINO  Consent Calendar Second Day  Regular Session",72,0,7,0,79
71372,10335,2010-06-30,Senate,"Do pass, but re-refer to the Committee on Appropriations Recommend Consent",8,0,1,0,9
71372,19530,2010-08-02,Senate,"Placed on Appropriations Suspense file",10,0,0,0,10
71372,20244,2010-08-12,Senate,"Do pass",11,0,0,0,11
71372,21277,2010-08-25,Senate,"From Committee:  Amendments returned to Senate floor for 	consideration",7,0,0,0,7
71372,21750,2010-08-30,Senate,"Assembly 3rd Reading AB2541 Portantino By Emmerson",37,0,0,0,37
71372,21859,2010-08-31,Assembly,"AB 2541 PORTANTINO  Concurrence in Senate Amendments",78,0,0,0,78
71373,1324,2010-04-20,Assembly,"Do pass as amended and be re-referred to the Committee on Appropriations.",4,3,2,0,9
71373,1325,2010-04-20,Assembly,"Set second hearing.  Failed passage.  Reconsideration granted.",9,0,0,0,9
71374,487,2010-04-21,Assembly,"Do pass as amended and re-refer to Committee on Appropriations with recommendation:  To Consent Calendar.",9,0,0,0,9
71374,488,2010-05-19,Assembly,"Do pass, to Consent Calendar.",16,0,1,0,17
71374,489,2010-06-02,Assembly,"AB 2543 LOWENTHAL  Assembly Third Reading",75,0,4,0,79
71374,10169,2010-06-30,Senate,"Do pass as amended",7,0,2,0,9
71374,21440,2010-08-24,Senate,"Assembly 3rd Reading AB2543 Bonnie Lowenthal By Price",24,11,0,0,35
71374,21441,2010-08-25,Assembly,"AB 2543 LOWENTHAL  Concurrence in Senate Amendments",50,26,0,0,76
71376,4146,2010-04-19,Assembly,"Do pass and be re-referred to the Committee on Appropriations",14,0,1,0,15
71376,4147,2010-05-05,Assembly,"Do pass, to Consent Calendar",17,0,0,0,17
71376,4148,2010-05-13,Assembly,"AB 2545 DE LA TORRE  Consent Calendar Second Day  Regular Session",76,0,3,0,79
71376,9019,2010-06-15,Senate,"Do pass as amended, and re-refer to the Committee on Appropriations",9,0,2,0,11
71376,19593,2010-08-02,Senate,"Placed on Appropriations Suspense file",10,0,0,0,10
71376,20285,2010-08-12,Senate,"Do pass as amended",11,0,0,0,11
71379,4891,2010-04-13,Assembly,"Do pass and re-refer to Committee on Appropriations with recommendation:  To Consent Calendar",7,0,0,0,7
71382,397,2010-05-04,Assembly,"Do pass and be re-referred to the Committee on Appropriations.",7,4,0,0,11
71382,398,2010-05-19,Assembly,"Do pass.",11,5,1,0,17
71382,399,2010-06-01,Assembly,"AB 2551 HERNANDEZ  Assembly Third Reading",50,27,2,0,79
71382,9174,2010-06-21,Senate,"Do pass, but re-refer to the Committee on Health",5,1,3,0,9
71382,10068,2010-06-30,Senate,"Do pass, but re-refer to the Committee on Appropriations",6,2,1,0,9
71382,19819,2010-08-11,Senate,"Do pass, but re-refer to the Committee on Appropriations",6,2,0,0,8
71382,20005,2010-08-12,Senate,"Placed on Appropriations Suspense file",11,0,0,0,11
71382,20006,2010-08-12,Senate,"Do pass",7,4,0,0,11
71382,21921,2010-08-30,Senate,"Assembly 3rd Reading AB2551 Hernandez Urgency Clause",23,14,0,0,37
71384,693,2010-04-21,Assembly,"Do pass and be re-referred to the Committee on Appropriations.",6,3,0,0,9
71385,1671,2010-04-28,Assembly,"Do pass",6,2,1,0,9
71385,1672,2010-06-01,Assembly,"AB 2554 BROWNLEY  Assembly Third Reading",48,28,3,0,79
71385,10185,2010-06-30,Senate,"Do pass",3,2,0,0,5
71385,19824,2010-08-11,Senate,"Do pass",3,1,0,0,4
71385,20723,2010-08-19,Senate,"Assembly 3rd Reading AB2554 Brownley By Lowenthal",23,10,0,0,33
71385,21222,2010-08-25,Assembly,"Senate amendments be concurred in",6,3,0,0,9
71385,21527,2010-08-27,Assembly,"AB 2554 BROWNLEY  Concurrence in Senate Amendments",48,26,0,0,74
71386,328,2010-04-06,Assembly,"Do pass as amended and be re-referred to the Committee on Appropriations.",4,0,2,0,6
71386,329,2010-05-28,Assembly,"Do pass as amended.",17,0,0,0,17
71386,330,2010-06-02,Assembly,"AB 2555 FEUER  Third Reading Urgency",76,0,3,0,79
71386,8843,2010-06-16,Senate,"Do pass, but re-refer to the Committee on Appropriations",7,1,1,0,9
71386,9761,2010-06-28,Senate,"Placed on Appropriations Suspense file",10,0,1,0,11
71387,5233,2010-04-19,Assembly,"Do pass and be re-referred to the Committee on Appropriations",9,0,0,0,9
71391,4444,2010-04-21,Assembly,"Do pass and re-refer to Committee on Appropriations with recommendation:  To Consent Calendar",9,0,0,0,9
71391,4445,2010-05-05,Assembly,"Do pass, to Consent Calendar",17,0,0,0,17
71391,4446,2010-05-13,Assembly,"AB 2560 BROWNLEY  Consent Calendar Second Day  Regular Session",76,0,3,0,79
71391,9369,2010-06-23,Senate,"Do pass, but re-refer to the Committee on Appropriations",5,2,2,0,9
71391,19716,2010-08-02,Senate,"Placed on Appropriations Suspense file",10,0,0,0,10
71391,20334,2010-08-12,Senate,"Do pass as amended",7,4,0,0,11
71391,21006,2010-08-24,Senate,"Assembly 3rd Reading AB2560 Brownley Urgency Clause",35,0,0,0,35
71391,21111,2010-08-25,Assembly,"AB 2560 BROWNLEY  Concurrence- Urgency Added",76,0,0,0,76
71392,2814,2010-04-05,Assembly,"Do pass as amended and be re-referred to the Committee on Natural Resources",14,0,1,0,15
71392,2815,2010-04-19,Assembly,"Do pass as amended and be re-referred to the Committee on Appropriations",9,0,0,0,9
71392,2816,2010-05-28,Assembly,"Do pass",17,0,0,0,17
71392,2817,2010-06-02,Assembly,"AB 2561 VILLINES  Assembly Third Reading",73,1,5,0,79
71392,10319,2010-06-29,Senate,"Do pass as amended, and re-refer to the Committee on Rules",6,3,2,0,11
71395,5442,2010-04-19,Assembly,"Do pass as amended",20,0,7,0,27
71395,5443,2010-04-29,Assembly,"AB 2564 SWANSON  Assembly Third Reading",71,0,8,0,79
71395,5444,2010-06-09,Senate,"Do pass as amended, and re-refer to the Committee on Appropriations",3,0,2,0,5
71395,19734,2010-08-09,Senate,"Assembly 3rd Reading AB2564 Swanson By Wolk",28,1,0,0,29
71395,20404,2010-08-16,Assembly,"AB 2564 SWANSON  Concurrence in Senate Amendments",74,1,0,0,75
71396,3220,2010-04-12,Assembly,"Do pass and re-refer to Committee on Appropriations with recommendation:  To Consent Calendar",9,0,0,0,9
71396,3221,2010-04-21,Assembly,"Do pass, to Consent Calendar",17,0,0,0,17
71396,3222,2010-04-29,Assembly,"AB 2565 AMMIANO  Consent Calendar Second Day  Regular Session",74,0,5,0,79
71396,9714,2010-06-28,Senate,"Do pass, but re-refer to the Committee on Appropriations Recommend Consent",7,0,0,0,7
71396,19568,2010-08-05,Senate,"Consent Calendar 2nd AB2565 Ammiano",33,0,0,0,33
71396,19651,2010-08-09,Assembly,"AB 2565 AMMIANO  Concurrence in Senate Amendments",70,1,0,0,71
71397,1789,2010-04-13,Assembly,"Do pass and re-refer to Committee on Appropriations with recommendation:  To Consent Calendar",11,0,0,0,11
71397,1790,2010-04-21,Assembly,"Do pass, to Consent Calendar",17,0,0,0,17
71397,1791,2010-04-29,Assembly,"AB 2566 CARTER  Consent Calendar Second Day  Regular Session",74,0,5,0,79
71397,9157,2010-06-21,Senate,"Do pass, but re-refer to the Committee on Appropriations",6,0,3,0,9
71397,21294,2010-08-23,Senate,"Assembly 3rd Reading AB2566 Carter By Correa",36,0,0,0,36
71398,125,2010-04-05,Assembly,"Do pass as amended.",11,3,0,0,14
71398,126,2010-04-22,Assembly,"AB 2567 BRADFORD  Assembly Third Reading",49,24,6,0,79
71398,8882,2010-06-15,Senate,"Do pass as amended, and re-refer to the Committee on Rules",7,1,1,0,9
71398,10293,2010-06-29,Senate,"Do pass",3,1,1,0,5
71398,21908,2010-08-30,Senate,"Assembly 3rd Reading AB2567 Bradford By Kehoe",21,16,0,0,37
71398,21909,2010-08-31,Assembly,"AB 2567 BRADFORD  Concurrence in Senate Amendments",53,24,0,0,77
71401,1639,2010-04-21,Assembly,"Do pass and be re-referred to the Committee on Appropriations",7,0,0,0,7
71401,1640,2010-05-28,Assembly,"Do pass",12,5,0,0,17
71401,1641,2010-06-03,Assembly,"AB 2570 MA  Assembly Third Reading",52,24,3,0,79
71401,9241,2010-06-23,Senate,"Do pass as amended, and re-refer to the Committee on Appropriations",5,0,1,0,6
71401,19534,2010-08-02,Senate,"Placed on Appropriations Suspense file",10,0,0,0,10
71403,1030,2010-04-12,Assembly,"Do pass and be re-referred to the Committee on Transportation.",15,0,0,0,15
71403,1031,2010-04-19,Assembly,"Do pass as amended and be re-referred to the Committee on Appropriations.",12,0,2,0,14
71403,1032,2010-05-12,Assembly,"Do pass.",14,1,2,0,17
71403,1033,2010-05-20,Assembly,"AB 2572 BRADFORD  Assembly Third Reading",62,4,13,0,79
71403,8750,2010-06-15,Senate,"Do pass, but re-refer to the Committee on Transportation and Housing",7,2,2,0,11
71403,9834,2010-06-29,Senate,"Do pass, but re-refer to the Committee on Appropriations",9,0,0,0,9
71403,20900,2010-08-23,Senate,"Assembly 3rd Reading AB2572 Bradford By Lowenthal",28,7,0,0,35
71403,21027,2010-08-24,Assembly,"AB 2572 BRADFORD  Concurrence in Senate Amendments",68,5,0,0,73
71406,2436,2010-04-19,Assembly,"Do pass as amended and be re-referred to the Committee on Appropriations",6,0,3,0,9
71406,2437,2010-05-28,Assembly,"Do pass as amended",12,5,0,0,17
71406,2438,2010-06-02,Assembly,"AB 2575 CHESBRO  Assembly Third Reading",45,29,5,0,79
71406,10063,2010-06-29,Senate,"Do pass as amended, and re-refer to the Committee on Appropriations",6,3,0,0,9
71406,19426,2010-08-02,Senate,"Do pass as amended",6,3,0,0,9
71406,20744,2010-08-19,Senate,"Assembly 3rd Reading AB2575 Chesbro By Wolk",23,10,0,0,33
71406,20902,2010-08-23,Assembly,"AB 2575 CHESBRO  Concurrence in Senate Amendments",51,26,0,0,77
71408,3714,2010-04-07,Assembly,"Do pass as amended and be re-referred to the Committee on Revenue and Taxation",5,6,1,0,12
71408,3715,2010-04-07,Assembly,"Set first hearing.  Failed passage.  Reconsideration granted",12,0,0,0,12
71409,1149,2010-03-23,Assembly,"Do pass and be re-referred to the Committee on Appropriations.",13,5,1,0,19
71409,1150,2010-05-28,Assembly,"Do pass as amended.",12,5,0,0,17
71409,1151,2010-06-02,Assembly,"AB 2578 JONES  Assembly Third Reading",43,28,8,0,79
71409,9545,2010-06-23,Senate,"Do pass, but re-refer to the Committee on Appropriations",5,1,3,0,9
71409,10564,2010-07-15,Senate,"Placed on Appropriations Suspense file",8,0,2,0,10
71409,20280,2010-08-12,Senate,"Do pass as amended",7,4,0,0,11
71409,21961,2010-08-30,Senate,"Assembly 3rd Reading AB2578 Jones By Lowenthal",17,17,0,0,34
71409,21962,2010-08-30,Senate,"Assembly 3rd Reading AB2578 Jones Reconsider",37,0,0,0,37
71409,21963,2010-08-31,Senate,"Assembly 3rd Reading AB2578 Jones By Lowenthal",16,19,0,0,35
71410,658,2010-04-21,Assembly,"Do pass and be re-referred to the Committee on Appropriations.",6,2,1,0,9
71412,1908,2010-04-19,Assembly,"Do pass as amended and be re-referred to the Committee on Appropriations",8,4,0,0,12
71412,1909,2010-05-28,Assembly,"Do pass as amended",12,5,0,0,17
71412,1910,2010-06-02,Assembly,"AB 2581 BRADFORD  Assembly Third Reading",48,27,4,0,79
71412,10133,2010-06-30,Senate,"Do pass as amended, and re-refer to the Committee on Appropriations",8,2,1,0,11
71412,19416,2010-08-02,Senate,"Placed on Appropriations Suspense file",10,0,0,0,10
71412,20088,2010-08-12,Senate,"Do pass as amended",7,4,0,0,11
71412,20593,2010-08-19,Senate,"Assembly 3rd Reading AB2581 Bradford By Cedillo",23,12,0,0,35
71412,20924,2010-08-23,Assembly,"AB 2581 BRADFORD  Concurrence in Senate Amendments",51,25,0,0,76
71413,3920,2010-05-04,Assembly,"Do pass as amended, to Consent Calendar",6,0,1,0,7
71413,3921,2010-05-17,Assembly,"AB 2582 ADAMS  Assembly Third Reading",70,2,7,0,79
71413,9334,2010-06-22,Senate,"Do pass",7,0,0,0,7
71413,10313,2010-07-01,Senate,"Assembly 3rd Reading AB2582 Adams By Leno",35,0,4,0,39
71414,5108,2010-04-20,Assembly,"Do pass as amended and be re-referred to the Committee on Appropriations",6,1,2,0,9
71415,4934,2010-04-21,Assembly,"Do pass and be re-referred to the Committee on Appropriations",4,1,1,0,6
71417,318,2010-04-13,Assembly,"Do pass as amended and be re-referred to the Committee on Appropriations.",11,6,2,0,19
71419,1841,2010-05-04,Assembly,"Do pass",3,7,0,0,10
71419,1842,2010-05-04,Assembly,"Set first hearing.  Failed passage.  Reconsideration granted",10,0,0,0,10
71421,5349,2010-04-20,Assembly,"Do pass as amended and be re-referred to the Committee on Appropriations",11,2,6,0,19
71423,754,2010-04-21,Assembly,"Do pass as amended and be re-referred to the Committee on Appropriations.",5,3,1,0,9
71423,755,2010-05-28,Assembly,"Do pass as amended.",12,5,0,0,17
71423,756,2010-06-03,Assembly,"AB 2592 BUCHANAN  Assembly Third Reading",50,27,2,0,79
71423,9200,2010-06-23,Senate,"Do pass, but re-refer to the Committee on Appropriations",5,2,2,0,9
71423,19174,2010-08-02,Senate,"Placed on Appropriations Suspense file",10,0,0,0,10
71423,20047,2010-08-12,Senate,"Do pass",7,4,0,0,11
71426,257,2010-04-13,Assembly,"Do pass and be re-referred to the Committee on Agriculture.",6,3,0,0,9
71426,258,2010-04-21,Assembly,"Do pass as amended and be re-referred to the Committee on Appropriations.",7,0,1,0,8
71426,259,2010-05-19,Assembly,"Do pass.",16,0,1,0,17
71426,260,2010-05-24,Assembly,"AB 2595 HUFFMAN  Assembly Third Reading",66,1,12,0,79
71426,9021,2010-06-15,Senate,"Do pass, but re-refer to the Committee on Environmental Quality",3,1,1,0,5
71426,9877,2010-06-28,Senate,"Do pass, but re-refer to the Committee on Appropriations",5,2,0,0,7
71426,19581,2010-08-02,Senate,"Placed on Appropriations Suspense file",10,0,0,0,10
71426,20260,2010-08-12,Senate,"Do pass as amended",6,5,0,0,11
71427,2941,2010-04-21,Assembly,"Do pass and re-refer to Committee on Appropriations with recommendation:  To Consent Calendar",21,0,1,0,22
71427,2942,2010-05-28,Assembly,"Do pass",12,5,0,0,17
71427,2943,2010-06-02,Assembly,"AB 2596 PORTANTINO  Assembly Third Reading",74,0,5,0,79
71427,10320,2010-06-29,Senate,"Do pass, but re-refer to the Committee on Appropriations",8,0,3,0,11
71427,20952,2010-08-24,Senate,"Assembly 3rd Reading AB2596 Portantino By Price",31,4,0,0,35
71427,21427,2010-08-26,Assembly,"AB 2596 PORTANTINO  Concurrence in Senate Amendments",76,0,0,0,76
71428,1534,2010-04-19,Assembly,"Do pass and be re-referred to the Committee on Appropriations",10,1,3,0,14
71428,1535,2010-05-19,Assembly,"Do pass",14,0,3,0,17
71428,1536,2010-06-03,Assembly,"AB 2597 BERRYHILL, B.  Assembly Third Reading",68,4,7,0,79
71428,10238,2010-06-29,Senate,"Do pass as amended, and re-refer to the Committee on Appropriations",3,1,1,0,5
71428,21630,2010-08-26,Senate,"Assembly 3rd Reading AB2597 Bill Berryhill",24,7,0,0,31
71428,21645,2010-08-30,Assembly,"AB 2597 Bill Berryhill  Concurrence in Senate Amendments",75,0,0,0,75
71429,4000,2010-04-12,Assembly,"Do pass as amended and be re-referred to the Committee on Appropriations",6,3,0,0,9
71429,4001,2010-05-05,Assembly,"Do pass",12,5,0,0,17
71429,4002,2010-05-13,Assembly,"AB 2598 BROWNLEY  Assembly Third Reading",46,29,4,0,79
71429,9958,2010-06-29,Senate,"Do pass as amended, and re-refer to the Committee on Appropriations",5,3,1,0,9
71429,19477,2010-08-02,Senate,"Placed on Appropriations Suspense file",10,0,0,0,10
71430,1690,2010-05-04,Assembly,"Do pass and be re-referred to the Committee on Appropriations",17,0,2,0,19
71430,1691,2010-05-28,Assembly,"Do pass as amended",12,5,0,0,17
71430,1692,2010-06-03,Assembly,"AB 2599 BASS  Third Reading Urgency",57,15,7,0,79
71430,19589,2010-08-04,Senate,"Do pass, but re-refer to the Committee on Appropriations",5,1,0,0,6
71430,19753,2010-08-09,Senate,"Placed on Appropriations Suspense file",10,0,0,0,10
71430,20053,2010-08-12,Senate,"Do pass as amended, and re-refer to the Committee on Rules",7,4,0,0,11
71430,21091,2010-08-25,Senate,"Assembly 3rd Reading AB2599 Bass",22,12,0,0,34
71430,21562,2010-08-27,Assembly,"AB 2599 BASS  Concurrence in Senate Amendments",56,20,0,0,76
71431,2267,2010-04-20,Assembly,"Do pass and be re-referred to the Committee on Appropriations",9,2,0,0,11
71431,2268,2010-04-28,Assembly,"Do pass",12,3,2,0,17
71431,2269,2010-05-06,Assembly,"AB 2600 MA  Assembly Third Reading",56,17,6,0,79
71431,9178,2010-06-21,Senate,"Do pass, but re-refer to the Committee on Appropriations",5,0,4,0,9
71431,21291,2010-08-25,Senate,"Assembly 3rd Reading AB2600 Ma Urgency Clause",34,0,0,0,34
71431,21870,2010-08-31,Senate,"W/O REF. TO FILE AB2600 Ma By Yee",32,1,0,0,33
71431,21871,2010-08-31,Assembly,"AB 2600 Ma  Concurrence- Urgency Added",69,4,0,0,73
71432,7717,2010-04-19,Assembly,"Do pass and be re-referred to the Committee on Governmental Organization",2,5,2,0,9
71434,2048,2010-04-20,Assembly,"Do pass and be re-referred to the Committee on Appropriations",4,6,1,0,11
71436,3043,2010-04-19,Assembly,"Do pass as amended and be re-referred to the Committee on Appropriations",6,3,0,0,9
71436,3044,2010-05-28,Assembly,"Do pass as amended",12,0,5,0,17
71436,3045,2010-06-03,Assembly,"AB 2605 DE LA TORRE  Assembly Third Reading",68,0,11,0,79
71436,9356,2010-06-22,Senate,"Do pass, but re-refer to the Committee on Appropriations",8,0,3,0,11
71436,19531,2010-08-02,Senate,"Placed on Appropriations Suspense file",10,0,0,0,10
71439,4901,2010-04-21,Assembly,"Do pass and be re-referred to the Committee on Appropriations",4,0,2,0,6
71440,208,2010-04-20,Assembly,"Do pass and be re-referred to the Committee on Appropriations.",3,3,1,0,7
71440,209,2010-04-20,Assembly,"Set first hearing.  Failed passage.  Reconsideration granted.",7,0,0,0,7
71441,2010,2010-04-20,Assembly,"Do pass and be re-referred to the Committee on Appropriations",6,0,2,0,8
71441,2011,2010-04-28,Assembly,"Do pass, to Consent Calendar",15,0,2,0,17
71441,2012,2010-05-06,Assembly,"AB 2610 NIELLO  Consent Calendar Second Day  Regular Session",74,0,5,0,79
71441,6021,2010-06-09,Senate,"Do pass, but re-refer to the Committee on Appropriations",6,0,5,0,11
71441,10206,2010-07-01,Senate,"Special Consent #29 AB2610 Niello",34,0,5,0,39
71442,8046,2010-04-13,Assembly,"Do pass and be re-referred to the Committee on Natural Resources",6,0,3,0,9
71442,8047,2010-04-19,Assembly,"Do pass as amended and be re-referred to the Committee on Appropriations",4,5,0,0,9
71443,3767,2010-04-14,Assembly,"Do pass and re-refer to Committee on Appropriations with recommendation:  To Consent Calendar",8,0,0,0,8
71443,3768,2010-04-28,Assembly,"Do pass, to Consent Calendar",15,0,2,0,17
71443,3769,2010-05-06,Assembly,"AB 2612 AGRI.  Consent Calendar Second Day  Regular Session",74,0,5,0,79
71443,8867,2010-06-15,Senate,"Do pass as amended, and re-refer to the Committee on Appropriations",5,0,0,0,5
71443,19730,2010-08-09,Senate,"Special Consent #30 AB2612 Committee on AGRI. (Galgiani)",34,0,0,0,34
71443,19966,2010-08-12,Assembly,"AB 2612 AGRI.  Concurrence in Senate Amendments By GALGIANI",79,0,0,0,79
71444,4096,2010-05-05,Assembly,"Do pass",6,3,0,0,9
71444,4097,2010-05-13,Assembly,"AB 2613 BEALL  Assembly Third Reading",44,30,5,0,79
71444,9029,2010-06-16,Senate,"Do pass as amended",3,1,1,0,5
71444,20255,2010-08-11,Senate,"Assembly 3rd Reading AB2613 Beall Reconsider",33,0,0,0,33
71444,20648,2010-08-20,Senate,"Assembly 3rd Reading AB2613 Beall By Kehoe",21,11,0,0,32
71444,20882,2010-08-23,Assembly,"AB 2613 BEALL  Concurrence in Senate Amendments",47,28,0,0,75
71445,1411,2010-04-12,Assembly,"Do pass and be re-referred to the Committee on Appropriations",15,0,0,0,15
71445,1412,2010-05-28,Assembly,"Do pass",17,0,0,0,17
71445,1413,2010-06-02,Assembly,"AB 2614 PEREZ, J.  Assembly Third Reading",75,0,4,0,79
71445,10015,2010-06-29,Senate,"Do pass as amended, but re-refer to the Committee on Appropriations Recommend Consent",10,0,1,0,11
71445,19475,2010-08-02,Senate,"Placed on Appropriations Suspense file",10,0,0,0,10
71445,20119,2010-08-12,Senate,"Do pass as amended",11,0,0,0,11
71446,3268,2010-04-13,Assembly,"Do pass and be re-referred to the Committee on Appropriations",9,3,1,0,13
71446,3269,2010-04-28,Assembly,"Do pass",10,5,2,0,17
71446,3270,2010-05-06,Assembly,"AB 2615 CHESBRO  Assembly Third Reading",46,27,6,0,79
71447,3217,2010-04-20,Assembly,"Do pass and be re-referred to the Committee on Appropriations",7,0,0,0,7
71447,3218,2010-04-28,Assembly,"Do pass",15,0,2,0,17
71447,3219,2010-05-06,Assembly,"AB 2616 HILL  Assembly Third Reading",75,0,4,0,79
71447,8967,2010-06-15,Senate,"Do pass, but re-refer to the Committee on Appropriations",4,1,0,0,5
71447,21055,2010-08-24,Senate,"Assembly 3rd Reading AB2616 Hill By DeSaulnier",23,8,0,0,31
71447,21203,2010-08-25,Assembly,"AB 2616 HILL  Concurrence in Senate Amendments",75,1,0,0,76
71449,4562,2010-04-14,Assembly,"Do pass, to Consent Calendar",8,0,1,0,9
71449,4563,2010-04-22,Assembly,"AB 2618 NESTANDE  Consent Calendar Second Day  Regular Session",74,0,5,0,79
71449,8826,2010-06-10,Senate,"Do pass and be placed on the Consent Calendar",5,0,0,0,5
71449,9005,2010-06-17,Senate,"Consent Calendar 2nd AB2618 Nestande",33,0,6,0,39
71450,3504,2010-05-04,Assembly,"Do pass, to Consent Calendar",10,0,0,0,10
71450,3505,2010-05-10,Assembly,"AB 2619 BLOCK  Consent Calendar Second Day  Regular Session",71,0,8,0,79
71450,8985,2010-06-15,Senate,"Do pass and be placed on the Consent Calendar",5,0,0,0,5
71450,9537,2010-06-24,Senate,"Consent Calendar 2nd AB2619 Block",31,0,8,0,39
71451,2944,2010-04-19,Assembly,"Do pass as amended and be re-referred to the Committee on Appropriations",10,0,4,0,14
71451,2945,2010-05-28,Assembly,"Do pass as amended",12,5,0,0,17
71451,2946,2010-06-03,Assembly,"AB 2620 ENG  Assembly Third Reading",44,29,6,0,79
71451,9974,2010-06-29,Senate,"Do pass, but re-refer to the Committee on Appropriations",5,2,2,0,9
71452,3134,2010-04-21,Assembly,"Do pass and be re-referred to the Committee on Appropriations",2,4,0,0,6
71456,3502,2010-04-21,Assembly,"Do pass and be re-referred to the Committee on Appropriations",3,4,5,0,12
71456,3503,2010-04-21,Assembly,"Set first hearing.  Failed passage.  Reconsideration granted",12,0,0,0,12
71457,1575,2010-05-04,Assembly,"Do pass",7,0,0,0,7
71457,1576,2010-05-06,Assembly,"AB 2626 JONES  Assembly Third Reading",73,0,6,0,79
71457,8935,2010-06-15,Senate,"Do pass as amended",7,0,0,0,7
71457,19843,2010-08-09,Senate,"Assembly 3rd Reading AB2626 Jones By Wolk",33,1,0,0,34
71457,19972,2010-08-12,Assembly,"AB 2626 JONES  Concurrence in Senate Amendments",79,0,0,0,79
71458,4336,2010-04-20,Assembly,"Do pass and be re-referred to the Committee on Appropriations",6,0,0,0,6
71458,4337,2010-05-05,Assembly,"Do pass, to Consent Calendar",17,0,0,0,17
71458,4338,2010-05-13,Assembly,"AB 2627 NIELSEN  Consent Calendar Second Day  Regular Session",76,0,3,0,79
71458,9263,2010-06-22,Senate,"Do pass as amended, and re-refer to the Committee on Appropriations",4,0,1,0,5
71458,19825,2010-08-09,Senate,"Placed on Appropriations Suspense file",10,0,0,0,10
71460,3052,2010-04-20,Assembly,"Do pass as amended and be re-referred to the Committee on Appropriations",5,0,1,0,6
71460,3053,2010-05-12,Assembly,"Do pass, to Consent Calendar",16,0,1,0,17
71460,3054,2010-05-20,Assembly,"AB 2629 LOWENTHAL  Consent Calendar Second Day  Regular Session",72,0,7,0,79
71460,9452,2010-06-22,Senate,"Do pass, but re-refer to the Committee on Appropriations Recommend Consent",5,0,0,0,5
71460,19452,2010-08-05,Senate,"Consent Calendar 2nd AB2629 Bonnie Lowenthal",33,0,0,0,33
71460,19677,2010-08-09,Assembly,"AB 2629 LOWENTHAL  Concurrence in Senate Amendments",77,0,0,0,77
71461,4667,2010-05-10,Assembly,"Do pass as amended and be re-referred to the Committee on Appropriations",9,0,0,0,9
71463,1663,2010-04-13,Assembly,"Do pass and re-refer to Committee on Appropriations with recommendation:  To Consent Calendar",7,0,0,0,7
71463,1664,2010-04-21,Assembly,"Do pass, to Consent Calendar",17,0,0,0,17
71463,1665,2010-04-29,Assembly,"AB 2632 DAVIS  Consent Calendar Second Day  Regular Session",74,0,5,0,79
71463,8777,2010-06-15,Senate,"Do pass, but re-refer to the Committee on Appropriations",7,0,0,0,7
71463,10014,2010-07-01,Senate,"Special Consent #29 AB2632 Davis",34,0,5,0,39
71463,19987,2010-08-12,Senate,"Assembly 3rd Reading AB2632 Davis By Runner",35,0,0,0,35
71463,20385,2010-08-17,Assembly,"AB 2632 DAVIS  Concurrence in Senate Amendments",73,1,0,0,74
71464,4628,2010-04-21,Assembly,"Do pass as amended and be re-referred to the Committee on Appropriations",15,5,2,0,22
71466,3566,2010-04-08,Assembly,"Be referred to Committee on Public Safety",11,0,0,0,11
71466,3567,2010-04-20,Assembly,"Do pass and be re-referred to the Committee on Appropriations",7,0,0,0,7
71466,3568,2010-05-05,Assembly,"Do pass, to Consent Calendar",17,0,0,0,17
71466,3569,2010-05-13,Assembly,"AB 2635 PORTANTINO  Consent Calendar Second Day  Regular Session",76,0,3,0,79
71466,8990,2010-06-16,Senate,"Do pass, but re-refer to the Committee on Public Safety Recommend Consent",8,0,1,0,9
71466,10248,2010-06-29,Senate,"Do pass, but re-refer to the Committee on Appropriations",7,0,0,0,7
71466,21200,2010-08-23,Senate,"Assembly 3rd Reading AB2635 Portantino By Yee",33,0,0,0,33
71468,2636,2010-04-19,Assembly,"Do pass and be re-referred to the Committee on Appropriations",13,0,1,0,14
71468,2637,2010-05-19,Assembly,"Do pass",11,5,1,0,17
71468,2638,2010-05-24,Assembly,"AB 2637 CHESBRO  Assembly Third Reading  Amend By CHESBRO  Set #1",46,23,10,0,79
71468,2639,2010-06-03,Assembly,"AB 2637 CHESBRO  Assembly Third Reading",64,10,5,0,79
71471,4801,2010-05-10,Assembly,"Do pass as amended and be re-referred to the Committee on Appropriations",6,3,0,0,9
71472,511,2010-04-19,Assembly,"Do pass as amended and be re-referred to the Committee on Appropriations.",6,3,0,0,9
71473,5178,2010-05-05,Assembly,"Do pass and be re-referred to the Committee on Appropriations",9,0,0,0,9
71473,5179,2010-05-19,Assembly,"Do pass, to Consent Calendar",16,0,1,0,17
71473,5180,2010-05-28,Assembly,"AB 2642 NESTANDE  Consent Calendar Second Day  Regular Session",63,0,16,0,79
71476,331,2010-04-20,Assembly,"Do pass and be re-referred to the Committee on Appropriations.",18,0,1,0,19
71476,332,2010-04-28,Assembly,"Do pass, to Consent Calendar.",15,0,2,0,17
71476,333,2010-06-02,Assembly,"AB 2645 CHESBRO  Assembly Third Reading",75,0,4,0,79
71476,9372,2010-06-23,Senate,"Do pass, but re-refer to the Committee on Appropriations",7,0,2,0,9
71476,19312,2010-08-02,Senate,"Do pass",10,0,0,0,10
71476,20442,2010-08-18,Senate,"Special Consent #31 AB2645 Chesbro",34,0,0,0,34
71476,20526,2010-08-19,Assembly,"AB 2645 CHESBRO  Concurrence- Urgency Added",77,0,0,0,77
71477,923,2010-04-19,Assembly,"Do pass as amended and re-refer to Committee on Appropriations with recommendation:  To Consent Calendar.",13,0,1,0,14
71481,3246,2010-04-22,Assembly,"Do pass and be re-referred to the Committee on Appropriations",4,2,1,0,7
71481,3247,2010-05-28,Assembly,"Do pass as amended",15,2,0,0,17
71481,3248,2010-06-03,Assembly,"AB 2650 BUCHANAN  Assembly Third Reading",54,15,10,0,79
71481,10183,2010-06-29,Senate,"Do pass, but re-refer to the Committee on Local Government",4,2,1,0,7
71481,10184,2010-06-30,Senate,"Do pass as amended, and re-refer to the Committee on Appropriations",4,0,1,0,5
71481,20059,2010-08-11,Senate,"Assembly 3rd Reading AB2650 Buchanan By DeSaulnier",28,2,0,0,30
71481,20303,2010-08-16,Assembly,"AB 2650 BUCHANAN  Concurrence in Senate Amendments",68,6,0,0,74
71482,2703,2010-04-13,Assembly,"Do pass as amended and be re-referred to the Committee on Appropriations",9,0,0,0,9
71482,2704,2010-04-28,Assembly,"Do pass, to Consent Calendar",15,0,2,0,17
71482,2705,2010-05-06,Assembly,"AB 2651 KNIGHT  Consent Calendar Second Day  Regular Session",74,0,5,0,79
71482,8883,2010-06-14,Senate,"W/O REF. TO FILE AB2651 Knight",33,0,6,0,39
71482,8884,2010-06-14,Assembly,"AB 2651 KNIGHT  Concurrence- Urgency Added",73,0,6,0,79
71483,4680,2010-05-13,Assembly,"Be referred to Committee on Appropriations",9,0,2,0,11
71485,5273,2010-04-06,Assembly,"Do pass and be re-referred to the Committee on Appropriations",7,2,2,0,11
71485,5274,2010-04-21,Assembly,"Do pass",12,5,0,0,17
71485,5275,2010-04-26,Assembly,"AB 2654 HILL  Assembly Third Reading",43,24,12,0,79
71485,9120,2010-06-21,Senate,"Do pass, but re-refer to the Committee on Appropriations",6,0,3,0,9
71485,20883,2010-08-23,Senate,"Assembly 3rd Reading AB2654 Hill By Ducheny",25,9,0,0,34
71485,21021,2010-08-24,Assembly,"AB 2654 HILL  Concurrence in Senate Amendments",49,27,0,0,76
71486,4686,2010-04-19,Assembly,"Do pass as amended and be re-referred to the Committee on Appropriations",6,0,3,0,9
71487,120,2010-04-20,Assembly,"Do pass as amended and be re-referred to the Committee on Appropriations.",6,3,0,0,9
71487,121,2010-05-12,Assembly,"Do pass as amended.",11,5,1,0,17
71487,122,2010-05-24,Assembly,"AB 2656 DE LEON  Assembly Third Reading",44,27,8,0,79
71490,4821,2010-04-20,Assembly,"Do pass and be re-referred to the Committee on Appropriations",11,0,0,0,11
71492,4689,2010-04-13,Assembly,"Do pass and be re-referred to the Committee on Health",8,0,1,0,9
71492,4690,2010-04-20,Assembly,"Do pass and be re-referred to the Committee on Appropriations",16,0,3,0,19
71493,8088,2010-04-19,Assembly,"Do pass and be re-referred to the Committee on Appropriations",2,8,5,0,15
71493,8089,2010-04-19,Assembly,"Set second hearing.  Failed passage.  Reconsideration granted",11,0,4,0,15
71494,3088,2010-04-14,Assembly,"Do pass and be re-referred to the Committee on Appropriations",8,0,1,0,9
71494,3089,2010-05-28,Assembly,"Do pass as amended",12,5,0,0,17
71494,3090,2010-06-02,Assembly,"AB 2663 LOWENTHAL  Assembly Third Reading",73,1,5,0,79
71494,10042,2010-06-30,Senate,"Do pass, but re-refer to the Committee on Appropriations Recommend Consent",5,0,0,0,5
71494,19175,2010-08-02,Senate,"Placed on Appropriations Suspense file",10,0,0,0,10
71494,20220,2010-08-12,Senate,"Do pass as amended",11,0,0,0,11
71494,20638,2010-08-19,Senate,"Assembly 3rd Reading AB2663 Bonnie Lowenthal By Lowenthal",32,1,0,0,33
71494,20798,2010-08-23,Assembly,"AB 2663 LOWENTHAL  Concurrence in Senate Amendments",76,0,0,0,76
71495,4055,2010-04-12,Assembly,"Do pass and be re-referred to the Committee on Judiciary",9,0,0,0,9
71495,4056,2010-04-20,Assembly,"Do pass and be re-referred to the Committee on Appropriations",10,0,0,0,10
71495,4057,2010-05-05,Assembly,"Do pass, to Consent Calendar",17,0,0,0,17
71495,4058,2010-05-17,Assembly,"AB 2664 CHESBRO  Assembly Third Reading",69,1,9,0,79
71495,7083,2010-06-09,Senate,"Do pass, but re-refer to the Committee on Appropriations",5,2,2,0,9
71495,20737,2010-08-18,Senate,"Assembly 3rd Reading AB2664 Chesbro By Wolk",23,11,0,0,34
71495,20738,2010-08-19,Assembly,"AB 2664 CHESBRO  Concurrence in Senate Amendments",52,22,0,0,74
71496,4636,2010-05-10,Assembly,"Do pass as amended and be re-referred to the Committee on Appropriations",9,0,0,0,9
71497,1087,2010-04-19,Assembly,"Do pass as amended and be re-referred to the Committee on Appropriations.",6,3,0,0,9
71497,1088,2010-05-28,Assembly,"Do pass as amended.",12,5,0,0,17
71497,1089,2010-06-02,Assembly,"AB 2666 SKINNER  Assembly Third Reading",45,28,6,0,79
71497,9422,2010-06-23,Senate,"Do pass as amended, and re-refer to the Committee on Appropriations",3,0,2,0,5
71497,19189,2010-08-02,Senate,"Placed on Appropriations Suspense file",10,0,0,0,10
71497,20249,2010-08-12,Senate,"Do pass as amended",7,4,0,0,11
71497,20851,2010-08-23,Senate,"Assembly 3rd Reading AB2666 Skinner By Wolk",22,14,0,0,36
71497,21109,2010-08-25,Assembly,"AB 2666 SKINNER  Concurrence in Senate Amendments",48,26,0,0,74
71498,828,2010-04-19,Assembly,"Do pass and be re-referred to the Committee on Appropriations.",10,2,2,0,14
71498,829,2010-05-12,Assembly,"Do pass.",16,0,1,0,17
71498,830,2010-05-20,Assembly,"AB 2667 HILL  Assembly Third Reading",65,6,8,0,79
71498,9411,2010-06-22,Senate,"Do pass as amended, and re-refer to the Committee on Appropriations",6,1,2,0,9
71498,20707,2010-08-20,Senate,"Assembly 3rd Reading AB2667 Hill By Pavley",28,3,0,0,31
71498,20835,2010-08-23,Assembly,"AB 2667 HILL  Concurrence in Senate Amendments",75,0,0,0,75
71499,2075,2010-04-20,Assembly,"Do pass and re-refer to Committee on Appropriations with recommendation:  To Consent Calendar",7,0,0,0,7
71499,2076,2010-05-28,Assembly,"Do pass as amended",12,0,5,0,17
71499,2077,2010-06-02,Assembly,"AB 2668 GALGIANI  Assembly Third Reading",75,0,4,0,79
71499,9780,2010-06-29,Senate,"Do pass, but re-refer to the Committee on Appropriations",7,0,0,0,7
71499,20504,2010-08-18,Senate,"Assembly 3rd Reading AB2668 Galgiani By Wright",32,0,0,0,32
71499,20668,2010-08-20,Assembly,"AB 2668 GALGIANI  Concurrence in Senate Amendments",77,0,0,0,77
71500,2643,2010-04-13,Assembly,"Do pass and be re-referred to the Committee on Appropriations",7,2,0,0,9
71500,2644,2010-05-28,Assembly,"Do pass as amended",12,0,5,0,17
71500,2645,2010-06-03,Assembly,"AB 2669 PEREZ, V.M.  Assembly Third Reading",52,24,3,0,79
71500,9607,2010-06-28,Senate,"Do pass, but re-refer to the Committee on Appropriations Recommend Consent",7,0,0,0,7
71500,19561,2010-08-05,Senate,"Consent Calendar 2nd AB2669 V. Manuel Perez",33,0,0,0,33
71500,20619,2010-08-19,Senate,"From Committee:  Amendments returned to Senate floor for 	consideration",5,2,0,0,7
71500,21831,2010-08-31,Senate,"W/O REF. TO FILE AB2669 V. Manuel Perez Reconsider",37,0,0,0,37
71500,22030,2010-08-31,Senate,"W/O REF. TO FILE AB2669 V. Manuel Perez By Ducheny",15,8,0,0,23
71501,410,2010-04-12,Assembly,"Do pass and be re-referred to the Committee on Appropriations.",6,3,0,0,9
71501,411,2010-05-28,Assembly,"Do pass as amended.",12,5,0,0,17
71501,412,2010-06-02,Assembly,"AB 2670 PEREZ, J.  Assembly Third Reading",50,25,4,0,79
71501,10145,2010-06-29,Senate,"Do pass, but re-refer to the Committee on Rules",7,1,3,0,11
71501,19193,2010-08-02,Senate,"Placed on Appropriations Suspense file",10,0,0,0,10
71501,20261,2010-08-12,Senate,"Do pass",7,4,0,0,11
71501,21956,2010-08-31,Senate,"W/O REF. TO FILE AB2670 John A. Perez By Steinberg",22,11,0,0,33
71501,21957,2010-08-31,Assembly,"AB 2670 PEREZ, J.  Concurrence in Senate Amendments",51,26,0,0,77
71502,844,2010-04-12,Assembly,"Do pass as amended and be re-referred to the Committee on Appropriations.",9,0,0,0,9
71502,845,2010-05-12,Assembly,"Do pass as amended, to Consent Calendar.",15,0,2,0,17
71502,846,2010-05-20,Assembly,"AB 2671 COOK  Consent Calendar Second Day  Regular Session",72,0,7,0,79
71502,9505,2010-06-23,Senate,"Do pass as amended, and re-refer to the Committee on Appropriations",3,0,2,0,5
71502,19167,2010-08-02,Senate,"Placed on Appropriations Suspense file",10,0,0,0,10
71502,20199,2010-08-12,Senate,"Do pass",11,0,0,0,11
71502,21330,2010-08-24,Senate,"Assembly 3rd Reading AB2671 Cook By Padilla",35,0,0,0,35
71502,21331,2010-08-25,Assembly,"AB 2671 COOK  Concurrence in Senate Amendments",76,0,0,0,76
71503,2154,2010-04-28,Assembly,"Do pass",9,0,0,0,9
71503,2155,2010-05-06,Assembly,"AB 2672 COOK  Assembly Third Reading",75,0,4,0,79
71503,8769,2010-06-16,Senate,"Do pass",3,1,1,0,5
71503,19926,2010-08-11,Senate,"Assembly 3rd Reading AB2672 Cook By Kehoe",28,2,0,0,30
71503,19927,2010-08-12,Assembly,"AB 2672 COOK  Concurrence in Senate Amendments",78,0,0,0,78
71504,385,2010-04-20,Assembly,"Do pass and be re-referred to the Committee on Appropriations.",3,4,0,0,7
71505,5176,2010-04-06,Assembly,"Do pass, to Consent Calendar",9,0,1,0,10
71505,5177,2010-04-12,Assembly,"AB 2674 BLOCK  Consent Calendar Second Day  Regular Session",71,0,8,0,79
71505,8908,2010-06-15,Senate,"Do pass and be placed on the Consent Calendar",5,0,0,0,5
71505,9540,2010-06-24,Senate,"Consent Calendar 2nd AB2674 Block",31,0,8,0,39
71506,2301,2010-04-13,Assembly,"Do pass and be re-referred to the Committee on Appropriations",18,0,1,0,19
71506,2302,2010-04-28,Assembly,"Do pass, to Consent Calendar",15,0,2,0,17
71506,2303,2010-05-06,Assembly,"AB 2675 CHESBRO  Consent Calendar Second Day  Regular Session",74,0,5,0,79
71506,6096,2010-06-09,Senate,"Do pass, but re-refer to the Committee on Appropriations",5,0,4,0,9
71506,10104,2010-07-01,Senate,"Special Consent #29 AB2675 Chesbro",34,0,5,0,39
71506,20842,2010-08-23,Senate,"Assembly 3rd Reading AB2675 Chesbro By Leno",36,0,0,0,36
71506,21000,2010-08-24,Assembly,"AB 2675 CHESBRO  Concurrence in Senate Amendments",78,0,0,0,78
71507,3080,2010-04-19,Assembly,"Do pass as amended and be re-referred to the Committee on Appropriations",6,3,0,0,9
71507,3081,2010-05-19,Assembly,"Do pass",11,5,1,0,17
71507,3082,2010-06-01,Assembly,"AB 2676 MA  Assembly Third Reading",49,28,2,0,79
71507,9456,2010-06-23,Senate,"Do pass, but re-refer to the Committee on Appropriations",3,0,2,0,5
71507,19898,2010-08-12,Senate,"Assembly 3rd Reading AB2676 Ma By Wolk",21,14,0,0,35
71508,8295,2010-04-08,Assembly,"Be referred to Committee on Local Government",11,0,0,0,11
71509,7848,2010-04-19,Assembly,"Do pass as amended and be re-referred to the Committee on Judiciary",6,5,1,0,12
71510,590,2010-04-13,Assembly,"Do pass and be re-referred to the Committee on Natural Resources.",7,4,0,0,11
71510,591,2010-04-19,Assembly,"Do pass as amended and be re-referred to the Committee on Appropriations.",6,3,0,0,9
71513,1941,2010-04-06,Assembly,"Do pass as amended and be re-referred to the Committee on Appropriations",9,0,0,0,9
71513,1942,2010-05-28,Assembly,"Do pass as amended",12,5,0,0,17
71513,1943,2010-06-02,Assembly,"AB 2682 BLOCK  Assembly Third Reading",67,2,10,0,79
71513,10137,2010-06-30,Senate,"Do pass as amended, and re-refer to the Committee on Appropriations",8,0,1,0,9
71513,19427,2010-08-02,Senate,"Placed on Appropriations Suspense file",10,0,0,0,10
71513,20207,2010-08-12,Senate,"Do pass",11,0,0,0,11
71513,21374,2010-08-25,Senate,"Assembly 3rd Reading AB2682 Block By Liu",30,0,0,0,30
71513,21594,2010-08-27,Assembly,"AB 2682 BLOCK  Concurrence in Senate Amendments",72,1,0,0,73
71514,243,2010-04-20,Assembly,"Do pass and re-refer to Committee on Appropriations with recommendation:  To Consent Calendar.",11,0,0,0,11
71514,244,2010-05-12,Assembly,"Do pass as amended, to Consent Calendar.",16,0,1,0,17
71514,245,2010-05-20,Assembly,"AB 2683 HERNANDEZ  Consent Calendar Second Day  Regular Session",72,0,7,0,79
71514,9774,2010-06-28,Senate,"Do pass as amended, and re-refer to the Committee on Appropriations",7,0,2,0,9
71514,19706,2010-08-09,Senate,"Special Consent #30 AB2683 Hernandez",34,0,0,0,34
71514,19908,2010-08-12,Assembly,"AB 2683 HERNANDEZ  Concurrence in Senate Amendments",78,0,0,0,78
71515,2830,2010-04-21,Assembly,"Do pass and be re-referred to the Committee on Appropriations",4,2,3,0,9
71516,3191,2010-04-07,Assembly,"Do pass as amended and be re-referred to the Committee on Appropriations",7,0,2,0,9
71516,3192,2010-05-19,Assembly,"Do pass",16,0,1,0,17
71516,3193,2010-05-24,Assembly,"AB 2685 DE LA TORRE  Assembly Third Reading",70,0,9,0,79
71516,9503,2010-06-23,Senate,"Do pass, but re-refer to the Committee on Appropriations Recommend Consent",6,0,3,0,9
71516,19443,2010-08-05,Senate,"Consent Calendar 2nd AB2685 De La Torre",33,0,0,0,33
71517,4034,2010-04-14,Assembly,"Do pass and re-refer to Committee on Appropriations with recommendation:  To Consent Calendar",8,0,0,0,8
71517,4035,2010-04-28,Assembly,"Do pass, to Consent Calendar",15,0,2,0,17
71517,4036,2010-05-06,Assembly,"AB 2686 BERRYHILL, T.  Consent Calendar Second Day  Regular Session",74,0,5,0,79
71517,9015,2010-06-15,Senate,"Do pass, but re-refer to the Committee on Appropriations Recommend Consent",5,0,0,0,5
71517,19422,2010-08-05,Senate,"Consent Calendar 2nd AB2686 Tom Berryhill",33,0,0,0,33
71517,20232,2010-08-12,Assembly,"AB 2686 BERRYHILL, T.  Concurrence in Senate Amendments",78,0,0,0,78
71518,4777,2010-04-19,Assembly,"Do pass as amended and be re-referred to the Committee on Appropriations",9,0,0,0,9
71520,1735,2010-04-21,Assembly,"Amend, and re-refer to the Committee on Local Government",8,0,1,0,9
71520,1736,2010-04-28,Assembly,"Do pass, to Consent Calendar",9,0,0,0,9
71520,1737,2010-05-06,Assembly,"AB 2689 SMYTH  Consent Calendar Second Day  Regular Session",74,0,5,0,79
71520,5948,2010-06-09,Senate,"Do pass",5,0,4,0,9
71520,8962,2010-06-17,Senate,"Assembly 3rd Reading AB2689 Smyth Urgency Clause",31,0,8,0,39
71521,8495,2010-05-03,Assembly,"Do pass",4,9,2,0,15
71521,8496,2010-05-03,Assembly,"Set second hearing.  Failed passage.  Reconsideration granted",14,0,1,0,15
71522,8294,2010-04-19,Assembly,"Do pass as amended and be re-referred to the Committee on Appropriations",3,5,1,0,9
71523,5079,2010-04-20,Assembly,"Do pass as amended and be re-referred to the Committee on Appropriations",3,0,3,0,6
71523,5080,2010-04-20,Assembly,"Set first hearing.  Failed passage.  Reconsideration granted",5,0,1,0,6
71523,5081,2010-04-22,Assembly,"Do pass as amended and be re-referred to the Committee on Appropriations",6,0,0,0,6
71525,1207,2010-05-05,Assembly,"Do pass as amended, to Consent Calendar.",9,0,0,0,9
71525,1208,2010-05-20,Assembly,"AB 2694 BLUMENFIELD  Consent Calendar Second Day",72,0,7,0,79
71525,9423,2010-06-23,Senate,"Do pass as amended. To Consent Calendar",6,0,3,0,9
71525,21032,2010-08-24,Senate,"Assembly 3rd Reading AB2694 Blumenfield",35,0,0,0,35
71525,21172,2010-08-25,Assembly,"AB 2694 BLUMENFIELD  Concurrence in Senate Amendments",76,0,0,0,76
71526,3165,2010-04-14,Assembly,"Do pass and be re-referred to the Committee on Judiciary",7,0,1,0,8
71526,3166,2010-04-20,Assembly,"Do pass and be re-referred to the Committee on Appropriations",8,2,0,0,10
71526,3167,2010-05-28,Assembly,"Do pass",14,3,0,0,17
71526,3168,2010-06-01,Assembly,"AB 2695 HERNANDEZ  Assembly Third Reading",58,18,3,0,79
71526,8723,2010-06-15,Senate,"Do pass, but re-refer to the Committee on Appropriations",4,1,0,0,5
71526,9940,2010-06-28,Senate,"Do pass as amended",9,1,1,0,11
71526,19939,2010-08-12,Senate,"Assembly 3rd Reading AB2695 Hernandez By Negrete McLeod",23,8,0,0,31
71526,20360,2010-08-17,Assembly,"AB 2695 HERNANDEZ  Concurrence in Senate Amendments",67,9,0,0,76
71527,2151,2010-04-21,Assembly,"Do pass and be re-referred to the Committee on Appropriations",7,0,0,0,7
71527,2152,2010-05-19,Assembly,"Do pass",16,0,1,0,17
71527,2153,2010-06-02,Assembly,"AB 2696 BASS  Assembly Third Reading  By BRADFORD",72,2,5,0,79
71527,9508,2010-06-23,Senate,"Do pass as amended, and re-refer to the Committee on Appropriations",4,1,1,0,6
71527,19514,2010-08-02,Senate,"Placed on Appropriations Suspense file",10,0,0,0,10
71527,20234,2010-08-12,Senate,"Do pass",7,4,0,0,11
71527,20819,2010-08-23,Senate,"Assembly 3rd Reading AB2696 Bass By Yee",25,11,0,0,36
71527,20985,2010-08-24,Assembly,"AB 2696 BASS  Concurrence in Senate Amendments",73,4,0,0,77
71529,3097,2010-04-13,Assembly,"Do pass as amended and be re-referred to the Committee on Appropriations",5,0,1,0,6
71529,3098,2010-05-12,Assembly,"Do pass",16,0,1,0,17
71529,3099,2010-05-12,Assembly,"Do pass",16,0,1,0,17
71529,3100,2010-05-20,Assembly,"AB 2698 BLOCK  Assembly Third Reading",71,0,8,0,79
71529,9493,2010-06-22,Senate,"Do pass, but re-refer to the Committee on Appropriations",5,0,0,0,5
71529,19429,2010-08-02,Senate,"Do pass",9,0,0,0,9
71529,20607,2010-08-19,Senate,"Assembly 3rd Reading AB2698 Block By Liu",35,0,0,0,35
71529,20939,2010-08-23,Assembly,"AB 2698 BLOCK  Concurrence in Senate Amendments",76,0,0,0,76
71530,2510,2010-04-08,Assembly,"Be referred to Committee on Business, Professions and Consumer Protection",11,0,0,0,11
71530,2511,2010-04-20,Assembly,"Do pass as amended and re-refer to Committee on Appropriations with recommendation:  To Consent Calendar",11,0,0,0,11
71530,2512,2010-05-19,Assembly,"Do pass",16,0,1,0,17
71530,2513,2010-06-02,Assembly,"AB 2699 BASS  Assembly Third Reading",67,3,9,0,79
71530,9679,2010-06-28,Senate,"Do pass as amended, and re-refer to the Committee on Appropriations",5,1,3,0,9
71530,19138,2010-08-02,Senate,"Placed on Appropriations Suspense file",10,0,0,0,10
71530,21696,2010-08-30,Senate,"W/O REF. TO FILE AB2699 Bass By Price",31,2,0,0,33
71530,21792,2010-08-31,Assembly,"AB 2699 Bass  Concurrence in Senate Amendments",70,1,0,0,71
71531,3494,2010-04-13,Assembly,"Do pass and be re-referred to the Committee on Appropriations",7,3,0,0,10
71531,3495,2010-04-21,Assembly,"Do pass",12,5,0,0,17
71531,3496,2010-05-06,Assembly,"AB 2700 MA  Assembly Third Reading",47,26,6,0,79
71531,9323,2010-06-22,Senate,"Do pass, but re-refer to the Committee on Appropriations",3,1,1,0,5
71531,20773,2010-08-19,Senate,"Assembly 3rd Reading AB2700 Ma By Leno",26,9,0,0,35
71532,2189,2010-04-14,Assembly,"Do pass and be re-referred to the Committee on Appropriations",8,0,1,0,9
71532,2190,2010-04-28,Assembly,"Do pass, to Consent Calendar",15,0,2,0,17
71532,2191,2010-05-06,Assembly,"AB 2701 ENG  Consent Calendar Second Day  Regular Session",74,0,5,0,79
71532,8944,2010-06-15,Senate,"Do pass, but re-refer to the Committee on Appropriations",6,0,3,0,9
71532,21756,2010-08-24,Senate,"Assembly 3rd Reading AB2701 Eng By DeSaulnier",32,0,0,0,32
71533,4157,2010-04-13,Assembly,"Do pass as amended and be re-referred to the Committee on Appropriations",5,1,0,0,6
71533,4158,2010-05-05,Assembly,"Do pass",12,0,5,0,17
71533,4159,2010-05-13,Assembly,"AB 2702 CHESBRO  Assembly Third Reading",65,7,7,0,79
71533,9357,2010-06-22,Senate,"Do pass, but re-refer to the Committee on Appropriations",4,1,0,0,5
71533,19402,2010-08-02,Senate,"Placed on Appropriations Suspense file",10,0,0,0,10
71534,3209,2010-04-19,Assembly,"Do pass as amended and re-refer to Committee on Appropriations with recommendation:  To Consent Calendar",13,0,1,0,14
71534,3210,2010-05-12,Assembly,"Do pass as amended, to Consent Calendar",16,0,1,0,17
71534,3211,2010-05-20,Assembly,"AB 2703 PEREZ, J.  Consent Calendar Second Day  Regular Session",72,0,7,0,79
71534,10168,2010-06-29,Senate,"Do pass, but re-refer to the Committee on Appropriations Recommend Consent",8,0,1,0,9
71535,5114,2010-04-19,Assembly,"Do pass",11,0,3,0,14
71535,5115,2010-04-22,Assembly,"AB 2704 GAINES  Assembly Third Reading",73,0,6,0,79
71535,8897,2010-06-15,Senate,"Do pass",6,1,2,0,9
71535,9715,2010-06-28,Senate,"Assembly 3rd Reading AB2704 Gaines By Ashburn",34,0,5,0,39
71536,1019,2010-04-07,Assembly,"Do pass as amended and be re-referred to the Committee on Appropriations.",7,0,2,0,9
71537,3727,2010-04-13,Assembly,"Do pass as amended and be re-referred to the Committee on Appropriations",7,2,1,0,10
71537,3728,2010-04-28,Assembly,"Do pass",10,5,2,0,17
71537,3729,2010-05-06,Assembly,"AB 2706 LOWENTHAL  Assembly Third Reading",48,24,7,0,79
71537,8999,2010-06-15,Senate,"Do pass as amended",3,2,0,0,5
71537,19151,2010-08-02,Senate,"Do pass",7,3,0,0,10
71537,20873,2010-08-23,Senate,"Assembly 3rd Reading AB2706 Bonnie Lowenthal By Yee",21,13,0,0,34
71537,21017,2010-08-24,Assembly,"AB 2706 LOWENTHAL  Concurrence in Senate Amendments",51,26,0,0,77
71545,4961,2010-04-20,Assembly,"Do pass and re-refer to Committee on Appropriations with recommendation:  To Consent Calendar",6,0,0,0,6
71546,5218,2010-04-13,Assembly,"Do pass and be re-referred to the Committee on Appropriations",5,2,0,0,7
71548,664,2010-04-12,Assembly,"Be referred to Committee on Insurance.",10,0,1,0,11
71548,665,2010-04-21,Assembly,"Do pass as amended and re-refer to Committee on Appropriations with recommendation:  To Consent Calendar.",12,0,0,0,12
71548,666,2010-05-12,Assembly,"Do pass, to Consent Calendar.",16,0,1,0,17
71548,667,2010-05-20,Assembly,"AB 2717 SKINNER  Consent Calendar Second Day  Regular Session",72,0,7,0,79
71548,9845,2010-06-30,Senate,"Do pass as amended, and re-refer to the Committee on Appropriations",10,0,1,0,11
71548,19652,2010-08-09,Senate,"Special Consent #30 AB2717 Skinner",34,0,0,0,34
71548,19983,2010-08-12,Assembly,"AB 2717 SKINNER  Concurrence in Senate Amendments",79,0,0,0,79
71549,1905,2010-04-12,Assembly,"Do pass as amended and be re-referred to the Committee on Appropriations",8,0,1,0,9
71549,1906,2010-05-28,Assembly,"Do pass",17,0,0,0,17
71549,1907,2010-06-01,Assembly,"AB 2718 ADAMS  Assembly Third Reading",75,0,4,0,79
71549,9670,2010-06-28,Senate,"Do pass, but re-refer to the Committee on Appropriations",7,0,0,0,7
71549,11040,2010-07-15,Senate,"Placed on Appropriations Suspense file",8,0,2,0,10
71550,8065,2010-04-19,Assembly,"Do pass and be re-referred to the Committee on Appropriations",3,6,0,0,9
71551,2279,2010-04-21,Assembly,"Do pass and be re-referred to the Committee on Appropriations",6,0,2,0,8
71551,2280,2010-05-28,Assembly,"Do pass",12,5,0,0,17
71551,2281,2010-06-02,Assembly,"AB 2720 PEREZ, J.  Assembly Third Reading",53,22,4,0,79
71551,10197,2010-06-30,Senate,"Do pass, but re-refer to the Committee on Appropriations",6,2,1,0,9
71551,19331,2010-08-02,Senate,"Placed on Appropriations Suspense file",10,0,0,0,10
71551,20052,2010-08-12,Senate,"Do pass as amended",7,4,0,0,11
71551,21129,2010-08-25,Senate,"Assembly 3rd Reading AB2720 John A. Perez By Alquist",21,11,0,0,32
71551,21577,2010-08-27,Assembly,"AB 2720 PEREZ, J.  Concurrence in Senate Amendments",51,23,0,0,74
71552,4426,2010-04-21,Assembly,"Do pass as amended and re-refer to Committee on Appropriations with recommendation:  To Consent Calendar",9,0,0,0,9
71552,4427,2010-05-13,Assembly,"AB 2721 BLAKESLEE  Consent Calendar Second Day  Regular Session",76,0,3,0,79
71552,9879,2010-06-30,Senate,"Do pass as amended, and re-refer to the Committee on Appropriations",8,0,1,0,9
71552,19137,2010-08-02,Senate,"Placed on Appropriations Suspense file",10,0,0,0,10
71555,2480,2010-04-12,Assembly,"Do pass as amended and be re-referred to the Committee on Natural Resources",10,0,5,0,15
71555,2481,2010-04-21,Assembly,"Do pass as amended and be re-referred to the Committee on Appropriations",8,0,1,0,9
71555,2482,2010-05-28,Assembly,"Do pass",17,0,0,0,17
71555,2483,2010-06-02,Assembly,"AB 2724 BLUMENFIELD  Assembly Third Reading",73,0,6,0,79
71555,10289,2010-06-29,Senate,"Do pass as amended",9,0,2,0,11
71555,19780,2010-08-09,Senate,"Placed on Appropriations Suspense file",10,0,0,0,10
71555,20051,2010-08-12,Senate,"Do pass as amended",11,0,0,0,11
71555,20810,2010-08-23,Senate,"Assembly 3rd Reading AB2724 Blumenfield By Dutton",36,0,0,0,36
71555,20979,2010-08-24,Assembly,"AB 2724 BLUMENFIELD  Concurrence in Senate Amendments",76,0,0,0,76
71557,847,2010-04-21,Assembly,"Do pass and be re-referred to the Committee on Appropriations.",6,1,0,0,7
71557,848,2010-05-28,Assembly,"Do pass.",12,5,0,0,17
71557,849,2010-06-03,Assembly,"AB 2726 LOWENTHAL  Assembly Third Reading",53,24,2,0,79
71557,9216,2010-06-23,Senate,"Do pass, but re-refer to the Committee on Appropriations",4,1,1,0,6
71557,21260,2010-08-23,Senate,"Assembly 3rd Reading AB2726 Bonnie Lowenthal By Hancock",24,12,0,0,36
71557,21261,2010-08-24,Assembly,"AB 2726 LOWENTHAL  Concurrence in Senate Amendments",52,25,0,0,77
71558,4854,2010-04-21,Assembly,"Do pass and be re-referred to the Committee on Appropriations",5,2,0,0,7
71560,2508,2010-04-19,Assembly,"Do pass as amended",10,2,2,0,14
71560,2509,2010-05-06,Assembly,"AB 2729 AMMIANO  Assembly Third Reading",49,24,6,0,79
71560,9307,2010-06-22,Senate,"Do pass as amended",4,2,3,0,9
71560,9308,2010-06-22,Senate,"Set, first hearing.  Failed passage in Committee.  Reconsideration granted",6,0,3,0,9
71560,9917,2010-06-29,Senate,"Do pass as amended",6,2,1,0,9
71560,21475,2010-08-24,Senate,"Assembly 3rd Reading AB2729 Ammiano By Leno",21,15,0,0,36
71560,21476,2010-08-25,Assembly,"AB 2729 AMMIANO  Concurrence in Senate Amendments",49,24,0,0,73
71562,3833,2010-05-04,Assembly,"Do pass, to Consent Calendar",19,0,0,0,19
71562,3834,2010-05-13,Assembly,"AB 2731 ARAMBULA  Consent Calendar Second Day",76,0,3,0,79
71562,6810,2010-06-09,Senate,"Do pass and be placed on the Consent Calendar",3,0,2,0,5
71562,9065,2010-06-17,Senate,"Consent Calendar 2nd AB2731 Arambula",33,0,6,0,39
71564,292,2010-04-12,Assembly,"Do pass and be re-referred to the Committee on Judiciary.",17,0,5,0,22
71564,293,2010-04-20,Assembly,"Do pass and be re-referred to the Committee on Appropriations.",9,0,1,0,10
71564,294,2010-05-19,Assembly,"Do pass.",16,0,1,0,17
71564,295,2010-05-24,Assembly,"AB 2733 RUSKIN  Assembly Third Reading",67,0,12,0,79
71564,9358,2010-06-23,Senate,"Do pass, but re-refer to the Committee on Appropriations",3,0,2,0,5
71564,20701,2010-08-20,Senate,"Assembly 3rd Reading AB2733 Ruskin By Padilla",30,1,0,0,31
71564,20818,2010-08-23,Assembly,"AB 2733 RUSKIN  Concurrence in Senate Amendments",74,0,0,0,74
71565,493,2010-04-20,Assembly,"Do pass and be re-referred to the Committee on Appropriations.",6,0,0,0,6
71565,494,2010-05-28,Assembly,"Do pass as amended.",12,5,0,0,17
71565,495,2010-06-02,Assembly,"AB 2734 PEREZ, J.  Assembly Third Reading",75,0,4,0,79
71565,10189,2010-06-29,Senate,"Do pass, but re-refer to the Committee on Appropriations",8,0,3,0,11
71565,19158,2010-08-02,Senate,"Placed on Appropriations Suspense file",10,0,0,0,10
71565,20190,2010-08-12,Senate,"Do pass as amended",7,4,0,0,11
71565,21774,2010-08-31,Senate,"Assembly 3rd Reading AB2734 John A. Perez By Alquist",28,6,0,0,34
71565,21775,2010-08-31,Assembly,"AB 2734 PEREZ, J.  Concurrence in Senate Amendments",76,0,0,0,76
71566,4716,2010-05-10,Assembly,"Do pass and be re-referred to the Committee on Appropriations",6,3,0,0,9
71569,1195,2010-04-20,Assembly,"Do pass and be re-referred to the Committee on Appropriations.",10,1,0,0,11
71569,1196,2010-05-05,Assembly,"Do pass.",17,0,0,0,17
71569,1197,2010-05-13,Assembly,"AB 2738 NIELLO  Assembly Third Reading",72,0,7,0,79
71569,9427,2010-06-22,Senate,"Do pass as amended, and re-refer to the Committee on Rules",9,0,2,0,11
71569,19699,2010-08-09,Senate,"Do pass as amended, and re-refer to the Committee on 	Appropriations",6,0,0,0,6
71569,21496,2010-08-25,Senate,"Assembly 3rd Reading AB2738 Niello Urgency Clause",34,0,0,0,34
71569,21568,2010-08-27,Assembly,"AB 2738 NIELLO  Concurrence- Urgency Added",74,1,0,0,75
71570,2034,2010-04-19,Assembly,"Do pass as amended and be re-referred to the Committee on Appropriations",9,0,0,0,9
71570,2035,2010-05-28,Assembly,"Do pass as amended",16,1,0,0,17
71570,2036,2010-06-03,Assembly,"AB 2739 BLAKESLEE  Assembly Third Reading",76,0,3,0,79
71571,1893,2010-05-04,Assembly,"Do pass",3,7,0,0,10
71571,1894,2010-05-04,Assembly,"Set first hearing.  Failed passage.  Reconsideration granted",10,0,0,0,10
71573,4465,2010-04-21,Assembly,"Do pass and be re-referred to the Committee on Appropriations",6,0,0,0,6
71573,4466,2010-05-05,Assembly,"Do pass",16,0,1,0,17
71573,4467,2010-05-13,Assembly,"AB 2742 BLAKESLEE  Assembly Third Reading",75,0,4,0,79
71573,9639,2010-06-28,Senate,"Do pass, but re-refer to the Committee on Appropriations",6,0,0,0,6
71573,21236,2010-08-23,Senate,"Assembly 3rd Reading AB2742 Blakeslee By Blakeslee",34,0,0,0,34
71573,21237,2010-08-24,Assembly,"AB 2742  Concurrence in Senate Amendments By HAGMAN",78,0,0,0,78
71574,3613,2010-05-04,Assembly,"Do pass as amended",9,0,1,0,10
71574,3614,2010-05-13,Assembly,"AB 2743 NAVA  Assembly Third Reading",63,7,9,0,79
71574,8830,2010-06-15,Senate,"Do pass",3,2,0,0,5
71574,19822,2010-08-11,Senate,"Assembly 3rd Reading AB2743 Nava Reconsider",33,0,0,0,33
71574,20999,2010-08-24,Senate,"Assembly 3rd Reading AB2743 Nava By Pavley",22,12,0,0,34
71574,21101,2010-08-25,Assembly,"AB 2743 NAVA  Concurrence in Senate Amendments",58,17,0,0,75
71577,2627,2010-04-21,Assembly,"Do pass and re-refer to Committee on Appropriations with recommendation:  To Consent Calendar",12,0,0,0,12
71577,2628,2010-04-28,Assembly,"Do pass, to Consent Calendar",15,0,2,0,17
71577,2629,2010-05-06,Assembly,"AB 2746 BLAKESLEE  Consent Calendar Second Day  Regular Session",74,0,5,0,79
71577,9849,2010-06-30,Senate,"Do pass, but re-refer to the Committee on Appropriations",10,0,1,0,11
71577,19317,2010-08-02,Senate,"Do pass",9,0,0,0,9
71577,20455,2010-08-18,Senate,"Special Consent #31 AB2746 Blakeslee By Calderon",34,0,0,0,34
71577,20710,2010-08-20,Assembly,"AB 2746 BLAKESLEE  Concurrence in Senate Amendments",76,0,0,0,76
71578,325,2010-04-20,Assembly,"Do pass as amended and be re-referred to the Committee on Appropriations.",16,0,3,0,19
71578,326,2010-05-12,Assembly,"Do pass.",16,0,1,0,17
71578,327,2010-05-24,Assembly,"AB 2747 LOWENTHAL  Assembly Third Reading",71,0,8,0,79
71578,9366,2010-06-22,Senate,"Do pass, but re-refer to the Committee on Appropriations",7,0,0,0,7
71578,19891,2010-08-09,Senate,"Placed on Appropriations Suspense file",10,0,0,0,10
71578,20057,2010-08-12,Senate,"Do pass",11,0,0,0,11
71578,20848,2010-08-23,Senate,"Assembly 3rd Reading AB2747 Bonnie Lowenthal By Liu",36,0,0,0,36
71578,21005,2010-08-24,Assembly,"AB 2747 LOWENTHAL  Concurrence in Senate Amendments",78,0,0,0,78
71583,2122,2010-04-20,Assembly,"Do pass and be re-referred to the Committee on Appropriations",9,0,0,0,9
71583,2123,2010-05-28,Assembly,"Do pass",17,0,0,0,17
71583,2124,2010-06-03,Assembly,"AB 2752 BLAKESLEE  Assembly Third Reading",74,1,4,0,79
71584,1100,2010-04-12,Assembly,"Be referred to Committee on Higher Education.",10,0,1,0,11
71585,1584,2010-04-21,Assembly,"Do pass and be re-referred to the Committee on Appropriations",6,3,0,0,9
71585,1585,2010-05-28,Assembly,"Do pass as amended",12,5,0,0,17
71585,1586,2010-06-02,Assembly,"AB 2754 PEREZ, J.  Assembly Third Reading",49,27,3,0,79
71585,10288,2010-06-30,Senate,"Do pass, but re-refer to the Committee on Appropriations",4,0,1,0,5
71585,19778,2010-08-09,Senate,"Placed on Appropriations Suspense file",10,0,0,0,10
71585,20048,2010-08-12,Senate,"Do pass",7,4,0,0,11
71585,20808,2010-08-23,Senate,"Assembly 3rd Reading AB2754 John A. Perez By Aanestad",25,11,0,0,36
71585,21278,2010-08-25,Assembly,"AB 2754 PEREZ, J.  Concurrence in Senate Amendments",52,25,0,0,77
71587,8682,2010-04-12,Assembly,"Do pass and be re-referred to the Committee on Transportation",13,4,5,0,22
71587,8683,2010-04-19,Assembly,"Do pass",9,4,1,0,14
71587,8684,2010-04-26,Assembly,"AB 2756 BLUMENFIELD  Assembly Third Reading",47,19,13,0,79
71587,10163,2010-06-29,Senate,"Do pass as amended",8,1,0,0,9
71587,20681,2010-08-20,Senate,"Assembly 3rd Reading AB2756 Blumenfield By Padilla",23,9,0,0,32
71587,21258,2010-08-25,Assembly,"AB 2756 BLUMENFIELD  Concurrence in Senate Amendments",53,22,0,0,75
71588,316,2010-04-21,Assembly,"Do pass and be re-referred to the Committee on Appropriations.",21,0,1,0,22
71589,1275,2010-04-19,Assembly,"Do pass as amended and be re-referred to the Committee on Appropriations.",9,2,4,0,15
71589,1276,2010-05-28,Assembly,"Do pass as amended.",12,5,0,0,17
71589,1277,2010-06-03,Assembly,"AB 2758 BRADFORD  Assembly Third Reading",53,21,5,0,79
71589,10230,2010-06-29,Senate,"Do pass as amended, and re-refer to the Committee on Appropriations",8,2,1,0,11
71589,20963,2010-08-24,Senate,"Assembly 3rd Reading AB2758 Bradford By Price",22,13,0,0,35
71589,21443,2010-08-26,Assembly,"AB 2758 BRADFORD  Concurrence in Senate Amendments",51,25,0,0,76
71596,27114,2010-03-11,Assembly,"From committee:  Be adopted.  To third reading",7,3,0,0,10
71596,27115,2010-03-25,Senate,"Assembly 3rd Reading ACR133 John A. Perez",23,10,0,0,33
71597,27197,2010-03-25,Assembly,"From committee:  Be adopted.  To third reading",10,0,0,0,10
71597,27198,2010-04-26,Senate,"Assembly 3rd Reading ACR134 Adams By Denham",35,0,0,0,35
71598,1339,2010-04-22,Assembly,"From committee:  Be adopted.  To third reading.",8,0,3,0,11
71598,9617,2010-06-24,Senate,"W/O REF. TO FILE ACR135 Smyth",31,0,8,0,39
71599,27288,2010-04-05,Assembly,"Be adopted, and re-refer to Committee on Appropriations with 	recommendation:  To Consent Calendar",13,0,0,0,13
71599,27289,2010-04-14,Assembly,"Be adopted, to Consent Calendar",15,0,0,0,15
71599,27290,2010-04-19,Assembly,"ACR 136 CHESBRO  Consent Calendar Second Day  Regular Session",73,0,0,0,73
71599,27291,2010-05-04,Senate,"Be adopted, but re-refer to the Committee on Appropriations 	Recommend Consent",8,0,0,0,8
71599,27292,2010-05-27,Senate,"Consent Calendar 2nd ACR136 Chesbro",33,0,0,0,33
71600,1099,2010-03-25,Assembly,"Be adopted, to Consent Calendar.",10,0,1,0,11
71600,20335,2010-08-12,Senate,"Assembly 3rd Reading ACR137 Carter By Negrete McLeod",33,0,0,0,33
71603,3819,2010-03-16,Assembly,"Be adopted as amended",6,2,1,0,9
71603,3820,2010-04-29,Assembly,"AJR 37 DE LEON  Assembly Third Reading",44,25,10,0,79
71603,6780,2010-06-10,Senate,"Be adopted as amended",3,2,0,0,5
71603,9843,2010-06-28,Senate,"Assembly 3rd Reading AJR37 De Leon By Cedillo",21,12,6,0,39
71603,9983,2010-07-01,Assembly,"AJR 37 DE LEON  Concurrence in Senate Amendments",48,25,6,0,79
71604,726,2010-04-20,Senate,"Do pass.",8,0,1,0,9
71604,727,2010-04-26,Senate,"Senate 3rd Reading SB1229 Denham",36,0,3,0,39
71604,8850,2010-06-14,Assembly,"Do pass",11,0,3,0,14
71604,9453,2010-06-24,Assembly,"SB 1229 Denham  Senate Third Reading  By NIELSEN",68,1,10,0,79
71604,9623,2010-06-28,Senate,"Unfinished Business SB1229 Denham",36,0,3,0,39
71605,4787,2010-04-19,Senate,"Do pass as amended, and re-refer to the Committee on Appropriations",4,2,0,0,6
71605,4788,2010-05-10,Senate,"Do pass",6,2,3,0,11
71605,4789,2010-05-28,Senate,"Senate 3rd Reading SB1230 DeSaulnier",23,7,8,0,38
71605,9472,2010-06-23,Assembly,"Do pass and be re-referred to the Committee on Appropriations",4,0,2,0,6
71605,19932,2010-08-12,Assembly,"Do pass as amended",12,5,0,0,17
71605,21401,2010-08-25,Assembly,"SB 1230 DeSaulnier  Senate Third Reading  By SWANSON",51,23,0,0,74
71605,21402,2010-08-26,Senate,"Unfinished Business SB1230 DeSaulnier",23,14,0,0,37
71606,3275,2010-04-13,Senate,"Do pass, but re-refer to the Committee on Appropriations",7,1,3,0,11
71606,3276,2010-05-24,Senate,"Placed on Appropriations Suspense file",10,0,1,0,11
71606,3277,2010-05-27,Senate,"Do pass",7,3,1,0,11
71606,3278,2010-06-02,Senate,"Senate 3rd Reading SB1231 Corbett",21,13,4,0,38
71606,9462,2010-06-23,Assembly,"Do pass and be re-referred to the Committee on Business, Professions and Consumer Protection",4,1,1,0,6
71606,9719,2010-06-29,Assembly,"Do pass and be re-referred to the Committee on Appropriations",7,4,0,0,11
71606,20077,2010-08-12,Assembly,"Do pass",12,5,0,0,17
71606,20631,2010-08-19,Assembly,"SB 1231 Corbett  Senate Third Reading  By SWANSON",50,27,0,0,77
71608,1624,2010-04-06,Senate,"Do pass, but re-refer to the Committee on Judiciary",5,0,0,0,5
71608,1625,2010-04-13,Senate,"Do pass, but re-refer to the Committee on Appropriations",4,0,1,0,5
71608,1626,2010-04-26,Senate,"Placed on Appropriations Suspense file",9,0,2,0,11
71608,1627,2010-05-27,Senate,"Do pass",10,0,1,0,11
71608,1628,2010-06-02,Senate,"Special Consent #26 SB1233 Oropeza",35,0,3,0,38
71608,8753,2010-06-15,Assembly,"Do pass and re-refer to Committee on Appropriations with recommendation:  To Consent Calendar",10,0,0,0,10
71608,20333,2010-08-12,Assembly,"Do pass",17,0,0,0,17
71608,20540,2010-08-19,Assembly,"SB 1233 Oropeza  Senate Third Reading  By LOWENTHAL",79,0,0,0,79
71611,2886,2010-04-14,Senate,"Do pass as amended, and re-refer to the Committee on Appropriations",9,0,0,0,9
71611,2887,2010-05-03,Senate,"Placed on Appropriations Suspense file",10,0,1,0,11
71611,2888,2010-05-27,Senate,"Do pass",10,0,1,0,11
71611,2889,2010-06-02,Senate,"Special Consent #26 SB1236 Alquist",35,0,3,0,38
71611,8788,2010-06-15,Assembly,"Do pass and re-refer to Committee on Appropriations with recommendation:  To Consent Calendar",18,0,1,0,19
71612,3346,2010-04-21,Senate,"Do pass as amended, and re-refer to the Committee on Appropriations",5,0,4,0,9
71612,3347,2010-05-28,Senate,"Senate 3rd Reading SB1237 Padilla",24,5,9,0,38
71612,9397,2010-06-22,Assembly,"Do pass and be re-referred to the Committee on Business, Professions and Consumer Protection",19,0,0,0,19
71612,9718,2010-06-29,Assembly,"Do pass and be re-referred to the Committee on Appropriations",11,0,0,0,11
71612,19702,2010-08-04,Assembly,"Do pass",17,0,0,0,17
71612,21392,2010-08-26,Assembly,"SB 1237 Padilla  Senate Third Reading  By FLETCHER",70,4,0,0,74
71612,21708,2010-08-30,Senate,"W/O REF. TO FILE SB1237 Padilla Concurrence",22,10,0,0,32
71615,439,2010-04-07,Senate,"Do pass as amended, and re-refer to the Committee on Health.",3,2,0,0,5
71615,440,2010-04-21,Senate,"Do pass as amended, and re-refer to the Committee on Appropriations.",5,0,4,0,9
71615,441,2010-06-01,Senate,"Senate 3rd Reading SB1240 Corbett",22,12,4,0,38
71615,9511,2010-06-22,Assembly,"Do pass and be re-referred to the Committee on Appropriations",13,6,0,0,19
71615,19726,2010-08-04,Assembly,"Do pass as amended",12,5,0,0,17
71615,21808,2010-08-31,Assembly,"SB 1240 Corbett  Senate Third Reading  By HUFFMAN",48,28,0,0,76
71615,21809,2010-08-31,Senate,"W/O REF. TO FILE SB1240 Corbett Concurrence",22,13,0,0,35
71616,4477,2010-04-06,Senate,"Do pass as amended, and re-refer to the Committee on Environmental Quality",3,1,1,0,5
71616,4478,2010-04-19,Senate,"Do pass as amended, and re-refer to the Committee on Appropriations",4,2,1,0,7
71616,4479,2010-05-10,Senate,"Placed on Appropriations Suspense file",9,0,2,0,11
71617,3724,2010-04-07,Senate,"Do pass, but re-refer to the Committee on Appropriations",10,0,1,0,11
71617,3725,2010-04-26,Senate,"Do pass",9,0,2,0,11
71617,3726,2010-05-03,Senate,"Special Consent #22 SB1242 Calderon",34,0,4,0,38
71617,9266,2010-06-23,Assembly,"Do pass and be re-referred to the Committee on Appropriations",12,0,0,0,12
71619,1504,2010-04-19,Senate,"Do pass as amended, and re-refer to the Committee on Revenue and Taxation",6,0,0,0,6
71619,1505,2010-05-10,Senate,"Do pass",9,0,2,0,11
71619,1506,2010-05-24,Senate,"Senate 3rd Reading SB1244 Walters",33,0,5,0,38
71619,9442,2010-06-23,Assembly,"Do pass and re-refer to Committee on Appropriations with recommendation:  To Consent Calendar",12,0,0,0,12
71619,19692,2010-08-04,Assembly,"Do pass, to Consent Calendar",17,0,0,0,17
71619,19894,2010-08-12,Assembly,"SB 1244 Walters  Consent Calendar Second Day  Regular Session",78,0,0,0,78
71620,1403,2010-04-20,Senate,"Do pass as amended",8,0,1,0,9
71620,1404,2010-05-10,Senate,"Placed on Appropriations Suspense file",9,0,2,0,11
71620,1405,2010-05-27,Senate,"Do pass",10,0,1,0,11
71620,1406,2010-06-02,Senate,"Special Consent #26 SB1245 Simitian",35,0,3,0,38
71621,4681,2010-04-12,Senate,"Do pass as amended, and re-refer to the Committee on Appropriations",8,0,1,0,9
71621,4682,2010-05-28,Senate,"Senate 3rd Reading SB1246 Negrete McLeod",28,0,10,0,38
71621,9438,2010-06-22,Assembly,"Do pass and be re-referred to the Committee on Appropriations",11,0,0,0,11
71621,19592,2010-08-04,Assembly,"Do pass, to Consent Calendar",17,0,0,0,17
71621,19895,2010-08-12,Assembly,"SB 1246 Negrete McLeod  Consent Calendar Second Day  Regular Session",78,0,0,0,78
71621,20756,2010-08-19,Senate,"Unfinished Business SB1246 Negrete McLeod",35,0,0,0,35
71622,8937,2010-06-15,Senate,"Do pass as amended, and re-refer to the Committee on Appropriations",6,0,5,0,11
71622,10043,2010-07-01,Senate,"Special Consent #29 SB1247 Dutton",34,0,5,0,39
71622,19833,2010-08-09,Assembly,"Do pass and be re-referred to the Committee on Appropriations",15,0,0,0,15
71622,20214,2010-08-12,Assembly,"Do pass, to Consent Calendar",17,0,0,0,17
71622,20454,2010-08-18,Assembly,"SB 1247 Dutton  Consent Calendar Second Day  Regular Session",75,0,0,0,75
71622,21487,2010-08-26,Senate,"Special Consent #32 SB1247 Dutton",34,0,0,0,34
71624,708,2010-04-13,Senate,"Do pass as amended, and re-refer to the Committee on Appropriations.",7,1,3,0,11
71624,709,2010-05-03,Senate,"Placed on Appropriations Suspense file.",10,0,1,0,11
71624,710,2010-05-27,Senate,"Do pass as amended.",7,3,1,0,11
71624,711,2010-06-02,Senate,"Senate 3rd Reading SB1249 Ducheny",23,12,3,0,38
71625,1188,2010-04-14,Senate,"Do pass, but re-refer to the Committee on Appropriations Recommend Consent.",5,0,0,0,5
71625,1189,2010-05-03,Senate,"Placed on Appropriations Suspense file.",10,0,1,0,11
71625,1190,2010-05-27,Senate,"Do pass as amended.",10,0,1,0,11
71625,1191,2010-06-03,Senate,"Senate 3rd Reading SB1250 Ducheny",33,0,5,0,38
71625,9746,2010-06-28,Assembly,"Do pass",9,0,0,0,9
71625,20424,2010-08-18,Assembly,"SB 1250 Ducheny  Senate Third Reading  By SALAS",74,0,0,0,74
71625,21445,2010-08-26,Senate,"Special Consent #32 SB1250 Ducheny",34,0,0,0,34
71627,5420,2010-04-13,Senate,"Do pass as amended, and re-refer to the Committee on Appropriations",3,1,1,0,5
71627,5421,2010-05-28,Senate,"Senate 3rd Reading SB1252 Corbett",22,8,8,0,38
71627,10069,2010-06-29,Assembly,"Do pass and be re-referred to the Committee on Appropriations",7,2,1,0,10
71627,19598,2010-08-04,Assembly,"Do pass",12,5,0,0,17
71627,20754,2010-08-19,Assembly,"SB 1252 Corbett  Senate Third Reading  By EVANS",50,28,0,0,78
71628,3532,2010-04-20,Senate,"Do pass as amended",7,0,0,0,7
71628,3533,2010-05-03,Senate,"Special Consent #22 SB1253 Strickland",34,0,4,0,38
71628,8986,2010-06-15,Assembly,"Do pass",5,0,2,0,7
71628,8987,2010-06-17,Assembly,"SB 1253 Strickland  Senate Third Reading  By PORTANTINO",68,0,11,0,79
71629,3513,2010-04-05,Senate,"Do pass as amended, and re-refer to the Committee on Appropriations",7,0,2,0,9
71629,3514,2010-04-26,Senate,"Do pass",9,0,2,0,11
71629,3515,2010-05-03,Senate,"Special Consent #22 SB1254 Leno",34,0,4,0,38
71629,8988,2010-06-15,Assembly,"Do pass and be re-referred to the Committee on Appropriations",11,0,0,0,11
71629,20373,2010-08-12,Assembly,"Do pass",12,5,0,0,17
71629,21275,2010-08-25,Assembly,"SB 1254 Leno  Senate Third Reading  By BERRYHILL, B",75,1,0,0,76
71629,21455,2010-08-26,Senate,"Unfinished Business SB1254 Leno",36,0,0,0,36
71630,261,2010-04-14,Senate,"Do pass, but re-refer to the Committee on Education.",6,3,0,0,9
71630,262,2010-04-21,Senate,"Do pass as amended.",6,2,1,0,9
71630,263,2010-05-27,Senate,"Senate 3rd Reading SB1255 Padilla",21,11,6,0,38
71630,9022,2010-06-16,Assembly,"Do pass as amended and be re-referred to the Committee on Health",5,2,2,0,9
71630,10094,2010-06-29,Assembly,"Do pass and be re-referred to the Committee on Appropriations",14,5,0,0,19
71631,3592,2010-03-24,Senate,"Do pass",8,0,1,0,9
71631,3593,2010-05-03,Senate,"Special Consent #22 SB1256 Hancock",34,0,4,0,38
71631,8991,2010-06-16,Assembly,"Do pass as amended",8,0,1,0,9
71631,9657,2010-06-28,Assembly,"SB 1256 Hancock  Senate Third Reading  By BEALL",73,0,6,0,79
71631,9997,2010-07-01,Senate,"Special Consent #29 SB1256 Hancock",34,0,5,0,39
71633,4215,2010-04-13,Senate,"Do pass, but re-refer to the Committee on Banking, Finance and Insurance",7,1,3,0,11
71633,4216,2010-04-21,Senate,"Do pass, but re-refer to the Committee on Appropriations",6,2,3,0,11
71633,4217,2010-05-03,Senate,"Placed on Appropriations Suspense file",10,0,1,0,11
71634,4007,2010-04-13,Senate,"Do pass, but re-refer to the Committee on Appropriations",8,0,3,0,11
71634,4008,2010-04-26,Senate,"Placed on Appropriations Suspense file",9,0,2,0,11
71635,4996,2010-04-13,Senate,"Do pass as amended, and re-refer to the Committee on Appropriations",8,0,3,0,11
71635,4997,2010-05-10,Senate,"Special Consent #23 SB1260 Yee",30,0,8,0,38
71635,9972,2010-06-30,Assembly,"Do pass and be re-referred to the Committee on Appropriations",18,0,4,0,22
71635,20101,2010-08-12,Assembly,"Do pass",17,0,0,0,17
71635,20383,2010-08-17,Assembly,"SB 1260 Yee  Senate Third Reading  By HAGMAN",75,0,0,0,75
71635,21442,2010-08-26,Senate,"Special Consent #32 SB1260 Yee",34,0,0,0,34
71637,8317,2010-04-12,Senate,"Do pass, but re-refer to the Committee on Appropriations",3,3,0,0,6
71637,8318,2010-04-12,Senate,"Set, first hearing.  Failed passage in Committee.  Reconsideration granted",6,0,0,0,6
71639,2463,2010-04-20,Senate,"Do pass as amended, and re-refer to the Committee on Appropriations",6,2,1,0,9
71639,2464,2010-05-10,Senate,"Placed on Appropriations Suspense file",9,0,2,0,11
71639,2465,2010-05-27,Senate,"Do pass as amended",7,3,1,0,11
71639,2466,2010-06-03,Senate,"Senate 3rd Reading SB1264 Leno",17,16,5,0,38
71639,2467,2010-06-03,Senate,"Senate 3rd Reading SB1264 Leno Reconsider",36,0,2,0,38
71640,2406,2010-04-06,Senate,"Do pass as amended, and re-refer to the Committee on Appropriations",7,0,0,0,7
71640,2407,2010-05-03,Senate,"Special Consent #22 SB1265 Dutton",34,0,4,0,38
71640,8950,2010-06-15,Assembly,"Do pass",7,0,0,0,7
71640,9089,2010-06-21,Assembly,"SB 1265 Dutton  Senate Third Reading  By HAGMAN",74,0,5,0,79
71641,3259,2010-04-13,Senate,"Do pass as amended, and re-refer to the Committee on Appropriations",5,2,0,0,7
71641,3260,2010-05-17,Senate,"Do pass as amended",6,4,1,0,11
71641,3261,2010-05-28,Senate,"Senate 3rd Reading SB1266 Liu",22,6,10,0,38
71641,9513,2010-06-22,Assembly,"Do pass and be re-referred to the Committee on Appropriations",4,2,1,0,7
71641,19393,2010-08-04,Assembly,"Do pass",10,5,0,0,15
71641,20447,2010-08-18,Assembly,"SB 1266 Liu  Senate Third Reading  By LOWENTHAL  Amend By LOWENTHAL 	Set #1",44,25,0,0,69
71641,21611,2010-08-26,Assembly,"SB 1266 Liu  Senate Third Reading  By LOWENTHAL",42,28,0,0,70
71641,21734,2010-08-30,Senate,"Unfinished Business SB1266 Liu",22,14,0,0,36
71642,2228,2010-04-19,Senate,"Do pass, but re-refer to the Committee on Appropriations",2,4,0,0,6
71643,1526,2010-04-06,Senate,"Do pass, but re-refer to the Committee on Judiciary",8,0,1,0,9
71643,1527,2010-04-13,Senate,"Do pass as amended, and re-refer to the Committee on Appropriations",3,1,1,0,5
71643,1528,2010-05-27,Senate,"Do pass as amended",6,3,2,0,11
71643,1529,2010-06-01,Senate,"Senate 3rd Reading SB1268 Simitian",24,10,4,0,38
71643,9165,2010-06-21,Assembly,"Do pass and be re-referred to the Committee on Judiciary",10,2,2,0,14
71643,10053,2010-06-29,Assembly,"Do pass as amended and be re-referred to the Committee on Appropriations",10,0,0,0,10
71643,19380,2010-08-04,Assembly,"Do pass",16,0,0,0,16
71643,20941,2010-08-23,Assembly,"SB 1268 Simitian  Senate Third Reading  By BLUMENFIELD",57,13,0,0,70
71643,21210,2010-08-25,Senate,"Unfinished Business SB1268 Simitian",25,4,0,0,29
71644,627,2010-04-20,Senate,"Do pass as amended, and re-refer to the Committee on Appropriations.",4,0,1,0,5
71644,628,2010-05-28,Senate,"Senate 3rd Reading SB1269 Oropeza",23,6,9,0,38
71644,8786,2010-06-15,Assembly,"Do pass and be re-referred to the Committee on Appropriations",7,3,0,0,10
71644,9909,2010-06-30,Assembly,"Do pass",12,5,0,0,17
71644,20491,2010-08-16,Assembly,"SB 1269 Oropeza  Senate Third Reading  By COTO",48,27,0,0,75
71646,283,2010-04-20,Senate,"Do pass, but re-refer to the Committee on Appropriations Recommend Consent.",5,0,0,0,5
71646,284,2010-05-03,Senate,"Do pass.",9,0,2,0,11
71646,285,2010-05-10,Senate,"Special Consent #23 SB1271 Romero",30,0,8,0,38
71646,9258,2010-06-22,Assembly,"Do pass and be re-referred to the Committee on Appropriations",7,0,0,0,7
71646,19687,2010-08-04,Assembly,"Do pass as amended",17,0,0,0,17
71646,21296,2010-08-23,Assembly,"SB 1271 Romero  Senate Third Reading  By GATTO",76,0,0,0,76
71646,21483,2010-08-26,Senate,"Unfinished Business SB1271 Romero",37,0,0,0,37
71647,1860,2010-04-14,Senate,"Do pass as amended, and re-refer to the Committee on Appropriations",3,2,0,0,5
71647,1861,2010-05-03,Senate,"Do pass",6,3,2,0,11
71647,1862,2010-06-02,Senate,"Senate 3rd Reading SB1272 Wolk",20,16,2,0,38
71647,1863,2010-06-02,Senate,"Senate 3rd Reading SB1272 Wolk Reconsider",35,0,3,0,38
71647,1864,2010-06-03,Senate,"Senate 3rd Reading SB1272 Wolk",21,15,2,0,38
71647,10115,2010-06-28,Assembly,"Do pass as amended and be re-referred to the Committee on Appropriations",6,3,0,0,9
71647,20092,2010-08-12,Assembly,"Do pass as amended",12,5,0,0,17
71647,20827,2010-08-23,Assembly,"SB 1272 Wolk  Senate Third Reading  By SKINNER",47,27,0,0,74
71647,21081,2010-08-25,Senate,"Unfinished Business SB1272 Wolk",22,12,0,0,34
71649,764,2010-04-13,Senate,"Do pass, but re-refer to the Committee on Appropriations Recommend Consent.",4,0,1,0,5
71649,765,2010-04-29,Senate,"Consent Calendar 2nd SB1274 Committee on Jud. (Corbett)",33,0,5,0,38
71649,9076,2010-06-15,Assembly,"Do pass and re-refer to Committee on Appropriations with recommendation:  To Consent Calendar",10,0,0,0,10
71649,9925,2010-06-30,Assembly,"Do pass, to Consent Calendar",17,0,0,0,17
71649,19856,2010-08-05,Assembly,"SB 1274 JUD.  Consent Calendar Second Day  Regular Session",71,0,0,0,71
71650,2520,2010-04-07,Senate,"Do pass, but re-refer to the Committee on Judiciary",7,2,2,0,11
71650,2521,2010-04-20,Senate,"Do pass as amended, and re-refer to the Committee on Appropriations",3,1,1,0,5
71650,2522,2010-05-24,Senate,"Do pass",6,4,1,0,11
71650,2523,2010-06-02,Senate,"From Committee:  Amendments returned to Senate floor for consideration",6,5,0,0,11
71650,2524,2010-06-03,Senate,"Senate 3rd Reading SB1275 Leno",21,12,5,0,38
71650,9213,2010-06-21,Assembly,"Do pass and be re-referred to the Committee on Judiciary",7,4,1,0,12
71650,9742,2010-06-29,Assembly,"Do pass and be re-referred to the Committee on Appropriations",7,3,0,0,10
71650,20111,2010-08-12,Assembly,"Do pass as amended",9,7,0,0,16
71650,21452,2010-08-24,Assembly,"SB 1275 Leno  Senate Third Reading  By NAVA",27,38,0,0,65
71650,21743,2010-08-30,Assembly,"SB 1275 Leno  Motion to Reconsider  By NAVA",47,29,0,0,76
71650,21744,2010-08-30,Assembly,"SB 1275 Leno  Senate Third Reading  By NAVA",30,36,0,0,66
71652,4314,2010-04-20,Senate,"Do pass as amended, and re-refer to the Committee on Appropriations",4,3,0,0,7
71652,4315,2010-05-10,Senate,"Placed on Appropriations Suspense file",9,0,2,0,11
71653,2118,2010-04-21,Senate,"Do pass as amended, and re-refer to the Committee on Appropriations",7,0,2,0,9
71653,2119,2010-05-17,Senate,"Placed on Appropriations Suspense file",10,0,1,0,11
71653,2120,2010-05-27,Senate,"Do pass as amended",10,0,1,0,11
71653,2121,2010-06-02,Senate,"Senate 3rd Reading SB1278 Wyland Urgency Clause",36,0,2,0,38
71653,10218,2010-06-30,Assembly,"Do pass as amended and re-refer to Committee on Appropriations with recommendation:  To Consent Calendar",9,0,0,0,9
71654,250,2010-04-13,Senate,"Do pass as amended.",7,0,0,0,7
71654,251,2010-04-22,Senate,"Senate 3rd Reading SB1279 Pavley",32,0,7,0,39
71654,9084,2010-06-15,Assembly,"Do pass",7,0,0,0,7
71654,9392,2010-06-24,Assembly,"SB 1279 Pavley  Senate Third Reading  By SWANSON",73,0,6,0,79
71654,10118,2010-07-01,Senate,"Special Consent #29 SB1279 Pavley",34,0,5,0,39
71656,4031,2010-05-04,Senate,"Do pass",1,3,1,0,5
71657,1450,2010-05-03,Senate,"Do pass",5,3,1,0,9
71657,1451,2010-06-01,Senate,"Senate 3rd Reading SB1282 Steinberg",23,12,3,0,38
71658,2788,2010-04-21,Senate,"Do pass as amended, and re-refer to the Committee on Appropriations",5,0,4,0,9
71658,2789,2010-05-10,Senate,"Placed on Appropriations Suspense file",9,0,2,0,11
71658,2790,2010-05-27,Senate,"Do pass as amended",7,3,1,0,11
71658,2791,2010-06-01,Senate,"Senate 3rd Reading SB1283 Steinberg",23,10,5,0,38
71658,10292,2010-06-29,Assembly,"Do pass and be re-referred to the Committee on Appropriations",14,5,0,0,19
71658,19341,2010-08-04,Assembly,"Do pass",12,5,0,0,17
71658,20783,2010-08-23,Assembly,"SB 1283 Steinberg  Senate Third Reading  By CHESBRO",54,21,0,0,75
71658,21432,2010-08-26,Senate,"Unfinished Business SB1283 Steinberg",24,11,0,0,35
71659,1700,2010-04-19,Senate,"Do pass as amended, and re-refer to the Committee on Appropriations",7,0,0,0,7
71659,1701,2010-05-10,Senate,"Placed on Appropriations Suspense file",9,0,2,0,11
71659,1702,2010-05-27,Senate,"Do pass as amended",10,0,1,0,11
71659,1703,2010-06-03,Senate,"Senate 3rd Reading SB1284 Ducheny",31,0,7,0,38
71659,8831,2010-06-15,Assembly,"Do pass and be re-referred to the Committee on Judiciary",9,0,0,0,9
71659,9707,2010-06-29,Assembly,"Do pass and re-refer to Committee on Appropriations with recommendation:  To Consent Calendar",10,0,0,0,10
71659,20257,2010-08-12,Assembly,"Do pass",17,0,0,0,17
71659,21165,2010-08-25,Assembly,"SB 1284 Ducheny  Senate Third Reading  By CALDERON",77,0,0,0,77
71659,21377,2010-08-26,Senate,"Unfinished Business SB1284 Ducheny",37,0,0,0,37
71660,5287,2010-05-04,Senate,"Do pass and be placed on the Consent Calendar",4,0,1,0,5
71660,5288,2010-05-13,Senate,"Consent Calendar 2nd SB1285 Steinberg",31,0,7,0,38
71660,9400,2010-06-24,Assembly,"Be referred to Committee on Education",11,0,0,0,11
71660,9401,2010-06-24,Assembly,"Author's amendments",11,0,0,0,11
71660,10344,2010-06-30,Assembly,"Do pass as amended and be re-referred to the Committee on Appropriations",6,2,1,0,9
71660,20201,2010-08-12,Assembly,"Do pass as amended and be re-referred to the Committee on Rules",9,2,0,0,11
71662,4054,2010-05-17,Senate,"Placed on Appropriations Suspense file",10,0,1,0,11
71665,3273,2010-04-21,Senate,"Do pass as amended, and re-refer to the Committee on Appropriations",8,0,1,0,9
71665,3274,2010-05-24,Senate,"Senate 3rd Reading SB1290 Kehoe",25,3,10,0,38
71665,9054,2010-06-16,Assembly,"Do pass as amended and be re-referred to the Committee on Appropriations",6,1,2,0,9
71665,20226,2010-08-12,Assembly,"Do pass",12,5,0,0,17
71665,21246,2010-08-23,Assembly,"SB 1290 Kehoe  Senate Third Reading  By EVANS",49,26,0,0,75
71665,21247,2010-08-25,Senate,"Unfinished Business SB1290 Kehoe",30,3,0,0,33
71666,3318,2010-04-19,Senate,"Do pass as amended, and re-refer to the Committee on Appropriations",5,1,1,0,7
71666,3319,2010-05-10,Senate,"Placed on Appropriations Suspense file",9,0,2,0,11
71666,3320,2010-05-27,Senate,"Do pass as amended",7,3,1,0,11
71666,3321,2010-06-03,Senate,"Senate 3rd Reading SB1291 Leno Reconsider",36,0,2,0,38
71666,8865,2010-06-03,Senate,"Senate 3rd Reading SB1291 Leno",20,13,5,0,38
71668,2411,2010-04-19,Senate,"Do pass, but re-refer to the Committee on Appropriations Recommend Consent",7,0,0,0,7
71668,2412,2010-05-03,Senate,"Placed on Appropriations Suspense file",10,0,1,0,11
71668,2413,2010-05-27,Senate,"Do pass",10,0,1,0,11
71668,2414,2010-06-02,Senate,"Special Consent #26 SB1293 Hollingsworth",35,0,3,0,38
71668,9711,2010-06-28,Assembly,"Amend, and re-refer to the Committee on Natural Resources",9,0,0,0,9
71670,877,2010-04-13,Senate,"Do pass as amended, and re-refer to the Committee on Appropriations.",8,0,1,0,9
71670,878,2010-05-10,Senate,"Special Consent #23 SB1295 Dutton",30,0,8,0,38
71670,8923,2010-06-14,Assembly,"Do pass and re-refer to Committee on Appropriations with recommendation:  To Consent Calendar",12,0,2,0,14
71670,9942,2010-06-30,Assembly,"Do pass, to Consent Calendar",17,0,0,0,17
71670,19907,2010-08-05,Assembly,"SB 1295 Dutton  Consent Calendar Second Day  Regular Session",71,0,0,0,71
71671,1312,2010-04-20,Senate,"Do pass, but re-refer to the Committee on Appropriations.",7,0,0,0,7
71671,1313,2010-05-03,Senate,"Placed on Appropriations Suspense file.",10,0,1,0,11
71671,1314,2010-05-27,Senate,"Do pass.",10,0,1,0,11
71671,1315,2010-06-02,Senate,"Special Consent #26 SB1296 Correa",35,0,3,0,38
71671,9167,2010-06-22,Assembly,"Do pass and re-refer to Committee on Appropriations with recommendation:  To Consent Calendar",6,0,1,0,7
71671,20127,2010-08-12,Assembly,"Do pass",17,0,0,0,17
71671,21287,2010-08-23,Assembly,"SB 1296 Correa  Senate Third Reading  By COOK",77,0,0,0,77
71673,2559,2010-04-14,Senate,"Do pass as amended, and re-refer to the Committee on Appropriations",5,3,1,0,9
71673,2560,2010-05-03,Senate,"Do pass",9,0,2,0,11
71673,2561,2010-05-27,Senate,"Senate 3rd Reading SB1298 Hancock",28,3,7,0,38
71673,10012,2010-06-30,Assembly,"Do pass as amended and be re-referred to the Committee on Appropriations",5,0,4,0,9
71674,3735,2010-04-13,Senate,"Do pass, but re-refer to the Committee on Appropriations",7,1,1,0,9
71674,3736,2010-05-03,Senate,"Placed on Appropriations Suspense file",10,0,1,0,11
71675,2934,2010-04-21,Senate,"Do pass, but re-refer to the Committee on Appropriations",6,1,2,0,9
71675,2935,2010-05-10,Senate,"Placed on Appropriations Suspense file",9,0,2,0,11
71675,2936,2010-05-27,Senate,"Do pass as amended",7,3,1,0,11
71675,2937,2010-06-03,Senate,"Senate 3rd Reading SB1300 Correa",22,8,8,0,38
71675,10253,2010-06-30,Assembly,"Do pass as amended and be re-referred to the Committee on Appropriations",2,2,5,0,9
71676,3621,2010-04-14,Senate,"Do pass, but re-refer to the Committee on Appropriations Recommend Consent",8,0,1,0,9
71676,3622,2010-05-03,Senate,"Placed on Appropriations Suspense file",10,0,1,0,11
71678,3117,2010-04-13,Senate,"Do pass as amended, and re-refer to the Committee on Appropriations",9,0,0,0,9
71678,3118,2010-05-10,Senate,"Senate 3rd Reading SB1303 Wolk",30,0,8,0,38
71678,9012,2010-06-15,Assembly,"Do pass and be re-referred to the Committee on Appropriations",11,0,1,0,12
71678,9956,2010-06-30,Assembly,"Do pass, to Consent Calendar",17,0,0,0,17
71678,19523,2010-08-05,Assembly,"SB 1303 Wolk  Consent Calendar Second Day  Regular Session",71,0,0,0,71
71678,19814,2010-08-11,Senate,"Unfinished Business SB1303 Wolk",27,0,0,0,27
71679,1498,2010-04-19,Senate,"Do pass, but re-refer to the Committee on Rules",4,2,0,0,6
71679,1499,2010-04-20,Senate,"Do pass, but re-refer to the Committee on Appropriations",3,1,1,0,5
71679,1500,2010-06-02,Senate,"Senate 3rd Reading SB1304 DeSaulnier",22,13,3,0,38
71679,9520,2010-06-23,Assembly,"Do pass and be re-referred to the Committee on Judiciary",4,0,2,0,6
71679,9716,2010-06-29,Assembly,"Do pass",7,1,2,0,10
71679,21687,2010-08-26,Assembly,"SB 1304 DeSaulnier  Senate Third Reading  By ENG",43,28,0,0,71
71691,9522,2010-06-23,Senate,"Do pass as amended, and re-refer to the Committee on Appropriations",3,0,2,0,5
71691,11001,2010-07-15,Senate,"Placed on Appropriations Suspense file",8,0,2,0,10
71691,20104,2010-08-12,Senate,"Do pass as amended",7,4,0,0,11
71692,2792,2010-04-20,Senate,"Do pass as amended, and re-refer to the Committee on Appropriations",6,1,0,0,7
71692,2793,2010-05-10,Senate,"Do pass",8,1,2,0,11
71692,2794,2010-05-13,Senate,"Senate 3rd Reading SB1317 Leno",21,9,8,0,38
71692,9180,2010-06-22,Assembly,"Do pass and be re-referred to the Committee on Education",4,1,2,0,7
71692,10234,2010-06-30,Assembly,"Do pass as amended and be re-referred to the Committee on Appropriations",7,2,0,0,9
71692,19372,2010-08-04,Assembly,"Do pass as amended",14,1,0,0,15
71692,21933,2010-08-30,Assembly,"SB 1317 Leno  Senate Third Reading  By BROWNLEY",58,17,0,0,75
71692,21934,2010-08-31,Senate,"Unfinished Business SB1317 Leno",23,13,0,0,36
71693,1666,2010-04-20,Senate,"Do pass, but re-refer to the Committee on Appropriations Recommend Consent",8,0,1,0,9
71693,1667,2010-05-10,Senate,"Consent Calendar 2nd SB1318 Committee on T.&H. (Lowenthal)",30,0,8,0,38
71693,8778,2010-06-14,Assembly,"Do pass and re-refer to Committee on Appropriations with recommendation:  To Consent Calendar",12,0,2,0,14
71693,9903,2010-06-30,Assembly,"Do pass as amended, to Consent Calendar",17,0,0,0,17
71693,19465,2010-08-05,Assembly,"SB 1318 T.& H.  Consent Calendar Second Day  Regular Session",71,0,0,0,71
71693,20146,2010-08-12,Senate,"Unfinished Business SB1318 Committee on T.&H. (Lowenthal)",32,0,0,0,32
71694,473,2010-04-19,Senate,"Do pass.",4,1,0,0,5
71694,474,2010-04-22,Senate,"Senate 3rd Reading SB1319 Pavley",29,2,8,0,39
71694,9827,2010-06-30,Assembly,"Do pass, to Consent Calendar",9,0,0,0,9
71694,19442,2010-08-05,Assembly,"SB 1319 Pavley  Consent Calendar Second Day  Regular Session",71,0,0,0,71
71694,21414,2010-08-25,Senate,"Unfinished Business SB1319 Pavley",28,1,0,0,29
71695,3236,2010-04-20,Senate,"Do pass as amended, and re-refer to the Committee on Rules",7,1,1,0,9
71695,3237,2010-05-03,Senate,"Senate 3rd Reading SB1320 Hancock",23,11,4,0,38
71695,8728,2010-06-14,Assembly,"Do pass as amended",8,4,2,0,14
71695,20293,2010-08-16,Assembly,"SB 1320 Hancock  Senate Third Reading  By ENG",49,24,0,0,73
71695,20561,2010-08-19,Senate,"Unfinished Business SB1320 Hancock",22,13,0,0,35
71696,466,2010-04-20,Senate,"Do pass.",3,1,1,0,5
71696,467,2010-04-22,Senate,"Senate 3rd Reading SB1321 Kehoe",24,8,7,0,39
71696,9321,2010-06-16,Assembly,"Do pass",5,3,0,0,8
71696,21128,2010-08-25,Assembly,"SB 1321 Kehoe  Senate Third Reading  By GALGIANI",50,27,0,0,77
71697,2241,2010-04-13,Senate,"Do pass, but re-refer to the Committee on Appropriations",3,1,1,0,5
71697,2242,2010-05-17,Senate,"Placed on Appropriations Suspense file",10,0,1,0,11
71697,2243,2010-05-27,Senate,"Do pass as amended",10,0,1,0,11
71697,2244,2010-06-02,Senate,"Senate 3rd Reading SB1322 Liu",36,0,2,0,38
71697,9699,2010-06-29,Assembly,"Do pass and be re-referred to the Committee on Appropriations",4,2,0,0,6
71697,20238,2010-08-12,Assembly,"Do pass as amended",12,5,0,0,17
71697,20887,2010-08-23,Assembly,"SB 1322 Liu  Senate Third Reading  By HALL",58,16,0,0,74
71697,21138,2010-08-25,Senate,"Unfinished Business SB1322 Liu",34,0,0,0,34
71698,5324,2010-04-13,Senate,"Do pass, but re-refer to the Committee on Appropriations",8,1,2,0,11
71698,5325,2010-05-03,Senate,"Do pass",10,0,1,0,11
71698,5326,2010-05-10,Senate,"Senate 3rd Reading SB1323 Walters",31,0,7,0,38
71698,9516,2010-06-23,Assembly,"Do pass and be re-referred to the Committee on Appropriations",21,0,1,0,22
71700,4520,2010-04-20,Senate,"Do pass",2,5,0,0,7
71701,2562,2010-04-05,Senate,"Do pass, but re-refer to the Committee on Appropriations",4,2,1,0,7
71701,2563,2010-04-26,Senate,"Placed on Appropriations Suspense file",9,0,2,0,11
71701,2564,2010-05-27,Senate,"Do pass as amended",7,3,1,0,11
71701,2565,2010-06-02,Senate,"Senate 3rd Reading SB1326 Oropeza",23,13,2,0,38
71701,9680,2010-06-28,Assembly,"Do pass and be re-referred to the Committee on Appropriations",6,3,0,0,9
71703,2304,2010-04-19,Senate,"Do pass, but re-refer to the Committee on Appropriations Recommend Consent",7,0,0,0,7
71703,2305,2010-05-13,Senate,"Senate 3rd Reading SB1328 Lowenthal",27,0,11,0,38
71703,10073,2010-06-28,Assembly,"Do pass and be re-referred to the Committee on Appropriations",8,0,1,0,9
71703,19601,2010-08-04,Assembly,"Do pass, to Consent Calendar",17,0,0,0,17
71703,21659,2010-08-30,Assembly,"SB 1328 Lowenthal  Senate Third Reading  By HILL",76,0,0,0,76
71703,21660,2010-08-30,Senate,"W/O REF. TO FILE SB1328 Lowenthal Concurrence",37,0,0,0,37
71704,4662,2010-03-23,Senate,"Do pass as amended, and re-refer to the Committee on Appropriations",4,0,1,0,5
71704,4663,2010-05-03,Senate,"Do pass",9,0,2,0,11
71704,4664,2010-05-10,Senate,"Special Consent #23 SB1329 Leno",30,0,8,0,38
71704,8755,2010-06-15,Assembly,"Do pass and be re-referred to the Committee on Judiciary",4,0,2,0,6
71704,9450,2010-06-22,Assembly,"Do pass and be re-referred to the Committee on Appropriations",7,0,3,0,10
71704,19632,2010-08-04,Assembly,"Do pass",13,4,0,0,17
71704,21095,2010-08-25,Assembly,"SB 1329 Leno  Senate Third Reading  By ADAMS",73,3,0,0,76
71704,21485,2010-08-26,Senate,"Unfinished Business SB1329 Leno",26,11,0,0,37
71705,4668,2010-03-23,Senate,"Do pass and be placed on the Consent Calendar",5,0,0,0,5
71705,4669,2010-04-15,Senate,"Senate 3rd Reading SB1330 Committee on Jud. (Corbett)",36,0,3,0,39
71705,8841,2010-06-15,Assembly,"Do pass, to Consent Calendar",10,0,0,0,10
71705,20460,2010-08-16,Assembly,"SB 1330 JUD.  Senate Third Reading  By FEUER",75,0,0,0,75
71705,20544,2010-08-19,Senate,"Unfinished Business SB1330 Committee on Jud. (Corbett)",34,0,0,0,34
71706,4011,2010-04-06,Senate,"Do pass as amended, and re-refer to the Committee on Appropriations",5,2,0,0,7
71706,4012,2010-04-26,Senate,"Placed on Appropriations Suspense file",9,0,2,0,11
71707,884,2010-05-05,Senate,"Do pass as amended, and re-refer to the Committee on Appropriations.",9,0,0,0,9
71707,885,2010-06-01,Senate,"Special Consent #25 SB1332 Dutton",35,0,3,0,38
71707,10276,2010-06-29,Assembly,"Do pass and re-refer to Committee on Appropriations with recommendation:  To Consent Calendar",19,0,0,0,19
71707,19751,2010-08-04,Assembly,"Do pass, to Consent Calendar",17,0,0,0,17
71707,19874,2010-08-12,Assembly,"SB 1332 Dutton  Consent Calendar Second Day  Regular Session",78,0,0,0,78
71707,20752,2010-08-19,Senate,"Unfinished Business SB1332 Dutton",34,0,0,0,34
71708,1198,2010-04-19,Senate,"Do pass as amended, and re-refer to the Committee on Appropriations.",5,0,0,0,5
71708,1199,2010-05-10,Senate,"Do pass as amended.",9,0,2,0,11
71708,1200,2010-05-24,Senate,"Senate 3rd Reading SB1333 Yee",32,0,6,0,38
71708,9914,2010-06-30,Assembly,"Do pass and be re-referred to the Committee on Appropriations",9,0,0,0,9
71708,19351,2010-08-04,Assembly,"Do pass, to Consent Calendar",17,0,0,0,17
71708,19986,2010-08-12,Assembly,"SB 1333 Yee  Consent Calendar Second Day  Regular Session",78,0,0,0,78
71709,1496,2010-04-13,Senate,"Do pass as amended, and re-refer to the Committee on Appropriations",5,3,1,0,9
71709,1497,2010-06-02,Senate,"Senate 3rd Reading SB1334 Wolk",23,12,3,0,38
71709,9282,2010-06-21,Assembly,"Do pass and be re-referred to the Committee on Water, Parks and Wildlife",5,2,2,0,9
71709,10077,2010-06-29,Assembly,"Do pass and be re-referred to the Committee on Appropriations",9,4,0,0,13
71709,19786,2010-08-04,Assembly,"Do pass",12,5,0,0,17
71709,20446,2010-08-16,Assembly,"SB 1334 Wolk  Senate Third Reading  By CHESBRO",47,27,0,0,74
71710,2632,2010-04-19,Senate,"Do pass, but re-refer to the Committee on Appropriations",2,4,0,0,6
71713,766,2010-04-20,Senate,"Do pass.",7,0,0,0,7
71713,767,2010-04-20,Senate,"Do pass.",7,0,0,0,7
71713,768,2010-04-26,Senate,"Senate 3rd Reading SB1338 Harman",33,0,6,0,39
71713,9568,2010-06-22,Assembly,"Do pass, to Consent Calendar",6,0,1,0,7
71713,20332,2010-08-16,Assembly,"SB 1338 Harman  Senate Third Reading  By CONWAY",74,0,0,0,74
71713,20541,2010-08-19,Senate,"Unfinished Business SB1338 Harman",34,0,0,0,34
71715,5182,2010-04-06,Senate,"Do pass, but re-refer to the Committee on Environmental Quality",6,1,2,0,9
71715,5183,2010-04-19,Senate,"Do pass as amended, and re-refer to the Committee on Appropriations",5,0,2,0,7
71715,5184,2010-05-10,Senate,"Do pass",7,1,3,0,11
71715,5185,2010-05-28,Senate,"Senate 3rd Reading SB1340 Kehoe",23,4,11,0,38
71715,9717,2010-06-28,Assembly,"Do pass and be re-referred to the Committee on Local Government",11,1,2,0,14
71715,9804,2010-06-30,Assembly,"Do pass and be re-referred to the Committee on Appropriations",7,2,0,0,9
71715,20138,2010-08-12,Assembly,"Do pass as amended",12,5,0,0,17
71715,20846,2010-08-23,Assembly,"SB 1340 Kehoe  Senate Third Reading  By SOLORIO  Amend By SOLORIO 	Set #1",49,26,0,0,75
71715,21102,2010-08-25,Assembly,"SB 1340 Kehoe  Senate Third Reading  By SOLORIO",51,26,0,0,77
71715,21565,2010-08-27,Senate,"From committee:  That the Assembly Amendments be concurred in",3,1,0,0,4
71715,21650,2010-08-30,Senate,"Unfinished Business SB1340 Kehoe",23,14,0,0,37
71716,5256,2010-05-04,Senate,"Do pass as amended",7,1,1,0,9
71716,5257,2010-05-28,Senate,"Senate 3rd Reading SB1341 Price",28,0,10,0,38
71716,9726,2010-06-28,Assembly,"Do pass",13,1,0,0,14
71716,9727,2010-06-28,Assembly,"Do pass and be re-referred to the Committee on Transportation",9,0,0,0,9
71716,20320,2010-08-12,Assembly,"SB 1341 Price  Senate Third Reading  By BRADFORD  Amend By BRADFORD 	Set #1",50,23,0,0,73
71716,20321,2010-08-16,Assembly,"SB 1341 Price  Senate Third Reading  By BRADFORD",72,3,0,0,75
71716,21376,2010-08-25,Senate,"Unfinished Business SB1341 Price",34,0,0,0,34
71717,1891,2010-04-20,Senate,"Do pass",4,0,1,0,5
71717,1892,2010-04-26,Senate,"Senate 3rd Reading SB1342 Simitian",29,4,6,0,39
71717,9581,2010-06-22,Assembly,"Do pass",6,1,0,0,7
71717,10352,2010-07-01,Assembly,"SB 1342 Simitian  Senate Third Reading  By ADAMS",62,12,5,0,79
71719,2451,2010-04-07,Senate,"Do pass, but re-refer to the Committee on Banking, Finance and Insurance",5,0,0,0,5
71719,2452,2010-04-21,Senate,"Do pass",9,0,2,0,11
71719,2453,2010-05-03,Senate,"Special Consent #22 SB1344 Kehoe",34,0,4,0,38
71719,8952,2010-06-16,Assembly,"Do pass and be re-referred to the Committee on Banking and Finance to Consent Calendar",9,0,0,0,9
71719,9151,2010-06-21,Assembly,"Do pass, to Consent Calendar",12,0,0,0,12
71719,9579,2010-06-28,Assembly,"SB 1344 Kehoe  Consent Calendar Second Day  Regular Session",73,0,6,0,79
71720,518,2010-04-13,Senate,"Do pass as amended, and re-refer to the Committee on Appropriations.",8,0,1,0,9
71720,519,2010-05-28,Senate,"Senate 3rd Reading SB1345 Calderon",23,5,10,0,38
71720,9836,2010-06-29,Assembly,"Do pass",7,4,2,0,13
71720,20246,2010-08-12,Assembly,"SB 1345 Calderon  Senate Third Reading  By HUFFMAN",53,19,0,0,72
71721,4391,2010-04-20,Senate,"Do pass as amended, and re-refer to the Committee on Appropriations",3,2,0,0,5
71721,4392,2010-05-17,Senate,"Placed on Appropriations Suspense file",10,0,1,0,11
71722,3710,2010-04-20,Senate,"Do pass",4,2,1,0,7
71722,3711,2010-06-03,Senate,"Senate 3rd Reading SB1347 Leno Reconsider",36,0,2,0,38
71722,9044,2010-06-03,Senate,"Senate 3rd Reading SB1347 Leno",20,16,2,0,38
71723,3150,2010-04-20,Senate,"Do pass, but re-refer to the Committee on Appropriations Recommend Consent",8,0,1,0,9
71723,3151,2010-06-01,Senate,"Special Consent #25 SB1348 Steinberg",35,0,3,0,38
71723,8853,2010-06-14,Assembly,"Do pass as amended and re-refer to Committee on Appropriations with recommendation:  To Consent Calendar",12,0,2,0,14
71723,10324,2010-06-30,Assembly,"Do pass, to Consent Calendar",17,0,0,0,17
71723,20505,2010-08-16,Assembly,"SB 1348 Steinberg  Senate Third Reading  By LOWENTHAL",73,0,0,0,73
71723,21348,2010-08-26,Senate,"Special Consent #32 SB1348 Steinberg",34,0,0,0,34
71724,1494,2010-03-23,Senate,"Do pass as amended, and re-refer to the Committee on Appropriations",8,0,1,0,9
71724,1495,2010-06-02,Senate,"Senate 3rd Reading SB1349 Cogdill",36,0,2,0,38
71724,9796,2010-06-29,Assembly,"Do pass and be re-referred to the Committee on Appropriations",13,0,0,0,13
71724,19639,2010-08-04,Assembly,"Do pass, to Consent Calendar",17,0,0,0,17
71724,19969,2010-08-12,Assembly,"SB 1349 Cogdill  Consent Calendar Second Day  Regular Session",78,0,0,0,78
71724,20733,2010-08-19,Senate,"Unfinished Business SB1349 Cogdill",35,0,0,0,35
71725,2853,2010-04-13,Senate,"Do pass as amended, and re-refer to the Committee on Appropriations",8,1,0,0,9
71725,2854,2010-05-27,Senate,"Senate 3rd Reading SB1350 Kehoe",28,5,5,0,38
71725,9149,2010-06-21,Assembly,"Do pass and be re-referred to the Committee on Appropriations",7,0,2,0,9
71725,9980,2010-06-30,Assembly,"Do pass",14,2,1,0,17
71725,21633,2010-08-26,Assembly,"SB 1350 Kehoe  Senate Third Reading  By CHESBRO",58,14,0,0,72
71726,2691,2010-04-13,Senate,"Do pass, but re-refer to the Committee on Rules",6,1,4,0,11
71726,2692,2010-04-22,Senate,"Do pass as amended, and re-refer to the Committee on Appropriations",5,0,2,0,7
71726,2693,2010-05-24,Senate,"Senate 3rd Reading SB1351 Wright",24,0,14,0,38
71726,9814,2010-06-28,Assembly,"Do pass as amended and be re-referred to the Committee on Appropriations",9,0,0,0,9
71726,19553,2010-08-04,Assembly,"Do pass, to Consent Calendar",17,0,0,0,17
71726,19967,2010-08-12,Assembly,"SB 1351 Wright  Consent Calendar Second Day  Regular Session",78,0,0,0,78
71726,20640,2010-08-19,Senate,"From committee:  That the Assembly Amendments be concurred in",2,1,0,0,3
71728,3630,2010-03-24,Senate,"Do pass, but re-refer to the Committee on Human Services",7,0,2,0,9
71728,3631,2010-04-13,Senate,"Do pass, but re-refer to the Committee on Appropriations",4,0,1,0,5
71728,3632,2010-05-03,Senate,"Special Consent #22 SB1353 Wright",34,0,4,0,38
71728,8994,2010-06-15,Assembly,"Do pass as amended and be re-referred to the Committee on Education",5,0,1,0,6
71728,10349,2010-06-30,Assembly,"Do pass as amended, to Consent Calendar",9,0,0,0,9
71728,19460,2010-08-05,Assembly,"SB 1353 Wright  Consent Calendar Second Day  Regular Session",71,0,0,0,71
71728,19791,2010-08-11,Senate,"Unfinished Business SB1353 Wright",34,0,0,0,34
71729,288,2010-04-14,Senate,"Do pass as amended, and re-refer to the Committee on Appropriations.",7,1,1,0,9
71729,289,2010-05-03,Senate,"Placed on Appropriations Suspense file.",10,0,1,0,11
71729,290,2010-05-27,Senate,"Do pass as amended.",8,2,1,0,11
71729,291,2010-06-02,Senate,"Senate 3rd Reading SB1354 Hancock",23,12,3,0,38
71729,9984,2010-06-30,Assembly,"Do pass as amended and be re-referred to the Committee on Appropriations",8,0,1,0,9
71729,20107,2010-08-12,Assembly,"Do pass",17,0,0,0,17
71729,20858,2010-08-23,Assembly,"SB 1354 Hancock  Senate Third Reading  By TORLAKSON",76,0,0,0,76
71729,21112,2010-08-25,Senate,"Unfinished Business SB1354 Hancock",25,7,0,0,32
71730,2973,2010-05-04,Senate,"Do pass as amended",4,0,1,0,5
71730,2974,2010-05-24,Senate,"Do pass as amended",10,0,1,0,11
71730,2975,2010-06-02,Senate,"Special Consent #26 SB1355 Wright",35,0,3,0,38
71730,8790,2010-06-15,Assembly,"Do pass and be re-referred to the Committee on Appropriations",9,1,0,0,10
71730,9913,2010-06-30,Assembly,"Do pass",13,1,3,0,17
71730,21176,2010-08-23,Assembly,"SB 1355 Wright  Senate Third Reading  By CALDERON",51,24,0,0,75
71730,21177,2010-08-25,Senate,"Unfinished Business SB1355 Wright",31,2,0,0,33
71731,7814,2010-04-07,Senate,"Do pass as amended, and re-refer to the Committee on Public Safety",2,3,0,0,5
71731,7815,2010-04-07,Senate,"Set, first hearing.  Failed passage in Committee.  Reconsideration granted",5,0,0,0,5
71731,7816,2010-04-19,Senate,"Do pass, but re-refer to the Committee on Public Safety",2,3,0,0,5
71732,3339,2010-04-14,Senate,"Do pass, but re-refer to the Committee on Appropriations",8,0,1,0,9
71732,3340,2010-04-26,Senate,"Placed on Appropriations Suspense file",9,0,2,0,11
71732,3341,2010-05-27,Senate,"Do pass",10,0,1,0,11
71732,3342,2010-06-01,Senate,"Senate 3rd Reading SB1357 Steinberg",35,0,3,0,38
71732,9046,2010-06-16,Assembly,"Do pass as amended and re-refer to Committee on Appropriations with recommendation:  To Consent Calendar",8,0,1,0,9
71732,20073,2010-08-12,Assembly,"Do pass as amended",17,0,0,0,17
71732,21251,2010-08-25,Assembly,"SB 1357 Steinberg  Senate Third Reading  By BROWNLEY",76,1,0,0,77
71732,21435,2010-08-26,Senate,"Unfinished Business SB1357 Steinberg",37,0,0,0,37
71734,1023,2010-04-13,Senate,"Do pass as amended, and re-refer to the Committee on Appropriations.",3,1,1,0,5
71736,1440,2010-04-13,Senate,"Do pass as amended",3,0,2,0,5
71736,1441,2010-04-22,Senate,"Senate 3rd Reading SB1361 Corbett",25,4,10,0,39
71736,19517,2010-06-28,Assembly,"Do pass and be re-referred to the Committee on Judiciary",3,2,0,0,5
71736,19518,2010-06-28,Assembly,"Reconsideration granted",9,0,0,0,9
71737,3229,2010-05-04,Senate,"Do pass as amended",7,0,2,0,9
71737,3230,2010-06-01,Senate,"Senate 3rd Reading SB1362 Simitian",31,1,6,0,38
71737,9934,2010-06-28,Assembly,"Do pass as amended and be re-referred to the Committee on Appropriations",11,1,2,0,14
71738,3119,2010-04-21,Senate,"Do pass as amended, and re-refer to the Committee on Appropriations",9,0,2,0,11
71738,3120,2010-05-10,Senate,"Do pass",9,0,2,0,11
71738,3121,2010-05-17,Senate,"Special Consent #24 SB1363 Runner",33,0,5,0,38
71738,9160,2010-06-21,Assembly,"Do pass and be re-referred to the Committee on Appropriations",12,0,0,0,12
71738,20152,2010-08-12,Assembly,"Do pass",17,0,0,0,17
71738,20609,2010-08-19,Assembly,"SB 1363 Runner  Senate Third Reading  By ENG",77,0,0,0,77
71738,21413,2010-08-26,Senate,"Special Consent #32 SB1363 Runner",34,0,0,0,34
71739,5372,2010-04-20,Senate,"Do pass as amended, and re-refer to the Committee on Appropriations",2,5,0,0,7
71740,5493,2010-04-05,Senate,"Do pass as amended, and re-refer to the Committee on Appropriations",5,1,1,0,7
71740,5494,2010-04-26,Senate,"Do pass",7,2,2,0,11
71740,5495,2010-04-29,Senate,"Senate 3rd Reading SB1365 Corbett",23,10,5,0,38
71740,8891,2010-06-15,Assembly,"Do pass as amended and be re-referred to the Committee on Appropriations",6,2,1,0,9
71740,20248,2010-08-12,Assembly,"Do pass",12,5,0,0,17
71740,20901,2010-08-23,Assembly,"SB 1365 Corbett  Senate Third Reading  By NAVA",75,0,0,0,75
71740,21149,2010-08-25,Senate,"Unfinished Business SB1365 Corbett",29,0,0,0,29
71743,2780,2010-04-21,Senate,"Do pass, but re-refer to the Committee on Appropriations Recommend Consent",5,0,4,0,9
71743,2781,2010-05-17,Senate,"Consent Calendar 2nd SB1368 Committee on Health (Alquist)",33,0,5,0,38
71743,10059,2010-06-29,Assembly,"Do pass and re-refer to Committee on Appropriations with recommendation:  To Consent Calendar",19,0,0,0,19
71743,19334,2010-08-04,Assembly,"Do pass, to Consent Calendar",17,0,0,0,17
71743,19921,2010-08-12,Assembly,"SB 1368 HEALTH  Consent Calendar Second Day  Regular Session",78,0,0,0,78
71743,20763,2010-08-19,Senate,"Unfinished Business SB1368 Committee on Health (Alquist)",35,0,0,0,35
71745,437,2010-05-03,Senate,"Do pass.",4,0,2,0,6
71745,438,2010-05-28,Senate,"Senate 3rd Reading SB1370 Ducheny",22,7,9,0,38
71745,9374,2010-06-23,Assembly,"Do pass",4,0,2,0,6
71745,20316,2010-08-16,Assembly,"SB 1370 Ducheny  Senate Third Reading  By MONNING",47,27,0,0,74
71745,21349,2010-08-25,Senate,"Unfinished Business SB1370 Ducheny",22,13,0,0,35
71746,5285,2010-04-20,Senate,"Do pass, but re-refer to the Committee on Appropriations Recommend Consent",8,0,1,0,9
71746,5286,2010-05-10,Senate,"Consent Calendar 2nd SB1371 Lowenthal",30,0,8,0,38
71746,8859,2010-06-14,Assembly,"Do pass as amended and re-refer to Committee on Appropriations with recommendation:  To Consent Calendar",12,0,2,0,14
71746,9989,2010-06-30,Assembly,"Do pass, to Consent Calendar",17,0,0,0,17
71746,21093,2010-08-23,Assembly,"Do pass",13,0,0,0,13
71746,21880,2010-08-31,Assembly,"SB 1371 Correa  Third Reading Urgency  By LOWENTHAL",71,3,0,0,74
71746,21881,2010-08-31,Senate,"W/O REF. TO FILE SB1371 Correa Urgency Clause",33,0,0,0,33
71747,4742,2010-04-13,Senate,"Do pass, but re-refer to the Committee on Appropriations",9,0,2,0,11
71747,4743,2010-05-03,Senate,"Special Consent #22 SB1372 Dutton",34,0,4,0,38
71749,1657,2010-05-05,Senate,"Do pass and be placed on the Consent Calendar",5,0,0,0,5
71749,1658,2010-05-13,Senate,"Consent Calendar 2nd SB1374 Kehoe",31,0,7,0,38
71749,10158,2010-06-30,Assembly,"Do pass, to Consent Calendar",8,0,1,0,9
71749,19544,2010-08-05,Assembly,"SB 1374 Kehoe  Consent Calendar Second Day  Regular Session",71,0,0,0,71
71750,1161,2010-04-20,Senate,"Do pass, but re-refer to the Committee on Appropriations.",10,0,1,0,11
71750,1162,2010-06-01,Senate,"Senate 3rd Reading SB1375 Price",35,0,3,0,38
71750,9704,2010-06-28,Assembly,"Do pass as amended and be re-referred to the Committee on Appropriations",14,0,1,0,15
71750,19349,2010-08-04,Assembly,"Do pass",16,0,0,0,16
71750,20324,2010-08-16,Assembly,"SB 1375 Price  Senate Third Reading  By FUENTES",62,7,0,0,69
71750,20558,2010-08-19,Senate,"W/O REF. TO FILE SB1375 Price",28,7,0,0,35
71751,3655,2010-04-21,Senate,"Do pass, but re-refer to the Committee on Appropriations Recommend Consent",8,0,1,0,9
71751,3656,2010-05-10,Senate,"Placed on Appropriations Suspense file",9,0,2,0,11
71753,2995,2010-04-21,Senate,"Do pass, but re-refer to the Committee on Appropriations",0,5,4,0,9
71753,2996,2010-04-21,Senate,"Set, first hearing.  Failed passage in Committee.  Reconsideration granted",5,0,4,0,9
71755,142,2010-04-21,Senate,"Do pass as amended, and re-refer to the Committee on Appropriations.",7,0,2,0,9
71755,143,2010-05-17,Senate,"Do pass.",10,0,1,0,11
71755,144,2010-06-01,Senate,"Special Consent #25 SB1380 Hancock",35,0,3,0,38
71755,10136,2010-06-30,Assembly,"Do pass as amended and be re-referred to the Committee on Appropriations",8,0,1,0,9
71755,20071,2010-08-12,Assembly,"Do pass as amended",17,0,0,0,17
71755,20611,2010-08-19,Assembly,"SB 1380 Hancock  Senate Third Reading  By FULLER",76,0,0,0,76
71755,21419,2010-08-26,Senate,"Special Consent #32 SB1380 Hancock",34,0,0,0,34
71756,1368,2010-04-14,Senate,"Do pass as amended, and re-refer to the Committee on Appropriations",8,0,1,0,9
71756,1369,2010-05-03,Senate,"Placed on Appropriations Suspense file",10,0,1,0,11
71756,1370,2010-05-27,Senate,"Do pass as amended",8,2,1,0,11
71756,1371,2010-06-02,Senate,"Senate 3rd Reading SB1381 Simitian",28,4,6,0,38
71756,9957,2010-06-30,Assembly,"Do pass as amended and be re-referred to the Committee on Appropriations",8,0,1,0,9
71756,19934,2010-08-12,Assembly,"Do pass",12,5,0,0,17
71756,21536,2010-08-27,Assembly,"Do pass as amended",8,0,0,0,8
71756,21847,2010-08-31,Senate,"From committee:  That the Assembly Amendments be concurred in",6,5,0,0,11
71756,21848,2010-08-31,Assembly,"SB 1381 Simitian  Senate Third Reading  By BROWNLEY",51,18,0,0,69
71756,21849,2010-08-31,Senate,"W/O REF. TO FILE SB1381 Simitian Concurrence",21,15,0,0,36
71757,3782,2010-04-21,Senate,"Do pass and be placed on the Consent Calendar",8,0,1,0,9
71757,3783,2010-04-29,Senate,"Consent Calendar 2nd SB1382 Committee on V.A. (Denham)",33,0,5,0,38
71757,9567,2010-06-22,Assembly,"Do pass",9,0,0,0,9
71757,9651,2010-06-28,Assembly,"SB 1382 V. A.  Senate Third Reading  By COOK",78,0,1,0,79
71761,3683,2010-04-13,Senate,"Do pass as amended, and re-refer to the Committee on Appropriations",4,0,1,0,5
71761,3684,2010-05-03,Senate,"Placed on Appropriations Suspense file",10,0,1,0,11
71762,1213,2010-04-13,Senate,"Do pass as amended, and re-refer to the Committee on Appropriations.",4,0,1,0,5
71762,1214,2010-05-10,Senate,"Special Consent #23 SB1387 Committee on V.A. (Denham)",30,0,8,0,38
71762,8811,2010-06-15,Assembly,"Do pass and be re-referred to the Committee on Appropriations",9,0,0,0,9
71762,9864,2010-06-30,Assembly,"Do pass, to Consent Calendar",17,0,0,0,17
71762,19417,2010-08-05,Assembly,"SB 1387 V. A.  Consent Calendar Second Day  Regular Session",71,0,0,0,71
71765,192,2010-04-14,Senate,"Do pass, but re-refer to the Committee on Business, Professions and Economic Development.",9,0,0,0,9
71765,193,2010-04-19,Senate,"Do pass as amended, and re-refer to the Committee on Appropriations.",7,0,2,0,9
71765,194,2010-05-24,Senate,"Senate 3rd Reading SB1390 Corbett",32,0,6,0,38
71765,9407,2010-06-22,Assembly,"Do pass and be re-referred to the Committee on Business, Professions and Consumer Protection",10,6,3,0,19
71765,9730,2010-06-29,Assembly,"Do pass and be re-referred to the Committee on Appropriations",2,7,2,0,11
71766,974,2010-05-12,Senate,"Do pass as amended, and re-refer to the Committee on Appropriations.",3,1,1,0,5
71766,975,2010-05-24,Senate,"Do pass.",6,3,2,0,11
71766,976,2010-06-03,Senate,"Senate 3rd Reading SB1391 Yee",22,11,5,0,38
71766,9723,2010-06-28,Assembly,"Do pass as amended and be re-referred to the Committee on Appropriations",6,3,0,0,9
71766,20256,2010-08-12,Assembly,"Do pass as amended",12,5,0,0,17
71766,21122,2010-08-25,Assembly,"SB 1391 Yee  Senate Third Reading  By SWANSON",46,28,0,0,74
71766,21981,2010-08-31,Senate,"W/O REF. TO FILE SB1391 Yee Concurrence",20,17,0,0,37
71767,1661,2010-04-20,Senate,"Do pass as amended, but re-refer to the Committee on Appropriations Recommend Consent",8,0,1,0,9
71767,1662,2010-05-17,Senate,"Consent Calendar 2nd SB1392 Steinberg",33,0,5,0,38
71767,9098,2010-06-21,Assembly,"Be referred to Committee on Health",11,0,0,0,11
71767,9951,2010-06-29,Assembly,"Do pass as amended and be re-referred to the Committee on Appropriations",18,0,1,0,19
71767,20085,2010-08-12,Assembly,"Do pass as amended",12,5,0,0,17
71767,20923,2010-08-23,Assembly,"SB 1392 Steinberg  Senate Third Reading  By MONNING",66,10,0,0,76
71767,21602,2010-08-27,Senate,"Unfinished Business SB1392 Steinberg",32,0,0,0,32
71769,2877,2010-04-06,Senate,"Do pass as amended, and re-refer to the Committee on Appropriations",7,0,2,0,9
71769,2878,2010-05-03,Senate,"Special Consent #22 SB1394 Kehoe",34,0,4,0,38
71769,8964,2010-06-14,Assembly,"Do pass and re-refer to Committee on Appropriations with recommendation:  To Consent Calendar",12,0,2,0,14
71769,9862,2010-06-30,Assembly,"Do pass, to Consent Calendar",17,0,0,0,17
71769,20888,2010-08-23,Assembly,"Do pass as amended",14,0,0,0,14
71769,21672,2010-08-30,Assembly,"SB 1394 Kehoe  Senate Third Reading  By LOWENTHAL",78,0,0,0,78
71769,21891,2010-08-31,Senate,"From committee:  That the Assembly Amendments be concurred in",8,0,0,0,8
71770,574,2010-04-13,Senate,"Do pass, but re-refer to the Committee on Rules.",8,0,1,0,9
71770,575,2010-04-21,Senate,"Do pass as amended, and re-refer to the Committee on Appropriations.",5,0,4,0,9
71770,576,2010-06-01,Senate,"Senate 3rd Reading SB1395 Alquist",35,0,3,0,38
71770,9273,2010-06-22,Assembly,"Do pass and be re-referred to the Committee on Transportation to Consent Calendar",19,0,0,0,19
71770,9687,2010-06-28,Assembly,"Do pass as amended and re-refer to Committee on Appropriations with recommendation:  To Consent Calendar",14,0,0,0,14
71770,19346,2010-08-04,Assembly,"Do pass",17,0,0,0,17
71770,20319,2010-08-16,Assembly,"SB 1395 Alquist  Senate Third Reading  By BERRYHILL, T",74,0,0,0,74
71770,21322,2010-08-26,Senate,"Special Consent #32 SB1395 Alquist",34,0,0,0,34
71771,1168,2010-04-21,Senate,"Do pass as amended, and re-refer to the Committee on Appropriations.",7,0,2,0,9
71771,1169,2010-05-17,Senate,"Placed on Appropriations Suspense file.",10,0,1,0,11
71771,1170,2010-05-27,Senate,"Do pass as amended.",8,0,3,0,11
71771,1171,2010-06-02,Senate,"Senate 3rd Reading SB1396 Lowenthal",35,0,3,0,38
71771,10157,2010-06-30,Assembly,"Do pass as amended and be re-referred to the Committee on Appropriations",7,0,2,0,9
71772,850,2010-04-19,Senate,"Do pass, but re-refer to the Committee on Appropriations.",4,2,0,0,6
71772,851,2010-05-28,Senate,"Senate 3rd Reading SB1397 Corbett",21,5,12,0,38
71772,9406,2010-06-23,Assembly,"Do pass and be re-referred to the Committee on Appropriations",4,1,1,0,6
71772,19385,2010-08-04,Assembly,"Do pass",12,5,0,0,17
71772,20753,2010-08-19,Assembly,"SB 1397 Corbett  Senate Third Reading  By FURUTANI",51,27,0,0,78
71773,2162,2010-04-19,Senate,"Do pass, but re-refer to the Committee on Appropriations",3,2,0,0,5
71773,2163,2010-05-03,Senate,"Placed on Appropriations Suspense file",10,0,1,0,11
71773,2164,2010-05-27,Senate,"Do pass as amended",7,3,1,0,11
71773,2165,2010-06-03,Senate,"Senate 3rd Reading SB1398 DeSaulnier",30,3,5,0,38
71773,10186,2010-06-30,Assembly,"Do pass and be re-referred to the Committee on Appropriations",5,0,4,0,9
71773,20206,2010-08-12,Assembly,"Do pass as amended",12,4,0,0,16
71773,20673,2010-08-20,Assembly,"SB 1398 DeSaulnier  Senate Third Reading  By BUCHANAN  Amend By 	BUCHANAN  Set #1",48,26,0,0,74
71773,21233,2010-08-25,Assembly,"Do pass",6,0,0,0,6
71773,21826,2010-08-31,Assembly,"Do pass as amended",12,3,0,0,15
71773,21827,2010-08-31,Assembly,"SB 1398 DeSaulnier  Senate Third Reading  By BUCHANAN",63,10,0,0,73
71774,68,2010-04-20,Senate,"Do pass, but re-refer to the Committee on Appropriations.",5,2,0,0,7
71774,69,2010-05-17,Senate,"Do pass as amended.",7,1,3,0,11
71774,70,2010-06-02,Senate,"Senate 3rd Reading SB1399 Leno",21,13,4,0,38
71774,9732,2010-06-29,Assembly,"Do pass and be re-referred to the Committee on Appropriations",4,2,1,0,7
71774,19383,2010-08-04,Assembly,"Do pass",10,4,0,0,14
71774,21941,2010-08-30,Assembly,"SB 1399 Leno  Senate Third Reading  By CALDERON",44,32,0,0,76
71774,21942,2010-08-31,Senate,"Unfinished Business SB1399 Leno",22,15,0,0,37
71776,1565,2010-04-05,Senate,"Do pass, but re-refer to the Committee on Appropriations",6,0,1,0,7
71776,1566,2010-05-03,Senate,"Special Consent #22 SB1401 Simitian",34,0,4,0,38
71776,9297,2010-06-21,Assembly,"Do pass and re-refer to Committee on Appropriations with recommendation:  To Consent Calendar",7,0,2,0,9
71776,10117,2010-06-30,Assembly,"Do pass, to Consent Calendar",17,0,0,0,17
71777,2330,2010-04-19,Senate,"Do pass as amended, and re-refer to the Committee on Appropriations",7,0,0,0,7
71777,2331,2010-05-17,Senate,"Do pass as amended",10,0,1,0,11
71777,2332,2010-05-24,Senate,"Senate 3rd Reading SB1402 Dutton",33,0,5,0,38
71777,9194,2010-06-21,Assembly,"Do pass as amended and be re-referred to the Committee on Judiciary",7,0,2,0,9
71777,9721,2010-06-29,Assembly,"Do pass and re-refer to Committee on Appropriations with recommendation:  To Consent Calendar",10,0,0,0,10
71777,20082,2010-08-12,Assembly,"Do pass as amended",17,0,0,0,17
71777,20430,2010-08-18,Assembly,"SB 1402 Dutton  Third Reading Urgency  By FUENTES",75,0,0,0,75
71777,21450,2010-08-26,Senate,"Special Consent #32 SB1402 Dutton",34,0,0,0,34
71779,149,2010-04-06,Senate,"Do pass, but re-refer to the Committee on Appropriations.",3,2,0,0,5
71779,150,2010-05-17,Senate,"Senate 3rd Reading SB1404 Pavley",21,12,5,0,38
71779,9195,2010-06-22,Assembly,"Do pass and be re-referred to the Committee on Appropriations",5,2,0,0,7
71779,19745,2010-08-04,Assembly,"Do pass",12,5,0,0,17
71779,20432,2010-08-18,Assembly,"SB 1404 Pavley  Senate Third Reading  By COTO",49,25,0,0,74
71780,392,2010-04-21,Senate,"Do pass and be placed on the Consent Calendar.",9,0,2,0,11
71780,393,2010-04-29,Senate,"Consent Calendar 2nd SB1405 Committee on B.,F.& I. (Calderon)",33,0,5,0,38
71780,9320,2010-06-23,Assembly,"Do pass as amended, to Consent Calendar",12,0,0,0,12
71780,19236,2010-08-02,Assembly,"SB 1405 B.,F.& I.  Consent Calendar Second Day  Regular Session",76,0,0,0,76
71780,19634,2010-08-09,Senate,"Special Consent #30 SB1405 Committee on B.,F.& I. (Calderon)",34,0,0,0,34
71781,5508,2010-04-21,Senate,"Do pass and be placed on the Consent Calendar",9,0,2,0,11
71781,5509,2010-04-29,Senate,"Consent Calendar 2nd SB1406 Committee on B.,F.& I. (Calderon)",33,0,5,0,38
71781,9557,2010-06-23,Assembly,"Do pass as amended",12,0,0,0,12
71781,21752,2010-08-30,Assembly,"SB 1406 B.,F.& I.  Senate Third Reading  By SOLORIO",78,0,0,0,78
71781,21753,2010-08-30,Senate,"W/O REF. TO FILE SB1406 Committee on B.,F.& I. (Calderon) 	Concurrence",37,0,0,0,37
71782,5491,2010-04-21,Senate,"Do pass, but re-refer to the Committee on Appropriations Recommend Consent",9,0,2,0,11
71782,5492,2010-05-10,Senate,"Consent Calendar 2nd SB1407 Committee on B.,F.& I. (Calderon)",30,0,8,0,38
71782,9224,2010-06-23,Assembly,"Do pass and re-refer to Committee on Appropriations with recommendation:  To Consent Calendar",12,0,0,0,12
71782,20397,2010-08-04,Assembly,"Do pass, to Consent Calendar",17,0,0,0,17
71782,20398,2010-08-12,Assembly,"SB 1407 B.,F.& I.  Consent Calendar Second Day  Regular Session",78,0,0,0,78
71782,21924,2010-08-30,Assembly,"SB 1407 B.,F.& I.  Senate Third Reading  By FUENTES",78,0,0,0,78
71782,21925,2010-08-30,Senate,"W/O REF. TO FILE SB1407 Committee on B.,F.& I. (Calderon)",37,0,0,0,37
71783,1492,2010-04-21,Senate,"Do pass and be placed on the Consent Calendar",9,0,2,0,11
71783,1493,2010-04-29,Senate,"Consent Calendar 2nd SB1408 Committee on B.,F.& I. (Calderon)",33,0,5,0,38
71783,9298,2010-06-23,Assembly,"Do pass as amended and be re-referred to the Committee on Appropriations",12,0,0,0,12
71783,19602,2010-08-04,Assembly,"Do pass",17,0,0,0,17
71783,20486,2010-08-18,Assembly,"SB 1408 B.,F.& I.  Third Reading Urgency  By SOLORIO",75,0,0,0,75
71783,21368,2010-08-26,Senate,"Special Consent #32 SB1408 Committee on B.,F.& I. (Calderon)",34,0,0,0,34
71784,3637,2010-04-21,Senate,"Do pass, but re-refer to the Committee on Appropriations",5,0,4,0,9
71784,3638,2010-05-10,Senate,"Placed on Appropriations Suspense file",9,0,2,0,11
71785,5302,2010-04-05,Senate,"Do pass, but re-refer to the Committee on Appropriations",7,0,2,0,9
71785,5303,2010-05-28,Senate,"Senate 3rd Reading SB1410 Cedillo Urgency Clause",28,0,10,0,38
71785,9708,2010-06-29,Assembly,"Do pass and be re-referred to the Committee on Appropriations",11,0,0,0,11
71785,19656,2010-08-04,Assembly,"Do pass",17,0,0,0,17
71785,20726,2010-08-19,Assembly,"SB 1410 Cedillo  Senate Third Reading  By HAYASHI",78,0,0,0,78
71785,21252,2010-08-25,Senate,"Unfinished Business SB1410 Cedillo",35,0,0,0,35
71786,3011,2010-04-13,Senate,"Do pass, but re-refer to the Committee on Judiciary",7,0,0,0,7
71786,3012,2010-04-20,Senate,"Do pass as amended, and re-refer to the Committee on Appropriations",4,0,1,0,5
71786,3013,2010-06-01,Senate,"Special Consent #25 SB1411 Simitian",35,0,3,0,38
71786,9287,2010-06-22,Assembly,"Do pass and be re-referred to the Committee on Judiciary to Consent Calendar",6,0,1,0,7
71786,9698,2010-06-29,Assembly,"Do pass and re-refer to Committee on Appropriations with recommendation:  To Consent Calendar",10,0,0,0,10
71786,19563,2010-08-04,Assembly,"Do pass, to Consent Calendar",17,0,0,0,17
71786,19974,2010-08-12,Assembly,"SB 1411 Simitian  Consent Calendar Second Day  Regular Session",78,0,0,0,78
71788,2525,2010-04-14,Senate,"Do pass, but re-refer to the Committee on Appropriations",6,2,1,0,9
71788,2526,2010-05-10,Senate,"Placed on Appropriations Suspense file",9,0,2,0,11
71788,2527,2010-05-27,Senate,"Do pass as amended",7,3,1,0,11
71788,2528,2010-06-02,Senate,"Senate 3rd Reading SB1413 Leno",21,13,4,0,38
71788,10017,2010-06-30,Assembly,"Do pass as amended",6,2,1,0,9
71788,21619,2010-08-26,Assembly,"SB 1413 Leno  Senate Third Reading  By TORLAKSON",52,22,0,0,74
71788,21620,2010-08-27,Senate,"Unfinished Business SB1413 Leno",22,9,0,0,31
71789,35,2010-04-20,Senate,"Do pass as amended, and re-refer to the Committee on Appropriations.",10,0,1,0,11
71789,36,2010-05-10,Senate,"Placed on Appropriations Suspense file.",9,0,2,0,11
71789,37,2010-05-27,Senate,"Do pass as amended.",10,0,1,0,11
71789,38,2010-06-02,Senate,"Senate 3rd Reading SB1414 Kehoe",31,0,7,0,38
71789,10173,2010-06-28,Assembly,"Do pass and be re-referred to the Committee on Appropriations",14,0,1,0,15
71789,20102,2010-08-12,Assembly,"Do pass as amended",12,0,0,0,12
71789,21245,2010-08-25,Assembly,"SB 1414 Kehoe  Senate Third Reading  By SKINNER",60,16,0,0,76
71789,21433,2010-08-26,Senate,"Unfinished Business SB1414 Kehoe",21,14,0,0,35
71792,703,2010-04-20,Senate,"Do pass as amended, and re-refer to the Committee on Appropriations.",4,0,1,0,5
71792,704,2010-05-24,Senate,"Senate 3rd Reading SB1417 Cox",29,0,9,0,38
71792,9352,2010-06-22,Assembly,"Do pass as amended and be re-referred to the Committee on Appropriations",9,0,1,0,10
71792,19333,2010-08-04,Assembly,"Do pass",16,0,0,0,16
71792,20473,2010-08-17,Assembly,"SB 1417  Senate Third Reading  By NIELLO",75,0,0,0,75
71792,21474,2010-08-26,Senate,"Special Consent #32 SB1417 Cox",34,0,0,0,34
71793,2111,2010-04-20,Senate,"Do pass as amended, and re-refer to the Committee on Appropriations",6,2,1,0,9
71793,2112,2010-05-10,Senate,"Do pass",6,3,2,0,11
71793,2113,2010-06-03,Senate,"Senate 3rd Reading SB1418 Wiggins",22,14,2,0,38
71793,9881,2010-06-28,Assembly,"Do pass and be re-referred to the Committee on Appropriations",5,6,3,0,14
71797,1057,2010-05-05,Senate,"Do pass.",6,0,2,0,8
71797,1058,2010-05-10,Senate,"Senate 3rd Reading SB1422 Romero",22,4,12,0,38
71797,10055,2010-06-30,Assembly,"Do pass",9,0,0,0,9
71797,19633,2010-08-09,Assembly,"SB 1422 Romero  Senate Third Reading  By COTO",54,12,0,0,66
71800,430,2010-04-12,Senate,"Do pass, but re-refer to the Committee on Appropriations.",6,0,0,0,6
71800,431,2010-05-10,Senate,"Placed on Appropriations Suspense file.",9,0,2,0,11
71800,432,2010-05-27,Senate,"Do pass.",10,0,1,0,11
71800,433,2010-06-01,Senate,"Senate 3rd Reading SB1425 Simitian",35,0,3,0,38
71800,9376,2010-06-23,Assembly,"Do pass and be re-referred to the Committee on Appropriations",6,0,0,0,6
71800,20188,2010-08-12,Assembly,"Do pass as amended",12,0,0,0,12
71800,21912,2010-08-30,Assembly,"SB 1425 Simitian  Senate Third Reading  By TORRICO",78,0,0,0,78
71800,21913,2010-08-31,Senate,"W/O REF. TO FILE SB1425 Simitian",37,0,0,0,37
71801,1856,2010-05-27,Senate,"Do pass",10,0,5,0,15
71801,1857,2010-06-02,Senate,"Senate 3rd Reading SB1426 DeSaulnier",35,1,2,0,38
71802,4781,2010-05-04,Senate,"Do pass as amended",4,0,1,0,5
71802,4782,2010-05-28,Senate,"Senate 3rd Reading SB1427 Price",29,0,9,0,38
71802,9952,2010-06-29,Assembly,"Do pass as amended, to Consent Calendar",10,0,0,0,10
71802,19437,2010-08-05,Assembly,"SB 1427 Price  Consent Calendar Second Day  Regular Session",71,0,0,0,71
71802,20653,2010-08-19,Senate,"Unfinished Business SB1427 Price",34,0,0,0,34
71803,1895,2010-04-13,Senate,"Do pass as amended",5,0,2,0,7
71803,1896,2010-05-03,Senate,"Placed on Appropriations Suspense file",10,0,1,0,11
71803,1897,2010-05-27,Senate,"Do pass",10,0,1,0,11
71803,1898,2010-06-01,Senate,"Senate 3rd Reading SB1428 Pavley",35,0,3,0,38
71803,9447,2010-06-22,Assembly,"Do pass as amended and be re-referred to the Committee on Appropriations",7,0,0,0,7
71803,20218,2010-08-12,Assembly,"Do pass",17,0,0,0,17
71803,20388,2010-08-17,Assembly,"SB 1428 Pavley  Senate Third Reading  By LIEU",76,0,0,0,76
71803,21456,2010-08-25,Senate,"Unfinished Business SB1428 Pavley",35,0,0,0,35
71806,1459,2010-04-14,Senate,"Do pass, but re-refer to the Committee on Appropriations",7,2,0,0,9
71806,1460,2010-05-03,Senate,"Placed on Appropriations Suspense file",10,0,1,0,11
71806,1461,2010-05-27,Senate,"Do pass",7,3,1,0,11
71806,1462,2010-06-01,Senate,"Senate 3rd Reading SB1431 Simitian",25,10,3,0,38
71806,9486,2010-06-22,Assembly,"Do pass and be re-referred to the Committee on Appropriations",18,1,0,0,19
71806,20086,2010-08-12,Assembly,"Do pass",17,0,0,0,17
71806,20435,2010-08-18,Assembly,"SB 1431 Simitian  Senate Third Reading  By MONNING",75,0,0,0,75
71807,4633,2010-04-14,Senate,"Do pass as amended, and re-refer to the Committee on Appropriations",8,0,1,0,9
71807,4634,2010-05-10,Senate,"Special Consent #23 SB1432 Hancock",30,0,8,0,38
71807,9954,2010-06-30,Assembly,"Do pass as amended and re-refer to Committee on Appropriations with recommendation:  To Consent Calendar",9,0,0,0,9
71807,19364,2010-08-04,Assembly,"Do pass, to Consent Calendar",17,0,0,0,17
71807,19964,2010-08-12,Assembly,"SB 1432 Hancock  Consent Calendar Second Day  Regular Session",78,0,0,0,78
71807,20731,2010-08-19,Senate,"Unfinished Business SB1432 Hancock",35,0,0,0,35
71808,691,2010-04-19,Senate,"Do pass, but re-refer to the Committee on Appropriations.",4,2,1,0,7
71808,692,2010-05-28,Senate,"Senate 3rd Reading SB1433 Leno",21,7,10,0,38
71808,9733,2010-06-28,Assembly,"Do pass and be re-referred to the Committee on Appropriations",5,3,1,0,9
71808,19576,2010-08-04,Assembly,"Do pass",12,5,0,0,17
71808,21974,2010-08-31,Assembly,"SB 1433 Leno  Senate Third Reading  By HUFFMAN",45,31,0,0,76
71809,4475,2010-04-20,Senate,"Do pass",3,2,0,0,5
71809,4476,2010-05-27,Senate,"Senate 3rd Reading SB1434 Price",21,11,6,0,38
71809,9239,2010-06-22,Assembly,"Do pass as amended",5,2,0,0,7
71809,10050,2010-07-01,Assembly,"SB 1434 Price  Senate Third Reading  By ADAMS",47,27,5,0,79
71809,19841,2010-08-09,Senate,"Unfinished Business SB1434 Price",21,13,0,0,34
71810,1655,2010-04-20,Senate,"Do pass, but re-refer to the Committee on Appropriations",10,0,1,0,11
71810,1656,2010-05-10,Senate,"Special Consent #23 SB1435 Padilla",30,0,8,0,38
71810,9759,2010-06-28,Assembly,"Do pass as amended and be re-referred to the Committee on Appropriations",9,4,2,0,15
71810,20091,2010-08-12,Assembly,"Do pass as amended",12,4,0,0,16
71812,3135,2010-04-06,Senate,"Do pass as amended, and re-refer to the Committee on Appropriations",10,0,1,0,11
71812,3136,2010-05-03,Senate,"Special Consent #22 SB1437 Kehoe",34,0,4,0,38
71812,8900,2010-06-14,Assembly,"Do pass",13,0,2,0,15
71812,21041,2010-08-18,Assembly,"SB 1437 Kehoe  Senate Third Reading  By BRADFORD",74,0,0,0,74
71812,21042,2010-08-20,Senate,"From committee:  That the Assembly Amendments be concurred in",9,0,0,0,9
71812,21393,2010-08-26,Senate,"Special Consent #32 SB1437 Kehoe",34,0,0,0,34
71814,577,2010-04-13,Senate,"Do pass as amended, and re-refer to the Committee on Appropriations.",8,0,3,0,11
71814,578,2010-05-24,Senate,"Do pass as amended.",6,3,2,0,11
71814,579,2010-06-03,Senate,"Senate 3rd Reading SB1439 Price",18,18,2,0,38
71814,580,2010-06-03,Senate,"Senate 3rd Reading SB1439 Price Reconsider",36,0,2,0,38
71815,564,2010-04-21,Senate,"Do pass as amended, and re-refer to the Committee on Appropriations.",8,0,1,0,9
71815,565,2010-05-24,Senate,"Placed on Appropriations Suspense file.",10,0,1,0,11
71815,566,2010-05-27,Senate,"Do pass.",10,0,1,0,11
71815,567,2010-06-01,Senate,"Senate 3rd Reading SB1440 Padilla",35,0,3,0,38
71815,9225,2010-06-22,Assembly,"Do pass as amended and be re-referred to the Committee on Appropriations",9,0,0,0,9
71815,20002,2010-08-12,Assembly,"Do pass as amended",17,0,0,0,17
71815,20933,2010-08-23,Assembly,"SB 1440 Padilla  Senate Third Reading  By BEALL",73,0,0,0,73
71815,21196,2010-08-25,Senate,"Unfinished Business SB1440 Padilla",34,0,0,0,34
71818,5430,2010-04-13,Senate,"Do pass as amended, and re-refer to the Committee on Appropriations",9,0,0,0,9
71818,5431,2010-05-03,Senate,"Do pass",9,0,2,0,11
71818,5432,2010-05-10,Senate,"Special Consent #23 SB1443 Simitian",30,0,8,0,38
71818,10371,2010-06-29,Assembly,"Do pass and be re-referred to the Committee on Appropriations",13,0,0,0,13
71818,19700,2010-08-04,Assembly,"Do pass",17,0,0,0,17
71818,20465,2010-08-16,Assembly,"SB 1443 Simitian  Senate Third Reading  By HUFFMAN",75,0,0,0,75
71819,3241,2010-04-21,Senate,"Do pass",6,1,2,0,9
71819,3242,2010-05-03,Senate,"Senate 3rd Reading SB1444 Hancock",24,8,6,0,38
71819,10150,2010-06-30,Assembly,"Do pass",9,0,0,0,9
71819,20394,2010-08-16,Assembly,"SB 1444 Hancock  Senate Third Reading  By HUBER",75,0,0,0,75
71819,21466,2010-08-25,Senate,"Unfinished Business SB1444 Hancock",35,0,0,0,35
71820,2204,2010-04-07,Senate,"Do pass as amended, and re-refer to the Committee on Transportation and Housing",3,2,0,0,5
71820,2205,2010-04-20,Senate,"Do pass as amended, and re-refer to the Committee on Appropriations",6,2,1,0,9
71820,2206,2010-05-10,Senate,"Do pass as amended",6,2,3,0,11
71820,2207,2010-06-03,Senate,"Senate 3rd Reading SB1445 DeSaulnier",21,16,1,0,38
71820,9695,2010-06-28,Assembly,"Do pass and be re-referred to the Committee on Transportation",5,3,1,0,9
71820,10102,2010-07-01,Assembly,"Reconsideration granted",8,4,2,0,14
71820,10103,2010-07-01,Assembly,"Do pass and be re-referred to the Committee on Appropriations",8,3,3,0,14
71820,20081,2010-08-12,Assembly,"Do pass",12,5,0,0,17
71820,20689,2010-08-20,Assembly,"SB 1445 DeSaulnier  Senate Third Reading  By MA  Amend By MA  Set #1",48,27,0,0,75
71821,3675,2010-04-13,Senate,"Do pass as amended, and re-refer to the Committee on Appropriations",8,0,1,0,9
71822,4605,2010-03-23,Senate,"Do pass, but re-refer to the Committee on Appropriations",7,0,0,0,7
71822,4606,2010-04-22,Senate,"Senate 3rd Reading SB1447 Padilla",32,0,7,0,39
71822,8837,2010-06-15,Assembly,"Do pass and re-refer to Committee on Appropriations with recommendation:  To Consent Calendar",7,0,0,0,7
71822,9812,2010-06-30,Assembly,"Do pass, to Consent Calendar",17,0,0,0,17
71822,19528,2010-08-05,Assembly,"SB 1447 Padilla  Consent Calendar Second Day  Regular Session",71,0,0,0,71
71824,2487,2010-04-20,Senate,"Do pass",5,2,0,0,7
71824,2488,2010-04-20,Senate,"Do pass",5,2,0,0,7
71824,2489,2010-06-03,Senate,"Senate 3rd Reading SB1449 Leno",21,13,4,0,38
71824,9203,2010-06-22,Assembly,"Do pass",4,1,2,0,7
71824,21972,2010-08-30,Assembly,"SB 1449 Leno  Senate Third Reading  By FEUER",43,33,0,0,76
71825,17,2010-04-13,Senate,"Do pass.",7,2,0,0,9
71825,18,2010-04-22,Senate,"Senate 3rd Reading SB1450 Simitian",24,7,8,0,39
71825,9859,2010-06-29,Assembly,"Do pass and be re-referred to the Committee on Appropriations",12,1,0,0,13
71825,19359,2010-08-04,Assembly,"Do pass",17,0,0,0,17
71825,20498,2010-08-17,Assembly,"SB 1450 Simitian  Third Reading Urgency  By HUFFMAN",73,1,0,0,74
71825,20597,2010-08-19,Senate,"Unfinished Business SB1450 Simitian Urgency Clause",32,3,0,0,35
71826,475,2010-04-21,Senate,"Do pass as amended, and re-refer to the Committee on Appropriations.",8,0,1,0,9
71826,476,2010-05-17,Senate,"Do pass.",6,3,2,0,11
71826,477,2010-05-28,Senate,"Senate 3rd Reading SB1451 Yee",25,5,8,0,38
71826,9026,2010-06-16,Assembly,"Do pass as amended and be re-referred to the Committee on Appropriations",6,2,1,0,9
71826,19721,2010-08-04,Assembly,"Do pass",12,5,0,0,17
71826,21854,2010-08-30,Assembly,"SB 1451 Yee  Senate Third Reading  By TORLAKSON",50,28,0,0,78
71826,21855,2010-08-31,Senate,"Unfinished Business SB1451 Yee",22,14,0,0,36
71827,1127,2010-04-13,Senate,"Do pass as amended.",7,0,0,0,7
71827,1128,2010-05-10,Senate,"Do pass.",9,0,2,0,11
71827,1129,2010-05-13,Senate,"Senate 3rd Reading SB1452 Runner",27,0,11,0,38
71827,9701,2010-06-29,Assembly,"Do pass and be re-referred to the Committee on Appropriations",3,4,0,0,7
71827,9702,2010-06-29,Assembly,"Set second hearing.  Failed passage.  Reconsideration granted",7,0,0,0,7
71828,734,2010-04-20,Senate,"Do pass, but re-refer to the Committee on Appropriations.",7,0,2,0,9
71828,735,2010-05-17,Senate,"Do pass as amended.",9,0,2,0,11
71828,736,2010-05-28,Senate,"Senate 3rd Reading SB1453 Price",25,0,13,0,38
71828,9817,2010-06-28,Assembly,"Do pass as amended and be re-referred to the Committee on Appropriations",8,0,6,0,14
71829,2092,2010-04-19,Senate,"Do pass as amended, and re-refer to the Committee on Appropriations",7,0,0,0,7
71829,2093,2010-05-10,Senate,"Do pass",7,1,3,0,11
71829,2094,2010-06-02,Senate,"Senate 3rd Reading SB1454 DeSaulnier",26,8,4,0,38
71829,9410,2010-06-21,Assembly,"Do pass and be re-referred to the Committee on Judiciary",6,0,3,0,9
71829,10148,2010-06-29,Assembly,"Do pass and be re-referred to the Committee on Appropriations",7,3,0,0,10
71829,19574,2010-08-04,Assembly,"Do pass",11,5,0,0,16
71829,20419,2010-08-16,Assembly,"SB 1454 DeSaulnier  Senate Third Reading  By CHESBRO  Amend By 	CHESBRO  Set #1",46,27,0,0,73
71829,20786,2010-08-23,Assembly,"SB 1454 DeSaulnier  Senate Third Reading  By CHESBRO",42,28,0,0,70
71829,21381,2010-08-25,Senate,"Unfinished Business SB1454 DeSaulnier",24,7,0,0,31
71830,2929,2010-04-06,Senate,"Do pass as amended, and re-refer to the Committee on Transportation and Housing",10,0,1,0,11
71830,2930,2010-04-20,Senate,"Do pass as amended, but re-refer to the Committee on Appropriations Recommend Consent",8,0,1,0,9
71830,2931,2010-05-10,Senate,"Placed on Appropriations Suspense file",9,0,2,0,11
71830,2932,2010-05-27,Senate,"Do pass as amended",10,0,1,0,11
71830,2933,2010-06-02,Senate,"Senate 3rd Reading SB1455 Kehoe",35,0,3,0,38
71830,9278,2010-06-21,Assembly,"Do pass and be re-referred to the Committee on Transportation",14,0,1,0,15
71830,10070,2010-06-28,Assembly,"Do pass as amended and re-refer to Committee on Appropriations with recommendation:  To Consent Calendar",14,0,0,0,14
71830,19775,2010-08-04,Assembly,"Do pass, to Consent Calendar",17,0,0,0,17
71830,19859,2010-08-12,Assembly,"SB 1455 Kehoe  Consent Calendar Second Day  Regular Session",78,0,0,0,78
71830,20747,2010-08-19,Senate,"Unfinished Business SB1455 Kehoe",34,0,0,0,34
71831,2056,2010-04-05,Senate,"Do pass and be placed on the Consent Calendar",6,0,1,0,7
71831,2057,2010-04-15,Senate,"Consent Calendar 2nd SB1456 Simitian",35,0,4,0,39
71831,9773,2010-06-28,Assembly,"Do pass as amended and be re-referred to the Committee on Appropriations",9,0,0,0,9
71831,19398,2010-08-04,Assembly,"Do pass, to Consent Calendar",17,0,0,0,17
71831,20789,2010-08-23,Assembly,"SB 1456 Simitian  Third Reading Urgency  By CHESBRO",75,1,0,0,76
71831,21444,2010-08-26,Assembly,"Do pass as amended",9,0,0,0,9
71831,21738,2010-08-30,Assembly,"SB 1456 Simitian  Third Reading Urgency  By CHESBRO",77,1,0,0,78
71831,21840,2010-08-31,Senate,"From committee:  That the Assembly Amendments be concurred in",6,0,0,0,6
71831,21841,2010-08-31,Senate,"W/O REF. TO FILE SB1456 Simitian Urgency Clause",37,0,0,0,37
71832,924,2010-04-13,Senate,"Do pass as amended, and re-refer to the Committee on Appropriations.",5,3,3,0,11
71832,925,2010-04-22,Senate,"Reconsideration granted.",6,0,5,0,11
71832,926,2010-04-22,Senate,"Do pass as amended, and re-refer to the Committee on Appropriations.",6,2,3,0,11
71832,927,2010-05-17,Senate,"Do pass as amended.",6,3,2,0,11
71832,928,2010-06-01,Senate,"Senate 3rd Reading SB1457 Cogdill Reconsider",35,0,3,0,38
71832,8925,2010-06-01,Senate,"Senate 3rd Reading SB1457 Cogdill",18,9,11,0,38
71833,4665,2010-04-07,Senate,"Do pass and be placed on the Consent Calendar",5,0,0,0,5
71833,4666,2010-04-15,Senate,"Consent Calendar 2nd SB1458 Cogdill",35,0,4,0,39
71833,9260,2010-06-16,Assembly,"Do pass, to Consent Calendar",9,0,0,0,9
71833,9351,2010-06-24,Assembly,"SB 1458 Cogdill  Consent Calendar Second Day  Regular Session",73,0,6,0,79
71835,523,2010-04-14,Senate,"Do pass as amended, and re-refer to the Committee on Appropriations.",6,2,1,0,9
71835,524,2010-05-03,Senate,"Placed on Appropriations Suspense file.",10,0,1,0,11
71835,525,2010-05-27,Senate,"Do pass as amended.",7,3,1,0,11
71835,526,2010-06-03,Senate,"Senate 3rd Reading SB1460 Cedillo",24,9,5,0,38
71835,9512,2010-06-22,Assembly,"Do pass and be re-referred to the Committee on Appropriations",6,2,1,0,9
71835,20213,2010-08-12,Assembly,"Do pass as amended",12,5,0,0,17
71835,20709,2010-08-20,Assembly,"SB 1460 Cedillo  Senate Third Reading  Amend By FURUTANI  Set #1",48,27,0,0,75
71835,21914,2010-08-31,Assembly,"SB 1460 Cedillo  Senate Third Reading  By TORRICO",48,27,0,0,75
71835,21915,2010-08-31,Senate,"W/O REF. TO FILE SB1460 Cedillo Concurrence",21,12,0,0,33
71836,4083,2010-05-05,Senate,"Do pass as amended",2,3,0,0,5
71836,4084,2010-05-05,Senate,"Set, first hearing.  Failed passage in Committee.  Reconsideration granted",5,0,0,0,5
71837,2423,2010-04-20,Senate,"Do pass",10,0,1,0,11
71837,2424,2010-04-26,Senate,"Senate 3rd Reading SB1462 Padilla",36,0,3,0,39
71837,8871,2010-06-14,Assembly,"Do pass and be re-referred to the Committee on Appropriations",10,3,2,0,15
71837,20330,2010-08-12,Assembly,"Do pass as amended",12,5,0,0,17
71837,20706,2010-08-20,Assembly,"SB 1462 Padilla  Senate Third Reading  By FUENTES  Amend By FUENTES 	Set #1",49,26,0,0,75
71837,20832,2010-08-23,Assembly,"SB 1462 Padilla  Senate Third Reading  By FUENTES",50,24,0,0,74
71837,21478,2010-08-26,Senate,"From committee:  That the Assembly Amendments be concurred in",9,0,0,0,9
71837,21560,2010-08-27,Senate,"Unfinished Business SB1462 Padilla",31,3,0,0,34
71839,2144,2010-04-19,Senate,"Do pass and be placed on the Consent Calendar",7,0,0,0,7
71839,2145,2010-04-26,Senate,"Consent Calendar 2nd SB1464 Simitian",35,0,4,0,39
71839,9589,2010-06-21,Assembly,"Do pass and re-refer to Committee on Appropriations with recommendation:  To Consent Calendar",7,0,2,0,9
71839,10066,2010-07-01,Assembly,"SB 1464 Simitian  Consent Calendar Second Day  Regular Session",76,0,3,0,79
71842,1488,2010-04-20,Senate,"Do pass, but re-refer to the Committee on Appropriations",10,0,1,0,11
71842,1489,2010-05-10,Senate,"Special Consent #23 SB1467 Padilla",30,0,8,0,38
71842,9848,2010-06-28,Assembly,"Amend, and do pass as amended and be re-referred to the Committee on Appropriations with the recommendation:  To Consent Calendar",12,0,3,0,15
71842,19696,2010-08-04,Assembly,"Do pass, to Consent Calendar",17,0,0,0,17
71842,20781,2010-08-23,Assembly,"SB 1467 Padilla  Senate Third Reading  By BRADFORD",76,0,0,0,76
71842,21244,2010-08-25,Senate,"Unfinished Business SB1467 Padilla",34,0,0,0,34
71844,3784,2010-04-13,Senate,"Do pass as amended, and re-refer to the Committee on Appropriations",6,3,0,0,9
71844,3785,2010-05-03,Senate,"Placed on Appropriations Suspense file",10,0,1,0,11
71845,2022,2010-04-15,Senate,"Do pass, but re-refer to the Committee on Judiciary",5,3,1,0,9
71845,2023,2010-04-20,Senate,"Do pass as amended, and re-refer to the Committee on Appropriations",3,1,1,0,5
71845,2024,2010-06-03,Senate,"Senate 3rd Reading SB1470 Leno Reconsider",36,0,2,0,38
71845,8791,2010-06-03,Senate,"Senate 3rd Reading SB1470 Leno",14,20,4,0,38
71847,532,2010-03-24,Senate,"Do pass, but re-refer to the Committee on Appropriations.",5,1,0,0,6
71847,533,2010-04-26,Senate,"Do pass.",7,2,2,0,11
71847,534,2010-05-27,Senate,"Senate 3rd Reading SB1472 Leno",23,9,6,0,38
71847,9388,2010-06-23,Assembly,"Do pass and be re-referred to the Committee on Appropriations",12,0,0,0,12
71847,19731,2010-08-04,Assembly,"Do pass, to Consent Calendar",17,0,0,0,17
71847,19968,2010-08-12,Assembly,"SB 1472 Leno  Consent Calendar Second Day  Regular Session",78,0,0,0,78
71848,3076,2010-04-21,Senate,"Do pass as amended. To Consent Calendar",8,0,1,0,9
71848,3077,2010-05-03,Senate,"Consent Calendar 2nd SB1473 Wyland",34,0,4,0,38
71848,8965,2010-06-16,Assembly,"Do pass as amended, to Consent Calendar",8,0,1,0,9
71848,10346,2010-07-01,Assembly,"SB 1473 Wyland  Consent Calendar Second Day",76,0,3,0,79
71848,20431,2010-08-16,Assembly,"SB 1473 Wyland  Senate Third Reading  By NESTANDE",75,0,0,0,75
71848,21395,2010-08-26,Senate,"Special Consent #32 SB1473 Wyland",34,0,0,0,34
71849,983,2010-04-19,Senate,"Do pass, but re-refer to the Committee on Appropriations.",4,2,0,0,6
71849,984,2010-05-03,Senate,"Placed on Appropriations Suspense file.",10,0,1,0,11
71849,985,2010-05-27,Senate,"Do pass.",7,3,1,0,11
71849,986,2010-06-02,Senate,"Senate 3rd Reading SB1474 Steinberg",22,11,5,0,38
71849,9489,2010-06-23,Assembly,"Do pass and be re-referred to the Committee on Appropriations",4,1,1,0,6
71849,19395,2010-08-04,Assembly,"Do pass as amended",12,5,0,0,17
71849,20129,2010-08-12,Assembly,"SB 1474 Steinberg  Senate Third Reading  Amend By SOLORIO  Set #1",53,23,0,0,76
71849,20302,2010-08-16,Assembly,"SB 1474 Steinberg  Senate Third Reading",45,27,0,0,72
71849,20482,2010-08-18,Senate,"From committee:  That the Assembly Amendments be concurred in",4,2,0,0,6
71849,20573,2010-08-19,Senate,"Unfinished Business SB1474 Steinberg",23,11,0,0,34
71850,407,2010-04-06,Senate,"Do pass as amended, and re-refer to the Committee on Appropriations.",6,1,2,0,9
71850,408,2010-05-10,Senate,"Do pass as amended.",6,3,2,0,11
71850,409,2010-06-03,Senate,"Senate 3rd Reading SB1475 Simitian",21,16,1,0,38
71850,9173,2010-06-21,Assembly,"Do pass as amended and be re-referred to the Committee on Appropriations",8,3,3,0,14
71851,4802,2010-04-06,Senate,"Do pass, but re-refer to the Committee on Judiciary",10,0,1,0,11
71851,4803,2010-04-13,Senate,"Do pass as amended, and re-refer to the Committee on Appropriations",4,0,1,0,5
71851,4804,2010-05-03,Senate,"Do pass",10,0,1,0,11
71851,4805,2010-05-10,Senate,"Special Consent #23 SB1476 Padilla",30,0,8,0,38
71851,8733,2010-06-14,Assembly,"Do pass and be re-referred to the Committee on Judiciary",13,0,2,0,15
71851,9672,2010-06-29,Assembly,"Do pass as amended and re-refer to Committee on Appropriations with recommendation:  To Consent Calendar",10,0,0,0,10
71851,19339,2010-08-04,Assembly,"Do pass, to Consent Calendar",17,0,0,0,17
71851,21078,2010-08-25,Assembly,"SB 1476 Padilla  Senate Third Reading  By SKINNER",77,0,0,0,77
71851,21764,2010-08-30,Senate,"Unfinished Business SB1476 Padilla",37,0,0,0,37
71852,3348,2010-05-05,Senate,"Be adopted, but re-refer to the Committee on Elections, Reapportionmnt and Constitutional Amend",3,6,0,0,9
71853,10028,2010-07-01,Senate,"Senate 3rd Reading SCR76 Corbett",34,0,5,0,39
71853,19821,2010-08-10,Assembly,"Be adopted, to Consent Calendar",8,0,0,0,8
71853,19935,2010-08-12,Assembly,"SCR 76 Corbett  Consent Calendar Second Day  Regular Session",78,0,0,0,78
71854,1160,2010-05-28,Senate,"Senate 3rd Reading SCR77 Correa",23,5,10,0,38
71854,19836,2010-08-05,Assembly,"Be adopted, to Consent Calendar",9,0,0,0,9
71854,20221,2010-08-12,Assembly,"SCR 77 Correa  Consent Calendar Second Day  Regular Session",78,0,0,0,78
71855,27219,2010-04-08,Senate,"Senate 3rd Reading SCR78 Wolk",32,0,0,0,32
71855,27220,2010-04-29,Assembly,"Be adopted, to Consent Calendar",10,0,0,0,10
71855,27221,2010-05-06,Assembly,"SCR 78 Wolk  Consent Calendar Second Day  Regular Session",74,0,0,0,74
71856,3977,2010-05-05,Senate,"Be adopted",9,0,0,0,9
71856,3978,2010-05-10,Senate,"Senate 3rd Reading SJR23 Simitian",32,0,6,0,38
71856,9363,2010-06-22,Assembly,"From committee:  Be adopted.  To third reading",19,0,0,0,19
71856,19090,2010-08-02,Assembly,"SJR 23 Simitian  Senate Third Reading  By MONNING",71,3,0,0,74
71856,21644,2010-08-27,Senate,"Unfinished Business SJR23 Simitian",34,0,0,0,34
72070,27254,2010-04-08,Senate,"W/O REF. TO FILE SCR79 Denham",32,0,0,0,32
72070,27255,2010-04-29,Assembly,"Be adopted, to Consent Calendar",10,0,0,0,10
72070,27256,2010-05-27,Senate,"Unfinished Business SCR79 Denham",33,0,0,0,33
72071,2196,2010-05-27,Senate,"Senate 3rd Reading SJR24 Yee",24,0,14,0,38
72071,8794,2010-06-15,Assembly,"From committee:  Be adopted.  To third reading",7,0,3,0,10
72071,8997,2010-06-17,Assembly,"SJR 24 Yee  Senate Third Reading  By GILMORE",54,1,24,0,79
72071,9858,2010-06-28,Senate,"Unfinished Business SJR24 Yee",22,5,12,0,39
72223,2938,2010-04-19,Assembly,"Do pass and re-refer to Committee on Appropriations with recommendation:  To Consent Calendar",9,0,0,0,9
72223,2939,2010-05-05,Assembly,"Do pass, to Consent Calendar",17,0,0,0,17
72223,2940,2010-05-13,Assembly,"AB 2761 NAT. RES.  Consent Calendar Second Day  Regular Session",76,0,3,0,79
72223,5161,2010-06-09,Senate,"Do pass, but re-refer to the Committee on Appropriations Recommend Consent",7,0,2,0,9
72223,21534,2010-08-27,Senate,"Assembly 3rd Reading AB2761 Committee on NAT. RES. (Chesbro) By 	Pavley",34,0,0,0,34
72223,21739,2010-08-30,Assembly,"AB 2761 Natural Resources  Concurrence in Senate Amendments",78,0,0,0,78
72224,607,2010-04-14,Assembly,"Do pass and be re-referred to the Committee on Local Government to Consent Calendar.",8,0,1,0,9
72224,608,2010-04-21,Assembly,"Do pass and be re-referred to the Committee on Appropriations to Consent Calendar.",8,0,1,0,9
72224,609,2010-05-12,Assembly,"Do pass, to Consent Calendar.",16,0,1,0,17
72224,610,2010-05-20,Assembly,"AB 2762 H.& C.D.  Consent Calendar Second Day  Regular Session",72,0,7,0,79
72224,10110,2010-06-29,Senate,"Do pass, but re-refer to the Committee on Appropriations Recommend Consent",8,0,1,0,9
72224,21141,2010-08-25,Senate,"Assembly 3rd Reading AB2762 Committee on H. & C.D.(Torres) By 	Lowenthal",34,0,0,0,34
72224,21668,2010-08-30,Assembly,"AB 2762 Housing and Community De Concurrence in Senate Amendments 	By TORRES",77,0,0,0,77
72225,3226,2010-03-16,Assembly,"Be adopted and be re-referred to the Committee on Appropriations",6,0,2,0,8
72225,3227,2010-05-28,Assembly,"Be adopted as amended",12,5,0,0,17
72225,3228,2010-06-02,Assembly,"ACR 138 NAVA  Assembly Third Reading",52,23,4,0,79
72225,10308,2010-06-30,Senate,"Do pass as amended, and re-refer to the Committee on Appropriations",6,2,1,0,9
72225,19150,2010-08-02,Senate,"Placed on Appropriations Suspense file",10,0,0,0,10
72225,20174,2010-08-12,Senate,"Be adopted",7,4,0,0,11
72225,21292,2010-08-23,Senate,"Assembly 3rd Reading ACR138 Nava By Simitian",24,11,0,0,35
72225,21293,2010-08-24,Assembly,"ACR 138 NAVA  Concurrence in Senate Amendments",51,26,0,0,77
72365,4389,2010-05-12,Senate,"Do pass, but re-refer to the Committee on Appropriations",1,3,1,0,5
72365,4390,2010-05-12,Senate,"Set, first hearing.  Failed passage in Committee.  Reconsideration granted",4,0,1,0,5
72367,3538,2010-04-28,Senate,"Do pass, but re-refer to the Committee on Appropriations",2,2,1,0,5
72367,3539,2010-04-28,Senate,"Set, first hearing.  Failed passage in Committee.  Reconsideration granted",4,0,1,0,5
72371,27210,2010-04-15,Senate,"Senate 3rd Reading SCR80 Wolk",33,0,0,0,33
72371,27211,2010-05-13,Assembly,"Be adopted, to Consent Calendar",9,0,0,0,9
72371,27212,2010-05-20,Assembly,"SCR 80 Wolk  Consent Calendar Second Day  Regular Session",72,0,0,0,72
72372,1038,2010-05-10,Senate,"Senate 3rd Reading SCR81 Wolk",30,0,8,0,38
72372,1039,2010-05-28,Assembly,"Be adopted, to Consent Calendar.",9,0,2,0,11
72372,1040,2010-06-02,Assembly,"SCR 81 Wolk  Consent Calendar Second Day",73,0,6,0,79
72373,27213,2010-04-19,Senate,"Senate 3rd Reading SCR82 Wolk",34,0,0,0,34
72373,27214,2010-05-13,Assembly,"Be adopted, to Consent Calendar",9,0,0,0,9
72373,27215,2010-05-20,Assembly,"SCR 82 Wolk  Consent Calendar Second Day  Regular Session",72,0,0,0,72
72548,52,2010-04-13,Assembly,"Do pass and re-refer to Committee on Appropriations with recommendation:  To Consent Calendar.",10,0,0,0,10
72548,53,2010-05-28,Assembly,"Do pass.",17,0,0,0,17
72548,54,2010-06-01,Assembly,"AB 2763 JUD.  Assembly Third Reading  By FEUER",76,0,3,0,79
72548,9243,2010-06-22,Senate,"Do pass, but re-refer to the Committee on Appropriations",3,1,1,0,5
72548,10474,2010-07-15,Senate,"Placed on Appropriations Suspense file",8,0,2,0,10
72548,19994,2010-08-12,Senate,"Do pass as amended",7,4,0,0,11
72548,20654,2010-08-20,Senate,"Assembly 3rd Reading AB2763 Committee on JUD. (Feuer)",23,9,0,0,32
72548,20815,2010-08-23,Assembly,"AB 2763 JUD.  Concurrence in Senate Amendments By FEUER",75,0,0,0,75
72549,3804,2010-05-04,Assembly,"Do pass as amended",10,0,0,0,10
72549,3805,2010-05-13,Assembly,"AB 2764 JUD.  Assembly Third Reading  By FEUER",71,1,7,0,79
72549,9785,2010-06-29,Senate,"Do pass as amended",4,0,1,0,5
72549,21550,2010-08-27,Senate,"Assembly 3rd Reading AB2764 Committee on JUD. (Feuer)",27,8,0,0,35
72549,21758,2010-08-30,Assembly,"AB 2764 Judiciary  Concurrence in Senate Amendments By FEUER",75,2,0,0,77
72550,2149,2010-05-04,Assembly,"Do pass",10,0,0,0,10
72550,2150,2010-05-06,Assembly,"AB 2765 JUD.  Assembly Third Reading  By FEUER",74,0,5,0,79
72550,9304,2010-06-22,Senate,"Do pass as amended",4,0,1,0,5
72550,21197,2010-08-25,Senate,"Assembly 3rd Reading AB2765 Committee on JUD. (Feuer) By Leno",34,0,0,0,34
72550,21718,2010-08-30,Assembly,"AB 2765 Judiciary  Concurrence in Senate Amendments By FEUER",76,0,0,0,76
72551,2109,2010-04-27,Assembly,"Do pass",10,0,0,0,10
72551,2110,2010-04-29,Assembly,"AB 2766 JUD.  Assembly Third Reading  By FEUER",69,1,9,0,79
72551,10369,2010-06-29,Senate,"Do pass",4,0,1,0,5
72552,4175,2010-04-13,Assembly,"Do pass and re-refer to Committee on Appropriations with recommendation:  To Consent Calendar",10,0,0,0,10
72552,4176,2010-04-28,Assembly,"Do pass, to Consent Calendar",15,0,2,0,17
72552,4177,2010-05-17,Assembly,"AB 2767 JUD.  Assembly Third Reading  By FEUER",70,0,9,0,79
72552,7144,2010-06-10,Senate,"Do pass as amended, but re-refer to the Committee on Appropriations Recommend Consent",5,0,0,0,5
72552,19233,2010-08-02,Senate,"Consent Calendar 2nd AB2767 Committee on JUD. (Feuer)",33,0,0,0,33
72552,19793,2010-08-09,Assembly,"AB 2767 JUD.  Concurrence in Senate Amendments By FEUER",77,0,0,0,77
72553,677,2010-04-19,Assembly,"Do pass and be re-referred to the Committee on Appropriations to Consent Calendar.",14,0,1,0,15
72553,678,2010-05-05,Assembly,"Do pass, to Consent Calendar.",17,0,0,0,17
72553,679,2010-05-13,Assembly,"AB 2768 U.& C.  Consent Calendar Second Day  Regular Session",76,0,3,0,79
72553,8976,2010-06-15,Senate,"Do pass, but re-refer to the Committee on Appropriations Recommend Consent",8,0,1,0,9
72553,19234,2010-08-02,Senate,"Consent Calendar 2nd AB2768 Committee on U. & C. (Fuentes)",33,0,0,0,33
72553,19804,2010-08-09,Assembly,"AB 2768 U.& C.  Concurrence in Senate Amendments By BRADFORD",77,0,0,0,77
72554,3480,2010-05-03,Assembly,"Do pass, to Consent Calendar",10,0,5,0,15
72554,3481,2010-05-10,Assembly,"AB 2769 U.& C.  Consent Calendar Second Day  Regular Session",71,0,8,0,79
72554,9930,2010-06-29,Senate,"Do pass and be placed on the Consent Calendar",10,0,1,0,11
72554,19356,2010-08-02,Senate,"Consent Calendar 2nd AB2769 Committee on U. & C. (Fuentes)",33,0,0,0,33
72556,3557,2010-05-04,Assembly,"Be adopted, as amended, to Consent Calendar",7,0,0,0,7
72556,3558,2010-05-13,Assembly,"ACR 140 ADAMS  Consent Calendar Second Day  Regular Session",76,0,3,0,79
72556,9325,2010-06-22,Senate,"Be adopted",7,0,0,0,7
72556,9653,2010-06-28,Senate,"Assembly 3rd Reading ACR140 Adams",33,0,6,0,39
72557,5215,2010-05-11,Assembly,"Be adopted as amended",8,1,3,0,12
72557,5216,2010-05-24,Assembly,"AJR 38 CABALLERO  Assembly Third Reading",63,4,12,0,79
72557,19823,2010-08-10,Senate,"Be adopted as amended",9,0,0,0,9
72557,20441,2010-08-18,Senate,"Assembly 3rd Reading AJR38 Caballero By Cogdill",33,1,0,0,34
72557,20704,2010-08-20,Assembly,"AJR 38 CABALLERO  Concurrence in Senate Amendments",71,4,0,0,75
74861,520,2010-04-21,Assembly,"Do pass and be re-referred to the Committee on Appropriations.",6,0,1,0,7
74861,521,2010-05-28,Assembly,"Do pass.",12,5,0,0,17
74861,522,2010-06-01,Assembly,"AB 2770 MONNING  Assembly Third Reading",58,17,4,0,79
74861,9518,2010-06-23,Senate,"Do pass, but re-refer to the Committee on Appropriations",4,1,1,0,6
74861,19360,2010-08-02,Senate,"Placed on Appropriations Suspense file",10,0,0,0,10
74861,20170,2010-08-12,Senate,"Do pass as amended",7,4,0,0,11
74861,21571,2010-08-25,Senate,"Assembly 3rd Reading AB2770 Monning By DeSaulnier",24,3,0,0,27
74861,21654,2010-08-30,Assembly,"AB 2770 Monning  Concurrence in Senate Amendments",59,12,0,0,71
74862,4118,2010-05-05,Assembly,"Do pass, to Consent Calendar",6,0,0,0,6
74862,4119,2010-05-13,Assembly,"AB 2771 L.& E.  Consent Calendar Second Day  Regular Session",76,0,3,0,79
74863,3780,2010-05-05,Assembly,"Do pass",6,0,0,0,6
74863,3781,2010-05-13,Assembly,"AB 2772 L.& E.  Assembly Third Reading  By SWANSON",55,20,4,0,79
74863,6728,2010-06-09,Senate,"Do pass",4,0,2,0,6
74863,9709,2010-06-28,Senate,"Assembly 3rd Reading AB2772 Committee on L. & E. (Monning) By DeSaulnier",21,12,6,0,39
74864,2808,2010-05-04,Assembly,"Do pass",7,3,0,0,10
74864,2809,2010-06-01,Assembly,"AB 2773 SWANSON  Assembly Third Reading",46,28,5,0,79
74864,10298,2010-06-29,Senate,"Do pass",3,1,1,0,5
74864,21967,2010-08-26,Senate,"Assembly 3rd Reading AB2773 Swanson By Hancock",22,12,0,0,34
74865,1360,2010-05-05,Assembly,"Do pass.",4,0,2,0,6
74865,1361,2010-05-28,Assembly,"AB 2774 L.& E.  Assembly Third Reading  By SWANSON  Amend By SWANSON  Set #1",42,21,16,0,79
74865,1362,2010-06-02,Assembly,"AB 2774 L.& E.  Assembly Third Reading  By SWANSON",44,29,6,0,79
74865,9465,2010-06-23,Senate,"Do pass",4,1,1,0,6
74865,20202,2010-08-12,Senate,"Placed on Appropriations Suspense file",11,0,0,0,11
74865,20203,2010-08-12,Senate,"Do pass",7,4,0,0,11
74865,20995,2010-08-24,Senate,"Assembly 3rd Reading AB2774 Swanson By DeSaulnier",23,13,0,0,36
74865,21479,2010-08-26,Assembly,"AB 2774 SWANSON  Concurrence in Senate Amendments",50,26,0,0,76
74866,2545,2010-04-13,Assembly,"Do pass and re-refer to Committee on Appropriations with recommendation:  To Consent Calendar",13,0,0,0,13
74866,2546,2010-04-21,Assembly,"Do pass, to Consent Calendar",17,0,0,0,17
74866,2547,2010-04-29,Assembly,"AB 2775 W., P.& W.  Consent Calendar Second Day  Regular Session",74,0,5,0,79
74866,9137,2010-06-22,Senate,"Do pass, but re-refer to the Committee on Appropriations",7,1,1,0,9
74867,2156,2010-04-13,Assembly,"Do pass and re-refer to Committee on Appropriations with recommendation:  To Consent Calendar",13,0,0,0,13
74867,2157,2010-04-21,Assembly,"Do pass, to Consent Calendar",17,0,0,0,17
74867,2158,2010-04-29,Assembly,"AB 2776 W., P.& W.  Consent Calendar Second Day  Regular Session",74,0,5,0,79
74867,8701,2010-06-14,Senate,"Do pass, but re-refer to the Committee on Natural Resources and Water Recommend Consent",7,0,0,0,7
74867,9735,2010-06-29,Senate,"Do pass as amended, and re-refer to the Committee on Appropriations",5,4,0,0,9
74867,19439,2010-08-02,Senate,"Do pass",5,5,0,0,10
74867,19440,2010-08-02,Senate,"Set, first hearing.  Failed passage in Committee.  Reconsideration 	granted",10,0,0,0,10
74867,19796,2010-08-09,Senate,"Do pass",5,4,0,0,9
74868,3265,2010-04-12,Assembly,"Do pass and re-refer to Committee on Appropriations with recommendation:  To Consent Calendar",13,0,1,0,14
74868,3266,2010-04-21,Assembly,"Do pass, to Consent Calendar",17,0,0,0,17
74868,3267,2010-04-29,Assembly,"AB 2777 TRANS.  Consent Calendar Second Day  Regular Session",74,0,5,0,79
74868,10273,2010-06-29,Senate,"Do pass as amended, but re-refer to the Committee on Appropriations Recommend Consent",8,0,1,0,9
74868,20433,2010-08-18,Senate,"Consent Calendar 2nd AB2777 Committee on TRANS. (Lowenthal)",34,0,0,0,34
74868,20695,2010-08-20,Assembly,"AB 2777 TRANS.  Concurrence in Senate Amendments By LOWENTHAL",76,0,0,0,76
74869,179,2010-05-05,Assembly,"Do pass as amended and be re-referred to the Committee on Appropriations.",12,0,0,0,12
74869,180,2010-05-19,Assembly,"Do pass, to Consent Calendar.",16,0,1,0,17
74869,181,2010-05-28,Assembly,"AB 2778 INS.  Consent Calendar Second Day  Regular Session",63,0,16,0,79
74869,9835,2010-06-30,Senate,"Do pass, but re-refer to the Committee on Appropriations Recommend Consent",10,0,1,0,11
74869,19445,2010-08-05,Senate,"Consent Calendar 2nd AB2778 Committee on INS. (Coto)",33,0,0,0,33
74869,20098,2010-08-12,Assembly,"AB 2778 INS.  Concurrence in Senate Amendments By SOLORIO",78,0,0,0,78
74870,5159,2010-04-05,Senate,"Do pass, but re-refer to the Committee on Appropriations Recommend Consent",6,0,1,0,7
74870,5160,2010-04-22,Senate,"Consent Calendar 2nd SB1477 Committee on E.Q. (Simitian)",33,0,6,0,39
74870,10277,2010-06-29,Assembly,"Do pass and re-refer to Committee on Appropriations with recommendation:  To Consent Calendar",9,0,0,0,9
74870,19747,2010-08-04,Assembly,"Do pass, to Consent Calendar",17,0,0,0,17
74870,19867,2010-08-12,Assembly,"SB 1477 E.Q.  Consent Calendar Second Day  Regular Session",78,0,0,0,78
74872,4363,2010-04-06,Senate,"Be adopted, but re-refer to the Committee on Appropriations Recommend Consent",8,0,1,0,9
74872,4364,2010-04-22,Senate,"Consent Calendar 2nd SCR83 Negrete McLeod",33,0,6,0,39
74872,8807,2010-06-07,Assembly,"Be adopted, and re-refer to Committee on Appropriations with recommendation:  To Consent Calendar",11,0,3,0,14
74872,10013,2010-06-30,Assembly,"Be adopted, to Consent Calendar",16,0,1,0,17
74872,21015,2010-08-23,Assembly,"SCR 83 Negrete McLeod  Senate Third Reading  By TORRES",74,0,0,0,74
74872,21124,2010-08-25,Senate,"Unfinished Business SCR83 Negrete McLeod",35,0,0,0,35
75054,1344,2010-04-13,Senate,"Do pass and be placed on the Consent Calendar.",9,0,0,0,9
75054,1345,2010-04-22,Senate,"Consent Calendar 2nd SB1478 Committee on N.R. & W. (Pavley)",33,0,6,0,39
75054,9802,2010-06-29,Assembly,"Do pass",12,0,1,0,13
75054,20579,2010-08-17,Assembly,"SB 1478 N.R.& W.  Senate Third Reading  By HUFFMAN",77,0,0,0,77
75054,21488,2010-08-26,Senate,"Special Consent #32 SB1478 Committee on N.R. & W. (Pavley)",34,0,0,0,34
75055,1101,2010-04-12,Senate,"Do pass.",6,0,0,0,6
75055,1102,2010-04-15,Senate,"Senate 3rd Reading SB1479 Committee on P.E. & R. (Correa)",35,0,4,0,39
75055,9394,2010-06-23,Assembly,"Do pass, to Consent Calendar",6,0,0,0,6
75055,10339,2010-07-01,Assembly,"SB 1479 P.E.& R.  Consent Calendar Second Day  Regular Session",76,0,3,0,79
75055,19618,2010-08-09,Senate,"Special Consent #30 SB1479 Committee on P.E. & R. (Correa)",34,0,0,0,34
75122,1387,2010-04-21,Assembly,"Do pass, to Consent Calendar",12,0,0,0,12
75122,1388,2010-04-29,Assembly,"AB 2779 INS.  Consent Calendar Second Day  Regular Session",74,0,5,0,79
75122,19758,2010-08-10,Senate,"Do pass as amended",4,0,0,0,4
75123,2671,2010-04-21,Assembly,"Do pass and re-refer to Committee on Appropriations with recommendation:  To Consent Calendar",12,0,0,0,12
75123,2672,2010-04-28,Assembly,"Do pass, to Consent Calendar",15,0,2,0,17
75123,2673,2010-05-06,Assembly,"AB 2780 INS.  Consent Calendar Second Day  Regular Session",74,0,5,0,79
75123,8957,2010-06-16,Senate,"Do pass, but re-refer to the Committee on Appropriations",9,0,2,0,11
75123,10097,2010-07-01,Senate,"Special Consent #29 AB2780 Committee on INS. (Coto)",34,0,5,0,39
75123,21700,2010-08-30,Senate,"Do pass, but re-refer to the Committee on Appropriations",6,0,0,0,6
75123,21701,2010-08-30,Senate,"W/O REF. TO FILE AB2780 Solorio Urgency Clause",35,0,0,0,35
75123,21799,2010-08-31,Assembly,"Senate amendments be concurred in",10,0,0,0,10
75123,21800,2010-08-31,Assembly,"AB 2780 SOLORIO  Concurrence- Urgency Added",77,0,0,0,77
75124,4190,2010-04-21,Assembly,"Do pass and re-refer to Committee on Appropriations with recommendation:  To Consent Calendar",12,0,0,0,12
75124,4191,2010-05-05,Assembly,"Do pass, to Consent Calendar",17,0,0,0,17
75124,4192,2010-05-13,Assembly,"AB 2781 INS.  Consent Calendar Second Day  Regular Session",76,0,3,0,79
75124,9024,2010-06-16,Senate,"Do pass, but re-refer to the Committee on Appropriations Recommend Consent",9,0,2,0,11
75124,19502,2010-08-02,Senate,"Consent Calendar 2nd AB2781 Committee on INS. (Coto)",33,0,0,0,33
75125,5071,2010-04-21,Assembly,"Do pass as amended and re-refer to Committee on Appropriations with recommendation:  To Consent Calendar",12,0,0,0,12
75125,5072,2010-05-05,Assembly,"Do pass as amended, to Consent Calendar",17,0,0,0,17
75125,5073,2010-05-13,Assembly,"AB 2782 INS.  Consent Calendar Second Day  Regular Session",76,0,3,0,79
75125,8809,2010-06-16,Senate,"Do pass, but re-refer to the Committee on Appropriations",9,0,2,0,11
75125,20837,2010-08-23,Senate,"Assembly 3rd Reading AB2782 Committee on INS. (Solorio) By Calderon",36,0,0,0,36
75125,20997,2010-08-24,Assembly,"AB 2782 INS.  Concurrence in Senate Amendments By SOLORIO",78,0,0,0,78
75126,27216,2010-04-29,Assembly,"Be adopted, to Consent Calendar",10,0,0,0,10
75126,27217,2010-05-06,Assembly,"ACR 141 BLAKESLEE  Consent Calendar Second Day  Regular Session",74,0,0,0,74
75126,27218,2010-05-17,Senate,"W/O REF. TO FILE ACR141 Blakeslee",33,0,0,0,33
75280,4588,2010-04-06,Senate,"Be adopted as amended, but re-refer to the Committee on Appropriations Recommend Consent",8,0,1,0,9
75280,4589,2010-04-29,Senate,"Consent Calendar 2nd SCR84 Aanestad",33,0,5,0,38
75280,8833,2010-06-07,Assembly,"Be adopted, and re-refer to Committee on Appropriations with recommendation:  To Consent Calendar",11,0,3,0,14
75280,10092,2010-06-30,Assembly,"Be adopted, to Consent Calendar",16,0,1,0,17
75280,19267,2010-08-02,Assembly,"SCR 84 Aanestad  Consent Calendar Second Day  Regular Session",76,0,0,0,76
75728,2882,2010-04-13,Assembly,"Do pass and be re-referred to the Committee on Business, Professions and Consumer Protection",9,0,0,0,9
75728,2883,2010-04-20,Assembly,"Do pass and be re-referred to the Committee on Appropriations",11,0,0,0,11
75728,2884,2010-04-28,Assembly,"Do pass, to Consent Calendar",15,0,2,0,17
75728,2885,2010-05-06,Assembly,"AB 2783 V. A.  Consent Calendar Second Day  Regular Session",74,0,5,0,79
75728,9317,2010-06-22,Senate,"Do pass, but re-refer to the Committee on Appropriations",4,0,1,0,5
75728,19625,2010-08-09,Senate,"Special Consent #30 AB2783 Committee on V. A. (Cook)",34,0,0,0,34
75729,2211,2010-04-22,Assembly,"Do pass and be re-referred to the Committee on Appropriations to Consent Calendar",9,0,0,0,9
75729,2212,2010-05-28,Assembly,"Do pass as amended",17,0,0,0,17
75729,2213,2010-06-02,Assembly,"AB 2784 V. A.  Assembly Third Reading  By COOK",76,0,3,0,79
75729,9507,2010-06-22,Senate,"Do pass as amended, and re-refer to the Committee on Appropriations",4,0,1,0,5
75729,20063,2010-08-12,Senate,"Do pass as amended",10,0,0,0,10
75729,20867,2010-08-23,Senate,"Assembly 3rd Reading AB2784 Committee on V. A. (Cook) By Negrete 	McLeod",33,1,0,0,34
75729,21013,2010-08-24,Assembly,"AB 2784 V. A.  Concurrence in Senate Amendments By COOK",75,0,0,0,75
75730,4093,2010-04-13,Assembly,"Do pass and be re-referred to the Committee on Appropriations",9,0,0,0,9
75730,4094,2010-04-28,Assembly,"Do pass",15,0,2,0,17
75730,4095,2010-05-17,Assembly,"AB 2785 V. A.  Assembly Third Reading  By COOK",70,0,9,0,79
75730,9342,2010-06-22,Senate,"Do pass, but re-refer to the Committee on Appropriations",4,0,1,0,5
75730,10899,2010-07-15,Senate,"Placed on Appropriations Suspense file",8,0,2,0,10
75732,8265,2010-03-18,Assembly,"From committee:  Be adopted.  To third reading",8,0,3,0,11
75732,21982,2010-08-31,Senate,"Assembly 3rd Reading ACR142 Solorio By Calderon",28,2,0,0,30
75733,5840,2010-04-12,Assembly,"Be adopted",3,6,0,0,9
75734,1236,2010-04-13,Senate,"Do pass, but re-refer to the Committee on Appropriations Recommend Consent.",10,0,1,0,11
75734,1237,2010-04-29,Senate,"Consent Calendar 2nd SB1480 Committee on G.O. (Wright)",33,0,5,0,38
75734,10222,2010-06-30,Assembly,"Do pass and re-refer to Committee on Appropriations with recommendation:  To Consent Calendar",18,0,4,0,22
75734,19512,2010-08-04,Assembly,"Do pass, to Consent Calendar",17,0,0,0,17
75734,19958,2010-08-12,Assembly,"SB 1480 G.O.  Consent Calendar Second Day  Regular Session",78,0,0,0,78
75734,20728,2010-08-19,Senate,"Unfinished Business SB1480 Committee on G.O. (Wright)",35,0,0,0,35
75735,4547,2010-04-13,Senate,"Do pass, but re-refer to the Committee on Appropriations Recommend Consent",10,0,1,0,11
75735,4548,2010-04-29,Senate,"Consent Calendar 2nd SB1481 Committee on G.O. (Wright)",33,0,5,0,38
75735,8747,2010-06-15,Assembly,"Do pass and be re-referred to the Committee on Appropriations",11,0,0,0,11
75735,19336,2010-08-04,Assembly,"Do pass",17,0,0,0,17
75735,20469,2010-08-18,Assembly,"SB 1481 G.O.  Senate Third Reading  By BLOCK",75,0,0,0,75
75735,21323,2010-08-26,Senate,"Special Consent #32 SB1481 Committee on G.O. (Wright)",34,0,0,0,34
75736,2997,2010-04-27,Senate,"Do pass and be placed on the Consent Calendar",7,0,4,0,11
75736,2998,2010-05-03,Senate,"Consent Calendar 2nd SB1482 Committee on G.O. (Wright)",34,0,4,0,38
75736,8977,2010-06-17,Assembly,"Be referred to Committee on Judiciary",9,0,2,0,11
75736,9694,2010-06-29,Assembly,"Do pass as amended, to Consent Calendar",10,0,0,0,10
75736,19420,2010-08-05,Assembly,"SB 1482 Wright  Consent Calendar Second Day  Regular Session",71,0,0,0,71
75736,19965,2010-08-12,Senate,"From committee:  That the Assembly Amendments be concurred in",5,0,0,0,5
75736,20730,2010-08-19,Senate,"Unfinished Business SB1482 Wright",35,0,0,0,35
75737,2907,2010-04-27,Senate,"Do pass and be placed on the Consent Calendar",7,0,4,0,11
75737,2908,2010-05-03,Senate,"Consent Calendar 2nd SB1483 Committee on G.O. (Wright)",34,0,4,0,38
75737,10089,2010-06-30,Assembly,"Do pass, to Consent Calendar",9,0,0,0,9
75737,19418,2010-08-05,Assembly,"SB 1483 Wright  Consent Calendar Second Day  Regular Session",71,0,0,0,71
75737,19834,2010-08-11,Senate,"From committee:  That the Assembly Amendments be concurred in",4,0,0,0,4
75737,20669,2010-08-19,Senate,"Unfinished Business SB1483 Wright",34,0,0,0,34
75738,2865,2010-04-27,Senate,"Do pass and be placed on the Consent Calendar",7,0,4,0,11
75738,2866,2010-05-03,Senate,"Consent Calendar 2nd SB1484 Committee on G.O. (Wright)",34,0,4,0,38
75738,9293,2010-06-22,Assembly,"Do pass as amended and be re-referred to the Committee on Appropriations",6,0,0,0,6
75739,542,2010-04-13,Senate,"Do pass, but re-refer to the Committee on Appropriations Recommend Consent.",10,0,1,0,11
75739,543,2010-04-29,Senate,"Consent Calendar 2nd SB1485 Committee on G.O. (Wright)",33,0,5,0,38
75740,5036,2010-04-13,Senate,"Do pass, but re-refer to the Committee on Appropriations Recommend Consent",10,0,1,0,11
75740,5037,2010-04-29,Senate,"Consent Calendar 2nd SB1486 Committee on G.O. (Wright)",33,0,5,0,38
75740,8800,2010-06-16,Assembly,"Do pass and re-refer to Committee on Appropriations with recommendation:  To Consent Calendar",20,0,2,0,22
75740,10271,2010-06-30,Assembly,"Do pass",12,0,5,0,17
75740,19290,2010-08-02,Assembly,"SB 1486 G.O.  Senate Third Reading  By COTO",78,0,0,0,78
75741,20032,2010-08-11,Senate,"Senate 3rd Reading SJR25 Yee",34,0,0,0,34
75741,20033,2010-08-12,Assembly,"Be adopted, to Consent Calendar",9,0,0,0,9
75741,20378,2010-08-17,Assembly,"SJR 25 Yee  Consent Calendar Second Day  Regular Session",76,0,0,0,76
76069,2682,2010-04-20,Assembly,"Do pass and re-refer to Committee on Appropriations with recommendation:  To Consent Calendar",18,0,1,0,19
76069,2683,2010-04-28,Assembly,"Do pass, to Consent Calendar",15,0,2,0,17
76069,2684,2010-05-06,Assembly,"AB 2786 HEALTH  Consent Calendar Second Day  Regular Session",74,0,5,0,79
76069,10373,2010-06-30,Senate,"Do pass, but re-refer to the Committee on Appropriations Recommend Consent",8,0,1,0,9
76069,19546,2010-08-02,Senate,"Placed on Appropriations Suspense file",10,0,0,0,10
76069,20168,2010-08-12,Senate,"Do pass",11,0,0,0,11
76069,21161,2010-08-25,Senate,"From Committee:  Amendments returned to Senate floor for 	consideration",8,0,0,0,8
76069,21688,2010-08-30,Senate,"Assembly 3rd Reading AB2786 Committee on HEALTH (Monning) By Alquist",37,0,0,0,37
76069,21785,2010-08-31,Assembly,"AB 2786 HEALTH  Concurrence in Senate Amendments By MONNING",77,0,0,0,77
76070,4266,2010-04-20,Assembly,"Do pass and re-refer to Committee on Appropriations with recommendation:  To Consent Calendar",18,0,1,0,19
76070,4267,2010-05-05,Assembly,"Do pass as amended, to Consent Calendar",17,0,0,0,17
76070,4268,2010-05-13,Assembly,"AB 2787 MONNING  Consent Calendar Second Day  Regular Session",76,0,3,0,79
76070,10080,2010-06-30,Senate,"Do pass as amended, and re-refer to the Committee on Appropriations",5,3,1,0,9
76070,19455,2010-08-02,Senate,"Placed on Appropriations Suspense file",10,0,0,0,10
76071,4879,2010-05-10,Assembly,"Do pass and re-refer to Committee on Appropriations with recommendation:  To Consent Calendar",9,0,0,0,9
76071,4880,2010-05-19,Assembly,"Do pass, to Consent Calendar",16,0,1,0,17
76071,4881,2010-05-28,Assembly,"AB 2788 REV.& TAX.  Consent Calendar Second Day  Regular Session",63,0,16,0,79
76071,19852,2010-08-11,Senate,"Do pass, but re-refer to the Committee on Appropriations",4,0,0,0,4
76072,2352,2010-04-19,Assembly,"Do pass and be re-referred to the Committee on Appropriations",11,1,0,0,12
76072,2353,2010-04-28,Assembly,"Do pass",14,1,2,0,17
76072,2354,2010-05-06,Assembly,"AB 2789 B.& F.  Assembly Third Reading  By ENG",68,5,6,0,79
76072,10233,2010-06-30,Senate,"Do pass as amended, and re-refer to the Committee on Appropriations",10,0,1,0,11
76072,20515,2010-08-18,Senate,"Assembly 3rd Reading AB2789 Committee on B. & F. (Eng) By Calderon",33,1,0,0,34
76072,20684,2010-08-20,Assembly,"AB 2789 B.& F.  Concurrence in Senate Amendments By ENG",71,4,0,0,75
76073,5721,2010-03-11,Assembly,"From committee:  Be adopted.  To third reading",10,0,1,0,11
76074,281,2010-04-13,Senate,"Do pass, but re-refer to the Committee on Appropriations.",7,0,0,0,7
76074,282,2010-04-29,Senate,"Senate 3rd Reading SB1487 Committee on Pub. S. (Leno) Urgency Clause",35,0,3,0,38
76074,9310,2010-06-22,Assembly,"Do pass and be re-referred to the Committee on Appropriations",4,1,2,0,7
76075,2773,2010-04-13,Senate,"Do pass, but re-refer to the Committee on Appropriations Recommend Consent",9,0,0,0,9
76075,2774,2010-04-29,Senate,"Consent Calendar 2nd SB1488 Committee on N.R. & W. (Pavley)",33,0,5,0,38
76075,9313,2010-06-21,Assembly,"Do pass and re-refer to Committee on Appropriations with recommendation:  To Consent Calendar",7,0,2,0,9
76075,10139,2010-06-30,Assembly,"Do pass, to Consent Calendar",17,0,0,0,17
76075,19524,2010-08-05,Assembly,"SB 1488 N.R.& W.  Consent Calendar Second Day  Regular Session",71,0,0,0,71
76076,96,2010-04-13,Senate,"Be adopted, but re-refer to the Committee on Appropriations Recommend Consent.",8,0,1,0,9
76076,97,2010-04-29,Senate,"Consent Calendar 2nd SCR85 Denham",33,0,5,0,38
76076,8768,2010-06-07,Assembly,"Be adopted, and re-refer to Committee on Appropriations with recommendation:  To Consent Calendar",11,0,3,0,14
76076,10220,2010-06-30,Assembly,"Be adopted, to Consent Calendar",16,0,1,0,17
76076,19505,2010-08-02,Assembly,"SCR 85 Denham  Consent Calendar Second Day  Regular Session",76,0,0,0,76
76077,21189,2010-08-23,Senate,"W/O REF. TO FILE SCR86 Aanestad",36,0,0,0,36
76077,21397,2010-08-26,Assembly,"Be adopted, to Consent Calendar",9,0,0,0,9
76077,21710,2010-08-30,Assembly,"SCR 86 Aanestad  Consent Calendar Second Day  Regular Session",78,0,0,0,78
76321,27186,2010-04-15,Assembly,"From committee:  Be adopted.  To third reading",9,0,0,0,9
76321,27187,2010-04-29,Senate,"Assembly 3rd Reading ACR144 Blumenfield By Liu",34,0,0,0,34
76586,4691,2010-04-19,Senate,"Do pass, but re-refer to the Committee on Appropriations",7,0,2,0,9
76586,4692,2010-05-10,Senate,"Special Consent #23 SB1489 Committee on B.P.&E.D. (Negrete M",30,0,8,0,38
76586,9756,2010-06-29,Assembly,"Do pass and re-refer to Committee on Appropriations with recommendation:  To Consent Calendar",11,0,0,0,11
76586,19501,2010-08-04,Assembly,"Do pass, to Consent Calendar",17,0,0,0,17
76586,20317,2010-08-16,Assembly,"SB 1489 B. P.& E.D.  Senate Third Reading  By RUSKIN",74,0,0,0,74
76586,20624,2010-08-19,Senate,"Unfinished Business SB1489 Committee on B.P.&E.D. (Negrete M",34,0,0,0,34
76587,4921,2010-04-19,Senate,"Do pass, but re-refer to the Committee on Appropriations",7,0,2,0,9
76587,4922,2010-05-10,Senate,"Special Consent #23 SB1490 Committee on B.P.&E.D. (Negrete M",30,0,8,0,38
76587,9947,2010-06-29,Assembly,"Do pass and re-refer to Committee on Appropriations with recommendation:  To Consent Calendar",11,0,0,0,11
76587,19513,2010-08-04,Assembly,"Do pass, to Consent Calendar",17,0,0,0,17
76587,19961,2010-08-12,Assembly,"SB 1490 B. P.& E.D.  Consent Calendar Second Day  Regular Session",78,0,0,0,78
76588,4687,2010-04-19,Senate,"Do pass, but re-refer to the Committee on Appropriations",7,0,2,0,9
76588,4688,2010-05-10,Senate,"Special Consent #23 SB1491 Committee on B.P.&E.D. (Negrete M",30,0,8,0,38
76588,9978,2010-06-29,Assembly,"Do pass and re-refer to Committee on Appropriations with recommendation:  To Consent Calendar",11,0,0,0,11
76588,19685,2010-08-04,Assembly,"Do pass, to Consent Calendar",17,0,0,0,17
76588,20943,2010-08-23,Assembly,"SB 1491 B. P.& E.D.  Senate Third Reading  By MA",75,0,0,0,75
76588,21217,2010-08-25,Senate,"Unfinished Business SB1491 Committee on B.P.&E.D. (Negrete M",34,0,0,0,34
76590,27251,2010-04-08,Senate,"W/O REF. TO FILE SCR87 Price",32,0,0,0,32
76590,27252,2010-05-06,Assembly,"From committee:  Be adopted.  To third reading",10,0,0,0,10
76590,27253,2010-05-27,Senate,"Unfinished Business SCR87 Price",34,0,0,0,34
76885,27199,2010-03-24,Assembly,"Be adopted, as amended, to Consent Calendar",9,0,0,0,9
76885,27200,2010-04-26,Senate,"W/O REF. TO FILE ACR145 Brownley By Pavley",25,1,0,0,26
76886,4601,2010-04-14,Senate,"Do pass, but re-refer to the Committee on Appropriations Recommend Consent",5,0,0,0,5
76886,4602,2010-05-10,Senate,"Consent Calendar 2nd SB1492 Committee on Rev. & Tax. (Wolk)",30,0,8,0,38
76886,9898,2010-06-28,Assembly,"Do pass and re-refer to Committee on Appropriations with recommendation:  To Consent Calendar",9,0,0,0,9
76886,19591,2010-08-04,Assembly,"Do pass, to Consent Calendar",17,0,0,0,17
76886,19893,2010-08-12,Assembly,"SB 1492 REV.& TAX.  Consent Calendar Second Day  Regular Session",78,0,0,0,78
76887,625,2010-04-14,Senate,"Do pass and be placed on the Consent Calendar.",5,0,0,0,5
76887,626,2010-04-22,Senate,"Consent Calendar 2nd SB1493 Committee on Rev. & Tax. (Wolk)",33,0,6,0,39
76887,9768,2010-06-28,Assembly,"Do pass, to Consent Calendar",9,0,0,0,9
76887,19499,2010-08-02,Assembly,"SB 1493 REV.& TAX.  Consent Calendar Second Day  Regular Session",76,0,0,0,76
76887,19612,2010-08-09,Senate,"Special Consent #30 SB1493 Committee on Rev. & Tax. (Wolk)",34,0,0,0,34
76888,62,2010-04-14,Senate,"Do pass and be placed on the Consent Calendar.",5,0,0,0,5
76888,63,2010-04-22,Senate,"Consent Calendar 2nd SB1494 Committee on Rev. & Tax. (Wolk)",33,0,6,0,39
76888,9912,2010-06-28,Assembly,"Do pass and re-refer to Committee on Appropriations with recommendation:  To Consent Calendar",9,0,0,0,9
76888,20143,2010-08-12,Assembly,"Do pass as amended",17,0,0,0,17
76888,20590,2010-08-19,Assembly,"SB 1494 REV.& TAX.  Senate Third Reading  By PORTANTINO",78,0,0,0,78
76888,21390,2010-08-26,Senate,"Special Consent #32 SB1494 Committee on Rev. & Tax. (Wolk)",34,0,0,0,34
76889,782,2010-05-04,Senate,"Be adopted, but re-refer to the Committee on Appropriations Recommend Consent.",8,0,1,0,9
76889,783,2010-05-27,Senate,"Consent Calendar 2nd SCR88 DeSaulnier",33,0,5,0,38
76889,8742,2010-06-14,Assembly,"Be adopted, and re-refer to Committee on Appropriations with recommendation:  To Consent Calendar",12,0,2,0,14
76889,9826,2010-06-30,Assembly,"Be adopted, to Consent Calendar",16,0,1,0,17
76889,19079,2010-08-02,Assembly,"SCR 88 DeSaulnier  Consent Calendar Second Day  Regular Session",76,0,0,0,76
76890,2818,2010-05-04,Senate,"Be adopted, but re-refer to the Committee on Appropriations Recommend Consent",8,0,1,0,9
76890,2819,2010-05-27,Senate,"SCR89 Correa",32,0,6,0,38
76890,8825,2010-06-14,Assembly,"Be adopted, and re-refer to Committee on Appropriations with recommendation:  To Consent Calendar",12,0,2,0,14
76890,9801,2010-06-30,Assembly,"Be adopted, to Consent Calendar",16,0,1,0,17
76890,19074,2010-08-02,Assembly,"SCR 89 Correa  Consent Calendar Second Day  Regular Session",76,0,0,0,76
76963,4758,2010-04-12,Assembly,"Be adopted, and re-refer to Committee on Appropriations with recommendation:  To Consent Calendar",13,0,1,0,14
76963,4759,2010-04-21,Assembly,"Be adopted, to Consent Calendar",16,0,1,0,17
76963,4760,2010-04-26,Assembly,"ACR 146 HAYASHI  Consent Calendar Second Day  Regular Session",71,0,8,0,79
76963,9269,2010-06-22,Senate,"Be adopted, but re-refer to the Committee on Appropriations",6,0,3,0,9
76963,19614,2010-08-09,Senate,"Special Consent #30 ACR146 Hayashi",34,0,0,0,34
77267,3947,2010-05-05,Assembly,"Do pass",19,0,3,0,22
77267,3948,2010-05-13,Assembly,"AB 2790 G.O.  Assembly Third Reading  By COTO",73,0,6,0,79
77267,9790,2010-06-29,Senate,"Do pass and be placed on the Consent Calendar",8,0,3,0,11
77267,19307,2010-08-02,Senate,"Consent Calendar 2nd AB2790 Committee on G.O. (Price)",33,0,0,0,33
77268,5167,2010-04-21,Assembly,"Do pass and re-refer to Committee on Appropriations with recommendation:  To Consent Calendar",21,0,1,0,22
77268,5168,2010-05-19,Assembly,"Do pass, to Consent Calendar",16,0,1,0,17
77268,5169,2010-05-28,Assembly,"AB 2791 G.O.  Consent Calendar Second Day  Regular Session",63,0,16,0,79
77268,10268,2010-06-29,Senate,"Do pass, but re-refer to the Committee on Appropriations Recommend Consent",8,0,3,0,11
77268,21051,2010-08-24,Senate,"Assembly 3rd Reading AB2791 Committee on G.O. (Coto) By Price",35,0,0,0,35
77268,21409,2010-08-26,Assembly,"AB 2791 G.O.  Concurrence in Senate Amendments By COTO",78,0,0,0,78
77269,386,2010-04-21,Assembly,"Do pass and re-refer to Committee on Appropriations with recommendation:  To Consent Calendar.",21,0,1,0,22
77269,387,2010-05-12,Assembly,"Do pass.",11,0,6,0,17
77269,388,2010-05-28,Assembly,"AB 2792 G.O.  Assembly Third Reading  By COTO",62,0,17,0,79
77269,10153,2010-06-29,Senate,"Do pass, but re-refer to the Committee on Appropriations Recommend Consent",8,0,3,0,11
77269,21248,2010-08-25,Senate,"Assembly 3rd Reading AB2792 Committee on G.O. (Coto) By Price",35,0,0,0,35
77269,21731,2010-08-30,Assembly,"AB 2792 Governmental Organizatio Concurrence in Senate Amendments 	By COTO",76,0,0,0,76
77270,2650,2010-04-21,Assembly,"Do pass and be re-referred to the Committee on Appropriations",21,0,1,0,22
77270,2651,2010-05-19,Assembly,"Do pass, to Consent Calendar",16,0,1,0,17
77270,2652,2010-06-01,Assembly,"AB 2793 G.O.  Assembly Third Reading  By COTO",77,0,2,0,79
77270,10280,2010-06-29,Senate,"Do pass, but re-refer to the Committee on Appropriations Recommend Consent",8,0,3,0,11
77270,21145,2010-08-25,Senate,"Assembly 3rd Reading AB2793 Committee on G.O. (Coto) By Price",34,0,0,0,34
77270,21674,2010-08-30,Assembly,"AB 2793 Governmental Organizatio Concurrence in Senate Amendments 	By COTO",78,0,0,0,78
77271,3918,2010-05-05,Assembly,"Do pass, to Consent Calendar",19,0,3,0,22
77271,3919,2010-05-13,Assembly,"AB 2794 G.O.  Consent Calendar Second Day  Regular Session",76,0,3,0,79
77271,10286,2010-06-29,Senate,"Do pass and be placed on the Consent Calendar",8,0,3,0,11
77271,19324,2010-08-02,Senate,"Consent Calendar 2nd AB2794 Committee on G.O. (Price)",33,0,0,0,33
77347,9036,2010-06-15,Senate,"Be adopted, but re-refer to the Committee on Appropriations",5,3,1,0,9
77347,20318,2010-08-11,Senate,"Senate 3rd Reading SCR90 Lowenthal",22,12,0,0,34
77538,8288,2010-04-15,Assembly,"From committee:  Be adopted.  To third reading",9,0,2,0,11
77539,27140,2010-04-12,Assembly,"Be adopted and be re-referred to the Committee on Appropriations",13,0,0,0,13
77539,27141,2010-04-14,Assembly,"From committee:  Be adopted.  To third reading",16,0,0,0,16
77539,27142,2010-04-15,Assembly,"ACR 148 CALDERON  Assembly Third Reading",70,0,0,0,70
77539,27143,2010-04-22,Senate,"W/O REF. TO FILE ACR148 Charles Calderon By Calderon",34,0,0,0,34
77540,7932,2010-03-25,Assembly,"From committee:  Be adopted.  To third reading",10,0,1,0,11
77540,7933,2010-04-05,Assembly,"HR 27 PEREZ, J.  Assembly Third Reading",74,0,5,0,79
77541,27245,2010-04-08,Senate,"Senate 3rd Reading SCR91 Steinberg",34,0,0,0,34
77541,27246,2010-04-29,Assembly,"From committee:  Be adopted.  To third reading",6,0,0,0,6
77541,27247,2010-05-27,Senate,"Unfinished Business SCR91 Steinberg",33,0,0,0,33
77619,3761,2010-04-28,Assembly,"Do pass, to Consent Calendar",9,0,0,0,9
77619,3762,2010-05-06,Assembly,"AB 2795 L. GOV.  Consent Calendar Second Day  Regular Session",74,0,5,0,79
77619,6717,2010-06-09,Senate,"Do pass and be placed on the Consent Calendar",3,0,2,0,5
77619,9063,2010-06-17,Senate,"Consent Calendar 2nd AB2795 Committee on L. GOV. (Caballero)",33,0,6,0,39
77619,9083,2010-06-21,Assembly,"AB 2795 L. GOV.  Concurrence in Senate Amendments By SMYTH",76,0,3,0,79
77620,3748,2010-05-04,Assembly,"Do pass, to Consent Calendar",7,0,0,0,7
77620,3749,2010-05-13,Assembly,"AB 2796 E.& R.  Consent Calendar Second Day  Regular Session",76,0,3,0,79
77620,9783,2010-06-29,Senate,"Do pass and be placed on the Consent Calendar",4,0,1,0,5
77620,20812,2010-08-23,Senate,"Assembly 3rd Reading AB2796 Committee on E. & R. (Fong) By 	Strickland",36,0,0,0,36
77621,4296,2010-05-04,Assembly,"Do pass as amended, to Consent Calendar",7,0,0,0,7
77621,4297,2010-05-13,Assembly,"AB 2797 E.& R.  Consent Calendar Second Day  Regular Session",76,0,3,0,79
77621,9831,2010-06-29,Senate,"Do pass and be placed on the Consent Calendar",4,0,1,0,5
77621,20984,2010-08-24,Senate,"Assembly 3rd Reading AB2797 Committee on E. & R. (Fong) By 	Strickland",35,0,0,0,35
77621,21467,2010-08-26,Assembly,"AB 2797 E.& R.  Concurrence in Senate Amendments By FONG",78,0,0,0,78
77622,496,2010-05-04,Assembly,"Do pass, to Consent Calendar.",6,0,0,0,6
77622,497,2010-05-10,Assembly,"AB 2798 J., E.D.& E.  Consent Calendar Second Day  Regular Session",71,0,8,0,79
77622,8725,2010-06-14,Senate,"Do pass",7,0,2,0,9
77622,21621,2010-08-25,Senate,"Assembly 3rd Reading AB2798 Committee on Jobs, Economic Devel By 	Negrete McLeod",35,0,0,0,35
77624,3934,2010-05-05,Assembly,"Be adopted",9,0,0,0,9
77624,3935,2010-05-10,Assembly,"AJR 39 TORLAKSON  Assembly Third Reading",70,1,8,0,79
77624,9009,2010-06-16,Senate,"Be adopted and be placed on the Consent Calendar",6,0,3,0,9
77624,9629,2010-06-28,Senate,"Assembly 3rd Reading AJR39 Torlakson By Hancock",31,0,8,0,39
77624,10114,2010-07-01,Assembly,"AJR 39 TORLAKSON  Concurrence in Senate Amendments",72,0,7,0,79
77627,4986,2010-04-08,Senate,"Senate 3rd Reading SCR93 DeSaulnier",28,1,10,0,39
77627,8975,2010-06-17,Assembly,"Be adopted, to Consent Calendar",9,0,2,0,11
77627,20241,2010-08-09,Senate,"Unfinished Business SCR93 DeSaulnier",33,0,0,0,33
77628,27188,2010-04-15,Senate,"W/O REF. TO FILE SCR94 Harman",35,0,0,0,35
77628,27189,2010-04-22,Assembly,"Be adopted, to Consent Calendar",8,0,0,0,8
77628,27190,2010-04-29,Assembly,"SCR 94 Harman  Consent Calendar Second Day  Regular Session",74,0,0,0,74
77629,9370,2010-06-23,Senate,"Be adopted",4,0,1,0,5
77629,10221,2010-07-01,Senate,"Senate 3rd Reading SCR95 Simitian",34,0,5,0,39
77629,19911,2010-08-12,Assembly,"Be adopted, to Consent Calendar",9,0,0,0,9
77629,20351,2010-08-17,Assembly,"SCR 95 Simitian  Consent Calendar Second Day  Regular Session",76,0,0,0,76
77629,20585,2010-08-19,Senate,"Unfinished Business SCR95 Simitian",35,0,0,0,35
77630,27148,2010-04-08,Senate,"Senate 3rd Reading SJR26 Simitian",34,0,0,0,34
77630,27149,2010-04-12,Assembly,"From committee:  Be adopted.  To third reading",9,0,0,0,9
77630,27150,2010-04-15,Assembly,"SJR 26 Simitian  Senate Third Reading  By PORTANTINO",71,0,0,0,71
77630,27151,2010-04-22,Senate,"Unfinished Business SJR26 Simitian",34,0,0,0,34
77631,9060,2010-06-17,Senate,"Senate 3rd Reading SJR27 Yee",31,0,8,0,39
77632,8774,2010-06-15,Senate,"Be adopted",3,2,0,0,5
77632,9042,2010-06-17,Senate,"Senate 3rd Reading SJR28 Kehoe",22,9,8,0,39
77632,20179,2010-08-10,Assembly,"Be adopted as amended",6,2,0,0,8
77632,21166,2010-08-23,Assembly,"SJR 28 Kehoe  Senate Third Reading  By FEUER",49,25,0,0,74
77632,21167,2010-08-25,Senate,"Unfinished Business SJR28 Kehoe",21,8,0,0,29
78355,1998,2010-04-19,Assembly,"Be adopted, and re-refer to Committee on Appropriations with recommendation:  To Consent Calendar",13,0,1,0,14
78356,842,2010-05-04,Assembly,"Be adopted, to Consent Calendar.",7,0,0,0,7
78356,843,2010-05-10,Assembly,"AJR 40 HUFFMAN  Consent Calendar Second Day  Regular Session",71,0,8,0,79
78356,9387,2010-06-24,Senate,"W/O REF. TO FILE AJR40 Huffman",31,0,8,0,39
78357,27248,2010-04-29,Senate,"W/O REF. TO FILE SCR96 Correa",33,0,0,0,33
78357,27249,2010-05-03,Assembly,"From committee:  Be adopted.  To third reading",7,0,0,0,7
78357,27250,2010-05-27,Senate,"Unfinished Business SCR96 Correa",33,0,0,0,33
78383,8980,2010-06-17,Assembly,"From committee:  Be adopted.  To third reading",9,0,2,0,11
78383,19566,2010-08-02,Senate,"W/O REF. TO FILE ACR150 Carter",33,0,0,0,33
78435,4111,2010-05-11,Assembly,"Be adopted as amended",4,2,0,0,6
78435,21007,2010-08-24,Senate,"Assembly 3rd Reading ACR151 Ma By Liu",25,9,0,0,34
78436,6032,2010-04-22,Assembly,"Be adopted as amended",8,0,3,0,11
78436,21548,2010-08-26,Senate,"W/O REF. TO FILE ACR152 Hernandez",34,0,0,0,34
78437,8480,2010-04-15,Assembly,"From committee:  Be adopted.  To third reading",9,0,2,0,11
78439,77,2010-04-29,Senate,"W/O REF. TO FILE SCR97 Yee",33,0,5,0,38
78439,78,2010-05-20,Assembly,"Be adopted, to Consent Calendar.",11,0,0,0,11
78439,9584,2010-06-28,Senate,"Special Consent #28 SCR97 Yee",32,0,7,0,39
78440,694,2010-05-13,Senate,"W/O REF. TO FILE SJR29 Wright",31,0,7,0,38
78440,9440,2010-06-22,Assembly,"From committee:  Be adopted.  To third reading",6,0,0,0,6
78440,20514,2010-08-16,Assembly,"SJR 29 Wright  Senate Third Reading  By LOWENTHAL",73,2,0,0,75
78440,21380,2010-08-25,Senate,"Special Consent #32 SJR29 Wright",34,0,0,0,34
78441,5342,2010-06-09,Senate,"Do pass and be placed on the Consent Calendar",3,0,2,0,5
78441,9057,2010-06-17,Senate,"Consent Calendar 2nd SJR30 Kehoe",33,0,6,0,39
78441,20208,2010-08-12,Assembly,"SJR 30 Kehoe  Consent Calendar Second Day  Regular Session",78,0,0,0,78
84897,2278,2010-05-20,Assembly,"From committee:  Be adopted.  To third reading",9,1,1,0,11
84897,19608,2010-08-09,Assembly,"Be adopted, and re-refer to Committee on Appropriations with 	recommendation:  To Consent Calendar",12,0,0,0,12
84897,19937,2010-08-12,Assembly,"Be adopted, as amended, to Consent Calendar",16,0,0,0,16
84897,20582,2010-08-19,Assembly,"ACR 154 JEFFRIES  Consent Calendar Second Day",77,0,0,0,77
84897,21709,2010-08-30,Senate,"W/O REF. TO FILE ACR154 Jeffries By Dutton",37,0,0,0,37
84897,21805,2010-08-31,Assembly,"ACR 154 JEFFRIES  Concurrence in Senate Amendments",77,0,0,0,77
84899,9560,2010-06-24,Senate,"W/O REF. TO FILE SCR98 Strickland",31,0,8,0,39
84899,19555,2010-08-05,Assembly,"Be adopted, to Consent Calendar",9,0,0,0,9
84899,20231,2010-08-12,Assembly,"SCR 98 Strickland  Consent Calendar Second Day  Regular Session",78,0,0,0,78
84900,9559,2010-06-24,Senate,"W/O REF. TO FILE SCR99 Strickland",31,0,8,0,39
84900,19557,2010-08-05,Assembly,"Be adopted, to Consent Calendar",9,0,0,0,9
84900,20233,2010-08-12,Assembly,"SCR 99 Strickland  Consent Calendar Second Day  Regular Session",78,0,0,0,78
84900,20749,2010-08-19,Senate,"Unfinished Business SCR99 Strickland",35,0,0,0,35
84901,2867,2010-05-04,Senate,"Be adopted, but re-refer to the Committee on Appropriations Recommend Consent",8,0,1,0,9
84901,2868,2010-05-27,Senate,"Consent Calendar 2nd SCR100 Cox",33,0,5,0,38
84901,8827,2010-06-14,Assembly,"Be adopted, and re-refer to Committee on Appropriations with recommendation:  To Consent Calendar",12,0,2,0,14
84901,9808,2010-06-30,Assembly,"Be adopted, to Consent Calendar",16,0,1,0,17
84901,19072,2010-08-02,Assembly,"SCR 100  Consent Calendar Second Day  Regular Session",76,0,0,0,76
85636,4082,2010-05-06,Assembly,"From committee:  Be adopted.  To third reading",10,0,1,0,11
85636,21612,2010-08-26,Senate,"W/O REF. TO FILE ACR157 Fong",34,0,0,0,34
85848,4496,2010-04-27,Assembly,"Be adopted",8,0,1,0,9
86108,1103,2010-04-19,Assembly,"Be adopted, and re-refer to Committee on Appropriations with recommendation:  To Consent Calendar.",13,0,1,0,14
86108,1104,2010-04-28,Assembly,"Be adopted, to Consent Calendar.",14,0,3,0,17
86108,1105,2010-05-06,Assembly,"ACR 159 YAMADA  Consent Calendar Second Day  Regular Session",74,0,5,0,79
86108,8931,2010-06-15,Senate,"Be adopted, but re-refer to the Committee on Appropriations",6,1,2,0,9
86108,19107,2010-08-02,Senate,"Assembly 3rd Reading ACR159 Eng By Calderon",31,1,0,0,32
86108,19840,2010-08-09,Assembly,"ACR 159 ENG  Concurrence in Senate Amendments",77,0,0,0,77
86206,8731,2010-06-07,Assembly,"Be adopted, and re-refer to Committee on Appropriations with recommendation:  To Consent Calendar",11,0,3,0,14
86206,10054,2010-06-30,Assembly,"Be adopted, to Consent Calendar",16,0,1,0,17
86206,19207,2010-08-02,Assembly,"ACR 160 PEREZ, V.M.  Consent Calendar Second Day",76,0,0,0,76
86206,20971,2010-08-24,Senate,"Assembly 3rd Reading ACR160 V. Manuel Perez",35,0,0,0,35
86207,2730,2010-05-06,Assembly,"From committee:  Be adopted.  To third reading",9,0,2,0,11
86207,20389,2010-08-12,Senate,"Assembly 3rd Reading ACR161 Bonnie Lowenthal By Wolk",34,0,0,0,34
86208,10083,2010-07-01,Senate,"W/O REF. TO FILE ACR162 Beall",34,0,5,0,39
86208,19367,2010-08-02,Assembly,"ACR 162 BEALL  Concurrence in Senate Amendments",75,0,0,0,75
86209,5019,2010-04-22,Senate,"W/O REF. TO FILE SCR101 Calderon",32,0,7,0,39
86209,9292,2010-06-22,Assembly,"From committee:  Be adopted.  To third reading",8,0,1,0,9
86316,9103,2010-06-14,Assembly,"Be adopted as amended",8,4,2,0,14
86316,9104,2010-06-21,Assembly,"AJR 41 LIEU  Assembly Third Reading",46,27,6,0,79
86316,19752,2010-08-10,Senate,"Be adopted",6,3,0,0,9
86316,19882,2010-08-12,Senate,"Assembly 3rd Reading AJR41 Lieu By Pavley",21,14,0,0,35
86316,20297,2010-08-16,Assembly,"AJR 41 LIEU  Concurrence in Senate Amendments",57,16,0,0,73
86317,1902,2010-04-26,Senate,"W/O REF. TO FILE SCR103 Cedillo",33,0,6,0,39
86317,1903,2010-04-29,Assembly,"From committee:  Be adopted.  To third reading",10,0,1,0,11
86317,1904,2010-06-01,Senate,"Unfinished Business SCR103 Cedillo",35,0,3,0,38
95332,27242,2010-04-29,Senate,"W/O REF. TO FILE SCR104 Steinberg",33,0,0,0,33
95332,27243,2010-05-20,Assembly,"Be adopted, to Consent Calendar",11,0,0,0,11
95332,27244,2010-05-28,Assembly,"SCR 104 Steinberg  Consent Calendar Second Day  Regular Session",63,0,0,0,63
95333,8834,2010-06-15,Senate,"Be adopted, but re-refer to the Committee on Appropriations Recommend Consent",8,0,1,0,9
95333,19081,2010-08-02,Senate,"Consent Calendar 2nd SCR105 Florez",33,0,0,0,33
95333,19703,2010-08-09,Assembly,"Be adopted, and re-refer to Committee on Appropriations with 	recommendation:  To Consent Calendar",12,0,0,0,12
95333,19905,2010-08-12,Assembly,"Be adopted, to Consent Calendar",17,0,0,0,17
95333,20346,2010-08-17,Assembly,"SCR 105 Florez  Consent Calendar Second Day  Regular Session",76,0,0,0,76
95334,9011,2010-06-15,Senate,"Be adopted, but re-refer to the Committee on Appropriations",6,1,2,0,9
95334,19682,2010-08-09,Senate,"Senate 3rd Reading SCR106 Wright",32,1,0,0,33
95334,21603,2010-08-26,Assembly,"Be adopted, to Consent Calendar",9,0,0,0,9
95334,21711,2010-08-30,Assembly,"SCR 106 Wright  Consent Calendar Second Day  Regular Session",78,0,0,0,78
95335,8847,2010-06-15,Senate,"Be adopted, but re-refer to the Committee on Appropriations",6,1,2,0,9
95335,19698,2010-08-09,Senate,"Senate 3rd Reading SCR107 Wright",33,0,0,0,33
95335,21720,2010-08-30,Assembly,"Be adopted, to Consent Calendar",11,0,0,0,11
95335,21810,2010-08-31,Assembly,"SCR 107 Wright  Consent Calendar First Day",77,0,0,0,77
95335,21811,2010-08-31,Senate,"W/O REF. TO FILE SCR107 Wright Concurrence",37,0,0,0,37
115678,2507,2010-05-13,Assembly,"From committee:  Be adopted.  To third reading",9,0,2,0,11
115679,3902,2010-05-05,Senate,"Be adopted as amended",9,0,0,0,9
115679,3903,2010-05-13,Senate,"Senate 3rd Reading SJR31 Pavley",29,0,9,0,38
115679,8885,2010-06-15,Assembly,"Be adopted, to Consent Calendar",5,0,1,0,6
115679,9101,2010-06-21,Assembly,"SJR 31 Pavley  Consent Calendar Second Day  Regular Session",75,0,4,0,79
115679,9574,2010-06-28,Senate,"Special Consent #28 SJR31 Pavley",32,0,7,0,39
119267,9235,2010-06-23,Assembly,"From committee:  Be adopted.  To third reading",4,0,2,0,6
119267,21634,2010-08-23,Senate,"Assembly 3rd Reading ACR163 V. Manuel Perez",21,13,0,0,34
176422,2484,2010-06-01,Senate,"Senate 3rd Reading SCR108 Harman",31,1,6,0,38
176423,3349,2010-05-13,Senate,"Senate 3rd Reading SCR109 Padilla",28,0,10,0,38
176423,8973,2010-06-17,Assembly,"From committee:  Be adopted.  To third reading",9,0,2,0,11
176423,9102,2010-06-21,Assembly,"SCR 109 Padilla  Senate Third Reading  By BRADFORD",48,10,21,0,79
190721,10269,2010-07-01,Senate,"W/O REF. TO FILE SCR110 Romero",34,0,5,0,39
190721,21521,2010-08-26,Assembly,"Be adopted, to Consent Calendar",9,0,0,0,9
190721,21707,2010-08-30,Assembly,"SCR 110 Romero  Consent Calendar Second Day  Regular Session",78,0,0,0,78
191161,135,2010-05-28,Assembly,"From committee:  Be adopted.  To third reading.",6,3,2,0,11
191161,8894,2010-06-14,Assembly,"HR 30 AMMIANO  Assembly Third Reading",50,1,28,0,79
193651,8775,2010-06-07,Assembly,"Be adopted as amended, and re-refer to Committee on Appropriations. with the recommendation:  To Consent Calendar",11,0,3,0,14
193651,9900,2010-06-30,Assembly,"Be adopted, to Consent Calendar",16,0,1,0,17
193651,19155,2010-08-02,Assembly,"ACR 164 VILLINES  Consent Calendar Second Day  Regular Session",76,0,0,0,76
193651,21510,2010-08-26,Senate,"W/O REF. TO FILE ACR164 Villines",34,0,0,0,34
193651,21665,2010-08-30,Assembly,"ACR 164 Villines  Concurrence in Senate Amendments",74,0,0,0,74
193914,8829,2010-06-14,Assembly,"Be adopted, and re-refer to Committee on Appropriations with recommendation:  To Consent Calendar",12,0,2,0,14
193914,9807,2010-06-30,Assembly,"Be adopted, to Consent Calendar",16,0,1,0,17
193914,19071,2010-08-02,Assembly,"ACR 165 BLAKESLEE  Consent Calendar Second Day  Regular Session",76,0,0,0,76
193914,21613,2010-08-26,Senate,"W/O REF. TO FILE ACR165 Blakeslee",34,0,0,0,34
193914,21761,2010-08-30,Assembly,"ACR 165 Blakeslee  Concurrence in Senate Amendments By HAGMAN",77,0,0,0,77
193915,20009,2010-08-11,Senate,"Senate 3rd Reading SJR32 DeSaulnier",32,0,0,0,32
205147,9052,2010-06-17,Assembly,"From committee:  Be adopted.  To third reading",9,0,2,0,11
205147,19067,2010-08-02,Senate,"W/O REF. TO FILE ACR166 Fletcher",33,0,0,0,33
205148,19458,2010-08-05,Assembly,"From committee:  Be adopted.  To third reading",9,0,0,0,9
205148,19694,2010-08-09,Assembly,"ACR 167 MA  Assembly Third Reading",77,0,0,0,77
205148,21297,2010-08-25,Senate,"Assembly 3rd Reading ACR167 Ma By Yee",35,0,0,0,35
205149,9487,2010-06-24,Assembly,"Be referred to Committee on Health",11,0,0,0,11
205149,19765,2010-08-04,Assembly,"Be adopted, to Consent Calendar",17,0,0,0,17
205149,20223,2010-08-12,Assembly,"ACR 168 GALGIANI  Consent Calendar Second Day",78,0,0,0,78
205149,21610,2010-08-26,Senate,"W/O REF. TO FILE ACR168 Galgiani",34,0,0,0,34
205150,9911,2010-06-29,Senate,"Be adopted and be placed on the Consent Calendar",8,0,1,0,9
205150,19332,2010-08-02,Senate,"Consent Calendar 2nd SJR33 Lowenthal",33,0,0,0,33
205150,19712,2010-08-09,Assembly,"From committee:  Be adopted.  To third reading",13,0,0,0,13
205150,20474,2010-08-16,Assembly,"SJR 33 Lowenthal  Senate Third Reading  By LOWENTHAL",71,0,0,0,71
205686,21986,2010-06-23,Senate,"Do pass as amended, and re-refer to the Committee on Appropriations",3,0,0,0,3
205686,21987,2010-08-02,Senate,"Placed on Appropriations Suspense file",10,0,0,0,10
205852,9035,2010-06-17,Assembly,"Be adopted, to Consent Calendar",9,0,2,0,11
205852,9546,2010-06-24,Assembly,"ACR 169 CARTER  Consent Calendar Second Day",73,0,6,0,79
205852,10333,2010-07-01,Senate,"W/O REF. TO FILE ACR169 Carter",34,0,5,0,39
205885,9937,2010-06-30,Assembly,"Be adopted as amended",8,0,0,0,8
205885,19839,2010-08-09,Assembly,"ACR 170 NIELSEN  Assembly Third Reading",76,0,0,0,76
205886,7983,2010-06-10,Assembly,"Be adopted, to Consent Calendar",11,0,0,0,11
205886,9430,2010-06-24,Senate,"W/O REF. TO FILE ACR171 Gaines",31,0,8,0,39
205887,9111,2010-06-15,Assembly,"Be adopted, to Consent Calendar",18,0,1,0,19
205887,9429,2010-06-24,Assembly,"AJR 42 SOLORIO  Assembly Third Reading",71,0,8,0,79
205887,19767,2010-08-11,Senate,"Assembly 3rd Reading AJR42 Solorio By DeSaulnier",32,0,0,0,32
205993,8756,2010-06-14,Assembly,"Be adopted, and re-refer to Committee on Appropriations with recommendation:  To Consent Calendar",12,0,2,0,14
205993,9870,2010-06-30,Assembly,"Be adopted, to Consent Calendar",16,0,1,0,17
205993,19110,2010-08-02,Assembly,"ACR 172 VILLINES  Consent Calendar Second Day  Regular Session",76,0,0,0,76
205994,9074,2010-06-17,Senate,"W/O REF. TO FILE SJR34 Padilla",26,0,13,0,39
205994,9794,2010-06-30,Assembly,"Be adopted, to Consent Calendar",18,0,4,0,22
205994,19511,2010-08-02,Assembly,"SJR 34 Padilla  Consent Calendar Second Day  Regular Session",76,0,0,0,76
206189,9630,2010-06-28,Assembly,"From committee:  Be adopted.  To third reading",10,1,0,0,11
206189,21625,2010-08-27,Senate,"Assembly 3rd Reading ACR173 Evans By Wolk",24,11,0,0,35
206190,10362,2010-07-01,Senate,"W/O REF. TO FILE SCR111 Wright",34,0,5,0,39
206190,19923,2010-08-12,Assembly,"Be adopted, to Consent Calendar",9,0,0,0,9
206190,20354,2010-08-17,Assembly,"SCR 111 Wright  Consent Calendar Second Day  Regular Session",76,0,0,0,76
206321,9399,2010-06-21,Assembly,"Be adopted, and re-refer to Committee on Appropriations with recommendation:  To Consent Calendar",13,0,1,0,14
206321,10134,2010-06-30,Assembly,"Be adopted, to Consent Calendar",16,0,1,0,17
206321,19069,2010-08-02,Assembly,"ACR 174 ENG  Consent Calendar Second Day  Regular Session",76,0,0,0,76
206321,19820,2010-08-10,Senate,"Be adopted as amended, but re-refer to the Committee on 	Appropriations Recommend Consent",9,0,0,0,9
206321,20696,2010-08-20,Senate,"Consent Calendar 2nd ACR174 Eng",32,0,0,0,32
206321,21459,2010-08-26,Assembly,"ACR 174 ENG  Concurrence in Senate Amendments",77,0,0,0,77
206322,9666,2010-06-28,Assembly,"From committee:  Be adopted.  To third reading",11,3,1,0,15
206322,10060,2010-07-01,Assembly,"AJR 43 HILL  Assembly Third Reading",51,19,9,0,79
206322,21960,2010-08-30,Senate,"Assembly 3rd Reading AJR43 Hill By Lowenthal",22,11,0,0,33
206685,9906,2010-06-29,Assembly,"From committee:  Be adopted.  To third reading",19,0,0,0,19
206685,20467,2010-08-16,Assembly,"HR 31 ENG  Assembly Third Reading",75,0,0,0,75
206833,10235,2010-06-29,Assembly,"From committee:  Be adopted.  To third reading",10,3,0,0,13
206833,19649,2010-08-09,Assembly,"AJR 44 HILL  Assembly Third Reading  Amend By HILL  Set #1",52,25,0,0,77
206833,19980,2010-08-12,Assembly,"AJR 44 HILL  Assembly Third Reading",57,16,0,0,73
206833,21063,2010-08-24,Senate,"Assembly 3rd Reading AJR44 Hill By Lowenthal",24,11,0,0,35
206997,9748,2010-06-28,Assembly,"Be adopted, and re-refer to Committee on Appropriations with recommendation:  To Consent Calendar",13,0,1,0,14
206997,19590,2010-08-04,Assembly,"Be adopted, to Consent Calendar",16,0,0,0,16
206997,20134,2010-08-12,Assembly,"ACR 175 ANDERSON  Consent Calendar Second Day  Regular Session",78,0,0,0,78
206997,21616,2010-08-26,Senate,"W/O REF. TO FILE ACR175 Anderson",34,0,0,0,34
207398,9736,2010-06-28,Assembly,"Be adopted, and re-refer to Committee on Appropriations with recommendation:  To Consent Calendar",13,0,1,0,14
207398,19579,2010-08-04,Assembly,"Be adopted, to Consent Calendar",16,0,0,0,16
207398,20094,2010-08-12,Assembly,"ACR 176 CONWAY  Consent Calendar Second Day  Regular Session",78,0,0,0,78
207532,9424,2010-06-24,Assembly,"From committee:  Be adopted.  To third reading",10,0,1,0,11
207641,10284,2010-07-01,Senate,"W/O REF. TO FILE SCR115 DeSaulnier",34,0,5,0,39
207641,20230,2010-08-12,Assembly,"Be adopted, as amended, to Consent Calendar",9,0,0,0,9
207641,20466,2010-08-18,Assembly,"SCR 115 DeSaulnier  Consent Calendar Second Day",75,0,0,0,75
207641,21515,2010-08-26,Senate,"Special Consent #32 SCR115 DeSaulnier",34,0,0,0,34
207711,19560,2010-08-05,Assembly,"From committee:  Be adopted.  To third reading",7,0,0,0,7
207711,21678,2010-08-30,Senate,"Assembly 3rd Reading ACR177 Yamada By Corbett",27,4,0,0,31
207893,19748,2010-08-10,Assembly,"Be adopted and be re-referred to the Committee on Appropriations",5,0,0,0,5
207893,19870,2010-08-12,Assembly,"Be adopted, to Consent Calendar",17,0,0,0,17
207893,20396,2010-08-17,Assembly,"ACR 178 NIELLO  Consent Calendar Second Day  Regular Session",76,0,0,0,76
207893,21470,2010-08-26,Senate,"W/O REF. TO FILE ACR178 Niello",34,0,0,0,34
207894,19761,2010-08-10,Senate,"Be adopted, but re-refer to the Committee on Appropriations 	Recommend Consent",9,0,0,0,9
207894,20663,2010-08-20,Senate,"Consent Calendar 2nd SCR116 Ducheny",32,0,0,0,32
207894,21394,2010-08-26,Assembly,"Be adopted, to Consent Calendar",9,0,0,0,9
207894,21706,2010-08-30,Assembly,"SCR 116 Ducheny  Consent Calendar Second Day  Regular Session",78,0,0,0,78
208019,20245,2010-08-11,Assembly,"Be adopted as amended",5,0,0,0,5
208019,20401,2010-08-17,Assembly,"AJR 45 FONG  Assembly Third Reading",68,2,0,0,70
208019,21768,2010-08-30,Senate,"Assembly 3rd Reading AJR45 Fong",23,13,0,0,36
208020,21593,2010-08-24,Assembly,"From committee:  Be adopted.  To third reading",18,0,0,0,18
208020,21681,2010-08-30,Assembly,"AJR 46 HARKEY  Assembly Third Reading",77,0,0,0,77
208020,21780,2010-09-01,Senate,"W/O REF. TO FILE AJR46 Harkey",37,0,0,0,37
208084,19794,2010-08-09,Senate,"Senate 3rd Reading SJR35 Corbett",33,0,0,0,33
208084,21609,2010-08-26,Assembly,"Be adopted, to Consent Calendar",9,0,0,0,9
208084,21724,2010-08-30,Assembly,"SJR 35 Corbett  Consent Calendar Second Day  Regular Session",78,0,0,0,78
208161,19646,2010-08-09,Assembly,"Be adopted, and re-refer to Committee on Appropriations with 	recommendation:  To Consent Calendar",12,0,0,0,12
208161,19858,2010-08-12,Assembly,"Be adopted, to Consent Calendar",16,0,0,0,16
208161,20356,2010-08-17,Assembly,"ACR 179 PEREZ, J.  Consent Calendar Second Day  Regular Session",76,0,0,0,76
208161,21404,2010-08-26,Senate,"W/O REF. TO FILE ACR179 John A. Perez",34,0,0,0,34
208161,21719,2010-08-30,Assembly,"ACR 179 JohnA Perez  Concurrence in Senate Amendments By SOLORIO",77,0,0,0,77
208162,19818,2010-08-10,Senate,"Be adopted, but re-refer to the Committee on Appropriations 	Recommend Consent",9,0,0,0,9
208162,20665,2010-08-20,Senate,"Consent Calendar 2nd SCR118 Denham",32,0,0,0,32
208162,21400,2010-08-26,Assembly,"Be adopted, to Consent Calendar",9,0,0,0,9
208162,21715,2010-08-30,Assembly,"SCR 118 Denham  Consent Calendar Second Day  Regular Session",78,0,0,0,78
208426,19449,2010-08-05,Senate,"W/O REF. TO FILE SCR119 Wolk",33,0,0,0,33
208426,20117,2010-08-12,Assembly,"Be adopted, to Consent Calendar",9,0,0,0,9
208426,20399,2010-08-17,Assembly,"SCR 119 Wolk  Consent Calendar Second Day  Regular Session",76,0,0,0,76
208691,20113,2010-08-12,Assembly,"Be adopted, to Consent Calendar",9,0,0,0,9
208691,20393,2010-08-17,Assembly,"ACR 180 BEALL  Consent Calendar Second Day",76,0,0,0,76
208691,21954,2010-08-31,Senate,"Assembly 3rd Reading ACR180 Beall By Alquist",37,0,0,0,37
208692,19890,2010-08-12,Assembly,"Be adopted, to Consent Calendar",9,0,0,0,9
208692,20342,2010-08-17,Assembly,"ACR 181 LOGUE  Consent Calendar Second Day  Regular Session",76,0,0,0,76
208692,21354,2010-08-26,Senate,"W/O REF. TO FILE ACR181 Logue",34,0,0,0,34
208693,19684,2010-08-09,Assembly,"Be adopted, and re-refer to Committee on Appropriations with 	recommendation:  To Consent Calendar",12,0,0,0,12
208693,19888,2010-08-12,Assembly,"Be adopted, to Consent Calendar",16,0,0,0,16
208693,20340,2010-08-17,Assembly,"ACR 182 CHESBRO  Consent Calendar Second Day  Regular Session",76,0,0,0,76
208693,21484,2010-08-26,Senate,"W/O REF. TO FILE ACR182 Chesbro",34,0,0,0,34
208709,20187,2010-08-12,Assembly,"From committee:  Be adopted.  To third reading",9,0,0,0,9
208709,21551,2010-08-27,Senate,"W/O REF. TO FILE ACR183 Fletcher",34,0,0,0,34
208723,20374,2010-08-17,Assembly,"ACR 184 RUSKIN  Assembly Third Reading",76,0,0,0,76
208723,21525,2010-08-27,Senate,"Assembly 3rd Reading ACR184 Ruskin By Negrete McLeod",34,0,0,0,34
208724,20031,2010-08-12,Assembly,"Be adopted, to Consent Calendar",9,0,0,0,9
208725,21617,2010-08-26,Senate,"W/O REF. TO FILE SCR120 Denham",34,0,0,0,34
208725,21889,2010-08-31,Assembly,"From committee:  Be adopted.  To third reading",11,0,0,0,11
208725,21890,2010-08-31,Assembly,"SCR 120 Denham  Senate Third Reading  By GALGIANI",76,0,0,0,76
208733,19936,2010-08-12,Assembly,"Be adopted, to Consent Calendar",9,0,0,0,9
208733,20357,2010-08-17,Assembly,"ACR 185 COOK  Consent Calendar Second Day  Regular Session",76,0,0,0,76
208733,21928,2010-09-01,Senate,"W/O REF. TO FILE ACR185 Cook",37,0,0,0,37
208766,20715,2010-08-19,Senate,"W/O REF. TO FILE SCR121 Alquist",35,0,0,0,35
208766,21614,2010-08-26,Assembly,"Be adopted, to Consent Calendar",9,0,0,0,9
208766,21662,2010-08-30,Assembly,"SCR 121 Alquist  Consent Calendar Second Day  Regular Session",78,0,0,0,78
208767,21615,2010-08-26,Senate,"W/O REF. TO FILE SCR122 Kehoe",34,0,0,0,34
208767,21885,2010-08-31,Assembly,"From committee:  Be adopted.  To third reading",11,0,0,0,11
208767,21886,2010-08-31,Assembly,"SCR 122 Kehoe  Senate Third Reading  By SALDANA",76,0,0,0,76
208768,20675,2010-08-19,Senate,"Senate 3rd Reading SCR123 Cedillo",33,0,0,0,33
208769,20676,2010-08-19,Senate,"Senate 3rd Reading SJR36 Cedillo",30,2,0,0,32
208784,19860,2010-08-12,Assembly,"Be adopted, to Consent Calendar",9,0,0,0,9
208784,20392,2010-08-17,Assembly,"HR 34 GALGIANI  Consent Calendar Second Day  Regular Session",76,0,0,0,76
208873,21588,2010-08-26,Assembly,"Be adopted, to Consent Calendar",9,0,0,0,9
208873,21677,2010-08-30,Assembly,"AJR 47 SALDANA  Consent Calendar Second Day  Regular Session",78,0,0,0,78
208874,21332,2010-08-26,Assembly,"Be adopted, to Consent Calendar",9,0,0,0,9
208874,21669,2010-08-30,Assembly,"HR 35 HARKEY  Consent Calendar Second Day  Regular Session",78,0,0,0,78
208875,21333,2010-08-23,Senate,"W/O REF. TO FILE SCR124 Yee",33,0,0,0,33
208875,21334,2010-08-26,Assembly,"Be adopted, to Consent Calendar",9,0,0,0,9
208875,21670,2010-08-30,Assembly,"SCR 124 Yee  Consent Calendar Second Day  Regular Session",78,0,0,0,78
208887,21628,2010-08-26,Assembly,"Be adopted, to Consent Calendar",9,0,0,0,9
208887,21772,2010-08-30,Assembly,"ACR 187 TORRES  Consent Calendar Second Day",78,0,0,0,78
208887,21876,2010-09-01,Senate,"W/O REF. TO FILE ACR187 Torres",37,0,0,0,37
208888,21526,2010-08-26,Assembly,"Be adopted, as amended, to Consent Calendar",9,0,0,0,9
208917,21379,2010-08-26,Senate,"W/O REF. TO FILE SCR125 Hollingsworth",34,0,0,0,34
208917,21788,2010-08-31,Assembly,"From committee:  Be adopted.  To third reading",11,0,0,0,11
209001,21469,2010-08-26,Senate,"W/O REF. TO FILE SCR126 Corbett",28,0,0,0,28
209001,21865,2010-08-31,Assembly,"Be adopted as amended",2,6,0,0,8
